time,open,high,low,close,Volume,Volume MA,RSI,RSI-based MA,Upper Bollinger Band,Lower Bollinger Band,CCI,Smoothing Line,Histogram,MACD,Signal,OnBalanceVolume,Smoothing Line,RSI,RSI-based MA,Upper Bollinger Band,Lower Bollinger Band,True Strength Index,Signal
1998-12-22T09:30:00-05:00,25.875,26.53101,25.875,26.5,150300,NaN,NaN,NaN,NaN,NaN,NaN,NaN,NaN,NaN,NaN,NaN,NaN,NaN,NaN,NaN,NaN,NaN,NaN
1998-12-23T09:30:00-05:00,26.79687,27.14062,26.6875,27.14062,44000,NaN,NaN,NaN,NaN,NaN,NaN,NaN,NaN,NaN,NaN,44000,NaN,NaN,NaN,NaN,NaN,NaN,NaN
1998-12-24T09:30:00-05:00,27.14062,27.14062,27,27.09375,45500,NaN,NaN,NaN,NaN,NaN,NaN,NaN,NaN,NaN,NaN,-1500,NaN,NaN,NaN,NaN,NaN,NaN,NaN
1998-12-28T09:30:00-05:00,27.14062,27.15625,26.8125,26.9375,25400,NaN,NaN,NaN,NaN,NaN,NaN,NaN,NaN,NaN,NaN,-26900,NaN,NaN,NaN,NaN,NaN,NaN,NaN
1998-12-29T09:30:00-05:00,26.95312,27.5625,25.98437,27.53125,123500,NaN,NaN,NaN,NaN,NaN,NaN,NaN,NaN,NaN,NaN,96600,NaN,NaN,NaN,NaN,NaN,NaN,NaN
1998-12-30T09:30:00-05:00,27.53125,27.60937,27.3125,27.35937,10200,NaN,NaN,NaN,NaN,NaN,NaN,NaN,NaN,NaN,NaN,86400,39720,NaN,NaN,NaN,NaN,NaN,NaN
1998-12-31T09:30:00-05:00,27.29687,27.42187,27.07812,27.15625,66300,NaN,NaN,NaN,NaN,NaN,NaN,NaN,NaN,NaN,NaN,20100,34940,NaN,NaN,NaN,NaN,NaN,NaN
1999-01-04T09:30:00-05:00,27.375,27.59375,26.73437,26.9375,50000,NaN,NaN,NaN,NaN,NaN,NaN,NaN,NaN,NaN,NaN,-29900,29260,NaN,NaN,NaN,NaN,NaN,NaN
1999-01-05T09:30:00-05:00,27.09375,27.28125,27.01562,27.14062,27900,NaN,NaN,NaN,NaN,NaN,NaN,NaN,NaN,NaN,NaN,-2000,34240,NaN,NaN,NaN,NaN,NaN,NaN
1999-01-06T09:30:00-05:00,27.32812,27.48437,27.15625,27.46875,118500,NaN,NaN,NaN,NaN,NaN,NaN,NaN,NaN,NaN,NaN,116500,38220,NaN,NaN,NaN,NaN,NaN,NaN
1999-01-07T09:30:00-05:00,27.26562,27.26562,26.95312,27.15625,43500,NaN,NaN,NaN,NaN,NaN,NaN,NaN,NaN,NaN,NaN,73000,35540,NaN,NaN,NaN,NaN,NaN,NaN
1999-01-08T09:30:00-05:00,27.15625,27.17187,26.625,27.04687,63800,NaN,NaN,NaN,NaN,NaN,NaN,NaN,NaN,NaN,NaN,9200,33360,NaN,NaN,NaN,NaN,NaN,NaN
1999-01-11T09:30:00-05:00,26.98437,26.98437,26.32812,26.5,65400,NaN,NaN,NaN,NaN,NaN,NaN,NaN,NaN,NaN,NaN,-56200,28100,NaN,NaN,NaN,NaN,NaN,NaN
1999-01-12T09:30:00-05:00,26.48437,26.57812,26.25,26.29687,29400,NaN,NaN,NaN,NaN,NaN,NaN,NaN,NaN,NaN,NaN,-85600,11380,NaN,NaN,NaN,NaN,NaN,NaN
1999-01-13T09:30:00-05:00,25.54687,26.48437,25.54687,26.34375,73800,NaN,47.93388429752066,NaN,NaN,NaN,NaN,NaN,NaN,NaN,NaN,-11800,-14280,NaN,NaN,NaN,NaN,NaN,NaN
1999-01-14T09:30:00-05:00,26.23437,26.32812,25.48437,25.84375,30800,NaN,41.9588202559822,NaN,NaN,NaN,NaN,NaN,NaN,NaN,NaN,-42600,-37400,NaN,NaN,NaN,NaN,NaN,NaN
1999-01-15T09:30:00-05:00,26.0625,26.21875,25.82812,26.125,39000,NaN,46.03383084577115,NaN,NaN,NaN,NaN,NaN,NaN,NaN,NaN,-3600,-39960,NaN,NaN,NaN,NaN,NaN,NaN
1999-01-19T09:30:00-05:00,26.32812,26.32812,25.65625,25.82812,39200,NaN,42.63135725157263,NaN,NaN,NaN,NaN,NaN,NaN,NaN,NaN,-42800,-37280,NaN,NaN,NaN,NaN,NaN,NaN
1999-01-20T09:30:00-05:00,25.98437,26.1875,25.78125,25.90625,480500,NaN,43.80844877871254,NaN,NaN,NaN,NaN,NaN,NaN,NaN,NaN,437700,67380,NaN,NaN,NaN,NaN,NaN,NaN
1999-01-21T09:30:00-05:00,25.79687,25.9375,25.35937,25.51562,42500,78475,39.45015207566303,NaN,NaN,NaN,-138.0642642073786,NaN,NaN,NaN,NaN,395200,148780,69.04379409094084,NaN,NaN,NaN,NaN,NaN
1999-01-22T09:30:00-05:00,25.35937,25.67187,25.21875,25.39062,75700,74745,38.142485538873004,NaN,NaN,NaN,-142.08265982528775,NaN,NaN,NaN,NaN,319500,221200,75.67046006376285,NaN,NaN,NaN,NaN,NaN
1999-01-25T09:30:00-05:00,25.39062,25.48437,25.10937,25.32812,179000,81495,37.47363536715675,NaN,NaN,NaN,-133.44685961910258,NaN,NaN,NaN,NaN,140500,250020,77.71493330469133,NaN,NaN,NaN,NaN,NaN
1999-01-26T09:30:00-05:00,25.34375,25.92187,25.29687,25.92187,85000,83470,46.98470430193964,NaN,NaN,NaN,-80.02235476782491,NaN,NaN,NaN,NaN,225500,303680,80.9284141559131,NaN,NaN,NaN,NaN,NaN
1999-01-27T09:30:00-05:00,26.17187,26.42187,26.09375,26.26562,50400,84720,51.57711363693457,NaN,NaN,NaN,-18.61371090470636,-102.44596986486003,NaN,NaN,NaN,275900,271320,73.99850922598905,NaN,NaN,NaN,NaN,NaN
1999-01-28T09:30:00-05:00,26.29687,26.79687,26.26562,26.73437,57300,81410,57.04183900895313,NaN,NaN,NaN,21.677592848983103,-70.4975984535877,NaN,NaN,NaN,333200,258920,71.47290364782252,NaN,NaN,NaN,NaN,NaN
1999-01-29T09:30:00-05:00,26.8125,26.98437,26.4375,26.79687,167800,89290,57.726862664467795,NaN,NaN,NaN,44.50791619047649,-33.17948325043485,NaN,-0.3095921025359516,NaN,501000,295220,74.2442245126382,NaN,NaN,NaN,NaN,NaN
1999-02-01T09:30:00-05:00,26.98437,27.07812,26.67187,26.6875,57200,88835,56.042708354727395,NaN,NaN,NaN,58.02833366303982,5.115555405993635,NaN,-0.2508882200068605,NaN,443800,355880,78.07697228376706,NaN,NaN,NaN,NaN,NaN
1999-02-02T09:30:00-05:00,26.78125,26.90625,26.53125,26.90625,81800,90425,58.64167891083647,47.531965806365065,NaN,NaN,57.70119079756421,32.66026451907146,NaN,-0.1845858821848445,NaN,525600,415900,81.07746868473939,NaN,NaN,NaN,NaN,NaN
1999-02-03T09:30:00-05:00,26.78125,26.90625,26.54687,26.8125,65300,92295,57.083948366094596,48.18554181126321,NaN,NaN,59.11033024508554,48.20507274902983,NaN,-0.13801469577517622,NaN,460300,452780,82.64891257888601,NaN,NaN,NaN,NaN,NaN
1999-02-04T09:30:00-05:00,26.70312,26.90625,26.5625,26.6875,34400,88090,54.98662021334106,49.116098951074555,NaN,NaN,62.73436553696832,56.41642728662688,NaN,-0.10992599194110397,NaN,425900,471320,83.39544782224057,NaN,NaN,NaN,NaN,NaN
1999-02-05T09:30:00-05:00,26.6875,26.6875,26.25,26.28125,33000,87565,48.721350851769984,49.308064665788756,NaN,NaN,24.437078881671763,52.40225982486593,NaN,-0.11907386224841332,NaN,392900,449700,79.12038358708566,NaN,NaN,NaN,NaN,NaN
1999-02-08T09:30:00-05:00,26.21875,26.375,26.01562,26.23437,83500,88550,48.04109153317263,49.69447425733161,NaN,NaN,-0.9315687577002593,40.610279340717916,NaN,-0.1286237451131349,NaN,309400,422820,74.03859354564071,NaN,NaN,NaN,NaN,NaN
1999-02-09T09:30:00-05:00,26.17187,26.17187,25.71875,25.76562,44500,87505,41.76227631460139,49.54831908132367,NaN,NaN,-50.27987612639216,19.01406595592664,NaN,-0.1720332118007306,NaN,264900,370680,65.27999017572031,76.19364340570269,NaN,NaN,NaN,NaN
1999-02-10T09:30:00-05:00,25.89062,25.95312,25.625,25.95312,32000,87635,44.86631098076609,49.93518757454532,NaN,NaN,-52.3110672056884,-3.270213534228148,-0.01114089455452888,-0.18912572032462194,-0.17798482577009306,296900,338000,60.45285747534078,75.58000507601696,NaN,NaN,NaN,NaN
1999-02-11T09:30:00-05:00,26.04687,26.40625,25.96875,26.39062,22400,85065,51.37830158398285,50.88060300633888,NaN,NaN,16.403656472573886,-12.536355347107037,0.010018482162027775,-0.16546172306755835,-0.17548020522958613,319300,316680,57.46733692094236,74.27978199438692,NaN,NaN,NaN,NaN
1999-02-12T09:30:00-05:00,26.4375,26.51562,25.98437,26.17187,29600,85005,48.30607560429217,51.654348737562835,NaN,NaN,8.548349438544177,-15.714101235732556,0.01039528974777082,-0.1624860930448726,-0.17288138279264342,289700,296040,54.65331844674755,72.63252379024809,NaN,NaN,NaN,NaN
1999-02-16T09:30:00-05:00,26.5,26.67187,26.40625,26.48437,37700,84940,52.66098638034605,52.05979745744901,NaN,NaN,55.11096934414452,-4.505593615363596,0.03160567368634962,-0.1333742906847064,-0.16497996437105603,327400,299640,55.06660624625579,70.78525179670113,NaN,NaN,NaN,NaN
1999-02-17T09:30:00-05:00,26.46875,26.71875,26.03125,26.21875,26800,84320,48.890803902857165,51.8679181907292,NaN,NaN,18.600406294462136,9.270462868807263,0.027795952765111598,-0.13023502341466653,-0.15803097617977813,300600,306780,55.92459923321753,69.49425822578888,NaN,NaN,-5.547109881888857,NaN
1999-02-18T09:30:00-05:00,26.3125,26.57812,26.26562,26.5,29400,61765,52.74831450127675,51.56123786875231,NaN,NaN,36.964256686871806,27.125527647319302,0.04334043991674799,-0.10385542628384314,-0.14719586620059114,330000,313400,56.749217492233115,68.4425663575325,NaN,NaN,-4.548981152990172,NaN
1999-02-19T09:30:00-05:00,26.45312,26.625,26.34375,26.39062,30300,61155,51.13198174443888,51.090174945893104,NaN,NaN,32.83013566421792,30.41082348564811,0.045173026386075954,-0.09072958321799618,-0.13590260960407213,299700,309480,56.08013679280658,67.14513152040168,NaN,NaN,-4.205689565647992,NaN
1999-02-22T09:30:00-05:00,26.5,27.125,26.42187,26.95312,183700,66555,58.22188514796395,51.24583043112428,NaN,NaN,100.74751217000735,48.850656031940744,0.0810900454415775,-0.03454005280210026,-0.11563009824367776,483400,348220,60.97679502102751,65.92369028734883,NaN,NaN,-1.4661993030325675,NaN
1999-02-23T09:30:00-05:00,26.98437,27.15625,26.78125,26.90625,35400,59375,57.47364426061167,51.16239938467966,NaN,NaN,121.41492653468481,62.1114474700488,0.09741430661099475,0.006137785020065678,-0.09127652159092907,448000,372340,63.69107460440766,64.68180499589657,NaN,NaN,0.4842438688897134,NaN
1999-02-24T09:30:00-05:00,27.09375,27.26562,26.59375,26.75,69000,58575,54.93884007859659,51.00917736414408,NaN,NaN,94.99352095271436,77.39007040169925,0.09340005898911684,0.025473552145466982,-0.06792650684364986,379000,388020,65.37704229724261,63.44809997577919,NaN,NaN,1.3704744657716297,NaN
1999-02-25T09:30:00-05:00,26.48437,26.625,26.07812,26.4375,28100,57460,50.17278990962528,50.6653323424501,NaN,NaN,-31.07499904550144,63.7822192552246,0.06666407397397779,0.01540358562382238,-0.05126048835015541,350900,392200,65.83251646730392,62.19360487899801,NaN,NaN,0.7320489071920822,NaN
1999-02-26T09:30:00-05:00,26.375,26.59375,26.21875,26.51562,15100,55350,51.30993626296028,50.85023130039226,NaN,NaN,-13.01831740314205,54.612528641752604,0.051864603598675806,0.013570266148189347,-0.03829433745048646,366000,405460,67.30202583849622,61.34943646838447,NaN,NaN,0.5535772826678939,NaN
1999-03-01T09:30:00-05:00,26.42187,26.51562,26.15625,26.39062,17500,47835,49.36846108086297,50.94504341094158,NaN,NaN,-32.32910153376105,27.99720590099892,0.032241668245568685,0.0020077478564743956,-0.03023392038909429,348500,378480,61.50563846299124,60.45422539105237,NaN,NaN,-0.135776573886609,NaN
1999-03-02T09:30:00-05:00,26.53125,26.70312,26.26562,26.3125,29700,46460,48.14244706614026,51.40076989319436,NaN,NaN,-7.948805043141561,2.1244595854336468,0.01354243198301544,-0.013305880410324988,-0.02684831239334043,318800,352640,56.48777350403869,59.826209914503686,NaN,NaN,-1.0426899172833504,NaN
1999-03-03T09:30:00-05:00,26.42187,26.42187,26.04687,26.3125,32000,43970,48.14244706614025,51.634779613578225,NaN,NaN,-52.19392692214292,-27.313029989537803,0.0013569672348919364,-0.025152103349725508,-0.026509070584617444,318800,340600,54.26624214718117,59.38430881963514,NaN,NaN,-1.7922583650045085,NaN
1999-03-04T09:30:00-05:00,26.35937,26.71875,26.21875,26.67187,85300,44970,54.20940623280049,51.83700137420806,NaN,NaN,39.281272943916875,-13.241775591654141,0.016824051520252202,-0.005479006184302193,-0.022303057704554395,404100,351240,55.91621460382354,59.273514368412364,NaN,NaN,-0.7274425694393577,NaN
1999-03-05T09:30:00-05:00,26.6875,27.23437,26.6875,27.07812,49100,45705,59.9181787460164,52.666437312902644,NaN,NaN,174.555200358185,24.272927960611273,0.05176583436772223,0.0424042352550984,-0.009361599112623834,453200,368680,58.55555651901174,59.552245659288374,NaN,NaN,2.0230803217185827,-1.1002094217641165
1999-03-08T09:30:00-05:00,27.14062,27.20312,26.82812,27.20312,30700,45590,61.508316295308795,53.2983894496857,NaN,NaN,161.39133649326118,63.01701556601572,0.07901557223449428,0.08940786618049401,0.010392293945999739,483900,395760,62.32720713821416,60.07086000871397,NaN,NaN,4.7998780637343454,-0.257339780978622
1999-03-09T09:30:00-05:00,27.23437,27.39062,27,27.23437,23300,42580,61.91510112185699,54.22869639389997,NaN,NaN,160.69476104077313,96.74572878279866,0.09385261058477407,0.12770805717696732,0.03385544659219326,507200,433440,66.84806582800158,60.85110762262712,NaN,NaN,7.1949943385111625,0.80727937894849
1999-03-10T09:30:00-05:00,27.125,27.125,26.84375,26.9375,32600,41985,55.8740945389276,54.45196639658933,NaN,NaN,91.16863499469063,125.41824116616537,0.07897806634889704,0.13257802952831454,0.053599963179417516,474600,464600,70.04899292281779,61.8010915819546,NaN,NaN,7.6175735247256116,1.780178542630936
1999-03-11T09:30:00-05:00,27.14062,27.39062,27.01562,27.20312,55700,43170,59.66604516060051,55.06154235488658,NaN,NaN,125.21539673233634,142.60506592384928,0.08197741667685374,0.1560717340254847,0.07409431734863095,530300,489840,72.37566574338669,62.965057935567465,NaN,NaN,9.140742518350574,2.8316876820194556
1999-03-12T09:30:00-05:00,27.45312,27.57812,27.25,27.4375,48100,44455,62.71108676249492,55.382199613067364,NaN,NaN,147.91867880334792,137.27776161288185,0.09384204000956273,0.19139686736058437,0.09755482735102164,578400,514880,74.49265565887474,63.930476552556556,NaN,NaN,11.391427053119665,4.054507592176629
1999-03-15T09:30:00-05:00,27.59375,27.875,27.5,27.67187,246400,55295,65.5147267629584,55.95656264894927,NaN,NaN,172.48851426896894,139.4971971680234,0.1104267583841963,0.23558827533126703,0.12516151694707073,824800,583060,79.17285248401713,65.03631782967152,NaN,NaN,14.19681373270775,5.50340846939536
1999-03-16T09:30:00-05:00,27.71875,27.95312,27.70312,27.79687,63700,56595,66.94232972770774,56.81395476674293,NaN,NaN,169.6493447696843,141.28811391380563,0.12186911973439546,0.27749791661506507,0.1556287968806696,888500,659320,82.94277012379716,66.29101267442542,NaN,NaN,16.966960981130043,7.1410588282146
1999-03-17T09:30:00-05:00,27.78125,27.78125,27.3125,27.32812,40900,57300,57.35380190257741,57.32688419481094,NaN,NaN,99.79977728964289,143.01434237279608,0.09131902156890451,0.26977757384180023,0.17845855227289573,847600,733920,85.67450430947537,67.7082975202948,NaN,NaN,16.49209092127797,8.47692055579508
1999-03-18T09:30:00-05:00,27.21875,27.79687,27.21875,27.79687,22300,56945,63.05301388654972,58.165675453638755,NaN,NaN,109.975977272362,139.9664584808012,0.09567127524255253,0.2980476463260864,0.20237637108353385,869900,801840,87.61869898979292,69.15948845967314,NaN,NaN,18.00049988152976,9.837431888042891
1999-03-19T09:30:00-05:00,27.92187,27.92187,27.40625,27.625,174200,64140,59.892550396788764,58.917396119062026,NaN,NaN,105.37125686662891,131.4569740934574,0.08057056856526751,0.30308958179011825,0.22251901322485074,695700,825300,88.21370638290423,71.06720759680978,NaN,NaN,18.20073241833477,11.032189106656016
1999-03-22T09:30:00-05:00,27.48437,27.625,27.28125,27.60937,93400,59625,59.59997715422556,59.735791125353835,NaN,NaN,73.07082530540968,111.57343630074554,0.06385596237460328,0.30233896619310485,0.23848300381850157,602300,780800,80.32801458350487,72.7700819596288,NaN,NaN,18.270091275157053,12.066175130727594
1999-03-23T09:30:00-05:00,27.29687,27.48437,26.51562,26.82812,91600,62435,47.19098350609592,59.66782944249353,NaN,NaN,-15.5490815961749,74.5337510275737,-0.0019996179155896687,0.23598348142401449,0.23798309933960415,510700,705240,69.04215394783903,73.82550423110436,NaN,NaN,14.033643380696201,12.347242023580252
1999-03-24T09:30:00-05:00,26.59375,26.85937,26.5,26.8125,46700,61320,46.980371754247656,59.15146983688261,NaN,NaN,-48.03373791836383,44.96704798597237,-0.04633827493007009,0.18006025567701656,0.22639853060708665,464000,628520,59.84787431595169,74.10633706768495,NaN,NaN,10.70675406448741,12.112886600852702
1999-03-25T09:30:00-05:00,27.0625,27.1875,26.76562,27.01562,46000,62215,50.09917271526578,58.450112263257566,NaN,NaN,-12.500088541703235,20.471834823159316,-0.06080114553524099,0.1503970986880354,0.2111982442232764,510000,556540,52.750209349575826,73.69166941272523,NaN,NaN,8.940576301634648,11.659699415250124
1999-03-26T09:30:00-05:00,26.76562,26.98437,26.70312,26.92187,20400,62480,48.67596330062466,57.53351562078013,NaN,NaN,-37.9779108897029,-8.197998728107047,-0.0745872561814058,0.11796417399651915,0.19255143017792495,489600,515320,49.15506857672812,72.75080237261909,NaN,NaN,7.077188948989238,11.00505506292714
1999-03-29T09:30:00-05:00,27.1875,27.46875,27.1875,27.26562,18200,62515,53.85253481505832,56.95761802743738,NaN,NaN,32.72034970944057,-16.268093847300868,-0.05913626873122818,0.11863109426388974,0.17776736299511792,507800,496420,47.5546870095219,71.37270388558484,NaN,NaN,7.066119232373586,10.442349944276632
1999-03-30T09:30:00-05:00,26.71875,27.14062,26.71875,27.03125,45800,63320,50.13936956937036,56.54799481532614,NaN,NaN,-40.12713029615401,-21.18370358729669,-0.06292948519245428,0.09910550650455008,0.16203499169700436,462000,486680,46.710666243216245,69.70568055132757,NaN,NaN,5.90985715476252,9.794850974346044
1999-03-31T09:30:00-05:00,27.23437,27.23437,26.40625,26.4375,45800,64010,42.20075628133899,55.30047418109317,NaN,NaN,-106.79143662410408,-32.93524332844474,-0.10137711216498713,0.03531360149077045,0.13669071365575758,416200,477120,45.85049007627099,67.8110251465336,NaN,NaN,2.186452933171462,8.707936968463962
1999-04-01T09:30:00-05:00,26.71875,26.71875,26.375,26.48437,38500,61670,42.96839589637452,53.89028197637028,NaN,NaN,-142.80823571747337,-58.99687276359877,-0.11841603340094284,-0.011329328095420976,0.10708670530552186,454700,466060,44.82212873918731,65.69170179512736,NaN,NaN,-0.4896828437601355,7.393991281003377
1999-04-05T09:30:00-04:00,26.75,26.75,26.53125,26.625,32900,60860,45.31516227405463,52.44745594144859,NaN,NaN,-108.54032669309585,-73.10935592427737,-0.11488974597732707,-0.036525477166136966,0.0783642688111901,487600,465660,44.783008223663934,63.23528434795928,NaN,NaN,-1.9662384251183784,6.056815608700269
1999-04-06T09:30:00-04:00,26.42187,26.625,26.14062,26.32812,136600,66155,41.438598140619,50.625760828085106,NaN,NaN,-141.34127143638182,-107.92168015344184,-0.12631744711982357,-0.07953254008858934,0.04678490703123421,351000,434300,41.70941140616575,60.29004443955703,NaN,NaN,-4.434573694543334,4.5580457082368975
1999-04-07T09:30:00-04:00,26.54687,26.54687,26.14062,26.29687,77800,68880,41.040609207079015,49.46053277840665,NaN,NaN,-128.66783499703158,-125.62982109361735,-0.129279170558129,-0.11481405616642704,0.014465114391701957,273200,396540,38.30076683259705,56.90620604835144,NaN,NaN,-6.53548624178773,2.973255429661951
1999-04-08T09:30:00-04:00,26.34375,26.96875,26.34375,26.90625,49100,69705,50.936356488720556,48.59505724999028,NaN,NaN,-55.18420546178413,-115.30837486115335,-0.08560116139633545,-0.09253633735371736,-0.006935175957381905,322300,377760,36.6945736107749,53.26876852127872,NaN,NaN,-5.297780593236678,1.7916788549621467
1999-04-09T09:30:00-04:00,26.96875,27.125,26.64062,26.96875,61000,69970,51.829362750413466,48.01911527524919,NaN,NaN,-24.329819579332167,-91.61269163352513,-0.049685446443770695,-0.06904198401209527,-0.01935653756832458,383300,363480,35.47629700505921,49.50181070857551,NaN,NaN,-4.033634744946538,0.9594911978323346
1999-04-12T09:30:00-04:00,27,27.54687,27,27.42187,28400,68985,57.822973857414034,47.89218646833409,NaN,NaN,45.69452368374744,-60.765721558156464,0.004523950776595877,-0.01370159909757973,-0.018225549874175608,411700,348300,34.17729450396516,46.2053307028941,NaN,NaN,-0.9550506760448094,0.6859852158498855
1999-04-13T09:30:00-04:00,27.625,27.67187,27.1875,27.51562,70200,60175,58.96072830509112,48.73288252540517,NaN,NaN,72.96497768108048,-17.904471734664014,0.04441326261075028,0.03729102838926224,-0.007122234221488038,481900,374480,38.36866303278362,44.014367066104434,NaN,NaN,1.8780727615808877,0.8562834366686001
1999-04-14T09:30:00-04:00,27.5,27.5,26.57812,26.6875,38700,58925,46.92034166008165,48.72859466153617,NaN,NaN,-14.888444404359305,4.8514063838704455,0.014303142157715406,0.01075669347565622,-0.003546448682059186,443200,408480,43.40859371691434,42.84013273760176,NaN,NaN,0.422743597623224,0.7943491739478321
1999-04-15T09:30:00-04:00,26.76562,26.76562,25.75,26.03125,292300,71495,39.956815813054455,48.00414059709251,NaN,NaN,-148.91250459782736,-13.894253443338195,-0.047167101943670825,-0.06250532611164772,-0.015338224167976892,150900,374200,39.86861461031544,41.920018827654594,NaN,NaN,-3.4013330229932026,0.19496600295625577
1999-04-16T09:30:00-04:00,26.15625,26.15625,25.875,26.14062,16800,71220,41.51467609365549,47.492620082308996,NaN,NaN,-154.4359355788045,-39.91547664323266,-0.07610330909239986,-0.11046736053347672,-0.03436405144107686,167700,331080,35.902442141287594,40.973402653694556,NaN,NaN,-5.795518857571246,-0.660817548547673
1999-04-19T09:30:00-04:00,26.01562,26.1875,25,25.04687,71700,66095,32.44785055084935,45.96371406343693,NaN,NaN,-235.68484221869426,-96.191349823721,-0.1597377812314565,-0.2340362779803975,-0.074298496748941,96000,267940,31.034012573427972,39.793354479687856,NaN,NaN,-11.552995527744162,-2.2168429741471716
1999-04-20T09:30:00-04:00,25.3125,25.73437,25.125,25.51562,29400,62895,38.63359773743092,45.14187321829839,NaN,NaN,-189.45674143379364,-148.67569364669583,-0.1731926345258645,-0.2907892899062716,-0.11759665538040712,125400,196640,26.640803643941652,38.35979286545395,NaN,NaN,-13.762967321635589,-3.8662893095026596
1999-04-21T09:30:00-04:00,25.75,26.51562,25.60937,26.32812,92900,62960,47.59176733974279,45.52694543675581,NaN,NaN,-69.29097751307486,-159.55620026843894,-0.11962287370613997,-0.2671252475130821,-0.14750237380694212,218300,151660,24.303440021898638,36.82071786157021,NaN,NaN,-12.097686885103835,-5.042203248874256
1999-04-22T09:30:00-04:00,26.3125,26.65625,26.29687,26.65625,29700,62110,50.720457372475046,46.08066411362013,NaN,NaN,-8.505026937779473,-131.47470473642937,-0.05749031572119773,-0.2193652684584393,-0.16187495273724156,248000,171080,27.27035357884364,35.56701963583138,NaN,NaN,-9.651609916898957,-5.700689915734928
1999-04-23T09:30:00-04:00,26.67187,26.71875,26.39062,26.60937,16600,60640,50.25881926333655,46.43378246999742,NaN,NaN,0.3791420824092244,-100.51168920418662,-0.017049083770440315,-0.18318630745029196,-0.16613722367985165,231400,183820,29.230022446337344,34.456092080308046,NaN,NaN,-7.971231153577653,-6.025052949712459
1999-04-26T09:30:00-04:00,26.625,26.625,26.23437,26.42187,51800,62210,48.362860762668944,46.928372657286694,NaN,NaN,-20.01732231534022,-57.378185223515786,-0.0012587325273662742,-0.1677106393390595,-0.16645190681169322,179600,200540,31.826233728033202,33.7501508175843,NaN,NaN,-7.249598083163727,-6.199987968776926
1999-04-27T09:30:00-04:00,26.71875,26.79687,26.45312,26.45312,39800,63290,48.71014212325629,47.47619643701364,NaN,NaN,10.103382403525977,-17.46616045605187,0.012216150816725613,-0.1511817182907862,-0.1633978691075118,219400,219340,34.725836775999895,33.494798670684496,NaN,NaN,-6.575202212926573,-6.2535900036554475
1999-04-28T09:30:00-04:00,26.28125,26.5625,25.59375,26.0625,110200,66510,44.66634931184163,47.02833878152229,NaN,NaN,-70.06040186470612,-17.620045326378133,-0.003417232824819788,-0.16766941013853653,-0.16425217731371675,109200,197520,32.97292401601629,33.228966556773166,NaN,NaN,-7.235402493203467,-6.393848930733736
1999-04-29T09:30:00-04:00,26.10937,26.10937,25.75,25.85937,27100,65575,42.681998201436656,46.37495559945252,NaN,NaN,-88.7412010713182,-33.66728015308588,-0.024502624134677936,-0.19488045748206417,-0.17037783334738624,82100,164340,30.455375438461502,32.87032930201619,NaN,NaN,-8.377172570507724,-6.677180879272877
1999-04-30T09:30:00-04:00,25.90625,25.96875,25.3125,25.51562,34700,65385,39.485128483872444,45.065109501342405,NaN,NaN,-121.81653003087138,-58.106414575741994,-0.05681809062293561,-0.24140044662605575,-0.18458235600312015,47400,127540,27.91008322264682,32.422671353350594,NaN,NaN,-10.321672603539636,-7.197822554168128
1999-05-03T09:30:00-04:00,25.75,26.10937,25.59375,26.10937,46900,66085,46.88528117066493,44.2025775631691,NaN,NaN,-62.524992433292326,-66.60794859933242,-0.034519760767505375,-0.22773205696250187,-0.1932122961949965,94300,110480,26.792196240588083,31.59578086819377,NaN,NaN,-9.713365498054053,-7.557185831866117
1999-05-04T09:30:00-04:00,26.25,26.3125,25.73437,25.89062,91200,63815,44.71573898158939,44.0451059432768,NaN,NaN,-51.364977051278686,-78.90162049029335,-0.030932651040612297,-0.23187810999576186,-0.20094545895514956,3100,67220,24.150652491986236,30.220213637841766,NaN,NaN,-9.880337346963275,-7.889064619737139
1999-05-05T09:30:00-04:00,25.9375,26.14062,25.48437,26.14062,23500,61100,47.69462914968502,44.59780689589327,NaN,NaN,-54.625743808890164,-75.81468887913016,-0.009276382129727367,-0.21254093661730877,-0.2032645544875814,26600,50700,23.209576030722502,29.03028231072798,NaN,NaN,-9.114631752893644,-8.064145638759497
1999-05-06T09:30:00-04:00,26.21875,26.25,25.73437,25.79687,28100,60050,44.170343207356424,44.78749740401476,NaN,NaN,-49.25110111681895,-67.9166688882303,-0.015300566842143315,-0.22239026304026055,-0.20708969619811723,-1500,33980,22.263971398942047,28.05610582913187,NaN,NaN,-9.529355142046136,-8.27346128208616
1999-05-07T09:30:00-04:00,25.79687,26.20312,25.75,26.01562,31900,58595,46.86127582307113,45.81702778060203,NaN,NaN,-36.00862004931585,-50.755086891919206,-0.002426216924772351,-0.2101224673540827,-0.20769625042931034,30400,30580,22.067085465995447,27.41561103574383,NaN,NaN,-9.071696723502589,-8.387494916574221
1999-05-10T09:30:00-04:00,26,26,25.5625,25.60937,125400,63445,42.74111898473233,46.110422155409275,NaN,NaN,-75.04445048358255,-53.25897850197725,-0.01826203637032306,-0.23052379589221417,-0.2122617595218911,-95000,-7280,19.951308818469926,26.937789976781566,NaN,NaN,-9.923522300072184,-8.606927399931074
1999-05-11T09:30:00-04:00,25.53125,26,25.53125,25.71875,59800,62925,44.164557876841386,45.86562147948774,NaN,NaN,-67.76655081242069,-56.53929325420565,-0.018314769072136527,-0.23515522086206175,-0.21684045178992523,-35200,-14940,19.543036689861538,26.597761167350342,NaN,NaN,-10.20497457094007,-8.83521985293236
1999-05-12T09:30:00-04:00,25.70312,26.1875,25.67187,26.09375,38300,62905,48.85859637084254,45.73263140794256,NaN,NaN,-6.236740954575558,-46.86149268334273,0.008520786489845944,-0.20618946867761778,-0.21471025516746373,3100,-19640,19.28230663340767,26.027186385533486,NaN,NaN,-9.051204987187408,-8.866074872111652
1999-05-13T09:30:00-04:00,26.25,26.3125,26,26.21875,173300,56955,50.356763297692815,45.73962741039659,NaN,NaN,45.17136737038205,-27.976998985902526,0.034828799506251645,-0.17117425578464918,-0.20600305529090082,176400,15940,27.200403208428966,25.882213582825745,NaN,NaN,-7.6630960163319095,-8.694220749857402
1999-05-14T09:30:00-04:00,25.73437,26.03125,25.51562,25.75,41600,58195,45.02953865863683,45.501532974394294,NaN,NaN,-59.33303193934614,-32.64188136390858,0.021455929790082817,-0.1791831430532973,-0.20063907284338012,134800,36820,31.450193672965014,25.855353578892306,NaN,NaN,-8.014946184119882,-8.597181526180615
1999-05-17T09:30:00-04:00,25.54687,25.96875,25.5,25.92187,36800,56450,47.23369972484709,45.39607280307935,NaN,NaN,-59.340334047291314,-29.501058076650338,0.0247468488425171,-0.16970551179023374,-0.19445236063275084,171600,90140,40.93282891192194,26.298710160029596,NaN,NaN,-7.662360440716021,-8.46363565682853
1999-05-18T09:30:00-04:00,25.92187,26.96875,25.35937,25.57812,95500,59755,43.478637131850085,45.31123621879424,NaN,NaN,-20.53092462246985,-20.05393283866017,0.0053477255572136895,-0.18776770368623374,-0.19311542924344743,76100,112400,44.3913083121184,27.114309038322602,NaN,NaN,-8.470558742418172,-8.46462466905562
1999-05-19T09:30:00-04:00,25.70312,25.98437,25.625,25.9375,59400,58080,48.12211479702694,45.699815975622116,NaN,NaN,-52.20292472382769,-29.24716959251059,0.017603782823763098,-0.17111070071374357,-0.18871448353750667,135500,138880,48.27144373337329,28.38688534510202,NaN,NaN,-7.771365208909699,-8.365587603320488
1999-05-20T09:30:00-04:00,25.85937,26.17187,25.85937,26,150600,64125,48.90824120455489,46.372895455670864,NaN,NaN,5.067267267268583,-37.26798961313328,0.030071900607251678,-0.15112460777844205,-0.18119650838569373,286100,160820,51.303289844293694,30.05782867521965,NaN,NaN,-6.974839844853352,-8.166909352110897
1999-05-21T09:30:00-04:00,25.95312,26.10937,25.73437,25.92187,78100,67200,47.93045443069144,46.447550688529894,NaN,NaN,-18.599813888744645,-29.121346003012984,0.032976116470579575,-0.13997636279746928,-0.17295247926804885,208000,175460,53.271396957857775,31.949200155024634,NaN,NaN,-6.584091724004312,-7.940792548095671
1999-05-24T09:30:00-04:00,25.76562,26.04687,25.25,25.25,20100,65615,40.442659690636845,46.142330739176145,NaN,NaN,-186.44524354767577,-54.542327903089884,-0.008232638855542207,-0.18324327783747663,-0.17501063898193442,187900,178720,53.719940107062754,34.0612921275301,NaN,NaN,-8.500571290274817,-8.020760939835549
1999-05-25T09:30:00-04:00,25.32812,25.54687,25,25,33500,65300,38.06005889444137,45.45414714951588,NaN,NaN,-276.160465408174,-105.6682360602307,-0.04798879718050553,-0.23499663545756633,-0.1870078382770608,154400,194380,55.90934854119109,36.39699016399214,NaN,NaN,-10.839089981974121,-8.423379374426773
1999-05-26T09:30:00-04:00,25.21875,25.25,24.85937,25,67600,63170,38.06005889444137,45.017698270021945,NaN,NaN,-252.63866774983512,-145.7553846654322,-0.0686866202029682,-0.27286611353077106,-0.20417949332780286,154400,198160,56.44496750138019,38.83848988559487,NaN,NaN,-12.720178349091055,-9.037207799378812
1999-05-27T09:30:00-04:00,24.78125,25.26562,24.76562,24.875,24400,63035,36.80278015410693,44.29923429366736,NaN,NaN,-210.44212220958622,-188.85726256080315,-0.08417469107065514,-0.3093978571661218,-0.22522316609546664,130000,166940,50.94069330776707,40.900890445721416,NaN,NaN,-14.656412794766185,-9.839951370148437
1999-05-28T09:30:00-04:00,25.125,25.40625,25,25.25,16500,62125,42.89711236752489,44.310376678152544,NaN,NaN,-124.61967523032739,-210.0612348291197,-0.06348479689312206,-0.3045791622118692,-0.24109436531874714,146500,154640,48.91679036358381,42.96985341322954,NaN,NaN,-14.633567312132875,-10.524753647574785
1999-06-01T09:30:00-04:00,25.29687,25.375,24.95312,25.34375,36700,61615,44.34215036346148,44.32306185576827,NaN,NaN,-103.84768929235798,-193.54172397805615,-0.03900787680505646,-0.2898542113250677,-0.25084633452001126,183200,153700,48.757359486945816,45.05659075587842,NaN,NaN,-14.208655588052741,-11.05102535335735
1999-06-02T09:30:00-04:00,25.07812,25.32812,24.95312,24.95312,65200,60315,39.820407174475214,43.6774769131706,NaN,NaN,-114.60509516487619,-161.23064992939658,-0.0442635359986423,-0.30617575451831414,-0.26191221851967184,118000,146420,47.467046988379096,47.06978649551924,NaN,NaN,-15.142708902477267,-11.635551574660195
1999-06-03T09:30:00-04:00,25,25.46875,25,25.1875,40600,61170,43.54059670596668,43.19060787090445,NaN,NaN,-75.9748942112641,-125.89789522168238,-0.02789192591587869,-0.2967771259145202,-0.2688851999986415,158600,147260,47.63923120176473,48.52970278075751,NaN,NaN,-14.855988738767687,-12.09561402667555
1999-06-04T09:30:00-04:00,25.1875,26.0625,25.1875,26.0625,17400,60635,54.77948825824032,43.8870328423047,NaN,NaN,31.85042269393587,-77.43938624097795,0.042123453842113745,-0.21623088269599933,-0.25835433653811307,176000,156460,49.58812248712726,49.82526912462624,NaN,NaN,-10.815436351189813,-11.912731501606158
1999-06-07T09:30:00-04:00,26.10937,26.10937,25.76562,25.84375,28400,60460,51.99300275029775,44.22698305840832,NaN,NaN,59.65910918977546,-40.58362935695738,0.07219480960560348,-0.1681108245311087,-0.2403056341367122,147600,156680,49.63639700307499,50.4469525597086,NaN,NaN,-8.42840930447848,-11.414971187730776
1999-06-08T09:30:00-04:00,25.59375,25.82812,25.34375,25.48437,77100,58045,47.70012191735469,44.52851768594436,NaN,NaN,-8.478344898758246,-21.509760478237432,0.06651441017672108,-0.15716262141581083,-0.2236770315925319,70500,134140,44.893097565936955,50.48279464926707,NaN,NaN,-7.800823005383277,-10.898664304538276
1999-06-09T09:30:00-04:00,25.45312,25.67187,25.25,25.34375,18400,55975,46.09632951738849,44.38381873739876,NaN,NaN,-30.987293051766443,-4.786200055615472,0.05253243148580847,-0.15801149223527133,-0.2105439237210798,52100,120960,42.34493049798811,50.05947227531099,NaN,NaN,-7.792085579264188,-10.454867343784834
1999-06-10T09:30:00-04:00,25,25.23437,24.8125,24.875,71200,57620,41.13172706080034,43.82835344141629,NaN,NaN,-107.3429192903379,-11.059805071430233,0.013019920102812166,-0.1942690235925646,-0.20728894369537676,-19100,85420,36.352899174488634,48.99158722746777,NaN,NaN,-9.380098212822933,-10.301328896504563
1999-06-11T09:30:00-04:00,25.25,25.3125,24.625,24.625,20400,49975,38.73558967486893,43.17157738742896,NaN,NaN,-117.73882542174161,-40.97765469456573,-0.02649288449640705,-0.24040504931588558,-0.21391216481947853,-39500,42320,30.682562913823006,47.37809908146528,NaN,NaN,-11.453489281504618,-10.465923237218856
1999-06-14T09:30:00-04:00,24.64062,24.84375,24.5625,24.70312,32300,49510,39.91351691315652,43.1337814747518,NaN,NaN,-129.64831354675866,-78.83913924187256,-0.042934311874390896,-0.26758005466246715,-0.22464574278807625,-7200,11360,27.37891089583549,45.49659699494905,NaN,NaN,-12.773009225606355,-10.795506949845642
1999-06-15T09:30:00-04:00,24.75,25,24.67187,24.76562,25600,48950,40.89267757897137,43.33611138078965,NaN,NaN,-99.01021528267594,-96.9455133186561,-0.044952136112983154,-0.2808359129293052,-0.23588377681632205,18400,940,26.350554003774832,43.385254527990746,NaN,NaN,-13.57162652134993,-11.192095460060541
1999-06-16T09:30:00-04:00,25,25.03125,24.71875,24.95312,46300,46490,43.84892763747483,43.74960200529205,NaN,NaN,-77.13293060279089,-106.17464082886099,-0.02974408466625439,-0.27306388264914006,-0.24331979798288567,64700,3460,27.064042359029315,41.28661701782283,NaN,NaN,-13.41344355241428,-11.509430901825361
1999-06-17T09:30:00-04:00,24.875,25.375,24.875,25.15625,26300,44835,46.94481528433265,44.47403308602246,NaN,NaN,-28.04358291201491,-90.31477355319637,-0.0034711563765561504,-0.24765874345358085,-0.2441875870770247,91000,25480,33.15759966177315,40.016396043108976,NaN,NaN,-12.398849085100217,-11.636490642293198
1999-06-18T09:30:00-04:00,25.09375,25.15625,24.8125,25.04687,33600,38985,45.49037729610774,44.65926629520694,NaN,NaN,-51.66744995864507,-77.10049846057709,0.008424005388993738,-0.23365758034078254,-0.24208158572977628,57400,44860,38.062226193192245,39.24107003093815,NaN,NaN,-11.944415456551695,-11.680479901472983
1999-06-21T09:30:00-04:00,25.01562,25.01562,24.48437,24.76562,35900,36875,41.89603225255465,44.484543572999314,NaN,NaN,-106.07205837083356,-72.38524742539207,-0.00030364428736090465,-0.24246114108897743,-0.24215749680161652,21500,50600,39.47868855582669,38.578307821572494,NaN,NaN,-12.557272946493509,-11.80573605076163
1999-06-22T09:30:00-04:00,24.71875,25,24.71875,24.90625,85400,40140,44.2672991851278,44.80217871661735,NaN,NaN,-68.93571867410955,-66.37034810367881,0.005424333250686475,-0.23537708023825843,-0.2408014134889449,106900,68300,43.75051916446264,38.3128415484356,NaN,NaN,-12.417708177233196,-11.893160640257568
1999-06-23T09:30:00-04:00,24.60937,24.89062,24.51562,24.64062,17400,39335,40.87411924055941,44.61171604051684,NaN,NaN,-107.87495290247558,-72.51875256361575,-0.00602637942816725,-0.24833438777415395,-0.2423080083459867,89500,73260,44.92369625309564,38.11887476638782,NaN,NaN,-13.258437670926185,-12.08820021606737
1999-06-24T09:30:00-04:00,24.54687,24.90625,24.5,24.5625,23000,37105,39.90534032064237,43.54927690211698,NaN,NaN,-103.63181601499583,-87.63639918421194,-0.01566391156823088,-0.2618878978062753,-0.24622398623804442,66500,68360,43.948508404054785,37.7160451890255,NaN,NaN,-14.229839752631745,-12.394148721290852
1999-06-25T09:30:00-04:00,24.9375,25,24.40625,24.54687,149300,43350,39.70258303798003,42.67138977980857,NaN,NaN,-96.33348476388105,-96.56960614525913,-0.019636094878764443,-0.27076910483649996,-0.2511330099577355,-82800,40320,38.76294259884809,36.93936987443785,NaN,NaN,-15.091713314864318,-12.779515091801347
1999-06-28T09:30:00-04:00,24.84375,25.85937,24.51562,24.5625,21200,43585,40.030722861820976,42.12357556155616,NaN,NaN,-18.430673369908476,-79.04132914507412,-0.01780942408298769,-0.27339479006147016,-0.25558536597848247,-61600,23700,36.047940549981746,36.30757294472677,NaN,NaN,-15.734506877025176,-13.201656775404752
1999-06-29T09:30:00-04:00,24.625,25.21875,24.51562,25,46400,44070,48.48201080706956,42.293981367961955,NaN,NaN,-31.259642565725223,-71.50611392339725,0.014519448137323365,-0.23743605580682825,-0.2519555039441516,-15200,-720,32.4513908784953,35.600891543334434,NaN,NaN,-13.984977915704194,-13.31355979544753
1999-06-30T09:30:00-04:00,25.21875,25.625,24.82812,25.59375,51000,43360,57.28087613596468,43.44749201618798,NaN,NaN,65.95206253513355,-36.740710835875426,0.0742101935941965,-0.15919276195140597,-0.23340295554560248,35800,-11460,30.98709199532874,35.21761960196587,NaN,NaN,-9.533190123652897,-12.773506985191153
1999-07-01T09:30:00-04:00,25.67187,25.96875,25.57812,25.78125,38400,43250,59.625929024692134,44.93965911260392,NaN,NaN,138.7823043959583,11.742113246315427,0.12182667762874,-0.08111960850967748,-0.20294628613841748,74200,-9920,31.464634760664893,35.27348187674029,NaN,NaN,-5.089294575278728,-11.675762355203664
1999-07-02T09:30:00-04:00,25.82812,26,25.71875,25.875,48500,44805,60.78507046250464,46.43048436612879,NaN,NaN,152.78982188455296,61.56677457600223,0.1531185401212559,-0.011548110986847604,-0.1646666511081035,122700,31180,42.833766646201546,36.377400144623586,NaN,NaN,-1.0959340701219253,-10.164358314477703
1999-07-06T09:30:00-04:00,25.98437,26.23437,25.70312,25.85937,93000,48035,60.473346436669125,47.82910357025006,NaN,NaN,165.03405988724978,98.25972122743387,0.16520871075848945,0.041844237340008306,-0.12336447341848114,29700,49440,47.03740605585296,37.85503243405774,NaN,NaN,2.068951744444959,-8.416742591774465
1999-07-07T09:30:00-04:00,25.90625,25.92187,25.6875,25.75,17800,45070,58.22328700543465,48.855843525104326,NaN,NaN,128.43228944387536,130.19810762935398,0.15827103434018375,0.07447431950674854,-0.0837967148334352,11900,54860,48.253726902199816,39.368581329998484,NaN,NaN,4.138722804491417,-6.623104678022196
1999-07-08T09:30:00-04:00,25.48437,25.98437,25.48437,25.54687,34800,45890,54.190427398888666,49.373387247572616,NaN,NaN,100.03916812986809,137.0155287483009,0.13342648061819107,0.08298638593930363,-0.05044009467888744,-22900,43120,45.80015202537175,40.27162078454124,NaN,NaN,4.8245115816680215,-4.987730926637879
1999-07-09T09:30:00-04:00,25.90625,25.90625,25.625,25.67187,31900,43925,56.20091787724663,50.13842586051111,NaN,NaN,95.85032243733916,128.42913235657707,0.11929701976565106,0.09868118002817639,-0.020615839737474672,9000,30080,43.17419918211991,40.63676171232179,NaN,NaN,5.96674360295641,-3.422805993838695
1999-07-12T09:30:00-04:00,25.71875,25.75,25.54687,25.625,14300,43620,55.22226291179774,51.09029947902848,NaN,NaN,70.90634822202603,112.05243762407167,0.10138401730386391,0.10611418189235522,0.004730164588491306,-5300,4480,38.506516805385786,40.56732087300458,NaN,NaN,6.661847619466692,-1.9821411919379255
1999-07-13T09:30:00-04:00,25.54687,26,25.46875,25.71875,22600,43135,56.841151819560075,51.98843181005935,NaN,NaN,75.41947900624386,94.12952144787049,0.09078155865239193,0.11820711290398123,0.027425554251589292,17300,2000,38.07704306063202,40.16207257987382,NaN,NaN,7.6881518662757085,-0.6006707550502635
1999-07-14T09:30:00-04:00,25.75,25.89062,25.54687,25.64062,19100,42810,55.05474291203815,53.00133350087928,NaN,NaN,62.80151863504636,81.00336728610469,0.07414111604232707,0.12010194930449813,0.04596083326217106,-1800,-740,37.5783609570519,39.637405773013555,NaN,NaN,8.101771345798879,0.6425352593567568
1999-07-15T09:30:00-04:00,25.82812,26.21875,25.82812,25.92187,28000,41895,59.93600021329158,54.432094921782785,NaN,NaN,97.91077259339718,80.57768817881052,0.0773543109829747,0.14265372199088944,0.06529941100791474,26200,9080,40.58184506186488,39.39692981999999,NaN,NaN,9.832488615353613,1.955385738784879
1999-07-16T09:30:00-04:00,26.20312,26.20312,25.82812,25.875,23700,41765,58.790119834153806,55.79549040722377,NaN,NaN,85.3571977475887,78.47906324086041,0.07172678234944284,0.1549578889447183,0.08323110659527545,2500,7780,40.30536135916191,39.50710258859384,NaN,NaN,10.978468128966052,3.244397508810761
1999-07-19T09:30:00-04:00,26.25,26.25,25.59375,25.65625,33100,41740,53.63609541262933,56.76730273228151,NaN,NaN,60.21638993394098,76.3410715832434,0.04972060390012335,0.14538186147042964,0.09566125757030629,-30600,2720,39.1862750593216,39.73126933926097,NaN,NaN,10.564701447370089,4.2901552143192365
1999-07-20T09:30:00-04:00,25.98437,25.98437,25.32812,25.4375,35900,41740,49.009056501056634,56.804948853280585,NaN,NaN,18.93519357861055,65.04421449771675,0.018488881977509586,0.11877236004219327,0.10028347806468368,-66500,-14040,35.65501602221855,39.96009970666977,NaN,NaN,8.854332002004414,4.9421804697028335
1999-07-21T09:30:00-04:00,25.625,25.71875,25.34375,25.54687,23700,38655,51.272426804430175,56.375773901028126,NaN,NaN,6.738788233957862,53.831668417499046,0.004009698555377611,0.10529560125890569,0.10128590270352808,-42800,-22240,34.03881794574502,40.17808013169951,NaN,NaN,8.035961103568203,5.384149131683601
1999-07-22T09:30:00-04:00,25.54687,25.65625,25.125,25.26562,24900,39030,45.65969173848503,55.3781855234419,NaN,NaN,-36.99013168877042,26.85148756106553,-0.024147890319094742,0.07110103980465965,0.09524893012375439,-67700,-41020,30.61596443223965,40.11746082252627,NaN,NaN,5.609638556523045,5.416361906660664
1999-07-23T09:30:00-04:00,25.21875,25.46875,25.0625,25.07812,37200,39740,42.33264076492139,54.06015483075738,NaN,NaN,-80.87075964865265,-6.394103918182739,-0.053364827489774794,0.028542895761535902,0.0819077232513107,-104900,-62500,27.241753180116007,39.00374557494873,NaN,NaN,2.50846617418377,5.000948230592536
1999-07-26T09:30:00-04:00,25.15625,25.3125,25.01562,25.3125,82300,36390,47.48400263133276,53.132344558947636,NaN,NaN,-96.82850901774489,-37.803083708519914,-0.05466911827650317,0.013571325405681733,0.0682404436821849,-22600,-60900,27.87936193846238,37.63531385227798,NaN,NaN,1.3725055238941954,4.482599272492774
1999-07-27T09:30:00-04:00,25.42187,25.5625,25.09375,25.39062,38000,37230,49.1155636870865,52.48179289335134,NaN,NaN,-72.81044591437042,-56.152211607116115,-0.04825747615848521,0.007918598484078387,0.0561760746425636,15400,-44520,34.23348304836382,36.63386786271826,NaN,NaN,0.9191489951222905,3.9735349471541332
1999-07-28T09:30:00-04:00,25.23437,25.3125,25.03125,25.15625,20600,35940,44.635196270774536,51.79927638420033,NaN,NaN,-137.04538951591618,-84.90904715709091,-0.05717813886952758,-0.015296598944345874,0.041881539925181704,-5200,-37000,36.978671167700355,36.00376208717031,NaN,NaN,-0.8434890765090372,3.2853886580593947
1999-07-29T09:30:00-04:00,25,25,24.54687,24.78125,115300,39155,38.572253838199565,50.54008609569697,NaN,NaN,-213.45645480628096,-120.20231178059302,-0.08408551484955902,-0.06322535363676707,0.02086016121279195,-120500,-47560,34.783010616560034,35.4043914753446,NaN,NaN,-4.41355268282543,2.1855398950758484
1999-07-30T09:30:00-04:00,24.78125,24.9375,24.625,24.64062,48700,39670,36.56631107094288,49.20751810706448,NaN,NaN,-180.0936127668456,-140.0468824042316,-0.1057074913688045,-0.11127420299821367,-0.005566711629409173,-169200,-60420,32.27010589298041,34.95893355302993,NaN,NaN,-7.989696696867559,0.731934667655362
1999-08-02T09:30:00-04:00,24.67187,24.96875,24.64062,24.64062,29600,38725,36.56631107094288,47.75931519644897,NaN,NaN,-147.23486893323437,-150.12815438732952,-0.11366761534554005,-0.14765123081133424,-0.03398361546579419,-169200,-89740,27.408290323698864,34.19687978610613,NaN,NaN,-10.830822656327577,-0.9198878071993435
1999-08-03T09:30:00-04:00,24.89062,24.95312,24.5625,24.82812,56300,36890,41.28765472134956,46.77595175425693,NaN,NaN,-122.61139146279133,-160.08834349701368,-0.10042258851657576,-0.1595118511115139,-0.05908926259493813,-112900,-115400,24.00034276544369,33.2270213438484,NaN,NaN,-11.878711766817759,-2.4854340871448315
1999-08-04T09:30:00-04:00,24.98437,24.98437,24.1875,24.375,57400,38870,34.58780205926618,44.965366171826545,NaN,NaN,-149.4475575227034,-162.56877709837113,-0.11523489856962202,-0.20313288580696565,-0.08789798723734363,-170300,-148420,20.472654400637765,31.790650582332177,NaN,NaN,-15.046420484581072,-4.279860715350009
1999-08-05T09:30:00-04:00,24.375,24.5,23.85937,24.4375,85300,41395,36.127413086308685,43.34660140412332,NaN,NaN,-162.3360540600887,-152.3446969491327,-0.113688210589081,-0.2300082504736949,-0.11632003988461388,-85000,-141320,23.090352469778935,30.561007090233396,NaN,NaN,-17.10147299307173,-6.111519612167397
1999-08-06T09:30:00-04:00,24.28125,24.28125,23.79687,24.03125,18800,40740,31.017059664147695,41.73095599351749,NaN,NaN,-168.63849822135901,-150.05367404003536,-0.13162451099309957,-0.28085067862598834,-0.14922616763288876,-103800,-128240,27.80494940176375,29.748055257550693,NaN,NaN,-20.649907403708525,-8.18843215381613
1999-08-09T09:30:00-04:00,24.125,24.1875,23.89062,23.96875,7400,40395,30.306786689794393,40.39507957842733,NaN,NaN,-144.3584949031526,-149.47839923401904,-0.13859479974006544,-0.32246966730797055,-0.1838748675679051,-111200,-116640,31.797921600752872,29.472548513160287,NaN,NaN,-23.695737352402038,-10.40376146789983
1999-08-10T09:30:00-04:00,24.07812,24.07812,23.625,23.89062,29200,40725,29.40042657285008,38.83279384760018,NaN,NaN,-140.3510048806109,-153.02632191758295,-0.13900799527538923,-0.35763486166214165,-0.2186268663867524,-140400,-122140,30.924584093039,29.250103237967,NaN,NaN,-26.4515248607344,-12.696299095447625
1999-08-11T09:30:00-04:00,23.96875,23.98437,23.5625,23.64062,38200,41680,26.653643588933264,37.47521897977506,NaN,NaN,-136.91700957781947,-150.52021232860614,-0.14594118596560623,-0.4010533488437602,-0.25511216287815397,-178600,-123800,30.650957997690227,29.252602778356326,NaN,NaN,-29.702188486938415,-15.125711865660595
1999-08-12T09:30:00-04:00,23.73437,24.29687,23.73437,24.07812,27300,41645,37.63453535787819,37.139640022129115,NaN,NaN,-93.70253653503936,-136.79350882359626,-0.11239026063475288,-0.39559998867159507,-0.2832097280368422,-151300,-137060,28.48295996187069,29.341260405624517,NaN,NaN,-29.003412097401338,-17.108240470194986
1999-08-13T09:30:00-04:00,24.3125,24.4375,24.10937,24.25,26200,41770,41.34956493380995,36.70146590087749,NaN,NaN,-61.08639205404873,-115.28308759013422,-0.07191855836072314,-0.3731079259877461,-0.301189367627023,-125100,-141320,27.80258126258208,29.335776071633067,NaN,NaN,-27.213648441749523,-18.551870180417062
1999-08-16T09:30:00-04:00,24.1875,24.5,24.17187,24.39062,37700,42000,44.27425870162769,36.355658401916145,NaN,NaN,-42.92244479249785,-94.99587756800327,-0.031061663914765336,-0.34001644752047966,-0.3089547836057143,-87400,-136560,29.819841693296993,29.020515974842578,NaN,NaN,-24.814964431119343,-19.446597930517388
1999-08-17T09:30:00-04:00,24.53125,24.5625,24.23437,24.51562,24700,41440,46.813244449879996,36.51123327185225,NaN,NaN,-25.915729244190693,-72.10882244071922,0.006968839508824098,-0.3002437342196842,-0.3072125737285083,-62700,-121020,36.09735811623413,28.95756504259499,NaN,NaN,-22.05070986050121,-19.818613920515077
1999-08-18T09:30:00-04:00,24.51562,24.60937,24.17187,24.17187,33500,41930,41.24754341531257,36.702325384503176,NaN,NaN,-37.26392655936692,-52.17820583702871,0.011303780654576379,-0.2930828479102878,-0.3043866285648642,-96200,-104540,42.02033567255949,29.474516832309238,NaN,NaN,-21.372709088274643,-20.0406275159093
1999-08-19T09:30:00-04:00,24.01562,24.39062,24.01562,24.32812,15000,41435,44.47880375406516,37.26750343329763,NaN,NaN,-43.40527928834337,-42.1187543876895,0.026174819684286643,-0.2716681039595059,-0.29784292364379256,-81200,-90520,46.55845362519434,30.49511309889595,NaN,NaN,-19.791667525359145,-20.005061802973565
1999-08-20T09:30:00-04:00,24.26562,24.875,24.21875,24.8125,89300,44040,53.09165406356335,38.44788507562766,NaN,NaN,29.382795162993812,-24.024916944280992,0.06775094863017217,-0.21315423785607734,-0.2809051864862495,8100,-63880,53.93630270080511,32.389971125832105,NaN,NaN,-15.41347050985444,-19.34912018967083
1999-08-23T09:30:00-04:00,25,25.375,25,25.35937,56100,42730,60.53521006556583,39.822710457357395,NaN,NaN,139.69322190293428,12.498216394805421,0.1277193688867401,-0.1212559753778244,-0.2489753442645645,64200,-33560,60.60277453112428,35.00443053766644,NaN,NaN,-8.80389773340049,-17.842659838775067
1999-08-24T09:30:00-04:00,25.09375,25.4375,25.09375,25.25,52800,43470,58.534692015169654,41.53320259706478,NaN,NaN,145.26543594137917,46.734449431919394,0.15390127535561604,-0.056598750070044446,-0.2105000254256605,11400,-18740,63.3916021293313,38.070069661144544,NaN,NaN,-4.360351595510665,-15.91661580402301
1999-08-25T09:30:00-04:00,25.45312,26,25.35937,26,61900,45535,66.66914885507131,43.71475515197637,NaN,NaN,216.08563949596177,97.40436264298513,0.21202616435268534,0.05453268001519618,-0.15749348433748916,73300,15160,68.82742062512762,41.337003100812275,NaN,NaN,2.808214661243504,-13.241640023270651
1999-08-26T09:30:00-04:00,25.82812,26.04687,25.57812,25.57812,23800,40960,59.58783814574921,45.75552504351934,NaN,NaN,174.49663555697867,140.98474561204952,0.21185539884028182,0.1073257642128631,-0.10452963462741871,49500,41300,72.24918804706358,44.511591575476544,NaN,NaN,5.964800080599947,-10.497862865574852
1999-08-27T09:30:00-04:00,25.65625,25.82812,25.23437,25.25,66000,41825,54.719720560988954,47.49930603431894,NaN,NaN,114.84429936410261,158.0770464522713,0.18065568111782415,0.12128996676986148,-0.05936571434796267,-16500,36380,70.67666152970745,47.28864442754473,NaN,NaN,6.685595097316978,-8.043083156590306
1999-08-30T09:30:00-04:00,25.375,25.5,25.125,25.28125,35700,42130,55.09598279349715,49.334702907222315,NaN,NaN,87.03544189414856,147.54549045051414,0.1541655610449034,0.13334123695816658,-0.020824324086736817,19200,27380,67.77083340224031,49.920519378201966,NaN,NaN,7.356140233665322,-5.8431941008395025
1999-08-31T09:30:00-04:00,25.04687,25.375,24.89062,25.0625,14100,40020,51.848122867719674,51.13430856999277,NaN,NaN,58.4317014408913,130.17874355041658,0.11571019095319002,0.1238134146047507,0.008103223651560687,5100,26120,67.35332458390769,52.54211699150322,NaN,NaN,6.830872674030937,-4.0326131330008685
1999-09-01T09:30:00-04:00,24.98437,25.17187,24.82812,24.96875,19800,38140,50.47483937434012,52.051473142597196,NaN,NaN,39.7572124905713,94.9130581493385,0.0794846090460644,0.10745898495914119,0.02797437591307679,-14700,8520,61.64092258174882,54.91054289292308,NaN,NaN,5.980643279698597,-2.6021479311866593
1999-09-02T09:30:00-04:00,24.96875,25.01562,24.625,24.9375,30000,35375,49.99944311707108,52.6693215842587,NaN,NaN,21.077629573359896,64.22925695261475,0.05036306252487911,0.09092820406917568,0.040565141544296565,-44700,-10320,56.15095492781724,56.93542672615416,NaN,NaN,5.1587587613207635,-1.4934469751141706
1999-09-03T09:30:00-04:00,25.32812,25.5,25.20312,25.375,136200,41245,56.216740261103105,53.52235598136408,NaN,NaN,72.75271155127754,55.810939390049725,0.05702052965291006,0.11184080361043414,0.05482027395752408,91500,11280,60.49514360180197,59.126519719618805,NaN,NaN,6.342396559385628,-0.3740407558999137
1999-09-07T09:30:00-04:00,25.48437,25.5,25.04687,25.1875,225600,52155,53.16557855430224,53.976094131679965,NaN,NaN,53.48867948084038,49.10158690738808,0.04573859274661382,0.11199351489079135,0.06625492214417752,-134100,-19380,52.53850977299322,60.3008876951016,NaN,NaN,6.393624222248713,0.5927685266927473
1999-09-08T09:30:00-04:00,25.04687,25.34375,24.92187,25.20312,63400,53865,53.39252302207333,54.84359267502002,NaN,NaN,37.486616373681244,44.91256989394608,0.03666239908056157,0.11208292099487949,0.07542052191431792,-70700,-34540,49.09976452387944,60.806561184481595,NaN,NaN,6.500017246941391,1.4366612010139819
1999-09-09T09:30:00-04:00,24.875,25.03125,24.71875,24.84375,80300,55970,47.66932330793401,55.07148692886779,NaN,NaN,-10.282910587176465,34.904545278396526,0.005429964836289519,0.08220797795967982,0.0767780131233903,-151000,-61800,43.57661186546801,60.59357248735829,NaN,NaN,4.867269560404762,1.926748109498379
1999-09-10T09:30:00-04:00,24.9375,25.125,24.75,24.875,32500,56230,48.18940305172714,54.72132614230806,NaN,NaN,-10.179107540144717,28.653197855695602,-0.01313623610024231,0.06035771799808742,0.07349395409832973,-118500,-76560,40.89426328094391,59.661998243082486,NaN,NaN,3.6901686146712604,2.1786653245230765
1999-09-13T09:30:00-04:00,24.875,24.875,24.625,24.84375,22200,56030,47.67910214465513,53.80303271938586,NaN,NaN,-40.65235444534195,5.972184656371698,-0.026748880302259817,0.040057853720504966,0.06680673402276478,-140700,-123000,33.83689479739198,57.750149690673034,NaN,NaN,2.578515486107798,2.2357867761780366
1999-09-14T09:30:00-04:00,24.67187,24.67187,24.32812,24.4375,18400,55065,41.52317608781455,52.587924438860504,NaN,NaN,-99.19435037202096,-24.56442131420057,-0.06041379162919528,-0.008710505513729316,0.051703286115465964,-159100,-128000,33.173107349473085,55.591685777826015,NaN,NaN,-0.2718770427373623,1.877549087761551
1999-09-15T09:30:00-04:00,24.48437,24.84375,24.25,24.25,53700,56515,39.019166997800895,50.61292573476976,NaN,NaN,-105.30658574084673,-53.12306173710617,-0.09078449602098478,-0.06177733391076501,0.02900716211021977,-212800,-156420,29.616682055777645,52.790918737158165,NaN,NaN,-3.445003399696088,1.1171844466961742
1999-09-16T09:30:00-04:00,24.42187,24.42187,24,24.3125,44700,57075,40.31128155422727,49.23602883537534,NaN,NaN,-141.3217969031172,-79.3308390002943,-0.10133704063112627,-0.09766413867868806,0.0036729019524382005,-168100,-159840,29.210838849036747,49.716750937299096,NaN,NaN,-5.705841655676991,0.1424664320714364
1999-09-17T09:30:00-04:00,24.375,24.57812,24.23437,24.29687,28100,57730,40.08254970015964,48.19051663103039,NaN,NaN,-121.3606419114685,-101.56714587455906,-0.10366987126607531,-0.12591443713015593,-0.022244565864080624,-196200,-175380,27.375193939895595,46.62378896659826,NaN,NaN,-7.634583576997968,-0.9685407120813356
1999-09-20T09:30:00-04:00,24.53125,24.5625,24.26562,24.39062,17200,54125,42.200995632491626,47.269446119529995,NaN,NaN,-108.7571444540353,-115.18810387629773,-0.09351179291173893,-0.1391343070037543,-0.04562251409201536,-179000,-183040,26.491476849511272,43.67526349854619,NaN,NaN,-8.728330424391723,-2.0770820995542483
1999-09-21T09:30:00-04:00,24.10937,24.21875,23.73437,23.96875,30400,52840,36.027996429263446,46.13943708821169,NaN,NaN,-159.64576966511538,-127.27838773491662,-0.10874968957092619,-0.1815596260556731,-0.07280993648474691,-209400,-193100,25.334760824061476,40.67393751570002,NaN,NaN,-11.571915511887616,-3.433486872744729
1999-09-22T09:30:00-04:00,23.96875,24.10937,23.59375,23.95312,28000,51600,35.81894586566463,45.09258755187773,NaN,NaN,-150.08977195744993,-136.23502497823728,-0.11293334535487395,-0.21397661817833935,-0.1010432728234654,-237400,-198020,24.7652331795708,38.03995970125873,NaN,NaN,-13.955905553260099,-4.936689541389782
1999-09-23T09:30:00-04:00,23.90625,23.90625,23.25,23.39062,43400,50675,29.24271371047658,43.609964022835264,NaN,NaN,-175.3316752814109,-143.037000653896,-0.14461167083892865,-0.2818078613721262,-0.13719619053319757,-280800,-220560,22.29274081179956,35.6215158358289,NaN,NaN,-18.35360798124284,-6.853392175654505
1999-09-24T09:30:00-04:00,23.32812,23.40625,23,23.26562,41800,51575,28.011935977712,41.59533514545019,NaN,NaN,-183.2762188392048,-155.42011603944326,-0.16361266529291496,-0.34171202214934127,-0.1780993568564263,-322600,-245840,19.893806930426592,32.72142035930208,NaN,NaN,-22.351218619236402,-9.06736738188049
1999-09-27T09:30:00-04:00,23.3125,23.5,23.1875,23.1875,30600,49805,27.2403029708872,39.74352974663483,NaN,NaN,-152.56065983338732,-164.18081911531368,-0.17030701229162615,-0.390983122220959,-0.22067610992933284,-353200,-280680,17.154076061194658,30.193960808459327,NaN,NaN,-25.86071243007129,-11.466416674479175
1999-09-28T09:30:00-04:00,23.26562,23.26562,22.53125,22.84375,117900,53915,24.095017472978313,37.65085077884233,NaN,NaN,-174.250488254939,-167.1017628332784,-0.1855005842624987,-0.4525518402574562,-0.2670512559949575,-471100,-333020,14.028432761746316,27.68886568259267,NaN,NaN,-29.981339762129185,-14.111405687000605
1999-09-29T09:30:00-04:00,22.59375,22.96875,22.25,22.25,95200,57970,19.834882409155043,35.66267642892955,NaN,NaN,-178.47243584259448,-172.7782956103073,-0.2207564562396439,-0.5429968262945124,-0.3222403700548685,-566300,-398800,11.25323310823633,25.380052914218982,NaN,NaN,-35.29020723708948,-17.13694876558473
1999-09-30T09:30:00-04:00,22.70312,23,22.54687,22.75,25000,58230,30.91250651767112,34.428612390782696,NaN,NaN,-128.25683103655325,-163.3633267613358,-0.19643509970399498,-0.5677842446848622,-0.37134914498086724,-541300,-450900,9.628531306677075,23.14678634462849,NaN,NaN,-35.950831946227815,-19.824646362819458
1999-10-01T09:30:00-04:00,22.8125,23.25,22.67187,23.125,67800,60120,37.84921948405082,33.72647791502524,NaN,NaN,-92.72804586240919,-145.25369216597667,-0.14357634888822696,-0.5508195810911509,-0.40724323220292397,-473500,-481080,8.832977318016745,21.36079223895883,NaN,NaN,-34.00189333735525,-21.84996735918171
1999-10-04T09:30:00-04:00,23.375,23.48437,23.23437,23.39062,38300,55225,42.27067211775463,33.77987048859239,NaN,NaN,-54.778426202912165,-125.69724543988164,-0.082254991788337,-0.5100619719383452,-0.42780698015000823,-435200,-497480,8.4255795100418,19.593111678999456,NaN,NaN,-30.879420430200256,-23.139889226470075
1999-10-05T09:30:00-04:00,23.23437,23.53125,23.03125,23.10937,49200,46405,39.098917603439496,33.785566960423715,NaN,NaN,-60.975304921778864,-103.0422087732496,-0.05355649393260464,-0.49475259756576406,-0.4411961036331594,-484400,-500140,8.358243240836615,18.07465176364652,NaN,NaN,-29.409281703638868,-24.035516723208474
1999-10-06T09:30:00-04:00,23.5625,24.01562,23.375,24.01562,36500,45060,51.68021844952993,34.597633881516764,NaN,NaN,0.4880853939035547,-67.25010452595001,0.029095746945591028,-0.40482641995117064,-0.43392216689676166,-447900,-476460,14.880014393819238,17.0510214454167,NaN,NaN,-23.200303978715535,-23.91620061685234
1999-10-07T09:30:00-04:00,23.8125,24.1875,23.73437,23.82812,43400,43215,49.40607014780081,35.26359962777685,NaN,NaN,18.5991049518308,-37.878917328273204,0.07136549675605969,-0.34471529595168704,-0.4160807927077467,-491300,-466460,17.548552562148686,16.349118489863347,NaN,NaN,-19.266820136349313,-23.252003405351907
1999-10-08T09:30:00-04:00,24.125,24.71875,24.01562,24.46875,32600,43220,56.45640029509595,36.28184281796287,NaN,NaN,78.58265068363569,-3.6167780190642276,0.13879509890607633,-0.24258691907515129,-0.3813820179812276,-458700,-463500,18.364379367460344,15.768611526859711,NaN,NaN,-13.27013532417439,-21.826022250897974
1999-10-11T09:30:00-04:00,24.70312,24.70312,24.40625,24.5,49000,44560,56.772843041949834,37.76361757601189,NaN,NaN,97.59870679609244,26.858648580736705,0.17925408782537045,-0.1573144081995146,-0.33656849602488503,-409700,-458400,19.8361542225002,15.375853912462475,NaN,NaN,-8.669147103388202,-19.94646865839658
1999-10-12T09:30:00-04:00,24.4375,24.4375,24,24.03125,98600,48570,50.80824780746933,38.83428200042652,NaN,NaN,55.94609982749756,50.242929530592,0.16837010359043358,-0.12610586653684308,-0.29447597012727666,-508300,-463180,19.481643259203636,14.998454632436248,NaN,NaN,-6.851862595780807,-18.07581064945147
1999-10-13T09:30:00-04:00,24.125,24.14062,23.54687,23.5625,19500,46860,45.6439824773992,40.00580119806385,NaN,NaN,11.479066140951055,52.441125680001505,0.12549214537578174,-0.13761078840754948,-0.2631029337833312,-527800,-479160,18.303903151571802,14.713537656705693,NaN,NaN,-7.1351225018409306,-16.51285519979282
1999-10-14T09:30:00-04:00,23.42187,23.71875,23.26562,23.625,47100,46980,46.425885249783335,41.32108328892609,NaN,NaN,-12.012589601777863,46.31878676927977,0.0984258294383705,-0.14007064698536809,-0.23849647642373858,-480700,-477040,19.00347773097846,14.649942713887969,NaN,NaN,-7.10071810981552,-15.16826418693892
1999-10-15T09:30:00-04:00,23.32812,23.32812,22.75,22.76562,68300,48990,38.27336821427639,42.10915937773961,NaN,NaN,-83.57127954491749,13.888000723569135,0.023632245269309737,-0.2089561698371014,-0.23258841510641115,-549000,-495100,17.619311604861423,14.68317382414988,NaN,NaN,-9.972437890284995,-14.42600328741693
1999-10-18T09:30:00-04:00,22.98437,23.3125,22.85937,23.1875,15900,48925,43.517060410332164,43.49644815897916,NaN,NaN,-53.986303654842395,-16.429001366617833,0.0045580945519090865,-0.2268907969165248,-0.2314488914684339,-533100,-519780,15.913493376438936,14.817821010913638,NaN,NaN,-10.480205687459115,-13.862317915994385
1999-10-19T09:30:00-04:00,23.82812,24.21875,23.65625,24.17187,88300,51820,53.45302790081792,45.89774426552651,NaN,NaN,75.96379475632652,-12.42546238085204,0.057294112657651164,-0.15983125064636994,-0.2171253633040211,-444800,-507080,20.19519223785592,15.45653237731504,NaN,NaN,-7.177539634187949,-12.907349590022037
1999-10-20T09:30:00-04:00,24.20312,24.35937,23.92187,24.26562,186500,59745,54.2779560024824,47.56670494301303,NaN,NaN,94.92916591542931,4.264557574043613,0.09530697155490503,-0.0979916488603898,-0.19329862041529483,-258300,-453180,35.26193155975254,17.287489538248998,NaN,NaN,-4.409571169191059,-11.69338124418904
1999-10-21T09:30:00-04:00,24.125,24.4375,24.0625,24.4375,37800,59465,55.823752220325886,48.850600138461246,NaN,NaN,99.09028720997827,26.485132936394837,0.12686779282588545,-0.03471387938293802,-0.16158167220882347,-220500,-401140,45.88481818826967,19.934049600409924,NaN,NaN,-1.7241146767909932,-10.269200305989319
1999-10-22T09:30:00-04:00,24.78125,24.78125,24.40625,24.59375,57100,60230,57.23906730950851,49.91977122358652,NaN,NaN,118.31232649658727,66.8618541446958,0.151443504058612,0.02772270786444153,-0.12372079619417047,-163400,-324020,57.11532485752499,23.41188855380158,NaN,NaN,0.8707685085925504,-8.67777618962048
1999-10-25T09:30:00-04:00,24.10937,24.64062,24.04687,24.3125,109900,64195,53.89213528915385,50.97642962970898,NaN,NaN,78.45830497537322,93.35077587073891,0.14208738595132772,0.05388843624498918,-0.08819894970633854,-273300,-272060,62.7277733847376,27.29542642122308,NaN,NaN,1.9936156705847183,-7.153291638162595
1999-10-26T09:30:00-04:00,24.25,24.4375,23.78125,24,20100,59305,50.36801023113214,50.882700471251994,NaN,NaN,43.111528192822654,86.78032255803814,0.10963576986572424,0.04884576262581675,-0.06079000723990748,-293400,-241780,65.55672847804499,30.91519171295349,NaN,NaN,1.8536623725121733,-5.866583922351914
1999-10-27T09:30:00-04:00,23.85937,24.29687,23.76562,24.29687,64900,57790,53.48019101688162,51.17370910475777,NaN,NaN,43.712433970448096,76.53697616904189,0.10304819812442806,0.0680202404156276,-0.03502795770880046,-228500,-235820,66.10209521184571,34.38330190221756,NaN,NaN,2.680652770354162,-4.645550109108189
1999-10-28T09:30:00-04:00,24.375,24.92187,24.375,24.73437,125200,62800,57.69070705893845,51.261873873603655,NaN,NaN,115.33357297877633,79.78563332280152,0.121756850079113,0.11716810489009077,-0.004588745189022213,-103300,-212380,68.23250546205298,37.94531090897418,NaN,NaN,4.7002429602536715,-3.310436813485066
1999-10-29T09:30:00-04:00,24.98437,25.28125,24.82812,24.82812,154600,67140,58.55633928397635,51.38926646231984,NaN,NaN,149.63272029926978,86.04971208333802,0.13312511609956676,0.16181764993543624,0.028692533835869477,51300,-169440,71.73680167705767,41.652500012871144,NaN,NaN,6.591900252883484,-1.8958172325752736
1999-11-01T09:30:00-05:00,25.0625,25.1875,24.78125,24.875,116900,71070,59.00798503063735,51.97496197826041,NaN,NaN,132.95014130327448,96.94807934891827,0.1360020741622234,0.19869512653864874,0.06269305237642533,168200,-81140,77.28563616190127,45.781356648778115,NaN,NaN,8.262550282400719,-0.44462187329298897
1999-11-02T09:30:00-05:00,24.64062,25.07812,24.39062,24.39062,276500,82435,52.62642358506547,52.47370777166515,NaN,NaN,76.6278727169584,103.65134825374541,0.09919228168813772,0.18668340448659748,0.08749112279845976,-108300,-44120,79.13514429080959,50.126445301580816,NaN,NaN,7.883403317485524,0.7450960111039415
1999-11-03T09:30:00-05:00,24.65625,25.01562,24.65625,25.01562,92300,85225,58.815532474160946,53.3586825734064,NaN,NaN,108.51740860904324,116.61234318146444,0.11000919359606881,0.22500261479354577,0.11499342119747696,-16000,-1620,81.043466833168,54.557873094594356,NaN,NaN,9.472365935376153,1.9918488574285431
1999-11-04T09:30:00-05:00,25.3125,25.3125,24.79687,24.90625,36700,84890,57.40226660532705,54.72503245848145,NaN,NaN,111.86054883263529,115.91773835223623,0.10299404974918933,0.24373598338396363,0.1407419336347743,-52700,8500,81.47788036569257,59.119199434653716,NaN,NaN,10.33441630173393,3.1836442066150266
1999-11-05T09:30:00-05:00,25.15625,25.23437,24.90625,25.09375,55900,86055,59.21175020462092,55.846081729502075,NaN,NaN,110.16597482924904,108.0243892582321,0.10388066983657102,0.27059277093048806,0.16671210109391704,3200,-1120,79.61024271109748,63.66896724427219,NaN,NaN,11.582980732898331,4.383549424655499
1999-11-08T09:30:00-05:00,24.90625,25.0625,24.8125,25.0625,22300,84720,58.763716334566155,56.22541661762695,NaN,NaN,89.33362526315723,99.30108605020862,0.09547660536571576,0.28605785780106174,0.190581252435346,-19100,-38580,72.62888838233994,67.41423125459247,NaN,NaN,12.47746981727321,5.539823766458029
1999-11-09T09:30:00-05:00,25.17187,25.17187,24.51562,24.625,37900,81685,52.74632975754509,56.11601474298857,NaN,NaN,55.65797010883628,95.10710552858421,0.0555463383283647,0.26001417534580185,0.20446783701743715,-57000,-28320,73.31902752268343,70.13259525194468,NaN,NaN,11.526718478822112,6.3950944396528975
1999-11-10T09:30:00-05:00,24.42187,24.75,24.42187,24.64062,33400,82380,52.931646782170134,55.909435783120294,NaN,NaN,29.401129205010868,79.28384964777774,0.026739727354247622,0.23789249621024666,0.21115276885599904,-23600,-29840,73.02526372938044,72.07119850488117,NaN,NaN,10.801543109447339,7.024587106766389
1999-11-11T09:30:00-05:00,24.64062,24.89062,24.54687,24.64062,26600,81355,52.931646782170134,55.60176288831042,NaN,NaN,36.545251396646584,64.22079016058,0.0053575214911039115,0.21784967071987893,0.21249214922877502,-23600,-24020,73.46367968601147,73.23893813548734,NaN,NaN,10.202108976086397,7.478518802383533
1999-11-12T09:30:00-05:00,24.64062,24.85937,24.4375,24.8125,31500,79515,55.17507917238282,55.69340173711248,NaN,NaN,31.19346753324027,48.42628870137825,0.0007064486624424049,0.21337521005682802,0.21266876139438562,7900,-23080,73.53848516358568,74.01113183397649,NaN,NaN,10.266620222423347,7.876819005246364
1999-11-15T09:30:00-05:00,24.70312,24.875,24.59375,24.70312,119600,84700,53.42980045966897,55.91210103915083,NaN,NaN,26.92774345239397,35.94511233922559,-0.011165023457660794,0.19871248207230963,0.20987750552997042,-111700,-41600,69.38821627606296,74.28480953383492,NaN,NaN,9.867314284825891,8.161175473757725
1999-11-16T09:30:00-05:00,24.8125,25.17187,24.8125,25.17187,41100,82340,59.36231523749784,56.332252769194845,NaN,NaN,102.68138212162799,45.34979474178393,0.009980573543771243,0.22235322245968447,0.21237264891591323,-70600,-44320,68.77431234135217,74.47568218594253,NaN,NaN,11.150262854533013,8.588187956725623
1999-11-17T09:30:00-05:00,25,25.25,25,25.04687,45300,75280,57.267282933259,56.30200818878917,NaN,NaN,107.15838774829524,60.901246450440816,0.012797657049691213,0.22836972022802726,0.21557206317833605,-115900,-62780,64.59720264149679,74.21601769875994,NaN,NaN,11.660977103460365,9.027157834830586
1999-11-18T09:30:00-05:00,24.98437,25.26562,24.85937,25.17187,99900,78385,58.83196017375005,56.32169539520158,NaN,NaN,96.97554269960973,72.98730471103345,0.019904354711851507,0.24045250656815043,0.22054815185629892,-16000,-61260,64.78685185792585,73.7195927116791,NaN,NaN,12.521112042024725,9.526294150144034
1999-11-19T09:30:00-05:00,25.10937,25.1875,24.82812,25,20800,76570,55.80628621404817,56.09300262258807,NaN,NaN,64.21900579500384,79.59241236338616,0.010336238680616922,0.23346845020707008,0.22313221152645316,-36800,-70200,62.66073290986749,72.67495676510525,NaN,NaN,12.445773882506145,9.943362683338622
1999-11-22T09:30:00-05:00,24.95312,25.375,24.9375,25.26562,39600,73055,59.290833765569126,56.56903192119547,NaN,NaN,106.51064748211085,95.50899316932954,0.01871428028893668,0.24652506188762402,0.22781078159868734,2800,-47300,65.76038009018941,71.71961646506095,NaN,NaN,13.345981500560578,10.4294510857989
1999-11-23T09:30:00-05:00,25.3125,25.45312,25.10937,25.20312,33000,73700,58.12942302661425,56.52002410351356,NaN,NaN,121.3622376339605,99.24516427179603,0.016918929563576462,0.2489594435531579,0.23204051398958145,-30200,-39220,66.80738449916777,70.70275344120378,NaN,NaN,13.787839278701147,10.909220827642079
1999-11-24T09:30:00-05:00,25.375,25.5,25.15625,25.5,41400,72525,61.94288763132946,56.844354176799456,NaN,NaN,163.89884074609176,110.59325487135534,0.03173743922649497,0.27171231302270016,0.2399748737962052,11200,-13800,69.92338423382009,69.87743228892718,NaN,NaN,15.25336538305851,11.529812906987283
1999-11-26T09:30:00-05:00,25.64062,25.64062,25.25,25.25,17200,67125,57.21703802423791,56.70187473534353,NaN,NaN,148.2536402363416,120.84887437870171,0.021219443921442954,0.2664991786980089,0.24527973477656592,-6000,-11800,70.16073096227225,69.2024671640111,NaN,NaN,15.191382755433983,12.05289431390824
1999-11-29T09:30:00-05:00,25.0625,25.35937,24.96875,25.23437,34200,61105,56.9246279687711,56.57051128064388,NaN,NaN,70.81376981742955,122.16782718318684,0.010280971310186904,0.25813094891429955,0.24784997760411265,-40200,-12480,69.9585878643598,69.0117314127268,NaN,NaN,15.060299382718126,12.48252360945251
1999-11-30T09:30:00-05:00,25.29687,25.29687,24.90625,24.90625,23500,56435,51.02884999041849,56.44783415442055,NaN,NaN,16.757541902548088,104.21720606727429,-0.02031344970097343,0.22245816547789588,0.2427716151788693,-63700,-25780,65.95595083055863,68.48579736328932,NaN,NaN,13.246294134620614,12.591633684476525
1999-12-01T09:30:00-05:00,24.73437,24.95312,24.59375,24.8125,37500,44485,49.45285249215059,56.19934884799058,NaN,NaN,-77.12125610229421,64.52050732002336,-0.046620783936102084,0.18449563525874169,0.23111641919484377,-101200,-39980,61.88485839686532,67.69005412525253,NaN,NaN,11.276732292839412,12.403790628528366
1999-12-02T09:30:00-05:00,24.71875,24.9375,24.625,24.9375,64600,43100,51.599274129230224,56.10417937278059,NaN,NaN,-57.58350208252225,20.224038754300544,-0.054795609146151086,0.1626219077621549,0.217417516908306,-36600,-49540,59.23402488533102,66.67365021091821,NaN,NaN,10.179458901456435,12.086028953232375
1999-12-03T09:30:00-05:00,24.79687,25.35937,24.79687,25.10937,93100,45920,54.46254160458345,56.053283832223485,NaN,NaN,32.0999423339861,-3.0067008261705537,-0.048060766958195944,0.15734155821056106,0.205402325168757,56500,-37040,61.55300616558949,65.81754456820418,NaN,NaN,10.015443654958581,11.790231053478976
1999-12-06T09:30:00-05:00,24.875,24.92187,24.3125,24.39062,44700,45360,43.00499961784069,55.308655200664326,NaN,NaN,-135.57117472853147,-44.283689735362756,-0.08906163318941784,0.0940752836819847,0.18313691687140254,11800,-26640,63.41758107666007,65.3910706253897,NaN,NaN,6.1349230806107515,10.982329914497802
1999-12-07T09:30:00-05:00,24.46875,24.46875,23.75,24,44600,46475,38.29040057390242,53.80351843897894,NaN,NaN,-218.57223762869586,-91.34964564161154,-0.1366895039990265,0.012275036872619438,0.14896454087164593,-32800,-20460,64.51875549019192,65.08710227887825,NaN,NaN,1.1940708546954524,9.584007191668896
1999-12-08T09:30:00-05:00,23.82812,23.9375,23.5,23.625,34600,46310,34.392336508825665,52.16959369437656,NaN,NaN,-246.91745168973046,-125.3088847590988,-0.18466594626489752,-0.08186789195947597,0.10279805430542155,-67400,-13700,65.73380095968173,65.16828787303432,NaN,NaN,-4.337965028739502,7.595154017324839
1999-12-09T09:30:00-05:00,23.5625,23.79687,23.28125,23.59375,50700,47175,34.08096818839732,50.4016656954228,NaN,NaN,-222.14587797711155,-158.22135993801666,-0.20798764900277514,-0.15718650694804737,0.050801142054727765,-118100,-30000,60.36582663371514,64.85250035701928,NaN,NaN,-8.758697810743625,5.258889470457916
1999-12-10T09:30:00-05:00,23.78125,23.78125,23.46875,23.71875,56700,48680,36.55527163226997,49.02659322529578,NaN,NaN,-167.27435124631825,-198.09621865407752,-0.2041881205562141,-0.20443400864053984,-0.0002458880843257544,-61400,-53580,53.55273514102976,64.20192908781658,NaN,NaN,-11.625864293170936,2.846781789939509
1999-12-13T09:30:00-05:00,23.34375,23.54687,23.03125,23.21875,58800,50045,31.4672837268766,47.039196793960606,NaN,NaN,-176.81172791163596,-206.34432929069845,-0.22300936124468357,-0.27900758964018024,-0.05599822839549666,-120200,-79980,47.138126096489565,62.87176808826659,NaN,NaN,-15.881347999090028,0.1713346772210036
1999-12-14T09:30:00-05:00,22.875,23.375,22.85937,23.1875,81200,48125,31.17522489041791,45.113896927089435,NaN,NaN,-153.9131215528287,-193.412506075525,-0.2245994078933864,-0.33674748826222967,-0.11214808036884326,-201400,-113700,40.47018113877809,60.99053927681018,NaN,NaN,-19.338380120258716,-2.6157674367046706
1999-12-15T09:30:00-05:00,23.34375,23.625,23.07812,23.59375,88600,50500,39.08982501442593,43.48153531159632,NaN,NaN,-106.04076777126933,-165.23716929183277,-0.18687378766631202,-0.3457403149517333,-0.15886652728542128,-112800,-122780,38.87548311002835,58.7728320536822,NaN,NaN,-19.87061643253237,-5.080745864680056
1999-12-16T09:30:00-05:00,23.35937,23.35937,22.90625,23,64100,51440,33.09891418481263,41.7588121802088,NaN,NaN,-118.45189550347034,-144.49837279710454,-0.18987524911836218,-0.396210588683374,-0.20633533956501182,-176900,-134540,36.8501842007477,56.39350728500188,NaN,NaN,-22.385890894640006,-7.55290944038862
1999-12-17T09:30:00-05:00,23,23.21875,22.875,23,1213100,107100,33.09891418481263,40.05697548135463,NaN,NaN,-107.67433964657803,-132.57837047715648,-0.1799218127909114,-0.4312376055536511,-0.2513157927627397,-176900,-157640,33.19222363599067,53.76733841154695,NaN,NaN,-24.32554834613112,-9.949000712637549
1999-12-20T09:30:00-05:00,22.76562,22.95312,22.5,22.70312,905900,151355,30.39737143152739,38.58329844143384,NaN,NaN,-117.2528282827889,-120.66659055138707,-0.1809063829213039,-0.4774487714143696,-0.2965423884930657,-1082800,-350160,17.55330325822227,50.31000644209434,NaN,NaN,-26.826209806428935,-12.360030583179174
1999-12-21T09:30:00-05:00,22.76562,22.76562,22.39062,22.48437,1212300,209990,28.548394106647095,37.090122842469306,NaN,NaN,-117.3900865047225,-113.36198354176581,-0.18329667448756204,-0.5256632316025183,-0.3423665571149562,-2295100,-768900,8.344290093387528,46.48568013470308,NaN,NaN,-29.48415370209933,-14.806333885882054
1999-12-22T09:30:00-05:00,22.70312,23.09375,22.625,22.92187,750600,245870,36.825054065889084,36.03482140937351,NaN,NaN,-83.97031377308974,-108.9478927421299,-0.1441446299041934,-0.522547344495198,-0.3784027145910046,-1544500,-1055240,6.018908485045827,42.68460039182556,NaN,NaN,-29.113533514129365,-16.85021954706024
1999-12-23T09:30:00-05:00,23.125,23.46875,23.125,23.3125,431000,265350,43.15641140991418,35.22724068118284,NaN,NaN,-46.44264335578756,-94.54604231259333,-0.08366966783789842,-0.4829897993883776,-0.3993201315504792,-1113500,-1242560,5.031134510067233,38.64732384500254,NaN,NaN,-26.682072897072402,-18.25477002563341
1999-12-27T09:30:00-05:00,23.53125,23.75,23.17187,23.46875,2693700,399175,45.5088434637314,35.40608667017504,NaN,NaN,-28.050595545281528,-78.62129349233402,-0.027766995576461617,-0.4340288760210562,-0.4062618804445946,1580200,-891140,28.678686172710897,36.16597420900618,NaN,NaN,-23.961893249826076,-19.070073343375217
1999-12-28T09:30:00-05:00,23.42187,23.5625,23.17187,23.28125,75700,401250,43.198532071822456,35.75666749145505,NaN,NaN,-35.25509224991099,-62.22174628575847,0.0004653082228104899,-0.4056802451660815,-0.40614555338889197,1504500,-373680,48.86837152939437,35.04808964037778,NaN,NaN,-22.430075313379632,-19.55007362480442
1999-12-29T09:30:00-05:00,23.25,23.42187,22.9375,23,62800,403215,39.92444969655769,36.151818433435906,NaN,NaN,-54.27431937780653,-49.59859286037528,0.0038904106028236907,-0.40128254013536235,-0.40517295073818604,1441700,373680,64.4993026473492,34.9599111894969,NaN,NaN,-22.141278751667056,-19.920245785784797
1999-12-30T09:30:00-05:00,23.04687,23.25,22.96875,23.01562,63400,404510,40.1955483168751,36.58857415689861,NaN,NaN,-55.29471289065359,-43.86347268388805,0.010523973026965006,-0.3920179844544798,-0.4025419574814448,1505100,983600,72.01744164468128,35.79216940456591,NaN,NaN,-21.830622076057928,-20.193156684395245
1999-12-31T09:30:00-05:00,23.01562,23.1875,22.89062,23.03125,35400,403050,40.484961891601614,36.86926631827943,NaN,NaN,-56.9748362212742,-45.969911256985384,0.01879744565817576,-0.3790451504087251,-0.39784259606690087,1540500,1514400,76.65162176378159,37.44208987761961,NaN,NaN,-21.49642248588077,-20.379337513178893
2000-01-03T09:30:00-05:00,23.125,23.125,22.46875,22.75,634300,430110,37.0138553467347,37.265450005412156,NaN,NaN,-97.18221892641056,-59.796235933211186,0.008676041915071653,-0.3869975436730613,-0.3956735855881329,906200,1379600,73.33028783008005,39.31295857287608,NaN,NaN,-22.18811020811308,-20.637733612455204
2000-01-04T09:30:00-05:00,22.3125,22.65625,22.07812,22.10937,172000,436475,30.581960235395414,37.22307395862483,NaN,NaN,-185.37754289229537,-89.82072606168805,-0.03539889973973953,-0.4399222102628073,-0.4045233105230678,734200,1225540,69.61754730836921,41.39491329927544,NaN,NaN,-24.899836649680797,-21.246605474916002
2000-01-05T09:30:00-05:00,22.26562,22.60937,22.09375,22.5,343600,451425,37.69184447903538,37.123218206096944,NaN,NaN,-150.18421081298908,-109.00270434872455,-0.03255149465476287,-0.4452126788415214,-0.4126611841867585,1077800,1152760,67.86934492930493,43.46590342922376,NaN,NaN,-24.914792586296823,-21.770632205113262
2000-01-06T09:30:00-05:00,22.65625,23,22.48437,22.92187,420800,470735,44.324016939330456,37.925011259991074,NaN,NaN,-55.412917205817934,-109.02634521175742,0.0016245179086001316,-0.41063053680100836,-0.4122550547096085,1498600,1151460,67.83657670586298,45.67921717958914,NaN,NaN,-22.702923674725835,-21.9038167007722
2000-01-07T09:30:00-05:00,23.32812,24.42187,23.26562,24.375,336600,485030,60.08433022049201,39.85254097682531,NaN,NaN,201.7552963731008,-57.28031869288243,0.11945403303535973,-0.26293751341540883,-0.38239154645076856,1835200,1210400,68.57733032416922,48.20672480017331,NaN,NaN,-14.004166178784738,-20.775295197631134
2000-01-10T09:30:00-05:00,24.125,24.29687,23.73437,23.82812,451700,504780,53.90044323406788,41.53133181986392,NaN,NaN,176.42019313682627,-2.5598362802350607,0.15563089932789131,-0.18785292229090444,-0.34348382161879576,1383500,1305860,69.79084779809214,51.937977981592596,NaN,NaN,-9.645935412384016,-19.185386656881548
2000-01-11T09:30:00-05:00,23.9375,24.15625,23.76562,23.82812,142900,508985,53.90044323406788,43.34219247182255,NaN,NaN,146.62065398374708,63.83980309497342,0.17327890578345845,-0.12688518938947269,-0.30016409517293113,1383500,1435720,71.40847670953247,56.44256273988866,NaN,NaN,-6.486303093080617,-17.371231862052845
2000-01-12T09:30:00-05:00,24,24.1875,23.875,23.95312,84300,509140,55.124761772472745,44.64931445086423,NaN,NaN,135.69110866903986,121.01486699137922,0.1859705144967419,-0.06770095205200377,-0.25367146654874567,1467800,1513720,72.36565624805328,61.181616151532054,NaN,NaN,-3.6314698721926746,-15.40840872064425
2000-01-13T09:30:00-05:00,24.09375,24.28125,23.76562,24.07812,233800,516400,56.37255364435817,45.593324610467384,NaN,NaN,125.5954082856578,157.21653208967436,0.19446636960539973,-0.010588504541996002,-0.20505487414739573,1701600,1554320,72.87469041059187,66.02758443014095,NaN,NaN,-0.9701570221578047,-13.345801335146186
2000-01-14T09:30:00-05:00,24.46875,24.48437,23.875,24.15625,76100,517000,57.17411038950231,46.42655796230816,NaN,NaN,123.33119456881049,141.5317117288163,0.19645267878043374,0.04051097432814643,-0.1559417044522873,1777700,1542820,72.46749999824578,69.15535684625058,NaN,NaN,1.404892628747977,-11.238559340304164
2000-01-18T09:30:00-05:00,23.89062,24.04687,23.65625,23.75,218300,467260,51.840693680925206,47.043855220101214,NaN,NaN,68.53903577398857,119.95548025624876,0.16289504967272583,0.04767710763861999,-0.11521794203410585,1559400,1578000,72.96515388557242,70.87655558597758,NaN,NaN,1.8235372510808958,-9.372545541534869
2000-01-19T09:30:00-05:00,23.85937,24.03125,23.70312,23.92187,137800,428855,53.8040598253157,48.03525594358393,NaN,NaN,69.69355403225683,104.57006026595073,0.1453413120568702,0.0664586980369819,-0.0788826140198883,1697200,1640740,73.8721769720392,71.54604660916974,NaN,NaN,2.756319240231872,-7.639850572711049
2000-01-20T09:30:00-05:00,24.04687,24.04687,23.39062,23.59375,425500,389515,49.643066803069864,48.71007869259784,NaN,NaN,37.37098743804176,84.9060360197511,0.10649924353131361,0.054241440394253715,-0.0522578031370599,1271700,1601520,72.240541308607,71.56198229945014,NaN,NaN,2.295325679734221,-6.220539679504582
2000-01-21T09:30:00-05:00,23.73437,23.73437,23.125,23.32812,345000,369235,46.50737838137801,49.140251299010444,NaN,NaN,-4.05619309802265,58.975715743015016,0.06009545952402101,0.022861521267966367,-0.037233938256054644,926700,1446540,66.03383020876791,70.80356861694916,NaN,NaN,0.955718350234809,-5.195359960970383
2000-01-24T09:30:00-05:00,23.51562,23.51562,22.26562,22.65625,278200,361595,39.6802038602843,49.330704764263984,NaN,NaN,-79.07482363254914,18.494512102743073,-0.014677555673779395,-0.05558088284827889,-0.040903327174499494,648500,1220700,58.18823948189043,69.72199373493562,NaN,NaN,-2.4998648586738175,-4.810289232070874
2000-01-25T09:30:00-05:00,22.57812,22.65625,22.32812,22.375,85000,231160,37.21725471141146,49.8046543696937,NaN,NaN,-110.85346191883106,-17.383987435820853,-0.07835022140642824,-0.1388411039325348,-0.06049088252610656,563500,1021520,52.287742429872296,68.4841505293287,NaN,NaN,-6.150829559047159,-5.001794993067485
2000-01-26T09:30:00-05:00,22.51562,22.78125,22.42187,22.57812,385500,246650,40.10854218760168,49.977275634591294,NaN,NaN,-83.11507379911967,-47.945713002096156,-0.10063763896546087,-0.18628793123293264,-0.08565029226747177,949000,871880,48.32317763701541,67.08799572273658,NaN,NaN,-8.256531431449371,-5.466757341407755
2000-01-27T09:30:00-05:00,22.57812,23.03125,22.39062,23,67800,246900,45.701712437779406,50.075682455909075,NaN,NaN,-55.110655599230164,-66.44204160955053,-0.08162711580525156,-0.18768418702403622,-0.10605707121878466,1016800,820900,47.015286693719716,65.60076072186921,NaN,NaN,-8.315524833189055,-5.87372412594794
2000-01-28T09:30:00-05:00,22.54687,23.03125,22.54687,22.8125,37100,245585,43.746329624089796,48.90868241330892,NaN,NaN,-53.43067647432246,-76.31693828481049,-0.07643156978256571,-0.2015965334469918,-0.1251649636644261,979700,831500,47.334464926606444,64.08341319347187,NaN,NaN,-8.962642856722509,-6.314998230344307
2000-01-31T09:30:00-05:00,22.46875,23.23437,22.25,23.23437,195800,253605,49.03044417253599,48.56082533748521,NaN,NaN,-40.24952757343936,-68.55187907298853,-0.04110457008821858,-0.1765456762746993,-0.13544110618648073,1175500,936900,50.52585854739672,62.70734253270791,NaN,NaN,-7.872443922345365,-6.537490472058744
2000-02-01T09:30:00-05:00,23.04687,23.09375,22.64062,23,104000,227090,46.42159211814538,48.02662168634789,NaN,NaN,-40.824994352669094,-54.54618555975613,-0.030529676748684703,-0.1736032021223366,-0.1430735253736519,1071500,1038500,53.45388559861686,61.42487173907108,NaN,NaN,-7.764693907108339,-6.7128052484944005
2000-02-02T09:30:00-05:00,23.10937,23.17187,22.84375,23.04687,72700,222125,47.02861155449911,47.44832524220692,NaN,NaN,-34.99626983817809,-44.92242476756782,-0.018005614446496676,-0.16558054343177275,-0.14757492898527608,1144200,1077540,54.56657282116556,60.15350863715053,NaN,NaN,-7.501078565982841,-6.8254157224213206
2000-02-03T09:30:00-05:00,22.85937,23.03125,22.625,22.73437,87900,209340,43.4906851531928,46.52819177855225,NaN,NaN,-65.84469063263928,-47.069231774249644,-0.027809498249771136,-0.18233680179749,-0.15452730354771887,1056300,1085440,54.802029259675486,58.86260426922792,NaN,NaN,-8.312712235559868,-7.037886652869685
2000-02-04T09:30:00-05:00,23.10937,23.10937,22.60937,22.71875,137500,195175,43.31527955504404,45.53827529037666,NaN,NaN,-64.07224055182,-49.19754458974916,-0.032084598812654574,-0.1946330520635371,-0.16254845325088252,918800,1073260,54.33449270788308,57.56738946277345,NaN,NaN,-9.022122673663025,-7.321348941554448
2000-02-07T09:30:00-05:00,22.625,22.8125,22.53125,22.6875,31600,179925,42.94212869662729,44.90266350578395,NaN,NaN,-73.38215411788025,-55.82406989863735,-0.03359460010974455,-0.2045417033880632,-0.17094710327831866,887200,1015600,52.069762069093294,56.07486147588208,NaN,NaN,-9.711063697288239,-7.662736763802132
2000-02-08T09:30:00-05:00,23,23.15625,22.84375,22.96875,314700,173075,47.33914823581549,44.440884106533936,NaN,NaN,-30.611266169913993,-53.78132426208632,-0.013272745160597732,-0.18753803472906583,-0.1742652895684681,1201900,1041680,53.02352189512041,54.58567182753073,NaN,NaN,-9.120269625954275,-7.870955744109581
2000-02-09T09:30:00-05:00,22.98437,23,22.51562,22.76562,90900,170475,44.66214655711891,44.08510408896601,NaN,NaN,-56.09509119796703,-58.001088534044115,-0.011214159615339891,-0.18828298908764296,-0.17706882947230307,1111000,1035040,52.73579522780321,53.192475678901886,NaN,NaN,-9.341663090949474,-8.081056793658137
2000-02-10T09:30:00-05:00,22.67187,22.67187,22,22,149100,173715,36.32437113799597,43.35774642872444,NaN,NaN,-125.79627646906148,-69.99140570132855,-0.05658179035268737,-0.2477960674131623,-0.19121427706047492,961900,1016160,51.873852048058325,52.18104866742264,NaN,NaN,-12.170695461120207,-8.665290889009862
2000-02-11T09:30:00-05:00,22.23437,22.23437,21.51562,21.57812,166800,170365,32.7016071004914,42.85927523159637,NaN,NaN,-188.25462173456856,-94.82788193787826,-0.10723136338155798,-0.3252534812874224,-0.2180221179058644,795100,991420,50.70435063181553,51.64648517813156,NaN,NaN,-15.79009311282359,-9.683119778126109
2000-02-14T09:30:00-05:00,21.64062,21.85937,21.51562,21.6875,209200,177020,34.52488095938877,42.666962820737616,NaN,NaN,-197.87210300429197,-119.72587171516061,-0.12438824715030966,-0.3735074268437515,-0.24911917969344183,1004300,1014840,51.81190209679511,51.61249658291177,NaN,NaN,-18.154400471427692,-10.89330273431205
2000-02-15T09:30:00-05:00,21.85937,22.1875,21.65625,22.17187,54500,168830,42.01649931371345,42.80324547260274,NaN,NaN,-129.56151330047896,-139.5159211412736,-0.09543867822307484,-0.3684175274722854,-0.27297884924921056,1058800,986220,50.3239216524868,51.75540686973115,NaN,NaN,-17.857288832235838,-11.888157891158306
2000-02-16T09:30:00-05:00,22.125,22.14062,21.6875,21.85937,315500,177715,38.922253622779515,42.31899841438847,NaN,NaN,-128.43717183363205,-153.9843372684066,-0.08974491992993244,-0.38515999916162613,-0.2954150792316937,743300,912680,46.61907672130491,51.727106157415804,NaN,NaN,-18.586892022488932,-12.845119909919823
2000-02-17T09:30:00-05:00,21.875,22.0625,21.53125,21.53125,113700,162125,35.930247342559326,41.76070682285057,NaN,NaN,-136.74525011398867,-156.17413199739204,-0.09971821450331053,-0.4200628473608319,-0.32034463285752135,629600,846220,43.50214275618178,51.45336885952833,NaN,NaN,-20.15206872578027,-13.88896974075703
2000-02-18T09:30:00-05:00,21.59375,21.625,21.0625,21.28125,191300,154440,33.798415927194185,40.672704805326156,NaN,NaN,-166.0896516511375,-151.74113798070582,-0.11377578383134201,-0.46256436264669887,-0.34878857881535685,438300,774860,40.38028907110252,50.72868532550732,NaN,NaN,-22.120351432727073,-15.064881411038465
2000-02-22T09:30:00-05:00,21.46875,21.71875,21.10937,21.625,266600,153860,39.14499885619302,40.152948143758124,NaN,NaN,-120.8771368421058,-136.3421447482686,-0.09150532051926524,-0.4631702294644384,-0.3716649089451732,704900,714980,37.92108651589906,49.61919967674176,NaN,NaN,-22.114405365653017,-16.071956261697686
2000-02-23T09:30:00-05:00,21.625,21.64062,21.10937,21.15625,103200,154770,34.99457964677376,39.29337443606346,NaN,NaN,-123.65299438707345,-135.1604409655875,-0.09927589734309461,-0.49575978062404147,-0.39648388328094686,601700,623560,34.469606869300335,48.18370210875139,NaN,NaN,-23.446637914721606,-17.125482212129675
2000-02-24T09:30:00-05:00,21.17187,21.17187,20.45312,20.71875,166100,143800,31.624355238589814,38.44577944216325,NaN,NaN,-157.5142081317404,-140.97584822520915,-0.12324769780927636,-0.5505435055425423,-0.4272958077332659,435600,562020,32.33601199181322,46.57898658961837,NaN,NaN,-25.688808353208504,-18.34881451799808
2000-02-25T09:30:00-05:00,20.57812,20.79687,20.09375,20.20312,258800,153350,28.179746326283393,37.3646699258232,NaN,NaN,-171.64431703958635,-147.95566161032872,-0.16082263763298965,-0.628324104774503,-0.4675014671415133,176800,471460,29.44741828731304,44.801338416720505,NaN,NaN,-28.772452983226554,-19.837905727316432
2000-02-28T09:30:00-05:00,20.45312,20.73437,20.10937,20.59375,222000,162595,34.041172109419776,36.72888731245123,NaN,NaN,-141.34501398824315,-143.00673407774983,-0.1467520779005611,-0.6509415645172147,-0.5041894866166536,398800,463560,29.202346614355505,43.16795159852495,NaN,NaN,-29.372629246368597,-21.200009087181027
2000-02-29T09:30:00-05:00,20.73437,20.8125,20.5,20.51562,131300,159370,33.453101282946434,35.73702681581773,NaN,NaN,-116.25571241914389,-142.08244919315746,-0.13062941199834144,-0.6674762516145805,-0.536846839616239,267500,376080,26.565801650161944,41.27811443817077,NaN,NaN,-30.02970613774354,-22.461394380118527
2000-03-01T09:30:00-05:00,20.42187,20.625,20.25,20.32812,295500,168945,32.023351487624694,34.83425573942528,NaN,NaN,-121.8277292272551,-141.7173961611938,-0.12074770953102199,-0.6877814765300165,-0.5670337669989945,-28000,250140,23.303802656782395,39.17582925452643,NaN,NaN,-31.004657188876006,-23.68186049565531
2000-03-02T09:30:00-05:00,20.17187,20.46875,20.17187,20.375,1447500,237685,32.79671763453777,34.582280489178274,NaN,NaN,-113.91814158605797,-132.99818285205728,-0.10006294470886268,-0.6921124478850729,-0.5920495031762102,1419500,446920,36.43691889908908,38.07319117245719,NaN,NaN,-31.56842836056521,-24.808513047785297
2000-03-03T09:30:00-05:00,20.4375,20.5,20.1875,20.26562,220900,244335,31.88523167086666,34.52396795849079,NaN,NaN,-103.87699197063566,-119.44471783826717,-0.08343544370122169,-0.6963438078027373,-0.6129083641015156,1198600,651280,46.653379997698195,37.7838361271631,NaN,NaN,-32.29336981593304,-25.87777830037783
2000-03-06T09:30:00-05:00,20.07812,20.3125,19.78125,19.78125,315100,253215,28.15376105610271,34.06888796539893,NaN,NaN,-121.37663768115978,-115.4510425768505,-0.09396341763025651,-0.7303626361393363,-0.6363992185090798,883500,748220,50.70122158236435,37.70450180470376,NaN,NaN,-34.05782394553625,-27.046356249686177
2000-03-07T09:30:00-05:00,19.20312,19.20312,18.34375,18.71875,224100,262840,22.05618495400607,32.643151225419835,NaN,NaN,-190.3082192605828,-130.26154394513827,-0.15764076771789948,-0.8334501781564541,-0.6758094104385546,659400,826600,53.75652264355883,37.94968758978034,NaN,NaN,-37.893672523871416,-28.595972860284068
2000-03-08T09:30:00-05:00,18.9375,19.5,18.60937,19.29687,309900,262600,30.834014028745983,32.065419825846014,NaN,NaN,-143.30590084364908,-134.55717826841706,-0.14623321438419246,-0.8586009284187952,-0.7123677140346028,969300,1026060,60.47042785644058,38.9390698137186,NaN,NaN,-38.055547613055104,-29.9473406821085
2000-03-09T09:30:00-05:00,19.35937,19.96875,19.25,19.8125,1267300,321420,37.58545024963749,32.18364860492302,NaN,NaN,-93.2796288431235,-130.42947571983018,-0.09201657175457556,-0.8273884287278221,-0.7353718569732466,2236600,1189480,64.95924808732886,40.47172019451482,NaN,NaN,-35.80496627172966,-30.784144337768666
2000-03-10T09:30:00-05:00,19.8125,20,19.4375,19.57812,1967700,412350,35.87141721299044,32.33172012533704,NaN,NaN,-86.34772130114371,-126.92362158593178,-0.061464308959377156,-0.812202243172468,-0.7507379342130909,268900,1003540,57.02464842306566,41.66060300536933,NaN,NaN,-34.59452849589323,-31.32848493178646
2000-03-13T09:30:00-05:00,19.15625,19.57812,19.125,19.26562,1061900,457105,33.666884653991985,31.94042625375125,NaN,NaN,-106.51801045270285,-123.9518961402404,-0.052191367394483046,-0.8159771434561947,-0.7637857760617116,-793000,668240,46.091397474783136,42.24419664528962,NaN,NaN,-34.32624754272596,-31.756736733349246
2000-03-14T09:30:00-05:00,19.5,19.5,19,19.15625,552800,474285,32.90470241640577,31.791149308724965,NaN,NaN,-106.19455596583848,-107.12916348129154,-0.04365975831262403,-0.8183604739524917,-0.7747007156398676,-1345800,267200,36.96303047961819,42.42229833174089,NaN,NaN,-34.34876781622895,-32.127026888046345
2000-03-15T09:30:00-05:00,19.17187,20.46875,19.03125,20.375,1582200,550670,47.23883374605858,32.906469202115595,NaN,NaN,-35.88374620852601,-85.64473255426691,0.048816981975151275,-0.7136794881709285,-0.7624964701460798,236400,120620,34.28995146973199,42.561865437306516,NaN,NaN,-29.245725518531078,-31.715412406687022
2000-03-16T09:30:00-05:00,21,21.625,20.75,21.5,580200,563905,56.48112293581975,34.92799610279676,NaN,NaN,97.57436080403238,-47.473934624835735,0.18296695091941106,-0.5337877814968159,-0.716754732416227,816600,-163380,29.79418232447952,42.586634297104126,NaN,NaN,-21.16525520805233,-30.208247092596352
2000-03-17T09:30:00-05:00,21.625,21.64062,20.92187,21.09375,116000,564020,52.878880379235085,36.273546693497856,NaN,NaN,95.56004990726572,-11.092380383153852,0.23806671278423142,-0.4191713414359377,-0.6572380542201691,700600,-77040,32.68376635648649,42.83530713582776,NaN,NaN,-16.202421072761975,-28.207414804048582
2000-03-20T09:30:00-05:00,21.20312,21.20312,20.65625,20.90625,563400,582625,51.2541139338953,37.54504759713706,NaN,NaN,69.05933921465592,24.023089550317906,0.2541484275094035,-0.33955251983341483,-0.5937009473428183,137200,109000,38.55251252968499,43.69150077007941,NaN,NaN,-12.942430546663521,-26.02670276727929
2000-03-21T09:30:00-05:00,20.95312,21.29687,20.76562,21.29687,32600,570925,54.3977539666793,39.14321920278382,NaN,NaN,93.76715972712978,64.01543268891155,0.2812463682639935,-0.24214298701282644,-0.52338935527682,169800,412120,46.70524078078231,45.36303206465084,NaN,NaN,-9.243656231805977,-23.6291246907831
2000-03-22T09:30:00-05:00,21.04687,21.1875,20.79687,21.125,132900,572410,52.78475663184699,40.57093627402019,NaN,NaN,87.77750386449614,88.74768270351599,0.2772907321581191,-0.17677594007917108,-0.4540666722372902,36900,372220,45.84302670777931,46.03489690812871,NaN,NaN,-6.817111051786961,-21.227408456640795
2000-03-23T09:30:00-05:00,21.10937,21.34375,20.84375,20.95312,126400,570425,51.15125735557762,41.947080965785254,NaN,NaN,85.9767098234271,86.42815250739494,0.2534460368195378,-0.13725912621286795,-0.39070516303240577,-89500,191000,42.046413433711884,45.70582786784397,NaN,NaN,-5.350430846726031,-18.959268798081542
2000-03-24T09:30:00-05:00,21,21.15625,20.51562,20.57812,231100,569040,47.68409206185209,43.342104609053074,NaN,NaN,50.93938332927695,77.50401919179718,0.20484494414072135,-0.13464898285650406,-0.3394939269972254,-320600,-13240,38.206031910577664,44.81331431985921,NaN,NaN,-5.164173118979054,-16.988540843924042
2000-03-27T09:30:00-05:00,20.78125,20.78125,20.29687,20.3125,52200,560550,45.339798438719434,45.005219857961166,NaN,NaN,21.17310306121696,67.92677196110938,0.14978826381269578,-0.1522585972313557,-0.3020468610440515,-372800,-115240,36.41709600979826,43.57478384601916,NaN,NaN,-5.711735712534346,-15.377568682296943
2000-03-28T09:30:00-05:00,20.29687,20.65625,20.25,20.54687,71600,557565,47.77933224271137,46.21559973038727,NaN,NaN,24.189153991839504,54.01117081405134,0.12513830435121676,-0.14562398060503057,-0.2707622849562473,-301200,-209440,34.796645974508365,41.74094228302401,NaN,NaN,-5.460599676222495,-13.960858824286307
2000-03-29T09:30:00-05:00,20.6875,21.125,20.5625,21.04687,36200,544600,52.63598232217992,47.290637735568865,NaN,NaN,64.35779731432172,49.32722950401645,0.13750555059131023,-0.09888034671710955,-0.23638589730841977,-265000,-269820,33.75970076106398,39.512403188290804,NaN,NaN,-3.7860781862884316,-12.507318733143753
2000-03-30T09:30:00-05:00,20.96875,21.5,20.96875,21.32812,62200,475335,55.16206304686576,48.6685410094171,NaN,NaN,90.47929784081703,50.22774710749443,0.15815263581446565,-0.0386951025403377,-0.19684773835480335,-202800,-292480,33.357938526532934,37.82192390996703,NaN,NaN,-1.628020582423918,-10.95313328304092
2000-03-31T09:30:00-05:00,21,21.5,20.9375,21.21875,439800,486280,53.956926496876996,50.11782971248032,NaN,NaN,77.6761169526746,55.575093832173955,0.15761809169151086,0.00017487625958523267,-0.15744321543192563,-642600,-356880,32.185626722946665,36.82865457055014,NaN,NaN,-0.1946930325247858,-9.416213247252902
2000-04-03T09:30:00-04:00,21.625,22.1875,21.35937,22.1875,76600,474355,61.897432610762834,52.18873901207725,NaN,NaN,127.38609153371681,76.81769152667394,0.2122791905382572,0.10790577274089586,-0.10437341779736134,-566000,-395520,31.470982046792997,36.436365396776914,NaN,NaN,3.6921667238241427,-7.543587537099039
2000-04-04T09:30:00-04:00,22.0625,23,21.92187,22.8125,823600,504330,65.97444541937139,53.52699698874245,NaN,NaN,173.99014076133943,106.77788888057391,0.2762492748041605,0.24093817570783926,-0.03531109909632123,257600,-283760,35.90393879137915,36.551650205466,NaN,NaN,8.395027709538285,-5.266642501865135
2000-04-05T09:30:00-04:00,22.75,22.75,22.34375,22.5,38600,490765,62.38034430447432,53.94836994364635,NaN,NaN,159.91107360571263,125.8885441388521,0.2822419454571834,0.31749133272515806,0.035249387267974636,219000,-186960,39.55130652239202,37.24858764817403,NaN,NaN,11.106769234990548,-2.9275836823143235
2000-04-06T09:30:00-04:00,22.25,22.4375,21.82812,22.09375,55100,430155,57.959859493696804,54.31129702325075,NaN,NaN,113.38694178930864,130.47007292855042,0.24495515830047607,0.3414433351435697,0.09648817684309366,163900,-113620,42.233407894220825,37.93070490086934,NaN,NaN,11.979248759859574,-0.7980361905751954
2000-04-07T09:30:00-04:00,22.28125,22.3125,21.75,21.8125,169700,340255,55.051327969335844,54.582526597210794,NaN,NaN,90.7887513376806,133.09259980555163,0.18991518606941485,0.3338821594298622,0.14396697336044736,-5800,13740,46.65951630809205,38.50977659932699,NaN,NaN,11.796419566556857,1.0011717747293836
2000-04-10T09:30:00-04:00,22.03125,22.45312,21.875,22.35937,55200,289920,59.32543701996875,54.93450395816004,NaN,NaN,109.30176824883296,129.47573514857487,0.17904897629943106,0.3677781937347362,0.18872921743530513,49400,136820,50.59883915434143,38.78789076886693,NaN,NaN,12.975785994841123,2.711830949031061
2000-04-11T09:30:00-04:00,22.5625,22.875,22.34375,22.75,60900,265325,62.09785495600139,55.59972526702821,NaN,NaN,134.68943036144321,121.6155930685956,0.18606068909402085,0.4213050788028312,0.23524438970881034,110300,107360,49.65359230700014,39.06007402595413,NaN,NaN,14.829653043515107,4.44294839110021
2000-04-12T09:30:00-04:00,22.85937,23.46875,22.67187,23.01562,76500,190040,63.89973571517933,56.510330864142624,NaN,NaN,149.95077915342156,119.62353417813738,0.19550845572767378,0.4796299593684026,0.2841215036407288,186800,100920,49.436178368728974,39.58791437845535,NaN,NaN,16.910786514099502,6.224068122957252
2000-04-13T09:30:00-04:00,22.5,23,22.45312,22.85937,506700,186365,62.03155508719428,57.53514965166706,NaN,NaN,105.84902247592103,118.11595031545987,0.17861946502215542,0.5073958349184231,0.3287763698962677,-319900,4160,46.16542200869605,40.15644224260666,NaN,NaN,18.067563798946885,7.915996076670057
2000-04-14T09:30:00-04:00,22.1875,22.5625,21.54687,21.73437,62900,183710,50.56814121519008,57.908602707129255,NaN,NaN,27.445226997800134,105.44724544748378,0.08387798212959308,0.433623847558259,0.3497458654286659,-382800,-71240,43.73706195872302,40.67929695324414,NaN,NaN,15.368441481605402,8.980631134517964
2000-04-17T09:30:00-04:00,22.32812,22.35937,21.71875,22.35937,139500,162515,55.489407421916404,58.45932236278676,NaN,NaN,40.97806176891939,91.78250415150106,0.05679630726657203,0.42074124951188097,0.36394494224530893,-243300,-129780,41.894511231637274,41.18628732875335,NaN,NaN,14.710805818148136,9.799227517893703
2000-04-18T09:30:00-04:00,22,22.5,22,22.5,129000,167335,56.53789506226181,58.73803041564975,NaN,NaN,53.692281012183344,75.58307428164909,0.04250134333849653,0.4170716214184296,0.37457027807993304,-114300,-174700,40.48510298422678,41.66667320183642,NaN,NaN,14.52070864555843,10.473724821845806
2000-04-19T09:30:00-04:00,22.60937,23,22.25,22.76562,39500,162665,58.525144137398264,58.978250493544934,NaN,NaN,80.0427451310169,61.60146747716815,0.044849908377071035,0.43063266355127183,0.3857827551742008,-74800,-227020,38.84588260403936,42.05866920737259,NaN,NaN,14.973661312923136,11.116572891999711
2000-04-20T09:30:00-04:00,22.70312,22.92187,22.59375,22.75,14300,157060,58.35616494459922,59.292481811239384,NaN,NaN,83.08520530872505,57.04870404372896,0.03945689748758563,0.4351038770336828,0.3956469795460972,-89100,-180860,41.11134310262621,42.6962203773497,NaN,NaN,15.28722898215146,11.712380904878533
2000-04-24T09:30:00-04:00,22.75,23.46875,22.75,23.375,75300,149270,62.96401473309625,59.368666248548905,NaN,NaN,120.02106398882852,75.56387144193464,0.07028726887218373,0.4835060656363268,0.4132187967641431,-13800,-107060,44.642236244972395,43.637024248648224,NaN,NaN,16.96016505861064,12.462064355411691
2000-04-25T09:30:00-04:00,23.375,23.4375,23,23.26562,51400,149230,61.67778382643711,59.0617618490536,NaN,NaN,118.53770190957326,91.0757994700654,0.07517896063206575,0.5071924975542252,0.4320135369221595,-65200,-71440,46.31534932093092,44.3806964293305,NaN,NaN,17.952875754214134,13.24646598381204
2000-04-26T09:30:00-04:00,23.3125,23.3125,22.79687,23,39100,147605,58.54983430278034,58.78815399178975,NaN,NaN,90.55132471735689,98.44760821110012,0.05341414010042067,0.49878121204768533,0.44536707194726466,-104300,-69440,46.41328133438737,44.870837487330164,NaN,NaN,17.895748478683274,13.910649197365073
2000-04-27T09:30:00-04:00,22.70312,23,22.67187,23,27900,147190,58.54983430278034,58.83029504958143,NaN,NaN,66.04939456548995,95.64893809799472,0.03291198817722896,0.4865070571688008,0.45359506899157187,-104300,-75340,46.14584901422968,45.1502975673308,NaN,NaN,17.849071664366868,14.47328097836533
2000-04-28T09:30:00-04:00,22.9375,22.9375,22.28125,22.34375,56400,146900,51.121185859793066,58.549570613185516,NaN,NaN,5.415408217709233,80.11497867979156,-0.027679345800936783,0.4189958867404009,0.4466752325413377,-160700,-89660,45.46116860148587,45.06470130257321,NaN,NaN,15.625475579419682,14.63788020708738
2000-05-01T09:30:00-04:00,22.5,22.8125,22.15625,22.625,21200,125970,53.825129998676545,58.156691540236075,NaN,NaN,-4.5141356081735555,55.207938760391144,-0.0503293579279781,0.3837635351313651,0.4340928930593432,-139500,-114800,44.22069433530738,44.60911952978507,NaN,NaN,14.509402221854293,14.619526209196938
2000-05-02T09:30:00-04:00,22.59375,22.78125,22.39062,22.6875,19000,123090,54.428443557348146,57.60887644033227,NaN,NaN,6.84054641560784,32.86850766159806,-0.061856536674031015,0.3567722222168044,0.4186287588908354,-120500,-125860,43.65631798720652,44.18074279265695,NaN,NaN,13.756720617513063,14.496268267527812
2000-05-03T09:30:00-04:00,22.9375,22.96875,22.5,22.6875,309800,97400,54.428443557348146,56.93235557191576,NaN,NaN,26.835632706853673,20.125369259497425,-0.06965548561357682,0.33155940187386435,0.40121488748744116,-120500,-129100,43.48124474184003,43.75539039073631,NaN,NaN,13.135139979778664,14.301821369277933
2000-05-04T09:30:00-04:00,22.75,22.9375,22.51562,22.6875,30600,97000,54.428443557348146,56.38927617692674,NaN,NaN,23.639016103358465,11.643293567071133,-0.07455005960608208,0.30802731297983854,0.3825773725859206,-120500,-132340,43.29426792492824,43.55030795618148,NaN,NaN,12.614467719041201,14.060770847815542
2000-05-05T09:30:00-04:00,22.625,23.21875,22.625,23.21875,11600,94825,59.97969359807196,57.06152991856117,NaN,NaN,84.73295684844119,27.506803293217523,-0.04329459742338876,0.3284591258066847,0.37175372323007344,-108900,-121980,44.1216925941902,43.57778157300056,NaN,NaN,13.637939772350824,14.000366408463439
2000-05-08T09:30:00-04:00,23.32812,23.70312,23.20312,23.70312,277200,100200,64.25506999933309,57.68764867409094,NaN,NaN,183.54000733973467,65.11763188279916,0.00608744918187204,0.3793630347074135,0.37327558552554146,168300,-60420,48.89368365500519,44.07772246038399,NaN,NaN,15.80384527372147,14.258006246357443
2000-05-09T09:30:00-04:00,23.76562,23.8125,23.46875,23.8125,975200,146200,65.16020813642916,58.3035281793886,NaN,NaN,183.88998568009734,100.52751973569707,0.040297338966856666,0.4236472592341123,0.3833499202672556,1143500,192380,62.90396867136912,45.679070009465576,NaN,NaN,17.86657866975918,14.77351659255769
2000-05-10T09:30:00-04:00,23.65625,23.71875,23.3125,23.65625,87000,147505,62.71704324499534,58.60294954421697,NaN,NaN,132.40714306548642,121.64182180742361,0.046160544012017746,0.4410506002822778,0.3948900562702601,1056500,427780,70.90296070588158,47.96886130245431,NaN,NaN,18.953151018142876,15.370607224784147
2000-05-11T09:30:00-04:00,23.51562,23.70312,23.375,23.625,28800,145120,62.21461113612013,58.87855284361132,NaN,NaN,119.19929760466913,140.75387810768575,0.041821236091931,0.44716660138517383,0.40534536529324283,1027700,657420,76.27702369813011,50.48069563070459,NaN,NaN,19.72764549763274,15.993041263762517
2000-05-12T09:30:00-04:00,23.57812,23.57812,23.15625,23.3125,26400,121105,57.27344139543221,58.472083319492455,NaN,NaN,72.93921358171515,138.39512945434052,0.013270627386944844,0.4219336495269239,0.40866302213997907,1001300,879460,80.10349980974036,53.013643028188014,NaN,NaN,19.075719761638055,16.433423906316165
2000-05-15T09:30:00-04:00,23.29687,23.98437,23.29687,23.89062,188200,127370,63.11048553025332,58.57441915547933,NaN,NaN,121.69534901202796,126.02619778879921,0.02784855579189155,0.4434737168798435,0.41562516108795194,1189500,1083700,82.84460020008648,55.622875233841974,NaN,NaN,20.176815895235613,16.968194190447516
2000-05-16T09:30:00-04:00,23.96875,23.96875,23.5,23.78125,1201000,180445,61.40149785745065,58.77810940938435,NaN,NaN,113.76819554069421,112.00183976091857,0.024756938433020736,0.4465713341292279,0.42181439569620716,-11500,852700,70.94045812941792,57.37481643348701,NaN,NaN,20.602530637558214,17.48738511146333
2000-05-17T09:30:00-04:00,23.625,23.9375,23.625,23.85937,19000,174945,62.18909332132165,59.03805648213729,NaN,NaN,111.05289874249307,107.7309908963199,0.022661207514652393,0.45014090508952265,0.42747969757487025,7500,642900,62.19879523163601,58.52145544901604,NaN,NaN,21.174613615283487,18.014132040580495
2000-05-18T09:30:00-04:00,23.71875,23.98437,23.71875,23.8125,12100,173575,61.37985578280338,59.770818619495174,NaN,NaN,104.99576847020425,104.89028506942694,0.013271321325050045,0.44406884923118284,0.4307975279061328,-4600,436440,55.01438019594348,59.203827705763004,NaN,NaN,21.43777721418731,18.503224208238613
2000-05-19T09:30:00-04:00,23.625,23.98437,23.53125,23.98437,17800,173750,63.26742537180106,60.44526828900407,NaN,NaN,93.82541024968381,109.06752440302066,0.013731061030481162,0.4479613541942342,0.43423029316375306,13200,238820,49.16096302095761,59.55670404045231,NaN,NaN,22.169100061578856,19.02692075871579
2000-05-22T09:30:00-04:00,23.84375,24.1875,23.5625,23.90625,41400,172055,61.78917393208894,60.9710347443427,NaN,NaN,91.14754969478984,102.95796453957303,0.004355181469541336,0.4396742700006797,0.4353190885311384,-28200,-4720,43.07802824407597,59.5153976302287,NaN,NaN,22.407005435018657,19.509789998187628
2000-05-23T09:30:00-04:00,23.6875,23.875,23.625,23.78125,17700,170370,59.39767571249411,61.32597989828169,NaN,NaN,65.60062708385371,93.32445084820493,-0.013695673019762933,0.4181994972564347,0.4318951702761976,-45900,-11600,42.91647353313585,59.47505682960697,NaN,NaN,21.991197113968884,19.864276729013522
2000-05-24T09:30:00-04:00,24.03125,24.375,23.90625,24.29687,24700,169650,65.35443143332753,62.106407603708746,NaN,NaN,117.24246378295108,94.56236385629653,0.004676508892010989,0.4377408063912114,0.4330642974992004,-21200,-17340,42.77234994733757,59.43777697406478,NaN,NaN,23.287872263650222,20.353361805390193
2000-05-25T09:30:00-04:00,24.07812,24.34375,23.96875,24.23437,85400,172525,64.12634113027883,62.40259671315209,NaN,NaN,107.24511962788797,95.01223408783328,0.008009917738109995,0.44307669467183786,0.43506677693372786,-106600,-37740,42.22956154328794,59.30262475614319,NaN,NaN,24.028579500500516,20.87839290469167
2000-05-26T09:30:00-04:00,24.26562,24.45312,24.0625,24.3125,35500,171480,65.01146392173341,62.45662485046639,NaN,NaN,118.19198150551016,99.88554833899855,0.010698994016095142,0.4484405194538468,0.43774152543775163,-71100,-54600,41.75791318955015,58.79292686575354,NaN,NaN,24.893627008408636,21.451997776651236
2000-05-30T09:30:00-04:00,24.35937,24.35937,23.84375,24.17187,161300,178485,62.044084593895455,62.23404459742827,NaN,NaN,91.26408301982184,99.90885500400495,-0.0011418880070981907,0.4363141654288789,0.4374560534359771,-232400,-95440,40.57574015783024,57.19805340050077,NaN,NaN,24.845210158959944,21.936742402695337
2000-05-31T09:30:00-04:00,23.9375,24.28125,23.9375,23.9375,84900,181780,57.34625849851349,61.85041711553671,NaN,NaN,75.48197294210011,101.88512417565423,-0.027448813012134532,0.40314503717080896,0.4305938501829435,-317300,-149720,38.995596341864065,54.91895594592809,NaN,NaN,23.501486451724173,22.160277266842314
2000-06-01T09:30:00-04:00,24.17187,24.4375,23.40625,24,89000,170740,58.254024369385895,61.56751806076998,NaN,NaN,49.99401184381611,88.43543378782724,-0.04243560977073946,0.37754933796951917,0.41998494774025863,-228300,-191140,37.786335795325506,52.169621095727756,NaN,NaN,22.60733870331533,22.22414318633846
2000-06-02T09:30:00-04:00,24,24.01562,23.125,23.17187,1366300,237525,44.68420810027763,60.66828711111607,NaN,NaN,-95.71003011308048,47.84440383963354,-0.10628274338863086,0.28713151850447005,0.3934142618931009,-1594600,-488740,30.47420137765765,48.62467120772185,NaN,NaN,17.280905613264576,21.517966390185048
2000-06-05T09:30:00-04:00,23.15625,23.42187,23.01562,23.14062,30800,238485,44.265176837998226,59.322193633097854,NaN,NaN,-173.3644468342937,-10.466881828327226,-0.14631035750727078,0.21052631500901242,0.3568366725162832,-1625400,-799600,25.026368041123618,44.494797482081644,NaN,NaN,12.911010501624274,20.288401263247795
2000-06-06T09:30:00-04:00,23.25,23.40625,23.03125,23.21875,32000,226225,45.637770857478706,58.19621313309985,NaN,NaN,-150.62207022511916,-58.844112477315434,-0.16199619762128575,0.154341425489676,0.31633762311096175,-1593400,-1071800,21.416097292961652,40.95734313662048,NaN,NaN,9.714745337395838,18.777878988126087
2000-06-07T09:30:00-04:00,23.57812,23.76562,23.35937,23.46875,38200,179375,49.89027153885278,57.31772586292351,NaN,NaN,-60.887870878201404,-86.11808124137573,-0.15026524372614813,0.1285060684532766,0.27877131217942475,-1555200,-1319380,18.76458828675031,37.85489978341435,NaN,NaN,8.18544270557973,17.26467380490518
2000-06-08T09:30:00-04:00,23.46875,23.53125,23.07812,23.46875,40100,177030,49.89027153885278,56.49704127406989,NaN,NaN,-99.26810399981572,-115.97050441010211,-0.1375768615537356,0.10680023523725524,0.24437709679099084,-1555200,-1584760,16.418125547119615,35.09802445135551,NaN,NaN,6.943989979656798,15.790290401298268
2000-06-09T09:30:00-04:00,23.35937,23.82812,23.35937,23.73437,85500,179865,54.29575712265406,55.85620782770225,NaN,NaN,-29.451829484754214,-102.71886428443683,-0.10768871448596223,0.10976620368353807,0.2174549181695003,-1469700,-1559780,17.464350617162964,32.83398070822732,NaN,NaN,7.11423992987389,14.550854619666215
2000-06-12T09:30:00-04:00,23.57812,23.9375,23.5,23.70312,12700,179180,53.69762007115234,55.278239694778215,NaN,NaN,-16.594389760575282,-71.36485286969315,-0.08728697954775755,0.10834619373480336,0.1956331732825609,-1482400,-1531180,18.718823504680614,31.094037512556223,NaN,NaN,7.090030459366684,13.485022596766282
2000-06-13T09:30:00-04:00,23.60937,24.21875,23.60937,23.96875,150000,177270,57.93916867739199,55.17406062084234,NaN,NaN,40.382559396926226,-33.163926945284075,-0.05475550389083583,0.12718879341901612,0.18194429730985195,-1332400,-1478980,21.07666332468237,29.534051069095263,NaN,NaN,8.291184239351155,12.74304568856412
2000-06-14T09:30:00-04:00,24.25,24.5,24.20312,24.28125,139100,124175,62.31307448357362,54.956820838717064,NaN,NaN,129.4858943225615,4.9108260948685025,-0.01321076268080007,0.16543084395885188,0.17864160663965195,-1193300,-1406600,24.353435775081152,28.218414342505525,NaN,NaN,10.688344621825067,12.449516964744255
2000-06-15T09:30:00-04:00,24.60937,24.73437,24.375,24.73437,144900,130470,67.5778648079462,55.203358244264734,NaN,NaN,168.91912276887868,58.54827144860737,0.0408096246647483,0.2296536374705873,0.188844012805839,-1048400,-1305240,28.810892161508903,27.259937958092735,NaN,NaN,14.588053688047209,12.755022210930392
2000-06-16T09:30:00-04:00,24.70312,24.70312,24.21875,24.21875,24400,131085,57.69991626541976,54.68110484024233,NaN,NaN,103.05948008656958,85.05053336287213,0.03790193030922534,0.2362214256923707,0.19831949538314536,-1072800,-1225860,32.18125619857268,26.575891030165774,NaN,NaN,14.727595176868135,13.036818348921498
2000-06-19T09:30:00-04:00,24.26562,24.5,24.09375,24.26562,51500,132770,58.296653425876485,54.41343118538383,NaN,NaN,75.52102149488842,103.47361561396488,0.03527565492138679,0.24241406403487886,0.20713840911349207,-1021300,-1133640,35.97371005626134,26.24717459433943,NaN,NaN,15.027943868012091,13.321264851648726
2000-06-20T09:30:00-04:00,24.25,24.25,23.84375,23.84375,86100,135005,51.28386157863254,53.98040283396376,NaN,NaN,14.016665812031254,98.20043689698588,0.0029691490950582433,0.2108498454823149,0.20788069638725665,-1107400,-1088640,37.801484755188106,26.161880909576862,NaN,NaN,12.953673596418588,13.268751815187278
2000-06-21T09:30:00-04:00,24,24.3125,23.96875,24.3125,96300,138935,57.4138915871874,53.92039334952101,NaN,NaN,52.45645378164252,82.79454878880208,0.010583730708788097,0.22111035977324178,0.21052662906445369,-1011100,-1052200,39.312314195879054,26.270879366759257,NaN,NaN,13.268547948903153,13.268722691432403
2000-06-22T09:30:00-04:00,24.0625,24.0625,23.71875,23.78125,48000,140100,49.77022561886206,54.28368031513418,NaN,NaN,-11.601025668969045,46.69051910123254,-0.021020878701546092,0.18425053068752106,0.20527140938906716,-1059100,-1054340,39.25201417578544,26.897865995196955,NaN,NaN,10.791652288418836,12.914855491001894
2000-06-23T09:30:00-04:00,23.84375,24.09375,23.82812,24.0625,87200,140190,53.31387553065204,54.93001593603803,NaN,NaN,18.648022204533564,29.808227524825337,-0.023650788707843762,0.17570792350426245,0.19935871221210621,-971900,-1034160,40.183765437033315,27.98053723776194,NaN,NaN,10.041585540844581,12.504388355265135
2000-06-26T09:30:00-04:00,23.9375,24.59375,23.9375,24.375,39900,140410,56.94819515733496,55.73790338602776,NaN,NaN,80.64025840054275,30.832074905956198,-0.005933847306815121,0.1919414030785873,0.19787525038540243,-932000,-1016300,41.04561055997237,29.3826453282627,NaN,NaN,10.684383243273427,12.244387624980606
2000-06-27T09:30:00-04:00,24.39062,24.75,24.39062,24.75,74100,136050,60.8833586739332,56.523123895676356,NaN,NaN,133.8305900947936,54.794859762508665,0.027609483455116296,0.2323871047042978,0.2047776212491815,-857900,-966400,43.4952322905857,31.14911989996523,NaN,NaN,12.57916608091697,12.292213118685801
2000-06-28T09:30:00-04:00,24.73437,24.75,24.3125,24.75,104300,137020,60.8833586739332,57.308344405324966,NaN,NaN,115.16008731523007,67.33558646922617,0.045319540104839295,0.2614270463802306,0.21610750627539133,-857900,-935760,45.00624850806254,33.191128682889726,NaN,NaN,14.035886832714544,12.54130936354705
2000-06-29T09:30:00-04:00,24.6875,25.03125,24.625,24.96875,42600,134700,63.16139555244953,57.941604293167494,NaN,NaN,138.7749327394949,97.41077815091896,0.06603403840948169,0.29865005428724345,0.23261601587776176,-815300,-887000,47.41613270785184,35.3305416893675,NaN,NaN,15.960504871869304,13.029765864735944
2000-06-30T09:30:00-04:00,24.78125,25.23437,24.59375,25.23437,111900,71980,65.76829967125916,58.803795693175125,NaN,NaN,141.7548555020385,122.03214481041996,0.09038640327978958,0.34559901997749876,0.25521261669770917,-703400,-833300,50.014054147349235,37.56591530670097,NaN,NaN,18.401624841458013,13.797174289981955
2000-07-03T09:30:00-04:00,25.07812,25.28125,24.90625,25.28125,59500,73415,66.22261710210088,59.395470580654326,NaN,NaN,147.6008878546657,135.42427070124455,0.10157683654955102,0.38218366238464796,0.28060682583509694,-643900,-775680,52.71361579145406,39.82569762575609,NaN,NaN,20.501568464526567,14.754944886345472
2000-07-05T09:30:00-04:00,25.45312,25.60937,25.20312,25.34375,72900,75460,66.85420880484446,59.71983731788796,NaN,NaN,165.93701886466906,141.84555645521965,0.10469632282922131,0.41147722937162357,0.30678090654240225,-571000,-718300,55.30243190203396,42.03634020625272,NaN,NaN,22.409150451017396,15.848402824155746
2000-07-06T09:30:00-04:00,25.46875,25.65625,25.21875,25.375,123700,79735,67.1846108037864,59.691747746162264,NaN,NaN,148.61038905117152,148.53561680240793,0.10036064117831922,0.4322317080153013,0.3318710668369821,-447300,-636180,58.78052078741422,44.177027965245955,NaN,NaN,24.077404428773473,17.02397448195828
2000-07-07T09:30:00-04:00,25.3125,25.3125,25.04687,25.20312,22300,78845,63.438935157427466,60.101677667019956,NaN,NaN,102.91107534611095,141.36284532373116,0.0783874640422565,0.4298553968898027,0.3514679328475462,-469600,-567040,61.497058912770235,46.27101387340292,NaN,NaN,24.510358148920062,18.09345786295282
2000-07-10T09:30:00-04:00,25.29687,25.4375,25.09375,25.4375,47900,76965,66.2057674639785,60.66661438402725,NaN,NaN,110.159864274256,135.04384707817468,0.07225921990145007,0.44179195772435875,0.3695327378229087,-421700,-510700,63.60210552324759,48.24447069247337,NaN,NaN,25.662192230876414,19.17470562979905
2000-07-11T09:30:00-04:00,25.1875,25.46875,25.1875,25.45312,19700,77315,66.38832481397837,61.74550461512337,NaN,NaN,105.51149161609436,126.62596783046038,0.06225807996356658,0.4473553377773669,0.38509725781380033,-402000,-462320,65.35379525442393,50.21249287099022,NaN,NaN,26.66575040088196,20.244854882810895
2000-07-12T09:30:00-04:00,25.42187,25.42187,24.9375,24.9375,219900,80810,55.693066580990504,61.622588543252164,NaN,NaN,58.66234089882982,105.17103223729255,0.016309365767929962,0.40548396502371276,0.3891745992557828,-621900,-472500,64.64876500201447,52.022239357142745,NaN,NaN,24.453561817266667,20.846098730590292
2000-07-13T09:30:00-04:00,25,25,24.375,24.5625,53400,76525,49.45313804030264,61.59993943049792,NaN,NaN,-10.682322228901413,73.31248998127796,-0.04082501648502823,0.3381433286494975,0.3789683451345257,-675300,-518100,61.45085233996093,53.607870654583856,NaN,NaN,20.529560005761663,20.800878912757632
2000-07-14T09:30:00-04:00,24.40625,24.40625,23.96875,24.28125,39900,71275,45.349258352926654,61.03103820351753,NaN,NaN,-69.73110910187691,38.784053091680406,-0.09589932559259884,0.25909418814377716,0.354993513736376,-715200,-567220,58.11597334390561,54.88874264793187,NaN,NaN,15.870022841486458,20.096470902576037
2000-07-17T09:30:00-04:00,24.28125,24.71875,24.14062,24.40625,55600,72835,47.437029221581106,60.35166920810654,NaN,NaN,-40.545320200479644,8.643016196733273,-0.12065083458609643,0.20417997050375547,0.3248308050898519,-659600,-614800,55.002227163896926,55.88564383392649,NaN,NaN,12.670804008755082,19.0356613463159
2000-07-18T09:30:00-04:00,24.64062,24.64062,24.29687,24.4375,114900,76005,47.97214454866563,59.42943962773029,NaN,NaN,-37.09134500690728,-19.877551127867058,-0.13080700324271305,0.16132205103646058,0.29212905427917363,-544700,-643340,53.16227937409402,56.576147197034224,NaN,NaN,10.229705493386275,17.77766765304024
2000-07-19T09:30:00-04:00,24.59375,24.59375,24.28125,24.46875,37200,73560,48.536369889931606,58.54751185744446,NaN,NaN,-44.22691339421065,-40.45540198647516,-0.1309845565717278,0.12839835856451387,0.2593829151362417,-507500,-620460,54.477027531984525,57.25263141302865,NaN,NaN,8.371386992779563,16.433913273003
2000-07-20T09:30:00-04:00,24.3125,24.45312,24.0625,24.0625,11500,69320,42.138648784807785,57.0458870883272,NaN,NaN,-84.08715441629388,-55.13636842395365,-0.15252008711275006,0.06873280624530409,0.22125289335805415,-519000,-589200,56.28261540167258,57.88595160544441,NaN,NaN,4.741727871348676,14.763601072766669
2000-07-21T09:30:00-04:00,24.07812,24.3125,24.03125,24.125,49100,69375,43.375266629438336,55.44638472819713,NaN,NaN,-95.18987810877364,-60.228122225333,-0.1560513018560458,0.026188766037996913,0.1822400678940427,-469900,-540140,59.029156933409254,58.52988751873442,NaN,NaN,2.1011261430929613,12.954676082813283
2000-07-24T09:30:00-04:00,24.375,24.71875,24.375,24.625,210100,75520,52.180256324767385,54.4433589583876,NaN,NaN,-34.718792543997964,-59.06281669403667,-0.11983674774389225,0.032444133214177384,0.15228088095806963,-259800,-460180,63.098345044429884,59.271653893946976,NaN,NaN,2.3723706352113796,11.442918161727297
2000-07-25T09:30:00-04:00,24.03125,24.375,24.03125,24.1875,94600,78255,45.51161090285257,52.918887679673894,NaN,NaN,-97.31735111185515,-71.10801791502627,-0.12016467012538734,0.0020750433013354552,0.1222397134267228,-354400,-422120,64.8860397790747,59.95619731373559,NaN,NaN,0.42958320168063924,9.869584596006346
2000-07-26T09:30:00-04:00,24.125,24.4375,24.03125,24.20312,36500,76375,45.77804771212737,51.389847458841096,NaN,NaN,-85.42677279103641,-79.34798979439142,-0.11418857917549322,-0.020496010542643717,0.0936925686328495,-317900,-384200,66.62105903375084,60.5162357599025,NaN,NaN,-1.0147814823339496,8.314675156243446
2000-07-27T09:30:00-04:00,24.23437,24.59375,24.17187,24.375,29600,72640,48.7478745972839,50.34048599025942,NaN,NaN,-56.769399473542606,-73.88443880584116,-0.09434212434306873,-0.024235086795986405,0.07010703754708232,-288300,-338060,68.65081877058245,61.02721860688909,NaN,NaN,-1.323623645158797,6.937775327471697
2000-07-28T09:30:00-04:00,24.57812,24.6875,24.375,24.57812,106300,75825,52.08763721075188,49.33204811502894,NaN,NaN,-27.72261446519815,-60.39098607712606,-0.06463368949721394,-0.010685074324435107,0.05394861517277884,-182000,-280480,71.01924836287151,61.55701452400508,NaN,NaN,-0.5723767437520011,5.864896460154026
2000-07-31T09:30:00-04:00,24.5,24.57812,24.21875,24.3125,52000,72830,47.70938934747696,47.99783843885027,NaN,NaN,-51.606478833139306,-63.76852333495433,-0.060067900368199124,-0.021136260287470066,0.03893164008072906,-234000,-275320,71.22902234400485,61.976673601832296,NaN,NaN,-1.2562509344667934,4.847589689493909
2000-08-01T09:30:00-04:00,24.42187,25.125,24.42187,25.125,691600,104435,59.04857745982029,48.23751778733811,NaN,NaN,36.39399790609787,-37.02625353136373,-0.0025603740807351102,0.03573117247981017,0.03829154656054528,457600,-112920,76.8970338566591,62.85154994859262,NaN,NaN,2.1002825221403656,4.455117237014831
2000-08-02T09:30:00-04:00,24.90625,25.28125,24.90625,25.10937,44500,103015,58.78449392651217,48.90404320778165,NaN,NaN,77.68689207766951,-4.403520557622537,0.03227188152420558,0.07863139846580225,0.04635951694159667,413100,33280,80.60196308518722,64.2194864303945,NaN,NaN,4.582079584101257,4.473254715170035
2000-08-03T09:30:00-04:00,25.1875,25.34375,25.0625,25.10937,66700,100165,58.78449392651217,49.86370289160919,NaN,NaN,96.89165534639639,26.32869040636526,0.05198966830149577,0.11134660231846638,0.05935693401697061,413100,173560,83.35944705308444,66.02259169533585,NaN,NaN,6.528992678598813,4.766931567088432
2000-08-04T09:30:00-04:00,25.15625,25.15625,24.76562,25.0625,60300,102065,57.884173586117164,50.60992748907604,NaN,NaN,68.12279780528543,45.49777286046198,0.05809073099494598,0.13197034776065308,0.0738796167657071,352800,280520,85.09879663407791,68.17234665749163,NaN,NaN,7.853554127017991,5.2078776470783685
2000-08-07T09:30:00-04:00,25.03125,25.0625,24.75,24.75,25900,100965,52.14931589524904,50.90829687097486,NaN,NaN,49.6964339645375,65.75835541999734,0.038252980478143864,0.12169584236338693,0.08344286188524307,326900,392700,86.67225262570302,70.5659161754637,NaN,NaN,7.315787615298374,5.50900764253837
2000-08-08T09:30:00-04:00,24.625,25,24.625,24.85937,28300,101395,53.87182663846761,51.289400924441715,NaN,NaN,55.55545249595324,69.59064633796842,0.030032783576355998,0.12098384135568807,0.09095105777933207,355200,372220,84.9095104500533,72.73966495532576,NaN,NaN,7.370657622764676,5.7749576397135565
2000-08-09T09:30:00-04:00,24.5625,25.04687,23.8125,23.84375,101500,95475,39.61190273435947,51.1089190636954,NaN,NaN,-76.87861043007959,38.677545836418595,-0.042337523891143355,0.038029152915402875,0.08036667680654623,253700,340340,82.11002671396152,74.5844800490607,NaN,NaN,2.3324743206987795,5.283174308425731
2000-08-10T09:30:00-04:00,23.875,24.3125,23.875,24.26562,28700,94240,46.00539253224116,51.296785199609886,NaN,NaN,-88.18056176982175,1.6631024131749683,-0.059288357421153876,0.006256230030103893,0.06554458745125777,282400,314200,79.78714814097782,76.06719370674416,NaN,NaN,0.4425582383699622,4.591657726989193
2000-08-11T09:30:00-04:00,24.26562,24.65625,24.26562,24.4375,253300,104910,48.402284656041054,51.02693008041515,NaN,NaN,-19.547402580885336,-15.870937664059188,-0.05643339525561923,-0.004997156618266274,0.05143623863735296,535700,350780,80.6136597291497,77.31828761279557,NaN,NaN,-0.21995860211251528,3.9042839656889488
2000-08-14T09:30:00-04:00,24.51562,24.60937,24.40625,24.51562,15600,102910,49.499558057501716,51.31178344860437,NaN,NaN,-6.581138223665431,-27.126452101699766,-0.04716912692091361,-0.007525170013789051,0.03964395690712456,551300,395660,81.607368350475,78.51266822503847,NaN,NaN,-0.3856103735422309,3.2914419172273517
2000-08-15T09:30:00-04:00,24.46875,24.75,24.46875,24.46875,30700,98700,48.82862944052575,51.52968214348997,NaN,NaN,5.188635775908791,-37.199815445708666,-0.042242339721832806,-0.01315896774516645,0.029083371976666356,520600,428740,82.32645978382229,79.63448256432926,NaN,NaN,-0.720842389389137,2.718258444853568
2000-08-16T09:30:00-04:00,24.46875,24.78125,24.46875,24.71875,17800,97730,52.524954233044426,51.79947354604429,NaN,NaN,26.05062268465957,-16.613968822760825,-0.021250643299170258,0.0025200678527035336,0.02377071115187379,538400,485680,83.5207614226343,80.69662132519012,NaN,NaN,0.12063558546834795,2.3471694649413934
2000-08-17T09:30:00-04:00,24.8125,24.82812,24.5,24.57812,120100,103160,50.32288359281437,51.67341971619161,NaN,NaN,16.029073320148747,4.227958195233275,-0.01617085192024321,0.003557146251569776,0.019727998171812988,418300,512860,84.07400172877874,81.6291037084692,NaN,NaN,0.1683954223409692,2.03591603028419
2000-08-18T09:30:00-04:00,24.46875,24.46875,24.25,24.28125,18200,101615,45.9439633060372,51.547317856088775,NaN,NaN,-67.65294359978236,-5.3931500085461295,-0.03126464056825831,-0.019352802538509906,0.011911838029748408,400100,485740,81.14666772070137,82.33750694966182,NaN,NaN,-1.1131062179472326,1.5860557091082725
2000-08-21T09:30:00-04:00,24.4375,24.71875,24.4375,24.53125,19200,92070,49.897782859174924,50.893689670328385,NaN,NaN,-5.487189503739582,-5.17436026456096,-0.023240372755729877,-0.01713862791491394,0.006101744840815939,419300,459340,78.28900951955009,82.43693378272545,NaN,NaN,-1.0077876331956046,1.2155066602077187
2000-08-22T09:30:00-04:00,24.54687,24.6875,24.4375,24.4375,8700,87775,48.466164538251135,50.156666142595455,NaN,NaN,-22.27134434171431,-10.666356288085586,-0.02303115282988424,-0.02268719619653936,0.0003439566333448786,410600,437340,75.89055890374536,82.10040491262247,NaN,NaN,-1.339753528309783,0.8504694904195043
2000-08-23T09:30:00-04:00,24.3125,24.625,24.3125,24.59375,138200,92860,50.990017111363414,49.59991779865626,NaN,NaN,-30.834933334528046,-22.04346749192311,-0.01172431256056889,-0.014311434067366235,-0.0025871215067973445,548800,439420,75.9655293130233,81.57226793118954,NaN,NaN,-0.8897539518933113,0.6018661415176735
2000-08-24T09:30:00-04:00,24.40625,24.59375,24.375,24.4375,11300,91945,48.43543758487273,48.925008084281664,NaN,NaN,-45.374911140628775,-34.32426438407862,-0.01397071997029849,-0.020050521469670457,-0.006079801499371967,537500,463260,76.85392746861042,80.98334870508471,NaN,NaN,-1.2361347918428234,0.3392945796090311
2000-08-25T09:30:00-04:00,24.5,24.53125,24.3125,24.53125,13300,87295,50.0523455548133,48.77522448853625,NaN,NaN,-46.447825341012965,-30.083240732324736,-0.008608022015567554,-0.01683982901883141,-0.008231807003263855,550800,493400,77.9629690951308,80.36125702432956,NaN,NaN,-1.0753338550343021,0.13720480323141204
2000-08-28T09:30:00-04:00,24.51562,24.71875,24.39062,24.45312,20300,85710,48.68229608242077,48.40454373453291,NaN,NaN,-30.81437442987809,-35.14867771755244,-0.009706566353064805,-0.02036501494459486,-0.010658448591530057,530500,515640,78.77126588390028,79.92281098389005,NaN,NaN,-1.3116352239673923,-0.06977234351127426
2000-08-29T09:30:00-04:00,24.125,24.3125,24.0625,24.07812,30000,52630,42.648219143389504,48.621423478035055,NaN,NaN,-134.04333700279204,-57.50307624976798,-0.03372073130423517,-0.052809362721824016,-0.019088631417588847,500500,533620,79.42821148879085,79.73125275352072,NaN,NaN,-3.286195918192187,-0.5292614256085475
2000-08-30T09:30:00-04:00,23.96875,24.15625,23.875,23.96875,20500,51430,41.0501124553268,48.2674749011126,NaN,NaN,-173.32270926953166,-86.00063143676871,-0.05381035869091273,-0.08635157978122976,-0.03254122109031703,480000,519860,77.45280758014893,79.56451414203295,NaN,NaN,-5.402155010798135,-1.2253890806356313
2000-08-31T09:30:00-04:00,23.95312,24.15625,23.95312,24.01562,39000,50045,42.05223987764505,47.81390027408431,NaN,NaN,-146.51508034045227,-106.22866527673341,-0.06029351401190214,-0.1079081136051947,-0.04761459959329256,519000,516160,76.89898620567769,79.2991803189278,NaN,NaN,-6.887467811982656,-2.0342574708280634
2000-09-01T09:30:00-04:00,24.0625,24.1875,23.875,23.875,750400,84550,39.862744728308094,47.125556464856196,NaN,NaN,-143.1395780476788,-125.56701581806655,-0.06973629120306772,-0.13478496359712722,-0.0650486723940595,-231400,359720,58.01139338610917,77.61375353575882,NaN,NaN,-8.775502500624576,-2.9972924750847083
2000-09-05T09:30:00-04:00,23.9375,23.9375,23.4375,23.79687,905400,128525,38.65839105036684,46.39911086555913,NaN,NaN,-185.33583320613542,-156.47130757331803,-0.07639218713543133,-0.16053890631334866,-0.08414671917791733,-1136800,26260,37.09607191835671,74.3830115453684,NaN,NaN,-10.706029685332991,-4.09854064797732
2000-09-06T09:30:00-04:00,23.78125,23.78125,23.25,23.5,65100,130365,34.404945387889256,45.104824519476615,NaN,NaN,-202.09462823012865,-170.08156581878535,-0.09473776935895901,-0.2025689308766161,-0.10783116151765708,-1201900,-314220,26.56463477095396,70.3147167845341,NaN,NaN,-13.69006706772827,-5.468758707941741
2000-09-07T09:30:00-04:00,23.375,23.75,23.375,23.71875,41100,127345,39.67216344403979,44.34405879456415,NaN,NaN,-146.52632099646178,-164.72228816417137,-0.08632692439062592,-0.21573981700593947,-0.12941289261531355,-1160800,-642380,20.51843310991258,65.77503331175794,NaN,NaN,-14.785344387326829,-6.799699519282468
2000-09-08T09:30:00-04:00,23.57812,23.875,23.57812,23.70312,2931200,272470,39.428541439980805,43.878671518417256,NaN,NaN,-108.8384774549196,-157.18696758706486,-0.07634740713082519,-0.22484715152884505,-0.14849974439801986,-4092000,-1564580,12.149599888009874,60.846671323708556,NaN,NaN,-15.750641315494187,-8.078405490169857
2000-09-11T09:30:00-04:00,23.75,23.875,23.65625,23.8125,1523600,335985,42.10779810233679,43.322244035785964,NaN,NaN,-84.75160618671418,-145.5093732148719,-0.05775596191590465,-0.22069469679290066,-0.162938734876996,-2568400,-2031980,9.93732750860461,55.96440832292673,NaN,NaN,-15.842910079532558,-9.187620431507385
2000-09-12T09:30:00-04:00,23.82812,24,23.71875,24,1444100,407410,46.478234040549914,43.18024900023587,NaN,NaN,-54.211142397804444,-119.28443505320573,-0.029624247961086203,-0.19996904482835376,-0.17034479686726756,-1124300,-2029480,10.031690601014148,51.260203444160204,NaN,NaN,-14.69324751856626,-9.97413858680151
2000-09-13T09:30:00-04:00,24.01562,24.1875,23.9375,24,50100,408380,46.478234040549914,42.85797878089205,NaN,NaN,-23.56938553121625,-83.57938651342324,-0.008885881629121961,-0.18145214890367,-0.17256626727454805,-1124300,-2013960,10.657513946097197,46.59534520366549,NaN,NaN,-13.744609476662738,-10.512777285353115
2000-09-14T09:30:00-04:00,23.84375,24,23.625,23.75,55900,410285,41.61963498837627,42.371135738285155,NaN,NaN,-68.34755187282764,-67.94363268869643,-0.009802825018618233,-0.18481979854782082,-0.1750169735292026,-1180200,-2017840,10.637592070493028,41.865606960942806,NaN,NaN,-14.230429715856676,-11.043870489710766
2000-09-15T09:30:00-04:00,23.75,23.875,23.5,23.625,194400,414000,39.40178567994737,41.610381461509014,NaN,NaN,-88.38805720941045,-63.8535486395946,-0.016245278722474277,-0.19532357193229544,-0.17907829320982116,-1374600,-1474360,30.29318250273117,38.46062220434284,NaN,NaN,-15.269374758377467,-11.647513956663152
2000-09-18T09:30:00-04:00,23.46875,23.75,23.46875,23.65625,88400,417510,40.25888623176494,41.00870932931931,NaN,NaN,-89.66583838836952,-64.83639507992567,-0.01580475492784092,-0.19883423686962232,-0.1830294819417814,-1286200,-1217920,37.300941181952176,35.49845615420369,NaN,NaN,-15.904469524321721,-12.255650466328662
2000-09-19T09:30:00-04:00,23.46875,23.78125,23.46875,23.6875,29800,418040,41.15520946263542,40.90206578069402,NaN,NaN,-78.8242241694024,-69.75901143424525,-0.011037184934379662,-0.19682596310975597,-0.1857887781753763,-1256400,-1244340,36.889471309251306,32.459974712808005,NaN,NaN,-16.205185275769626,-12.819869724820228
2000-09-20T09:30:00-04:00,23.48437,23.5625,23.25,23.5,30900,419150,37.518010397637134,40.649772776573336,NaN,NaN,-116.99158231921,-88.443450791844,-0.017742388092454237,-0.2079667632909441,-0.19022437519848986,-1287300,-1276940,36.356541170468326,29.524527112116527,NaN,NaN,-17.465960421547766,-13.483596967209875
2000-09-21T09:30:00-04:00,23.5,24.1875,23.5,24.125,35000,413990,52.56644585974281,41.40078748958032,NaN,NaN,9.742703794710254,-72.82539965833641,0.020605284975238253,-0.16446776897944204,-0.1850730539546803,-1252300,-1291360,36.10805382572006,26.610889084976698,NaN,NaN,-13.805708025136488,-13.529612832627963
2000-09-22T09:30:00-04:00,24.5625,24.9375,24.40625,24.9375,54800,416165,64.52722970942251,43.16253641680284,NaN,NaN,212.52656029592566,-12.642476157269197,0.09709982800658457,-0.06369826894644959,-0.16079809695303415,-1197500,-1255940,37.24268330294023,25.12740979332178,NaN,NaN,-5.479774586358007,-12.379635940303684
2000-09-25T09:30:00-04:00,24.59375,24.8125,24.54687,24.71875,60300,418515,60.13098679423602,44.69629325565064,NaN,NaN,183.61290208562502,42.013271937529716,0.12746084379525965,-0.0014720422089595786,-0.12893288600421923,-1257800,-1250260,37.434562059812315,25.151587660568605,NaN,NaN,-0.64996455188995,-10.703968599101723
2000-09-26T09:30:00-04:00,24.46875,24.6875,24.32812,24.5,41100,419555,56.02070220474952,46.240275885426364,NaN,NaN,139.24910894955508,85.6279385613212,0.12702417480064204,0.029847332496583334,-0.09717684230405871,-1298900,-1258760,37.25101143281099,25.914900279272683,NaN,NaN,1.6843836665057261,-8.93420398972923
2000-09-27T09:30:00-04:00,24.40625,24.70312,24.32812,24.51562,23300,419220,56.250667681156415,47.42445475950613,NaN,NaN,127.78288913065317,134.58283285129386,0.12197443662464598,0.05529120347674876,-0.06668323314789722,-1275600,-1256420,37.342095119299444,27.11659042280032,NaN,NaN,3.5337964015588432,-7.153061076688077
2000-09-28T09:30:00-04:00,24.70312,25.09375,24.64062,24.89062,51500,420770,61.46083398120396,48.99818994102207,NaN,NaN,168.24825982996555,166.28394405834493,0.1369548192840785,0.10451029095720088,-0.0324445283268776,-1224100,-1250780,37.57728814095978,28.9328538694396,NaN,NaN,6.9166733715610995,-5.143099012652481
2000-09-29T09:30:00-04:00,25.15625,25.25,24.95312,24.98437,71100,422375,62.65812832354098,50.466070671108085,NaN,NaN,163.2991837044322,156.43846874004623,0.14544353153733905,0.14935988609479622,0.003916354557457168,-1153000,-1241880,37.97295098506942,30.9353984034728,NaN,NaN,9.980853154038055,-2.9825344174109762
2000-10-02T09:30:00-04:00,24.82812,25.03125,24.70312,24.9375,22000,385955,61.62731452890086,51.54814784884744,NaN,NaN,114.1056104626405,142.53701041544932,0.1401128631066998,0.17905743344083191,0.038944570334132116,-1175000,-1225320,38.750875629393896,32.98676876264278,NaN,NaN,12.102655841568984,-0.8275072375566963
2000-10-03T09:30:00-04:00,24.9375,25.15625,24.6875,24.9375,15600,341465,61.62731452890086,52.63022502658679,NaN,NaN,102.86489086538373,135.26016679861505,0.12907170538313056,0.2002842020630453,0.07121249667991475,-1175000,-1200540,39.96424229448794,35.08010650181355,NaN,NaN,13.800794029101468,1.2622500862516128
2000-10-04T09:30:00-04:00,24.98437,24.98437,24.57812,24.73437,6500,338535,56.92057100430067,53.723149027724254,NaN,NaN,72.56732096325094,124.21705316513462,0.10177265675745936,0.19842831762673896,0.0966556608692796,-1181500,-1181720,40.92149081340605,37.24324212630734,NaN,NaN,13.900056166881836,3.0676509549130735
2000-10-05T09:30:00-04:00,24.9375,25.34375,24.84375,25.3125,542600,363610,65.0921580672927,55.558175626820336,NaN,NaN,110.7187251169599,112.71114622253349,0.11534076588348074,0.24083161822363053,0.12549085234014978,-638900,-1064680,46.62155803649844,38.40955466443357,NaN,NaN,16.67931158496403,5.01217390206321
2000-10-06T09:30:00-04:00,25.35937,25.40625,24.8125,25.17187,20000,218050,62.01080815152322,57.1118843353745,NaN,NaN,96.03217939854643,99.25774536135631,0.107679886077156,0.2600907099365948,0.15241082385943877,-658900,-965860,50.9267314994634,39.382825401398655,NaN,NaN,17.948706362263366,6.860249967806089
2000-10-09T09:30:00-04:00,25.09375,25.25,24.90625,25.0625,105100,147125,59.64598597363976,58.432654086160525,NaN,NaN,81.79827771708567,92.79627881224535,0.08886419918951724,0.26349107284633533,0.1746268736568181,-764000,-883660,54.23336026640195,40.6216746126237,NaN,NaN,18.250619105586168,8.487445558917528
2000-10-10T09:30:00-04:00,25.10937,25.59375,25.0625,25.42187,45600,77200,64.44410487353039,60.355946548724326,NaN,NaN,108.74021357229243,93.97134335362708,0.09375459697849198,0.29182011987993306,0.19806552290144108,-718400,-792340,57.6476235491368,42.14246621110002,NaN,NaN,20.054683616276495,10.139908138540237
2000-10-11T09:30:00-04:00,25.5625,25.75,25.34375,25.39062,84400,78915,63.73444320709532,61.15366064496379,NaN,NaN,114.55928294287695,102.36973574955229,0.08810500511492014,0.30819677929509126,0.22009177418017112,-802800,-716600,60.29340923139615,43.86999159721974,NaN,NaN,21.272156372867176,11.730229314872657
2000-10-12T09:30:00-04:00,25.3125,25.67187,25.125,25.54687,24800,77360,65.7644617234539,61.24203436025174,NaN,NaN,102.24605804149034,100.67520233445838,0.08791031570900251,0.32997966881642427,0.24206935310742175,-778000,-744420,58.83941810829171,45.4126155118877,NaN,NaN,22.902872416565216,13.326321186543023
2000-10-13T09:30:00-04:00,25.5,25.5,25,25.23437,47700,70025,58.68867646499309,61.13901219387725,NaN,NaN,72.77062900510529,96.02289225577015,0.061029964118429536,0.31835680825545865,0.2573268441370291,-825700,-777780,57.06238534221366,46.814602889202085,NaN,NaN,22.13737886717686,14.585043712347856
2000-10-16T09:30:00-04:00,25.26562,25.59375,25.25,25.59375,16600,66435,63.54619835609263,61.676547633258906,NaN,NaN,102.00894192827029,100.06502509800707,0.061571381238247014,0.3342910706848379,0.27271968944659086,-809100,-786800,56.564946576845514,48.19416968520455,NaN,NaN,23.024041158295486,15.79061477605466
2000-10-17T09:30:00-04:00,25.54687,25.92187,25.54687,25.8125,20600,65975,66.1548770667369,62.38399116080037,NaN,NaN,140.54682325910073,106.42634703536874,0.07015683806259998,0.36041573702484087,0.2902588989622409,-788500,-800820,55.751419903786484,49.509121455525055,NaN,NaN,24.598840970594875,17.04893280384612
2000-10-18T09:30:00-04:00,25.5625,25.84375,25.34375,25.79687,60800,67470,65.79259205723812,62.69340245194566,NaN,NaN,119.95591134803186,107.50567271639973,0.0682165936304801,0.37552964100034103,0.3073130473698609,-849300,-810120,55.18444903582066,50.76677580515797,NaN,NaN,25.735870931505023,18.28992396494025
2000-10-19T09:30:00-04:00,25.07812,25.5,25.01562,25.32812,24200,66930,55.90469829336841,62.21101459264762,NaN,NaN,39.51016903859986,94.95849491582162,0.03070821514201516,0.3456983162973799,0.31499010115536474,-873500,-829220,53.97051120552245,51.90945867804748,NaN,NaN,23.550249086464962,19.041398982300922
2000-10-20T09:30:00-04:00,25.1875,25.53125,25.15625,25.5,16900,65035,58.3749988757816,61.978706331710534,NaN,NaN,59.07512133794024,92.21939338238862,0.013686190213890448,0.3320978389227278,0.31841164870883737,-856600,-835400,53.55996709387007,52.967250925510065,NaN,NaN,22.532801324182877,19.540170745426916
2000-10-23T09:30:00-04:00,25.40625,26,25.40625,25.76562,30800,63560,61.924917861450986,61.99996371260697,NaN,NaN,120.35088448137529,95.88778189300959,0.016348011695397457,0.3388466633280842,0.32249865163268676,-825800,-838740,53.32388245325857,53.92151093685082,NaN,NaN,22.79872223136172,20.00567810056046
2000-10-24T09:30:00-04:00,25.67187,25.875,25.5,25.84375,26100,62810,62.92646168329744,62.42895590396388,NaN,NaN,114.73044878813911,90.72450699881726,0.019205315471784057,0.34650529597241686,0.3272999805006328,-799700,-840980,53.15466115575023,54.795308818446834,NaN,NaN,23.318359810611085,20.478918344853405
2000-10-25T09:30:00-04:00,25.96875,26.60937,25.96875,26.45312,39200,63605,69.63528361851621,62.75346487190842,NaN,NaN,223.1879476751135,111.37091426423358,0.05589408210574964,0.39716758313281986,0.3412735010270702,-760500,-823220,54.390517605373816,55.350234501937926,NaN,NaN,26.08233634169451,21.27940663011642
2000-10-26T09:30:00-04:00,26.15625,26.60937,26.125,26.5,184500,70255,70.08380159013439,63.33010726038065,NaN,NaN,200.65753475196823,143.60038740690726,0.07584027682210143,0.436073847054697,0.36023357023259556,-576000,-763720,58.35447245624067,55.88078742742202,NaN,NaN,28.386129416449794,22.29465274244976
2000-10-27T09:30:00-04:00,26.23437,26.29687,25.89062,26.20312,17200,67560,63.66989305368393,63.61752919466952,NaN,NaN,125.4021890580973,156.86580095093868,0.06213612388570966,0.43790372508973263,0.37576760120402297,-593200,-711040,61.5414563855331,56.402794293074244,NaN,NaN,28.28505480794124,23.1504244660914
2000-10-30T09:30:00-05:00,26.45312,26.84375,26.25,26.8125,40400,68480,69.78284078599633,63.99886747413138,NaN,NaN,182.3196437579245,169.2595528062485,0.08575275451432718,0.482958544346932,0.3972057898326048,-552800,-656440,64.56794732662874,56.8971031343237,NaN,NaN,30.32446590326763,24.175287528545148
2000-10-31T09:30:00-05:00,26.75,26.75,26.28125,26.71875,53500,70375,67.89023958757983,64.29571007273742,NaN,NaN,148.91239038503952,176.0959411256286,0.08645574462192612,0.5052754706100124,0.4188197259880863,-606300,-617760,66.5747283952808,57.34576878888689,NaN,NaN,31.291049073356845,25.191824892089677
2000-11-01T09:30:00-05:00,26.75,26.84375,26.45312,26.6875,39100,72005,67.23564341822802,64.40079447950698,NaN,NaN,140.95856440859762,159.65006447232543,0.07655161071727457,0.5145092393846795,0.43795762866740495,-645400,-594740,67.7455659544016,57.981922206466166,NaN,NaN,31.848483656736725,26.14277614418211
2000-11-02T09:30:00-05:00,26.625,26.64062,26.34375,26.48437,33700,46560,62.98447452883,64.70763719835249,NaN,NaN,98.76664924357591,139.27188737064694,0.049374871378361884,0.4996762178903573,0.45030134651199544,-679100,-615360,65.53125696044422,58.58684160776835,NaN,NaN,31.0113648029861,26.838288809725537
2000-11-03T09:30:00-05:00,26.54687,26.54687,26.28125,26.34375,26700,46895,60.14919226168055,64.46499390589449,NaN,NaN,74.14356193372672,129.02016194577283,0.01667335400867398,0.47114303902283794,0.45446968501416396,-705800,-637880,63.10527578600595,59.05400797985124,NaN,NaN,29.463259056455936,27.21328455925845
2000-11-06T09:30:00-05:00,26.26562,26.95312,26.25,26.84375,118500,47565,66.00843563519366,64.4545338036414,NaN,NaN,101.95406001279285,112.94704519674649,0.02306815022765829,0.4833048727987368,0.4602367225710785,-587300,-644780,62.34372813051236,59.52488713890309,NaN,NaN,29.918520907998815,27.599746894792787
2000-11-07T09:30:00-05:00,26.98437,26.98437,26.5,26.57812,38500,47210,60.88668380699466,64.10411178576686,NaN,NaN,91.99914439551725,101.56439599884202,0.004719237668570131,0.46613576965679115,0.461416531988221,-625800,-648680,61.889110933517955,60.00379156016719,NaN,NaN,28.648774459818714,27.749607975510777
2000-11-08T09:30:00-05:00,27.03125,27.35937,26.98437,27.1875,37100,44845,67.17846652898757,64.90938094545395,NaN,NaN,140.36858804563482,101.44640072624945,0.02765366604901609,0.49598361454949114,0.46832994850047505,-588700,-637340,62.739915968775435,60.63017761468525,NaN,NaN,29.673096786947152,28.024392091430258
2000-11-09T09:30:00-05:00,27.17187,27.26562,26.5,27.21875,57300,46470,67.46747683767765,65.55884365701795,NaN,NaN,106.360414828079,102.96515384315008,0.038303497824500876,0.5162093207811012,0.4779058229566003,-531400,-607800,64.93588386673545,61.44274309846134,NaN,NaN,30.556403037409417,28.38610794085585
2000-11-10T09:30:00-05:00,27.23437,27.59375,27.01562,27.35937,107100,49440,68.79887065229599,66.04984028493544,NaN,NaN,138.0233709859917,115.74111565360313,0.04758773713269038,0.5373904943724632,0.48980275723977285,-424300,-551500,68.71974375301994,62.54244747701573,NaN,NaN,31.6893897605946,28.85800534367567
2000-11-13T09:30:00-05:00,27.17187,27.17187,26.34375,26.54687,45700,50895,54.83495445401932,65.47187548284414,NaN,NaN,49.853098846872314,105.320923420419,-0.005404999444536873,0.48304650793410175,0.4884515073786386,-470000,-528040,70.16454818649869,63.757439407783465,NaN,NaN,27.840499431016674,28.712647356152956
2000-11-14T09:30:00-05:00,26.48437,26.98437,26.25,26.875,32700,51500,58.49846415367109,64.67638837821235,NaN,NaN,47.95858068302245,96.51281067792006,-0.021849110216109913,0.4611401196085012,0.4829892298246111,-437300,-490340,72.3729180185607,65.04189658015396,NaN,NaN,25.96969110428097,28.320796463028387
2000-11-15T09:30:00-05:00,26.9375,27.09375,26.6875,26.9375,175100,57215,59.177685428218865,63.89738008093268,NaN,NaN,73.49046537356537,83.13718614350617,-0.0314253104360776,0.44370759177951413,0.47513290221559173,-262200,-425040,75.72459519433829,66.28261963287522,NaN,NaN,24.738472626764086,27.80903591499063
2000-11-16T09:30:00-05:00,26.96875,27.21875,26.8125,27,18800,56945,59.88472155623162,63.627010688257506,NaN,NaN,87.14314457671298,79.29373209323296,-0.036123212497213564,0.4299788865940748,0.46610209909128836,-243400,-367440,78.23311447958281,67.47488092530735,NaN,NaN,23.97540220581467,27.26137395653692
2000-11-17T09:30:00-05:00,27.01562,27.3125,26.76562,27,27400,57470,59.88472155623161,62.920002171845745,NaN,NaN,88.02189573519904,69.29343704307442,-0.04142349187212424,0.4143227342511331,0.4557462261232573,-243400,-331260,79.65522888049134,68.55254389344039,NaN,NaN,23.365334198071725,26.70479684818475
2000-11-20T09:30:00-05:00,27,27.125,26.875,26.92187,39600,57910,58.417834723439306,62.24340182440714,NaN,NaN,72.69596267756293,73.86200980921254,-0.05171514183117615,0.39110229883428715,0.4428174406654633,-283000,-293860,81.03462025865804,69.58539331225305,NaN,NaN,22.44821307383984,26.096713451849762
2000-11-21T09:30:00-05:00,27.09375,27.40625,27.07812,27.375,37100,58460,63.935442870917875,62.00767321388498,NaN,NaN,133.33328313730365,90.93695030006879,-0.030574139527552058,0.40459976625602323,0.4351739057835753,-245900,-255580,82.35342396999532,70.6288117419383,NaN,NaN,23.249559497056268,25.689977172593547
2000-11-22T09:30:00-05:00,27,27.5,27,27.28125,49900,58995,62.09947602899218,61.94445903532513,NaN,NaN,111.4061518221416,98.52008758978403,-0.025670925352059892,0.4030852490935004,0.4287561744455603,-295800,-262300,81.28483624720629,71.75406740527845,NaN,NaN,23.380577044218896,25.360062868540027
2000-11-24T09:30:00-05:00,27.25,27.25,26.84375,27,25000,51020,56.82734206156252,61.70718402103098,NaN,NaN,49.75645696552944,91.04275006754733,-0.0431095795205495,0.37486920004487345,0.41797877956542295,-320800,-277780,78.74991212382824,72.87154142940861,NaN,NaN,21.937195516576573,24.871081818259533
2000-11-27T09:30:00-05:00,27.10937,27.70312,26.875,27.54687,58500,53085,63.34393502504794,61.51686254887772,NaN,NaN,126.79389949711887,98.79715081993129,-0.020690581653024787,0.392115552499142,0.41280613415216677,-262300,-281560,78.10934601435517,73.99765699254024,NaN,NaN,22.68683778694556,24.55904695664325
2000-11-28T09:30:00-05:00,27.5625,27.9375,27.54687,27.84375,64600,54295,66.31636911098995,61.904697213448806,NaN,NaN,198.48950342987737,123.95585897039419,0.009628559668865722,0.4248418337382489,0.4152132740693832,-197700,-264500,78.9418862977079,75.21571237569667,NaN,NaN,24.27791205794791,24.5188848282582
2000-11-29T09:30:00-05:00,27.67187,28.3125,27.67187,28.125,66700,54955,68.89008984488697,62.02695602172734,NaN,NaN,219.43790781467254,141.17678390586795,0.04229056284802979,0.4680764776294204,0.4257859147813906,-131000,-241520,80.0429166037751,76.45164099248235,NaN,NaN,26.443749965969516,24.79386556221696
2000-11-30T09:30:00-05:00,28.34375,28.51562,27.64062,27.64062,472400,76620,60.33904284617207,61.517782165191214,NaN,NaN,162.4595464276806,151.38746282697576,0.025751723576555363,0.4579755692520848,0.43222384567552946,-603400,-303040,69.55772938783447,76.781772815418,NaN,NaN,25.491908352031196,24.89358596076185
2000-12-01T09:30:00-05:00,27.53125,27.53125,27.04687,27.23437,57800,77825,54.256235594353434,60.47902251819532,NaN,NaN,29.159207104101686,147.2680128546902,-0.015830876593517007,0.41243524993363323,0.42826612652715024,-661200,-371120,60.165125359242545,76.17072864443391,NaN,NaN,22.621555896549957,24.569010237303008
2000-12-04T09:30:00-05:00,27.1875,27.84375,27.15625,27.75,77400,80360,59.79614679546261,60.83339339972698,NaN,NaN,83.57356809454926,138.62394657417627,-0.012062282613406583,0.413188273260392,0.42525055587379856,-583800,-435420,52.89956923431714,74.93751586213521,NaN,NaN,22.084446571849952,24.214072570809716
2000-12-05T09:30:00-05:00,27.75,27.875,27.23437,27.53125,51900,77030,56.66105592210208,60.70214995461492,NaN,NaN,68.34886146473781,112.59581818114836,-0.026904918234731567,0.3916194080803841,0.41852432631511566,-635700,-523020,44.93773655444828,72.97786004327004,NaN,NaN,20.601593479697154,23.698004129222205
2000-12-06T09:30:00-05:00,27.4375,27.53125,26.60937,27,65600,78385,49.82840152074327,60.0343439612238,NaN,NaN,-45.8333476190646,59.541567094400946,-0.07251633471729851,0.3278789079184925,0.400395242635791,-701300,-637080,37.106581818187735,70.21943051640214,NaN,NaN,16.95624153495218,22.734895187183632
2000-12-07T09:30:00-05:00,27.25,27.40625,27.03125,27.39062,45100,78785,54.20156437464128,59.62840416253878,NaN,NaN,5.465000062263022,28.14265782131743,-0.07602513199308514,0.3053638276444346,0.38138895963751973,-656200,-647640,36.47285855739099,67.23655509338845,NaN,NaN,15.45058701065837,21.69427973339431
2000-12-08T09:30:00-05:00,26.875,27.5,26.875,27.28125,62700,79055,52.81349540985802,59.123316580654944,NaN,NaN,-10.776567281967878,20.15550294410351,-0.08469580334021087,0.27551920546225617,0.36021500880246704,-718900,-659180,35.75423287058685,64.10076966410955,NaN,NaN,13.81877380053464,20.5692074572715
2000-12-11T09:30:00-05:00,27.03125,27.35937,26.89062,26.90625,66300,77015,48.250799977282526,58.397099813072316,NaN,NaN,-46.398491504948296,-5.838908975795988,-0.11290615360538298,0.2190823167957383,0.3319884704011213,-785200,-699460,33.28876707861204,60.69035157982056,NaN,NaN,10.953061640208418,19.195472340548204
2000-12-12T09:30:00-05:00,26.85937,27.28125,26.85937,27.01562,20600,75760,49.61791278258057,57.37441909247679,NaN,NaN,-53.984257219292054,-30.305532712601963,-0.12071606510761207,0.1810933890166062,0.3018094541242183,-764600,-725240,31.77840276310397,57.0778500650426,NaN,NaN,9.08287616743133,17.75081574438865
2000-12-13T09:30:00-05:00,27.09375,27.6875,27.09375,27.625,44000,76325,56.51156209496976,56.975282382903764,NaN,NaN,42.033979338149194,-12.732067321159196,-0.0831453619329896,0.19787775170798128,0.2810231136409709,-720600,-729100,31.547600842677525,53.52519039329054,NaN,NaN,9.67527968203565,16.59716773548108
2000-12-14T09:30:00-05:00,27.625,27.65625,27.34375,27.42187,21400,68640,53.86576567701573,56.763741212579006,NaN,NaN,36.88357190787968,-6.448352952035866,-0.07076347192064336,0.19256877374016668,0.26333224566081004,-742000,-746260,30.48750790507627,50.07787580623683,NaN,NaN,9.31652188319617,15.55707547086895
2000-12-15T09:30:00-05:00,27.375,27.375,27.09375,27.21875,31500,69275,51.280332899060895,55.902055346437066,NaN,NaN,-32.059103174996025,-10.704860130641496,-0.07465659870143854,0.17001149728401188,0.24466809598545042,-773500,-757180,29.801227197082312,46.62729589071734,NaN,NaN,8.222053687241768,14.509215216065067
2000-12-18T09:30:00-05:00,27.01562,27.4375,27.01562,27.375,27300,69270,53.143460690900795,54.9611333164307,NaN,NaN,-23.585626692195017,-6.1422871680908395,-0.06544219523369521,0.1628653519433314,0.22830754717702662,-746200,-749380,30.996068827275664,43.20259464282933,NaN,NaN,7.882019747698371,13.562473006298397
2000-12-19T09:30:00-05:00,27.60937,28,27.48437,27.64062,47400,69660,56.209275331947794,54.05536085122076,NaN,NaN,88.28668930950477,22.311902137668525,-0.04136638610481658,0.1765995645460059,0.21796595065082247,-698800,-736220,33.06608169431799,39.847106435010964,NaN,NaN,8.513968639584412,12.841258096767827
2000-12-20T09:30:00-05:00,27.75,28.10937,27.60937,27.70312,50000,70305,56.92347601896545,53.81139179213458,NaN,NaN,101.22451543608274,34.15000935725523,-0.02210619103188166,0.1903332118609704,0.21243940289285207,-648800,-721860,35.34528287714005,37.40336025567564,NaN,NaN,9.235608952739975,12.326165361906705
2000-12-21T09:30:00-05:00,27.5,27.75,27.46875,27.60937,44300,70025,55.46226914062923,53.89753704544,NaN,NaN,44.535078583622195,35.68031069240374,-0.01679510629747996,0.19144552002100212,0.20824062631848209,-693100,-712080,36.92068872576842,35.743043353284634,NaN,NaN,9.434328042467362,11.913045744843942
2000-12-22T09:30:00-05:00,27.4375,27.54687,27.23437,27.5,60600,71805,53.729484504789404,53.46420402467762,NaN,NaN,-8.830351729213833,40.326060981560175,-0.021464021986304732,0.18141059883560118,0.2028746208219059,-753700,-708120,37.58386672825753,34.64906460285181,NaN,NaN,9.133320437001679,11.515942129437905
2000-12-26T09:30:00-05:00,27.5,28.0625,27.5,28.04687,51400,71450,60.39281694273375,53.73075838329417,NaN,NaN,102.22015606942718,65.4872175338846,0.009785168231291747,0.2151060811110206,0.20532091287972884,-702300,-699340,39.1123352549978,34.232964510033916,NaN,NaN,10.828659548255667,11.417758903554727
2000-12-27T09:30:00-05:00,27.92187,28.64062,27.92187,28.23437,37100,70075,62.39251003837086,54.628194705981855,NaN,NaN,181.0488785332774,84.03965537863914,0.03895254096975603,0.2540115890919239,0.21505904812216786,-665200,-692620,40.31700958444244,34.46228077905211,NaN,NaN,12.848991610824756,11.622220718879017
2000-12-28T09:30:00-05:00,28.53125,28.70312,28.375,28.65625,55900,69535,66.49183532301015,55.506071202293924,NaN,NaN,225.18241035099462,108.8312343616215,0.0801548722934824,0.31525263848902085,0.23509776619553846,-609300,-684720,41.775450949681634,34.84103737850144,NaN,NaN,15.913753608224585,12.235296845928383
2000-12-29T09:30:00-05:00,28.5625,28.875,28.5625,28.5625,34400,47635,64.80143457636996,56.3623525713305,NaN,NaN,207.5812096481818,141.44046057453343,0.09365159704901932,0.3521622625068126,0.2585106654577933,-643700,-674840,43.630672533364574,35.40364021155698,NaN,NaN,17.93015013881865,13.048847316341279
2001-01-02T09:30:00-05:00,28.625,28.75,28.04687,28.1875,164200,52955,58.40529075932426,57.087673341476325,NaN,NaN,121.7487290464166,167.55627672965952,0.07091329485828185,0.3471522840306456,0.2762389891723637,-807900,-685680,42.04764540755885,36.02927437791033,NaN,NaN,17.77978772045327,13.724695945500136
2001-01-03T09:30:00-05:00,28.35937,28.35937,26.89062,26.89062,316800,64925,42.70611442136304,56.59397345853222,NaN,NaN,-39.71569609545403,139.16910629668328,-0.03233829452264625,0.2358161210190559,0.26815441554170216,-1124700,-770160,32.23244786672413,36.06170617102606,NaN,NaN,11.799653760882101,13.449689919126131
2001-01-04T09:30:00-05:00,26.125,26.32812,25.5,25.82812,271500,75905,34.519520311419285,55.023113331135754,NaN,NaN,-239.24757368363018,55.109815853301754,-0.16561014402213683,0.061141735514031126,0.22675187953616796,-1396200,-916360,22.460910899265613,35.412656889353784,NaN,NaN,3.1919237479561464,11.984294751816133
2001-01-05T09:30:00-05:00,25.875,26.34375,25.6875,26,64300,75840,36.63563582150323,53.79238977002772,NaN,NaN,-195.83314888879005,-29.093295994655183,-0.2315590735218403,-0.06269696236613242,0.16886211115570787,-1331900,-1060880,16.980765144117854,34.447889549285314,NaN,NaN,-2.4136644061920385,9.927443443529251
2001-01-08T09:30:00-05:00,26.0625,26.32812,25.9375,26.17187,39600,75565,38.76659601021345,52.898551420824326,NaN,NaN,-153.26438726186493,-101.26241537666452,-0.2513270173760619,-0.14529666056436952,0.10603035681169239,-1292300,-1190600,13.740195695714945,33.300673013473364,NaN,NaN,-5.9773985287045726,7.655323161781562
2001-01-09T09:30:00-05:00,26.0625,26.6875,26.0625,26.45312,56200,75240,42.19262207765706,52.11634866273548,NaN,NaN,-108.90364714178305,-147.39289061430446,-0.23356014464103697,-0.18591982398960383,0.04764032065143314,-1236100,-1276240,12.098641957761245,31.950856808508043,NaN,NaN,-7.683476640243062,5.464066047206615
2001-01-10T09:30:00-05:00,26.65625,26.65625,26.0625,26.29687,36500,73750,40.82599136056442,51.017542664779526,NaN,NaN,-104.46027228990431,-160.3418058531945,-0.2205864419714781,-0.22809273181291445,-0.007506289841436378,-1272600,-1305820,11.583861857327449,30.41641253443729,NaN,NaN,-9.477141008819052,3.329607896345806
2001-01-11T09:30:00-05:00,26.125,26.1875,25.625,25.78125,49300,75185,36.61166161141848,49.566698778526174,NaN,NaN,-132.73530267796133,-139.03935165206073,-0.23372850109663051,-0.2996669162122245,-0.065938415115594,-1321900,-1290960,13.573335551174608,28.86127343972547,NaN,NaN,-12.39593107836906,1.0831023285293964
2001-01-12T09:30:00-05:00,25.64062,26,25.64062,25.75,69400,76455,36.3666425158082,48.202725448181816,NaN,NaN,-117.49348234700983,-123.3714183437047,-0.23110640895699136,-0.3548214263118332,-0.12371501735484186,-1391300,-1302840,13.315381363139352,27.17518005668054,NaN,NaN,-14.766892840412835,-1.1811826956052078
2001-01-16T09:30:00-05:00,25.78125,26.34375,25.70312,26.10937,139600,82365,41.23700097425564,47.310405196000836,NaN,NaN,-84.09388030056842,-109.5373169514454,-0.19328591251520916,-0.3653224079988533,-0.17203649548364414,-1251700,-1294720,14.511265643373548,25.527137122045964,NaN,NaN,-15.291974674319317,-3.1970101211357944
2001-01-17T09:30:00-05:00,25.9375,26.09375,25.70312,25.8125,56100,83595,38.6081596978999,45.75435824994127,NaN,NaN,-86.42881960881472,-105.04235144485173,-0.17682551709350033,-0.39306839185051956,-0.21624287475701923,-1307800,-1309060,14.140258502428253,23.743417354005285,NaN,NaN,-16.53126862561654,-5.101904193204472
2001-01-18T09:30:00-05:00,25.78125,26.34375,25.78125,26.01562,63900,85425,41.362537557226865,44.25221735843099,NaN,NaN,-66.26939957671887,-97.40417690221464,-0.14230488545099634,-0.39412398157076467,-0.2518190961197683,-1243900,-1303320,15.076210905992284,21.940503162687413,NaN,NaN,-16.738208904965127,-6.764233437741709
2001-01-19T09:30:00-05:00,26,26,25.625,25.8125,338600,99985,39.456145556632485,42.32109666083259,NaN,NaN,-74.8011533141353,-85.81734702944945,-0.12387502231358316,-0.4066628740117473,-0.2827878516981641,-1582500,-1355440,13.623950665217961,19.92968171379715,NaN,NaN,-17.465516188301276,-8.292988116393076
2001-01-22T09:30:00-05:00,26.03125,26.1875,25.85937,25.96875,35000,99235,41.68280441618614,40.66976593510517,NaN,NaN,-56.52173953371121,-73.62299846678974,-0.09328017494539387,-0.3993880703799064,-0.30610789543451256,-1547500,-1386680,12.826417215022715,17.729377762487015,NaN,NaN,-17.43612870909663,-9.59915105820787
2001-01-23T09:30:00-05:00,25.89062,26.21875,25.76562,26.14062,40200,99030,44.11738993925243,39.64920159081432,NaN,NaN,-49.795185464372636,-66.76325949955057,-0.055454947294716284,-0.3754265795529079,-0.31997163225819164,-1507300,-1437800,11.626980615475802,15.556473134481086,NaN,NaN,-16.723418107986905,-10.61690349389059
2001-01-24T09:30:00-05:00,26.125,26.125,25.76562,26.04687,76600,99830,43.06136997295123,39.67457698735634,NaN,NaN,-50.457681866808066,-59.56903195114925,-0.03190557311637554,-0.35985359865366107,-0.3279480255372855,-1583900,-1493020,10.486251694461288,14.003173407890882,NaN,NaN,-16.411060273328896,-11.444640176667491
2001-01-25T09:30:00-05:00,26.125,26.59375,26.01562,26.59375,53600,99940,50.50417040916104,40.816337708623614,NaN,NaN,-15.548864577789736,-49.42492495136342,0.022417704793301296,-0.2999258945456589,-0.3223435993389602,-1530300,-1550300,9.450487257896427,13.073857433507369,NaN,NaN,-13.922056372002572,-11.798556776001075
2001-01-26T09:30:00-05:00,26.73437,26.8125,26.32812,26.32812,45900,100380,47.271938332756626,41.576073602284566,NaN,NaN,-1.4522338087292685,-34.755141050282205,0.04127816886685265,-0.27074588825539436,-0.312024057122247,-1576200,-1549040,9.66186733213587,12.5510790183658,NaN,NaN,-12.729767426506623,-11.931586868930438
2001-01-29T09:30:00-05:00,26.61,26.63,26.03,26.11,48200,99995,44.73988302066905,42.00273696017426,NaN,NaN,-16.488167522360772,-26.748426648012092,0.03986042747603413,-0.26219852277720435,-0.3020589502532385,-1624400,-1564420,9.374205095258219,12.239222546904609,NaN,NaN,-12.449663799542272,-12.005597859017843
2001-01-30T09:30:00-05:00,26.17999,26.45,26.00999,26.41,59500,101250,48.801833595836875,42.47482349718711,NaN,NaN,3.6037657948854056,-16.068636396160485,0.0587813781007398,-0.22858222762731373,-0.28736360572805353,-1564900,-1575940,9.154353169750763,12.02891620490386,NaN,NaN,-11.00872445197144,-11.86318737229693
2001-01-31T09:30:00-05:00,26.5,26.55,26,26.48,139900,100035,49.730351226097014,43.11084920186801,NaN,NaN,45.42272193721116,3.1074443646433565,0.07464632202868982,-0.19405570319219123,-0.26870202522088105,-1425000,-1544160,15.07179331129069,12.27805416590123,NaN,NaN,-9.55788987267832,-11.533859158065699
2001-02-01T09:30:00-05:00,26.62,26.85001,26.5,26.71001,53900,86890,52.76188012111066,44.26443623827459,NaN,NaN,172.40309267118818,40.69783581443894,0.09780548390768784,-0.14644517033627125,-0.2442506542439591,-1371100,-1512320,20.648631247017022,12.783432429889976,NaN,NaN,-7.440356279991548,-10.949073032626535
2001-02-02T09:30:00-05:00,27.05,27.05,26.75999,26.88,63600,76495,54.92534387070289,45.59005776362421,NaN,NaN,195.19780777352153,80.0278441308891,0.12026922408734286,-0.09391412413478051,-0.21418334822212337,-1307500,-1458580,29.109820909155488,13.911606683176842,NaN,NaN,-5.0230084045376415,-10.102492371470978
2001-02-05T09:30:00-05:00,27.02,27.10001,26.84,26.86,108900,78725,54.60845411019272,46.54516155904829,NaN,NaN,172.3165786762349,117.78879337060823,0.12872066520024106,-0.05328251672182205,-0.1820031819220631,-1416400,-1416980,34.896895233945315,15.3677230825034,NaN,NaN,-3.105440868783188,-9.102913585372722
2001-02-06T09:30:00-05:00,27.03999,27.05,26.8,26.98,90700,81280,56.23981666029184,47.80456562779057,NaN,NaN,149.132202722958,146.89448075622278,0.136587522713927,-0.011268778529654355,-0.14785630124358135,-1325700,-1369140,40.8745392541737,17.27731456477093,NaN,NaN,-1.0212771173152688,-7.948394089935943
2001-02-07T09:30:00-05:00,27.10001,27.2,26.89,27.03,34200,80180,56.934329327608246,48.9168364685321,NaN,NaN,147.13810871084976,167.2375581109505,0.13889703382234528,0.02576499103435026,-0.11313204278799502,-1291500,-1342440,43.96681646150936,19.340929247307862,NaN,NaN,0.928287921788125,-6.680296659689647
2001-02-08T09:30:00-05:00,26.95,27.14999,26.88,26.95,62800,81495,55.4188051728531,50.05702644111928,NaN,NaN,118.45496423657627,156.4479324240281,0.12898936874668104,0.0481046681453563,-0.08088470060132474,-1354300,-1339080,44.36117795929518,21.536445482599095,NaN,NaN,2.2294059951462804,-5.407481994713086
2001-02-09T09:30:00-05:00,27.14999,27.25,27,27.17,1596600,158860,58.67644945604635,51.27085822968072,NaN,NaN,125.83089269322895,142.57454940796958,0.13079489678183695,0.08260892037597145,-0.048185976405865506,242300,-1029120,67.25583641896603,25.424261140023614,NaN,NaN,4.256057389089117,-4.026976368455628
2001-02-12T09:30:00-05:00,27.3,27.46001,27.11,27.39999,26800,156730,61.817582516352964,52.53515769947362,NaN,NaN,135.8813323125293,135.28750013522844,0.1401868090081826,0.1270475348543627,-0.013139274153819866,269100,-692020,77.90454554990961,30.1583729210546,NaN,NaN,6.923304715287956,-2.462650499349402
2001-02-13T09:30:00-05:00,27.39999,27.39999,26.92999,27.03,116400,155570,54.62410698248759,53.36106748586907,NaN,NaN,91.35283397735631,123.73162638610813,0.11523254428264912,0.13090140619949153,0.015668861916842417,152700,-396340,83.0970186550454,35.344856275382035,NaN,NaN,7.332604612479167,-1.0633283405167493
2001-02-14T09:30:00-05:00,26.82001,26.89999,26.57001,26.78,108800,158205,50.35982720584711,53.35075725706094,NaN,NaN,28.652273460033225,100.03445933594482,0.07745374823549098,0.11248604721120614,0.035032298975715165,43900,-129260,86.24207456355838,40.829969654357896,NaN,NaN,6.442847842564579,0.008982542780583413
2001-02-15T09:30:00-05:00,26.60001,26.64999,26.3,26.53999,62800,158150,46.59877106857988,53.302673881048314,NaN,NaN,-17.371819922510298,72.86910250412748,0.03407821702571663,0.07763007025786095,0.04355185323214432,-18900,137820,88.538671149696,46.4640270698979,NaN,NaN,4.551946017112379,0.6579773248279828
2001-02-16T09:30:00-05:00,26.52,26.67,26.35001,26.63,34900,142965,48.162340171694545,53.547135106121566,NaN,NaN,-16.06028666279483,44.49086663292273,0.010452011926668857,0.05661686814048039,0.046164856213811535,16000,92560,85.92115286228548,51.931666196114136,NaN,NaN,3.421902289145698,1.052823748301942
2001-02-20T09:30:00-05:00,26.77,26.89999,26.56,26.75999,29000,142665,50.42008806043026,53.66272471073538,NaN,NaN,14.480030661224285,20.21060630266173,0.0029704344875643024,0.04987789932326692,0.046907464835702614,45000,47740,83.29501382403132,57.22742767141989,NaN,NaN,3.094670912832299,1.3445162003777074
2001-02-21T09:30:00-05:00,26.75,26.96001,26.60001,26.67999,36300,142470,49.005469542913126,53.610947447650815,NaN,NaN,9.480282153834164,3.836095937957301,-0.00740764790174725,0.03764790495851855,0.0450555528602658,8700,18940,81.56976340491342,61.97728267810722,NaN,NaN,2.428000984889845,1.4992997410222983
2001-02-22T09:30:00-05:00,26.71001,26.74001,26.19,26.48,128700,145075,45.56387748300336,53.096804402071726,NaN,NaN,-67.03859126765107,-15.302077007579552,-0.026697765204906562,0.011683346354132595,0.03838111155903916,-120000,-13840,79.55011807150554,66.18453173699926,NaN,NaN,0.8735570119600464,1.4099079225848339
2001-02-23T09:30:00-05:00,26.17,26.38,25.92,26.28,102800,147535,42.359991178423755,52.199279209766075,NaN,NaN,-129.83384594328857,-37.794482211735215,-0.050502342082153394,-0.024746816043652586,0.025755526038500808,-222800,-54620,76.99602244286845,69.60497470369305,NaN,NaN,-1.4043554868884383,1.0078702926600807
2001-02-26T09:30:00-05:00,26,26.53,25.95,26.53,63500,148415,47.34421156248024,51.68040474207233,NaN,NaN,-89.83182285204632,-52.54878944958551,-0.04705556573459179,-0.03306393112973893,0.013991634604852858,-159300,-89680,74.77326514705865,72.453286840344,NaN,NaN,-1.9756818458734504,0.581648558583862
2001-02-27T09:30:00-05:00,26.31,26.63,26.31,26.55,27400,147375,47.733588791104516,51.07281703713037,NaN,NaN,-57.16201592850065,-66.8771987675305,-0.04127966836922487,-0.03760795085667823,0.0036717175125466402,-131900,-125060,72.49877011112258,74.71216047298321,NaN,NaN,-2.336466771336388,0.16477494002382637
2001-02-28T09:30:00-05:00,26.66,26.84,26.39999,26.64,20300,145415,49.54181697696184,50.54478044065563,NaN,NaN,-30.908241851917282,-74.95490356868079,-0.029785383975110373,-0.033560012456341326,-0.003774628481230954,-111600,-149120,70.91889383154302,76.63730885655704,NaN,NaN,-2.1499432495175674,-0.16589908705351558
2001-03-01T09:30:00-05:00,26.64,26.66,26.27,26.39,43600,140600,44.89543490333359,49.793111135689955,NaN,NaN,-84.1694507464744,-78.38107546444544,-0.03693959353924793,-0.04994912040529087,-0.01300952686604294,-155200,-156160,70.43522946458603,78.49974110693496,NaN,NaN,-3.3013508085611543,-0.6138207615546067
2001-03-02T09:30:00-05:00,26.58,26.64999,26.42,26.64,219200,148865,49.95050700413518,49.16982953198202,NaN,NaN,-45.7276343700656,-61.55983314980085,-0.023414257633313895,-0.04227734890768531,-0.018863091274371413,64000,-98800,72.10453891088123,78.84607699921462,NaN,NaN,-2.844666244129077,-0.9325129733509596
2001-03-05T09:30:00-05:00,26.38,26.57001,26.2,26.53999,20400,146705,48.05146525497682,48.18653544188372,NaN,NaN,-73.18540190269675,-58.230548959930935,-0.019919858397313785,-0.04376291427101364,-0.023843055873699857,43600,-58220,73.25505229390431,78.51397033807139,NaN,NaN,-3.0051990549237924,-1.2286109850042215
2001-03-06T09:30:00-05:00,26.39999,26.46001,25.94,26,45800,143550,39.352068296233696,47.09567553572273,NaN,NaN,-134.28709166758395,-73.6555641077476,-0.05092893245649311,-0.08750422144431624,-0.03657528898782313,-2200,-32280,73.99343867027126,77.86371462487323,NaN,NaN,-5.970240221049481,-1.9059865901535442
2001-03-07T09:30:00-05:00,26.09,26.13,25.56,25.83,44300,141230,37.07630619527483,46.14685260639613,NaN,NaN,-181.02605391230188,-103.67912651982451,-0.07821059345666291,-0.13433853080865177,-0.05612793735198886,-46500,-19260,74.37583814478168,77.01612630924633,NaN,NaN,-9.150586323191735,-2.9409294091589997
2001-03-08T09:30:00-05:00,25.75,26.2,25.75,26.05,89800,144010,41.769497707339916,45.80190450916471,NaN,NaN,-132.04442195453078,-113.2541207614358,-0.0766586877612462,-0.1519512970535466,-0.0752926092923004,43300,20440,75.55607585763201,76.0887980740989,NaN,NaN,-10.355793034708478,-4.000195641380354
2001-03-09T09:30:00-05:00,26,26.38,26,26.21001,40500,142895,44.98356972073394,45.57484947695324,NaN,NaN,-79.623884584133,-120.03337080424926,-0.060769515517558326,-0.1512545036892483,-0.09048498817168998,83800,24400,75.67642323195354,75.35703167193232,NaN,NaN,-10.356873328517363,-4.908292453828498
2001-03-12T09:30:00-05:00,25.89999,26.14999,25.39999,25.39999,35600,64845,34.5785087972136,44.44330810100919,NaN,NaN,-186.80821123225363,-142.75793267016064,-0.09849350143982627,-0.21360186497147282,-0.11510836353164655,48200,25320,75.70634834618258,74.81498413780027,NaN,NaN,-14.128891529517265,-6.225520893212607
2001-03-13T09:30:00-05:00,25.17999,25.3,24.82001,25.27,153600,71185,33.24936210794719,43.317871855654474,NaN,NaN,-246.4866163085062,-165.19783759834507,-0.12422121002416892,-0.2703848760618577,-0.14616366603768877,-105400,4680,73.52097234313054,74.24007049053007,NaN,NaN,-17.52506330375898,-7.839741237576375
2001-03-14T09:30:00-05:00,24.72,25.19,24.55,24.64999,221500,76440,27.766985974142187,42.04666531930725,NaN,NaN,-245.01482650333077,-177.99559211655088,-0.172070001741521,-0.36125116821459,-0.189181166473069,-326900,-51400,67.79469257770245,73.4003972409727,NaN,NaN,-22.570385314181205,-9.944118962805636
2001-03-15T09:30:00-05:00,24.85001,24.85001,24.45,24.67999,20100,72005,28.382322910587504,41.048260443033236,NaN,NaN,-208.92400784336454,-193.3715092943176,-0.18940124508357362,-0.425932722827536,-0.2365314777439624,-306800,-121420,61.367805111936626,72.284096003049,NaN,NaN,-26.172281134825052,-12.262427844522694
2001-03-16T09:30:00-05:00,24.5,24.67999,24.10001,24.31,42600,70995,25.49744566604761,39.487777164716626,NaN,NaN,-193.90324579418962,-216.22738153632895,-0.21179089151358177,-0.5012700921359396,-0.2894792006223579,-349400,-208060,54.48503513455564,70.83493671644165,NaN,NaN,-30.19896704364522,-14.824790587254483
2001-03-19T09:30:00-05:00,24.2,24.62,24.2,24.59,88800,73690,31.1969831136243,38.30659104489661,NaN,NaN,-148.32855654132567,-208.53145059814332,-0.19421378715107523,-0.5322464345612019,-0.3380326474101267,-260600,-269820,50.16582667098075,69.23972647071722,NaN,NaN,-31.574126171448608,-17.21755281356793
2001-03-20T09:30:00-05:00,24.55,24.64999,24,24,318400,88160,26.582320067971906,36.66662697996875,NaN,NaN,-144.87149660126292,-188.2084266566947,-0.20758643354696232,-0.5975156893438296,-0.38992925579686727,-579000,-364540,44.357948852795744,67.34251611509241,NaN,NaN,-34.42222836322857,-19.675363606376592
2001-03-21T09:30:00-05:00,23.92,24.08,23.34,23.39999,142600,93475,22.8763251584935,35.09383342676589,NaN,NaN,-165.0704847324408,-172.21955830251667,-0.23982245124291912,-0.6897073198505161,-0.449884868607597,-721600,-443480,40.18264457758259,65.18161719459216,NaN,NaN,-38.223634690194324,-22.325116618350552
2001-03-22T09:30:00-05:00,23,23.16,22.52,23.16,57400,89910,21.580369471167018,33.06739503155387,NaN,NaN,-176.91506240744638,-165.81776921533304,-0.25866956010530395,-0.773221818739227,-0.5145522586339231,-779000,-537920,35.836663930416805,62.591054695987566,NaN,NaN,-41.655402115323284,-25.08658597506094
2001-03-23T09:30:00-05:00,23.39999,23.78,23.13,23.71001,35200,86530,31.199923447569446,31.863713473881923,NaN,NaN,-116.80538552109633,-150.3981971607144,-0.2171312490402274,-0.7859663199342073,-0.5688350708939799,-743800,-616800,32.65940141119604,59.691365347222686,NaN,NaN,-41.04666610465162,-27.366597422145325
2001-03-26T09:30:00-05:00,23.95,24.14999,23.75,24.03,43900,85550,36.11026534847627,31.63215612047068,NaN,NaN,-79.17288409984708,-136.5670626724187,-0.15410648652308123,-0.7614681790478315,-0.6073616925247503,-699900,-704660,29.519973799161406,56.51468928500055,NaN,NaN,-38.81586326005971,-29.002206827561665
2001-03-27T09:30:00-05:00,24.03999,24.57001,24.03999,24.57001,30300,85695,43.44588942014795,32.08712635081876,NaN,NaN,-46.96338652482266,-116.98544065713065,-0.06652589244366225,-0.6905190580793281,-0.6239931656356659,-669600,-722780,28.902902442342125,53.266622449112006,NaN,NaN,-34.29226858133583,-29.757929935243688
2001-03-28T09:30:00-05:00,24.23,24.78999,24.23,24.64,19300,85645,44.337929189363514,32.27058574239187,NaN,NaN,-31.286254024193834,-90.22859451548126,0.0020107492898704393,-0.6214797290233278,-0.6234904783131983,-650300,-708520,30.14053210326999,50.02265503808615,NaN,NaN,-30.528045661087972,-29.867946467507156
2001-03-29T09:30:00-05:00,24.75999,25.02,24.48,24.7,34400,85185,45.136844534180916,32.28153394335237,NaN,NaN,-13.63363002735256,-57.5723080394625,0.05437608525866222,-0.5555203717398705,-0.6098964569985327,-615900,-675900,33.01314775553345,46.97527821834186,NaN,NaN,-27.31671871005819,-29.50348535930016
2001-03-30T09:30:00-05:00,24.83,24.94,24.59,24.72,12900,74870,45.418069404254325,33.05578827242671,NaN,NaN,-6.071916572022989,-35.42561424964781,0.09118384197310714,-0.4959166545321487,-0.5871004965052559,-603000,-647740,35.479654517770356,44.10194294488384,NaN,NaN,-24.672208728267815,-28.813302983438398
2001-04-02T09:30:00-04:00,24.8,24.83,24.23,24.39,77500,77725,41.626560361570014,33.654159576256916,NaN,NaN,-23.63498963214858,-24.318035356108105,0.09376687722578214,-0.46989189997302816,-0.5636587771988103,-680500,-643860,35.830250425785806,41.40974852221636,NaN,NaN,-23.49640223744639,-28.053745734010967
2001-04-03T09:30:00-04:00,24.25,24.47,23.84,23.94,38200,77345,37.08071383011021,34.31942585168321,NaN,NaN,-57.82792437543355,-26.490942926230293,0.06689127979464327,-0.4800446774555063,-0.5469359572501495,-718700,-653680,35.30732540247094,39.08922229541411,NaN,NaN,-23.863401565400846,-27.455125138495234
2001-04-04T09:30:00-04:00,23.85001,24.28,23.82001,24.25,18800,76070,41.796229843495844,35.27756206117666,NaN,NaN,-48.99038653780433,-30.031769428952394,0.0713094110770589,-0.4577991934038259,-0.5291086044808848,-699900,-663600,34.75550462699999,37.18834368934721,NaN,NaN,-22.707783172866062,-26.776933429119637
2001-04-05T09:30:00-04:00,24.44,24.60001,24.14999,24.5,24200,72790,45.35314578529178,36.695826355408386,NaN,NaN,-5.121138737936939,-28.329271171069273,0.09111865111310569,-0.41521029058950276,-0.5063289417026084,-675700,-675560,34.06425281117791,35.729716380534505,NaN,NaN,-20.64343873965701,-25.90071990205355
2001-04-06T09:30:00-04:00,24.45,24.62,24.2,24.42,24800,72005,44.41771141135714,37.64016409096073,NaN,NaN,7.917121007594371,-25.531463655145803,0.09826879994757237,-0.38349294176814297,-0.48176174171571534,-700500,-695060,32.91479776112412,34.497500029830455,NaN,NaN,-19.239361695831278,-24.949097301164652
2001-04-09T09:30:00-04:00,24.7,24.75,24.41,24.63,25300,71490,47.47999001408801,39.13285480139759,NaN,NaN,51.23584710036808,-10.557296308642474,0.11539280108158334,-0.33752074036373614,-0.4529135414453195,-675200,-694000,33.04705478592001,33.68957902505362,NaN,NaN,-17.152965793298737,-23.835364228612377
2001-04-10T09:30:00-04:00,24.82001,24.82001,24.39999,24.60001,25100,65065,47.08106031950969,40.861764455755896,NaN,NaN,60.76179961593417,13.160648489631068,0.12229194650097674,-0.3000486083190985,-0.42234055482007526,-700300,-690320,33.536945210400035,33.214886213112,NaN,NaN,-15.554993056202854,-22.6524540611253
2001-04-11T09:30:00-04:00,24.38,24.38,23.85001,24.13,31300,55555,41.23377650641937,42.265579243988206,NaN,NaN,-25.85582550899077,17.787560695393783,0.09406090932739125,-0.3047644181608362,-0.39882532748822747,-731600,-696660,33.08776274938815,33.018536128752814,NaN,NaN,-15.813551320986113,-21.67546795539113
2001-04-12T09:30:00-04:00,24.22,24.47,24.08,24.45,19100,55505,46.13849397150924,43.33261999569819,NaN,NaN,19.775117252424646,22.7668118934661,0.09549308066115025,-0.27945897666178965,-0.3749520573229399,-712500,-704020,32.54284858842034,33.010210927125975,NaN,NaN,-14.564810782417318,-20.659659787823443
2001-04-16T09:30:00-04:00,24.45,24.7,24.33,24.45,13600,54055,46.13849397150924,44.048922040200544,NaN,NaN,50.166613266688636,31.21671034528495,0.09480319915885804,-0.25644805837436735,-0.3512512575332254,-712500,-706420,32.35572440011288,33.21276454147966,NaN,NaN,-13.55935303073202,-19.645330251096098
2001-04-17T09:30:00-04:00,24.52,24.99001,24.52,24.99001,37900,51510,53.70119878630056,44.78144413778288,NaN,NaN,109.74936275146824,42.91941347550498,0.12706552174883046,-0.19241935534718735,-0.3194848770960178,-674600,-706300,32.37666194022897,33.46089021990014,NaN,NaN,-10.30885148923134,-18.311547570829703
2001-04-18T09:30:00-04:00,25.02,25.10001,24.56,24.75,19700,36575,50.31941047035748,45.20869280071101,NaN,NaN,94.01748732010203,49.570551016338555,0.12822174105459228,-0.15920770077777746,-0.28742944183236974,-694300,-705100,32.601324473541695,33.63666110349098,NaN,NaN,-8.59001320364481,-16.922756946946148
2001-04-19T09:30:00-04:00,24.60001,24.64999,24.39999,24.64999,53600,32125,48.93649983773261,45.48009675096471,NaN,NaN,46.913498052068505,64.12441572855042,0.11846287617062251,-0.13935084661909158,-0.2578137227897141,-747900,-708360,32.28749807166639,33.58482898321476,NaN,NaN,-7.5838822463650315,-15.588631989720275
2001-04-20T09:30:00-04:00,24.49001,24.5,24.17999,24.38,25000,30505,45.31576421564331,45.4727892374925,NaN,NaN,-15.603903628393128,57.04861155238685,0.09125649644673017,-0.14374310223130138,-0.23499959867803155,-772900,-720440,31.09309157541209,33.2715030587606,NaN,NaN,-7.786973215685143,-14.474109307715256
2001-04-23T09:30:00-04:00,24.75,24.75,24.36,24.5,32800,30385,47.186144994281015,45.86990242554328,NaN,NaN,27.301941888070846,52.47567727666329,0.0792208145148022,-0.1359735805345288,-0.215194395049331,-740100,-725960,30.537182762935814,32.893426797128456,NaN,NaN,-7.420148100978115,-13.466400563895665
2001-04-24T09:30:00-04:00,24.45,24.53999,24.05,24.05,16300,29005,41.45941155773286,46.182666548944894,NaN,NaN,-95.7725485228263,11.371295021804391,0.04076813375144511,-0.16423422786002462,-0.20500236161146973,-756400,-742320,28.88865638389504,32.43495043865875,NaN,NaN,-8.837895917573851,-12.80518561442112
2001-04-25T09:30:00-04:00,24.12,24.75,24.12,24.69,68100,30895,50.635531461392084,46.814045235937485,NaN,NaN,16.53414110816614,-4.125374220582785,0.0572418777064056,-0.13345001447846272,-0.19069189218486832,-688300,-741120,29.190610125204344,32.037457974244774,NaN,NaN,-7.123134989054022,-11.993464096511534
2001-04-26T09:30:00-04:00,24.64999,24.92999,24.5,24.92,132600,36560,53.45892215293892,47.393029262198,NaN,NaN,106.07436656795078,7.7067994825936665,0.08098315171006826,-0.08946295254728298,-0.17044610425735124,-555700,-702680,38.23775274305075,32.33556511223569,NaN,NaN,-4.807532084222039,-10.966902380470177
2001-04-27T09:30:00-04:00,24.95,25.17,24.75999,25.06,29600,36320,55.14079428846239,48.1589637534198,NaN,NaN,166.60971984010195,44.14952417629268,0.10210684921138974,-0.04281254274311408,-0.14491939195450382,-526100,-653320,47.5116079003746,33.378194407896444,NaN,NaN,-2.4070400446501035,-9.744064903924453
2001-04-30T09:30:00-04:00,25.39999,25.53,25.2,25.2,40200,37685,56.82119121584779,48.82619241068835,NaN,NaN,229.13328349221032,84.51579249712059,0.12024983918020778,0.005392907020755899,-0.11485693215945188,-485900,-602480,55.00556342177346,34.946659310457406,NaN,NaN,0.07339869092157188,-8.341570104660736
2001-05-01T09:30:00-04:00,25.31,25.58,25.2,25.48,23000,34960,60.0448409129673,49.752176738792464,NaN,NaN,205.14322517974222,144.6989472376343,0.1442338931264604,0.06543543424862364,-0.07879845887783678,-462900,-543780,61.78904933697178,36.96466674806967,NaN,NaN,3.178753251672519,-6.695809625184557
2001-05-02T09:30:00-04:00,25.45,25.45,25.13,25.33,61900,36145,57.565384344857975,50.91872015582379,NaN,NaN,148.49867193240908,171.09185340248285,0.14285139541437586,0.09976578539013303,-0.04308561002424282,-524800,-511080,64.95841391529231,39.24114183134854,NaN,NaN,5.031398641304972,-5.020494158543196
2001-05-03T09:30:00-04:00,25.22,25.22,24.92,25.2,27700,36590,55.429117275930665,51.582336106139614,NaN,NaN,92.65280480450777,168.40754104979428,0.12659287341948627,0.11515548175011503,-0.011437391669371244,-552500,-510440,65.0195681349259,41.560907513241794,NaN,NaN,5.9633827421442716,-3.451368887016415
2001-05-04T09:30:00-04:00,25.2,25.48,25.07001,25.42,647300,67745,58.25261490301919,52.44763045839032,NaN,NaN,119.50997763462208,158.98759260869832,0.12391029776007918,0.14345048053072773,0.01954018277064855,94800,-386260,74.36709727337573,44.561719861331994,NaN,NaN,7.578093916295931,-1.87573134368608
2001-05-07T09:30:00-04:00,25.53,25.53,25.31,25.41,34400,68225,58.07253345789343,52.75986864921838,NaN,NaN,121.49327869807317,137.45959164987087,0.11491700799164374,0.16318644276020322,0.04826943476855948,60400,-277000,79.54606073269392,47.930962632222354,NaN,NaN,8.850007619995344,-0.34348292030301963
2001-05-08T09:30:00-04:00,25.42,25.44,25.12,25.32001,25500,68235,56.38332532821633,53.19300542477972,NaN,NaN,86.83535942690234,113.79801849930288,0.09707303395357823,0.16961072721053227,0.07253769325695404,34900,-177440,82.9304187542177,51.525897937984915,NaN,NaN,9.475147738451145,1.0591786023761467
2001-05-09T09:30:00-04:00,25.34,25.52,25.32001,25.45,17900,67875,58.27151402261331,53.859792152271204,NaN,NaN,98.17342974932295,103.73297006268565,0.08843439369277392,0.18308068537292144,0.09464629168014752,52800,-61920,85.85497530282191,55.35214631163889,NaN,NaN,10.516992986403192,2.410294942951439
2001-05-10T09:30:00-04:00,25.56,25.56,25.27,25.32001,24500,67535,55.67587339655282,54.599799950907595,NaN,NaN,81.55377052546763,101.51316320687764,0.06922545399277033,0.18117810917111044,0.1119526551783401,28300,54240,88.06863730518633,59.42182814947991,NaN,NaN,10.727796196937858,3.5985094078066417
2001-05-11T09:30:00-04:00,25.36,25.39999,25.06,25.17999,43300,68745,52.94035330410728,55.0108148301809,NaN,NaN,46.12110515065254,86.83538871008372,0.04360034976474088,0.1664530923842662,0.12285274261952532,-15000,32280,85.34927027110358,63.33697725720618,NaN,NaN,10.178514590810094,4.538510148235706
2001-05-14T09:30:00-04:00,25.11,25.39999,25.08,25.39999,16400,68885,56.552419938575,56.088886857383905,NaN,NaN,55.7910473263233,73.69494243573374,0.03817328953049609,0.17056935453264543,0.13239606500214934,1400,20480,83.85100342018312,67.26285918836962,NaN,NaN,10.666540588254811,5.413943068238435
2001-05-15T09:30:00-04:00,25.25999,25.34,25.05,25.25,35000,68740,53.5354376793821,56.29602301581176,NaN,NaN,36.82781315264248,63.69343318088177,0.02199156535128713,0.15988552169125825,0.13789395633997112,-33600,6780,82.05009475081053,71.03853666162719,NaN,NaN,10.260435370181632,6.106299111373177
2001-05-16T09:30:00-04:00,25.49001,26.14999,25.32001,26.02,436700,89590,64.11838526224014,57.0574132379047,NaN,NaN,141.27376833444475,72.31350089790614,0.0585787881940843,0.2111174415825765,0.1525386533884922,403100,76840,83.94867344992359,74.30360242640383,NaN,NaN,13.268467574860848,7.1294660347285586
2001-05-17T09:30:00-04:00,26.2,26.24001,25.95,26.14999,55800,89700,65.54510802111551,57.800578504522775,NaN,NaN,180.1241036081127,92.02756751443515,0.08534514611944624,0.2592200860378,0.17387493991835376,458900,162960,85.92011586521426,77.04706728103523,NaN,NaN,16.15972540390969,8.41950308746872
2001-05-18T09:30:00-04:00,26.2,26.2,25.83,26.00999,26500,89775,62.65555945849797,58.2173190932835,NaN,NaN,157.13118969808787,114.2295844239222,0.08712818955888696,0.2827851768669625,0.19565698730807551,432400,252440,87.62131211407367,79.37676361619954,NaN,NaN,17.66101053133624,9.73971843659265
2001-05-21T09:30:00-04:00,26.08,26.08,25.75999,25.99001,24300,89350,62.23389323314814,58.37367997329642,NaN,NaN,136.1106718917146,130.29350933700044,0.08061951864551511,0.2964313856149694,0.21581186696945429,408100,333780,88.93061925706616,81.31544718192056,NaN,NaN,18.75023562735312,11.02693517812986
2001-05-22T09:30:00-04:00,25.92999,25.92999,25.64999,25.73,40100,90540,56.870095274636824,58.32401646828062,NaN,NaN,89.83178114086095,140.89430293464414,0.05375305506055289,0.2830031857951454,0.2292501307345925,368000,414100,90.0498063025027,83.10768949529272,NaN,NaN,18.112699230609593,12.039187185626965
2001-05-23T09:30:00-04:00,25.91,25.91,25.44,25.5,29100,88590,52.555077498892665,58.118727912777906,NaN,NaN,44.65137845824012,121.56982495940323,0.017327759846431645,0.25090983054263205,0.2335820706962004,338900,401260,88.50919267338732,84.78551981946853,NaN,NaN,16.26021512340202,12.642191176737686
2001-05-24T09:30:00-04:00,25.55,25.64,25.22,25.61,48200,84370,54.33946495674203,57.83921720232954,NaN,NaN,4.252237033853434,86.39545164455137,-0.0015208394541611214,0.231681021378499,0.23320186083266012,387100,386900,86.72222996738522,85.66802929761208,NaN,NaN,15.230613611277738,13.011965810243408
2001-05-25T09:30:00-04:00,25.56,25.58,25.3,25.39999,131600,89470,50.439154381647,57.293975839740504,NaN,NaN,-19.94794891560828,50.97962392181216,-0.02878345584971284,0.19722254102051906,0.2260059968702319,255500,351520,82.31279896577547,85.8656534571179,NaN,NaN,13.18312752151653,13.036417483282426
2001-05-29T09:30:00-04:00,25.49001,25.74001,25.46001,25.61,46000,89760,53.99523298191632,57.12339781500479,NaN,NaN,26.71857641879256,29.101204827227765,-0.03302036527811969,0.1847305402725823,0.21775090555070198,301500,330200,79.6835316440495,85.63373294924875,NaN,NaN,12.461170394951553,12.954239327806587
2001-05-30T09:30:00-04:00,25.7,25.89,25.64,25.75,39100,90565,56.24892277860692,56.97892701186148,NaN,NaN,63.786117179547624,23.892072034965103,-0.02699571642027107,0.18400626002536313,0.2110019764456342,340600,324720,78.98515311343769,85.14303136429274,NaN,NaN,12.507291812661128,12.890389682785807
2001-05-31T09:30:00-04:00,25.67,25.72,25.52,25.57001,23600,88650,52.676111815435995,56.76465832749599,NaN,NaN,17.10700733710033,18.383197810737148,-0.03521462922302382,0.16698368991685442,0.20219831913987824,317000,320340,78.39375219731033,84.4519681423016,NaN,NaN,11.498297186743073,12.691519326208274
2001-06-01T09:30:00-04:00,25.60001,25.95,25.50999,25.91,61700,90350,58.091177592144305,57.132574348070065,NaN,NaN,62.474756335282294,30.027701671022907,-0.018666111445671207,0.17886567983278923,0.19753179127846043,378700,318660,78.15204103441643,83.93788033968109,NaN,NaN,12.247612073328144,12.628104004368256
2001-06-04T09:30:00-04:00,25.8,26.05,25.75999,25.95,24100,59190,58.690080194119666,57.285264366323254,NaN,NaN,90.91971358936243,52.20123417201705,-0.006563465777503025,0.18932745905658166,0.19589092483408468,402800,348120,79.35418225579176,83.61667882793884,NaN,NaN,13.030225415782004,12.685549920284505
2001-06-05T09:30:00-04:00,26.08,26.25,25.87,26.22,61400,60540,62.57758556763623,57.93113207262712,NaN,NaN,126.750577756404,72.20763443953933,0.016811174843104904,0.2169048933879658,0.2000937185448609,464200,380660,80.62245555400148,83.51470459959535,NaN,NaN,14.89051629102118,13.00054511610403
2001-06-06T09:30:00-04:00,26.17,26.17,25.8,25.8,41900,61360,54.055824455010686,57.21237772925359,NaN,NaN,68.20802699306527,73.09201640224288,0.001953042136772526,0.20253502121582656,0.20058197907905403,422300,397000,81.24548112816223,83.32161943375525,NaN,NaN,13.84512392666372,13.121199231898272
2001-06-07T09:30:00-04:00,25.78999,26.10001,25.78999,25.98,34300,62180,56.77274012107271,56.58578002210768,NaN,NaN,70.26910966022042,83.7244368668669,0.0021963825818942795,0.20332745730642188,0.2011310747245276,456600,424920,82.29308724367299,83.06254596078801,NaN,NaN,13.831836262506567,13.222718807699456
2001-06-08T09:30:00-04:00,26,26.03999,25.77,25.83,11700,61540,53.911648631492305,55.96121496303585,NaN,NaN,44.74287400989554,80.17806040178954,-0.009172557534056464,0.18966537780695703,0.1988379353410135,444900,438160,82.78419488334312,82.71703758716441,NaN,NaN,12.935736865865275,13.181721387437431
2001-06-11T09:30:00-04:00,25.7,25.86,25.47,25.47,40100,61380,47.698743102095754,54.922989953674964,NaN,NaN,-45.454400970381144,52.90323748984082,-0.04060467479893842,0.14808209184234045,0.18868676664127887,404800,438560,82.79971611379169,82.27911593407336,NaN,NaN,10.139626801114172,12.747136446534109
2001-06-12T09:30:00-04:00,25.52,25.8,25.48,25.77,1029200,112020,52.60088427517447,54.61804631085623,NaN,NaN,-28.286391225166273,21.895843693526768,-0.040752074899299245,0.13774667301715482,0.17849874791645406,1434000,632520,88.3054842658394,82.15452150288311,NaN,NaN,9.340237624603777,12.260436614829775
2001-06-13T09:30:00-04:00,25.63,25.73,25.57001,25.57001,50500,112795,49.28456507358571,54.38443828047716,NaN,NaN,-64.37928724031242,-4.62161915314878,-0.05309840491999626,0.11212574176645873,0.165224146686455,1383500,824760,91.2835701057629,82.3526913194814,NaN,NaN,7.613421190583998,11.59657726850895
2001-06-14T09:30:00-04:00,25.62,25.75,25.53999,25.55,26700,92295,48.95201477414794,53.99962041029187,NaN,NaN,-62.148876118273925,-31.105216308847645,-0.06083664772176556,0.08917833703424805,0.1500149847560136,1356800,1004800,93.06481277139059,82.80573294833891,NaN,NaN,6.142282677596868,10.817392326950081
2001-06-15T09:30:00-04:00,25.3,25.50999,25.25999,25.32001,22400,90625,45.17867067637648,53.62387157420112,NaN,NaN,-143.65140155823363,-68.78407142247347,-0.07854275327597787,0.05183654316104125,0.13037929643701912,1334400,1182700,94.30355275196327,83.66221536163805,NaN,NaN,3.727874053148776,9.804604002121323
2001-06-18T09:30:00-04:00,25.27,25.56,25.22,25.39999,24500,90525,46.716835859019376,53.10398606542277,NaN,NaN,-120.03013749069888,-83.69921872653701,-0.08160776270688266,0.028369593053415798,0.10997735576029846,1358900,1373520,95.27785538185938,84.77609562862447,NaN,NaN,2.190712268665447,8.716905183056198
2001-06-19T09:30:00-04:00,25.32001,25.48,25.28,25.48,34300,91025,48.28019181971253,52.53479099693031,NaN,NaN,-103.33274062098045,-98.70848860569984,-0.07514742874513029,0.016043069828885592,0.09119049857401589,1393200,1365360,94.53325142289715,85.88667407930016,NaN,NaN,1.353653734016695,7.665012118907698
2001-06-20T09:30:00-04:00,25.58,25.85001,25.58,25.62,17200,89880,50.989896345220174,52.41434703477204,NaN,NaN,4.232308975678315,-84.9861693625017,-0.05905575761960685,0.01737080154950732,0.07642655916911417,1410400,1370740,94.56341869603985,87.04165025778083,NaN,NaN,1.4020826026478632,6.77030790229915
2001-06-21T09:30:00-04:00,25.75,25.94,25.55,25.84,18200,89335,54.98139842542219,52.19221995143475,NaN,NaN,38.067044886923895,-64.94298516146213,-0.03253088981768423,0.035762946897008874,0.0682938367146931,1428600,1385100,94.64830837345882,88.21995506771243,NaN,NaN,2.6017825443041525,6.174804279728436
2001-06-22T09:30:00-04:00,25.42,25.42,25.06,25.12,430300,108440,42.71919979310939,51.051442779934014,NaN,NaN,-170.50619578177026,-70.31394400616946,-0.06077163337443092,-0.007670705003345546,0.053100928371085376,998300,1317880,87.74171531197331,88.81906457172538,NaN,NaN,-0.33569905487300267,5.244732374785373
2001-06-25T09:30:00-04:00,25.35001,25.35001,24.91,24.99001,52100,104465,40.94377383447547,49.50617051327968,NaN,NaN,-189.08265204336996,-84.12444691670368,-0.08406640402737216,-0.05198207666312982,0.03208432736424234,946200,1235340,80.0202203178134,88.77604776914052,NaN,NaN,-3.268550319520495,4.028549132741678
2001-06-26T09:30:00-04:00,25,25.07001,24.85001,24.99001,31200,103725,40.94377383447547,48.56959546895573,NaN,NaN,-186.26164305172588,-100.71022740285277,-0.0945527218538961,-0.08610657495312779,0.008446146900768312,946200,1145940,72.57091755698193,88.15643608548477,NaN,NaN,-5.572738250043722,2.656936649486621
2001-06-27T09:30:00-04:00,25.07001,25.07001,24.60001,24.8,47800,104160,38.24892405934078,47.24646575026059,NaN,NaN,-181.30287388930455,-137.81726397584936,-0.10837172900433967,-0.12701851435465628,-0.018646785350316605,898400,1043540,65.09583171598734,86.92806069065009,NaN,NaN,-8.346876420745325,1.0849633537392003
2001-06-28T09:30:00-04:00,24.84,25.02,24.74001,24.96001,23400,104150,41.727229438542885,46.37615009362135,NaN,NaN,-133.86469763575698,-172.20361248038552,-0.10097072628723547,-0.14486019320936094,-0.043889466922125475,921800,942180,58.65542780023176,85.20457732757072,NaN,NaN,-9.649116874293032,-0.44847667883683284
2001-06-29T09:30:00-04:00,24.88,24.92,24.31,24.31,188300,110480,33.477590087823614,45.36035344974477,NaN,NaN,-178.45704926126947,-173.79378317628536,-0.13212085661316345,-0.20904053768857978,-0.07691968107541633,733500,889220,55.562243774816366,83.25904358907246,NaN,NaN,-13.698854755856397,-2.3413878326967703
2001-07-02T09:30:00-04:00,24.63,24.88,24.53,24.87,207500,119650,43.78842512168112,44.7308920816381,NaN,NaN,-117.41527730026907,-159.46030822766517,-0.10828000741254044,-0.2122696903410919,-0.10398968292855144,941000,888180,55.50034767247723,80.91581954668946,NaN,NaN,-13.55973780184022,-3.94400925686012
2001-07-03T09:30:00-04:00,24.72,24.73,24.60001,24.67,8800,117020,41.324860746466584,44.16234177255816,NaN,NaN,-118.11057676380247,-145.8300949700805,-0.0994762867689516,-0.22833504138974092,-0.12885875462078933,932200,885380,55.32166266039219,78.34711187202012,NaN,NaN,-14.299994133454149,-5.423435667802124
2001-07-05T09:30:00-04:00,24.66,24.67999,24.41,24.52,15700,115710,39.52862931615621,43.48924281127303,NaN,NaN,-122.88894200864873,-134.14730859394933,-0.09714144280050671,-0.2502855581214227,-0.153144115320916,916500,889000,55.521042958006234,75.66541402820697,NaN,NaN,-15.48218554841741,-6.860399936461451
2001-07-06T09:30:00-04:00,24.45,24.45,24.2,24.23,112800,119635,36.24821332815126,42.85135300068553,NaN,NaN,-143.9387110683869,-136.1621112804753,-0.10769662972468311,-0.2877649024767699,-0.18006827275208678,803700,865380,53.83297613868665,72.77465855583006,NaN,NaN,-17.553138104158723,-8.387933960418204
2001-07-09T09:30:00-04:00,24.45,24.60001,24.33,24.60001,48000,121450,42.77370097250792,42.56970050879185,NaN,NaN,-98.25656241171441,-120.12201391056428,-0.08341195925054684,-0.2843332218152703,-0.20092126256472348,851700,889020,55.29789070072172,69.91894679289166,NaN,NaN,-17.1129567411296,-9.634365786234117
2001-07-10T09:30:00-04:00,24.60001,24.63,24.39999,24.39999,25900,120740,40.36820468441911,42.0045585705566,NaN,NaN,-93.56827212151336,-115.35261287481315,-0.07475125385246276,-0.2943603298803019,-0.21960907602783916,825800,865980,53.51559221143117,66.98911399207265,NaN,NaN,-17.53812406869614,-10.76347411230012
2001-07-11T09:30:00-04:00,24.60001,24.60001,24.19,24.27,65600,72560,38.83950304708639,41.13667333497562,NaN,NaN,-103.1136098720615,-112.35321949646497,-0.07169783134034813,-0.3092313652032743,-0.2375335338629262,760200,831580,50.87883765275228,63.86878677469497,NaN,NaN,-18.36009968889956,-11.848706337528611
2001-07-12T09:30:00-04:00,24.25,24.25,23.96001,24.12,29500,71510,37.09387581701264,39.858993148660645,NaN,NaN,-129.07478789904462,-113.59038867454414,-0.07343258815604947,-0.32932426905798806,-0.2558916809019386,730700,794420,48.120656061033955,60.5453830380932,NaN,NaN,-19.56923015144595,-12.951638310945373
2001-07-13T09:30:00-04:00,24.03999,24.42,24.03999,24.3,17100,71030,40.54704020284029,39.70383889221285,NaN,NaN,-97.70037889208147,-104.34272223928306,-0.05685034741102363,-0.3269546151657181,-0.2701042677546945,747800,783240,47.290029074150915,57.65597687824875,NaN,NaN,-19.539602199480722,-13.892776009307566
2001-07-16T09:30:00-04:00,24.39999,24.39999,24.10001,24.12,72600,73540,38.283832483027915,39.51384308139517,NaN,NaN,-96.34249373904916,-103.95990850475,-0.052501421447824936,-0.33573104456447567,-0.28322962311665073,675200,747940,44.668278921631654,55.1308382070929,NaN,NaN,-20.185500904138983,-14.791736708569196
2001-07-17T09:30:00-04:00,24.13,24.62,24.13,24.48,45900,74610,44.90714457165245,39.79694099119352,NaN,NaN,-57.802211645104144,-96.80669640946817,-0.021466878255466393,-0.3100632209359837,-0.2885963426805173,721100,727000,43.14038775332355,53.0286575068316,NaN,NaN,-18.70125909678952,-15.350239906886385
2001-07-18T09:30:00-04:00,24.62,25.17999,24.62,25.17999,52100,75500,55.0161211328048,40.99459792501238,NaN,NaN,48.636646827497856,-66.45664506955629,0.04641310567272999,-0.23057996058960484,-0.27699306626233483,773200,729600,43.399266628867714,51.47890285775162,NaN,NaN,-13.803605004466736,-15.129292063683577
2001-07-19T09:30:00-04:00,25.08,25.2,24.89999,24.94,19700,75625,51.52536900463487,41.6944650368761,NaN,NaN,64.92015493751634,-27.6576565022441,0.0737356046239111,-0.18482356048244597,-0.25855916510635707,753500,734160,43.881849879456624,50.42364729198197,NaN,NaN,-10.996209910209993,-14.538851756044494
2001-07-20T09:30:00-04:00,25.2,25.31,25.10001,25.28,59800,77705,55.80379907429495,43.28919425019548,NaN,NaN,125.79375690804576,17.041170657781347,0.11105071565673233,-0.11974577053544166,-0.230796486192174,813300,747260,45.324089254898325,49.69235054055925,NaN,NaN,-7.204449710618816,-13.491080035269396
2001-07-23T09:30:00-04:00,25.10001,25.12,24.64999,24.69,55300,58955,47.90269704357761,43.58307081604523,NaN,NaN,41.283706730547614,44.5664107517007,0.09306934817796392,-0.11445980096971908,-0.207529149147683,758000,763820,47.17237374283093,49.09749525987023,NaN,NaN,-6.659260969190163,-12.515105882972364
2001-07-24T09:30:00-04:00,24.74001,24.74001,24.39999,24.5,33500,58025,45.660612871180795,43.89276739638196,NaN,NaN,-18.672611992561766,52.392330682209185,0.06668677389154803,-0.12417068178324797,-0.190857455674796,724500,764500,47.25122677899059,48.521035554055835,NaN,NaN,-6.9857399488321175,-11.725196463809471
2001-07-25T09:30:00-04:00,24.45,24.71001,24.45,24.67999,43600,58645,48.137057160293864,44.50765509953465,NaN,NaN,3.1808724630007497,43.301175809309754,0.0598814088646073,-0.11600569459403687,-0.17588710345864417,768100,763480,47.137568665342876,47.92221596172273,NaN,NaN,-6.443831428756839,-10.970715744516237
2001-07-26T09:30:00-04:00,24.55,24.8,24.5,24.69,20700,57290,48.27823208720914,45.36694215375307,NaN,NaN,19.952630445702827,34.30767091094705,0.054719199468688695,-0.10748810412278331,-0.162207303591472,788800,770540,48.0686890909962,47.51048117260199,NaN,NaN,-5.97509255847174,-10.257055289367024
2001-07-27T09:30:00-04:00,24.7,24.88,24.62,24.69,30000,57620,48.27823208720913,45.76012294766031,NaN,NaN,43.4458643552318,17.838092400384244,0.05009396879679823,-0.09958984259547421,-0.14968381139227244,788800,765640,47.44406791884611,46.94949383103944,NaN,NaN,-5.598861963189859,-9.591599099913143
2001-07-30T09:30:00-04:00,24.81,25,24.61,25,27200,49565,52.884616026792315,46.654152329258395,NaN,NaN,76.38810062630462,24.858971179535644,0.06571706971639374,-0.06753747424678025,-0.133254543963174,816000,777240,49.12933384473914,46.63618966199001,NaN,NaN,-3.917027370575643,-8.780945995722071
2001-07-31T09:30:00-04:00,24.8,25.48,24.8,25.05,28000,40590,53.602369931736646,47.708642821019126,NaN,NaN,129.86811146389238,54.56711587082648,0.07647006874833688,-0.037666958027752884,-0.11413702677608976,844000,801140,52.50833752591694,46.7525825100732,NaN,NaN,-2.3326860928396855,-7.859766009596016
2001-08-01T09:30:00-04:00,25.25,25.28,24.98,25.05,32200,41760,53.602369931736646,48.887820972070834,NaN,NaN,111.6427011363423,76.25948160549478,0.08024171834303896,-0.013834878847291066,-0.09407659719033003,844000,816320,54.572294300712464,47.21341381290739,NaN,NaN,-1.029381591209235,-6.883996806969333
2001-08-02T09:30:00-04:00,25.05,25.3,24.89999,24.89999,70100,44480,50.90410134416866,49.62761105359429,NaN,NaN,84.20381119280664,89.10971775491555,0.06968370240096508,-0.0069719691891236835,-0.07665567159008876,773900,813340,54.07545880720878,47.698087365268655,NaN,NaN,-0.6137262463949131,-5.988243869744416
2001-08-03T09:30:00-04:00,25.14,25.14,24.87,25.08,19300,39805,53.90282600779252,50.74325344822034,NaN,NaN,75.11075647545745,95.44269617896069,0.07159988051394046,0.012844179052336813,-0.05875570146160365,793200,814220,54.20803963581888,48.37949884485346,NaN,NaN,0.5600605067032897,-5.052771815966172
2001-08-06T09:30:00-04:00,25.14999,25.14999,24.82001,24.95,16800,38245,51.45838837056849,51.21119943385719,NaN,NaN,56.44055747005734,91.45318754771122,0.06128688800133416,0.01785290854006405,-0.04343397946127011,776400,806300,52.73253114362661,49.064651944160815,NaN,NaN,0.9187664518598121,-4.19969492056246
2001-08-07T09:30:00-04:00,25,25.12,24.91,25,18900,37895,52.35336358845318,51.0210024664035,NaN,NaN,59.00214662908169,77.2799945807491,0.055197006640304705,0.025562278839110775,-0.02963472780119393,795300,796560,50.897706015915446,49.60025475752138,NaN,NaN,1.4558163107507123,-3.3917647446605783
2001-08-08T09:30:00-04:00,25.12,25.13,24.77,24.89999,15000,35365,50.35356991125994,50.93730253116244,NaN,NaN,36.819348769674306,62.31532410741549,0.042374238285190394,0.02333307005529406,-0.019041168229896332,780300,783820,48.51961453188086,49.931523661265956,NaN,NaN,1.4022993394699856,-2.7068984469276405
2001-08-09T09:30:00-04:00,24.8,25,24.72,24.98,30200,35400,51.93537047941569,50.66098620295677,NaN,NaN,22.232101950414965,49.92098225893715,0.037395493885656356,0.027703199127174116,-0.009692294758482241,810500,791140,49.96612255123479,50.26309746814713,NaN,NaN,1.7603942582515246,-2.068713774759188
2001-08-10T09:30:00-04:00,25.10001,25.25,25,25.07001,24500,35770,53.72174236907048,51.07663229763484,NaN,NaN,78.11929030035628,50.522689023916925,0.0381471704891726,0.03799166835298351,-0.00015550213618909133,835000,799500,51.637474481352264,50.58203323518437,NaN,NaN,2.5278074036977753,-1.412067892122479
2001-08-13T09:30:00-04:00,25.14,25.35001,25.11,25.28999,84900,36385,57.84527691269454,51.94696544345725,NaN,NaN,124.53308002944175,64.1411935357938,0.050658596479508676,0.06316774346319676,0.01250914698368808,919900,828200,56.953661666560706,51.27506429858223,NaN,NaN,4.328602447294744,-0.59197212934859
2001-08-14T09:30:00-04:00,25.24001,25.46001,25.24001,25.25,23000,35240,56.85352527513187,52.569570308802824,NaN,NaN,145.63909471582986,81.46858315314344,0.05317879668549842,0.07898264284056111,0.02580384615506269,896900,848520,60.28254938441507,52.213991492801675,NaN,NaN,5.600315125647635,0.29264033565087055
2001-08-15T09:30:00-04:00,25.48,25.57001,25.2,25.2,24400,33855,55.57065188536298,53.09045743724238,NaN,NaN,130.5302749002841,100.21076837926539,0.04854455702341448,0.08648454243433079,0.03793998541091631,872500,866960,63.07332567455374,53.28575124877007,NaN,NaN,6.366744351813438,1.1603694808169516
2001-08-16T09:30:00-04:00,25.3,25.45,25.17,25.45,253000,45520,60.38404384335029,53.95515827696675,NaN,NaN,125.62346259581275,120.88904050834495,0.05870364383764781,0.11131954020797608,0.05261589637032826,1125500,929960,70.6588430991722,54.94394947593623,NaN,NaN,8.382917312822826,2.1921620282463623
2001-08-17T09:30:00-04:00,25.35001,25.46001,25.21001,25.46001,15200,43290,60.568250822999445,54.503989333838696,NaN,NaN,125.70394875157747,130.40597219858918,0.06215294635654675,0.1303070793160117,0.06815413295946496,1140700,991100,75.84476379429427,56.85219447233302,NaN,NaN,10.118229651342878,3.324457402974436
2001-08-20T09:30:00-04:00,25.5,25.66,25.38,25.42999,19800,41515,59.672125518829375,54.93754330434531,NaN,NaN,143.7346733810703,134.24629086891488,0.05851958771189529,0.14130361759933407,0.08278402988743878,1120900,1031300,78.53155835457456,58.71099596009427,NaN,NaN,11.37230982870839,4.474150606650715
2001-08-21T09:30:00-04:00,25.55,25.88,25.55,25.66,122000,45940,64.05971457334722,55.68449649303178,NaN,NaN,183.63679923943346,141.8458317736356,0.06709855007268549,0.16665721747829565,0.09955866740561016,1242900,1100500,82.20158505555463,60.68451672829728,NaN,NaN,13.726821119719828,5.795960679946303
2001-08-22T09:30:00-04:00,25.60001,25.8,25.37,25.77,172500,52385,65.9667330569067,56.76039875822736,NaN,NaN,145.8384490929573,144.90746661217025,0.07507054626168477,0.19339685023271613,0.11832630397103136,1415400,1209080,86.19064472128242,62.97845857930254,NaN,NaN,16.29961708413024,7.296483023401151
2001-08-23T09:30:00-04:00,25.75,25.86,25.59,25.69,71300,54915,63.33466657693034,57.43410165602292,NaN,NaN,143.99837923583178,148.58244994017406,0.06994774551427255,0.20576098586387204,0.1358132403495995,1344100,1252800,87.41384425182416,65.35030176616006,NaN,NaN,17.8096067799876,8.798357845770644
2001-08-24T09:30:00-04:00,25.67,26.10001,25.67,26,26000,54715,68.56822601608,58.65623291641659,NaN,NaN,175.98138441014706,158.63793707188796,0.08161538924358286,0.23783247690407805,0.1562170876604952,1370100,1298680,88.55912289589655,67.90934403417934,NaN,NaN,20.77253294558922,10.508954288601869
2001-08-27T09:30:00-04:00,25.98,26.06,25.87,25.95,327000,69705,66.90932242217406,59.69594426168238,NaN,NaN,161.22775644122828,162.13655368391954,0.08003494416623941,0.25626076786829444,0.17622582370205503,1043100,1283120,85.71057620505253,70.3959776191177,NaN,NaN,22.761254771679006,12.25928292904146
2001-08-28T09:30:00-04:00,25.91,25.91,25.56,25.64,20000,69305,57.60407704539401,60.21383762840623,NaN,NaN,86.39435562215961,142.6880649604648,0.053458694805780416,0.24304919220928056,0.18959049740350015,1023100,1239160,78.07030641884404,72.50674132532936,NaN,NaN,21.738032806278856,13.613390054361087
2001-08-29T09:30:00-04:00,25.62,25.69,25.25,25.25,62700,70830,48.4711123140628,59.96639061659532,NaN,NaN,9.81708726580118,115.48379259503358,0.007381474192053206,0.19881734014356667,0.19143586595151346,960400,1148160,65.12803144005184,73.58973481738772,NaN,NaN,17.710158356267023,14.198642668919078
2001-08-30T09:30:00-04:00,25.47,25.60001,25.17999,25.36,402600,87455,50.83864073753488,59.760454785771344,NaN,NaN,1.485102664917931,86.98113728085082,-0.016611125327030185,0.17067195929272572,0.1872830846197559,1363000,1151940,65.38473241784459,74.57168181285147,NaN,NaN,15.20287336310147,14.34210419665942
2001-08-31T09:30:00-04:00,25.35001,25.35001,25,25.17,23700,87675,46.835802846203485,58.97406378102199,NaN,NaN,-56.0035738633411,40.58414562615318,-0.044611219512116274,0.13151906022961057,0.17613027974172685,1339300,1145780,64.55080867003304,75.11433517024234,NaN,NaN,11.784020434888516,13.976663659263577
2001-09-04T09:30:00-04:00,25.2,25.75999,25.2,25.2,79000,90785,47.53817901872209,58.30868190556414,NaN,NaN,-4.458805133595044,7.446833311188525,-0.05951375847755541,0.1017380816447826,0.161251840122338,1418300,1220820,69.63197423820847,75.78215123122759,NaN,NaN,9.27011798917149,13.304299992107564
2001-09-05T09:30:00-04:00,25.14999,26.10001,25.14999,26.10001,74600,93570,63.23206550569937,58.85592573558818,NaN,NaN,95.53780376761352,9.275522940279297,-0.009768138263312715,0.14904166729319712,0.15880980555650984,1492900,1314780,74.55084343280598,76.6019739282456,NaN,NaN,12.600786702247424,13.203798093556117
2001-09-06T09:30:00-04:00,25.85001,25.85001,25.3,25.3,26000,94120,49.15561786137086,58.05389530830393,NaN,NaN,4.577232723102422,8.227552031739545,-0.030579093210898856,0.12058593904288628,0.15116503225378514,1466900,1416080,78.57925946647823,77.16771795448176,NaN,NaN,9.571833813453216,12.684946053541417
2001-09-07T09:30:00-04:00,25.07001,25.44,24.89999,24.89999,225200,103870,43.89398189697312,56.86287609930205,NaN,NaN,-125.90047230493812,-17.249562962231664,-0.06892583644907896,0.06500773669243642,0.13393357314151538,1241700,1391820,75.4970855317594,77.14288379287211,NaN,NaN,5.0438640438149935,11.593362909294784
2001-09-10T09:30:00-04:00,24.75,25.45,24.75,25.45,251900,115240,51.57016076395104,56.284164331096456,NaN,NaN,-86.36909838842044,-23.32266786724753,-0.05546831951400573,0.06459817374900823,0.12006649326301395,1493600,1422680,76.74655684229617,77.01538368485224,NaN,NaN,4.632634561468254,10.598973145319565
2001-09-17T09:30:00-04:00,24.89999,25.42999,24.7,25.42999,2926100,257300,51.295198220064115,55.37241316300481,NaN,NaN,-93.77732102929009,-41.18637104638654,-0.046497282401946866,0.061944890260580365,0.10844217266252723,-1432500,852520,38.09521918621731,73.86492897989957,NaN,NaN,4.236378381096766,9.69003103614488
2001-09-18T09:30:00-04:00,25.2,25.28,24.97,25.12,399100,276105,47.10506405125641,54.025151091172646,NaN,NaN,-106.50273862824682,-81.59447952555861,-0.05920842995656639,0.034431635216819245,0.09364006517338563,-1831600,187620,23.33573077209398,69.37529226924325,NaN,NaN,2.38827647794741,8.64692324211667
2001-09-19T09:30:00-04:00,25.14999,25.16,24.28,24.8,49600,277365,43.183527147235445,52.585783989051585,NaN,NaN,-190.57383267324403,-120.6246926048279,-0.08534707827385839,-0.013043782668937354,0.07230329560492103,-1881200,-482000,16.431281638615687,64.30510922544265,NaN,NaN,-0.5084529979728437,7.339012350675311
2001-09-20T09:30:00-04:00,24.25,24.57001,24.13,24.3,116800,270555,37.8774436712615,50.39358525013598,NaN,NaN,-243.19043744867338,-144.08268563357495,-0.12982424903027215,-0.08997701568291916,0.03984723334735299,-1998000,-1129940,12.559089884117569,58.876535438887004,NaN,NaN,-4.889212728154912,5.592123053699565
2001-09-21T09:30:00-04:00,23.3,23.99001,23.2,23.50999,126700,276130,31.327607180170375,47.85203416142143,NaN,NaN,-291.03641894110314,-185.0161497441115,-0.20167594854869225,-0.2122477023385123,-0.010571753789820067,-2124700,-1853600,9.785446993038462,53.45331192374315,NaN,NaN,-11.2767506199528,3.1822839574635124
2001-09-24T09:30:00-04:00,24.10001,24.10001,23.52,23.83,83600,279320,36.14446667631644,46.31920484934445,NaN,NaN,-198.46271074624624,-205.9532276875027,-0.2156203440718531,-0.28009718387963645,-0.06447683980778335,-2041100,-1975320,9.409046611400441,48.54893622321146,NaN,NaN,-14.420200043656545,0.6676433858749329
2001-09-25T09:30:00-04:00,23.67999,24.08,23.67999,23.95,1107500,328595,37.903410329814605,45.56436899332673,NaN,NaN,-153.4346622533162,-215.3396124125166,-0.20481130360686417,-0.32049096931636356,-0.11567966570949939,-933600,-1795720,14.627212937849947,44.941734901625615,NaN,NaN,-16.196251036729002,-1.741484388782772
2001-09-26T09:30:00-04:00,24.2,24.37,24.03,24.36,171200,328530,43.61795352889541,45.04860562128105,NaN,NaN,-93.62559127990129,-195.94996413384806,-0.1600799878834044,-0.3157796505637549,-0.1556996626803505,-762400,-1571960,20.751884908605447,41.75367436525139,NaN,NaN,-15.674336175166406,-3.7318917868375765
2001-09-27T09:30:00-04:00,24.47,25.05,24.38,24.84,79200,328925,49.47963620266382,45.237450861028215,NaN,NaN,-29.556667579562784,-153.22321016002593,-0.09159964555635824,-0.2701992196257983,-0.17859957406944005,-683200,-1309000,27.348203911839278,39.096345453951834,NaN,NaN,-13.175803122575633,-5.081021977657299
2001-09-28T09:30:00-04:00,25.25,25.3,24.85001,25.06,86500,331950,51.94556790871243,45.55226435317038,NaN,NaN,12.874894492175915,-92.44094747337012,-0.028207544624135827,-0.21385900484960985,-0.18565146022547402,-596700,-1003400,34.20260838885876,36.56567646471257,NaN,NaN,-10.359176294281909,-5.835044022889386
2001-10-01T09:30:00-04:00,25.2,25.35001,25.03999,25.27,45200,317860,54.241543362014035,44.91008420005,NaN,NaN,37.843837599217004,-45.17963780427747,0.028098340557896728,-0.1505285345281031,-0.17862687508599984,-551500,-705480,40.1324842662193,34.107222238527804,NaN,NaN,-7.341586336502537,-6.0502643534055505
2001-10-02T09:30:00-04:00,25.09,25.48,25.06,25.45,68600,320290,56.174399627808754,45.411425754795566,NaN,NaN,56.004129804138366,-3.2918793927865453,0.07503250373185058,-0.08483624542118662,-0.1598687491530372,-482900,-615340,41.84037889205787,31.483016483212065,NaN,NaN,-4.282192489570278,-5.79768265857194
2001-10-03T09:30:00-04:00,25.28,25.3,25.10001,25.24001,92100,321760,53.3435246387964,46.08639309349723,NaN,NaN,42.20123198510846,23.873485260215396,0.08857302175718715,-0.049152471956553256,-0.1377254937137404,-575000,-577860,42.57395545949687,29.131364335193314,NaN,NaN,-2.6097254599039785,-5.342260201619374
2001-10-04T09:30:00-04:00,25.39999,25.39999,25.03999,25.14999,47800,304020,52.130692151732084,46.1264310497673,NaN,NaN,41.728135186719506,38.130445813471866,0.08792756291139107,-0.027816040074501558,-0.11574360298589263,-622800,-565780,42.82427089368813,26.708343910292736,NaN,NaN,-1.6005883852536964,-4.807735656424278
2001-10-05T09:30:00-04:00,25.14999,25.42999,25.08,25.42,83000,306985,55.405781794954905,46.4200441622595,NaN,NaN,55.76811975945952,46.70909086692859,0.10120031341256078,0.010756788779808346,-0.09044352463275243,-539800,-554400,43.076000411032815,27.06411399777956,NaN,NaN,0.23042149589999872,-4.087998920377952
2001-10-08T09:30:00-04:00,25.42,25.48,25.14,25.37,67300,306400,54.66000214782719,46.95968259772884,NaN,NaN,59.104022295726246,50.96112780623044,0.101848001795155,0.03686647761119133,-0.06498152418396368,-607100,-565520,42.8773463081578,28.459943678926972,NaN,NaN,1.5219140253100423,-3.286582785279667
2001-10-09T09:30:00-04:00,25.37,25.37,25.10001,25.24001,47600,305050,52.67489593430139,47.6376375110907,NaN,NaN,52.15521334764937,50.19134451493264,0.08921168580805586,0.04653308307610615,-0.042678602731949705,-654700,-599880,42.22929550338395,30.302658954981847,NaN,NaN,2.0704411034466674,-2.521293658318762
2001-10-10T09:30:00-04:00,25.35001,25.66,25.19,25.55,96100,308555,56.71228999265148,48.98298367690427,NaN,NaN,84.97419403984709,58.74593692588037,0.09678679404940135,0.078304889829802,-0.018481904219599363,-558600,-596600,42.318918595018964,32.42836100576052,NaN,NaN,3.701767239271906,-1.6322849586629524
2001-10-11T09:30:00-04:00,25.60001,25.60001,25.16,25.37,41800,299385,53.84002616708411,50.59101360454097,NaN,NaN,68.58300563118584,64.11691101477363,0.0851423179698864,0.08794599324275865,0.0028036752728722407,-600400,-592120,42.45024274768904,34.76156070252127,NaN,NaN,4.291218081022581,-0.7860702387078763
2001-10-12T09:30:00-04:00,25.17,25.38,25.08,25.35001,83000,290940,53.515869689518794,51.831828105484,NaN,NaN,53.19730970303183,63.602749003488086,0.07207920928323985,0.09290268687692205,0.0208234775936822,-683400,-620840,41.7933276100754,37.07472363099806,NaN,NaN,4.690936825336576,-0.003640658130097507
2001-10-15T09:30:00-04:00,25.14999,25.49001,25.14999,25.46001,36100,146440,55.11724640693369,53.06138782527821,NaN,NaN,64.47827336561355,64.67759921746556,0.06694309392662046,0.10450234500195776,0.037559251075337315,-647300,-628880,41.59925202237344,39.00129785132117,NaN,NaN,5.45722159075136,0.7764825202815393
2001-10-16T09:30:00-04:00,25.46001,25.67999,25.25999,25.32001,68300,129900,52.632058727721095,53.705252482337194,NaN,NaN,68.2812627262557,67.90280909318682,0.05093771526523411,0.10123139515687996,0.05029367989164585,-715600,-641060,41.286465818130594,40.46805363057297,NaN,NaN,5.466615835156062,1.4465015652636137
2001-10-17T09:30:00-04:00,25.5,25.50999,25.11,25.11,178100,136325,49.05864078774159,53.67518138127132,NaN,NaN,41.45952563057971,59.19987541133334,0.024374749333500166,0.08076211655852106,0.05638736722502089,-893700,-708080,39.52538224870864,41.337852083206485,NaN,NaN,4.5108079200260205,1.8842596159439575
2001-10-18T09:30:00-04:00,25.25,25.44,25.22,25.3,22400,131605,52.219345058480314,53.69473689196902,NaN,NaN,48.58098295539223,55.19947087617462,0.018059115521995857,0.07896126162751571,0.060902146105519854,-871300,-762260,38.110135988210196,41.61696119744588,NaN,NaN,4.526952256931068,2.2617871360849735
2001-10-19T09:30:00-04:00,25.45,25.60001,25.25,25.60001,25700,126555,56.77940820964625,53.87601295251419,NaN,NaN,74.93351873310064,59.54671268218838,0.03174461400725713,0.10058291361459126,0.06883829960733413,-845600,-794700,37.250112999775375,41.41107753555703,NaN,NaN,5.831428917510488,2.771735962002904
2001-10-22T09:30:00-04:00,25.52,25.95,25.52,25.85001,1901300,217440,60.18906088812819,54.16277447110843,NaN,NaN,145.91030495688332,75.83311900044234,0.0539851445208753,0.13631973025842825,0.08233458573755295,1055700,-454100,50.006591247047886,41.994378418056314,NaN,NaN,7.964128083194389,3.513506265030259
2001-10-23T09:30:00-04:00,25.89999,25.89999,25.52,25.52,54800,164805,54.11965442618428,54.21821231306471,NaN,NaN,132.58079800956727,88.69302605710466,0.04328399175577935,0.13643957543227714,0.09315558367649779,1000900,-110800,59.04409029833044,43.17081662083014,NaN,NaN,8.046690586813027,4.16110402528494
2001-10-24T09:30:00-04:00,25.5,25.71001,25.47,25.47,67200,159605,53.243614750975894,54.297706784439264,NaN,NaN,101.3769448040859,100.67650989180588,0.030267533281730777,0.13099000027866126,0.10072246699693048,933700,254680,66.07524604042248,44.831600559882595,NaN,NaN,7.862438297076052,4.689866064112242
2001-10-25T09:30:00-04:00,25.39999,25.71001,25.11,25.71001,87000,159995,56.853998233212415,54.40115081574337,NaN,NaN,73.88545384825036,105.73740407037751,0.03492100515903808,0.14437372344572807,0.10945271828669,1020700,633080,71.52572861762363,46.86372400321051,NaN,NaN,8.750080238429375,5.269896660443261
2001-10-26T09:30:00-04:00,25.48,25.81,25.48,25.62,31600,157250,55.13457594502338,54.435048944114534,NaN,NaN,121.43954530165509,115.0386093840884,0.02926500692417716,0.14603397694191145,0.11676897001773429,989100,1000020,75.6168040738921,49.20225670076296,NaN,NaN,9.004316413368423,5.803385196575427
2001-10-29T09:30:00-05:00,25.62,25.73,25.46001,25.46001,50700,157525,52.11746300676381,54.39523230643328,NaN,NaN,69.26090871479867,99.70873013567147,0.01291106833975833,0.1329078054424322,0.11999673710267386,938400,976560,74.87609833357924,51.53417118863405,NaN,NaN,8.368912858946317,6.169889148342697
2001-10-30T09:30:00-05:00,25.10001,25.32001,25.02,25.19,37600,155975,47.402873441023615,53.730273981317005,NaN,NaN,-108.00607644079113,51.591355245599786,-0.01634147782762578,0.09956988981814163,0.11591136764576741,900800,956540,74.2080633003317,53.81196723901353,NaN,NaN,6.424642930945799,6.206282545857426
2001-10-31T09:30:00-05:00,25.02,25.25999,24.89999,24.89999,43000,153520,42.912689184756594,52.949749911150754,NaN,NaN,-167.5092627370223,-2.185886262621841,-0.05338426227566989,0.04918103980118005,0.10256530207684994,857800,941360,73.6713442522739,56.042045917912446,NaN,NaN,3.348420712470098,5.798016569659236
2001-11-01T09:30:00-05:00,25.13,25.48,24.98,25.48,77200,154990,52.58596556991381,52.88332818832182,NaN,NaN,-40.216826099103514,-25.006342252092615,-0.03772365577807117,0.05541073235426097,0.09313438813233214,935000,924220,73.02907747881501,58.273170908536706,NaN,NaN,3.648729363217787,5.4909755401676
2001-11-02T09:30:00-05:00,25.14999,25.47,25.14999,25.44,87700,155225,51.93241124619055,52.65583996255446,NaN,NaN,-22.974247183495113,-53.889100749122655,-0.029332149641988922,0.05646920107984599,0.08580135072183491,847300,895860,71.91196194537586,60.43836447446545,NaN,NaN,3.6824139894158003,5.232609604345915
2001-11-05T09:30:00-05:00,25.45,25.67,25.42,25.49001,38700,153795,52.72352417325684,52.662373208664164,NaN,NaN,52.96437515059227,-57.14840746196394,-0.02012558958204326,0.06064436374428084,0.0807699533263241,886000,885380,71.4768436127024,62.59482003122058,NaN,NaN,3.943787676145029,5.048492186031503
2001-11-06T09:30:00-05:00,25.32001,25.64,25.25999,25.53999,45200,153675,53.54639124309265,52.982926812617805,NaN,NaN,26.936290120238183,-30.15993414975808,-0.010846836844569469,0.06721140727061226,0.07805824411518172,931200,891460,71.58426533542512,64.88474025170032,NaN,NaN,4.392394366022712,4.954763926030247
2001-11-07T09:30:00-05:00,25.67999,25.81,25.5,25.57001,80300,152885,54.063570317581224,53.11465718826787,NaN,NaN,88.71174640168793,21.08426767798397,-0.0032583211208773166,0.07398534271408508,0.0772436638349624,1011500,922200,72.15524790758737,67.31653396022726,NaN,NaN,4.905172104686223,4.947679380123958
2001-11-08T09:30:00-05:00,25.71001,25.71001,25.33,25.33,35600,152575,49.33450220095147,52.58287818764681,NaN,NaN,9.477522808284734,31.023137459461623,-0.014352273133513282,0.05930332241807079,0.07365559555158407,975900,930380,72.31466973987935,69.82114515594898,NaN,NaN,4.034885527320466,4.817280258294888
2001-11-09T09:30:00-05:00,25.41,25.46001,25.24001,25.39,23000,149575,50.500186655677915,51.890815742471794,NaN,NaN,-37.14485820451361,28.18901525525792,-0.01739582163177325,0.05191081851186752,0.06930664014364077,998900,960700,72.93325706302363,71.45876414280438,NaN,NaN,3.6219420029682787,4.646517650391087
2001-11-12T09:30:00-05:00,25.3,25.46001,25.09,25.42999,43300,149935,51.304348947439124,51.68972249399,NaN,NaN,-52.92726703279291,7.010686818580879,-0.016471328184627793,0.04871747991285602,0.06518880809748381,1042200,991940,73.58807103752393,72.49761990988964,NaN,NaN,3.4867099091483835,4.4808308302135575
2001-11-13T09:30:00-05:00,25.45,25.48,25.3,25.42999,28300,147935,51.304348947439124,51.551203508023086,NaN,NaN,-16.25429285426605,-1.6274297763199677,-0.015622733281329258,0.04566039149582224,0.0612831247771515,1042200,1014140,74.068181908796,73.06854390048775,NaN,NaN,3.373290867657393,4.322610835562677
2001-11-14T09:30:00-05:00,25.5,25.59,25.3,25.3,63700,142215,48.34356496372938,50.94331541734572,NaN,NaN,-24.420845307821153,-24.253948118221786,-0.023126245612342992,0.032375317761722755,0.05550156337406575,978500,1007540,73.63960524912504,73.21953508845215,NaN,NaN,2.5088061456184496,4.063495879856359
2001-11-15T09:30:00-05:00,25.75,25.75,25.45,25.45,105200,146355,51.80027611781756,50.70515114397388,NaN,NaN,47.44165359025897,-16.661121961826932,-0.01755033335123856,0.033563646685017545,0.051113980036256106,1083700,1029100,74.16548523703807,73.11586945724828,NaN,NaN,2.644285067962497,3.8607514781572356
2001-11-16T09:30:00-05:00,25.8,25.8,25.46001,25.67999,49500,147545,56.59616529120813,51.02505845000562,NaN,NaN,87.72686912941083,8.313223504957936,0.0010759860077083558,0.05245896254589155,0.051382976538183196,1133200,1055960,74.83893573271082,73.11321498575768,NaN,NaN,4.098694456497327,3.8947433322058203
2001-11-19T09:30:00-05:00,25.8,25.85001,25.56,25.75,35700,54265,57.96720081914122,51.7796532627283,NaN,NaN,126.70321327179252,44.23931956587502,0.016693623020537132,0.07225000531385461,0.05555638229331748,1168900,1081300,75.488118964861,73.20464753322405,NaN,NaN,5.71019463953033,4.154093518966464
2001-11-20T09:30:00-05:00,25.64999,25.92,25.64999,25.72,83700,55710,57.13435653594548,52.795486644956085,NaN,NaN,139.74517212983537,75.4392125626953,0.023186321185511817,0.08453928377520725,0.061352962589695435,1085200,1089900,75.7171082778901,73.35077353505379,NaN,NaN,6.8507810888849985,4.539334600383397
2001-11-21T09:30:00-05:00,25.72,26.05,25.72,26.05,49500,54825,63.36895093178566,53.565699885089785,NaN,NaN,189.5158221777755,118.22654605981464,0.04654083915187848,0.11952901152954354,0.07298817237766506,1134700,1121140,76.57325420769371,73.60392901568798,NaN,NaN,9.751042281432037,5.283864269104631
2001-11-23T09:30:00-05:00,25.85001,26.14999,25.85001,26.13,35800,52265,64.70900847655463,54.47831397297294,NaN,NaN,189.82519858492722,146.70325505874828,0.06317924473762668,0.1519622282996984,0.08878298356207173,1170500,1138500,77.05733149054376,73.9714554117714,NaN,NaN,12.579336354258034,6.326074566983689
2001-11-26T09:30:00-05:00,25.89999,26.25,25.89999,26.14999,1186300,110000,65.05303431014828,55.35899326846518,NaN,NaN,178.50563546901896,164.85900832666988,0.07076221219715337,0.17723574880851345,0.10647353661136008,2356800,1383220,82.53576821977369,74.76137859799077,NaN,NaN,15.020614994166104,7.568151770866891
2001-11-27T09:30:00-05:00,26.14999,26.2,25.82001,25.86,134600,114195,56.45525179089863,55.56676902187989,NaN,NaN,114.76282122344064,162.47092991699952,0.052328413962141676,0.17188405406403717,0.1195556401018955,2222200,1593880,85.70106067563557,75.76972112229153,NaN,NaN,14.782616908880724,8.59878964772601
2001-11-28T09:30:00-05:00,25.8,25.97,25.55,25.55,54600,115045,48.99976135950536,55.20506838201733,NaN,NaN,31.632434043886434,140.84838229980974,0.01715788268883328,0.1410029934629371,0.12384511077410382,2167600,1810360,88.08996051002744,76.90791487960868,NaN,NaN,12.21489711058567,9.115376428134532
2001-11-29T09:30:00-05:00,25.84,26.03999,25.73,26.03999,25500,114170,58.36010337187842,55.84975417994069,NaN,NaN,95.96622336237216,122.13846253672907,0.024355175349573738,0.154289079961071,0.12993390461149726,2193100,2022040,89.87181582961402,78.16199674316115,NaN,NaN,13.042434211385414,9.676384682884658
2001-11-30T09:30:00-05:00,26,26.06,25.83,26,43000,112460,57.43362642183385,56.34499987752326,NaN,NaN,93.0883905246437,102.79110092467238,0.023852909435539138,0.1597500414059212,0.13589713197038206,2150100,2217960,91.18615716692112,79.46577532201097,NaN,NaN,13.383790594282265,10.206014098798601
2001-12-03T09:30:00-05:00,26,26.07001,25.82001,25.99001,23300,109240,57.189377473177025,56.765359057933104,NaN,NaN,82.79447896412134,83.64886962369286,0.02041120329022239,0.16141113608316005,0.14099993279293765,2126800,2171960,88.28916236074672,80.51585327366975,NaN,NaN,13.578580200958134,10.687809256249963
2001-12-04T09:30:00-05:00,25.89999,26,25.75,26,40200,109315,57.38454979483269,57.19965911846121,NaN,NaN,62.49044753535481,73.19439488607568,0.016536088539660376,0.16167004346751312,0.14513395492785275,2167000,2160920,87.57009340263596,81.48027552322974,NaN,NaN,13.791819054001897,11.131239227357382
2001-12-05T09:30:00-05:00,26,26,25.75999,25.75999,86700,111390,51.32994231088404,57.412971786115115,NaN,NaN,34.5096948687072,73.76984705103985,-0.0033996434547070575,0.14088440060946894,0.144284044064176,2080300,2143460,86.37198559757559,82.38973126240478,NaN,NaN,12.159840633404183,11.278182285364068
2001-12-06T09:30:00-05:00,25.91,26,25.62,25.7,53600,110055,49.91240747298712,57.27812402577008,NaN,NaN,11.462136830191188,56.869029744603644,-0.02086059086267994,0.11820830548582606,0.139068896348506,2026700,2110180,84.01255060516435,83.0930930744138,NaN,NaN,10.397548761348753,11.152377496219023
2001-12-07T09:30:00-05:00,25.8,25.83,25.64999,25.82001,29900,109770,52.72506687902751,57.001616996328615,NaN,NaN,4.727391927371662,39.19683002514923,-0.02432033452705684,0.10866847818968495,0.1329888127167418,2056600,2091480,82.64638933398828,83.65076833164791,NaN,NaN,9.697240874855547,10.94450083602424
2001-12-10T09:30:00-05:00,25.67,25.77,25.32001,25.32001,59800,111610,42.11416236032863,55.86925710641343,NaN,NaN,-103.15840354234227,2.006253523856516,-0.05833518823520105,0.060069827422740474,0.11840501565794152,1996800,2065480,80.68189705858731,84.0217524811998,NaN,NaN,5.484192320779869,10.1644567624179
2001-12-11T09:30:00-05:00,25.44,25.59,25.05,25.05,123600,115625,37.70161163797574,54.48120389941558,NaN,NaN,-181.64538968703104,-46.82091392062065,-0.09490789593426129,-0.00022985425988508723,0.0946780416743762,1873200,2006720,76.2695396073725,84.06121186187711,NaN,NaN,0.3825324571923096,8.767039004528531
2001-12-12T09:30:00-05:00,25.14,25.14999,24.75,25.10001,125700,120495,38.976926181918806,52.73891641728223,NaN,NaN,-225.98974520170026,-98.92080193470215,-0.11052737212218221,-0.043481173478351565,0.06704619864383064,1998900,1990440,75.0449977561781,83.95205068676886,NaN,NaN,-3.2373894385191617,7.052120655521717
2001-12-13T09:30:00-05:00,25,25.25,24.84,24.85001,37800,119200,35.10780753928165,50.624544921762734,NaN,NaN,-201.7210343923025,-141.5574361792009,-0.13108899306222455,-0.09681504268395003,0.034273950378274506,1961100,1977320,74.01366564613703,83.73464598359693,NaN,NaN,-7.619138442694162,4.956226498633734
2001-12-14T09:30:00-05:00,24.84,25.17,24.75,24.75,71100,117495,33.66798271175317,48.38275552187737,NaN,NaN,-184.0118053434456,-179.30527563336435,-0.1437995907137207,-0.14547553801387636,-0.0016759473001556682,1890000,1944000,71.332521237949,82.93441405632375,NaN,NaN,-11.635838149972088,2.585931548832903
2001-12-17T09:30:00-05:00,25,25.38,25,25.38,39100,116975,48.105930938478544,47.78637546099022,NaN,NaN,-86.42528615032087,-175.95865215496005,-0.10400772741695731,-0.1316856065713523,-0.027677879154395,1929100,1930460,70.21934627683943,81.8285773135526,NaN,NaN,-10.319348579649013,0.7423201019069152
2001-12-18T09:30:00-05:00,25.00999,25.42,25.00999,25.24001,227900,126585,45.72432072187379,47.55241541544511,NaN,NaN,-80.75877941115452,-155.78133009978475,-0.0822962022800491,-0.13054813200445636,-0.04825192972440727,1701200,1896060,67.34394240438377,80.34671887743518,NaN,NaN,-10.097966254949908,-0.8062922347869164
2001-12-19T09:30:00-05:00,25.39999,25.67999,25.23,25.55,41900,124495,51.455540762244446,47.059232371899824,NaN,NaN,-26.096933314448613,-115.80276772233442,-0.04415099479517509,-0.10344067321837613,-0.05928967842320104,1743100,1844900,63.19908460234093,78.44152378977283,NaN,NaN,-7.900175953508809,-1.8197041946043295
2001-12-20T09:30:00-05:00,25.64999,25.78,25.5,25.59,69300,125485,52.15756495973529,46.68237083889279,NaN,NaN,3.626115282262992,-74.73333778742132,-0.014834610402420484,-0.07783294142622665,-0.06299833102380617,1812400,1815160,60.8543284465552,76.27496459546099,NaN,NaN,-5.968170018946315,-2.4123421695103273
2001-12-21T09:30:00-05:00,25.67,25.75999,25.52,25.75999,87200,128055,55.12746020733869,46.535091034190046,NaN,NaN,19.559054746473393,-34.01916576943752,0.0157406946035253,-0.04332246276939955,-0.05906315737292485,1899600,1817080,60.95504405526349,74.32252757364074,NaN,NaN,-3.4148150386857012,-2.555552579392524
2001-12-24T09:30:00-05:00,25.60001,25.84,25.60001,25.757,16700,69575,55.06271345896772,46.36924558162826,NaN,NaN,36.141215317185015,-9.50586547593635,0.03442720293456839,-0.01602915370471436,-0.05045635663928275,1882900,1807840,60.15294983045589,72.36416017562789,NaN,NaN,-1.4166658399354868,-2.392854473755804
2001-12-26T09:30:00-05:00,25.60001,25.95,25.60001,25.82001,34600,64575,56.22940331001627,46.71920708156629,NaN,NaN,51.93365094766521,17.032620595827602,0.048815965441916846,0.010563600163113307,-0.03825236527880354,1917500,1851100,62.63215795067931,70.66845820084959,NaN,NaN,0.5695374900670397,-1.9696556217811123
2001-12-27T09:30:00-05:00,25.72,25.72,25.53999,25.66,24800,63085,52.501676510596276,46.90415486996694,NaN,NaN,18.71291400054039,25.994590058825402,0.04541282457689628,0.018513665442316807,-0.02689915913457947,1892700,1881020,64.2871688090208,69.25950235826791,NaN,NaN,1.2100396956888135,-1.515413433571123
2001-12-28T09:30:00-05:00,25.8,25.84,25.55,25.55,17500,62685,50.04541210835536,46.712750957776066,NaN,NaN,24.50180863169223,30.16972872871125,0.03412447798633021,0.01575643834833329,-0.01836803963799692,1875200,1893580,64.98818838455405,67.99820229045118,NaN,NaN,1.0521215395773762,-1.1486227231213375
2001-12-31T09:30:00-05:00,25.39999,25.64999,25.39999,25.39999,45400,62805,46.82790939989339,47.04944717488784,NaN,NaN,-9.023092190610672,24.453299341294436,0.015854469672850056,0.0014500474530656504,-0.014404422219784404,1829800,1879620,63.496305325156456,66.77066002377755,NaN,NaN,-0.00858850592439002,-0.9857606920932022
2002-01-02T09:30:00-05:00,25.2,25.37,24.92,25.31,412500,82265,44.96047949343897,47.56793773599235,NaN,NaN,-72.02446506045547,2.8201632657663382,-0.002039564286817293,-0.01695387757830602,-0.014914313291488727,1417300,1786500,54.50755556192236,65.21623259195967,NaN,NaN,-1.433246869802964,-1.0496872889088824
2002-01-03T09:30:00-05:00,25.16,25.32001,25.03,25.23,146200,87565,43.3070761101666,47.87723415943862,NaN,NaN,-64.78503850792792,-20.52357462535229,-0.018117722935581875,-0.03756146696096607,-0.019443744025384197,1271100,1657220,44.98612001822969,63.069169896391934,NaN,NaN,-3.1006045102782243,-1.342675463390217
2002-01-04T09:30:00-05:00,25.28,25.28,24.89999,25.16,76200,87040,41.85661939451768,48.35929214909834,NaN,NaN,-75.88237463356646,-39.44263235217365,-0.031535411880972294,-0.058863008876599565,-0.02732759699562727,1194900,1517660,37.39256297024326,60.4533768481138,NaN,NaN,-4.914136641581268,-1.8528842031317958
2002-01-07T09:30:00-05:00,25,25.13,24.86,24.97,173700,93045,38.124227741697545,48.677595365522926,NaN,NaN,-97.2334783559436,-63.78968974970083,-0.050168436607437514,-0.09003814275492417,-0.03986970614748665,1021200,1346860,30.58762631040331,57.54302721043196,NaN,NaN,-7.596530100480084,-2.6734050456101226
2002-01-08T09:30:00-05:00,24.82001,24.98,24.8,24.84,66000,94850,35.77372044337987,47.796723187301595,NaN,NaN,-114.46736955075174,-84.87854522172904,-0.06715015497374707,-0.12380739986467049,-0.05665724489092342,955200,1171940,25.474556022419264,54.34697076368767,NaN,NaN,-10.59117555387714,-3.8045151182196966
2002-01-09T09:30:00-05:00,24.89999,25.17999,24.84,24.92999,528500,118285,38.595955047996036,47.28755421059604,NaN,NaN,-78.9236926002169,-86.25839072968132,-0.06801436011739212,-0.14167519503766357,-0.07366083492027145,1483700,1185220,26.47937645713145,51.428073196026794,NaN,NaN,-12.359697035779538,-5.026683963585389
2002-01-10T09:30:00-05:00,24.89999,25.08,24.81,24.97,41100,114160,39.86125556927331,46.45939098252667,NaN,NaN,-79.65471584024297,-89.23232619614433,-0.061765705512542346,-0.15086796681094938,-0.08910226129840704,1524800,1235960,30.343766421645824,49.08126475454857,NaN,NaN,-13.501713454711647,-6.237402462317711
2002-01-11T09:30:00-05:00,25.05,25.27,25.00999,25.03,41100,109930,41.79812810522018,45.719431207204174,NaN,NaN,-45.717643694836774,-83.19938000839839,-0.0499699213796279,-0.15156466302294191,-0.10159474164331402,1565900,1310160,35.66890408599055,47.28230587165109,NaN,NaN,-13.96195909441816,-7.340910552617775
2002-01-14T09:30:00-05:00,25.11,25.35001,24.14,25.23,49800,110530,47.829736578209285,45.19816523369492,NaN,NaN,-91.55958789836308,-82.0646019168823,-0.026267293926963683,-0.13442885905201862,-0.10816156512505494,1615700,1429060,43.1667418427168,46.011712856469195,NaN,NaN,-12.68434233166619,-8.10425794962469
2002-01-15T09:30:00-05:00,25.42,25.42999,25.00999,25.25999,49100,109430,48.688438771713244,44.742859898891034,NaN,NaN,-18.170888700229387,-62.80530574677782,-0.007133991202627671,-0.11707905412833952,-0.10994506292571185,1664800,1570980,50.57191628440361,45.32735331746546,NaN,NaN,-11.381749060681273,-8.572470965489916
2002-01-16T09:30:00-05:00,25.35001,25.37,25.02,25.02,125700,113760,42.64006326033983,43.77219275248558,NaN,NaN,-40.39153224892718,-55.09887367651987,-0.009080885109053291,-0.12129616931202847,-0.11221528420297518,1539100,1582060,51.10753471999211,44.50416594384494,NaN,NaN,-11.915140368006194,-9.049995165849385
2002-01-17T09:30:00-05:00,25.23,25.27,25.03,25.25,51600,104945,49.15859540504183,43.53340124494598,NaN,NaN,-28.14810265234534,-44.79755103894034,0.0058759825149993505,-0.10487030605922598,-0.11074628857422533,1590700,1595240,51.7769517181192,43.61057900878053,NaN,NaN,-10.402412713789392,-9.243197672697958
2002-01-18T09:30:00-05:00,25.06,25.33,25.00999,25.14999,37100,104705,46.67475618452865,43.29264010752978,NaN,NaN,-29.93760830349584,-41.64154396067215,0.009569876880964515,-0.09878394247301969,-0.10835381935398421,1553600,1592780,51.634849095824094,42.65676905958554,NaN,NaN,-9.875091249764417,-9.333468183707453
2002-01-22T09:30:00-05:00,25.23,25.42999,25.07001,25.42999,89300,105705,53.72451531473051,43.785254815732436,NaN,NaN,12.211180963597258,-20.887390188280087,0.03024025650442562,-0.07055349872345218,-0.1007937552278778,1642900,1598220,51.94891248357015,41.83195528518653,NaN,NaN,-7.139411340181215,-9.020031491775132
2002-01-23T09:30:00-05:00,25.38,25.58,25.31,25.52,80200,105355,55.749746497303256,44.55591674457988,NaN,NaN,62.65264429317622,-4.722683589598958,0.04827395113180291,-0.04045131631312415,-0.08872526744492706,1723100,1609880,52.658508283529436,41.69988047958703,NaN,NaN,-4.261931600366406,-8.340302935859599
2002-01-24T09:30:00-05:00,25.5,25.5,25.13,25.14999,2455900,227315,46.70154504326035,44.79837881122943,NaN,NaN,9.589039252191037,5.273430710624685,0.03424223880422679,-0.04592246893964358,-0.08016470774387037,-732800,1155500,32.510365862302706,40.808755182735105,NaN,NaN,-4.6481639970486075,-7.812854516029457
2002-01-25T09:30:00-05:00,25.10001,25.31,25.09,25.10001,46400,227905,45.62437621322787,45.06750429828016,NaN,NaN,-13.675263676481672,8.167998505797422,0.021193638116808577,-0.05367266009785965,-0.07486629821466823,-779200,681520,22.73729969931047,39.76195066338276,NaN,NaN,-5.297568300034306,-7.453527913744436
2002-01-28T09:30:00-05:00,25.14999,25.23,25.00999,25.10001,48700,229100,45.624376213227876,45.603229189103764,NaN,NaN,-28.602134137296353,8.435093339037298,0.012586564218533922,-0.05913309294150082,-0.07171965716003474,-779200,214960,17.24260055245628,38.80873453781511,NaN,NaN,-5.811450917772041,-7.21894548574838
2002-01-29T09:30:00-05:00,25.23,25.28,24.71001,24.78999,50700,230760,39.131439366796215,45.84306625506207,NaN,NaN,-109.78331028123577,-15.963804909929308,-0.012598889161321805,-0.087468268611687,-0.07486937945036519,-829900,-279600,13.514408723535183,37.95443830218054,NaN,NaN,-8.365433259662307,-7.382729453450369
2002-01-30T09:30:00-05:00,24.89999,25.13,24.82001,25.09,73300,232155,46.99299051864117,46.442854502965304,NaN,NaN,-57.560511163870345,-40.00643600133863,-0.007895681664908782,-0.08473898153150117,-0.07684329986659238,-756600,-775540,10.956131747407568,36.845635108628834,NaN,NaN,-7.987113627092936,-7.469070049685022
2002-01-31T09:30:00-05:00,25.16,25.28,25.00999,25.23,74000,215230,50.22381809748914,47.183037540695004,NaN,NaN,34.61740360075289,-35.00076313162625,0.005101140988708286,-0.07046687363070703,-0.07556801461941531,-682600,-765500,11.32210986837255,35.4869453548236,NaN,NaN,-6.615434203586385,-7.347122071670931
2002-02-01T09:30:00-05:00,25.50999,25.50999,25.25,25.25,43700,210105,50.686236669453635,47.81790243814026,NaN,NaN,117.25388914634463,-8.814932567060989,0.014945179838805528,-0.05688653982090841,-0.07183171965971394,-638900,-737440,12.405701348183115,33.825288016408784,NaN,NaN,-5.390505216509468,-7.067605378076436
2002-02-04T09:30:00-05:00,25.25,25.39,24.92999,24.98,71700,209880,44.65505062666662,47.59113915588721,NaN,NaN,-10.60296085053426,-5.215097909708571,0.0037558885023382532,-0.06713685903179112,-0.07089274753412937,-710600,-723720,12.965706171907087,31.668071182779517,NaN,NaN,-6.240552727715947,-6.9494549994535095
2002-02-05T09:30:00-05:00,25.14999,25.39999,25.03,25.27,307000,216545,51.35090989564347,47.781315664739374,NaN,NaN,55.61616557177569,27.86479726089372,0.015699205737787686,-0.05126874036189477,-0.06696794609968246,-403600,-638460,16.536686445145634,29.236983337118236,NaN,NaN,-4.746756739028334,-6.63478381939277
2002-02-06T09:30:00-05:00,25.21001,25.21001,24.84,25.14999,190300,222760,48.72382665780871,48.21587019313,NaN,NaN,-44.90955244541011,30.394989004585767,0.015313843440758285,-0.04782564179873461,-0.06313948523949289,-593900,-605920,17.920848072616366,26.866505719448533,NaN,NaN,-4.384909026555737,-6.313373134701766
2002-02-07T09:30:00-05:00,25,25.09,24.8,24.88,246000,208635,43.35059374063531,47.80101293138669,NaN,NaN,-125.55956759393861,-1.6404052343525308,-0.0023849715788711867,-0.06612069971308188,-0.06373572813421069,-839900,-637380,17.616661082856055,24.426484959786883,NaN,NaN,-5.862808838095492,-6.249006806615155
2002-02-08T09:30:00-05:00,24.67999,25.06,24.62,24.94,32900,208225,44.80727446371507,47.66762137989999,NaN,NaN,-146.98245766484897,-54.48767459659125,-0.008943095502625467,-0.07491459751249252,-0.06597150200986705,-807000,-671000,17.279119441454768,21.97250427018908,NaN,NaN,-6.5784243922274594,-6.296066461702627
2002-02-11T09:30:00-05:00,25.2,25.34,25.06,25.34,160000,214170,53.40864699120994,47.645059356791386,NaN,NaN,57.452247194602535,-40.876632987563895,0.013543726435990278,-0.049041843964879206,-0.06258557040086948,-647000,-658280,17.919909361727946,19.54186119005749,NaN,NaN,-4.30057445109825,-6.01099617447343
2002-02-12T09:30:00-05:00,25.27,25.45,25.17,25.33,31200,213240,53.18549344056801,47.461898424167444,NaN,NaN,89.83495364522645,-34.03287537287374,0.02686045032589237,-0.02901000749350402,-0.05587045781939639,-678200,-713200,17.296896780198878,17.016031796962448,NaN,NaN,-2.6063090243349696,-5.524612295882221
2002-02-13T09:30:00-05:00,25.49001,25.57001,25.39,25.49001,139900,217780,56.32969419124825,48.14962336330944,NaN,NaN,162.3937337686884,7.42778186994596,0.044519870368069654,-0.00022061985930932337,-0.04474049022737898,-538300,-702080,17.91914238265575,15.973801548416237,NaN,NaN,-0.19760509907024412,-4.763611267766224
2002-02-14T09:30:00-05:00,25.5,25.67,25.39999,25.49001,58300,214410,56.32969419124825,48.91428893316804,NaN,NaN,151.91091266429584,62.92187792159285,0.0536625380695933,0.022337682359612643,-0.031324855709980656,-538300,-641760,21.374893873470555,15.876486846570527,NaN,NaN,1.7165177121997433,-3.8378785563425146
2002-02-15T09:30:00-05:00,25.56,25.69,25.5,25.5,53300,214495,56.541041567248456,49.69405074416951,NaN,NaN,145.06583850931574,121.3315371564258,0.057503027334909876,0.040553928458656685,-0.016949098876253187,-485000,-577360,25.005181973666552,16.430956948085548,NaN,NaN,3.335518413895814,-2.813107560594182
2002-02-19T09:30:00-05:00,25.42,25.59,25.17999,25.17999,211800,223230,48.45187209714568,50.35979593919448,NaN,NaN,39.27755871441336,117.69659946038796,0.03662799899249186,0.028835899864361636,-0.007792099128130222,-696800,-587320,24.814354463642402,17.238095929521776,NaN,NaN,2.404987587799028,-2.0676653965380094
2002-02-20T09:30:00-05:00,25.48,25.73,25.28,25.69,170300,227280,58.61416440661142,51.189879788335205,NaN,NaN,127.28461695442556,125.18653212222777,0.05424252121589909,0.06001105239174365,0.005768531175844553,-526500,-556980,26.650673003150843,18.3591345906463,NaN,NaN,4.979216577969018,-1.0609679716084341
2002-02-21T09:30:00-05:00,25.73,25.97,25.37,25.37,93800,227960,51.72403816728847,51.29703836474944,NaN,NaN,123.12007717741909,117.33180080397392,0.04196523688260771,0.0582250772791042,0.016259840396496483,-620300,-573380,26.27707625929584,19.42734647571225,NaN,NaN,4.754274018530472,-0.23021911587430477
2002-02-22T09:30:00-05:00,25.55,25.89999,25.5,25.78999,104100,110370,58.60224248211592,51.862467351368174,NaN,NaN,152.5407155294321,117.45776137700118,0.05872472861698602,0.08966575116772901,0.030941022550742988,-516200,-568960,26.575818833136566,20.439497724637494,NaN,NaN,7.07689028134252,0.81365365515667
2002-02-25T09:30:00-05:00,25.92999,25.95,25.7,25.83,257500,120925,59.19863625607197,52.901294896325695,NaN,NaN,155.45844697254927,119.53628306964788,0.0684220673715394,0.11646860676516724,0.04804653939362784,-258700,-523700,29.716507350681766,21.6359835231214,NaN,NaN,9.042711806588184,1.9892333910754574
2002-02-26T09:30:00-05:00,25.95,25.95,25.64999,25.82001,90700,123025,58.9701971329551,53.44552969899081,NaN,NaN,130.52401629723158,137.78557458621154,0.0698378040105865,0.13534379440686095,0.06550599039627446,-349400,-454220,34.3583976456094,22.908962894583095,NaN,NaN,10.494986890268605,3.2043410338173355
2002-02-27T09:30:00-05:00,25.95,26.10001,25.75,25.85001,1063300,173655,59.47591977554513,54.2135363502577,NaN,NaN,135.7635808180486,139.48136735893613,0.06838147152491045,0.1509828298024125,0.08260135827750206,713900,-206140,47.652380174728066,25.032643759019646,NaN,NaN,11.808931156370896,4.433568194182129
2002-02-28T09:30:00-05:00,25.82001,26.07001,25.75999,25.75999,884000,214190,57.197708305072474,55.202615962003215,NaN,NaN,112.52270333189915,137.36189258983217,0.05738607389130708,0.1543339506416359,0.09694787675032883,-170100,-116100,51.49224160367653,27.452328081935395,NaN,NaN,12.24353105052237,5.5492771736593065
2002-03-01T09:30:00-05:00,25.92,26.36,25.78,26.25,208600,220920,65.04637235953489,56.648265811704626,NaN,NaN,157.19788087328394,138.29332565860253,0.07787353701212295,0.19428979801548252,0.11641626100335957,38500,-5160,55.79482308775511,30.203449770956848,NaN,NaN,15.210303524590824,6.929423795220952
2002-03-04T09:30:00-05:00,26.33,26.33,26.05,26.25999,350800,236275,65.18653144075483,57.48954327238641,NaN,NaN,153.061537232897,137.81394371067208,0.08620861612991665,0.22417703116575538,0.13796841503583873,389300,124440,60.23242674908066,33.22577244148204,NaN,NaN,17.586311975333437,8.451836392379878
2002-03-05T09:30:00-05:00,26,26.2,25.75999,25.8,209200,243150,54.3748208664654,57.57449523137908,NaN,NaN,81.40322259897195,127.98978497102014,0.05630036524960125,0.2083438715978403,0.15204350634823904,180100,230340,63.46029675340112,36.52315815385363,NaN,NaN,16.186684228016436,9.556814654613671
2002-03-06T09:30:00-05:00,25.88,26.16,25.85001,26.00999,269100,241255,57.81462239917992,57.68056153194562,NaN,NaN,90.09427664571592,118.85592413655361,0.046618014438842975,0.21031602439679276,0.16369800995794978,449200,177400,60.80332500976187,39.586314055789785,NaN,NaN,16.155527816621138,10.49948796347188
2002-03-07T09:30:00-05:00,26.05,26.05,25.8,26,3059000,384690,57.59216657643984,57.77073813088788,NaN,NaN,70.09333907635938,110.37005128544565,0.03597556920833639,0.20866747146837028,0.1726919022600339,-2609800,-310540,42.953018016352175,41.12760863742419,NaN,NaN,16.06245815299972,11.294197990547286
2002-03-08T09:30:00-05:00,25.97,26.08,25.78,25.91,100700,377425,55.51957411160433,57.69777616977044,NaN,NaN,58.08133612278304,90.54674233534548,0.020101203079059576,0.19781840610885837,0.1777172030297988,-2710500,-860340,31.670686920776333,41.60371613364631,NaN,NaN,15.366151299960718,11.875905606177776
2002-03-11T09:30:00-05:00,25.89999,25.95,25.71001,25.91,513700,401465,55.519574111604335,58.20261202794605,NaN,NaN,35.02786461807424,66.94000781238093,0.0074775058289431595,0.18706408531597774,0.17958657948703458,-2710500,-1480300,24.011695258108375,41.54638333325102,NaN,NaN,14.803846358126641,12.294182856456185
2002-03-12T09:30:00-05:00,25.86,26.05,25.75,25.89999,47000,395815,55.26303936339129,57.96324595343034,NaN,NaN,42.28041400844898,59.115446094276344,-0.003102837637258715,0.17570803244046118,0.1788108700777199,-2757500,-2067820,19.258547530182994,41.01837437089618,NaN,NaN,14.270582062957324,12.576525600242062
2002-03-13T09:30:00-05:00,26.00999,26.17999,26.00999,26.10001,108900,399700,59.309006882493534,58.505029433087834,NaN,NaN,101.54231155689646,61.405053076512424,0.0015628884758815964,0.1807644806725719,0.1792015921966903,-2648600,-2687380,15.723780063060843,40.264567499736536,NaN,NaN,14.910935779823117,12.910012768753642
2002-03-14T09:30:00-05:00,26.14,26.22,26.03,26.03,224000,403905,57.35381421524092,58.41585598545391,NaN,NaN,94.6213581405627,66.3106568893531,-0.0016962753363511385,0.17708124802625136,0.1787775233626025,-2872600,-2739940,15.464464328453104,39.470899320830576,NaN,NaN,14.920047378349855,13.19716057012453
2002-03-15T09:30:00-05:00,26.25999,26.45,26.24001,26.42999,55300,403755,64.54527020947796,58.7977584106972,NaN,NaN,180.28883822364327,90.75215730952513,0.02024641227828483,0.20408553871045854,0.1838391264321737,-2817300,-2761300,15.353645388910735,38.4449806092755,NaN,NaN,17.11703577560422,13.757142742335914
2002-03-18T09:30:00-05:00,26.35001,26.45,26.2,26.35001,41200,403150,62.283609993208685,59.03443075785817,NaN,NaN,149.2362893162716,113.59384224916462,0.02615815041137798,0.21653681444639616,0.19037866403501819,-2858500,-2790900,15.191185585156077,37.075894033528826,NaN,NaN,18.26344510991489,14.400900223418624
2002-03-19T09:30:00-05:00,26.3,26.5,26.3,26.45,67700,395945,63.982765587692406,59.356348315868686,NaN,NaN,157.64815795128948,136.6673910377327,0.03313774214015114,0.2318008417102071,0.19866309957005596,-2790800,-2797560,15.152336461613118,34.75446233973491,NaN,NaN,19.721356012041895,15.16096533607909
2002-03-20T09:30:00-05:00,26.39999,26.39999,25.92999,25.92999,220000,398430,51.09159624036057,58.92019745410356,NaN,NaN,33.047691747388,122.96846707583101,0.0007782828989171819,0.19963595319370242,0.19885767029478524,-3010800,-2870000,14.711640022422557,32.12727651250248,NaN,NaN,16.853953989541434,15.402820858002283
2002-03-21T09:30:00-05:00,26.10001,26.17999,25.89999,26.13,120300,399755,54.8588639889713,58.19251828477758,NaN,NaN,18.937649894172427,107.83172542655295,-0.008593574603517562,0.1881157020403883,0.19670927664390586,-2890500,-2873580,14.688902739821373,29.19113934479293,NaN,NaN,15.706844991238208,15.446252877035986
2002-03-22T09:30:00-05:00,26.14999,26.34,26.08,26.16,59700,397535,55.41361674923322,57.49445294966889,NaN,NaN,63.46519009222066,84.46699580026844,-0.013896014954205477,0.17933925795114902,0.1932352729053545,-2830800,-2876280,14.670487074063743,25.936715082291723,NaN,NaN,14.973415388370533,15.378704664369494
2002-03-25T09:30:00-05:00,26.14999,26.25999,25.89999,25.89999,71300,388225,49.711485510248586,57.161357567081986,NaN,NaN,-17.56424167761581,51.10688960149095,-0.034845949641643614,0.14967783585329997,0.18452378549494358,-2902100,-2885000,14.60679426761915,22.447179190450154,NaN,NaN,12.510993315892302,14.969031614587038
2002-03-26T09:30:00-05:00,25.98,26.13,25.95,26.10001,193500,393365,53.66176861120873,56.86472515365546,NaN,NaN,-5.281860000199281,18.52088601119319,-0.03506773958869566,0.140689111009074,0.17575685059776966,-2708600,-2868560,15.352946953730608,19.20072361501935,NaN,NaN,11.68595757323402,14.500021037250892
2002-03-27T09:30:00-05:00,26.02,26.13,25.95,26.02,76200,344010,51.90535376157697,56.45852423830812,NaN,NaN,-23.406562038912863,7.230035253933011,-0.04007683731471007,0.12566080395438206,0.16573764126909213,-2784800,-2823360,17.487684404829793,17.381771214196323,NaN,NaN,10.476870390736321,13.925285230605954
2002-03-28T09:30:00-05:00,26.00999,26.14,26,26.10001,152900,307455,53.542919397837025,56.31733461589617,NaN,NaN,-4.548876600245368,2.532729955049448,-0.037520495848027524,0.11883702145905772,0.15635751730708525,-2631900,-2771640,19.97462332009809,16.546338099862165,NaN,NaN,9.9656797748405,13.359627308353748
2002-04-01T09:30:00-05:00,25.98,26.09,25.88,26.05,33900,298720,52.34325444756609,56.09045463989344,NaN,NaN,-43.35193067883712,-18.830694199162103,-0.03856834715602647,0.10814708336205214,0.14671543051807862,-2665800,-2738640,21.598345333471215,16.373955962388084,NaN,NaN,9.201610388521726,12.765624891234888
2002-04-02T09:30:00-05:00,25.95,26,25.87,25.87,33600,282860,48.16061630807273,55.58313870737068,NaN,NaN,-89.40673273776947,-33.19919241119284,-0.050028059628243804,0.08418035598277385,0.13420841561101765,-2699400,-2698100,23.64789962950907,16.687481112339945,NaN,NaN,7.313590950795781,11.986762899743587
2002-04-03T09:30:00-05:00,26.07001,26.07001,25.69,25.89,104600,277630,48.6515905870516,54.82189468626768,NaN,NaN,-104.32346381011055,-53.007513173175084,-0.05453543107178471,0.06603912677128676,0.12057455784307147,-2594800,-2675340,24.835903451605503,17.338347068664564,NaN,NaN,5.8998254736007425,11.11720041029461
2002-04-04T09:30:00-05:00,25.46001,25.64,25.42999,25.59,98600,269105,42.19586904306007,53.7391843168262,NaN,NaN,-235.86763168475858,-95.49972710234424,-0.07474628113148522,0.02714170642871494,0.10188798756020016,-2693400,-2657060,25.834040296305375,18.079031066368298,NaN,NaN,2.655200301738694,9.908343251929479
2002-04-05T09:30:00-05:00,25.7,25.7,25.25999,25.38,439100,138110,38.35883318565456,51.868724529410244,NaN,NaN,-230.0675960501668,-140.6034709923285,-0.09782632956598135,-0.020394924397276526,0.07743140516870482,-3132500,-2757180,23.957529730215015,18.69359423360432,NaN,NaN,-1.3564651810001014,8.29908490436811
2002-04-08T09:30:00-04:00,25.3,25.50999,25.3,25.46001,156500,140900,40.57599553814581,50.318180639762886,NaN,NaN,-192.70311660372718,-170.47370817730652,-0.10276411500220649,-0.05102373858405329,0.0517403764181532,-2976000,-2819220,22.849938888741576,19.240648041003283,NaN,NaN,-4.0163741347477435,6.539733613065845
2002-04-09T09:30:00-04:00,25.58,25.58,25.42999,25.44,35500,116990,40.186684849666165,48.618460587046734,NaN,NaN,-147.81355782609464,-182.15507319497155,-0.10222065712319546,-0.07603544498584114,0.026185212137354325,-3011500,-2881640,21.759926574525423,19.712618763354158,NaN,NaN,-6.297756668701189,4.705806429956269
2002-04-10T09:30:00-04:00,25.47,25.87,25.47,25.86,98300,119555,50.84687925753673,48.60098080255932,NaN,NaN,-66.61843272668973,-174.6140669782874,-0.06995675927245598,-0.061260736953215655,0.00869602231924033,-2913200,-2945320,20.676291670852294,20.138665309670568,NaN,NaN,-5.115881696014189,3.3027081262462037
2002-04-11T09:30:00-04:00,26,26,25.50999,25.50999,41200,116170,43.83542203367175,47.81359209146649,NaN,NaN,-73.888287050013,-142.21819805133828,-0.06848322472443874,-0.07690800858630809,-0.008424783861869352,-2954400,-2997520,19.80559749404989,20.504143506401174,NaN,NaN,-6.399470506114804,1.9166826073374883
2002-04-12T09:30:00-04:00,25.53999,25.75999,25.5,25.64999,27200,106330,46.984470572939514,47.211510221731224,NaN,NaN,-74.56084311583669,-111.11684746447227,-0.054958357932838486,-0.07712273127791747,-0.022164373345078977,-2927200,-2956460,22.567752093655074,21.068233864943416,NaN,NaN,-6.412115408388389,0.7268543193766488
2002-04-15T09:30:00-04:00,25.72,25.72,25.52,25.63,108200,108975,46.582853299578815,46.98803649239767,NaN,NaN,-69.5208680202503,-86.48039774777688,-0.0446738722495883,-0.07800671365706435,-0.033332841407476055,-3035400,-2968340,22.328123667954173,21.619757393538777,NaN,NaN,-6.544575596085482,-0.31192138283222715
2002-04-16T09:30:00-04:00,25.7,25.91,25.67,25.89999,19400,107885,52.48981718314478,46.90432567610738,NaN,NaN,-9.038395955500583,-58.72536537365805,-0.018351857456965173,-0.05627266322868252,-0.037920805771717345,-3016000,-2969240,22.308797891429037,22.116603889088662,NaN,NaN,-4.775669972550121,-0.9495997527919262
2002-04-17T09:30:00-04:00,25.85001,25.85001,25.50999,25.52,289200,118960,44.95502847202943,46.40787386971114,NaN,NaN,-59.03981975841705,-57.20964278000351,-0.02479605116051161,-0.06891586972235686,-0.04411981856184525,-3305200,-3047640,20.63341500726402,22.34129893211968,NaN,NaN,-5.72319450823374,-1.6315418607121852
2002-04-18T09:30:00-04:00,25.67,25.8,25.5,25.78,218000,118860,50.22044674942884,46.17055439482483,NaN,NaN,-33.597667416002515,-49.151518853201424,-0.01054047239706006,-0.05729540905817032,-0.04675493666111026,-3087200,-3074200,20.083156742172292,22.349051319410695,NaN,NaN,-4.721872584457968,-2.073017678390154
2002-04-19T09:30:00-04:00,25.85001,25.86,25.72,25.83,145000,120095,51.187450277435126,46.0879969541012,NaN,NaN,5.999290326194247,-33.039492164795234,0.0025643361994673528,-0.04354951641177607,-0.04611385261124342,-2942200,-3077200,20.01821876448882,22.23618513591195,NaN,NaN,-3.625368436156662,-2.294782072356798
2002-04-22T09:30:00-04:00,25.8,25.88,25.63,25.67999,79600,121090,48.16444756170926,46.08827061507524,NaN,NaN,-12.282152491454973,-21.591749059036164,0.0014908730471045323,-0.04425026130236276,-0.04574113434946729,-3021800,-3074480,20.269940780406444,21.99490236097605,NaN,NaN,-3.6635191645403187,-2.4903159426687296
2002-04-23T09:30:00-04:00,25.69,25.7,25.42,25.47,33600,119205,44.226909884893026,45.77222199349247,NaN,NaN,-81.43978399559619,-36.07202666705528,-0.012244164923460824,-0.06104634050379332,-0.048802175580332494,-3055400,-3082360,20.072843323438775,21.65468378039271,NaN,NaN,-4.939500917478966,-2.8401995104987634
2002-04-24T09:30:00-04:00,25.61,25.64999,25.36,25.36,57000,112380,42.277143708305886,45.77802732672432,NaN,NaN,-102.13147435198935,-44.690357585769746,-0.026786184174388175,-0.08228490579831771,-0.055498721623929534,-3112400,-3043800,23.96881500425836,21.52145340238935,NaN,NaN,-6.587566224151218,-3.375537612449114
2002-04-25T09:30:00-04:00,25.42,25.60001,25.35001,25.44,46300,110885,44.20370694034828,46.19551830920245,NaN,NaN,-92.54116710692963,-56.47905752395517,-0.028885279721962587,-0.09160532127638277,-0.06272004155442018,-3066100,-3039580,24.403110637340546,21.55328061004118,NaN,NaN,-7.370931538893954,-3.9463081733698053
2002-04-26T09:30:00-04:00,25.5,25.5,25.23,25.28,259500,116215,41.2391497289364,46.24288646568749,NaN,NaN,-137.25653392830674,-85.13022237485536,-0.03832575761543411,-0.11062723857371282,-0.07230148095827871,-3325600,-3116260,21.949667557581876,21.488975514958344,NaN,NaN,-8.921902345393665,-4.657107340801785
2002-04-29T09:30:00-04:00,25.17999,25.19,24.96001,25.02,364500,132745,36.90749561557392,46.00865866325233,NaN,NaN,-223.8857967939832,-127.450951235361,-0.058167200513934064,-0.1450104816006963,-0.08684328108676223,-3690100,-3249920,18.46484614167386,21.253612626897517,NaN,NaN,-11.630715569130173,-5.65333708770584
2002-04-30T09:30:00-04:00,24.96001,25.21001,24.89999,25.13,510700,156600,39.789029406005994,45.21881224528585,NaN,NaN,-185.45442212691663,-148.25387886162508,-0.059742535125714785,-0.16152144999390572,-0.10177891486819093,-3179400,-3274720,17.897079776008795,21.055097491551553,NaN,NaN,-13.012927893213316,-6.704707202778337
2002-05-01T09:30:00-04:00,25.17,25.5,25.10001,25.49001,70900,154915,48.137484084037844,45.526102391740565,NaN,NaN,-66.813874856711,-141.1903589625694,-0.033695225839960916,-0.14389794716814208,-0.11020272132818117,-3108500,-3273940,17.982499488130998,20.924876205414495,NaN,NaN,-11.579038680081274,-7.4010402709644705
2002-05-02T09:30:00-04:00,25.44,25.56,25.42,25.49001,26400,151305,48.137484084037844,45.60846049967616,NaN,NaN,-13.76594495778827,-125.43531453274116,-0.014598220408132911,-0.1284504968383473,-0.1138522764302144,-3108500,-3282420,17.766089511577817,20.58190030669469,NaN,NaN,-10.449387995764873,-7.836518517364528
2002-05-03T09:30:00-04:00,25.49001,25.5,25.13,25.25,202700,139485,43.47658181061698,45.38658396475032,NaN,NaN,-86.62202742495134,-115.30841323207005,-0.01614223255888088,-0.1340300671288155,-0.11788783456993461,-3311200,-3279540,18.126462387928456,20.28178164383571,NaN,NaN,-10.889628201127211,-8.27267704361634
2002-05-06T09:30:00-04:00,25.25,25.35001,25.07001,25.07001,142600,138790,40.3234103451922,44.517554904896556,NaN,NaN,-122.79222791234169,-95.08969945574177,-0.02667556738354332,-0.15123229379936376,-0.12455672641582044,-3453800,-3232280,24.011320092594445,20.40339037249038,NaN,NaN,-12.234827576520809,-8.838698548316978
2002-05-07T09:30:00-04:00,25.13,25.13,24.72,24.72,51500,139590,35.0065179706242,43.806947011939045,NaN,NaN,-188.4287455629802,-95.68456414295449,-0.0530805408793793,-0.19090740251504457,-0.13782686163566527,-3505300,-3297460,21.695198475602865,20.479232048800302,NaN,NaN,-15.175324448248551,-9.743930819735775
2002-05-08T09:30:00-04:00,24.81,25.19,24.73,25.17,143500,141850,45.040242359590444,43.43693241266487,NaN,NaN,-117.19597899004394,-105.76098496962106,-0.036873607146243076,-0.18391887056846912,-0.14704526342222604,-3361800,-3348120,20.074419374514378,20.47860795111045,NaN,NaN,-14.311201065708273,-10.396397997731846
2002-05-09T09:30:00-04:00,25.14999,25.17999,24.91,24.91,61100,142845,41.09290102619367,42.71589318043335,NaN,NaN,-109.7958962289723,-124.96697522385789,-0.04003444863988265,-0.19708832422207934,-0.1570538755821967,-3422900,-3411000,18.25179255876631,20.352434650701703,NaN,NaN,-14.96440032017165,-11.04896975808039
2002-05-10T09:30:00-04:00,25.02,25.10001,24.78999,24.86,54400,144205,40.36034611366173,42.15845736271567,NaN,NaN,-116.66726036461726,-130.97602181179107,-0.041675983887074386,-0.20914885544103967,-0.16747287155396529,-3477300,-3444220,17.35527648972267,20.144244344224287,NaN,NaN,-15.709858692385653,-11.714811034409713
2002-05-13T09:30:00-04:00,24.89,25.11,24.86,25.11,65600,142075,45.5837837192369,42.255376922311655,NaN,NaN,-79.25999527334292,-122.26957528399132,-0.023038908279914783,-0.19627150690385875,-0.17323259862394397,-3411700,-3435800,18.448680576312086,20.028232719429525,NaN,NaN,-14.630922396204248,-12.131398371808933
2002-05-14T09:30:00-04:00,25.2,25.27,25.06,25.21001,142500,148230,47.56235885064705,42.632892289621736,NaN,NaN,-34.037151127348736,-91.39125639686503,-0.002188079614611954,-0.17596769814220892,-0.17377961852759696,-3269200,-3388580,24.482750003202568,20.06494236221126,NaN,NaN,-13.137108099478855,-12.275071190047493
2002-05-15T09:30:00-04:00,25.00999,25.11,24.83,24.84,81400,137840,41.54388920518241,42.442905308538464,NaN,NaN,-92.93651067694309,-86.53936273424486,-0.011033339584514468,-0.18757129300824005,-0.17653795342372558,-3350600,-3386340,24.76712648685249,20.09094349431925,NaN,NaN,-13.78352493637364,-12.4905645823798
2002-05-16T09:30:00-04:00,24.74001,24.87,24.64,24.87,63100,130095,42.18270105635422,42.510301831925446,NaN,NaN,-117.74370829509446,-88.12892514746929,-0.01247499854196965,-0.19213170160118764,-0.179656703059218,-3287500,-3359260,28.28316754630488,20.54333635065661,NaN,NaN,-14.09590568323303,-12.719899025358833
2002-05-17T09:30:00-04:00,24.78,25.2,24.78,25.16,130800,129385,48.08837050583939,43.30893575265869,NaN,NaN,-43.16655085618282,-73.4287832457824,0.0074203759660679824,-0.170381233101633,-0.17780160906770098,-3156700,-3295140,35.91976535351715,21.790116294359706,NaN,NaN,-12.493103999826348,-12.687499735997049
2002-05-20T09:30:00-04:00,25.12,25.17999,24.96001,25.03999,49100,127860,45.99463123582539,43.75219302621723,NaN,NaN,-32.891989224963915,-64.1551820361066,0.013463648396291605,-0.1609720485723365,-0.1744356969686281,-3205800,-3253960,40.31537200674915,23.391422882269726,NaN,NaN,-11.819661982450352,-12.563522914061807
2002-05-21T09:30:00-04:00,24.97,25.10001,24.78999,24.83,174600,134910,42.507161081622215,43.35002709747325,NaN,NaN,-81.32191514462411,-73.61213483956168,0.004734893508704763,-0.16851708008274713,-0.1732519735914519,-3380400,-3276200,38.76866278727215,24.876148832208383,NaN,NaN,-12.32027704691831,-12.528773504469878
2002-05-22T09:30:00-04:00,24.89,25.05,24.83,25.05,294900,146805,47.03797946904768,43.27149105354538,NaN,NaN,-50.64159421876591,-65.15315154792624,0.014635059319713012,-0.15495814944181063,-0.16959320876152364,-3085500,-3223180,44.25903870213413,26.768502345819545,NaN,NaN,-11.340168689750406,-12.35897281665281
2002-05-23T09:30:00-04:00,25.08,25.13,24.84,25.13,18200,145400,48.62352668392021,43.63912997306704,NaN,NaN,-21.186158986538725,-45.8416416862151,0.026724659476338647,-0.13618738441610034,-0.162912043892439,-3067300,-3179140,48.39796273317016,28.930752370479667,NaN,NaN,-10.064687697764102,-12.03121779966871
2002-05-24T09:30:00-04:00,25.12,25.24001,24.82001,24.84,31000,133975,43.535484428982876,43.86856383619495,NaN,NaN,-50.01939046280479,-47.21220960753949,0.015879351329757097,-0.1430628547302426,-0.1589422060599997,-3098300,-3167460,49.469595517395966,30.74920061510835,NaN,NaN,-10.508162133787762,-11.813638418828575
2002-05-28T09:30:00-04:00,24.97,24.97,24.67999,24.75,42800,117890,42.06436547430431,44.372695800743536,NaN,NaN,-124.68364094860107,-65.57053995226693,0.0039547564655853795,-0.15399876047801797,-0.15795351694360335,-3141100,-3154520,50.691334713549914,32.82035320353314,NaN,NaN,-11.31211239890751,-11.741991844554137
2002-05-29T09:30:00-04:00,24.7,24.88,24.7,24.83,30400,93875,43.87969954336137,44.2897998852986,NaN,NaN,-110.57256320929825,-71.42066956520176,0.0028187817223794265,-0.15443003979062908,-0.1572488215130085,-3110700,-3100580,55.51924540723917,35.35212649158491,NaN,NaN,-11.453188388362047,-11.700734207955268
2002-05-30T09:30:00-04:00,24.56,24.8,24.53,24.72,37300,92195,41.93404844058713,44.34988184346957,NaN,NaN,-155.61050591458877,-92.41445190436632,-0.0036273259652399026,-0.1617829789695584,-0.1581556530043185,-3148000,-3113080,54.19496880492181,37.91949622345316,NaN,NaN,-12.126913259917204,-11.761616929664116
2002-05-31T09:30:00-04:00,24.77,25.06,24.77,24.85001,341700,107960,45.03609056611639,44.68386359007347,NaN,NaN,-43.8864997545433,-96.95452005796724,0.00226133841110579,-0.15532897999043627,-0.15759031840154206,-2806300,-3060880,58.632483214309005,40.86786813235218,NaN,NaN,-11.825502643553017,-11.770743460219673
2002-06-03T09:30:00-04:00,24.89999,24.97,24.25,24.28,282800,111965,35.96438106999271,43.99676340084175,NaN,NaN,-237.539505097523,-134.45854298491088,-0.029106289637562344,-0.193973180448495,-0.16486689081093264,-3089100,-3059040,58.78405690942139,43.74896644185999,NaN,NaN,-14.482126426961836,-12.158083884039982
2002-06-04T09:30:00-04:00,24.32001,24.33,24.03,24.25,76200,108645,35.55841077572589,43.13933853834738,NaN,NaN,-296.6282448819331,-168.84746377157728,-0.04765258134919029,-0.2244326174974205,-0.1767800361482302,-3165300,-3063880,58.1801755340115,46.15592540834634,NaN,NaN,-16.710457538064507,-12.808422977472057
2002-06-05T09:30:00-04:00,24.2,24.53,24.19,24.53,176900,114915,42.12492232792798,43.18084090425778,NaN,NaN,-162.86971033703807,-179.30689319712525,-0.03729839492200987,-0.22340302980074256,-0.1861046348787327,-2988400,-3039420,60.394510124496946,48.70073852532095,NaN,NaN,-16.591147479947324,-13.348812192111382
2002-06-06T09:30:00-04:00,24.38,24.39999,23.92,23.98,107400,113110,34.65489204753321,42.643140260770565,NaN,NaN,-216.31241242428052,-191.44727449906358,-0.06225638263666319,-0.2639251131745617,-0.2016687305378985,-3095800,-3028980,61.3355364158546,51.06162201600307,NaN,NaN,-19.069800167317926,-14.16609618856946
2002-06-07T09:30:00-04:00,23.71001,24.08,23.71001,23.98,303400,125225,34.65489204753321,41.68360608517726,NaN,NaN,-204.50836575785098,-223.57164769972513,-0.07279740804688534,-0.29266549059650515,-0.21986808254961981,-3095800,-3086880,53.713168795012734,52.332579404681326,NaN,NaN,-20.969856638906805,-15.138061967189081
2002-06-10T09:30:00-04:00,23.89999,24.32001,23.89999,24.25,59400,125475,40.647209752761746,41.30164740781557,NaN,NaN,-122.87494025805168,-200.63873473183088,-0.05635289356832848,-0.2903091995100304,-0.23395630594170194,-3036400,-3076340,54.814018854254115,53.36819703664596,NaN,NaN,-20.648881003765858,-15.925321829557193
2002-06-11T09:30:00-04:00,24.08,24.08,23.60001,23.60001,62500,125320,32.83975822366503,40.611118632247205,NaN,NaN,-169.04624657309145,-175.12233507006255,-0.08243958699866122,-0.3370057896900285,-0.25456620269136726,-3098900,-3063060,56.22663070007061,54.615194744703,NaN,NaN,-23.154637664250817,-16.958081234513426
2002-06-12T09:30:00-04:00,23.5,23.67999,23.35001,23.58,70000,121695,32.63195763028041,39.582117072335265,NaN,NaN,-173.03115871123978,-177.15462474490292,-0.09342476165759384,-0.37134715476335955,-0.2779223931057657,-3168900,-3099160,51.51226186501391,55.13328211348012,NaN,NaN,-25.12658214075847,-18.125009935405576
2002-06-13T09:30:00-04:00,23.67,23.81,23.50999,23.50999,42400,119745,31.87206077101328,38.3855837928419,NaN,NaN,-137.07716158659338,-161.3075745773655,-0.09734668516906825,-0.39960574956710104,-0.3022590643980328,-3211300,-3122260,48.69850487721531,55.15474940948335,NaN,NaN,-26.930719793455992,-19.382968486555637
2002-06-14T09:30:00-04:00,23.34,23.67,23.09,23.61,241900,128685,34.22829601424863,37.720784620360895,NaN,NaN,-136.4738288327747,-147.70066719235024,-0.08556375399909666,-0.40921375689690365,-0.323650002897807,-2969400,-3096980,51.80135346039345,55.32130354826889,NaN,NaN,-27.68991412013592,-20.569675005638533
2002-06-17T09:30:00-04:00,23.72,24.06,23.72,24.06,79800,126135,43.66881839663398,37.83538840052729,NaN,NaN,-61.28134105621824,-135.38194735198357,-0.042024443628014385,-0.37618055743282497,-0.3341561138048106,-2889600,-3067620,55.19103674167632,55.6427108359922,NaN,NaN,-25.307267757108328,-21.24647397013422
2002-06-18T09:30:00-04:00,23.98,24.12,23.89,24,42700,125815,42.78697406723495,37.75733658080397,NaN,NaN,-47.46859547437789,-111.06641713224084,-0.013314478931237161,-0.35079921246885704,-0.3374847335376199,-2932300,-3034300,58.737635173934144,55.87259581932756,NaN,NaN,-23.67550775802557,-21.59347879697584
2002-06-19T09:30:00-04:00,23.89999,24.17999,23.82001,23.91,27700,118470,41.43531526862973,37.72171278280702,NaN,NaN,-47.06407460187406,-85.87300031036769,0.002711531874878381,-0.33409531869402187,-0.33680685056890025,-2960000,-2992520,62.7219067952782,56.481662818638725,NaN,NaN,-22.73551886959359,-21.756627378778376
2002-06-20T09:30:00-04:00,23.92,23.92,23.7,23.7,42900,105870,38.38803205466424,37.246851460560435,NaN,NaN,-70.60562193672727,-72.57869238039443,0.002283076355415692,-0.33395300512463066,-0.33623608148004636,-3002900,-2950840,66.22560258158147,57.024028487729616,NaN,NaN,-22.83331582862269,-21.91044001447042
2002-06-21T09:30:00-04:00,23.60001,23.62,22.8,22.99001,246300,117275,30.279996965236776,36.84082402450644,NaN,NaN,-156.67086271363107,-76.6180991565657,-0.04034965685964298,-0.3866731525546001,-0.34632349569495713,-3249200,-3006800,58.30251158485333,56.98963239311761,NaN,NaN,-25.714704939875986,-22.4539064323855
2002-06-24T09:30:00-04:00,23,23.11,22.66,22.75999,274400,129445,28.201764597285475,36.31534929747498,NaN,NaN,-182.30938444868113,-100.82370783505829,-0.07647780624673989,-0.441920753503382,-0.3654429472566421,-3523600,-3133600,45.12784692129298,56.05732320649486,NaN,NaN,-28.76404848985152,-23.35535529773779
2002-06-25T09:30:00-04:00,22.95,22.95,22.14999,22.28999,68600,130735,24.50138813617309,35.05652542663534,NaN,NaN,-205.40942361342405,-132.4118734628675,-0.12177576578805305,-0.5176626544917085,-0.3958868887036554,-3592200,-3265580,36.00737481788994,54.31538497030864,NaN,NaN,-32.71189454739351,-24.692003761974323
2002-06-26T09:30:00-04:00,22,22.34,21.83,22.25,98600,134145,24.21031091324069,34.31048391704302,NaN,NaN,-207.23123491681343,-164.44530552585542,-0.14272680557362927,-0.574295395670692,-0.4315685900970627,-3690800,-3411740,29.01401815505261,52.006705094537075,NaN,NaN,-35.84953213469076,-26.2859363866481
2002-06-27T09:30:00-04:00,22.33,22.5,22.12,22.42,172800,140920,28.119706129638033,33.843684922907656,NaN,NaN,-152.4547423886269,-180.8151296162353,-0.1335930051233749,-0.5985598465012814,-0.46496684137790645,-3518000,-3514760,25.286194295519635,49.97620691600185,NaN,NaN,-37.177026818711546,-27.84180644837145
2002-06-28T09:30:00-04:00,22.53999,22.7,22.25,22.25,58100,126740,26.639861574337175,32.843160053020185,NaN,NaN,-127.0177676932431,-174.88451061215773,-0.12747493878224958,-0.6243105148557184,-0.49683557607346884,-3576100,-3580140,23.24499669975073,47.72127676210875,NaN,NaN,-38.73131904597185,-29.39745110517151
2002-07-01T09:30:00-04:00,22.3,22.64999,22.3,22.47,81700,116685,31.652715273503816,32.758371270865815,NaN,NaN,-102.73173455714696,-158.9689806338509,-0.09838836524357075,-0.6198210326279323,-0.5214326673843616,-3494400,-3574300,23.836424203641457,45.40769058379238,NaN,NaN,-38.493334925604984,-30.696863079519147
2002-07-02T09:30:00-04:00,22.45,22.56,22.25,22.32001,87200,117235,30.140546326399033,32.580413320588576,NaN,NaN,-98.16843787616519,-137.52078348639913,-0.07981799306516169,-0.6212051587158136,-0.5413871656506519,-3581600,-3572180,24.065164970864473,43.44718366278171,NaN,NaN,-38.7483745520076,-31.847079004160353
2002-07-03T09:30:00-04:00,22.14,22.38,21.92999,22.17,84600,112620,28.665545885415142,32.35137654304585,NaN,NaN,-106.04313731783459,-117.28316396660334,-0.06863181676393337,-0.6271769366055686,-0.5585451198416352,-3666200,-3567260,24.630887629546876,41.72806814509111,NaN,NaN,-39.39645522880105,-32.925561321966164
2002-07-05T09:30:00-04:00,21.95,22.46001,21.95,22.46001,27300,108615,35.26154800058059,32.42518025635528,NaN,NaN,-83.74395340048352,-103.54100616897468,-0.03442283500262466,-0.601573663594916,-0.5671508285922914,-3638900,-3591440,23.69650926909948,39.72057927428439,NaN,NaN,-37.954110180353794,-33.643925444592966
2002-07-08T09:30:00-04:00,22.53,22.60001,22.39999,22.42,46100,95750,34.78369163266336,31.79052834464309,NaN,NaN,-59.02858187984766,-89.94316900629558,-0.00855954496549749,-0.5778502597991633,-0.5692907148336658,-3685000,-3613220,22.85546466945712,37.41089555484017,NaN,NaN,-36.92046897125214,-34.112003091258565
2002-07-09T09:30:00-04:00,22.42999,22.57001,22,22.05,40800,94820,30.647430671969744,30.923418102124145,NaN,NaN,-78.38054452591807,-85.0729310000498,-0.010322651167772423,-0.5821940287933813,-0.5718713776256089,-3725800,-3659500,21.13861840130518,34.72525149965238,NaN,NaN,-37.23737058173702,-34.558484161326916
2002-07-10T09:30:00-04:00,21.89999,22.05,21.57001,21.60001,154700,99430,26.51743502344779,29.857855227468292,NaN,NaN,-115.71825551816234,-88.58289452844924,-0.0343902698988614,-0.6148592149991856,-0.5804689451003242,-3880500,-3719280,19.13874687974713,31.612168648543022,NaN,NaN,-38.85674901553172,-35.17252199764189
2002-07-11T09:30:00-04:00,21.2,21.44,20.94,21.24001,138700,102865,23.758970160471165,28.81292223502593,NaN,NaN,-152.88765689622556,-97.95179844412743,-0.0653549266805703,-0.6621626034510371,-0.5968076767704668,-4019200,-3789880,17.08319657658292,28.101996791043128,NaN,NaN,-41.16038505002939,-36.027931005125815
2002-07-12T09:30:00-04:00,21.10001,21.14,20.61,20.78999,79000,104695,20.840483389923563,28.1386712653607,NaN,NaN,-172.09162628993923,-115.62133302201858,-0.10461520381842648,-0.7275766815434999,-0.6229614777250734,-4098200,-3881740,14.848566846617132,24.998143595454827,NaN,NaN,-44.158814298314866,-37.18948576129568
2002-07-15T09:30:00-04:00,20.47,20.56,19.85001,20.49001,141700,99685,19.151669028230216,27.492235867571036,NaN,NaN,-205.5206147812862,-144.91973960230627,-0.13720328499036083,-0.7944655839630244,-0.6572622989726635,-4239900,-3992720,12.688999394068915,22.681083057795963,NaN,NaN,-47.20436158566629,-38.62018230763434
2002-07-16T09:30:00-04:00,20.47,20.48,20,20.17,61300,98760,17.520577009448857,26.99360650137645,NaN,NaN,-186.60023397327274,-166.5636774917772,-0.1648665956948927,-0.8633455435912794,-0.6984789478963866,-4301200,-4107800,10.916080807357346,20.888847771329353,NaN,NaN,-50.28365234577519,-40.28639231308303
2002-07-17T09:30:00-04:00,20.2,20.64,20.2,20.25999,221500,107700,19.594408530381642,26.663899188315092,NaN,NaN,-146.20127528202056,-172.66028144454884,-0.1614519927346153,-0.9002939388146558,-0.7388419460800405,-4079700,-4147640,10.375601750480257,19.557532313859898,NaN,NaN,-52.05090308957197,-41.967036709724304
2002-07-18T09:30:00-04:00,20.35001,20.48,19.75999,19.8,50200,108825,17.212087790397035,25.88478359265502,NaN,NaN,-146.55657647841036,-171.39406536098582,-0.1734678116946322,-0.9556767106983308,-0.7822088990036986,-4129900,-4169780,10.077004001562472,18.47116157857724,NaN,NaN,-54.3870356183646,-43.74132226810149
2002-07-19T09:30:00-04:00,19.3,19.5,18.72,18.88,140700,113715,13.640101421234007,24.95622929600479,NaN,NaN,-182.2399880860765,-173.4237377202133,-0.22348662639323913,-1.0615671819952475,-0.8380805556020083,-4270600,-4204260,9.61301551630882,17.49744863690282,NaN,NaN,-57.905964848656254,-45.76484263675217
2002-07-22T09:30:00-04:00,18.8,19.34,18.74001,19.03999,205700,111685,16.8709653815377,23.90039001800721,NaN,NaN,-152.0713461715613,-162.73388399826828,-0.22527110368705805,-1.119669435210831,-0.8943983315237729,-4064900,-4169260,13.944529547630069,16.790884732902008,NaN,NaN,-59.46847735898708,-47.72250473992859
2002-07-23T09:30:00-04:00,19.10001,19.33,18.97,19.13,84800,102205,18.713466491795927,23.084170029821273,NaN,NaN,-126.21574735176098,-150.65698667396595,-0.20068220920250734,-1.145251093026907,-0.9445688838243997,-3980100,-4105040,21.388534616887,16.599696850475045,NaN,NaN,-60.073249298184216,-49.486896819679394
2002-07-24T09:30:00-04:00,18.89,20.11,18.89,20.11,205200,109035,35.480799681493224,23.570973872398277,NaN,NaN,-82.69896859889678,-137.9565253373412,-0.10359750873479856,-1.074065769742898,-0.9704682610080994,-3774900,-4044080,27.77519598275066,16.824290304275312,NaN,NaN,-54.40976531784304,-50.190163747988485
2002-07-25T09:30:00-04:00,20.09,20.49001,19.84,20.36,146100,111410,38.94094309545757,23.833787807746635,NaN,NaN,-46.726968056554306,-117.99060365296998,-0.012513956886247679,-0.986110707115909,-0.9735967502296613,-3628800,-3943860,36.85764368262138,17.764371333812587,NaN,NaN,-48.757322589634924,-49.98547215393798
2002-07-26T09:30:00-04:00,20.25999,20.47,20.17,20.45,29000,104220,40.184613279713595,24.21956792539308,NaN,NaN,-34.40502811264139,-88.42361165828295,0.05985113660128227,-0.8987828294780584,-0.9586339660793407,-3599800,-3809700,46.547888208074376,19.45668730085668,NaN,NaN,-43.9732188937522,-49.126578831054296
2002-07-29T09:30:00-04:00,20.55,21.14999,20.55,21.03999,140600,108345,47.704423952074016,25.43792458825767,NaN,NaN,3.8432169797004416,-57.24069902803062,0.1484621461319,-0.7730562834144656,-0.9215184295463656,-3459200,-3688560,53.48885804712354,21.76741870412942,NaN,NaN,-37.22124744523857,-47.425817204509194
2002-07-30T09:30:00-04:00,21.00999,21.03999,20.71001,20.83,81100,108315,45.51135443564866,26.79463311770059,NaN,NaN,6.1319975714720885,-30.771150043383994,0.19121941559759126,-0.6824941600493766,-0.8737135756469678,-3540300,-3600600,57.776261085731036,24.52724114741398,NaN,NaN,-32.54381655741426,-45.29981711206706
2002-07-31T09:30:00-04:00,20.88,21.3,20.88,21.3,62800,107095,50.94691113250889,28.73662890141757,NaN,NaN,34.13573414805767,-7.404209493993115,0.24595458789823754,-0.5662703407741709,-0.8122249286724085,-3477500,-3541120,60.43238083152359,27.623611451338316,NaN,NaN,-26.748031755812708,-42.64956206117358
2002-08-01T09:30:00-04:00,21.2,21.37,21.05,21.10001,52800,105505,48.71981602967076,30.72800980425666,NaN,NaN,41.25844665005981,10.192873447329697,0.2620101926291949,-0.48471218788591486,-0.7467223805151098,-3530300,-3521420,61.300689506415644,30.941620212752493,NaN,NaN,-22.79426686432966,-39.813091318767306
2002-08-02T09:30:00-04:00,21.06,21.37,20.92999,21.06,43200,106300,48.26524643101636,32.80755104731281,NaN,NaN,44.865605697260385,26.047000209310056,0.26259290805392976,-0.4184812454476976,-0.6810741535016274,-3573500,-3516160,61.54335599407429,34.43121711275288,NaN,NaN,-19.796175174404382,-36.9535318695726
2002-08-05T09:30:00-04:00,21,21.08,20.77,20.77,69300,107460,44.98872816792358,34.76956184434672,NaN,NaN,33.87708789870965,32.05377439311191,0.23689468918342782,-0.38495579202234254,-0.6218504812057704,-3642800,-3552880,58.77269254085089,37.84954652228813,NaN,NaN,-18.232785740274295,-34.279139565387126
2002-08-06T09:30:00-04:00,20.95,21.28,20.78999,20.78999,96700,110255,45.264561121220474,36.60314417226378,NaN,NaN,52.58578337104065,41.34453155302562,0.2153141396317848,-0.3527078066660394,-0.5680219462978242,-3546100,-3554040,58.68281451257834,41.30006171958085,NaN,NaN,-16.892601368935445,-31.795348394465456
2002-08-07T09:30:00-04:00,21.10001,21.27,20.8,21.27,296600,117350,51.54711573370608,39.05564616821442,NaN,NaN,76.9782439245146,49.913033508317,0.22631241073596464,-0.28513143287786846,-0.5114438436138331,-3249500,-3508440,61.195029723777296,44.95134927116762,NaN,NaN,-13.803156671195268,-29.225035291141143
2002-08-08T09:30:00-04:00,21.10001,21.8,20.61,21.75999,126100,116720,56.9758832787927,42.15105915804004,NaN,NaN,105.54004227727341,62.769352633759716,0.2572749964480495,-0.18985009805377118,-0.4471250945018207,-3123400,-3427060,65.25527706038531,48.92579652431594,NaN,NaN,-9.366213645420752,-26.388060770323946
2002-08-09T09:30:00-04:00,21.52,21.92999,21.52,21.86,83700,116955,58.00999725643921,45.08956143481873,NaN,NaN,132.45589518914426,80.2874105321365,0.2736537235831487,-0.10505794002288482,-0.37871166360603353,-3039700,-3320300,69.72988302522236,52.910464629858254,NaN,NaN,-5.459608721012012,-23.39828190613653
2002-08-12T09:30:00-04:00,21.5,21.84,21.5,21.78999,62600,113000,56.97756476787926,47.82271131168182,NaN,NaN,111.27194837358806,95.7663826271122,0.2685589793647213,-0.043012939400131955,-0.31157191876485324,-3102300,-3212200,73.45733669869381,56.629664778558734,NaN,NaN,-2.556825115710431,-20.420930936075656
2002-08-13T09:30:00-04:00,21.60001,22,21.58,21.58,45300,112200,53.88007265318752,49.136945095374266,NaN,NaN,101.16301824432864,105.48182960176977,0.24072685740370464,-0.010663347010222424,-0.25139020441392707,-3147600,-3132500,75.82133809437255,60.06153207224601,NaN,NaN,-0.9544014456847947,-17.639998151734105
2002-08-14T09:30:00-04:00,21.7,22.3,21.5,22.28999,81400,105195,61.5007986669487,50.74836335048078,NaN,NaN,117.09501293273757,113.50518340341439,0.25826470255034956,0.07144067377400987,-0.1868240287763397,-3066200,-3095840,76.84299357559973,62.91762849317304,NaN,NaN,2.950462559043135,-14.698503764480213
2002-08-15T09:30:00-04:00,22.3,22.34,21.98,22.09,80800,106725,58.56525526486056,52.061266349419846,NaN,NaN,118.17160218036523,116.03149538403275,0.2446587660757619,0.11899942881836267,-0.12565933725739922,-3147000,-3100560,76.3954104581348,65.04959436817737,NaN,NaN,5.271235291410686,-11.845683899352942
2002-08-16T09:30:00-04:00,22.05,22.19,21.89999,21.99001,72600,103320,57.09781572744786,52.73222290480369,NaN,NaN,105.56693554523738,110.65370345525136,0.21806989587354028,0.14692803258452614,-0.07114186328901415,-3219600,-3136540,72.90918470225468,66.43676055782959,NaN,NaN,6.732434783253746,-9.191666944694845
2002-08-19T09:30:00-04:00,21.95,22.2,21.91,22.16,98100,97940,58.97960712973506,53.6942409543813,NaN,NaN,107.93306109877226,109.98592600028822,0.20146987431787955,0.18069547960833532,-0.020774394709544244,-3121500,-3140380,72.52877347985331,67.49051144312403,NaN,NaN,8.500877447284273,-6.664160602983542
2002-08-20T09:30:00-04:00,22,22.17,21.88,22.06,27200,95060,57.385006895053095,54.15410493742017,NaN,NaN,93.22670100511576,108.39866255244564,0.17431154848704278,0.19711504089925924,0.02280349241221645,-3148700,-3140600,72.50543257080236,68.35287228164394,NaN,NaN,9.526350046774178,-4.351230510161011
2002-08-21T09:30:00-04:00,22.17,22.17,21.8,22.03,75700,88585,56.88809739975818,54.737553606712126,NaN,NaN,80.9854015277727,101.17674027145266,0.14602911159056406,0.20533988190042152,0.059310770309857465,-3224400,-3172240,69.06310639634222,68.90733063092442,NaN,NaN,10.242204810117544,-2.2664540358355034
2002-08-22T09:30:00-04:00,22.03999,22.21001,21.94,22.14,46000,83580,58.3134773338755,55.45528438548778,NaN,NaN,85.2302776357854,94.58847536253668,0.12712635878291906,0.2182187187885063,0.09109236000558724,-3178400,-3178520,68.36928077264524,69.39489668653663,NaN,NaN,11.228950031474433,-0.33853916907694126
2002-08-23T09:30:00-04:00,21.94,22.05,21.78,21.78999,28700,83565,52.37923775041955,55.98317792709463,NaN,NaN,48.47808814519053,83.17070588252732,0.08544701356552094,0.1979011269624884,0.11245411339696747,-3207100,-3176020,68.50492829818137,70.0900563834888,NaN,NaN,10.468662073843861,1.2053467227688877
2002-08-26T09:30:00-04:00,21.83,21.95,21.61,21.84,86000,80835,53.11342315719984,56.54381092966459,NaN,NaN,32.822313941305744,68.14855645103401,0.057010232482037154,0.1837169039995139,0.12670667151747675,-3121100,-3175940,68.50958218581583,70.79196836014863,NaN,NaN,10.027588200914751,2.4656669339325825
2002-08-27T09:30:00-04:00,21.89,21.99001,21.67,21.78,35800,78570,52.076069874929644,56.58159336832341,NaN,NaN,30.23056573215785,55.549329396442445,0.031213818052144376,0.16572394408265723,0.13451012603051285,-3156900,-3177580,68.28681629104469,71.29852454352486,NaN,NaN,9.379582789560805,3.4533691990223288
2002-08-28T09:30:00-04:00,21.8,21.8,21.49001,21.55,280800,89470,48.190579722023735,55.95407168569706,NaN,NaN,-10.422965018505694,37.267656087186765,-0.0024955204949577703,0.13139072541181562,0.1338862459067734,-3437700,-3220240,62.58600939878402,71.1078625676962,NaN,NaN,7.744162297648513,4.0663396416832125
2002-08-29T09:30:00-04:00,21.35001,21.49001,21.25999,21.31,146900,94175,44.46262364702924,54.986402142167776,NaN,NaN,-64.88345622596727,7.244909314836233,-0.040029916193410606,0.08384885066501013,0.12387876685842074,-3584600,-3301480,53.43697829815693,69.9440836586201,NaN,NaN,5.244710325485886,4.2346783107978805
2002-08-30T09:30:00-04:00,21.24001,21.84,21.24001,21.47,55100,94770,47.38484375299835,54.301207783962006,NaN,NaN,-39.065215175718954,-10.26375134934567,-0.05237586676220975,0.05840893340565856,0.1107848001678683,-3529500,-3365960,47.501630685720635,68.09010465769344,NaN,NaN,3.8750004140270744,4.183295754116337
2002-09-03T09:30:00-04:00,21.25,21.38,21,21,75000,95055,40.623040238301876,53.354276897184455,NaN,NaN,-134.0860440986012,-43.64542295732706,-0.08837274578570888,0.0003188679357322144,0.08869161372144109,-3604500,-3462640,40.27781768465004,65.55128177128469,NaN,NaN,0.539957943081394,3.6628189239684876
2002-09-04T09:30:00-04:00,21.02,21.17999,21,21.17,51700,92805,43.74972086460687,52.08634276844575,NaN,NaN,-143.19877250626027,-78.33129060501068,-0.09626182848263377,-0.031635671881851124,0.06462615660078265,-3552800,-3541820,35.51432908642485,62.59923430777219,NaN,NaN,-1.3572242022469618,2.9456699059377094
2002-09-05T09:30:00-04:00,21,21.38,21,21.16,33500,79650,43.60426531315264,51.01770062903804,NaN,NaN,-130.75049295791462,-102.39679619289247,-0.09738770953780859,-0.05710848032147808,0.0402792292163305,-3586300,-3571540,33.894011442787544,59.563420092390245,NaN,NaN,-2.941173045833391,2.1046923413989806
2002-09-06T09:30:00-04:00,21.28,21.28,21.05,21.16,65400,76615,43.60426531315264,50.05387559944553,NaN,NaN,-125.76891503848036,-114.5738879553951,-0.09335538335585569,-0.0764149999784891,0.01694038337736658,-3586300,-3571880,33.874970420281386,56.77526192939216,NaN,NaN,-4.247221203495604,1.1972761206997544
2002-09-09T09:30:00-04:00,21.06,21.58,21.06,21.58,37500,74305,51.46446365533825,49.51707963698862,NaN,NaN,-62.09443093535171,-119.17973110732164,-0.059285179404374846,-0.05716609087810198,0.0021190885262728637,-3548800,-3575740,33.64388819203158,53.99777012311917,NaN,NaN,-3.201027819147296,0.5689469864358901
2002-09-10T09:30:00-04:00,21.55,21.61,21.39,21.57001,119900,77170,51.28138073238509,49.08110633965519,NaN,NaN,-33.61135456440197,-99.08479320048178,-0.03547966633576457,-0.04223049439343285,-0.0067508280576682785,-3668700,-3588580,32.841340409999106,51.1646206830618,NaN,NaN,-2.395861210750217,0.14540295826644628
2002-09-11T09:30:00-04:00,21.62,21.7,21.53,21.53,68500,78330,50.50642874922241,48.62527286461692,NaN,NaN,-18.540107518143742,-74.15306020285848,-0.021190727915661053,-0.033239237952244594,-0.012048510036583542,-3737200,-3625460,30.5846169896666,48.41615715401354,NaN,NaN,-1.9275219781504958,-0.1507291755074026
2002-09-12T09:30:00-04:00,21.39999,21.42999,21.17999,21.25,146500,81585,45.342345559043096,47.698763452128894,NaN,NaN,-74.51621229928146,-62.90620407113185,-0.02888294706612141,-0.048152193869235305,-0.019269246803113895,-3883700,-3684940,27.323552707609764,45.48431943508243,NaN,NaN,-2.9516475086722735,-0.550860365959527
2002-09-13T09:30:00-04:00,21.27,21.48,21.14999,21.37,54600,80275,47.805432653798654,47.37206308808454,NaN,NaN,-59.112995135096185,-49.57502009045502,-0.02435639549151925,-0.049714741167512955,-0.025358345675993706,-3829100,-3733500,24.981645139552143,42.37551349518035,NaN,NaN,-3.1446139181628188,-0.9213965877028544
2002-09-16T09:30:00-04:00,21.32001,21.7,21.32001,21.67999,36300,78460,53.61991956318881,47.40824140279803,NaN,NaN,-1.8231496246751915,-37.520763828319716,-0.0002284133558501586,-0.025643862370806403,-0.025415449014956244,-3792800,-3782300,22.861064200487306,39.114905067656885,NaN,NaN,-1.6131974727787899,-1.0202252855708451
2002-09-17T09:30:00-04:00,21.81,21.82001,21.13,21.13,237100,85410,44.20977684258899,46.84636332905943,NaN,NaN,-46.490419913449315,-40.09657689812918,-0.019960856910146634,-0.05036652015263954,-0.030405663242492904,-4029900,-3854540,20.1361498747099,35.6755717522044,NaN,NaN,-3.230378381236237,-1.3359614420944725
2002-09-18T09:30:00-04:00,21,21.2,20.83,21.14,79100,88005,44.400836151564725,46.575667359740926,NaN,NaN,-115.04611274559117,-59.397777943618664,-0.03036700988000763,-0.06836442559250244,-0.03799741571249481,-3950800,-3897260,18.715472710148845,32.541961988730456,NaN,NaN,-4.445313478865457,-1.7801545902046132
2002-09-19T09:30:00-04:00,20.85001,20.86,20.53,20.53,355100,101975,36.246467983581496,45.98879909806608,NaN,NaN,-199.8625923636249,-84.46705395648736,-0.07387985586661161,-0.13034723554575933,-0.056467379679147715,-4305900,-3981700,16.271735484770502,29.887301787774284,NaN,NaN,-8.385681136781042,-2.7238012397155313
2002-09-20T09:30:00-04:00,20.42,20.45,20.28,20.39999,93100,104330,34.78036360211395,45.08847908728863,NaN,NaN,-233.77204693816375,-119.39886431710087,-0.10506209277297707,-0.18779499564536906,-0.08273290287239199,-4399000,-4095680,13.675912224423257,27.471179040538754,NaN,NaN,-12.01814078489566,-4.051564031884121
2002-09-23T09:30:00-04:00,20.28,20.36,20.10001,20.32001,70700,106430,33.87267268707302,44.60630997648657,NaN,NaN,-212.9376210188908,-161.621758595944,-0.12344886292450355,-0.23704398152802142,-0.11359511860351787,-4469700,-4231060,11.358192089444685,25.405491498024094,NaN,NaN,-15.215437349717584,-5.646403077288902
2002-09-24T09:30:00-04:00,20.08,20.22,19.92999,19.99001,91100,106685,30.35285157102284,43.64939074123057,NaN,NaN,-210.6219257923807,-194.44805977173027,-0.148526144907392,-0.29925279973775787,-0.15072665483036587,-4560800,-4337240,9.935911456814821,23.57846166733766,NaN,NaN,-19.135488038104565,-7.573415214548282
2002-09-25T09:30:00-04:00,20,20.32001,19.88,20.14999,121000,110945,33.93684240616746,42.95886053358877,NaN,NaN,-161.11448007024902,-203.66173323666186,-0.144874417484265,-0.3318196766856971,-0.18694525920143212,-4439800,-4435040,8.838126854643846,21.788755625327394,NaN,NaN,-21.249583041650016,-9.527153475562816
2002-09-26T09:30:00-04:00,20.2,20.61,20.2,20.61,52100,99510,43.01703134603081,42.91691525022292,NaN,NaN,-86.79113465433358,-181.04744169480358,-0.1039299213468193,-0.31685766088495626,-0.21292773953813696,-4387700,-4451400,8.665646545754,19.98808963428973,NaN,NaN,-20.128082573356238,-11.041571918104733
2002-09-27T09:30:00-04:00,20.3,20.36,20,20,53500,94840,35.958907263052296,41.80937550791678,NaN,NaN,-119.38580406705005,-158.17019312058082,-0.10980607955325261,-0.3501853389797027,-0.2403792594264501,-4441200,-4459840,8.572698413608734,18.197290364402377,NaN,NaN,-21.624722902571875,-12.553450630171467
2002-09-30T09:30:00-04:00,19.75,19.96001,19.5,19.78999,134300,98800,33.89683972117524,40.56762257854465,NaN,NaN,-143.8164522379469,-144.34595936439206,-0.118943781295335,-0.38905898604561884,-0.27011520475028383,-4575500,-4481000,8.331420995864875,16.446581834821366,NaN,NaN,-23.52412185546361,-14.120689376641772
2002-10-01T09:30:00-04:00,19.89,20.39,19.89,20.38,137600,101930,43.670099938740314,40.07931337779592,NaN,NaN,-74.3907237774693,-117.09971896140978,-0.07832023756947643,-0.3680155017121294,-0.28969526414265295,-4437900,-4456420,11.449180514898288,15.07976494376649,NaN,NaN,-21.62640598880488,-15.192934606950788
2002-10-02T09:30:00-04:00,20.28,20.52,20.25,20.27,204000,109545,42.41113079103423,39.86994089436672,NaN,NaN,-53.269378086010384,-95.53069856456204,-0.053131357694193804,-0.3561094612603952,-0.3029781035662014,-4641900,-4496840,10.798758747087518,13.899422518014902,NaN,NaN,-20.587961568953588,-15.96365274437976
2002-10-03T09:30:00-04:00,20.11,20.53999,20.11,20.22,108900,113315,41.82094768443387,39.44247768226923,NaN,NaN,-54.61968851288416,-89.09640933627216,-0.03498691186642511,-0.34671174339923283,-0.3117248315328077,-4750800,-4569460,9.729338068051433,12.809972012907707,NaN,NaN,-19.964076173308783,-16.535141805655336
2002-10-04T09:30:00-04:00,20.3,20.41,19.92,20,154900,117790,39.23389257283053,38.41490432581507,NaN,NaN,-69.81335759433026,-79.1819200417282,-0.03297820325857337,-0.35294758560602446,-0.3199693823474511,-4905700,-4662360,8.561296189820808,11.788560012145817,NaN,NaN,-20.253360100736533,-17.066315847809793
2002-10-07T09:30:00-04:00,20.07001,20.36,19.92999,19.96001,198000,125815,38.764475234658164,38.02595421096287,NaN,NaN,-67.98300890806874,-64.01523137575256,-0.029625380303594462,-0.35700110772694416,-0.3273757274233497,-5103700,-4768000,7.463955412193812,10.88340326482324,NaN,NaN,-20.624330596752515,-17.574603669087324
2002-10-08T09:30:00-04:00,20,20.59,20,20.38,200800,129860,46.06332060013027,38.144703100146124,NaN,NaN,-33.479676767915585,-55.833021973841824,0.0038165182019225252,-0.32260507967094654,-0.32642159787286906,-4902900,-4861000,6.6552246632390535,10.021956975758258,NaN,NaN,-18.674829057757588,-17.731778724611647
2002-10-09T09:30:00-04:00,20.36,20.39999,20.09,20.12,311600,142015,42.67240543339186,38.60369863227543,NaN,NaN,-46.201742658662766,-54.4194948883723,0.0109605149241217,-0.31272095421771695,-0.32368146914183865,-5214500,-4975520,5.81909532004039,9.27533982113468,NaN,NaN,-18.07511864410935,-17.78082728453989
2002-10-10T09:30:00-04:00,20.14999,20.34,19.91,20.21001,110100,140195,44.20373582446312,39.27679664815752,NaN,NaN,-50.809015839431986,-53.657360353681874,0.023558835452706595,-0.2942329248259554,-0.317791760278662,-5104400,-5046240,5.370389097090296,8.682088169182324,NaN,NaN,-17.128032841124906,-17.687570935480604
2002-10-11T09:30:00-04:00,20.33,20.64,20.24001,20.44,144500,144690,48.02414352446659,40.28761599368563,NaN,NaN,9.12001749794812,-37.8706853352262,0.0477948969252161,-0.25804813912214186,-0.30584303604735796,-4959900,-5057080,5.302891075813321,8.249566668208656,NaN,NaN,-15.17062824386482,-17.328007693821206
2002-10-14T09:30:00-04:00,20.58,20.87,20.45,20.78,124600,149105,53.13302853122818,41.914771490843144,NaN,NaN,89.80743392872535,-6.312596767867379,0.08496642152886241,-0.19963500913627996,-0.2846014306651424,-4835300,-5003400,11.25148460337627,8.343536178677335,NaN,NaN,-11.870735672147655,-16.5483974050107
2002-10-15T09:30:00-04:00,21,21.09,20.82001,20.96001,288700,151685,55.620235167413206,43.46358525950355,NaN,NaN,178.86335281106977,36.156009147929694,0.11789320738298936,-0.1372349214364057,-0.25512812881939506,-4546600,-4932140,18.564698514057525,9.038291297206884,NaN,NaN,-8.35491302988453,-15.377899637135533
2002-10-16T09:30:00-04:00,20.89999,20.89999,20.5,20.52,426200,169040,48.80253418115504,43.87683546201243,NaN,NaN,104.75690714270142,66.34773910820253,0.10659646631257108,-0.1218825459286812,-0.22847901224125228,-4972800,-4883800,23.188698410634842,10.07565214469837,NaN,NaN,-7.374032492303999,-14.234490045016742
2002-10-17T09:30:00-04:00,20.89,20.89,20.47,20.61,460300,174300,50.14854217228917,44.89038081267221,NaN,NaN,109.34170233412152,98.37788274291323,0.10175451424285362,-0.10128586943768525,-0.20304038368053887,-4512500,-4765420,33.19293337434583,11.83424035617959,NaN,NaN,-6.172084425415327,-13.082717813645111
2002-10-18T09:30:00-04:00,20.45,20.86,20.45,20.85001,233100,181300,53.648287695756,46.301198525142254,NaN,NaN,113.42512308992364,119.23890386130833,0.11055349062567738,-0.06484852039844213,-0.1754020110241195,-4279400,-4629320,42.47012748029756,14.272719390781926,NaN,NaN,-4.082923117416142,-11.797032857040973
2002-10-21T09:30:00-04:00,20.78,21.38,20.78,21.37,226000,189065,60.17203407301536,47.479908106161915,NaN,NaN,193.83164636761347,140.04374634908595,0.1450567755601107,0.005918958426018861,-0.13913781713409185,-4053400,-4472940,50.90600691771603,17.091064133840337,NaN,NaN,-0.0602781321137691,-10.120353610622802
2002-10-22T09:30:00-04:00,21.35001,21.36,20.88,21,161300,192575,54.31421189007524,48.33012818466484,NaN,NaN,145.30825516603002,133.332726820078,0.13673460755469483,0.03178044230927668,-0.10495416524541815,-4214700,-4406560,53.99010989946305,20.176160644724302,NaN,NaN,1.43864530108806,-8.469068051806964
2002-10-23T09:30:00-04:00,21.02,21.09,20.72,21,117100,192380,54.31421189007524,49.22250419935351,NaN,NaN,99.96062489043251,132.37347036962424,0.1253074268953964,0.051680118373827355,-0.07362730852156904,-4214700,-4254940,60.148277927313615,23.777513491814457,NaN,NaN,2.608783733217427,-6.88651779680348
2002-10-24T09:30:00-04:00,21.05,21.10001,20.67999,20.69,165000,198025,49.620346599740394,49.96439377270421,NaN,NaN,67.8106853975984,124.0672669823196,0.09246403939496568,0.04195274072213806,-0.05051129867282762,-4379700,-4228380,61.12974115623355,27.532402417986795,NaN,NaN,2.153137769656332,-5.595138430166363
2002-10-25T09:30:00-04:00,20.60001,20.89999,20.60001,20.83,159400,203320,51.65243578022937,50.884962383102156,NaN,NaN,52.40992626280255,111.86422761689539,0.07642629745989821,0.045021573152045136,-0.03140472430785307,-4220300,-4216560,61.58318383982152,31.398061591388775,NaN,NaN,2.3883021044779453,-4.454646925217176
2002-10-28T09:30:00-05:00,20.86,20.86,20.28999,20.37,362900,214750,45.201081480392745,50.823373874549475,NaN,NaN,-11.630031727062867,70.77189199796011,0.033297944237126884,0.010217705988555537,-0.023080238248571347,-4583200,-4322520,55.349718627991436,34.87623973172823,NaN,NaN,0.5380051045134424,-3.741410920969945
2002-10-29T09:30:00-05:00,20.49001,20.72,20.28,20.66,193900,217565,49.484673501338044,51.309964450831345,NaN,NaN,-5.009194648191215,40.70840203511587,0.023237935346594473,0.005967180934671745,-0.017270754411922728,-4389300,-4357440,53.43029028077553,38.277039371780745,NaN,NaN,0.3316674809405109,-3.15954257783988
2002-10-30T09:30:00-05:00,20.75,20.82001,20.58,20.75,189600,216845,50.77081269938525,51.77904137046864,NaN,NaN,31.07235740245487,26.930748537520344,0.021615389613897404,0.009748482605449027,-0.011866907008448377,-4199700,-4354440,53.57922658127533,41.720527763508244,NaN,NaN,0.5550454926608616,-2.628887139196917
2002-10-31T09:30:00-05:00,20.67999,20.73,20.39999,20.56,116800,217240,47.99278520581885,51.77680149056523,NaN,NaN,-11.300377642945016,11.10853592941166,0.007448127141925987,-0.002556748081040894,-0.010004875222966881,-4316500,-4341800,54.243218814807044,45.216265459150655,NaN,NaN,-0.09248196020340872,-2.2665435421978444
2002-11-01T09:30:00-05:00,20.5,20.83,20.39999,20.82001,120700,215530,51.873633217833884,51.68684468246563,NaN,NaN,14.415344666830883,3.509619610217321,0.014862361664627946,0.008573076857818052,-0.006289284806809894,-4195800,-4336900,54.51483403402111,48.30650470419671,NaN,NaN,0.5192023479319285,-1.8685798436078769
2002-11-04T09:30:00-05:00,20.72,20.74001,20.25,20.35001,96100,210435,45.29407249578714,50.949261634492345,NaN,NaN,-67.19141593544772,-7.60265723145965,-0.011206613116719673,-0.020297551202709485,-0.009090938085989812,-4291900,-4278640,57.72784430623957,51.103872260781145,NaN,NaN,-1.0320643701884977,-1.7490776331193942
2002-11-05T09:30:00-05:00,20.3,20.64999,20.3,20.55,45800,202685,48.29906723958177,50.91329971009425,NaN,NaN,-55.17740965269381,-17.63630023236017,-0.014112897357955494,-0.02673205978343418,-0.012619162425478687,-4246100,-4250000,59.251683764414246,53.6797997860511,NaN,NaN,-1.3803441604360245,-1.6964014227360558
2002-11-06T09:30:00-05:00,20.67,20.67,20.25,20.47,70300,190620,47.182570853194896,50.701444615873235,NaN,NaN,-77.26991857434207,-39.304755427719556,-0.02018504522668366,-0.03785046895883326,-0.0176654237321496,-4316400,-4273340,57.43461624813148,55.411348562750085,NaN,NaN,-1.9968289261883247,-1.7393196375149513
2002-11-07T09:30:00-05:00,20.57001,20.57001,20.3,20.42,367600,203495,46.45970169463941,50.187974187222046,NaN,NaN,-101.96083690528909,-57.436847280188374,-0.02596264734351144,-0.0501187329115389,-0.02415608556802746,-4684000,-4346840,52.02401638919098,56.09376919909961,NaN,NaN,-2.7077126886310925,-1.8776615019601144
2002-11-08T09:30:00-05:00,20.38,20.64999,20.23,20.28999,179300,205235,44.54851647355475,49.07200864440343,NaN,NaN,-115.22179375107282,-83.36427496376912,-0.03629963959640138,-0.06953063506352919,-0.03323099546712781,-4863300,-4480340,43.92925358690092,55.59542967546996,NaN,NaN,-3.8482209315786142,-2.1591699919056144
2002-11-11T09:30:00-05:00,20.3,20.38,20.14999,20.23,74300,202720,43.65611911888768,48.310716303604316,NaN,NaN,-144.20445706467504,-98.76688318961457,-0.04440123999972424,-0.08873254546678311,-0.044331305467058865,-4937600,-4609480,37.80183764976953,54.43912451477757,NaN,NaN,-5.0461571714345625,-2.571596731838321
2002-11-12T09:30:00-05:00,20.17999,20.31,19.60001,19.63,159000,196235,35.90833709797545,46.99601096131148,NaN,NaN,-238.5261428516658,-135.436629829409,-0.08503801804884753,-0.15062882802811828,-0.06559080997927075,-5096600,-4779580,31.557884509650492,52.396953556373056,NaN,NaN,-8.600275050974169,-3.4328364917148706
2002-11-13T09:30:00-05:00,19.8,20.12,19.64999,19.92,72100,178530,41.32825495052087,46.40371870065294,NaN,NaN,-184.92643209960693,-156.96793253446194,-0.08694542843851623,-0.17427259552741603,-0.0873271670888998,-5024500,-4921200,27.487079658727396,49.99390630655119,NaN,NaN,-9.982881598907973,-4.3685572213138855
2002-11-14T09:30:00-05:00,20.16,20.23,19.96001,20.19,196500,165340,45.91416131006718,45.993841952784216,NaN,NaN,-107.75743680537194,-158.12725251447853,-0.06555621894499769,-0.16927244077014691,-0.10371622182514922,-4828000,-4950000,26.731892345471678,47.50452834266906,NaN,NaN,-9.730307159415958,-5.1345214981856095
2002-11-15T09:30:00-05:00,20.17999,20.35001,20.10001,20.33,63000,156835,48.17607203087249,46.20634127781848,NaN,NaN,-66.62682971154356,-148.40825970657266,-0.038833277557523305,-0.15225781877205335,-0.11342454121453005,-4765000,-4930340,28.182441434731047,45.56400854315046,NaN,NaN,-8.834326369877257,-5.663065051284416
2002-11-18T09:30:00-05:00,20.39999,20.39999,20.17999,20.24001,181300,154600,46.820632746451345,46.01605265246943,NaN,NaN,-56.943591239623714,-130.95608654156243,-0.024757032702283688,-0.14437083209238466,-0.11961379939010097,-4946300,-4932080,28.129361821055113,43.756799367456146,NaN,NaN,-8.492177005158466,-6.067223901837852
2002-11-19T09:30:00-05:00,20.12,20.59,20.12,20.36,168900,154980,48.88566519039277,45.88139925896997,NaN,NaN,-26.1570992246897,-88.48227781616718,-0.005888532907631111,-0.12697446552463987,-0.12108593261700876,-4777400,-4868240,33.10737127039661,42.29452398810766,NaN,NaN,-7.612555160176577,-6.287985510171955
2002-11-20T09:30:00-05:00,20.3,20.46001,20.14999,20.34,29100,150580,48.547274665577824,45.92100564895275,NaN,NaN,-31.422451936392854,-57.78148178352436,0.006074127903473253,-0.11349327273766718,-0.11956740064114044,-4806500,-4824640,36.34988413843312,41.01642865408096,NaN,NaN,-6.980405223842342,-6.386902612124867
2002-11-21T09:30:00-05:00,20.45,20.45,20.02,20.09,75800,146120,44.40914780388404,45.387828119384906,NaN,NaN,-67.63639760506177,-49.75727394346232,-0.0016106666632774713,-0.12158073397023728,-0.1199700673069598,-4882300,-4835500,35.88330650147816,39.68560525889932,NaN,NaN,-7.578498686569062,-6.557130622759752
2002-11-22T09:30:00-05:00,20.2,20.24001,20.07001,20.09,127500,144525,44.40914780388403,45.3246192128204,NaN,NaN,-77.88503273935316,-52.00891454902425,-0.00524916900714531,-0.12653152856589145,-0.12128235955874614,-4882300,-4858960,34.842865127261135,38.050963888972284,NaN,NaN,-8.070728797818912,-6.7733589334824895
2002-11-25T09:30:00-05:00,20.14999,20.14999,19.85001,19.96001,123800,132570,42.23803706837359,44.89168848630553,NaN,NaN,-115.95413875317709,-63.81102405173492,-0.014444491671908172,-0.13933797414863136,-0.12489348247672319,-5006100,-4870920,34.29689631479954,36.268479071142664,NaN,NaN,-9.080990176772628,-7.103020539666795
2002-11-26T09:30:00-05:00,19.86,19.98,19.75,19.83,88200,127285,40.125143449685545,44.387586528912,NaN,NaN,-141.83882086855027,-86.94736838050704,-0.02660904208660672,-0.1581547850849816,-0.13154574299837488,-5094300,-4934300,31.48164523094114,34.41469542705764,NaN,NaN,-10.529063189250518,-7.592455203893041
2002-11-27T09:30:00-05:00,19.73,20.12,19.73,20.11,104300,123020,46.34974621806201,44.37973256629933,NaN,NaN,-88.56523241033932,-98.37592447529633,-0.013770433366509821,-0.14875878470651216,-0.13498835134000234,-4990000,-4971000,29.948659156374703,32.837884196142184,NaN,NaN,-10.099538753635343,-7.9506099967133705
2002-11-29T09:30:00-05:00,20,20.05,19.94,19.99001,25500,118455,44.22780081242485,44.35682430479005,NaN,NaN,-76.71571572804778,-100.19178809989354,-0.011428391723620701,-0.14927384099452823,-0.13784544927090753,-5015500,-4997640,28.85044717401196,31.760826595221552,NaN,NaN,-10.323367689969464,-8.28957538146424
2002-12-02T09:30:00-05:00,20.10001,20.11,19.75999,19.83,636400,144240,41.499357272840285,44.20276988721524,NaN,NaN,-98.42006419005992,-104.29879439003489,-0.01831610395491165,-0.1607405792145471,-0.14242447525963545,-5651900,-5151560,23.490640041652924,30.73859819464179,NaN,NaN,-11.284374407553386,-8.71740381376269
2002-12-03T09:30:00-05:00,19.88,19.98,19.8,19.95,146100,146740,44.275760743820605,44.8004430047756,NaN,NaN,-85.39711359322843,-98.18738935804515,-0.012716451696458964,-0.15832003988020915,-0.1456035881837502,-5505800,-5251500,20.78992639543506,29.969458329340686,NaN,NaN,-11.334407702025219,-9.091261512085909
2002-12-04T09:30:00-05:00,20.05,20.39,19.89999,20.25,71300,148015,50.58923238479021,45.461941392937696,NaN,NaN,16.425661764748572,-66.53449283138539,0.011932658532211426,-0.1306877650184859,-0.14262042355069732,-5434500,-5319540,19.17371007415902,29.375646216157232,NaN,NaN,-9.515967658525339,-9.151933818720114
2002-12-05T09:30:00-05:00,20.35001,20.35001,19.99001,20.05,66200,147810,46.78372711348925,45.52405323603927,NaN,NaN,3.984068754310563,-48.024632598455405,0.015293424027016778,-0.12350364351692633,-0.1387970675439431,-5500700,-5421680,17.033017244192877,28.68286942320875,NaN,NaN,-9.068902932016726,-9.140072263476773
2002-12-06T09:30:00-05:00,20.05,20.28999,19.97,20.21001,82800,133570,50.02285079005528,45.655966004552326,NaN,NaN,22.427007608602928,-28.19608793112527,0.02807503092986602,-0.10370327888161057,-0.1317783098114766,-5417900,-5502160,15.558987250063979,27.78119412430396,NaN,NaN,-7.724799621295141,-8.937890457450825
2002-12-09T09:30:00-05:00,20.21001,20.27,20.05,20.14999,29200,126065,48.8224232330792,45.79895103931146,NaN,NaN,29.53694110910907,-2.604686871291468,0.031985616516516255,-0.09179628916583127,-0.12378190568234752,-5447100,-5461200,19.38282094365445,27.156441204489628,NaN,NaN,-6.955692038994254,-8.654719254814172
2002-12-10T09:30:00-05:00,20.2,20.42,20.17,20.42,77300,126215,54.152700705222344,46.175167861799274,NaN,NaN,111.31892279802189,36.73852040695859,0.051119860343702,-0.059882080252720016,-0.11100194059642202,-5369800,-5434000,21.911683700804076,26.356749235233014,NaN,NaN,-4.671502174176209,-8.085688243294463
2002-12-11T09:30:00-05:00,20.45,20.45,20.21001,20.3,89300,122730,51.58142010019731,46.39189253570067,NaN,NaN,98.42699913252619,53.13878788051412,0.05378690997779503,-0.04376830312417823,-0.09755521310197326,-5459100,-5438920,21.778604984426252,25.315943581375382,NaN,NaN,-3.500824642123257,-7.430707728841433
2002-12-12T09:30:00-05:00,20.2,20.35001,20.12,20.17,45600,121405,48.874009577254355,46.71081123379855,NaN,NaN,40.397311822341,60.421436494120215,0.04523206227931953,-0.04101513525282385,-0.08624719753214338,-5504700,-5439720,21.755467781986866,24.30681224426886,NaN,NaN,-3.293023390975194,-6.839609966289114
2002-12-13T09:30:00-05:00,20.10001,20.25999,19.97,20.17999,31300,113145,49.09512904385873,47.04552417951103,NaN,NaN,-1.4564317748367657,55.64474861743226,0.03892274772803264,-0.03759376287210259,-0.07651651060013523,-5473400,-5450820,21.415508537425524,23.34771534499489,NaN,NaN,-3.0617986364459115,-6.29992263345437
2002-12-16T09:30:00-05:00,20.17999,20.28,20.06,20.28,81500,114070,51.362981570288795,47.69730592964783,NaN,NaN,38.888930555793806,57.51514650676921,0.04000778782615762,-0.02650677581743821,-0.06651456364359583,-5391900,-5439780,22.70915985654895,22.520019883691276,NaN,NaN,-2.241257631180478,-5.720113347415243
2002-12-17T09:30:00-05:00,20.2,20.3,20.02,20.07001,572200,133615,46.662293631651565,48.16424522835969,NaN,NaN,0.292162961053343,35.30979453937551,0.02579592494651474,-0.03426965746045241,-0.06006558240696715,-5964100,-5558640,19.069427993227578,21.63343293814031,NaN,NaN,-2.842436747074846,-5.309016690223758
2002-12-18T09:30:00-05:00,20.08,20.11,19.97,20.03999,176700,134005,46.01396145392086,48.14026060234961,NaN,NaN,-43.630601681585155,6.898274376553239,0.014167739793137644,-0.04235590766554509,-0.056523647458682734,-6140800,-5694980,15.917868663430028,20.63123361721569,NaN,NaN,-3.520187670924499,-5.053469687466721
2002-12-19T09:30:00-05:00,20.10001,20.10001,19.77,19.78,237300,144415,40.73520053525827,47.89078915398057,NaN,NaN,-117.6232509189744,-24.705838171709836,-0.009939916828139266,-0.06894854349385682,-0.05900862666571755,-6378100,-5869660,12.962114823478984,19.496352735034765,NaN,NaN,-5.681689719616512,-5.143215406345262
2002-12-20T09:30:00-05:00,19.92999,20.02,19.82001,20.00999,302400,155745,46.57410254946539,48.25327095945379,NaN,NaN,-71.236584149409,-38.661868646624285,-0.009313667203390302,-0.07065071066995543,-0.06133704346656513,-6075700,-5990120,11.391249132117053,18.632110527210777,NaN,NaN,-5.85469522099519,-5.244855379866681
2002-12-23T09:30:00-05:00,20.05,20.21001,19.98,20.07001,336700,166205,48.01355140652565,48.520256006789865,NaN,NaN,4.922352022225868,-45.45518435333786,-0.004043373946751916,-0.06639126090000502,-0.06234788695325311,-5739000,-6059540,10.594417258619885,17.903859874581116,NaN,NaN,-5.579832656996512,-5.292709276599513
2002-12-24T09:30:00-05:00,20.07001,20.10001,20,20.07001,18800,160955,48.01355140652565,48.33627879405668,NaN,NaN,-14.189191942955427,-48.35145533413962,0.00004031789179785583,-0.06229748958850578,-0.06233780748030364,-5739000,-6014520,14.75879843831278,17.588509043449243,NaN,NaN,-5.35535532784543,-5.301658712491787
2002-12-26T09:30:00-05:00,20.12,20.25,20.06,20.06,40200,158555,47.76463225921964,48.40634344732314,NaN,NaN,18.149546553216524,-35.995425687179285,0.002527290368177615,-0.05917869452008162,-0.061705984888259235,-5779200,-5942200,21.115273820840983,17.880098798924106,NaN,NaN,-5.233893327667717,-5.291977943231205
2002-12-27T09:30:00-05:00,20.03,20.07001,19.81,19.89999,46800,155680,43.85106873481921,47.96550187194914,NaN,NaN,-101.97153403360846,-32.865082310106104,-0.005695310903414394,-0.06882512351752723,-0.06312981261411284,-5826000,-5831780,29.731224439181872,18.89240145528967,NaN,NaN,-6.191839895594612,-5.420529650711692
2002-12-30T09:30:00-05:00,19.89999,20.06,19.86,20.02,36700,156240,47.33630534306708,47.85935059409112,NaN,NaN,-68.16970249980969,-32.25170598018624,-0.0023162201876360533,-0.0660250878486579,-0.06370886766102185,-5789300,-5774500,33.77223800201162,19.920216959458035,NaN,NaN,-6.074260233460247,-5.513919733961486
2002-12-31T09:30:00-05:00,20,20.05,19.72,19.94,61100,127475,45.31696810773878,47.22822683712802,NaN,NaN,-115.48024802550344,-56.3322259897321,-0.004601443021143181,-0.06946067143745083,-0.06485922841630765,-5850400,-5796780,32.97782419954295,20.710655566510816,NaN,NaN,-6.524464348625035,-5.658283250341992
2003-01-02T09:30:00-05:00,20.00999,20.35001,20.00999,20.32001,365000,138420,55.11252985725269,47.48044896263197,NaN,NaN,77.29815764462008,-38.034756072217,0.019050098457914014,-0.04104660534391513,-0.060096703801829146,-5485400,-5746060,36.63212923433989,21.771621584361785,NaN,NaN,-3.9385886694459185,-5.412612595928268
2003-01-03T09:30:00-05:00,20.42,20.42,20.19,20.3,364100,153060,54.55831968383778,47.88647111310222,NaN,NaN,117.28366483661115,-18.207932415538075,0.03214668753464608,-0.019913344383521547,-0.052060031918167625,-5849500,-5760120,36.04541441767906,22.792332058339802,NaN,NaN,-2.011810373860269,-4.926783707061411
2003-01-06T09:30:00-05:00,20.28,20.46001,20,20.45,76100,153555,57.9703201531291,48.52041333519295,NaN,NaN,105.18358940566645,23.22309227231691,0.04871746431066197,0.008836798470159835,-0.039880665840502136,-5773400,-5749600,36.860273836260774,23.895529579685178,NaN,NaN,0.6763022683088762,-4.126342853437084
2003-01-07T09:30:00-05:00,20.35001,20.41,20.22,20.27,46100,151720,52.8428099525341,48.62611536249619,NaN,NaN,93.92876638916808,55.64278605011246,0.04542626111435707,0.0169021605524442,-0.028524100561912867,-5819500,-5755640,36.57215777604135,24.885743716791776,NaN,NaN,1.4786291127256228,-3.3256325725566973
2003-01-08T09:30:00-05:00,20.25,20.37,20.07001,20.14999,36000,152060,49.6872570145642,48.84218417556138,NaN,NaN,35.452827729107796,85.8294012010347,0.03358336998645607,0.013455111921157226,-0.020128258065298846,-5855500,-5756660,36.52024305962624,26.132230507248824,NaN,NaN,1.2070833644705619,-2.678101724409946
2003-01-09T09:30:00-05:00,20.23,20.42,20.22,20.35001,50800,150735,54.55792363442504,49.452467188454534,NaN,NaN,108.0972630409588,91.98922228030246,0.03734829411728261,0.026557109581304417,-0.010791184535978193,-5804700,-5820520,33.3302355191492,27.37597099694305,NaN,NaN,2.471563058327003,-1.9424353268760963
2003-01-10T09:30:00-05:00,20.3,20.45,20.28999,20.41,37300,148135,55.9357266919178,50.538219056787355,NaN,NaN,131.9208038137691,94.91665007573404,0.041677019153007255,0.04130508940528088,-0.00037192974772637735,-5767400,-5804100,34.9047132297984,28.943299454537293,NaN,NaN,3.9201591201420367,-1.1049218344449345
2003-01-13T09:30:00-05:00,20.35001,20.53999,20.33,20.46001,96500,150680,57.10338212684769,51.29031045517181,NaN,NaN,143.48196042511512,102.57632427962378,0.04540031411208725,0.056378462892382686,0.010978148780295436,-5670900,-5783600,36.90801859532953,30.76592584476676,NaN,NaN,5.455543885370067,-0.1677124458999344
2003-01-14T09:30:00-05:00,20.38,20.52,20.37,20.52,81700,153200,58.52322335138097,52.04100130837576,NaN,NaN,133.11704434356025,110.41397987050223,0.04908237973954563,0.07233112345472748,0.023248743715181847,-5589200,-5737540,41.28056318672673,32.9577934110601,NaN,NaN,7.146690089542014,0.877202202020344
2003-01-15T09:30:00-05:00,20.48,20.48,20.25,20.32001,86000,153425,52.307460110360864,52.34770907293542,NaN,NaN,74.65662807842659,118.25473994036597,0.03584239874508392,0.06805174214653675,0.03220934340145283,-5675200,-5701480,44.52221006661793,35.08375138451047,NaN,NaN,6.840478838813971,1.7290988644194336
2003-01-16T09:30:00-05:00,20.3,20.64999,20.3,20.62,107100,130170,59.291881539637885,53.17108402153673,NaN,NaN,127.29100605045946,122.0934885422661,0.044515931922932,0.08785425830511784,0.043338326382185835,-5568100,-5654160,48.53716973410197,37.04245823545768,NaN,NaN,8.774384030648408,2.735568173880716
2003-01-17T09:30:00-05:00,20.5,20.67999,20.49001,20.5,16000,122135,55.773316326034326,54.02267313519495,NaN,NaN,124.74530446518571,120.65838867254942,0.039565508866870214,0.0927952124657736,0.05322970359890339,-5584100,-5617500,51.46756704061381,38.59505413555996,NaN,NaN,9.277847399251366,3.6701794917908086
2003-01-21T09:30:00-05:00,20.60001,20.67999,20.3,20.35001,65900,113565,51.647715271533684,54.33063098722828,NaN,NaN,77.0190668277179,107.36580995306997,0.024331293804188324,0.0836438208541388,0.05931252704995047,-5650000,-5613320,51.80454957122772,39.88307639050397,NaN,NaN,8.404331337801642,4.346486898363785
2003-01-22T09:30:00-05:00,20.37,20.47,20.11,20.11,56100,101250,45.80845157892669,54.365736949455986,NaN,NaN,-11.311819335764218,78.48003721720507,-0.002350322168308487,0.05637462433956486,0.05872494650787335,-5706100,-5636700,49.72484488918187,41.07929215404961,NaN,NaN,5.726104354353415,4.5435751063623036
2003-01-23T09:30:00-05:00,20.10001,20.22,19.89,19.97,111700,90000,42.77080149886102,53.484184923856574,NaN,NaN,-93.80319857645844,44.78807188622806,-0.028420491441463497,0.023199332206043977,0.05161982364750747,-5817800,-5665220,47.23382834310318,41.83655637610413,NaN,NaN,2.5162792735289954,4.253961415957545
2003-01-24T09:30:00-05:00,19.89999,20,19.53,19.53,67100,92415,34.930890776490415,52.082225716188915,NaN,NaN,-201.1980566919861,-20.909740662261047,-0.0718212995133835,-0.0381568007442219,0.0336644987691616,-5884900,-5728580,42.17854918090899,42.27463743062055,NaN,NaN,-3.2746601033915446,3.1784440560505325
2003-01-27T09:30:00-05:00,19.55,19.55,19.16,19.27,441700,112490,31.281979449249462,50.1759156659118,NaN,NaN,-249.34220652606882,-95.72724286051195,-0.11215859940180811,-0.10653375048309854,0.005624848918709565,-6326600,-5877080,33.20781048463432,42.01374719121867,NaN,NaN,-9.407518314633577,1.3804494316670883
2003-01-28T09:30:00-05:00,19.3,19.45,19.25,19.33,76100,113955,33.02080556604487,48.76005820973399,NaN,NaN,-200.8786259940169,-151.3067814248589,-0.12778391923941607,-0.15410505013056053,-0.02632113089114446,-6250500,-5997180,28.017763680971896,41.40271904157085,NaN,NaN,-13.577789524452067,-0.7564418477785053
2003-01-29T09:30:00-05:00,19.3,19.3,18.89,19.12,114500,117845,30.145640657174624,47.364228469920455,NaN,NaN,-203.1223499019385,-189.66888753809377,-0.14404066747707128,-0.20637196523748358,-0.06233129776041228,-6365000,-6128960,23.65004903421223,40.483419468326986,NaN,NaN,-18.03314617062961,-3.224542465328663
2003-01-30T09:30:00-05:00,19.14999,19.14999,18.75999,18.77,197800,124680,26.071187401864705,45.329461596166134,NaN,NaN,-193.92421752076146,-209.6930913269544,-0.16844715231431448,-0.2728902381533054,-0.1044430858389909,-6562800,-6277960,19.876995427149424,39.52247374746986,NaN,NaN,-23.355864262676146,-6.100445579235446
2003-01-31T09:30:00-05:00,18.97,19.25999,18.88,19.25999,560200,134440,38.585801588067774,44.09018123160542,NaN,NaN,-127.6356032796484,-194.98060064448683,-0.14269218133689204,-0.28280831251010596,-0.14011613117321392,-6002600,-6301500,19.35172201286423,38.411545803403136,NaN,NaN,-23.362652153654516,-8.566475089866742
2003-02-03T09:30:00-05:00,19.34,19.38,19.22,19.33,265400,129505,40.14486119914545,42.87885830819811,NaN,NaN,-88.09388082271073,-162.73093550381523,-0.11332401788564933,-0.2817711535302756,-0.16844713564462627,-5737200,-6183620,29.41147144695445,37.87607814994777,NaN,NaN,-22.820355852883115,-10.602743770297652
2003-02-04T09:30:00-05:00,19.22,19.34,19.07001,19.34,167900,134095,40.377684999322874,41.58274842590826,NaN,NaN,-84.0702161864396,-139.36925354229976,-0.08680211269353638,-0.27694977651154673,-0.19014766381801035,-5569300,-6047380,38.89779889009267,37.705880700188196,NaN,NaN,-22.328951698667115,-12.277916331493289
2003-02-05T09:30:00-05:00,19.45,19.48,19.17,19.2,281200,145850,38.140873993224254,40.57084941754135,NaN,NaN,-71.0824227509084,-112.96126811209373,-0.07282931913215945,-0.28118431273320965,-0.2083549936010502,-5850500,-5944480,44.91872615744997,37.73420327810477,NaN,NaN,-22.624840321378866,-13.75604833004837
2003-02-06T09:30:00-05:00,19.17999,19.17999,18.95,19.05,267800,157440,35.84938640703152,38.89638547949803,NaN,NaN,-87.66394408921735,-91.70921342578492,-0.06792672643968706,-0.293263401650659,-0.22533667521097195,-6118300,-5855580,49.54451671864813,37.80615663414379,NaN,NaN,-23.579998926884087,-15.159469843882045
2003-02-07T09:30:00-05:00,19.10001,19.21001,18.85001,18.92,231900,166495,33.94589505067212,37.3372839598293,NaN,NaN,-86.44425982385792,-83.47094473462684,-0.06753498991686802,-0.30975541260705697,-0.24222042269018895,-6350200,-5925100,46.27192207023686,37.43503913625972,NaN,NaN,-24.953784543096507,-16.55865765805554
2003-02-10T09:30:00-05:00,18.94,19.05,18.81,19.05,611900,195225,37.51865809820549,36.32806559030586,NaN,NaN,-81.8302355244473,-82.21821567497413,-0.053244587631683715,-0.30877615722979357,-0.25553156959810985,-5738300,-5925320,46.26150815575136,37.03910760658283,NaN,NaN,-25.029351270346684,-17.768756745525703
2003-02-11T09:30:00-05:00,19,19.16,18.69,18.69,135800,197190,32.30732085798604,35.36369911023867,NaN,NaN,-89.02187352245701,-83.20854714217762,-0.06214119749528113,-0.33320806646721124,-0.2710668689719301,-5874100,-5986280,43.35016006965169,36.58377297661639,NaN,NaN,-26.762824706937614,-19.053623597155976
2003-02-12T09:30:00-05:00,18.72,18.89,18.69,18.69,164300,201320,32.30732085798604,34.616307635890465,NaN,NaN,-94.28917375890477,-87.84989734377689,-0.06198861104333997,-0.34855263277610504,-0.2865640217327651,-5874100,-5991000,43.1238656965817,36.29020421615057,NaN,NaN,-28.128256286898594,-20.349999695690634
2003-02-13T09:30:00-05:00,18.69,18.87,18.50999,18.71001,116200,202830,32.908060351210466,34.47181974837047,NaN,NaN,-97.90675880531852,-89.89846028699712,-0.0547538864502628,-0.3550063797955936,-0.3002524933453308,-5757900,-5918920,47.62063627661689,36.67892472298685,NaN,NaN,-29.065685562376594,-21.59509767664577
2003-02-14T09:30:00-05:00,18.8,19.05,18.74001,19.05,181400,206545,42.28083655001544,35.25745239842518,NaN,NaN,-62.44196910768733,-85.09800214376301,-0.022914299840956054,-0.32889536814652587,-0.3059810683055698,-5576500,-5764180,55.715269321780234,38.28660035421156,NaN,NaN,-27.047947568157994,-22.37407623257609
2003-02-18T09:30:00-05:00,19.2,19.3,19.05,19.17999,236600,217575,45.42031432800547,36.143131595708084,NaN,NaN,-18.72607280061441,-72.47716959899643,0.009328570784967127,-0.2943203548243609,-0.30364892560932805,-5339900,-5684500,59.21080320913106,40.514674606222925,NaN,NaN,-24.401880867202614,-22.66376260895131
2003-02-19T09:30:00-05:00,19.17999,19.2,18.89999,19.03,152300,221895,42.544766629983144,37.02878345090869,NaN,NaN,-37.863273611072195,-62.24544961671946,0.02224505624710199,-0.27584260530045057,-0.29808766154755256,-5492200,-5608120,62.28406397272892,43.27424710183126,NaN,NaN,-23.0148746345104,-22.713921469745465
2003-02-20T09:30:00-05:00,19.03999,19.03999,18.77,18.84,64100,222295,39.16243557522928,37.96387260614902,NaN,NaN,-73.02242548426287,-57.99209996179106,0.01976698867922344,-0.2733789256985233,-0.29314591437774673,-5556300,-5544560,64.66962958870081,46.473720970513504,NaN,NaN,-22.842178697418046,-22.73224393084155
2003-02-21T09:30:00-05:00,18.85001,19.07001,18.81,18.95,18900,217655,42.0355659578026,38.210284346844354,NaN,NaN,-49.49130408168764,-48.30900901706489,0.026870064090557033,-0.25955833426455044,-0.28642839835510747,-5537400,-5500460,66.2640358349093,49.824600529231006,NaN,NaN,-21.839872082547075,-22.60476223822805
2003-02-24T09:30:00-05:00,18.89999,18.89999,18.69,18.69,52900,216945,37.52464280458758,38.02312589009022,NaN,NaN,-110.18114510105197,-57.856844215737816,0.015932281429486383,-0.2665130465682495,-0.28244532799773586,-5590300,-5503220,66.06309652863612,52.442573749351126,NaN,NaN,-22.34218683345558,-22.5672514661177
2003-02-25T09:30:00-05:00,18.61,18.89999,18.5,18.83,179500,203835,41.18462340022758,38.0807643472977,NaN,NaN,-106.99560905962642,-75.51075146754022,0.019750967713970058,-0.2577566183552733,-0.27750758606924336,-5410800,-5517400,64.97298318666918,54.3050869133923,NaN,NaN,-21.64382137517615,-22.435332881697477
2003-02-26T09:30:00-05:00,18.78,18.89,18.67,18.73,17900,200925,39.40872127897636,38.17132486770856,NaN,NaN,-92.08932126436692,-86.35596099819917,0.01725728524123904,-0.25593597951769453,-0.2731932647589336,-5428700,-5504700,65.52172795700997,55.77672989907516,NaN,NaN,-21.591677482336014,-22.314810681788696
2003-02-27T09:30:00-05:00,18.73,18.86,18.64,18.75,160800,203240,39.9662841316111,38.465388990892826,NaN,NaN,-88.76178751182039,-89.50383340371067,0.018556642092488307,-0.2499974621433232,-0.2685541042358115,-5267900,-5447020,67.97561336486805,57.09323680237657,NaN,NaN,-21.3909769081923,-22.18283442841778
2003-02-28T09:30:00-05:00,18.8,18.91,18.63,18.67,99300,198315,38.442444095799964,38.78657106554481,NaN,NaN,-87.19080252144292,-97.04373309166172,0.015741227352683407,-0.24887757004495725,-0.26461879739764066,-5367200,-5412980,69.36149255597144,58.7424918370719,NaN,NaN,-21.64445663214262,-22.105923314664185
2003-03-03T09:30:00-05:00,18.77,18.88,18.5,18.52,96400,175125,35.6943532773044,38.65626357833759,NaN,NaN,-115.06786496479187,-98.02107706440971,0.005991228280389893,-0.2571297620471533,-0.2631209903275432,-5463600,-5387640,70.38880427171178,60.46587013106908,NaN,NaN,-22.643123428692245,-22.182666188096764
2003-03-04T09:30:00-05:00,18.58,18.58,18.32001,18.36,190300,171370,32.98566665751379,38.704716849732435,NaN,NaN,-179.21746521304578,-112.46544829509358,-0.008245954703127834,-0.273428433706453,-0.26518247900332514,-5653900,-5436260,65.82803055181438,62.07143230836641,NaN,NaN,-24.298608142236905,-22.484943610116783
2003-03-05T09:30:00-05:00,18.37,18.39,18,18.22,374600,181705,30.78435260508124,38.59593340309637,NaN,NaN,-227.02839182951598,-139.4532624081234,-0.02325413349807387,-0.29425014587591747,-0.2709960123778436,-6028500,-5556220,56.15942626252368,63.00254377736228,NaN,NaN,-26.369837245104545,-23.039928415115035
2003-03-06T09:30:00-05:00,18.14999,18.3,18.08,18.10001,184500,176870,28.99815769119725,38.31665464166686,NaN,NaN,-216.19919056836622,-164.94074301943255,-0.03662881167161863,-0.3167820269673669,-0.28015321529574827,-6213000,-5745240,44.95505600120232,62.812145186261226,NaN,NaN,-28.662565556727802,-23.843162292488287
2003-03-07T09:30:00-05:00,17.89,18.17,17.85001,18.12,304200,178690,29.72967267158286,37.42014293606453,NaN,NaN,-206.84371589508848,-188.87132569416167,-0.03926183951912737,-0.3292305146946575,-0.2899686751755301,-5908800,-5853560,40.02671939692148,61.69153447734275,NaN,NaN,-30.350319215188232,-24.772756138588278
2003-03-10T09:30:00-05:00,18.13,18.13,17.82001,17.82001,464200,190305,25.486066386897093,35.99626808312822,NaN,NaN,-188.99940731038737,-203.65763416328076,-0.05535507176624577,-0.3591625148833373,-0.3038074431170915,-6373000,-6035440,33.40470096440464,59.84824145986229,NaN,NaN,-33.21056328591039,-25.978157159634293
2003-03-11T09:30:00-05:00,17.85001,18.2,17.85001,18,105400,164980,31.778153258949388,35.22722427091152,NaN,NaN,-136.2189934984523,-195.05793982036204,-0.048283897851410185,-0.36416231543135424,-0.31587841757994406,-6267600,-6158180,29.81940347690454,57.52933713873198,NaN,NaN,-33.77313620076052,-27.091725594080895
2003-03-12T09:30:00-05:00,17.89999,18.17999,17.89999,18.14,196900,168035,36.28490753390229,35.02168655367388,NaN,NaN,-104.92960244563078,-170.638181943585,-0.029506425150595927,-0.35276144901818896,-0.323255023867593,-6070700,-6166620,29.584267308295892,55.02323983298878,NaN,NaN,-32.8763461555592,-27.918099960006366
2003-03-13T09:30:00-05:00,18.3,18.53999,18.25,18.53999,135400,166590,47.04782464706734,35.37970503147851,NaN,NaN,-25.54012680337017,-132.5063691905858,0.01228318822070179,-0.3079010385917158,-0.3201842268124176,-5935300,-6111080,33.31095579195524,52.6694484013492,NaN,NaN,-28.420833949578643,-27.989919101373832
2003-03-14T09:30:00-05:00,18.57001,18.71001,18.46001,18.50999,187000,170130,46.41454061352074,36.014697732116595,NaN,NaN,-0.27662315918637637,-91.1929506434054,0.03883673182248126,-0.271638312034316,-0.31047504385679725,-6122300,-6153780,31.91258588810973,50.230126212740174,NaN,NaN,-25.11280680209998,-27.578903058620426
2003-03-17T09:30:00-05:00,18.41,19.07001,18.41,19.03999,335100,177815,57.3395881047904,37.16862378244251,NaN,NaN,59.890528332558176,-41.41496351481629,0.0900979964013996,-0.19785254835504773,-0.2879505447564473,-5787200,-6036620,39.426308947381614,48.40536376707677,NaN,NaN,-18.03977846216858,-26.21617097341302
2003-03-18T09:30:00-05:00,19.08,19.08,18.72,18.89999,350600,183515,54.196309072387294,38.22488005340043,NaN,NaN,78.19735686952254,1.4683065587786757,0.11119519530965283,-0.1489565506193813,-0.2601517459290341,-6137800,-6010660,40.98046329572959,46.65241629127103,NaN,NaN,-13.481466352940643,-24.396927456202683
2003-03-19T09:30:00-05:00,19.09,19.22,18.98,19.22,660500,208925,59.64227854634797,39.63030822588164,NaN,NaN,127.96747511323706,48.04772207055224,0.14138351939253474,-0.08342234668836568,-0.22480586608090042,-5477300,-5891980,47.59961209974666,45.19698762947665,NaN,NaN,-7.669034382769197,-22.007228445712187
2003-03-20T09:30:00-05:00,19.24001,19.27,18.97,19.17999,925700,252005,58.70250962080229,41.0774557633818,NaN,NaN,121.17053989948195,77.38985541112268,0.15238958581096623,-0.034318883817192614,-0.18670846962815885,-6403000,-5985520,43.4622540571684,43.347042022419295,NaN,NaN,-3.4816055192627724,-19.36071088479084
2003-03-21T09:30:00-05:00,19.19,19.49001,19.08,19.49001,158400,258980,63.5014788551344,43.063679018941095,NaN,NaN,152.63272703470366,107.97172544990069,0.17278639873388282,0.029274528789194676,-0.14351186994468815,-6244600,-6009980,42.42383327734562,41.34954409425028,NaN,NaN,1.7642838364583604,-16.342854496040957
2003-03-24T09:30:00-05:00,19.03999,19.10001,18.78,18.97,273700,270020,52.48451006027646,44.45645354770985,NaN,NaN,69.36017952365569,109.86565568812019,0.1446355243468781,0.037282535488909474,-0.10735298885796862,-6518300,-6156200,36.76834376032626,39.27385218057255,NaN,NaN,2.462249941666336,-13.656411004939915
2003-03-25T09:30:00-05:00,18.95,19.10001,18.8,18.98,286800,275385,52.65461968142271,46.018615481734244,NaN,NaN,67.30400556721067,107.6869854276578,0.12102596181474619,0.04392946341046411,-0.07709649840428208,-6231500,-6174940,36.10404469279831,37.84132492559217,NaN,NaN,3.0446345376047934,-11.270547356004958
2003-03-26T09:30:00-05:00,18.89999,19.05,18.87,18.91,398400,294410,51.270902445084744,47.60952582129763,NaN,NaN,61.10540472091988,94.31457134919438,0.09611920210088108,0.04305250422181928,-0.053066697879061805,-6629900,-6405460,29.1316965954032,36.71108496803509,NaN,NaN,3.0640898136329087,-9.222742046056691
2003-03-27T09:30:00-05:00,18.8,19.07001,18.64999,18.95,996500,336195,52.046396992843164,49.20357755853052,NaN,NaN,49.2048036936099,79.92142410801998,0.07850590574050029,0.045065684296563546,-0.033440221443936734,-5633400,-6251540,37.77289413126984,36.550097449059976,NaN,NaN,3.3115925782349898,-7.432122814015022
2003-03-28T09:30:00-05:00,18.95,18.95,18.64999,18.75,296500,346055,47.93841319186592,50.80731661602829,NaN,NaN,29.415467614091728,55.277972223897585,0.05089215885648818,0.030174977126673497,-0.020717181729814686,-5929900,-6188600,40.94394145215706,37.08861462675657,NaN,NaN,2.269194039540216,-6.046220406364274
2003-03-31T09:30:00-05:00,18.35001,18.7,18.17,18.57001,94500,345960,44.5318834813994,51.71829734620329,NaN,NaN,-23.121656117213355,36.78160509572377,0.01961887949492796,0.003806417638845261,-0.015812461856082698,-6024400,-6089820,45.62703767746309,38.2177313553679,NaN,NaN,0.3361972654874105,-5.134446453242605
2003-04-01T09:30:00-05:00,18.35001,18.57001,18.35001,18.50999,332800,353085,43.42375977091947,52.22821536313308,NaN,NaN,-24.389832891133132,18.442837404055005,-0.004697237212508261,-0.021684008371718022,-0.01698677115920976,-6357200,-6114960,44.65645223049379,39.294315992667755,NaN,NaN,-1.5736078773385553,-4.625755228113455
2003-04-02T09:30:00-05:00,18.82001,18.98,18.73,18.89999,883700,378540,51.814279122884095,52.568676397119994,NaN,NaN,40.66647426661243,14.355051313193517,0.005351882892289866,-0.010296917543847428,-0.015648800436137294,-5473500,-5883680,54.289889281495405,40.79281124192062,NaN,NaN,-0.7028229316903767,-4.0653363286244435
2003-04-03T09:30:00-05:00,18.98,18.98,18.67999,18.77,335000,386065,49.19543536583851,52.767311736571266,NaN,NaN,25.340470190739474,9.582184612619432,0.0032169311522137842,-0.011627636495870064,-0.014844567648083848,-5808500,-5918700,52.791445116307656,42.28415832964904,NaN,NaN,-0.79518133546291,-3.5981713296013673
2003-04-04T09:30:00-05:00,18.77,18.86,18.67,18.85001,333300,387520,50.8423469285687,52.30322308112686,NaN,NaN,16.623601936438355,7.023811477088756,0.006951534287415935,-0.0061551497888139295,-0.013106684076229865,-5475200,-5827760,56.17423198464862,43.48043854659669,NaN,NaN,-0.38096034060059075,-3.1385697597441133
2003-04-07T09:30:00-04:00,19.06,19.22,18.75,18.75,79800,368300,48.71652122776228,51.91180966365364,NaN,NaN,36.659256353250925,18.979993971181614,0.0026649868455385986,-0.009775450519306617,-0.012440437364845215,-5555000,-5733880,59.40791953712581,44.79668542098212,NaN,NaN,-0.656356821098982,-2.7839679113662372
2003-04-08T09:30:00-04:00,18.89,19,18.82001,18.97,65200,366290,53.338468525358344,51.46153751929724,NaN,NaN,37.81652390931124,31.42126533127049,0.013991862071737221,0.005049390224826311,-0.00894247184691091,-5489800,-5560400,64.60512533329567,46.011364937664204,NaN,NaN,0.4800688541662792,-2.317676944861592
2003-04-09T09:30:00-04:00,19.05,19.2,18.81,18.82001,250000,368945,50.02803219231148,50.84193198869075,NaN,NaN,35.236852322697246,30.33534094248745,0.010867366908072839,0.00464173678818014,-0.006225630119892699,-5739800,-5613660,61.981353351380896,47.334157744393664,NaN,NaN,0.45960417528640934,-1.9209224991261633
2003-04-10T09:30:00-04:00,18.92,18.92,18.75999,18.88,357200,380035,51.32914488844219,49.97247956249845,NaN,NaN,-10.730523556272804,23.121142193084996,0.012224488074082149,0.009054979972709987,-0.003169508101372162,-5382600,-5528480,64.46685428516756,48.908659244952375,NaN,NaN,0.8155558774276438,-1.5299970167613337
2003-04-11T09:30:00-04:00,19.05,19.08,18.89,18.92,124500,376910,52.22240625098972,49.953757861835115,NaN,NaN,35.16089575411153,26.82860095661963,0.015015879817337818,0.01560034167030011,0.0005844618529622925,-5258100,-5485060,65.69790183921089,50.97505625058698,NaN,NaN,1.3576525733977916,-1.1174756467386016
2003-04-14T09:30:00-04:00,18.97,19.25,18.97,19.25,437500,382030,58.92079348911481,50.40134170524169,NaN,NaN,119.99872393733165,43.496494473435774,0.03703281348385921,0.0468754787077863,0.009842665223927094,-4820600,-5338180,69.54204412406209,53.36348478139154,NaN,NaN,3.8726645106376365,-0.4045984813991389
2003-04-15T09:30:00-04:00,19.36,19.36,19.16,19.32001,203400,374670,60.195780928736546,51.038833025502534,NaN,NaN,153.1652771755653,66.5662451266866,0.053269420634326076,0.07642944101683469,0.02316002038250861,-4617200,-5163660,73.36191738649477,56.52278626646951,NaN,NaN,6.325326777003512,0.5568194126583826
2003-04-16T09:30:00-04:00,19.07001,19.14,18.73,18.77,1049300,394110,47.676407934019444,50.726690949872264,NaN,NaN,-17.69047064508999,55.980780533129135,0.02534224162637051,0.05483782241547175,0.02949558078910124,-5666500,-5149000,73.66074800073311,59.0862044000026,NaN,NaN,4.546753898128543,1.1268100534398342
2003-04-17T09:30:00-04:00,18.85001,19.10001,18.75999,19.10001,195900,357620,53.875013169118866,51.150733805390324,NaN,NaN,37.29155166384691,65.58519557715309,0.027301106338050704,0.06362196371166462,0.036320857373613916,-5470600,-5166600,72.6076521527109,61.347898021470726,NaN,NaN,5.145545634048996,1.7009151363840003
2003-04-21T09:30:00-04:00,19.13,19.14999,18.92999,18.96001,49000,352150,51.10884781819492,51.620516972304294,NaN,NaN,66.30427725740259,71.81387187781131,0.017832112424525703,0.058610997904271045,0.04077888547974534,-5519600,-5218900,69.43107526713555,63.048186420733046,NaN,NaN,4.703116253455573,2.129801010251368
2003-04-22T09:30:00-04:00,18.89999,19.3,18.88,19.3,305600,353745,56.896777887364195,52.58287540919321,NaN,NaN,131.34836154783926,74.08379939991282,0.03228793589141552,0.08113880534401474,0.04885086945259922,-5214000,-5297580,64.83552663479226,64.48954887818294,NaN,NaN,6.3017889921064,2.725799293373515
2003-04-23T09:30:00-04:00,19.31,19.31,19.16,19.25999,278400,353325,56.055769335766605,52.88583899582767,NaN,NaN,150.7124154454396,73.59322705388769,0.036657270250575885,0.09467245726581908,0.05801518701524319,-5492400,-5472620,55.96132837797502,64.60893738507434,NaN,NaN,7.2777160397569265,3.3760731142854308
2003-04-24T09:30:00-04:00,19.2,19.2,18.95,19.13,38300,335320,53.29925682166893,53.17896909981556,NaN,NaN,73.86165023683331,91.90365123027235,0.028649678193471778,0.09382728475708291,0.06517760656361113,-5530700,-5445460,56.94603394358928,64.90569372988018,NaN,NaN,7.21723825590813,3.924810991660102
2003-04-25T09:30:00-04:00,19.10001,19.10001,18.82001,18.84,102100,290600,47.66760588323843,52.952201882291966,NaN,NaN,-3.185980883231691,83.80814472085663,0.0030274768478115444,0.06896195262337557,0.06593447577556402,-5632800,-5477900,55.353983495504615,64.84710455208418,NaN,NaN,5.348417809641865,4.128183394228925
2003-04-28T09:30:00-04:00,18.84,19.22,18.83,19.11,349300,293240,52.68067367556579,53.235355628563646,NaN,NaN,50.52298323538073,80.65188591645226,0.0034389292907570923,0.07023313738901038,0.06679420809825329,-5283500,-5430680,57.22845193489391,64.6914282947819,NaN,NaN,5.3792151171602365,4.306902211790541
2003-04-29T09:30:00-04:00,19.23,19.33,19.11,19.28,182700,297650,55.56676923761106,53.39451996515313,NaN,NaN,122.807172124873,78.943648031859,0.013756598158515335,0.08398995579639745,0.07023335763788212,-5100800,-5408040,58.13600332733315,64.22934815149887,NaN,NaN,6.3273401581849935,4.595536204132605
2003-04-30T09:30:00-04:00,19.17999,19.24001,19.11,19.12,73900,284705,52.33163572683669,53.55906307476208,NaN,NaN,74.84581005329379,63.770326953429844,0.008651239185149845,0.08104740661931942,0.07239616743416957,-5174700,-5344500,60.659002438520865,64.134894514866,NaN,NaN,6.095157018529681,4.809767749046473
2003-05-01T09:30:00-04:00,19.07001,19.11,18.8,19.10001,64000,243720,51.92488336254175,53.60161582291204,NaN,NaN,-8.68016462335024,47.26196398139314,0.0030620496953030346,0.07622372955329837,0.07316167985799533,-5238700,-5286100,62.873670993178166,64.02109570829533,NaN,NaN,5.78899146606325,4.949656851477441
2003-05-02T09:30:00-04:00,19.02,19.25,19,19.25,71600,230550,54.765851667366995,53.783290495510414,NaN,NaN,71.02679485958994,62.10451912995744,0.008303346624917066,0.08354086313914166,0.0752375165142246,-5167100,-5192960,66.14685528877612,64.05316381183572,NaN,NaN,6.3629688784080844,5.15155856961039
2003-05-05T09:30:00-04:00,19.25999,19.27,19.09,19.13,74100,217590,52.11251883292856,53.29698516292569,NaN,NaN,61.930526545361744,64.38602779195364,0.002809169114294824,0.07874897790709312,0.0759398087927983,-5241200,-5184500,66.43630758230776,63.831325487424685,NaN,NaN,6.07736378673243,5.283816457770681
2003-05-06T09:30:00-04:00,19.13,19.3,19.13,19.23,411900,234195,54.107888486914376,52.86213570279553,NaN,NaN,84.95226884305035,56.81504713558911,0.004907701444274243,0.0820744355981411,0.07716673415386685,-4829300,-5130200,68.30925089287587,63.470420737880474,NaN,NaN,6.4036174757572635,5.443788031768764
2003-05-07T09:30:00-04:00,19.33,19.42999,19.25,19.28,456100,253740,55.114954016729584,53.39346042298911,NaN,NaN,127.22491766212288,67.29086865735493,0.008453119839512468,0.08773313395325744,0.07928001411374497,-4373200,-4969900,73.08431039301914,63.42924662304375,NaN,NaN,6.953133792172618,5.6594088546836
2003-05-08T09:30:00-04:00,19.14999,19.3,19.14999,19.19,132700,247875,52.86613532376435,53.321397719749505,NaN,NaN,61.98292884144942,81.42348735031486,0.0037658223943315,0.08398729210665934,0.08022146971232784,-4505900,-4823340,76.56159999181801,63.71167146869426,NaN,NaN,6.811050416876344,5.823929077853992
2003-05-09T09:30:00-04:00,19.35001,19.49001,19.2,19.42999,90900,234560,57.80962568136932,53.80002470997625,NaN,NaN,143.4481963381468,95.90776764602623,0.015214741844260762,0.09923989701765379,0.08402515517339303,-4415000,-4672920,79.490268022909,64.4301852369638,NaN,NaN,8.093399545203338,6.148139144618185
2003-05-12T09:30:00-04:00,19.49001,19.7,19.36,19.60001,339300,245300,60.93551964531786,54.0885062641158,NaN,NaN,223.2340327240164,128.16846888175715,0.03167735874595491,0.12362185360583666,0.09194449485988175,-4075700,-4439820,83.02915723581692,65.72973027989413,NaN,NaN,10.119594842749338,6.715489958636921
2003-05-13T09:30:00-04:00,19.60001,19.62,19.45,19.50999,252100,236030,58.46558837725874,54.26063619565095,NaN,NaN,170.12558412094046,145.20313193733517,0.033752122090387374,0.13413464747286596,0.10038252538247859,-4327800,-4339520,84.28561451666295,67.75289357551469,NaN,NaN,11.127111159061878,7.345721558697629
2003-05-14T09:30:00-04:00,19.63,19.63,19.36,19.36,135300,232625,54.501606734189224,54.34651833225955,NaN,NaN,120.29188665753989,143.81652573641858,0.022796021828528995,0.12887755266813983,0.10608153083961083,-4463100,-4357500,83.09791148762685,69.62088482866022,NaN,NaN,10.86398876212962,7.8483311591879135
2003-05-15T09:30:00-04:00,19.53,19.53999,19.38,19.50999,176000,188960,57.59764268347539,55.05580667513362,NaN,NaN,119.26404446641149,155.272748861411,0.023338831634966944,0.13525507038331952,0.11191623874835258,-4287100,-4313740,83.69993847425303,71.64559589857083,NaN,NaN,11.52810390471973,8.374012979978174
2003-05-16T09:30:00-04:00,19.45,19.58,19.33,19.39999,882200,223275,54.660027887659076,55.19718911885456,NaN,NaN,89.72120571432446,144.52735073664653,0.014415332180090681,0.12993540397346592,0.11552007179337524,-5169300,-4464600,73.92431689651596,72.83815768154383,NaN,NaN,11.250954000901771,8.785004554395831
2003-05-19T09:30:00-04:00,19.28999,19.3,19.14,19.21001,69000,224275,49.924147980176656,54.794144743323535,NaN,NaN,-15.65091149775622,96.750361892292,-0.005110674150178643,0.10913172910565194,0.11424240325583059,-5238300,-4697120,61.920378933932625,73.10847022487236,NaN,NaN,9.610059022515623,8.902869478412944
2003-05-20T09:30:00-04:00,19.25,19.42,19.22,19.33,284600,223225,52.710993377609704,54.82124171837875,NaN,NaN,31.34955442474658,68.99515595305323,-0.010465331354493762,0.10116073906271339,0.11162607041720715,-4953700,-4822300,56.59249696953312,72.8180055485161,NaN,NaN,9.021903829604524,8.919874385726027
2003-05-21T09:30:00-04:00,19.25999,19.50999,19.25999,19.48,173000,217955,56.007077109393826,55.112826986011044,NaN,NaN,67.73732146656805,58.484242914858854,-0.00471794079427193,0.10572864442436725,0.11044658521863918,-4780700,-4885820,54.05102597858063,72.18781661890198,NaN,NaN,9.479785685480094,8.999861714262323
2003-05-22T09:30:00-04:00,19.39,19.8,19.39,19.74001,233900,227735,61.07211118424183,55.563274094359244,NaN,NaN,147.23093867906314,64.0776217573892,0.014718044850067863,0.128844141281224,0.11412609643115615,-4546800,-4937760,51.99483866689615,71.17695828876771,NaN,NaN,11.452746135466048,9.350273774434283
2003-05-23T09:30:00-04:00,19.7,19.75999,19.60001,19.64,354600,240360,58.292095286647644,56.00467241248204,NaN,NaN,143.05095337387002,74.7435712892983,0.01870572948805671,0.13750825829122704,0.11880252880317033,-4901400,-4884180,53.94134332613908,70.28446084189851,NaN,NaN,12.256118691083008,9.765394476812673
2003-05-27T09:30:00-04:00,19.60001,19.88,19.59,19.83,816000,263695,61.84550221430796,56.55735910729586,NaN,NaN,162.27283099812203,110.32831978847396,0.0312668038630039,0.15788603363192522,0.12661922976892132,-4085400,-4653600,61.22744946802961,69.77861788298092,NaN,NaN,14.040363526810781,10.376104341098117
2003-05-28T09:30:00-04:00,19.92,19.98,19.81,19.95,258600,267490,63.93537714063095,57.187389330431685,NaN,NaN,185.19957220023105,141.09832334357085,0.04400454071813065,0.18162490566658462,0.13762036494845398,-3826800,-4428220,66.76216579269268,69.32703612581476,NaN,NaN,16.170561850046163,11.203883985233551
2003-05-29T09:30:00-04:00,19.97,20.09,19.81,19.85001,474500,287520,60.940095331301855,57.764100759541506,NaN,NaN,162.01052433382327,159.95296391702192,0.04204572986650401,0.190177527281584,0.14813179741507998,-4301300,-4332340,68.80244184909478,68.77281054419167,NaN,NaN,17.067970564105302,12.041610639358087
2003-05-30T09:30:00-04:00,19.97,20.14,19.92,20.06,792600,323950,64.68220699864543,58.25499942506122,NaN,NaN,174.10730401156115,165.3282369835215,0.05066446044020764,0.21146237296533954,0.1607979125251319,-3508700,-4124720,72.70905678577142,68.28843831296756,NaN,NaN,18.996406473815963,13.035152901423498
2003-06-02T09:30:00-04:00,20.2,20.24001,20.00999,20.02,338400,337290,63.43550114013832,58.43356953183411,NaN,NaN,160.52874490350192,168.82379528944787,0.04939192862833977,0.2225378233105566,0.17314589468221683,-3847100,-3913860,75.99654004099457,67.78610851333738,NaN,NaN,20.206096383376387,14.05957339884534
2003-06-03T09:30:00-04:00,20.10001,20.22,20.03999,20.22,258800,346525,66.87352641055001,59.03413653421206,NaN,NaN,152.57339663184388,166.88390841619224,0.05719011851906636,0.24463354283104977,0.1874434243119834,-3588300,-3814440,77.38010582258246,67.29285789233164,NaN,NaN,22.304378557920945,15.237402707284712
2003-06-04T09:30:00-04:00,20.28,20.44,20.17999,20.37,192400,335550,69.21172174058103,60.084859034668625,NaN,NaN,166.76650482184644,163.19729494051532,0.06694363600456615,0.2711229693176911,0.20417933331312493,-3395900,-3728260,78.53508095709729,66.96694142586524,NaN,NaN,24.806138043435812,16.60436489816344
2003-06-05T09:30:00-04:00,20.45,20.47,20.3,20.39,262400,325865,69.52063385030395,60.93650126087066,NaN,NaN,151.51516811043575,161.09822369583782,0.06896254505791116,0.2903825146355139,0.22141996957760274,-3133500,-3494700,81.31901252155559,66.79687528638686,NaN,NaN,26.928015020877133,18.07917205855111
2003-06-06T09:30:00-04:00,20.49001,20.55,20.25999,20.32001,681600,353310,66.9876357623728,61.81704468049306,NaN,NaN,129.8350038683183,152.24376366718926,0.06012758568475393,0.29657945168354516,0.23645186599879123,-3815100,-3555980,78.44429205072677,67.11973065454478,NaN,NaN,28.008224381697282,19.497608104714846
2003-06-09T09:30:00-04:00,20.38,20.39,20.21001,20.28,269000,362215,65.51803541308425,62.930893782843604,NaN,NaN,99.40554770179152,140.01912422684717,0.04672898565657729,0.29486309806951283,0.24813411241293554,-4084100,-3603380,76.20038451728973,68.13973105335599,NaN,NaN,28.513721523429442,20.78562430738836
2003-06-10T09:30:00-04:00,20.32001,20.42,20.25999,20.34,323100,361405,66.69792999823598,63.9299606843169,NaN,NaN,96.58098712423318,128.82064232532503,0.037448260579650616,0.2949444381374988,0.2574961775578482,-3761000,-3637920,74.52741381828658,69.42079654255267,NaN,NaN,29.26003270862701,21.996254078993882
2003-06-11T09:30:00-04:00,20.42999,20.50999,20.36,20.49001,164700,357035,69.50725137677325,64.89425884627259,NaN,NaN,106.25672241975947,116.71868584490764,0.0368939264492375,0.3036135856193951,0.2667196591701576,-3596300,-3678000,72.53727901226573,70.7412431878159,NaN,NaN,30.7027812885722,23.240043680362213
2003-06-12T09:30:00-04:00,20.60001,20.60001,20.3,20.56,58900,353215,70.74718469400855,65.58533552554164,NaN,NaN,102.1362261824978,106.84289745932003,0.03664740603698469,0.3125289167163885,0.2758815106794038,-3537400,-3758780,68.56335702511204,71.92470878483131,NaN,NaN,32.276177749344534,24.530919975931116
2003-06-13T09:30:00-04:00,20.5,20.58,20.32001,20.36,43100,346570,62.87881446485214,65.91295832398482,NaN,NaN,81.80616120410444,97.23712892647725,0.019293082401797,0.29999786368165005,0.28070478127985304,-3580500,-3711860,69.60495402253802,73.04353812028837,NaN,NaN,31.43367634727387,25.517028028980082
2003-06-16T09:30:00-04:00,20.55,20.77,20.45,20.77,116200,308270,70.19660409875864,66.5094656014456,NaN,NaN,117.63962576886748,100.88394453989243,0.031010463552708478,0.31946786072073863,0.28845739716803015,-3464300,-3587900,72.2234400595114,73.82896601967994,NaN,NaN,33.00138473386841,26.58622184396413
2003-06-17T09:30:00-04:00,20.78,20.8,20.57001,20.64,117700,310705,65.76943249481783,66.64046955531607,NaN,NaN,112.0985801373429,103.98746314251437,0.025802963988301342,0.3207111021534068,0.29490813816510547,-3582000,-3552100,72.94825784170547,74.27082973746656,NaN,NaN,32.85378975028426,27.481588687724148
2003-06-18T09:30:00-04:00,20.63,20.72,20.5,20.61,372300,315090,64.75448703167574,66.91292610534279,NaN,NaN,94.25180004210027,101.58647866698253,0.016583219020543605,0.31563716194078495,0.29905394292024134,-3954300,-3623700,69.06646556238087,74.28968857412985,NaN,NaN,32.423650353353786,28.187597497099812
2003-06-19T09:30:00-04:00,20.61,20.67999,20.36,20.38,116700,312275,57.436407203377215,66.39536897710934,NaN,NaN,59.21235425565427,93.00170428161383,-0.007469338643925849,0.28971726961533406,0.2971866082592599,-4071000,-3730420,63.63138228614094,73.64128325272767,NaN,NaN,29.697723078246437,28.4033297229779
2003-06-20T09:30:00-04:00,20.38,20.42999,20.22,20.28999,121100,306635,54.8251209483959,65.78034182055632,NaN,NaN,12.847132138941936,79.20989846858133,-0.030607082238128747,0.25892775546159896,0.2895348376997277,-4192100,-3852740,57.99777413070261,72.35565711627825,NaN,NaN,26.64132947103389,28.151615401271613
2003-06-23T09:30:00-04:00,20.24001,20.24001,20.03999,20.17999,108700,294340,51.72987440188771,64.69865239136615,NaN,NaN,-46.27346565712594,46.427280183382685,-0.0531644747115832,0.22307924431024873,0.2762437190218319,-4300800,-4020040,51.30701794714749,70.49329369660433,NaN,NaN,23.127950347971694,27.43394896508591
2003-06-24T09:30:00-04:00,20.17,20.45,20.17,20.39999,366200,271850,56.963119900037306,63.82375225989875,NaN,NaN,7.288076246787784,25.465179405271662,-0.05299461690627294,0.21000044788899075,0.2629950647952637,-3934600,-4090560,48.753880964417846,68.36606512569865,NaN,NaN,21.677124713867094,26.61154550062608
2003-06-25T09:30:00-04:00,20.39999,20.47,20.11,20.11,147900,266315,49.36574739397953,62.38411751301843,NaN,NaN,-47.40832253298825,-2.866845109746042,-0.07101424807180284,0.17422725470551015,0.245241502777313,-4082500,-4116200,47.82209462713771,65.97342813324022,NaN,NaN,17.83962454247538,25.358413935175978
2003-06-26T09:30:00-04:00,20.10001,20.25,20.03,20.24001,43600,244770,52.429049978254504,61.34421852843855,NaN,NaN,-84.9012497438854,-31.689565909653982,-0.07252480505408826,0.15458549645970265,0.2271103015137909,-4038900,-4109780,48.08961881483989,63.805237187819735,NaN,NaN,15.694653905667844,23.977876788103387
2003-06-27T09:30:00-04:00,20.3,20.36,20.07001,20.13,85400,209410,49.689673476683716,60.213621247267085,NaN,NaN,-86.11388431776201,-51.48176920099477,-0.07876082524768538,0.1286592699541842,0.20742009520186958,-4124300,-4096220,48.688036461715484,61.840069469564426,NaN,NaN,13.064313698289387,22.418796346701388
2003-06-30T09:30:00-04:00,20.14999,20.25999,20.09,20.16,40500,194515,50.44999487767461,59.053054452941275,NaN,NaN,-99.236259166215,-62.074327902812584,-0.07851714878808108,0.10927365921676824,0.18779080800484932,-4083800,-4052820,50.648962375279524,60.134465795063925,NaN,NaN,11.185337632551882,20.814016530394316
2003-07-01T09:30:00-04:00,20.00999,20.33,19.95,20.33,127500,187950,54.63391805635355,57.99067350148272,NaN,NaN,-84.3629448762486,-80.40453212741986,-0.06511146852256283,0.10640147235164577,0.1715129408742086,-3956300,-4057160,50.44136870964186,58.55618648773365,NaN,NaN,10.837971400990916,19.38886722619383
2003-07-02T09:30:00-04:00,20.25999,20.47,20.25999,20.46001,114000,184030,57.58367070897405,57.05042250255168,NaN,NaN,15.614020083193944,-67.80006360418342,-0.04656251334184272,0.1133097991969052,0.15987231253874792,-3842300,-4009120,52.749942896683365,57.426656907131594,NaN,NaN,11.444728413788471,18.253990252993066
2003-07-03T09:30:00-04:00,20.33,20.48,20.25,20.34,13800,171600,54.0876212345725,56.422480128960274,NaN,NaN,-4.671749008460759,-51.75416345709849,-0.041611786888497565,0.10785757892812597,0.14946936581662354,-3856100,-3972560,54.48751545073016,56.34683986628818,NaN,NaN,10.905692465235617,17.204233426170575
2003-07-07T09:30:00-04:00,20.45,20.57001,20.42999,20.49001,172000,146120,57.556409553292056,55.519609089998376,NaN,NaN,62.90692619479481,-21.95000135458713,-0.028116804757810976,0.11432335986935982,0.1424401646271708,-3684100,-3884520,58.45002154732283,55.36302425827471,NaN,NaN,11.500165458804315,16.38936657368968
2003-07-08T09:30:00-04:00,20.42,20.50999,20.35001,20.50999,67700,136055,58.011438428158904,54.96546665666559,NaN,NaN,38.59469728297375,5.616189935250621,-0.01820800490171992,0.1196801585000209,0.13788816340174082,-3616400,-3791040,62.212002797278664,54.59614889795851,NaN,NaN,12.113950070505384,15.778592787520497
2003-07-09T09:30:00-04:00,20.48,20.48,20.16,20.24001,79600,123880,50.182546007080255,53.92461372633734,NaN,NaN,-41.37746447883611,14.21328601473312,-0.02952946035571849,0.10097633795709271,0.1305057983128112,-3696000,-3738980,64.15828048570171,54.24556424962428,NaN,NaN,10.262393190592885,14.990564273673694
2003-07-10T09:30:00-04:00,20.23,20.23,20.07001,20.16,418300,136560,48.11038780332325,53.25846948347635,NaN,NaN,-98.65285285519805,-8.640088572945277,-0.04137339392818576,0.07878905590257901,0.12016244983076477,-4114300,-3793380,60.64337453737443,54.03213512471239,NaN,NaN,8.107187089691594,14.007224675961966
2003-07-11T09:30:00-04:00,20.25,20.42,20.17999,20.3,98600,138545,51.856464357546784,53.046422584129985,NaN,NaN,-25.861419454201414,-12.878022662093406,-0.03878910554392087,0.07167606790086367,0.11046517344478454,-4015700,-3825300,58.614231173710024,54.0761677706415,NaN,NaN,7.39218542417001,13.062219068563115
2003-07-14T09:30:00-04:00,20.41,20.52,20.22,20.25,90100,140895,50.45548649331753,52.955394876374974,NaN,NaN,-9.235960920036812,-27.306600085059728,-0.03933390773331184,0.061297788778144735,0.10063169651145658,-4105800,-3909640,53.51869076265193,54.234144400320375,NaN,NaN,6.396188068486315,12.109928925695002
2003-07-15T09:30:00-04:00,20.36,20.41,20.25,20.36,247700,147470,53.4359672419517,52.70345540079744,NaN,NaN,4.448507237737583,-34.135838094106965,-0.031510927699722066,0.06124303688680399,0.09275396458652606,-3858100,-3957980,50.7931656322769,54.37980759088174,NaN,NaN,6.411208320357333,11.295825982075336
2003-07-16T09:30:00-04:00,20.36,20.38,20.09,20.14999,159100,149540,47.55415454282557,52.5740559114293,NaN,NaN,-66.88635271138905,-39.23761574061756,-0.03920374823992584,0.04374927928661876,0.0829530275265446,-4017200,-4022220,47.34267336960124,54.345563215343425,NaN,NaN,4.64148367800242,10.345205652922061
2003-07-17T09:30:00-04:00,20.22,20.34,20.06,20.08,94700,135660,45.7468977485561,52.0967593235937,NaN,NaN,-89.51717714106442,-37.41048059779083,-0.04719319906418647,0.023961528696311518,0.07115472776049798,-4111900,-4021740,47.371441897361045,54.294264864094934,NaN,NaN,2.639376039445219,9.244372850996799
2003-07-18T09:30:00-04:00,20.19,20.3,20.08,20.25999,148400,137245,50.913343995123185,52.1841643606251,NaN,NaN,-45.36558408115331,-41.311313523181205,-0.03888904934165179,0.022543416083433243,0.061432465425085035,-3963500,-4011300,48.036411677194366,54.24772023662914,NaN,NaN,2.4506566287257496,8.273841962100935
2003-07-21T09:30:00-04:00,20.28999,20.28999,20.06,20.09,121800,137280,46.417523292424114,51.89613067596434,NaN,NaN,-85.80574825737455,-56.625270990648744,-0.043053973679306495,0.007614998325951916,0.05066897200525841,-4085300,-4007200,48.3126176192254,54.08083846833955,NaN,NaN,0.9002327605702909,7.220469219025128
2003-07-22T09:30:00-04:00,20.10001,20.36,20.05,20.3,155900,139640,52.05054749567013,51.71160420734411,NaN,NaN,-24.746947332567537,-62.46436190470977,-0.03046773706677184,0.012584300671793613,0.04305203773856545,-3929400,-4021460,47.36952729974395,53.86142122477541,NaN,NaN,1.3456196253170805,6.381204991352551
2003-07-23T09:30:00-04:00,20.36,20.36,20.11,20.21001,110800,126870,49.642145295788225,51.144352392116545,NaN,NaN,-28.831135246970632,-54.85331841182608,-0.02711720744847524,0.009155528427971404,0.036272735876446645,-4040200,-4026060,47.05046198136912,53.45431544511011,NaN,NaN,0.9674081683342575,5.60780544520708
2003-07-24T09:30:00-04:00,20.32001,20.35001,20.07001,20.07001,133800,126165,46.07067718764048,50.571713531621405,NaN,NaN,-73.10579781900715,-51.57104254741463,-0.032860796114364904,-0.004803259266509485,0.02805753684785542,-4174000,-4038480,46.14666820380736,52.858540641758474,NaN,NaN,-0.45772106367550036,4.741301658223854
2003-07-25T09:30:00-04:00,20.03,20.25,19.95,20.23,58300,126900,50.45725452928174,50.06463102990638,NaN,NaN,-85.87033666024496,-59.67199306323296,-0.024783756159676717,-0.002922158351740478,0.02186159780793624,-4115700,-4068920,43.91990233355344,51.820674983632095,NaN,NaN,-0.3032653099426066,4.020649234200074
2003-07-28T09:30:00-04:00,20.28,20.3,20.08,20.11,48900,125075,47.346526527716996,49.30285160844624,NaN,NaN,-69.43446402322256,-56.39773621640256,-0.02627944621556418,-0.010987709961518988,0.015291736254045191,-4164600,-4084780,42.76209473507118,50.43139583633156,NaN,NaN,-1.1317329830198388,3.2845946317400867
2003-07-29T09:30:00-04:00,20.21001,20.23,19.96001,20,81200,127110,44.63030964086125,48.90626329657345,NaN,NaN,-132.7471086427998,-77.99776847844902,-0.03299865863135342,-0.025956587035146583,0.007042071596206836,-4245800,-4148060,38.41117930597637,48.5923171806369,NaN,NaN,-2.6531272115515168,2.4363486541270003
2003-07-30T09:30:00-04:00,20.06,20.14,20.03,20.13,23200,121895,48.398024275744056,48.92680875888923,NaN,NaN,-99.08165959872352,-92.04787334879958,-0.027248191513874337,-0.027018167796136083,0.00023002371773825185,-4222600,-4184540,36.128995595787025,46.841290113380644,NaN,NaN,-2.7974302680032337,1.6886659509655382
2003-07-31T09:30:00-04:00,20.25999,20.46001,20.10001,20.13,72500,119820,48.398024275744056,48.67977732447475,NaN,NaN,-6.659922207328454,-78.75869822646385,-0.022217611987364515,-0.02754199126646739,-0.005324379279102878,-4222600,-4194260,35.52337134874976,45.19194298302635,NaN,NaN,-2.9132848709425514,1.0312444049786684
2003-08-01T09:30:00-04:00,19.96001,20.05,19.85001,19.92999,123600,125310,43.15787472590218,48.15851934108794,NaN,NaN,-194.0036019893024,-100.38535129227535,-0.030615487856047188,-0.043593739099161866,-0.012978251243114676,-4346200,-4240360,32.72178687565554,43.706449848240894,NaN,NaN,-4.5819982728480575,0.22935259386056472
2003-08-04T09:30:00-04:00,19.92,20.10001,19.75999,20.00999,142100,123815,45.69074448306243,47.60528914402442,NaN,NaN,-170.0520111522445,-120.50886071807972,-0.029050465948868277,-0.04929133367920002,-0.020240867730331746,-4204100,-4248260,32.25236645219849,42.382107049663865,NaN,NaN,-5.235503723097901,-0.5513411657049303
2003-08-05T09:30:00-04:00,19.98,20,19.75999,19.77,378200,139340,39.94099094926255,47.0614917444842,NaN,NaN,-226.0217314183356,-139.16378527318687,-0.04167773612045211,-0.07233803788089688,-0.03066030176044477,-4582300,-4315560,28.501242472405366,41.03629055700702,NaN,NaN,-7.613057584315923,-1.560157796935072
2003-08-06T09:30:00-04:00,19.74001,19.96001,19.7,19.89,165300,143625,43.75250038654949,46.91903479005515,NaN,NaN,-179.02349429784084,-155.15215221301037,-0.039469804859763605,-0.07999755783514928,-0.040527752975385675,-4417000,-4354440,26.578066221224006,39.55104943728294,NaN,NaN,-8.435750325489916,-2.5423853010143356
2003-08-07T09:30:00-04:00,19.89999,20.09,19.89999,20.06,45000,124960,48.717720617192484,46.762204548774385,NaN,NaN,-66.76519555004492,-167.17320688155365,-0.024798357291976734,-0.0715256995903566,-0.04672734229837986,-4372000,-4384320,25.172287399532664,37.91789770316425,NaN,NaN,-7.584355697434404,-3.2626667862172023
2003-08-08T09:30:00-04:00,20.14,20.19,20.03999,20.17999,152000,127630,51.94234188254002,47.15683444806837,NaN,NaN,8.040299250644726,-126.76442663356423,-0.0062191215813234,-0.05450124427503411,-0.04828212269371071,-4220000,-4359080,28.60739455887311,36.51038177028194,NaN,NaN,-5.8645828629856345,-3.6343690828984068
2003-08-11T09:30:00-04:00,20.25,20.28,20.08,20.14999,137900,130020,51.07756814893937,47.08733592330189,NaN,NaN,35.09690501908122,-85.73464339929907,0.00427764903423411,-0.04293506140091807,-0.04721271043515218,-4357900,-4389840,26.981735866713365,35.054110953636894,NaN,NaN,-4.726530784158849,-3.79039218307847
2003-08-12T09:30:00-04:00,20.2,20.35001,20.14,20.31,28800,119075,55.34764674958417,47.494871741430174,NaN,NaN,102.25270292431712,-20.079756530768535,0.021274473725359844,-0.02061961827845238,-0.04189409200381222,-4329100,-4339200,33.66496116077481,34.09800375216587,NaN,NaN,-2.4380927150267473,-3.5972065447853665
2003-08-13T09:30:00-04:00,20.37,20.37,20.19,20.24001,256200,123930,53.161890152996506,48.001386953241315,NaN,NaN,98.22772013437336,35.370486355674316,0.026727853240783264,-0.008484275452833145,-0.03521212869361641,-4585300,-4372860,31.594929061459936,33.058593813426775,NaN,NaN,-1.1711563182660176,-3.250627940996888
2003-08-14T09:30:00-04:00,20.28,20.42999,20.22,20.35001,160100,127200,56.09645430543286,48.40418693725211,NaN,NaN,128.20034232294674,74.36359393027263,0.036085772914806004,0.009895087449891093,-0.02619068546491491,-4425200,-4383500,30.94714281790985,32.13196813373795,NaN,NaN,0.7788750390832908,-2.6749846581282912
2003-08-15T09:30:00-04:00,20.42,20.42,20.32001,20.42,9500,120255,57.90369587413494,49.15827046199625,NaN,NaN,147.3019239146716,102.21591886307799,0.04476483359896702,0.029765356533793863,-0.014999477065173156,-4415700,-4422640,28.622353733101505,31.12198663359726,NaN,NaN,2.941475017638245,-1.8726332758759288
2003-08-18T09:30:00-04:00,20.36,20.48,20.36,20.46001,33200,115825,58.94411720532616,50.18068528802946,NaN,NaN,151.142858171624,125.42510949358658,0.050548146245414594,0.048185705741595086,-0.0023624405038195073,-4382500,-4427560,28.33421401072023,30.40220339822182,NaN,NaN,5.037805887433245,-0.8854276811174755
2003-08-19T09:30:00-04:00,20.33,20.42999,20.23,20.35001,389700,127515,54.924883661854885,50.646889529894516,NaN,NaN,94.2185378136776,123.81827647145865,0.04452479211696501,0.05329354964238675,0.008768757525421745,-4772200,-4516180,23.70516215881311,29.514786724152255,NaN,NaN,5.741377891771158,0.061258829295186334
2003-08-20T09:30:00-04:00,20.3,20.37,20.25,20.28,182700,131110,52.47250975110748,50.93792420670619,NaN,NaN,71.88515350029074,118.54976314464213,0.03386758953208904,0.05110324444053305,0.017235654908444004,-4954900,-4590100,20.671496655686695,28.453938531790605,NaN,NaN,5.657964785661935,0.8607882516332933
2003-08-21T09:30:00-04:00,20.28999,20.42,20.25,20.35001,436200,146230,54.6529838900736,51.75900343271844,NaN,NaN,82.43605551385083,109.39690578282296,0.02972320687747134,0.05438966350528318,0.02466645662781184,-4518700,-4608800,19.97506687173488,27.54345853151056,NaN,NaN,6.188313731912663,1.6218633202446318
2003-08-22T09:30:00-04:00,20.42,20.42,20.14999,20.17,106700,148650,48.49266305543341,51.95914047360208,NaN,NaN,35.6506673468947,87.06665446926758,0.013854751459323484,0.041984895951966195,0.02813014449264271,-4625400,-4650740,18.47195988218803,26.559143776509814,NaN,NaN,4.870258703774309,2.0859198036060143
2003-08-25T09:30:00-04:00,20.14,20.28999,20.14,20.28999,278300,160120,52.348339619663854,52.84537966434503,NaN,NaN,30.2381984063887,62.885722516220504,0.010583446384620755,0.041359452473418656,0.0307760060887979,-4347100,-4643660,19.572224692795018,25.921356792251935,NaN,NaN,4.862064240342731,2.482511865996974
2003-08-26T09:30:00-04:00,20.21001,20.36,20.12,20.32001,68800,159500,53.29041961769121,53.52665960942659,NaN,NaN,38.42723085713386,51.72746112491177,0.009613481286625654,0.04279285769707997,0.03317937641045431,-4278300,-4544880,33.13139022382737,26.38945136386646,NaN,NaN,5.1227582032428085,2.8596899141749503
2003-08-27T09:30:00-04:00,20.3,20.42,20.3,20.39999,157500,166215,55.797738820778534,54.032375195397016,NaN,NaN,80.52695840380595,53.4558221056148,0.01330321809076987,0.04980839902391665,0.03650518093314678,-4120800,-4378060,48.82294496041282,28.07878404678647,NaN,NaN,6.0563351097452065,3.3163535135421296
2003-08-28T09:30:00-04:00,20.45,20.52,20.28999,20.46001,37000,164440,57.63556467900763,54.43903396657328,NaN,NaN,94.55225811674518,55.87906262619367,0.01841602237867683,0.05952520890649282,0.04110918652781599,-4083800,-4291080,54.78119510036046,29.94834122832128,NaN,NaN,7.364825367574689,3.8947066355467808
2003-08-29T09:30:00-04:00,20.38,20.53,20.38,20.47,937500,205135,57.94895877152608,54.929847582472334,NaN,NaN,106.83480833087233,70.1158908229892,0.020917984585750504,0.06725666726000412,0.04633868267425362,-3146300,-3995260,68.29906637404618,32.899579121702196,NaN,NaN,8.536035851863208,4.557753666449127
2003-09-02T09:30:00-04:00,20.44,20.77,20.44,20.7,126000,204330,64.46638098494947,55.581185742141194,NaN,NaN,181.39992778297324,100.3482366983061,0.0356452124621597,0.09089519825195325,0.055249985789793545,-3020300,-3729900,75.40255683150654,35.88083595532589,NaN,NaN,11.593427200271394,5.562849885566593
2003-09-03T09:30:00-04:00,20.78,20.82001,20.67,20.75,327800,201810,65.71056960604191,56.477519988787286,NaN,NaN,214.1042009530021,135.48363071747977,0.045694552259822635,0.11236817611457184,0.0666736238547492,-2692500,-3412740,80.90885139674755,39.403258979275,NaN,NaN,14.507812256473773,6.840701652839048
2003-09-04T09:30:00-04:00,20.84,20.89999,20.75999,20.85001,292700,208180,68.11540726343472,57.336016628644565,NaN,NaN,224.97792365579775,164.37382376787812,0.05537245367739965,0.13588919095149876,0.08051673727409911,-2399800,-3068540,84.86786375905692,43.2547390464998,NaN,NaN,17.740364685810047,8.397796371834904
2003-09-05T09:30:00-04:00,20.72,20.78,20.60001,20.63,95700,210715,58.41033320202241,57.37220500920796,NaN,NaN,126.93770869102664,170.8509138827344,0.043761079332460734,0.13521808643967503,0.0914570071072143,-2495500,-2750880,87.45372862635817,47.456980110303846,NaN,NaN,17.679215245300036,9.723713353758495
2003-09-08T09:30:00-04:00,20.71001,20.71001,20.56,20.69,126600,209445,60.080766737014336,57.453394261471395,NaN,NaN,103.63237406640934,170.2104270298418,0.0371845305052618,0.13793767023879155,0.10075313973352976,-2368900,-2595400,88.49044684287647,51.75385388402929,NaN,NaN,18.135172394696664,10.925350359606805
2003-09-09T09:30:00-04:00,20.60001,20.60001,20.41,20.46001,624800,233790,51.53605668176908,57.21133519146527,NaN,NaN,25.206129034164366,138.97166728008003,0.01551723093139186,0.12014967839776958,0.10463244746637772,-2993700,-2590080,88.52538547847465,56.383869835433686,NaN,NaN,15.747807219958695,11.614272768228503
2003-09-10T09:30:00-04:00,20.48,20.62,20.42999,20.45,451000,254900,51.19478723051824,57.12006929713747,NaN,NaN,24.927481424091816,101.13632337429797,-0.00046958042838299296,0.10404547193089897,0.10451505235928196,-3444700,-2740520,81.03417390377356,60.695489638868466,NaN,NaN,13.758033712878959,11.920524331749997
2003-09-11T09:30:00-04:00,20.55,20.67999,20.55,20.56,94400,246810,54.74152769918941,57.12639385493145,NaN,NaN,62.42973531250771,68.62668570563997,-0.004398088652936519,0.09901744154311132,0.10341553019604784,-3350300,-2930620,72.66620268370572,64.45914219686638,NaN,NaN,13.140401907872565,12.094792556910363
2003-09-12T09:30:00-04:00,20.56,20.63,20.41,20.61,94400,243525,56.296219156143636,57.68379071926789,NaN,NaN,35.75059612806256,50.38926319304715,-0.0043817828831768935,0.09793830159207673,0.10232008447525362,-3255900,-3082700,66.72950991312268,67.90611005621886,NaN,NaN,13.090905537399628,12.237094411265973
2003-09-15T09:30:00-04:00,20.59,20.63,20.52,20.59,90600,247580,55.47532185630377,57.9071465933136,NaN,NaN,45.070185590106966,38.67682549778668,-0.0063510483986288085,0.0943812739769676,0.10073232237559641,-3346500,-3278220,59.948502550415206,70.79012990319173,NaN,NaN,12.81670116294874,12.319895375792083
2003-09-16T09:30:00-04:00,20.60001,20.64,20.45,20.60001,59600,248900,55.82253737831182,58.088012147643646,NaN,NaN,33.99599300350439,40.434798291654694,-0.007531955961213421,0.09131737742407964,0.09884933338529306,-3286900,-3336860,58.04340754812306,72.56955971207,NaN,NaN,12.684071450039399,12.371920529255984
2003-09-17T09:30:00-04:00,20.67999,20.75,20.60001,20.7,259600,242395,59.241713232254114,58.334010319891895,NaN,NaN,81.34516178371763,51.71833436357986,-0.0023973506646746967,0.09585264505444968,0.09824999571912438,-3027300,-3253380,59.99258745177918,73.36739131859618,NaN,NaN,13.515553352517992,12.535296646864843
2003-09-18T09:30:00-04:00,20.67999,20.89,20.67999,20.83,111200,238820,63.226682268793674,58.73337586201948,NaN,NaN,122.36907339557028,63.706201980192375,0.008347163384233386,0.1086839499494161,0.10033678656518272,-2916100,-3166540,61.97174415088744,73.88100196506238,NaN,NaN,15.418326116064582,12.947157999607663
2003-09-19T09:30:00-04:00,20.73,20.77,20.64,20.71001,86300,221325,57.62631787721351,58.71033008385429,NaN,NaN,73.49746724456234,71.25557620349234,0.0060718117246384845,0.10792655122098083,0.10185473949634234,-3002400,-3115840,63.118884593379285,73.51098898072904,NaN,NaN,15.431920471080115,13.30212406696087
2003-09-22T09:30:00-04:00,20.60001,20.60001,20.42,20.53999,126700,222325,50.76482763597617,57.731647701784766,NaN,NaN,-23.69011794773587,57.50351549592377,-0.007451498438419135,0.09254036644831842,0.09999186488673756,-3129100,-3072360,64.11853155793938,72.70498717547423,NaN,NaN,13.29335321282894,13.300871087799166
2003-09-23T09:30:00-04:00,20.61,20.67999,20.5,20.66,152200,216020,54.85126868197382,56.955983350065615,NaN,NaN,17.942583372300454,54.292833569682976,-0.008789876308058858,0.08900451950166399,0.09779439580972285,-2976900,-3010360,65.55233377134368,71.60809305937396,NaN,NaN,12.746534609758067,13.221680162364724
2003-09-24T09:30:00-04:00,20.67999,20.67999,20.42,20.48,271800,226170,48.36703058692243,55.54538501602902,NaN,NaN,-47.58890246070733,28.506020720797988,-0.02154671811387747,0.07086099816737601,0.09240771628125348,-3248700,-3054640,63.59771896758457,70.08879700284021,NaN,NaN,10.131828349122628,12.780272760472995
2003-09-25T09:30:00-04:00,20.46001,20.60001,20.46001,20.46001,170700,226830,47.69273628653839,54.77984237920874,NaN,NaN,-70.06057063645461,-9.979908085606993,-0.03053112345885077,0.054243811957690014,0.08477493541654078,-3419400,-3155300,59.27108736878947,68.07575119872817,NaN,NaN,7.850091490317546,12.075961150450787
2003-09-26T09:30:00-04:00,20.39,20.46001,20.35001,20.41,226800,236320,45.966231805165734,53.77166131264813,NaN,NaN,-140.9160798949484,-52.86261751350914,-0.03852628100182523,0.03661708416425924,0.07514336516608447,-3646200,-3284060,54.19235713403639,65.62588764809672,NaN,NaN,5.450857077702798,11.12951771148679
2003-09-29T09:30:00-04:00,20.48,20.48,20.34,20.41,111200,195005,45.966231805165734,53.373816678605024,NaN,NaN,-133.4753155092802,-74.81965702581799,-0.04220294726265747,0.022389681087762625,0.0645926283504201,-3646200,-3387480,50.45291543717139,62.90642550228936,NaN,NaN,3.512716315095349,10.041403226288011
2003-09-30T09:30:00-04:00,20.39999,20.45,20.2,20.32001,105000,193955,42.73750431370723,52.76972504168996,NaN,NaN,-165.74010354547426,-111.55619440937294,-0.04862689244348688,0.003809012796061495,0.05243590523954837,-3751200,-3542340,45.40102641858428,60.361200681918696,NaN,NaN,0.8951353046286583,8.734793523193819
2003-10-01T09:30:00-04:00,20.34,20.71001,20.34,20.69,191100,187120,56.32181223684882,52.88260250866563,NaN,NaN,2.8899202880153654,-101.4604298596284,-0.02697034547935301,0.01872297339035711,0.04569331886971012,-3560100,-3604620,43.513947554366005,58.27889674410871,NaN,NaN,2.8487530352597954,7.8939305963461015
2003-10-02T09:30:00-04:00,20.67,20.78,20.67,20.69,222000,183585,56.32181223684882,52.88443058585886,NaN,NaN,106.41962734222228,-66.16439026389305,-0.01239918858890756,0.030194333133575668,0.04259352172248323,-3560100,-3632760,42.65133226205152,56.55902691188935,NaN,NaN,4.358424175038135,7.388858250444963
2003-10-03T09:30:00-04:00,20.99001,21,20.8,20.85001,707100,214155,60.96625840795136,53.27664033954797,NaN,NaN,200.53238931461186,2.125303578019003,0.007206863594630061,0.0516021012157708,0.04439523762114074,-2853000,-3474120,48.81202956560575,55.76356455583153,NaN,NaN,7.187830367285011,7.360139981422113
2003-10-06T09:30:00-04:00,20.87,20.96001,20.81,20.92,209600,218305,62.82816085903494,53.77704201674248,NaN,NaN,175.82126339677015,63.98461935922908,0.023179616956026536,0.07336975881617391,0.05019014186014738,-2643400,-3273560,55.343454830107454,55.570710790258985,NaN,NaN,10.093581285205905,7.750631596248369
2003-10-07T09:30:00-04:00,20.91,21.10001,20.86,21.03,300900,202110,65.6050160179361,54.2315636442912,NaN,NaN,186.36537456208163,134.40571498074024,0.03853828457301488,0.09836299757641598,0.0598247130034011,-2342500,-2991820,62.56885683079064,55.75473003161694,NaN,NaN,13.431872947661521,8.562237503593105
2003-10-08T09:30:00-04:00,21.06,21.06,20.92999,20.97,134400,186280,62.84718131975192,54.20445643364536,NaN,NaN,150.17239908706418,163.86221074055,0.04177008901171461,0.11203732426804436,0.07026723525632975,-2476900,-2775180,66.99146050945899,56.11328120008634,NaN,NaN,15.33637090909915,9.529970847236825
2003-10-09T09:30:00-04:00,21.2,21.22,20.97,21,267100,194915,63.66953164755866,54.636114560098584,NaN,NaN,152.3825082223466,173.05478691657487,0.04287998127917206,0.12386721185529481,0.08098723057612275,-2209800,-2505120,71.51040949442896,56.7126758358756,NaN,NaN,17.133159763832733,10.616140692464812
2003-10-10T09:30:00-04:00,20.98,21.05,20.92999,20.99001,522100,216300,63.168122803842984,55.52206421494622,NaN,NaN,109.0579965189564,154.75990835744378,0.03995191719216769,0.13092712706633236,0.09097520987416467,-2731900,-2480900,71.88219385853627,57.26722314306109,NaN,NaN,18.463445987839762,11.737184306089805
2003-10-13T09:30:00-04:00,21.00999,21.16,21,21.07001,123900,217965,65.51049789680644,56.2834377302914,NaN,NaN,121.70921041093025,143.9374977602758,0.04029832731446123,0.1413481190172412,0.10104979170277997,-2608000,-2473820,71.99723406344481,57.727573163925456,NaN,NaN,20.280168011332123,12.95761054969585
2003-10-14T09:30:00-04:00,21.10001,21.19,21.00999,21.17999,247700,227370,68.47839800969687,57.7199639747753,NaN,NaN,119.43422699216102,130.55126824629167,0.04450036056480362,0.1566752424087845,0.11217488184398088,-2360300,-2477380,71.83807757819751,58.31617020754067,NaN,NaN,22.748523241265513,14.356312362777231
2003-10-15T09:30:00-04:00,21.14999,21.2,21.03999,21.14999,632100,245995,66.79003340514123,59.08405662610407,NaN,NaN,105.43042123237673,121.6028726753542,0.04186412426503777,0.1645050371752781,0.12264091291024032,-2992400,-2580480,67.20466175235102,58.88285409208078,NaN,NaN,24.334396205480253,15.781752911734806
2003-10-16T09:30:00-04:00,21.03,21.19,21,21.17999,107500,245810,67.64901688868483,60.632826989212575,NaN,NaN,92.437901232578,109.61395127740047,0.03881363197518656,0.17115795287922353,0.13234432090403697,-2884900,-2715500,61.60115910308198,59.412054232726895,NaN,NaN,25.904431426234602,17.227849842377633
2003-10-17T09:30:00-04:00,21.21001,21.21001,21,21.05,127000,247845,60.36344325526638,61.66119923564833,NaN,NaN,74.5340887887288,102.70916973135498,0.025364751750102554,0.16405026059166516,0.1386855088415626,-3011900,-2771500,59.38937101643254,60.050372488388405,NaN,NaN,25.243223516049085,18.3729032243307
2003-10-20T09:30:00-04:00,21.06,21.06,20.89,21.06,164000,249710,60.71396518908905,62.945232155318465,NaN,NaN,48.362739499885244,88.03987554914598,0.014979399299922674,0.15740975796646595,0.14243035866654327,-2847900,-2819480,57.48493844279748,60.91350906154649,NaN,NaN,24.793253677356002,19.290096146191456
2003-10-21T09:30:00-04:00,21.11,21.16,21,21.03,84700,246335,59.027491596753535,63.138494966740225,NaN,NaN,59.598555410911246,76.07274123289604,0.004471776411342471,0.14802007918072135,0.14354830276937888,-2932600,-2933940,53.1096331841732,61.59891517796128,NaN,NaN,23.95599351090214,19.956652912578697
2003-10-22T09:30:00-04:00,20.95,21.03999,20.83,20.92999,274600,246475,53.67484463770615,62.949425852515745,NaN,NaN,20.244914697044706,59.03563992582963,-0.010039722991271899,0.13099864903028902,0.14103837202156091,-3207200,-2976900,51.52450874431796,62.232713498123175,NaN,NaN,21.69732841084132,20.20532084090193
2003-10-23T09:30:00-04:00,20.8,20.97,20.8,20.92999,289000,252390,53.67484463770615,62.42861058321252,NaN,NaN,5.1322826605508265,41.57451621142419,-0.019894770729177058,0.11616990861008958,0.13606467933926664,-3207200,-3041360,49.15390587566375,62.25713323455589,NaN,NaN,19.8313312703261,20.151893759391097
2003-10-24T09:30:00-04:00,20.92,20.92,20.63,20.91,289900,255545,52.56977630341175,61.69586882923943,NaN,NaN,-33.15214836473387,20.037268780731665,-0.027544997779912567,0.10163343211437592,0.1291784298942885,-3497100,-3138400,45.74193987688152,61.57131073789689,NaN,NaN,17.95187221649442,19.837604967548714
2003-10-27T09:30:00-05:00,21.03,21.05,20.83,20.89999,166600,258315,51.99252461589714,60.72354801480808,NaN,NaN,-2.1350723065388215,9.937706419446853,-0.032712567488383,0.08828772053380973,0.12100028802219273,-3663700,-3301560,40.63464719339365,60.00458147808282,NaN,NaN,16.205110546339903,19.318677193090313
2003-10-28T09:30:00-05:00,20.89999,21.14,20.89999,21.13,907000,298415,62.25005346223727,60.6808960249856,NaN,NaN,54.36420144084304,8.890835625433176,-0.020661088900773075,0.09517392689622639,0.11583501579699947,-2756700,-3266380,42.1348840056951,58.22911172781397,NaN,NaN,17.446884229694774,19.051278198319523
2003-10-29T09:30:00-05:00,21.06,21.23,21.06,21.23,109300,294325,65.68310145841029,60.824722440046436,NaN,NaN,126.2728651329673,30.096425712617695,-0.006698646523281282,0.10746170764289786,0.11416035416617915,-2647400,-3154420,46.747218538784544,56.46031237383937,NaN,NaN,19.58813858902505,19.127972539848884
2003-10-30T09:30:00-05:00,21.3,21.3,21.08,21.2,63500,286400,63.808336216861036,60.87045196954772,NaN,NaN,130.4250364011477,55.154976460737075,-0.0005514120909609621,0.11347108905247794,0.1140225011434389,-2710900,-3055160,50.51329049065725,54.93396213327659,NaN,NaN,20.796175110673413,19.366287192823815
2003-10-31T09:30:00-05:00,21.3,21.32001,21.2,21.24001,222600,262175,65.23356751245083,60.85067122780804,NaN,NaN,156.86782726395342,93.15897158647454,0.004844284643868352,0.12007785694827433,0.11523357230440598,-2488300,-2853400,57.14721930081166,53.873246793088505,NaN,NaN,22.222851739848238,19.774367842398732
2003-11-03T09:30:00-05:00,21.34,21.47,21.34,21.42999,96682,256529.1,71.06107914160486,61.03514845151575,NaN,NaN,235.39134959056153,140.6642559658946,0.01904577470894149,0.13904079069058284,0.11999501598164135,-2391618,-2598983.6,63.746889343287435,53.29530477630921,NaN,NaN,25.447369111897267,20.584796595184237
2003-11-04T09:30:00-05:00,21.39999,21.41,21.3,21.3,36679,243318.05,63.2490513393052,60.782221161098896,NaN,NaN,155.08428374144728,160.80827242601544,0.017558952795925245,0.1419437069765479,0.12438475418062266,-2428297,-2533303,65.23541707457096,53.15464444218207,NaN,NaN,25.674335589156083,21.31187359432307
2003-11-05T09:30:00-05:00,21.34,21.34,21.14,21.27,33100,238253.05,61.56686155367081,60.34778149431218,NaN,NaN,90.3764969288584,153.6289987851937,0.01265805032958145,0.14020731709259948,0.12754926676301803,-2461397,-2496102.4,66.08480004934455,53.47490450977225,NaN,NaN,25.32619228006447,21.88534769228613
2003-11-06T09:30:00-05:00,21.23,21.44,21.19,21.39999,47900,227293.05,65.8100542920115,60.73682513979397,NaN,NaN,125.1109699132321,152.56618548761054,0.01605551949681186,0.14761866613403285,0.131563146637221,-2413497,-2436621.8,67.45402224608108,54.05095102617572,NaN,NaN,26.393250138031654,22.52933375596406
2003-11-07T09:30:00-05:00,21.44,21.5,21.35001,21.39999,71500,204763.05,65.8100542920115,61.10083150428843,NaN,NaN,143.09547499451426,149.8117150337227,0.016143894393705976,0.15174301462935347,0.1355991202356475,-2413497,-2421661.2,67.80607827579412,54.78817529996119,NaN,NaN,27.232737289902943,23.20124854652676
2003-11-10T09:30:00-05:00,21.35001,21.42999,21.27,21.34,53800,201258.05,62.138212586889146,61.323025860726695,NaN,NaN,94.54503437337623,121.64245199028565,0.01028834349831892,0.14845954960854613,0.1381712061102272,-2467297,-2436797,67.01624467721506,55.78150469232132,NaN,NaN,26.84031527817955,23.72111522247716
2003-11-11T09:30:00-05:00,21.37,21.38,21.28999,21.36,181900,197968.05,62.88177045151175,61.98066341885567,NaN,NaN,82.67127750764607,107.15985074352538,0.006095538435904879,0.14579062915510832,0.13969509071920344,-2285397,-2408217,67.77945010948491,56.94257193269039,NaN,NaN,26.73043705010644,24.151018340709914
2003-11-12T09:30:00-05:00,21.39999,21.53,21.32001,21.52,345300,183628.05,68.253183088529,63.02197330820015,NaN,NaN,116.09692695160417,112.30393674807453,0.012085283987892798,0.15480169570406943,0.14271641171617663,-1940097,-2303957,70.46434981865163,58.464746500046665,NaN,NaN,28.293390498585314,24.742785791834972
2003-11-13T09:30:00-05:00,21.34,21.34,21.17,21.27,66100,181558.05,54.88779046602404,63.187545748386746,NaN,NaN,32.87120071964755,93.85598290935764,-0.0020495243352775527,0.1401545062970797,0.14220403063235726,-2006197,-2222497,72.39953648872788,60.368860543749975,NaN,NaN,25.092754943829494,24.792781384977047
2003-11-14T09:30:00-05:00,21.31,21.35001,21.06,21.14999,250800,187748.05,49.842135353904716,63.03394651538729,NaN,NaN,1.185411092843283,65.47397012902344,-0.019756713740836096,0.11750813845631214,0.13726485219714823,-2256997,-2191197,73.12808677278903,62.689820513706785,NaN,NaN,20.672009531558057,24.204099691631477
2003-11-17T09:30:00-05:00,21.02,21.21001,20.98,21.17,492100,204153.05,50.65662395355073,62.205844407623964,NaN,NaN,-30.413548955008203,40.482253463346574,-0.029793983437198607,0.10002237290064997,0.12981635633784858,-1764897,-2050717,76.16860409691573,65.12080052022256,NaN,NaN,17.507389508667806,23.24742680835095
2003-11-18T09:30:00-05:00,21.22,21.23,21.03,21.09,89100,204373.05,47.34637764248886,60.89607842077243,NaN,NaN,-33.681521753846795,17.211693611048002,-0.04081222383103167,0.07880107654905899,0.11961330038009066,-1853997,-1964437,77.82794337733918,67.34085229440502,NaN,NaN,13.815537690990348,21.90001407729944
2003-11-19T09:30:00-05:00,21.09,21.24001,21.05,21.2,45600,192923.05,51.991816252762014,60.05204128047965,NaN,NaN,-19.539847205470178,-9.915661220366871,-0.03964934784632908,0.07005161557217932,0.1097009634185084,-1808397,-1938097,78.32413839550044,69.32734143046525,NaN,NaN,12.180705751264451,20.511541459294442
2003-11-20T09:30:00-05:00,21.2,21.27,21.03999,21.05,320500,194498.05,46.02824826092,58.680232762513164,NaN,NaN,-49.71760594146273,-26.43342255258893,-0.04741476769228875,0.050432503803147455,0.0978472714954362,-2128897,-1962637,76.60408541705932,70.7171175816258,NaN,NaN,8.765779188656643,18.8335754206319
2003-11-21T09:30:00-05:00,21.05,21.17999,21.03,21.10001,76900,183848.05,48.16306585073802,57.0446603845941,NaN,NaN,-74.13942969518284,-41.49839071019415,-0.04749695546823926,0.03847607716013712,0.08597303262837638,-2051997,-1921637,77.49338947639353,71.69901044827624,NaN,NaN,6.708207620663012,17.101380020636345
2003-11-24T09:30:00-05:00,21.24001,21.41,21.19,21.39,140900,182563.05,58.43084096018903,56.70050250037151,NaN,NaN,53.399583913502504,-24.73576413649201,-0.02733591568050346,0.05180313802774705,0.07913905370825051,-1911097,-1950877,75.29524618221954,72.41756967025114,NaN,NaN,8.47285349861995,15.868733374634003
2003-11-25T09:30:00-05:00,21.39999,21.48,21.31,21.44,108200,142623.05,59.90550619172076,56.581834260232235,NaN,NaN,95.90896352444693,1.1823329191667369,-0.010796985110824178,0.0656428223197203,0.07643980743054447,-1802897,-1940657,75.55623247521643,73.09410055781342,NaN,NaN,10.35131521816816,15.080530780853168
2003-11-26T09:30:00-05:00,21.53999,21.53999,21.3,21.41,79200,141118.05,58.56310529662525,56.064195046276076,NaN,NaN,89.68408434623517,23.027119229507807,-0.002476125089198533,0.07334465106904631,0.07582077615824484,-1882097,-1955397,74.33648352671706,73.5857049350017,NaN,NaN,11.400747052924897,14.55484739114913
2003-11-28T09:30:00-05:00,21.44,21.5,21.39999,21.49001,17600,138823.05,61.068761108903104,55.72553124748261,NaN,NaN,107.5281541215793,54.47627124211622,0.007283839078016774,0.08492557500576581,0.07764173592774903,-1864497,-1902517,75.8431564748757,74.15978194922181,NaN,NaN,13.06480638106107,14.341984389707978
2003-12-01T09:30:00-05:00,21.41,21.49001,21.31,21.45,79000,131643.05,59.142810543218744,55.51157395864901,NaN,NaN,71.25571742513779,83.55530066618034,0.009758175040363248,0.0898394547282031,0.08008127968783985,-1943497,-1880817,76.45405890199723,74.83391153670625,NaN,NaN,13.838002968991,14.269987043891266
2003-12-02T09:30:00-05:00,21.45,21.45,21.25,21.25999,304500,142033.95,50.928363452756535,54.657759173023635,NaN,NaN,15.265354572641572,75.92845479800816,-0.0020585788172645947,0.07750805616625911,0.0795666349835237,-2247997,-1948197,70.49287090081481,75.02772730751553,NaN,NaN,11.887783979640364,13.929672320426851
2003-12-03T09:30:00-05:00,21.33,21.42,21.25999,21.27,323500,156375,51.31201809208928,53.44767595899223,NaN,NaN,13.88717057193031,59.524096207504826,-0.009443756111817275,0.06776193984375212,0.07720569595556939,-1924497,-1972517,68.4192571055334,74.88164925657851,NaN,NaN,10.461029466818653,13.434151912768538
2003-12-04T09:30:00-05:00,21.28999,21.36,21.2,21.36,103500,159895,54.73837918220528,53.43700372443375,NaN,NaN,5.803181353879385,42.747915609033676,-0.008537864714105253,0.06653336506293783,0.07507122977704309,-1820997,-1960297,68.91406758911998,74.6326871923208,NaN,NaN,10.284241154392374,12.984164661571944
2003-12-05T09:30:00-05:00,21.32001,21.41,21.23,21.28999,359600,175480,51.69098644870238,53.5690645169193,NaN,NaN,9.191290387588626,23.08054286223554,-0.012674785275500283,0.05922774818266774,0.07190253345816802,-2180597,-2023517,63.38126210025705,73.93648542999709,NaN,NaN,9.222902694670454,12.44684152344316
2003-12-08T09:30:00-05:00,21.36,21.44,21.22,21.34,109600,177385,53.67495070866919,53.78465928514204,NaN,NaN,28.291665518755135,14.487732480959002,-0.012067294054713809,0.056818415889775764,0.06888570994448957,-2070997,-2049017,61.245361239328204,72.87053951159798,NaN,NaN,8.918284868241553,11.942762001271502
2003-12-09T09:30:00-05:00,21.3,21.39999,21.24001,21.25999,341100,191750,50.12797712974785,53.9833449628034,NaN,NaN,7.1914888358922076,12.872959333609135,-0.016788011982470735,0.04790069496640115,0.06468870694887188,-2412097,-2081837,58.5122934214686,71.49085022903579,NaN,NaN,7.616846299834068,11.324774043923297
2003-12-10T09:30:00-05:00,21.28999,21.35001,21.17999,21.28,183900,191850,51.00008287249896,53.912506864213185,NaN,NaN,-11.251594888204664,7.845206241582138,-0.018179574335363678,0.04196423902966728,0.06014381336503096,-2228197,-2142577,53.73324762752003,69.73435803132291,NaN,NaN,6.7904328827746845,10.677011020902066
2003-12-11T09:30:00-05:00,21.35001,21.39,21.27,21.27,85300,178850,50.5245807331285,54.233673469370935,NaN,NaN,23.48882437061177,11.382334844928613,-0.01928527163631523,0.03603722381963692,0.05532249545595215,-2313497,-2241077,47.025541834603814,67.62160491829037,NaN,NaN,5.977441745033761,10.005643981492309
2003-12-12T09:30:00-05:00,21.38,21.42999,21.2,21.41,114000,181245,56.62221884459228,54.83789868321767,NaN,NaN,47.106596580951475,18.965396083601185,-0.010537227173524864,0.04215096148904607,0.05268818866257093,-2199497,-2244857,46.784179119772624,65.42808989281745,NaN,NaN,6.987087297011558,9.574421597995059
2003-12-15T09:30:00-05:00,21.55,21.55,21.25,21.27,277300,182570,49.98755746207864,54.23480700478121,NaN,NaN,50.77358149023991,23.461779277898138,-0.013916564614870605,0.03529248289398268,0.049209047508853285,-2476797,-2326017,41.82094115774814,63.03706810535521,NaN,NaN,5.8871691076908785,9.04767124223732
2003-12-16T09:30:00-05:00,21.31,21.50999,21.27,21.48,86900,162310,57.94734138378139,54.0949380899284,NaN,NaN,98.8228663109526,41.78805477291022,-0.0023520586325675025,0.04626897421814391,0.04862103285071141,-2389897,-2321577,42.18231143158578,60.653216602238736,NaN,NaN,7.511388162950776,8.82820223091067
2003-12-17T09:30:00-05:00,21.49001,21.56,21.44,21.46001,397600,177735,57.01707710274683,53.98450750465137,NaN,NaN,147.64358539400772,73.5670908293527,0.0033006647002649867,0.05274686372604265,0.04944619902577766,-2787497,-2433437,36.09879162722881,57.921952895132435,NaN,NaN,8.505790981838734,8.78214348104325
2003-12-18T09:30:00-05:00,21.60001,21.61,21.49001,21.57001,458700,198390,60.75100514344553,53.961810649975824,NaN,NaN,183.23661885969275,105.5166497271689,0.013239807338029472,0.0659959581983145,0.052756150860285025,-2328797,-2436497,35.94606764677478,55.072160835982366,NaN,NaN,10.542317347951812,9.033596890601615
2003-12-19T09:30:00-05:00,21.53,21.53999,21.33,21.39999,62900,185510,53.07628532768154,53.5284874202946,NaN,NaN,59.229080574495256,107.94114652587766,0.007444169852375407,0.06206136317575428,0.054617193323378874,-2391697,-2474937,34.00007548289,52.03973344890328,NaN,NaN,9.811429194228984,9.144715791119811
2003-12-22T09:30:00-05:00,21.39999,21.52,21.39999,21.52,134400,188385,57.18760021738829,53.97557576062543,NaN,NaN,101.53320337451517,118.0930709027327,0.010582164180688483,0.06784489854923947,0.05726273436855099,-2257297,-2431037,38.120147383520035,49.7273960548108,NaN,NaN,10.561685898668795,9.347140092198238
2003-12-23T09:30:00-05:00,21.44,21.59,21.42999,21.53,259900,194335,57.52158288448353,54.419116102939306,NaN,NaN,120.81088630831192,122.49067490220457,0.012110386919507131,0.0724007180179349,0.060290331098427775,-1997397,-2352537,44.76063339654775,48.03749436131182,NaN,NaN,11.253929376938226,9.619538561446808
2003-12-24T09:30:00-05:00,21.53,21.53,21.42999,21.46001,52600,191555,54.32716258926441,54.389743489157816,NaN,NaN,73.85822867111432,107.73360355762588,0.007417147101004114,0.06956176497468292,0.0621446178736788,-2049997,-2205037,54.61576935858771,47.01618734484523,NaN,NaN,10.857791035085631,9.79643177196664
2003-12-26T09:30:00-05:00,21.39999,21.52,21.39999,21.48,29800,189085,55.09421493992816,54.63283123853108,NaN,NaN,63.475962837919454,83.78147235327121,0.004795850679567032,0.06813943122313759,0.06334358054357056,-2020197,-2143317,57.99295290113495,46.63130811633651,NaN,NaN,10.758987607710372,9.933939748501459
2003-12-29T09:30:00-05:00,21.56,21.66,21.45,21.62,319700,204190,60.14284173989696,55.094823455047354,NaN,NaN,143.58981625617153,100.65361948960647,0.011258448050051342,0.07741664060613473,0.06615819255608339,-1700497,-2005077,64.38543876103233,46.85559936788682,NaN,NaN,12.210599024974107,10.259176787997552
2003-12-30T09:30:00-05:00,21.64,21.72,21.60001,21.64999,479000,224190,61.15044629601273,55.88214268120913,NaN,NaN,173.38077721750912,115.02313425820526,0.016029632554913548,0.08619523324972533,0.07016560069481179,-1221497,-1797917,71.40739615452932,47.77667813453401,NaN,NaN,13.695903575709345,10.750137757670664
2003-12-31T09:30:00-05:00,21.74001,21.78,21.66,21.78,256000,221765,65.25157916614276,56.90010670218367,NaN,NaN,193.07486187904027,129.47592937235095,0.025837066827951574,0.10246193422975125,0.07662486740179968,-965497,-1591537,76.39963827623332,49.39570603801353,NaN,NaN,16.271802022455937,11.538946938354275
2004-01-02T09:30:00-05:00,21.75,21.88,21.48,21.52,356900,223435,53.16451255950202,57.08867326121035,NaN,NaN,108.21949170405576,136.3481819789392,0.01333858800956969,0.0932981024137618,0.0799595144041921,-1322397,-1446017,79.16232114695907,51.691190274610335,NaN,NaN,14.604886660605127,11.976938327247254
2004-01-05T09:30:00-05:00,21.7,21.7,21.46001,21.66,235700,230045,57.70741575825772,57.16618732647216,NaN,NaN,87.53133046556987,141.1592555044693,0.013011050102124,0.0962233270318471,0.0832122769297231,-1086697,-1259317,82.06339586327991,54.211134327718,NaN,NaN,14.759229762563612,12.374408532292447
2004-01-06T09:30:00-05:00,21.66,21.74001,21.60001,21.71001,140300,219080,59.228754480852224,57.82627282781313,NaN,NaN,120.51924959199789,136.54514217163458,0.014556585863682955,0.1014080092593268,0.08685142339564385,-946397,-1108497,84.00114589841306,57.22400609490835,NaN,NaN,15.378126962855848,12.803511165230075
2004-01-07T09:30:00-05:00,21.60001,21.67,21.5,21.62,550600,241130,55.368274735749544,57.642053781525135,NaN,NaN,61.37093520377746,114.14317376888823,0.008226181683584813,0.09713415050012486,0.08890796881654005,-1496997,-1163597,80.57629121125262,59.9664332220274,NaN,NaN,14.648692869771828,13.067108551593183
2004-01-08T09:30:00-05:00,21.77,21.77,21.5,21.59,730400,260595,54.102543386914185,57.43387280182281,NaN,NaN,67.90784822181524,89.10977103744324,0.0011020900516418297,0.09028558138109233,0.0891834913294505,-2227397,-1415977,67.08456375407857,62.179702659659526,NaN,NaN,13.675222105969784,13.153981916504126
2004-01-09T09:30:00-05:00,21.58,21.61,21.39,21.42999,741400,288470,47.823001913240965,56.510443999665334,NaN,NaN,-30.33562892642527,61.39874691134703,-0.014445459202582556,0.0711266673262223,0.08557212652880486,-2968797,-1745257,54.30787784126844,63.49126053069478,NaN,NaN,10.804951358532973,12.818406122508247
2004-01-12T09:30:00-05:00,21.39999,21.53,21.38,21.53,599900,314200,51.60395354386699,56.405277443678585,NaN,NaN,-36.75414740084298,36.54165133806446,-0.017830847212538442,0.0632835675131318,0.08111441472567024,-2368897,-2001697,46.82782443376557,64.40752831290017,NaN,NaN,9.589660622570172,12.357156765374237
2004-01-13T09:30:00-05:00,21.56,21.56,21.34,21.5,458800,331440,50.42358331174654,55.922133378989884,NaN,NaN,-54.38017138312915,1.5617671430390545,-0.02167205490655852,0.054024346092472086,0.0756964009990306,-2827697,-2377957,38.45801298772555,64.43166157034342,NaN,NaN,8.25221630415543,11.770736699485836
2004-01-14T09:30:00-05:00,21.53999,21.64,21.50999,21.58,391900,337170,53.479444221696454,55.633409188790814,NaN,NaN,25.946482986421422,-5.523123300432152,-0.018528261076359673,0.05253607465358101,0.07106433572994068,-2435797,-2565717,35.0877278333507,63.740739744400784,NaN,NaN,8.036791581802497,11.237315968388216
2004-01-15T09:30:00-05:00,21.59,21.61,21.41,21.60001,288600,347255,54.23923412692164,55.627128584337754,NaN,NaN,-11.65181460839946,-21.43505586647509,-0.014957398477748407,0.052367587632755175,0.06732498611050358,-2147197,-2549677,35.60689253876866,62.382962828699426,NaN,NaN,8.079235848325705,10.786161665522144
2004-01-16T09:30:00-05:00,21.64999,21.64999,21.50999,21.59,118800,333315,53.76615987008819,55.53226750792061,NaN,NaN,24.993669932655685,-10.369196094658898,-0.013187763297887706,0.05084028198814394,0.06402804528603165,-2265997,-2409117,40.126058255076984,61.106756068266705,NaN,NaN,7.984643235408624,10.385944746934499
2004-01-20T09:30:00-05:00,21.59,21.59,21.42999,21.52,114400,316100,50.452219499442485,54.84008020503101,NaN,NaN,-39.00713352773961,-10.819793320038224,-0.016438233841090513,0.04348025298466851,0.059918486825759024,-2380397,-2411417,40.076495049536256,59.370402946016995,NaN,NaN,6.987223299792758,9.900413111628536
2004-01-21T09:30:00-05:00,21.55,21.64999,21.48,21.61,210100,323460,54.348249219506364,54.35420898528055,NaN,NaN,17.33517862964571,3.523276682516749,-0.012416522088018009,0.04439783421573651,0.05681435630375452,-2170297,-2279937,44.311146839495166,57.43495656637169,NaN,NaN,7.205182029146387,9.515380099845371
2004-01-22T09:30:00-05:00,21.66,21.66,21.50999,21.53999,128700,323175,50.98947473101963,53.335487239914606,NaN,NaN,2.740827431345326,-1.1178544284984704,-0.014230736754902905,0.039025935360125885,0.05325667211502879,-2298997,-2252577,45.17931929331123,55.204933781877266,NaN,NaN,6.442646986340457,9.076418226487526
2004-01-23T09:30:00-05:00,21.62,21.74001,21.55,21.72,208600,320610,58.15094482436684,53.69166097311925,NaN,NaN,102.85870568848402,21.78424963087823,-0.0036195658751062496,0.048732214771145976,0.052351780646252226,-2090397,-2241217,45.558819644537344,52.80468367456142,NaN,NaN,7.939723861674822,8.914033317228569
2004-01-26T09:30:00-05:00,21.75999,21.94,21.72,21.92999,449000,340430,64.64164492609804,54.186963056536406,NaN,NaN,251.78697111324254,67.1429098669956,0.016144844118022042,0.07253283579377978,0.05638799167575774,-1641397,-2116297,49.683730088493526,50.49185040493382,NaN,NaN,11.489766321316234,9.281995174955378
2004-01-27T09:30:00-05:00,21.95,21.96001,21.82001,21.82001,224500,350165,59.4417203833856,54.20217490671736,NaN,NaN,207.5813612513628,116.46060882281608,0.020153708771455357,0.08158012764007694,0.06142641886862158,-1865897,-2013397,52.85265750722667,48.266958376991944,NaN,NaN,12.72565085315713,9.773945986127057
2004-01-28T09:30:00-05:00,21.86,21.92,21.57001,21.60001,402100,354285,50.662345682997376,53.86603711723507,NaN,NaN,60.464722834769894,125.08651766384091,0.007009997779945085,0.07018891609355293,0.06317891831360785,-2267997,-2032937,52.18059945940187,46.23869468043117,NaN,NaN,10.729591193337109,9.910466730014207
2004-01-29T09:30:00-05:00,21.7,21.94,21.64999,21.89999,833100,371990,59.45572914597094,54.24840752859626,NaN,NaN,141.60603515803209,152.8595592091783,0.016972331352919784,0.08439433250475759,0.0674220011518378,-1434897,-1860117,57.346528806034385,45.543120755570875,NaN,NaN,12.28973136235137,10.250361677490945
2004-01-30T09:30:00-05:00,21.88,21.88,21.73,21.78,155000,366940,55.21652780590361,54.7765165209293,NaN,NaN,111.73146412366492,154.63411089621448,0.01405465638276164,0.08499032163028986,0.07093566524752822,-1589897,-1760017,60.03931585315372,45.95250918499124,NaN,NaN,11.957823121602177,10.494284740935406
2004-02-02T09:30:00-05:00,21.78,21.96001,21.77,21.87,104100,354300,57.65530158960145,55.2087556670532,NaN,NaN,132.43975961582655,130.76466859673127,0.016586028748375573,0.09166820118299768,0.0750821724346221,-1485797,-1728897,60.86647074009653,46.95526963544346,NaN,NaN,12.553308093159421,10.788430934110265
2004-02-03T09:30:00-05:00,21.78,22.00999,21.78,21.98,227300,353880,60.48749664320845,55.92760661930048,NaN,NaN,139.6953111368045,117.18745857381961,0.023638610057987203,0.10463043500710612,0.08099182494911891,-1258497,-1607417,63.99915415608248,48.77963686175467,NaN,NaN,14.003061446421954,11.247663864440506
2004-02-04T09:30:00-05:00,21.98,22.17999,21.94,22.11,378700,365800,63.58715664553842,56.649586078146335,NaN,NaN,178.5048661991897,140.79548724670357,0.03437776567967099,0.12396403204870765,0.08958626636903666,-879797,-1329777,69.92482575825007,51.268000999247484,NaN,NaN,16.24585778593657,11.961691567511371
2004-02-05T09:30:00-05:00,22.19,22.28999,22.10001,22.25,494500,362995,66.62374860786875,57.53419425535685,NaN,NaN,191.2640587091537,150.7270919569279,0.04742445313233015,0.14886683278444934,0.10144237965211919,-385297,-1119857,73.479234696283,53.9731682962128,NaN,NaN,19.131180140251686,12.985904220759988
2004-02-06T09:30:00-05:00,22.34,22.44,22.2,22.42,480900,350520,69.90562856262322,58.68701344768078,NaN,NaN,195.64795520060528,167.51039017231597,0.06303996791028858,0.18024233953997992,0.11720237162969134,95603,-782757,77.97982624175775,56.677008866689995,NaN,NaN,22.679632208955258,14.370722504787883
2004-02-09T09:30:00-05:00,22.39999,22.5,22.35001,22.45,405400,333720,70.45768898842384,60.11597555403659,NaN,NaN,187.1952383291408,178.46148591497882,0.07036882902819735,0.20516340791493803,0.13479457888674068,501003,-385397,81.88271920547928,59.66316773497164,NaN,NaN,25.636942758271587,15.980182540999841
2004-02-10T09:30:00-05:00,22.38,22.55,22.38,22.53999,289600,318205,72.11041575174215,61.384701734910585,NaN,NaN,173.4494799274991,185.21231967311775,0.07578762201789285,0.22952910640910673,0.15374148439121388,790603,24423,84.8626686847425,62.55970500963216,NaN,NaN,28.600430900503998,17.78307516378615
2004-02-11T09:30:00-05:00,22.48,22.60001,22.39999,22.50999,362300,313380,70.69060654427854,62.79192543585765,NaN,NaN,148.96716594021143,179.30477962132207,0.07189494242402472,0.24361016242124478,0.17171521999722006,428303,286043,86.40047646745404,65.50407337921379,NaN,NaN,30.571600879258447,19.610007408853622
2004-02-12T09:30:00-05:00,22.55,22.60001,22.47,22.55,225100,305040,71.49665255970528,63.7451902740961,NaN,NaN,132.48733638898898,167.5494351572891,0.066674084431879,0.2550578255370688,0.1883837411051898,653403,493783,87.48748100513522,68.49897776211364,NaN,NaN,32.43114343607647,21.441598269885457
2004-02-13T09:30:00-05:00,22.5,22.59,22.33,22.41,484800,314850,64.78300888663239,63.75528769984856,NaN,NaN,96.47635206825869,147.7151145308198,0.04925465456476688,0.2499520593111484,0.2006974047463815,168603,508383,87.56272129198804,71.20461999093467,NaN,NaN,32.08616416866036,22.962250541139014
2004-02-17T09:30:00-05:00,22.60001,22.64,22.50999,22.61,207300,319275,69.22839394769807,64.45433581158515,NaN,NaN,111.19548996900222,132.51516485879208,0.04668829584697723,0.25905777455510304,0.2123694787081258,375903,483363,86.60166009471673,73.61526303289826,NaN,NaN,33.1566220259871,24.41858932468874
2004-02-18T09:30:00-05:00,22.59,22.63,22.5,22.58,492700,338190,67.8449842169019,65.68166713543549,NaN,NaN,96.5117444884073,117.12761777097371,0.03878161239009936,0.26084649419575,0.22206488180565065,-116797,301883,79.76316818873588,75.58544651356497,NaN,NaN,33.60708083552472,25.73123096909388
2004-02-19T09:30:00-05:00,22.73,22.85001,22.64999,22.69,341000,344735,70.19671106254472,66.44888012947646,NaN,NaN,115.13352318922058,110.36088922077556,0.03678828005315013,0.2680502318720883,0.2312619518189382,224203,261063,78.26611642327292,77.07970277193915,NaN,NaN,34.69559814574767,27.011854851472993
2004-02-20T09:30:00-05:00,22.78,22.91,22.71001,22.87,526200,364610,73.59935975225079,67.76193955421556,NaN,NaN,122.9829152766665,108.46000499831106,0.04298920394794414,0.28499845675386837,0.24200925280592422,750403,280463,78.47290816843449,78.39638793731635,NaN,NaN,36.72564242331768,28.399538790307947
2004-02-23T09:30:00-05:00,22.88,23.02,22.85001,23,809000,394630,75.7525141085874,69.05459759128598,NaN,NaN,134.03226121503977,115.97118682766727,0.05071220194006176,0.30539950523100146,0.2546873032909397,1559403,558623,81.2304790333424,79.85095995826248,NaN,NaN,39.131468947544995,29.93267166991324
2004-02-24T09:30:00-05:00,22.99001,22.99001,22.75,22.86,750000,409680,69.2064997037761,69.67738352418368,NaN,NaN,106.7677872995117,115.08564629376917,0.041638001575498074,0.30673480526031227,0.2650968036848142,809403,645323,82.00426356802696,81.13703920197281,NaN,NaN,39.09863290104351,31.24209470293185
2004-02-25T09:30:00-05:00,22.89999,22.97,22.84,22.92999,744700,435690,70.57543402615643,70.17654619422783,NaN,NaN,107.82448063147596,117.3481935223829,0.03581749707126841,0.3098686750238997,0.2740511779526313,1554103,979503,84.63380096377293,82.18768028808158,NaN,NaN,39.491208967346246,32.42053959784819
2004-02-26T09:30:00-05:00,22.92999,22.98,22.84,22.92999,269700,429070,70.57543402615643,70.45880943839123,NaN,NaN,104.0016251811637,115.12181392077153,0.027793232950211466,0.30879271914039563,0.28099948619018417,1554103,1245483,86.34413925014226,83.10660204192867,NaN,NaN,39.80457592317091,33.47540193003715
2004-02-27T09:30:00-05:00,22.98,23.11,22.89999,23.02,341000,404465,72.40511857907057,70.63734443956604,NaN,NaN,116.51526650849597,113.82828416713741,0.024489221700286,0.31161101331554164,0.28712179161525564,1895103,1474423,87.62130644638073,83.79527919940175,NaN,NaN,40.60019434252034,34.49322941753475
2004-03-01T09:30:00-05:00,23.12,23.28,23.03999,23.28,345600,413995,76.87775351860506,71.09592047743612,NaN,NaN,146.09536500201673,116.24090492453281,0.03510952401527756,0.3310086966343526,0.29589917261907506,2240703,1610683,88.3213920463233,84.25518440231917,NaN,NaN,42.76761342034364,35.67528427507888
2004-03-02T09:30:00-05:00,23.21001,23.24001,23,23.05,830100,450295,66.59487101432606,70.7019529961921,NaN,NaN,109.46050825074161,116.7794491147788,0.022549905539595627,0.3240865545435696,0.301536649003974,1410603,1730923,88.91705003664568,84.54478307031226,NaN,NaN,41.23160910795829,36.46904496549023
2004-03-03T09:30:00-05:00,23.05,23.17999,22.97,23.17,262500,452055,68.92991329086,70.5761891923765,NaN,NaN,102.11206023873048,115.63696503622971,0.0184047442763704,0.324542579349437,0.3061378350730666,1673103,1754723,89.036250425547,84.73305263874748,NaN,NaN,40.733551944814636,37.07826024825086
2004-03-04T09:30:00-05:00,23.17999,23.17999,23.03999,23.12,134200,439830,66.83362946647495,70.24311611428863,NaN,NaN,95.76713614050298,113.99006722809754,0.008859946997659851,0.3172127688201414,0.3083528218224815,1538903,1751683,88.9047193337709,84.83428394793575,NaN,NaN,39.6721024293501,37.44880913126504
2004-03-05T09:30:00-05:00,23.08,23.31,23,23.13,426100,436410,67.04946329917702,70.40500571518467,NaN,NaN,96.44996232232859,109.97700639086406,0.00023998273582026552,0.30865280024225683,0.30841281750643657,1965003,1765663,88.98530398853163,84.93589699768884,NaN,NaN,38.88947487475537,37.65461852319223
2004-03-08T09:30:00-05:00,23.16,23.25,23.12,23.12,233500,424040,66.58283770242741,70.21603741195106,NaN,NaN,94.29323369181654,99.61658012882404,-0.008625341583166413,0.2976311405274785,0.30625648211064493,1731503,1663823,84.1883875703118,84.76352038880279,NaN,NaN,38.120960655917294,37.72123882786724
2004-03-09T09:30:00-05:00,23.10001,23.17999,22.97,23.12,278700,417705,66.58283770242741,70.1258840894886,NaN,NaN,68.09009525591613,91.34249752985893,-0.016521882346132277,0.2856041291779796,0.3021260115241119,1731503,1728003,84.74644753663972,85.11946891365308,NaN,NaN,37.48920194871372,37.68809070227388
2004-03-10T09:30:00-05:00,23.2,23.3,23.02,23.06,730500,439750,63.50732388774777,69.64807071986023,NaN,NaN,73.59713593028775,85.6395126681704,-0.02718866174658896,0.2681401843408757,0.2953288460874647,1001003,1593583,78.49746645800141,85.13599391613367,NaN,NaN,36.1182480467245,37.463827465766826
2004-03-11T09:30:00-05:00,22.88,22.98,22.57001,22.62,886700,465970,46.53271192694267,67.71473873233823,NaN,NaN,-62.23722063029815,54.03864131401016,-0.06322134664528684,0.21630216278085612,0.27952350942614296,114303,1308663,67.18842277163616,84.32995924493379,NaN,NaN,28.965852821452437,36.249831088007625
2004-03-12T09:30:00-05:00,22.61,22.64999,22.46001,22.62,280200,468725,46.53271192694267,65.6276100050779,NaN,NaN,-113.97527544844176,11.9535937598561,-0.08504013049031134,0.17322334631325376,0.2582634768035651,114303,938523,55.917796276409256,82.52191047658141,NaN,NaN,23.39527323102731,34.41346567986758
2004-03-15T09:30:00-05:00,22.64999,22.64999,22.36,22.39999,359400,462455,40.28801925382917,63.56200425865311,NaN,NaN,-152.34724930711246,-37.3745028399297,-0.11065284037821793,0.1199474263307927,0.23060026670901063,-245097,543203,46.87395974992439,80.01260306100266,NaN,NaN,16.33109042393792,31.83026921473477
2004-03-16T09:30:00-05:00,22.49001,22.56,22.27,22.44,600900,482135,41.81719765281227,61.50784451769995,NaN,NaN,-157.65519227208023,-82.52356034552898,-0.12045477988206366,0.08003179185643106,0.2004865717384947,355803,268063,41.806023470562515,76.95347609720193,NaN,NaN,11.153549880468708,28.876452166982475
2004-03-17T09:30:00-05:00,22.50999,22.75999,22.48,22.71001,158500,465425,50.94694426834861,60.10580953499939,NaN,NaN,-86.28857176468733,-114.50070188452398,-0.10488039746206274,0.0693860749109163,0.17426647237297904,514303,170723,40.15204641714512,73.65404089484498,NaN,NaN,9.486652761371436,26.106480823323757
2004-03-18T09:30:00-05:00,22.60001,22.84,22.55,22.7,389000,467825,50.62976200971783,58.55042692290277,NaN,NaN,-69.26341433786236,-115.90594062603682,-0.09184824152442972,0.05945617046744189,0.1513044119918716,125303,172923,40.209621946784644,70.2674920020167,NaN,NaN,8.088700555543356,23.532512213640842
2004-03-19T09:30:00-05:00,22.67,22.67999,22.5,22.57001,179600,450495,46.57466682218592,56.3859207303014,NaN,NaN,-95.91248603065665,-112.29338274247979,-0.08854017362712216,0.040629194957968906,0.12916936858509107,-54297,139203,39.58109199672787,66.78604199847415,NaN,NaN,5.627551693784477,20.97466071080422
2004-03-22T09:30:00-05:00,22.39999,22.39999,22.2,22.27,355300,427810,38.842327807437286,54.40359621552363,NaN,NaN,-154.47786664868545,-112.7195062107944,-0.10214886834884751,0.0014832831490316778,0.10363215149787919,-409597,106303,38.94150194435077,63.21635999188167,NaN,NaN,0.7192469464847441,18.081030173044294
2004-03-23T09:30:00-05:00,22.37,22.39,22.2,22.23,277900,404205,37.937962128193114,52.18988541819028,NaN,NaN,-133.62212799650376,-107.91289335567913,-0.1088212231806259,-0.03239437747790319,0.0764268457027227,-687497,-102357,35.0708171828221,59.361686188829886,NaN,NaN,-3.423988442457799,15.008884656543994
2004-03-24T09:30:00-05:00,22.25,22.38,22.16,22.28999,176600,375800,40.18720560695289,50.286569428224425,NaN,NaN,-115.42790211822387,-113.74075942638642,-0.10416708489776674,-0.053782010419485715,0.05038507447828102,-510897,-307397,31.73294600787534,55.27798809412305,NaN,NaN,-6.080703179306134,11.99608639427969
2004-03-25T09:30:00-05:00,22.47,22.63,22.39,22.60001,308900,377760,50.22651851383429,49.08493051498566,NaN,NaN,-51.93630261377618,-110.27533708156918,-0.07646394943902754,-0.045194862320503404,0.031269087118524136,-201997,-372857,30.727468054177294,51.11671409881204,NaN,NaN,-5.109071056118388,9.55249247279425
2004-03-26T09:30:00-05:00,22.61,22.63,22.47,22.47,101000,365760,46.687504452253336,47.663835282830355,NaN,NaN,-50.88792256689122,-101.2704243888161,-0.06367380302358201,-0.048323166660953376,0.015350636362628633,-302997,-422597,29.950887835447062,47.24260697489313,NaN,NaN,-5.485003392867631,7.404278777699696
2004-03-29T09:30:00-05:00,22.63,22.83,22.58,22.74001,212300,359095,53.945389710695906,46.7611604262781,NaN,NaN,-3.0831973051487336,-70.99149052010875,-0.0352278424803576,-0.028684166737818373,0.00654367574253923,-90697,-358817,32.3131456625912,43.497371126746806,NaN,NaN,-3.2561522191849512,5.881360063859033
2004-03-30T09:30:00-05:00,22.8,22.89,22.72,22.88,190900,327135,57.19880030187889,46.31055159871605,NaN,NaN,29.54153832765299,-38.358757255277396,-0.006677586472461356,-0.001803307348037464,0.004874279124423892,100203,-201277,37.885146067850556,40.59649109887887,NaN,NaN,-0.3252434883290219,4.994702413546453
2004-03-31T09:30:00-05:00,22.83,22.92,22.69,22.88,305100,329265,57.19880030187888,47.072415054068635,NaN,NaN,35.208664646517015,-8.231443902329225,0.011522773127630751,0.01927774553396233,0.00775497240633158,100203,-79057,41.882304090990836,38.7889111931185,NaN,NaN,1.9316960074903875,4.557130069824158
2004-04-01T09:30:00-05:00,22.83,22.87,22.73,22.78999,360900,340600,54.33646654429751,47.62982609816542,NaN,NaN,32.593871653164705,8.67459095105895,0.016511434594215866,0.028394265649101413,0.011882831054885547,-260697,-90797,41.605345093096204,37.76659325145327,NaN,NaN,2.917784135642282,4.3229377935124615
2004-04-02T09:30:00-05:00,23.03,23.03999,22.77,22.82001,772900,357940,55.14271873975728,48.690876061445984,NaN,NaN,64.04818632268245,31.66181272897368,0.020580147035069076,0.037608014848721893,0.017027867813652817,512203,72243,46.86080401259492,37.765653555929745,NaN,NaN,3.9547365081989443,4.270337609896245
2004-04-05T09:30:00-04:00,22.78,22.95,22.78,22.89999,148600,353695,57.30557643270164,49.79718883143808,NaN,NaN,73.51765203428647,46.98198259686072,0.027000388785893233,0.05077835379601936,0.023777965010126127,660803,222543,51.21928548410609,38.438029414039995,NaN,NaN,5.460335699436068,4.4403373369733625
2004-04-06T09:30:00-04:00,22.95,23.05,22.89,23.00999,70200,343270,60.15137591931176,50.4546482350783,NaN,NaN,114.34231282716527,63.94213749676318,0.03641223079013388,0.06929325349779347,0.03288102270765959,731003,348703,54.586368612609014,39.4690524280017,NaN,NaN,7.591520272977043,4.890506327831031
2004-04-07T09:30:00-04:00,23.03999,23.03999,22.88,22.95,87100,311100,57.88531087018103,50.97290172511139,NaN,NaN,112.71570712287014,79.44354599203379,0.03627441005432094,0.07822403527556077,0.04194962522123983,643903,457443,57.32084291566997,40.6912824972078,NaN,NaN,8.739950978630338,5.440426992230932
2004-04-08T09:30:00-04:00,23.03,23.03,22.67999,22.83,588400,296185,53.540264770609326,51.470444435713055,NaN,NaN,68.65252876353853,86.65527741410855,0.02624589578769522,0.07475699495585886,0.04851109916816364,55503,520683,58.8718507750456,42.0691938385162,NaN,NaN,8.49263543785944,5.876456770177861
2004-04-12T09:30:00-04:00,22.83,22.92999,22.82001,22.92,264100,295380,56.19600554003712,52.70999284518448,NaN,NaN,75.6925657221559,88.98415329400325,0.0238856874159291,0.07836820843807502,0.054482521022145916,319603,482163,57.50111566564246,43.394880532894184,NaN,NaN,9.04479006467084,6.329075812248287
2004-04-13T09:30:00-04:00,22.96001,22.96001,22.64,22.69,132900,284055,48.5570914633248,53.46850208340817,NaN,NaN,28.994620201316174,80.0795469274092,0.005979457907348697,0.061956843406331785,0.05597738549898309,186703,387343,54.158323210315636,44.75827382057229,NaN,NaN,7.197256218304304,6.453101584542003
2004-04-14T09:30:00-04:00,22.69,22.85001,22.60001,22.85001,534600,280740,53.31193296562272,54.40598260902744,NaN,NaN,25.98609203107542,62.40830276819122,0.0041438563376042375,0.06115720592098839,0.05701334958338415,721303,385403,54.08903986060977,46.35513766719618,NaN,NaN,7.092412222194897,6.544431675635274
2004-04-15T09:30:00-04:00,22.89999,22.97,22.78999,22.92,761800,310905,55.25989754426241,54.76550968262945,NaN,NaN,68.08685642046483,53.48253262771017,0.006722927503922324,0.06541700896328706,0.058694081459364736,1483103,553243,58.97842674959953,48.373063288297764,NaN,NaN,7.601471217543919,6.695437324479366
2004-04-16T09:30:00-04:00,23.03999,23.13,22.96001,23.08,415700,312240,59.427407041542565,55.67550272472153,NaN,NaN,115.3802825286662,62.8280833807357,0.017662735851067063,0.08077250127319857,0.06310976542213151,1898803,921903,67.23292887104188,51.03606621941169,NaN,NaN,9.345708471574211,7.074047488350058
2004-04-19T09:30:00-04:00,23,23.2,23,23.14999,188600,312690,61.13294712001576,56.1888996825301,NaN,NaN,126.1110686667394,72.9117839696524,0.027484924589988885,0.09746592115961761,0.06998099656962872,2087403,1275463,72.87103865138678,53.93305857575423,NaN,NaN,11.303333545935338,7.678231210862241
2004-04-20T09:30:00-04:00,23.24001,23.24001,22.97,22.97,720100,330930,54.75803651273029,56.014559411876625,NaN,NaN,104.71369550188912,88.05559902976697,0.020075932342366112,0.09507591199758636,0.07499997965522025,1367303,1511583,75.8585746350314,56.645446330552865,NaN,NaN,11.033900200302922,8.157612495068053
2004-04-21T09:30:00-04:00,22.89999,23.09,22.82001,23.02,655500,349810,56.12672658050353,55.93798271749267,NaN,NaN,69.48079803762936,96.75454023107777,0.016886828682897342,0.09610851550884192,0.07922168682594458,2022803,1771883,78.64987445833557,59.27170135679177,NaN,NaN,11.225675475458505,8.595907206552402
2004-04-22T09:30:00-04:00,23.03999,23.25,22.91,23.25,282900,355125,61.84491671283852,56.474300586674175,NaN,NaN,143.17352030791503,111.77187300856781,0.027958538509987446,0.11416985996342888,0.08621132145344143,2305703,1936403,80.20753454439023,62.02900060331278,NaN,NaN,13.223503127185129,9.256992338071363
2004-04-23T09:30:00-04:00,23.10001,23.31,23.08,23.27,300600,354710,62.30499234542731,56.98589155850775,NaN,NaN,166.2258372760206,121.94098395803869,0.033922820061908096,0.12861484653082655,0.09469202646891846,2606303,2077903,81.46037461500549,64.50039850348496,NaN,NaN,14.956829336735591,10.071254766451966
2004-04-26T09:30:00-04:00,23.3,23.35001,23.14,23.22,142800,356800,60.34592455838476,57.20305928177083,NaN,NaN,154.9650028529569,127.7117707952822,0.031828653587787,0.1344778434536522,0.10264918986586521,2463503,2153123,82.1087089084051,66.70678589093488,NaN,NaN,15.819784362319798,10.892473280147371
2004-04-27T09:30:00-04:00,23.27,23.39,23.22,23.28,323600,362365,61.8943212948823,57.32755538002586,NaN,NaN,161.2085756251319,139.01074681993074,0.031740786756182277,0.14232517331109307,0.11058438655491079,2787103,2437083,84.33569584121777,68.83173783583551,NaN,NaN,16.98713660459177,11.763139469353714
2004-04-28T09:30:00-04:00,23.25999,23.27,23.00999,23.00999,476600,376650,52.045373599979,56.91041700358287,NaN,NaN,55.74442778877565,136.26347277016,0.011782224886545983,0.12531216766309328,0.1135299427765473,2310503,2494623,84.74992933935582,70.79095829467022,NaN,NaN,14.99721605991621,12.225150410862643
2004-04-29T09:30:00-04:00,23.13,23.22,23.00999,23.13,152900,369040,55.439379013721954,57.046068020948056,NaN,NaN,59.859137316723086,119.60059617192162,0.005278668287920826,0.12012827813644833,0.1148496098485275,2463403,2526163,84.98432814407113,72.65613524960061,NaN,NaN,14.374105823062688,12.532144041176934
2004-04-30T09:30:00-04:00,23.27,23.39,23.16,23.17999,589100,380450,56.810606495372745,57.089968089186314,NaN,NaN,107.82770256909588,107.92096923053668,0.0030688315366086127,0.11868564926928826,0.11561681773267965,3052503,2615403,85.65611704677767,74.66720677682456,NaN,NaN,14.276997838145261,12.781408869315268
2004-05-03T09:30:00-04:00,23.3,23.36,23.2,23.32001,1041000,393855,60.479014711690894,57.94153403549817,NaN,NaN,118.21950443714175,100.57186954737367,0.009404568282172468,0.12737252808539523,0.11796795980322276,4093503,2941403,87.80289674153931,77.07039060048339,NaN,NaN,15.31273716030829,13.143027196599984
2004-05-04T09:30:00-04:00,23.38,23.38,23.10001,23.22,799500,426400,56.770008596397986,58.18853943769641,NaN,NaN,82.81951857112537,84.89405813657235,0.0054247863911805055,0.12474894279219839,0.11932415640101789,3294003,3042783,88.38507569388123,79.52010744571706,NaN,NaN,15.06320535006731,13.41733836138103
2004-05-05T09:30:00-04:00,23.22,23.27,23.14999,23.25999,754600,460620,57.88227896122745,58.37585239605106,NaN,NaN,72.15972244829723,88.17711706847668,0.004110172755570768,0.12446187234548134,0.12035169958991057,4048603,3390403,90.12548952610923,81.74489764403918,NaN,NaN,15.182160418021423,13.669455798043945
2004-05-06T09:30:00-04:00,23.25999,23.25999,23.00999,23.16,425000,477515,54.131955064631455,57.99760582627169,NaN,NaN,29.901582460635673,82.1856060972592,-0.00440761532768745,0.11484218043030126,0.1192497957579887,3623603,3622443,91.08569946921943,83.44866697248044,NaN,NaN,14.187154062618534,13.743412692983172
2004-05-07T09:30:00-04:00,23.10001,23.17999,22.86,22.94,374000,466795,46.92749665720958,56.9829307932141,NaN,NaN,-48.436061171423475,50.93285334915534,-0.02464240906761392,0.08844678442347131,0.11308919349108523,3249603,3661863,91.24151757954601,84.76084403877753,NaN,NaN,11.021343701676747,13.354545694225111
2004-05-10T09:30:00-04:00,22.75,22.92999,22.72,22.83,661800,486680,43.78936634231866,56.19945435247042,NaN,NaN,-128.20814408376663,1.6473236449736306,-0.04408434557790056,0.05798376151870954,0.1020681070966101,2587803,3360723,79.77032588207162,85.04025484213754,NaN,NaN,7.374417485938765,12.500241664469918
2004-05-11T09:30:00-04:00,22.89999,22.91,22.64,22.78999,443400,502205,42.67161997510104,55.23837530922738,NaN,NaN,-152.91937627438588,-45.50045532412862,-0.057443080667187216,0.030264256262626077,0.08770733692981329,2144403,3130803,72.29676011256728,84.58646096029695,NaN,NaN,4.0676741225097075,11.295589158475602
2004-05-12T09:30:00-04:00,22.74001,22.74001,22.39,22.67,1116500,531300,39.42171055616867,53.6367177266081,NaN,NaN,-222.09224733657112,-104.3508492811023,-0.07126190834109382,-0.0013700484965539772,0.06989185984453984,1027903,2526663,57.14645682344954,82.93924112308692,NaN,NaN,0.2330698012503054,9.71522925030056
2004-05-13T09:30:00-04:00,22.7,22.74001,22.53,22.63,862900,536355,38.37252541893844,51.92725580328747,NaN,NaN,-180.85818880623398,-146.50280353447621,-0.0793775121196867,-0.029330030305068533,0.05004748181461817,165003,1834943,45.412267223284594,80.36437630939257,NaN,NaN,-3.2337974923090576,7.8653682870706145
2004-05-14T09:30:00-04:00,22.60001,22.8,22.52,22.72,983700,564755,42.106034114619334,50.624406485875646,NaN,NaN,-133.23629045395327,-163.46284939098217,-0.07501579858719262,-0.0437222664193726,0.031293532167820014,1148703,1414763,40.034653602816405,77.35908664470765,NaN,NaN,-5.131730149270799,6.008639939021841
2004-05-17T09:30:00-04:00,22.53,22.69,22.46001,22.57001,412400,575945,37.976833137957264,48.916014474666724,NaN,NaN,-142.36062031191082,-166.293344636611,-0.07820681748116357,-0.06646498968363446,0.011741827797529115,736303,1044463,35.989833032712795,73.90581072981443,NaN,NaN,-8.051115965150965,4.0001033812828695
2004-05-18T09:30:00-04:00,22.7,22.77,22.64999,22.7,554900,567685,43.17766793959492,48.28260692749643,NaN,NaN,-87.64858410830732,-153.2391862033953,-0.06791854558364901,-0.07315635418203215,-0.005237808598383135,1291203,873823,34.27149708495806,70.30020842592889,NaN,NaN,-8.99944221961525,2.143025438297424
2004-05-19T09:30:00-04:00,22.8,22.84,22.53999,22.58,660200,567920,39.85520493246849,47.16945163597833,NaN,NaN,-91.12672172368666,-127.04608108081841,-0.06552002124260592,-0.08713783515164053,-0.021617813909034615,631003,794443,33.47090618403236,66.62067828592612,NaN,NaN,-10.825231399005068,0.29041731868278253
2004-05-20T09:30:00-04:00,22.56,22.7,22.50999,22.66,1020900,604820,43.00396137101997,46.18326269852456,NaN,NaN,-87.60792773549585,-108.39602886667076,-0.05527950628419144,-0.09071719676427392,-0.03543769048008248,1651903,1091823,39.20097134261714,63.30245359277178,NaN,NaN,-11.402438389959825,-1.3799906396947328
2004-05-21T09:30:00-04:00,22.74001,22.82001,22.63,22.67,142600,596920,43.40283050252816,44.96353525501293,NaN,NaN,-59.25835874737553,-93.60044252535522,-0.04500185153770629,-0.09169000490221535,-0.04668815336450906,1794503,1220983,41.55544049499426,59.99906386087571,NaN,NaN,-11.755685325093296,-2.8622327376088132
2004-05-24T09:30:00-04:00,22.7,22.77,22.5,22.58,578500,618705,40.645876968799165,43.811811567327304,NaN,NaN,-75.40370899337356,-80.20906026164778,-0.04151888799557718,-0.09858676335898053,-0.05706787536340335,1216003,1316923,43.31153318997082,56.779525110596396,NaN,NaN,-12.846426144442006,-4.288546081442126
2004-05-25T09:30:00-04:00,22.58,22.87,22.45,22.85001,418000,623425,50.75272278923145,43.30255755504187,NaN,NaN,-42.45410235649545,-71.17016391128541,-0.019407660874354124,-0.08132745145634601,-0.06191979058199189,1634003,1385483,44.59275891619685,53.52718720988837,NaN,NaN,-10.649906248579951,-5.197311819604672
2004-05-26T09:30:00-04:00,22.82001,22.88,22.75,22.87,92600,604225,51.41236454811873,43.10830108957668,NaN,NaN,-8.12202592016273,-54.56922475058061,-0.002691164416748784,-0.06528374610292786,-0.06259258168617908,1726603,1604603,48.591828747696944,50.49191072977961,NaN,NaN,-8.692530753497659,-5.696628810160813
2004-05-27T09:30:00-04:00,23.06,23.14999,22.95,23.14,762500,634705,59.33519350658618,43.99456515024644,NaN,NaN,67.00402008793806,-23.646835185893842,0.02572890084632061,-0.030431455628278314,-0.056160356474598924,2489103,1772043,51.47405671440968,47.6513778108413,NaN,NaN,-4.231998641299116,-5.487395928894856
2004-05-28T09:30:00-04:00,23.14999,23.14999,23.00999,23.05,521400,631320,56.054052029006954,44.87061412786703,NaN,NaN,70.18803692647485,2.24244394887623,0.036961709174016366,-0.009958220007078467,-0.04691992918109483,1967703,1806683,52.07271956679916,45.672977359750405,NaN,NaN,-1.6289999519466012,-4.936196503616534
2004-06-01T09:30:00-04:00,23.05,23.07001,22.89999,23.05,158200,587180,56.054052029006954,45.826502131717454,NaN,NaN,59.906950524789124,29.304575852508766,0.04249238198504286,0.006195548300208742,-0.03629683368483412,1967703,1957023,54.68563622121577,44.415039938939586,NaN,NaN,0.42309226253808824,-4.170583822737302
2004-06-02T09:30:00-04:00,23.14999,23.27,23.06,23.24001,101000,552255,61.29471444511567,47.38885955235653,NaN,NaN,126.70476526096054,63.13634937599996,0.05618828528331289,0.03393852291930699,-0.022249762364005898,2068703,2043963,56.173652962746615,44.34555394888937,NaN,NaN,3.9186723226400417,-3.01497580196911
2004-06-03T09:30:00-04:00,23.21001,23.38,23.19,23.19,1102300,569640,59.29061894998586,48.88300909028849,NaN,NaN,147.36711930358433,94.23417842074939,0.058838454844485535,0.05129830619160103,-0.00754014865288451,966403,1891923,52.90200212719643,44.880535013454505,NaN,NaN,6.1646292335117385,-1.7036036540432744
2004-06-04T09:30:00-04:00,23.32001,23.36,23.17,23.23,206200,558700,60.40572357373643,50.19012976593971,NaN,NaN,140.14029054976433,108.86143251311464,0.06003656940291521,0.0675055631007595,0.007468993697844293,1172603,1628623,47.71876414022972,45.429400051841164,NaN,NaN,8.338562023461268,-0.2690085572569114
2004-06-07T09:30:00-04:00,23.31,23.45,23.23,23.42999,770700,578535,65.49479658586552,52.15569858364744,NaN,NaN,154.12419617802922,125.64866436342552,0.07033510942003215,0.09538788047288449,0.025052771052852335,1943303,1623743,47.62562689407037,46.26052818479527,NaN,NaN,11.903162032571508,1.46987295557572
2004-06-08T09:30:00-04:00,23.42999,23.56,23.35001,23.53999,678500,579370,67.93594301453925,53.92414680328632,NaN,NaN,153.31834105886574,144.33094247024084,0.079894493816235,0.12492088832314607,0.04502639450691108,2621803,1754563,50.41936259240068,47.41394714961261,NaN,NaN,15.681788615603448,3.5001466212939665
2004-06-09T09:30:00-04:00,23.53,23.56,23.42,23.45,538100,584105,63.94995721609161,55.64520053783083,NaN,NaN,128.95707722301574,144.78140486265187,0.07554448076359789,0.13945699546140844,0.06391251469781055,2083703,1757563,50.48459128006697,48.62921037075794,NaN,NaN,17.630442205862483,5.518760276232326
2004-06-10T09:30:00-04:00,23.48,23.48,23.35001,23.45,146300,535595,63.949957216091605,57.14134309819309,NaN,NaN,104.3620122002563,136.18038344198627,0.06827513214632096,0.14925642988071175,0.08098129773439079,2083703,1981023,55.21129385201262,49.77280483571475,NaN,NaN,19.19198403326576,7.4720779558085315
2004-06-14T09:30:00-04:00,23.39999,23.39999,23.25,23.33,283700,506635,58.62995222084468,58.228994649501416,NaN,NaN,74.29436042110193,123.01119741625378,0.051743339325687004,0.14566047189149955,0.09391713256581255,1800003,2106503,57.65569412746141,50.92282295231956,NaN,NaN,18.99502780585164,9.118213648671833
2004-06-15T09:30:00-04:00,23.5,23.5,23.35001,23.44,319300,473415,61.76957205328243,59.73783001267879,NaN,NaN,89.05990725173584,109.9983396309951,0.0448327789600379,0.14995810626585993,0.10512532730582203,2119303,2141703,58.34252465500551,51.99646519982203,NaN,NaN,19.750716582470393,10.637142639214485
2004-06-16T09:30:00-04:00,23.44,23.45,23.35001,23.41,318500,468720,60.422766494911286,60.428547420227346,NaN,NaN,76.67918549357594,94.67050851793715,0.035278227789992386,0.1492231120433125,0.11394488425332013,1800803,1977503,53.94675365159567,52.664607680921954,NaN,NaN,19.987087287727437,11.972849017573477
2004-06-17T09:30:00-04:00,23.42,23.42,23.3,23.32001,161300,449040,56.44693171939198,60.788159361032584,NaN,NaN,57.32623285517032,80.34433964436808,0.020658511897239357,0.13976802412486933,0.11910951222762997,1639503,1888663,51.678058658947286,52.885052674582695,NaN,NaN,19.043283669468742,12.982911110701371
2004-06-18T09:30:00-04:00,23.10001,23.3,23.10001,23.23,518500,441955,52.710909702364376,60.3149962321596,NaN,NaN,18.4743099675459,63.166799197825995,0.003582077269195613,0.12358710881412449,0.12000503154492888,1121003,1696123,47.0590279430546,52.56969347662876,NaN,NaN,17.13926634803586,13.576676144606298
2004-06-21T09:30:00-04:00,23.13,23.34,23.13,23.2,211500,401485,51.48773621031439,59.9888308165387,NaN,NaN,15.969396794890276,51.50180647258365,-0.0103174724198834,0.10710819102007463,0.11742566343995803,909503,1518023,43.211582530879376,51.9367551169202,NaN,NaN,15.20973156434934,13.80996977599816
2004-06-22T09:30:00-04:00,23.17999,23.27,23.05,23.21001,148800,401795,51.88890789358534,59.69132052115145,NaN,NaN,-6.558304347109654,32.378164152814556,-0.018920314477090056,0.09377527034359545,0.11269558482068551,1058303,1305823,39.10887138486971,50.8241290571812,NaN,NaN,13.713935761193527,13.79625063102607
2004-06-23T09:30:00-04:00,23.23,23.28,23.03999,23.24001,308500,388295,53.13961731444858,59.10881358324666,NaN,NaN,-15.997304382225968,13.842866177654173,-0.02243346928516192,0.0846537482142331,0.10708721749939502,1366803,1219023,37.53883197478353,49.493070415183844,NaN,NaN,12.763549600790242,13.648721912420951
2004-06-24T09:30:00-04:00,23.16,23.67,23.09,23.14999,200900,377440,49.02148666290123,58.375304134169184,NaN,NaN,26.150366299682265,7.607692866556564,-0.03018060694592227,0.06936145881699218,0.09954206576291445,1165903,1124303,35.847604379301785,48.27489914747707,NaN,NaN,10.791938480077064,13.240609993514681
2004-06-25T09:30:00-04:00,23.13,23.17999,22.91,22.92999,393800,392500,40.716792985573605,56.968951949300404,NaN,NaN,-139.51239607243113,-23.98964834143884,-0.04840163751003369,0.03904001887537234,0.08744165638540603,772103,1054523,34.610508830572044,47.338595196787246,NaN,NaN,6.343958609463156,12.25537408150732
2004-06-28T09:30:00-04:00,22.87,23.12,22.87,22.92999,695900,389170,40.716792985573605,55.19909454927955,NaN,NaN,-148.97934690383778,-56.979397081184445,-0.05808212153953135,0.014839004460991845,0.0729211260005232,772103,1027043,34.111266505197904,46.373283740439206,NaN,NaN,2.763103204701046,10.89933538482071
2004-06-29T09:30:00-04:00,22.96001,23.03,22.92999,22.95,706700,398435,41.75759992194885,53.32921289980881,NaN,NaN,-142.4659248380705,-84.16092117937663,-0.06049271713316125,-0.0026947704159283603,0.05779794671723289,1478803,1111143,37.10151676489189,45.42200903847429,NaN,NaN,0.06781625922688297,9.351975509735876
2004-06-30T09:30:00-04:00,22.92999,23.11,22.92999,23.09,314700,406260,48.56197719759369,52.2300714699161,NaN,NaN,-107.84938906091621,-102.53133811511468,-0.050424963471746374,-0.005233257622450083,0.04519170584929629,1793503,1196483,40.07356690442684,44.67836444021429,NaN,NaN,-0.4223374139537595,7.955645092065929
2004-07-01T09:30:00-04:00,23.14,23.14999,22.78999,22.86,539900,428205,40.24372983835601,50.53676951436355,NaN,NaN,-142.37775958929313,-136.23696329290973,-0.056561397447033784,-0.02551004095949594,0.031051356487537846,1253603,1214023,40.69383216088213,43.64140289084782,NaN,NaN,-3.5796002506262283,6.307752900252764
2004-07-02T09:30:00-04:00,22.78999,22.99001,22.78999,22.86,165100,381345,40.24372983835601,49.22346791561436,NaN,NaN,-141.22477094222313,-136.57943826686815,-0.05772564275272598,-0.04110569695336963,0.01661994579935635,1253603,1310323,44.113970431837075,42.67413691258894,NaN,NaN,-6.064578096986962,4.540277043504232
2004-07-06T09:30:00-04:00,22.84,22.95,22.78999,22.87,705100,406290,40.75544167966336,47.722458603213,NaN,NaN,-124.48426827845486,-131.68042254179156,-0.054942639810162154,-0.05205835396334635,0.002884285846815807,1958703,1547643,51.532045580975094,42.187674121586774,NaN,NaN,-7.933501899112098,2.7583086231304703
2004-07-07T09:30:00-04:00,22.86,22.95,22.84,22.89,294000,382455,41.828363179266866,46.39428693780982,NaN,NaN,-102.26371342253886,-123.63998025868526,-0.04906806572138394,-0.05845079630491412,-0.00938273058353018,2252703,1702423,55.66534173309922,42.31043041312274,NaN,NaN,-9.189629454338153,1.0514603263492384
2004-07-08T09:30:00-04:00,22.78,22.99001,22.78,22.86,158000,356430,40.63946833967035,45.265182410686855,NaN,NaN,-95.96040783927043,-121.26218401435608,-0.044642756756506634,-0.06518617652916348,-0.02054341977265684,2094703,1762663,57.1953289459076,42.704521147905616,NaN,NaN,-10.57492150944615,-0.6094513644786743
2004-07-09T09:30:00-04:00,22.88,22.95,22.86,22.92,339000,346475,44.06383261094077,44.647534047013735,NaN,NaN,-75.97367569317342,-107.98136723513214,-0.0355124614862353,-0.06493399663045096,-0.029421535144215666,2433703,1998683,62.63593281897009,43.81715721047101,NaN,NaN,-10.85164324514448,-2.072621633145218
2004-07-12T09:30:00-04:00,22.89999,22.99001,22.81,22.95,354500,356885,45.74900588770827,44.23762473825616,NaN,NaN,-67.1442785353835,-93.16526875376421,-0.025745386947011603,-0.06160326882798017,-0.03585788188096857,2788203,2305603,68.28174355668119,45.60788299802828,NaN,NaN,-10.634508414508437,-3.2957483161971064
2004-07-13T09:30:00-04:00,22.98,23.02,22.88,22.98,451900,365295,47.45382250208282,43.920832924577404,NaN,NaN,-46.045074940901515,-77.47743008625355,-0.01603251874053603,-0.055898530306638605,-0.039866011566102574,3240103,2561883,72.07597945825569,47.962676431841565,NaN,NaN,-9.995751622476616,-4.252891645665608
2004-07-14T09:30:00-04:00,22.86,23.10001,22.83,22.97,970900,397875,46.92448470068173,43.47689488073691,NaN,NaN,-38.59649359484941,-64.74398612071566,-0.009378955813862534,-0.05158970633343074,-0.042210750519568206,2269203,2565183,72.12222363589404,50.43291869334946,NaN,NaN,-9.587847351995293,-5.0150281751412775
2004-07-15T09:30:00-04:00,23.03999,23.03999,22.74001,22.82001,246900,394295,39.76041776201661,42.81538995924516,NaN,NaN,-80.89323110703343,-61.73055077426825,-0.013904155151451589,-0.05959094445888269,-0.0456867893074311,2022303,2550703,71.56220544567765,52.983961626662015,NaN,NaN,-11.210500041501419,-5.9000955846212975
2004-07-16T09:30:00-04:00,22.99001,23.10001,22.8,22.81,601600,416310,39.328870807565025,42.716252660815975,NaN,NaN,-59.32971162039693,-58.40175795971296,-0.016233880717547847,-0.0659791402043659,-0.04974525948681806,1420703,2348103,64.06639068021613,55.08795318735088,NaN,NaN,-12.674622179077513,-6.8678850981150426
2004-07-19T09:30:00-04:00,22.83,22.94,22.77,22.82001,166600,398715,40.029836931885654,42.667184371266835,NaN,NaN,-91.88906338544125,-63.3507149297245,-0.01575076786563826,-0.06943371931886588,-0.05368295145322762,1587303,2107923,56.50956849403638,56.68783190083934,NaN,NaN,-13.720478671615362,-7.846827037186516
2004-07-20T09:30:00-04:00,22.74001,23.02,22.74001,22.83,187900,397535,40.76537756792524,42.59631134597943,NaN,NaN,-77.79107846106766,-69.69991563375773,-0.013495325128322064,-0.0705521078636302,-0.057056782735308134,1775203,1814943,48.928103326835476,57.53258808383532,NaN,NaN,-14.420490279544133,-8.785921786094747
2004-07-21T09:30:00-04:00,22.92,22.92,22.52,22.52,1546900,467440,28.91416118032582,41.192895916174585,NaN,NaN,-217.43832164632747,-105.46828124405333,-0.03063751005902357,-0.09535367030908759,-0.06471616025006402,228303,1406763,40.72951905893316,57.57944180915719,NaN,NaN,-19.099078917895433,-10.25922994778056
2004-07-22T09:30:00-04:00,22.37,22.52,22.31,22.45,1137800,508905,27.00502432724832,40.24727409395261,NaN,NaN,-332.98811133742157,-155.88725729013098,-0.04365306215836469,-0.11928248794801988,-0.07562942578965519,-909497,820403,32.34489602900442,56.98308922830878,NaN,NaN,-23.594207775015427,-12.164226780242682
2004-07-23T09:30:00-04:00,22.42,22.42,22.03,22.12,301400,513930,20.225183272939447,38.817377910708565,NaN,NaN,-343.43533295647916,-212.70838155734742,-0.06989292243076908,-0.16299557882811655,-0.09310265639734747,-1210897,294083,26.976649111625505,55.75899484829366,NaN,NaN,-30.661038392781947,-14.806628439176862
2004-07-26T09:30:00-04:00,22.2,22.2,21.95,22.03999,128100,500645,18.980933631853304,37.262055907293565,NaN,NaN,-263.06153208105707,-246.9428752964706,-0.08693290814795038,-0.20176879158228544,-0.11483588343433507,-1338997,-291177,22.50395474317797,53.68555978845102,NaN,NaN,-36.6011126879429,-17.92012618900058
2004-07-27T09:30:00-04:00,22.14999,22.28,22.05,22.27,299800,480840,31.94301879722019,36.555959880004515,NaN,NaN,-164.60216574661754,-264.30509275358054,-0.07733043669743417,-0.2114989293061278,-0.13416849260869362,-1039197,-854057,19.205837255979745,51.08130946865676,NaN,NaN,-36.68268840551648,-20.60049221993142
2004-07-28T09:30:00-04:00,22.19,22.3,21.92999,22.21001,437800,467395,30.569323862922616,35.83666384595111,NaN,NaN,-144.75544838668466,-249.76851810165198,-0.06986323746468526,-0.2214975394395502,-0.15163430197486494,-1476997,-1195117,17.529446937933457,48.2480321823729,NaN,NaN,-37.23794009707398,-22.977270488094643
2004-07-29T09:30:00-04:00,22.25,22.25,21.88,21.95,720400,487680,25.45896933250377,34.50774504034847,NaN,NaN,-143.81841471997222,-211.93457877816212,-0.0767314050804268,-0.24754855832539846,-0.17081715324497165,-2197397,-1452697,16.367490038010473,44.943143412304345,NaN,NaN,-39.67301882993629,-25.36237739407202
2004-07-30T09:30:00-04:00,21.88,21.98,21.83,21.95,416900,481530,25.45896933250377,33.05845671497672,NaN,NaN,-138.71912248101776,-170.99133668306985,-0.07545654505649407,-0.26513783456558926,-0.18968128950909519,-2197397,-1649997,15.51892882592027,41.17437093153571,NaN,NaN,-41.46279181991915,-27.662436597764465
2004-08-02T09:30:00-04:00,21.86,22.24001,21.86,22.17,551400,500845,35.96387667087261,32.2377462984617,NaN,NaN,-91.34401789654628,-136.64783384616769,-0.05493275656437571,-0.2583472352145648,-0.2034144786501891,-1645997,-1711397,15.25389109687832,37.11565033429448,NaN,NaN,-39.152129926809806,-29.303821359056656
2004-08-03T09:30:00-04:00,22.12,22.14999,22.00999,22.08,112000,471190,33.86151363529913,31.30467693664866,NaN,NaN,-82.51564844570694,-120.23053038598559,-0.043078276448331926,-0.257262324210604,-0.2141840477622721,-1757997,-1855157,14.624137580991942,33.008644187515756,NaN,NaN,-38.05755210218838,-30.55435432236119
2004-08-04T09:30:00-04:00,21.92,22.22,21.92,22.13,129700,462975,36.096515702003025,31.042969646647695,NaN,NaN,-72.57145564964681,-105.79373183857801,-0.028246325265943784,-0.24949195434470184,-0.22124562907875805,-1628297,-1885417,14.488546748028924,28.93195428054085,NaN,NaN,-36.45205323331718,-31.396882738212046
2004-08-05T09:30:00-04:00,22.21001,22.21001,21.83,21.87,238200,466985,30.352605053110153,30.401807807043777,NaN,NaN,-85.09694065987937,-94.04943702655945,-0.032044764986540436,-0.2613015853119336,-0.22925682032539316,-1866497,-1819237,16.315994818610704,25.52121171899761,NaN,NaN,-37.038217139513755,-32.20278765268372
2004-08-06T09:30:00-04:00,21.74001,21.78999,21.60001,21.60001,580700,479070,25.767281293657916,29.38305383288465,NaN,NaN,-125.4583786622065,-91.39728826279719,-0.047885754267843805,-0.2891140131601979,-0.2412282588923541,-2447197,-1869197,16.037360882644094,22.6303397467553,NaN,NaN,-39.24874553688776,-33.209353064712865
2004-08-09T09:30:00-04:00,21.67999,21.72,21.63,21.67999,310500,476870,29.18035887884284,28.555552497950185,NaN,NaN,-113.3279109729148,-95.7940668780709,-0.048000960350189914,-0.3012294593300915,-0.2532284989799016,-2136697,-1967337,15.47818455310481,20.24105983434597,NaN,NaN,-39.74822833283537,-34.14347810301608
2004-08-10T09:30:00-04:00,21.67,21.86,21.67,21.85001,230000,465775,35.924773196699604,29.056310499119743,NaN,NaN,-88.04959089323356,-96.90085536757621,-0.03239796454089067,-0.2937259546560149,-0.26132799011512425,-1906697,-1997077,15.304043303422915,18.424954423238095,NaN,NaN,-37.77319202737282,-34.662008663638474
2004-08-11T09:30:00-04:00,21.8,22.03999,21.75,22.02,201400,427300,41.88405433636303,30.119098356913646,NaN,NaN,-58.41205891551006,-94.06897602074886,-0.007689112136429421,-0.270939380285661,-0.2632502681492316,-1705297,-2012477,15.208624052977925,17.200934996379058,NaN,NaN,-34.04290294075905,-34.57356498894141
2004-08-12T09:30:00-04:00,22.14,22.14999,21.97,21.97,229300,426420,40.685454515942546,31.580546302842436,NaN,NaN,-34.92321850516745,-84.03423158980648,0.007410113078298974,-0.2539876268013579,-0.26139773987965687,-1934597,-2026097,15.118842024350855,16.353948775859443,NaN,NaN,-31.526780506649903,-34.13831006289977
2004-08-13T09:30:00-04:00,22.08,22.11,21.96001,22.07001,1228200,457750,44.129479681626435,33.376871020683375,NaN,NaN,-24.935599106918463,-63.92967567874888,0.025251082406542558,-0.22983388687147865,-0.2550849692780212,-706397,-1677937,26.98471567734589,16.674003128300004,NaN,NaN,-28.352748642004897,-33.311801288486215
2004-08-16T09:30:00-04:00,22.12,22.21001,22.00999,22.21001,707300,484785,48.626392466640326,34.5685405684991,NaN,NaN,14.874984511128735,-38.289096581940164,0.046369786787236716,-0.19712273579397532,-0.24349252258121204,903,-1250417,38.37661682792467,18.043344526296075,NaN,NaN,-24.22478365473461,-32.01365591223598
2004-08-17T09:30:00-04:00,22.35001,22.35001,22.16,22.23,245800,487680,49.254449607673195,35.903192407409854,NaN,NaN,75.16050955413371,-5.647076492466705,0.06067139065939539,-0.1676532842569678,-0.22832467491636319,246703,-819737,47.29730225364623,20.169619905989844,NaN,NaN,-20.757513883334386,-30.405635622392897
2004-08-18T09:30:00-04:00,22.31,22.38,22.23,22.38,414600,431065,53.81696853697038,37.92876377915747,NaN,NaN,129.98020052074648,32.031375394784604,0.07810910639579,-0.13068829192162568,-0.20879739831741567,661303,-346417,55.006168335103325,22.92952549863934,NaN,NaN,-16.33742557381318,-28.395891329738653
2004-08-19T09:30:00-04:00,22.42,22.42,22.2,22.27,154800,381915,50.249005915809235,39.699480677965006,NaN,NaN,122.41579142935933,63.49917738168997,0.07982774337282633,-0.10901271910138277,-0.1888404624742091,506503,141803,61.29500187376589,26.19924500205688,NaN,NaN,-13.702862314118377,-26.296887184650043
2004-08-20T09:30:00-04:00,22.3,22.37,22.22,22.37,64600,370075,53.281381921176674,40.936445338701006,NaN,NaN,125.27928344234199,93.54215389154204,0.08482363834948078,-0.08281091453735812,-0.1676345528868389,571103,397303,64.12127508480494,29.689772429765927,NaN,NaN,-10.563508580768495,-24.049261669809823
2004-08-23T09:30:00-04:00,22.39,22.39999,22.2,22.28999,98100,368575,50.62276302059551,42.13367743765075,NaN,NaN,101.32134890342992,110.83142677000228,0.07993061418558287,-0.06772128515486031,-0.14765189934044318,473003,491723,65.13448844543524,33.29765463436902,NaN,NaN,-8.7324935248798,-21.86115193481982
2004-08-24T09:30:00-04:00,22.28999,22.38,22.27,22.3,44900,355830,50.95250325707489,43.19481940587017,NaN,NaN,103.94216439676917,116.58775773852938,0.07465859555542911,-0.05432865489615679,-0.1289872504515859,517903,545963,65.73314605768665,36.95798315648743,NaN,NaN,-7.154584352391804,-19.760213708758673
2004-08-25T09:30:00-04:00,22.19,22.45,22.17999,22.42999,109600,339420,55.14185672094712,44.965480239287096,NaN,NaN,108.58034788457482,112.30778721129505,0.07691207972805698,-0.03284715079151468,-0.10975923051957166,627503,539203,65.5820062503721,40.47698397304181,NaN,NaN,-4.548729901692152,-17.587144593463456
2004-08-26T09:30:00-04:00,22.34,22.47,22.34,22.47,60300,306415,56.37692156063901,47.15188311550003,NaN,NaN,119.30121913620799,111.68487275266477,0.07784666032248412,-0.012450905116466515,-0.09029756543895064,687803,575463,66.03315057551464,44.04811180824686,NaN,NaN,-2.0308259685551877,-15.364813361333704
2004-08-27T09:30:00-04:00,22.46001,22.49001,22.39999,22.42999,96000,290370,54.75345017510356,48.978532493804366,NaN,NaN,109.89974188544129,108.60896444128464,0.07262146770210212,0.00047926918867702284,-0.0721421985134251,591803,579603,66.08780722991074,47.66308485659014,NaN,NaN,-0.3560916356050476,-13.220710257658181
2004-08-30T09:30:00-04:00,22.45,22.46001,22.32001,22.32001,57000,265650,50.45257840793149,50.01623286603522,NaN,NaN,75.78257582121933,103.50120982484252,0.05917852084466475,0.0018309525424058393,-0.057347568302258914,534803,591963,66.26235142170262,51.302964007895824,NaN,NaN,-0.08219105445374404,-11.34377894291469
2004-08-31T09:30:00-04:00,22.23,22.39999,22.2,22.34,141000,267100,51.202858031586814,50.681861701408344,NaN,NaN,52.82553230495431,93.27788340647955,0.049449048270273244,0.004463742035582641,-0.0449853062346906,675803,623543,66.73347549724161,54.98331053962895,NaN,NaN,0.34761818734722877,-9.673579352877274
2004-09-01T09:30:00-04:00,22.32001,22.42,22.22,22.34,315000,276365,51.202858031586814,51.43310480966865,NaN,NaN,52.495306471909956,82.06087512394657,0.04116872498084736,0.006475599991368597,-0.03469312498947876,675803,633203,66.88580512208222,58.68095076089548,NaN,NaN,0.7052647191761441,-8.19088734258393
2004-09-02T09:30:00-04:00,22.45,22.61,22.37,22.60001,164600,272685,60.27674805965961,52.5864811223853,NaN,NaN,108.27727067503038,79.85608543171107,0.05073016753539267,0.02871958442976208,-0.02201058310563059,840403,663723,67.3938113827988,61.56731473985639,NaN,NaN,3.7374122354125445,-6.4868445457272905
2004-09-03T09:30:00-04:00,22.67999,22.78,22.67,22.7,70500,247175,63.11711962117525,53.621533061994946,NaN,NaN,170.4322617608206,91.96258940678692,0.060645529772677745,0.05379632911021659,-0.006849200662461155,910903,727543,68.48264514711381,63.71774533408419,NaN,NaN,7.193290296901292,-4.532539568208922
2004-09-07T09:30:00-04:00,22.78999,22.78999,22.60001,22.7,119700,237635,63.11711962117525,54.61172377724508,NaN,NaN,168.9525898305408,110.59659220865123,0.06374359070289262,0.07283028771615463,0.009086697013262004,910903,802763,69.7642198738339,65.3225251640976,NaN,NaN,9.986533353704624,-2.4583862936498435
2004-09-08T09:30:00-04:00,22.55,22.64,22.42999,22.46001,181600,235215,52.639793100372266,54.52763981748808,NaN,NaN,85.94860949152269,117.22120764596491,0.04694540809682704,0.0677684571342958,0.020823049037468764,729303,813463,69.95139734937908,66.39004152226015,NaN,NaN,9.372305626500708,-0.7682874479140507
2004-09-09T09:30:00-04:00,22.42,22.47,22.3,22.37,400600,245175,49.33217135852552,54.46215163482496,NaN,NaN,14.001617694106939,109.5224698904043,0.028021609124646237,0.05585006044327656,0.027828451318630324,328703,744043,67.05121967926357,66.80119993693856,NaN,NaN,7.82454783609635,0.459260449801721
2004-09-10T09:30:00-04:00,22.25,22.42999,22.21001,22.39,208000,244110,50.082716000690546,54.233675497647376,NaN,NaN,-15.947277959266172,84.677560163545,0.015714246087628413,0.04747125892816584,0.031757012840537426,536703,683303,64.53025672068709,66.83041291093014,NaN,NaN,6.791508844523767,1.363867363333442
2004-09-13T09:30:00-04:00,22.35001,22.48,22.35001,22.41,487200,207060,50.86651816924359,54.25108657969367,NaN,NaN,16.567240078851402,53.90455582715116,0.008163293274960563,0.04196112943423813,0.03379783615927757,1023903,705903,65.0566885935293,66.82485577865114,NaN,NaN,6.160712686461435,2.049130980923155
2004-09-14T09:30:00-04:00,22.45,22.47,22.33,22.42,276400,185515,51.27845559192968,54.27436888932615,NaN,NaN,3.839679002829741,20.881973661608935,0.003332617232924745,0.0379636077004335,0.034630990467508754,1300303,783783,66.88085890407035,66.90683526767855,NaN,NaN,5.748459721255345,2.577606515256325
2004-09-15T09:30:00-04:00,22.35001,22.35001,22.14,22.2,279100,187180,42.78062293709617,53.39142361905108,NaN,NaN,-121.8699480464128,-20.68173784597818,-0.014225468396222074,0.016849154972231162,0.031074623368453236,1021203,842163,68.22015300996014,67.09527432193484,NaN,NaN,2.7707519367274305,2.6051987183236256
2004-09-16T09:30:00-04:00,22.21001,22.23,22.03999,22.08,641400,198520,38.98554980109501,52.14918277908366,NaN,NaN,-178.89232553179954,-59.26052649115949,-0.032426234819870906,-0.009458170156385393,0.02296806466348551,379803,852383,68.4606013533064,67.26866366320567,NaN,NaN,-0.998131535825863,2.090437253445127
2004-09-17T09:30:00-04:00,22.07001,22.17999,22,22.09,150500,198305,39.46745918867983,51.057326280053395,NaN,NaN,-175.2694626548243,-91.12496343027111,-0.04170550461884495,-0.029163816110070684,0.01254168850877427,530303,851103,68.39080841512443,67.4331637478638,NaN,NaN,-3.8970941415915332,1.2350756255827473
2004-09-20T09:30:00-04:00,21.8,21.83,21.64999,21.72,736100,231880,30.019755855454804,49.59783895487649,NaN,NaN,-296.9458406090177,-153.82757956784494,-0.06906217548498586,-0.07378603084745805,-0.004723855362472195,-205797,605163,56.47709826971712,66.73421709415055,NaN,NaN,-10.153213043816422,-0.3918227557599909
2004-09-21T09:30:00-04:00,21.66,21.72,21.59,21.64,525100,253230,28.434824084902885,47.97155081582764,NaN,NaN,-250.85166414954278,-204.76584819831945,-0.08765080005612058,-0.11428735543262292,-0.026636555376502342,-730897,198923,43.11638058533394,65.0472817433,NaN,NaN,-15.708764790047649,-2.5799573320867992
2004-09-22T09:30:00-04:00,21.64999,21.64999,21.42,21.42999,494300,275700,24.741894422817168,46.081481986629804,NaN,NaN,-221.17925943300784,-224.62771047563848,-0.10786649722823513,-0.16146967691179626,-0.053603179683561125,-1225197,-250357,33.638467867084856,62.672471939371626,NaN,NaN,-21.839907682866837,-5.331378810769662
2004-09-23T09:30:00-04:00,21.55,21.62,21.47,21.55,2347300,387585,30.31172932011232,43.94112350523358,NaN,NaN,-164.8737931628715,-221.82400400185284,-0.10673531675495133,-0.1870223256272503,-0.08028700887229896,1122103,-101897,38.453002683118704,60.6052713179659,NaN,NaN,-24.93279067842035,-8.131580506148332
2004-09-24T09:30:00-04:00,21.57001,21.58,21.48,21.53,428300,405985,29.914385584475596,41.569499645469314,NaN,NaN,-138.91587067695596,-214.5532856062792,-0.10097546501476817,-0.2065063401407592,-0.10553087512599102,693803,-69197,39.49425862766444,58.534672280862374,NaN,NaN,-27.469447729908275,-10.894132966685467
2004-09-27T09:30:00-04:00,21.46001,21.55,21.41,21.44,621300,432250,28.127549357261245,39.07024462661832,NaN,NaN,-128.4162470755183,-180.8473668995793,-0.09685348569990859,-0.22659773225087676,-0.12974424655096817,72503,-13537,41.31422596430194,56.50252985875295,NaN,NaN,-30.134775179868882,-13.642796139997383
2004-09-28T09:30:00-04:00,21.55,21.56,21.41,21.55,735500,466175,33.36636400229466,37.69357111961278,NaN,NaN,-104.72878662378619,-151.622791394428,-0.08098989260842479,-0.23098161231149916,-0.14999171970307437,808003,294243,50.22925958349299,55.093805732618236,NaN,NaN,-30.73806498632458,-16.084977403758412
2004-09-29T09:30:00-04:00,21.53999,21.63,21.36,21.61,928100,505530,36.10225844126041,36.74857733980813,NaN,NaN,-87.47630721919629,-124.88220095166567,-0.061604770080873256,-0.22699768230416595,-0.1653929122232927,1736103,886503,62.146023731822204,54.74343459351528,NaN,NaN,-30.397251272221364,-18.129587956395977
2004-09-30T09:30:00-04:00,21.61,21.69,21.60001,21.66,715300,525545,38.373063440471945,35.91217358550679,NaN,NaN,-60.91852780347885,-104.09114787978714,-0.04152638818724233,-0.2173008974573456,-0.17577450927010327,2451403,1152363,66.07297330522843,54.85362863526824,NaN,NaN,-29.441121999770075,-19.745521391163706
2004-10-01T09:30:00-04:00,21.66,21.94,21.66,21.88,582500,546440,47.255093171507355,35.654214657097064,NaN,NaN,-27.749781337425635,-81.85793001188108,-0.011122376822830515,-0.1896774802986414,-0.17855510347581088,3033903,1620383,71.64882245627757,55.32449533975024,NaN,NaN,-25.715202496744755,-20.598332977675284
2004-10-04T09:30:00-04:00,21.95,22,21.81,21.83,396200,562725,45.644943228575535,35.25182091685748,NaN,NaN,-12.939862972016112,-58.76265319118064,0.0069542914530462685,-0.16986223915950305,-0.17681653061254932,2637703,2133423,76.25560597019651,55.994120130187824,NaN,NaN,-23.17128158791241,-20.965897064852015
2004-10-05T09:30:00-04:00,21.82001,21.91,21.78,21.83,736200,593550,45.644943228575535,35.45641522339173,NaN,NaN,-13.971975520428053,-40.61129097050901,0.019531844034006873,-0.15240172557004072,-0.1719335696040476,2637703,2499363,78.89041820819943,56.756281930062066,NaN,NaN,-21.13340466630497,-20.989826722202437
2004-10-06T09:30:00-04:00,21.78,21.92999,21.78,21.92999,698400,619390,49.6258444954023,36.216436272985106,NaN,NaN,0.8938714841373535,-22.937255229842272,0.03433993252494433,-0.1290086539478672,-0.16334858647281153,3336103,2819363,80.88764574772772,57.64392795823501,NaN,NaN,-18.195136958239125,-20.590585327350535
2004-10-07T09:30:00-04:00,21.99001,22,21.75,21.75999,498100,624265,43.75803148663689,36.52290572283918,NaN,NaN,-3.202448944271802,-11.394039458000853,0.03246141453707935,-0.12277181830146233,-0.15523323283854168,2838003,2896683,81.34687141187963,58.56936102943182,NaN,NaN,-17.329329313165605,-20.1246916110384
2004-10-08T09:30:00-04:00,21.7,21.78,21.56,21.61,219400,624835,39.33842693878583,37.18852508593425,NaN,NaN,-46.09610525673499,-15.063304241862719,0.021425535221610975,-0.12845131381152797,-0.14987684903313894,2618603,2813623,79.14683296446776,60.188627793342576,NaN,NaN,-17.96349198228422,-19.81594880693066
2004-10-11T09:30:00-04:00,21.56,21.63,21.56,21.60001,173900,609170,39.05548615644993,37.94714380533047,NaN,NaN,-54.95443944309314,-23.466219536078125,0.014114158068978477,-0.13223415144691586,-0.14634830951589434,2444703,2775023,78.08985941799337,62.686733424246825,NaN,NaN,-18.55376808057924,-19.635637274594743
2004-10-12T09:30:00-04:00,21.5,21.58,21.48,21.53999,257700,608235,37.31879971410698,38.84549418327974,NaN,NaN,-70.24868752998064,-34.72156193798864,0.006295534446193296,-0.13847889145815273,-0.14477442590434603,2187003,2684883,75.55243013745671,65.68058787213053,NaN,NaN,-19.555817604137918,-19.624234464529483
2004-10-13T09:30:00-04:00,21.52,21.62,21.41,21.45,597300,624145,34.81882067619962,39.16742928014312,NaN,NaN,-80.21967999794352,-50.94427223440481,-0.003358120448193669,-0.1489720764645881,-0.14561395601639443,1589703,2335603,66.53120459617915,67.68617372306342,NaN,NaN,-21.15180216994968,-19.842458422446654
2004-10-14T09:30:00-04:00,21.48,21.53,21.37,21.37,697500,626950,32.72033113612143,39.367853962403544,NaN,NaN,-105.9754392982506,-71.49887030520057,-0.013010684554361912,-0.16187731170934683,-0.14886662715498492,892203,1946443,58.193764697283115,69.02185272803618,NaN,NaN,-23.1315017693645,-20.312321757720632
2004-10-15T09:30:00-04:00,21.45,21.63,21.45,21.50999,2318500,735350,39.582298675558505,40.186050342281916,NaN,NaN,-52.5180557151286,-72.78326039687929,-0.008087659769920819,-0.15897620186738592,-0.1508885420974651,3210703,2064863,59.8428815015458,70.34532812355359,NaN,NaN,-22.81719790172205,-20.670161206863693
2004-10-18T09:30:00-04:00,21.46001,21.61,21.44,21.59,1275800,762335,43.151072540009075,40.8849580949758,NaN,NaN,-39.79255888651157,-69.75088428556299,0.0019036385977609371,-0.14850899385026395,-0.15041263244802489,4486503,2473223,64.97391423256005,71.3985177413441,NaN,NaN,-21.477969291154498,-20.78556236176238
2004-10-19T09:30:00-04:00,21.61,21.64999,21.46001,21.46001,202700,746215,39.10918728942343,41.09973872698745,NaN,NaN,-48.296921324222055,-65.36053104441126,0.001141824109226558,-0.14898535231149168,-0.15012717642071824,4283803,2892583,69.31061030467892,71.91027392511957,NaN,NaN,-21.54414742467135,-20.89393165646366
2004-10-20T09:30:00-04:00,21.42,21.52,21.37,21.52,353700,739185,41.817735718267535,41.345786746829994,NaN,NaN,-75.08421207851812,-64.33343746052618,0.005801579703126586,-0.14287520179181,-0.1486767814949366,4637503,3502143,74.29295411199323,72.49741541131706,NaN,NaN,-20.785058784126996,-20.878378388986995
2004-10-21T09:30:00-04:00,21.45,21.60001,21.39999,21.52,356100,639625,41.817735718267535,40.95740407159857,NaN,NaN,-54.2082837611288,-53.980006353101814,0.009773553677210806,-0.1364598393984231,-0.1462333930756339,4637503,4251203,78.83928126915865,73.01101961223713,NaN,NaN,-20.17273991344099,-20.77757289248042
2004-10-22T09:30:00-04:00,21.66,21.67999,21.38,21.38,382300,637325,37.32414750117808,40.36306151964162,NaN,NaN,-65.84944359511915,-56.64628392909994,0.004149473177154334,-0.141046551604191,-0.14519602478134533,4255203,4460103,79.90654009187746,73.27180062092863,NaN,NaN,-20.94904586746774,-20.802069031764322
2004-10-25T09:30:00-04:00,21.49001,21.49001,21.2,21.25999,486300,630575,33.955772347769525,39.52812074244118,NaN,NaN,-139.95826579843194,-76.67942531148401,-0.0059281471566663135,-0.15260620872717823,-0.14667806157051191,3768903,4316583,77.03199482094415,73.13905609326754,NaN,NaN,-22.651656520917594,-21.066295815929074
2004-10-26T09:30:00-04:00,21.2,21.53999,21.17999,21.49001,893800,638490,44.32655435608133,39.14960001820397,NaN,NaN,-92.2744523515214,-85.47493151694388,0.004082733844094855,-0.14157464426539335,-0.1456573781094882,4662703,4392363,77.49240277689358,72.89653873820795,NaN,NaN,-20.80788738090322,-21.029380325211093
2004-10-27T09:30:00-04:00,21.37,21.72,21.34,21.72,405800,612375,52.37860964477394,39.765355600928046,NaN,NaN,-2.756510955743531,-71.00939129238897,0.026148691471975127,-0.1129715137695193,-0.13912020524149443,5068503,4478563,78.03185171429746,72.6597516169521,NaN,NaN,-16.35027104959125,-20.360936142979686
2004-10-28T09:30:00-04:00,21.61,21.89999,21.61,21.82001,492500,601235,55.39938645095592,40.91256699465448,NaN,NaN,78.6299486479312,-44.44174481057697,0.04625918552275246,-0.08129622333805386,-0.12755540886080632,5561003,4663263,79.18313159951514,72.66234437659834,NaN,NaN,-11.720665894026167,-19.12661182170061
2004-10-29T09:30:00-04:00,21.82001,21.89,21.74001,21.8,714100,607815,54.652397581002724,42.02663209640826,NaN,NaN,95.01989830525612,-12.267876430501914,0.05632497750539375,-0.057149186979064126,-0.11347416448445788,4846903,4781603,79.90961400267535,72.79232684693277,NaN,NaN,-8.338502826022873,-17.585453393746647
2004-11-01T09:30:00-05:00,21.81,21.84,21.7,21.75,202900,598150,52.73881528339863,43.12806177992909,NaN,NaN,80.36484842746468,31.796746414677408,0.05752501162628201,-0.04156789995160537,-0.09909291157788738,4644003,4956623,80.967517238753,73.17911878273965,NaN,NaN,-6.168230839502855,-15.954421600283249
2004-11-02T09:30:00-05:00,21.78,22.05,21.75,21.89,1323100,627495,57.252125320087636,44.73044068306395,NaN,NaN,140.27218921226083,78.30607472743387,0.06509949769386181,-0.017718539460560123,-0.08281803715442193,5967103,5217503,82.45089078926758,74.3162392251031,NaN,NaN,-2.8675460689700194,-14.084867952952788
2004-11-03T09:30:00-05:00,22.10001,22.11,21.97,22.06,366600,610905,61.99786711121825,46.82169325271372,NaN,NaN,192.7133526722971,117.40004745304198,0.07803845466307893,0.014730031174426728,-0.0633084234886522,6333703,5470543,83.77204062246969,76.143258934045,NaN,NaN,1.5598540873769935,-11.849907661477104
2004-11-04T09:30:00-05:00,22.05,22.64999,22.05,22.64999,234800,597740,73.14195244145033,49.21881137884885,NaN,NaN,282.5704730572385,158.18815233490346,0.1202863917644769,0.08704956621694393,-0.033236825547532975,6568503,5672043,84.75619012235931,77.92278097838881,NaN,NaN,10.63636365531525,-8.637583187649625
2004-11-05T09:30:00-05:00,22.78999,22.82001,22.64999,22.75,751500,624345,74.50668105106287,51.458497701066975,NaN,NaN,266.07267561599673,192.39870779705157,0.14714638719351847,0.15069615844436512,0.003549771250846649,7320003,6166663,86.86237015683095,79.48624211583675,NaN,NaN,17.991705736734946,-4.833399055594686
2004-11-08T09:30:00-05:00,22.7,22.77,22.63,22.71001,1681800,699740,72.91131822578399,53.87293562509274,NaN,NaN,199.53991543003366,216.23372119756536,0.15368362423632725,0.19565430154625574,0.04197067730992847,5638203,6365503,87.60385999784926,80.79290280820605,NaN,NaN,22.99057236594721,-0.8585459953744157
2004-11-09T09:30:00-05:00,22.74001,22.77,22.61,22.7,132900,693500,72.49288420674291,56.06401765998384,NaN,NaN,160.2534671699775,220.2299767891087,0.14870323476646213,0.22784972076800614,0.079146486001544,5505303,6273143,85.19847359784345,81.57186848576679,NaN,NaN,26.696126354502336,3.0778357688936917
2004-11-10T09:30:00-05:00,22.7,22.86,22.67,22.73,345800,680925,72.99312401170792,58.290831109515295,NaN,NaN,140.53545955011512,209.7943981646723,0.13897932035541244,0.25287063644580954,0.11389131609039711,5851103,6176623,82.64462986313137,81.84367909962198,NaN,NaN,29.805109175950644,6.896017684187542
2004-11-11T09:30:00-05:00,22.73,22.89999,22.7,22.89999,568300,674465,75.69080488457892,61.03130663690107,NaN,NaN,128.44361597074078,178.96902674737277,0.13540907284413353,0.28315265714556404,0.1477435843014305,6419403,6146803,81.82853193581374,81.9809642313317,NaN,NaN,33.35543700195237,10.675934729582517
2004-11-12T09:30:00-05:00,22.91,22.99001,22.81,22.97,274100,572245,76.72209646863793,64.08604407410596,NaN,NaN,120.34284308526529,149.8230602412265,0.12919386810744415,0.3092359194357357,0.18004205132829154,6693503,6021503,78.32847258345083,82.07356978579648,NaN,NaN,36.58631777129911,14.377418021256315
2004-11-15T09:30:00-05:00,22.97,23.06,22.91,23.03999,607700,538840,77.73885761228036,66.47263716383445,NaN,NaN,112.92678582056196,132.50043431933216,0.12135093141371386,0.3317307155954339,0.21037978418172001,7301203,6354103,80.68959201842506,82.30194044590586,NaN,NaN,39.571414521358506,17.97656037841377
2004-11-16T09:30:00-05:00,22.82001,22.95,22.82001,22.89,258100,541610,70.61994820071018,67.7755899178299,NaN,NaN,87.18073722278626,117.8858883298939,0.09858371055897103,0.3336094223804338,0.23502571182146276,7043103,6661663,82.5796597137807,82.62678387444036,NaN,NaN,40.0052059129062,21.123509740484117
2004-11-17T09:30:00-05:00,22.94,23.03999,22.85001,22.91,469800,547415,71.00128302648939,68.89001110179659,NaN,NaN,83.3039876311515,106.43959394610117,0.07827940531635824,0.33287496846691056,0.2545955631505523,7512903,6994023,84.36104264494195,82.99663466339943,NaN,NaN,40.46509092440109,23.88659276675797
2004-11-18T09:30:00-05:00,22.85001,22.99001,22.85001,22.89999,577400,558480,70.5080170299791,70.02255534815204,NaN,NaN,73.79117416978309,95.50910558590962,0.05848961040673528,0.3277075761589714,0.2692179657522361,6935503,7097243,84.87822443885145,83.35153540884059,NaN,NaN,40.70515920891162,26.289245115637062
2004-11-19T09:30:00-05:00,22.85001,22.85001,22.61,22.64999,1000400,589385,59.4074210635948,70.49888433245177,NaN,NaN,43.9521230621603,80.23096158128865,0.024610803563405614,0.29998147020649313,0.2753706666430875,5935103,6945563,80.65710896696854,83.32936338942741,NaN,NaN,37.53031231109175,27.895111857844874
2004-11-22T09:30:00-05:00,22.60001,22.81,22.59,22.8,248100,577475,63.1557868632341,70.92057444267651,NaN,NaN,43.25450852746662,66.29650612266957,0.009148870730482261,0.28680675505619035,0.2776578843257081,6183203,6721963,74.75509910390912,82.77966398333037,NaN,NaN,35.91437337207621,29.04072064559221
2004-11-23T09:30:00-05:00,22.75,22.75999,22.59,22.75,459700,555770,61.129591608839455,70.85855476393517,NaN,NaN,33.577274747574485,55.57581362762721,-0.006744205265319769,0.2692276277440584,0.27597183300937816,5723503,6458043,68.39362063750247,81.68120541297557,NaN,NaN,33.979739337567466,29.746294744445816
2004-11-24T09:30:00-05:00,22.75,22.81,22.67999,22.74001,186600,544810,60.71049697632663,69.97059365928348,NaN,NaN,36.155871135465226,46.14619032848996,-0.01950565599986126,0.2515897630095516,0.27109541900941286,5536903,6062843,60.14057690521895,79.92294732603698,NaN,NaN,32.290099720359876,30.10969545529068
2004-11-26T09:30:00-05:00,22.69,22.81,22.69,22.74001,73500,523860,60.71049697632663,68.98515193965946,NaN,NaN,32.5541434397894,37.89878418249123,-0.028953292558358656,0.23490380331146454,0.2638570958698232,5536903,5783123,55.07483538562896,77.65240912809398,NaN,NaN,30.904097922207264,30.223181521993048
2004-11-29T09:30:00-05:00,22.67999,22.67999,22.45,22.50999,442300,510270,51.3158290873784,67.44261700120191,NaN,NaN,-23.974620088646322,24.313435552329896,-0.05044198249163345,0.20080461775528136,0.2512466002469148,5094603,5615023,52.22771805791515,75.1255418466701,NaN,NaN,26.76059414303811,29.728526182142343
2004-11-30T09:30:00-05:00,22.53,22.53,22.33,22.34,557300,527990,45.68890735753152,65.52804722625824,NaN,NaN,-89.2776134297187,-2.1929888391071812,-0.07440535693113146,0.15823990408300048,0.23264526101413194,4537303,5285843,47.09361484550727,72.40376622150323,NaN,NaN,21.312045419205774,28.526171787437118
2004-12-01T09:30:00-05:00,22.35001,22.69,22.35001,22.64,626400,493155,55.05544661278849,64.24678455490685,NaN,NaN,-62.184780703414795,-21.34539992930504,-0.06850036731404224,0.14701980187157915,0.2155201691856214,5163703,5173883,45.45688373982011,69.74749864126673,NaN,NaN,19.406129734607067,27.223308637032826
2004-12-02T09:30:00-05:00,22.56,22.89,22.53999,22.85001,2301600,589905,60.226592823625694,63.142197979124475,NaN,NaN,13.87678352023796,-25.80121745235049,-0.049770840439559316,0.15330661863617223,0.20307745907573155,7465303,5559563,51.68613694803222,67.59447042785375,NaN,NaN,19.582874026168138,26.13181797833787
2004-12-03T09:30:00-05:00,22.81,22.97,22.75,22.81,5691898,862759.9,58.83766887674598,61.864738865417905,NaN,NaN,55.520237338414034,-21.207998672625564,-0.03982722930727428,0.15329342244163868,0.19312065174891296,1773405,4806863.4,41.681178724500704,64.97680658078589,NaN,NaN,19.26558549088469,25.150927622987417
2004-12-06T09:30:00-05:00,22.85001,22.85001,22.62,22.66,152500,832809.9,53.825922934713525,60.15667210273456,NaN,NaN,-27.96787509056589,-22.00664967300948,-0.04284025100881189,0.13957033798789809,0.18241058899670998,1620905,4112123.8,34.955426506800634,61.71008047281271,NaN,NaN,17.35178066653535,24.036763772065694
2004-12-07T09:30:00-05:00,22.56,22.74001,22.53999,22.60001,346100,766024.9,51.9211205227087,58.82104155430589,NaN,NaN,-75.56185456886593,-19.26349790083892,-0.047974422064555655,0.1224425614160154,0.17041698348057105,1274805,3459624.2,30.050859733288988,57.95802333134902,NaN,NaN,15.209720715116722,22.775757621072984
2004-12-08T09:30:00-05:00,22.50999,22.66,22.47,22.61,204300,769594.9,52.22432567876605,57.47983031518279,NaN,NaN,-95.93019002395222,-26.012579764946405,-0.04959364318539197,0.10842492949883109,0.15801857268422306,1479105,2722704.6,25.670197251579026,53.76582008896595,NaN,NaN,13.590853553078999,21.463628468502414
2004-12-09T09:30:00-05:00,22.69,22.92,22.55,22.87,345900,769599.9,59.400535007722226,56.68643874216444,NaN,NaN,19.348535418770375,-24.91822938523993,-0.03285679146049969,0.11694758335859845,0.14980437481909814,1825005,1594645,20.696527008690026,49.18141312966871,NaN,NaN,14.394960236496793,20.453818721073038
2004-12-10T09:30:00-05:00,22.77,22.96001,22.75999,22.91,185400,750454.9,60.38637002473208,56.75636366795995,NaN,NaN,72.19599044061049,-21.58307876480064,-0.019457081081785177,0.12548302346686668,0.14494010454865186,2010405,1642045,21.38578190602695,44.947746911030016,NaN,NaN,15.344292822953898,19.72388644991316
2004-12-13T09:30:00-05:00,22.91,23,22.8,22.96001,2296700,851584.9,61.64048843956315,56.64812806626917,NaN,NaN,96.85144441907053,3.380785137126645,-0.0081682997693458,0.13472972983696963,0.14289802960631542,4307105,2179285,28.925830256119795,41.67422770761649,NaN,NaN,16.49700634090564,19.2629035771978
2004-12-14T09:30:00-05:00,23.02,23.21001,22.94,23.17,305900,836494.9,66.44430664429817,57.027750568801935,NaN,NaN,190.10496743275465,56.51414953745076,0.011433782594621494,0.15719025784959229,0.1457564752549708,4613005,2846925,37.01112035196028,39.43262054436347,NaN,NaN,19.04634466770808,19.23196659012784
2004-12-15T09:30:00-05:00,23.17999,23.2,22.97,23.16,323500,839764.9,66.02029573532,57.40702190873004,NaN,NaN,168.53659683284135,109.40750690880948,0.02115359968726066,0.1721984748640466,0.15104487517678594,4289505,3409005,42.90034060072519,38.20117509404249,NaN,NaN,20.961085201619362,19.47898353462663
2004-12-16T09:30:00-05:00,23.00999,23.28999,23,23.10001,538500,843199.9,63.406240237862214,57.59957499883972,NaN,NaN,159.70270234250685,137.47834029355676,0.020931417139022523,0.17720914660056408,0.15627772946154156,3751005,3794205,46.58605275919055,37.59483347786831,NaN,NaN,21.816295176814968,19.81288519779639
2004-12-17T09:30:00-05:00,23.09,23.10001,22.78,22.83,1798800,904269.9,53.19667010994749,57.73392078616609,NaN,NaN,58.33811079531968,134.7067643644986,0.0010387363121065751,0.15757614985167478,0.1565374135395682,1952205,3782565,46.488400142875065,37.18488219822259,NaN,NaN,19.39024475265938,19.752507991348246
2004-12-20T09:30:00-05:00,23.03,23.03999,22.75999,22.84,476400,878069.9,53.49532996947195,58.29152240130469,NaN,NaN,42.9719697897821,123.93086943864094,-0.012273007999545726,0.14119615354013604,0.15346916153968176,2428605,3406865,43.3312035914362,36.91613853721751,NaN,NaN,17.546746895766812,19.43739926340804
2004-12-21T09:30:00-05:00,22.84,23,22.82001,23,175900,874459.9,58.102104710037224,58.50914083682245,NaN,NaN,62.291214007942294,98.36811875367844,-0.01116150292347648,0.13951728288533616,0.15067878580881264,2604505,3005165,40.188495206556055,36.5398250705558,NaN,NaN,17.332972045733168,19.1367668037402
2004-12-22T09:30:00-05:00,23.03,23.13,22.95,23.09,197800,861364.9,60.47397410173216,58.52681092811578,NaN,NaN,98.85955734406635,84.43271085592346,-0.005509848633052067,0.14379147501749756,0.14930132365054963,2802305,2707725,37.991294893627995,35.56162206666978,NaN,NaN,17.872301059372468,18.956128840259098
2004-12-23T09:30:00-05:00,23.00999,23.13,23,23.03999,200600,862064.9,58.49245862551774,58.502153053028046,NaN,NaN,88.63061838773798,70.2182940649697,-0.006231338880742704,0.14151215004962125,0.14774348893036396,2601705,2477865,36.33790053204816,35.17995933863745,NaN,NaN,17.737315820514375,18.78201269458128
2004-12-27T09:30:00-05:00,23.14999,23.16,22.92999,23.02,202900,868534.9,57.67890425343957,58.77736600436562,NaN,NaN,73.80019682921666,73.3107112717491,-0.008979562196024221,0.13651903618533368,0.1454985983813579,2398805,2567185,37.47658923740347,35.36004239082337,NaN,NaN,17.398092227160795,18.584309770664067
2004-12-28T09:30:00-05:00,23.08,23.17,23.03,23.16,469100,869874.9,61.69699280663463,59.47564259607462,NaN,NaN,98.18173088785268,84.3526634913632,-0.002623381853504164,0.14221937106447768,0.14484275291798185,2867905,2655045,38.639220750392994,35.97349674918794,NaN,NaN,18.263138473717426,18.538428156814547
2004-12-29T09:30:00-05:00,23.16,23.16,23.05,23.11,172200,850619.9,59.523405821420916,59.997005463407106,NaN,NaN,87.70390392154988,89.43520147408472,-0.0030133160639856105,0.14107610783799984,0.14408942390198545,2695705,2673285,38.89326351906177,36.91800148257956,NaN,NaN,18.372846303090814,18.514773606282585
2004-12-30T09:30:00-05:00,23.25,23.25,23.13,23.16,111200,824859.9,61.00295502074614,60.111464035765955,NaN,NaN,109.7113829277466,91.60556659082076,-0.0012225088480738444,0.14256128784189315,0.143783796689967,2806905,2674205,38.90700251773679,38.21874973322576,NaN,NaN,18.87783659598583,18.566639747668763
2004-12-31T09:30:00-05:00,23.17999,23.19,23.08,23.08,226200,721089.9,57.38840476417272,59.897323660011715,NaN,NaN,73.27345318372178,88.53413355001753,-0.006452242178850043,0.13571849396640445,0.1421707361452545,2580705,2670005,38.86404292898798,39.46719694915156,NaN,NaN,18.30688134223937,18.529531404035993
2005-01-03T09:30:00-05:00,23.3,23.41,23.02,23.08,813900,477190,57.38840476417272,59.593603397483825,NaN,NaN,87.78511984044601,91.33111815226341,-0.010688043980401074,0.12881068116975314,0.1394987251501542,2580705,2706385,39.48731384477224,40.2215886340553,NaN,NaN,17.835930134492457,18.430445508386917
2005-01-04T09:30:00-05:00,23.00999,23.17999,22.87,23,2075600,573345,53.69834291671955,58.6831774169425,NaN,NaN,14.988789436444922,74.69252986198185,-0.019159873916532483,0.1155488827544886,0.13470875667102108,505105,2233825,34.5587824639873,40.04642164205723,NaN,NaN,16.422114437012112,18.143541069619086
2005-01-05T09:30:00-05:00,23,23.03,22.88,22.88,1772000,644640,48.64558105621681,57.442126368435126,NaN,NaN,-39.461528076522875,49.25944346236729,-0.03235169422203821,0.09426913889347333,0.12662083311551153,-1266895,1441305,28.201516828387483,38.996505658318824,NaN,NaN,13.718287199485808,17.51136194531433
2005-01-06T09:30:00-05:00,22.98,23.07001,22.83,22.99001,594900,664170,53.01075924049732,56.69959201148049,NaN,NaN,-38.941902726054614,19.52878633160705,-0.03305793912088424,0.08529840921440623,0.11835634833529048,-671995,745525,24.023299923338698,37.38488045575798,NaN,NaN,12.577689369010331,16.806551577270902
2005-01-07T09:30:00-05:00,23.10001,23.17,22.98,23.10001,325800,663165,56.95108036516102,56.967764172567165,NaN,NaN,37.721137817932515,12.418323258449192,-0.025826737162464544,0.0860729268822098,0.11189966404467434,-346195,160145,21.180159192901897,35.577148959331325,NaN,NaN,12.739149541389782,16.2254941435736
2005-01-10T09:30:00-05:00,23.2,23.34,23.05,23.24001,357500,671770,61.38886105055971,57.5315878212163,NaN,NaN,127.86529679442621,20.434358649245233,-0.012026174570732281,0.09686694583125899,0.10889312040199127,11305,-353735,19.048865377340064,33.84269622975303,NaN,NaN,14.245224714716615,15.942598510879744
2005-01-11T09:30:00-05:00,23.10001,23.23,23.08,23.14,639100,588890,56.878110464738015,57.44415966083778,NaN,NaN,73.44545389959761,32.12569154187577,-0.010120979707491956,0.09624189576762632,0.10636287547511827,-627795,-580315,18.18019085668577,32.27067449047658,NaN,NaN,14.15087464963674,15.6866379592736
2005-01-12T09:30:00-05:00,23.2,23.25,23.03,23.21001,586700,602930,59.14141944668929,57.348977185477565,NaN,NaN,79.76105802308075,55.97020876179649,-0.00489809738552742,0.100240253743209,0.10513835112873642,-41095,-335155,22.30851795654786,31.150476137827997,NaN,NaN,14.756745895137824,15.553796235825633
2005-01-13T09:30:00-05:00,23.3,23.3,23,23.06,358800,604695,52.75241451487948,56.9389740347177,NaN,NaN,43.53680522477752,72.46595035196292,-0.011899543598877516,0.09026392163013952,0.10216346522901704,-399895,-280735,23.234442623600756,30.21451485865318,NaN,NaN,13.292002348026614,15.230682823282915
2005-01-14T09:30:00-05:00,23.14999,23.2,23.05,23.19,253000,590420,57.07966836694941,56.896171471396976,NaN,NaN,64.03698684081557,77.72912015653954,-0.008299229221243778,0.09178942870246232,0.1000886579237061,-146895,-240875,23.94938072562681,29.248285679240563,NaN,NaN,13.409040110120046,14.970448149973935
2005-01-18T09:30:00-05:00,22.96001,23.42999,22.96001,23.42999,1039600,552460,63.690904393360796,57.038593727591696,NaN,NaN,154.05364287153697,82.96678937196168,0.0087955493411329,0.11108309460012222,0.10228754525898932,892705,-64595,27.179411432707127,28.42972787083443,NaN,NaN,15.785582526522878,15.086895918052356
2005-01-19T09:30:00-05:00,23.49001,23.52,23.39,23.39,567200,557000,61.9777429507891,57.213903522546566,NaN,NaN,255.83550320215014,119.44479923247218,0.015564543731493949,0.12174322492335676,0.10617868119186281,325505,126065,30.612058327126363,27.83821321426762,NaN,NaN,17.106008425608998,15.375340561989018
2005-01-20T09:30:00-05:00,23.3,23.44,23.28999,23.37,1052900,600850,61.09268167494184,57.22031256927483,NaN,NaN,175.8355471220781,138.65969705227167,0.016746935131514096,0.12711235010625543,0.11036541497474134,-727395,-11195,29.53274425308784,27.168623338221266,NaN,NaN,17.88682508950829,15.734124065920343
2005-01-21T09:30:00-05:00,23.45,23.45,23.13,23.17,909900,636455,52.94966241584952,56.9032595443946,NaN,NaN,78.31474597274182,145.61528520186454,0.0028404199567682864,0.1139159399207017,0.11107551996393342,-1637295,-258675,27.640480408907393,26.366940301072653,NaN,NaN,15.950821930845727,15.765080903766826
2005-01-24T09:30:00-05:00,23.22,23.22,23.06,23.08,415700,647210,49.736944662600614,56.35672667999659,NaN,NaN,-21.422780989996976,128.52333163570202,-0.01278105790514747,0.09509919758249907,0.10788025548764654,-2052995,-639895,24.9848099085699,25.331047162772485,NaN,NaN,13.322373730091218,15.416122736098883
2005-01-25T09:30:00-05:00,23.25,23.25999,23.14999,23.17,1014000,687765,52.81980461445237,56.29397394412037,NaN,NaN,29.92475109059769,103.69755327951415,-0.017142227368756632,0.08645247127670075,0.10359469864545738,-1038995,-1026235,22.613565462280278,24.47781737693627,NaN,NaN,12.09830785570781,14.942149181757301
2005-01-26T09:30:00-05:00,23.27,23.28999,23.14,23.14999,621300,695375,52.05533640215198,56.53752789740145,NaN,NaN,26.979421712695718,57.92633698162327,-0.021198544559853025,0.0770965179456411,0.09829506250549412,-1660295,-1423395,20.463459590079367,23.925099002771407,NaN,NaN,10.886074706046516,14.362709970941475
2005-01-27T09:30:00-05:00,23.10001,23.3,23.06,23.28,212600,697395,56.46417106161698,56.78420017033857,NaN,NaN,38.77910404946831,30.515048367101297,-0.01522890570559933,0.07925893037349496,0.09448783607909429,-1447695,-1567455,19.73064407299654,23.618480727746967,NaN,NaN,11.169080738447445,13.906477223442328
2005-01-28T09:30:00-05:00,23.28,23.34,23.14999,23.28999,1183000,750985,56.7929556923827,56.7729055508544,NaN,NaN,69.45176397523304,28.742451967599557,-0.010912816425071553,0.08084681554775486,0.09175963197282641,-264695,-1292935,25.22583084374621,23.907457274235846,NaN,NaN,11.492748351885279,13.561658813219893
2005-01-31T09:30:00-05:00,23.52,23.52,23.25999,23.35001,867100,783030,58.80582547759548,56.58840300992839,NaN,NaN,136.36648659358735,60.30030548431641,-0.004641726277994501,0.08595747412533328,0.09059920040332778,602405,-761855,34.55945345807167,25.01535642285953,NaN,NaN,12.342683250440455,13.387519447108545
2005-02-01T09:30:00-05:00,23.39999,23.39999,23.24001,23.36,1059900,795330,59.14697091423622,56.750464470606836,NaN,NaN,94.23932254828821,73.16321977585451,-0.0006562386581030755,0.08977890208069894,0.09043514073880202,1662305,-221595,42.43187397342929,26.74761950262692,NaN,NaN,13.13761557924598,13.35181889455675
2005-02-02T09:30:00-05:00,23.37,23.55,23.35001,23.55,423600,712730,65.07153099177032,57.17404386668404,NaN,NaN,168.09587701977915,101.3865108372712,0.013177065094947135,0.10690647210748594,0.0937294070125388,2085905,527645,51.199610305772175,28.811268956142946,NaN,NaN,15.659053750600055,13.681423873991507
2005-02-03T09:30:00-05:00,23.55,23.57001,23.47,23.50999,599100,654085,62.9996277882115,57.90598767192204,NaN,NaN,164.54237220999408,126.53916446937635,0.017748890523677244,0.11591552016713536,0.09816662964345811,1486805,1114545,56.755618939202506,31.205638692971643,NaN,NaN,17.15792781091288,14.178067293551704
2005-02-04T09:30:00-05:00,23.59,23.69,23.50999,23.64,951200,671900,66.70898273902787,58.59379584135622,NaN,NaN,188.22260222452024,150.2933321192338,0.02708596401035958,0.13202408465640758,0.104938120646048,2438005,1655085,61.143471539635975,33.86235946540087,NaN,NaN,19.608105692041992,14.953787064764603
2005-02-07T09:30:00-05:00,23.60001,23.69,23.59,23.59,1953800,753300,64.049565864441,58.61941451786195,NaN,NaN,160.9885803673692,155.21775087399016,0.027370785785892707,0.13915160287841388,0.11178081709252118,484205,1631445,60.85266360274592,36.26759176326078,NaN,NaN,20.877748737070696,15.800067303665474
2005-02-08T09:30:00-05:00,23.73,23.73,23.53999,23.62,1029800,786915,64.95237638644568,58.83188833469456,NaN,NaN,139.2591907128464,164.2217245069018,0.027009930280083,0.14554322994262492,0.11853329966254192,1514005,1601785,60.46410000373409,38.39988045444705,NaN,NaN,22.188174678076937,16.71265407143854
2005-02-09T09:30:00-05:00,23.48,23.60001,23.38,23.41,473500,778635,54.61346270432127,58.36908697965024,NaN,NaN,56.97922949723229,141.99839500239244,0.010885492994182205,0.13214016590526967,0.12125467291108746,1040505,1392705,57.66867084824811,40.4095894969585,NaN,NaN,20.206610031334733,17.211790637137995
2005-02-10T09:30:00-05:00,23.49001,23.49001,23.33,23.39999,591300,778865,54.17082866416121,58.45631314024393,NaN,NaN,26.49312895360752,114.38854635111511,-0.0015358979668080586,0.11933480045257738,0.12087069841938544,449205,1185185,54.95301594294413,42.36048489224684,NaN,NaN,18.48516703780487,17.393701551518976
2005-02-11T09:30:00-05:00,23.47,23.58,23.35001,23.53999,411500,781500,59.156735761401926,59.12915536158688,NaN,NaN,59.884269138763536,88.72087973396378,-0.0014083530202846084,0.11911025714402967,0.12051861016431428,860705,869725,51.01984520824759,44.220130270795245,NaN,NaN,18.471573070493584,17.547683197086776
2005-02-14T09:30:00-05:00,23.63,23.63,23.49001,23.55,348500,786275,59.49604085473304,59.60602937874978,NaN,NaN,84.36709738237039,73.39658313696403,-0.001714512475319882,0.11837546957016443,0.12008998204548431,1209205,1014725,52.69578902739399,46.36886052544622,NaN,NaN,18.55907110110397,17.69216718337495
2005-02-15T09:30:00-05:00,23.62,23.8,23.53,23.59,1124800,790535,60.89409152341206,60.23736903026837,NaN,NaN,112.95107152833164,68.13495930006107,-0.0003586606038333967,0.11964165629069257,0.12000031689452596,2334005,1178725,54.58842209847574,48.80635784747454,NaN,NaN,19.028595520410484,17.883085517237166
2005-02-16T09:30:00-05:00,23.7,23.7,23.60001,23.64999,567600,790555,62.95904902188047,60.7012888845729,NaN,NaN,104.28844886276359,77.59680317316734,0.0032443643328518984,0.12405577231059084,0.12081140797773894,2901605,1550945,58.633746471132504,51.58515087591282,NaN,NaN,20.014994863137797,18.18764399522297
2005-02-17T09:30:00-05:00,23.7,23.7,23.47,23.5,216300,748725,55.121853575582364,60.581924447658594,NaN,NaN,56.591870582811794,83.61655149900818,-0.005340830320090015,0.11413537007762642,0.11947620039771643,2685305,1998165,62.90899666981303,54.27680557777473,NaN,NaN,18.56426713194383,18.241447300468806
2005-02-18T09:30:00-05:00,23.42,23.50999,23.39999,23.47,465000,726480,53.68246322739263,60.21597000121553,NaN,NaN,9.888997539346573,73.6174971791248,-0.013445660482568372,0.10266912479450596,0.11611478527707433,2220305,2270085,65.25998242633418,56.4697005040792,NaN,NaN,16.949242091696643,18.056846556358497
2005-02-22T09:30:00-05:00,23.47,23.47,23.10001,23.12,449700,728180,40.420957365097046,58.87839760484845,NaN,NaN,-105.97543922231334,35.54898985818805,-0.041215545940554876,0.06459535285138074,0.10581089879193561,1770605,2382365,66.21230892124362,58.16830300035165,NaN,NaN,10.644605038355612,16.997954910929515
2005-02-23T09:30:00-05:00,23.25,23.25,23.06,23.17999,1091800,732070,43.019227148538036,57.30323304461758,NaN,NaN,-136.3568030710108,-14.31258506168044,-0.05359682124421469,0.03881487223666724,0.09241169348088193,2862405,2488045,67.12576275393893,59.30588531807785,NaN,NaN,6.498807695595684,15.498076737310397
2005-02-24T09:30:00-05:00,23.25,23.3,23.08,23.28999,839200,742965,47.53717201017809,56.19877191761519,NaN,NaN,-109.27300811377673,-57.0248764569885,-0.05237008755490116,0.02694908403725549,0.07931917159215665,3701605,2648045,68.51367474040482,60.14574644673515,NaN,NaN,4.543951336658171,13.933201680074365
2005-02-25T09:30:00-05:00,23.35001,23.39,23.22,23.37,432500,753960,50.60500561214376,55.04848783712346,NaN,NaN,-64.25540246905197,-81.19433106736126,-0.04447295458178309,0.023727978364927793,0.06820093294671088,4134105,2937805,70.90901799433733,60.84328547921382,NaN,NaN,3.938724611518206,12.5054192417092
2005-02-28T09:30:00-05:00,23.5,23.5,23.28,23.32001,985000,744060,48.68926430022138,53.9513234396792,NaN,NaN,-48.647278547588385,-92.90158628474823,-0.04100385876138107,0.01694610949498454,0.057949968256365614,3149105,3123565,72.36069929617057,61.66528802874416,NaN,NaN,2.8514528361041616,11.126281183765624
2005-03-01T09:30:00-05:00,23.44,23.56,23.42,23.50999,438100,722610,55.57266538738918,53.281344082603745,NaN,NaN,19.832796204108888,-67.73993919946379,-0.025084245703609342,0.026594661126853936,0.05167890683046328,3587205,3486885,74.98949671080392,62.702816364963425,NaN,NaN,4.157497180442243,10.130740611862283
2005-03-02T09:30:00-05:00,23.37,23.59,23.37,23.45,409200,690075,53.14807683368122,53.17667366327231,NaN,NaN,1.0042162625167677,-40.26773533275828,-0.01809075142498333,0.029065467549234114,0.04715621897421744,3178005,3550005,75.42677171383022,63.971252141076434,NaN,NaN,4.446424928474444,9.318695514235449
2005-03-03T09:30:00-05:00,23.64,23.69,23.53,23.61,283600,683075,58.36549913426861,53.4762929825657,NaN,NaN,77.64427378703745,-2.8842789525954515,-0.0029781056506222106,0.04343358691093968,0.04641169256156189,3461605,3502005,74.36203454667817,65.35761061277172,NaN,NaN,6.420212050886449,8.904626448042734
2005-03-04T09:30:00-05:00,23.8,23.8,23.67999,23.73,2885400,797390,61.801264526541324,53.665187894361374,NaN,NaN,132.69778700739172,36.506358942693296,0.01388531827568397,0.06376834040616686,0.04988302213048289,6347005,3944585,77.51389103973877,67.25004245787824,NaN,NaN,9.212050534922074,8.948544174739782
2005-03-07T09:30:00-05:00,23.73,23.77,23.63,23.66,289100,764285,58.7553411906069,53.612280775495215,NaN,NaN,101.66615726383634,66.56904610497824,0.01880508390730197,0.07338937701461035,0.054584293107308376,6057905,4526345,80.84704531000796,69.26084647806495,NaN,NaN,10.520590343472138,9.173122198844403
2005-03-08T09:30:00-05:00,23.71001,23.71001,23.5,23.55,253200,679255,54.232026831943905,53.13641901181892,NaN,NaN,51.7522804734174,72.95294295883994,0.01338532652017578,0.0713159512575281,0.05793062473735232,5804705,4969845,82.92500082427543,71.28488781562207,NaN,NaN,10.186636308684896,9.317909928821617
2005-03-09T09:30:00-05:00,23.55,23.55,23.31,23.38,244100,639970,48.07250383611158,52.07309435569257,NaN,NaN,-33.95875698111376,65.96034831011384,-0.0020904986430707456,0.05531750143351388,0.05740800007658463,5560605,5446365,84.82946790606441,73.15601077526006,NaN,NaN,7.8664386734513005,9.110556892340144
2005-03-10T09:30:00-05:00,23.33,23.53,23.32001,23.42999,596200,646105,49.87536132773761,51.69834490941795,NaN,NaN,-25.451099644827465,45.341273623740854,-0.009013991409813106,0.04614051081431825,0.05515450222413135,6156805,5985405,86.6441805395941,74.85138105167299,NaN,NaN,6.567745879571501,8.747298176230338
2005-03-11T09:30:00-05:00,23.31,23.46001,23.2,23.25,2529400,743010,43.95771447853337,51.00371999878514,NaN,NaN,-84.4098458291071,1.919747056441088,-0.02487034860029723,0.02406656647375982,0.04893691507405705,3627405,5441485,76.6770293519691,75.66688440350406,NaN,NaN,3.4834004732145014,7.995312790085219
2005-03-14T09:30:00-05:00,23.34,23.37,23.25,23.32001,386500,741760,46.6111581516509,51.44587719782471,NaN,NaN,-71.16847607559217,-32.647179611444614,-0.029483335198297475,0.012082746076185202,0.04156608127448268,4013905,5032685,70.14581475527646,75.94784910593498,NaN,NaN,1.8146759116959725,7.11236466460104
2005-03-15T09:30:00-05:00,23.45,23.45,23.17999,23.17999,250500,736860,42.29770110667341,51.3943396234058,NaN,NaN,-82.38356338081272,-59.47434838229064,-0.04014379999598886,-0.008613668720503398,0.031530131275485464,3763405,4624425,64.25908822225425,75.74308663938608,NaN,NaN,-1.0037076050490323,5.952925768936744
2005-03-16T09:30:00-05:00,23.07001,23.2,23.02,23.12,482800,704760,40.56562401971916,50.89637190980159,NaN,NaN,-138.3692767093168,-80.35645232793125,-0.048837044314072944,-0.02951617411710572,0.019320870196967224,3280605,4168425,58.36721044056032,75.01833918939717,NaN,NaN,-3.8389265490190874,4.554089723514482
2005-03-17T09:30:00-05:00,23.2,23.23,23.03,23.2,185500,685655,43.86678123004893,50.41507016822339,NaN,NaN,-108.27754455551836,-96.92174131006944,-0.04679641445432866,-0.0391746478709436,0.007621766583385058,3466105,3630285,52.275585058183545,73.68737969395762,NaN,NaN,-5.19477002197587,3.1613954741587174
2005-03-18T09:30:00-05:00,23.02,23.2,22.95,23.03,402100,694945,38.91977518980429,49.71724951747931,NaN,NaN,-133.36222494936362,-106.71221713412073,-0.05398273085878419,-0.059856646990095186,-0.005873916131310993,3064005,3517605,51.073605680427406,72.16687300711882,NaN,NaN,-7.962557859351866,1.5722592836572054
2005-03-21T09:30:00-05:00,23.12,23.12,22.88,22.89999,353200,689355,35.612142366307424,48.29149787311632,NaN,NaN,-150.38928702622852,-122.55637932424801,-0.0639004939059586,-0.08574953351375925,-0.021849039607800644,2710805,3256985,48.30696081650108,70.26097758609718,NaN,NaN,-11.37402249035943,-0.2772095412023139
2005-03-22T09:30:00-05:00,23,23,22.77,22.77,727400,703240,32.62651548413773,46.82567206243465,NaN,NaN,-172.6612248348273,-140.61191161505093,-0.07486345075998348,-0.11542835305777999,-0.04056490229779651,1983405,2900985,44.741661889393995,68.06918402720889,NaN,NaN,-15.224257268884294,-2.4125020737283105
2005-03-23T09:30:00-05:00,22.75,22.99001,22.64999,22.92,466100,671955,38.983494284301166,45.441243144579836,NaN,NaN,-151.81344805066647,-143.30074588332087,-0.06786788188975576,-0.1253997546599912,-0.05753187277023545,2449505,2734765,43.14066306663999,65.83908606434902,NaN,NaN,-16.4353633801906,-4.415767974651494
2005-03-24T09:30:00-05:00,23,23,22.87,22.91,396700,649830,38.721190906031175,43.792666457400536,NaN,NaN,-113.01284953621442,-144.24780687946006,-0.060039117869566075,-0.13258077010719305,-0.07254165223762697,2052805,2452105,40.487490373595186,63.194343159624474,NaN,NaN,-17.469367850359298,-6.280567956895466
2005-03-28T09:30:00-05:00,22.95,23.03,22.85001,22.92999,325000,644455,39.59614497177196,42.42415244176947,NaN,NaN,-95.89549012122065,-136.75445991383145,-0.05004778698523024,-0.13510138596916477,-0.08505359898393453,2377805,2314865,39.226084917280595,60.221417417286816,NaN,NaN,-18.052646856391235,-7.962293513966291
2005-03-29T09:30:00-05:00,22.85001,23.00999,22.83,22.88,673400,628875,38.12993545794162,41.27400305791216,NaN,NaN,-91.80120358196282,-125.03684322497834,-0.04357665424497144,-0.13952441679014882,-0.09594776254517738,1704405,2113585,37.38636509403511,56.96865772226964,NaN,NaN,-18.95579628121504,-9.532793909287541
2005-03-30T09:30:00-05:00,22.99001,23.2,22.95,23.17999,2248800,719410,50.07679839748899,41.417166955153405,NaN,NaN,-33.581276189821466,-97.22085349597717,-0.01721691498255394,-0.11746890627336981,-0.10025199129081587,3953205,2507545,43.01937034658907,53.98222218230712,NaN,NaN,-15.956872228557293,-10.450519383468935
2005-03-31T09:30:00-05:00,23.16,23.16,23,23.02,264300,712165,45.07755369208016,41.0744664097493,NaN,NaN,-42.41234197650496,-75.34063228114488,-0.009088811718901621,-0.1116130059394429,-0.10252419422054128,3688905,2755425,46.29333130765184,51.10001866573982,NaN,NaN,-15.01964488801342,-11.103251598403862
2005-04-01T09:30:00-05:00,23.2,23.2,22.74001,22.8,2441100,820040,39.27174681643284,40.739754433884976,NaN,NaN,-76.94048014609115,-68.12615840312023,-0.01662301606323914,-0.1233029642995902,-0.10667994823635106,1247805,2594425,44.50469851887844,48.80199503480476,NaN,NaN,-16.183696534413716,-11.82902944640527
2005-04-04T09:30:00-04:00,22.95,22.97,22.78,22.92999,511900,701365,43.87172613123666,40.54408071814111,NaN,NaN,-78.95948024346737,-64.73895642756956,-0.011205664569891666,-0.12068702894871564,-0.10948136437882397,1759705,2470805,43.126860560729625,46.87206973519427,NaN,NaN,-15.577663627330866,-12.364548615108927
2005-04-05T09:30:00-04:00,22.96001,23.12,22.94,23.10001,240400,698930,49.2829311315563,41.043025719918454,NaN,NaN,-19.899140921135633,-50.35854389540411,0.004625645751006352,-0.10369930719006604,-0.10832495294107239,2000105,2529945,44.01976354492681,45.42640368681374,NaN,NaN,-13.216748193436054,-12.486291412012802
2005-04-06T09:30:00-04:00,23.17,23.17,23.00999,23.03999,265200,699530,47.540495794715056,41.541230846703876,NaN,NaN,-2.882821593843197,-44.21885297620846,0.011463162099128274,-0.09399600031716204,-0.10545916241629032,1734905,2086285,39.06484200043059,44.047663083947334,NaN,NaN,-11.904301889859433,-12.403150051705177
2005-04-07T09:30:00-04:00,23.13,23.2,22.98,23.2,1957700,785210,52.37478781953399,42.14894560309567,NaN,NaN,31.4051144038345,-29.455361700140564,0.026320782423043754,-0.07255818438748562,-0.09887896681052938,3692605,2087025,39.07715986277752,43.10491842713261,NaN,NaN,-9.198806594797954,-11.945386700718432
2005-04-08T09:30:00-04:00,23.22,23.22,23.06,23.09,210000,765900,49.02976738185476,42.87108790252785,NaN,NaN,42.12276861704076,-5.6427119475141865,0.028134989740625782,-0.06371022963474715,-0.09184521937537293,3482605,2533985,46.15692544483127,42.75372698173289,NaN,NaN,-8.039398697993324,-11.387388414614845
2005-04-11T09:30:00-04:00,23.2,23.2,23.06,23.14999,166600,647760,50.87253967067526,43.961116281411265,NaN,NaN,57.929820317435784,21.735148164666445,0.03246297407293977,-0.051266501784198226,-0.083729475857138,3649205,2911885,51.30898078222327,42.96815697928448,NaN,NaN,-6.527130831755494,-10.693065902777795
2005-04-12T09:30:00-04:00,23.14999,23.27,22.94,23.24001,452100,651040,53.5843795757077,45.45810657366627,NaN,NaN,75.59312401099237,40.83360115109205,0.0399821198077244,-0.03375182609748251,-0.0737339459052069,4101305,3332125,56.314955270139066,43.79482079219484,NaN,NaN,-4.435317155259199,-9.799101795989424
2005-04-13T09:30:00-04:00,23.25,23.27,23,23.13,672600,672145,49.955279330749526,46.24180550555544,NaN,NaN,73.09575873380243,56.029317216621166,0.03625068301025147,-0.028420592142392564,-0.06467127515264404,3428705,3670885,59.894464645518745,44.99152090497189,NaN,NaN,-3.7602950717033496,-8.936415121091413
2005-04-14T09:30:00-04:00,23.25,23.25,23.05,23.08,642100,680110,48.35239825730442,46.92974888778924,NaN,NaN,67.69092010341029,63.28647835653633,0.029410282490752324,-0.02790842203920363,-0.05731870452995595,2786605,3489685,57.19487005238787,46.1849051677428,NaN,NaN,-3.675267686858126,-8.184822630486657
2005-04-15T09:30:00-04:00,23.10001,23.10001,22.8,22.86,518800,696775,41.97111815123751,47.099389829179636,NaN,NaN,-65.24569476082546,41.81278568096309,0.010063794007494166,-0.04473896202058825,-0.05480275602808241,2267805,3246725,53.69987620393505,47.21874740250383,NaN,NaN,-5.599201336791391,-7.815448159958762
2005-04-18T09:30:00-04:00,22.89999,22.95,22.64999,22.71001,1227800,738060,38.26347050641869,47.108928046928,NaN,NaN,-142.7982656351814,1.6671684904396442,-0.011662156011777086,-0.06938045104280377,-0.057718295031026684,1040005,2724885,47.04969578624309,47.908985309090106,NaN,NaN,-8.42909572597251,-7.903112097960726
2005-04-19T09:30:00-04:00,22.89999,22.89999,22.66,22.77,802900,760545,40.52641184622591,46.42675757898064,NaN,NaN,-122.08215898178283,-37.867888108115395,-0.020313582762557278,-0.08311027348422328,-0.06279669072166601,1842905,2273205,42.18057229056571,47.84907116223129,NaN,NaN,-10.047988756690335,-8.209523049207814
2005-04-20T09:30:00-04:00,22.82001,22.84,22.46001,22.48,1104100,779380,34.03221912677425,45.637805110030214,NaN,NaN,-197.60852994074756,-92.0087458430254,-0.04260587493358739,-0.11605403438865025,-0.07344815945506286,738805,1735225,37.23752534634446,47.20222787928077,NaN,NaN,-13.710440451704411,-8.995368392421613
2005-04-21T09:30:00-04:00,22.72,22.87,22.63,22.86,939800,803065,46.198359411119,46.13256315250779,NaN,NaN,-94.46532117849449,-124.43999409940633,-0.029424456325590514,-0.11022872986205101,-0.0808042735364605,1678605,1513625,35.39742202276446,46.55170812955834,NaN,NaN,-12.626448930342862,-9.514094183553219
2005-04-22T09:30:00-04:00,22.84,22.85001,22.50999,22.62,438200,805140,41.04918278661018,45.9309529136059,NaN,NaN,-137.34408780345143,-138.85967270793154,-0.03419968206500046,-0.12355387611771107,-0.08935419405271061,1240405,1308145,33.73286341786368,45.88070833363935,NaN,NaN,-13.623253286453796,-10.101116912539016
2005-04-25T09:30:00-04:00,22.74001,22.86,22.66,22.86,568000,817290,47.36683098885504,45.79408861769867,NaN,NaN,-70.12987762599622,-124.3259951060945,-0.019269032753617937,-0.11344048499473303,-0.09417145224111509,1808405,1461825,36.15117815568453,45.31866652012204,NaN,NaN,-12.108056530761825,-10.387822572285131
2005-04-26T09:30:00-04:00,22.7,22.85001,22.67999,22.69,370100,802125,43.78722371622172,45.52599775494914,NaN,NaN,-85.01046033338139,-116.9116553764142,-0.018891136177147355,-0.11778537246254928,-0.09889423628540192,1438305,1380905,35.418244185471195,45.05819524762494,NaN,NaN,-12.182354975044667,-10.644184344107922
2005-04-27T09:30:00-04:00,22.7,22.82001,22.49001,22.77,840700,731720,45.86070167748222,45.06070588765973,NaN,NaN,-94.1955678599732,-96.22906296025934,-0.01165696036917832,-0.11346543674687481,-0.1018084763776965,2279005,1688945,40.37404315445836,45.15082976845928,NaN,NaN,-11.536024968287727,-10.77159014756218
2005-04-28T09:30:00-04:00,22.82001,22.92,22.63,22.72,3187700,877890,44.74968876016653,44.75498598611057,NaN,NaN,-62.48326585694856,-89.83265189595014,-0.008774356742527828,-0.11277642230585627,-0.10400206556332844,-908695,1171485,35.45246264682487,44.386225282887395,NaN,NaN,-11.382133194120124,-10.858810582784743
2005-04-29T09:30:00-04:00,22.64,22.8,22.47,22.78,2003700,856020,46.42691256666382,44.437441192966894,NaN,NaN,-82.45142322839023,-78.8541189809379,-0.0017304035467191337,-0.10616506999672737,-0.10443466645000823,1095005,1142405,35.19283027115742,43.23507167495411,NaN,NaN,-10.743240919243018,-10.842300630850211
2005-05-02T09:30:00-04:00,22.87,22.97,22.81,22.95,212400,841045,50.968558801641585,44.25059685196218,NaN,NaN,3.682419712547603,-64.09165951322913,0.014576434233842958,-0.08621412365770453,-0.10079055789154749,1307405,1042205,34.261764903902744,41.65984379165152,NaN,NaN,-8.782990756910436,-10.548113506001672
2005-05-03T09:30:00-04:00,22.98,23.14,22.89999,23.05,520100,855030,53.4675149506416,44.50147082481161,NaN,NaN,50.1746890688006,-37.054629632792754,0.031333778128638856,-0.06162333523074892,-0.09295711335938778,1827505,1120045,35.68526099277574,39.930614959312734,NaN,NaN,-6.391394569231442,-9.954296515034496
2005-05-04T09:30:00-04:00,23.14999,23.24001,23.08,23.2,663200,874930,57.00713243633593,45.11966612331387,NaN,NaN,100.34287077621192,1.8530580944442732,0.05061451004327888,-0.029688975805289175,-0.08030348584856806,2490705,1162385,36.49083849093191,38.451755562065884,NaN,NaN,-3.2595208479613746,-8.997899991166907
2005-05-05T09:30:00-04:00,23.24001,23.28,23.05,23.16,1124000,833245,55.78843010621762,46.10661697724102,NaN,NaN,94.95685266622596,33.34108179907918,0.058225408023733924,-0.007521725818900649,-0.06574713384263457,1366705,1617465,44.53268108864767,37.79695591097392,NaN,NaN,-1.0624006154282268,-7.8642572232042385
2005-05-06T09:30:00-04:00,23.34,23.34,23.07001,23.07001,1518900,898690,53.04116575845014,47.16216663810041,NaN,NaN,92.11772409340571,68.25491126343836,0.054799951831026164,0.002752805946148129,-0.052047145884878035,-152195,1368025,41.435578256382655,37.39594751598389,NaN,NaN,0.006037914974865968,-6.739929346321509
2005-05-09T09:30:00-04:00,23.17,23.25999,23.09,23.214,435900,912155,56.714196448311675,48.31843696682081,NaN,NaN,99.97675517557828,87.5137783560445,0.05944384753115389,0.02225766352906433,-0.03718618400208956,283705,1163285,39.03585186122492,37.17132462817383,NaN,NaN,2.0131515071301447,-5.489489224399844
2005-05-10T09:30:00-04:00,23.22,23.22,23,23.08,895500,934325,52.5915123341466,49.64410076734741,NaN,NaN,70.14764773903342,91.50837009009106,0.051025859064663816,0.026596139828740206,-0.02442971923592361,-611795,675425,33.985119846286665,36.93900994959828,NaN,NaN,2.5295811651632962,-4.3439077401765385
2005-05-11T09:30:00-04:00,23.17999,23.17999,22.91,23.16,1590500,980220,54.70829755231193,50.25195349171833,NaN,NaN,65.87547748563594,84.61489143197586,0.0484029013214651,0.03607390741590777,-0.012328993905557334,978705,373025,31.283196372236603,36.645136688846286,NaN,NaN,3.576116801547538,-3.2124756627873845
2005-05-12T09:30:00-04:00,22.95,23.19,22.95,23.05,497300,972980,51.31550957828266,50.98526254826636,NaN,NaN,60.7121355870935,77.76594801614938,0.0373139802179866,0.03431348136692591,-0.0030004988510606845,481405,195965,29.78979970336988,36.363489280668155,NaN,NaN,3.489545229213685,-2.2550441067872318
2005-05-13T09:30:00-04:00,23.08,23.08,22.74001,22.85001,343100,964195,45.75924807127537,50.87043519701068,NaN,NaN,-4.0524988877708665,58.53190341991406,0.01567205918535608,0.016589575130634415,0.0009175159452783355,138305,254065,30.954567533905305,35.99230280768392,NaN,NaN,1.7237724414028925,-1.686641742760071
2005-05-16T09:30:00-04:00,22.95,23.10001,22.92,23.07001,781500,941880,51.925835091916944,51.4517645809889,NaN,NaN,43.84993468400744,47.30653932159989,0.015317288338593827,0.02006412636852062,0.004746838029926792,919805,381285,33.55396198779371,35.859139793564104,NaN,NaN,2.093264574047409,-1.1466551260732882
2005-05-17T09:30:00-04:00,23.03,23.21001,23,23.19,270500,915260,54.93512734488827,52.09993784294648,NaN,NaN,74.35748607116435,48.14850698802608,0.021906172744823777,0.032129553960956514,0.010223381216132737,1190305,741705,40.39975061009721,35.86097604039545,NaN,NaN,3.3389912396078123,-0.5058485024045596
2005-05-18T09:30:00-04:00,23.32001,23.46001,23.25,23.41,726400,896375,59.892387787619434,53.181559202050266,NaN,NaN,147.391345927713,64.4516806764415,0.03883428149403835,0.058766233083680675,0.019931951589642324,1916705,929305,43.65382494969381,36.44678763345752,NaN,NaN,6.027494403736291,0.42748619847270475
2005-05-19T09:30:00-04:00,23.46001,23.55,23.39,23.55,308800,864825,62.70400277838284,54.344208502887334,NaN,NaN,170.1815413462042,86.34556182826364,0.05616149203606115,0.09013381663471876,0.03397232459865761,2225505,1278125,49.206943762155205,37.447795739957364,NaN,NaN,9.17301431327482,1.6768473577301497
2005-05-20T09:30:00-04:00,23.55,23.56,23.39999,23.52,384100,862120,61.705767975599244,55.11115201531288,NaN,NaN,156.10879484527703,118.3778205748732,0.061853524591802524,0.11128923033841076,0.04943570574660824,1841405,1618745,53.97677509984379,38.85601075395315,NaN,NaN,11.387652117865892,3.0641051806066844
2005-05-23T09:30:00-04:00,23.60001,23.64999,23.5,23.56,507500,859095,62.5615799801774,55.76072808885116,NaN,NaN,162.30646685658664,142.06912700938904,0.06428072701740065,0.12978661451835904,0.0655058875009584,2348905,1904565,57.57682865915773,40.41969415869472,NaN,NaN,13.449863899312037,4.547784997564592
2005-05-24T09:30:00-04:00,23.56,23.56,23.42999,23.52,2247200,952950,61.091270193211024,56.05245221434223,NaN,NaN,125.73788653852154,152.34520710286048,0.05928243732084548,0.13960893415201525,0.08032649683116977,101705,1686845,54.10498928221508,41.67784778664351,NaN,NaN,14.750602610554456,6.005330370848858
2005-05-25T09:30:00-04:00,23.5,23.5,23.33,23.44,388700,930350,58.14786796359333,56.22098348986907,NaN,NaN,90.36875331481492,140.9406885802809,0.04720418840402063,0.13933173233619556,0.09212754393217493,-286995,1246105,47.81890325003728,41.91257794102849,NaN,NaN,15.04520991224903,7.296741733906026
2005-05-26T09:30:00-04:00,23.53,23.53,23.42,23.46001,290300,785480,58.68407160702077,56.624048193338396,NaN,NaN,93.28748821250993,125.56187795354204,0.0375963366407209,0.13912296473307606,0.10152662809235516,3305,801665,42.46150706099898,41.985858569929654,NaN,NaN,15.433727405746303,8.459168258454637
2005-05-27T09:30:00-04:00,23.55,23.56,23.28999,23.39,319900,701290,55.9816355379777,56.57172241402883,NaN,NaN,63.93665090840091,107.1274491661668,0.0242099856663313,0.1317891101752693,0.10757912450893799,-316595,370065,38.0081835231432,41.9124536886381,NaN,NaN,15.04614431836964,9.400164838442494
2005-05-31T09:30:00-04:00,23.48,23.48,23.25999,23.31,424400,711890,52.979321119017435,56.59942304151961,NaN,NaN,35.138746160576815,81.69390502696484,0.008464361310049406,0.11815957614649975,0.10969521483645034,-740995,-247915,32.717134654760216,41.82188331781479,NaN,NaN,13.897075767067626,10.042580685388941
2005-06-01T09:30:00-04:00,23.3,23.50999,23.25999,23.47,455500,708660,57.848324848153354,56.82371070550828,NaN,NaN,52.53124283267684,67.05257628579591,0.0073623490765320765,0.11889815118211544,0.11153580210558336,-285495,-325355,32.113835871560156,41.88121471062361,NaN,NaN,14.20991174109998,10.637913693347661
2005-06-02T09:30:00-04:00,23.5,23.55,23.38,23.53,328800,691940,59.54028444592124,57.41119462462532,NaN,NaN,72.72278525923099,63.52338267467911,0.009097891865364957,0.12290816693728956,0.11381027507192461,43305,-259295,33.244675470576894,42.12799155113839,NaN,NaN,14.944411837094082,11.253127713882865
2005-06-03T09:30:00-04:00,23.53,23.53,23.28,23.34,503800,660930,52.371330492057965,57.88348622610978,NaN,NaN,31.065830424461694,51.07905111706947,-0.0034541727414998946,0.10949255914504974,0.11294673188654963,-460495,-352055,32.42782160737784,42.23322398495787,NaN,NaN,13.494498904682775,11.573323598282853
2005-06-06T09:30:00-04:00,23.37,23.37,23.27,23.35001,739500,621960,52.69449357445688,57.93839040343407,NaN,NaN,8.043132048700441,39.900347345129376,-0.011531389200485659,0.09853249538594255,0.11006388458642821,279005,-232935,34.64850391229682,42.3114055509938,NaN,NaN,12.401882793987836,11.691689197669278
2005-06-07T09:30:00-04:00,23.34,23.57001,23.34,23.44,511400,625735,55.610436531887274,57.98662677393399,NaN,NaN,51.79018181702232,43.23063447641846,-0.011250017378160379,0.09600136286372773,0.10725138024188811,790405,73345,40.09940481634944,42.28995228001181,NaN,NaN,12.271890757714706,11.774575134818626
2005-06-08T09:30:00-04:00,23.39999,23.50999,23.35001,23.38,181000,590010,53.25345178061751,57.51241705914815,NaN,NaN,33.237374081704594,39.37186072622401,-0.015290764660509146,0.08813792441625168,0.10342868907676082,609405,252325,43.08682372178559,42.249452192304084,NaN,NaN,11.502320933467416,11.73568167748274
2005-06-09T09:30:00-04:00,23.38,23.46001,23.31,23.39,659500,543460,53.60638465968926,56.862587193527176,NaN,NaN,16.601193992864317,28.147542472950676,-0.01732662260184535,0.08177041082445413,0.09909703342629948,1268905,497445,46.986348077712464,42.090838214843885,NaN,NaN,10.95647161872806,11.6243659548035
2005-06-10T09:30:00-04:00,23.42999,23.46001,23.25,23.37,599600,548575,52.748619605340245,56.22279088136582,NaN,NaN,-5.068568433623397,20.920662701333658,-0.019874170744818537,0.07425431999527632,0.09412849074009486,669305,723405,50.362676397455125,41.83268830753041,NaN,NaN,10.270396607793792,11.430941762373541
2005-06-13T09:30:00-04:00,23.45,23.5,23.28,23.45,636100,563225,55.79554976051005,55.73950300853244,NaN,NaN,12.767708918535554,21.86557807530068,-0.01618182607279095,0.07390120814910617,0.09008303422189712,1305405,928685,53.27415668441479,41.525354595048775,NaN,NaN,10.462142523783251,11.292541871146357
2005-06-14T09:30:00-04:00,23.38,23.49001,23.32001,23.41,220700,535185,53.923235983447114,55.227500564977866,NaN,NaN,-7.568638012584878,9.99381410937924,-0.016393234283403668,0.06959149136764253,0.0859847256510462,1084705,987545,54.105394778298866,41.52538355905476,NaN,NaN,10.137738008802053,11.127569890811456
2005-06-15T09:30:00-04:00,23.42999,23.48,23.28,23.42,283000,535810,54.33578895775087,54.955209207417695,NaN,NaN,-45.29920718780047,-5.713502144521774,-0.015812110117031958,0.06621958800475625,0.0820316981217882,1367705,1139205,56.264329711446926,42.1286283062983,NaN,NaN,9.966725215798505,10.961734937238177
2005-06-16T09:30:00-04:00,23.45,23.45,23.34,23.35001,371200,518050,50.90066891632695,54.39925187236814,NaN,NaN,-64.36404752733264,-21.906550448561166,-0.019833441431088936,0.05723989633292703,0.07707333776401597,996505,1084725,55.258719982391796,43.04271494354065,NaN,NaN,8.9234250627262,10.670547812307895
2005-06-17T09:30:00-04:00,23.32001,23.41,23.26401,23.3,820900,543655,48.53934587642345,53.86765975368569,NaN,NaN,-132.42326045330367,-47.37748885249722,-0.025208416495490604,0.04556281714465271,0.07077123364014332,175605,985985,53.39600756266865,44.14184523207818,NaN,NaN,7.391427733768471,10.202102086802263
2005-06-20T09:30:00-04:00,23.3,23.33,23.17999,23.28999,644800,556690,48.05876506312343,53.51619146397898,NaN,NaN,-192.14933143112924,-88.36089692243017,-0.028539902530533068,0.03509635547697698,0.06363625800751005,-469195,631065,47.23275078355107,45.17867495556324,NaN,NaN,5.96526560591457,9.596839732389736
2005-06-21T09:30:00-04:00,23.3,23.34,23.21001,23.24001,750500,568840,45.62955219523672,52.64342198877064,NaN,NaN,-178.6338842786845,-122.5739461756501,-0.03290167103985535,0.02250916920769086,0.05541084024754621,-1219695,170185,40.66828476119947,45.78970701910891,NaN,NaN,4.076818051124648,8.808265206494724
2005-06-22T09:30:00-04:00,23.36,23.37,23.19,23.25999,859200,499440,46.78750407365643,51.73250910503744,NaN,NaN,-144.61005149136045,-142.43611503636208,-0.033140876207119016,0.013984744988647435,0.04712562119576645,-360495,-175455,36.56405779110472,46.02680575628947,NaN,NaN,2.7325433275527566,7.940304938074443
2005-06-23T09:30:00-04:00,23.25,23.25,22.95,22.97,2179300,588970,35.10231826410376,50.49900823161214,NaN,NaN,-304.3519201546192,-190.43368956181942,-0.05048962550174439,-0.015986410681414043,0.03450321482033035,-2539795,-882715,29.91194065310151,45.84709997384117,NaN,NaN,-2.3471363701933408,6.47067046546476
2005-06-24T09:30:00-04:00,22.91,22.96001,22.72,22.74001,328900,590900,28.93097821121303,48.801614277094714,NaN,NaN,-355.25560951859757,-235.0001593748782,-0.07370871958439479,-0.057632684660163136,0.016076034924231652,-2868695,-1491575,25.594935466980544,45.20041651346143,NaN,NaN,-9.236840628467315,4.22674030918875
2005-06-27T09:30:00-04:00,22.77,22.78999,22.67,22.72,629400,606375,28.462128267414457,46.86244940106094,NaN,NaN,-275.89326921479113,-251.7489469316106,-0.08582161864304907,-0.09120098837957968,-0.005379369736530616,-3498095,-2097355,22.167038044681235,43.919533172627986,NaN,NaN,-14.788832104035219,1.5102299644424688
2005-06-28T09:30:00-04:00,22.81,23.03,22.8,23.00999,1095000,639905,42.90329847051717,46.12315273605378,NaN,NaN,-138.31044537347327,-243.68425915056832,-0.0703593110268515,-0.093328508520095,-0.022969197493243495,-2403095,-2334035,20.98452939614471,42.340797863653634,NaN,NaN,-14.819925376440201,-0.8226493699693411
2005-06-29T09:30:00-04:00,23.03,23.06,22.91,22.95,551900,644725,41.056869008016044,45.22675876093426,NaN,NaN,-106.15105440091489,-235.9924597324792,-0.06059850068372961,-0.0987173233479055,-0.0381188226641759,-2954995,-2852935,18.63715160876184,40.3158552587286,NaN,NaN,-15.474695867824453,-2.9157988696629284
2005-06-30T09:30:00-04:00,22.91,22.99001,22.73,22.75,503100,653440,35.56192668760714,43.99913783823904,NaN,NaN,-133.19311043866693,-201.76069778928874,-0.06371995105241257,-0.11776876147969162,-0.05404881042727904,-3458095,-3036595,17.874993218496783,37.99530646023157,NaN,NaN,-17.99549786792095,-5.070041583699789
2005-07-01T09:30:00-04:00,22.85001,22.89999,22.75999,22.83,578800,657190,39.07446704392147,42.80477478705414,NaN,NaN,-110.71771654873179,-152.8531191953156,-0.05673794475149796,-0.1249712413666515,-0.06823329661515354,-2879295,-3038715,17.865910897965193,35.46614604691374,NaN,NaN,-18.78245887824541,-7.028958340063449
2005-07-05T09:30:00-04:00,22.78999,23.00999,22.78,22.96001,864100,663420,44.3805821800792,42.123156658242145,NaN,NaN,-74.08697014777852,-112.49185938191309,-0.04046845723355652,-0.11881886815709919,-0.07835041092354267,-2015195,-2742135,23.706156569527025,33.29477188914432,NaN,NaN,-17.60322219552406,-8.539567462272107
2005-07-06T09:30:00-04:00,23,23,22.73,22.74001,1169000,696300,38.30167266727697,40.97786263749401,NaN,NaN,-89.63485831852637,-102.75674197092368,-0.04147521454979568,-0.13019442911078727,-0.08871921456099159,-3184195,-2898355,22.787030954700256,30.903536263662424,NaN,NaN,-18.739535921905095,-9.996705813648248
2005-07-07T09:30:00-04:00,22.64999,22.73,22.55,22.7,510500,712775,37.30101868015974,40.00645904919635,NaN,NaN,-120.07598813478809,-105.5417287176983,-0.04167653983543915,-0.14081488935529052,-0.09913834951985137,-3694695,-3046295,21.920281624218134,28.522219238078584,NaN,NaN,-19.954116781949764,-11.419193094834178
2005-07-08T09:30:00-04:00,22.7,23.02,22.66,23,380300,698815,48.22381060753054,39.983920815704,NaN,NaN,-51.2133431961945,-89.14577526920382,-0.019568848984744022,-0.1235994107507814,-0.10403056176603738,-3314395,-3017555,22.53671693029453,26.317984192909005,NaN,NaN,-17.052035339224577,-12.223884844032806
2005-07-11T09:30:00-04:00,23.08,23.14999,23,23.13,888100,713240,52.11663339791463,40.27376855390338,NaN,NaN,8.90470908058798,-65.22129014333987,0.004558377813330114,-0.09833258949937473,-0.10289096731270485,-2426295,-2926955,24.55873188738306,24.69841141461129,NaN,NaN,-13.330998279899372,-12.382043906299458
2005-07-12T09:30:00-04:00,23.14,23.24001,23.13,23.14999,287200,695795,52.705476416201584,40.77919171254372,NaN,NaN,38.369668027412416,-42.72996250830171,0.021655650859516026,-0.07582140373830981,-0.09747705459782584,-2139095,-2951735,24.371350757958112,23.53434470009405,NaN,NaN,-10.280661494385898,-12.081846418883234
2005-07-13T09:30:00-04:00,23.17999,23.25999,23.12,23.24001,310700,700295,55.36729792805361,41.39203413071495,NaN,NaN,54.605589548536116,-13.881872934889211,0.03787021117022496,-0.05013929063504463,-0.08800950180526959,-1828395,-2680575,30.61046447632991,23.109088034752993,NaN,NaN,-6.922131922835671,-11.344744348019297
2005-07-14T09:30:00-04:00,23.36,23.48,23.33,23.37,564300,714360,58.95931426104575,43.096105273353665,NaN,NaN,116.3441927126398,33.402163234596365,0.05514598834572751,-0.01907701637311021,-0.07422300471883772,-1264095,-2194455,40.14386379025823,23.83993968740705,NaN,NaN,-2.925983387603547,-10.142064210817047
2005-07-15T09:30:00-04:00,23.37,23.39,23.3,23.36,259200,708760,58.56880956635908,45.21309322729267,NaN,NaN,103.27682712164753,64.30019729816476,0.06312176728632084,0.0046792043890633295,-0.05844256289725751,-1523295,-1836235,46.02837410935667,25.299471019005342,NaN,NaN,0.11904135743345515,-8.67619198678126
2005-07-18T09:30:00-04:00,23.32001,23.42,23.25,23.25,1033500,719390,54.30779176763203,47.059212048736775,NaN,NaN,89.54001038774437,80.42725755959606,0.05832475033513619,0.014463375021662728,-0.043861375313473464,-2556795,-1862335,45.67603133231106,26.978684825264615,NaN,NaN,1.4365263836826765,-7.231517933857841
2005-07-19T09:30:00-04:00,23.31,23.38,23.21001,23.21001,1161500,745225,52.80376608519469,47.76638830692803,NaN,NaN,76.15262010719124,87.98384797555181,0.05010840066441143,0.01877412551704083,-0.031334275147370604,-3718295,-2178175,41.5327733321724,28.446416534980873,NaN,NaN,2.080254912078119,-5.901264670152704
2005-07-20T09:30:00-04:00,23.05,23.33,23.05,23.3,632300,739315,55.772126926626186,48.81747815825732,NaN,NaN,63.963963963963,89.8555228586372,0.04836040687719511,0.029116233449123285,-0.019244173428071824,-3085995,-2429695,38.53499831168898,29.867691299475666,NaN,NaN,3.497830751179034,-4.558536752819599
2005-07-21T09:30:00-04:00,23.3,23.35001,23.17,23.21001,1640100,778360,52.23419907548686,50.008354757391594,NaN,NaN,70.64021680511972,80.71472767713318,0.03916215968415128,0.029708526177117278,-0.009453633507034003,-4726095,-3122095,31.742642851694796,30.858237701846953,NaN,NaN,3.6807278246612416,-3.381498956036622
2005-07-22T09:30:00-04:00,23.25,23.35001,23.17999,23.28,2361400,787465,54.64406201532298,51.12046868392027,NaN,NaN,72.15462755134557,74.4902877630728,0.03589671668290882,0.03541726234660203,-0.0004794543363067956,-2364695,-3290375,30.342795195594164,31.749443723106165,NaN,NaN,4.530038053401368,-2.2512793832597664
2005-07-25T09:30:00-04:00,23.39,23.39,23.2,23.2,552400,798640,51.44891963991636,51.6253499310515,NaN,NaN,63.689774502165385,69.320240585957,0.02686719305509592,0.033104536982563104,0.006237343927467184,-2917095,-3362435,29.738016986332426,32.18029089573512,NaN,NaN,4.336792469999099,-1.3101262613656428
2005-07-26T09:30:00-04:00,23.25,23.39999,23.25,23.32001,507400,792540,55.63933805544343,52.863754601634824,NaN,NaN,77.33168159515306,69.55605288354936,0.027401133081019175,0.040488760278741154,0.013087627197721979,-2409695,-3100715,34.81944676673653,33.03974916802343,NaN,NaN,5.398772463508236,-0.35171215781223153
2005-07-27T09:30:00-04:00,23.39999,23.42999,23.33,23.38,678100,771695,57.60894178961429,54.31432053802443,NaN,NaN,88.45126414287493,74.45351291933174,0.030008487924267392,0.05059823710305622,0.02058974917878883,-1731595,-2829835,39.68171820768083,34.308423209699335,NaN,NaN,6.862783078017724,0.678930018734905
2005-07-28T09:30:00-04:00,23.42999,23.63,23.34,23.58,1786200,833410,63.43740048996257,55.40100552962672,NaN,NaN,123.134698292718,84.95240921685141,0.04264545285399824,0.07389656524628663,0.03125111239228839,54605,-1873695,53.007171076149355,36.484884220117536,NaN,NaN,10.024154441897366,2.013962079186685
2005-07-29T09:30:00-04:00,23.58,23.62,23.47,23.48,1326100,874560,59.06458352578577,55.89728768161752,NaN,NaN,119.98299202062898,94.5180821107081,0.04166383573824968,0.08333090706510049,0.04166707132685081,-1271495,-1655055,55.431829880262285,38.690105505323196,NaN,NaN,11.341571207862353,3.346477668997495
2005-08-01T09:30:00-04:00,23.50999,23.51401,23.33,23.36,916400,891440,54.233449573258916,56.00642862140733,NaN,NaN,73.7983693032135,96.53980107091772,0.03082649963769605,0.08020019587397087,0.04937369623627482,-2187895,-1509215,57.02466221381193,41.02248489502704,NaN,NaN,10.95599114923645,4.433551023317346
2005-08-02T09:30:00-04:00,23.35001,23.49001,23.35001,23.44,404600,868465,56.771970769577614,56.1067623958019,NaN,NaN,79.86051222781994,97.04556719745109,0.02707317381601098,0.08321516350628855,0.05614198969027757,-1783295,-1383935,58.40005820829038,43.00745587588136,NaN,NaN,11.410897795654943,5.4303148479370025
2005-08-03T09:30:00-04:00,23.48,23.49001,23.36,23.49001,3065000,963265,58.328037160688744,56.06167117434783,NaN,NaN,85.74046514090045,96.50340739705618,0.02598112696132726,0.08861839839193664,0.06263727143060938,1281705,-781275,64.31639029019918,44.734064911591425,NaN,NaN,12.247934077792241,6.4042604522020365
2005-08-04T09:30:00-04:00,23.38,23.42,23.24001,23.28999,479900,961735,50.49840125671017,55.48521343794433,NaN,NaN,9.692323887220345,73.81493251595666,0.0105988183781454,0.07588579440329113,0.06528697602514573,801805,-631835,65.62201804648348,46.13361090710048,NaN,NaN,10.517359125181262,6.991845976913354
2005-08-05T09:30:00-04:00,23.23,23.25,23.12,23.14,1371300,1011285,45.559639777761035,54.860345438667835,NaN,NaN,-103.98342784936737,29.02164854195737,-0.009765342504300778,0.05308029789476976,0.06284564039907053,-569495,-491435,66.84925607553865,47.64598410304531,NaN,NaN,7.418990163089785,7.052866574938559
2005-08-08T09:30:00-04:00,23.12,23.2,23.07001,23.10001,807900,1007275,44.315219413399745,54.25402067639676,NaN,NaN,-140.81865117426727,-13.901755553538788,-0.025142308718931305,0.0314177545004064,0.05656006321933771,-1377395,-329335,68.25815917688622,49.55494023481059,NaN,NaN,4.539399875035799,6.693799903523879
2005-08-09T09:30:00-04:00,23.17,23.21001,23.08,23.14,806400,1033235,45.9063926150116,53.549325368424284,NaN,NaN,-123.11883032500236,-54.49762406410325,-0.0314258707961196,0.017277724724188204,0.048703595520307806,-570995,-86875,70.29193894879589,51.82329313746108,NaN,NaN,2.6537460395152577,6.116649351522647
2005-08-10T09:30:00-04:00,23.24001,23.38,23.06,23.10001,2009700,1118185,44.535902571846684,52.99944704673571,NaN,NaN,-94.49329909184561,-90.54437691065246,-0.036712979457081046,0.002812371198956498,0.039525350656037544,-2580695,-859355,57.623974156501944,53.67195965923302,NaN,NaN,0.6938810515338141,5.3419681658099565
2005-08-11T09:30:00-04:00,23.14999,23.2,23.02,23.16,1102400,1145090,47.087841841097884,52.45971703429105,NaN,NaN,-117.00022694232327,-115.88288707656118,-0.03463420511377728,-0.0037674057361840596,0.03086679937759322,-1478295,-1315375,51.70048899553241,55.197509216371465,NaN,NaN,-0.24835455579667196,4.543350634151867
2005-08-12T09:30:00-04:00,23.12,23.14999,22.99001,23.08,1271600,1195710,44.169244615893106,51.93974024686082,NaN,NaN,-133.53572412680668,-121.79334633204905,-0.03690250718895681,-0.015261334608602795,0.021641172580354015,-2749895,-1751455,46.75129265196159,56.41274319248783,NaN,NaN,-1.8956178761803812,3.6234979898186888
2005-08-15T09:30:00-04:00,23.03999,23.24001,23.03999,23.19,1384600,1213265,48.862678825689166,51.45569315902124,NaN,NaN,-73.8494615340596,-108.39950840400752,-0.02956709999955488,-0.015317702419089585,0.014249397580465294,-1365295,-1749035,46.78173895687432,57.26719263464053,NaN,NaN,-1.9801166323355335,2.8229816152252285
2005-08-16T09:30:00-04:00,23.12,23.16,22.95,22.96001,2445700,1277475,41.08573077191104,50.27546380061386,NaN,NaN,-134.76504076958147,-110.72875049292334,-0.03822678618359233,-0.03353408514902512,0.004692701034567211,-3810995,-2397035,40.16011132774513,57.30136357178798,NaN,NaN,-4.542620276994052,1.7707527734796171
2005-08-17T09:30:00-04:00,22.86,23.00999,22.86,22.95,1438300,1317775,40.78149875592693,48.6571851053256,NaN,NaN,-154.9631819523331,-122.82272706502083,-0.04233219569362313,-0.0482225435824617,-0.005890347888838571,-5249295,-2930755,35.68048033952081,56.06374280488594,NaN,NaN,-6.6712061827896765,0.5647586368697182
2005-08-18T09:30:00-04:00,22.89999,23.28,22.89999,23.21001,1494300,1310485,50.942954798357384,48.07706876765214,NaN,NaN,-55.56147866095459,-110.53497740874711,-0.026039331244051313,-0.038439511943902716,-0.012400180699851401,-3754995,-3386095,32.36372910980235,54.41602132128166,NaN,NaN,-5.298827823260232,-0.2728965717202746
2005-08-19T09:30:00-04:00,23.17,23.28,23.17,23.17999,1753700,1280100,49.878763916605685,47.76601979217691,NaN,NaN,-16.0152688068154,-87.03088634474885,-0.01626501086788153,-0.032731444284703315,-0.016466433416821784,-5508695,-3937855,28.86253799770175,52.40444102013093,NaN,NaN,-4.542706017200427,-0.8828693496460105
2005-08-22T09:30:00-04:00,23.14999,23.38,23.14,23.25,1085500,1306755,52.37728832280571,47.45211390312178,NaN,NaN,6.313584868527712,-70.99827706423139,-0.004668021495631138,-0.022301460286360708,-0.01763343879072957,-4423195,-4549435,25.561629130200686,50.05883894312452,NaN,NaN,-3.146450134391744,-1.2062380331811153
2005-08-23T09:30:00-04:00,23.25,23.27,23.16,23.19,1114700,1337120,50.07348450679585,46.86250299927229,NaN,NaN,-15.064877280324987,-47.05824436638007,-0.0008228469613118725,-0.01866199749236941,-0.017839150531057536,-5537895,-4894815,23.899315116276938,47.17190500213008,NaN,NaN,-2.6738464222289338,-1.4158963744736608
2005-08-24T09:30:00-04:00,23.13,23.22,22.97,22.98,1031200,1354775,42.95244913719935,46.323506419307236,NaN,NaN,-82.06733618590468,-32.47907521309439,-0.011608704330722315,-0.03235003094446043,-0.020741326613738113,-6569095,-5158775,22.685112692015352,44.10498319109665,NaN,NaN,-4.527241729789773,-1.8603742823759624
2005-08-25T09:30:00-04:00,23.03999,23.2,22.94,23.00999,434500,1287190,44.173455508849344,46.224493257242116,NaN,NaN,-82.02452610209812,-37.7716847013231,-0.015657536856139003,-0.04031324768391187,-0.024655710827772865,-6134595,-5634695,20.648217316836508,40.80490899404649,NaN,NaN,-5.641733942218504,-2.4005685194963253
2005-08-26T09:30:00-04:00,22.97,23.22,22.89999,22.95,229400,1232355,42.22651258151602,46.07529991210756,NaN,NaN,-94.16201896643035,-53.40103473324609,-0.02097811293246242,-0.05087835199335089,-0.02990023906088847,-6363995,-5805755,19.954677052340045,37.35466027086461,NaN,NaN,-7.150228171868618,-3.0790913269780815
2005-08-29T09:30:00-04:00,22.89999,23.14999,22.84,23.11,271600,1200115,48.71850931032929,46.276165390344545,NaN,NaN,-82.71058181113388,-71.20586806917842,-0.012729818612914903,-0.045812512327032096,-0.03308269371411719,-6092395,-6139595,18.638895259409438,33.66515715019416,NaN,NaN,-6.471872267569206,-3.5637743184910993
2005-08-30T09:30:00-04:00,23.07001,23.07001,22.81,22.99001,729800,1216375,44.66503742893379,46.28538930870791,NaN,NaN,-128.37464024436875,-93.86782066198717,-0.014248502280540545,-0.05089332156479287,-0.036644819284252325,-6822195,-6396455,17.673290547779274,30.81153689242825,NaN,NaN,-7.161550807716206,-4.0777423883804005
2005-08-31T09:30:00-04:00,22.94,23.10001,22.83,23.07001,391200,1082685,47.784381066061684,46.33514211049104,NaN,NaN,-88.17255875478625,-95.08886517576347,-0.009013956819589108,-0.04791226530873871,-0.0388983084891496,-6430995,-6368835,18.164237109815744,28.416090329162778,NaN,NaN,-6.771056859235141,-4.462501598502506
2005-09-01T09:30:00-04:00,23.13,23.19,23.00999,23.03999,421500,1079765,46.72006067546636,46.51734325760342,NaN,NaN,-15.46076853846423,-81.7761136630367,-0.006821696437665149,-0.04742542903623104,-0.04060373259856589,-6852495,-6512415,17.577418972376904,26.332242209192437,NaN,NaN,-6.7671064062968,-4.791730856758834
2005-09-02T09:30:00-04:00,23.05,23.2,23.03,23.08,873300,1054865,48.37060061264515,46.48219481381456,NaN,NaN,9.205944070379239,-61.102521055674785,-0.0021665042929611272,-0.0433118629647673,-0.04114535867180617,-5979195,-6435455,19.08633145638531,24.35399881630037,NaN,NaN,-6.289568265999425,-5.00570762950749
2005-09-06T09:30:00-04:00,23.12,23.36,23.12,23.33,636300,1046285,57.2766271954048,47.63868741549269,NaN,NaN,145.68902720247266,-15.422599252953471,0.01719438202776539,-0.01965238113709944,-0.03684676316486483,-5342895,-6285555,22.07856867235084,23.06246005520078,NaN,NaN,-2.9793787095702298,-4.716232069516453
2005-09-07T09:30:00-04:00,23.33,23.36,23.21001,23.35001,3038100,1157870,57.902569445523135,48.86162103617812,NaN,NaN,152.95668118933233,40.84366503378674,0.030040968931971817,0.0007044480000999442,-0.029336520931871873,-2304795,-5382075,37.16194189343096,23.168278737622934,NaN,NaN,-0.14177201118732,-4.062737775469434
2005-09-08T09:30:00-04:00,23.39999,23.39999,23.16,23.25999,1408900,1127830,54.06495628000184,49.08462114200987,NaN,NaN,116.56767765431319,81.79171231560663,0.03104075285664097,0.009464420138929341,-0.02157633271771163,-3713695,-4838615,44.16348238947734,24.011118257599716,NaN,NaN,1.1208605005516998,-3.3222237360378433
2005-09-09T09:30:00-04:00,23.2,23.46001,23.14999,23.36,2431600,1194290,57.439817674670216,49.62469641044305,NaN,NaN,130.45871625571024,110.97560927444151,0.03661930235966863,0.024197795231874153,-0.012421507127794473,-1282095,-3724535,55.186758493196095,25.8914197215636,NaN,NaN,3.2275811931683087,-2.3865373175798217
2005-09-12T09:30:00-04:00,23.3,23.42999,23.3,23.41,827100,1172065,59.05930760033188,50.101983501694924,NaN,NaN,141.88850621390395,137.51212170314645,0.041500312473789894,0.039453883464442896,-0.002046429009346998,-454995,-2619695,62.99006072724422,28.564879121352423,NaN,NaN,5.454941275411833,-1.2663260900095854
2005-09-13T09:30:00-04:00,23.25,23.3,23.13,23.19,1381000,1171885,50.037250552544926,50.09939536210557,NaN,NaN,37.457846474878465,115.86588555762762,0.028362890959314647,0.03340718468979631,0.005044293730481664,-1835995,-1918315,66.927207514814,31.638300006962215,NaN,NaN,4.633597843965781,-0.4234798137273903
2005-09-14T09:30:00-04:00,23.19,23.2,23.02,23.03999,1794500,1139325,44.99041210770731,50.24496414571329,NaN,NaN,-34.1794091194672,78.43866749586772,0.009022504444291615,0.016322424285846182,0.0072999198415545676,-3630495,-2183455,64.14903065221203,34.600008432690544,NaN,NaN,2.268240266658853,-0.03894837367221271
2005-09-15T09:30:00-04:00,23.13,23.14999,23.03,23.13,990300,1116925,48.35629200691402,50.54373818128933,NaN,NaN,-31.197391525608786,48.88565365988332,0.002105026214737713,0.009931202609976708,0.007826176395238995,-2640195,-1968755,65.40146890055094,37.79666926009872,NaN,NaN,1.3938132530882816,0.1657318587221436
2005-09-16T09:30:00-04:00,23.2,23.2,23.03,23.08,1479300,1116175,46.64877744356374,50.85961424286417,NaN,NaN,-30.014516787777637,16.79100705118575,-0.005603297025482965,0.0008220551133852894,0.006425352138868254,-4119495,-2536235,59.48619562167579,40.620349157908414,NaN,NaN,0.15486691948294792,0.16417972454511565
2005-09-19T09:30:00-04:00,23.12,23.2,22.89,22.94,2017400,1129360,42.159750876617764,50.39113149759906,NaN,NaN,-80.32931725435682,-27.652557642466412,-0.019134042251763236,-0.01749220067583579,0.0016418415759274453,-6136895,-3672615,49.777178036399334,42.8445122134077,NaN,NaN,-2.342295059869536,-0.19388810179983457
2005-09-20T09:30:00-04:00,23.89,23.89,22.75,22.8,987100,1124440,38.20089137199588,49.92940677924635,NaN,NaN,6.935833891956311,-33.75696015905084,-0.035561254403878494,-0.04280972642892067,-0.007248472025042178,-7123995,-4730215,42.77917617803719,44.63778975842611,NaN,NaN,-5.765235945513934,-0.9897949366161345
2005-09-21T09:30:00-04:00,22.66,22.66,22.5,22.52,1848300,1161120,31.77452108495126,48.78584535202418,NaN,NaN,-306.8955044927988,-88.30017923371716,-0.06179619594790725,-0.08449371695992625,-0.02269752101201899,-8972295,-5798575,37.1043850584167,45.990657469040464,NaN,NaN,-11.156203655137366,-2.442139039262025
2005-09-22T09:30:00-04:00,22.39999,22.7,22.39999,22.69,912500,1155185,38.53525588663684,48.201216438536356,NaN,NaN,-227.87325086702558,-127.6353511020005,-0.06394435853196775,-0.1026279691769787,-0.038683610645010934,-8059795,-6882495,32.40733606603392,47.04993726144454,NaN,NaN,-13.274517805412401,-3.98962172014065
2005-09-23T09:30:00-04:00,22.60001,22.8,22.60001,22.73,971500,1182035,40.04081827996272,47.6062319862019,NaN,NaN,-145.60113748519518,-150.75267524148404,-0.05903333863864038,-0.11247528394331141,-0.05344194530467103,-7088295,-7476255,30.155364876162764,47.84058250571435,NaN,NaN,-14.427967804683083,-5.480814017932426
2005-09-26T09:30:00-04:00,22.87,22.87,22.60001,22.64999,1083100,1224720,38.03397543507806,46.231756860464266,NaN,NaN,-125.70697191075878,-159.8282061727644,-0.05747941262024077,-0.125291211079972,-0.06781179845973122,-8171395,-7883155,28.684321383114167,48.31242198505459,NaN,NaN,-16.007360270768814,-6.984606339766195
2005-09-27T09:30:00-04:00,22.64,22.94,22.64,22.89,847300,1253505,46.66893702441795,45.42935454467105,NaN,NaN,-73.7173458887157,-175.95884212889882,-0.03755717139137703,-0.1147582626989525,-0.07720109130757548,-7324095,-7923175,28.536872536811543,47.69634560243893,NaN,NaN,-14.487342394801267,-8.056425776199777
2005-09-28T09:30:00-04:00,22.85001,23.10001,22.85001,22.92,1363600,1285195,47.650894413025036,44.97120726845841,NaN,NaN,-27.785203102926864,-120.13678185092442,-0.020483130034864322,-0.10280500385115587,-0.08232187381629155,-5960495,-7320815,34.03335585195808,46.97276513547326,NaN,NaN,-12.979810759799685,-8.75976648814262
2005-09-29T09:30:00-04:00,22.8,23.129,22.8,23.12,2294300,1380350,53.76305750943654,44.70858154237029,NaN,NaN,-7.553331551422064,-76.07279798780372,0.004806353404698108,-0.07631393206041892,-0.08112028546511703,-3666195,-6442095,41.14493151297681,45.969777494029024,NaN,NaN,-9.635246693719338,-8.884835088939294
2005-09-30T09:30:00-04:00,23.08,23.28,23.02,23.28,830200,1400785,57.98899801558862,44.63213085774578,NaN,NaN,50.57586856670606,-36.83739677742347,0.031355739067221805,-0.041925611631089765,-0.07328135069831157,-2835995,-5591635,47.090128077716415,44.83406801906276,NaN,NaN,-5.400431107731886,-8.38706309162395
2005-10-03T09:30:00-04:00,23.2,23.35001,23.2,23.25,977200,1405980,56.938188796266836,45.12505501801163,NaN,NaN,70.2902038335159,2.362038371431467,0.04510622217022349,-0.016898572985532212,-0.0620047951557557,-3813195,-4719995,52.39750584068966,43.796232185196736,NaN,NaN,-2.380568960573894,-7.528992501473943
2005-10-04T09:30:00-04:00,23.31,23.34,23.14999,23.14999,702400,1409285,53.460293791900185,45.73004656688255,NaN,NaN,54.35809721330794,27.977126991836194,0.04554309721075166,-0.005075923642316127,-0.050619020853067784,-4515595,-4158295,55.495623895112736,43.178131702546786,NaN,NaN,-0.9247826098878941,-6.585533945533079
2005-10-05T09:30:00-04:00,23.2,23.2,22.96001,22.99001,1138700,1314315,48.370498343878225,45.731061305237134,NaN,NaN,4.776331926866142,34.4894339977948,0.03368141170354154,-0.008517256223640857,-0.042198667927182396,-5654295,-4097055,55.83312898643989,42.49467885153884,NaN,NaN,-1.2685524173065175,-5.825965155786427
2005-10-06T09:30:00-04:00,22.95,23.13,22.72,22.86,1163100,1302025,44.65011794556517,45.58829991252295,NaN,NaN,-40.65437624918065,27.86922505824308,0.016568884496804145,-0.02148756230617721,-0.038056446802981356,-6817395,-4727295,51.50424357856044,41.92453941988776,NaN,NaN,-2.736380908462975,-5.384595977597363
2005-10-07T09:30:00-04:00,22.86,22.92999,22.77,22.84,1034200,1232155,44.08833518704438,45.726055934696284,NaN,NaN,-53.13048371563804,7.127954601774258,0.004045115749072167,-0.03300005211664114,-0.03704516786571331,-7851595,-5730415,45.462417030912185,41.6163422052101,NaN,NaN,-4.079872351244792,-5.198206888118424
2005-10-10T09:30:00-04:00,22.95,22.97,22.74001,22.75999,769900,1229295,41.82137911769939,45.984662202246525,NaN,NaN,-53.831733898225025,-17.696432944573928,-0.008784909086011802,-0.04802630422322807,-0.039241395137216264,-8621495,-6692075,40.5512688927661,41.457205970547875,NaN,NaN,-5.881690584764162,-5.295847416210672
2005-10-11T09:30:00-04:00,22.75,22.89999,22.75,22.75999,755700,1198030,41.82137911769939,46.7022949188714,NaN,NaN,-54.64115429373223,-39.496283245981964,-0.016008244334149144,-0.0592517005549027,-0.043243456220753554,-8621495,-7513255,36.88686179157107,41.44166859434462,NaN,NaN,-7.342609068481243,-5.588241937963611
2005-10-12T09:30:00-04:00,22.75999,22.83,22.60001,22.67999,1411400,1178875,39.46806284067381,46.7689239870169,NaN,NaN,-83.16387649761478,-57.08432493087814,-0.024407683077555822,-0.07375306006769833,-0.049345376990142506,-10032895,-8388975,33.41869234279942,41.513908328399296,NaN,NaN,-9.26367251466273,-6.113303448920628
2005-10-13T09:30:00-04:00,22.67999,22.69,22.52,22.62,1125500,1185635,37.7525204331619,46.60547414081684,NaN,NaN,-105.956445970918,-70.14473887522561,-0.03177134674864731,-0.08905956042595164,-0.057288213677304335,-11158395,-9257175,30.37000645523115,41.52923986976133,NaN,NaN,-11.381853657788508,-6.865953478758897
2005-10-14T09:30:00-04:00,22.64999,22.8,22.55,22.75,818700,1152605,43.48531203858091,46.99485532678133,NaN,NaN,-66.71579158326492,-72.861800448751,-0.02590265997855476,-0.08966653865049778,-0.06376387867194303,-10339695,-9754795,28.75103412205989,41.53400506540031,NaN,NaN,-11.64980565846685,-7.54936093300289
2005-10-17T09:30:00-04:00,22.64999,23.02,22.60001,23,2232100,1163340,52.537898597924205,47.41406686774606,NaN,NaN,-0.6927803009715924,-62.234009729300304,-0.0043306815034092755,-0.06917723055120462,-0.06484654904779534,-8107595,-9652015,29.58596257145885,41.60894006787511,NaN,NaN,-9.054841148822932,-7.764429535262896
2005-10-18T09:30:00-04:00,22.95,22.96001,22.83,22.83,1156000,1171785,47.022116268260326,47.36915414312001,NaN,NaN,4.960461319135601,-50.31368660672674,-0.0008405710727924787,-0.06589726288878595,-0.06505669181599347,-9263595,-9780435,29.126689943804735,41.25846393157844,NaN,NaN,-8.569645907405354,-7.879460445568961
2005-10-19T09:30:00-04:00,22.72,23.08,22.71001,23.07001,1571900,1157965,54.31462147347878,47.40855156912302,NaN,NaN,32.002832506617956,-27.28034480588019,0.017301013588994142,-0.04343042482975079,-0.06073143841874493,-7691695,-9312195,33.19853615947247,40.69086426347099,NaN,NaN,-5.649037347755043,-7.560828574452687
2005-10-20T09:30:00-04:00,23.19,23.2,22.81,22.89,913300,1158005,48.880044854350686,46.75791205760603,NaN,NaN,31.40034512696215,0.19101341369583907,0.01683071894083204,-0.03969303974270488,-0.05652375868353692,-8604995,-8801515,37.42133111285194,40.00023590883781,NaN,NaN,-5.0573172611396195,-7.203184101122249
2005-10-21T09:30:00-04:00,22.95,22.99001,22.77,22.87,643600,1141610,48.30177560039737,46.1410254007582,NaN,NaN,-15.43546859300987,10.447078011746848,0.014892616310292213,-0.03790798829567166,-0.05280060460596387,-9248595,-8583295,39.19028838655676,39.05686323354259,NaN,NaN,-4.783137638787486,-6.857463177931568
2005-10-24T09:30:00-04:00,22.85001,23.09,22.85001,23.07001,858000,1130355,54.14427251165161,46.18988102359759,NaN,NaN,40.84321659404526,18.75427739075022,0.026142699546506484,-0.02012223017283077,-0.04626492971933725,-8390595,-8639895,38.88327281860074,37.87026672807745,NaN,NaN,-2.6105921011829047,-6.250767309824616
2005-10-25T09:30:00-04:00,22.95,23.03999,22.85201,22.99001,225400,1099260,51.630907399294955,46.42276738469878,NaN,NaN,16.0940197132507,20.980989069573248,0.02713996568728473,-0.012339972610231342,-0.03947993829751607,-8615995,-8510375,40.04083048465203,36.74224540652118,NaN,NaN,-1.6520924355493172,-5.593813756356717
2005-10-26T09:30:00-04:00,23.10001,23.12,22.89,22.92,1013300,1081745,49.46683418057093,46.76681854434205,NaN,NaN,23.698996442926518,19.320221856834962,0.022234367353600168,-0.01168697910551586,-0.03392134645911603,-9629295,-8897895,37.73779296878341,35.75892750582282,NaN,NaN,-1.5388223020497214,-5.014529262884289
2005-10-27T09:30:00-04:00,22.87,22.87,22.67999,22.7,1063600,1020210,43.32190322913549,46.71207340449142,NaN,NaN,-84.03969651227806,-3.7677864710130904,0.004263439478821671,-0.028592047110588936,-0.03285548658941061,-10692895,-9315475,35.37653477379379,35.03850734460008,NaN,NaN,-3.43689731376923,-4.789153270153566
2005-10-28T09:30:00-04:00,22.8,23.11,22.8,23.08,635600,1010480,53.96039532653961,47.57914599083714,NaN,NaN,48.7244226846733,9.064191784523544,0.017326362949545517,-0.011197532902478713,-0.02852389585202423,-10057295,-9477215,34.47671548677387,34.60461067274348,NaN,NaN,-1.384102040093993,-4.302717380145055
2005-10-31T09:30:00-05:00,23.2,23.28,23.09,23.17,1661000,1044670,56.06383730488939,48.596464432779285,NaN,NaN,157.4499269536024,32.385533856434975,0.030609310391184003,0.009737742136955774,-0.02087156825422823,-8396295,-9478355,34.470060393485156,34.43198200145164,NaN,NaN,0.9496403617859117,-3.552380559869203
2005-11-01T09:30:00-05:00,23.33,23.33,23.03,23.03999,603800,1039740,52.34351339624591,49.51613947246301,NaN,NaN,137.88383610102127,56.74349713398908,0.02922356151475969,0.01565788363922138,-0.013565677875538307,-9000095,-9555175,33.993867429726265,34.473065936232125,NaN,NaN,1.6043394221007357,-2.8157062767306402
2005-11-02T09:30:00-05:00,23.03,23.13,22.96001,23.10001,1015300,1033570,53.865557124692096,50.66707066471516,NaN,NaN,95.70891398946293,71.14548064329635,0.03077706545925425,0.024905653948529505,-0.005871411510724744,-7984795,-9226275,37.946457396147004,35.014241003440404,NaN,NaN,2.611117205014658,-2.0404457793384547
2005-11-03T09:30:00-05:00,23.27,23.36,23.13,23.19,680100,1009420,56.12798941400359,51.57011904867393,NaN,NaN,159.25645373599255,119.8047106929505,0.03593386711216603,0.03904592237948279,0.003112055267316763,-7304695,-8548635,45.224338423815176,36.19090559642292,NaN,NaN,4.141827653306703,-1.1572638603891465
2005-11-04T09:30:00-05:00,23.23,23.25,23.09,23.17999,374100,976415,55.80018825620129,51.803139738550854,NaN,NaN,116.57814097869618,133.37545435175508,0.036615150963793724,0.04888099397205892,0.012265843008265194,-7678795,-8072935,49.685522465599924,37.626588446004426,NaN,NaN,5.270892224402101,-0.23895584827611127
2005-11-07T09:30:00-05:00,23.28999,23.28999,23.10001,23.23,1065100,991175,57.14673782769125,52.52632699279593,NaN,NaN,119.58906164309666,125.80328128965391,0.0382024357843022,0.060018887738642945,0.021816451954340746,-6613695,-7716415,52.78894992405594,39.31674987316522,NaN,NaN,6.593478077307297,0.737106141092947
2005-11-08T09:30:00-05:00,23.06,23.21001,23.06,23.16,660900,986435,54.63762821703213,52.54939890304974,NaN,NaN,82.18260973814954,114.66303601707958,0.032528547453323974,0.062477136270995715,0.02994858881767174,-7274595,-7371315,55.64111709381095,40.91979136847512,NaN,NaN,7.015042859179537,1.6339542436767456
2005-11-09T09:30:00-05:00,23.12,23.31,23.10001,23.2,695500,950640,55.83104448578701,53.04589887672376,NaN,NaN,100.28780308453193,115.57881383609337,0.02954673494571078,0.06688200749981021,0.037335272554099436,-6579095,-7090175,57.87389236741628,42.380688600944,NaN,NaN,7.6942549055035165,2.49971148108057
2005-11-10T09:30:00-05:00,23.2,23.53,23.2,23.47,1720200,980375,62.92194785780633,54.09019689511012,NaN,NaN,170.7577380393545,117.87907069676575,0.04301929464129406,0.09110939085571701,0.04809009621442295,-4858895,-6601015,61.504561427998496,43.974565246761266,NaN,NaN,10.48534714521519,3.6405165759569442
2005-11-11T09:30:00-05:00,23.49001,23.52,23.41319,23.5,355200,957200,63.62079124618648,54.76709109043404,NaN,NaN,180.70821441861128,130.70508538474877,0.05068459322745609,0.11144583774874306,0.06076124452128697,-4503695,-5965995,65.64415000446806,45.88605647432322,NaN,NaN,12.967902168484072,4.973000232032248
2005-11-14T09:30:00-05:00,23.5,23.52,23.39,23.41,988100,895000,59.969081226491845,55.36267493523382,NaN,NaN,143.1847276029847,135.4242185767264,0.0465345453388587,0.11892942619486035,0.07239488085600165,-5491795,-5741615,66.994707021178,47.81133336978936,NaN,NaN,14.041201554888797,6.268457563868898
2005-11-15T09:30:00-05:00,23.32001,23.42,23.25,23.28999,690800,871740,55.40254854929331,55.786654532999705,NaN,NaN,84.5835227965524,135.90440118840698,0.03317518981616621,0.11386386812620941,0.0806886783100432,-6182595,-5523215,68.30091440377757,49.99441347228895,NaN,NaN,13.638390423049326,7.321305115180388
2005-11-16T09:30:00-05:00,23.28999,23.36,23.24001,23.35001,1767000,881495,57.1595667780323,56.775059072206616,NaN,NaN,76.18314514270354,131.08346960004127,0.026157419222997122,0.1133854523387896,0.08722803311579248,-4415595,-5090515,70.76916215547075,52.52245828526587,NaN,NaN,13.799627274594165,8.246779709382356
2005-11-17T09:30:00-05:00,23.39,23.39,23.27,23.34,536400,862650,56.75794646559508,56.97488415356772,NaN,NaN,76.03489106768399,112.13890020570719,0.01895354529088701,0.11091996472940124,0.09196641943851423,-4951995,-5109135,70.51471404543675,55.096601039456075,NaN,NaN,13.822271161516989,9.043278488258732
2005-11-18T09:30:00-05:00,23.49001,23.49001,23.25,23.39999,602500,860595,58.63381202578108,57.15845377648856,NaN,NaN,89.26780661210617,93.85081864440617,0.01643470187031762,0.11250979677641126,0.09607509490609364,-4349495,-5078295,70.70260400490831,57.68463986884344,NaN,NaN,14.347487822522668,9.801022678867866
2005-11-21T09:30:00-05:00,23.37,23.49001,23.35001,23.42999,780200,856705,59.57817381511051,57.675215234978886,NaN,NaN,98.77845832026325,84.96956478786187,0.015033036996701485,0.1148663911519705,0.09983335415526902,-3569295,-4693795,73.01169230020831,60.47162735959216,NaN,NaN,15.04159367198232,10.549675677884217
2005-11-22T09:30:00-05:00,23.42999,23.60001,23.42999,23.59,1184800,904675,64.26422152947868,58.417976978177926,NaN,NaN,133.84206621887716,94.82127347232682,0.022667746722538545,0.1281680375584422,0.10550029083590365,-2384495,-3934175,76.88735442048699,63.25312000418787,NaN,NaN,17.002307354184747,11.471480203070007
2005-11-23T09:30:00-05:00,23.60001,23.7,23.55,23.67999,1633000,935660,66.6087487506255,59.16660264507949,NaN,NaN,156.6846898685426,110.92158241749465,0.031045879683547883,0.1443076404403385,0.11326176075679062,-751495,-3201355,79.88797847572724,65.72909429361016,NaN,NaN,19.374833450287944,12.600530666958283
2005-11-25T09:30:00-05:00,23.75,23.78,23.69,23.7,92000,887080,67.12522732607387,59.975534007213255,NaN,NaN,178.63946542387885,131.44249728873362,0.03491406039814385,0.15690433625447042,0.12199027585632657,-659495,-2342855,82.7185255943007,68.0885945170888,NaN,NaN,21.489498415482398,13.870383202461728
2005-11-28T09:30:00-05:00,23.64,23.72,23.57001,23.59,504900,880545,61.49424254244938,60.286070058267406,NaN,NaN,121.95189394647306,137.979314755607,0.02737620331308782,0.15621052999768636,0.12883432668459854,-1164395,-1705835,84.46558263388116,70.35121113921916,NaN,NaN,21.78881619296581,15.001587915390882
2005-11-29T09:30:00-05:00,23.67999,23.73,23.56,23.57001,888400,841915,60.50097611125255,60.704880622140294,NaN,NaN,105.79220374828056,139.38206384121048,0.01876624164624041,0.15229212874239906,0.13352588709615865,-2052795,-1402535,85.23113924921293,72.4647841503193,NaN,NaN,21.76735955773536,15.968126721440093
2005-11-30T09:30:00-05:00,23.60001,23.7,23.38,23.38,1107900,867120,51.916987489923066,60.425305122435724,NaN,NaN,43.91343595958578,121.3963377893522,-0.0009573972475065418,0.13232914053677547,0.133286537784282,-3160695,-1557775,82.97712511304763,74.25787220357869,NaN,NaN,19.18935370752325,16.42830200516626
2005-12-01T09:30:00-05:00,23.60001,23.60001,23.42,23.53999,805000,856605,57.39796656926592,60.030735030397125,NaN,NaN,52.31836762899203,100.52307334144207,-0.004274563538617576,0.12794333336101005,0.13221789689962762,-2355695,-1878615,78.36450896054886,75.46215417018944,NaN,NaN,18.56532415995768,16.733590884422178
2005-12-02T09:30:00-05:00,23.38,23.56,23.38,23.53,495900,847395,56.96134613985971,59.55506037994521,NaN,NaN,33.293224226563794,71.45382510197906,-0.007972563211019967,0.12225219288585265,0.13022475609687262,-2851595,-2317035,72.43871934216386,75.94748055145341,NaN,NaN,17.935050807282128,16.905228016259315
2005-12-05T09:30:00-05:00,23.42999,23.5,23.39,23.44,1266300,892005,53.04640525329623,59.060583524716954,NaN,NaN,3.565346338049335,47.77651558029433,-0.016803286813172003,0.10922064758040761,0.12602393439357962,-4117895,-2907735,65.27653935320043,75.82475428945502,NaN,NaN,16.232474899863377,16.809120428202753
2005-12-06T09:30:00-05:00,23.42,23.56,23.39999,23.42,1036600,890580,52.18800890383131,58.8309735500411,NaN,NaN,6.374237326066916,27.892922295851598,-0.023882646656963574,0.09617062607237514,0.12005327272933872,-5154495,-3528075,58.711393843316955,75.1397885351364,NaN,NaN,14.586856466647516,16.491654147980576
2005-12-07T09:30:00-05:00,23.5,23.5,23.28999,23.36,1170900,916080,49.5951604104922,58.29065880950252,NaN,NaN,-53.55471303348843,8.399292497236729,-0.031991447055482486,0.0800639639099856,0.11205541096546809,-6325395,-4161015,52.868819010290586,73.86119259619497,NaN,NaN,12.442813682191849,15.913248367153615
2005-12-08T09:30:00-05:00,23.39999,23.46001,23.25,23.32001,660800,914345,47.88745480106018,57.657052262035734,NaN,NaN,-91.6560496577168,-20.39559096010504,-0.03897049770204182,0.06334228883791582,0.10231278653995764,-6986195,-5087115,45.7024181515588,72.08888574663224,NaN,NaN,10.15006398315796,15.089936312297093
2005-12-09T09:30:00-05:00,23.45,23.45,23.33,23.36,1264400,891555,49.75077609701965,57.02254969569564,NaN,NaN,-63.461908080613945,-39.74661742154059,-0.03968263132441591,0.05270949738443775,0.09239212870885366,-5721795,-5661155,41.91022511448929,70.03228725445946,NaN,NaN,8.6936175856054,14.17617649419828
2005-12-12T09:30:00-05:00,23.39,23.52,23.37,23.41,924800,920035,52.05888794413898,56.4854578477691,NaN,NaN,-23.005408343216107,-45.06076835779368,-0.03570019198658518,0.04776688872562218,0.08346708071220736,-4796995,-5796975,41.0424820962605,67.74877223989175,NaN,NaN,8.054311180605243,13.301624306542132
2005-12-13T09:30:00-05:00,23.39999,23.77,23.39999,23.7,1960100,968635,62.7470080825812,56.37708545870499,NaN,NaN,98.9397453186088,-26.5476667592853,-0.013586444041865806,0.0664840256598751,0.0800704697017409,-2836895,-5333455,45.21164469510645,65.48622154522172,NaN,NaN,10.827777402025665,12.948217605896923
2005-12-14T09:30:00-05:00,23.69,23.96001,23.64999,23.89999,1651900,1016690,68.03888893194815,56.47923832879947,NaN,NaN,198.30863882335447,23.825003612083282,0.01301915600133495,0.0963444147034096,0.08332525870207465,-1184995,-4305375,53.128638834505324,63.5748401422773,NaN,NaN,15.125971226227,13.259325265944078
2005-12-15T09:30:00-05:00,23.8,24.03,23.8,23.94,1622300,1009455,68.98801397570949,56.61229451805915,NaN,NaN,202.71950452461382,82.7001144485494,0.030806229252710163,0.12183304526796235,0.09102681601525218,437305,-2820675,61.729350267914825,62.07561333324974,NaN,NaN,18.843483883773747,14.057062211348317
2005-12-16T09:30:00-05:00,23.82001,23.98,23.78999,23.8,1228600,1044065,62.04493556229419,56.651629733762356,NaN,NaN,142.91292181603177,123.97508042787857,0.030575561690897424,0.12924626812887396,0.09867070643797654,-791295,-1834575,66.16954107870733,60.76875322216589,NaN,NaN,19.752095365887882,14.87063837628254
2005-12-19T09:30:00-05:00,23.71001,23.88,23.71001,23.75999,749700,1051425,60.180866231689485,56.62876474236499,NaN,NaN,95.2824929297213,147.63266068246602,0.025375255539010988,0.13038977586174028,0.10501452032272929,-1540995,-1183375,68.74817284467889,59.59139847898489,NaN,NaN,19.89373422967171,15.58822349819528
2005-12-20T09:30:00-05:00,23.67999,23.75,23.58,23.62,873200,1056075,54.06086057500058,56.78189853415625,NaN,NaN,29.29555652151181,133.70382292304663,0.010894359469591747,0.11863246965971896,0.10773811019012722,-2414195,-1098835,69.07769591151029,58.59858210744651,NaN,NaN,18.038240535425142,15.93822593208526
2005-12-21T09:30:00-05:00,23.8,23.8,23.63,23.69,1353700,1064520,56.445965502243574,56.71389845794037,NaN,NaN,51.28231426747906,104.29855801187155,0.004731922711411166,0.11365301357939117,0.10892109086798,-1060495,-1073935,69.18077105859372,57.94260082873543,NaN,NaN,17.257269550466013,16.12666073471108
2005-12-22T09:30:00-05:00,23.66,23.72,23.59,23.71001,1340600,1049900,57.131138619087864,56.726026492170945,NaN,NaN,34.716545433552604,70.69796619365931,0.0009053501887140158,0.11005277860387253,0.10914742841515851,280105,-1105375,68.86861530715721,57.68759339766353,NaN,NaN,16.832463313748715,16.2274896745736
2005-12-23T09:30:00-05:00,23.71001,23.71001,23.64999,23.67,318000,1061200,55.25923727398487,56.88408592222014,NaN,NaN,37.88322593243227,49.692027016939406,-0.0050889522881923666,0.10278623805491804,0.10787519034311041,-37895,-954695,69.57712206261735,57.994777876907584,NaN,NaN,15.935966986094705,16.185843576219472
2005-12-27T09:30:00-05:00,23.7,23.71001,23.46001,23.50999,852900,1078600,48.425649345455454,56.61534595376471,NaN,NaN,-15.203154471318186,27.594897536731516,-0.01977423556999891,0.08315739588061177,0.10293163145061068,-890795,-824655,70.20729752629087,58.815913854262874,NaN,NaN,13.015361904018446,15.732917623047896
2005-12-28T09:30:00-05:00,23.59,23.60001,23.50999,23.53999,754400,1071900,49.68204294054148,56.62155184876824,NaN,NaN,-18.195987906664,18.096588651096354,-0.02696596664735429,0.06922417314141782,0.09619013978877211,-136395,-369095,72.36676299309552,60.20862413874894,NaN,NaN,10.99682181721558,15.056332507928994
2005-12-29T09:30:00-05:00,23.46001,23.57001,23.42999,23.48,735100,1053260,47.20560307858323,56.572848154305596,NaN,NaN,-44.88074497931958,-1.1360231982633722,-0.03476537262465165,0.05273342400795755,0.0874987966326092,-871495,-331295,72.5445889738328,62.12592205462566,NaN,NaN,8.565116644307745,14.129015955983101
2005-12-30T09:30:00-05:00,23.38,23.46001,23.28999,23.28999,277900,1026905,40.345836421518435,55.90106674891266,NaN,NaN,-103.72480959173866,-28.824294203321625,-0.050755135040421645,0.024054877832082155,0.0748100128725038,-1149395,-617195,68.9314244082251,64.05600771846393,NaN,NaN,4.143761324329306,12.702551008603988
2006-01-03T09:30:00-05:00,23.31,23.47,23.17999,23.44,1372800,1070750,46.905663980765134,55.53297932295738,NaN,NaN,-90.11435267180072,-54.423809924168225,-0.049225281159845855,0.013278411422696479,0.06250369258254233,223405,-564935,69.2330767626837,66.06962162320845,NaN,NaN,2.408913777598308,11.232031404174606
2006-01-04T09:30:00-05:00,23.45,23.53,23.45,23.52,1124300,1063650,50.05963592445246,54.62673845451962,NaN,NaN,-33.50310800091602,-58.083800630087794,-0.04115034893533535,0.011065756413373151,0.0522161053487085,1347705,-117235,71.762459852058,67.96610842013357,NaN,NaN,1.9839288144815268,9.910873891361309
2006-01-05T09:30:00-05:00,23.53999,23.57001,23.37,23.39999,1806300,1102135,45.67622700965803,53.02940546007032,NaN,NaN,-56.150077120158166,-65.67461847278662,-0.042066770665570304,-0.0003673579832543794,0.041699412682315924,-458595,-181675,70.85947268244469,69.23259655212924,NaN,NaN,0.21434451404307658,8.525655408887276
2006-01-06T09:30:00-05:00,23.49001,23.50999,23.35001,23.5,1131600,1100170,49.63418213002902,51.64698889966457,NaN,NaN,-55.9234617714684,-67.88316183121638,-0.03443371744901614,-0.0013427341289542483,0.03309098332006189,673005,127225,72.63691832965222,70.01170855653905,NaN,NaN,0.00010494658852966806,7.307719628558885
2006-01-09T09:30:00-05:00,23.47,23.63,23.45,23.61,1714100,1152835,53.63547801560235,51.04631336061515,NaN,NaN,-13.07158661544538,-49.75251723595773,-0.0211261363604681,0.006683312869476765,0.027809449229944865,2387105,834525,76.21444332030758,70.7292015737962,NaN,NaN,1.1067170997527176,6.421862124443718
2006-01-10T09:30:00-05:00,23.55,23.58,23.47,23.55,1144600,1146845,51.24408072892344,50.40797153898901,NaN,NaN,-32.45538952909072,-38.22072460741574,-0.01576032863688653,0.008109038433836702,0.023869367070723232,1242505,1038345,77.14188355516839,71.32875233883117,NaN,NaN,1.2729803566858229,5.686307586192591
2006-01-11T09:30:00-05:00,23.5,23.59,23.49001,23.57001,722700,1136740,52.01251737204602,50.26166131020654,NaN,NaN,-28.172756856749142,-37.154654378582364,-0.010511582849195865,0.010729888509228402,0.021241471358424267,1965205,1161845,77.70904427579046,71.94527722199403,NaN,NaN,1.6351738823676119,5.1075741999318796
2006-01-12T09:30:00-05:00,23.48,23.58,23.45,23.50999,1491000,1113285,49.49277517447173,49.76500485822284,NaN,NaN,-43.443057864974016,-34.61325052754553,-0.010694726754120261,0.007873062915773943,0.018567789669894204,474205,1348405,78.57390273150884,72.61621519863083,NaN,NaN,1.2096352625520583,4.550725780306191
2006-01-13T09:30:00-05:00,23.5,23.60001,23.44,23.48,1385600,1099970,48.2353593782424,49.12959205530531,NaN,NaN,-42.392732354998124,-31.90710464425148,-0.012332053289025651,0.003152723058612139,0.01548477634763779,-911395,1031525,73.36701542113038,72.93752949248605,NaN,NaN,0.5021029552403586,3.972351091011072
2006-01-17T09:30:00-05:00,23.3,23.42999,23.3,23.39,788800,1058295,44.575346914483156,48.36645702962661,NaN,NaN,-117.58511989482211,-52.80981130012683,-0.018596592723423736,-0.0077609645566418806,0.010835628166781856,-1700195,214065,61.960097621668695,72.39345631813258,NaN,NaN,-1.1667958414624422,3.2381872435148558
2006-01-18T09:30:00-05:00,23.36,23.5,23.35001,23.49001,1169200,1055325,49.18915050619929,48.4209928268226,NaN,NaN,-64.85236776824273,-59.289206947957226,-0.015264602351886227,-0.00824512477307593,0.007019477578810298,-530995,-140635,57.763473059940985,71.5046117133933,NaN,NaN,-1.2820752802157158,2.5924354544104884
2006-01-19T09:30:00-05:00,23.38,23.53999,23.38,23.50999,1162400,1075960,50.083155577167304,48.449643729438726,NaN,NaN,-35.832353366803865,-60.82112624996817,-0.011164897973650343,-0.00693664488825263,0.004228253085397713,631405,-407395,54.759528399801184,70.24695209958657,NaN,NaN,-1.1248605844908979,2.061393163138862
2006-01-20T09:30:00-05:00,23.55,23.55,23.17,23.17,8322801,1448440.05,37.87199265432911,47.782957270563436,NaN,NaN,-166.8682935307008,-85.50617338311353,-0.02974591599059147,-0.03295414190284163,-0.003208225912250155,-7691396,-2040515.2,40.778191125107874,67.9779236818205,NaN,NaN,-5.089745143262604,1.039801976510081
2006-01-23T09:30:00-05:00,23.22,23.3,23.16,23.19,1426300,1452070.05,38.817020272475375,47.67375611706036,NaN,NaN,-198.80133739081856,-116.78789439027761,-0.03852720598085245,-0.051367233388315725,-0.012840027407463272,-6265096,-3111255.4,34.549686818082165,65.52208528252457,NaN,NaN,-7.897592644824399,-0.2369686836805589
2006-01-24T09:30:00-05:00,23.31,23.32001,23.19,23.27,1194900,1444785.05,42.57945570636112,47.36474124031722,NaN,NaN,-144.83954260420896,-122.23877893215499,-0.03678901543984264,-0.05882629670726658,-0.022037281267423933,-5070196,-3785255.6,31.30799538173413,62.81315089817103,NaN,NaN,-9.05862337365093,-1.4972050679620403
2006-01-25T09:30:00-05:00,23.31,23.32001,23.21001,23.28999,1130900,1485430.05,43.5141838740546,46.89720895100309,NaN,NaN,-117.58755945163378,-132.78581726883323,-0.03229438551627957,-0.062405263162773394,-0.030110877646493825,-3939296,-4466915.8,28.405190404179635,59.716203080465434,NaN,NaN,-9.715394977248529,-2.6712321978601103
2006-01-26T09:30:00-05:00,23.35001,23.47,23.28999,23.34,1229300,1504250.05,45.88744125067921,46.9122956825046,NaN,NaN,-43.58059093610798,-134.33546478269403,-0.024318277011570154,-0.06050872391095652,-0.036190446899386365,-2709996,-5135196,25.872530657400915,56.502850078676595,NaN,NaN,-9.57145127528412,-3.6569777803492545
2006-01-27T09:30:00-05:00,23.44,23.55,23.3101,23.53,1052000,1519130.05,53.825106250092226,47.21164740536626,NaN,NaN,31.186523646950462,-94.72450134716378,-0.0055889049371330365,-0.04317657807080266,-0.037587673133669626,-1657996,-3928516,36.82565665693865,53.944902816339905,NaN,NaN,-6.9193657800590875,-4.123033208879231
2006-01-30T09:30:00-05:00,23.39999,23.57001,23.39999,23.44,766200,1520685.05,50.07784542511743,46.95753079176019,NaN,NaN,37.48830044706733,-47.4665737795866,0.0010423721604365943,-0.03628470793312388,-0.03732708009356048,-2424196,-3160336,42.63663302088764,51.54648779495277,NaN,NaN,-5.855374305146148,-4.370510508345933
2006-01-31T09:30:00-05:00,23.38,23.42,23.25999,23.33,945800,1554080.05,45.87414402039255,46.57396388400799,NaN,NaN,-63.70548797013526,-31.23976285277185,-0.0015355538509262273,-0.039246522407218265,-0.03771096855629204,-3369996,-2820296,45.04629989237224,49.25394610475304,NaN,NaN,-6.27218504394287,-4.642178299145495
2006-02-01T09:30:00-05:00,23.25999,23.44,23.25999,23.39,1696000,1570240.05,48.41763791138785,46.31718677967526,NaN,NaN,-43.44252537303064,-16.410756037051215,0.0011020118691237174,-0.03633345371988739,-0.037435465589011105,-1673996,-2367236,48.17030287496351,47.14403600469397,NaN,NaN,-5.829936353299744,-4.811858021167531
2006-02-02T09:30:00-05:00,23.48,23.5,23.28999,23.38,2180800,1623065.05,48.01267499326616,46.21146533816058,NaN,NaN,-19.420698061150265,-11.57877746205968,0.002400533036943285,-0.034434799292832,-0.03683533232977528,-3854796,-2596196,46.724698069335446,44.86909281453874,NaN,NaN,-5.591625554544284,-4.923253383078496
2006-02-03T09:30:00-05:00,23.16,23.34,23.16,23.23,1563800,1610940.05,42.2978156996048,45.78735507540075,NaN,NaN,-115.97640997100423,-41.01136418565061,-0.006148247839136131,-0.04452064212869544,-0.03837239428955931,-5418596,-3348316,42.240251014100075,42.64575249975086,NaN,NaN,-7.128764158730728,-5.238326351028815
2006-02-06T09:30:00-05:00,23.14999,23.28,23.13,23.17999,1004800,1604600.05,40.56423827436457,45.50084731539228,NaN,NaN,-130.83222039299673,-74.67546835366343,-0.014025844337061763,-0.05590469971088652,-0.041878855373824755,-6423396,-4148156,38.057141559957984,40.93839849534295,NaN,NaN,-8.92110243956491,-5.764437220819685
2006-02-07T09:30:00-05:00,23.16,23.19,23.03,23.07001,1043600,1571075.05,36.975205359249706,44.628422662038744,NaN,NaN,-174.91534179727884,-96.91743911909214,-0.024864976406990272,-0.07296007588256259,-0.04809509947557232,-7466996,-4967556,34.30867059064157,39.26305546182157,NaN,NaN,-11.578990435638971,-6.595087680079583
2006-02-08T09:30:00-05:00,23.00999,23.23,23.00999,23.17,1782700,1602980.05,41.999694731459726,44.05103260163106,NaN,NaN,-130.62581626513497,-114.354097297513,-0.02353566920235891,-0.07751468597852096,-0.05397901677616205,-5684296,-5769616,31.081542986983067,37.57177078947742,NaN,NaN,-12.315017197560376,-7.412220468291125
2006-02-09T09:30:00-05:00,23.19,23.32001,23.12,23.24001,1260300,1629860.05,45.288565345388015,44.58078779384955,NaN,NaN,-67.46942346174248,-123.96384237763145,-0.016508715492883193,-0.07461491114226604,-0.058106195649382845,-4423996,-5883456,30.64100039670869,36.847685737448906,NaN,NaN,-11.930765355458044,-8.057726880743541
2006-02-10T09:30:00-05:00,23.17999,23.28999,23.12,23.21001,515700,1581095.05,44.1336964793491,44.96055038005482,NaN,NaN,-72.33178050870127,-115.23491648517086,-0.012623729717293891,-0.07388585779600021,-0.06126212807870632,-4939696,-5787676,31.52044980014611,36.631311664739194,NaN,NaN,-11.95145218106584,-8.613973352218155
2006-02-13T09:30:00-05:00,23.21001,23.28,23.0601,23.17999,724300,1548030.05,42.95333476773574,44.987256027295864,NaN,NaN,-86.54474057408764,-106.37742052138904,-0.010884230266355849,-0.07486741591165114,-0.06398318564529529,-5663996,-5635796,32.97181248581194,36.750155743601894,NaN,NaN,-12.301464817170075,-9.140757847211287
2006-02-14T09:30:00-05:00,23.17,23.47,23.17,23.47,793900,1548285.05,55.371201019495864,45.83418582339881,NaN,NaN,47.33355831933542,-61.9276404980662,0.009867706799662049,-0.05164855214571773,-0.06151625894537978,-4870096,-5116416,37.82472110053016,37.42297936476979,NaN,NaN,-8.528669395847187,-9.053316639873557
2006-02-15T09:30:00-05:00,23.37,23.62,23.37,23.62,1513200,1565485.05,60.197260292283154,46.85631575494195,NaN,NaN,150.18891606006824,-5.76469403302554,0.032490818987800076,-0.020902735210629686,-0.05339355419842976,-3356896,-4650936,41.885677295872156,38.56677555323203,NaN,NaN,-3.65024481415006,-8.281449236198773
2006-02-16T09:30:00-05:00,23.5,23.73,23.5,23.73,826200,1548675.05,63.3290043565906,47.53516561969184,NaN,NaN,201.0952829856192,47.9482472564468,0.052474046866573094,0.012199004384786605,-0.04027504248178649,-2530696,-4272276,45.03097449993551,39.15286968487465,NaN,NaN,1.4459913042515284,-6.891814873277301
2006-02-17T09:30:00-05:00,23.64999,23.75,23.62,23.63,703500,1167710,58.79961381958059,48.15814907643921,NaN,NaN,172.33655586684068,96.88191453155518,0.056233784208247165,0.03001718777852247,-0.0262165964297247,-3234196,-3931176,47.773114406273606,39.519761212402216,NaN,NaN,4.1552224558260535,-5.313666683405394
2006-02-21T09:30:00-05:00,23.63,23.69,23.5085,23.60001,1126200,1152705,57.472051380813106,48.986571030754966,NaN,NaN,121.15824649375082,138.4225119451229,0.053967566813120774,0.04124286208667627,-0.012724704726444505,-4360396,-3670456,49.83310895166729,39.86167614520901,NaN,NaN,5.89295241479379,-3.712721097948368
2006-02-22T09:30:00-05:00,23.61,23.81,23.61,23.78999,1692500,1177585,63.148217337560226,50.03875527548156,NaN,NaN,159.1466455500071,160.78512939125721,0.06195816510040101,0.06472300164905676,0.0027648365486557473,-2667896,-3230016,53.191950928002676,40.22036529185466,NaN,NaN,9.323625222262914,-1.8503859093467563
2006-02-23T09:30:00-05:00,23.83,23.88,23.71001,23.8,1307200,1186400,63.42521323094676,51.13965086388732,NaN,NaN,153.97671315800972,161.5426888108455,0.06433217623543996,0.08318005684295571,0.018847880607515737,-1360696,-2830776,56.06358425995605,40.88742859118471,NaN,NaN,12.101957993504426,0.14280607677484114
2006-02-24T09:30:00-05:00,23.7,23.77,23.64,23.67999,486200,1149245,57.814481476872764,52.24798413369217,NaN,NaN,100.00917785361536,141.32546778444475,0.05461717107598725,0.0871193444524998,0.03250217337651255,-1846896,-2694016,57.03593629116269,41.94426325383205,NaN,NaN,12.731817739211051,1.9412363142657283
2006-02-27T09:30:00-05:00,23.89999,23.89999,23.74001,23.85001,736500,1133470,62.83103344370991,53.83846950293112,NaN,NaN,127.44712588403638,132.34758178788388,0.05621883478629407,0.10277571685938014,0.04655688207308607,-1110396,-2269256,59.99708198654687,43.51140185573125,NaN,NaN,14.919434073955685,3.7952645656500077
2006-02-28T09:30:00-05:00,23.89999,23.89999,23.52,23.53,1044800,1147400,50.62770305395809,54.813647909696,NaN,NaN,63.22243411799772,120.76041931273326,0.033428901548590316,0.08834300900882397,0.05491410746023365,-2155196,-1828216,62.85942757746758,45.55074164050454,NaN,NaN,12.507926458160105,5.039930550294307
2006-03-01T09:30:00-05:00,23.64999,23.64999,23.53,23.62,454800,1122850,53.37070823870218,55.62586316021333,NaN,NaN,43.25063166572616,97.58121653587708,0.02263516295981069,0.08320806115999702,0.060572898200186326,-1700396,-1634716,64.0740095187499,47.90734639277366,NaN,NaN,11.558768979744498,5.971193183072906
2006-03-02T09:30:00-05:00,23.60001,23.62,23.44,23.49001,763500,1076225,49.125469416844666,55.899927736745944,NaN,NaN,15.629009492622346,69.91167580279959,0.005835394406442498,0.06786714120823945,0.06203174680179695,-2463896,-1855356,61.600298266577475,50.118724812050004,NaN,NaN,9.31487073939202,6.448861405404208
2006-03-03T09:30:00-05:00,23.46001,23.71001,23.45,23.55,1047000,1019535,51.060176241819995,56.39467629120815,NaN,NaN,29.398660084858538,55.78957224904823,-0.0017373860168791722,0.05986001428069798,0.061597400297577154,-1416896,-1769356,62.21266591986808,52.31102596345871,NaN,NaN,8.167075654979136,6.694320583914912
2006-03-06T09:30:00-05:00,23.52,23.5901,23.45,23.47,1464300,1014560,48.415947667664504,56.78486292691735,NaN,NaN,5.047796378959483,31.309706348032865,-0.012059766277199867,0.04652269245107732,0.058582458728277186,-2881196,-2123516,58.10333432009801,54.106134665907724,NaN,NaN,6.383699209152928,6.649946101806058
2006-03-07T09:30:00-05:00,23.45,23.64,23.45,23.63,2089000,1068770,53.59227404287873,56.657796714301845,NaN,NaN,24.101178846742663,23.48545529378186,-0.00822070025355625,0.04830658341133187,0.05652728366488812,-792196,-1850916,60.27819944000824,55.709954547299006,NaN,NaN,6.52800895059946,6.632526508776544
2006-03-08T09:30:00-05:00,23.53999,23.89999,23.5,23.89,2036100,1118395,60.52448877261024,56.681170177182345,NaN,NaN,89.97627054137808,32.83058306891225,0.010693738783879699,0.06989445714473774,0.059200718360858044,1243904,-1262056,64.55816217245649,57.32941775276932,NaN,NaN,9.060018322036582,6.979311053527978
2006-03-09T09:30:00-05:00,23.88,24.03,23.86,23.92999,2680800,1163300,61.47763043184356,56.54892918255756,NaN,NaN,154.87517819250257,60.67981680888829,0.024000706008545702,0.08920160087154017,0.06520089486299446,3924704,15664,71.68682345085519,59.23340696354929,NaN,NaN,11.350724795829796,7.6037987309996655
2006-03-10T09:30:00-05:00,23.98,24.49001,23.96001,24.14999,2637700,1232170,66.29859224207097,57.08457049844969,NaN,NaN,231.7908249393204,101.15824977978066,0.04452856052509077,0.12086159551935793,0.07633303499426716,6562404,1611524,77.71567957663594,61.372161618575184,NaN,NaN,14.989867086242514,8.658951353177216
2006-03-13T09:30:00-05:00,24.12,24.25,24.09,24.17,1294300,1271100,66.70671093817586,57.74418903826132,NaN,NaN,191.5393757311158,138.4565656502119,0.05564183906639346,0.145885333827259,0.09024349476086553,7856704,3759104,82.9707735656652,63.739137662432164,NaN,NaN,17.957965911753803,9.987382004402441
2006-03-14T09:30:00-05:00,23.67,24.16,23.67,24.11,1859000,1327835,64.19634187385057,57.81905507656777,NaN,NaN,104.38815677786008,154.5139612364354,0.055038797063628436,0.15904199109040107,0.10400319402677263,5997704,5117084,85.32705466377853,66.03450221498758,NaN,NaN,19.61264409892727,11.362419446477416
2006-03-15T09:30:00-05:00,24.09,24.17999,23.92,24.02,1268000,1351540,60.51738942575978,57.61135337619727,NaN,NaN,112.5571936365501,159.0301458554698,0.045083830318717835,0.16035798192516992,0.11527415160645209,4729704,5814244,86.36975521987195,68.19922871212444,NaN,NaN,19.88981188621609,12.580618366440083
2006-03-16T09:30:00-05:00,24.06,24.11,24,24.10001,1419900,1346875,62.57095727977225,57.95110164783296,NaN,NaN,107.96822710549309,149.6487556380679,0.04053599998570767,0.16594415158858666,0.125408151602879,6149604,6259224,87.00454023808635,70.33984327976185,NaN,NaN,20.73064703703517,13.744908176525096
2006-03-17T09:30:00-05:00,24.08,24.09,23.92,23.96001,983100,1354720,56.985766177511756,57.53358255739023,NaN,NaN,69.83802070863055,117.25819479192994,0.025482748822950096,0.1572615876315666,0.13177883880861652,5166504,5980044,84.35031238109563,72.07935973651533,NaN,NaN,19.76336742286617,14.604688068859534
2006-03-20T09:30:00-05:00,24.14,24.1499,23.96001,24.10001,1038100,1371450,60.758019416065736,58.25717658325506,NaN,NaN,86.93699759705878,96.33771916511854,0.022444885237946355,0.15983494535604947,0.13739006011810312,6204604,5649624,81.1932517058001,73.38891860282479,NaN,NaN,20.084437490009396,15.387509414738085
2006-03-21T09:30:00-05:00,24.05,24.17,23.92999,23.94,1600600,1395170,54.83860408828776,58.36202628679689,NaN,NaN,60.67811890603095,87.5957115907527,0.007900189883367548,0.14726529747231254,0.139365107588945,4604004,5370884,78.52324635486667,74.4210069482617,NaN,NaN,18.48811622086897,15.830453244185355
2006-03-22T09:30:00-05:00,24.00999,24.16,23.95,24.16,1350200,1378055,60.53210514874694,59.17678598193277,NaN,NaN,77.7150113783448,80.62727513911163,0.011139036561015253,0.15328890329021405,0.1421498667291988,5954204,5615784,79.1713254370762,75.67608031758304,NaN,NaN,18.950583728720634,16.276186170547536
2006-03-23T09:30:00-05:00,24.05,24.39999,23.98,23.98,2017400,1413565,54.480286076643516,59.421079541563024,NaN,NaN,78.80128242409239,74.7938862028315,-0.00019797647936481422,0.14190239612999278,0.1421003726093576,3936804,5173224,74.77983512873807,76.57373526107376,NaN,NaN,17.309286458362692,16.4237719259497
2006-03-24T09:30:00-05:00,24.05,24.07001,23.88,23.98,1189900,1448750,54.480286076643516,59.85424657077582,NaN,NaN,30.206382791888394,66.86755861948308,-0.008588920336954603,0.13136422218816435,0.13995314252511895,3936804,4927284,72.37720181032167,77.59329722466116,NaN,NaN,16.036101990490508,16.368390506598388
2006-03-27T09:30:00-05:00,23.97,24.03,23.89,23.89999,952800,1459565,51.81001700977998,59.72694249698304,NaN,NaN,16.6780486824293,52.815768836557176,-0.019779933358464008,0.11522822582703895,0.13500815918550296,2984004,4283164,66.36333895838102,78.02795004740207,NaN,NaN,14.165182646153227,16.053646526534795
2006-03-28T09:30:00-05:00,23.84,23.92,23.71001,23.71001,1222900,1468470,46.03973832887283,58.69231746528752,NaN,NaN,-39.214319500397,32.83728115527159,-0.03911227011153923,0.08611782154607894,0.12523009165761817,1761104,3714584,61.505167743104884,77.80987901673409,NaN,NaN,10.681927128772294,15.286258041140153
2006-03-29T09:30:00-05:00,23.82001,23.89,23.67,23.88,608200,1476140,51.269523892761796,57.96316699821025,NaN,NaN,-33.90753749378615,10.512771380845402,-0.03947240859851715,0.07588958090947173,0.11536198950798889,2369304,2997604,55.943624324038176,76.68536479339002,NaN,NaN,9.359134191979829,14.439526062688678
2006-03-30T09:30:00-05:00,23.81,23.88,23.60001,23.69,1429900,1509460,45.91324995077088,56.50707112026024,NaN,NaN,-76.24007713127132,-20.495500530227343,-0.05080601690435206,0.05185446837754881,0.10266048528190087,939404,2398124,51.731590082146035,74.82935840092647,NaN,NaN,6.454208109818948,13.298766355135859
2006-03-31T09:30:00-05:00,23.74001,23.78999,23.58,23.60001,535800,1483900,43.5904074746968,54.8559065871546,NaN,NaN,-107.88982712220763,-48.11474251304655,-0.06192525527798606,0.0252539161844183,0.08717917146240436,403604,1691484,47.21861684770732,72.27563292107233,NaN,NaN,3.343123118516125,11.876531607047326
2006-04-03T09:30:00-04:00,23.75,23.77,23.63,23.67999,1250100,1473190,46.19578037751176,53.570152194558965,NaN,NaN,-104.71419162285268,-72.39319057410295,-0.06133901337987753,0.010505404737557456,0.07184441811743499,1653704,1425424,45.60541254527939,69.43837276975097,NaN,NaN,1.5991621439676278,10.408335969464513
2006-04-04T09:30:00-04:00,23.61,23.74001,23.60001,23.66,1517500,1444615,45.628536849226315,52.506662724806574,NaN,NaN,-123.53433151005925,-89.2571929760354,-0.05968678282204861,-0.0027640604101257793,0.05692272241192283,136204,1100444,43.64402835443956,66.3865351365058,NaN,NaN,0.02875030179748261,8.925538016940651
2006-04-05T09:30:00-04:00,23.64,23.75999,23.62,23.71001,1118600,1398740,47.36967036547969,51.420856516642814,NaN,NaN,-105.03657376786617,-103.48300023085139,-0.05284974916127997,-0.009139464039677136,0.04371028512160283,1254804,877544,42.30025092304009,63.193371614002494,NaN,NaN,-0.7814757720985341,7.538821761363625
2006-04-06T09:30:00-04:00,23.61,23.74001,23.60001,23.62,1286900,1329045,44.6012821639605,50.53625051567487,NaN,NaN,-106.34016481215144,-109.50301776702743,-0.05193668398308174,-0.02121056985724934,0.0307261141258324,-32096,683244,41.111972414650246,60.1049187592564,NaN,NaN,-2.2661296023069406,6.138114423696401
2006-04-07T09:30:00-04:00,23.61,23.75,23.41,23.41,2276400,1310980,38.89064016001348,48.97429485452829,NaN,NaN,-137.669047547805,-115.4588618521469,-0.062323619141800554,-0.0471784098014183,0.015145209340382259,-2308496,140824,37.91027822614678,57.01327779642401,NaN,NaN,-5.362226994331548,4.495208506835265
2006-04-10T09:30:00-04:00,23.47,23.55,23.39,23.44,895900,1291060,40.07112485614572,47.919474909375275,NaN,NaN,-142.71874343559148,-123.05977221469466,-0.06379038783865981,-0.06459277545794251,-0.0008023876192826945,-1412596,-472436,34.62691477064928,53.87782554040849,NaN,NaN,-7.543561047162137,2.7753842848356367
2006-04-11T09:30:00-04:00,23.48,23.5,23.19,23.22,944300,1245325,34.76708248845706,46.07911614792601,NaN,NaN,-171.59701957415098,-132.672309827513,-0.07539830332782312,-0.09505026677906159,-0.01965196345123847,-2356896,-971056,32.18607251680238,50.521736046103214,NaN,NaN,-11.18429336995342,0.7811446198657717
2006-04-12T09:30:00-04:00,23.22,23.36,23.2,23.3,1419300,1252890,37.981826611163534,44.900654757534575,NaN,NaN,-155.4508633666423,-142.75516774726822,-0.07343683991853706,-0.11144801334940979,-0.038011173430872736,-937596,-1409536,30.171914404363292,47.335455994362164,NaN,NaN,-13.23149121029727,-1.2206604987289487
2006-04-13T09:30:00-04:00,23.2,23.37,23.2,23.25999,706400,1217215,36.99975819965868,43.65204562346423,NaN,NaN,-141.75850612876192,-149.83883601059034,-0.07056455627317289,-0.12621686877233884,-0.055652312499165954,-1643996,-1731916,28.747524107434728,44.21905044415595,NaN,NaN,-15.196829830375751,-3.2172561175356345
2006-04-17T09:30:00-04:00,23.33,23.33,23.08,23.13,552700,1195695,33.930183676877206,42.374914671114034,NaN,NaN,-152.15011251610204,-152.73504900424973,-0.07285344049709327,-0.14671911312053254,-0.07386567262343927,-2196696,-1709556,28.99789610188384,41.55009024012044,NaN,NaN,-17.82233118499568,-5.30369541288707
2006-04-18T09:30:00-04:00,23.13,23.38,23.13,23.35001,1128600,1200220,42.6086485157851,42.129836827322045,NaN,NaN,-107.9838969676547,-145.78807971066237,-0.05575502759601389,-0.14355945711845663,-0.08780442952244275,-1068096,-1640656,29.81627478987285,39.286597886318155,NaN,NaN,-17.449800253692104,-7.038853247287789
2006-04-19T09:30:00-04:00,23.28999,23.41,23.28,23.38,1313400,1185860,43.69435020050316,41.588752992160714,NaN,NaN,-76.86783467097648,-126.84224273002746,-0.03940091500206504,-0.13705557327502405,-0.09765465827295901,245304,-1120216,35.832629911681494,37.850098285435536,NaN,NaN,-16.821174738329017,-8.436327746007965
2006-04-20T09:30:00-04:00,23.3,23.53999,23.28,23.42,845000,1160600,45.18385116665283,41.53665307900943,NaN,NaN,-53.00292198206306,-106.35265445311163,-0.02364200755710838,-0.12720716771934448,-0.1035651601622361,1090304,-714636,40.139186957354255,37.02206949080755,NaN,NaN,-15.868530651531652,-9.498071018225634
2006-04-21T09:30:00-04:00,23.42,23.56,23.33,23.42,762200,1097840,45.18385116665283,41.65047048557772,NaN,NaN,-39.08426798320649,-85.81780682400056,-0.011581092772318113,-0.11804152612763374,-0.10646043335531563,1090304,-167776,45.454838534224876,36.89608532555881,NaN,NaN,-15.09201013701485,-10.297205178052664
2006-04-24T09:30:00-04:00,23.41,23.53,23.32001,23.52,933800,1085035,49.088768064578964,41.857112463225384,NaN,NaN,-26.459233619134025,-60.67963104460695,0.0039379008071728505,-0.10153805734634958,-0.10547595815352243,2024104,676384,52.47108857543415,37.38649075628415,NaN,NaN,-13.310442981496609,-10.727667721401799
2006-04-25T09:30:00-04:00,23.53,23.61,23.47,23.52,986400,1086715,49.088768064578964,42.10427183575057,NaN,NaN,9.542682988729139,-37.17431505333019,0.014420078239444509,-0.08745086035421679,-0.1018709385936613,2024104,1294824,56.85019178630532,38.32978814427456,NaN,NaN,-11.840955414835605,-10.886708820463772
2006-04-26T09:30:00-04:00,23.5,23.75,23.5,23.74001,450400,1048090,56.91939992775906,42.786395375913386,NaN,NaN,67.08841883287872,-8.383064352559149,0.035203441769338845,-0.057866636381987746,-0.09307007815132659,2474504,1740664,59.73069020725697,39.57481952171862,NaN,NaN,-8.109694843388501,-10.489992538024447
2006-04-27T09:30:00-04:00,23.63,23.88,23.42,23.77,601000,1047730,57.87063283237133,43.73420613794273,NaN,NaN,84.19048453549452,19.055616950952366,0.04914702267562229,-0.03163629980679872,-0.08078332248242101,3075504,2137704,62.15368398371468,41.07779891950894,NaN,NaN,-4.750183368256736,-9.670019799486203
2006-04-28T09:30:00-04:00,23.71001,23.84,23.69,23.83,1265800,1039525,59.783853413252096,45.22657851317406,NaN,NaN,122.60290728365457,51.39305200432458,0.05987576687532188,-0.005938613888268662,-0.06581438076359054,4341304,2787904,65.78445576442381,43.06881160081444,NaN,NaN,-1.3409995016846457,-8.480159756943124
2006-05-01T09:30:00-04:00,23.89,24,23.78999,23.82001,738600,1049665,59.30097161129522,46.60013899568474,NaN,NaN,143.90812352828223,85.46652343380784,0.0634240279347861,0.013465654154892093,-0.04995837377989401,3602704,3103624,67.41893865864239,45.411099021385375,NaN,NaN,1.3595193842106843,-7.0744913082068654
2006-05-02T09:30:00-04:00,23.85001,23.99001,23.75999,23.96001,1027800,1038550,63.72312709757556,48.66842789633606,NaN,NaN,143.97236653993986,112.35246014404997,0.07171315077004839,0.03968306468266647,-0.032030086087381913,4630504,3624904,69.9697022943763,48.10992971978351,NaN,NaN,5.100721102858626,-5.335175249483224
2006-05-03T09:30:00-04:00,23.73,23.82001,23.64999,23.8,542800,989815,56.20623623891359,49.97017144117535,NaN,NaN,84.55823646791121,115.84642367105648,0.0632298383058558,0.04700721179493783,-0.01622262651091796,4087704,3947544,71.45907980045314,51.05901296236136,NaN,NaN,6.257402967612142,-3.679092647041029
2006-05-04T09:30:00-04:00,23.73,23.89999,23.73,23.84,568700,962320,57.55418562316361,51.43834482856857,NaN,NaN,102.78939705698721,119.56620617535502,0.057298654938007024,0.055400692161590825,-0.0018979627764162017,4656404,4263724,72.87865140343767,54.21123634064729,NaN,NaN,7.606716883703002,-2.0668341426490247
2006-05-05T09:30:00-04:00,23.88,24.10001,23.82001,24.06,685600,932255,64.09922814089575,53.59327657599846,NaN,NaN,141.64160550336592,123.37394581929729,0.06463460333999774,0.07889529139858098,0.014260688058583236,5342004,4463864,73.76806515618206,57.40910555881145,NaN,NaN,10.943402845560213,-0.20822885861913365
2006-05-08T09:30:00-04:00,24.06,24.2,24.02,24.19,649600,850915,67.30723043289606,55.357460998649245,NaN,NaN,154.61574650168973,125.51547041397878,0.07401066529211947,0.10677401967373257,0.0327633543816131,5991604,4941644,75.8076828939723,60.694206137675685,NaN,NaN,14.82948913491167,1.9400165690281237
2006-05-09T09:30:00-04:00,24.16,24.25999,24.16,24.2599,761200,844180,68.9156212426572,57.158980358803106,NaN,NaN,152.28931807510895,127.1788607210126,0.08016979536069609,0.1329755985824832,0.052805803221787115,6752804,5366104,77.48273234342564,63.66921345422884,NaN,NaN,18.529114374785667,4.309887684136344
2006-05-10T09:30:00-04:00,24.17,24.23,24.12,24.16,373600,815645,64.06462276238975,58.50760690135575,NaN,NaN,123.7767226578078,135.0225579589919,0.07297078057477219,0.14401927894025235,0.07104849836548016,6379204,5824404,79.16051220514164,66.45645097192794,NaN,NaN,20.139990743149657,6.571330978281102
2006-05-11T09:30:00-04:00,24.09,24.09,23.83,23.86,1816400,835500,52.185067937900904,59.00769381358776,NaN,NaN,58.44934035224178,126.15454661804283,0.044840293935886816,0.1270988657853387,0.08225857184945187,4562804,5805684,78.90190094872999,68.84552685867831,NaN,NaN,17.51023552030708,8.134031627141956
2006-05-12T09:30:00-04:00,23.75,23.92999,23.64,23.67,1861500,893255,46.32605758686981,58.81035735089424,NaN,NaN,7.865117249295564,99.39924896722874,0.011982755762402666,0.0972370165524552,0.08525426079005254,2701304,5277544,71.77739995787184,70.224549100281,NaN,NaN,13.198590333532442,8.857540013769169
2006-05-15T09:30:00-04:00,23.60001,23.95,23.56,23.92999,926900,911965,53.94572007650134,59.15728249460299,NaN,NaN,19.681491392166205,72.41239794532406,0.0065748391278639545,0.09347280969988248,0.08689797057201852,3628204,4804864,66.03073393362068,70.88030211080353,NaN,NaN,12.273078320644357,9.345474057608481
2006-05-16T09:30:00-04:00,23.98,24.08,23.94,24.02,2268400,968955,56.260779175535276,59.110238155158434,NaN,NaN,75.11460396046056,56.977455122394375,0.007792593528486172,0.09663871248262623,0.08884611895414006,5896604,4633624,64.03069197574513,71.18744509426696,NaN,NaN,12.36054085111485,9.776197885252248
2006-05-17T09:30:00-04:00,23.85001,23.98,23.69,23.72,2725100,1039540,47.661283275576196,58.38099890110164,NaN,NaN,-4.139055969012698,31.394299397030284,-0.011807934487014643,0.07408620084537176,0.0858941353323864,3171504,3992084,57.05782473216659,70.82345514772781,NaN,NaN,9.241809519134666,9.699856690092593
2006-05-18T09:30:00-04:00,23.7,23.81,23.57001,23.60001,982000,1046390,44.717198441302074,57.30480926024807,NaN,NaN,-63.486548534294364,7.007121619723053,-0.031914736201865135,0.04600071508005499,0.07791545128192012,2189504,3517424,52.50223532723944,69.87472511650036,NaN,NaN,5.734398543802858,9.13336266919406
2006-05-19T09:30:00-04:00,23.64999,23.67999,23.48,23.62,888500,1052705,45.323153577133155,56.30639368637935,NaN,NaN,-96.81146457996157,-13.928194746128373,-0.04227889197182355,0.025066836317140684,0.06734572828896424,3078004,3592764,53.14173922075351,68.85492515665115,NaN,NaN,3.2477385271917605,8.292559220336589
2006-05-22T09:30:00-04:00,23.64999,23.77,23.5,23.69,1843300,1098180,47.493520954455015,55.147136104727885,NaN,NaN,-80.00878586006033,-33.86625019657369,-0.0427053563240559,0.013964032883894362,0.05666938920795026,4921304,3851384,55.3634221962994,67.81161943535996,NaN,NaN,1.9279655309258872,7.383331550420774
2006-05-23T09:30:00-04:00,23.85001,23.87,23.67,23.67999,740400,1085880,47.20495961434455,54.50418777440152,NaN,NaN,-49.573476078306456,-58.803866204327086,-0.04188942939127543,0.0043076024688559755,0.0461970318601314,4180904,3508244,51.8506949706638,66.41102051894643,NaN,NaN,0.792602096986363,6.441798771358715
2006-05-24T09:30:00-04:00,23.64999,23.92999,23.60001,23.86,1785200,1152620,52.76313313115816,54.161969739258275,NaN,NaN,-27.67142312985817,-63.51033963649618,-0.028115460946665165,0.011052705676799945,0.03916816662346511,5966104,4067164,56.6728843730172,65.25346573105925,NaN,NaN,1.5021112409514894,5.736129124157683
2006-05-25T09:30:00-04:00,24.05,24.10001,23.89999,24.09,1404100,1192775,58.7401262567473,53.779176747533384,NaN,NaN,73.98027672823468,-36.01697458399037,-0.0036873714707722216,0.03455895228499983,0.038246323755772055,7370204,5103304,63.892376116641664,64.54805937109208,NaN,NaN,4.079643050170937,5.499488256445291
2006-05-26T09:30:00-04:00,24.23,24.23,24.03999,24.09,3487700,1303870,58.7401262567473,53.167240734951335,NaN,NaN,101.30204139739448,3.6057266114808413,0.011468295434468277,0.0525816930488574,0.041113397614389126,7370204,5961744,68.56570888274081,64.03077551314695,NaN,NaN,6.1028332658163755,5.58568040064116
2006-05-30T09:30:00-04:00,24.14999,24.14999,23.75999,23.78999,1479000,1340890,49.30277174443952,51.76632291365007,NaN,NaN,4.382718689103274,20.48402752131356,0.0008456265193498222,0.042170430763576405,0.04132480424422658,5891204,6155724,69.52554146135662,63.4624047358563,NaN,NaN,4.875100042833285,5.484168920954321
2006-05-31T09:30:00-04:00,23.81,23.92999,23.7,23.88,728700,1325935,51.804617546070766,50.89060825534157,NaN,NaN,-21.692442634643637,26.060234210046122,-0.0004893081326858215,0.040713169078369305,0.041202477211055126,6619904,6643524,71.853056924248,62.940443644363896,NaN,NaN,4.674538832271962,5.368507479713984
2006-06-01T09:30:00-04:00,23.88,24.00999,23.85001,24.00999,680700,1332830,55.23996453923502,51.10881515543686,NaN,NaN,26.548818755363197,36.90428258709039,0.006619654030046503,0.04947704474861325,0.04285739071856675,7300604,6910424,73.06522112216769,62.52353794246659,NaN,NaN,5.596966264210996,5.401144448927843
2006-06-02T09:30:00-04:00,24.07001,24.09,23.84,23.96001,1794300,1394110,53.65632231439903,51.63240549311752,NaN,NaN,26.52130305763569,27.412487852970592,0.007148071099416425,0.05179247959283728,0.044644408493420856,5506304,6537644,68.62022804926995,62.29802566328073,NaN,NaN,5.863012674326165,5.467125623984746
2006-06-05T09:30:00-04:00,24.05,24.05,23.61,23.62,870100,1403335,44.34292482010013,50.94649154623172,NaN,NaN,-57.767498041556806,-4.401420034819663,-0.015001099442314536,0.025893034190527686,0.04089413363284222,4636204,5990844,62.6040156279274,62.053260070016925,NaN,NaN,2.9851113479503617,5.1125521559798335
2006-06-06T09:30:00-04:00,23.60001,23.74001,23.5,23.69,2695900,1505650,46.40544835140812,50.24253934450836,NaN,NaN,-99.51021338680081,-25.18000645000048,-0.024002975559314785,0.010890414183698738,0.03489338974301352,7332104,6279024,64.37667570530347,62.07797319355682,NaN,NaN,1.3432033985746032,4.574073762064801
2006-06-07T09:30:00-04:00,23.74001,23.91,23.63,23.67999,2101200,1572650,46.1421204962155,50.134027717411165,NaN,NaN,-51.39844064736786,-31.121206052545325,-0.029343832660812762,-0.0017864010830024313,0.02755743157781033,5230904,6001224,61.35728233282076,62.38507730788927,NaN,NaN,-0.035794990733630794,3.9155210830935965
2006-06-08T09:30:00-04:00,23.67999,23.81,23.50999,23.75999,2283100,1668125,48.650012132053,50.414942981036226,NaN,NaN,-70.30111290938987,-50.491192385495935,-0.026298948964002474,-0.005316254627192762,0.02098269433680971,7514004,6043904,61.65484503958832,63.03883514448562,NaN,NaN,-0.4510302063321559,3.2917280417470605
2006-06-09T09:30:00-04:00,23.89999,23.89999,23.71001,23.78,2168800,1685745,49.28611619995088,50.698011739808926,NaN,NaN,-9.422033606842792,-57.679859718391626,-0.0219261442564298,-0.006424985983727538,0.015501158272702261,9682804,6879204,67.00919237177567,64.02936751241576,NaN,NaN,-0.6116213170821023,2.734106704771466
2006-06-12T09:30:00-04:00,23.74001,23.89999,23.64,23.64,2327700,1709055,45.07861700473165,50.52551860054297,NaN,NaN,-49.709023299195735,-56.06816476991942,-0.0271117443034031,-0.01838852210655162,0.008723222196851484,7355104,7422984,69.95085951298168,65.07132732075021,NaN,NaN,-1.9676839102959778,2.0624223311904024
2006-06-13T09:30:00-04:00,23.74001,23.78,23.53999,23.56,1350600,1730240,42.82862875806994,50.2129235393805,NaN,NaN,-97.29681528415857,-55.62548514939097,-0.03412567657172658,-0.033933873517806745,0.00019180305391983815,6004504,7157464,66.81791850825606,66.14041471629251,NaN,NaN,-3.7653781901433647,1.2298793995712929
2006-06-14T09:30:00-04:00,23.42999,23.67,23.42999,23.66,1369900,1685315,46.42812099738823,49.760422672682644,NaN,NaN,-110.95362682505325,-67.53652238492805,-0.030352931329230497,-0.037749361107618284,-0.007396429778387787,7374404,7586164,69.21528907482696,67.03630076642179,NaN,NaN,-4.2863456292508415,0.4418472525967023
2006-06-15T09:30:00-04:00,23.75,23.88,23.59,23.85001,1259000,1612010,52.542204112062485,49.317713948062305,NaN,NaN,-3.7285836778246773,-54.222016538615,-0.01420367074490882,-0.025151018209523812,-0.010947347464614992,8633404,7810044,70.41731977706205,67.50236817073754,NaN,NaN,-2.909691252823295,-0.036943962463297286
2006-06-16T09:30:00-04:00,23.74001,23.82001,23.69,23.75,1392600,1632540,49.34970577736222,48.64696962810623,NaN,NaN,-18.482656631059253,-56.03414114345829,-0.009619646864158074,-0.022971906044812584,-0.01335225918065451,7240804,7321644,64.50049673976557,67.21199587481074,NaN,NaN,-2.695414206109925,-0.41672542584138694
2006-06-19T09:30:00-04:00,23.74001,23.92999,23.59,23.66,1478300,1662030,46.60534093468118,48.45429599883778,NaN,NaN,-40.16305571728474,-54.1249476270761,-0.011864051464032254,-0.02818232351069483,-0.016318272046662575,5762504,7003124,60.90618124440928,66.59632728788593,NaN,NaN,-3.3263756466413725,-0.8323897430985276
2006-06-20T09:30:00-04:00,23.7,23.89,23.7,23.83,871800,1613455,52.031634604747545,48.47051150302898,NaN,NaN,5.11342036262894,-33.64290049771859,-0.0016510941833630076,-0.018382139775866335,-0.016731045592503328,6634304,7129084,61.81244705006314,65.87914086830129,NaN,NaN,-2.218727543738886,-1.0304380003328646
2006-06-21T09:30:00-04:00,23.95,23.99001,23.83,23.92,908300,1621850,54.658739062137045,48.42899539752198,NaN,NaN,66.09735930312937,1.7672967279179275,0.010732866160278711,-0.003314962892154938,-0.014047829052433649,7542604,7162724,62.065371811487715,65.09343734610987,NaN,NaN,-0.49280361551666513,-0.9536330882162647
2006-06-22T09:30:00-04:00,23.8,23.92,23.78999,23.88,1221200,1593650,53.262542761243324,48.400868286582295,NaN,NaN,31.913914932558622,8.895796449994585,0.01550762283042115,0.0053366994855927885,-0.010170923344828362,6321404,6700324,56.52363235287711,64.22939479636753,NaN,NaN,0.5210716559990852,-0.7429609818997862
2006-06-23T09:30:00-04:00,23.75999,23.95,23.75999,23.8,369700,1541930,50.484980842244205,48.8395865738783,NaN,NaN,23.99764293773212,17.391856363752858,0.012674725856215988,0.005672483975441622,-0.007002241880774365,5951704,6442504,53.64736909734834,63.58963432989759,NaN,NaN,0.5849462640646798,-0.5532599467620054
2006-06-26T09:30:00-04:00,23.8,23.95,23.7805,23.92999,734100,1404250,54.62553099343086,49.42673533402278,NaN,NaN,75.00141284299035,40.42475007580788,0.01859418706402023,0.016240491949250924,-0.002353695114769307,6685804,6627164,55.39799698864003,62.948300135850204,NaN,NaN,1.8605621181451981,-0.20842822320383347
2006-06-27T09:30:00-04:00,23.88,23.95,23.75,23.82001,752400,1367920,50.75816341193031,49.756452685145256,NaN,NaN,42.70694458857353,47.94345492099679,0.01433244418113212,0.015561860111645842,0.0012294159305137231,5933404,6486984,53.73877266544016,62.40412087389445,NaN,NaN,1.816473509539231,0.08084345290231854
2006-06-28T09:30:00-04:00,23.7,23.92999,23.7,23.92999,1940400,1428505,54.246577639156364,50.15620736422407,NaN,NaN,52.15772059863601,45.155527180098126,0.017917394214904733,0.02362615869914464,0.005708764484239907,7873804,6553224,54.433281459083624,61.8882949038584,NaN,NaN,2.817274272229675,0.47176214137765515
2006-06-29T09:30:00-04:00,24.09,24.31,23.96001,24.31,1585000,1473720,63.7914640556792,51.19230363963323,NaN,NaN,272.5139679288443,93.27553777935526,0.04342441674346831,0.05998928541357529,0.016564868670106984,9458804,7180704,60.48509801187605,61.42228816386557,NaN,NaN,7.069491508259149,1.4142949080750113
2006-06-30T09:30:00-04:00,24.42999,24.42999,24.17999,24.19,5448199,1656414.95,59.565617418938245,52.22708938350514,NaN,NaN,264.80152555264186,141.43631430233722,0.04932620622625894,0.07822262645293065,0.02889642022667172,4010605,6792484.2,55.56782963440642,60.39492888682448,NaN,NaN,9.124215190375633,2.5157120912608146
2006-07-03T09:30:00-04:00,24.24001,24.33,24.17999,24.33,535400,1639679.95,62.6724121592485,53.64450248358933,NaN,NaN,213.25433847809762,169.08689942935865,0.059110602086446556,0.10278467283472992,0.04367407074828336,4546005,6364524.4,50.676857614789334,59.241995965862564,NaN,NaN,11.86041899558784,3.8506702204503895
2006-07-05T09:30:00-04:00,24.3,24.3,24.03999,24.13,1175000,1563634.95,56.047165628937734,54.33157710012858,NaN,NaN,129.11330290330594,186.36817109230515,0.04898289548945456,0.10490269011010156,0.055919794620647,3371005,5852044.6,45.51095567102493,57.548829294162424,NaN,NaN,11.95287353797299,5.008127837239332
2006-07-06T09:30:00-04:00,24.21001,24.52,24.08,24.41,3086700,1612909.95,62.08941731590441,55.013520900403,NaN,NaN,165.8845827233965,209.11354351725726,0.057426416654327905,0.12770281543855688,0.07027639878422898,6457705,5568824.8,42.907776649068445,55.58386192787717,NaN,NaN,14.167489034938841,6.316608008339262
2006-07-07T09:30:00-04:00,24.39,24.44,24.3,24.36,813000,1539404.95,60.49024979950205,55.80927404484156,NaN,NaN,144.06686567215874,183.42412306592013,0.05587668478459129,0.1401222547649681,0.0842455699803768,5644705,4806005,36.801980504682625,53.605396482514095,NaN,NaN,15.356151845796786,7.607971413690337
2006-07-10T09:30:00-04:00,24.45,24.59,24.45,24.50999,1721200,1517024.95,63.52516586816285,57.01783296866167,NaN,NaN,155.81901092493553,161.62762014037884,0.06078015533924912,0.1602207641544382,0.09944060881518908,7365905,5477065,44.30972874632491,52.41993558979379,NaN,NaN,17.342773850534122,8.998657476096593
2006-07-11T09:30:00-04:00,24.57001,24.67,24.45,24.64,2270600,1514169.95,65.96556091680833,58.013113419523116,NaN,NaN,146.2623015294731,148.22921275065394,0.06805771293347561,0.1845127499820336,0.11645503704855799,9636505,6495165,53.362041187579486,51.81633517104495,NaN,NaN,19.77516553936047,10.538158627991432
2006-07-12T09:30:00-04:00,24.64,24.66,24.39999,24.44,2125600,1552919.95,59.383382340216976,58.35058793938597,NaN,NaN,109.20832784128689,144.24821773825016,0.055226216164810354,0.18548780725457092,0.13026159108976057,7510905,7323145,59.17410072121536,51.60981580745407,NaN,NaN,19.677572459525226,11.843789175353402
2006-07-13T09:30:00-04:00,24.27,24.39999,24.17999,24.24001,839300,1526389.95,53.621620490273614,58.37623634860241,NaN,NaN,47.69098616033738,120.6094984256383,0.03033816842114631,0.16818430161619347,0.13784613319504715,6671605,7365925,59.455246007479694,51.81921678278282,NaN,NaN,17.661557613432272,12.674898952221811
2006-07-14T09:30:00-04:00,24.19,24.3,23.91,24,3464600,1636669.95,47.64673900054129,58.173504788480784,NaN,NaN,-8.482081337606054,90.09970902368534,-0.0034251490397647355,0.13356469689534123,0.13698984593510596,3207005,6878385,54.82181586737396,51.90310583778465,NaN,NaN,13.882870123382787,12.847466262387664
2006-07-17T09:30:00-04:00,23.94,24.13,23.94,24.06,1180900,1626084.95,49.17150503199556,57.783931505521124,NaN,NaN,-20.851007130871906,54.76570541252386,-0.021827640794922748,0.10970529494145254,0.13153293573637528,4387905,6282785,49.723750102314185,51.49780248876139,NaN,NaN,11.391691077695727,12.639498378860244
2006-07-18T09:30:00-04:00,24.06,24.17,23.91,24.17,1581100,1631224.95,51.93533612063323,57.86801527042847,NaN,NaN,-15.682942260601921,22.37665665450885,-0.02639694276034972,0.09853675728593814,0.12493370004628786,5969005,5549285,44.26444738958806,50.82106496905766,NaN,NaN,10.21360555398244,12.292942261020558
2006-07-19T09:30:00-04:00,24.14999,24.5,24.14999,24.47,2522600,1713764.95,58.554391575208676,58.17571626586078,NaN,NaN,67.95246532276869,14.125484150805239,-0.009870818902092418,0.11259517641867234,0.12246599532076476,8491605,5745425,45.97264360306337,50.21673369362764,NaN,NaN,11.37206474462834,12.161388330107384
2006-07-20T09:30:00-04:00,24.60001,24.63,24.49001,24.49001,498600,1693279.95,58.960352514812186,57.83063687008456,NaN,NaN,108.78450620743362,26.34418816022448,0.001165372355994329,0.12392271076575767,0.12275733840976334,8990205,6209145,49.8834051673961,49.459469919021934,NaN,NaN,12.40574485735579,12.196296405428585
2006-07-21T09:30:00-04:00,24.5,24.56,24.39,24.44,796900,1672064.95,57.445887918230646,57.67922762003402,NaN,NaN,78.2888652113819,43.698377470022066,0.0037108758959327193,0.12739593327967924,0.12368505738374652,8193305,7206405,57.07882982888821,49.56739850434206,NaN,NaN,12.791826613275967,12.281372149406783
2006-07-24T09:30:00-04:00,24.48,24.62,24.44,24.62,1962500,1751704.95,61.299080144419094,57.58113247611764,NaN,NaN,102.90052932289792,68.44868476077605,0.015471384382177572,0.14302428786146848,0.1275529034792909,10155805,8359985,63.59076960703972,50.4898207895028,NaN,NaN,14.306098906769021,12.57061882902996
2006-07-25T09:30:00-04:00,24.58,24.78999,24.49001,24.74001,4859199,1957959.9,63.661595353429,58.125020313581295,NaN,NaN,129.64332622551598,97.51393845799961,0.02852749008932573,0.16321226609094808,0.13468477600162235,15015004,10169184.8,71.01750686816494,52.311717303584224,NaN,NaN,16.300069217237667,13.103397455916776
2006-07-26T09:30:00-04:00,24.75,24.75,24.57001,24.62,1902400,2015459.9,59.73456961461076,57.956816906346035,NaN,NaN,111.87959106926344,106.29936360729857,0.02632869280933628,0.1675956420132927,0.1412669492039564,13112604,11093384.6,73.9416431568713,54.52842205414158,NaN,NaN,16.807037401748783,13.63248887674992
2006-07-27T09:30:00-04:00,24.62,24.72,24.44,24.46001,4074200,2122149.9,54.87476314640646,57.55571071683921,NaN,NaN,66.80121471327679,97.9027053084672,0.012072243844258257,0.15635725400927925,0.144285010165021,9038404,11103024.4,73.97114192097939,57.18336215530563,NaN,NaN,15.762696056218884,13.936804188102629
2006-07-28T09:30:00-04:00,24.53999,24.73,24.5,24.69,2108400,2148319.9,59.92247884237658,57.29837592928304,NaN,NaN,95.44206479955443,101.33334522610171,0.015865736460841495,0.16411718074107284,0.14825144428023135,11146804,11693724.2,75.78042606221965,59.43126910644097,NaN,NaN,16.431937428020838,14.293251793805231
2006-07-31T09:30:00-04:00,24.69,24.69,24.53999,24.57001,943900,1923104.95,56.37912513133768,56.61363051603514,NaN,NaN,72.41580086932261,95.23639953538665,0.008402654418312533,0.15875476230312202,0.1503521078848095,10202904,11703144,75.80930356100919,61.034644990257384,NaN,NaN,15.884101695154746,14.520516065426591
2006-08-01T09:30:00-04:00,24.64999,24.64999,24.36,24.45,1266500,1959659.95,53.00326514033972,56.157907858901055,NaN,NaN,25.425706316700705,74.3928755536236,-0.005745031154008845,0.14317081894229844,0.14891585009630728,8936404,10487424,65.03228454962199,61.453086692286426,NaN,NaN,14.384497055475695,14.501084778290748
2006-08-02T09:30:00-04:00,24.58,24.69,24.5,24.67,916300,1946724.95,57.971477443950846,56.46861192702085,NaN,NaN,73.7600546600769,66.76896827178628,-0.0016291136981255727,0.14687945797365032,0.1485085716717759,9852704,9835444,60.09802765255145,61.49899966693441,NaN,NaN,14.64271304323439,14.521317387568411
2006-08-03T09:30:00-04:00,24.62,24.77,24.60001,24.73,1275900,1856184.95,59.237118598702544,57.29649618403237,NaN,NaN,99.9161696239038,73.39195925391168,0.0035111999856073106,0.15289757165378504,0.14938637166817773,11128604,10253484,62.08447939203259,62.017761347267175,NaN,NaN,15.237342584961441,14.623606701481702
2006-08-04T09:30:00-04:00,24.91,24.91,24.64,24.74001,679600,1849514.95,59.45647759623033,58.03113708147771,NaN,NaN,116.72644917776249,77.64883612955329,0.005825873892579436,0.15666871403390203,0.1508428401413226,11808204,10385764,62.71697258492616,62.945848667453745,NaN,NaN,15.779549241419117,14.788741350044189
2006-08-07T09:30:00-04:00,24.75,24.75,24.59,24.67999,968500,1811879.95,57.45982959358595,58.425743758117186,NaN,NaN,73.47285773594403,77.86024750287757,0.0017657231559923547,0.15304999408631303,0.15128427093032068,10839704,10513124,63.350880141972354,64.30916529262404,NaN,NaN,15.674828567485427,14.91532523825008
2006-08-08T09:30:00-04:00,24.8,24.87,24.71001,24.78999,5638000,1980249.95,60.104134895148306,58.53643970954145,NaN,NaN,111.6048237093544,95.09607098140832,0.0047690504064303585,0.15724558393835864,0.15247653353192828,16477704,12021384,69.88176618547638,66.0169597627964,NaN,NaN,16.328496238668542,15.117206809738432
2006-08-09T09:30:00-04:00,24.89999,24.9019,24.60001,24.63,3860500,2066994.95,54.77138819712989,58.23722797256414,NaN,NaN,73.71067840286078,95.08619572996508,-0.005198811245091611,0.14597801947556377,0.15117683072065538,12617204,12574284,71.86132010378341,67.58681082968121,NaN,NaN,15.360697527438305,15.151991197981271
2006-08-10T09:30:00-04:00,24.62,24.91,24.55,24.89,1278000,2088929.95,60.85047439803713,58.48041272112175,NaN,NaN,95.78878410670744,94.26071862652582,0.004040398741428641,0.1562273291474412,0.15218693040601255,13895204,13127604,73.72269206264366,68.77565813209232,NaN,NaN,16.356693244882116,15.324091490395677
2006-08-11T09:30:00-04:00,24.94,24.94,24.75999,24.84,658200,1948609.95,59.20251488086122,58.33065805943904,NaN,NaN,117.86864176573226,94.48915714411976,0.005041209803802044,0.15848844266076512,0.15344723285696307,13237004,13413364,74.65514932800968,69.56597096930446,NaN,NaN,16.677607623529557,15.517450937986231
2006-08-14T09:30:00-04:00,24.98,25.09,24.86,24.89,2429600,2011044.95,60.35866835585119,58.09473470246919,NaN,NaN,162.3857634919567,112.27173829532231,0.007196164300071112,0.16244243823205196,0.15524627393198084,15666604,14378744,77.5530704101658,70.03279693659023,NaN,NaN,17.276308194207928,15.768716260303616
2006-08-15T09:30:00-04:00,25.14,25.14,24.97,25.05,932200,1978599.95,63.88560088166474,58.39123693583019,NaN,NaN,206.39872090254414,131.23051773396026,0.01696508877150954,0.17645263489636775,0.15948754612485821,16598804,14402964,77.62220170598233,70.29569397581245,NaN,NaN,18.848044572669345,16.20862030492729
2006-08-16T09:30:00-04:00,25,25.2,24.92999,25.08,4637199,2084329.9,64.52295718278819,59.0803936527146,NaN,NaN,183.91039285217522,153.27046062382314,0.02265923578781001,0.18781159085962074,0.16515235507181072,21236003,16126723.8,81.89572586231677,70.86173568590797,NaN,NaN,20.321475984170473,16.796171116247745
2006-08-17T09:30:00-04:00,25.02,25.14999,24.99001,25.03999,3013400,2210069.9,62.92789694732612,59.295066374496706,NaN,NaN,149.81323007573613,164.07534981762888,0.02098137501533326,0.1913790738409773,0.17039769882564404,18222603,16992203.6,83.59020715313639,71.41957719240203,NaN,NaN,21.117176052761522,17.413457535749714
2006-08-18T09:30:00-04:00,25.14999,25.2,25.03999,25.19,1070900,2223769.9,66.29244277639958,60.00316049200113,NaN,NaN,160.45381219221528,172.5923839029255,0.026849650495479604,0.20395976194499355,0.17711011144951394,19293503,18203503.4,85.61894446685218,72.12026582853368,NaN,NaN,22.788296057157996,18.181291610236613
2006-08-21T09:30:00-04:00,25.21001,25.27,25.17,25.25,852300,2168259.9,67.56058499464353,61.04296905302283,NaN,NaN,163.5008565937723,172.81540252328858,0.031334649583446256,0.21627842342882175,0.1849437738453755,20145803,19099343.2,86.90805533676367,73.68282088475807,NaN,NaN,24.557640740957652,19.092198628911046
2006-08-22T09:30:00-04:00,25.24001,25.25999,25.14,25.23,562100,1953404.95,66.6603176688382,61.66360049765764,NaN,NaN,131.0884151163408,157.75334136604792,0.029540695653850257,0.22186964341268833,0.19232894775883808,19583703,19696323,87.69935564600402,75.65434431286182,NaN,NaN,25.79067821189826,20.049124283623506
2006-08-23T09:30:00-04:00,25.2,25.25,25.09,25.14999,1693000,1942934.95,63.041209356626254,61.93532126608077,NaN,NaN,100.69066005554518,141.10939480672192,0.020008230419179762,0.21733923578281278,0.19733100536363302,17890703,19027263,81.73664038517593,77.05807009808635,NaN,NaN,25.88781595678306,20.88322309407487
2006-08-24T09:30:00-04:00,25.22,25.28,25.16,25.28,1626000,1820524.95,66.24786701060965,62.420420509965005,NaN,NaN,110.22458594284753,133.19166598014422,0.019482506748227213,0.22168413879891702,0.2022016320506898,19516703,19286083,82.23969545137753,78.45255030283288,NaN,NaN,26.867275674724926,21.738087748453452
2006-08-25T09:30:00-04:00,25.28,25.28,25.14999,25.24001,1062900,1768249.95,64.39706381722621,62.91593724022501,NaN,NaN,93.9485903117848,119.89062160405811,0.013736186080593737,0.219371864651432,0.20563567857083825,18453803,19118143,80.686673245964,79.6908212388323,NaN,NaN,27.188696873539286,22.516746194894285
2006-08-28T09:30:00-04:00,25.21001,25.41,25.2,25.34,1744800,1808294.95,66.8880053354369,63.400499414531346,NaN,NaN,110.915688604864,109.37358800627644,0.013920817014526271,0.2230366998389961,0.20911588282446983,20198603,19128703,80.71133890406416,80.46436214730285,NaN,NaN,28.160451890882364,23.322989865749726
2006-08-29T09:30:00-04:00,25.44,25.45,25.31,25.42999,2319200,1860929.95,68.9907717875823,64.41616967099223,NaN,NaN,124.53640566709494,108.06318611642727,0.017143269856009863,0.23054497014448216,0.2134017002884723,22517803,19715523,82.08088849713728,81.1943313182567,NaN,NaN,29.596090662597028,24.219147122442198
2006-08-30T09:30:00-04:00,25.52,25.53999,25.41,25.5,859500,1858089.95,70.55728499415235,65.10951328500046,NaN,NaN,140.1691796252684,115.95889003037193,0.020786694411145473,0.23938506830240414,0.21859837389125866,23377303,20812843,84.32252354880315,81.95146213869667,NaN,NaN,31.268477476027346,25.226194315811505
2006-08-31T09:30:00-04:00,25.53,25.53,25.42999,25.52,1773700,1882979.95,71.0078711161518,65.95275301609266,NaN,NaN,131.17524292661108,120.14902142712462,0.02126408309636557,0.24517847776171564,0.22391439466535007,25151003,21939703,86.22785823257904,82.77808420330875,NaN,NaN,32.789385995463284,26.306650270047474
2006-09-01T09:30:00-04:00,25.60001,25.67,25.50999,25.66,754600,1886729.95,74.00665303416547,66.92760906454366,NaN,NaN,151.02159252981673,131.56362187073103,0.02734169084236543,0.25809150821830684,0.2307498173759414,25905603,23430063,88.26006029902796,83.54286919537034,NaN,NaN,35.02522083823101,27.55216035121655
2006-09-05T09:30:00-04:00,25.75999,26.56,25.49001,25.57001,2118400,1944224.95,69.06179807346666,67.29733743538667,NaN,NaN,204.15735037362032,150.2119542244823,0.021871067415065004,0.2580886516447727,0.23621758422970768,23787203,24147783,89.09461525790513,84.36232730622196,NaN,NaN,35.55819634568551,28.69587977899783
2006-09-06T09:30:00-04:00,25.49001,25.53,25.45,25.5,1714600,1748054.95,65.4006653764997,67.36003087779463,NaN,NaN,84.03415667983792,142.11150442703087,0.010674243870967659,0.24956038906841727,0.2388861451974496,22072603,24058743,88.25641049911329,84.81666192313601,NaN,NaN,34.97019140304561,29.592210011004656
2006-09-07T09:30:00-04:00,25.53999,25.60001,25.36,25.41,3359800,1723019.95,60.929005206497614,67.21725289630687,NaN,NaN,64.4435674780359,126.96638199758438,-0.004824738840027043,0.2328552216474158,0.23767996048744283,18712803,23125843,79.7867841444374,84.54498885108607,NaN,NaN,33.16597211753429,30.102747454794603
2006-09-08T09:30:00-04:00,25.52,25.56,25.41,25.53999,534900,1685864.95,64.68478871875968,67.1024204636183,NaN,NaN,70.39252566783576,114.80983854582932,-0.008157504866587173,0.22748307940420887,0.23564058427079604,19247703,21945183,70.55810889497461,83.46921488166626,NaN,NaN,32.66385131764616,30.46861943520197
2006-09-11T09:30:00-04:00,25.45,25.73,25.45,25.73,1554000,1730654.95,69.32633745615091,67.22854563944027,NaN,NaN,103.2992433078162,105.26536870142922,0.00015891591414263218,0.23583922916347433,0.2356803132493317,20801703,20924403,63.69806879641626,81.81135870021286,NaN,NaN,33.666270467801205,30.92542672557329
2006-09-12T09:30:00-04:00,25.78999,25.8,25.64999,25.74001,3268200,1772584.95,69.55336715816404,67.43519203153497,NaN,NaN,121.07481397331543,88.64886142136822,0.003853319095174612,0.24049696211829996,0.23664364302312535,24069903,20980943,63.9073867043893,80.11193234724037,NaN,NaN,34.53474792654948,31.44104403999846
2006-09-13T09:30:00-04:00,25.8,25.8,25.50999,25.55,1795600,1815754.95,60.412801307118464,67.24744859942727,NaN,NaN,76.93987784168725,87.23000565373808,-0.008316527141857932,0.22624798409580293,0.23456451123766087,22274303,21021283,64.06658555054628,78.84978557333822,NaN,NaN,32.41815825041525,31.580631784343716
2006-09-14T09:30:00-04:00,25.56,25.69,25.48,25.67999,953800,1631585,63.907355613544475,67.08026921392262,NaN,NaN,69.26395339626232,88.19408283738336,-0.009351206653815336,0.2228755029203917,0.23222670957420705,23228103,21924343,67.52039031686456,77.79840663515873,NaN,NaN,31.720037957649165,31.60054695195878
2006-09-15T09:30:00-04:00,25.52,25.7,25.50999,25.58,1597200,1560775,59.5525507532473,66.73423256649555,NaN,NaN,56.97693531268518,85.51096476635324,-0.018007812810049595,0.20971694356164505,0.22772475637169465,21630903,22400983,69.20293714606032,76.9781397708799,NaN,NaN,29.746595971290972,31.33569681186338
2006-09-18T09:30:00-04:00,25.66,25.66,25.39,25.48,1403000,1577380,55.480734527476635,65.9194275087841,NaN,NaN,17.329795828965764,68.31707527058316,-0.030947496055223844,0.18904038630266484,0.2199878823578887,20227903,22286223,68.28572245012856,76.09059573845593,NaN,NaN,26.798885260489392,30.687580875952808
2006-09-19T09:30:00-04:00,25.48,25.55,25.42,25.53999,1275700,1598550,57.36406750887354,65.08894863173347,NaN,NaN,9.325297953988295,45.96717206671772,-0.03561268582749405,0.1754720250735211,0.21108471090101516,21503603,21772963,64.18809449647463,74.81253902412288,NaN,NaN,24.947723103129693,29.867601194120933
2006-09-20T09:30:00-04:00,25.59,25.72,25.5,25.69,2111200,1676005,61.724468090634424,64.45803313862504,NaN,NaN,68.11935078512191,44.2030666554047,-0.0290209918262343,0.1748084711182223,0.20382946294445659,23614803,22041063,65.35747599843177,73.45789277052494,NaN,NaN,24.699353559763964,29.12928010349851
2006-09-21T09:30:00-04:00,25.60001,25.7,25.38,25.46001,1811200,1681915,52.80745707278961,63.15800356409918,NaN,NaN,-5.549873368410237,29.240301302470193,-0.039903816189602814,0.15394969270745307,0.19385350889705588,21803603,21756163,63.003125054613434,71.79898325781309,NaN,NaN,21.471080437595518,28.035251579798082
2006-09-22T09:30:00-04:00,25.44,25.48,25.38,25.48,1364600,1668845,53.43709451141269,61.688749383902554,NaN,NaN,-54.504830917881556,6.943948056356841,-0.04512474602014932,0.13744757637186922,0.18257232239201854,23168203,22063623,64.48977989485692,70.10110608608659,NaN,NaN,19.136160039042476,26.763952788261566
2006-09-25T09:30:00-04:00,25.47,25.47,25.1799,25.32001,2822700,1756835,47.92582682220736,60.17903715166974,NaN,NaN,-140.70626541403644,-24.663264192243595,-0.05790627498768344,0.11018947865741424,0.16809575364509768,20345503,22087143,64.6069445294078,68.35198674833677,NaN,NaN,15.323667832555667,25.129626366017867
2006-09-26T09:30:00-04:00,25.39,25.42,25.16,25.35001,3256000,1832395,48.98823671149776,59.00672081845533,NaN,NaN,-148.80826414181587,-56.28997661140443,-0.06249991408953132,0.08997086103318352,0.15247077512271484,23601503,22506723,66.71669808348426,66.81343586150612,NaN,NaN,12.598900047838324,23.33952260627793
2006-09-27T09:30:00-04:00,25.41,25.55,25.35001,25.50999,2751300,1854000,54.33821177956189,58.53594985938849,NaN,NaN,-48.081591699885834,-79.53016510840598,-0.05328326640734199,0.08586669211353737,0.13914995852087936,26352803,23054323,69.28965060405594,66.06364060862174,NaN,NaN,11.906312711513621,21.706206907025887
2006-09-28T09:30:00-04:00,25.58,25.58,25.33051,25.45,1040400,1863045,52.13035958589255,57.639204921326545,NaN,NaN,-57.48073528207329,-89.91633749113859,-0.0498102785876576,0.07688711028630735,0.12669738887396495,25312403,23756083,72.25021704603992,66.18450547655497,NaN,NaN,10.66285875023677,20.128585741770298
2006-09-29T09:30:00-04:00,25.45,25.55,25.33,25.38,1591600,1853940,49.597959470740754,56.23003506522582,NaN,NaN,-75.11108901670175,-94.03758911090263,-0.05064465237128164,0.0633915734098629,0.11403622578114454,23720803,23866603,72.6966365438447,66.82726031565701,NaN,NaN,8.865485417657634,18.519571409754203
2006-10-02T09:30:00-04:00,25.2,25.41,25.17999,25.21001,1928900,1912655,44.00714802800233,54.40530512735713,NaN,NaN,-156.20711581054138,-97.13775919020361,-0.06040075650594125,0.03853528014871799,0.09893603665465923,21791903,24155883,73.88104520252749,67.53966449409545,NaN,NaN,5.516652540710171,16.66201157131934
2006-10-03T09:30:00-04:00,25.24001,25.31,25.16,25.24001,2918800,1952675,45.1815594779023,53.31735928241312,NaN,NaN,-166.82247090596337,-100.74060054303311,-0.06233683715326724,0.02101499021307518,0.08335182736634242,24710703,24377723,74.78440503173181,68.30522302846585,NaN,NaN,3.1589347962797207,14.733000603456537
2006-10-04T09:30:00-04:00,25.10001,25.50999,24.34,25.50999,3268900,2030390,54.44227845675991,52.641282342642796,NaN,NaN,-196.38718520129862,-130.40171924331565,-0.043812944806725374,0.0285856463579357,0.07239859116466107,27979603,24703083,76.09052767409798,68.91737569683967,NaN,NaN,4.007340283767062,13.200763414929469
2006-10-05T09:30:00-04:00,25.5,25.52,25.34,25.41,1116100,1918205,51.0055507136359,52.030782339813406,NaN,NaN,-24.141677887221373,-123.7339077643453,-0.03694695332821789,0.02621489950438871,0.0631618528326066,26863503,25013303,77.29797885261634,69.49559296159366,NaN,NaN,3.600162404826506,11.82924898491476
2006-10-06T09:30:00-04:00,25.42,25.42999,25.2,25.27,1665800,1974750,46.57257606528349,51.39448530679961,NaN,NaN,-82.46600241768941,-125.20489044454284,-0.04021697003064965,0.012890640294294542,0.05310761032494419,25197703,25308683,78.41570015902425,70.21916279794335,NaN,NaN,1.8173036976361572,10.398971086732102
2006-10-09T09:30:00-04:00,25.3,25.36,25.19,25.36,1622600,1978180,49.60483204150588,50.84025420198764,NaN,NaN,-72.50035872753605,-108.46353902794176,-0.03489889532697606,0.009483991166224115,0.04438288649320017,26820303,26314363,81.71632336096013,71.47117914540661,NaN,NaN,1.3190031416384438,9.10183280886158
2006-10-10T09:30:00-04:00,25.3,25.39,25.14999,25.27,2463400,1937940,46.747599274989405,49.770477858012995,NaN,NaN,-81.2598217153161,-91.35100918981232,-0.03588439141801475,-0.0004726027793182652,0.035411788638696484,24356903,26243603,80.78032247548471,72.57281103662467,NaN,NaN,0.015207155843319336,7.803743429858971
2006-10-11T09:30:00-04:00,25.17999,25.32001,25.10001,25.31,2001800,1948250,48.176335072902354,49.43968342944962,NaN,NaN,-85.28952995278915,-69.13147814011043,-0.03239109814616303,-0.005077084044007307,0.027314014102155726,26358703,25919423,76.45935357746755,73.53397021682854,NaN,NaN,-0.615201067678829,6.601037073067857
2006-10-12T09:30:00-04:00,25.44,25.4496,25.28999,25.35001,1496100,1975365,49.63199761065558,49.16789079368126,NaN,NaN,-13.291729933541653,-66.96148854937448,-0.02619924663456974,-0.005435044191056448,0.02076420244351329,27854803,26117683,77.26046104521636,74.44616172756851,NaN,NaN,-0.7121911435454858,5.556290184980237
2006-10-13T09:30:00-04:00,25.39999,25.41,25.17999,25.3,638000,1927405,47.82378491684618,49.16060208615546,NaN,NaN,-47.22526604660242,-59.91334127515707,-0.02432573090007466,-0.009642961181580034,0.014682769718494627,27216803,26521503,78.83998349837798,75.46280736820923,NaN,NaN,-1.3030431598267056,4.576385421436388
2006-10-16T09:30:00-04:00,25.25,25.35001,25.17,25.34,2616300,1988070,49.411339828663905,49.19082373738161,NaN,NaN,-48.63534844817934,-55.140339219285735,-0.019457405979699728,-0.009638987756130035,0.009818418223569693,29833103,27124063,80.9647001800798,76.48052180368033,NaN,NaN,-1.3603787953345763,3.728276247611965
2006-10-17T09:30:00-04:00,25.19,25.36,25.17,25.28999,1097600,1979165,47.466753363292675,48.70000527907667,NaN,NaN,-52.61350304414074,-49.41107548505066,-0.018667078873738092,-0.013515430368602921,0.00515164850513517,28735503,27999783,83.54994683536346,77.49911439163087,NaN,NaN,-1.9367388137134585,2.918988381708333
2006-10-18T09:30:00-04:00,25.25,25.42999,25.25,25.39,2107700,1978990,51.57138278018873,48.66007836438354,NaN,NaN,19.612365874510306,-28.430696319590766,-0.01085772007210553,-0.008420501584996742,0.002437218487108787,30843203,28896683,85.69309156221246,78.45931971421463,NaN,NaN,-1.29792897859314,2.3165716159509797
2006-10-19T09:30:00-04:00,25.42999,25.4601,25.34,25.45,1283800,1952620,53.89864800454248,48.96727040251223,NaN,NaN,81.42230227403468,-9.487889878075505,-0.0015869454666151512,0.00045353665383984776,0.002040482120454999,32127003,29751123,87.37991184145739,79.50812509261551,NaN,NaN,-0.0991373979922931,1.9714703282447978
2006-10-20T09:30:00-04:00,25.50999,25.55,25.41,25.53999,2572000,2012990,57.219271750349996,49.91099352553707,NaN,NaN,149.61509301139057,29.880181933523097,0.010031335635970376,0.01457965166541797,0.004548316029447593,34699003,31247563,89.67576158453417,80.63631911990171,NaN,NaN,1.8984905766436289,1.9610446494446307
2006-10-23T09:30:00-04:00,25.55,25.84,25.49001,25.78999,2048700,1974290,64.80385245884005,51.312585881318334,NaN,NaN,249.0406023590441,89.41537209496778,0.032700539782901314,0.04542399075807424,0.012723450975172922,36747703,32630483,91.25843928522656,81.8130358522942,NaN,NaN,6.250841859536749,2.573872822314933
2006-10-24T09:30:00-04:00,25.82001,25.82001,25.63,25.71001,997200,1861350,61.073399459052155,51.78623738148207,NaN,NaN,203.98752607346358,140.73557791848867,0.03997480741024909,0.06269196023798429,0.022717152827735197,35750503,34033483,92.51249512118345,82.98603352708604,NaN,NaN,8.719242526509523,3.4517827800570173
2006-10-25T09:30:00-04:00,25.64999,25.97,25.64999,25.88,2500100,1848790,65.60528673430274,52.82907566867255,NaN,NaN,217.96088827162274,180.40528239791112,0.05307988869976106,0.08906701370243653,0.035987125002675466,38250603,35514963,93.56265928985364,84.1477964154601,NaN,NaN,12.373973230146122,4.726381415784032
2006-10-26T09:30:00-04:00,25.95,26.05,25.87,26.05,1450400,1869290,69.43735932025281,54.462274472598935,NaN,NaN,227.72757057103962,209.66633605731212,0.06903227938810362,0.122277474237805,0.053245194849701374,39701003,37029763,94.42384892867653,85.29123561329241,NaN,NaN,16.82489873101783,6.454741032246003
2006-10-27T09:30:00-04:00,26.02,26.02,25.87,25.96001,1698100,1874615,65.29047540538883,55.58267757001914,NaN,NaN,165.49732810406587,212.8427830758472,0.06918376482165332,0.13972490087676803,0.07054113605511471,38002903,37690543,94.75356696939748,86.22246729960936,NaN,NaN,19.118610359715763,8.26386522188454
2006-10-30T09:30:00-05:00,25.8,25.92,25.8,25.85001,2902200,1923280,60.53170547433412,56.567256584258054,NaN,NaN,113.86002601885282,185.80666780780894,0.05798893259169907,0.14302730179473855,0.08503836920303948,35100703,37361143,91.83826700249308,87.01232048010998,NaN,NaN,19.492460365664073,9.867950242424474
2006-10-31T09:30:00-05:00,25.85001,25.88,25.77,25.83,835700,1819125,59.67956805635271,57.38891608307593,NaN,NaN,91.35405484883526,163.27997356288327,0.04588008292865964,0.14238847286386402,0.09650838993520439,34265003,37064043,89.17333322942129,87.92046188382096,NaN,NaN,19.529192595877547,11.248127721489197
2006-11-01T09:30:00-05:00,25.86,25.86,25.61,25.63,2555100,1783435,51.826392662100226,57.54565858675055,NaN,NaN,48.26477797668904,129.3407515038965,0.022241999454162276,0.12431088925290723,0.10206888979874496,31709903,35755903,78.38767223058765,88.00097696849033,NaN,NaN,17.01455084045897,12.071902452770594
2006-11-02T09:30:00-05:00,25.60001,25.64,25.5,25.59,1346600,1794960,50.3980000104063,57.72953109343341,NaN,NaN,10.99942632777953,85.9951226552445,0.0027768951758069677,0.10554000876850367,0.1027631135926967,30363303,33888363,66.09656456566091,87.09073275901054,NaN,NaN,14.546631796178449,12.425435216114574
2006-11-03T09:30:00-05:00,25.61,25.66,25.381,25.47,1916400,1807490,46.27730367603334,57.50567136824551,NaN,NaN,-13.505487024481816,50.19455962953495,-0.018164015866840938,0.08005809375914552,0.09822210962598646,28446903,31977163,56.35752605822764,85.33307746459253,NaN,NaN,11.140922696597205,12.241933427612093
2006-11-06T09:30:00-05:00,25.39999,25.621,25.39999,25.56,1083700,1780545,49.605337969389765,57.65842741153816,NaN,NaN,-10.328791210869221,25.356796183590543,-0.02548906797007658,0.06636077466339074,0.09184984263346732,29530603,30863143,51.5861681029937,83.0499504122804,NaN,NaN,9.301328073298343,11.821846948424414
2006-11-07T09:30:00-05:00,25.67,25.67,25.55,25.60001,1737200,1744235,51.05688893250834,57.621677850989556,NaN,NaN,9.992778005392635,9.084540814902018,-0.02702812241021954,0.05806468962069289,0.08509281203091243,31267803,30263703,49.1737063470159,80.44142289690922,NaN,NaN,8.224173777639685,11.30789363831231
2006-11-08T09:30:00-05:00,25.55,25.7401,25.55,25.69,808500,1684570,54.24886761896369,57.64669353773393,NaN,NaN,22.2264104424141,3.8768673080470464,-0.02160873643580971,0.05808189148615028,0.07969062792196,32076303,30336983,49.48471637225657,77.73462322053774,NaN,NaN,8.248261127542834,10.870803279630955
2006-11-09T09:30:00-05:00,25.75,25.75,25.49001,25.53999,1308100,1675170,48.56314278062065,57.0283986113247,NaN,NaN,-5.941323284420057,0.4887173856071291,-0.027379016619745025,0.045466857147278716,0.07284587376702374,30768203,30417963,49.84991957386043,74.88992021977533,NaN,NaN,6.522145074671832,10.249566393208223
2006-11-10T09:30:00-05:00,25.45,25.58,25.45,25.55,458700,1666205,48.947654350024855,55.895813032123606,NaN,NaN,-37.73193059124965,-4.356571327746438,-0.029585770268509448,0.03586366093138693,0.06544943119989638,31226903,30973963,52.39469151018659,72.1139382358439,NaN,NaN,5.244106139996087,9.534500642749347
2006-11-13T09:30:00-05:00,25.49001,25.57001,25.41,25.47,1030900,1586935,45.988773952603665,54.818339781663,NaN,NaN,-62.432811115526924,-14.777375308677978,-0.03512008881445898,0.02154932018182265,0.05666940899628163,30196003,31107043,53.00931854634166,69.29228276621235,NaN,NaN,3.288532337204603,8.642219456242955
2006-11-14T09:30:00-05:00,25.44,25.61,25.42,25.53999,911000,1577605,48.89918317690839,53.625046670420545,NaN,NaN,-54.67648362946322,-27.711227635649152,-0.03279788526662632,0.015672052412998738,0.048469937679625055,31107003,31074883,52.831801677546366,66.3829357939047,NaN,NaN,2.458100505554957,7.758773891858955
2006-11-15T09:30:00-05:00,25.60001,25.77,25.60001,25.67,635600,1504000,53.871562115084,52.51320401290849,NaN,NaN,10.485639207880082,-30.059381882555954,-0.021768010426584994,0.021259924646393813,0.04302793507297881,31742603,31008143,52.43933801382363,63.38404215712948,NaN,NaN,3.2050102686831656,7.108236231405271
2006-11-16T09:30:00-05:00,25.64999,25.88,25.64999,25.85001,1568700,1518245,59.71636166293199,52.11505303130442,NaN,NaN,60.232265468598,-16.82466413195234,-0.002618043291469488,0.03975538095864195,0.04237342425011144,33311303,31516763,55.17235227229365,60.55681253590778,NaN,NaN,5.732925462739226,6.911763264452978
2006-11-17T09:30:00-05:00,25.77,25.99001,25.75,25.89,9636199,1871454.95,60.9015831114602,52.14147286252772,NaN,NaN,93.27241889987909,9.376205766273406,0.011687785223310633,0.05698315577924973,0.045295370555939095,42947502,33860882.8,65.12037674580635,58.64839180328729,NaN,NaN,8.150250710653562,7.088690042481633
2006-11-20T09:30:00-05:00,25.89999,25.92999,25.8,25.81,10016301,2269835,57.27137368513244,51.96945897886913,NaN,NaN,70.07777078169919,35.87832214571863,0.014523346019218793,0.06344955307996258,0.04892620706074379,32931201,34407922.4,66.962913987524,57.06193328600892,NaN,NaN,9.108585238629846,7.377246499074235
2006-11-21T09:30:00-05:00,25.82001,25.83,25.72,25.77,1950100,2317480,55.49032792805316,52.23116864072291,NaN,NaN,32.1323257972776,53.24008403106679,0.01254052535184487,0.06460186375054988,0.05206133839870501,30981101,34382742,66.78802131723691,56.23338679219815,NaN,NaN,9.384388420201795,7.663981059235315
2006-11-22T09:30:00-05:00,25.7,25.83,25.67999,25.83,1168500,2250900,57.61935405598714,52.74697964397868,NaN,NaN,37.39883308790409,58.62272280707159,0.013994763254490082,0.06955479246681762,0.055560029212327534,32149601,34464141.6,67.08727905001862,56.30415211250941,NaN,NaN,10.230044899851928,8.030561607894832
2006-11-24T09:30:00-05:00,25.69,25.78,25.64999,25.73,262700,2191515,53.06363410502404,53.23171753176373,NaN,NaN,16.263799447491458,49.82902960285029,0.007284326220928221,0.06466543698848781,0.05738111076755959,31886901,34179261.2,64.88378544994637,56.91317064048933,NaN,NaN,9.63985569983945,8.26046076388692
2006-11-27T09:30:00-05:00,25.67,25.67,25.39,25.41,2513900,2232305,41.701190324860676,52.66713555715451,NaN,NaN,-100.00235142520792,11.174075537832888,-0.01824828718165295,0.034570751790493404,0.052819038972146355,29373001,31464361,48.526068052965,56.694592065487264,NaN,NaN,5.1959981539899,7.822680391044488
2006-11-28T09:30:00-05:00,25.41,25.57001,25.36,25.52,1844000,2179395,45.98304795440381,52.304718344432764,NaN,NaN,-94.02188554106,-21.645855726718953,-0.026756627321640643,0.019373254820095553,0.046129882141736196,31217001,31121521,46.917484797711225,56.533433383394076,NaN,NaN,2.962749841684068,7.128404598278714
2006-11-29T09:30:00-05:00,25.50999,25.74001,25.50999,25.74001,1200800,2197650,53.36129859566637,52.24132055705439,NaN,NaN,14.051912204726872,-25.261938445229095,-0.017066896583556007,0.024796261412291187,0.041863157995847194,32417801,31408861,48.45956101129458,56.46020800046822,NaN,NaN,3.5916942940640286,6.623160269105188
2006-11-30T09:30:00-05:00,25.64999,25.73,25.50999,25.61,1155500,2127670,49.093839669747794,52.27922747770632,NaN,NaN,-12.201335038179606,-35.18197207044583,-0.018777479050995118,0.0183913091821033,0.03716878823309842,31262301,31231401,47.54099227367316,56.29528462188341,NaN,NaN,2.6327183902179914,6.053097143549874
2006-12-01T09:30:00-05:00,25.69,25.69,25.39,25.53,889300,2104805,46.623018793662055,52.113182080823265,NaN,NaN,-59.898883977588085,-50.41450875546174,-0.024309566374767205,0.00678183026463941,0.031091396639406615,30373001,30928621,45.94090695453932,55.83430001076575,NaN,NaN,1.0421105206649852,5.337241911709176
2006-12-04T09:30:00-05:00,25.55,25.94,25.55,25.89999,1077500,2062860,57.32122353386527,52.92264276519909,NaN,NaN,89.45971886194135,-12.522094698031893,-0.0031741807883854146,0.027123670653924847,0.030297851442310262,31450501,31344121,48.50238445821277,55.51237614732798,NaN,NaN,3.539773532615994,5.080460714695865
2006-12-05T09:30:00-05:00,25.95,26.03999,25.89999,26.03999,1180200,2067685,60.543742753256296,53.75439702065252,NaN,NaN,176.8760609662456,41.65749460342923,0.018897718444932265,0.05391999949847559,0.035022281053543325,32630701,31626861,50.23055076797314,55.326572510929886,NaN,NaN,6.695657628576724,5.311203130964559
2006-12-06T09:30:00-05:00,25.94,26.09,25.94,26.07001,870700,2024360,61.21991852992673,54.27927962171272,NaN,NaN,165.15234112884525,71.87758038825291,0.03333782246935142,0.0766945591402326,0.04335673667088118,33501401,31843581,51.57205148006435,55.264623472804224,NaN,NaN,9.338691811671799,5.886558656779879
2006-12-07T09:30:00-05:00,26.10001,26.17999,26.00999,26.02,712700,2019570,59.393854169268,54.25624337216529,NaN,NaN,153.77867243489553,105.07358188286794,0.03705417971889539,0.08967446131950041,0.05262028160060502,32788701,32148861,53.474458979156594,55.14334538043729,NaN,NaN,10.858562093719414,6.5968448620569555
2006-12-08T09:30:00-05:00,25.95,26.19,25.9191,26.07001,1684000,2038365,60.6576257414486,54.23881784573589,NaN,NaN,130.26946720758684,143.1072521199029,0.040152871419606245,0.10281137087511283,0.06265849945550658,34472701,32968801,58.22155633592383,54.65057249401711,NaN,NaN,12.476938040724818,7.436858173295222
2006-12-11T09:30:00-05:00,26.2,26.2,26.02,26.12,554200,2043140,61.93299654035719,54.571790906823374,NaN,NaN,135.6993002864321,152.35516840480108,0.042609190911854375,0.11591998809532456,0.07331079718347018,35026901,33684081,61.87594308530401,54.28721742957283,NaN,NaN,14.185470555652621,8.400945656489135
2006-12-12T09:30:00-05:00,26.12,26.13,25.98,26.06,1313100,2057250,59.44228079861554,54.85407325472069,NaN,NaN,103.18815974440673,137.6175881604333,0.03741769981364515,0.12008292195052661,0.08266522213688146,33713801,33900701,62.93337507914799,54.01188555542361,NaN,NaN,14.897352003217886,9.329003706021814
2006-12-13T09:30:00-05:00,26.14999,26.2,25.99001,26.05,2534800,2138440,59.01628299659506,54.95385389333554,NaN,NaN,99.47801753492026,124.48272344164829,0.030810456426138694,0.12117829266955482,0.09036783624341613,31179001,33436221,59.145233204142144,53.44459656643244,NaN,NaN,15.363901283982418,10.191131931444756
2006-12-14T09:30:00-05:00,26.05,26.25,26.03999,26.14999,740500,2143685,61.95244427470031,55.588768905455275,NaN,NaN,110.46969936737422,115.82092882814405,0.03061129112850003,0.12863195015404116,0.09802065902554113,31919501,33262381,57.7442865109655,52.93463235650523,NaN,NaN,16.594122865169656,11.105844921976885
2006-12-15T09:30:00-05:00,26.13,26.16,26.03999,26.06,3579600,2244230,57.92996170309943,56.747966861043764,NaN,NaN,78.92591040347683,105.55221746732204,0.02224517650990565,0.1258271296629232,0.10358195315301755,28339901,32035821,48.93664170735113,52.96395904610424,NaN,NaN,16.53085380668529,11.880846191220943
2006-12-18T09:30:00-05:00,26.14,26.14,26.03,26.03999,1136200,1819230.05,57.04305885114418,57.53796763938236,NaN,NaN,66.34313342609121,91.68098409525388,0.013614000686650127,0.12059945401133021,0.10698545332468008,27203701,30471181,40.458981061510734,52.50263735066135,NaN,NaN,16.236733586552678,12.503115819125476
2006-12-19T09:30:00-05:00,25.98,26.14,25.98,26.06,1170400,1376935,57.73982774862949,57.850719721736866,NaN,NaN,57.40002123230832,82.52335639283419,0.0077921039789876495,0.11672558329841465,0.108933479319427,28374101,29403241,35.888944640132124,51.6047361812926,NaN,NaN,16.17150914441192,13.02717200845211
2006-12-20T09:30:00-05:00,26.05,26.14,26.05,26.08,780800,1318470,58.464993493273504,58.5200878519887,NaN,NaN,61.40676279728079,74.9091054453063,0.0040178044840546295,0.11395573492449529,0.10993793044044066,29154901,28998421,34.30701402623288,50.65945202076115,NaN,NaN,16.30116459159018,13.494885234614692
2006-12-21T09:30:00-05:00,26.02,26.17999,26.02,26.09,2009800,1360535,58.84525348690579,59.39310461579182,NaN,NaN,58.666272815283826,64.54842013488823,0.00107742024245637,0.11128470574351113,0.11020728550105476,31164701,28847461,33.71028957152717,49.785836493403146,NaN,NaN,16.505871452089085,13.92502612282532
2006-12-22T09:30:00-05:00,26.22,26.23,26,26.07001,512400,1373020,57.70789065575226,59.42072369592661,NaN,NaN,55.776939207809015,59.91862589575466,-0.003102489669839781,0.10632917341375503,0.10943166308359481,30652301,29309941,37.30794193670917,48.98623345615289,NaN,NaN,16.40486145273216,14.279288312812012
2006-12-26T09:30:00-05:00,26.10001,26.17,26.02,26.17,549200,1274785,61.69594280205041,59.50302369941191,NaN,NaN,60.54466551527044,58.758932313590506,-0.00017627796798422302,0.10921131562361452,0.10938759359159875,31201501,30109501,43.06132411456296,48.47414583805216,NaN,NaN,17.336531206794575,14.716037297666665
2006-12-27T09:30:00-05:00,26.27,26.28,26.12,26.25999,983500,1231760,64.90358965168099,59.76614306525148,NaN,NaN,104.84716266706778,68.2483606005424,0.006412741375396644,0.11740352031084456,0.11099077893544791,32185001,30871681,47.96371723391387,48.21640767761284,NaN,NaN,19.0419824182463,15.33402945774947
2006-12-28T09:30:00-05:00,26.3,26.3,26.17999,26.25,736600,1208550,64.2602503201027,60.1137427903111,NaN,NaN,121.37103830564114,80.24121570221448,0.008557024343040301,0.12168705936424828,0.11313003502120798,31448401,31330381,50.714017220421205,48.019233266274604,NaN,NaN,20.313235968352423,16.04534467354989
2006-12-29T09:30:00-05:00,26.14999,26.28,26.10049,26.12,959500,1198750,56.42258185115081,59.81123965528984,NaN,NaN,84.33193021114207,85.37434718138613,0.00012476477865784596,0.1132859909945303,0.11316122621587245,30488901,31195221,49.877485375950236,47.42322819770506,NaN,NaN,19.32289507109942,16.51356615891411
2007-01-03T09:30:00-05:00,26.07001,26.41,26.07001,26.287,2059700,1257270,62.713994083348176,59.86702519407491,NaN,NaN,173.29661756467698,108.87828285275971,0.0044589280265712045,0.11873488624908646,0.11427595822251525,32548601,31574481,52.257257473314915,46.73617922542012,NaN,NaN,20.29043582122018,17.053118967814978
2007-01-04T09:30:00-05:00,26.24001,26.35001,26.13,26.33,845300,1245660,64.14922525973984,60.20323551272664,NaN,NaN,168.687312175346,130.50681218477482,0.00864408065489107,0.1250810590411291,0.11643697838623802,33393901,32012961,54.92205408109333,46.16394201127336,NaN,NaN,21.5188623523534,17.691082308463322
2007-01-05T09:30:00-05:00,26.34,26.34,26.07001,26.14,1360200,1254660,54.218261209036015,59.860519670758144,NaN,NaN,63.26308145223723,122.1899959418087,-0.002372773580596302,0.11347101141049265,0.11584378499108895,32033701,31982701,54.69516715262037,45.84608015045038,NaN,NaN,19.45858997655937,17.943583403905613
2007-01-08T09:30:00-05:00,26.06,26.22,26.03999,26.17999,965200,1259385,55.770278948812226,59.41893643319471,NaN,NaN,17.159275800382886,101.34764344075707,-0.007657596970611288,0.10627178877782484,0.11392938574843613,32998901,32292801,56.67060276060823,45.769388453996285,NaN,NaN,18.264040540752603,17.989362994883756
2007-01-09T09:30:00-05:00,26.2,26.28999,26.16,26.24001,2437600,1345630,58.067909426101174,59.42878984198054,NaN,NaN,99.50218030466782,104.38169345946221,-0.00777693428097849,0.10420821789721302,0.11198515217819151,35436501,33282321,62.31699865121525,46.72512823570087,NaN,NaN,17.962509962529893,17.985526847404632
2007-01-10T09:30:00-05:00,26.24001,26.39999,26.10001,26.35001,1042000,1313530,61.967363364084086,59.780525878619116,NaN,NaN,136.85936503306837,97.0942429531405,-0.0014450570857682254,0.11017883082098123,0.11162388790674946,36478501,34068301,66.09626753474782,48.55636298378925,NaN,NaN,18.91083929665718,18.117714340154997
2007-01-11T09:30:00-05:00,26.50999,26.60001,26.28999,26.55,1866300,1379135,67.82561260203008,60.50093908243344,NaN,NaN,255.30353700600548,114.41748791927239,0.01434463405959667,0.1295546804812453,0.11521004642164863,38344801,35058481,70.15689914240744,51.00407401966606,NaN,NaN,21.747945233872485,18.63631875354321
2007-01-12T09:30:00-05:00,26.60001,26.60001,26.47,26.50999,1347000,1380830,65.64704254428797,61.013942586077334,NaN,NaN,230.2570160865029,147.8162748461255,0.01988564442066222,0.1400671019474764,0.12018145752681418,36997801,36051301,73.57442336847122,53.80888897268307,NaN,NaN,23.31543316746685,19.304763669818016
2007-01-16T09:30:00-05:00,26.5,26.59,26.47,26.53,1941800,1351180,66.23123534331535,61.54151271867801,NaN,NaN,190.492836171789,182.48298692040674,0.022497524073109176,0.14830336261820065,0.12580583854509148,38939601,37239441,76.97292998557135,56.89907757368623,NaN,NaN,24.748906204364367,20.08249831761035
2007-01-17T09:30:00-05:00,26.56,26.67,26.53,26.61,1573700,1392840,68.53504584136321,62.31488094622165,NaN,NaN,189.12781319953427,200.40811349938002,0.026913707541054988,0.15944797297141022,0.13253426543035524,40513301,38254801,79.40994532892157,59.90636353027283,NaN,NaN,26.66896843948601,21.023422620735445
2007-01-18T09:30:00-05:00,26.67,26.6899,26.53999,26.57001,664400,1247080,66.10717122875143,62.629968690986004,NaN,NaN,154.90824790792314,204.017890074351,0.02451046678554253,0.16317234891228338,0.13866188212674085,39848901,38928881,80.85830383792825,62.606147796227496,NaN,NaN,27.54468814179824,21.955031980887274
2007-01-19T09:30:00-05:00,26.52,26.64999,26.52,26.61,773400,1228940,67.35267716960287,62.804903513694704,NaN,NaN,126.91663968302223,178.34051060975435,0.023007197332915702,0.16742087879288547,0.14441368145996977,40622301,39384381,81.79044059943678,65.02234232233627,NaN,NaN,28.63483054673635,22.909288918865713
2007-01-22T09:30:00-05:00,26.5,26.62,26.48,26.58,2141800,1277510,65.41071217370671,62.88707936038071,NaN,NaN,96.74417784437784,151.63794296132932,0.017627779979139058,0.16644840643389358,0.14882062645475452,38480501,39680921,82.39161212105083,67.28502767238125,NaN,NaN,29.00466080985576,23.78005633186429
2007-01-23T09:30:00-05:00,26.67,26.69,26.5386,26.63,646700,1270805,67.11266921511339,63.65065702923518,NaN,NaN,104.07755745995387,134.35488721896232,0.015166101990242653,0.16777825394255785,0.1526121519523152,39127201,39718441,82.47046789806042,69.61309785253198,NaN,NaN,29.793414199493455,24.639107455811313
2007-01-24T09:30:00-05:00,26.7,26.73,26.58,26.73,2088000,1274715,70.26406697986086,64.18994795041465,NaN,NaN,111.04946684589244,118.73921794823396,0.017818568313819533,0.17488536234458962,0.1570667940307701,41215201,39858821,82.78117032173807,71.79337734170505,NaN,NaN,31.408353719952697,25.60614263640294
2007-01-25T09:30:00-05:00,26.78999,26.78999,26.50999,26.56,2132700,1355730,59.77724087688884,63.87766335163958,NaN,NaN,80.64052096474428,103.88567255959818,0.006266053195055826,0.16489936052458987,0.15863330732953404,39082501,39705541,81.09107076025558,73.66259281878807,NaN,NaN,29.614209216711817,26.178723576447066
2007-01-26T09:30:00-05:00,26.52,26.59,26.41,26.49001,3111700,1483855,56.06709814828351,64.0097231330144,NaN,NaN,31.13014298911624,84.72837322081699,-0.007216144207714381,0.14961312706989105,0.15682927127760543,35970801,38775241,71.5438833201296,74.86607254503873,NaN,NaN,26.950272873717214,26.288944904628515
2007-01-29T09:30:00-05:00,26.61,26.67999,26.50999,26.56,1691600,1519260,58.819614115066216,64.22753278774684,NaN,NaN,59.07704075820784,77.19494580358298,-0.012251426382286879,0.14151498829974685,0.15376641468203373,37662401,38611621,69.98327215583404,75.81697750184058,NaN,NaN,25.549169233948703,26.18326266595997
2007-01-30T09:30:00-05:00,26.45,26.58501,26.44,26.53999,2545300,1609695,57.70644774759809,64.20171409642519,NaN,NaN,30.958413194742896,62.571116950540784,-0.01744405418842665,0.1319613469465004,0.14940540113492706,35117101,37809601,62.756946968003035,75.84840238161112,NaN,NaN,24.081109680226156,25.882955096569425
2007-01-31T09:30:00-05:00,26.57001,26.67999,26.47,26.64999,1858800,1654660,61.967554696244335,64.20172776300807,NaN,NaN,60.31140692806806,52.423504966975905,-0.014126404057130948,0.13174739606351338,0.14587380012064433,36975901,36961741,56.155499347989455,75.13834751112839,NaN,NaN,24.071113547873722,25.624120589612897
2007-02-01T09:30:00-05:00,26.73,26.84,26.69,26.75,2725800,1687965,65.38246883517371,64.02721749394689,NaN,NaN,128.96700877837094,62.08880252970124,-0.006253934817386397,0.13805638159891132,0.1443103164162977,39701701,37085581,56.86915194645452,74.18922271141746,NaN,NaN,25.121102718095607,25.552260893681854
2007-02-02T09:30:00-05:00,26.81,26.86,26.74001,26.8,1108000,1701100,66.978823347918,64.12234469420618,NaN,NaN,142.54888566850164,84.37255106557832,0.0008834515668047493,0.14541463087480366,0.1445311793079989,40809701,38053361,62.065586689040444,73.36716294860098,NaN,NaN,26.477090079632898,25.684379348817718
2007-02-05T09:30:00-05:00,26.74001,26.75999,26.67,26.71001,1195900,1692885,61.48341272480025,63.78321450716938,NaN,NaN,95.03138646391828,91.56342020672041,-0.0017498996528321487,0.14234380474195873,0.14409370439479088,39613801,38443641,63.951777695537736,72.43708064217002,NaN,NaN,25.962120247824632,25.72405662010442
2007-02-06T09:30:00-05:00,26.8,26.8,26.64,26.67,1561800,1722715,59.15936458965662,63.11352298919034,NaN,NaN,87.73495358796782,102.91872828536539,-0.007175720076682268,0.13512405429893803,0.1422997743756203,38052001,39030621,66.63853880337388,71.52483731891661,NaN,NaN,24.84220895485064,25.598078382211025
2007-02-07T09:30:00-05:00,26.63,26.7294,26.58,26.61,1713200,1686495,55.75572177658987,62.37413374260736,NaN,NaN,37.3718668456329,98.33082026887836,-0.015326735808415981,0.12314135461510034,0.13846809042351632,36338801,38903201,65.49732312014348,70.42762441050341,NaN,NaN,22.881421774162902,25.209984581061292
2007-02-08T09:30:00-05:00,26.58,26.61,26.49001,26.56,1844200,1726605,53.0182520810895,61.35024623628498,NaN,NaN,-56.247607179098836,61.2878970773844,-0.02408545208038579,0.10836127532303408,0.13244672740341987,34494601,37861781,56.91779624808165,68.65100695683519,NaN,NaN,20.422645708235216,24.526079027800424
2007-02-09T09:30:00-05:00,26.58,26.64,26.42,26.52,782700,1672425,50.86662276813818,60.31138270731579,NaN,NaN,-87.92104600782478,15.19391074211911,-0.03207284464233798,0.0923556716004974,0.12442851624283538,33711901,36442221,47.73829270049083,66.17576985536661,NaN,NaN,17.73252676726965,23.555571562010314
2007-02-12T09:30:00-05:00,26.55,26.55,26.45,26.46001,922316,1651190.8,47.73761718503739,58.92745041945323,NaN,NaN,-124.19165687138675,-28.65069792494189,-0.04036068872834042,0.07397765533240985,0.11433834406075027,32789585,35077377.8,40.90727571021773,63.20697041337785,NaN,NaN,14.509250480832463,22.263239978984906
2007-02-13T09:30:00-05:00,26.45,26.64999,26.45,26.55,770018,1592601.7,52.46169655556895,57.655852532003806,NaN,NaN,-61.94963695351068,-58.5876160332376,-0.03873902413379157,0.0659145638935108,0.10465358802730237,33559603,34178898.2,37.1396603861913,59.94686256083879,NaN,NaN,13.045385643867997,20.946403645396778
2007-02-14T09:30:00-05:00,26.64,26.74001,26.59,26.71001,1683371,1598085.25,59.475907652146816,57.63432873023652,NaN,NaN,63.72276280426643,-53.31743684151089,-0.02643447492246913,0.07161049437421596,0.09804496929668509,35242974,33959732.8,36.26231622033813,56.7448086651304,NaN,NaN,13.934610155439419,19.944718861117156
2007-02-15T09:30:00-05:00,26.64999,26.89,26.64999,26.87,980100,1613870.25,65.03163447689994,58.27465275370912,NaN,NaN,152.1385973809984,-11.64019592949145,-0.0080201522349609,0.08801977900298397,0.09603993123794487,36223074,34305427.4,38.72125226153967,54.400335018088256,NaN,NaN,16.6149454923901,19.469036951299007
2007-02-16T09:30:00-05:00,26.83,26.91,26.78,26.91,1131100,1631755.25,66.27647132189213,58.80728541133954,NaN,NaN,168.7487850462009,39.69377028131369,0.005619146945706074,0.10306386492007746,0.09744471797437139,37354174,35033882,43.654205934515765,52.51968743085123,NaN,NaN,19.160375576360096,19.424942469164876
2007-02-20T09:30:00-05:00,27.27,27.27,26.82001,27.05,1113900,1580360.25,70.26617474619334,59.70440876838206,NaN,NaN,234.8508111765889,111.50226389090881,0.021919518508176944,0.12484411610959256,0.10292459760141562,38468074,36169579.8,50.36304351202963,51.63440861256742,NaN,NaN,22.725923680063715,19.896511213578997
2007-02-21T09:30:00-05:00,27.03,27.03999,26.89,26.89999,837200,1589885.25,61.825928651558556,59.69429262233308,NaN,NaN,145.86545198109,153.06528167782895,0.020475586573331553,0.12851908081808006,0.1080434942447485,37630874,36983834,54.542089492402695,51.51916505145408,NaN,NaN,22.897713639929336,20.32525441734333
2007-02-22T09:30:00-05:00,26.85001,26.92999,26.73,26.8,2054600,1588215.25,56.91819527967652,59.08970165408328,NaN,NaN,69.65328480090815,154.2513860771573,0.011131053809232641,0.1219573115062893,0.11082625769705666,35576274,37050494,54.87702387052575,51.37687018888774,NaN,NaN,21.36321232113101,20.473534117884427
2007-02-23T09:30:00-05:00,26.82001,26.82001,26.71001,26.82001,1364800,1549820.25,57.642819029338696,58.42284420275619,NaN,NaN,45.83190807636215,132.99004821623004,0.004957183088941455,0.11702273655823348,0.11206555346929202,36941074,37194094,55.6353587728283,50.917568194872594,NaN,NaN,20.39351493604981,20.462102806193766
2007-02-26T09:30:00-05:00,26.82001,26.84,26.7,26.81,989314,1443700.95,57.12519073024449,58.11154263171649,NaN,NaN,40.450943265781675,107.3304798601462,-0.000832838274029496,0.11102450562675514,0.11185734390078464,35951760,36913611.2,53.73575450142597,50.18785225243603,NaN,NaN,19.466301041276655,20.319845411205606
2007-02-27T09:30:00-05:00,26.69,26.71001,25.81,26.2,4679898,1593115.85,35.94310160395757,56.45323813273798,NaN,NaN,-211.5430769337277,18.05170223808285,-0.0443668097158911,0.05639883175592075,0.10076564147181186,31271862,35474368.8,45.2062612665703,48.65697528552149,NaN,NaN,9.568217260323989,18.783898532508232
2007-02-28T09:30:00-05:00,26.14999,26.36,25.97,26.3,2056300,1568665.85,39.87881536855889,55.3191733893072,NaN,NaN,-194.26309142947483,-49.974006444030124,-0.06386417288155302,0.020935425369870586,0.08479959825142361,33328162,34613826.4,41.01429183386395,46.90818733650152,NaN,NaN,3.6875499108944285,16.627277300849116
2007-03-01T09:30:00-05:00,25.8,26.3,25.8,26.3,2121095,1581780.6,39.8788153685589,54.38064219555502,NaN,NaN,-184.22976040831443,-100.75061548587465,-0.07350997866454193,-0.0070878750792537915,0.06642210358528813,33328162,34164204,38.98040754598749,45.62694528635194,NaN,NaN,-0.6125972941033685,14.164438072998761
2007-03-02T09:30:00-05:00,26.07001,26.17999,25.85001,25.89,2159900,1553485.6,30.86229383185298,52.951761557248936,NaN,NaN,-191.24215980638093,-148.16542906242324,-0.10247306811270038,-0.061669231555587345,0.04080383655711303,31168262,33009641.6,34.2795195449483,44.66560434667033,NaN,NaN,-8.233128434182092,10.964785714830068
2007-03-05T09:30:00-05:00,25.73,26.05,25.5,25.8,2244600,1610315.6,29.29642719300071,51.634533700674886,NaN,NaN,-199.56034688378628,-196.16768709233685,-0.12137035444404717,-0.11090910649794594,0.010461247946101235,28923662,31604022,29.59945054696668,43.857902549295254,NaN,NaN,-14.568489742704768,7.317174935182235
2007-03-06T09:30:00-05:00,25.86,26.10001,25.85001,26,2027900,1651915.6,36.951879950232794,50.52668965743659,NaN,NaN,-126.00439893177726,-179.05995149194675,-0.1141842133174215,-0.13226901870067564,-0.018084805383254143,30951562,31539962,29.40243313315281,43.30524345979251,NaN,NaN,-16.85399211431781,3.8641510709679436
2007-03-07T09:30:00-05:00,26.11,26.11,25.89999,25.89999,1882900,1667970.6,34.91600019942243,48.77241055367056,NaN,NaN,-110.48640247184554,-162.3046137004209,-0.10991188297518531,-0.1554746591022358,-0.04556277612705048,29068662,30688062,26.843567052320807,42.63247566207699,NaN,NaN,-19.353323798707077,0.5473689467286555
2007-03-08T09:30:00-05:00,25.74001,26.87,25.69,26.14,1756100,1670115.6,43.028322304218726,47.20074539847905,NaN,NaN,-48.66870598659587,-135.19240281607716,-0.08574004193346989,-0.15273782854388784,-0.06699778661041796,30824762,30187382,25.442128571472963,41.68396682707222,NaN,NaN,-18.484641821692453,-2.17148973447436
2007-03-09T09:30:00-05:00,26.22,26.24001,26.08,26.22,1510500,1653430.6,45.46818957277473,45.714439559256384,NaN,NaN,-53.82888045395575,-107.70974694559216,-0.060378746440858624,-0.14247121966149123,-0.08209247322063261,32335262,30420782,27.346346126718288,40.51911969794383,NaN,NaN,-16.960054260483933,-4.284141809618584
2007-03-12T09:30:00-04:00,26.23,26.28999,26.16,26.25,1086800,1668635.6,46.39528855818872,44.00937626011319,NaN,NaN,-39.44056044265437,-75.68578965736576,-0.038654672773643844,-0.1304108141876874,-0.09175614141404356,33422062,31320462,34.310827087694705,39.372532810491336,NaN,NaN,-15.474068769340018,-5.882702803864503
2007-03-13T09:30:00-04:00,26.14999,26.17999,25.75,25.75,1423300,1693684.8,35.547931093458686,42.132376434534635,NaN,NaN,-94.1359018137111,-69.31209023375253,-0.05408441112593161,-0.15936165532145807,-0.10527724419552646,31998762,31529902,35.85241346052662,38.03755595107162,NaN,NaN,-18.069692477559922,-7.623701328678134
2007-03-14T09:30:00-04:00,25.86,25.92999,25.57001,25.8,2661600,1788263.9,37.130898628700365,40.718998102322054,NaN,NaN,-105.31548438832206,-68.27790661704782,-0.05676960226940976,-0.17623924703228866,-0.1194696447628789,34660362,32648242,43.47981416967459,37.22346954386796,NaN,NaN,-19.48278158010855,-9.317855650311051
2007-03-15T09:30:00-04:00,25.89,26.13,25.89,26.13,1459600,1777075.35,46.4746867506703,39.92127436813145,NaN,NaN,-51.28205128205453,-68.80057567613957,-0.0333276606926754,-0.16112922062872315,-0.12780155993604775,36119962,33707282,49.592280499782674,36.791821095793274,NaN,NaN,-17.281529307058488,-10.455523315560685
2007-03-16T09:30:00-04:00,26,26.06,25.86,25.92999,1909800,1823560.35,42.36494243778967,38.86697091867039,NaN,NaN,-65.35568202112498,-71.10593598957341,-0.028486643326802008,-0.16340986409455027,-0.13492322076774826,34210162,34082262,51.58864819197241,36.63845635940373,NaN,NaN,-16.97741808956322,-11.387222568989618
2007-03-19T09:30:00-04:00,26,26.14,26,26.10001,785600,1806285.35,46.68123982611082,39.63398079168133,NaN,NaN,-37.018479860215294,-70.62151987308559,-0.011878722061383545,-0.1497716233444777,-0.13789290128309414,34995762,34397002,53.2618321276551,37.213854278052644,NaN,NaN,-15.20940245648983,-11.933248267203934
2007-03-20T09:30:00-04:00,26.10001,26.35001,26.08,26.35001,1460200,1823600.35,52.33397040701986,40.52363472299998,NaN,NaN,11.976889382430754,-49.39896163385723,0.016365062691971022,-0.11743657291813037,-0.1338016356101014,36455962,35288442,57.71907052226424,38.407052755795526,NaN,NaN,-11.722729944568606,-11.903174221113174
2007-03-21T09:30:00-04:00,26.35001,26.62,26.23,26.60001,1103200,1836900.35,57.21846154483678,41.7621808784484,NaN,NaN,83.70890654923164,-11.594083446346488,0.05038409609983026,-0.07082151548531357,-0.12120561158514383,37559162,35868202,60.3663458280104,39.934619775940014,NaN,NaN,-7.0886580804174395,-11.215386201013784
2007-03-22T09:30:00-04:00,26.67,26.73,26.57001,26.73,2610482,1864694.45,59.54007564427222,43.810593865049775,NaN,NaN,145.95641726004328,27.85361026207308,0.07846601615272043,-0.02312309139424329,-0.10158910754696372,40169644,36678138.4,63.7783543884246,42.04167940761689,NaN,NaN,-2.6176223546104396,-9.987134222956163
2007-03-23T09:30:00-04:00,26.62,26.78999,26.53,26.78999,1196200,1856264.45,60.60263788884229,46.04675177189561,NaN,NaN,158.06679316200646,72.53810529869936,0.09670849153328033,0.019296506869636687,-0.07741198466364364,41365844,38109274.8,68.87687306345158,44.84720958736582,NaN,NaN,1.240564616553678,-8.383177245883328
2007-03-26T09:30:00-04:00,26.67999,26.67999,26.47,26.60001,1162600,1864928.75,55.62089834884826,47.38025308608241,NaN,NaN,130.80516859872517,106.10283499048747,0.09165457327240958,0.037156231926868344,-0.05449834134554124,40203244,39150771.2,71.96911891053642,47.88768714289322,NaN,NaN,2.8853179802749644,-6.773392213575001
2007-03-27T09:30:00-04:00,26.60001,26.60001,26.41,26.48,1892100,1725538.85,52.67518942098855,48.64876660190857,NaN,NaN,93.58104152473278,122.42366541894788,0.07652028417469296,0.041152013872824966,-0.035368270301867996,38311144,39521807.6,72.99837654110101,51.184459249234656,NaN,NaN,3.3078218589897244,-5.333218774637183
2007-03-28T09:30:00-04:00,26.42,26.56,26.28999,26.42999,1289100,1687178.85,51.45231776942579,49.25048056370907,NaN,NaN,66.01497386635883,118.88487888237333,0.06015400962954652,0.03982424173506516,-0.020329767894481363,37022044,39414384,72.17210162907212,54.5223144676346,NaN,NaN,3.2812788247077376,-4.102576260445052
2007-03-29T09:30:00-04:00,26.53,26.62,26.38,26.58,1844700,1673359.1,54.839086412786706,49.91983033799564,NaN,NaN,83.84512683577621,106.46262079751989,0.056501203590076966,0.050296736593114844,-0.006204466996962121,38866744,39153804,70.09933075556215,57.576099083980594,NaN,NaN,4.273713842573349,-2.9059633885852802
2007-03-30T09:30:00-04:00,26.56,26.68201,25.91,26.64999,2088700,1669799.1,56.36847514631261,50.632200808575924,NaN,NaN,48.623003589093095,84.57386288293722,0.05577297230702796,0.06351174838682283,0.00773877607979487,40955444,39071724,69.42298899303512,60.08411064864776,NaN,NaN,5.53985430795232,-1.6994180033656232
2007-04-02T09:30:00-04:00,26.63,26.75,26.59,26.72,1076000,1611369.1,57.90416346038835,52.2290745490709,NaN,NaN,109.41969635226769,80.29676843364572,0.05679014137775413,0.07872645280198753,0.021936311424233405,42031444,39437364,70.775677561881,62.578629513030215,NaN,NaN,7.035044713153536,-0.45163761529145763
2007-04-03T09:30:00-04:00,26.78,26.97,26.73,26.89999,2240000,1621974.1,61.64208878255116,53.97987384577453,NaN,NaN,137.88104299392367,89.15676872748391,0.06573720233972212,0.10410781434888605,0.03837061200916393,44271444,40629424,74.70459988075666,64.80897134953607,NaN,NaN,9.447505043688635,0.9625256217056986
2007-04-04T09:30:00-04:00,26.85001,27.03999,26.85001,27.02,2778800,1666769.1,63.94118262070118,55.22748069363388,NaN,NaN,146.09025542356665,105.17182503892545,0.07520793433446035,0.13238052992723937,0.05717259559277902,47050244,42635064,79.65945653047979,66.95662678030016,NaN,NaN,12.178996252786144,2.564878569002905
2007-04-05T09:30:00-04:00,27.03,27.09,26.92,27.09,794800,1618704.1,65.2495434987978,56.86209505513445,NaN,NaN,142.41883871338857,116.88656741444792,0.08114748630366583,0.1586069534723613,0.07745946716869548,47845044,44430724,82.89074949665918,69.19249115920636,NaN,NaN,14.84114752209299,4.318631276587203
2007-04-09T09:30:00-04:00,27.10001,27.16,27.02,27.02,326500,1559504.1,62.79578809427887,58.01313421714646,NaN,NaN,132.90501367848503,133.74296943232633,0.0754429774441167,0.17176318897384135,0.09632021152972466,47518544,45743344,84.79256873814491,71.4446866313842,NaN,NaN,16.409590923586187,6.045911226158486
2007-04-10T09:30:00-04:00,27.13,27.14999,27.05,27.14999,1157200,1563024.1,65.39804971437181,58.94628273910017,NaN,NaN,127.75717986923156,137.4104661357191,0.0753301814014756,0.19048293828156915,0.11515275688009355,48675744,47072204,86.43633547138565,73.49591984203573,NaN,NaN,18.514316899762086,7.827112036673286
2007-04-11T09:30:00-04:00,27.05,27.13,26.88,26.97,1958415,1589779.85,59.22130133270935,59.089342723948214,NaN,NaN,93.08024979433114,128.4503074958006,0.05877418342658938,0.18862048616333027,0.1298463027367409,46717329,47561381,86.99366338885086,75.39787109638146,NaN,NaN,18.5856137033027,9.364040846191774
2007-04-12T09:30:00-04:00,26.91,27.09,26.87,27,735690,1493484.35,59.90110742585357,59.11513070834689,NaN,NaN,84.20286589881876,116.07282959085103,0.046046910781911005,0.18740494121412965,0.14135803043221865,47453019,47641936,87.0877540895743,77.06282821789216,NaN,NaN,18.833482839290212,10.716818273777264
2007-04-13T09:30:00-04:00,27.03999,27.10001,26.98,27.09,632508,1452129.75,61.95041682553071,59.211400632396064,NaN,NaN,92.36302461405444,106.0616667709842,0.040110703267385056,0.19149640951644997,0.15138570624906492,48085527,47690032.6,87.14753803854742,78.3678757161133,NaN,NaN,19.614152349875386,11.987865998934138
2007-04-16T09:30:00-04:00,27.24001,27.24001,27.10001,27.14999,1402900,1426784.75,63.29689403455614,59.759686038518055,NaN,NaN,107.60894669994858,101.0024533752769,0.03673560112119459,0.19730520765055815,0.16056960652936356,49488427,48084009.2,87.6518791998895,79.48807287963851,NaN,NaN,20.644144010778476,13.224477143483329
2007-04-17T09:30:00-04:00,27.27,27.39999,27.22501,27.39999,957450,1435377.25,68.32706996519366,60.87767750596125,NaN,NaN,137.15053068439087,102.88112353830877,0.04718494507080834,0.21955078786787396,0.17236584279706563,50445877,48438035.8,88.10363377739674,80.56701982508821,NaN,NaN,23.093101171286413,14.634280576026626
2007-04-18T09:30:00-04:00,27.28,27.34,27.24001,27.33,717392,1398236.85,65.61581984075018,61.88935622534158,NaN,NaN,117.31989484830142,107.72905254910282,0.04522285385331873,0.22889441011371403,0.1836715562603953,49728485,49040267,88.85086483351712,81.75836005397716,NaN,NaN,24.357147271511913,16.023261532524526
2007-04-19T09:30:00-04:00,27.17999,27.36,27.17999,27.35001,255914,1355872.55,66.03082884189782,62.68876639884951,NaN,NaN,105.91329024732426,112.07113741880391,0.04122488929838336,0.23520266788337452,0.19397777858499116,49984399,49546543,89.45075368806054,83.1406045491556,NaN,NaN,25.512950626212366,17.37893140305136
2007-04-20T09:30:00-04:00,27.39999,27.60001,27.39999,27.60001,1448396,1297768.25,70.77660372200555,63.71791843997043,NaN,NaN,148.17352179654623,123.23323685530227,0.05074392332502903,0.25740768274127745,0.20666375941624843,51432795,50215996.6,90.20152220081867,84.6247854925687,NaN,NaN,28.01239208473784,18.897997214720856
2007-04-23T09:30:00-04:00,27.53,27.62,27.46001,27.53999,2432458,1359581.15,68.30918995249647,64.46113461797815,NaN,NaN,136.15960498952265,128.94336851321708,0.0483357388992427,0.2670834330403018,0.2187476941410591,49000337,50118378.6,89.2045893132545,85.94113633195253,NaN,NaN,29.366299075912682,20.393468909176832
2007-04-24T09:30:00-04:00,27.49001,27.60001,27.35001,27.53,695900,1336246.15,67.88498069239787,64.90705546868149,NaN,NaN,114.84179258855596,124.48162089405011,0.04166067681755886,0.2708235401630077,0.22916286334544883,48304437,49690090.6,84.77745095536812,86.66062569442478,NaN,NaN,30.355725144390323,21.816648371350187
2007-04-25T09:30:00-04:00,27.64999,27.72,27.58,27.67,863932,1284837.75,70.63698371216447,65.38532697521458,NaN,NaN,139.69669488712492,128.9569809018148,0.042138194555111974,0.2818356065393388,0.23969741198422684,49168369,49578067.4,83.60864123763929,86.94271031636474,NaN,NaN,32.01632951433217,23.27374567749047
2007-04-26T09:30:00-04:00,27.69,27.69,27.49001,27.56,995012,1270133.35,65.86145590410518,65.42903500416512,NaN,NaN,109.70618564293369,129.7155599809367,0.031023321062514903,0.2784765633123705,0.24745324224985557,48173357,49215859,79.77875443648054,86.7204249549234,NaN,NaN,32.07805803446912,24.531504585630277
2007-04-27T09:30:00-04:00,27.46001,27.52,26.77,27.5,675351,1211665.9,63.34580518757228,65.46832193940035,NaN,NaN,25.43888258553053,105.16863213873356,0.016345396130545253,0.2678849874130371,0.25153959128249187,47498006,48428901.2,72.0558344713966,85.81065822158425,NaN,NaN,31.415738614044663,25.514966589689475
2007-04-30T09:30:00-04:00,27.49001,27.66,27.39999,27.39999,836282,1149045,59.281248221594005,65.03140754705909,NaN,NaN,77.54387171731426,93.44548548429188,-0.002386938530248517,0.24855591811968125,0.25094285664992977,46661724,47961178.6,67.85169989579401,84.48318425189913,NaN,NaN,29.677167864564012,26.10956677181441
2007-05-01T09:30:00-04:00,27.39,27.39,27.17999,27.28999,2412681,1215879.05,55.09395615599198,64.73659717729355,NaN,NaN,11.564912787489376,72.79010952407856,-0.023310616871269396,0.22180458556084304,0.24511520243211243,44249043,47150099.8,61.18498762094226,82.63970741133423,NaN,NaN,26.946880677953306,26.229183044119967
2007-05-02T09:30:00-04:00,27.36,27.4792,27.3,27.3,1805618,1194159.95,55.40266628921696,64.41527995324807,NaN,NaN,30.230967786398637,50.89696410393331,-0.03679904573843823,0.19911639525906466,0.2359154409975029,46054661,46527358.2,56.58769159922153,80.46113151916617,NaN,NaN,24.783883424511146,26.022711669890136
2007-05-03T09:30:00-04:00,27.48,27.58,27.32001,27.39999,2080262,1159233.05,58.4736467775771,64.1669392355371,NaN,NaN,51.47594565194154,39.250916105734866,-0.03909393269109179,0.18704802513363816,0.22614195782472996,48134923,46519671.4,56.53122802073707,78.27425223217972,NaN,NaN,23.727641615708873,25.69484451929281
2007-05-04T09:30:00-04:00,27.45,27.45,27.28999,27.39999,3004200,1269703.05,58.4736467775771,63.822421574324316,NaN,NaN,25.71389754979783,39.30591909858833,-0.04054464788513035,0.17546114796831702,0.21600579585344737,48134923,46647054.8,57.29174718834479,76.10567137421224,NaN,NaN,22.854841397958044,25.28912978767356
2007-05-07T09:30:00-04:00,27.41,27.52,27.39,27.45,2766901,1391723.1,60.06861554459989,63.23253197285334,NaN,NaN,50.05866333103744,33.808877421332966,-0.038106272866135715,0.16837295477077774,0.20647922763691345,50901824,47495074.8,62.05170401870437,74.24481924859137,NaN,NaN,22.517119258157308,24.893128283456953
2007-05-08T09:30:00-04:00,27.35001,27.36,27.25999,27.25999,1690900,1418408.1,51.91053188124615,62.25358283288876,NaN,NaN,-23.53500367287585,26.788894129259916,-0.04858877885907717,0.14574325406306698,0.19433203292214415,49210924,48487451,66.7253860580649,72.66442790748762,NaN,NaN,19.853387971054303,24.173165381685145
2007-05-09T09:30:00-04:00,27.3,27.38,27.24001,27.3,1094500,1375212.35,53.34732378168873,61.34761818573097,NaN,NaN,-27.5139566544545,15.239909241089288,-0.0518302497787089,0.12954422069875804,0.18137447047746694,50305424,49337603.6,70.12043742650906,71.28369103166251,NaN,NaN,18.013471088384183,23.293209054070722
2007-05-10T09:30:00-04:00,27.27,27.3,27.05,27.13,1547080,1415781.85,46.9312276069616,59.64437703465641,NaN,NaN,-113.30989159923786,-17.717258209146593,-0.0636474728895893,0.10181512936548032,0.16546260225506962,48758344,49462287.8,70.59431251742362,69.88317605427716,NaN,NaN,14.41215336522762,22.02448681280742
2007-05-11T09:30:00-04:00,27.11,27.2,27.03999,27.2,657500,1417031.45,49.618214713262326,58.3093073747111,NaN,NaN,-127.14038275640497,-48.288114270387155,-0.06475902818999163,0.0845138170175801,0.14927284520757172,49415844,49718472,71.59124877431148,68.62508030149552,NaN,NaN,12.149391075132678,20.61375885028246
2007-05-14T09:30:00-04:00,27.25,27.25,27.10001,27.10001,1065800,1400176.45,46.03281724426828,56.74843855698756,NaN,NaN,-124.2712721091119,-83.15410135841702,-0.06980297449214734,0.06201912709238755,0.1318221015845349,48350044,49208116,66.73714304778227,67.3364868795251,NaN,NaN,9.127719047802312,18.972896021356725
2007-05-15T09:30:00-04:00,27.10001,27.38,27.10001,27.28,1898400,1447223.95,52.66364141099331,55.46462839261819,NaN,NaN,-62.22397037245639,-90.89189469833312,-0.05902049067701594,0.05804648823826497,0.11706697891528091,50248444,49415620,67.69619236454426,66.19988338858973,NaN,NaN,8.468352648555072,17.472246968099345
2007-05-16T09:30:00-04:00,27.35001,27.56,27.27,27.56,918400,1457274.35,60.74411592214729,55.099104108192634,NaN,NaN,46.074125160924595,-76.1742783352573,-0.0323666184967992,0.07660870579428192,0.10897532429108112,51166844,49587904,68.50805769554324,65.39483362137992,NaN,NaN,10.639603967487492,16.49615511086908
2007-05-17T09:30:00-04:00,27.53,27.53,27.16,27.49001,1198850,1504421.15,58.075432153525,54.72264889147497,NaN,NaN,6.401072385068386,-52.23208553839606,-0.01942388168125217,0.0846954721895159,0.10411935387076807,49967994,49829834,69.66113665847068,65.2237837775995,NaN,NaN,11.502503470268307,15.78277630506897
2007-05-18T09:30:00-04:00,27.55,27.69,27.49001,27.69,1166300,1490316.35,63.068290852553226,54.993151936543484,NaN,NaN,125.31381287373542,-1.7412464123679796,0.0015202652987170717,0.1060196854941644,0.10449942019544733,51134294,50173524,71.27048392418345,65.46798263677017,NaN,NaN,13.959558040161674,15.522316552939357
2007-05-21T09:30:00-04:00,27.66,27.66,27.44,27.48,2122577,1474822.3,55.5828529346058,55.02807313501591,NaN,NaN,74.98745163233781,38.11049833592195,0.0002135453826821454,0.10476635192380002,0.10455280654111787,49011717,50305858.6,71.88881463313072,66.23254170906934,NaN,NaN,13.45239748261867,15.22661382860783
2007-05-22T09:30:00-04:00,27.50999,27.57001,27.42,27.53,1093350,1494694.8,56.89466777775359,55.134644669911374,NaN,NaN,63.67413610535575,63.29011963148439,0.0016210194638777153,0.10657908087096502,0.1049580614070873,50105067,50277183.2,71.52956293004061,67.29981823269928,NaN,NaN,13.488648945848839,14.978333131070832
2007-05-23T09:30:00-04:00,27.5,27.66,27.45,27.45,3732146,1638105.5,54.13954384845253,54.825065889259626,NaN,NaN,78.53862210417448,69.78301902013436,-0.0036440752847695934,0.1004029673011253,0.1040470425858949,46372921,49318398.6,60.62122742534269,67.59196104731397,NaN,NaN,12.636766330728669,14.643823588164809
2007-05-24T09:30:00-04:00,27.47,27.62,27.33,27.33,1728218,1674765.8,50.21173165025715,54.234929094451054,NaN,NaN,32.59643209088652,75.022090961298,-0.01535980290795294,0.08484728895095373,0.10020709185890667,44644703,48253740.4,51.27106616538132,67.16191240281658,NaN,NaN,10.670079209884387,14.076145819839034
2007-05-25T09:30:00-04:00,27.56,27.56,27.45,27.5,407210,1661358.75,55.1733645044699,53.88526830587033,NaN,NaN,71.46244326075882,64.25181703870268,-0.011962373841121574,0.0852541245575047,0.09721649839862627,45051913,47037264.2,43.092547627303006,65.80768694628792,NaN,NaN,10.58730598587447,13.577740129272668
2007-05-29T09:30:00-04:00,27.45,27.73,27.45,27.60001,1502740,1694681.65,57.835463046552256,54.30847767482077,NaN,NaN,116.98945180983273,72.65221707420167,-0.0037097434180334843,0.09257931912608441,0.0962890625441179,46554653,46545851.4,40.2961833881902,63.919886755582574,NaN,NaN,11.369636802130161,13.262296796823739
2007-05-30T09:30:00-04:00,27.57001,27.78999,27.56,27.73,1207318,1634413.5,61.071454466416476,54.86020129515846,NaN,NaN,152.59291217510113,90.43597228815074,0.009075125447579116,0.10763296935359179,0.09855784390601267,47761971,46077232.2,37.77853553232479,61.609750905997984,NaN,NaN,13.06429554424389,13.234010903598046
2007-05-31T09:30:00-04:00,27.78999,27.88,27.73,27.77,1545300,1621397.6,62.036962108187325,55.9391823309603,NaN,NaN,176.4461680020585,110.01748146772755,0.018266873999430153,0.12139143640530037,0.10312456240587022,49307271,46664102.2,42.614054867296424,59.61116107384604,NaN,NaN,14.726927526794558,13.447284706911834
2007-06-01T09:30:00-04:00,27.81,28.03,27.78999,27.89999,1677500,1601259.5,65.06899080008083,57.042809194304475,NaN,NaN,190.31298245613272,141.5607915407768,0.030425995367289974,0.14115705661498268,0.1107310612476927,50984771,47932115.8,51.40201098273559,58.169072660162044,NaN,NaN,17.090906045284456,13.967802040965065
2007-06-04T09:30:00-04:00,27.91,28.02,27.88,28,511100,1476604.5,67.23706113241623,58.5573980434579,NaN,NaN,179.43019720606017,163.15434232983705,0.0418250067353184,0.1630123196668407,0.12118731293152231,51495871,49220907.4,58.378591108060704,57.57203323589622,NaN,NaN,19.74883287806103,14.793663589121632
2007-06-05T09:30:00-04:00,27.87,27.92,27.77,27.83,1942000,1435359.45,60.377057372272915,59.10835632640645,NaN,NaN,115.89222471409238,162.934896910689,0.034823305811260585,0.16471644519559803,0.12989313938433744,49553871,49820751,61.172448943638074,57.10605156297435,NaN,NaN,19.931797888054554,15.527682774683479
2007-06-06T09:30:00-04:00,27.67,27.78,27.61,27.64999,2511600,1476394.45,54.08458228354507,58.63267535222057,NaN,NaN,54.64759129806525,143.3458327352818,0.015937251462971258,0.1498147037130515,0.13387745225008024,47042271,49676811,60.12940504907837,56.50757637394114,NaN,NaN,18.060221183352905,15.889473975921968
2007-06-07T09:30:00-04:00,27.45,27.67999,27.3,27.3,2088479,1526093.4,44.39642374140876,57.6556033227837,NaN,NaN,-36.41697144008487,100.77320484685313,-0.020291697912365125,0.10851282985962385,0.12880452777198897,44953792,48806115.2,54.11822300286201,55.39736825568338,NaN,NaN,12.88444818690247,15.460184577490612
2007-06-08T09:30:00-04:00,27.3,27.56,27.28,27.46001,626700,1480074.4,48.90292951625364,56.64379179876231,NaN,NaN,-41.333931996612904,54.44382195630401,-0.03289839908004706,0.08768152892193015,0.12057992800197721,45580492,47725259.4,47.73816423223164,53.71648827768682,NaN,NaN,10.235261575195675,14.713767005734192
2007-06-11T09:30:00-04:00,27.55,27.6198,27.46001,27.61,1237600,1509079.4,52.76730893331396,56.442681512955744,NaN,NaN,0.044403838657565205,18.566663282823487,-0.030602739488660158,0.08232650364115202,0.11292924312981217,46818092,46789703.6,43.011523445431806,51.65382462142262,NaN,NaN,9.400750121946878,13.954764593764576
2007-06-12T09:30:00-04:00,27.35001,27.52,27.28,27.35001,1028900,1507234.4,46.23938836107674,55.68159012605025,NaN,NaN,-85.22108946471118,-21.655999552937228,-0.045181127127747495,0.05645283422012781,0.1016339613478753,45789192,46036767.8,39.61222672632675,49.37401489258592,NaN,NaN,6.378650586090235,12.872462592668242
2007-06-13T09:30:00-04:00,27.50999,27.62,27.35001,27.56,1587400,1491684.4,51.46233347201546,55.4903608134476,NaN,NaN,-37.10444791843051,-40.00640739623638,-0.03947561492763871,0.052289442688326915,0.09176505761596562,47376592,46103632,40.06523221693782,47.905729520556996,NaN,NaN,5.727138195683815,11.85170196452761
2007-06-14T09:30:00-04:00,27.60001,27.62,27.48,27.60001,1941919,1542860.35,52.41099760837161,55.647451239027205,NaN,NaN,-12.880543227347102,-35.299121753688816,-0.03211339323441373,0.051623316072948455,0.08373670930736218,49318511,46976575.8,45.78348515900979,47.51375944867332,NaN,NaN,5.5373403467377,10.949650304843336
2007-06-15T09:30:00-04:00,27.57001,27.59,27.45,27.49001,2190900,1592462.85,49.54396166769023,55.24535103640009,NaN,NaN,-45.02797425242552,-36.03793020485134,-0.03359881278359109,0.04173819332787332,0.0753370061114644,47127611,47285999.6,47.68865007980531,47.8420524809949,NaN,NaN,4.462499372484966,10.02291445736357
2007-06-18T09:30:00-04:00,27.42,27.53,27.35001,27.35001,850300,1576662.85,46.08837240218012,54.40627313323065,NaN,NaN,-87.42134078745993,-53.53107913007484,-0.0423898457327567,0.022349698945518526,0.06473954467827522,46277311,47177843.4,47.06607554117671,48.325616206208224,NaN,NaN,2.4650532683872948,8.943220001795531
2007-06-19T09:30:00-04:00,27.35001,27.35001,27.14999,27.14999,1081800,1524624,41.62172629304155,53.01700683513245,NaN,NaN,-161.8337219609424,-68.8536056293211,-0.05903277630342527,-0.009051425701006366,0.04998135060241891,45195511,47059107.2,46.350675755853544,48.93791193646028,NaN,NaN,-0.6970003913591337,7.566045659916293
2007-06-20T09:30:00-04:00,27.31,27.37,27,27.12,1084800,1524196.5,40.98043627909392,51.51296927591149,NaN,NaN,-162.7940337078219,-93.99152278719939,-0.06873920924784611,-0.03594266095738874,0.032796548290457375,44110711,46405931,42.52169425741433,48.93131475004013,NaN,NaN,-3.4073318941687796,5.998420295046997
2007-06-21T09:30:00-04:00,27.03,27.28999,26.99899,27.2,1541500,1414664.2,43.4820430690245,49.9710444379789,NaN,NaN,-141.37378942864524,-119.69017202745901,-0.06641317720266612,-0.05021992321287527,0.016193253989790844,45652211,45672671,38.66061851251678,48.021215287881645,NaN,NaN,-4.910022867486985,4.440071271827857
2007-06-22T09:30:00-04:00,27.25,27.25,26.92999,27.05,1672700,1411888.3,40.05393723958677,48.02939273134822,NaN,NaN,-153.65383493377013,-141.41534416372792,-0.07119405726619481,-0.07279931759295266,-0.0016052603267578576,43979511,45043051,35.66589907615791,46.39888014274573,NaN,NaN,-7.238218779926762,2.771744121577197
2007-06-25T09:30:00-04:00,27.05,27.14999,26.86,26.92999,792900,1431172.8,37.50618039535268,46.39575866156821,NaN,NaN,-156.31918214144696,-155.19491243452535,-0.0781026331272565,-0.09923355173582848,-0.021130918608571986,43186611,44424911,32.96600526557643,44.38413416574133,NaN,NaN,-9.978453466001735,0.9502873233516356
2007-06-26T09:30:00-04:00,27.05,27.10001,26.84,26.86,1165400,1414305.8,36.065371391212274,45.108672169258725,NaN,NaN,-145.20208311254666,-151.8685846648462,-0.08261247728778309,-0.12439651521830086,-0.04178403793051776,42021211,43790051,30.41908443367143,42.261968407497974,NaN,NaN,-12.679178322410129,-0.9967791974714737
2007-06-27T09:30:00-04:00,26.74001,27.12,26.71001,27.07001,712697,1389574.75,43.12545979580873,45.017889030287286,NaN,NaN,-120.76206195198236,-143.46219031367826,-0.06732519299103884,-0.1259405291693163,-0.058615336178277466,42733908,43514690.4,29.359568933246692,40.493493116811166,NaN,NaN,-12.936968809769182,-2.7025205706568602
2007-06-28T09:30:00-04:00,27,27.21001,27,27.02,824100,1353514.75,41.937828868422976,44.52038184115652,NaN,NaN,-81.94309814237792,-131.5760520564248,-0.05687125802782042,-0.129704408713053,-0.07283315068523258,41909808,42766209.8,26.643073770694755,38.9867009409871,NaN,NaN,-13.49496766163552,-4.244298726510954
2007-06-29T09:30:00-04:00,27.09,27.25999,26.91,27.05,1666494,1352964.45,42.95274830665864,43.81934179639543,NaN,NaN,-73.7651784920761,-115.598320768086,-0.04475911295143209,-0.1287820418745227,-0.0840229289230906,43576302,42685568,26.360084217946934,37.79731242473819,NaN,NaN,-13.666989372741552,-5.5903973902581825
2007-07-02T09:30:00-04:00,27.13,27.48,27.13,27.27,4223566,1538587.75,49.87263921580823,44.07885971459053,NaN,NaN,-6.081932045710191,-85.55087074893864,-0.020015201362642093,-0.10904193062639322,-0.08902672926375113,47799868,43608219.4,34.882208331196026,37.45945396794313,NaN,NaN,-11.742663969506564,-6.469292615865094
2007-07-03T09:30:00-04:00,27.37,27.39,27.2,27.25999,1070961,1495035.8,49.5779601696013,43.94426162156095,NaN,NaN,-0.7459377267567273,-56.65964167178064,-0.0032841421368566825,-0.09313190693482198,-0.0898477647979653,46728907,44549758.6,42.229482918055545,37.614043303737255,NaN,NaN,-10.26512055828385,-7.011553750496345
2007-07-05T09:30:00-04:00,27.23,27.28999,26.41,27.24001,2972877,1518099.65,48.9561748399685,43.69748856667501,NaN,NaN,-96.16323686394124,-51.73987665417244,0.006918769807145342,-0.08119930253903362,-0.08811807234617897,43756030,44754183,43.71440237401792,37.46625167623783,NaN,NaN,-9.207869682936698,-7.325313169416396
2007-07-06T09:30:00-04:00,27.16,27.39999,27.14999,27.39999,655400,1446445.7,53.937596493453185,44.011319625658075,NaN,NaN,26.253036617031356,-30.100649702290582,0.023963969507251548,-0.05816311046211453,-0.08212707996936608,44411430,45254507.4,47.28572061246576,37.43747099999929,NaN,NaN,-6.828392692270531,-7.25432452982413
2007-07-09T09:30:00-04:00,27.39999,27.4001,27.2825,27.39999,1885870,1509404.2,53.93759649345318,44.57197848932044,NaN,NaN,44.66105165466835,-6.415403672941695,0.03414007649013087,-0.039451984356702496,-0.07359206084683337,44411430,45421533,48.46137624267374,37.53713533582051,NaN,NaN,-4.87600002346889,-6.914563886059096
2007-07-10T09:30:00-04:00,27.24001,27.31,27.00999,27.14999,1853510,1540199.7,45.831403620499714,44.87266972699603,NaN,NaN,-26.085997955804153,-10.416216854960487,0.023445092796469003,-0.044285694851247115,-0.06773078764771612,42557920,44373143.4,42.11262241877496,37.2344172403149,NaN,NaN,-5.406517322619003,-6.699128662710511
2007-07-11T09:30:00-04:00,26.92,27.28,26.92,27.28,1142680,1545888.7,50.036711447000506,45.519546524703635,NaN,NaN,-21.053646490110573,-14.477758607631255,0.02442707684322807,-0.03719694159368103,-0.0616240184369091,43700600,43767482,38.93890433447714,36.97850367439081,NaN,NaN,-4.603069616352111,-6.3996916560878825
2007-07-12T09:30:00-04:00,27.25999,27.63,27.24001,27.50999,1291000,1531068.7,56.47416616610028,46.447555317351906,NaN,NaN,108.57203881398755,26.469296527954498,0.039001296602117534,-0.012872397684262182,-0.051873694286379717,44991600,44014596,40.8960567786542,37.13817783625776,NaN,NaN,-1.8245907732480822,-5.7461058156821965
2007-07-13T09:30:00-04:00,27.5,27.71001,27.42,27.7,1355600,1501752.75,60.950577393905895,47.940172471231854,NaN,NaN,169.5004733650926,55.11878387756676,0.058690539653947604,0.021489480281054796,-0.03720105937289281,46347200,44401750,43.92837176671576,37.728354457011896,NaN,NaN,2.0441093689974643,-4.633217932156531
2007-07-16T09:30:00-04:00,27.64,27.78,27.55,27.59,700700,1427242.75,57.277994630443764,49.3524449165955,NaN,NaN,171.65371274592366,80.51731609581782,0.06127393262193759,0.039391356404529176,-0.02188257621740841,45646500,44648764,45.837686669628155,38.64776027158702,NaN,NaN,4.06943115882553,-3.3899823477305224
2007-07-17T09:30:00-04:00,27.67,27.78999,27.45,27.46001,1364200,1452937.75,53.19859831711018,50.57624683987392,NaN,NaN,131.34523228418743,112.00356214381614,0.05158491363791935,0.042598565829990775,-0.008986347807928573,44282300,44993640,48.475674557997124,39.93751670903885,NaN,NaN,4.473953690519215,-2.2665629136948455
2007-07-18T09:30:00-04:00,27.49001,27.5,27.32001,27.47,693605,1433528,53.47285343535251,51.31534638555561,NaN,NaN,70.43762066924317,130.3018155756869,0.043527323112458445,0.045422806082644485,0.0018954829701860396,44975905,45248701,50.39976334769919,41.440387738642606,NaN,NaN,4.877450063035041,-1.2459896313048617
2007-07-19T09:30:00-04:00,27.48,27.61,27.47,27.56,1249500,1441763,55.97578626051564,52.31805762784795,NaN,NaN,99.11507568330165,128.4104229495497,0.04192151625668839,0.05429737829104653,0.012375862034358137,46225405,45495462,52.257298047167545,43.26997518696209,NaN,NaN,5.9559257691740575,-0.21714457409358756
2007-07-20T09:30:00-04:00,27.46001,27.50999,27.24001,27.39999,1204362,1424906.1,50.74872914704793,52.874913402161475,NaN,NaN,39.95881534664425,102.50209134586005,0.02839313971565432,0.047867286678926035,0.019474146963271717,45021043,45230230.6,50.086080532560594,44.964689209434496,NaN,NaN,5.318613602732822,0.5736780225958994
2007-07-23T09:30:00-04:00,27.14,27.55,27.12,27.39999,1333100,1407926.1,50.74872914704793,52.93749125439287,NaN,NaN,27.309153376882477,73.63317947205181,0.018247858006029676,0.04228396947080881,0.024036111464779138,45021043,45105139.2,49.05095960349479,45.97674287174156,NaN,NaN,4.806130297109991,1.1783140618121983
2007-07-24T09:30:00-04:00,27.31,27.5,27.07001,27.2,2000460,1468304.1,44.69839336347728,52.588950768241155,NaN,NaN,-13.695458677491878,44.62504127971595,-0.0020496181196518817,0.021474088815214287,0.02352370693486617,43020583,44852795.8,46.943316872242995,46.313445297040666,NaN,NaN,2.5079675505926904,1.3682645602094115
2007-07-25T09:30:00-04:00,27.48,27.48,27.03999,27.2,1806400,1500354.1,44.69839336347729,52.28482351992035,NaN,NaN,-28.4234155485695,24.85283403615342,-0.014878699704953396,0.004925332303674423,0.01980403200862782,43020583,44461731.4,43.80218427107396,46.31971543254466,NaN,NaN,0.6571414311613127,1.2666755417739688
2007-07-26T09:30:00-04:00,26.89,27.28,26.56,26.8,2815149,1605476.7,35.01496609964684,50.9332070632199,NaN,NaN,-172.6525480700638,-29.500690714519685,-0.04784736858421923,-0.04000517872164622,0.007842189862573012,40205434,43257737.2,35.84886069489545,45.50279686700393,NaN,NaN,-4.428451608482694,0.45308594888015974
2007-07-27T09:30:00-04:00,26.85001,26.85001,26.42999,26.44,3511292,1739836.3,28.938623599127283,49.14756614219663,NaN,NaN,-246.47345464234527,-86.7871447123176,-0.08904910812567061,-0.10346919529451526,-0.014420087168844645,36694142,41592357,28.216903548707947,44.05676310314923,NaN,NaN,-11.267266643714253,-1.221250135776185
2007-07-30T09:30:00-04:00,26.46001,26.64999,26.27,26.5,1047880,1708905.6,31.08514304505755,48.09426181537933,NaN,NaN,-227.0888338112886,-137.66674214995183,-0.10624493385406544,-0.14722625448642646,-0.04098132063236101,37742022,40136552.8,23.50591561162983,42.72771261692458,NaN,NaN,-15.838200890025862,-3.3093859578118527
2007-07-31T09:30:00-04:00,26.57001,26.81,26.28,26.28,3203319,1657893.25,27.772515943445413,46.503962136553966,NaN,NaN,-180.74921031603495,-171.07749247766043,-0.12511967645038527,-0.1973809161953426,-0.07226123974495732,34538703,38440176.8,19.434233299513025,41.33452182871285,NaN,NaN,-20.85517033394011,-5.815926582973033
2007-08-01T09:30:00-04:00,26.45,26.73,26.31,26.67,1454250,1677057.7,39.98271246023408,45.32600115756352,NaN,NaN,-128.51519648827434,-191.0958486656014,-0.10484333843704977,-0.20331541279126952,-0.09847207435421976,35992953,37034650.8,16.832582976959472,39.61570227144894,NaN,NaN,-20.799690090687807,-7.956464226932287
2007-08-02T09:30:00-04:00,26.71001,26.89,26.62,26.7,1618697,1609348.7,40.8116046805541,43.88750310660982,NaN,NaN,-86.19336430845614,-173.80401191327988,-0.08382618052220894,-0.20325480000698093,-0.11942861948477199,37611650,36515894,15.982175611528461,37.619545403221274,NaN,NaN,-20.472953713401683,-9.744534153570772
2007-08-03T09:30:00-04:00,26.82001,26.92999,26.45,26.64999,4452754,1799216.4,39.824213618079206,42.64080446286949,NaN,NaN,-85.22913583563302,-141.55514815193743,-0.06836143965262526,-0.20488041905055354,-0.1365189793979283,33158896,35808844.8,14.878820599202626,35.40819782676231,NaN,NaN,-20.532440476745343,-11.285663628309996
2007-08-06T09:30:00-04:00,26.71001,27.34,26.61,27.34,3834504,1896648.1,55.73655118660069,42.822086810690244,NaN,NaN,-3.2576898996689705,-96.78891936961348,-0.009805376362054419,-0.14877569985049632,-0.1389703234884419,36993400,35659120.4,14.648203571569056,32.9919498991603,NaN,NaN,-14.398993457264787,-11.730425032446394
2007-08-07T09:30:00-04:00,26.94,27.57001,26.94,27.27,7232871,2165616.15,54.171563523898556,42.87199467415782,NaN,NaN,27.029394277419627,-55.233198450922565,0.02421017316544155,-0.10870760703163995,-0.1329177801970815,29760529,34703485.6,13.237860640047288,30.337528277185175,NaN,NaN,-10.352958301509032,-11.533644070883915
2007-08-08T09:30:00-04:00,27.45,27.75,27.32001,27.75,4798910,2348427.65,62.042048183542754,43.30529909723118,NaN,NaN,84.71331005886908,-12.58749714149387,0.07610558799859066,-0.037785795198843175,-0.11389138319743383,34559439,34416782.8,12.838487472958718,27.52189895045597,NaN,NaN,-3.7561206224753727,-10.422569292539837
2007-08-09T09:30:00-04:00,27.36,27.50999,27.03,27.25,1764900,2372122.65,52.02012097162711,43.396112798986834,NaN,NaN,24.570254023765262,9.565226524950404,0.07377254204517125,-0.021675705640969767,-0.09544824768614102,32794539,33453360.6,11.574788742389131,24.771092394015152,NaN,NaN,-2.1751691834341416,-9.244369276953309
2007-08-10T09:30:00-04:00,26.99001,27.34,26.73,27.10001,2941230,2451404.15,49.44011012870784,43.30264001196254,NaN,NaN,-9.151324702608797,24.780788751555257,0.05974112754150403,-0.02077183825926099,-0.08051296580076502,29853309,32792243.2,10.789924211445424,22.038161294583055,NaN,NaN,-1.9551078788962999,-8.203046220088023
2007-08-13T09:30:00-04:00,27.03,27.17,26.81,27.02,1353100,2484024.15,48.07050459223951,43.54350509973126,NaN,NaN,-14.802460587584141,22.471834613972227,0.04344275019960314,-0.02620952805126109,-0.06965227825086423,28500209,31093605,9.08530253762892,19.33401741353919,NaN,NaN,-2.26711092169808,-7.355055463175174
2007-08-14T09:30:00-04:00,26.92999,26.92999,26.55,26.59,1639392,2497783.75,41.42817074751604,43.309917770019744,NaN,NaN,-70.51656377896595,2.962643002695091,0.004143313366299542,-0.0644731365429898,-0.06861644990928935,26860817,30513662.6,8.586537132693664,16.81861404651203,NaN,NaN,-4.953857725771509,-7.01202721497465
2007-08-15T09:30:00-04:00,26.46001,26.84,26.31,26.45,1755649,2550885.95,39.513762034818825,43.63126033681774,NaN,NaN,-92.04900850750931,-32.389820710580594,-0.02901492147574028,-0.1048851017539647,-0.07587018027822443,25105168,28622808.4,7.198886549208183,14.772187321820082,NaN,NaN,-7.716081603091565,-7.112606413277066
2007-08-16T09:30:00-04:00,26.25,26.52,26.0215,26.52,2661200,2621470.95,40.98226929737895,44.49152074383572,NaN,NaN,-115.43837844396222,-60.391547204126084,-0.04311792014583918,-0.1297675804605234,-0.08664966031468421,27766368,27617174.2,6.589001030951266,13.227337141980323,NaN,NaN,-9.399525822373379,-7.439309186005111
2007-08-17T09:30:00-04:00,26.88,27,26.48,26.64999,4028900,2762697.85,43.71507169051799,45.39365850422575,NaN,NaN,-38.22644018099837,-66.206570299804,-0.04061146733595537,-0.13741399448462843,-0.09680252714867306,31795268,28005566,9.768480067132089,12.246091745944767,NaN,NaN,-9.911686272837281,-7.792505912695421
2007-08-20T09:30:00-04:00,26.86,26.99001,26.57001,26.85001,1448695,2768477.6,47.72612625621946,46.818916383709606,NaN,NaN,-13.436519249204826,-65.93338203212814,-0.02326421176891416,-0.12588279185981577,-0.1026185800909016,33243963,28954316.8,17.183958927871146,12.085357862256059,NaN,NaN,-9.086689676965044,-7.977389307591081
2007-08-21T09:30:00-04:00,26.60001,26.85001,26.60001,26.85001,558082,2696358.7,47.72612625621945,47.37201736913713,NaN,NaN,-17.42351728659284,-55.31477273365351,-0.01023618562193998,-0.11541381211832658,-0.1051776264963866,33243963,30230946,25.99703194975963,12.739961360313215,NaN,NaN,-8.432164601005786,-8.042357206650324
2007-08-22T09:30:00-04:00,26.88,26.92999,26.77,26.92,2922400,2752158.7,49.19539575445898,47.97085958870177,NaN,NaN,14.571779884303877,-33.990615055290874,0.0038916091716955925,-0.1003131150317671,-0.10420472420346269,36166363,32443185,38.258489691821936,14.331126651762746,NaN,NaN,-7.471705420054282,-7.96083552285089
2007-08-23T09:30:00-04:00,27.05,27.05,26.78,26.92999,1035200,2663161.25,49.41395124163605,48.65584084752726,NaN,NaN,26.303333405962366,-5.642272685305956,0.014130185705289455,-0.08654199207185087,-0.10067217777714033,37201563,34330224,46.41443486470511,16.583670527870066,NaN,NaN,-6.6231254290686365,-7.769734080881997
2007-08-24T09:30:00-04:00,26.89999,27.14999,26.89999,27.12,1351700,2555181.65,53.510422345930486,48.49683164462225,NaN,NaN,55.797840301908764,13.162583411275472,0.03285060276882232,-0.05960892431611242,-0.09245952708493474,38553263,35681823,51.369583716534244,19.206626252510436,NaN,NaN,-4.728257565822276,-7.3352374358734656
2007-08-27T09:30:00-04:00,27.10001,27.17999,26.99001,27,1260800,2565827.65,50.717088015187294,48.25008339400001,NaN,NaN,49.659632781563296,25.7818138174291,0.0360469308306542,-0.04740086354661699,-0.08344779437727119,37292463,36491523,54.10744885142234,22.125882553322942,NaN,NaN,-3.864342922937891,-6.839395362596955
2007-08-28T09:30:00-04:00,26.92999,26.99001,26.59,26.69,2099100,2510616.7,44.28559043438394,46.981764983345805,NaN,NaN,-38.2535854493037,21.615800184886925,0.017137989486855132,-0.06202530751870228,-0.07916329700555741,35193363,36881403,55.409237453958106,25.16665040910861,NaN,NaN,-4.968457732462035,-6.572118558291966
2007-08-29T09:30:00-04:00,26.7,27.00999,26.64999,26.92,1167800,2496294.2,49.4113873514564,46.79542686761933,NaN,NaN,-13.402396241870942,16.02096495965196,0.019787608997464234,-0.054428785758727116,-0.07421639475619135,36361163,36920363,55.54494129068916,28.30737559113004,NaN,NaN,-4.384833595185444,-6.259649277848177
2007-08-30T09:30:00-04:00,26.75999,26.931,26.73199,26.83,1027300,2466724.35,47.56721729719967,46.661648808225884,NaN,NaN,-24.17334712271297,5.925628853916893,0.01534406697467379,-0.05503631103784912,-0.0703803780125229,35333863,36546823,53.852717863046266,31.383289423387247,NaN,NaN,-4.4445639007905315,-6.000351366839942
2007-08-31T09:30:00-04:00,26.97,27.14,26.84,26.89999,1578700,2323021.65,49.15645162550647,46.73921645345924,NaN,NaN,12.103752842380851,-2.813188637988689,0.016862822337327693,-0.0493018500908633,-0.06616467242819099,36912563,36218683,52.34407155314463,34.47320149592408,NaN,NaN,-4.040469926071884,-5.720368303873077
2007-09-04T09:30:00-04:00,27.03999,27.19,26.96001,27.19,1787300,2220661.45,55.213902672368995,47.72391159094874,NaN,NaN,61.377030445377386,-0.4697091052258699,0.03604174313660804,-0.02111249350743094,-0.05715423664403898,38699863,36500163,53.54626268556634,37.68461046398642,NaN,NaN,-1.8432299382304271,-5.166491394495555
2007-09-05T09:30:00-04:00,26.7,26.94,26.7,26.94,1866800,1952357.9,49.71526004155959,48.45259002000165,NaN,NaN,-15.280141231260222,4.124979738382822,0.03073999971606211,-0.01872923699896134,-0.04946923671502345,36833063,36828103,54.97146314565341,41.0969373637325,NaN,NaN,-1.6228684693819377,-4.660259548050752
2007-09-06T09:30:00-04:00,26.91,27.03,26.8,26.87,1298242,1777324.5,48.26585499870022,48.972846141524606,NaN,NaN,13.95151323455812,9.595761633668635,0.021789293192396017,-0.022232620224528432,-0.04402191341692445,35534821,36662834.6,54.07113486423938,44.48851835182451,NaN,NaN,-1.876605222059928,-4.262594644337778
2007-09-07T09:30:00-04:00,26.77,26.87,26.63,26.75,4722102,1925184.6,45.8007224793457,49.121821197869444,NaN,NaN,-44.45390960816586,5.5396491365780545,0.007780152716575582,-0.03429672252120497,-0.04207687523778055,30812719,35758605.8,49.31238577460503,47.313083045215436,NaN,NaN,-2.8182237493195266,-4.056255945049456
2007-09-10T09:30:00-04:00,26.75,26.89,26.62,26.82001,5020301,2029138.15,47.48587763624323,49.10466058215685,NaN,NaN,-26.28119108198014,-2.1373396482941436,0.003443127890638095,-0.037772965374482936,-0.04121609326512103,35833020,35542697.2,48.22109451950829,49.53002130176095,NaN,NaN,-3.1212834732483414,-3.922688449077868
2007-09-11T09:30:00-04:00,26.85001,27.11,26.82001,27,3407600,2131863.15,51.648167462981824,49.38480638263987,NaN,NaN,76.18374371934783,0.8240030064999445,0.012406570863726554,-0.025707879685462842,-0.038114450549189396,39240620,35650848.6,48.83193879705508,51.16108607656776,NaN,NaN,-2.1763753727534185,-3.67321515246009
2007-09-12T09:30:00-04:00,27.05,27.25,27,27.14,2135800,2156683.55,54.65851273115848,49.7750290238327,NaN,NaN,137.226356621542,31.32530257706039,0.026656265427671244,-0.004794118764600341,-0.031450384192271585,41376420,36559520,53.76696481042941,52.26883429932544,NaN,NaN,-0.48792105435994726,-3.218173138445784
2007-09-13T09:30:00-04:00,27.38,27.38,27.21001,27.22,2333000,2185551.1,56.33159514248951,50.269146445322235,NaN,NaN,181.81467879010305,64.89793568816938,0.039582472691528856,0.018027706672139487,-0.021554766019389368,43709420,38194439.8,61.04660730614,53.313989473713654,NaN,NaN,1.4072729410723572,-2.5573951270860493
2007-09-14T09:30:00-04:00,27.22,27.38,27.14999,27.38,2344400,2169711.1,59.54666615410966,50.70030671733503,NaN,NaN,176.39324301770236,109.06736621334304,0.056016727255022436,0.04846614304938868,-0.007550584205633759,46053820,41242660,70.40351504679032,54.67355599730337,NaN,NaN,3.9921455735446782,-1.621746455567374
2007-09-17T09:30:00-04:00,27.25,27.28999,27.19,27.22,603300,1998431.1,55.172170451372715,51.01852689134828,NaN,NaN,124.77237989190309,139.27808040811968,0.053238921249137004,0.0589980673557875,0.005759146106650494,45450520,43166160,74.55678025769272,56.13422252632268,NaN,NaN,4.965366613619915,-0.6807303028263327
2007-09-18T09:30:00-04:00,27.35001,27.75,27.27,27.75,1828300,2017411.35,64.48060539755302,52.46102796014607,NaN,NaN,223.83307178336779,168.80794602092365,0.08247783082229967,0.1088564346345251,0.02637860381222542,47278820,44773800,77.4100690415129,57.70571049686232,NaN,NaN,9.049323486568737,0.7092773813729629
2007-09-19T09:30:00-04:00,27.81,27.87,27.63,27.77,3788300,2178922.25,64.77782940243716,53.55863096378756,NaN,NaN,227.8327978380981,186.92923426423485,0.09751645329172115,0.14827417042687685,0.05075771713515571,51067120,46711940,80.28109708116924,59.47257876761089,NaN,NaN,12.334894281488804,2.3700797956752258
2007-09-20T09:30:00-04:00,27.78999,27.81,27.67,27.8,1412200,2103412.25,65.24759278558241,54.82151492724346,NaN,NaN,184.32157641332788,187.43061378887984,0.10328217838537336,0.1798604401168724,0.07657826173149905,52479320,48465920,82.4543762536025,61.515554366936335,NaN,NaN,15.115336016154334,4.190830684315098
2007-09-21T09:30:00-04:00,27.69,27.8,27.61,27.66,2317300,2167517.25,61.1489195348293,55.67811977790938,NaN,NaN,138.7894215689617,179.9098494991317,0.09184917838757026,0.19138973471596188,0.09954055632839162,50162020,49287560,83.3785291756995,63.73230133997596,NaN,NaN,16.271743739738646,5.916675406518461
2007-09-24T09:30:00-04:00,27.69,27.71899,27.53,27.64,951200,2147492.25,60.56362120928861,56.06024253054649,NaN,NaN,106.04330214506497,176.16403394976408,0.07768446425053874,0.19664613664156505,0.11896167239102631,49210820,50039620,84.19891390594326,65.92177642714576,NaN,NaN,17.04982478679455,7.507125317986474
2007-09-25T09:30:00-04:00,27.50999,27.67,27.42999,27.60001,6076301,2388267.3,59.34056542490026,56.74776434364225,NaN,NaN,81.18559131404007,147.63453785589854,0.06109732862658512,0.19533333317425772,0.1342360045476726,43134519,49210759.8,79.5393666107883,67.67662667465538,NaN,NaN,17.365071537659624,8.915403349368352
2007-09-26T09:30:00-04:00,27.67999,27.89999,27.63,27.78999,2808800,2423752.3,63.14803342967683,57.810777088712015,NaN,NaN,111.4537268480129,124.3587236578815,0.05839828618056897,0.2072338622733838,0.14883557609281484,45943319,48185999.6,74.08091787031383,69.10589688937499,NaN,NaN,18.721446072746637,10.31626659556525
2007-09-27T09:30:00-04:00,27.84,27.95,27.8,27.89,1408500,2435787.3,65.005800328441,59.18256836364742,NaN,NaN,117.4880469943733,110.9920177740906,0.058670743025745875,0.22217400487499717,0.1635032618492513,47351819,47160499.4,68.97934212671414,70.51067948595421,NaN,NaN,20.4048269921175,11.757489509358427
2007-09-28T09:30:00-04:00,27.89999,27.98,27.85001,27.98,825300,2425687.3,66.6358268970385,60.55042188227565,NaN,NaN,113.19111922407357,105.87235730511296,0.06001885811505675,0.23852683449307222,0.17850797637801546,48177119,46763519.2,67.05429069346958,71.8559077840943,NaN,NaN,22.29888178137808,13.26340269107552
2007-10-01T09:30:00-04:00,27.89999,27.95,27.72,27.89999,5794398,2636472.2,63.79107131751336,61.41777215759934,NaN,NaN,87.75239195562847,102.21417526722564,0.05098406838833616,0.24223806186343566,0.1912539934750995,42382721,45397899.4,60.771286340748915,72.70871832292957,NaN,NaN,23.131969717853547,14.673197980615237
2007-10-02T09:30:00-04:00,27.91,27.92,27.78,27.91,2038300,2649022.2,63.998150512933336,62.084889142011825,NaN,NaN,81.65241263548094,102.30753953151381,0.04154375677197042,0.24318368944006252,0.2016399326680921,44421021,45655199.8,61.503201498573574,73.26130665779702,NaN,NaN,23.879583406353806,15.98839589857789
2007-10-03T09:30:00-04:00,27.86,27.89999,27.75,27.84,6854898,2898427.1,61.35559796355869,62.44374648637391,NaN,NaN,68.75788745607308,93.76837165312584,0.027143410718572708,0.235569196066308,0.2084257853477353,37566123,43979760.6,54.38734144256494,72.7856448103988,NaN,NaN,23.829706624271672,17.108583145105573
2007-10-04T09:30:00-04:00,27.85001,27.91,27.78999,27.89999,5732398,3120134.9,62.774216283373356,62.674285781321316,NaN,NaN,71.37685543540113,84.5461333413314,0.01862289390352323,0.23170440272713932,0.2130815088236161,43298521,43169101,51.294920690405995,71.42074521351421,NaN,NaN,24.152973882472736,18.114924679015168
2007-10-05T09:30:00-04:00,27.96001,28.02,27.8699,28,3707600,3069409.8,65.07593877713757,63.38169780459024,NaN,NaN,89.77639160802629,79.86318781812194,0.0167459372785351,0.23401393042178498,0.21726799314324988,47006121,42934901.4,50.403276024193644,69.69549491112141,NaN,NaN,25.044749533601813,19.10489965824183
2007-10-08T09:30:00-04:00,27.78,27.92,27.78,27.82001,2909100,2963849.75,58.11186220133947,62.92678757628927,NaN,NaN,56.87505376492731,73.68772017998171,0.001224315393974329,0.21879838738571777,0.21757407199174345,44097021,43277761.4,51.72622789373667,67.86093482913739,NaN,NaN,23.904588339654616,19.790569469872228
2007-10-09T09:30:00-04:00,27.91,28.00999,27.821,27.98,4467398,3016839.65,62.004178132067864,62.72866962840575,NaN,NaN,81.57923514501853,73.67308468188924,-0.00034191038444811306,0.2171466840111833,0.21748859439563142,48564419,44106441,54.86026793421926,66.04516131864098,NaN,NaN,24.003199973153016,20.39237382748377
2007-10-10T09:30:00-04:00,27.84,28.12,27.84,28.10001,2556900,3037894.65,64.65712291697619,62.68649320921959,NaN,NaN,106.8554031654366,81.29258782376193,0.0043702889823758195,0.2229514556236012,0.21858116664122537,51121319,46817480.2,63.2631623527823,64.67436032572525,NaN,NaN,24.859941791332442,21.030597822319294
2007-10-11T09:30:00-04:00,28.28999,28.31,28.03,28.17,6015199,3222004.6,66.14188996808036,63.04313395445182,NaN,NaN,159.17199827132646,98.85161639094704,0.009568542002813485,0.23054184414474221,0.22097330214192873,57136518,49585079.6,69.50426289185472,63.68334130545062,NaN,NaN,26.007580521513624,21.741595350775626
2007-10-12T09:30:00-04:00,28.72,28.72,28.13,28.23,3744700,3292019.6,67.40602562411532,63.531877126939435,NaN,NaN,220.5934727262018,125.01503261458215,0.01413959591959571,0.23864779704142336,0.22450820112182765,60881218,52360099,74.23139553123912,62.97137570725746,NaN,NaN,27.332245592330512,22.540259670997752
2007-10-15T09:30:00-04:00,27.73,28.37,27.73,28.14,3811300,3452419.6,63.57185200065826,63.83411188235072,NaN,NaN,100.73717350497878,133.78745656259244,0.008473034817547742,0.23509949464376234,0.2266264598262146,57069918,54954678.4,77.71034156666829,62.84073106124889,NaN,NaN,27.393090503524224,23.233521218501533
2007-10-16T09:30:00-04:00,28.06,28.13,27.97,28.02,3147390,3518374.1,58.77160050197695,63.521509530372164,NaN,NaN,72.0127134208309,131.8741522177549,-0.005247056221020813,0.22006763954993858,0.2253146957709594,53922528,56026300.2,78.97302051894356,63.190166964722444,NaN,NaN,26.061041925567853,23.637452748082435
2007-10-17T09:30:00-04:00,28.13,28.2,27.95,28.12,7207898,3689354,61.388117392890585,63.26310360640428,NaN,NaN,85.14781656742899,127.5326348981534,-0.009243868814994977,0.21375985975221568,0.22300372856721065,61130426,58028121.6,81.12414094792669,64.05765259480906,NaN,NaN,25.65610066000464,23.92583102121418
2007-10-18T09:30:00-04:00,28.03,28.13,28,28.02,12642301,4250859.05,57.46090650161303,62.60775214958817,NaN,NaN,59.77634708042748,107.6535046599736,-0.019679263447167916,0.19840464925825074,0.21808391270541866,48488125,56298443,74.07280520215124,64.55897505971488,NaN,NaN,24.16368883365429,23.959810708705625
2007-10-19T09:30:00-04:00,28.03999,28.07001,27.7,27.73,7279602,4498974.15,47.89230754645986,61.472126165941496,NaN,NaN,-47.557710315388896,54.023268051655464,-0.04568369903778788,0.1609792889081838,0.20666298794597168,41208523,52363904,61.069376159892165,64.5802671896537,NaN,NaN,19.661561126391973,23.34577505408939
2007-10-22T09:30:00-04:00,27.64,27.96001,27.62,27.91,1933100,4548069.15,53.11147943333773,60.694506803113235,NaN,NaN,-58.222328627744204,22.23136762511087,-0.04998488800949291,0.14418187793410553,0.19416676594359844,43141623,49578245,53.86019699846465,64.03433829678876,NaN,NaN,17.4760783825439,22.50724695815432
2007-10-23T09:30:00-04:00,27.99001,28,27.82001,28,1506200,4319564.1,55.510908857316345,60.2770290098102,NaN,NaN,-11.05258919323618,5.618307102297452,-0.046087091101858185,0.13655790206627572,0.1826449931681339,44647823,47723304,49.65655472448212,63.69642495978285,NaN,NaN,16.447148936923988,21.64151866940713
2007-10-24T09:30:00-04:00,27.92999,28.02,27.7,27.92,2160100,4287129.1,52.91862723629072,59.573058363590015,NaN,NaN,-52.420870186408365,-21.895430248470017,-0.047998618686427824,0.12264671981009911,0.17064533849652694,42487723,43994763.4,42.4797203803346,63.06676779477775,NaN,NaN,14.794454700142476,20.663366673797896
2007-10-25T09:30:00-04:00,28.06,28.21001,27.99001,28.14999,2888900,4361149.1,58.865799916098396,59.12947701637294,NaN,NaN,83.82972270686139,-17.08475512318325,-0.03355887671481789,0.12869674260300457,0.16225561931782245,45376623,43372463,41.40413246442179,62.42397182622262,NaN,NaN,15.257148229199755,19.89104975314102
2007-10-26T09:30:00-04:00,28.03999,28.35001,28.03999,28.34,1332301,4386499.15,63.021660973884146,59.48017692869756,NaN,NaN,134.4037303844423,19.307533016782987,-0.012102373627951524,0.14712765228288305,0.15923002591083457,46708924,44472543.2,44.09873581588197,61.87915096351872,NaN,NaN,17.037516273561376,19.48340211320107
2007-10-29T09:30:00-04:00,28.35001,28.45,28.27,28.35001,1526300,4173094.25,63.23240992949322,59.5679077713708,NaN,NaN,166.06932362704254,64.16586346774034,0.0011677183120772372,0.16068967380093113,0.1595219554888539,48235224,45491263.4,46.55000377790238,61.285560666638936,NaN,NaN,18.498672989090643,19.342726524042437
2007-10-30T09:30:00-04:00,28.19,28.34,28.13,28.23,1541980,4148278.25,58.898403085432484,59.15657064054625,NaN,NaN,94.92331131907378,85.36104357020233,0.0003108520793135283,0.15991052058799582,0.1595996685086823,46693244,45900347.6,47.54472368721014,60.16281504766949,NaN,NaN,18.398064864081157,19.207774858333682
2007-10-31T09:30:00-04:00,28.09,28.45,28.09,28.41,2189395,3915003.1,62.99522749211235,58.93180903511997,NaN,NaN,119.46438785699915,119.73809517888382,0.009789629319499893,0.17183670515805716,0.16204707583855726,48882639,47179330.8,50.63775858725323,58.815207597340816,NaN,NaN,19.608805034688935,19.26506488352729
2007-11-01T09:30:00-04:00,28.5,28.5,27.84,27.85001,2617790,3759272.7,47.22458860241897,57.49027781928452,NaN,NaN,-2.38781324243089,102.49458798902538,-0.021997051105918264,0.13455076195615945,0.1565478130620777,46264849,47356976,51.069327493354685,57.160774166063355,NaN,NaN,14.879546048929331,18.638562192870438
2007-11-02T09:30:00-04:00,27.75999,28.03,27.75999,28.03,2536923,3700738.85,51.43315621268266,56.6232281201434,NaN,NaN,-62.104713237357856,63.19289926466534,-0.03070788003765998,0.11816296301500273,0.1488708430526627,48801772,47775545.6,52.131282116305805,55.33369849103747,NaN,NaN,12.660705703976072,17.784582694456958
2007-11-05T09:30:00-05:00,27.50999,28.19,27.50999,28.07001,1753658,3642966.75,52.34293299540077,56.1640375839594,NaN,NaN,-74.33336747908638,15.112361043439563,-0.03336178337115986,0.1071686138387129,0.14053039720987276,50555430,48239586.8,53.34032044345699,53.50279134278843,NaN,NaN,11.27824531754544,16.85510592632674
2007-11-06T09:30:00-05:00,28,28.25999,28,28.25999,1129451,3476069.4,56.508931079035875,55.81552427582692,NaN,NaN,45.86261120256145,5.300221020137104,-0.022433427788289384,0.11248861247451103,0.1349220402628004,51684881,49237914.2,55.91980489331938,51.70248162460218,NaN,NaN,11.544350309508937,16.096426552495625
2007-11-07T09:30:00-05:00,28,28.19,27.81,27.95,2671233,3481786.05,48.98448122490093,55.210065327490334,NaN,NaN,-49.058124345351835,-28.404281420333085,-0.03542064496579639,0.09064623405555494,0.12606687902135133,49013648,49264116,55.988574954840615,50.41075089265142,NaN,NaN,9.116398480937526,15.099279685130183
2007-11-08T09:30:00-05:00,28.17999,28.22,27.73,28.14999,3227208,3342386.5,53.30443021498979,55.59664551809961,NaN,NaN,-21.011407234454857,-32.129000218737886,-0.030090405434600467,0.08845387222810075,0.11854427766270122,52240856,50459317.4,59.1214698539975,50.271614727944666,NaN,NaN,8.642738433893154,14.176916649239178
2007-11-09T09:30:00-05:00,27.95,28.14999,27.87,27.88,2385771,3274440.05,47.46136638777718,55.19306601484529,NaN,NaN,-49.663297644458176,-29.640717100157946,-0.043483002390895434,0.06419052467408193,0.10767352706497736,49855085,50669980,59.66644652409238,50.68634683691807,NaN,NaN,6.176226060711675,13.033960850878106
2007-11-12T09:30:00-05:00,27.67,28.16,27.64,27.89999,2307067,3199228.4,47.91659182212485,54.65061479804591,NaN,NaN,-78.80422287201989,-30.53488817874466,-0.049303695761269334,0.0460439073633907,0.09534760312466004,52162152,50991324.4,60.53083419981696,51.463081085156276,NaN,NaN,4.437374855319231,11.805877137226839
2007-11-13T09:30:00-05:00,28.38,28.44,28.03999,28.32001,1602385,3121978.15,56.454194396282496,54.90315530947389,NaN,NaN,103.76943717862903,-18.953522983531144,-0.024431983138684804,0.06480762420130404,0.08923960733998884,53764537,51407255.6,61.6756927704495,52.834221970164485,NaN,NaN,5.889895574748166,10.9607369140156
2007-11-14T09:30:00-05:00,28.46001,28.66,28.36,28.46001,2915095,2907338,58.874080410853566,54.90374677338497,NaN,NaN,175.30299386027195,25.918700657593615,0.0005587818847702514,0.08993808469595166,0.08937930281118141,56679632,52940452.4,65.63297413945836,54.564853518381405,NaN,NaN,7.875451023047258,10.519981786734409
2007-11-15T09:30:00-05:00,28.14999,28.63,28.14999,28.44,4579004,2504173.15,58.37476215989212,54.57182542952838,NaN,NaN,118.61592134473022,53.84416637343063,0.014101371484440628,0.10700601716673219,0.09290464568229156,52100628,52912406.8,65.49974055505808,56.09349671403684,NaN,NaN,9.259101839822273,10.339856080032675
2007-11-16T09:30:00-05:00,28.55,28.64999,28.38,28.57001,1555733,2217979.7,60.706543845207925,54.391406423508,NaN,NaN,145.0841363242169,92.79365316716564,0.029300327639513263,0.12953005523168315,0.10022972759216989,53656361,53672662,67.42988690955488,57.5849169377263,NaN,NaN,11.134256233598938,10.453341816256426
2007-11-19T09:30:00-05:00,28.66,28.66,28.34,28.37,2718560,2257252.7,55.550911027497484,54.152299847941215,NaN,NaN,105.47630952379502,129.64975964632862,0.0236128210789803,0.12974575394089527,0.10613293286191497,50937801,53427791.8,66.14627281363799,58.91359901818544,NaN,NaN,11.123790790297795,10.549120241119478
2007-11-20T09:30:00-05:00,28.94,28.94,28.30991,28.60001,3525074,2358196.4,59.78106987858227,53.9227171612605,NaN,NaN,142.51098410786122,137.39806903217507,0.032521286217646744,0.1467845406339734,0.11426325441632665,54462875,53567459.4,66.53754970844378,60.04929838398476,NaN,NaN,12.468420941312548,10.823306055432774
2007-11-21T09:30:00-05:00,28.49001,28.62,28.23,28.25,3356838,2418033.3,51.71553373974516,54.2434989567838,NaN,NaN,52.31271607050869,112.80001347422242,0.013021583226107775,0.13054023344896137,0.1175186502228536,51106037,52452740.4,60.52489613031914,60.724696143767936,NaN,NaN,10.946907761606907,10.840963442029079
2007-11-23T09:30:00-05:00,28.59,28.59,28.35001,28.53999,686618,2307919.2,56.90351779773116,54.63423907000155,NaN,NaN,88.1597843801328,106.70878608130292,0.017552023481913342,0.13945867957524527,0.12190665609333193,51792655,52391145.8,60.201178545701936,61.30111731729624,NaN,NaN,11.432081088502748,10.925408820096745
2007-11-26T09:30:00-05:00,28.8,28.8,28.17999,28.25,2987212,2390664.75,51.00200771050874,54.53845869250926,NaN,NaN,54.35354331753327,88.56266747996621,-0.00014637445338097632,0.12172368802660571,0.12187006247998669,48805443,51420962.2,55.193714555359236,61.43350261100354,NaN,NaN,9.794065057256956,10.763788282548203
2007-11-27T09:30:00-05:00,28.25,28.67999,28.25,28.55,2612327,2444966.1,56.0770373237069,54.50760913855719,NaN,NaN,77.43423280313148,82.95425213583349,0.006802518835057628,0.13037321102380872,0.1235706921887511,51417770,51516956,55.58734934393507,61.40975578604752,NaN,NaN,10.197176370284058,10.682843723653326
2007-11-28T09:30:00-05:00,28.8,29.05,28.58,29,4533906,2594562.4,62.372673223767706,55.463908567047675,NaN,NaN,169.75556092521222,88.40316749930369,0.03839272955268497,0.1715616041296073,0.13316887457692234,55951676,51814716.2,56.85356476699532,61.47154077263,NaN,NaN,12.851999433303488,10.992723110746207
2007-11-29T09:30:00-05:00,28.71001,29.31,28.71001,29.14999,2780805,2624132.9,64.21385782754598,56.24315339651597,NaN,NaN,184.37681821078434,114.8159879273588,0.06453818748847345,0.21384160893751414,0.14930342144904069,58732481,53340005,62.71734697794742,61.72838913862642,NaN,NaN,15.569774085943457,11.646587535774385
2007-11-30T09:30:00-05:00,29.3,29.3,29.03,29.19,2794706,2632978.7,64.70992161203446,57.47519305539148,NaN,NaN,185.99390662458234,134.38281237624872,0.07873462950399818,0.2477217083290384,0.16898707882504022,61527187,55286911.4,68.58594754219705,62.365496354205334,NaN,NaN,17.832659731613475,12.530312135179969
2007-12-03T09:30:00-05:00,29.37,29.37,29.03,29.08,5158824,2764073.75,62.15878354568432,58.49249246421716,NaN,NaN,162.25914214544704,155.9639321418315,0.07494471898633895,0.2626679775579639,0.18772325857162495,56368363,56799495.4,72.2417218623809,63.20198833010276,NaN,NaN,18.870926345377026,13.436114165208119
2007-12-04T09:30:00-05:00,29.05,29.14999,29,29.03999,2187751,2785778.4,61.213481238992486,58.832441524410726,NaN,NaN,125.75031977767152,165.6271495367395,0.06437576864256986,0.2681929693748373,0.20381720073226742,54180612,57352063.8,73.45694905808736,64.04350663636261,NaN,NaN,19.426148123600107,14.29183330212126
2007-12-05T09:30:00-05:00,29.39,29.39,29.09,29.16,1632451,2810928.4,63.0296465697944,59.12926767862079,NaN,NaN,133.4548500214251,158.36700735598205,0.060177266474488345,0.27903878382537783,0.2188615173508895,55813063,57324341.2,73.28360682382178,64.58998039953141,NaN,NaN,20.420865964467126,15.167409396742098
2007-12-06T09:30:00-05:00,29.33,29.46001,29.14999,29.14999,3177313,2836232.4,62.765650211139764,59.442902539424196,NaN,NaN,121.52818089926268,145.79727989367774,0.0517570014157131,0.2835577691205309,0.23180076770481778,52635750,56104995,65.9157915449303,64.61969832737944,NaN,NaN,21.159218900618054,16.023382183010092
2007-12-07T09:30:00-05:00,29.39999,29.60001,29.31,29.46001,3010076,2825375.8,67.32966432949115,59.91598257401586,NaN,NaN,136.09555199789253,135.81760896833975,0.06143762365036945,0.3085977972677796,0.24716017361741013,55645826,54928722.8,59.682149808051996,64.06628853441494,NaN,NaN,23.180415312877134,17.045815487276812
2007-12-10T09:30:00-05:00,29.77,29.77,29.45,29.49001,980567,2755115.6,67.74172444360946,60.786754960881,NaN,NaN,135.98480091714484,130.56274072267934,0.06394580616000323,0.32709243131741417,0.26314662515741094,56626393,54980328.8,59.86149535764099,63.617375858986584,NaN,NaN,24.95146853276161,18.17519449377464
2007-12-11T09:30:00-05:00,29.73,29.73,29.08,29.17,3657122,2822618.35,59.16883921447905,60.74302419915933,NaN,NaN,86.22291496096157,122.65725975933735,0.03934439339154788,0.3123271168968458,0.2729827235052979,52969271,54738060.6,58.54486772834059,63.04647000326493,NaN,NaN,24.00795261873088,19.008445654482674
2007-12-12T09:30:00-05:00,29.7,29.74001,29.03,29.25,2379734,2861485.8,60.51415224550214,61.37149694957054,NaN,NaN,80.71475244243015,112.10924024353835,0.024478888084763173,0.30358133361125184,0.27910244552648866,55349005,54645249,58.01840008820837,62.867434571685585,NaN,NaN,23.615291220647926,19.66656644964914
2007-12-13T09:30:00-05:00,29.45,29.45,29.05,29.38,3219353,2876698.7,62.66676212170922,61.783157258426115,NaN,NaN,65.84947005987662,100.97349807566114,0.01963002616471521,0.30363997823238265,0.28400995206766744,58568358,55831770.6,62.64336720006401,63.04187661842574,NaN,NaN,23.899313507477373,20.271244600767456
2007-12-14T09:30:00-05:00,29,29.42999,28.98,29.02,2748971,2785197.05,53.903172710989,61.990383329888985,NaN,NaN,34.27367609889118,80.60912289586088,-0.010001808451975236,0.2715076915026984,0.2815094999546736,55819387,55866482.8,62.77257947788269,63.58322411289169,NaN,NaN,21.432004786680306,20.437067484469292
2007-12-17T09:30:00-05:00,28.75999,28.99001,28.71001,28.82001,2978533,2856337.05,49.74162217179839,61.537853676181236,NaN,NaN,-28.41745807652352,47.7286710971272,-0.043379519961974256,0.2272851000022058,0.27066461996418006,52840854,55109375,58.05583651102214,63.75954462482649,NaN,NaN,18.026993457550045,20.0927711949094
2007-12-18T09:30:00-05:00,29.16,29.16,28.63,28.69,4009879,2920903,47.190960684632614,60.453445637671585,NaN,NaN,-37.39901020964441,23.004286063006003,-0.07279052893287352,0.17967645879808813,0.25246698773096166,48830975,54281715.8,53.33755500209774,63.50840107019095,NaN,NaN,14.412991996997789,19.28137416663631
2007-12-19T09:30:00-05:00,28.53999,29.0099,28.53999,28.92999,1922635,2840781.05,52.076193412722375,59.586469608041334,NaN,NaN,-41.3915647947993,-1.4169773844398876,-0.07439507195843448,0.15947314778291855,0.23386821974135302,50753610,53362636.8,48.61284676032719,62.50093676893236,NaN,NaN,12.793575759423751,18.354545822748804
2007-12-20T09:30:00-05:00,29.38,29.38,28.8,28.8,1720704,2758974.35,49.40999024269997,58.493617367374576,NaN,NaN,-12.263241977738288,-17.039519791962878,-0.0819286458751319,0.13145741239743813,0.21338605827257004,49032906,51455546.4,40.58019187931039,60.50052565015475,NaN,NaN,10.632144922669964,17.251345694166112
2007-12-21T09:30:00-05:00,28.77,29.34,28.77,29.34,2275149,2838400.9,58.83798151697202,58.25641722246656,NaN,NaN,22.4831657045601,-19.39762187082908,-0.0498395705590165,0.1510865950737994,0.2009261656328159,51308055,50553280,37.4290694821928,58.013907622998445,NaN,NaN,11.80025236255715,16.47261807536483
2007-12-24T09:30:00-05:00,29.47,29.47,29.21001,29.3,882253,2733152.95,57.97608679326085,58.025174762057155,NaN,NaN,69.98377538439802,0.28262482135522476,-0.03149859922623438,0.1615529166000229,0.1930515158262573,50425802,50070269.6,35.8252807448503,55.325931314910086,NaN,NaN,12.437328088061882,15.896148077178696
2007-12-26T09:30:00-05:00,29.36,29.36,29.13,29.2,1349010,2669987.1,55.77634746452199,57.507081968823414,NaN,NaN,30.31546910430257,13.825520684144621,-0.026493405299364114,0.15993475920205213,0.18642816450141625,49076792,50119433,36.125291738809274,52.67176595169491,NaN,NaN,12.279756142985121,15.379520658008184
2007-12-27T09:30:00-05:00,29.36,29.36,28.92,28.92,2449451,2565764.35,50.0501015044858,56.59882848977669,NaN,NaN,-43.11026198017666,13.481781247069147,-0.04153599448735715,0.13450817139221982,0.17604416587957697,46627341,49294179.2,33.31027060590266,50.34280017033579,NaN,NaN,10.328128253193475,14.657893171606084
2007-12-28T09:30:00-05:00,29.21001,29.21001,28.95,29.03,725303,2462989.25,52.12936006329378,55.51309247076261,NaN,NaN,-44.80604143102899,6.9732213564110115,-0.04337203053751407,0.12182912770768439,0.16520115824519846,47352644,48958126.8,32.20959409041731,48.380474761933314,NaN,NaN,9.366634490268208,13.901999074272101
2007-12-31T09:30:00-05:00,29.02,29.02,28.61,28.8,1763259,2411416.9,47.66185867047142,54.07881634410988,NaN,NaN,-132.7541928043939,-24.074250345379788,-0.05843335895782681,0.09215945954791493,0.15059281850574174,45589385,47814392.8,28.730062213425867,46.15680096591795,NaN,NaN,7.149031594960508,12.937289434370445
2008-01-02T09:30:00-05:00,28.53,28.72,28.25999,28.39,10122625,2659606.95,40.9282725107966,52.77591872241828,NaN,NaN,-211.64259864694665,-80.39952515164872,-0.09234850273806133,0.03515719008316509,0.12750569282122642,35466760,44822584.4,22.026868670342537,43.54837246177523,NaN,NaN,2.913353717383494,11.505298617658024
2008-01-03T09:30:00-05:00,28.39999,28.5,28.19501,28.24001,4379594,2769199.1,38.77033844514143,51.22278916524966,NaN,NaN,-205.23339197970535,-127.5092973684503,-0.11949925316056853,-0.02186837362948424,0.09763087953108429,31087166,41224659.2,16.91553740150941,40.612453698439595,NaN,NaN,-1.2339919081083268,9.685399971119974
2008-01-04T09:30:00-05:00,28.00999,28.34,28.00999,28.12,4172473,2896200.2,37.08549834724714,49.39555603850237,NaN,NaN,-195.242489155014,-157.93574280341778,-0.1388013091414672,-0.07587075689574974,0.06293055224571747,26914693,37282129.6,13.279222866477653,37.08644338889771,NaN,NaN,-5.145913564639327,7.566640894582932
2008-01-07T09:30:00-05:00,28.10001,28.55,28.10001,28.45,3826337,2928651.4,44.25876348715715,48.70666966537152,NaN,NaN,-126.24216667005166,-174.2229678512223,-0.1231371666764575,-0.09099090609985439,0.0321462605766031,30741030,33959806.8,11.11151619967832,33.39636744045454,NaN,NaN,-6.261427321348097,5.591202578021356
2008-01-08T09:30:00-05:00,28.63,28.86,28.24001,28.24001,5549531,3055624.15,41.05129538731273,48.08593203790826,NaN,NaN,-96.98033183643828,-167.06819565763118,-0.12055827443912516,-0.11855158247230335,0.002006691966821808,25191499,29880229.6,9.138761040710207,29.902290621146545,NaN,NaN,-8.219328038806301,3.6182696327602626
2008-01-09T09:30:00-05:00,28.49001,28.63,28.28999,28.62,4758980,3244544.8,48.346258374809736,48.168453301492335,NaN,NaN,-75.48139743965024,-139.83595541617188,-0.08839023134055318,-0.10848109720886967,-0.020090865868316488,29950479,28776973.4,8.689458886423495,26.71314089859839,NaN,NaN,-7.487572318744489,2.0317207825452983
2008-01-10T09:30:00-05:00,28.59,28.91,28.50999,28.67,5023641,3312870.75,49.23644965396501,47.96561446158109,NaN,NaN,-32.28066210242751,-105.24540944071634,-0.060220315360122935,-0.09536626006847015,-0.03514594470834722,34974120,29554364.2,11.97352720184999,24.096046644421442,NaN,NaN,-6.629208584077001,0.7944451587421126
2008-01-11T09:30:00-05:00,28.67,28.71001,28.16,28.27,4456316,3416699.85,42.87111809645321,47.49855216542061,NaN,NaN,-91.26016519454807,-84.44894464862314,-0.06461375598294967,-0.11591313968703432,-0.05129938370408464,30517804,30274986.4,15.024497173901807,22.270639879749403,NaN,NaN,-7.96088115813407,-0.4563157436687706
2008-01-14T09:30:00-05:00,28.22,28.37,28.11,28.14999,7331492,3622306.8,41.15214566036337,46.23527817566285,NaN,NaN,-113.10396922278522,-81.82130515916984,-0.07117139073817148,-0.140263622126799,-0.06909223138862751,23186312,28764042.8,13.933997218120282,20.592420432315652,NaN,NaN,-9.579432120766281,-1.759618083254129
2008-01-15T09:30:00-05:00,28,28.02,27.75,27.85001,2611459,3615431.2,37.143093368487634,44.747207216750475,NaN,NaN,-158.5517169800293,-94.13558218788806,-0.09006478935960392,-0.18167321808813242,-0.0916084287285285,20574853,27840713.6,13.298768488533256,18.983383842578725,NaN,NaN,-12.265249027182684,-3.2604225038153514
2008-01-16T09:30:00-05:00,27.66,28.06,27.66,27.75,8980348,3915521.95,35.88783728762283,43.32659934697195,NaN,NaN,-143.69707526686096,-107.77871775333021,-0.10273268850651973,-0.22002428936167817,-0.11729160085515844,11594505,24169518.8,11.1267718947919,17.197775282291765,NaN,NaN,-14.824378174488583,-4.912416171054384
2008-01-17T09:30:00-05:00,27.96001,27.97,27.42,27.55,4250328,3927544.4,33.45304890401607,42.141095589795555,NaN,NaN,-151.31851771019998,-131.5862888748847,-0.11698147261211522,-0.26351844162030247,-0.14653696900818725,7344177,18643530.2,8.797610076696856,15.446870958777064,NaN,NaN,-17.73466610792611,-6.744166162036059
2008-01-18T09:30:00-05:00,27.73,27.73,27,27.14999,6034824,4133153.85,29.187830403997467,40.50241489984582,NaN,NaN,-180.06680057157934,-149.34761595029096,-0.14397172647633844,-0.3265016271036103,-0.18252990062727187,1309353,12801840,7.1045251178721,13.6536517464524,NaN,NaN,-21.715021039653628,-8.882859715981425
2008-01-22T09:30:00-05:00,25.17999,27.02,24.38,26.87,12101590,4652198.15,26.628595260361237,39.000038941980804,NaN,NaN,-280.56249144330627,-182.8393203943952,-0.1695456763366147,-0.3944619960480402,-0.22491631971142553,-10792237,6006130.2,5.72438324969437,12.010388963328722,NaN,NaN,-25.91519872803519,-11.316051003417677
2008-01-23T09:30:00-05:00,26.39,27.25,26.27,27.2,10402320,5058556.7,33.97649246820238,38.503483224652655,NaN,NaN,-150.74969753492783,-181.27891650537487,-0.15357671993089084,-0.41688721962503905,-0.2633104996941482,-389917,1813176.2,5.069954066102781,10.799180777311594,NaN,NaN,-27.05292658201876,-13.564176086074974
2008-01-24T09:30:00-05:00,27.38,27.38,26.84,27.07001,3787219,5203805,32.591885810563014,38.062165179325625,NaN,NaN,-111.62037955516502,-174.8635773630357,-0.14141204854910094,-0.4400755603805244,-0.2986635118314235,-4177136,-1341152,4.640179961557649,9.922369531600756,NaN,NaN,-28.407463230855477,-15.684645678186474
2008-01-25T09:30:00-05:00,27.17,27.17999,26.64,26.7,2960707,5284389.85,28.972595079250368,37.48267208875442,NaN,NaN,-120.15917435359717,-168.63170869171512,-0.1472647305002151,-0.48274442495669234,-0.33547969445647724,-7137843,-4237556,4.2813002943215395,9.279660776446748,NaN,NaN,-30.765401747999842,-17.839039402445525
2008-01-28T09:30:00-05:00,26.72,27.05,26.64,26.91,4415277,5382681.15,33.487102434312604,36.71326772783696,NaN,NaN,-103.68834022677058,-153.35601662275334,-0.1267530039069984,-0.49392094934022523,-0.36716794543322684,-2722566,-5043939.8,4.184271371195493,8.78485757441226,NaN,NaN,-31.245090292642928,-19.754189529616582
2008-01-29T09:30:00-05:00,27.23,27.23,26.83,26.99001,1733335,5433082.75,35.177617576569645,36.29371931278387,NaN,NaN,-78.55102096918952,-112.95372252793001,-0.09879859778795907,-0.4906661926681757,-0.3918675948802166,-989231,-3083338.6,9.551604382461576,8.814346384537359,NaN,NaN,-31.107411408744102,-21.376078369491943
2008-01-30T09:30:00-05:00,27.07001,27.25,26.77,26.8,4867270,5588283.3,33.03054925742816,35.19974009011376,NaN,NaN,-76.74134435528124,-98.1520518920007,-0.0846515440868082,-0.4976820249887268,-0.41303048090191863,-5856501,-4176655.4,9.24074071912166,8.853723658301513,NaN,NaN,-31.63895717917253,-22.842203913732025
2008-01-31T09:30:00-05:00,26.73,27.35001,26.71001,27.2,3030899,5233697,41.170846387090975,34.62362557105133,NaN,NaN,-55.39224882974967,-86.90642574691765,-0.04205428549895601,-0.46559833777561366,-0.42354405227665765,-2825602,-3906348.6,10.020450677609517,8.714218192284337,NaN,NaN,-29.499874834475158,-23.793299759552472
2008-02-01T09:30:00-05:00,27.2,27.57001,27.2,27.47,4343566,5231895.6,45.946934249526706,34.843326724842285,NaN,NaN,-18.02395932995659,-66.47938274218953,0.007941545583080023,-0.4136171202978076,-0.42155866588088764,1517964,-2175187.2,15.05373756992104,8.716306791999997,NaN,NaN,-26.14967557082287,-24.129924875448243
2008-02-04T09:30:00-05:00,27.61,27.62,27.28,27.3,2560890,5151316.45,43.54957316742484,35.01457154677525,NaN,NaN,-16.018316619597204,-48.94537802075485,0.031855922022217154,-0.3817387633531162,-0.41359468537533334,-1042926,-1839259.2,16.035255349788187,8.866396658547703,NaN,NaN,-24.132331157202916,-24.130268629984624
2008-02-05T09:30:00-05:00,27.28999,27.28999,26.8,26.92999,4559219,5187960.55,38.80386410123955,35.133198027686106,NaN,NaN,-54.36913622474008,-44.10900107186495,0.02533253981310979,-0.38192901060894613,-0.4072615504220559,-5602145,-2761842,15.505372417849145,9.02401122492741,NaN,NaN,-23.891521508697696,-24.096161898372205
2008-02-06T09:30:00-05:00,27,27.01801,26.72,26.82001,3143158,5067641.9,37.49592880281709,35.248061707342835,NaN,NaN,-67.5547310110607,-42.27167840302084,0.016610095775461797,-0.38649893070272867,-0.40310902647819047,-8745303,-3339602.4,15.167353535184745,9.312624199241185,NaN,NaN,-24.100354881605515,-24.096760895976963
2008-02-07T09:30:00-05:00,26.71001,27.12,26.7,27.10001,2395240,4949454.9,42.78355956928889,35.91452675486232,NaN,NaN,-47.461868384806216,-40.68560231403215,0.03181632208366486,-0.3633386238736094,-0.39515494595727424,-6350063,-4044494.6,14.745012271703885,9.737438641741686,NaN,NaN,-22.621767350459017,-23.886047532331542
2008-02-08T09:30:00-05:00,26.97,27.10001,26.8,26.8,2827507,4839648.2,38.97866874156737,36.61387235040303,NaN,NaN,-52.58775829534184,-47.598362107109196,0.024136040854399132,-0.3649848948892753,-0.38912093574367446,-9177570,-6183601.4,13.515117442283767,10.195338093485375,NaN,NaN,-22.5541993956631,-23.69578351280748
2008-02-11T09:30:00-05:00,26.8,27.14999,26.8,27.14,3441524,4788908.6,44.95346551222166,37.92279165410735,NaN,NaN,-25.2692573734162,-49.448550257873,0.04330248521969915,-0.3349928292190505,-0.37829531443874964,-5736046,-7122225.4,13.002613329598063,10.715211670621354,NaN,NaN,-20.562394782727733,-23.248156551367515
2008-02-12T09:30:00-05:00,27.33,27.5,27.24001,27.5,5154172,4680042.6,50.482032052016535,39.10175876723692,NaN,NaN,64.43538705766778,-25.68764560139143,0.0794688585488369,-0.27895924125270355,-0.35842809980154045,-581874,-6118171.2,16.64398220267509,11.541927966090801,NaN,NaN,-17.029324263789388,-22.359751938856355
2008-02-13T09:30:00-05:00,27.86,27.86,27.37,27.37,1872432,4643091.25,48.58442973195373,40.24408333305055,NaN,NaN,102.4372387206692,8.310748344954543,0.09294277608295909,-0.24224962969784158,-0.3351924057808007,-2454306,-4859971.8,21.100636703692203,12.71767487624327,NaN,NaN,-14.778615783421664,-21.276732488079972
2008-02-14T09:30:00-05:00,27.56,27.62,27.14999,27.23,3391694,4363658.55,46.55486542401435,41.49995978624798,NaN,NaN,67.59866639987301,31.32285530189039,0.09063716490369877,-0.2218959496511772,-0.312533114554876,-5846000,-4759159.2,21.462960252211573,13.944936301806846,NaN,NaN,-13.552074983941054,-20.173209987488697
2008-02-15T09:30:00-05:00,27.25,27.38,27.12,27.35001,3103283,4306306.3,48.53938225234812,42.57512263039337,NaN,NaN,64.21600943141958,54.68360884724268,0.09494876511142109,-0.1938471581655996,-0.2887959232770207,-2742717,-3472188.6,26.126848978729413,15.512263273773556,NaN,NaN,-11.94958436045814,-18.998406326484332
2008-02-19T09:30:00-05:00,27.94,27.94,27.32001,27.78999,3689135,4189021.85,55.11911436763512,43.99951525832662,NaN,NaN,160.4166580335791,91.82079192864174,0.1233852144622341,-0.13456440519922808,-0.2579496196614622,946418,-2135695.8,30.727479173938434,17.024825758879043,NaN,NaN,-8.427565730827393,-17.488286241390483
2008-02-20T09:30:00-05:00,27.37,27.7,27.159,27.2,3547366,3761310.65,46.52809184254315,44.96362544297769,NaN,NaN,61.43455663693796,91.22062584449577,0.09944046715166235,-0.13364903572188425,-0.2330895028735466,-2600948,-2539510.6,30.117176534771275,18.51599974571116,NaN,NaN,-8.13061712830139,-16.15147636809204
2008-02-21T09:30:00-05:00,27.46001,27.56,27.25,27.3,4037090,3443049.15,48.00728588350217,45.4519425498642,NaN,NaN,59.202889655104,82.57375603138273,0.0877263287051645,-0.12343159199209097,-0.21115792069725547,1436142,-1761421,32.8833575689404,20.149064523663363,NaN,NaN,-7.421410153167867,-14.904324051674301
2008-02-22T09:30:00-05:00,27.39999,27.60001,27.13,27.60001,3101565,3408766.45,52.27293031373478,45.90379941159335,NaN,NaN,72.5234854747373,83.55871984635559,0.0968563983343004,-0.09008742277937998,-0.18694382111368038,4537707,315320.4,39.73950778348514,21.91233382463223,NaN,NaN,-5.450362273406905,-13.553758083350388
2008-02-25T09:30:00-05:00,27.60001,27.67999,27.45,27.64,2436305,3382546.35,52.828479346138295,46.5665784243586,NaN,NaN,103.81657341022022,91.47883264211572,0.10175797615943688,-0.059746350914384294,-0.16150432707382117,6974012,2258666.2,45.36397683028938,24.007242501810886,NaN,NaN,-3.7158384030895553,-12.14834098617027
2008-02-26T09:30:00-05:00,27.69,27.98,27.61,27.98,2379420,3280753.5,57.37173785816033,47.892855121281514,NaN,NaN,162.842744538464,91.9640499430927,0.12266627874300293,-0.00817147864506751,-0.13083775738807044,9353432,3940069,49.735350003888904,26.452240900813727,NaN,NaN,-0.7911029074286609,-10.525878403492896
2008-02-27T09:30:00-05:00,27.96001,27.96001,27.60001,27.60001,2402405,3314207,51.411964982277574,48.88685770552869,NaN,NaN,114.12400332776994,102.5019392812591,0.10628357749843242,0.0020167144849700946,-0.10426686301346233,6951027,5850464,54.21738729197478,29.24152902629873,NaN,NaN,-0.1477697991826532,-9.043291460020004
2008-02-28T09:30:00-05:00,27.53999,27.75,27.53999,27.64999,3234169,3232551.95,52.116538010486096,49.55349902275706,NaN,NaN,87.9946777684508,108.26029690392845,0.09458384491115757,0.013962943125484628,-0.08062090178567294,10185196,7600274.8,57.91869040618111,32.325363178761386,NaN,NaN,0.5781429545603025,-7.668800829365675
2008-02-29T09:30:00-05:00,27.52,27.52,27.12,27.13,4405180,3301266,44.83248766181002,49.97162894563154,NaN,NaN,-29.342359954571954,87.8871278180666,0.04984289610816113,-0.01831728165047153,-0.06816017775863266,5780016,7848736.6,58.432568947099824,35.53375257196253,NaN,NaN,-1.1216696539591187,-6.733496375736167
2008-03-03T09:30:00-05:00,26.96001,27.39999,26.95,27.39999,3034184,3235796.9,48.831369267837005,50.24862207103263,NaN,NaN,-28.503360336626084,61.42314106869735,0.03703882358331413,-0.021861648279489998,-0.05890047186280413,8814200,8216774.2,59.22682944827898,38.83548229472546,NaN,NaN,-1.2674426315441552,-5.952631555137309
2008-03-04T09:30:00-05:00,27.28999,27.45,27,27.38,4349516,3325228.2,48.55076066420835,50.11067411476062,NaN,NaN,-18.57436401761442,25.139719357481663,0.026333111904001616,-0.02598408198280211,-0.052317193886803726,4464684,7239024.6,56.156868823387356,41.65783133906205,NaN,NaN,-1.4675424154362922,-5.3119045351800205
2008-03-05T09:30:00-05:00,27.5,27.60001,27.25999,27.45,2129962,3203765.35,49.64205034566234,50.18621844431123,NaN,NaN,24.392324184387608,7.193383528805197,0.02318675632552627,-0.02333374847989589,-0.04652050480542216,6594646,7167748.4,55.92927781159439,44.14559141819792,NaN,NaN,-1.3178926284118353,-4.741331405641708
2008-03-06T09:30:00-05:00,27.17999,27.45,27.05,27.2,1865550,3139884.95,45.897682556870436,50.139276810943805,NaN,NaN,-50.869610189918234,-20.579474062868616,0.004468896131004846,-0.0409343846416661,-0.045403280772670945,4729096,6076528.4,52.4261751955197,46.35724962843421,NaN,NaN,-2.2844379408694087,-4.390346624959951
2008-03-07T09:30:00-05:00,27.11,27.27,26.98,27.07001,5307871,3285516.5,44.03770342914417,49.8177283235721,NaN,NaN,-100.53969307602937,-34.8189406871601,-0.015379088008976027,-0.06462714078389098,-0.04924805277491495,-578775,4804770.2,48.60520753243256,47.96284666798444,NaN,NaN,-3.6322695351758103,-4.282049897847931
2008-03-10T09:30:00-04:00,27.24001,27.24001,26.89999,26.92999,4282301,3358256.2,42.060477380914534,48.88496853880633,NaN,NaN,-136.8809810241102,-56.494464824656916,-0.03549998693362015,-0.09362303644194014,-0.05812304950831999,-4861076,2069715,41.58557841225792,48.73842518500726,NaN,NaN,-5.33882890066916,-4.433018326822392
2008-03-11T09:30:00-04:00,27.49001,27.5,27.12,27.5,3677512,3370055.6,51.58949919557428,49.24649763545142,NaN,NaN,-14.550888312724972,-55.68976968367904,-0.009343805296630092,-0.06980280612910761,-0.060459000832477516,-1183564,940065.4,39.075440473564946,49.378301180635376,NaN,NaN,-3.9944926192074286,-4.370371797163111
2008-03-12T09:30:00-04:00,27.41,27.64999,27.33,27.42999,4541703,3339432.15,50.491123958343714,49.42391464079724,NaN,NaN,23.128000580998048,-55.942634404356944,0.003623518863654286,-0.05592960225290966,-0.059553121116563947,-5725267,-1523917.2,34.22308543546731,49.473996028244436,NaN,NaN,-3.233472325775976,-4.207957586964949
2008-03-13T09:30:00-04:00,27.23,27.46001,27.03999,27.42999,8384344,3665027.75,50.491123958343714,49.29664275826931,NaN,NaN,-36.91540464499802,-53.15179329537291,0.01210417001962217,-0.04442290859203624,-0.056527078611658406,-5725267,-3614789.8,30.735220643779783,48.830832661122635,NaN,NaN,-2.6187279616303054,-3.9809247833457144
2008-03-14T09:30:00-04:00,27.67,27.67999,26.81,26.96001,4151031,3702994.6,43.31178908884635,48.61687916846274,NaN,NaN,-94.01964461447577,-51.84778360306218,-0.012692521782347026,-0.07239273083959219,-0.059700209057245164,-9876298,-5474294.4,28.00194720513386,47.59068768789724,NaN,NaN,-4.236478775550338,-4.017432496517803
2008-03-17T09:30:00-04:00,26.5,27.12,26.3,26.81,5314184,3813539.65,41.29353095989247,47.468435818586464,NaN,NaN,-213.12565585260344,-67.09671856876083,-0.03659825718592237,-0.10544803053964813,-0.06884977335372576,-15190482,-7540175.6,25.30907474962001,45.84595374116374,NaN,NaN,-6.191953197932891,-4.328078311005673
2008-03-18T09:30:00-04:00,27.14,27.55,27.00999,27.3,3908872,3824526.5,49.56140938425816,47.33625327587079,NaN,NaN,-21.401215440084854,-68.46678399423281,-0.01776502237632968,-0.09105605132413785,-0.07329102894780817,-11281610,-9559784.8,22.98223490875253,43.614871428076434,NaN,NaN,-5.339268004384742,-4.4725339814883975
2008-03-19T09:30:00-04:00,27.53,27.75999,27.35001,27.45,5407945,3917555.45,51.799312184907556,47.31359428832946,NaN,NaN,58.692493605980985,-61.35388538923621,0.005211386063747117,-0.06677679636812428,-0.0719881824318714,-5873665,-9589464.4,22.948844139396613,41.11702526616326,NaN,NaN,-3.9444459656102113,-4.397092836362942
2008-03-20T09:30:00-04:00,27.28999,27.69,27.25,27.6201,3946533,3913027.6,54.2768059808878,47.98818845397788,NaN,NaN,53.930212896498766,-43.18476188093686,0.030851051411401778,-0.03342436816761918,-0.06427541957902096,-1927132,-8829837.4,25.915640446798164,38.79438751614172,NaN,NaN,-2.026686822176794,-4.058463405764921
2008-03-24T09:30:00-04:00,27.85001,27.94,27.74001,27.92999,4826941,3999296.4,58.465303943333446,48.676326645084764,NaN,NaN,148.4168894190049,5.302544925759269,0.06566667640617983,0.01780792592870384,-0.047858750477475995,2899809,-6274616,34.98423664624028,37.062773744567515,NaN,NaN,0.9436754117671509,-3.3438721461174823
2008-03-25T09:30:00-04:00,27.95,28.03999,27.85001,28,3438050,4049383.65,59.37082173051572,49.449188149821005,NaN,NaN,156.4684517583458,79.22136644794912,0.08895027371246343,0.0633290916631033,-0.025621182049360133,6337859,-1968947.8,46.801337764685854,36.39452152608884,NaN,NaN,3.624922654403008,-2.3483300317574125
2008-03-26T09:30:00-04:00,28.11,28.11,27.77,27.77,2154862,4038155.75,55.119321076528735,49.84042177345432,NaN,NaN,133.03703980094846,110.10901749615577,0.08443658184246237,0.07992454525371784,-0.004512036588744536,4182997,1123973.6,53.35931908449022,36.210953045581405,NaN,NaN,4.662827921418314,-1.3467360384465945
2008-03-27T09:30:00-04:00,28.08,28.09,27.83,27.91,2448881,4040479.55,57.13161402658828,50.64284544986274,NaN,NaN,139.4339608829653,126.25731095155265,0.08615679038885417,0.10318395139732317,0.017027161008469006,6631878,3625082.2,57.88096194803063,36.600580670760756,NaN,NaN,6.121844667660382,-0.27979593757416943
2008-03-28T09:30:00-04:00,28.00999,28.06,27.82001,27.88,2735107,4015526.45,56.546533456265806,51.53633330894285,NaN,NaN,122.44181844832006,139.95963206191692,0.08064873916898022,0.11783808496969428,0.03718934580071406,3896771,4789862.8,59.833895004804205,37.40262977593016,NaN,NaN,7.154115398981735,0.782191396219531
2008-03-31T09:30:00-04:00,27.92999,28.08,27.85001,27.86,2037832,3897159.05,56.13381190998216,52.54157148959054,NaN,NaN,108.85025451781742,132.0463050816794,0.07135325775688692,0.12638091799682272,0.0550276602399358,1858939,4581688.8,59.30464041665296,38.66827706195837,NaN,NaN,7.899776022834677,1.7989892000216947
2008-04-01T09:30:00-04:00,28.12,28.37,27.96001,28.2,7419699,4116434.8,61.30446726092657,53.235497779972846,NaN,NaN,141.08342966312887,128.96930066263604,0.08298290343735795,0.15875628953663323,0.07577338609927528,9278638,5169844.6,60.371185020607015,40.189401672461386,NaN,NaN,10.062027667047698,2.979423266739695
2008-04-02T09:30:00-04:00,28.39,28.46001,28.11,28.21001,3273681,4062643.05,61.44854481070074,54.01817069799835,NaN,NaN,134.147185764424,129.19132985533116,0.08587004244288024,0.18311093915287557,0.09724089670999533,12552319,6843709,63.31766614828191,42.267586009091005,NaN,NaN,11.878869700827948,4.250772757323731
2008-04-03T09:30:00-04:00,28.2,28.22,28.06,28.13,2664091,4089349.5,59.54026896812106,54.664538198696725,NaN,NaN,96.63770639756287,120.63207895825067,0.07718561774428781,0.1937229188903551,0.11653730114606728,9888228,7494979,64.42595090978247,44.67406674237691,NaN,NaN,12.91979526790255,5.489204544549277
2008-04-04T09:30:00-04:00,28.23,28.37,28.11,28.37,2220342,4107089.1,63.22907453804904,56.087201445068345,NaN,NaN,108.49203412124216,117.84212209283507,0.08194998194983613,0.21897477858336245,0.13702479663352632,12108570,9137338.8,67.1235145750688,47.468464411657976,NaN,NaN,14.88197892075776,6.8310294554362025
2008-04-07T09:30:00-04:00,28.33,28.38,28.14999,28.19,1447562,3914073.65,58.892296357111356,57.34425611629827,NaN,NaN,92.16423027530644,114.50491724433289,0.06790383126070992,0.22190458570941374,0.1540007544487038,10661008,10897752.6,69.76965365937593,50.64422004806911,NaN,NaN,15.379821601860675,8.052285476353983
2008-04-08T09:30:00-04:00,28.09,28.17999,28.03999,28.17999,1648505,3782383.85,58.65137525585704,57.99353939284105,NaN,NaN,68.56510476427535,100.00125226456218,0.05349753479050787,0.22087267293683865,0.1673751381463308,9012503,10844525.6,69.58728128156571,53.973151931841485,NaN,NaN,15.726286783968183,9.148571377441726
2008-04-09T09:30:00-04:00,28.14999,28.14999,27.82001,27.89999,1823034,3689659.95,52.21659742864776,58.023345481679634,NaN,NaN,32.78722307891011,79.72925972745941,0.022268645030796702,0.19521094443482667,0.17294229940402997,7189469,9771955.6,65.85186577253359,57.03765347706555,NaN,NaN,14.205652161015559,9.871011489380844
2008-04-10T09:30:00-04:00,27.95,28.11,27.91,27.97,1958430,3560496.3,53.58771604371017,57.974124771881236,NaN,NaN,37.059175771358845,67.8135536022186,0.004418815475822735,0.1784658187488084,0.17404700327298567,9147899,9623889.8,65.33050439569796,59.85300090198697,NaN,NaN,13.302514838012158,10.361226253471033
2008-04-11T09:30:00-04:00,27.89,27.95,27.64999,27.78999,2347862,3258672.2,49.64332423645466,57.34398336424704,NaN,NaN,-8.64197984097116,44.38675080977595,-0.020075324459569138,0.14895284769852424,0.16902817215809338,6800037,8562183.2,61.566503620336874,61.75173425727958,NaN,NaN,11.385726891882317,10.507583487529788
2008-04-14T09:30:00-04:00,27.8,27.85001,27.73,27.78,2333422,3167791.75,49.42589253670201,56.63363127897463,NaN,NaN,-21.083444067740075,21.737215941166646,-0.03655393120212433,0.12333575815543796,0.1598896893575623,4466615,7323304.6,57.40998220329868,62.509494574323355,NaN,NaN,9.742361736278426,10.398266094493879
2008-04-15T09:30:00-04:00,27.96001,27.96001,27.75999,27.95,1360842,2970124.65,53.18364140942957,56.4953684456104,NaN,NaN,-12.502105141328467,5.523773960045881,-0.03557486611718408,0.11542110671108219,0.15099597282826627,5827457,6686295.4,55.341103708655154,62.651050618906574,NaN,NaN,9.309045855683861,10.242663203235304
2008-04-16T09:30:00-04:00,28.05,28.11,27.92,28.11,3858364,2967599.25,56.462472416289906,56.44757261630338,NaN,NaN,35.608053880157996,6.087940120295459,-0.02426208907390076,0.12066836148589033,0.1449304505597911,9685821,7185565.8,56.65941254880433,62.5637970903904,NaN,NaN,9.842889799709974,10.1855527170174
2008-04-17T09:30:00-04:00,28.07001,28.14999,27.89999,28.14999,2294517,2811927.85,57.26801877021333,56.499107281585346,NaN,NaN,35.73746567444707,5.823598100913104,-0.014668835664528729,0.1265944059791302,0.14126324164365892,11980338,7752053.6,58.16829085146763,62.44482536515208,NaN,NaN,10.508704438502244,10.231717248658091
2008-04-18T09:30:00-04:00,28.38,28.38,27.94,27.96001,3737025,2801452.45,52.315789737841165,56.226391412146704,NaN,NaN,39.23847804381471,15.39968967787028,-0.021298955456466234,0.11463954732307613,0.13593850277954236,8243313,8040708.8,58.95247826793038,62.41967092595761,NaN,NaN,9.717100365652922,10.158200551085924
2008-04-21T09:30:00-04:00,27.92,28.12,27.91,28.03999,2342950,2677252.9,54.114743204488065,55.71283969382967,NaN,NaN,-1.668617215021214,19.28265504841405,-0.020473248284730905,0.11034694242362875,0.13082019070835965,10586263,9264638.4,62.18910730947268,62.54952251801944,NaN,NaN,9.53709586061658,10.069471309590304
2008-04-22T09:30:00-04:00,28.03999,28.08,27.75999,27.87,2750365,2642868.65,49.81327161443152,54.88174875123901,NaN,NaN,-65.21888291895098,8.739299492889517,-0.030923496900249203,0.09216581958304815,0.12308931648329735,7835898,9666326.6,63.2142927156897,62.542138701405705,NaN,NaN,8.15753738966788,9.79633789245853
2008-04-23T09:30:00-04:00,27.89999,28.21001,27.89999,28.05,1418525,2606051.8,53.98428378941689,54.484892667045855,NaN,NaN,12.23377747807146,4.064444212472209,-0.025487451786846374,0.09123000174973939,0.11671745353658576,9254423,9580047,62.820299071180884,62.42744928436274,NaN,NaN,8.141973970326784,9.560000189296852
2008-04-24T09:30:00-04:00,28.2,28.22,27.92,28.09,2711348,2619175.15,54.88166669006139,53.888649249332445,NaN,NaN,22.258362923395243,1.368623662261843,-0.019255533876564507,0.09264803619088013,0.11190357006744464,11965771,9577133.6,62.80606424434067,62.119059975025,NaN,NaN,8.379750506864948,9.39139309180658
2008-04-25T09:30:00-04:00,28.21001,28.21001,27.75,27.92999,5969230,2780881.3,50.628264398867294,53.29836125231501,NaN,NaN,-46.05852545897029,-15.690777038295158,-0.025571749433897367,0.07993888327507293,0.10551063270897029,5996541,9127779.2,60.527918552933386,61.458936038850545,NaN,NaN,7.3746790480188205,9.103291085551186
2008-04-28T09:30:00-04:00,28.02,28.14999,28,28.10001,3097803,2833879.85,54.65008943841962,53.01255512249805,NaN,NaN,21.773607545113588,-11.002332086268197,-0.01830175871509139,0.08263343431510606,0.10093519303019745,9094344,8829395.4,58.99758852047428,60.7025294130583,NaN,NaN,7.660098273626143,8.897120683847609
2008-04-29T09:30:00-04:00,28.08,28.22,27.94,28.13,2731558,2599472.8,55.34114583672147,53.23573715164617,NaN,NaN,33.61241632430369,8.763927762382737,-0.011791976091732853,0.08619522291553139,0.09798719900726424,11825902,9627396.2,61.780665696307736,60.4117294076136,NaN,NaN,8.089540633818201,8.781752105271979
2008-04-30T09:30:00-04:00,28.25999,28.41,27.64999,27.64999,2611387,2566358.1,43.828982377227405,52.5386847468974,NaN,NaN,-80.62254391476114,-9.807336516183783,-0.03862006298516893,0.04971212027580307,0.088332183260972,9214515,9619414.6,61.735529771518806,60.154945505886516,NaN,NaN,4.773047876461498,8.209080072584767
2008-05-01T09:30:00-04:00,27.82001,28.23,27.82001,28.14999,4348461,2650576.6,54.4566542094392,52.88249403068202,NaN,NaN,29.48591301869968,-8.361826497122895,-0.02230733633008268,0.06044801284836865,0.08275534917845133,13562976,9938855.6,62.90364681392597,60.25045573400002,NaN,NaN,5.507548120992702,7.8231469366430435
2008-05-02T09:30:00-04:00,28.35001,28.35001,28.07001,28.112,3967060,2737912.5,53.626442595466806,53.18253332059379,NaN,NaN,112.62953543032678,23.37578568073652,-0.014092345631444778,0.06513991713914535,0.07923226277059013,9595916,10658730.6,65.46243034732845,60.82563060143072,NaN,NaN,5.792457296475128,7.533048416619056
2008-05-05T09:30:00-04:00,28.17,28.17999,28.00999,28.00999,983227,2714695.75,51.36211686539679,53.05242442459145,NaN,NaN,43.87489680095587,27.796043531904974,-0.015436989869472298,0.05993602543374976,0.07537301530322206,8612689,10562399.6,64.81812394488557,61.502560618304315,NaN,NaN,5.291872937373114,7.212880491012492
2008-05-06T09:30:00-04:00,28.17999,28.23,27.95,28.19,770521,2670796.55,54.97498682214319,52.94617545358096,NaN,NaN,87.80854011027401,38.63526828909904,-0.004669898039663695,0.06953564275364243,0.07420554079330613,9383210,10073861.2,61.5115783661908,61.84914389097478,NaN,NaN,6.032113656073852,7.044199514592687
2008-05-07T09:30:00-04:00,28.22,28.28999,27.91,27.92,2370849,2698187.3,49.08543648913632,52.3617052906469,NaN,NaN,21.43799862968779,59.04737679798882,-0.015583776683682452,0.05472581993870307,0.07030959662238552,7012361,9633430.4,58.608859428716556,61.880613075063984,NaN,NaN,4.732050421137656,6.713892501241968
2008-05-08T09:30:00-04:00,27.92,28.112,27.92,28,1377043,2669117.95,50.768389359689,52.25117669220746,NaN,NaN,-2.1686307190019063,52.71646805044851,-0.01714304312213409,0.0488807927197179,0.066023835841852,8389404,8598716,52.35775664593888,61.40956153063602,NaN,NaN,4.217421568270314,6.357253796531732
2008-05-09T09:30:00-04:00,27.72,28.00999,27.53999,27.84,2844476,2693948.65,47.39419743533113,51.771137708696244,NaN,NaN,-172.0550676876176,-4.220452573140369,-0.028034447389101914,0.030980776605474603,0.05901522399457652,5544928,7788518.4,48.03732327106427,60.39871981360684,NaN,NaN,2.7289428812182823,5.838923665772668
2008-05-12T09:30:00-04:00,27.86,28.14999,27.84,28.14999,1344025,2644478.8,53.80074109242985,52.0559569571247,NaN,NaN,19.46006997627854,-9.103417938075834,-0.014146549450517146,0.04133203718143008,0.05547858663194723,6888953,7443771.2,46.28707173497693,59.18963260069879,NaN,NaN,3.5060375239982933,5.505654216947757
2008-05-13T09:30:00-04:00,28.21001,28.21001,27.95,28.05,2549315,2703902.45,51.61711905690362,51.88687376194518,NaN,NaN,37.71213769916283,-19.12269842029807,-0.01158721446716543,0.04099456854799044,0.05258178301515587,4339638,6435056.8,41.52020202033016,57.668197097066596,NaN,NaN,3.448906853013825,5.211833164957196
2008-05-14T09:30:00-04:00,28.14,28.35001,28.14,28.16,3384754,2680221.95,53.836874919729276,51.812245778350025,NaN,NaN,172.777281928313,11.145158239426973,-0.0028350870116519364,0.04903792425059095,0.051873011262242884,7724392,6577463,42.42172660269933,56.212172979806496,NaN,NaN,4.084096335806807,5.050727903649998
2008-05-15T09:30:00-04:00,28.2,28.5,28.11,28.5,984206,2614706.4,59.9527316143217,52.478279150882486,NaN,NaN,262.07588863807877,63.9940621108431,0.02402428622250053,0.08190336904036855,0.057879082817868015,8708598,6641301.8,42.84708070784198,54.94925599087139,NaN,NaN,6.649098289842242,5.2790665302488895
2008-05-16T09:30:00-04:00,28.5,28.53999,28.315,28.49001,2457904,2550750.35,59.70245197427055,52.83916218915755,NaN,NaN,253.25811170620102,149.05669798960682,0.03843461721965716,0.10592235434243946,0.0674877371227823,6250694,6782455,43.83506032445996,53.86621826258466,NaN,NaN,8.594629394827818,5.752718368045879
2008-05-19T09:30:00-04:00,28.50999,28.64999,28.37,28.64999,2167451,2541975.4,62.408823130212454,53.343996281549764,NaN,NaN,237.6183156687558,192.6883471281023,0.05504620440979971,0.13629549263503193,0.08124928822523222,8418145,7088293.4,46.01270540724832,52.7399353847947,NaN,NaN,11.07299119849067,6.512757343823706
2008-05-20T09:30:00-04:00,28.31,28.39999,28.16,28.22,3690094,2588961.85,52.25139083537012,53.945596885702805,NaN,NaN,70.94805150119606,199.33552988850892,0.0343907209293729,0.12423768938694835,0.08984696845757545,4728051,7165976,46.57926821058181,51.65734527329919,NaN,NaN,10.01182029526379,7.012623479743718
2008-05-21T09:30:00-04:00,28.28999,28.33,27.89,27.92999,2266800,2631375.6,46.7274465038687,53.393510621019196,NaN,NaN,-36.367880306587935,157.50649744152875,0.0003145672830524582,0.09024017756139102,0.08992561027833856,2461251,6113347.8,40.39337317297715,50.04946858466,NaN,NaN,7.23156259661414,7.043900496439493
2008-05-22T09:30:00-04:00,28.08,28.25999,27.95,28.23,1783403,2584978.35,52.34060614312142,53.3016651601374,NaN,NaN,11.262745045842316,107.34386872308144,-0.002734093096119855,0.08650799390818875,0.0892420870043086,4244654,5220559,36.02363123501567,47.946697219494794,NaN,NaN,6.797304603630273,7.0086725117524615
2008-05-23T09:30:00-04:00,28.2,28.2,28.05,28.08,2510420,2412037.85,49.53053625563237,53.17083797372565,NaN,NaN,-11.706676171292116,54.35091114758281,-0.014887861326500065,0.07063226034618353,0.0855201216726836,1734234,4317267,32.22519112192376,45.618630589283235,NaN,NaN,5.513440472713469,6.795067934746891
2008-05-27T09:30:00-04:00,28.03,28.28,28.03,28.16,1573413,2335818.35,51.04027147231301,52.88978687730921,NaN,NaN,11.235531616984566,9.074354337228568,-0.017399419023445495,0.06377084789337673,0.08117026691682222,3307647,3295167.4,28.556040633859197,43.26466360840241,NaN,NaN,4.965042231653509,6.533635691447836
2008-05-28T09:30:00-04:00,28.33,28.33,28.05,28.2,1392260,2268853.45,51.81638660036151,53.08485474239672,NaN,NaN,27.934450311377145,0.4716340992647794,-0.016248815711282602,0.060859247277718964,0.07710806298900157,4699907,3289538.6,28.53677061543766,41.11665726459677,NaN,NaN,4.757400749854359,6.279887842648768
2008-05-29T09:30:00-04:00,28.23,28.51801,28.06,28.31,3419278,2309248,53.97701133060255,53.314042026033405,NaN,NaN,73.21074434259397,22.38735902910117,-0.008358886548322203,0.0666594548035988,0.07501834135192101,8119185,4421125.4,37.64643113174491,40.0658482992972,NaN,NaN,5.218362413732536,6.128241352803592
2008-05-30T09:30:00-04:00,28.50999,28.53999,28.34,28.49001,2311030,2207376.45,57.34764548717865,54.025002601165376,NaN,NaN,135.7355544765756,47.281920915247824,0.007828444608412588,0.08480389711243674,0.07697545250402416,10430215,5658237.6,45.78331984420737,39.90484805452171,NaN,NaN,6.616668996628028,6.198016730492797
2008-06-02T09:30:00-04:00,28.49001,28.49001,28.065,28.24001,2447105,2131378.7,51.68605743985899,53.87395376883888,NaN,NaN,38.391998570599945,57.30165586362623,0.0009077837128972782,0.07811018214514576,0.07720239843224848,7983110,6908012.8,52.52365964369979,40.35031861943048,NaN,NaN,6.12335263896626,6.187350431703291
2008-06-03T09:30:00-04:00,28.13,28.39,28.0601,28.39,2637712,2214102.95,54.58305150117751,54.08580608628701,NaN,NaN,40.72712381755691,63.1999743037407,0.0053906318829435584,0.08394068828592793,0.07855005640298438,10620822,8370647.8,58.9549536412334,41.595658020923565,NaN,NaN,6.58345138670455,6.2439362824177564
2008-06-04T09:30:00-04:00,28.25999,28.37,28.17,28.37,2180147,2284584.25,54.11707734114165,54.10582054495933,NaN,NaN,46.92271144917101,66.99762653129947,0.005925329291134346,0.0859567180169023,0.08003138872576795,8440675,9118801.4,61.80509288839923,42.98018418418785,NaN,NaN,6.82241056357428,6.326575465440117
2008-06-05T09:30:00-04:00,28.41,28.67,28.38,28.66,1662499,2249166.75,59.51416869703012,54.07449462229564,NaN,NaN,150.5991856245388,82.47531478768845,0.023727343327948375,0.10969056788570342,0.08596322455775504,10103174,9515599.2,63.262168260485765,44.4384047236624,NaN,NaN,8.673921713160555,6.661910643685894
2008-06-06T09:30:00-04:00,28.58,28.58,27.92,27.95,2102078,2285418.5,45.42590881142647,53.05474153923535,NaN,NaN,-40.48927333124004,47.23034922612531,-0.012452777320825684,0.07039725290672294,0.08285003022754862,8001096,9029775.4,60.23245625541705,45.60964729015934,NaN,NaN,5.500478108278975,6.495991710056334
2008-06-09T09:30:00-04:00,28.03999,28.13,27.86,28.05,2486957,2267542.55,47.31751013697194,51.97679061114674,NaN,NaN,-117.93472160094674,15.965005191815976,-0.028850542382805294,0.046786852249042,0.0756373946318473,10488053,9530764,62.240693532108146,46.76878929907791,NaN,NaN,3.6605150114985925,6.0909236102623705
2008-06-10T09:30:00-04:00,27.86,28.3,27.86,28.10001,3032666,2351974.6,48.28293505757452,51.69332948416134,NaN,NaN,-83.33586371172733,-8.847592314040869,-0.03511400106261793,0.031744893303574884,0.06685889436619281,13520719,10110743.4,64.47716461921885,48.047210471123414,NaN,NaN,2.519892143138122,5.58077625781605
2008-06-11T09:30:00-04:00,28.2,28.2,27.75999,27.95,6986246,2573821.15,45.58446786649795,51.61168815292057,NaN,NaN,-135.15251084100157,-45.26263677207538,-0.04738190918791171,0.007631507881303179,0.055013417069214886,6534473,9729503,61.88251759577084,49.58214935846581,NaN,NaN,0.7327527401513769,4.888201469578239
2008-06-12T09:30:00-04:00,28.03,28.27,27.925,28.14,2360702,2522618.55,49.43888073215702,51.4044220521374,NaN,NaN,-60.593642741800345,-87.50120244534321,-0.04096354905437313,0.0038089807512484697,0.0447725298056216,8895175,9487903.2,60.22843842074109,51.3110641574462,NaN,NaN,0.41755389558238026,4.2495375304359735
2008-06-13T09:30:00-04:00,28.07001,28.22,27.95,28.12,4316379,2689227.2,49.04506618478697,51.36974561850558,NaN,NaN,-61.54267170928688,-91.71188212095258,-0.0364778042207561,-0.0008247254703235285,0.035653078750432575,4578796,8803443.2,55.68714601268224,52.986918078214664,NaN,NaN,0.04935112961788661,3.6495109017476755
2008-06-16T09:30:00-04:00,27.89,27.92,27.67999,27.82001,6055453,2869104.65,43.45377509573345,50.827853020178466,NaN,NaN,-179.81114246460658,-104.08716629368455,-0.0512237027704492,-0.02837654971262893,0.02284715305782027,-1476657,6410501.2,43.373843391076235,54.04533256087303,NaN,NaN,-1.9969603183746638,2.842872156015913
2008-06-17T09:30:00-04:00,27.87,27.92,27.63,27.73,3046703,2913067.25,41.90993460182283,50.12024930599714,NaN,NaN,-188.5148183356589,-125.12295721847086,-0.0637334362170087,-0.0568196422134406,0.006913794003568095,-4523360,2801685.4,31.91323545978412,54.286508621183486,NaN,NaN,-4.143467484826392,1.8448236358955836
2008-06-18T09:30:00-04:00,27.64,27.69,27.38,27.42,3251750,2891150.05,37.03029543839793,48.9097695994111,NaN,NaN,-249.0123604469996,-147.89492713967047,-0.0880797902701761,-0.10318594383415203,-0.015106153563975929,-7775110,-60231.2,26.03756911711308,53.45730419156693,NaN,NaN,-7.5876849442607694,0.4973224101589617
2008-06-19T09:30:00-04:00,27.36,27.58,27.36,27.50999,2159339,2885777,39.24182469496849,47.6164966856818,NaN,NaN,-201.7596026898266,-176.12811912927572,-0.09284165368704374,-0.1311582206727806,-0.038316566985736863,-5615771,-2962420.4,21.678707292383564,51.735546152150945,NaN,NaN,-9.74631680521299,-0.9660546206084597
2008-06-20T09:30:00-04:00,27.17999,27.33,26.98,27.08,5297352,3061474.45,33.235462150701736,46.29859702217057,NaN,NaN,-232.72630774165944,-210.36484633575023,-0.11805101696201468,-0.18588033818825522,-0.06782932122624054,-10913123,-6060804.2,18.179641178458127,49.28240197606225,NaN,NaN,-13.696863371264214,-2.784741584987853
2008-06-23T09:30:00-04:00,27.14999,27.16,26.91,26.98,1515271,3011717,32.00843787032569,44.68612461996686,NaN,NaN,-200.41151947309814,-214.48492173744853,-0.13342670750466068,-0.23461270560706637,-0.10118599810240571,-12428394,-8251151.6,16.190190415722654,46.22777603138291,NaN,NaN,-17.275548185992644,-4.854856813702823
2008-06-24T09:30:00-04:00,26.92,27.21919,26.84,27.07001,2343077,3050200.2,34.35759132956471,43.274732761997086,NaN,NaN,-157.0975362840194,-208.20146532712064,-0.12940272262536856,-0.2629394013841164,-0.13353667875874786,-10085317,-9363543,15.275900333558425,42.90426227746571,NaN,NaN,-19.491446060778397,-6.94579813471362
2008-06-25T09:30:00-04:00,27.17,27.67999,27.11,27.67999,4769059,3219040.15,47.576409982360055,42.422035710949224,NaN,NaN,-68.52861442569777,-172.10471612286028,-0.07995213532685197,-0.23347684791731282,-0.15352471259046085,-5316258,-8871772.6,17.494129186933947,39.63511662935486,NaN,NaN,-17.070654168021502,-8.392206139471888
2008-06-26T09:30:00-04:00,27.2,27.28999,26.75,26.84,2228955,3159524,36.63549965215124,41.79414934242957,NaN,NaN,-136.11875994069214,-158.97654757303337,-0.09697278610754517,-0.2747406952248923,-0.17776790911734713,-7545213,-9257661,17.115449747441076,36.555330450213724,NaN,NaN,-19.04775952395822,-9.914428051541364
2008-06-27T09:30:00-04:00,26.77,26.89999,26.36,26.56,3321009,3210022.95,33.841775456697405,40.8315968652671,NaN,NaN,-162.05058869323972,-144.84140376334943,-0.1188057963588213,-0.32627515456587375,-0.20746935820705245,-10866222,-9248280.8,17.16238963193298,33.33545160020122,NaN,NaN,-21.638409316116924,-11.5892825179093
2008-06-30T09:30:00-04:00,26.48,26.83,26.42999,26.75,2226583,3198996.85,37.33393508490561,40.04952543864789,NaN,NaN,-131.65646065290835,-131.0903919993115,-0.11224549338450676,-0.3477762249376859,-0.23553073155317913,-8639639,-8490529.8,21.05202191844174,30.23365569300285,NaN,NaN,-22.38374553685945,-13.131348663473608
2008-07-01T09:30:00-04:00,26.36,26.72,26.28999,26.72,7943371,3464279.8,37.0018222231259,39.43647932126417,NaN,NaN,-127.0325952105966,-125.07740378462692,-0.10201676952811489,-0.3630516934633228,-0.2610349239352079,-16583010,-9790068.4,19.372043264575737,27.197193240774627,NaN,NaN,-23.060748331509284,-14.549834330335846
2008-07-02T09:30:00-04:00,26.69,26.77,26.59,26.69,2998973,3505221.1,36.6507075544703,38.52303838000084,NaN,NaN,-102.81786560409788,-131.93525402030696,-0.08979244028504779,-0.37327547429151764,-0.28348303400646985,-19581983,-12643213.4,16.297085010748376,24.059239425775143,NaN,NaN,-23.700205688807703,-15.857030238688969
2008-07-03T09:30:00-04:00,26.67,26.88,26.63,26.67,1730541,3508623.2,36.402706821943205,37.62001271122629,NaN,NaN,-86.67535690710625,-122.0465734135898,-0.07611529201285461,-0.37862714902253813,-0.3025118570096835,-21312524,-15396675.6,13.989279985211368,21.08082042381294,NaN,NaN,-24.284450271615235,-17.060947386249865
2008-07-07T09:30:00-04:00,26.84,27.005,26.61,26.94,3255072,3566272.9,42.09879440917829,37.523228376472346,NaN,NaN,-63.32418045596911,-102.30129176613566,-0.04356391897766809,-0.3569667557317686,-0.3134028367541005,-18057452,-16834921.6,12.957143364587836,18.90819899334948,NaN,NaN,-23.085043626378525,-17.921532563411102
2008-07-08T09:30:00-04:00,26.94,27.28999,26.83,27.28999,6431008,3763475.45,48.53363875438881,37.996350101655636,NaN,NaN,-20.905699982750562,-80.1511396321041,0.004315121633567176,-0.3080089347121415,-0.3123240563457087,-11626444,-17432282.6,12.543202195501792,17.524625188757884,NaN,NaN,-20.00180582354782,-18.21871445771635
2008-07-09T09:30:00-04:00,27.28,27.34,27.02,27.02,3225235,3773103.9,44.431432594644285,38.525002755673235,NaN,NaN,-17.05894704987931,-58.156409999960644,0.01971583866126131,-0.2876792580191321,-0.3073950966803934,-14851679,-17086016.4,14.253237236253995,16.682887197267945,NaN,NaN,-18.646500148291732,-18.27982669922712
2008-07-10T09:30:00-04:00,27.09,27.22,26.88,27.22,4386129,3643098.05,47.941634953683675,39.14641777415289,NaN,NaN,-14.975798328866025,-40.587996544914276,0.0439011680746591,-0.2525186365870695,-0.2964198046617286,-10465550,-15262729.8,22.811640948408836,16.76381102984118,NaN,NaN,-16.416075973890774,-18.013576595607642
2008-07-11T09:30:00-04:00,27.03,27.21001,26.83,26.92999,4209605,3735543.2,43.6370976869114,39.88939174102501,NaN,NaN,-29.825722003596926,-29.218069564212385,0.0409533343233513,-0.24522813675753952,-0.2861814710808908,-14675155,-13935256,28.413855176386477,17.49482631540749,NaN,NaN,-15.85060588888755,-17.704580780361916
2008-07-14T09:30:00-04:00,26.83,27.25999,26.83,26.95,3935405,3716494.5,44.01063840188512,40.74669177899354,NaN,NaN,-16.86528076963138,-19.92628962694484,0.04084490107725858,-0.23512534473431757,-0.27597024581157614,-10739750,-12471715.6,34.09324011715444,18.77361557979547,NaN,NaN,-15.289073078997701,-17.3595082515956
2008-07-15T09:30:00-04:00,26.75,27.16,26.57001,26.89999,8632465,3845345.1,43.23934755254877,41.38110293777811,NaN,NaN,-43.908289415262466,-24.526807513447217,0.03796022669730348,-0.22851996243994677,-0.26648018913725025,-19372215,-14020869.8,31.26566221296632,19.9157414283246,NaN,NaN,-15.047336303990413,-17.029197973366287
2008-07-16T09:30:00-04:00,26.86,27.25999,26.86,27.24001,3588738,3872446.85,49.69452330527361,41.53239674655765,NaN,NaN,36.338823551744056,-13.847253393122546,0.05829096194065847,-0.19361648671142717,-0.25190744865208564,-15783477,-14207229.4,30.93329794221144,20.875682053701563,NaN,NaN,-12.894939727447621,-16.438589652520765
2008-07-17T09:30:00-04:00,27.2,27.28999,26.771,27.28999,5109777,3965348.2,50.58414120315814,42.528728285915285,NaN,NaN,44.96659714615621,-1.8587742981181008,0.07346436333529477,-0.1600769944829672,-0.23354135781826196,-10673700,-14248859.4,30.854393212975495,21.857035158382594,NaN,NaN,-10.877354515197368,-15.644127490045994
2008-07-18T09:30:00-04:00,27.3,27.3,26.83,26.83,2963662,4005564.35,43.040184468597246,43.18575750105099,NaN,NaN,9.67546745819663,6.041463594240611,0.05189729885229971,-0.16866973425288734,-0.22056703310518705,-13637362,-14041300.8,31.78862071030983,22.901765949695225,NaN,NaN,-11.337048788741466,-15.028830532716777
2008-07-21T09:30:00-04:00,26.89999,27.10001,26.75999,26.77,3792854,3930339.45,42.15701867174646,43.53026347153963,NaN,NaN,-27.912453909942002,3.8320289661784854,0.033840746204992944,-0.17826610034894586,-0.2121068465539388,-17430216,-15379394,29.062464096653855,23.473940390996088,NaN,NaN,-11.972345594139613,-14.592189827205754
2008-07-22T09:30:00-04:00,26.8,27.32001,26.8,27.24001,1357738,3922462.8,50.692393033592765,44.50816138657297,NaN,NaN,62.8042514310127,25.174537135433518,0.05267793878731086,-0.14625942306980022,-0.19893736185711108,-16072478,-14719446.6,32.15288848298209,24.386857906596543,NaN,NaN,-9.820766281357491,-13.910557892084574
2008-07-23T09:30:00-04:00,27.28,27.44,27.14,27.42999,3088462,3959732.05,53.66840468877326,45.72371118188033,NaN,NaN,129.89318348846268,43.88540912277724,0.07566101528977837,-0.10436109274488814,-0.1800221080346665,-12984016,-14159554.4,34.75006740305372,25.704928077475497,NaN,NaN,-7.094218237329086,-12.93679508426236
2008-07-24T09:30:00-04:00,27.38,27.48,27.118,27.25999,3320037,3887280.95,50.71846893010118,46.74626561817733,NaN,NaN,121.40923206994108,59.173936107534225,0.07689231128670698,-0.08390671892628276,-0.16079903021298975,-16304053,-15285625,32.089471280791216,26.99779888430263,NaN,NaN,-5.741999467587486,-11.908967139023092
2008-07-25T09:30:00-04:00,27.31,27.31,27.07001,27.11,5232844,4037475.4,48.20108886555276,47.18214379363265,NaN,NaN,69.06041825557539,71.05092626700997,0.06552720441585325,-0.07889002469317319,-0.14441722910902643,-21536897,-16865532,28.762146576790784,28.12672768517427,NaN,NaN,-5.380969776585877,-10.976396087246346
2008-07-28T09:30:00-04:00,26.92,27.17,26.88,26.88,1859897,3964419.8,44.54954796223647,46.89756587990748,NaN,NaN,-4.179836259289849,75.79744979714039,0.04160729290676296,-0.09240811297557272,-0.13401540588233568,-23396794,-18058847.6,26.524990242817935,29.12542683141114,NaN,NaN,-6.188143906857429,-10.2923600614765
2008-07-29T09:30:00-04:00,27.02,27.50999,27,27.50999,2977627,4001972,54.67753899021664,47.62943062244837,NaN,NaN,129.27106550637993,89.09081261221384,0.06585991563422496,-0.05169051133955449,-0.11755042697377945,-20419167,-18928185.4,24.999450816731127,29.89301351573093,NaN,NaN,-3.5176759231713364,-9.32454804171862
2008-07-30T09:30:00-04:00,27.63,27.89999,27.50999,27.83,3801496,3794878.25,58.79459677677475,48.40464218124059,NaN,NaN,257.2731169667998,114.56679930788127,0.0991024795051295,0.006327672407632434,-0.09277480709749707,-16617671,-19654916.4,23.768771923299767,29.96138001393743,NaN,NaN,0.1145230560076973,-7.976109313472003
2008-07-31T09:30:00-04:00,27.58,27.73,27.34,27.39999,5016137,3895736.45,51.963762392088356,48.99940394589608,NaN,NaN,147.76685602792224,119.83832409947749,0.08814673537811356,0.017408612125144884,-0.07073812325296867,-21633808,-20720867.4,22.05384052283864,29.507093252969725,NaN,NaN,0.8332783716353996,-6.71762535845666
2008-08-01T09:30:00-04:00,27.49001,27.53999,27.28,27.35001,4155258,4016972.3,51.21891197020051,49.514280629347176,NaN,NaN,93.95784501000985,124.8178094503644,0.0741143888126114,0.021904862762795574,-0.052209526049815824,-25789066,-21571301.2,20.76650605699662,28.55518367724417,NaN,NaN,1.14696410036263,-5.5941125786253325
2008-08-04T09:30:00-04:00,27.39999,27.8,27.36,27.60001,2253529,3966895.15,54.71551517641132,50.3340068881945,NaN,NaN,143.13109107460016,154.2799949171424,0.07786438734479276,0.045120958131175115,-0.032743429213617635,-23535537,-21599049.8,20.723998517515383,27.802207698997673,NaN,NaN,2.5318448275396226,-4.433261520601768
2008-08-05T09:30:00-04:00,27.88,28.3492,27.77,28.08,3395819,3815135.7,60.560731449812316,51.11016461280441,NaN,NaN,235.0343233325772,175.43264648238187,0.10706338997562181,0.10108580825590963,-0.005977581719712181,-20139718,-21543160,21.07442462353235,27.098002461949164,NaN,NaN,5.720023141210976,-2.9827922831999474
2008-08-06T09:30:00-04:00,27.87,28.42999,27.82001,28.38,5259051,3916826.5,63.713352344956604,52.04796540864716,NaN,NaN,215.4666088361073,167.07134485624334,0.13895211494637189,0.16771256196325268,0.028760447016880797,-14880667,-21195759.2,23.342676655253527,26.561451279254744,NaN,NaN,9.41732207193703,-1.2113473753232367
2008-08-07T09:30:00-04:00,28.21001,28.23,27.83,27.83,3992624,3897151.25,55.02859928590981,52.90428075274092,NaN,NaN,134.10578437550686,164.33913052576025,0.11629333189251959,0.17412711188253027,0.05783377999001069,-18873291,-20643655.8,26.936433668998816,26.214866490589667,NaN,NaN,9.604692966875158,0.33380124499081965
2008-08-08T09:30:00-04:00,27.82001,28.5414,27.81,28.41,3085267,3840934.35,61.05705165352303,54.2542831085821,NaN,NaN,161.32177862471227,177.81191724870075,0.13248194250608814,0.22343620812262088,0.09095426561653273,-15788024,-18643447.4,38.2339811867714,26.86997485416949,NaN,NaN,11.945401509073577,1.9926012827169277
2008-08-11T09:30:00-04:00,28.46001,28.77,28.39999,28.66,2904903,3789409.25,63.33833041183875,55.15756434988538,NaN,NaN,183.51162073121392,185.88802318002348,0.15080893094739914,0.27946542930078166,0.12865649835338253,-12883121,-16512964.2,47.53882110704167,27.96897004160232,NaN,NaN,14.590282903197057,3.7922700856426603
2008-08-12T09:30:00-04:00,28.71001,28.86,28.52,28.86,3044141,3509993.05,65.09971106143425,55.97408623364687,NaN,NaN,169.5630457894897,172.793767671406,0.16598087491584607,0.3361325919981901,0.17015171708234406,-9838980,-14452816.6,54.65282983022849,29.39059592925766,NaN,NaN,17.281969290102015,5.719369971993997
2008-08-13T09:30:00-04:00,28.73,28.75,28.42999,28.57001,4616891,3561400.7,60.55672823999142,56.67681904149618,NaN,NaN,124.44366200255972,154.58917830469647,0.14673163867636868,0.3535662654278049,0.2068346267514362,-14455871,-14367857.4,54.92429594513182,31.021654833853415,NaN,NaN,17.9974056110767,7.473375063291526
2008-08-14T09:30:00-04:00,28.53999,28.89,28.35001,28.7,4390855,3525454.6,61.842184038913416,57.651182982450514,NaN,NaN,115.4693713755303,150.86189570470117,0.13338466166800705,0.373565453836445,0.24018079216843796,-10065016,-12606202.4,60.239418621379684,33.27003140846691,NaN,NaN,18.97321852640996,9.116209843737016
2008-08-15T09:30:00-04:00,28.72,29.02,28.64999,28.98,1961996,3475371.3,64.52413010761336,59.077938849977464,NaN,NaN,126.43778579223752,143.88509713820625,0.13370605411396358,0.40731335981089245,0.27360730569692887,-8103020,-11069201.6,64.20519885729775,35.96147488092979,NaN,NaN,20.62948260809507,10.760963095788167
2008-08-18T09:30:00-04:00,28.99001,28.99001,28.595,28.86,2579843,3414720.75,62.49676500277231,59.63645499373144,NaN,NaN,106.29916531555217,128.4426060550739,0.11674585914012597,0.41953962962208635,0.3027937704819604,-10682863,-10629150,65.27315982583505,38.838168381580076,NaN,NaN,21.36800031170015,12.276254126632736
2008-08-19T09:30:00-04:00,28.52,28.62,28.39,28.47,2744231,3484045.4,56.30486704585521,59.45861715580862,NaN,NaN,62.13083532173242,106.95616396152244,0.07234612475845803,0.3932264264300329,0.3208803016715749,-13427094,-11346772.8,62.02327885177435,41.5706331621854,NaN,NaN,20.091351091395005,13.392696550170204
2008-08-20T09:30:00-04:00,28.42999,28.55,28.17,28.48,2201359,3439690.25,56.42408258531887,59.77721145532509,NaN,NaN,45.783741327142245,91.22417982643893,0.038437500186174645,0.3689271769042932,0.3304896767181186,-11225735,-10700745.6,63.771984150325856,44.55050056414877,NaN,NaN,19.105808600149423,14.20885541445295
2008-08-21T09:30:00-04:00,28.11,28.35001,28.0305,28.17,1888560,3368116.4,51.71374364504527,59.812556574956865,NaN,NaN,14.21682773331075,70.97367109799502,-0.007627213132416433,0.32095566030259803,0.32858287343501447,-13114295,-11310601.4,60.92016946419896,47.41861937894894,NaN,NaN,16.84027084050956,14.584771903889608
2008-08-22T09:30:00-04:00,28.35001,28.81,28.35001,28.67999,2801751,3246561.75,57.93518841513237,60.0425332348655,NaN,NaN,66.58379353473005,59.002872646493515,-0.006549108868728504,0.32039648734910386,0.32694559621783237,-10312544,-11752506.2,58.865973159780076,50.1430461391107,NaN,NaN,16.730752135409517,14.891340508392453
2008-08-25T09:30:00-04:00,28.46001,28.56,28.13,28.22,3148336,3310983.7,51.49097066854416,59.39469317906063,NaN,NaN,14.621109265851437,40.66726143655337,-0.037866246665600733,0.27961278788583144,0.31747903455143217,-13460880,-12308109.6,56.29571334282651,52.658852476203144,NaN,NaN,14.53502523752104,14.840438326839394
2008-08-26T09:30:00-04:00,28.12,28.28999,28.00999,28.11,1495523,3236878.5,50.057059988350765,58.41924372501735,NaN,NaN,-22.531892279728982,23.734715916261084,-0.06542454947821719,0.23569834770366072,0.3011228971818779,-14956403,-12613971.4,54.87523658267144,54.91117818530442,NaN,NaN,12.32568735053372,14.481188187367154
2008-08-27T09:30:00-04:00,28.09,28.272,28.03999,28.24001,1247796,3109193.5,51.76670790813772,58.186251483747924,NaN,NaN,-18.895755443639793,10.798816562104678,-0.0737162422969031,0.20897759431074903,0.2826938366076521,-13708607,-13110545.8,52.556614550580534,56.7411911054174,NaN,NaN,11.022453507995774,13.987083233171242
2008-08-28T09:30:00-04:00,28.36,28.46001,28.17999,28.42,1487447,2932759,54.10887350839681,57.68995304481033,NaN,NaN,7.317013125464902,9.418853640535502,-0.06613971192366214,0.20001919670307444,0.2661589086267366,-12221160,-12931918.8,53.320671298707076,57.818811827698525,NaN,NaN,10.61479471230801,13.50532773019078
2008-08-29T09:30:00-04:00,28.42,28.45,28.08,28.14,1666937,2808342.95,50.03819619802776,56.73994345810955,NaN,NaN,-36.80216412435798,-11.2583378912821,-0.07821920231140295,0.16838490573748288,0.24660410804888583,-13888097,-13647029.4,49.85886229659124,57.98452905552349,NaN,NaN,9.051502419155893,12.869066971471511
2008-09-02T09:30:00-04:00,28.45,28.7,28.34,28.45,3600919,2875712.45,54.150812335512185,55.957879263400834,NaN,NaN,26.6125692514972,-8.86004589415295,-0.06415477982858203,0.1664106332631583,0.23056541309174033,-10287178,-13012289,52.788811156646425,57.85138486455334,NaN,NaN,8.932650365094954,12.306721741989145
2008-09-03T09:30:00-04:00,28.36,28.52,28.24001,28.24001,2137120,2812777.5,51.08333800576553,55.281208532384696,NaN,NaN,-28.121529679902405,-9.977973374187638,-0.06747946480529773,0.14621608208511816,0.2136955468904159,-12424298,-12505868,55.04583447142508,57.860066187860006,NaN,NaN,7.916992845962158,11.67961761398529
2008-09-04T09:30:00-04:00,28.48,28.48,28.03999,28.06,3137468,2706698.35,48.54470162921282,54.331388360263226,NaN,NaN,-72.18314467964797,-20.63545122138927,-0.0794619670631582,0.11436808806146814,0.19383005512462634,-15561766,-12876499.8,53.04704097464563,57.346324927379,NaN,NaN,6.314753607824021,10.913208470247966
2008-09-05T09:30:00-04:00,28.06,28.39999,27.92,28.32001,8917832,2952958.75,52.23695376880396,53.45373290749112,NaN,NaN,-73.75135396701064,-36.84912463988438,-0.0679807205650558,0.10885415441830659,0.1768348749833624,-6643934,-11761054.6,57.991012143422424,56.90245444781648,NaN,NaN,6.023435943529105,10.214669537859557
2008-09-08T09:30:00-04:00,28.77,29.13,28.58,28.92,4121574,3004774.1,59.46512923793397,53.23718749571695,NaN,NaN,129.5997903975714,-3.568733735498506,-0.020543045670375737,0.1511560678953927,0.17169911356576845,-2522360,-9487907.2,65.8765296041255,56.94555228912294,NaN,NaN,8.07754568528343,9.909366130348682
2008-09-09T09:30:00-04:00,29.25999,29.28999,28.72,28.77,4849469,3102002.4,57.13710842990945,53.29663330886368,NaN,NaN,130.58962637896823,17.2266776899957,-0.0008711272836136319,0.1706102044612514,0.17148133174486505,-7371829,-8904837.4,67.5586774502566,57.340937903300244,NaN,NaN,9.03132015625519,9.783930991192468
2008-09-10T09:30:00-04:00,28.98,28.98,28.74001,28.97,5141254,3206858.05,59.41838150353347,53.51051180302186,NaN,NaN,115.80892254043063,46.01276813406231,0.022704686179414568,0.19986218946913326,0.1771575032897187,-2230575,-6866092.8,72.63780248063279,57.974210641179305,NaN,NaN,10.523259713198902,9.88954938005053
2008-09-11T09:30:00-04:00,28.8,29.23,28.56,29.09,4498980,3200962.5,60.76758297898644,54.157214612589094,NaN,NaN,117.8208107772396,84.01355922543982,0.04233434066841388,0.23007542912523604,0.18774108845682216,2268405,-3300058.6,78.86951246740769,59.256306569979934,NaN,NaN,12.152916895522631,10.212887596546544
2008-09-12T09:30:00-04:00,29.02,29.16,28.91,29.14999,3219170,3142378.25,61.45745749585579,54.4088052612122,NaN,NaN,128.86867200833365,124.53756442050867,0.054535413706073455,0.255910355589414,0.20137494188334054,5487575,-873756.8,81.89144078065544,60.90098282861389,NaN,NaN,13.689419012744786,10.709534941717722
2008-09-15T09:30:00-04:00,29.05,29.16,28.59,28.8,7420355,3415296.2,55.343110778500005,54.68395812620905,NaN,NaN,77.03672854194639,114.02495204938369,0.0351525323444378,0.2453156073138878,0.21016307496945,-1932780,-755840.8,82.02597494468095,62.73885865731778,NaN,NaN,13.27134267632446,11.075507475232971
2008-09-16T09:30:00-04:00,28.99001,28.99001,27.92999,28.8,7878797,3680243.9,55.343110778500005,55.06153318264827,NaN,NaN,14.838803157990814,90.87478740518819,0.019244947345578717,0.2342192591514234,0.21497431180584467,-1932780,331969,83.26144324808251,64.76644484770429,NaN,NaN,12.931916895102061,11.340708820928555
2008-09-17T09:30:00-04:00,28.34,28.57001,27.75,27.77,8617867,3973925.7,41.3141560489871,54.314922335566095,NaN,NaN,-107.94793252606681,46.123416391888725,-0.05942654418914067,0.14069113156941881,0.2001176757585595,-10550647,-1332045.4,74.79243187278269,66.35471751357588,NaN,NaN,7.8102373145974555,10.83635574859554
2008-09-18T09:30:00-04:00,28.49001,28.58,27.78,27.95,11022406,4414978.05,43.98639467848056,53.591888133429215,NaN,NaN,-83.39516447831058,5.880221340778692,-0.09595832848254743,0.08016976515537522,0.17612809363792264,471759,-1691374.6,73.0641552226264,67.7649663652844,NaN,NaN,4.560723758112169,9.939836892812203
2008-09-19T09:30:00-04:00,29.49001,30.28999,27.7,27.7,6403543,4640727.2,41.18162290725758,52.95927575551706,NaN,NaN,15.781888404614618,-16.737135379965114,-0.13138559116092813,0.011896104686762499,0.14328169584769063,-5931784,-3975246.4,63.08595558519051,68.70975874304148,NaN,NaN,0.9677531848984746,8.658110648824527
2008-09-22T09:30:00-04:00,27.78,29.38,27.37,27.55,5088602,4755069.75,39.55201289066066,51.9165043665991,NaN,NaN,-82.36931391821192,-48.61834387199677,-0.15758218471817717,-0.053696035050030844,0.10388614966814633,-11020386,-5792767.6,56.47592293133039,68.97312386980462,NaN,NaN,-2.4676953979142704,7.068709785004699
2008-09-23T09:30:00-04:00,27.55,27.82001,27.17999,27.17999,3901722,4792739.05,35.78977634107858,50.82410710483574,NaN,NaN,-202.076930935565,-92.00149069070794,-0.19030126751794457,-0.1339904347292844,0.05631083278866018,-14922108,-8390633.2,48.63228603014651,68.51501326685616,NaN,NaN,-6.635453916262628,5.11097211339508
2008-09-24T09:30:00-04:00,27.21001,27.49001,27.05,27.13,4509789,4943452.35,35.301212314492346,49.87814358235571,NaN,NaN,-202.0328701565913,-110.81847821681284,-0.20453666796963366,-0.1993600021733819,0.005176665796251763,-19431897,-10166883.2,44.12032874984094,67.8773909650844,NaN,NaN,-10.122374082949051,2.934779799631633
2008-09-25T09:30:00-04:00,27.33,27.89999,27.24001,27.8,7749539,5268539.5,45.950704287057874,49.42912576223099,NaN,NaN,-115.87907803110089,-117.3152609273709,-0.1600263509875214,-0.19485627293815,-0.03482992195062859,-11682358,-12597706.6,38.813263192909766,66.50755175433349,NaN,NaN,-9.882464578763992,1.1037448884322583
2008-09-26T09:30:00-04:00,27.45,27.96001,27.45,27.7,2529371,5320635.7,44.766316317795216,48.37921055364965,NaN,NaN,-94.13818583264809,-139.29927577482346,-0.12980352949328405,-0.19708433381723367,-0.06728080432394962,-14211729,-14253695.6,35.665828336224905,64.34964452091201,NaN,NaN,-10.058201106416229,-0.4908188251175256
2008-09-29T09:30:00-04:00,27.89,27.95,26.66,26.66,9894344,5732006.05,34.73806048586931,46.77927855764678,NaN,NaN,-158.63787504665032,-154.5529880005111,-0.16981291910797175,-0.2795469532089143,-0.10973403410094257,-24106073,-16870833,31.340349532429343,61.76262109821007,NaN,NaN,-13.836074895179998,-2.397283977983593
2008-09-30T09:30:00-04:00,27.00999,27.60001,26.98,27.60001,2583580,5681139.1,46.42100748453054,45.85089469914657,NaN,NaN,-104.43733717635573,-135.02506924866924,-0.12499848917783213,-0.26598214557323274,-0.14098365639540061,-21522493,-18190910,29.403322404097324,58.674443949886104,NaN,NaN,-12.622915007083908,-3.8580884107122095
2008-10-01T09:30:00-04:00,27.53,28.08,26.98,27.8,8520008,6000283.5,48.53201643043502,44.97692565996433,NaN,NaN,-67.93980358648395,-108.20645593464778,-0.07630882967365121,-0.23636969348746462,-0.1600608638138134,-13002485,-16905027.6,33.701852131107415,55.448182497293224,NaN,NaN,-10.933640003187756,-4.868881495351573
2008-10-02T09:30:00-04:00,27.85001,27.85001,27.34,27.45,5136340,6100227.1,45.177268114843486,43.81405498989203,NaN,NaN,-69.53185639727825,-98.93701160788326,-0.06266779741975026,-0.23839561058850123,-0.17572781316875097,-18138825,-18196321,31.619748032708287,51.85734730101128,NaN,NaN,-10.76334465502828,-5.710947661019674
2008-10-03T09:30:00-04:00,28.55,28.75,27.202,27.23,5895004,5949085.7,43.1578300954419,42.94367779824502,NaN,NaN,-44.53601014865559,-89.01657647108478,-0.06327052229005775,-0.25481596603132317,-0.19154544374126542,-24033829,-20160741,28.71352292935434,48.04931501420224,NaN,NaN,-11.306224413534691,-6.510272911378962
2008-10-06T09:30:00-04:00,26.53999,27.02,25.5,26.44,9393590,6212686.5,36.79702155036932,41.61895713909282,NaN,NaN,-179.06827130208725,-93.10265572217217,-0.10900122440218935,-0.3277969742440021,-0.21879574984181277,-33427419,-22025010.2,26.24791189288493,43.97691991740242,NaN,NaN,-14.04201232810898,-7.586235685197536
2008-10-07T09:30:00-04:00,27.32001,27.32001,25.35001,25.60001,6318867,6286156.4,31.483657112332992,40.91677864361753,NaN,NaN,-178.83135502104435,-107.9814592911099,-0.18356179857932553,-0.4482479980659697,-0.2646861994866442,-39746286,-25669768.8,22.22904424897844,40.222392229987825,NaN,NaN,-18.366577928115127,-9.126284577042906
2008-10-08T09:30:00-04:00,24.31,25.82001,24.31,24.89999,8483211,6453254.25,27.87170863502591,39.765729640513634,NaN,NaN,-245.3657295505585,-143.4666444839248,-0.2629328566612451,-0.5933522703132006,-0.3304194136519555,-48229497,-32715171.2,16.85633053542358,36.207547609473345,NaN,NaN,-23.274499218187135,-11.147458097206368
2008-10-09T09:30:00-04:00,25.17,25.42999,23.375,23.39999,13187305,6887670.5,22.03747624336866,38.398290593092995,NaN,NaN,-256.9063974692489,-180.94155269831896,-0.39161184837568674,-0.8199342241215639,-0.42832237574587717,-61416802,-41370766.6,12.772094303756532,32.6137003750852,NaN,NaN,-30.073296545146267,-13.851149304054925
2008-10-10T09:30:00-04:00,22.74001,24.25999,21.63,23.60001,14752930,7464358.5,24.312628172512504,37.309763113225266,NaN,NaN,-240.92515394201112,-220.21938145699005,-0.43506666479926925,-0.9721557067449638,-0.5370890419456945,-46663872,-45896775.2,11.238659117355027,29.382467245515535,NaN,NaN,-34.186451368135664,-16.756192456066458
2008-10-13T09:30:00-04:00,25.52,25.52,23.77,24.7,6320238,7409352.65,35.466151421015994,37.28664704750651,NaN,NaN,-123.37647929962918,-209.08102305649845,-0.36440105809458345,-0.9925903645639238,-0.6281893064693403,-40343634,-47280018.2,10.811436251086121,26.680977975582646,NaN,NaN,-33.29096192448489,-19.118302380126234
2008-10-14T09:30:00-04:00,26.24001,26.24001,23.94,24.75,15790402,7804932.9,35.92834144653587,37.33144198550962,NaN,NaN,-91.17008805527247,-191.54876966334405,-0.2920887540356867,-0.9933002490139486,-0.701211494978262,-24553232,-44241407.4,18.170322808062437,24.82740612259847,NaN,NaN,-32.46858512885851,-21.02548562994513
2008-10-15T09:30:00-04:00,24.44,24.44,22.78,23.89999,7790039,7763541.5,31.763486473263214,36.31806928452429,NaN,NaN,-132.8460328174761,-169.04483031672757,-0.27930586870479157,-1.0503438308592514,-0.7710379621544599,-32343271,-41064162.2,25.126804476958,23.84980192860192,NaN,NaN,-33.265767408956144,-22.774097312660988
2008-10-16T09:30:00-04:00,24.10001,24.13,22.21001,24.13,11936469,7809244.65,33.99324812579347,35.54856441366702,NaN,NaN,-123.52154293580372,-142.36785941003853,-0.23494402187898156,-1.0647179895031869,-0.8297739676242053,-20406802,-32862162.2,39.43951446806623,24.119350938019156,NaN,NaN,-33.12677524658113,-24.25305130322101
2008-10-17T09:30:00-04:00,23.85001,24.6483,23.35001,24.31,6180559,7798095.45,35.76230594093916,35.62172480331487,NaN,NaN,-85.29694957153961,-111.24221853594425,-0.17577065150676163,-1.0494872820076573,-0.8737166305008957,-14226243,-26374636.4,47.91982833266685,25.303599423750402,NaN,NaN,-32.449028348079565,-25.423905166772233
2008-10-20T09:30:00-04:00,24.82001,24.88,24,24.50999,5524875,7819909.1,37.758283633486215,35.00295881395456,NaN,NaN,-61.7541142879738,-98.91774553361316,-0.10873933900757193,-1.0096408042603606,-0.9009014652527887,-8701368,-20046183.2,54.598578346692754,27.103260562507216,NaN,NaN,-31.28762512440898,-26.261579446434624
2008-10-21T09:30:00-04:00,24.87,24.87,24.2,24.28,4127352,7831190.6,36.35913255937431,34.1334671088788,NaN,NaN,-56.06930077666104,-91.89758807789087,-0.06748919292104871,-0.9852629564040996,-0.9177737634830508,-12828720,-17701280.8,56.80877145403217,28.753754799858985,NaN,NaN,-30.743166336316648,-26.901806144989198
2008-10-22T09:30:00-04:00,24.50999,24.50999,22.98,23.89999,7026594,7957030.85,34.11004961462446,33.34295150172029,NaN,NaN,-77.0923103946519,-80.74684359332605,-0.05398068770187803,-0.9852496231103984,-0.9312689354085204,-19855314,-15203689.4,59.093000731243436,30.716129992611496,NaN,NaN,-30.940925043429246,-27.478823130480635
2008-10-23T09:30:00-04:00,23.5,24,22.47,24,8948469,8016977.35,35.24531202758371,32.777771639730425,NaN,NaN,-83.8236225830774,-72.80725952278078,-0.027811455806611596,-0.966033255166785,-0.9382217993601734,-10906845,-13303698,60.79177714475235,33.00743386513993,NaN,NaN,-30.781189071687283,-27.950589693510157
2008-10-24T09:30:00-04:00,22.25,23.17,22.25,22.8,7992406,8290129.1,28.82726347431648,32.20850320572665,NaN,NaN,-111.21447429336013,-77.99076446714488,-0.07797877329449376,-1.0356952659782905,-0.9577164926837968,-18899251,-14238299.6,59.4832201625907,35.38138445583319,NaN,NaN,-32.6631229675278,-28.623808732655533
2008-10-27T09:30:00-04:00,22.14999,23.05,22.13,22.22,4859266,8038375.2,26.3314724692963,31.840490016938315,NaN,NaN,-116.07806496022198,-88.85555460159452,-0.1336178264059673,-1.124738775691256,-0.9911209492852886,-23758517,-17249729.4,55.349045310326424,37.74709881735805,NaN,NaN,-35.06339629908839,-29.54374981357451
2008-10-28T09:30:00-04:00,22.81,24.25,22.22,23.75,4701063,8144249.35,40.8737721725111,32.7692088410444,NaN,NaN,-66.38346600102035,-90.91838764646637,-0.05480995358813656,-1.0596333912704594,-1.0048234376823229,-19057454,-18495476.2,53.68676847385854,40.377844384389114,NaN,NaN,-32.0900502754713,-29.907507022416908
2008-10-29T09:30:00-04:00,24.22,24.64,23.25,23.28999,7062430,8071370.45,38.41822159420985,33.93926208039021,NaN,NaN,-44.89380342148317,-84.47868625183263,-0.022737457387202342,-1.0332452594163257,-1.0105078020291234,-26119884,-19748390.2,51.995414799895705,43.17951013411334,NaN,NaN,-30.57488144202371,-30.00284622521788
2008-10-30T09:30:00-04:00,23.84,24.48,23.81,24.27,6944184,8161762.65,45.87799987952871,35.47964577374851,NaN,NaN,-8.30138779276089,-69.37423929376934,0.07031145243223791,-0.922618486488826,-0.992929938921064,-19175700,-21402161.2,49.76674760640588,45.93151645475984,NaN,NaN,-26.627463741288054,-29.52064872751362
2008-10-31T09:30:00-04:00,24.75999,24.92999,24.00999,24.12,12867117,8510368.3,44.97987369152723,36.159197364499306,NaN,NaN,20.03937092265094,-43.12347025056709,0.12442656707631428,-0.8373967300756711,-0.9618232971519853,-32042817,-24030874.4,46.36484772505531,48.47104584575764,NaN,NaN,-23.881120355401695,-28.715001817211917
2008-11-03T09:30:00-05:00,24.58,24.77,24.38,24.49001,7543078,8417842.7,47.69971654739071,37.00000987170323,NaN,NaN,52.127762686126616,-9.482304721297371,0.1842041594933489,-0.7315680977852992,-0.9157722572786481,-24499739,-24179118.8,46.17316117032337,50.47124858591913,NaN,NaN,-20.778366016109544,-27.58119670276872
2008-11-04T09:30:00-05:00,25.21001,25.36,24.66,24.85001,4796805,8341739.6,50.275257697600814,38.32227924487019,NaN,NaN,109.29343910846454,25.653076300599604,0.24333858975078992,-0.6115990200901606,-0.8549376098409506,-19702934,-24308214.8,45.99482846818579,51.96182172814969,NaN,NaN,-17.426782188032387,-26.130566057806387
2008-11-05T09:30:00-05:00,25.32001,25.32001,24.34,24.41,5029945,8169076.3,47.21479369152967,39.26667535670849,NaN,NaN,83.02858350435804,51.23755368576784,0.24736058677846262,-0.5457368763678723,-0.7930974631463349,-24732879,-24030813.8,46.473229756217016,52.4642299630176,NaN,NaN,-15.56414613347986,-24.621077497188313
2008-11-06T09:30:00-05:00,24.39999,24.64999,23.5,24.14999,6800910,7849756.55,45.45396567989284,39.958936766633755,NaN,NaN,14.560738764791184,55.809978997278265,0.2275517333067596,-0.5086577965128853,-0.7362095298196449,-31533789,-26502431.6,42.83250041782648,52.100849397671865,NaN,NaN,-14.556509255244393,-23.183282034053466
2008-11-07T09:30:00-05:00,24,24.31,23.88,24.25999,4683301,7346275.1,46.3652882169818,40.57372280831201,NaN,NaN,15.773250340955567,54.95675488093919,0.21693911461389503,-0.4650356365522761,-0.6819747511661711,-26850488,-25463965.8,44.78955245238979,51.40020469093594,NaN,NaN,-13.472987855512573,-21.796097151404766
2008-11-10T09:30:00-05:00,24.73,24.73,23.92,24.33,3000155,7180270.95,46.9725303665398,41.33182265168097,NaN,NaN,40.85906636938912,52.70301561759169,0.20960033222758467,-0.4199743358816903,-0.629574668109275,-23850333,-25334084.6,45.042957526123864,50.55978941037106,NaN,NaN,-12.412843822871146,-20.455632390185677
2008-11-11T09:30:00-05:00,24.2,24.23,23.608,23.78,4558387,6618670.2,42.866507580875734,41.95728393498463,NaN,NaN,-10.750869878161666,28.694153820266443,0.1646529268144069,-0.4237585095912664,-0.5884114364056733,-28408720,-27075241.8,42.243763424941314,49.3562724599209,NaN,NaN,-12.625233726342053,-19.337004009636587
2008-11-12T09:30:00-05:00,23.53999,23.61,23,23.27,6267684,6542552.45,39.425054364478136,42.25583695904852,NaN,NaN,-83.4242676982085,-4.596416420246865,0.10066681157855029,-0.4625779219324855,-0.5632447335110358,-34676404,-29063946.8,39.24393940612876,47.81714119287636,NaN,NaN,-13.807579818325078,-18.547086268020657
2008-11-13T09:30:00-05:00,23.11,24.2,22.53999,24.2,7828637,6337160.85,47.67466155456044,43.602079679065945,NaN,NaN,-38.841235425698436,-15.276811258344788,0.11976985563068876,-0.4135324139726748,-0.5333022696033636,-26847767,-28126742.4,41.35740411135454,46.522440046359485,NaN,NaN,-12.356444863586166,-17.662708924530016
2008-11-14T09:30:00-05:00,23.86,24.33,23.39,23.48,6104520,6333358.9,42.81334774813215,44.779356484697075,NaN,NaN,-24.73672567766606,-23.378806462069115,0.08437803685746059,-0.4278297235315378,-0.5122077603889984,-32952287,-29347102.2,39.433814429268224,45.38563784056962,NaN,NaN,-12.636395382832502,-16.944664132858943
2008-11-17T09:30:00-05:00,23.32001,23.72,22.95,23.17,4648574,6289543.85,40.88050649413714,44.77983750767037,NaN,NaN,-77.01199658775886,-46.9530190534987,0.04265811897984573,-0.4588851116641912,-0.5015432306440369,-37600861,-32097207.8,35.4341186212869,44.081877136814505,NaN,NaN,-13.464867247988183,-16.447550292163122
2008-11-18T09:30:00-05:00,23.92,23.92,22.75,23.33,6971168,6431734.65,42.32770207045598,45.05908611311652,NaN,NaN,-63.6324358841975,-57.529332254705864,0.029055973725588935,-0.4652232634870508,-0.4942792372126397,-30629693,-32541402.4,34.81980089739494,42.85504757235016,NaN,NaN,-13.713424279410875,-16.056960861769944
2008-11-19T09:30:00-05:00,23.35001,23.8,22.66,22.73,6408809,6400845.4,38.519714418781895,44.533494294491746,NaN,NaN,-89.16771115370314,-58.67802094580479,-0.014777098392378951,-0.5127506102031134,-0.49797351181073446,-37038502,-33013822,34.14185070848855,41.73898350821321,NaN,NaN,-15.086237339442137,-15.918286072865971
2008-11-20T09:30:00-05:00,22.73,23.28999,21.71001,21.94,11979355,6552389.7,34.16185862319462,43.76077893246799,NaN,NaN,-159.34691741816962,-82.77915734429902,-0.08735220385602227,-0.6071637666307623,-0.51981156277474,-49017857,-37447840,28.527609028037617,40.4648950298548,NaN,NaN,-17.684474783009815,-16.170598745743664
2008-11-21T09:30:00-05:00,22.03,22.99001,21.39999,22.99001,16419660,6973752.4,43.33750226544344,43.449192198043185,NaN,NaN,-137.38422118658448,-105.30865644608272,-0.05651351909867608,-0.5904534616480852,-0.5339399425494091,-32598197,-37377022,28.729188654924855,39.21889699304062,NaN,NaN,-16.953000188618123,-16.282370380440014
2008-11-24T09:30:00-05:00,23.32001,23.89,22.82001,23.28,7533523,7107465.25,45.59272888989605,43.1147258546357,NaN,NaN,-49.18459071553529,-99.74317527163801,-0.01084758401551389,-0.5474994225688015,-0.5366518385532876,-25064674,-34869784.6,35.64908423590779,38.479915262163615,NaN,NaN,-15.641316688228072,-16.190791281552592
2008-11-25T09:30:00-05:00,24.14,24.14,23.00999,23.41,7972348,7271029.5,46.61845318682899,43.072130104299944,NaN,NaN,-27.240010597306828,-92.46469021425987,0.03153243634788039,-0.4972362931184371,-0.5287687294663175,-17092326,-32162311.2,42.17790958705948,38.17310667865236,NaN,NaN,-14.278696038279254,-15.91763481822783
2008-11-26T09:30:00-05:00,23.12,23.72,22.89,23.71001,10188988,7427357.4,49.00767029336228,43.325966148119186,NaN,NaN,-34.3890777166423,-81.50896352684771,0.08040905055140934,-0.4282574162770558,-0.5086664668284652,-6903338,-26135278.4,53.49016407653773,38.93436836856031,NaN,NaN,-12.4320066807265,-15.419687941441925
2008-11-28T09:30:00-05:00,23.46001,24.07001,23.46001,24.07001,2234548,7191875.6,51.79572608639505,43.71385456736299,NaN,NaN,18.673058914531723,-45.90496826030744,0.13444056419380646,-0.3406157615862071,-0.47505632578001356,-4668790,-17265465,64.49803602926306,40.34211719547984,NaN,NaN,-10.04664949801295,-14.652111020952072
2008-12-01T09:30:00-05:00,23.59,23.67,22.64999,22.74001,7280773,6912558.4,42.54144533763201,43.39734849386958,NaN,NaN,-77.16002522729718,-33.86012906844998,0.0807123786173296,-0.37416585250835155,-0.45487823112568115,-11949563,-13135738.2,68.26420240221697,42.000777543772195,NaN,NaN,-10.809790119966893,-14.103208035097046
2008-12-02T09:30:00-05:00,22.95,23.21001,22.46001,23.07001,8265766,6948692.8,45.15960600221027,43.56114123825062,NaN,NaN,-82.75488398135833,-40.57418772161459,0.06801238359231404,-0.3698627516352886,-0.43787513522760263,-3683797,-8859562.8,71.6212621499638,44.099170309845235,NaN,NaN,-10.600151332617253,-13.602771363314218
2008-12-03T09:30:00-05:00,22.5,23.42999,22.47,23.35001,8389676,7128336.35,47.35167844028417,44.12732867223677,NaN,NaN,-55.57726413588542,-46.24163842933031,0.07834792111119043,-0.3399402338386146,-0.41828815494980504,4705879,-4499921.8,74.57426015086523,46.62276464875497,NaN,NaN,-9.756080099227699,-13.053244039873286
2008-12-04T09:30:00-05:00,23.33,23.55,22.82001,23.05,7789535,7266315.85,45.26397223564107,43.955136578028245,NaN,NaN,-41.27580498655035,-47.61898388331191,0.06538642424949798,-0.3365551246379326,-0.40194154888743056,-3083656,-3735985.4,75.06391438691011,49.030372525580376,NaN,NaN,-9.681811961644108,-12.571610885840547
2008-12-05T09:30:00-05:00,22.89,23.87,22.61,23.7,8089359,7330738.3,50.369546064512626,44.49486502919827,NaN,NaN,6.160967063228389,-50.12140225357258,0.0989806505762133,-0.27821573566716395,-0.37719638624337726,5005703,-1801086.8,76.30841665697724,51.664272684702446,NaN,NaN,-8.052030716803843,-11.92595657597816
2008-12-08T09:30:00-05:00,24.48,24.48,23.58,23.84,8635668,7528356.65,51.420594764332435,45.247728477069366,NaN,NaN,113.67244231536668,-11.95490874503981,0.1272214319359114,-0.21816959632348798,-0.3453910282593994,13641371,3317100,79.25740529828347,54.794507447345055,NaN,NaN,-6.415991664876705,-11.138818731535096
2008-12-09T09:30:00-05:00,23.7,23.78999,23.12,23.38,10381203,7897409.05,47.8359703428552,45.64117621081217,NaN,NaN,26.227766845348167,9.84162142030149,0.11204578761096107,-0.20533379374569805,-0.3173795813566591,3260168,4705893,79.98540611354079,58.02062210564119,NaN,NaN,-6.064701066874924,-10.413944779440786
2008-12-10T09:30:00-05:00,23.53,23.53,23.07001,23.37,7463691,8042674.25,47.75802686310728,46.30105567112113,NaN,NaN,10.361220074979961,23.02931826247456,0.09891567483834474,-0.19373498780872822,-0.29265066264707296,-4203523,2924012.6,76.28594042410774,61.03091422818541,NaN,NaN,-5.801431922837255,-9.755014371354568
2008-12-11T09:30:00-05:00,23,23.55,23,23.11,7506637,8104621.9,45.67423418158082,47.123368211005854,NaN,NaN,-12.054360760407508,28.873607107703133,0.07157609903626083,-0.20318053885174692,-0.27475663788800775,-11710160,1198711.8,72.77609527569734,64.19152038873254,NaN,NaN,-6.153142104889319,-9.240461190430961
2008-12-12T09:30:00-05:00,22.7,23.25,22.62199,23.14,6598488,8043114.45,45.96718741621273,47.31120286463223,NaN,NaN,-53.57391311927352,16.926631071202756,0.055107478929469156,-0.2058722892261713,-0.26097976815564045,-5111672,-824763.2,68.7792390940179,67.05223827723918,NaN,NaN,-6.368217813336672,-8.830140707988921
2008-12-15T09:30:00-05:00,23.31,23.31,22.87,23.12,4742969,7975036.9,45.789909088620725,47.32528716454114,NaN,NaN,-26.264717133792725,-11.060800818629124,0.042999391243717766,-0.20723052910099327,-0.25022992034471103,-9854641,-5523965.6,60.473036181894685,68.82537770195253,NaN,NaN,-6.594237989292682,-8.510726033889458
2008-12-16T09:30:00-05:00,23.17999,23.74001,23.13,23.66,8487047,8166960.55,51.256005394058036,47.65654089362893,NaN,NaN,66.36032530460531,-3.034289126777697,0.06989901419344405,-0.16285615260290598,-0.23275516679635003,-1367594,-6449518,58.962664569341236,70.02428877211551,NaN,NaN,-5.338489722744622,-8.057549418011625
2008-12-17T09:30:00-05:00,23.39999,23.75999,23.36,23.53999,6608801,8148842.2,50.0482081451501,47.73086502589948,NaN,NaN,71.09759406263028,9.112985670752366,0.07755818149124843,-0.1358074399322895,-0.21336562142353793,-7976395,-7204092.4,57.69744938737065,70.32480915146073,NaN,NaN,-4.586759445254724,-7.561722279046354
2008-12-18T09:30:00-05:00,23.74001,23.97501,23.38,23.62,7119977,8184400.6,50.87925543688626,47.66540283664886,NaN,NaN,84.99292784295551,28.522443391424964,0.08534433606285172,-0.10668520134497328,-0.192029537407825,-856418,-5033344,60.33435121508711,70.0274030933053,NaN,NaN,-3.7340099572681633,-7.01490623307804
2008-12-19T09:30:00-05:00,23.74001,23.86,23.22,23.23,9227523,8046809,46.79269656192766,47.96906363838426,NaN,NaN,30.231038834245144,45.2834337821287,0.06261246353265501,-0.11376395799200623,-0.17637642152466124,-10083941,-6027797.8,58.53424860887568,69.33240639378093,NaN,NaN,-4.0443831562186885,-6.590545793526704
2008-12-22T09:30:00-05:00,23.38,23.38,22.97,23.28999,4339699,7442810.95,47.49132619191887,48.135615080506305,NaN,NaN,-42.99868453215487,41.936640302456276,0.050518729239876936,-0.11322800997481508,-0.16374673921469202,-5744242,-5205718,59.607129185413754,68.4742540391702,NaN,NaN,-4.1285874521363475,-6.238837459042368
2008-12-23T09:30:00-05:00,23.33,23.4794,23.0126,23.10001,5958785,7364074.05,45.45579072803725,48.00019452963152,NaN,NaN,-44.48443508191126,19.767688225152963,0.02965910360757476,-0.12667285970522357,-0.15633196331279833,-11703027,-7272804.6,55.70429665290528,67.12639950360163,NaN,NaN,-4.727791846781907,-6.022973800148017
2008-12-24T09:30:00-05:00,23.22,23.35001,23.17,23.3,780836,7004498.45,47.98329719946225,48.19443202704732,NaN,NaN,-19.15797150703494,1.7165751112199197,0.029218058414170522,-0.1198093902950852,-0.14902744870925572,-10922191,-7861963.8,54.606839861140514,65.66517989461809,NaN,NaN,-4.605387062915849,-5.820461409114849
2008-12-26T09:30:00-05:00,23.45,23.45,23.22,23.32001,2630491,6626573.6,48.24172954737418,48.04244513296601,NaN,NaN,-0.5082194003082856,-15.38365433743284,0.0300456071848266,-0.11147043972822246,-0.14151604691304906,-8291700,-9349020.2,51.83116151799207,63.91680452754772,NaN,NaN,-4.437139613135024,-5.62284400968916
2008-12-29T09:30:00-05:00,23.32001,23.36,23.00999,23.27,1985042,6614098.3,47.605150348005196,47.76991338894264,NaN,NaN,-29.88394823709076,-27.406651751700018,0.02708791176450115,-0.10765615720742261,-0.13474406897192376,-10276742,-9387580.4,51.75769431015654,61.95253945696724,NaN,NaN,-4.447671787927483,-5.454962263723206
2008-12-30T09:30:00-05:00,23.39,23.66,23.38,23.64,3071347,6403627,52.58976131553114,48.10946988699091,NaN,NaN,81.91783852505172,-2.4233471402587012,0.048655064048748684,-0.0739252389109879,-0.12258030295973658,-7205395,-9679811,51.16578748035098,59.89399526888224,NaN,NaN,-3.1736179806019846,-5.129055937563032
2008-12-31T09:30:00-05:00,23.66,23.98,23.66,23.87,2815027,6131090.05,55.42840966564421,48.65735437288641,NaN,NaN,155.17671770471597,37.50888341706674,0.07541796232085293,-0.028307850058670425,-0.10372581237952336,-4390368,-8217279.2,54.00103390597852,58.302216231873004,NaN,NaN,-1.293692934514985,-4.581146937127596
2009-01-02T09:30:00-05:00,23.94,24.33,23.798,24.21001,3757968,5899504.65,59.30727551311363,49.631143039424465,NaN,NaN,204.00243303777347,82.14096432602842,0.11088318657377047,0.03487817083768974,-0.07600501573608073,-632400,-6159321,57.72075014660414,57.226834436937786,NaN,NaN,1.4743232299035582,-3.71607977040886
2009-01-05T09:30:00-05:00,24.11,24.31,24.05,24.31,6645465,5842301.15,60.398729203141954,50.66196745277655,NaN,NaN,191.25965458922695,120.49453912393547,0.13437347361946583,0.09196182628825156,-0.042411647331214275,6013065,-3298368,62.28654991742535,56.76307092432403,NaN,NaN,4.1256498332711695,-2.5958326841688555
2009-01-06T09:30:00-05:00,24.39999,24.42999,23.82001,23.95,8797422,5877704.3,54.709162091382666,51.299056952973835,NaN,NaN,128.25223637808872,152.12177604697138,0.11946495084714596,0.10691954122771818,-0.01254540961942778,-2784357,-1799891,64.4519089419353,57.04727612146979,NaN,NaN,4.9500690886106185,-1.5178467166289307
2009-01-07T09:30:00-05:00,23.69,23.89999,23.57001,23.71001,4228660,5657353.9,51.24365456255763,51.29817475072381,NaN,NaN,55.03111923695335,146.7444321893517,0.08865680043484779,0.09827559092413196,0.00961879048928417,-7013017,-1761415.4,64.50825726268863,57.443389885280325,NaN,NaN,4.690316665690548,-0.6309662334404337
2009-01-08T09:30:00-05:00,23.42,23.49001,23.17,23.39999,6252020,5450894.75,47.09363409976836,51.08713374748225,NaN,NaN,-34.03367224765367,108.90235419887776,0.04482686781868796,0.06565237526264411,0.02082550744395616,-13265037,-3536349.2,59.79912422537536,57.59350951656637,NaN,NaN,3.2554882077220877,-0.07575845613150212
2009-01-09T09:30:00-05:00,23.35001,23.42,23,23,6061340,5380777.2,42.330353720198076,50.47649791057595,NaN,NaN,-80.48691536160065,52.00448451900295,-0.010711072828718651,0.007436666408057846,0.018147739236776497,-19326377,-7275144.6,51.30330576192415,56.948434841340436,NaN,NaN,0.5304899321845016,0.010848456485069838
2009-01-12T09:30:00-05:00,23.05,23.17999,22.89999,23.00999,6542359,5332563.3,42.48681698298888,50.16893508350889,NaN,NaN,-100.83270217933638,-6.413986834709718,-0.04448759695389902,-0.03746175695559728,0.007025839998301741,-12784018,-11034561.2,44.46290327879375,55.94333874633459,NaN,NaN,-1.6369016554662243,-0.22454441665082936
2009-01-13T09:30:00-05:00,23.02,23.25,23,23.14999,9808676,5493072.7,44.749123756104474,49.97306348095073,NaN,NaN,-80.56508657543904,-48.17745142541526,-0.05445553487863543,-0.06104357859999254,-0.006588043721357116,-2975342,-11072758.2,44.39813021053992,54.85698167670074,NaN,NaN,-2.853461955426544,-0.60010406504736
2009-01-14T09:30:00-05:00,22.75,22.92,22.49001,22.64,5902418,5551045.15,38.76689020514158,49.49528487217247,NaN,NaN,-168.42622481927344,-92.86892023666061,-0.09033490457027887,-0.1195066744342057,-0.029171769863926833,-8877760,-11445706.8,43.72830163277335,54.00155346097703,NaN,NaN,-5.796559752004463,-1.3424548774698033
2009-01-15T09:30:00-05:00,22.50999,22.78,22.32001,22.74001,7621242,5507754.9,40.448171493320174,48.95706160744803,NaN,NaN,-157.0537615168028,-117.47293809049044,-0.10143953540932267,-0.15597118912558017,-0.0545316537162575,-1256518,-9044003,49.05830552433263,53.60522957977646,NaN,NaN,-7.743534683774501,-2.2568948497990458
2009-01-16T09:30:00-05:00,23.08,23.09,22.761,22.95,3835005,5369065.1,43.929374379276034,48.649036238298166,NaN,NaN,-85.64726559451456,-118.50500813707322,-0.08918384891691705,-0.1660114648624038,-0.07682761594548676,2578487,-4663030.2,57.04996266920684,53.978001090577514,NaN,NaN,-8.40592515384836,-3.135327750377519
2009-01-20T09:30:00-05:00,23,23.16,22.63,22.67999,11335238,5579828.15,40.639715881501395,48.15150520497646,NaN,NaN,-97.80757637571152,-117.89998297634824,-0.09335804202396472,-0.19352516847544265,-0.10016712645147793,-8756751,-3857576.8,58.34385193774031,54.44844092111922,NaN,NaN,-9.951438263958362,-4.109057823746211
2009-01-21T09:30:00-05:00,22.95,22.99001,22.36,22.78999,6566563,5446780.15,42.52792543783531,47.4328026422839,NaN,NaN,-106.19413188945124,-123.0257920391507,-0.083147214974579,-0.20410114516970168,-0.12095393019512268,-2190188,-3700546,58.60567235196203,54.97986126909144,NaN,NaN,-10.702887370515393,-5.051033473284665
2009-01-22T09:30:00-05:00,22.55,22.85001,22.36,22.77,8119520,5635771.2,42.26481505556617,46.49254588442119,NaN,NaN,-104.57920448284564,-110.25638797186514,-0.07256155319958718,-0.21165587169460665,-0.13909431849501946,-10309708,-3986935.6,57.891023487324496,55.257717667759,NaN,NaN,-11.394843963428935,-5.957292114733846
2009-01-23T09:30:00-05:00,22.38,22.67,22.28999,22.55,6117031,5643683.5,39.377423671812515,45.068985038613974,NaN,NaN,-116.18140269135043,-102.08191620677466,-0.0748946586452997,-0.23271264180164408,-0.15781798315634438,-16426739,-7020979.8,50.82064630045767,54.76485310731997,NaN,NaN,-12.806603372866684,-6.935765151609965
2009-01-26T09:30:00-05:00,22.67,22.955,22.55,22.7,6672953,5938289.35,42.27315184081895,43.77430094130518,NaN,NaN,-72.54844568811176,-99.4621522254941,-0.061419456174883924,-0.2345923033749493,-0.17317284720006537,-9753786,-9487434.4,45.91167596556266,53.59521925361549,NaN,NaN,-13.22332757428136,-7.833988354848736
2009-01-27T09:30:00-05:00,22.8,23.02,22.7,22.82001,8160434,6214786.5,44.555050000445846,43.04900722052398,NaN,NaN,-51.327565182395844,-90.16614998683096,-0.04051620931405925,-0.22381810884263942,-0.18330189952858017,-1593352,-8054754.6,48.99369142599508,52.49106085961976,NaN,NaN,-12.955532189959957,-8.56563747415034
2009-01-28T09:30:00-05:00,23.13,23.37,22.89,23.05,6032602,6417164.5,48.737176240433556,42.869973054657976,NaN,NaN,-12.683676851168176,-71.46405897917435,-0.008941979572599873,-0.19447937399433002,-0.18553739442173015,4439250,-6728867,51.73468900461218,51.578663126900004,NaN,NaN,-11.543650084196894,-8.991067847014133
2009-01-29T09:30:00-05:00,22.95,23.19,22.78999,22.85001,4191648,6473179.55,45.52175311039093,42.75769584113101,NaN,NaN,-32.949448625369314,-57.138107807679106,0.00024550370206183336,-0.18523051479415287,-0.1854760184962147,247602,-4617405,55.80750271547209,51.293547304764054,NaN,NaN,-11.21149081875677,-9.308271128691652
2009-01-30T09:30:00-05:00,22.77,22.78,22.00999,22.14999,8400973,6752476.85,36.45550268835317,42.338063624570665,NaN,NaN,-122.2668982235107,-58.35520691411116,-0.03699152105151246,-0.23171541981060528,-0.19472389875909282,-8153371,-2962731.4,58.74545659188726,51.825129506904275,NaN,NaN,-13.820447972917188,-9.952867820723872
2009-02-02T09:30:00-05:00,21.91,22.11,21.75,21.96001,5575027,6843329.8,34.45018838631522,41.76401872480826,NaN,NaN,-173.13358622707835,-78.47223502190448,-0.06874062926350522,-0.28064968533847434,-0.21190905607496913,-13728398,-3757653.8,56.792100410869885,52.70578644490972,NaN,NaN,-16.612492322229286,-10.90424274951036
2009-02-03T09:30:00-05:00,21.97,22.53,21.87,22.44,5453906,6783751.85,42.98369310611699,41.637916535523445,NaN,NaN,-112.5618595943371,-90.71909390429272,-0.052473082963646694,-0.2775004097795275,-0.2250273268158808,-8274492,-5093881.8,53.56768805551656,53.36075486240805,NaN,NaN,-16.24046593980819,-11.666560348124335
2009-02-04T09:30:00-05:00,22.39999,22.39999,21.78,21.83,7969414,6742351.45,36.48339137567836,41.47480947627607,NaN,NaN,-155.94547393601306,-119.3714533212617,-0.07640341812515536,-0.320531599472325,-0.24412818134716965,-16243906,-9230513,45.04197041627928,53.45458834694419,NaN,NaN,-18.213634046574562,-12.601856590760082
2009-02-05T09:30:00-05:00,21.78999,22.22,21.72,22.14,12049293,7133383.1,41.338505622010544,41.53840477118253,NaN,NaN,-138.96839842736117,-140.57524328166008,-0.06538814935512283,-0.3258633680410732,-0.26047521868595036,-4194613,-10118956,43.44273410326078,53.05347610258192,NaN,NaN,-18.116944394313382,-13.389726276981982
2009-02-06T09:30:00-05:00,22.23,22.60001,22.10001,22.52,7266465,7184105.35,46.715275654421156,41.73739771940718,NaN,NaN,-51.41531557106096,-126.40492675117011,-0.028430822354161722,-0.29601374662865254,-0.2675829242744908,3071852,-7873911.4,48.4259173728575,52.4374728671284,NaN,NaN,-16.155223666034658,-13.784797332560936
2009-02-09T09:30:00-05:00,22.47,22.48,22.19,22.3,4806754,7121376.05,44.1899597542709,41.990986567462144,NaN,NaN,-61.45784021382056,-104.06977754851854,-0.015376678681211231,-0.28680377262600487,-0.27142709394479364,-1734902,-5475212.2,53.17323321098586,52.06814295807451,NaN,NaN,-15.42818826590585,-14.019567465895925
2009-02-10T09:30:00-05:00,22.10001,22.19,21.45,21.58,7240492,7156282.7,37.11805357220456,41.60456714848852,NaN,NaN,-161.36373101054787,-113.83015183176072,-0.04986269236666252,-0.3337554594031218,-0.28389276703645927,-8975394,-5615392.6,52.866968323534124,51.65823552747252,NaN,NaN,-17.321769721419358,-14.491310645256416
2009-02-11T09:30:00-05:00,21.67999,21.8,21.56,21.7,5428105,6937254.15,38.873846853051795,41.36235513402321,NaN,NaN,-149.96163578277688,-112.63338420111347,-0.058617657086707964,-0.35716483839484425,-0.2985471813081363,-3547289,-3076069.2,57.62797473283209,51.639446330723054,NaN,NaN,-18.193063947156084,-15.020132545527797
2009-02-12T09:30:00-05:00,21.5,21.92999,21.39,21.89999,7142660,6999266.25,41.790936246971185,41.53474888939168,NaN,NaN,-121.68877397206965,-109.17745931005518,-0.04554757266456405,-0.35548164713884134,-0.3099340744742773,3595371,-1518072.4,60.27907397546182,52.31504830750907,NaN,NaN,-17.942035616421723,-15.437547269941215
2009-02-13T09:30:00-05:00,21.96001,21.96001,21.56,21.56,3952429,6815825.6,38.43302091270186,41.26045382309761,NaN,NaN,-114.01639453479277,-121.69767510280155,-0.05383957566109837,-0.37723354405065024,-0.32339396838955187,-357058,-2203854.4,58.54277592170786,53.21726973294801,NaN,NaN,-18.822460615197638,-15.921106319263561
2009-02-17T09:30:00-05:00,21.22,21.50999,21.09,21.248,5893355,6918743.1,35.60566865169102,40.621212298186556,NaN,NaN,-159.56269273361337,-141.31864560676013,-0.07317727300647126,-0.41486555964764094,-0.3416882866411697,-6250413,-3106956.6,56.24515525898964,53.735231435304776,NaN,NaN,-20.471333778961643,-16.571138813506145
2009-02-18T09:30:00-05:00,21.42999,21.45,21.17,21.36,6997207,6701841.55,37.38637520527619,39.81044079567531,NaN,NaN,-131.91882642781428,-135.42966469021343,-0.07119900826405345,-0.4306870469712365,-0.35948803870718304,746794,-1162519,59.894776159134395,54.31809480348493,NaN,NaN,-21.248065236130607,-17.239271159595354
2009-02-19T09:30:00-05:00,21.59,21.8,21.53999,21.63,5026855,6624856.15,41.58042459183565,39.52891733006421,NaN,NaN,-74.49245495196885,-120.33582852405182,-0.04571854752544269,-0.4166362231139864,-0.3709176755885437,5773649,701668.6,63.07476208440635,54.8371847584088,NaN,NaN,-20.614005725043473,-17.721376097516515
2009-02-20T09:30:00-05:00,21.11,21.59,21.11,21.3,7591391,6598449.7,38.21148325431668,39.654344513347326,NaN,NaN,-110.10402030674084,-118.01887779098604,-0.045029489978870185,-0.42720453806213143,-0.38217504808326125,-1817742,-380954,60.09465247061687,54.933555892603785,NaN,NaN,-21.11035238997859,-18.20551556786824
2009-02-23T09:30:00-05:00,21.28999,21.4599,20.74001,20.75,5494613,6567328.8,33.36010272056774,39.57648125150822,NaN,NaN,-143.30769071791863,-123.87713702761118,-0.07385257992267841,-0.47449077298660924,-0.40063819306393084,-7312355,-1772013.4,56.40689715337906,54.90604137421157,NaN,NaN,-23.131596617134072,-18.909241432049072
2009-02-24T09:30:00-05:00,20.92,21.23,20.77,21.14999,6060090,6536685.65,39.38718382282115,39.31958773127281,NaN,NaN,-121.58224944932752,-116.28104837075402,-0.05886789074677029,-0.4742230564973937,-0.4153551657506234,-1252265,-772383.8,58.38328503132554,55.25001258676936,NaN,NaN,-22.862438344048226,-19.473983848048952
2009-02-25T09:30:00-05:00,21.08,21.24001,20.82001,20.95,5800883,6418708.1,37.558154007996194,39.39635649072409,NaN,NaN,-117.33703661993513,-113.36469040917818,-0.05536600659052515,-0.48456267398877984,-0.4291966673982547,-7053148,-2332372.2,54.2497724388071,55.90771273123563,NaN,NaN,-23.223264876351347,-20.00959542352072
2009-02-26T09:30:00-05:00,21.10001,21.11,20.46001,20.4872,5424008,6388278.4,33.66248716424259,38.84806945802637,NaN,NaN,-153.1058643552582,-129.08737228983608,-0.0758906266152709,-0.5240599506673433,-0.44816932405207244,-12477156,-5982533.2,46.036626112331334,56.092990731883525,NaN,NaN,-24.801570567379404,-20.694163301214818
2009-02-27T09:30:00-05:00,20.37,20.745,20.28,20.36,5643254,6460858.7,32.65979085961081,37.84410625839706,NaN,NaN,-162.81911160325564,-139.630390549139,-0.0888084814265439,-0.5591799258352523,-0.47037144440870843,-18120410,-9243066.8,40.18428975238668,55.504303044707044,NaN,NaN,-26.38210143475025,-21.50672589171988
2009-03-02T09:30:00-05:00,20.14,20.34,19.89,19.97,6964805,6389050.3,29.73525433188368,36.811627299655115,NaN,NaN,-182.9295706879019,-147.55476654313568,-0.11285025743259258,-0.6114342661994492,-0.4985840087668566,-25085215,-12797638.8,34.96571903022448,54.2037663175098,NaN,NaN,-28.66408494229012,-22.52920575608706
2009-03-03T09:30:00-05:00,20.14999,20.14999,19.64999,19.73,6351230,6427860.45,28.069504728209637,36.16530238222691,NaN,NaN,-177.81786921197647,-158.80189049566548,-0.13277412397537636,-0.6645516637360771,-0.5317775397607007,-31436445,-18834474.8,28.254646900865296,52.44574335874774,NaN,NaN,-31.0768605434096,-23.750299297133136
2009-03-04T09:30:00-05:00,19.99001,20.35001,19.729,20.11,5214926,6415911.45,34.341240756682836,35.84154480391484,NaN,NaN,-134.12459706394537,-162.1594025844675,-0.10920295198401342,-0.6682812297407175,-0.559078277756704,-26221519,-22668149,24.976212276575453,50.11347461187227,NaN,NaN,-31.179631061478442,-24.811632406325323
2009-03-05T09:30:00-05:00,19.99001,20.03,19.44,19.64999,7267996,6380840.55,30.83612128754855,35.05905802109894,NaN,NaN,-147.9388522431853,-161.12600016205295,-0.1129641524300895,-0.700283468294316,-0.5873193158642265,-33489515,-26870620.8,21.967189780595447,47.3769114550961,NaN,NaN,-32.39081624179238,-25.89437295424919
2009-03-06T09:30:00-05:00,19.7,19.94,19.31,19.71001,6912223,6123987.05,31.814023234347232,34.58627247264504,NaN,NaN,-134.48328760039507,-155.45883536148082,-0.10021501819264655,-0.7125880886050346,-0.6123730704123881,-26577292,-28561997.2,20.877035821902894,44.68650144796717,NaN,NaN,-33.05812524036905,-26.917766137980596
2009-03-09T09:30:00-04:00,19.67999,19.82001,19.2794,19.41,4769766,5999152.1,29.56392015448924,34.154719008559205,NaN,NaN,-129.54920867389083,-144.7827629586786,-0.10053371992397941,-0.7380402203173624,-0.637506500393383,-31347058,-29814365.8,20.082334178922196,42.10344279939092,NaN,NaN,-34.30811661593262,-27.973530491973744
2009-03-10T09:30:00-04:00,19.46001,19.84,19.45,19.77,4260438,5971836.3,35.46249936350718,34.0172993055757,NaN,NaN,-99.85612152106478,-129.19041342049627,-0.06667694822322034,-0.7208526856724085,-0.6541757374491881,-27086620,-28944400.8,22.295112481905036,39.41775253673169,NaN,NaN,-33.56566784363443,-28.7724072564967
2009-03-11T09:30:00-04:00,19.91,20.00999,19.66,19.75,5810414,5900332.4,35.28570710588254,33.56767662800762,NaN,NaN,-79.56641678839812,-118.27877736538683,-0.037273221780735555,-0.7007672646751075,-0.663494042894372,-32897034,-30279503.8,21.319516207221866,36.435234974075655,NaN,NaN,-33.02078445426366,-29.37931828474912
2009-03-12T09:30:00-04:00,19.75,20.31,19.64999,20.25999,4139148,5835884.55,43.07839663402968,33.91531329798712,NaN,NaN,-48.72827054057141,-98.43666102486405,0.021705707094973103,-0.6363619090256556,-0.6580676161206287,-28757886,-29333178,23.86264776645524,33.84723463806411,NaN,NaN,-30.12892627150584,-29.48640514000008
2009-03-13T09:30:00-04:00,20.42,20.67,20.25,20.56,3651043,5661303.7,47.11294824010893,34.89765940652577,NaN,NaN,-2.65816964060944,-72.07163743290691,0.08268012223370502,-0.5547174633284975,-0.6373975855622025,-25106843,-29039088.2,24.67744735330723,31.580845366630403,NaN,NaN,-26.424726353764548,-29.049022456252146
2009-03-16T09:30:00-04:00,20.81,21.12,20.72,20.88,4294238,5678394.15,51.09469005968612,35.733909852016126,NaN,NaN,48.05597552063469,-36.550600594001814,0.1427961602827631,-0.4589023852087486,-0.6016985454915117,-20812605,-26932197.6,30.42218895421216,29.58362421826516,NaN,NaN,-22.028232948981266,-28.046052526642022
2009-03-17T09:30:00-04:00,20.97,21.27,20.8,21.27,3795983,5573525.55,55.4926824283919,37.0149475963301,NaN,NaN,73.2941380580529,-1.9205486781782752,0.20336457728322688,-0.34749282388747815,-0.550857401170705,-17016622,-24918198,35.487341031842874,28.243450546339144,NaN,NaN,-16.844309321258738,-26.445803497301554
2009-03-18T09:30:00-04:00,21.08,21.37,20.85001,21.16,5077137,5477522.05,54.017169428494334,38.46885347234809,NaN,NaN,77.26756624582393,29.446247928666132,0.22866909922578227,-0.2650210271384772,-0.49369012636425946,-22093759,-22757543,40.492354232590124,27.84743112635763,NaN,NaN,-13.069930684750675,-24.53496452408
2009-03-19T09:30:00-04:00,21.2,21.24001,20.685,20.89,5385801,5495469.35,50.46988967975122,39.7410033880724,NaN,NaN,63.13231083544586,51.81836420386959,0.219812380724283,-0.21892465045890575,-0.43873703118318874,-27479560,-22501877.8,41.074901907778305,27.91104628031417,NaN,NaN,-10.911218784808856,-22.58871513275555
2009-03-20T09:30:00-04:00,20.84,20.89999,20.57001,20.57001,3539825,5292891.05,46.566892811518656,40.9432632794749,NaN,NaN,37.411640937455644,59.832326319482604,0.1863171004511469,-0.20584065561925513,-0.39215775607040204,-31019385,-23684386.2,39.16515483876651,28.21100598092432,NaN,NaN,-10.231469740584963,-20.823394362445466
2009-03-23T09:30:00-04:00,20.91,21.49001,20.86,21.47,6526340,5344477.4,56.70750972178847,42.98883506473054,NaN,NaN,109.87285210611701,72.19570163657907,0.21656634407232656,-0.12144982597999388,-0.33801617005232043,-24493045,-24420474.2,37.98135055457097,28.905770527617584,NaN,NaN,-6.146798785995984,-18.726737851524113
2009-03-24T09:30:00-04:00,21.39,21.562,21.27,21.37,4791324,5281039.1,55.44832519265108,44.49648395301398,NaN,NaN,120.18693095072533,81.57426021511355,0.22087308085265828,-0.0619248189864976,-0.2827978998391559,-29284369,-26874023.6,34.26373470968612,29.569164987125486,NaN,NaN,-3.3346832034062768,-16.527872901792993
2009-03-25T09:30:00-04:00,21.41,21.78999,21.25,21.58,4945105,5238250.2,57.57861002774633,46.40666172017096,NaN,NaN,128.31326146557862,91.78339925906451,0.22797385203063478,0.002169415199137603,-0.22580443683149717,-24339264,-27323124.6,33.61515534270404,30.401162527276096,NaN,NaN,-0.36244364717610783,-14.218525865419153
2009-03-26T09:30:00-04:00,21.77,21.82001,21.48,21.82001,6675188,5300809.2,59.93646779013636,48.415407759870185,NaN,NaN,130.227717652021,105.20248062237951,0.23784920524901582,0.07150706972977261,-0.1663421355192432,-17664076,-25360027.8,39.0465240172573,31.69898311265856,NaN,NaN,2.83937348881943,-11.781683100527927
2009-03-27T09:30:00-04:00,21.61,21.765,21.49001,21.61,4300332,5233663.1,56.95350075710666,50.37180637434285,NaN,NaN,105.53306611117134,118.82676565712268,0.21968459888184602,0.10826361308306431,-0.11142098579878171,-21964408,-23549032.4,43.6285725757624,33.38085728386143,NaN,NaN,4.6143041245871,-9.43939921122578
2009-03-30T09:30:00-04:00,21.39,21.39,20.87,21.14,5073598,5139102.75,50.85361494675508,51.47117177314628,NaN,NaN,51.784996059323575,107.20919444776398,0.16780464769766584,0.09833482382330061,-0.06946982387436523,-27038006,-24058024.6,42.65797345588214,34.83534735343123,NaN,NaN,4.273076122659203,-7.4804741635279255
2009-03-31T09:30:00-04:00,21.28999,21.38,20.98,21.10001,6137676,5128425.05,50.35939528722972,52.54786378609965,NaN,NaN,49.057198561525354,92.983247969924,0.12457197720832291,0.08624514763603841,-0.038326829572284504,-33175682,-24836287.2,41.15051992719664,36.25184761914372,NaN,NaN,3.8524707185936555,-5.861482037510557
2009-04-01T09:30:00-04:00,20.99001,21.5,20.82001,21.46001,3698780,5052617.75,54.63371661906195,53.373243785030525,NaN,NaN,55.080418577586336,78.33667939232552,0.11426808537454196,0.10450827714589295,-0.009759808228649011,-29476902,-25863814.8,39.18181649578176,37.34607395695275,NaN,NaN,4.760218991684461,-4.344096176196983
2009-04-02T09:30:00-04:00,21.71001,22.1299,21.66,21.91,7864078,5082421.85,59.3458739214854,54.247024190843135,NaN,NaN,115.99204092743153,75.48954404740762,0.13062597258824396,0.15352265750665595,0.022896684918411986,-21612824,-26653564.4,37.689351221691645,38.275495661837354,NaN,NaN,7.017726154933543,-2.7209787003211936
2009-04-03T09:30:00-04:00,21.84,22.05,21.63,21.82001,5373141,5005467.75,58.04736434687299,54.74364378278505,NaN,NaN,104.78651625883968,75.3402340769413,0.12807945378383112,0.1829960021482009,0.054916548364369766,-26985965,-27657875.8,35.82074437279161,38.66110676316446,NaN,NaN,8.463808234882565,-1.1231519952920852
2009-04-06T09:30:00-04:00,21.7,21.8801,21.56,21.88,5334117,5033685.3,58.6961694402457,54.972464283631744,NaN,NaN,95.3172043191284,84.04667572890226,0.12309696648651255,0.20878775647251047,0.08569078998599791,-21651848,-26580644.2,39.297174892323454,38.93323775319878,NaN,NaN,9.83221544208896,0.4419004957623498
2009-04-07T09:30:00-04:00,21.44,21.7,21.42999,21.48,4710832,5056205,52.82943075845795,54.88762580720057,NaN,NaN,59.0813726840632,86.05151055340983,0.08721280148161988,0.19470679183802275,0.10749399035640288,-26362680,-25218043.8,43.46849515729989,39.14581924782091,NaN,NaN,9.317851421755972,1.7098934851900098
2009-04-08T09:30:00-04:00,21.57001,21.74001,21.48,21.66,2856046,4908486.6,55.0087087796238,55.21182717147719,NaN,NaN,67.5540132701302,88.54622949191858,0.07065664017825957,0.19581479057922735,0.12515815040096778,-23506634,-24023990.2,46.911257647389,39.562701800650245,NaN,NaN,9.51186116759357,2.824460296961947
2009-04-09T09:30:00-04:00,21.95,21.96001,21.55,21.67,3632506,4883154.5,55.132726396013,55.823672427512506,NaN,NaN,78.83185060327483,81.11419142708725,0.05607275485831398,0.19524909397386025,0.13917633911554628,-19874128,-23676251,47.90624304573159,40.1870652440049,NaN,NaN,9.704289179749116,3.807292994502971
2009-04-13T09:30:00-04:00,21.59,21.74001,21.53,21.61,4532355,4927220.1,54.16793562360804,55.64227427764247,NaN,NaN,52.43637021065105,70.64416221744952,0.03889452766471849,0.18779449869644438,0.1488999710317259,-24406483,-23160354.6,49.42078018080973,41.00416736016481,NaN,NaN,9.607157756423646,4.635845103348782
2009-04-14T09:30:00-04:00,21.61,21.67,21.228,21.31,3846295,4904822.95,49.50335118374377,55.21763327700624,NaN,NaN,-3.9438126233242166,50.791958828959004,0.005585840488301408,0.15588227164210267,0.15029643115380126,-28252778,-24480540.6,45.75481481406039,41.824958796191545,NaN,NaN,8.223255024047408,5.148332234877157
2009-04-15T09:30:00-04:00,21.3,21.69,21.21001,21.69,3849210,4907484.3,54.8115277305652,55.01998454149331,NaN,NaN,23.32056967335605,43.63979822681757,0.0072962700510120215,0.15941676871756627,0.15212049866655425,-24403568,-24088718.2,47.0111402584525,42.78181486160214,NaN,NaN,8.49312353788283,5.626159563877967
2009-04-16T09:30:00-04:00,21.81,22.03,21.55,21.98,7116648,5009459.85,58.40506639147629,54.9105987273033,NaN,NaN,98.11529270739585,49.75205411427071,0.025106120589828917,0.18350314940384038,0.15839702881401146,-17286920,-22844775.4,50.89913721759849,43.628430090197945,NaN,NaN,9.783302558335214,6.220037134514716
2009-04-17T09:30:00-04:00,22.08,22.16,21.92999,22.09,4750578,4977698.7,59.713738949964934,55.10775859822174,NaN,NaN,145.35639606310306,63.056963206236354,0.04052875308977666,0.2090579701762323,0.16852921708645563,-12536342,-21377218.2,55.08612045770024,44.44682636747922,NaN,NaN,11.232458912379958,6.936097388495465
2009-04-20T09:30:00-04:00,21.74001,22.06,21.66,21.66,10396977,5320556.3,52.72970480175887,55.241765016436304,NaN,NaN,66.64177501295303,65.89804416669675,0.019092732002769175,0.1923951320899171,0.17330240008714792,-22933319,-21082585.4,55.89919314633217,45.392627773939935,NaN,NaN,10.432498904402483,7.435583319339325
2009-04-21T09:30:00-04:00,21.7,21.94,21.57001,21.88,5797016,5284090.1,55.591491030230664,55.61548614093636,NaN,NaN,62.42935172871375,79.17267703710435,0.017116097848148826,0.19469752239733396,0.17758142454918513,-17136303,-18859290.4,61.554940742584925,46.850086403610526,NaN,NaN,10.608018048136692,7.888788280596092
2009-04-22T09:30:00-04:00,21.69,21.87,21.55,21.59,7322688,5410658.3,51.19192037112544,55.36964355179804,NaN,NaN,15.490856181914403,77.60673433881601,-0.005146170735841338,0.17114871112938346,0.1762948818652248,-24458991,-18870375,61.512584729049486,48.44514127741536,NaN,NaN,9.418862712234688,8.107370342258749
2009-04-23T09:30:00-04:00,21.59,21.67999,21.3,21.59,7898898,5558347.95,51.19192037112544,54.787218298200905,NaN,NaN,-37.135498514257016,50.556576094485436,-0.020437205405090697,0.1507483751088614,0.1711855805139521,-24458991,-20304789.2,56.13005019447766,49.7623340611858,NaN,NaN,8.462415080317534,8.15809101912429
2009-04-24T09:30:00-04:00,21.7,21.74001,21.42999,21.5,9407457,5694961.4,49.77410616792478,54.19627128541889,NaN,NaN,-22.359571585970343,17.013382564670756,-0.03625423362567742,0.1258677884818553,0.16212202210753274,-33866448,-24570810.4,43.84281002411662,50.33533875056615,NaN,NaN,7.263991860120305,8.030362567838006
2009-04-27T09:30:00-04:00,21.31,21.84,21.31,21.63,5371152,5748502.4,51.84860090719772,53.70715924734402,NaN,NaN,-8.61385651542106,1.9622562589959447,-0.0374492728865341,0.11531043099936511,0.1527597038858992,-28495296,-25683205.8,41.303770431251,50.478667003346686,NaN,NaN,6.804917685532974,7.855299013223002
2009-04-28T09:30:00-04:00,21.34,21.82001,21.34,21.73,4986688,5744156.9,53.4416301941265,53.75088777846321,NaN,NaN,-5.042277343322613,-11.532069555411326,-0.031246062256082563,0.113702126065796,0.14494818832187856,-23508608,-26957666.8,38.549290988909604,50.1272952770331,NaN,NaN,6.8417810974237065,7.710510739537388
2009-04-29T09:30:00-04:00,21.8,22.25,21.78,22.09,5567891,5715667.65,58.7344776840522,54.01701412877952,NaN,NaN,147.51557451463924,14.872874111133644,-0.004067145784340337,0.13986425609145314,0.14393140187579348,-17940717,-25654012,42.754719604255136,49.830399702523536,NaN,NaN,8.389300268415669,7.807480672234285
2009-04-30T09:30:00-04:00,22.17999,22.2,21.86,22,6801469,5870802.1,56.99019663567039,54.14969057446934,NaN,NaN,127.01182541385803,47.70233889675666,0.006125494159286288,0.15158826957490135,0.14546277541561506,-24742186,-25710651,42.61825604513691,49.45268634533819,NaN,NaN,9.203115970011442,8.006857143345307
2009-05-01T09:30:00-04:00,22.07001,22.09,21.75,22.09,4343664,5694781.4,58.3231142109304,54.44648904499236,NaN,NaN,104.03454828968385,72.9811628718875,0.016610368272496234,0.16622573575623534,0.1496153674837391,-20398522,-23017065.8,50.68042316863073,49.54266084446827,NaN,NaN,10.256935355719659,8.328296887970215
2009-05-04T09:30:00-04:00,22.23,22.5,22.09,22.42999,5021129,5677180.8,62.98938994995055,55.40977752829284,NaN,NaN,209.07761289351305,116.5194567536743,0.042644694063791067,0.20292123506347792,0.16027654099968686,-15377393,-20393485.2,57.01532739780959,50.34698317187893,NaN,NaN,12.571437042830672,8.934459767235994
2009-05-05T09:30:00-04:00,22.38,22.57001,22.17999,22.24001,7102230,5765586.45,59.013340639246465,55.70990702177007,NaN,NaN,168.05977241556565,151.13986670545196,0.04314170936895506,0.21420367771088067,0.1710619683419256,-22479623,-20187688.2,57.47672646706236,51.09452504392249,NaN,NaN,13.416457759624079,9.574745194720006
2009-05-06T09:30:00-04:00,22.32001,22.48,22.25,22.38,8046617,5932375.7,60.968462502046755,55.89300674395368,NaN,NaN,151.63402245951104,151.96355629442633,0.048565964685342106,0.23176942419860325,0.18320345951326114,-14433006,-19486146,59.08887108868991,51.679506034714734,NaN,NaN,14.693779054083103,10.30603574605759
2009-05-07T09:30:00-04:00,22.57001,22.66,22.39999,22.47,6843723,6131759.55,62.2163220878002,56.07176268237048,NaN,NaN,158.2434937630462,158.20988996426394,0.05349323348577914,0.2500700013704851,0.19657676788470593,-7589283,-16055565.4,65.89753099860621,52.45174964477945,NaN,NaN,16.117771337240153,11.1362836876551
2009-05-08T09:30:00-04:00,22.55,22.7782,22.55,22.75999,7584066,6329337.55,65.9893513331728,57.01888029175719,NaN,NaN,167.80742850339564,170.9644660070063,0.07049167788101263,0.2846913652359717,0.2141996873549591,-5217,-11976904.4,71.88783812322319,53.59379571455737,NaN,NaN,18.49810914745768,12.187973039055468
2009-05-11T09:30:00-04:00,22.62,22.67999,22.41,22.64999,5549461,6380192.85,63.402985262750015,57.57684416550858,NaN,NaN,125.02767476683516,154.15447838167074,0.06847792259441432,0.299797090597977,0.23131916800356267,-5554678,-10012361.4,74.23539125592671,54.49954217979608,NaN,NaN,19.764728754049894,13.2703667126261
2009-05-12T09:30:00-04:00,22.64,22.95,22.56,22.92,5243012,6450028.7,66.83871743212475,58.69447252700849,NaN,NaN,150.81770446691178,150.70606479193998,0.07874852864455839,0.32975482880926066,0.25100630016470227,-311666,-5578770,78.5822359658583,55.71880298242529,NaN,NaN,21.90225909592339,14.503494195954284
2009-05-13T09:30:00-04:00,22.75,22.75,22.49001,22.5,5287789,6521957.65,57.755836092420964,59.16332364995817,NaN,NaN,93.35825364374692,139.05091102878717,0.05196602221562474,0.31596382793423317,0.2639978057186084,-5599455,-3812059.8,80.02821435913371,57.42581470847215,NaN,NaN,20.9820581297945,15.429003329360029
2009-05-14T09:30:00-04:00,22.67999,22.73,22.56,22.58,6371340,6484692.25,58.90147344471104,59.815278455442915,NaN,NaN,89.44079756206824,125.29037178859156,0.03515371679843726,0.307939951716655,0.27278623491821774,771885,-2139826.2,81.3141433824122,60.102338519778975,NaN,NaN,20.57862605257569,16.164663718390837
2009-05-15T09:30:00-04:00,22.56,22.72,22.37,22.37,7032484,6598787.55,54.70735980883931,60.01947551984588,NaN,NaN,58.73868618847989,103.47662332560841,0.006884624112939608,0.28139201505939226,0.27450739094645266,-6260599,-3390902.6,77.30387940617167,62.67377487513045,NaN,NaN,18.952483100305546,16.56292363009294
2009-05-18T09:30:00-04:00,22.91,22.92999,22.50999,22.84,6592422,6408559.8,61.34199070581065,60.58378698496618,NaN,NaN,95.53858803677802,97.57880597959699,0.016296871618590947,0.29487848046969134,0.2785816088511004,331823,-2213602.4,78.384232215038,65.5191278198539,NaN,NaN,19.61724296487567,16.99925496363333
2009-05-19T09:30:00-04:00,22.85001,23.02,22.81,22.97,6450891,6441253.55,62.95824917404469,60.88548494853706,NaN,NaN,113.5942356378148,90.13411221377758,0.027098498014994532,0.3124547313698436,0.28535623335484905,6782714,-794726.4,79.64197416005442,68.15393171669672,NaN,NaN,20.666255794130553,17.523112225132934
2009-05-20T09:30:00-04:00,23.11,23.22,22.98,23,10199180,6585078.15,63.339171292391434,61.33898313830286,NaN,NaN,127.11550482798815,96.88556245062584,0.03176119173863112,0.32505772302813796,0.29329653128950683,16981894,3721543.4,83.02724447787409,71.0402880333208,NaN,NaN,21.619868940641577,18.10836318449131
2009-05-21T09:30:00-04:00,22.81,22.89999,22.66,22.78999,5728051,6476535.8,58.78202829991402,61.37176271608741,NaN,NaN,73.85132032338753,93.76766700288968,0.016942427610663557,0.3144745658028363,0.2975321381921727,11253843,5817935,84.32983655981451,73.44381756126249,NaN,NaN,21.071007246048215,18.53159805042801
2009-05-22T09:30:00-04:00,22.75999,23.13,22.75999,22.92999,6040328,6308179.35,60.806479436976964,61.21584053658929,NaN,NaN,97.46830971406528,101.51359170800677,0.012988092515494987,0.31376725383654147,0.3007791613210465,17294171,10528889,86.78435156459217,75.5701764303184,NaN,NaN,21.203202450541127,18.913255821872742
2009-05-26T09:30:00-04:00,22.92,23.25,22.78,23.22,5478637,6313553.6,64.67682735731626,61.62037530216571,NaN,NaN,121.45550893218544,106.69697588708823,0.025594349098261082,0.33277209769387284,0.30717774859561175,22772808,15017086,88.61415763057023,77.79427865628324,NaN,NaN,22.49523508546013,19.42496714524237
2009-05-27T09:30:00-04:00,23.2,23.25999,22.63,22.63,6976363,6413037.35,53.172820090362315,61.06354370133111,NaN,NaN,63.2451897791342,96.62716671535212,-0.008298894123122291,0.2968041309417089,0.30510302506483117,15796445,16819832.2,89.25753795446833,79.94918343241027,NaN,NaN,19.81555579153072,19.480765523283562
2009-05-28T09:30:00-04:00,22.75999,23,22.57001,22.87,7245949,6496940.25,56.55780049242071,60.65936358737543,NaN,NaN,50.57023455082375,81.31811265991924,-0.016572807334083117,0.28438701589722726,0.3009598232313104,23042394,18031932.2,89.67979740369618,81.64791674705955,NaN,NaN,18.730347048684514,19.373562884055126
2009-05-29T09:30:00-04:00,22.92999,23.17999,22.84,23.12,6894609,6501597.25,59.81632684604781,60.2184332668665,NaN,NaN,106.28165743326839,87.80418008189541,-0.007679339202468993,0.29136064922822413,0.2990399884306931,29937003,21768564.2,90.87109629067915,83.00386375902069,NaN,NaN,18.9031379359827,19.30635932004478
2009-06-01T09:30:00-04:00,23.34,23.66,23.28999,23.58,7258719,6647350,65.01605584399394,60.33365259409821,NaN,NaN,220.70465279640763,112.45144869836388,0.024927312841125537,0.33019912948210006,0.3052718166409745,37195722,25748874.4,91.93858885504568,84.26837787324348,NaN,NaN,20.84487451574586,19.526147205144934
2009-06-02T09:30:00-04:00,23.61,23.92,23.45,23.82001,6547281,6723657.6,67.38728853384356,60.37283624422098,NaN,NaN,236.42818630865537,135.44598417365788,0.056591572328486106,0.3760112820515822,0.3194197097230961,43743003,29942913.4,92.88296606401262,85.28985859454022,NaN,NaN,23.226919648925744,20.054828982827907
2009-06-03T09:30:00-04:00,23.8,23.8,23.53999,23.7,6743336,6705712.9,65.01434514653207,60.89130117665748,NaN,NaN,184.10731163505665,159.61840854484237,0.06290064664547124,0.39804551802993515,0.3351448713844639,36999667,34183557.8,93.68811722830223,86.26556594233797,NaN,NaN,24.36392110999551,20.67041357242328
2009-06-04T09:30:00-04:00,23.67,23.81,23.47,23.74001,6186461,6612705.1,65.45114139358523,61.35913460157707,NaN,NaN,154.54012262242978,180.41238615916356,0.06305558927518351,0.41396435797844333,0.3509087687032598,43186128,38212304.6,94.34289702883541,87.19619120279675,NaN,NaN,25.401284386434764,21.346252260139206
2009-06-05T09:30:00-04:00,23.89999,23.96001,23.53,23.62,4533762,6497207.05,62.913859126540686,61.945313124270015,NaN,NaN,136.28212031824108,186.4124787361581,0.048989300033085104,0.41214539374461623,0.3631560937115311,38652366,39955377.2,94.60372869248714,88.43189472324786,NaN,NaN,25.51194358026428,21.941351020157075
2009-06-08T09:30:00-04:00,23.48,23.82001,23.44,23.71001,4605832,6348295.35,64.03984042981949,62.138016675984936,NaN,NaN,110.07840273609301,164.2872287240952,0.04003812552098501,0.4132037506127624,0.37316562509177736,43258198,41167872.4,94.78389027234864,89.60329887019863,NaN,NaN,25.925121693824103,22.510461116395224
2009-06-09T09:30:00-04:00,23.8,23.8,23.5,23.5,5158055,6328725.05,59.50068166357907,61.89104756809453,NaN,NaN,86.24354126304034,134.2502997149722,0.015524410698926017,0.3925711384654349,0.3770467277665089,38100143,40039300.4,91.71458054494954,90.46562789769114,NaN,NaN,24.96831084306472,22.861582505919436
2009-06-10T09:30:00-04:00,23.59,23.67999,23.17999,23.24001,6272305,6380189.7,54.36340305122094,61.24992126515379,NaN,NaN,39.411028876558774,105.31104316327261,-0.020683543564792184,0.3511922983105187,0.37187584187531086,31827838,39004934.6,88.8739786416223,90.8832517665303,NaN,NaN,22.600009298447528,22.82421490485202
2009-06-11T09:30:00-04:00,23.3,23.63,23.28,23.34,4375055,6334553,55.93901752989526,61.046849067295305,NaN,NaN,42.011446865510116,82.80530801188868,-0.039302915161453345,0.32274719792349416,0.3620501130849475,36202893,37608287.6,85.04386075912029,90.93425349505215,NaN,NaN,21.076054789376357,22.574477745498353
2009-06-12T09:30:00-04:00,23.25999,23.52,23.23,23.52,5717066,6301839.3,58.70312258581497,60.896609292212304,NaN,NaN,37.614967395462735,63.071877427333014,-0.04072641508785457,0.3111420942251293,0.35186850931298386,41919959,38261806.2,85.36175489454386,90.83263944719155,NaN,NaN,20.55705678800062,22.286274751570105
2009-06-15T09:30:00-04:00,23.41,23.41,22.95,22.95,6131141,6256772.15,48.357605732430166,59.73095060472044,NaN,NaN,-31.959335263090257,34.66432982749636,-0.0790676776975186,0.2530339121910856,0.3321015898886042,35788818,36767930.2,81.11733843952202,90.29715236211668,NaN,NaN,16.71712964448054,21.49068259341445
2009-06-16T09:30:00-04:00,23,23.02,22.64999,22.64999,5372543,6195778.2,43.96572270734659,59.073300791647895,NaN,NaN,-101.16819453891618,-2.8180173328949634,-0.12112802411386014,0.18069155974627904,0.3018195838601392,30416275,35231156.6,76.88226589767369,89.41320435805991,NaN,NaN,12.00876574294615,20.136123043347553
2009-06-17T09:30:00-04:00,22.77,23,22.7,22.88,6574996,6201983.45,47.874424246244374,58.45305963120673,NaN,NaN,-81.34311864528642,-26.968846837264003,-0.1292138339037523,0.14030229148044882,0.2695161253842011,36991271,36263843.2,77.72391181956692,88.55921253062213,NaN,NaN,9.345443961797255,18.59459746026894
2009-06-18T09:30:00-04:00,22.88,23.31,22.81,23.3,5950113,5989530.1,54.16210720305596,58.04918679956446,NaN,NaN,-24.498752140404832,-40.27088663844699,-0.10316196840852926,0.14056366487353955,0.2437256332820688,42941384,37611541.4,78.80823817424275,87.69757980801951,NaN,NaN,9.123092148087546,17.241525272814457
2009-06-19T09:30:00-04:00,23.2,23.3,22.82001,22.89,6319121,6019083.6,48.06669249179665,56.838517988693226,NaN,NaN,-57.35328778937194,-59.26453767541392,-0.10981248521433201,0.10646002676415378,0.2162725119784858,36622263,36552002.2,75.68890080943973,86.53688780476193,NaN,NaN,6.8455229523163945,15.756382084171877
2009-06-22T09:30:00-04:00,22.82001,22.89999,22.69,22.8,3975010,5915817.7,46.82105341750887,55.369501194669326,NaN,NaN,-98.2720151534151,-72.52707365347888,-0.11593965332733477,0.07134794531931732,0.1872875986466521,32647253,35923689.2,73.82284257587246,85.17545041275194,NaN,NaN,4.6502340344380375,14.169789505638471
2009-06-23T09:30:00-04:00,22.75999,22.89,22.66,22.66,3668106,5825291.15,44.87298952072001,53.930832935682744,NaN,NaN,-101.70482688527042,-72.63440012274972,-0.124344233610262,0.03185730663382458,0.15620154024408658,28979147,35636263.6,72.93696286776509,83.69322510128498,NaN,NaN,2.254838577618803,12.467653658778518
2009-06-24T09:30:00-04:00,22.83,22.88,22.63499,22.72,6364785,5794712.25,45.91165009680146,52.53515498591247,NaN,NaN,-97.68476880569533,-75.90273015483152,-0.12068873130996527,0.005340626106629998,0.12602935741659527,35343932,35306795.8,71.87228637952403,82.08818148347703,NaN,NaN,0.6295342499850223,10.77649374323659
2009-06-25T09:30:00-04:00,22.7,23.16,22.64,23.11,6931320,5778980.8,52.21406940748192,51.770884291693996,NaN,NaN,-56.0362087823052,-82.2102214832116,-0.08833092726883959,0.015615698330545769,0.10394662559938536,42275252,35173569.4,71.41830137802657,80.43207953244413,NaN,NaN,1.1471123638565108,9.40086783189658
2009-06-26T09:30:00-04:00,23.22,23.22,22.9101,23.03,3293358,5598918.25,50.90379050594594,50.832595011417304,NaN,NaN,-39.263979217934605,-78.59235976892413,-0.06947230405266473,0.017106245533554443,0.08657854958621918,38981894,35645495.6,72.09080682393534,78.81114500041461,NaN,NaN,1.1783161564724343,8.226217592550274
2009-06-29T09:30:00-04:00,23.14,23.25,23.015,23.17,2134975,5342731.05,53.120856429523855,50.37689320898479,NaN,NaN,-17.51765791830067,-62.44148832190124,-0.04586507857274688,0.02924720137028558,0.07511227994303246,41116869,37339418.8,74.41757831577682,77.575644841188,NaN,NaN,1.8572438533394773,7.316364201234446
2009-06-30T09:30:00-04:00,23.13,23.52,22.89999,22.99001,3496299,5190181.95,49.995045969359666,50.06486770313756,NaN,NaN,-14.237269680690641,-44.94797688098529,-0.040835529411769295,0.02406786817832085,0.06490339759009014,37620570,39067703.4,76.56436732003039,76.69638688964572,NaN,NaN,1.529457389506449,6.489663228130446
2009-07-01T09:30:00-04:00,23.09,23.52,23.09,23.38,6945996,5200314.95,56.03207567727,50.07151471366432,NaN,NaN,36.40045366106725,-18.130932387632775,-0.011245900681561435,0.05084602173813835,0.06209192241969978,44566566,40912230.2,78.62589876606528,76.23796103299892,NaN,NaN,3.099234135756104,6.005316214934112
2009-07-02T09:30:00-04:00,23.17999,23.38,22.89,22.89,4945367,5138260.25,48.16413093312961,49.318729595615366,NaN,NaN,-26.572477784643095,-12.238186188100354,-0.02394690141819028,0.03215829564696193,0.05610519706515221,39621199,40381419.6,76.53930878472632,75.6077863108691,NaN,NaN,1.9461444106367174,5.425434528605913
2009-07-06T09:30:00-04:00,22.85001,23.36,22.82001,23.36,5522145,5187679.4,54.73038724174023,49.7739282748518,NaN,NaN,17.20993750619378,-0.9434028432746778,-0.0011695048557171656,0.05464331599550576,0.055812820851222925,45143344,41613709.6,77.99903448985691,75.38505031446446,NaN,NaN,3.1896136275638645,5.106031542742763
2009-07-07T09:30:00-04:00,23.28,23.38,23.06,23.07001,4595707,5187173.15,50.48137060028187,50.23933169577575,NaN,NaN,24.377606336527045,7.435650007690865,-0.005847085749263639,0.04850396366464338,0.05435104941390702,40547637,41499863.2,77.51915680629601,75.4305425222232,NaN,NaN,2.7804550148648537,4.77380632447449
2009-07-08T09:30:00-04:00,23.09,23.25999,23.05,23.17,6933168,5275928.8,51.868905385165796,50.52465177712728,NaN,NaN,31.868151804180243,16.656734304665044,-0.002586768874386372,0.05111758832092406,0.05370435719531043,47480805,43471910.2,79.83362782724716,75.58123652277179,NaN,NaN,2.901904059218368,4.506391715152187
2009-07-09T09:30:00-04:00,23.17,23.28999,22.94,23,3680609,5146344,49.33767885315969,50.180049752134686,NaN,NaN,5.478754412288043,10.4723944549092,-0.011746277943512254,0.039021509765920115,0.05076778770943237,43800196,43318636.2,79.15154913339357,75.60575873413971,NaN,NaN,2.213356976683051,4.1788153239423105
2009-07-10T09:30:00-04:00,23.02,23.1308,22.85001,22.89,3175584,5086370.45,47.71509131003142,50.1549353820086,NaN,NaN,-37.633215086396646,8.260246994558491,-0.02435430472903307,0.02032490679814103,0.0446792115271741,40624612,43519318.8,79.39971822464173,75.87081712093985,NaN,NaN,1.1626065054385422,3.7479283498703437
2009-07-13T09:30:00-04:00,22.88,23.31,22.88,23.3,2694341,4935234.2,53.812306883848066,50.65431062960426,NaN,NaN,65.55497886707637,17.92925526673501,-0.005222168440391223,0.03815150097668507,0.043373669417076294,43318953,43154440.6,77.59125550565511,76.13998947306719,NaN,NaN,2.1457304920830573,3.5190429416150173
2009-07-14T09:30:00-04:00,23.28,23.38,23.205,23.37,4134996,4835426.95,54.78184940119398,51.362086335352394,NaN,NaN,127.32738142350517,38.51921028413064,0.011115045635590827,0.057267476461564826,0.046152430825974,47453949,44535703,79.4952192950239,76.60843636072853,NaN,NaN,3.231427842861557,3.477955070364523
2009-07-15T09:30:00-04:00,23.56,23.8,23.405,23.75,4629230,4798261.3,59.72441745816501,52.34871257544979,NaN,NaN,241.51493812074088,80.44856754744276,0.04460217520361825,0.10190514983049681,0.05730297462687856,52083179,45456177.8,80.67366878986854,77.237106532896,NaN,NaN,5.740647597819862,3.8011968600009998
2009-07-16T09:30:00-04:00,23.75,23.91499,23.64999,23.91,4606414,4699832.2,61.62634554551526,53.02101801388074,NaN,NaN,259.5746197315753,131.2677406113002,0.07294154546690391,0.14847990646050846,0.07553836099360454,56689593,48034057.2,83.52874616140522,78.10213830313732,NaN,NaN,8.401499357244276,4.458382931035754
2009-07-17T09:30:00-04:00,23.91,23.96001,23.8,23.92999,3502117,4577432.4,61.86862258031755,53.80422030490728,NaN,NaN,221.41737745123922,183.07785911882738,0.0874674436610719,0.18487266556994442,0.09740522190887252,60191710,51947476.8,86.73295711042428,79.14800618074368,NaN,NaN,10.618048789399463,5.338335196516283
2009-07-20T09:30:00-04:00,24.06,24.06,23.75,24,5113313,4517142,62.75551916200846,54.49241050008475,NaN,NaN,180.3196522132341,206.03079378805893,0.09556665713470189,0.21686354332724989,0.121296886192548,65305023,56344690.8,89.26090441813082,80.20824375948325,NaN,NaN,12.711986566977101,6.391713963724971
2009-07-21T09:30:00-04:00,24.10001,24.17999,23.77,23.97,6419496,4639366.3,62.08909356828976,55.356271042865465,NaN,NaN,154.69292100837413,211.50390170503275,0.09261295467631062,0.23706307953793626,0.14445012486162565,58885527,58631006.4,90.29623149563751,81.18909120059804,NaN,NaN,14.27747798171774,7.518251680581081
2009-07-22T09:30:00-04:00,24.03999,24.11,23.92999,23.98,4032313,4657576.65,62.23306453329725,55.799198818295984,NaN,NaN,136.63097868606502,190.52710981809756,0.08522795950124637,0.2509850742381836,0.16575711473693724,62917840,60797938.6,91.16555780807005,82.08478113216982,NaN,NaN,15.625767188974867,8.676468181780193
2009-07-23T09:30:00-04:00,24.08,24.48,23.95,24.31,5286781,4603676.45,66.72403345397966,57.124906141213856,NaN,NaN,152.39614832666473,169.09141553711544,0.09568005021208437,0.2853571775020427,0.18967712728995834,68204621,63100944.2,91.98716280273163,83.18819927631306,NaN,NaN,18.129401105769333,10.026887170921498
2009-07-24T09:30:00-04:00,24.3,24.53,24.24001,24.53,2274492,4370835.05,69.3414527499016,58.1685536775111,NaN,NaN,154.67355573402367,155.74265119367234,0.1095261477196483,0.3265848119395187,0.2170586642198704,70479113,65158424.8,92.64524144461811,84.23435691593886,NaN,NaN,21.088396992979263,11.607102859786892
2009-07-27T09:30:00-04:00,24.41,24.53,24.24001,24.44,4539633,4433148.8,67.01900935997027,59.349813588917414,NaN,NaN,128.96674835454397,145.47207042193432,0.1047405995946317,0.34798441371316,0.24324381411852833,65939480,65285316.2,92.68514195974166,85.31764156975639,NaN,NaN,22.950770591855942,13.227626821511041
2009-07-28T09:30:00-04:00,24.28999,24.5222,24.28999,24.47,4661848,4559492.45,67.41083144357205,60.459951164517854,NaN,NaN,116.70193716424043,137.87387365310758,0.09594735792732395,0.36317801152768325,0.2672306536003593,70601328,67628476.4,93.39746245201022,86.28648690009662,NaN,NaN,24.611963367728265,14.853960613827788
2009-07-29T09:30:00-04:00,24.33,24.6476,24.33,24.60001,3655836,4567469.3,69.12282811446684,61.873176111754084,NaN,NaN,116.36541941578575,133.82076179905172,0.09126684896951498,0.381314214812253,0.29004736584273805,74257164,69896341.2,94.00587122382869,87.34750990655628,NaN,NaN,26.521876266637662,16.520805707086343
2009-07-30T09:30:00-04:00,24.8,24.89,24.57001,24.57001,4900531,4465196.05,68.23209515595396,63.33867638646284,NaN,NaN,121.63443594581372,127.66841932288153,0.07899000121323407,0.38878486735928064,0.30979486614604657,69356633,70126743.6,94.06569979370535,88.39508001863224,NaN,NaN,27.905119025996733,18.1471361812164
2009-07-31T09:30:00-04:00,24.64999,24.82001,24.50999,24.52,4421828,4439019.1,66.68932014156414,64.25846304772827,NaN,NaN,104.83049898081191,117.69980797223919,0.06113846246573684,0.38621794422821765,0.3250794817624808,64934805,69017882,89.43886633670685,89.24133793513593,NaN,NaN,28.701585033530502,19.65491458868984
2009-08-03T09:30:00-04:00,24.63,24.75,24.39,24.55,5843723,4455098,67.16888636502735,65.14325140228779,NaN,NaN,90.16119153054531,109.93869660743944,0.045695326923119506,0.3821986404163802,0.3365033134932607,70778528,69985691.6,89.90556017302447,89.98493371213598,NaN,NaN,29.503448328857612,21.06184798014238
2009-08-04T09:30:00-04:00,24.52,24.77,24.49001,24.59,4355066,4443065.95,67.83383454620315,65.72249548000481,NaN,NaN,89.68517908855986,104.53534499230332,0.033105314279412934,0.37788495634252683,0.3447796420631139,75133594,70892144.8,90.336290581237,90.67512098294802,NaN,NaN,30.361001147488615,22.390298432620416
2009-08-05T09:30:00-04:00,24.53999,24.57001,24.28,24.42999,4473773,4320096.2,62.39018360983438,65.77705534174189,NaN,NaN,56.88426469601157,92.63911404834849,0.010123948413435946,0.3574345775799088,0.3473106291664729,70659821,70172676.2,87.15737784350645,90.93430896024095,NaN,NaN,29.75661654070963,23.442629590918873
2009-08-06T09:30:00-04:00,24.41,24.45,24.08,24.17999,6181172,4445124.35,54.96800436665329,65.28415404076587,NaN,NaN,22.867491571289037,72.88572517344355,-0.023931821257946906,0.31739585259403924,0.34132767385198615,64478649,69197079.4,82.89746411033131,90.66034517452003,NaN,NaN,27.135179395501552,23.970136705859257
2009-08-07T09:30:00-04:00,24.21001,24.35001,24.14,24.28,6299383,4601314.3,57.163426319632286,64.88471883773899,NaN,NaN,18.3509382825398,55.58981303378912,-0.040752186992657424,0.29038744011116435,0.3311396271038218,70778032,70365724.8,83.91184258679718,90.27826932942477,NaN,NaN,25.455865684202916,24.182383702765495
2009-08-10T09:30:00-04:00,24.28,24.33,24.14999,24.3,4821484,4707671.45,57.60851514395428,64.56467752171503,NaN,NaN,10.378036774681073,39.63318208261627,-0.05090115288355307,0.26751318599938045,0.3184143388829335,75599516,71329922.4,84.71723833224794,89.8797698177541,NaN,NaN,24.16244810896763,24.179535760794373
2009-08-11T09:30:00-04:00,24.31,24.37,24.25,24.3,2613921,4631617.7,57.60851514395428,64.2343525653334,NaN,NaN,11.993474930159381,24.094841250936177,-0.05749692828915054,0.24654317852149532,0.30404010681064586,75599516,71423106.8,84.7964537604057,89.42483381434951,NaN,NaN,23.074783039424627,24.021713943455836
2009-08-12T09:30:00-04:00,24.22,24.47,24.205,24.28999,2812095,4540760.95,57.26314830638925,63.55857505479121,NaN,NaN,7.780518441673618,14.274092000068588,-0.06202763897435065,0.22650555809270756,0.2885331970670582,72787421,71848626.8,85.17435895515618,88.93820496809413,NaN,NaN,22.059725452136544,23.741429873267364
2009-08-13T09:30:00-04:00,24.35001,24.42999,24.17101,24.42999,5435191,4582199.8,60.80255414433105,62.94865372582189,NaN,NaN,7.386867708224405,11.177967227455657,-0.05531183847358345,0.21939339897507892,0.2747052374486624,78222612,74597419.4,87.3600552549556,88.5606916688325,NaN,NaN,22.027876598127953,23.496636548247448
2009-08-14T09:30:00-04:00,24.39,24.50999,24.17999,24.39999,2434917,4528839.8,59.66228951000945,62.42317373653897,NaN,NaN,6.836902829547438,8.875160136857179,-0.052621931982851256,0.20892782247009833,0.2615497544529496,75787695,75599352,88.05152026027419,88.22971869029912,NaN,NaN,21.712832293647224,23.241807369018844
2009-08-17T09:30:00-04:00,24.10001,24.27,24.08,24.14999,3634799,4454914.1,51.06755723106288,61.25579700707403,NaN,NaN,-87.20367232027067,-10.641181682133166,-0.06651633721876005,0.17840433292949953,0.24492067014825958,72152896,74910028,84.62166212799687,87.60287581001246,NaN,NaN,19.00754950558418,22.63691338852818
2009-08-18T09:30:00-04:00,24.10001,24.27,24.02,24.19,3225039,4295191.25,52.25302972931511,60.050811408134614,NaN,NaN,-100.55217265732433,-33.15031119962991,-0.07141773520038336,0.1556485011477804,0.22706623634816375,75377935,74865711.8,84.39406070152053,86.91631791556188,NaN,NaN,17.038716122902834,21.837170922010273
2009-08-19T09:30:00-04:00,24.05,24.39999,24.05,24.35001,2962224,4241686.8,56.76431403259578,59.2316841850376,NaN,NaN,-60.38075444372816,-46.782565776710264,-0.06260465595418255,0.14881041640543557,0.21141507235961812,78340159,75976259.4,85.45017414557311,86.30092322640955,NaN,NaN,16.525897318463613,21.078417550075034
2009-08-20T09:30:00-04:00,24.28999,24.53999,24.28999,24.47,2923730,4123534.25,59.82941736687311,58.74169112970253,NaN,NaN,23.51970944438166,-43.55599742947881,-0.048068898483612565,0.15132894925510243,0.199397847738715,81263889,76584514.8,86.00866156959697,86.05590860018742,NaN,NaN,16.956674273415576,20.489597081980826
2009-08-21T09:30:00-04:00,24.58,24.83,24.55,24.74001,3033146,4161466.95,65.71889825392313,58.638120550337945,NaN,NaN,148.63077096289695,-15.19722380280891,-0.02102478092560811,0.17311687158170486,0.19414165250731297,84297035,78286382.8,87.4591287142901,85.88116349599211,NaN,NaN,19.2037218180623,20.30590061570675
2009-08-24T09:30:00-04:00,24.87,24.89,24.67999,24.75,1557828,4012376.7,65.91799508308782,58.50127487440113,NaN,NaN,151.6773504734979,32.578980755944805,-0.004104312139941696,0.18901126233238585,0.19311557447232755,85854863,81026776.2,89.37008275245937,85.81214865107941,NaN,NaN,21.068060373393276,20.41478058109054
2009-08-25T09:30:00-04:00,24.75,25.009,24.73,24.78999,4690516,4013810.1,66.75045976279472,58.812723171041156,NaN,NaN,150.0249986834156,82.69441502409279,0.0075077352615114945,0.20250024354921692,0.19499250828770542,90545379,84060265,91.00417858597758,86.08692013268451,NaN,NaN,22.8559646929592,20.763521168500347
2009-08-26T09:30:00-04:00,24.82001,24.99001,24.7713,24.87,3094744,3985755.5,68.41283434169121,59.773068169258146,NaN,NaN,139.6659707957517,122.70376007198877,0.017720715526436143,0.2171434026957506,0.19942268716931447,93640123,87120257.8,92.29148276462648,86.75792146513416,NaN,NaN,24.862850283592124,21.349139613513458
2009-08-27T09:30:00-04:00,24.94,24.94,24.69,24.87,3329441,3907201,68.4128343416912,60.57659731369092,NaN,NaN,116.8289764399307,141.36561347109858,0.021374965935705675,0.22614139458894655,0.20476642865324088,93640123,89595504.6,93.14590625607244,87.41749744151096,NaN,NaN,26.51744508262212,22.087468966243268
2009-08-28T09:30:00-04:00,24.91,24.94,24.66,24.77,2780208,3825120,63.78987481966728,61.01812300481328,NaN,NaN,95.40517319310042,130.72049391713927,0.014296285437509437,0.22263678545012766,0.20834050001261822,90859915,90908080.6,93.55393225143614,88.04868986431013,NaN,NaN,26.716554659558955,22.748766922431223
2009-08-31T09:30:00-04:00,24.72,24.85001,24.63,24.82001,3750486,3720458.15,65.06141293509377,61.55047284703754,NaN,NaN,80.6826630051816,116.521556423476,0.010402191529550076,0.2213432394245558,0.21094104789500573,94610401,92659188.2,94.06181619848326,88.71050146702996,NaN,NaN,27.22932180676621,23.388846191621937
2009-09-01T09:30:00-04:00,24.71001,24.92999,24.52,24.59,5906082,3798008.95,55.42189577235599,61.4189548088923,NaN,NaN,53.83677983891917,97.28391265457671,-0.009185661282870988,0.199458971291417,0.20864463257428797,88704319,92290976.2,92.41299913311987,89.22754719402737,NaN,NaN,24.847402629819733,23.597211397078766
2009-09-02T09:30:00-04:00,24.55,24.67,24.48,24.61,4708547,3809747.65,56.031906380010525,61.078194254297976,NaN,NaN,24.778521023650804,74.30642270015655,-0.021607240414965895,0.1816355820555806,0.2032428224705465,93412866,92245524.8,92.19815901954756,89.57312603435537,NaN,NaN,23.062349891900492,23.520802610624727
2009-09-03T09:30:00-04:00,24.85001,24.85001,24.5101,24.66,4783496,3739863.85,57.5942107048438,60.93047433964329,NaN,NaN,43.83704181444562,59.708035775059535,-0.026922201148102176,0.1695900710354188,0.19651227218352096,98196362,93156772.6,92.57105145226555,89.89594969092617,NaN,NaN,21.981043826836334,23.300837070083528
2009-09-04T09:30:00-04:00,24.7,24.89,24.67,24.84,4520383,3650913.85,62.72862177164511,61.76340752111345,NaN,NaN,72.95230675145905,55.21746248673128,-0.01914659468414942,0.1725790288283342,0.19172562351248362,102716745,95528138.6,93.44859326397996,90.52644477206782,NaN,NaN,22.505492090813217,23.187216358759198
2009-09-08T09:30:00-04:00,24.97,25.11,24.91,25.05,9057133,3862696.3,67.64984754110219,62.86318022195538,NaN,NaN,125.5084175006759,64.18261338583014,-0.0016155155701378932,0.18970622904981127,0.19132174461994916,111773878,98960834,94.46739860344962,91.24596890791989,NaN,NaN,24.543829173919207,23.38101818949634
2009-09-09T09:30:00-04:00,25.10001,25.14999,24.97,25.03999,4949383,3979469.4,67.19440831045816,63.60818695608841,NaN,NaN,122.4200676245667,77.89927094295965,0.007074254540372443,0.20016456279541472,0.19309030825504228,106824495,102584869.2,95.29863156977737,91.94943015250591,NaN,NaN,26.03799347911991,23.760586088013994
2009-09-10T09:30:00-04:00,25.10001,25.25999,25.09,25.22,5524926,4115110.95,70.97826149676278,64.40453296536626,NaN,NaN,148.79826205072303,102.70321914837409,0.021877440165310957,0.22043710846168096,0.19855966829637,112349421,106372180.2,95.9786068918382,92.66156910409458,NaN,NaN,28.56211582021504,24.446518906899858
2009-09-11T09:30:00-04:00,25.38,25.38,25.21001,25.33,6393113,4163007.05,73.02572828885437,64.92644939643277,NaN,NaN,164.76180947214613,126.88817267991419,0.0352186509912277,0.24258298203540463,0.20736433104417692,118742534,110481414.6,96.5599680016232,93.31162905318979,NaN,NaN,31.341745518452747,25.43155127997884
2009-09-14T09:30:00-04:00,25.12,25.36,25.10001,25.27,3836518,4233087.1,70.11984840118637,65.22658177629695,NaN,NaN,134.85220144334122,139.26815161829063,0.03601488274086234,0.25238293447025484,0.2163680517293925,114906016,112919268.8,96.85083617127142,93.84596858310496,NaN,NaN,32.755577664416016,26.477840763469867
2009-09-15T09:30:00-04:00,25.36,25.37,25.07001,25.14,4470391,4274866.7,64.16241432967948,65.0417213882173,NaN,NaN,112.41151182088045,136.6487704823315,0.02435710318802148,0.24681443071441933,0.22245732752639785,110435625,112651618.2,95.89218172298389,94.1951116643197,NaN,NaN,32.14260931553134,27.287093413764364
2009-09-16T09:30:00-04:00,25.25,25.34,25.08,25.34,6054672,4416348.35,68.58455736933857,65.05398731876353,NaN,NaN,116.55458341764647,135.4756736409475,0.02650882498754012,0.255593358760823,0.2290845337732829,116490297,114584778.6,96.18583983077275,94.47328002618727,NaN,NaN,33.01638715236418,28.10556394785005
2009-09-17T09:30:00-04:00,25.36,25.44,25.23,25.25,7982887,4667381.5,64.7147065337168,64.78983533247965,NaN,NaN,116.24519610996056,128.965060452795,0.018635736406482445,0.25237920428138594,0.2337434678749035,108507410,113816376.4,93.32984950847593,94.48641882993039,NaN,NaN,32.508728093225365,28.734587397189383
2009-09-18T09:30:00-04:00,25.22,25.42999,25.17,25.39999,10221898,5032289.9,67.9593954559564,65.08765823507173,NaN,NaN,110.20440438063126,118.05357943449204,0.020165137731523175,0.25894989003930746,0.2387847523077843,118729308,113813731.2,93.31957708416712,94.46967917512545,NaN,NaN,33.11096401636482,29.35978405707159
2009-09-21T09:30:00-04:00,25.37,25.39,25.23,25.32001,5289516,5145108.4,64.55073082803334,65.05118094171027,NaN,NaN,93.27715358521024,109.73856986286583,0.012785555252502412,0.2547666963734123,0.2419811411209099,113439792,113520486.4,92.1092242319525,94.33020832037325,NaN,NaN,32.534678313899576,29.813340379475587
2009-09-22T09:30:00-04:00,25.44,25.44,25.25101,25.37,3232808,5228857.4,65.70846309463666,65.78593575044461,NaN,NaN,94.80859392681647,106.21798628405304,0.00847408512823597,0.2525737475312049,0.2440996624029689,116672600,114767881.4,92.55176277239896,94.3401200088932,NaN,NaN,32.411460457990444,30.184500390691994
2009-09-23T09:30:00-04:00,25.44,25.67999,25.37,25.37,5099668,5249315,65.70846309463667,66.4771183729179,NaN,NaN,114.85752299536571,105.8785741995969,0.003102103608612572,0.24797729191373463,0.24487518830512206,116672600,114804342,92.56488849973634,94.36631497176381,NaN,NaN,32.31218447455406,30.488455259815147
2009-09-24T09:30:00-04:00,25.41,25.5,25.22099,25.24001,5438996,5366527.6,59.81701862684694,66.6358903673467,NaN,NaN,66.41516770076997,95.91256851775877,-0.010955706201334403,0.23118055555345407,0.24213626175478847,111233604,115349580.8,92.77007615378777,94.38053102187256,NaN,NaN,30.491540316331346,30.488895982174604
2009-09-25T09:30:00-04:00,25.32001,25.38901,25.19,25.24001,4412953,5420703.2,59.81701862684694,66.42791871414683,NaN,NaN,48.975707483911265,83.66682913841477,-0.02140006290133384,0.2153861831281212,0.23678624602945503,111233604,113850440,85.76199728177744,93.83148845171523,NaN,NaN,29.01027967335521,30.27766508091469
2009-09-28T09:30:00-04:00,25.16,25.45,25.16,25.28999,5071734,5535279.5,61.361820576264,65.9787739309441,NaN,NaN,52.176279244811155,75.44665427033496,-0.025793684849794885,0.20454413996721144,0.23033782481700632,116305338,114423549.2,86.19145328786277,93.24034950060187,NaN,NaN,28.164567152950532,29.975793948348382
2009-09-29T09:30:00-04:00,25.42,25.56,25.38,25.41,4600480,5577779.2,64.85557929637858,65.8117147156527,NaN,NaN,92.28057770618639,74.94105102620895,-0.021636562533098008,0.20329212165063382,0.22492868418373183,120905818,115270192.8,86.82373394762544,92.63499967044815,NaN,NaN,28.392113911117722,29.749553943029717
2009-09-30T09:30:00-04:00,25.5,25.53,25.2,25.46001,5376418,5551296,66.22608777560815,65.47227373557023,NaN,NaN,74.63957393727279,66.89746121459036,-0.01675584495220167,0.20398387799347972,0.2207397229456814,126282236,117192120,88.15019393438781,92.07582731634457,NaN,NaN,28.967797981145022,29.63787451990333
2009-10-01T09:30:00-04:00,25.39,25.46001,25.16,25.23,10605063,5846121.8,55.5051419350173,64.22080328172473,NaN,NaN,26.278376890033947,58.870103052443156,-0.029509479420887386,0.18385287366957215,0.21336235309045953,115677173,118080833.8,88.71588457390133,91.51553564293587,NaN,NaN,26.20363178443676,29.147268414836677
2009-10-02T09:30:00-04:00,25.09,25.39999,25.09,25.31,5438000,5878847,58.04889725825347,63.35859248580095,NaN,NaN,6.396583816759193,50.35427831901273,-0.03279604549398091,0.1723672962229834,0.20516334171696432,121115173,120057147.6,89.87359921200434,91.0171615744168,NaN,NaN,24.654627158241706,28.505462521037394
2009-10-05T09:30:00-04:00,25.28999,25.39999,25.10001,25.37,4912699,5898462.8,59.90051059040575,63.054170790138535,NaN,NaN,7.804270506669293,41.47987657138437,-0.031178153734680025,0.1661906495486143,0.19736880328329431,126027872,122001654.4,90.86650748273405,90.65818484297039,NaN,NaN,23.914405463627396,27.84959722712168
2009-10-06T09:30:00-04:00,25.41,25.64999,25.4077,25.60001,5367922,5714002.25,66.08108717870155,62.87535149080732,NaN,NaN,223.03953709458787,67.63166844906462,-0.015650353035941034,0.177805861988368,0.19345621502430904,131395794,124099649.6,91.8006500182574,90.34495699921929,NaN,NaN,25.23432266367734,27.47598657520106
2009-10-07T09:30:00-04:00,25.63,25.71249,25.57001,25.71001,4390281,5686047.15,68.57561093058742,63.15113037629808,NaN,NaN,252.32340808473066,103.16843527855619,0.0001588286207719336,0.19365475080027394,0.193495922179502,135786075,126000417.4,92.54461984653922,90.28886916622379,NaN,NaN,27.14834529898043,27.42918067859811
2009-10-08T09:30:00-04:00,25.74001,25.92,25.73,25.86,3002641,5559932.9,71.63848696106461,63.41392262666295,NaN,NaN,270.1640810604571,151.94557611264082,0.017867337358321633,0.21583009387740404,0.1979627565190824,138788716,130622726,93.97605439409371,90.33576040264711,NaN,NaN,29.798958220351363,27.767720327420005
2009-10-09T09:30:00-04:00,25.89,25.94,25.78999,25.92,3633667,5421960.6,72.78137171485656,64.00182554715033,NaN,NaN,220.3988580893806,194.7460309671651,0.03005432338113398,0.2355306607454999,0.2054763373643659,142422383,134884168,94.94052590981086,90.53799623677988,NaN,NaN,32.310181841059176,28.416643400797028
2009-10-12T09:30:00-04:00,25.89999,26.12,25.89999,26.03,1902702,5325269.8,74.78731332877237,64.65031484958858,NaN,NaN,213.05931761356248,235.79704038854373,0.04126404729919447,0.257056396488359,0.2157923491891645,144325085,138543610.6,95.59304081092534,90.75523038238889,NaN,NaN,35.067346548516056,29.366743850471174
2009-10-13T09:30:00-04:00,26.02,26.02,25.8401,25.94,2224269,5212963.7,70.2270394965396,64.97307030686737,NaN,NaN,150.03355210391223,221.1958433904086,0.03841602813755052,0.26381238436110266,0.22539635622355214,142100816,140684615,95.92423414563412,90.99518364281016,NaN,NaN,35.95242205794836,30.307555022967914
2009-10-14T09:30:00-04:00,26.14,26.14,25.935,26.03,4402129,5130336.55,72.06166804170452,65.84768812221434,NaN,NaN,149.48734302992798,200.62863037944808,0.03830580741615944,0.27327861549375143,0.234972808077592,146502945,142827989,96.22971358461994,91.24230060215531,NaN,NaN,37.25991385879753,31.300749142372144
2009-10-15T09:30:00-04:00,26.00999,26.27,25.97,26.23,3667777,4914581.05,75.6521944076417,66.97877210655682,NaN,NaN,152.12838485198515,177.02149113775369,0.04685000000587353,0.2935353080849339,0.24668530807906036,150170722,145104390.2,96.5274025462605,92.01125812104696,NaN,NaN,39.59543920841313,32.485704866092284
2009-10-16T09:30:00-04:00,26.14999,26.45,26.14999,26.37,4825738,4644773.05,77.80269975480647,68.15312061930986,NaN,NaN,159.36459751682742,164.81463902324305,0.056434870045119045,0.3172288956354592,0.26079402559034015,154996460,147619205.6,96.82559252859129,92.77083949538473,NaN,NaN,42.27761266404375,33.88454883722821
2009-10-19T09:30:00-04:00,26.41,26.64,26.37,26.52,10552656,4907930.05,79.85566476826801,69.22455529587339,NaN,NaN,167.0987357977025,155.62252266007107,0.06667911197650023,0.34414291556096543,0.2774638035844652,165549116,151864011.8,97.25418652042765,93.51587182201345,NaN,NaN,45.230040018448015,35.50533329168818
2009-10-20T09:30:00-04:00,26.5,26.66,26.44,26.49001,8234699,5158024.6,78.29649430498,70.08672719082851,NaN,NaN,145.00233117650887,154.6162784745904,0.06516109885133298,0.3589151771486314,0.29375407829729844,157314417,154906732,97.51335707951797,94.18466918952275,NaN,NaN,47.08593248994711,37.159704605725175
2009-10-21T09:30:00-04:00,26.45,26.66,26.23,26.285,11709133,5488497.85,68.45667874733304,71.01183696313679,NaN,NaN,105.88214900491654,145.8952396695881,0.04503242603950269,0.3500446108466768,0.3050121848071741,145605284,154727199.8,96.93199486433745,94.77153421026819,NaN,NaN,45.50379484547292,38.35171749711771
2009-10-22T09:30:00-04:00,26.24001,26.45,26.13,26.33,5120277,5472561.9,69.3667183989455,71.82025275890048,NaN,NaN,82.60946059140664,131.9914548174724,0.030146546697299548,0.34269536817879853,0.312548821481499,150725561,154838167.6,96.94412199378176,95.27657155182372,NaN,NaN,44.51596542747671,39.232324344311856
2009-10-23T09:30:00-04:00,26.39999,26.39999,25.99001,26.07001,6902805,5597054.5,58.809918542891815,71.7423533269352,NaN,NaN,51.6803269238217,110.45460069887129,-0.00020536824075040316,0.312292111180561,0.3124974794213114,143822756,152603426.8,89.28960651669439,95.16393576853518,NaN,NaN,40.050070168337065,39.34914517631546
2009-10-26T09:30:00-04:00,26.05,26.27,25.83,25.87,5801492,5633542.4,52.22514905965477,70.75264346128901,NaN,NaN,17.652791961644244,80.56541193165963,-0.034831745576617335,0.2689577974505397,0.30378954302715705,138021264,147097856.4,73.8243920003108,93.87991733868184,NaN,NaN,33.95364470979516,38.57835939538399
2009-10-27T09:30:00-04:00,25.89999,26.03,25.78999,25.89,6461703,5726603.55,52.794325836050824,69.62540881167925,NaN,NaN,-3.668178731116391,50.83130995013458,-0.05620218840558622,0.23353680752017425,0.28973899592576047,144482967,144531566.4,67.9191790704086,92.12095728324392,NaN,NaN,29.3988952244368,37.267007370962965
2009-10-28T09:30:00-04:00,25.81,26.06,25.78999,25.82001,14674820,6191523.65,50.52576010230547,68.11735689319644,NaN,NaN,-12.567135692418704,27.141453010667497,-0.07375864978072083,0.19754068369985944,0.2712993334805803,129808147,141372139,61.406802584126524,89.79458215396055,NaN,NaN,24.96776580404089,35.509972861402666
2009-10-29T09:30:00-04:00,26.06,26.28999,25.94,26.24001,9853711,6153956.05,61.278405664003756,67.29571646099268,NaN,NaN,41.56280849549109,18.932122591484397,-0.05656611477702378,0.20059169000930055,0.25715780478632433,139661858,139159398.4,57.26541131478081,87.10350254002984,NaN,NaN,24.488973501980617,33.93554438148523
2009-10-30T09:30:00-04:00,26.21001,26.3,25.8,25.83,8113469,6287729.5,49.88110281235275,65.51670142410556,NaN,NaN,-13.744868572196824,5.847083492280694,-0.07133521666478959,0.16798878395533734,0.23932400062012693,131548389,136704525,52.99519793818539,84.06079947769128,NaN,NaN,19.64353246704648,31.893828393708265
2009-11-02T09:30:00-05:00,25.83,26.12,25.83,26.08,8836508,6483919.95,55.335954325480905,64.45305248331566,NaN,NaN,-16.627652635268202,-1.0090054271017954,-0.06308014894587544,0.16047381443778264,0.22355396338365807,140384897,137177251.6,53.71101244858505,81.0455693564735,NaN,NaN,17.8514070850587,29.887768206758327
2009-11-03T09:30:00-05:00,25.97,26.08,25.78,25.91,18182496,7124648.65,51.25108570681363,62.96658231653773,NaN,NaN,-55.0419337608023,-11.283756433038977,-0.06748636844462794,0.13919600282787314,0.20668237127250108,122202401,132721138.4,46.51944365036434,77.49483578974095,NaN,NaN,14.935233440872613,27.751691811631797
2009-11-04T09:30:00-05:00,25.95,26.25,25.94,26.00999,8038977,7307083.45,53.428702020099976,61.3791900031419,NaN,NaN,-12.661633810723561,-11.302656056699949,-0.06221351003555753,0.12891548372805417,0.1911289937636117,130241378,132807784.6,46.668970182091336,73.93351919230031,NaN,NaN,13.445056501658827,25.707886767349944
2009-11-05T09:30:00-05:00,25.89999,26.16,25.77,26.13,11922027,7753052.75,55.970857958425164,59.81977273197181,NaN,NaN,-35.70290101047247,-26.755797957892675,-0.049730978256052716,0.12896527094354582,0.17869624919959853,142163405,133308094,47.580331185408305,70.41600052493008,NaN,NaN,13.119956133971844,23.909610962581645
2009-11-06T09:30:00-05:00,26.00999,26.24001,25.96001,26.2,4571906,7799964.7,57.4305042827953,58.21797555443804,NaN,NaN,5.175594975466912,-22.971705248359928,-0.03646209223336591,0.13311863390789114,0.16958072614125705,146735311,136345478.4,52.84841358649482,67.24415960107774,NaN,NaN,13.33394827504831,22.39880200721974
2009-11-09T09:30:00-05:00,26.41,26.63,26.25999,26.63,5407160,7975187.6,65.08728395616217,57.27446052952249,NaN,NaN,139.8675501820182,8.327335315097354,-0.0003384480782826216,0.16915766604340376,0.1694961141216864,152142471,138696993.2,56.49378845824807,64.31419041384417,NaN,NaN,16.257533128303155,21.52147788166023
2009-11-10T09:30:00-05:00,26.62,26.75999,26.53,26.62,3515304,8039739.35,64.79540145603107,57.012940723000916,NaN,NaN,156.98027094404725,50.73177625606726,0.020137453897696778,0.19466793149380734,0.17453047759611057,148627167,143981946.4,63.351513166384876,61.915584578276125,NaN,NaN,18.391996399418055,21.074409098482775
2009-11-11T09:30:00-05:00,26.75999,26.75999,26.57001,26.7,7192352,8179250.5,66.10495364540614,56.779957526319535,NaN,NaN,142.1459935124934,81.69330172071065,0.03542996601932233,0.21881793512026348,0.18338796910094116,155819519,149097574.6,68.52350322165549,59.8855403802671,NaN,NaN,20.528181336394038,20.996376561041526
2009-11-12T09:30:00-05:00,26.67,26.8,26.52,26.53999,4785195,8235121.4,61.20123627404007,56.95076593568727,NaN,NaN,107.82987715627942,110.39985735406103,0.03127434149191141,0.22248089596583043,0.19120655447391902,151034324,150871758.4,70.09953129576213,58.51482072162908,NaN,NaN,20.804696834859428,20.968993743015513
2009-11-13T09:30:00-05:00,26.64,26.77,26.50999,26.72,4049906,8196329.8,64.4006316221988,57.82044326158327,NaN,NaN,107.55856672581935,130.8764517041315,0.036774847891347995,0.237175114338104,0.20040026644675601,155084230,152541542.2,71.54365055859625,58.35191061864947,NaN,NaN,22.049883748833057,21.123406600989448
2009-11-16T09:30:00-05:00,26.77,27.00999,26.77,26.87,5215910,7929492.5,66.85346195202159,58.8246672698669,NaN,NaN,147.2714382151073,132.35722931074935,0.04604029904247425,0.2579506402498488,0.21191034120737456,160300140,154173076,72.91989604452036,58.709104688228884,NaN,NaN,23.86591772043445,21.515193903767305
2009-11-17T09:30:00-05:00,26.85001,27,26.85001,27,4238621,7729688.6,68.85624092365983,60.13398732853507,NaN,NaN,146.08066744152657,130.1773086102452,0.05579854593422079,0.28165852362515054,0.22585997769092975,164538761,157355394.8,75.41724675810246,59.70985070065574,NaN,NaN,26.004702390336394,22.15655225899146
2009-11-18T09:30:00-05:00,27.02,27.02,26.799,26.98,6226297,7455546.8,68.1737710397468,60.62651342680243,NaN,NaN,123.35128751928522,126.41836741160357,0.055654298476623204,0.29542785078670875,0.23977355231008554,158312464,157853983.8,75.79389659620955,61.03331393504351,NaN,NaN,27.526121097851934,22.923633521685815
2009-11-19T09:30:00-05:00,26.84,26.91,26.64999,26.85001,6207316,7509898.75,63.751025161710224,61.617222166042254,NaN,NaN,85.55765972847914,121.96392392604352,0.04216476884689774,0.2924795133687077,0.25031474452180996,152105148,158068148.6,75.96425163921515,62.67396062797421,NaN,NaN,27.5409057605639,23.58324384152554
2009-11-20T09:30:00-05:00,26.74001,26.97,26.74001,26.89,5682773,7448897.15,64.51373801798445,62.272778144078224,NaN,NaN,86.71593744046599,117.79539806897284,0.0317694427848117,0.29002654800282457,0.2582571052180129,157787921,158608886.8,76.41556605903541,64.29571445729208,NaN,NaN,27.767363271702706,24.180975188693708
2009-11-23T09:30:00-05:00,27.06,27.23,27.06,27.12,4272008,7372422.95,68.60524712569034,63.512361102569415,NaN,NaN,120.61311676559313,112.46373377907,0.03591202905946428,0.30314714154234323,0.26723511248287896,162059929,158960844.6,76.7219433060724,66.45303586127123,NaN,NaN,29.18705966693559,24.896130114156833
2009-11-24T09:30:00-05:00,27.06,27.21001,27.02,27.17999,4565957,7277635.65,69.59010573823173,64.66674708243598,NaN,NaN,111.15690661201023,105.47898161316672,0.038018044118678374,0.3147576676312269,0.27673962351254855,166625886,159378269.6,77.10187327476208,68.62681465360485,NaN,NaN,30.64921774314794,25.717999775441278
2009-11-25T09:30:00-05:00,27.24001,27.24001,27.12,27.13,4851715,6786480.4,67.684662379563,65.50344739823153,NaN,NaN,107.72745558575271,102.35421522646023,0.0316318575260956,0.31627944542016806,0.28464758789407246,161774171,160070611,77.7505127369031,70.78182762156877,NaN,NaN,31.338454341052106,26.520921856242825
2009-11-27T09:30:00-05:00,26.53999,27.00999,26.53,26.88,3912428,6489416.25,58.98623435377092,65.61457097472979,NaN,NaN,39.77441164487914,93.19756560974022,0.007421431571369097,0.2939243773582838,0.2865029457869147,157861743,161221930,78.8247306939697,72.63727884353126,NaN,NaN,29.371104160858884,26.92809075690226
2009-11-30T09:30:00-05:00,26.91,26.91,26.67999,26.78,4728359,6320160.75,55.8920565129995,64.95776901450388,NaN,NaN,32.229986172959194,82.30037535623886,-0.017135997139377412,0.26508294936269294,0.28221894650207036,153133384,160291022.6,75.64459397688597,74.00519352343396,NaN,NaN,26.794123535457082,26.90895258241009
2009-12-01T09:30:00-05:00,27,27.16,26.83,27.14999,5351441,6145907.4,63.51733667174446,64.86647867276913,NaN,NaN,81.12396139916441,74.40254428295313,-0.010590859241390027,0.2689803724503328,0.2795712316917228,158484825,159576001.8,73.20171785327864,74.70877957249779,NaN,NaN,26.83726189653059,26.898711055855877
2009-12-02T09:30:00-05:00,27.07001,27.19,27,27.12,4973387,5485451.95,62.573063660196965,64.61420081668275,NaN,NaN,89.50090673913533,70.07134430837814,-0.010395992557102107,0.26657624099534516,0.27697223355244727,153511438,156953112.2,64.91953240682906,74.45135308572448,NaN,NaN,26.580128020417966,26.85319919365046
2009-12-03T09:30:00-05:00,27.16,27.16,26.87,26.91,7580129,5462509.55,56.26532564886437,64.26163577202735,NaN,NaN,54.35267306805105,59.39638780483781,-0.025655691171841855,0.24490261958764492,0.2705583107594868,145931309,153784539.8,56.5898151471955,73.48637336082686,NaN,NaN,24.356869605693117,26.496580681085128
2009-12-04T09:30:00-05:00,27.13,27.28999,26.87,27.05,8089750,5270895.7,59.21693903047595,63.89137201547572,NaN,NaN,76.00245900860357,66.6419972775827,-0.0274074164485113,0.23629904019884762,0.2637064566473589,154021059,153016403,54.75562957011182,72.28722900450654,NaN,NaN,23.416626552996675,26.05658723421535
2009-12-07T09:30:00-05:00,26.92,27.11,26.92,27.02,4439574,5264279.1,58.30881392242684,63.2810400133618,NaN,NaN,51.63813074281316,70.52362619155349,-0.031387313199183975,0.22447231514837895,0.25585962834756293,149581485,152306023.2,53.04335770199154,70.86747626575449,NaN,NaN,22.389679681374925,25.53274329809529
2009-12-08T09:30:00-05:00,26.89999,26.89999,26.60001,26.71001,9975145,5492678.35,49.808845422059036,61.92051176324746,NaN,NaN,-71.91107846655093,39.91661821841042,-0.054351921555295835,0.18791972640344312,0.24227164795873896,139606340,148530326.2,44.99040635720502,68.69413052283325,NaN,NaN,18.714009414344986,24.558638457559532
2009-12-09T09:30:00-05:00,26.73,26.78,26.59,26.75999,6639480,5648887.15,51.04789234981452,60.69723471396659,NaN,NaN,-87.27448116859087,4.561540636865175,-0.06491561316553968,0.16112713150181435,0.22604274466735402,146245820,147077202.6,42.3270333000521,66.30364028739343,NaN,NaN,16.134396745225793,23.35517535579757
2009-12-10T09:30:00-05:00,26.97,27,26.82001,26.85001,6643660,5621452.55,53.28479099002419,59.949646558846155,NaN,NaN,-12.294014652349567,-8.76779690721495,-0.06444966916252848,0.14548065821419343,0.2099303273767219,152889480,148468836.8,45.645624930731685,64.13802409393033,NaN,NaN,14.655360703424952,22.11234469117291
2009-12-11T09:30:00-05:00,26.99001,27.13,26.94,27,4554383,5609911.95,56.82489703855651,59.40044363174415,NaN,NaN,46.02198396271876,-14.763891916391913,-0.053120949659260036,0.14352914030264685,0.1966500899619069,157443863,149153397.6,47.253480182823246,62.05501795991517,NaN,NaN,14.450952608557758,21.017860107942177
2009-12-14T09:30:00-05:00,27.12,27.17999,27.02,27.10001,4087523,5611792.8,59.05305164415139,58.718143954491374,NaN,NaN,79.03820995668919,-9.283876073616705,-0.038646056563613196,0.1483425192573904,0.1869885758210036,161531386,151543377.8,52.53274578291394,60.32721813683242,NaN,NaN,14.943632320245298,20.150113281128338
2009-12-15T09:30:00-05:00,27.06,27.06,26.92,26.99001,5234516,5612723.1,55.65116275974755,57.72250517031393,NaN,NaN,15.486311686824761,8.195601957058434,-0.03627226602462405,0.14164824329022352,0.17792050931484757,156296870,154881483.8,58.74372677086303,59.015921957982485,NaN,NaN,14.362156397652036,19.32326229777458
2009-12-16T09:30:00-05:00,27.09,27.10001,26.85001,26.86,6109176,5706250.85,51.84935711375914,56.591411937042224,NaN,NaN,-14.241249941838408,22.802248202408926,-0.04280196977498682,0.12441804709611404,0.16722001687110086,150187694,155669858.6,60.07251371553753,57.753207742170666,NaN,NaN,12.739172730998167,18.38267807394938
2009-12-17T09:30:00-05:00,26.73,26.78999,26.53,26.53999,10700305,5929951.25,43.89969536886177,55.51380200954872,NaN,NaN,-160.3245431389038,-6.803857494901903,-0.0665977151744375,0.083972872903054,0.1505705880774915,139487389,152989440.4,53.73554551637054,55.961123086627865,NaN,NaN,8.674813527117314,16.995840281544798
2009-12-18T09:30:00-05:00,26.53,26.53,25.96001,26.24001,10117449,6125457.9,38.01558997244642,54.23691154236635,NaN,NaN,-267.32418455812626,-69.47309119907091,-0.09853801121579892,0.02739807405774286,0.12593608527354178,129369940,147374655.8,43.406201726645946,53.658380783039284,NaN,NaN,3.0770497312134357,15.00744163149746
2009-12-21T09:30:00-05:00,26.35001,26.53,26.27,26.38,7650238,6223831.15,41.927415592054764,52.694774322388525,NaN,NaN,-169.8857970598376,-119.25789260237624,-0.10560634510640728,-0.006071846109467316,0.09953449899693996,137020178,142472414.2,36.76182267594742,51.05553112751563,NaN,NaN,-0.19679094414543014,12.83540840640562
2009-12-22T09:30:00-05:00,26.35001,26.58,26.35001,26.56,4110762,6215768.85,46.59447548712427,51.553446595740475,NaN,NaN,-115.9315462210164,-145.5414641839445,-0.09392083827668071,-0.017866548848910924,0.07605428942776979,141130940,139439228.2,33.35924645317384,48.80122498796883,NaN,NaN,-1.3886097870910152,10.803405807334672
2009-12-23T09:30:00-05:00,26.50999,26.64,26.5,26.58,3559213,6165431.65,47.1031549041272,50.89900582825925,NaN,NaN,-81.34118536410836,-158.9614512683985,-0.08109012260528059,-0.02530836382883095,0.05578175877644964,144690153,138339720,32.195935056298964,47.058804981476214,NaN,NaN,-2.168874226373604,8.950222945376346
2009-12-24T09:30:00-05:00,26.63,26.72,26.60001,26.67999,1568138,6001252.8,49.683510556203686,50.21804665152552,NaN,NaN,-46.27827525910835,-136.15219769243942,-0.06292462381451172,-0.022874020991690003,0.04005060282282171,146258291,139693900.4,35.193450202906206,45.66150645524724,NaN,NaN,-2.033666104287038,7.381095938281577
2009-12-28T09:30:00-05:00,26.81,26.81,26.64999,26.73,8470684,6229165.6,50.97170539673306,49.69396747111882,NaN,NaN,-24.094284053131236,-87.50621759144039,-0.045413840671709164,-0.016716698016814746,0.02869714265489442,154728975,144765707.4,45.00044048369306,45.08701236822593,NaN,NaN,-1.5452851097828653,6.105898645700942
2009-12-29T09:30:00-05:00,26.75,26.85001,26.75,26.78,3185999,6152047.6,52.286949134399244,49.87097487914311,NaN,NaN,-4.026702660271896,-54.33439871152725,-0.029128495648117165,-0.007713476905252037,0.021415018742865128,157914974,148944666.6,51.5114210112438,45.55279912922869,NaN,NaN,-0.7653758396234137,5.12428800494032
2009-12-30T09:30:00-05:00,26.73,26.82001,26.69,26.73,3142506,6041600.85,50.81880535132295,49.85461152210801,NaN,NaN,-14.82637181817575,-34.113363830959116,-0.020780312841456018,-0.004560372308954896,0.01621994053250112,154772468,151672972.2,55.237175507496666,46.474952144046156,NaN,NaN,-0.5092270863792216,4.319500134751815
2009-12-31T09:30:00-05:00,26.8,26.8,26.44,26.47,5099352,6047899.1,43.91379566663497,49.18525471329449,NaN,NaN,-67.44180383572586,-31.333487525282624,-0.03119896194674248,-0.02277876190092698,0.0084202000458155,149673116,152669564.8,56.55049073602472,47.25387113013852,NaN,NaN,-2.3081415568904156,3.3726941788029245
2010-01-04T09:30:00-05:00,26.45,26.78,26.45,26.67,8465871,6092186.2,49.58811894145097,48.66834199207266,NaN,NaN,-41.09440796797331,-30.296714067055625,-0.023406900817084825,-0.02083842597554053,0.0025684748415442937,158138987,155045704,59.59440169468228,48.13536552384274,NaN,NaN,-2.1530776507697884,2.58329820314968
2010-01-05T09:30:00-05:00,26.69,26.72,26.53999,26.67999,11805324,6277964.9,49.8609878000257,48.01176600320654,NaN,NaN,-30.957368573192444,-31.669330971067865,-0.01668183727273511,-0.018283821749374596,-0.0016019844766394847,169944311,158088771.2,63.15445425030656,48.89405898579936,NaN,NaN,-1.9489235494147519,1.9358379527833325
2010-01-06T09:30:00-05:00,26.64999,26.69,26.53999,26.66,9267000,6519336.2,49.28610729848828,47.557119184545165,NaN,NaN,-32.043291783971576,-37.27264879580781,-0.012853318367035821,-0.01766863243543426,-0.00481531406839844,160677311,158641238.6,63.778421840622954,49.25368006221078,NaN,NaN,-1.9392722930153157,1.3822507748120971
2010-01-07T09:30:00-05:00,26.74001,26.74001,26.50999,26.66,6951484,6368153.15,49.28610729848828,47.37402991202582,NaN,NaN,-26.90459272728678,-39.68829297763001,-0.009735984400580988,-0.016985294569124676,-0.007249310168543687,160677311,159822207.2,65.13752262158825,49.61546641264294,NaN,NaN,-1.931293494798567,0.9088873077248595
2010-01-08T09:30:00-05:00,26.60001,26.60001,26.42,26.57001,5437371,6308047.7,46.48773245433571,47.55888970384539,NaN,NaN,-64.86753122468187,-39.17343845542119,-0.012948584462886981,-0.023435040747152414,-0.010486456284265432,155239940,160935572,66.41687227030685,50.52127546649553,NaN,NaN,-2.6661822267438207,0.3981630885150481
2010-01-11T09:30:00-05:00,26.56,26.67999,26.38,26.64,6140141,6282871.75,48.91704721045087,48.337565220845704,NaN,NaN,-46.10881643683356,-40.176320149193245,-0.009721192438616058,-0.022637946832535505,-0.012916754393919446,161380081,161583790.8,67.17221050332,52.21884752197224,NaN,NaN,-2.6581360054598204,-0.03845106776707591
2010-01-12T09:30:00-05:00,26.53999,26.78999,26.53999,26.78999,6822391,6396272.15,53.76150442055555,49.18285728002433,NaN,NaN,22.2013254737672,-29.54458133980131,0.002501046308594084,-0.009790446508176842,-0.012291492816770926,168202472,161235423,66.30904482089056,54.32936338946819,NaN,NaN,-1.3002576988527745,-0.21870915792217568
2010-01-13T09:30:00-05:00,26.8,27.03999,26.78999,26.98,7926688,6588230.4,59.0585227535342,50.07314637048218,NaN,NaN,147.1672604384918,6.297529104691356,0.02226865328671804,0.015544323791626624,-0.006724329495091416,176129160,164325792.8,69.99277255488643,56.946043825304805,NaN,NaN,1.5082998382480917,0.028006412959291044
2010-01-14T09:30:00-05:00,26.94,27,26.87,26.89999,5258855,6589447.35,56.141982205735175,50.71877689202561,NaN,NaN,146.54470752111544,40.9873891543718,0.028446499922320737,0.028833795407809504,0.0003872954854887674,170870305,166364391.6,72.1555823865265,59.80030434889249,NaN,NaN,3.048425854756161,0.4594949046445581
2010-01-15T09:30:00-05:00,26.94,26.98,26.67,26.77,11968742,6882425.65,51.676873596619494,50.86115996634102,NaN,NaN,93.21202028390704,72.60329945608957,0.022528252958525476,0.028547611683645613,0.006019358725120137,158901563,167096716.2,72.91092363996172,62.49440959439645,NaN,NaN,3.0814813166041723,0.83406439206736
2010-01-19T09:30:00-05:00,26.84,26.97,26.72,26.92999,10974121,6896116.45,56.28517241730089,51.24069332495301,NaN,NaN,113.02488583509863,104.43003991047601,0.0277931528605442,0.040760799800800385,0.012967646940256186,169875684,168795836.8,74.63050286782536,64.61084262183446,NaN,NaN,4.512146406374133,1.3595046798254704
2010-01-20T09:30:00-05:00,26.88,26.88,26.53,26.73,8670402,6823764.1,49.8815505557696,51.06887914076518,NaN,NaN,20.599005863995878,104.10957598852175,0.016755008973366275,0.03391140815696403,0.017156399183597754,161205282,167396398.8,70.65246032530351,65.97805971569588,NaN,NaN,3.75831120499071,1.7021913262776476
2010-01-21T09:30:00-05:00,26.71001,26.84,26.28999,26.35001,9044688,6893486.6,40.46204551744564,50.32911058120252,NaN,NaN,-117.81729839877447,51.1126642210685,-0.015448296718019764,-0.00215397171392695,0.013294325004092814,152160594,162602685.6,59.04272057825919,66.24988436360749,NaN,NaN,-0.28043435244096593,1.418959086460703
2010-01-22T09:30:00-05:00,26.25,26.49001,26.2,26.28999,9082313,7142064.15,39.202790678840586,49.99261022493148,NaN,NaN,-201.4166066556821,-18.479598614291007,-0.038774417608351305,-0.035173697006346316,0.0036007206020049875,143078281,157044280.8,48.99034896012211,65.7098742367573,NaN,NaN,-3.86355038118636,0.6643148767968369
2010-01-25T09:30:00-05:00,26.48,26.49001,26.205,26.34,6078234,7268015.2,40.8544978862411,49.368780149559356,NaN,NaN,-168.76114335637655,-70.87423134234773,-0.04820346495252731,-0.056653610588654146,-0.00845014563612684,149156515,155095271.2,46.030968659747494,64.74105759140481,NaN,NaN,-6.195593234870686,-0.3156719962985235
2010-01-26T09:30:00-05:00,26.21001,26.41,26.16,26.31,8116668,7595441.7,40.14983361441147,48.675126279158334,NaN,NaN,-164.46640973822096,-126.37249045701165,-0.05342399542135054,-0.07523013991281502,-0.021806144491464476,141039847,149328103.8,38.60049667557832,62.98720347892423,NaN,NaN,-8.282806113344057,-1.453834013019314
2010-01-27T09:30:00-05:00,26.28,26.39999,26.17,26.37,12558313,7799823.15,42.293617033855895,48.17566268882745,NaN,NaN,-133.24249622491624,-157.14079087479405,-0.04986768637581018,-0.08414075246122721,-0.034273066085417025,153598160,147806679.4,36.90788270388203,61.0678792548713,NaN,NaN,-9.390423942978654,-2.5876325744420767
2010-01-28T09:30:00-05:00,26.41,26.61,26.28999,26.3,14181621,8349604.25,40.47222232480476,47.54609947642148,NaN,NaN,-85.08942645287118,-150.5952164856134,-0.04917928970684349,-0.09574717821897138,-0.0465678885121279,139416539,145257868.4,34.20211833745715,58.85820752029051,NaN,NaN,-10.846270722470019,-3.767438024160354
2010-01-29T09:30:00-05:00,26.42,26.57001,26.2,26.2,8930430,8639000.45,37.95737265560681,46.93678806222656,NaN,NaN,-103.66969642918521,-131.04583444031402,-0.052126972211068434,-0.11172660377596344,-0.059599631564895006,130486109,142739434,31.727097402930298,56.38036645833505,NaN,NaN,-12.823750850757353,-5.061196999388496
2010-02-01T09:30:00-05:00,26.36,26.45,26.25,26.39999,9019598,8835012.75,45.280402961353836,46.67702775871963,NaN,NaN,-77.62778419715019,-112.81916260846876,-0.03793568742827205,-0.10701924085023506,-0.06908355342196301,139505707,140809272.4,29.938923456142163,53.72084595496519,NaN,NaN,-12.389059928855971,-6.108034560740992
2010-02-02T09:30:00-05:00,26.45,26.81,26.39,26.78,7433199,8783379.15,55.9256944356042,46.83161275979453,NaN,NaN,31.857950501458433,-73.55429056053288,-0.0021710416395353677,-0.07179735547138222,-0.06962631383184685,146938906,141989084.2,32.44525782545088,51.3020040267195,NaN,NaN,-8.300985597105145,-6.421313280221585
2010-02-03T09:30:00-05:00,26.71001,26.71001,26.53999,26.59,6566895,8521457.7,50.622898292654675,46.229068155445994,NaN,NaN,15.216302805080371,-43.86253075453355,0.008868768742092692,-0.058540352904230986,-0.06740912164632368,140372011,139343854.4,29.865563375102866,48.43577479959212,NaN,NaN,-6.697664254111324,-6.460791990777262
2010-02-04T09:30:00-05:00,26.50999,26.52,26,26.05,10827230,8599469.2,39.236047292995046,45.021501375964554,NaN,NaN,-124.83123517608401,-51.81089249917612,-0.01852358986653617,-0.09056360897949389,-0.07204001911295772,129544781,137369502.8,28.071536296700614,45.28691436460455,NaN,NaN,-9.631989457191272,-6.913820200264978
2010-02-05T09:30:00-05:00,26,26.05,25.71001,25.98,13527398,8928264.9,38.04150032002206,44.04754614192188,NaN,NaN,-183.7083127783394,-67.81861576900698,-0.03853201373887888,-0.12020503628655632,-0.08167302254767744,116017383,134475757.6,25.640429419026347,41.910450491680585,NaN,NaN,-12.264886294972442,-7.678258213794615
2010-02-08T09:30:00-05:00,26.05,26.17,25.92999,25.95,5150891,8913940.9,37.51436336743346,42.70677406693135,NaN,NaN,-131.09144477290056,-78.51134788415705,-0.05022292692112447,-0.14445168119908303,-0.09422875427795856,110866492,128747914.6,21.644631100212337,38.12574536542251,NaN,NaN,-14.449054916079165,-8.64551488554955
2010-02-09T09:30:00-05:00,26.19,26.39999,26.03999,26.25999,7456449,8979756.3,45.862259946681625,42.419681880567914,NaN,NaN,-64.40409714591095,-97.76375741363093,-0.034275892821567275,-0.13707362030491765,-0.10279772748335038,118322941,123024721.6,18.536263156734023,34.40315985338184,NaN,NaN,-13.42161396676782,-9.327814754295018
2010-02-10T09:30:00-05:00,26.28,26.28999,26.03999,26.23,6364539,8956863.7,45.23266318620213,42.7604402854791,NaN,NaN,-70.72011979309727,-114.95104193326645,-0.02346050633220384,-0.13212336039860517,-0.10866285406640133,111958402,117341999.8,16.06871287582095,31.33358787463624,NaN,NaN,-12.833021435754901,-9.828558565932143
2010-02-11T09:30:00-05:00,26.22,26.49001,26.06,26.44099,5879742,8854516.4,50.39237621286642,43.55969639505237,NaN,NaN,-26.341076481236453,-95.25301019429693,-0.0009962457134442826,-0.10990816120820668,-0.1089119154947624,117838144,115000672.4,15.17253852697202,28.918029986554096,NaN,NaN,-10.625151162159401,-9.942357508250323
2010-02-12T09:30:00-05:00,26.25999,26.49001,26.19,26.44,8895367,9036342,50.36839782024029,44.23926067605232,NaN,NaN,-5.530431049815448,-59.61743384859214,0.01406589214079526,-0.09132955031876833,-0.10539544245956359,108942777,113585751.2,14.641115493218734,26.67589761751632,NaN,NaN,-8.908957375286988,-9.794728917826989
2010-02-16T09:30:00-05:00,26.5,26.73,26.44,26.71001,7113859,8793597.85,56.45435994801604,45.40386969988122,NaN,NaN,95.60810881620701,-14.277523130770632,0.04096146857501977,-0.05419360674078888,-0.09515507531580865,116056636,114623780,16.939581438217985,25.1286893862763,NaN,NaN,-5.4157642685485055,-9.169162539358634
2010-02-17T09:30:00-05:00,26.78999,26.92999,26.72,26.89999,7493527,8619568.15,60.156408787672106,46.67978339658238,NaN,NaN,184.09920472790392,35.42313724399234,0.06866341739199969,-0.009325803575809033,-0.07798922096780872,123550163,115669224.4,19.296570430241474,23.870738509587685,NaN,NaN,-1.2550248321098059,-8.038571438323087
2010-02-18T09:30:00-05:00,26.89,27.12,26.825,27.06,7540242,8563060.15,63.00886537467019,48.28954361442991,NaN,NaN,214.1781868824772,92.40279857910723,0.09334948966214018,0.03869764110986651,-0.054651848552273674,131090405,119495625,27.415209683088747,23.38595931998994,NaN,NaN,3.1397578127920966,-6.4416672595923465
2010-02-19T09:30:00-05:00,27.05,27.2,26.94,27.12,4443828,8333017.15,64.04823400393903,50.153176567882205,NaN,NaN,192.23706703666087,136.1184272826867,0.10825601731175576,0.08066817308742102,-0.02758784422433473,135534233,123034842.8,34.02616912889103,23.550178728987134,NaN,NaN,7.0056294451061305,-4.52062487320685
2010-02-22T09:30:00-05:00,27.2,27.21001,27.03999,27.12,4414309,8099616.95,64.04823400393903,51.49373592806687,NaN,NaN,161.69563129714834,169.56363975207947,0.11217569385277051,0.11263177309162842,0.0004560792388579038,135534233,128353134,42.50095961234037,24.447467025858437,NaN,NaN,10.0992046333747,-2.4320778008380572
2010-02-23T09:30:00-05:00,27.03,27.14999,26.825,26.97,8464242,8218917.35,59.22347922572245,51.72929198450388,NaN,NaN,108.69619183823164,172.18125635648437,0.0991752283786049,0.12442511471211404,0.025249886333509133,127069991,130555805,45.616861261151406,25.388295842694188,NaN,NaN,11.388163162378524,-0.4577576632356888
2010-02-24T09:30:00-05:00,26.98,27.14999,26.92,27.14,4148324,8020500.15,62.65685488143324,52.58886031227377,NaN,NaN,111.30810653048968,157.62303671700153,0.09644666358444683,0.14580821581406767,0.04936155222962084,131218315,132089435.4,47.74032856000029,26.665064784472573,NaN,NaN,13.53206545556391,1.5407884965928254
2010-02-25T09:30:00-05:00,26.89999,27.2,26.82001,27.16,6443262,7714747.6,63.05102105865743,54.28992986696395,NaN,NaN,96.87002788955556,134.1614049184172,0.09050689198386876,0.16249516720945678,0.07198827522558802,137661577,133403669.8,49.557979912695075,28.199810757043604,NaN,NaN,15.391602756723952,3.519476248040129
2010-02-26T09:30:00-05:00,27.2,27.2,26.96001,27.03,5805855,7295959.3,58.712915181373724,55.76645949991764,NaN,NaN,87.63526918361221,113.24104534780747,0.07308683772360301,0.1633468223800918,0.09025998465648878,131855722,132667967.6,48.54018736903817,29.835507753473024,NaN,NaN,15.768647488442971,5.269357853811963
2010-03-01T09:30:00-05:00,27.13,27.24001,27.02,27.22,4360102,7067442.9,62.74716077617099,57.56880217197032,NaN,NaN,95.22243443236998,99.94640597485179,0.0696394254664132,0.1773092664895053,0.10766984102309209,136215824,132804285.8,48.7502139188323,31.771620811945883,NaN,NaN,17.291084458545647,6.986747368773917
2010-03-02T09:30:00-05:00,27.27,27.38,27.22,27.32001,14651906,7349058.3,64.70226307192522,58.914516680916314,NaN,NaN,108.35040122967257,99.87724785313998,0.06922883966459813,0.19420589060383975,0.12497705093924162,150867730,137563833.6,55.568748902756894,34.41679836523323,NaN,NaN,19.14965145209061,8.724305094962016
2010-03-03T09:30:00-05:00,27.36,27.42,27.27,27.33,7570117,7355904.2,64.90042431515366,60.31935676155571,NaN,NaN,100.925486699043,97.80072388685065,0.06484054881208151,0.2060277369543435,0.141187188142262,158437847,143007740,61.824919932387225,37.68509886927368,NaN,NaN,20.72213483846053,10.43828077260466
2010-03-04T09:30:00-05:00,27.42,27.53,27.36,27.42,5479457,7301532.3,66.71344362188941,61.48514729077164,NaN,NaN,104.47789275046954,99.32229685903346,0.06314741750794836,0.22012146002719746,0.1569740425192491,163917304,148258885.4,66.69618863395934,41.365359591201354,NaN,NaN,22.57855771506153,12.172606050098498
2010-03-05T09:30:00-05:00,27.56,27.61,27.41,27.59,5123176,7016329.6,69.87841296676604,62.878719801237764,NaN,NaN,112.37282827534774,104.26980867738057,0.06819380410305723,0.24221629764807062,0.1740224935450134,169040480,155695837,72.12183944072825,45.471125587452036,NaN,NaN,25.151323234520028,14.02670850501586
2010-03-08T09:30:00-05:00,27.58,27.62,27.45,27.49001,2690763,6474497.85,65.90890164887676,63.5540442084421,NaN,NaN,106.40848821719,106.50701943434456,0.05981429149930498,0.2487903579191446,0.18897606641983963,166349717,161722615.6,75.5921083809555,49.66059179764757,NaN,NaN,26.217048367410236,15.768185628215056
2010-03-09T09:30:00-05:00,27.42999,27.57001,27.41,27.45,4602789,6447092.75,64.33407859718005,63.85244919483552,NaN,NaN,97.63969578034826,104.3648783444797,0.047150407884044676,0.24791407627489548,0.2007636683908508,161746928,163898455.2,76.71886344560602,53.762184155887894,NaN,NaN,26.667161038600113,17.32518211541292
2010-03-10T09:30:00-05:00,27.49001,27.49001,27.34,27.41,4572988,6302919.7,62.720560854385475,63.83185601481519,NaN,NaN,81.91438884699987,100.56265877407108,0.032358198085541995,0.2412114159977783,0.2088532179122363,157173940,163645673.8,76.27830532580393,57.25240527322469,NaN,NaN,26.60800014806742,18.65129897722071
2010-03-11T09:30:00-05:00,27.36,27.48,27.23,27.46001,6088449,6289115.2,63.9383166422637,63.82400477469552,NaN,NaN,71.65251499982517,93.9975832239422,0.022677903789919823,0.23720059764963608,0.21452269385971626,163262389,163514690.8,76.03465492468399,60.25301140149561,NaN,NaN,26.878099262572547,19.8265561608424
2010-03-12T09:30:00-05:00,27.5,27.53999,27.44,27.48,14073078,6698782,64.43836632870355,63.85187136932156,NaN,NaN,88.56003262392386,89.23502409365742,0.014741622322333614,0.2329497217626333,0.21820809944029967,177335467,165173688.2,77.03521668850618,62.71974404979317,NaN,NaN,27.234630522902602,20.88485249827957
2010-03-15T09:30:00-04:00,27.45,27.71001,27.45,27.689,4104836,6459255.45,69.24079043106308,64.56739359827446,NaN,NaN,115.27305007881817,91.00793646598306,0.02034306479581044,0.24363693043506274,0.2232938656392523,181440303,168191805.4,78.77162569816234,65.08794150957966,NaN,NaN,28.914003902672935,22.031874127478623
2010-03-16T09:30:00-04:00,27.66,27.84,27.66,27.82001,5360480,6371586.5,71.81063546713888,65.22123506868202,NaN,NaN,150.4671315723558,101.57342362438456,0.029112547935060074,0.2596845505580774,0.2305720026230173,186800783,173202576.4,81.29970798265857,67.48504003976954,NaN,NaN,31.138381335829457,23.3328037286716
2010-03-17T09:30:00-04:00,27.89,27.98,27.81,27.94,3963642,6195092.25,73.95674698344641,66.00021549188122,NaN,NaN,174.58810790787078,120.10816743655873,0.03863836275054919,0.2788699560612038,0.2402315933106546,190764425,179920673.4,84.04343161977225,69.94828659027506,NaN,NaN,33.70490805596699,24.814532918285227
2010-03-18T09:30:00-04:00,27.94,27.99001,27.875,27.97,4595938,6047877.05,74.47987818890167,67.12642713527607,NaN,NaN,164.3961579633411,138.65689602926193,0.042307856443436875,0.2931164138649507,0.2508085574215138,195360363,186340268.2,86.1366150524609,72.63374571051953,NaN,NaN,35.975717881313194,26.408987913003507
2010-03-19T09:30:00-04:00,27.92,27.95,27.64,27.77,4385164,6044943.85,65.09258579737138,67.29395749393323,NaN,NaN,106.80505616613031,142.3059007377032,0.027339869748641887,0.28498339460731614,0.25764352485867426,190975199,189068214.6,86.92172615243074,75.3602822986337,NaN,NaN,35.22824107215456,27.668881221453656
2010-03-22T09:30:00-04:00,27.66,27.95,27.64999,27.91,3038753,5976166.05,68.12146826530389,67.53818643631743,NaN,NaN,108.91609561355023,141.03450984464965,0.023110610615374116,0.28653178812789193,0.2634211775125178,194013952,191582944.4,87.61786754735205,77.64950505896194,NaN,NaN,35.49523971824862,28.786932435281507
2010-03-23T09:30:00-04:00,27.89999,28.17,27.88,28.13,5327371,5819322.5,72.20315422994915,68.05981000165997,NaN,NaN,152.93995319198373,141.52907416857522,0.030886621975254436,0.30202945498158584,0.2711428330063314,199341323,194091052.4,88.28749960885837,79.53968932156702,NaN,NaN,37.04245288148841,29.96629249902535
2010-03-24T09:30:00-04:00,28.12,28.12,27.85001,27.92999,3325519,5778182.25,64.16011604031098,67.87742946011865,NaN,NaN,111.73405050001891,128.95826268700483,0.01890521909550552,0.2947743568757133,0.2758691377802078,196015804,195141328.2,88.56634764217162,81.10184353643932,NaN,NaN,35.69254752122922,30.784328930768762
2010-03-25T09:30:00-04:00,28.03,28.03999,27.85001,27.89,3843497,5648194,62.65725203742956,67.36163225088033,NaN,NaN,89.79886900079376,114.03880489449539,0.005337350418017972,0.2825408258027302,0.27720347538471224,192172307,194503717,87.20892169729045,82.17949226905091,NaN,NaN,34.14250466398107,31.264068321227665
2010-03-26T09:30:00-04:00,27.95,27.99001,27.81,27.91,3289218,5522362.15,63.12249450739896,67.16260316934621,NaN,NaN,74.7571144369261,107.62921654865454,-0.004697377439446704,0.27133175358540385,0.27602913102485055,195461525,195400982.2,87.49927853603572,83.03000442298521,NaN,NaN,33.03661687660817,31.51728954342488
2010-03-29T09:30:00-04:00,28,28.11,27.92999,28.03999,6690742,5638894.15,66.08042592930124,67.28734226449772,NaN,NaN,99.38144230547779,105.72228588704006,-0.004961552946671832,0.2698271898415108,0.2747887427881826,202152267,197028645.2,88.03009449821732,83.83794949817172,NaN,NaN,32.96607073311652,31.724258284809398
2010-03-30T09:30:00-04:00,28.10001,28.19,28.00999,28.09,3458080,5079202.85,67.17139049917847,67.60525866769721,NaN,NaN,109.18179643282993,96.97065453520929,-0.004180715380553979,0.26956284856249013,0.2737435639430441,205610347,198282450,88.43739478286,84.70645588796144,NaN,NaN,33.22541079857973,31.938708643919444
2010-03-31T09:30:00-04:00,28.05,28.0741,27.91,27.92999,4757191,4938556.55,60.469857565616316,67.35751159079383,NaN,NaN,67.24023312167647,88.0718910595408,-0.016179273719786558,0.2535194717933109,0.26969874551309747,200853156,199249920.4,88.75534745128725,85.61507678271882,NaN,NaN,31.41812139988526,31.864339037628845
2010-04-01T09:30:00-04:00,28.06,28.1562,27.98,28.11,4442598,4886713.6,64.73267319895608,67.37853351009758,NaN,NaN,94.95852618285265,89.10382249595258,-0.013822567690807142,0.25242053589958857,0.2662431035903957,205295754,201874609.8,89.5915611639187,86.51195853096257,NaN,NaN,31.151476733318688,31.762501565584536
2010-04-05T09:30:00-04:00,28.19,28.19,28.06,28.11,3603491,4810729.35,64.73267319895608,67.05652513637565,NaN,NaN,98.56351250352446,93.86510210927226,-0.014048115723865107,0.24868295893556436,0.26273107465942946,205295754,203841455.6,90.18084232490575,87.32690257572996,NaN,NaN,30.939491990108177,31.64492876908791
2010-04-06T09:30:00-04:00,28.03,28.07001,27.99001,28.02,3965561,4874469.25,60.923190101200326,66.27885046738004,NaN,NaN,63.69035446575577,86.72688454132785,-0.021591918222053252,0.2357411768818629,0.25733309510391617,201330193,203677040.8,89.72354499443254,87.92860521942809,NaN,NaN,29.63936670973316,31.358419903465805
2010-04-07T09:30:00-04:00,28,28,27.785,27.84,3591110,4823885.3,54.06970898964332,64.85834775353696,NaN,NaN,5.554843462312067,66.00149394722428,-0.03902157964270381,0.2085561205505364,0.2475777001932402,197739083,202102788,85.26519247711803,88.01587385209567,NaN,NaN,26.361769814686227,30.644612747925866
2010-04-08T09:30:00-04:00,27.84,27.94,27.75999,27.89,2570491,4723760.45,55.565034072123986,63.50728745948141,NaN,NaN,-9.195866150887367,50.714274092711506,-0.04696681351089485,0.18886918330462166,0.2358359968155165,200309574,201994071.6,84.95125508098938,87.93120528270484,NaN,NaN,24.10364578559147,29.71018889616381
2010-04-09T09:30:00-04:00,27.94,28.06,27.87,28.03999,3338976,4586286.8,59.79373645380568,63.12879822065529,NaN,NaN,43.89496557725132,40.501561971591244,-0.04206271457132643,0.18325760360135845,0.22532031817268489,203648550,201664630.8,83.94265045162774,87.71841416121892,NaN,NaN,23.402802017172515,28.809133627736482
2010-04-12T09:30:00-04:00,28.03,28.13,28.00999,28.13,4089985,4087132.15,62.12326453298413,62.700355096918166,NaN,NaN,97.92502457435423,40.37386438575719,-0.033093897771709846,0.18395294595804756,0.2170468437297574,207738535,202153187,84.24145628182063,87.47724192796667,NaN,NaN,23.51497615952051,28.052825417991343
2010-04-13T09:30:00-04:00,28.03,28.12,27.8918,28.03999,3045759,4034178.3,58.47466134543162,61.719748462309774,NaN,NaN,42.25591555241938,36.086976603089916,-0.03346058291421872,0.17522111508698401,0.20868169800120273,204692776,202825703.6,84.66450100318649,87.21845631327582,NaN,NaN,22.518416275702734,27.262195540521542
2010-04-14T09:30:00-04:00,28.03,28.08,27.91,28.08,3634482,3947878.4,59.61021174161835,61.39475529811744,NaN,NaN,40.88472186626528,43.15295228388056,-0.03128552148781888,0.16957479614142912,0.200860317629248,208327258,204943338.6,85.94406691429347,87.03115054699882,NaN,NaN,22.022962203918244,26.5137336352925
2010-04-15T09:30:00-04:00,27.96001,28.03,27.89999,28.03,3876266,3943509.6,57.49426894463319,61.02597079148912,NaN,NaN,6.2506321552805595,46.24225194511414,-0.03330428475628239,0.15922996168389503,0.19253424644017741,204450992,205771622.2,86.4213053477196,86.97489223631518,NaN,NaN,21.0082679551292,25.727238538126315
2010-04-16T09:30:00-04:00,27.94,28.13,27.81,27.91,6528977,4040161.55,52.66275988114411,60.278846889613774,NaN,NaN,-26.98749562704308,32.06575970425526,-0.04223715845472964,0.13973779837176536,0.181974956826495,197922015,204626315.2,82.26216658560597,86.60081281128448,NaN,NaN,18.710787341966455,24.724888367246336
2010-04-19T09:30:00-04:00,27.85001,28.03,27.83,28.02,4791039,4060455.3,56.28891171009955,59.57945301681366,NaN,NaN,-29.510676164287887,6.57861955652684,-0.04026105691608367,0.1316486356813904,0.17190969259747407,202713054,203621219,78.6833784678789,85.93319023768889,NaN,NaN,17.771635873724666,23.731566582457525
2010-04-20T09:30:00-04:00,28.07001,28.17,28.011,28.099,5377797,4177407.5,58.733787235123074,58.976767069381125,NaN,NaN,98.56275756026004,17.839987958094973,-0.03343759603447166,0.13011269755438448,0.16355029358885614,208090851,204300834,79.33793852577304,85.28322907646839,NaN,NaN,17.68603429646509,22.867919113030034
2010-04-21T09:30:00-04:00,28.14999,28.2,28.03999,28.10001,5605406,4191309.25,58.765541670377495,58.85503021972121,NaN,NaN,112.33613618241303,32.13027082132452,-0.02883452987633811,0.1275071312434335,0.1563416611197716,213696257,205374633.8,80.36390079607037,84.68384002966718,NaN,NaN,17.62508234395965,22.118942431734265
2010-04-22T09:30:00-04:00,27.96001,28.10001,27.88,28.10001,5113547,4280710.65,58.7655416703775,58.42880653910845,NaN,NaN,20.44388177621079,34.96892074551057,-0.02586320056314545,0.1240126604158398,0.14987586097898525,213696257,207223686.8,82.01955243289787,84.14298226316569,NaN,NaN,17.574617471659696,21.469753151723612
2010-04-23T09:30:00-04:00,28.07001,28.07001,27.87,28.03,4651129,4321092.25,55.34202165820811,57.75804571476931,NaN,NaN,-22.427457531930916,35.880928364533005,-0.02847930146305483,0.1142767341501667,0.14275603561322153,209045128,209448309.4,83.79038725471547,83.68652118672352,NaN,NaN,16.61979782103586,20.776902390196792
2010-04-26T09:30:00-04:00,28.05,28.1293,27.96001,27.97,4457348,4379498.75,52.51820893928529,57.15768991748967,NaN,NaN,4.502467416798495,42.683557080750276,-0.0337566301383308,0.10056024794030805,0.13431687807863885,204587780,209823254.6,84.07506361094204,83.28305823075992,NaN,NaN,15.030701118472189,19.956016494236135
2010-04-27T09:30:00-04:00,27.84,27.89999,27.46001,27.48,8249215,4457422.4,36.250551948996474,55.88489298601489,NaN,NaN,-335.5040630115909,-44.12980703361991,-0.06778997579037563,0.04957940834066932,0.11736938413104495,196338565,207472797.4,75.16348028103042,82.56150735961081,NaN,NaN,7.52351466485355,18.179944804324336
2010-04-28T09:30:00-04:00,27.59,27.7693,27.45,27.7,5162094,4542623.1,44.55463411650583,55.09843584632788,NaN,NaN,-237.2164600049799,-114.04032627109851,-0.07259790319244505,0.026622005140488625,0.09921990833293368,201500659,205033677.8,67.20295919705688,81.29377193932991,NaN,NaN,4.09649398031437,16.1680232580372
2010-04-29T09:30:00-04:00,27.78,27.91,27.64999,27.78999,4095499,4509538.5,47.5635152609877,54.224848618269455,NaN,NaN,-113.38077743338867,-140.8052581130184,-0.06696733429324106,0.015510740466382344,0.0824780747596234,205596158,203413658,62.470554399216056,79.76005079272909,NaN,NaN,2.4368804782869553,14.206431432358592
2010-04-30T09:30:00-04:00,27.77,27.95,27.62,27.63,7474566,4661136.9,43.08672700008654,52.8650959373482,NaN,NaN,-121.4073178034391,-160.60123016732,-0.07088978936563632,-0.006134161947422001,0.06475562741821432,198121592,201228950.8,56.6744233083459,77.79097700890948,NaN,NaN,-0.4940403013742496,12.106364041825328
2010-05-03T09:30:00-04:00,27.66,27.86,27.62,27.78999,3372735,4649599.1,48.32466763076222,52.140096386300385,NaN,NaN,-92.7656055623716,-180.05484476315405,-0.060012324976283914,-0.010259778802140573,0.04975254617414334,201494327,200610260.2,55.11488269986559,75.68028998724368,NaN,NaN,-1.0972583225304882,10.220132275488783
2010-05-04T09:30:00-04:00,27.59,27.74001,27.46001,27.50999,12393230,5070982.55,41.181384988718,50.823751618236074,NaN,NaN,-159.03208279832245,-144.76044872050034,-0.06837112612311055,-0.03571136147974485,0.0326597646433657,189101097,199162766.6,51.541385202829666,73.22295557928199,NaN,NaN,-4.221727269533365,8.157009483342762
2010-05-05T09:30:00-04:00,27.39999,27.69,27.39999,27.61,9051082,5343981.15,44.34582444987575,49.88457701146769,NaN,NaN,-135.4391838290623,-124.40499348531685,-0.0639414816173964,-0.04726708737837981,0.016674394239016597,198152179,198493070.6,49.92844462450903,70.61632267048122,NaN,NaN,-5.5674772332882965,6.196368523824039
2010-05-06T09:30:00-04:00,27.5,27.57001,24.95,26.92,11302102,5780561.7,31.6815822540279,48.38592146667367,NaN,NaN,-369.4537041223587,-175.61957882311083,-0.10199935343662359,-0.11082479755676289,-0.0088254441201393,186850077,194743854.4,42.00351552210282,67.74070473737386,NaN,NaN,-12.245848348984605,3.5617661134228045
2010-05-07T09:30:00-04:00,26.8,26.99001,26.53,26.74001,10845590,6155892.4,29.328684639248408,46.460190961612874,NaN,NaN,-226.84073134946786,-196.70626153231657,-0.13191239695745366,-0.17371594031695636,-0.04180354335950272,176004487,190320433.4,34.954169748823375,64.6171898288699,NaN,NaN,-18.198141954937174,0.4532078179428076
2010-05-10T09:30:00-04:00,27.61,27.61,27.25999,27.52,8008738,6351830.05,47.518483083778314,45.65909780794539,NaN,NaN,-58.54396088764652,-189.86193259737155,-0.09358799277459035,-0.15878853432774065,-0.0652005415531503,184013225,186824213,30.58501804471247,61.13483836593699,NaN,NaN,-15.29812923687562,-1.7969831898883961
2010-05-11T09:30:00-04:00,27.33,27.69501,27.27499,27.50999,5904645,6494774.35,47.35004710922988,44.84370533929199,NaN,NaN,-45.69980281496712,-167.1954766007005,-0.06470535539495433,-0.1460822357968432,-0.08137688040188888,178108580,184625709.6,28.19813296407517,57.40871209222304,NaN,NaN,-13.387126785013761,-3.4527179891920197
2010-05-12T09:30:00-04:00,27.50999,27.7,27.44,27.7,6882859,6657193.2,50.9073116568347,44.28240319546751,NaN,NaN,-15.240947050371643,-143.15582924496238,-0.030342424397595352,-0.11930491089888307,-0.08896248650128771,184991439,181993561.6,25.620191848251267,53.38018633617686,NaN,NaN,-10.563330854318213,-4.46851982706719
2010-05-13T09:30:00-04:00,27.67999,27.83,27.53,27.53,3342205,6630490.15,47.79584286978604,43.743390424865936,NaN,NaN,-7.728019036303159,-70.81069222775128,-0.01725175378466301,-0.11052717873211648,-0.09327542494745347,181649234,180953393,24.660710914670176,49.15663802617364,NaN,NaN,-9.501112168401034,-5.187461590114882
2010-05-14T09:30:00-04:00,27.49001,27.58,27.17,27.27,7372879,6672685.25,43.42436877005758,43.09383041277824,NaN,NaN,-69.60699939209772,-39.36394583627724,-0.023884627960404692,-0.12313120989795934,-0.09924658193755465,174276355,180607766.6,24.33459948080103,44.88946201687785,NaN,NaN,-10.207305745571208,-5.9045821837515
2010-05-17T09:30:00-04:00,27.37,27.58,27.215,27.56,7124160,6789341.3,49.02462093004434,44.00626391142452,NaN,NaN,-37.76771410323061,-35.20869647939405,-0.007377978678330788,-0.10846905528546813,-0.10109107660713734,181400515,180085224.6,23.82170011087787,41.2221920047241,NaN,NaN,-8.77096786507777,-6.314065852512395
2010-05-18T09:30:00-04:00,27.7,27.78,27.39,27.39999,8629113,6951907.1,46.30126241812708,44.131023075826036,NaN,NaN,-14.247778650833292,-28.91829164656729,-0.005935001200037607,-0.10850982810718435,-0.10257482690714674,172771402,179017789,22.766094569209002,38.04813024559211,NaN,NaN,-8.570927164507316,-6.636474611368812
2010-05-19T09:30:00-04:00,27.24001,27.47,27.145,27.33,11727445,7258009.05,45.120564893641564,43.9565266210156,NaN,NaN,-59.86055290605836,-37.84221281770463,-0.008250891475229033,-0.11288844125118302,-0.10463754977595399,161043957,174228292.6,18.75107298477411,34.92531014456055,NaN,NaN,-8.796708414830437,-6.945079440434759
2010-05-20T09:30:00-04:00,27,27,26.46001,26.52,18458960,7925279.7,34.23882422888116,43.32453356592949,NaN,NaN,-191.0827223912239,-74.51315348868877,-0.06000826839293508,-0.17964788526712283,-0.11963961687418775,142584997,166415445.2,14.315809434271102,31.899694867840914,NaN,NaN,-13.141422548290361,-7.830271312985559
2010-05-21T09:30:00-04:00,26.12,26.62,26.09,26.62,11238098,8254628.15,36.28190843923752,42.464336480820585,NaN,NaN,-188.1440479710425,-98.22056320447773,-0.08183055901819841,-0.22192781564693576,-0.14009725662873734,153823095,162324793.2,12.631177525197756,28.865144498221785,NaN,NaN,-15.711155624257234,-8.956111928881512
2010-05-24T09:30:00-04:00,26.5,26.62,26.35001,26.42999,6136039,8338562.7,34.113204083751086,41.959466416180085,NaN,NaN,-149.95291252812157,-120.65760288945594,-0.1020674092472898,-0.2676815181878496,-0.16561410894055978,147687056,155582101.4,10.448587543622068,25.92994466542125,NaN,NaN,-18.502964783656633,-10.319948050992243
2010-05-25T09:30:00-04:00,25.91,26.17999,25.78,26.12,15939742,8723089.05,30.871158845164103,40.99699030155783,NaN,NaN,-175.84499130141265,-152.9770454195718,-0.1276738980553827,-0.32520648150978815,-0.19753258345440544,131747314,147377283.8,8.519460906072979,22.972160114104387,NaN,NaN,-21.94195568999362,-11.980234856563868
2010-05-26T09:30:00-04:00,26.17999,26.36,25.92999,25.95,7443984,8837183.55,29.23049843062944,40.82191288560079,NaN,NaN,-138.34119961061515,-168.67317476048316,-0.14607880844429394,-0.38013109400977285,-0.2340522855654789,124303330,140029158.4,7.2316984173964585,20.488458892339647,NaN,NaN,-25.24716598802258,-13.875510732486541
2010-05-27T09:30:00-04:00,26.31,26.48,26.17999,26.48,12367902,9250803.7,39.94614309310692,41.58030277516211,NaN,NaN,-87.18564349917808,-147.893758982074,-0.11399978535704353,-0.37655201726178333,-0.2625522319047398,136671232,138846405.4,7.04705513672873,18.495093562904316,NaN,NaN,-24.414151520942237,-15.38103084512307
2010-05-28T09:30:00-04:00,26.5,26.55,26.32001,26.35001,7409852,9247568,38.409987895469385,40.929695975997184,NaN,NaN,-74.56791725394824,-125.17853283865516,-0.09381923757396637,-0.3798262788721978,-0.2860070412982314,129261380,133934062.4,6.324757209363966,16.76221778895085,NaN,NaN,-24.269739451785767,-16.650846360360596
2010-06-01T09:30:00-04:00,26.25999,26.60001,26.08,26.28999,10514680,9604665.25,37.6892970436539,40.23964239988462,NaN,NaN,-76.24861677580076,-110.43767368819098,-0.07747516630390316,-0.3828509991781104,-0.3053758328742072,118746700,128145991.2,5.596840788238197,15.147839776391063,NaN,NaN,-24.381336204733266,-17.755202052413836
2010-06-02T09:30:00-04:00,26.41,26.74001,26.32001,26.74001,7420590,9356033.25,45.887570161613176,39.881089435940225,NaN,NaN,-37.91707523366333,-82.85209047464113,-0.03166636458138711,-0.3449587886009411,-0.313292424019554,126167290,127029986.4,5.466211379522051,13.708269742910407,NaN,NaN,-21.760446401578644,-18.327379816580237
2010-06-03T09:30:00-04:00,26.8,26.85001,26.62,26.78,5494121,9178185.2,46.56043359834039,39.792845916551244,NaN,NaN,-14.814501557836977,-58.14675086408547,0.004114003635461716,-0.30814991947522685,-0.31226392311068857,131661411,128501602.6,8.498965444675733,12.553859352196522,NaN,NaN,-19.489878767865864,-18.493451095335327
2010-06-04T09:30:00-04:00,26.55,26.55,26.00999,26.07001,9126590,9069409.6,37.61707861059175,39.3780394765894,NaN,NaN,-83.8938001541931,-57.48838219508849,-0.016138270168616076,-0.3324367608214587,-0.3162984906528426,122534821,125674320.4,7.9699538177842015,11.384956090552462,NaN,NaN,-20.431086102372188,-18.770256096340592
2010-06-07T09:30:00-04:00,26.02,26.24001,25.87,25.87,9539965,9004128.35,35.54572163902819,38.41526095580254,NaN,NaN,-101.35093775140295,-62.84498629457943,-0.03786654622475816,-0.3636316734337903,-0.32576512720903217,112994856,122421015.6,7.3992300460053855,10.211922514490144,NaN,NaN,-21.879032334876587,-19.21436698756002
2010-06-08T09:30:00-04:00,25.89999,26.32001,25.85001,26.28999,9560027,9081692.8,42.68289222398383,38.15680594193516,NaN,NaN,-75.99754968013963,-62.79477287544721,-0.019727662677029745,-0.35042470555531935,-0.3306970428782896,122554883,123182652.2,9.041413214358244,9.231588132000804,NaN,NaN,-20.66788660245135,-19.42201264683021
2010-06-09T09:30:00-04:00,26.49001,26.61,26.17,26.24001,8617016,9217311.35,42.08565020757844,37.94002632150208,NaN,NaN,-47.704310111246905,-64.75221985096393,-0.007499110224127414,-0.34007093065844884,-0.33257182043432143,113937867,120736767.6,8.518938449160245,8.500721379456953,NaN,NaN,-19.916343143865117,-19.49263128926377
2010-06-10T09:30:00-04:00,26.52,26.71001,26.49001,26.69,8597777,9303057.25,49.00430023767177,38.99470317927284,NaN,NaN,-0.9740867317791562,-61.98413688575236,0.03230792964240292,-0.2921869083813178,-0.3244948380237207,122535644,118911614.2,8.140888735757414,8.059655615277405,NaN,NaN,-16.95848343267052,-19.130610166893305
2010-06-11T09:30:00-04:00,26.53999,26.53999,26.25,26.47,6023352,9437114.6,46.10440630345584,39.69631016957415,NaN,NaN,-28.319212945120775,-50.869219443937894,0.04448304743981418,-0.268891028723953,-0.31337407616376717,116512292,117707108.4,7.89197806817657,7.721141368347318,NaN,NaN,-15.476544071769627,-18.60860072473278
2010-06-14T09:30:00-04:00,26.66,26.77,26.57001,26.62,5606516,9348796.45,48.3487136198973,40.713132279298875,NaN,NaN,22.95584419735057,-26.00786305418719,0.06221192175965118,-0.23560917396420322,-0.2978210957238544,122118808,119531898.8,12.268374371088015,7.851126141737745,NaN,NaN,-13.570311860590936,-17.888845172712518
2010-06-15T09:30:00-04:00,26.75999,26.89999,26.67,26.89,5392445,9262210.7,52.206639023541726,42.237095149183,NaN,NaN,71.97409776460758,3.586466434762252,0.09000873229042827,-0.18531018036081903,-0.2753189126512473,127511253,120523172.8,14.641024978373466,8.288380718330638,NaN,NaN,-10.74954169075124,-16.868944675289477
2010-06-16T09:30:00-04:00,26.75,26.83,26.67,26.71001,3648759,9013193,49.54969174414999,43.688466100148744,NaN,NaN,73.9070665864735,27.908741774306332,0.09373631680071803,-0.1581485166503498,-0.2518848334510678,123862494,122508098.2,19.344785681514068,9.153601237196181,NaN,NaN,-9.221042462748393,-15.776387216355037
2010-06-17T09:30:00-04:00,26.83,26.97,26.69,26.95,6245055,8739073.5,52.98542301017254,44.61984323708201,NaN,NaN,130.60740114159583,54.22503934898134,0.10877086902343586,-0.11592124717177299,-0.22469211619520885,130107549,124022479.2,22.838384146374224,10.281553309313717,NaN,NaN,-6.877595522295564,-14.505131260060827
2010-06-18T09:30:00-04:00,26.86,26.89,26.66,26.66,7709309,8201590.95,48.671981387268566,45.352842772210515,NaN,NaN,86.44514538893674,77.17791101579283,0.09603363902568965,-0.10465006741309679,-0.20068370643878644,122398240,125199668.8,25.538415215171568,11.653957452585686,NaN,NaN,-6.190738029246962,-13.317360798515988
2010-06-21T09:30:00-04:00,26.89999,26.96001,26.50999,26.59,5379598,7908665.95,47.6633401544208,46.065274422979584,NaN,NaN,64.25926434010773,85.43859504434427,0.08037830655568012,-0.10021082324418629,-0.1805891297998664,117018642,124179635.6,24.73088338172164,13.020674780691648,NaN,NaN,-5.929643274630944,-12.261972580818124
2010-06-22T09:30:00-04:00,26.57001,26.69,26.3,26.3,7044156,7954071.8,43.629466976769095,45.90398133834786,NaN,NaN,-9.282190001295902,69.18733749116356,0.049491557927001495,-0.11872468239111456,-0.16821624031811605,109974486,120672282.2,22.138689289774987,14.211566059995429,NaN,NaN,-6.912315452895509,-11.49773584825775
2010-06-23T09:30:00-04:00,26.39999,26.53999,26.2601,26.47,6769789,7495574.15,46.48850829106885,45.898843816399896,NaN,NaN,-18.287004248445733,50.74852332417972,0.03992051121717516,-0.11831560129664709,-0.15823611251382225,116744275,119248638.4,21.16878193399569,15.11655295208971,NaN,NaN,-6.89901408473094,-10.840775596325349
2010-06-24T09:30:00-04:00,26.32001,26.39,26.13,26.14999,4779703,7362360.1,42.15430267040559,46.222931249243736,NaN,NaN,-85.28592574735352,7.569857946389854,0.012849183232807648,-0.14217463347281267,-0.15502381670562032,111964572,115620043,18.89640942756627,15.897014067074148,NaN,NaN,-8.201652290643734,-10.463757981227975
2010-06-25T09:30:00-04:00,26.19,26.23,25.86,25.88,10611270,7274528.5,38.86229277616934,46.459829187610964,NaN,NaN,-141.86934717643896,-38.09304056668528,-0.020608984615016424,-0.18078504747439084,-0.1601760628593744,101353302,111411055.4,16.662127855328905,16.558649624882968,NaN,NaN,-10.329153241028303,-10.444528732628022
2010-06-28T09:30:00-04:00,25.89999,26.21001,25.83,26.10001,7855012,7296786.5,42.78350119840383,46.467015542926674,NaN,NaN,-111.7616806619588,-73.29722956709858,-0.02499874019466125,-0.19142448810270096,-0.1664257479080397,109208314,109848989.8,15.910258879377551,17.04928145809863,NaN,NaN,-10.944302947978088,-10.515925049106603
2010-06-29T09:30:00-04:00,25.89999,25.97501,25.60001,25.67999,10234516,7282778.3,37.799186396834436,46.16083955644496,NaN,NaN,-167.00237065037925,-104.84126569691526,-0.051727102059715035,-0.2310846254826835,-0.17935752342296846,98973798,107648852.2,14.891030047503534,17.504430857980296,NaN,NaN,-13.072903798433227,-10.881207727581835
2010-06-30T09:30:00-04:00,25.61,25.71989,25.42999,25.5,6563543,7239925.95,35.870634668518036,45.222720587219705,NaN,NaN,-177.7499498981102,-136.73385482684816,-0.07561967430319219,-0.2738821163019587,-0.1982624419987665,92410255,102782048.2,12.919439121749633,17.845755885551167,NaN,NaN,-15.43080003680341,-11.53114948604206
2010-07-01T09:30:00-04:00,25.53,25.58749,25.3,25.55,9774246,7453932.2,36.83475957973033,44.56060296409645,NaN,NaN,-163.93323512730024,-152.46331670283752,-0.08163256339717978,-0.30030314624524124,-0.21867058284806146,102184501,100826034,12.219198012162153,18.15484302440728,NaN,NaN,-17.052313641612493,-12.31988722255212
2010-07-02T09:30:00-04:00,25.60001,25.62,25.36,25.45,4874520,7241328.7,35.679422123870296,43.65565357152309,NaN,NaN,-140.35704812718336,-152.16085689298637,-0.08551020034605678,-0.32555833328063244,-0.24004813293457566,97309981,100017369.8,11.931278029830906,18.13076471431749,NaN,NaN,-18.7327614893918,-13.236012117814932
2010-07-06T09:30:00-04:00,25.69,25.78999,25.39999,25.60001,6912305,7109945.7,38.781404117790075,42.69670822111225,NaN,NaN,-109.31050461435473,-151.67062168346555,-0.07169628130615668,-0.3296684845672715,-0.2579722032611148,104222286,99020164.2,11.569255425019733,17.91135260336365,NaN,NaN,-19.289857314099148,-14.100847145855534
2010-07-07T09:30:00-04:00,25.63,26.12,25.55,26.09,6495063,6956697.5,47.66053229768923,42.561768260650766,NaN,NaN,-51.65936742812602,-128.60202103901491,-0.025657646504882614,-0.29004426139221806,-0.26438661488733545,110717349,101368874.4,17.888729051620786,17.807348558371274,NaN,NaN,-17.08169185376709,-14.526682104128612
2010-07-08T09:30:00-04:00,26.28,26.49001,26.19,26.48,6357707,6843732.05,53.44798576040711,42.5948084570961,NaN,NaN,23.406844039069938,-88.37066225157889,0.03184274528887532,-0.22458318327624127,-0.2564259285651166,117075056,106301834.6,29.31416721179518,18.269904491615627,NaN,NaN,-13.28453375830556,-14.349232340439604
2010-07-09T09:30:00-04:00,26.47,26.52,26.37,26.48,6894898,6758588.1,53.44798576040711,42.93595162660599,NaN,NaN,36.77260005743238,-48.229495214632365,0.06855141381514479,-0.1707366612961856,-0.23928807511133038,117075056,109279945.6,35.178357738157274,18.958471814686032,NaN,NaN,-10.282147204954004,-13.768220178227375
2010-07-12T09:30:00-04:00,26.38,26.57001,26.38,26.57001,3786229,6646731.95,54.78619728820278,43.44472713616185,NaN,NaN,43.85054354862566,-11.387976879470564,0.09589188931923737,-0.11942321346228368,-0.21531510278152105,120861285,113990206.4,43.20403890479509,20.277982923476994,NaN,NaN,-7.408775214100917,-12.859728040495025
2010-07-13T09:30:00-04:00,26.75999,26.86,26.67999,26.81,6162270,6674519.65,58.233661460284296,44.487883884984356,NaN,NaN,86.55144587325582,27.784413218051547,0.12528014623185055,-0.05871491999170786,-0.1839950662235584,127023555,118550460.2,49.697552215877465,22.246473132484315,NaN,NaN,-3.8923569590931475,-11.578675028866185
2010-07-14T09:30:00-04:00,26.71001,26.86,26.6492,26.82001,4597039,6634749.35,58.37622085741931,45.33700621115225,NaN,NaN,86.19698938879343,55.35568458143545,0.13944900675043842,-0.009683807785510368,-0.1491328145359488,131620594,122731109.2,54.799593818166024,24.648673981353625,NaN,NaN,-0.9840256042726531,-10.06515368249568
2010-07-15T09:30:00-04:00,26.85001,26.95,26.64999,26.89999,4131461,6658884.45,59.56382450866216,46.580543485313434,NaN,NaN,93.60507030917127,69.39532983545571,0.14748337881994406,0.035221408988981295,-0.11226196983096276,135752055,126466509,58.818729652069585,27.50026828310386,NaN,NaN,1.8004319891579301,-8.370070015116593
2010-07-16T09:30:00-04:00,26.78999,26.89999,26.47501,26.52,7828227,6738043.05,51.97613656155125,47.517246612840715,NaN,NaN,65.02242825060972,75.04529547409118,0.12156124203493905,0.03968958271271106,-0.081871659322228,127923828,128636263.4,60.988629665248524,30.666446983812403,NaN,NaN,2.1898242919767457,-6.86151368553183
2010-07-19T09:30:00-04:00,26.52,26.62,26.47,26.57001,6491680,6677161.6,52.82782770793964,48.23469850637899,NaN,NaN,54.81551333210966,77.23828943078799,0.10287923737307916,0.04672738739412097,-0.056151849978958196,134415508,131347108,63.57126340471335,34.07080444990782,NaN,NaN,2.74879867628934,-5.4886119195573775
2010-07-20T09:30:00-04:00,26.34,26.92,26.34,26.89,7287629,6772563.15,57.964749063026055,49.675095839678384,NaN,NaN,81.5662191196387,76.24124408006455,0.10670955910145355,0.07723509889785873,-0.02947446020359481,141703137,134283024.4,66.18244773261748,37.734477141701646,NaN,NaN,4.758184040020841,-4.024783925331918
2010-07-21T09:30:00-04:00,26.98,26.99001,26.53,26.60001,11401266,6990418.65,52.39612952589335,50.85548832949092,NaN,NaN,75.26097376224469,74.05404095475481,0.08527866783486218,0.07712387458998293,-0.008154793244879256,130301871,134019279.8,65.72666320250613,41.50642171889854,NaN,NaN,4.843254598527057,-2.75792127906635
2010-07-22T09:30:00-04:00,26.83,26.98,26.78999,26.89999,7042871,7004072.75,56.998304518790015,52.29574153942375,NaN,NaN,96.1960655698972,74.57224000689999,0.0865941201755237,0.10008785697452538,0.01349373679900167,137344742,134337817.2,66.03093512914955,45.350117227254785,NaN,NaN,6.340417933266624,-1.458158534447354
2010-07-23T09:30:00-04:00,26.86,27.2081,26.86,27.14999,10102809,7270228.05,60.4315313466919,54.06374934105386,NaN,NaN,110.142226316183,83.59619962001463,0.0987106094802507,0.13688199864931505,0.038171389169064346,147447551,138242561.8,69.59442553837583,49.46891347786514,NaN,NaN,8.689788271928723,-0.008451847822200431
2010-07-26T09:30:00-04:00,27.23,27.28999,27.13,27.28999,8753188,7177323.95,62.24920427397327,55.74002078078123,NaN,NaN,121.5992886273044,96.95295467905359,0.10971688864623907,0.1753174999768632,0.06560061133062411,156200739,142599608,72.99825678763966,53.856699289480844,NaN,NaN,11.186975631532224,1.5908949349427173
2010-07-27T09:30:00-04:00,27.36,27.46001,27.25999,27.39,19712512,7770198.95,63.53777923225073,56.87410984753563,NaN,NaN,127.70391750187518,106.18049435550088,0.11664820690597759,0.2114108699630961,0.09476266305711852,175913251,149441630.8,77.2964473337448,58.10010773820399,NaN,NaN,13.629319583429305,3.3106698847265155
2010-07-28T09:30:00-04:00,27.34,27.41,27.21001,27.24001,7199445,7618445.4,60.217969125433605,57.357680087894664,NaN,NaN,109.50030551776484,113.02836070660491,0.10444178664469866,0.22531489636299185,0.12087310971829318,168713806,157124017.8,80.96109464406132,61.789173983365856,NaN,NaN,14.727190025501416,4.941601333408644
2010-07-29T09:30:00-04:00,27.24001,27.24001,26.77,26.91,11052563,7842896.4,53.58410365515449,57.36740279466233,NaN,NaN,60.774918847152065,105.94413136205587,0.06915358355967344,0.207315089167885,0.13816150560821155,157661243,161187318,82.56415128276805,65.17387352226663,NaN,NaN,13.675041946926129,6.189235706768285
2010-07-30T09:30:00-04:00,26.74001,27.065,26.67999,26.98,7392922,7723830.2,54.72348516746561,57.36292335746682,NaN,NaN,45.74605891065341,93.06489788094996,0.046618120784320594,0.1964341565886123,0.1498160358042917,165054165,164708640.8,83.83445848877503,68.07604634969377,NaN,NaN,13.14463300596864,7.182863892368335
2010-08-02T09:30:00-04:00,27.25999,27.28999,27.13,27.28999,7790266,7869617.5,59.46842034926947,57.451120420965765,NaN,NaN,102.89784419687824,89.32460899486475,0.04846652378265953,0.21039919053261613,0.1619326667499566,172844431,168037379.2,84.95065767443523,70.59412531101931,NaN,NaN,14.108202914315527,8.172198038360792
2010-08-03T09:30:00-04:00,27.11,27.16,26.99001,27.05,7104035,7879204,54.689888575562215,57.18781097226169,NaN,NaN,61.57378622637566,76.09858273976485,0.030292461356545314,0.19979824344563824,0.16950578208909292,165740396,166002808.2,81.25754133453248,72.48397870504549,NaN,NaN,13.460448214573944,8.927662349248385
2010-08-04T09:30:00-04:00,27.09,27.22,27.03,27.14999,4458547,7777378.2,56.26666030622474,56.95229924351616,NaN,NaN,71.06094650029756,68.41071093627139,0.022149106583353395,0.19719216531828465,0.17504305873493126,170198943,166299835.6,81.38477524486738,74.09583910453105,NaN,NaN,13.393542238599446,9.56564519058425
2010-08-05T09:30:00-04:00,27.06,27.08,26.96001,27.03,18512432,8385114.45,53.84511194210347,57.08579748498416,NaN,NaN,34.49847679229644,63.15542252530027,0.006630601172560757,0.1833313102006322,0.17670070902807145,151686511,165104889.2,79.05953847176235,75.38661830499632,NaN,NaN,12.627230899296238,10.003014577543105
2010-08-06T09:30:00-04:00,26.91,27.10001,26.797,27.09,8371973,8458968.2,54.89055497657831,57.233135147029785,NaN,NaN,19.76156118450205,57.95852298006999,-0.0012255712514837869,0.1751687449637167,0.1763943162152005,160058484,164105753,77.07660767105749,76.35128575259235,NaN,NaN,12.284299398870804,10.328912409161347
2010-08-09T09:30:00-04:00,27.21001,27.31,27.12,27.23,3650720,8452192.75,57.31979610599121,57.18706707867016,NaN,NaN,85.79345922190484,54.537645985075315,0.001240898166890797,0.17794543892381398,0.17670454075692318,163709204,162278707.6,73.44877562456799,76.87030917344593,NaN,NaN,12.668052327147269,10.663075254587907
2010-08-10T09:30:00-04:00,27.09,27.42999,27.05,27.28999,7496992,8518928.85,58.35471075401473,57.612680023535965,NaN,NaN,89.20677620527579,60.06424398085534,0.004939223566745116,0.18287857021535459,0.17793934664860947,171206196,163371867.6,74.23031832436249,77.4777131107214,NaN,NaN,13.272262432031882,11.035816279937047
2010-08-11T09:30:00-04:00,27.00999,27.00999,26.8,26.84,9337566,8755955.2,48.79652202941905,57.02683841715232,NaN,NaN,-40.738385237222495,37.70437763335133,-0.023341209581217576,0.1487628346720875,0.17210404425330508,161868630,161705805,70.8093351252245,77.81902739615532,NaN,NaN,10.940577352067898,11.022210718812882
2010-08-12T09:30:00-04:00,26.55,26.85001,26.53999,26.81,6405289,8869646.6,48.22935082640265,56.155254094274525,NaN,NaN,-89.0951919513163,12.985643884628786,-0.04332682205377625,0.11794551668608477,0.16127233873986102,155463341,162461171,71.4517273198338,77.9516918091166,NaN,NaN,8.882596142968257,10.716551493692222
2010-08-13T09:30:00-04:00,26.69,26.87,26.67999,26.8,4437914,8700130.95,48.02895353078925,55.13952189833281,NaN,NaN,-77.6882468995078,-6.504317732173182,-0.05569061892597177,0.0916590650823963,0.14734968400836806,151025427,160654559.6,67.61892410836757,77.56745376059716,NaN,NaN,7.140044746883713,10.205621958433863
2010-08-16T09:30:00-04:00,26.58,26.82001,26.53,26.77,5078941,8629494,47.39274680130351,53.98630529612229,NaN,NaN,-112.17800197117447,-46.09860997078904,-0.06377850186748879,0.06762655667400708,0.13140505854149587,145946486,157102016,60.72123324188272,76.38350989689273,NaN,NaN,5.509052607392861,9.53468347971372
2010-08-17T09:30:00-04:00,27,27.17,26.83,27.03,5250461,8527635.6,53.18107738439806,53.483670171762604,NaN,NaN,-5.90007997418709,-65.11998120668162,-0.05010985799314352,0.06876773605006647,0.11887759404321,151196947,153100166.2,54.034518351568764,74.46018301885753,NaN,NaN,5.6266582326010814,8.97639415869763
2010-08-18T09:30:00-04:00,26.98,27.14,26.88499,27.05,5379371,8226540.85,53.60396975884602,53.485089179169144,NaN,NaN,-6.863136733781178,-58.34493150599336,-0.03872320631652812,0.07047358614754984,0.10919679246407796,156576318,152041703.8,52.391169925212864,72.30497006474647,NaN,NaN,5.838474005096364,8.528119851040307
2010-08-19T09:30:00-04:00,26.96001,26.97,26.6181,26.73,7941184,8271456.5,46.38477787043515,52.88946722938125,NaN,NaN,-111.4825150303663,-62.822396121803365,-0.050973517914262856,0.04547989507124939,0.09645341298551224,148635134,150676062.4,50.26700937550128,69.90729512808406,NaN,NaN,3.9268975231571024,7.87080237562842
2010-08-20T09:30:00-04:00,26.64999,26.77,26.64,26.73,5856301,8059131.1,46.38477787043515,51.95492133803595,NaN,NaN,-119.8703652857424,-71.25881979905029,-0.056859007211796625,0.02537965397076647,0.0822386611825631,148635134,150198003.8,49.510257386997715,67.37583796469566,NaN,NaN,2.369754714051041,7.084938423974509
2010-08-23T09:30:00-04:00,26.82001,26.94,26.77,26.78999,4149891,7828966.25,47.91003801775352,51.47064629819248,NaN,NaN,-65.46618559205614,-61.916456523226614,-0.05448860729311911,0.01412790206616421,0.06861650935928332,152785025,151565711.6,51.748357436560724,65.26803911484053,NaN,NaN,1.4609837418266964,6.281516326524821
2010-08-24T09:30:00-04:00,26.53999,26.795,26.5,26.66,8427746,7264727.95,44.92751389008595,50.66070726846827,NaN,NaN,-124.09781347376514,-85.55600322314223,-0.05906772545165717,-0.005218147455288147,0.053849577996369025,144357279,150197778,49.39019634474272,62.98271205054591,NaN,NaN,-0.1548706745073971,5.362032469234505
2010-08-25T09:30:00-04:00,26.52,26.8,26.49001,26.72,6545738,7232042.6,46.580551889504044,50.14181012185402,NaN,NaN,-105.47336587547849,-105.27804905148169,-0.05550327672275621,-0.01552951790707624,0.03997375881567997,150903017,149063117.8,47.45833956024368,60.725483556866,NaN,NaN,-1.0889701227689224,4.440460670376872
2010-08-26T09:30:00-04:00,26.74001,26.82001,26.46001,26.52,7550098,7056919.35,42.0497506702477,49.22460981425898,NaN,NaN,-117.40959419366466,-106.46346488414137,-0.06348754172604146,-0.03938566834187185,0.02410187338416961,143352919,148006674.8,45.66730292351516,58.48196178918442,NaN,NaN,-3.2106783669524552,3.347440807901254
2010-08-27T09:30:00-04:00,26.67999,26.72,26.35001,26.69,9874383,7180992.4,46.7876559936429,48.472314091948384,NaN,NaN,-107.56131474597966,-104.00165477618881,-0.054534531833713575,-0.04406629140797236,0.010468240425741215,153227302,148925108.4,47.5215157879908,56.630014658000334,NaN,NaN,-3.7263153647130745,2.3369042118134926
2010-08-30T09:30:00-04:00,26.67,26.7699,26.46001,26.46001,8007711,7191864.65,41.807632831005506,47.290379954590584,NaN,NaN,-106.7785228709486,-112.2641222319673,-0.06083702986023825,-0.0655780468995566,-0.004741017039318347,145219591,147412021.6,44.80845774864396,54.52845318830615,NaN,NaN,-5.68306501857034,1.1911943217586594
2010-08-31T09:30:00-04:00,26.44,26.64,26.37,26.48,12423289,7457827.35,42.381682107898484,46.832177103053404,NaN,NaN,-118.95927044992817,-111.23641362719991,-0.06027919784280597,-0.08009001434282581,-0.01981081650001984,157642880,150069141.8,50.186764770567954,53.05541244868783,NaN,NaN,-7.112750239497921,0.004916527293433726
2010-09-01T09:30:00-04:00,26.77,27,26.71001,26.95,9661477,7717973.85,53.8971305299452,47.237018510449296,NaN,NaN,25.193796971950984,-85.10298105771402,-0.0265947109569306,-0.05305420519618309,-0.02645949423925249,167304357,153349409.8,55.90014388139536,51.94458506022794,NaN,NaN,-4.732499911446077,-0.6718572496693535
2010-09-02T09:30:00-04:00,26.95,27.12,26.94,27.12,6035637,7094134.1,57.22698952922606,47.89402108176622,NaN,NaN,89.5405967272687,-43.712942873527346,0.007002440547530374,-0.017706443554839524,-0.024708884102369898,173339994,159346824.8,64.0245860430152,51.68784662698848,NaN,NaN,-1.6556862253200542,-0.8124042461908821
2010-09-03T09:30:00-04:00,27.25,27.28999,27.11,27.28999,5842742,6967672.55,60.31371146612596,48.81694712925354,NaN,NaN,139.00188737212184,5.599697550092958,0.0387670355732691,0.023749910364216476,-0.015017125209052622,179182736,164537911.6,69.29706799863709,52.30040625247095,NaN,NaN,1.9217848331800167,-0.42180580628075376
2010-09-07T09:30:00-04:00,27.22,27.3,27.14999,27.17999,6444008,7107336.95,57.42576920445869,49.120139402115015,NaN,NaN,132.57404034254853,53.470210192792386,0.04976120153276637,0.04718437670690534,-0.002576824825861029,172738728,170041739,73.69838732385952,53.70496832192028,NaN,NaN,3.9540964065836417,0.20332308127130266
2010-09-08T09:30:00-04:00,27.22,27.35001,27.19,27.3,5738023,7019388.5,59.69332933781292,49.555093657755506,NaN,NaN,155.67208344780184,108.3964809723384,0.0617258176077788,0.07458044718386247,0.012854629576083671,178476751,174208513.2,76.45071761145562,55.423507442366194,NaN,NaN,6.346712729526639,1.0809501738792078
2010-09-09T09:30:00-04:00,27.47,27.48,27.28999,27.39,4963840,6800702.2,61.35562417821739,50.62443982259709,NaN,NaN,158.98457474131845,135.15463652621187,0.07161563435386353,0.10237417251841308,0.03075853816454955,183440591,177435760,78.34118727767292,57.42880586394988,NaN,NaN,8.830177361139175,2.18798262920206
2010-09-10T09:30:00-04:00,27.39999,27.56,27.38,27.52,4011161,6680995.8,63.68531827124293,51.86019270836908,NaN,NaN,156.6213926039345,148.57079570154502,0.08207604657580586,0.13335359638430688,0.05127754980850102,187451752,180258111.6,79.86361656022966,59.59690294775216,NaN,NaN,11.637838300528333,3.537962010820099
2010-09-13T09:30:00-04:00,27.72,27.72,27.46001,27.55,5256512,6721925.7,64.22136050648322,53.02528717184977,NaN,NaN,150.6552928354414,150.90147679420892,0.08577691059986611,0.15849868805833367,0.07272177745846756,192708264,182963217.2,81.22575940259905,61.702431659612046,NaN,NaN,14.090389323970568,5.045451626984452
2010-09-14T09:30:00-04:00,27.53,27.7,27.46001,27.60001,8514629,6893710.1,65.14499926045885,54.469393269733544,NaN,NaN,132.81599890007982,150.9498685057152,0.08612850388302415,0.18038240731224775,0.0942539034292236,201222893,188660050.2,83.72294568828575,64.15477089843655,NaN,NaN,16.402481358609577,6.667884445788041
2010-09-15T09:30:00-04:00,27.55,27.83,27.52,27.78999,6451207,6953747.4,68.47447853390449,56.03324517290501,NaN,NaN,137.029970800825,147.2214459763198,0.09309866217326108,0.21062723114579995,0.11752856897253887,207674100,194499520,85.80690938477417,66.89395445733157,NaN,NaN,19.439652374808258,8.492422721362358
2010-09-16T09:30:00-04:00,27.71001,27.82001,27.64,27.82001,6886133,7029085.5,68.97874269511351,57.95674460325257,NaN,NaN,125.3897868180632,140.50248839166878,0.09343135738452274,0.2343177657031923,0.14088640831866955,214560233,200723448.4,87.6254375901685,69.89096407637824,NaN,NaN,22.097649483585442,10.436026544537084
2010-09-17T09:30:00-04:00,27.73,27.75,27.55,27.55,10603715,7162212.05,59.72521386892372,58.880855880058334,NaN,NaN,89.27420662376579,127.03305119563501,0.07022621625626618,0.22866917863900227,0.15844296238273609,203956518,204024401.6,88.4692756662285,72.81580406768094,NaN,NaN,21.806539826841124,12.060385584866232
2010-09-20T09:30:00-04:00,27.66,27.89,27.57001,27.85001,6365699,7187681.95,65.29595272239023,60.558593015157236,NaN,NaN,103.9920366495965,117.70039995846605,0.06970175213388363,0.24557015255009063,0.175868400416207,210322217,207547192.2,89.30728598116508,75.9942917985753,NaN,NaN,23.30683154333868,13.667020721790868
2010-09-21T09:30:00-04:00,27.88,27.89,27.66,27.8,13369266,7648650.7,63.713904972125675,62.0823232197449,NaN,NaN,96.69748094012725,110.47669636647557,0.06092426715519483,0.25202373436020054,0.1910994672050057,196952951,206693203.8,87.64438383785465,78.66983601766721,NaN,NaN,24.033099736762196,15.147889152501058
2010-09-22T09:30:00-04:00,27.81,27.92,27.77,27.85001,5931277,7523827.25,64.6366286589581,62.84943022896011,NaN,NaN,98.62227104649297,102.79515641560916,0.05367826286452909,0.2581972957856671,0.204519032921138,202884228,205735229.4,85.71628298428098,80.7995602393019,NaN,NaN,24.897824703958477,16.540737088423548
2010-09-23T09:30:00-04:00,27.73,27.84,27.63,27.67,8952086,7644144.65,58.836924269606975,62.96442556755875,NaN,NaN,70.14170246260989,91.7455395445185,0.032970325867375416,0.24573194025535727,0.21276161438798186,193932142,201609611.2,77.7803936062515,81.7821179223902,NaN,NaN,23.905844632580422,17.592895309017386
2010-09-24T09:30:00-04:00,27.91,28.10989,27.87,28.03999,4518406,7492560.05,65.65771057795699,63.346139789832385,NaN,NaN,112.94061670092731,96.47882155995079,0.0399348235842559,0.26268014386830174,0.22274532028404584,198450548,200508417.2,75.76409341283129,82.24404830911837,NaN,NaN,25.211340749685885,18.681244657684314
2010-09-27T09:30:00-04:00,28.03999,28.03999,27.87,27.88,3613906,7179536.2,60.95424351868533,63.598173669420014,NaN,NaN,93.74146650473297,94.42870753097809,0.02996567178611992,0.26020241001669575,0.23023673823057583,194836642,197411302.2,70.24840526725998,81.99762101936126,NaN,NaN,24.75319020500705,19.54866545015899
2010-09-28T09:30:00-04:00,27.97,28.14999,27.78,28.06,5662961,7062298.7,64.07257852742067,63.91097718296344,NaN,NaN,103.25633375258826,95.74047809347029,0.03153450563571386,0.2696548702752182,0.2381203646395043,200499603,198120632.6,70.77320474530546,81.59208438606483,NaN,NaN,25.37965762869806,20.38166433280743
2010-09-29T09:30:00-04:00,28.05,28.09,27.92,27.98,5329484,6707608.45,61.71355820890361,63.93654389944103,NaN,NaN,102.88768408992249,96.5935607021562,0.023588418388895915,0.2676058876256242,0.2440174692367283,195170119,196577810.8,67.96505231855656,80.85093188898509,NaN,NaN,25.14416294436047,21.062021277315004
2010-09-30T09:30:00-04:00,28.10001,28.21671,27.77,27.88,8385992,6643834.2,58.799310847823925,63.58754336919681,NaN,NaN,87.13069979368326,99.99136016837086,0.008764993903959878,0.25497371161667814,0.24620871771271827,186784127,195148207.8,65.37649482485324,79.81613747931534,NaN,NaN,24.053415898296986,21.489363366026716
2010-10-01T09:30:00-04:00,27.91,28.02,27.81,27.92999,5417891,6612946.9,59.82075681234554,63.27321453390125,NaN,NaN,72.4278751056392,91.88881184931324,-0.00003990971769057827,0.24615883056560506,0.24619874028329564,192202018,193898501.8,63.11356060788699,78.52240899397877,NaN,NaN,23.458881694125868,21.770723127183736
2010-10-04T09:30:00-04:00,27.89,28.02,27.75999,27.8475,6300723,6635845.95,57.296453662936834,62.71260413407826,NaN,NaN,54.04781320062861,83.95008118849236,-0.013065426603345948,0.2298669570291132,0.24293238363245914,185901295,192111432.4,59.9195448816029,76.8221660792157,NaN,NaN,22.227693378083604,21.836004591598
2010-10-05T09:30:00-04:00,28.03,28.16,28,28.11,5418156,6584553.35,62.691661744464504,62.299545791975405,NaN,NaN,123.19212272193614,87.93723898236195,-0.006007288406668698,0.23542327312412326,0.24143056153079195,191319451,190275402,56.74234331581256,74.74612564571846,NaN,NaN,22.748549578364248,21.966368161136035
2010-10-06T09:30:00-04:00,28.22,28.24001,28.09,28.23,4640844,6529694.4,64.87630759048314,62.00651471307324,NaN,NaN,147.26099812191686,96.81190178876082,0.004188571174679329,0.2466662754991411,0.24247770432446178,195960295,190433437.2,56.953920344086306,72.55530298528402,NaN,NaN,23.848669840443705,22.235268401037132
2010-10-07T09:30:00-04:00,28.33,28.33,28.03999,28.13,4444699,6503737.35,61.63722761414961,62.14308712344651,NaN,NaN,129.51374807498962,105.2885114450221,0.0017671772842100808,0.24468667592972437,0.2429194986455143,191515596,191379731,58.27008396285452,70.39821786361445,NaN,NaN,23.80426270217125,22.459410444056292
2010-10-08T09:30:00-04:00,28.13,28.24001,28.0732,28.19,4196379,6512998.25,62.83615296889296,61.96738714105385,NaN,NaN,119.62818155305617,114.72857273450549,0.0017712652796564865,0.24513358024508491,0.24336231496542843,195711975,192081722.4,59.2651074503536,68.25234796855649,NaN,NaN,24.11289828469336,22.695622992718732
2010-10-11T09:30:00-04:00,28.21001,28.25,28.14999,28.22,3051593,6402752.3,63.45120228875211,61.94862266367003,NaN,NaN,124.53628276898834,128.82626664817744,0.0013768170459306506,0.24508333627284173,0.24370651922691108,198763568,194654177,62.76856019124431,66.47550342237004,NaN,NaN,24.53887831986929,22.95894518231167
2010-10-12T09:30:00-04:00,28.17999,28.37,28.138,28.28999,5885605,6271301.1,64.91024832697639,61.96816692567132,NaN,NaN,136.1485460569162,131.41755131517343,0.003302181984418451,0.24783424670743415,0.2445320647230157,204649173,197320121.4,66.02934172782555,65.06929333262319,NaN,NaN,25.302147160283674,23.293688322021957
2010-10-13T09:30:00-04:00,28.42999,28.67,28.35001,28.53,8268262,6362153.85,69.4187221811292,62.72400963363719,NaN,NaN,205.34261898370363,143.0338754875308,0.01742338292698528,0.2663112933817473,0.24888791045476202,212917435,200711549.4,69.66865721826402,64.48988359062409,NaN,NaN,27.33772498946059,23.87140784594176
2010-10-14T09:30:00-04:00,28.57001,28.62,28.42,28.53999,3705212,6203107.8,69.59384053419151,63.00516177336822,NaN,NaN,174.27550876048173,151.9862276246292,0.023729390471294298,0.27854964854387987,0.25482025807258557,216622647,205732959.6,74.09397363606291,64.37058932085492,NaN,NaN,29.047634400024496,24.610868782239294
2010-10-15T09:30:00-04:00,28.64999,28.705,28.50999,28.61,6481195,5996981.8,70.85346820769249,63.712249251154454,NaN,NaN,173.21723322977317,162.7040379599726,0.02858266696486461,0.2905485917786663,0.2619659248138017,223103842,211211333,77.88495114489915,64.91605688354342,NaN,NaN,30.856303156086533,25.5030736927889
2010-10-18T09:30:00-04:00,28.60001,28.73,28.60001,28.71001,4013769,5879385.3,72.59970787938093,64.32132991915161,NaN,NaN,167.01448734869987,171.1996788759149,0.034120367241299354,0.3046163838654259,0.27049601662412653,227117611,216882141.6,80.9865730049998,65.6455831878073,NaN,NaN,32.91752480975877,26.562280995213165
2010-10-19T09:30:00-04:00,28.57001,28.59,28.28,28.36,5782227,5500033.35,59.226018987744766,64.1436485462117,NaN,NaN,77.70499959378239,159.51096958328816,0.010999763396221662,0.2842457208694036,0.2732459574731819,221335384,220219383.8,82.53862677052567,66.68655279151939,NaN,NaN,30.712007446157614,27.1550990596338
2010-10-20T09:30:00-04:00,28.53,28.71001,28.44,28.61,4200930,5413516,64.28651221419895,64.53559150095278,NaN,NaN,115.97318622938195,141.63708303242385,0.009394875771375322,0.2849895521874011,0.27559467641602575,225536314,222743159.6,83.6271045726928,67.99016777350792,NaN,NaN,30.414385412577737,27.620711395768648
2010-10-21T09:30:00-04:00,28.64999,28.87,28.58,28.71001,6328363,5282329.85,66.09913966747871,64.98404741917656,NaN,NaN,133.76253724520694,133.5344887293689,0.011766328887638289,0.2903025875255736,0.2785362586379353,231864677,225791565.6,84.85514593225511,69.54313815381991,NaN,NaN,30.749734193421602,28.067714652576214
2010-10-22T09:30:00-04:00,28.78999,28.82001,28.71001,28.81,4073766,5260097.85,67.8557575798885,65.73828341324455,NaN,NaN,128.69138553113208,124.62931918964065,0.016477665658021334,0.29913334071046194,0.2826556750524406,235938443,228358485.8,85.81963884532344,71.39314486551424,NaN,NaN,31.57440121418312,28.568669875662916
2010-10-25T09:30:00-04:00,28.89,29,28.84,28.88,5218117,5340308.4,69.0642753367079,66.19347009840479,NaN,NaN,138.6548352833507,118.95738877657081,0.020457172442091665,0.3082271406050552,0.2877699681629635,241156560,231166275.6,86.80919862786158,73.54077738780346,NaN,NaN,32.61713432740845,29.14702194019799
2010-10-26T09:30:00-04:00,28.72,28.75,28.60001,28.72,3881427,5251231.7,63.21408096650104,66.0747396252632,NaN,NaN,77.99020402453161,119.01442966272069,0.009044681335082683,0.29907581983181686,0.2900311384967342,237275133,234354225.4,87.84624194366526,75.74737178777339,NaN,NaN,31.716963195621883,29.514156405258547
2010-10-27T09:30:00-04:00,28.61,28.63,28.38,28.57001,8722680,5420891.5,58.23416837565636,65.83166396537082,NaN,NaN,34.30303760738873,102.68039993832204,-0.010798754058925775,0.27653269592307694,0.2873314499820027,228552453,234957453.2,88.03788289706853,77.87364314021725,NaN,NaN,29.397237569489043,29.497453714434332
2010-10-28T09:30:00-04:00,28.69,28.74001,28.53999,28.67,6704656,5336824.7,60.46987603406868,65.66264418431196,NaN,NaN,59.60619422934613,87.84913133514985,-0.018908564178412468,0.26369574475898716,0.28260430893739963,235257109,235635939.6,88.2620715747158,79.94485486338598,NaN,NaN,28.135138825593685,29.302837301742812
2010-10-29T09:30:00-04:00,28.61,28.77,28.61,28.77,6424703,5387165.3,62.62467601089251,65.60360659303628,NaN,NaN,71.965070516618,76.50386833224704,-0.01919510102742833,0.25861043265311423,0.27780553368054256,241681812,236784613.4,88.64990511950012,81.79352235826138,NaN,NaN,27.71857949892169,29.076514758482652
2010-11-01T09:30:00-04:00,28.88,28.89999,28.56,28.64999,7641391,5454198.7,58.50313128861204,65.14595537601024,NaN,NaN,64.62393143706242,61.69768756298938,-0.028559915715908546,0.24210563903565685,0.2706655547515654,234040421,235361385.6,84.9065791876715,83.14189646253611,NaN,NaN,26.1240344108601,28.65473185167943
2010-11-02T09:30:00-04:00,28.78999,28.86,28.78,28.82001,3161261,5341353.95,62.28966774836794,64.63673720224158,NaN,NaN,97.51231575647797,65.60210990937865,-0.024549769156071932,0.2399783433064755,0.2645281124625474,237201682,235346695.4,84.86674509885793,84.22747416829282,NaN,NaN,25.89021135998776,28.259800352866332
2010-11-03T09:30:00-04:00,28.89999,28.92,28.67,28.91,8917168,5555170.15,64.15409437456753,64.2481839051256,NaN,NaN,95.70415011936957,77.88233241177483,-0.017418048256483076,0.24275555214194355,0.26017360039842663,246118850,238859974.8,86.49819934688063,85.11349029049407,NaN,NaN,26.256082572217554,27.973554955630792
2010-11-04T09:30:00-04:00,29.14,29.27,29.06,29.25999,9505688,5808219.6,70.3035367285581,64.20890308518743,NaN,NaN,209.75133398025565,107.91136036195671,0.007928650218029076,0.270084413170963,0.2621557629529339,255624538,242933460.6,88.10006256968622,85.84314110655029,NaN,NaN,28.64729390252489,28.069803376615663
2010-11-05T09:30:00-04:00,29.19,29.2301,29.02,29.11,6008730,5898837.15,65.1456373261768,63.67646947424428,NaN,NaN,169.12240414001155,127.34282708663542,0.011437801383077817,0.2764530146817812,0.26501521329870337,249615808,244520259.8,88.66425128904949,86.39154669826813,NaN,NaN,28.934813418409878,28.193376239729123
2010-11-08T09:30:00-05:00,29.03999,29.07001,28.92999,29.06,8569895,6174752.25,63.47384291346213,63.97988546893838,NaN,NaN,120.86918816439147,138.59187843210123,0.007430704597623905,0.27430359404573323,0.26687288944810933,241045913,245921358.2,89.15325321537368,86.86402001575728,NaN,NaN,28.641171320805466,28.257346965597172
2010-11-09T09:30:00-05:00,29.07001,29.07001,28.83,28.91,6868883,6223916.15,58.61417981189652,63.574718868773914,NaN,NaN,77.21261470839538,134.5319382224847,-0.007476074614996386,0.25752779617936383,0.2650038707943602,234177030,245316427.8,87.40020339145399,87.13352707424022,NaN,NaN,26.86611088895321,28.058598954648033
2010-11-10T09:30:00-05:00,28.91,28.91,28.67,28.82001,8337188,6227362.45,55.85147979486404,62.84274316358716,NaN,NaN,16.42707779682468,118.67652375797574,-0.024586388120417912,0.2342708856438378,0.2588572737642557,225839842,241260626.2,76.53422737526628,86.53917574874103,NaN,NaN,24.55010910589428,27.557386119111783
2010-11-11T09:30:00-05:00,28.66,28.85001,28.64999,28.85001,6433586,6363781.15,56.586114399719726,62.03776865071796,NaN,NaN,4.092657358666333,77.54478843365787,-0.03446736449028204,0.21577306815140318,0.2502404326416852,232273428,236590404.2,66.3110130007572,85.14570247412914,NaN,NaN,22.881086943398074,26.88934337972411
2010-11-12T09:30:00-05:00,28.7,28.78999,28.61,28.71001,8355836,6457513.2,52.21917930606205,60.83454750567183,NaN,NaN,-35.983634851777495,36.52358063530007,-0.05006960004356481,0.18765343258722922,0.23772303263079403,223917592,231450761,57.24800702194808,83.03418878799246,NaN,NaN,20.13653867899675,25.924656993905916
2010-11-15T09:30:00-05:00,28.78,28.87,28.7,28.72,4377613,6475705.4,52.500871389594295,60.06931825017848,NaN,NaN,-9.757352353288514,10.398272531764082,-0.058753784902081246,0.16428080150319246,0.2230345864052737,228295205,228900619.4,53.35171919972327,80.57029430628232,NaN,NaN,17.979789311020784,24.789675896350897
2010-11-16T09:30:00-05:00,28.66,28.73,28.31,28.39999,6364934,6504840.75,43.62791681052787,59.02601456695503,NaN,NaN,-152.80630216977943,-35.60551084387088,-0.08357254758918262,0.11856890191879543,0.20214144950797805,221930271,226451267.6,49.84286583899211,77.842078802134,NaN,NaN,13.132818008601255,23.124410483815232
2010-11-17T09:30:00-05:00,28.45,28.52,28.36,28.41,9451602,6767374.35,43.947037914163275,57.84581184410463,NaN,NaN,-165.4010888432486,-71.97114417188554,-0.09595152637535412,0.08220204153878541,0.17815356791413953,231381873,227559673.8,51.40055421645951,75.20911327654426,NaN,NaN,9.349476144144782,21.15656272100517
2010-11-18T09:30:00-05:00,28.60001,28.85001,28.59,28.78999,5221406,6712026.5,54.481298931807686,57.264142052741434,NaN,NaN,-17.601279189529627,-76.30993148152473,-0.07605461089095711,0.08308530430044314,0.15913991519140025,236603279,228425644,52.63811219436787,72.63684235332053,NaN,NaN,9.201292302898224,19.448666946989892
2010-11-19T09:30:00-05:00,28.78,28.83,28.64999,28.81,3591214,6687898.9,54.961309573943666,57.01115478740798,NaN,NaN,-7.60687285651824,-70.63457908247288,-0.059770558132129725,0.0844267175262381,0.14419727565836782,240194493,231681024.2,57.06435914764189,70.64811235046126,NaN,NaN,9.234754556781946,17.989536605531615
2010-11-22T09:30:00-05:00,28.69,28.82001,28.5611,28.81,4968664,6675426.25,54.961309573943666,56.487700632091965,NaN,NaN,-19.888010543487198,-72.66071072051261,-0.04774537695131223,0.08451555446922754,0.13226093142053977,240194493,234060881.8,60.00691982634672,68.8724105452819,NaN,NaN,9.261440271843536,16.742665700719034
2010-11-23T09:30:00-05:00,28.63,28.63,28.41,28.47,5976570,6780183.4,45.505006524551135,55.15562292851936,NaN,NaN,-120.64690380082159,-66.22883104672106,-0.06060913816174633,0.05649950871835685,0.11710864688010318,234217923,236518412.2,62.8391329257428,67.18247722948632,NaN,NaN,6.2381777671351095,15.242024567349901
2010-11-24T09:30:00-05:00,28.62,28.71001,28.58,28.69,4283938,6558246.3,51.339094129102335,53.80101988570109,NaN,NaN,-52.58872494931755,-43.66635826793485,-0.05252243444133592,0.05145560382843328,0.1039780382697692,238501861,237942409.8,64.41181853086248,65.49045979814177,NaN,NaN,5.56869848831104,13.860120841772922
2010-11-26T09:30:00-05:00,28.57001,28.63,28.47,28.5,2126470,6329337,46.690121893511055,52.482768783367824,NaN,NaN,-107.62961577187941,-61.6720255844048,-0.05777383646484675,0.031760742688710764,0.08953457915355752,236375391,237896832.2,64.31799420692775,63.751441435133074,NaN,NaN,3.459186253202818,12.374273043405765
2010-11-29T09:30:00-05:00,28.37,28.52,28.22,28.45,4896898,6252946.75,45.52188720859285,51.200486233020015,NaN,NaN,-147.73332995036102,-89.69731700317337,-0.062043866400773556,0.011979746152590565,0.07402361255336412,231478493,236153632.2,60.67751846027434,61.71746038119742,NaN,NaN,1.414929747589545,10.808652572574877
2010-11-30T09:30:00-05:00,28.28,28.46001,28.24001,28.32001,9236207,6332687.55,42.541693550574685,50.05245150006846,NaN,NaN,-145.57426134891608,-114.83456716425914,-0.07043831370647465,-0.014024279579729182,0.05641403412674546,222242286,232563190.8,53.9092960755965,59.32525271577903,NaN,NaN,-1.2284585462869968,9.089065269880324
2010-12-01T09:30:00-05:00,28.53999,28.82809,28.53999,28.78,6468574,6498053.2,54.0144704812042,49.92123654909276,NaN,NaN,-2.5380381067214524,-91.21279402543911,-0.04316612665308478,0.0024563758103894884,0.04562250246347427,228710860,231461778.2,51.993357622162854,57.5723334477002,NaN,NaN,0.3161911034786552,7.8357975318229425
2010-12-02T09:30:00-05:00,28.75,28.82001,28.7,28.8,9095473,6506968.45,54.440423494972464,49.76797291303939,NaN,NaN,20.877016711187608,-76.51964569333808,-0.0229491868403223,0.016936018913071393,0.039885205753393695,237806333,231322672.6,51.7432362872481,56.53177796816384,NaN,NaN,1.642087534714259,6.950981817950273
2010-12-03T09:30:00-05:00,28.69,28.86,28.69,28.81,5146074,6288987.75,54.6665305684151,49.94278371749318,NaN,NaN,37.62092510580089,-47.46953751780202,-0.008800015506250855,0.02888518637058013,0.037685201876830984,242952407,232638075.8,53.99689912779494,56.29955597572433,NaN,NaN,2.7541170710712835,6.3514297112532745
2010-12-06T09:30:00-05:00,28.75999,28.82961,28.739,28.74001,4836469,6230374.7,52.695345487565504,49.956674724491116,NaN,NaN,41.03838784978115,-9.71519395777359,-0.004280444757518952,0.03233464592993229,0.036615090687451245,238115938,233965564.8,56.21904566811285,56.50436500918074,NaN,NaN,3.0911766439170147,5.88567927306238
2010-12-07T09:30:00-05:00,28.89999,29,28.86,28.89999,8562383,6229999.1,56.55183139599492,50.879811480595905,NaN,NaN,116.46460747906222,42.69257980782207,0.008652459681394768,0.04743066528919471,0.03877820560779994,246678321,238852771.8,63.25602413769689,57.4624477448025,NaN,NaN,4.548814096363131,5.694698533533916
2010-12-08T09:30:00-05:00,28.92999,29.02,28.87,29.00999,4780652,6125587.55,59.025347965934664,51.956833627151006,NaN,NaN,137.04690780073722,70.60956898931381,0.02297138691922522,0.06749243925683146,0.04452105233760624,251458973,243402394.4,68.35522714927788,58.67349581143238,NaN,NaN,6.522252224147696,5.812920489335885
2010-12-09T09:30:00-05:00,29.11,29.14,29.01109,29.09,3764671,5896961.7,60.77457922071421,52.40635364778718,NaN,NaN,172.3448340973502,100.90313246654634,0.03544217639366533,0.0888237728296879,0.05338159643602257,255223644,246885856.6,71.6044993759668,60.02823775297516,NaN,NaN,8.688928468308301,6.22377877204623
2010-12-10T09:30:00-05:00,29.14,29.24001,29.10001,29.14,3169492,5733757,61.87006914983294,52.899836474636416,NaN,NaN,182.3989721220872,129.8587418698036,0.044104901550752834,0.1085127233744636,0.06440782182371077,258393136,249974002.4,74.13957623312142,61.24789611622369,NaN,NaN,10.8050986618219,6.878253042014182
2010-12-13T09:30:00-05:00,29.25,29.25,29.11,29.14,6420332,5636981.8,61.87006914983294,53.39331930148565,NaN,NaN,158.64068086626486,153.37920047310033,0.04663528421796152,0.12270192709616268,0.07606664287820115,258393136,254029442,77.03867713248127,62.46445020951902,NaN,NaN,12.543394347957104,7.687558942863171
2010-12-14T09:30:00-05:00,29.19,29.34,29.17999,29.28,4649141,5650558.2,65.04060109397929,54.788718913587665,NaN,NaN,164.18391518773504,162.9230620148349,0.05401756826344564,0.14358860320750821,0.08957103494406257,263042277,257302233.2,79.0771869719089,63.62431121281661,NaN,NaN,14.983397549755075,8.729821600990586
2010-12-15T09:30:00-05:00,29.24001,29.38,29.23,29.31,4278359,5546229.45,65.69879431301003,55.81441178386678,NaN,NaN,149.10386016825663,165.33445248833877,0.056910878582927565,0.16070963317272202,0.10379875458979446,267320636,260474565.8,80.85174500941406,64.7985916755703,NaN,NaN,17.210378011845158,9.941329659684097
2010-12-16T09:30:00-05:00,29.36,29.58,29.23,29.5675,7166945,5431996.6,70.78342497912718,57.53536200426794,NaN,NaN,161.28024837377325,163.1215353436234,0.07122772214324728,0.19283340726885356,0.12160568512560628,274487581,264327353.2,82.76376946124479,66.11614705087865,NaN,NaN,20.837439617844574,11.497916796564166
2010-12-17T09:30:00-05:00,29.31,29.39,29.235,29.36,8099727,5575912.65,62.71568738242416,58.76349058811303,NaN,NaN,109.45993437479957,148.53372779416586,0.062116546369553605,0.1992513680875483,0.13713482171799468,266387854,265926296.8,83.50012519380972,67.74633324613117,NaN,NaN,21.602266029578647,12.941395258423377
2010-12-20T09:30:00-05:00,29.44,29.44,29.28,29.33,5233430,5658023.45,61.6221221878877,60.1263783479211,NaN,NaN,101.0736014000574,137.02031190092436,0.04998482399658849,0.1996158517137303,0.14963102771714182,261154424,266478554.4,83.75821589105743,69.87839894723552,NaN,NaN,21.900201035262274,14.221224655114648
2010-12-21T09:30:00-05:00,29.42,29.45,29.23,29.25999,3154141,5567297.3,59.035087738065165,60.48499386626832,NaN,NaN,83.01264740548856,120.78605834447508,0.033928576212303996,0.19204174798252183,0.15811317177021783,258000283,265470155.6,81.25880624169542,71.968788134345,NaN,NaN,21.402104801505757,15.247064676027664
2010-12-22T09:30:00-05:00,29.27,29.39,29.25,29.3875,2306253,5383781.45,62.1516868393198,61.03579839086455,NaN,NaN,81.35686881284072,107.23666007339189,0.02878214184047176,0.19409084907080754,0.16530870723033578,260306536,264067335.6,77.78151754782161,73.82866536724312,NaN,NaN,21.875068482892445,16.19392236272263
2010-12-23T09:30:00-05:00,29.32001,29.42,29.3,29.39999,2988583,5319013.7,62.45301991221518,61.591976201135985,NaN,NaN,80.28766990906685,91.03814438045062,0.02333764373561162,0.1944807618998503,0.1711431181642387,263295119,261828843.2,72.4534726600541,75.14699204811878,NaN,NaN,22.346118111210487,17.07280746964947
2010-12-27T09:30:00-05:00,29.34,29.34,29.25999,29.25999,1507691,5288074.75,56.97717125320819,61.89782089868189,NaN,NaN,55.68047618083918,80.28225274165854,0.008206987878261518,0.18140185301206557,0.17319486513380405,261787428,260908758,70.321237637112,76.15429147447584,NaN,NaN,21.18860151753382,17.66077804791866
2010-12-28T09:30:00-05:00,29.31,29.35001,29.23,29.34,1966155,5141537.6,59.17995753613026,62.08554419440585,NaN,NaN,56.00967709283804,71.26946788021468,0.0018202288070236217,0.17547015114258357,0.17364992233555995,263753583,261428589.8,70.84331338283673,76.69624070627154,NaN,NaN,20.823715679235217,18.112626280963884
2010-12-29T09:30:00-05:00,29.37,29.39999,29.31,29.35001,2499367,4804695.6,59.459620977004235,62.11656369519653,NaN,NaN,65.81625195971709,67.83018879106038,-0.00322260582886133,0.16962166504948328,0.1728442708783446,266252950,263079123.2,72.49757745761121,76.99212287115252,NaN,NaN,20.598559738023738,18.467759631972434
2010-12-30T09:30:00-05:00,29.3,29.33,29.25101,29.3,3824944,4672514.1,57.34578536650603,61.87164984846738,NaN,NaN,41.61359176925126,59.88153338234248,-0.010981732152093193,0.15911710568822812,0.17009883784032132,262428006,263503417.2,72.92287847364732,77.08629280670111,NaN,NaN,19.836520906316345,18.663296956878707
2010-12-31T09:30:00-05:00,29.28999,29.37,29.23,29.31,3625065,4398993.7,57.66984635105862,61.57163393426921,NaN,NaN,40.35268485363666,51.89453637125645,-0.01618190366378114,0.1498714582605949,0.16605336192437603,266053071,264055007.6,73.49667811590675,77.04037151261436,NaN,NaN,19.279525627049654,18.751329624045987
2011-01-03T09:30:00-05:00,29.42999,29.44,29.3,29.35001,5257145,4404547.25,59.01161858572571,61.36745889397584,NaN,NaN,63.131379856125136,53.38471710631363,-0.017553520368383257,0.14411146146389697,0.16166498183228023,271310216,265959565.2,75.43256381526356,76.92564913281309,NaN,NaN,19.13883811656977,18.806687980120813
2011-01-04T09:30:00-05:00,29.33,29.35001,29.17,29.27,5187215,4422084.55,55.2406888201716,60.66746516013243,NaN,NaN,2.075053580490186,42.59779240384406,-0.024072958664955596,0.13157378350108573,0.15564674216604132,266123001,266433448.8,75.90417431343634,76.69900537149363,NaN,NaN,18.026248545156502,18.695196632268768
2011-01-05T09:30:00-05:00,29.21001,29.37,29.19,29.28,4494648,4218697.8,55.62238279938189,59.94772148058756,NaN,NaN,1.566278123376894,29.747797636576024,-0.027678097014648878,0.12104912089773023,0.1487272179123791,270617649,267306388.6,76.78813110209153,76.4087472352563,NaN,NaN,17.178512729257182,18.478527503267113
2011-01-06T09:30:00-05:00,29.28,29.3,29.10001,29.17999,5437508,4251540.6,50.94343449804785,58.53057930336762,NaN,NaN,-103.56793612355996,0.7114920580137835,-0.03622511852229188,0.10344581975951428,0.13967093828180616,265180141,267856815.6,77.35230545493883,76.02221409194873,NaN,NaN,15.167115491233393,18.005468644405152
2011-01-07T09:30:00-05:00,29.17,29.17999,28.95261,29.0325,5449758,4335794.95,44.93956366728942,57.26085618085799,NaN,NaN,-245.07936207728278,-56.3749173281701,-0.05036906596779961,0.07670960582205666,0.12707867178985627,259730383,266592278,72.96465077494257,75.26968020488678,NaN,NaN,11.589947877927177,17.08896567776544
2011-01-10T09:30:00-05:00,28.98,29.08,28.92999,29.05251,4486145,4401627.6,45.8716098381271,56.135819584446516,NaN,NaN,-240.08085141012498,-117.01736358142011,-0.05647534908441369,0.05648448543433915,0.11295983451875284,264216528,265173540.4,68.2847371781069,74.16443172539032,NaN,NaN,8.851110975908421,15.912129291785867
2011-01-11T09:30:00-05:00,29.13,29.14,28.97,29.03,3442072,4252714.6,44.94980563137703,55.12972800539736,NaN,NaN,-189.11938919754098,-155.25625213702637,-0.05980848678515972,0.03819922603730319,0.09800771282246291,260774456,264103831.4,64.90449100636812,72.99626635143838,NaN,NaN,6.285684676384619,14.536922918157117
2011-01-12T09:30:00-05:00,29.17,29.32001,29.09,29.27,4487906,4244652.85,55.27050502702893,54.63821501880516,NaN,NaN,-37.28285883266058,-163.02607952823385,-0.044339651509802736,0.042583148435209495,0.08692279994501223,265262362,263032774,61.615616766395185,71.84155915276506,NaN,NaN,6.865035084626682,13.440938941938484
2011-01-13T09:30:00-05:00,29.22,29.37,29.22,29.33,4778949,4269682.35,57.41973705190205,54.27869481449708,NaN,NaN,26.664263220464488,-136.97963965942898,-0.02928312618634074,0.0503188922120863,0.07960201839842704,270041311,264005008,63.42726033004897,71.19682970062183,NaN,NaN,7.9969391850030185,12.663224690947702
2011-01-14T09:30:00-05:00,29.28999,29.355,29.25999,29.33,4097055,4116187.85,57.41973705190205,54.31030665726093,NaN,NaN,41.2231632106206,-79.7191346018483,-0.01903663435125355,0.05580622545936009,0.07484285981061364,270041311,266067193.6,66.98645674843038,70.95863106571599,NaN,NaN,8.913939412434827,12.127612508303006
2011-01-18T09:30:00-05:00,29.35001,29.46001,29.32001,29.3475,3321485,3877275.75,58.1007443733219,54.233220002774615,NaN,NaN,88.91470935819495,-13.920022448184307,-0.011181918897157653,0.06086546118916658,0.07204738008632423,273362796,267896447.2,69.79454466010453,70.88371901409228,NaN,NaN,9.866678398245487,11.804621921151933
2011-01-19T09:30:00-05:00,29.37,29.41,29.21001,29.28999,5165414,3873874.95,54.9882854895969,53.91383889653124,NaN,NaN,31.344458088824254,30.172747009088745,-0.009999556813587829,0.05954793406933945,0.06954749088292728,268197382,269381032.4,71.88469377828508,70.83994160842612,NaN,NaN,9.851246403747831,11.525568275808489
2011-01-20T09:30:00-05:00,29.28,29.50999,29.28,29.44,15486316,4490483.7,60.875763862495994,54.165980217673386,NaN,NaN,113.02568138473578,60.234455052568,0.00020495467624211117,0.06980368422822991,0.0695987295519878,283683698,273065299.6,76.27273109985744,71.07921679601256,NaN,NaN,11.574838128198502,11.53260682614992
2011-01-21T09:30:00-05:00,29.53,29.59,29.4099,29.49001,4508172,4600579.65,62.630617952634964,54.52032104635741,NaN,NaN,167.740605615624,88.4497235315999,0.009147203756450006,0.08103273424755031,0.0718855304911003,288191870,276695411.4,79.6438675206417,71.51830175349362,NaN,NaN,13.543358989279708,11.81985713516846
2011-01-24T09:30:00-05:00,29.47,29.57001,29.42,29.53999,4961598,4699230.4,64.35153544925252,54.90174367946645,NaN,NaN,163.96103975149455,112.9972988397747,0.01680676088167954,0.09289398159319973,0.07608722071152019,293153468,281317842.8,82.96320641282162,72.05620479617635,NaN,NaN,15.712553259107164,12.375956581445418
2011-01-25T09:30:00-05:00,29.52,29.66499,29.48,29.63499,9109613,5079326.5,67.42249431923506,55.77187264368526,NaN,NaN,189.80941570891767,133.17624010991923,0.026095590115444087,0.1087067083558253,0.08261111824038121,302263081,287097899.8,86.03066314684625,72.77952542713419,NaN,NaN,18.537307218443143,13.256149529587951
2011-01-26T09:30:00-05:00,29.7,29.72,29.53,29.56,6028570,5282447.25,62.821952004829434,56.286127586931514,NaN,NaN,162.46803867151348,159.40095622645708,0.025010837964261012,0.11387466569570748,0.08886382773144647,296234511,292705325.6,88.24236531689903,73.59768501390614,NaN,NaN,19.620562156985184,14.16535133350184
2011-01-27T09:30:00-05:00,29.39999,29.44,29.19,29.25999,15264258,5920691.8,48.54931090947812,56.11511875917654,NaN,NaN,-9.265619383262203,134.94269607285747,0.003063734999748699,0.09269349648113234,0.08962976148138364,280970253,292162636.6,86.80987351831526,74.27322558986161,NaN,NaN,15.749490881347333,14.391656983194054
2011-01-28T09:30:00-05:00,29.28999,29.36,28.92,28.98,9732207,6216054.95,39.52428574189822,55.72831319307716,NaN,NaN,-114.80827454073213,78.43292004158627,-0.02953833512255276,0.05270684257819269,0.08224517770074545,271238046,288771871.8,78.26130460015844,74.65155800594846,NaN,NaN,8.792540927985529,13.591783261021407
2011-01-31T09:30:00-05:00,28.96001,29.00999,28.8,28.88,6825375,6376070.45,36.886865887892476,55.08654576806041,NaN,NaN,-174.7961673646066,10.681478618366038,-0.05555581269889015,0.012800411827132763,0.06835622452602291,264412671,283023712.4,66.33553650304036,74.51232938630085,NaN,NaN,2.364133232483566,11.987833256944572
2011-02-01T09:30:00-05:00,29,29.17,28.99001,29.09,11650016,6695714,45.16242690547486,55.10173300192453,NaN,NaN,-79.96313986090117,-43.273032495597725,-0.05617221734737447,-0.0018590471581951817,0.05431317018917929,276062687,277783633.6,57.7031219901384,73.99794588514159,NaN,NaN,0.03946214926338171,10.280923098704402
2011-02-02T09:30:00-05:00,29,29.06,28.89,28.98,8214004,6847053.45,42.05198381099025,54.15755291506462,NaN,NaN,-108.78050537049452,-97.52274130399933,-0.06112903321084996,-0.022098121324383158,0.039030911886466804,267848683,272106468,50.09680383325217,73.17517353277424,NaN,NaN,-2.918768163726414,8.395252918357142
2011-02-03T09:30:00-05:00,28.91,29.16,28.91,29.13,3306298,6787635.95,47.37458336336642,53.440041937312074,NaN,NaN,-66.1371939005372,-108.89705620745433,-0.0518145722334194,-0.025737303405307443,0.026077268828111955,271154981,270143413.6,47.752794053182,72.0555687987123,NaN,NaN,-3.4193591262268694,6.707451197702284
2011-02-04T09:30:00-05:00,29.16,29.32001,29.08,29.3,4638805,6747700.8,52.67948162688497,53.10145226409657,NaN,NaN,-4.483285266583611,-86.83205835262461,-0.032648981681053124,-0.01473395827320445,0.017915023407848674,275793786,271054561.6,48.94681921952262,70.76702326093319,NaN,NaN,-1.9184841714049643,5.4751747164012485
2011-02-07T09:30:00-05:00,29.3,29.41,29.27,29.34,5262172,6738321.5,53.85809876254171,52.798406149040844,NaN,NaN,31.653568514125123,-45.54211117687828,-0.016535468548443254,-0.0027543122777053952,0.013781156270737858,281055958,274383219,53.15841647129406,69.57872839030387,NaN,NaN,-0.36038582336405484,4.641523210720491
2011-02-08T09:30:00-05:00,29.35001,29.5,29.3,29.48,3624108,6695219.65,57.81815669402044,53.00053980649967,NaN,NaN,60.440803300035036,-17.461322544691036,0.003239818660671717,0.017830929596577505,0.014591110935905788,284680066,276106694.8,55.218312310213705,68.38827257115591,NaN,NaN,2.2766744020308205,4.303687666621967
2011-02-09T09:30:00-05:00,29.44,29.56,29.42999,29.53,2587157,6652473.9,59.16604574016532,52.87841708347605,NaN,NaN,87.44231265840102,21.783241061088074,0.01852260774230763,0.03774437061379032,0.019221762871482695,287267223,279990402.8,59.53651514523987,67.19282857439751,NaN,NaN,4.8112328412966905,4.376194120146927
2011-02-10T09:30:00-05:00,29.47,29.53999,29.28999,29.42,5797496,6717953.4,55.002009408647346,52.33351647319122,NaN,NaN,44.64263963162542,43.93920776752059,0.019935393993911976,0.044141005363872665,0.02420561136996069,281469727,282053352,61.65182470743326,65.90768265916834,NaN,NaN,5.618724674575812,4.553698485065339
2011-02-11T09:30:00-05:00,29.25999,29.595,29.22,29.58,6767695,6817390.7,59.470169576970285,51.98484748231392,NaN,NaN,59.51838573260307,56.73954196735792,0.029766003023772566,0.0614131151496764,0.031647112125903834,288237422,284542079.2,64.09070756688442,64.55964702731568,NaN,NaN,7.76484374407099,5.0124335220661465
2011-02-14T09:30:00-05:00,29.5,29.57001,29.39,29.45,5828934,6903984.65,54.71616781830083,51.07725273224719,NaN,NaN,56.41265617662925,61.691359499858756,0.025782438272002252,0.06387515996590665,0.038092721693904395,282408488,284812585.2,64.35605585098975,63.01146079189736,NaN,NaN,8.03522927826716,5.4442614872377195
2011-02-15T09:30:00-05:00,29.37,29.47,29.32001,29.44,5229648,6999392.8,54.35621078289453,50.47255693068041,NaN,NaN,31.66259444647504,55.935717729146745,0.020948598331789754,0.06427846960864159,0.04332987127685183,277178840,283312340,61.635783522212726,61.11099066370548,NaN,NaN,8.139769242207862,5.8293340236620255
2011-02-16T09:30:00-05:00,29.45,29.53999,29.418,29.52,4122172,6947230.7,56.80442237361927,51.06220774954763,NaN,NaN,59.082937355820086,50.263842668630566,0.021531063903763678,0.07024370115655643,0.04871263725279275,281301012,282119097.8,59.48220330796946,59.15901422010935,NaN,NaN,8.959266611939514,6.2764672505588095
2011-02-17T09:30:00-05:00,29.42999,29.72,29.42999,29.72,6706348,6508232.3,62.25509706914045,52.68583713006494,NaN,NaN,100.35152809704303,61.40562036171409,0.0330868770399335,0.09007123355270963,0.05698435651277613,288007360,283426624.4,61.08667863858373,57.93225522285401,NaN,NaN,11.421783132733962,7.011512376583831
2011-02-18T09:30:00-05:00,29.77,29.82001,29.63,29.8,5524336,6559040.5,64.20102284344946,54.636848341176155,NaN,NaN,134.65634124829822,76.43321146485312,0.04318126567691996,0.11096093860892609,0.06777967293200612,293531696,284485479.2,62.38568402486292,57.6501229029842,NaN,NaN,14.062974673027579,8.018864133218653
2011-02-22T09:30:00-05:00,29.57001,29.77,29.5,29.59,16824464,7152183.8,56.034495592187874,55.413424675941364,NaN,NaN,85.62046400087817,82.27477302970291,0.033224955871502565,0.10931086777138432,0.07608591189988176,276707232,283345228,60.06053569010387,57.81850959583887,NaN,NaN,13.769227192663468,8.840344570282198
2011-02-23T09:30:00-05:00,29.59,29.67,29.49001,29.52,7403457,7066876,53.58755815871824,56.23739427220765,NaN,NaN,66.26101547401228,89.19445723521035,0.02008192948031466,0.10118832375027509,0.08110639426996043,269303775,281770215,56.90561027644392,58.30485291320972,NaN,NaN,12.759514622074885,9.400226006252582
2011-02-24T09:30:00-05:00,29.47,29.60001,29.27,29.39999,7419613,7136428.15,49.58939692591575,56.39559524096118,NaN,NaN,23.474004218299182,82.07267060770617,0.0023932178844080637,0.0840979166254705,0.08170469874106244,261884162,277886845,49.940020089785754,58.461083344395696,NaN,NaN,10.646311092486629,9.578238161428875
2011-02-25T09:30:00-05:00,29.45,29.55,29.39999,29.55,4057279,6576079.2,54.190282267897786,56.503509572462086,NaN,NaN,46.81823320994802,71.36601163028718,0.000009221314199087116,0.08171622538381129,0.0817070040696122,265941441,273473661.2,43.433411211055095,58.06726848664802,NaN,NaN,10.292451430725755,9.680268628471286
2011-02-28T09:30:00-05:00,29.61,29.77,29.5499,29.72,5388336,6358885.65,58.781473414915304,56.85517919048878,NaN,NaN,105.62854300571162,65.56045198176984,0.008618590742544341,0.09248024249779263,0.08386165175524829,271329777,269033277.4,38.060239894613495,56.988827302599404,NaN,NaN,11.479915626411547,9.937361056748466
2011-03-01T09:30:00-05:00,29.84,29.89,29.47,29.49001,6715344,6353384.1,51.29183712219531,56.38901350678698,NaN,NaN,80.49515381439936,64.53538994447409,-0.0018789992319359905,0.0815129027153283,0.08339190194726429,264614433,266614717.6,35.48524949110039,55.57932281551989,NaN,NaN,9.979967967296593,9.943447758255342
2011-03-02T09:30:00-05:00,29.5,29.53999,29.35001,29.41,4991199,6020443.25,48.95495443252492,55.65964984195553,NaN,NaN,-8.640322424852883,49.55512236470106,-0.014226504345184382,0.06560877151578381,0.0798352758609682,259623234,264678609.4,33.52960457670375,53.721686346338736,NaN,NaN,8.01170511381112,9.667484523334739
2011-03-03T09:30:00-05:00,29.56,29.778,29.5226,29.71001,9047004,6062093.25,56.88681249268769,55.7942786336727,NaN,NaN,105.64913588315419,65.99014869767207,-0.002801810122158549,0.07633301320827002,0.07913482333042857,268670238,266035824.6,36.184644798525426,51.90260206713104,NaN,NaN,9.011693925047238,9.57380015215081
2011-03-04T09:30:00-05:00,29.69,29.78,29.42,29.58,14092633,6601410,53.04041665700172,55.335010567960644,NaN,NaN,53.393058811968345,67.30511381807614,-0.00451254915162809,0.07349413689089346,0.07800668604252155,254577605,263763057.4,33.75328197680176,49.73564309641085,NaN,NaN,8.509411678499148,9.421744655914859
2011-03-07T09:30:00-05:00,29.69,29.69,29.42,29.5,14750301,7106984.8,50.765783420756655,55.05284025385034,NaN,NaN,7.286061270026711,47.63661747093915,-0.011164837121513088,0.06405063964063018,0.07521547676214327,239827304,257462562.8,28.113690006701404,47.14690267896167,NaN,NaN,7.364025247496075,9.127784740426462
2011-03-08T09:30:00-05:00,29.50999,29.8,29.50999,29.75999,5817762,7134764.3,57.19103995190536,55.255328051636845,NaN,NaN,107.3231523760954,53.00221718327835,0.0011571461378106218,0.07666190943440654,0.07550476329659592,245645066,253668689.4,25.365378835492024,44.55615948705305,NaN,NaN,8.55429630256406,9.045857820731833
2011-03-09T09:30:00-05:00,29.71001,29.96001,29.69,29.91,14812813,7694199.55,60.40206866194577,55.5123027865173,NaN,NaN,190.5540567853687,92.84109302532268,0.01770459225053307,0.09763550360976225,0.07993091135922918,260457879,253835618.4,25.70950283094399,42.14382373869409,NaN,NaN,10.615309597211608,9.270065217371801
2011-03-10T09:30:00-05:00,29.71001,29.89999,29.67,29.71001,8328359,7981259.65,54.529674857677314,54.96048691426994,NaN,NaN,112.77204258375565,94.26567436544296,0.013656497467171264,0.09700153319319327,0.083345035726022,252129520,250527474.8,23.40623988727897,39.45236382788661,NaN,NaN,10.357777666837311,9.42545271015259
2011-03-11T09:30:00-05:00,29.59,29.81,29.56,29.73,7365578,8059663.75,55.00060794287818,54.30331442137199,NaN,NaN,68.94470545943511,97.37600369493632,0.010919208236234573,0.09699404602131523,0.08607483778508065,259495098,251510973.4,25.54191783901304,36.82066624318305,NaN,NaN,10.306364904377025,9.55129730932751
2011-03-14T09:30:00-04:00,29.58,29.66,29.39999,29.52,5821668,8012362.4,49.23201447839561,53.81742291324398,NaN,NaN,-45.47655986255167,86.82347946842063,-0.005555311830048232,0.07913069799752037,0.0846860098275686,253673430,254280198.6,31.34654074410355,34.76966660418302,NaN,NaN,8.386594904387646,9.384911251478957
2011-03-15T09:30:00-04:00,29.07001,29.36,29.00999,29.25999,12940039,8367917.65,43.19171669783759,53.07486280889536,NaN,NaN,-216.0034593214379,22.158157128913967,-0.03295530017294726,0.043491884611384535,0.0764471847843318,240733391,253297863.6,30.43998882741498,32.879265072109526,NaN,NaN,4.667858308453885,8.711046545332518
2011-03-16T09:30:00-04:00,29.14999,29.16,28.715,28.8425,13046887,8758779.6,35.632199152641945,52.07792011080437,NaN,NaN,-303.77349046944,-76.70735232204777,-0.07574170160760618,-0.018229942225175932,0.05751175938243025,227686504,246743588.6,25.20276660915367,31.11231839492152,NaN,NaN,-1.4733408232556038,7.256134064105644
2011-03-17T09:30:00-04:00,29.11,29.17,28.8936,28.98,7940223,8949682.15,39.39444645801905,51.02107469581303,NaN,NaN,-201.11523877772768,-139.48480859434443,-0.09033827891834223,-0.05541108926549754,0.03492718965284469,235626727,243443030,23.051912527938455,29.656497060413187,NaN,NaN,-4.989943672330954,5.506694387471844
2011-03-18T09:30:00-04:00,29.02,29.14999,28.895,29.05,7222195,8975474.5,41.27624241326294,49.77070105283786,NaN,NaN,-156.7637234626467,-184.6264943787608,-0.09060263699000508,-0.07832610658466166,0.01227653040534342,242848922,240113794.8,21.096184917360304,28.444778847752243,NaN,NaN,-7.114757225924549,3.7036298712723594
2011-03-21T09:30:00-04:00,29.22,29.46001,29.2,29.41,5923113,8995413.35,49.89306397522582,49.67078868519718,NaN,NaN,-42.19700718558802,-183.97058384336808,-0.06315635537304644,-0.06666891381096463,-0.0035125584379181903,248772035,239133515.8,20.543514707084384,27.377512077465386,NaN,NaN,-5.964374450985182,2.3224863966641394
2011-03-22T09:30:00-04:00,29.35001,29.45,29.32001,29.37,5478074,8428093.85,49.03215659338887,49.67630312525889,NaN,NaN,-30.375398257378823,-146.84497163055624,-0.045163480496703295,-0.05996690905879731,-0.014803428562094016,243293961,239645629.8,21.697602441615743,26.532369067816244,NaN,NaN,-5.356030276863527,1.2255554433030442
2011-03-23T09:30:00-04:00,29.3,29.47,29.24001,29.42,5391391,8327490.55,50.18916047099573,49.197899409423755,NaN,NaN,-28.270686612742075,-91.74441085921669,-0.028192507604014528,-0.05004406306711218,-0.02185155546309765,248685352,243845399.4,30.60009921574823,26.13347295476073,NaN,NaN,-4.5110612432604915,0.4060387737939678
2011-03-24T09:30:00-04:00,29.53999,29.74001,29.50999,29.69,5221090,8217564.4,55.99800044278055,49.409155394122244,NaN,NaN,55.195790422720414,-40.48220501912706,0.001352452948086176,-0.020160989277989927,-0.021513442226076103,253906442,247501342.4,37.28460857805417,26.38571056913591,NaN,NaN,-1.8827769881622103,0.0790650935145138
2011-03-25T09:30:00-04:00,29.71001,29.77,29.67,29.69,4581965,8243798.7,55.99800044278055,49.78288518140966,NaN,NaN,69.30236419483224,4.731012512368736,0.019995897968999015,0.0034814302351726667,-0.01651446773382635,253906442,249712846.4,40.98739344820016,27.305260814957247,NaN,NaN,0.18167519018351158,0.09372367875294205
2011-03-28T09:30:00-04:00,29.72,29.87,29.67999,29.67999,6117691,8280266.45,55.718613867242674,49.677711889648045,NaN,NaN,77.66761511509877,28.703936972506103,0.0301447745465471,0.021166500449357528,-0.008978274097189572,247788751,249516189.6,40.75695127841649,28.40465884659471,NaN,NaN,1.7697989192812877,0.33316299882842
2011-03-29T09:30:00-04:00,29.67999,29.83,29.64,29.82001,3790880,8134043.25,58.81405619335803,49.56428242760605,NaN,NaN,79.39686969465154,50.65839056291217,0.04394325737422753,0.04595079762059484,0.0020075402463673106,251579631,251173323.6,43.6328341699994,29.68489679938438,NaN,NaN,4.0424070574984174,0.8630550072098482
2011-03-30T09:30:00-04:00,29.91,30.03999,29.91,29.98,10211660,8395066.3,62.076184115199986,50.10331880314339,NaN,NaN,127.24793955865069,81.76211579719072,0.06048018659820416,0.07760777349412251,0.01712758689591835,261791291,253794511.4,47.93790802071595,31.437158808915594,NaN,NaN,6.9859191962516745,1.7377498913586806
2011-03-31T09:30:00-04:00,29.94,30.02,29.92,29.92,4596902,8172561.2,60.152006409657545,50.47127583648477,NaN,NaN,111.64444439682039,93.05184659201072,0.0636895333725637,0.09673950361162298,0.03304997023905928,257194389,254452100.8,48.990468575557074,33.11205529009731,NaN,NaN,8.896460965585042,2.7604229019624467
2011-04-01T09:30:00-04:00,29.96001,30.14,29.96001,30.07001,5222270,7729043.05,63.22150712182293,51.470525311015294,NaN,NaN,122.83776914439271,103.7589275819228,0.07163435665330245,0.12259291605568734,0.05095855940238489,262416659,256154144.2,51.71171437519687,34.56671054946112,NaN,NaN,11.457321381941115,4.0028369705308275
2011-04-04T09:30:00-04:00,30.14,30.14999,30.06149,30.13,2615456,7122300.8,64.40243902795554,52.98557690602372,NaN,NaN,120.53947714489466,112.33329998788199,0.07622266881641944,0.14623689542290919,0.07001422660648975,265032115,259602817,56.74673629793011,36.4457639402122,NaN,NaN,13.936424166974207,5.421920855737024
2011-04-05T09:30:00-04:00,30.11,30.265,30.10001,30.16,4454898,7054157.6,65.00754633890443,55.083815990756754,NaN,NaN,120.93703953113511,120.6413339551787,0.07637903931363527,0.16548802574853383,0.08910898643489856,269487013,263184293.4,61.26394124506244,39.0215621284914,NaN,NaN,16.168890996704157,6.957202304446614
2011-04-06T09:30:00-04:00,30.25999,30.35001,30.22,30.3,6282043,6627619.1,67.76162747935436,57.110043206566424,NaN,NaN,133.45490582287962,121.88272720802449,0.0805952171752431,0.18985300790395243,0.10925779072870934,275769056,265979846.4,64.39010633431322,41.97429025751818,NaN,NaN,18.921402606624806,8.666373776186356
2011-04-07T09:30:00-04:00,30.3,30.34,30.17,30.34,4331234,6427762.85,68.52388222309067,59.05630319298268,NaN,NaN,118.67321454037574,123.28848123673556,0.08056952544646326,0.2099696975367884,0.12940017209032514,280100290,270561026.6,68.82959768184068,45.383819740695344,NaN,NaN,21.445223606354777,10.491923751924702
2011-04-08T09:30:00-04:00,30.42999,30.42999,30.16,30.25,7290184,6423993.15,64.81074304081432,60.12185169766758,NaN,NaN,104.69728330017226,119.66038406789148,0.06940652829764205,0.2161583324623777,0.14675180416473566,272810106,272639716,70.61945842876683,48.960672863672656,NaN,NaN,22.638821433826955,12.227194849339309
2011-04-11T09:30:00-04:00,30.25999,30.528,30.25999,30.41,6796379,6472728.7,68.11826939206084,61.48514546900129,NaN,NaN,111.89146383351616,117.93078140561576,0.0676442910704517,0.23130716800280027,0.16366287693234857,279606485,275554590,72.96388179330266,52.62254996022172,NaN,NaN,24.64423892800412,14.001058289148567
2011-04-12T09:30:00-04:00,30.25999,30.56,30.25999,30.50999,9894938,6320473.65,70.01505293095482,62.90128064471265,NaN,NaN,107.47800513585182,115.23897452655913,0.06788277439848181,0.24851634493045083,0.18063357053196902,289501423,279557472,75.81761318464405,55.852372386571425,NaN,NaN,26.913479634631265,15.84568990993181
2011-04-13T09:30:00-04:00,30.48,30.58501,30.46001,30.53,5320438,5934151.2,70.39464865124204,63.92961265960276,NaN,NaN,112.07189675373625,110.96237271273044,0.06410391359372733,0.2607634625241282,0.19665954893040086,294821861,283368033,78.17888757351275,58.773392314818466,NaN,NaN,28.90132836367012,17.71078111760871
2011-04-14T09:30:00-04:00,30.41,30.77,30.41,30.71001,6517949,5863037.5,73.62894461205362,65.18896581455084,NaN,NaN,123.0036175600013,111.82845331665555,0.0680698738679533,0.28174689126534247,0.21367701739738917,301339810,287615937,80.46845930433166,61.59346844739929,NaN,NaN,31.643014928472944,19.701100233446457
2011-04-15T09:30:00-04:00,30.72,30.89999,30.67,30.84,8860582,5944956.85,75.69395320746699,66.61577576742401,NaN,NaN,144.33005852485172,119.75500836159145,0.07333493120552376,0.30534568140429386,0.2320107501987701,310200392,295093994.2,83.70903985620308,64.66147477438405,NaN,NaN,34.643207543569105,21.835686992035406
2011-04-18T09:30:00-04:00,30.61,30.74001,30.53999,30.67,10027848,6150193.6,68.17522175964817,67.28443045073045,NaN,NaN,106.40815139543238,118.6583458739747,0.059826428297968054,0.30679378557123016,0.2469673572732621,300172544,299207206,85.1668368968312,67.62818925487203,NaN,NaN,35.02991545336215,23.72057677222494
2011-04-19T09:30:00-04:00,30.64999,30.74001,30.56,30.73,7270988,6239839.3,69.33304189491864,67.80277743499606,NaN,NaN,103.48615831775612,117.85997651035555,0.0498008657235553,0.3092184394277062,0.2594175737041509,307443532,302795627.8,86.31719392849408,70.36956681971333,NaN,NaN,35.68691724477545,25.4300539825893
2011-04-20T09:30:00-04:00,30.92,30.99001,30.87,30.89,6838777,6312208.6,72.2340059870722,68.6657774048114,NaN,NaN,141.7159191007659,123.78878097976148,0.04875215936589894,0.32035777291152456,0.2716056135456256,314282309,306687717.4,87.45371634977546,73.11694166072893,NaN,NaN,37.133061793971045,27.10191224135812
2011-04-21T09:30:00-04:00,30.98,31.019,30.86,30.89999,5674016,6334854.9,72.40949964194222,69.32206258481992,NaN,NaN,130.10338978242112,125.20873542424545,0.04370054371244009,0.3262312931861757,0.28253074947373563,319956325,310411020.4,88.44270072360015,75.74058354275773,NaN,NaN,38.35371381672974,28.70931246641121
2011-04-25T09:30:00-04:00,30.86,30.88,30.71001,30.82001,6365590,6424036.15,68.66753037459911,69.62671196672302,NaN,NaN,94.02169437062345,115.1470625933998,0.030563518509063914,0.3207351476100655,0.2901716291010016,313590735,311089089,88.61865421247876,78.01714910808263,NaN,NaN,38.32983596800024,30.083672966638215
2011-04-26T09:30:00-04:00,30.83,31.07001,30.81,31.03,6733023,6454802.75,72.66211382130805,70.1734667868947,NaN,NaN,118.54801021022796,117.5750343563589,0.03148292734543778,0.3295252882827988,0.29804236093736103,320323758,315119331.8,89.6292849129378,80.04324508435944,NaN,NaN,39.50410709547976,31.429449270758436
2011-04-27T09:30:00-04:00,31.09,31.27,31.07001,31.23,7168125,6623665,75.8235567457855,70.74931887735407,NaN,NaN,149.64617965531437,126.80703862387057,0.04045514536779071,0.34861129264709945,0.30815614727930873,327491883,319129002,90.53023398516208,81.91039705942009,NaN,NaN,41.54108549397834,32.873968731218426
2011-04-28T09:30:00-04:00,31.21001,31.44901,31.11,31.42999,5723410,6399252.5,78.5008978518168,71.46196285083451,NaN,NaN,158.68932389890472,130.20171958349835,0.05391152604829613,0.3755455548396789,0.32163402879138275,333215293,322915598.8,91.29898638012116,83.51535339501154,NaN,NaN,44.18717498856734,34.490141053696846
2011-04-29T09:30:00-04:00,31.48,31.57001,31.42999,31.52,16050375,6971926.15,79.59609368281376,72.51805932526304,NaN,NaN,174.00333425753044,138.9817084785202,0.062331545359663454,0.39954846049096204,0.3372169151312986,349265668,328777467.4,92.33618923805557,85.06654845281788,NaN,NaN,46.698040154871734,36.234126639578975
2011-05-02T09:30:00-04:00,31.60001,31.67999,31.5,31.56,7724672,7097046.25,80.08169270116593,73.37258956162769,NaN,NaN,162.72429717132027,152.72222903865955,0.0638198920418957,0.4169917801836682,0.3531718881417725,356990340,337457388.4,93.56030746708285,86.53772171523076,NaN,NaN,48.870868419322164,38.039375465256576
2011-05-03T09:30:00-04:00,31.49001,31.67,31.48,31.64,10317504,7482148.65,81.05292120469616,74.16100872403779,NaN,NaN,146.3364206021571,158.27991111704537,0.06329282712584405,0.4322879220490776,0.36899509492323357,367307844,346854205.6,94.5712532492357,87.87726743413016,NaN,NaN,50.97675621135017,39.88757271469852
2011-05-04T09:30:00-04:00,31.62,31.71001,31.55,31.60001,11447863,7831796.9,78.97977010239529,74.77423168483445,NaN,NaN,131.51053698058007,154.6527825820985,0.053728432241511914,0.43615563522512346,0.38242720298361155,355859981,352527825.2,95.07407562079136,89.08406658036435,NaN,NaN,52.117589651313146,41.63471799135775
2011-05-05T09:30:00-04:00,31.57001,31.61,31.28,31.36,17020128,8368701.15,67.77518868575038,74.35610626152707,NaN,NaN,86.05163245669239,140.12524429365607,0.026113728317453788,0.41506936338042877,0.388955635062975,338839853,353652737.2,95.16960580219096,90.13414847306858,NaN,NaN,49.67476312423493,42.78329586748306
2011-05-06T09:30:00-04:00,31.69,31.71001,31.36,31.44,10208156,8662547.25,69.3366961050958,73.90201646850055,NaN,NaN,89.49574854534892,123.22372715121976,0.008995820919914466,0.4002004112128681,0.3912045902929536,349048009,353609205.4,95.09275064222378,90.94727067207006,NaN,NaN,48.110890941073805,43.544380877996026
2011-05-09T09:30:00-04:00,31.39,31.59,31.39,31.55,5201191,8558097.6,71.38958395241788,74.13161376798412,NaN,NaN,80.63556701259955,106.8059811194756,0.0012484778392239382,0.39276518759198353,0.3915167097527596,354249200,353060977.4,94.06252896833995,91.5826772486064,NaN,NaN,47.39427120999842,44.09436521113923
2011-05-10T09:30:00-04:00,31.60001,31.77,31.59,31.74001,7618645,8599210.9,74.55815425787,74.50483607962349,NaN,NaN,102.53996349031303,98.04668969710681,0.004883757209018791,0.3976214062640331,0.3927376490550143,361867845,351972977.6,91.93384598970806,91.98386668155025,NaN,NaN,47.7476014816423,44.61625610692538
2011-05-11T09:30:00-04:00,31.74001,31.85001,31.59,31.67999,7078137,8458370.85,71.85122102502268,74.47749429661995,NaN,NaN,95.21733785388587,90.78804987176797,-0.0005045850937390739,0.39210691768784045,0.3926115027815795,354789708,351758923,91.49514077253505,92.2725398546045,NaN,NaN,47.20910678661221,44.98666334688064
2011-05-12T09:30:00-04:00,31.69,32.17,31.69,32.14999,10350699,8709883.9,78.44944909054111,74.90891925723416,NaN,NaN,135.33080906631793,100.64388519369308,0.02255949539121005,0.4208108720205921,0.39825137662938204,365140407,357019033.8,92.44875152976843,92.5586863407594,NaN,NaN,49.01387187875436,45.56197885143403
2011-05-13T09:30:00-04:00,32.07001,32.25999,32.015,32.11,6649754,8716474.15,76.79989478985925,75.48980242975274,NaN,NaN,145.239717607602,111.7926790061437,0.02965015803017651,0.43531407416710266,0.40566391613692615,358490653,358907562.6,92.76251687803922,92.85467653115656,NaN,NaN,49.85279458529208,46.17495252769946
2011-05-16T09:30:00-04:00,32.07001,32.23,32,32.12,11341980,8840544.05,76.93052622128847,75.79468902975134,NaN,NaN,131.26153302153392,121.91787220793057,0.029479953873991493,0.4425138584794155,0.413033904605424,369832633,362024249.2,93.26023683942081,93.11403024019106,NaN,NaN,50.54842269618178,46.799733980339795
2011-05-17T09:30:00-04:00,32.08,32.27,32.02,32.19,13994816,9038892.45,77.86986970233295,75.9408542409333,NaN,NaN,131.23519820535958,127.6569191509399,0.0285295705110854,0.4486958677442807,0.4201662972331953,383827449,366416170,93.89714471090979,93.35452386345877,NaN,NaN,51.40384032631125,47.45746345833572
2011-05-18T09:30:00-04:00,32.19,32.28,32.06,32.24001,10312168,9190951.45,78.5420990545291,75.94379718398419,NaN,NaN,128.62377968433512,134.33820751702973,0.025799266840461965,0.45241538078377275,0.4266161139433108,394139617,374286151.8,94.83842347898646,93.60734079909199,NaN,NaN,52.30460567250812,48.14991234607463
2011-05-19T09:30:00-04:00,32.32001,32.42999,32.22,32.42,11103133,9404169.25,80.80235519825965,76.02995872080176,NaN,NaN,143.47649554564157,135.96734481289448,0.03033268882900597,0.4645319749795682,0.43419928615056225,405242750,382306620.4,95.58566526684693,93.83944622971997,NaN,NaN,53.78944034618285,48.955559203232944
2011-05-20T09:30:00-04:00,32.36,32.46001,32.24001,32.32001,12333809,9737158.9,76.01223097317369,75.73928288308801,NaN,NaN,123.5510533307667,131.6296119575274,0.021244420018024457,0.4607548111730928,0.43951039115506835,392908941,389190278,96.10663035402749,94.02132643593029,NaN,NaN,53.59702808810343,49.61862618678587
2011-05-23T09:30:00-04:00,32.06,32.19,32.03,32.09801,7637590,9800758.9,66.57556263491611,74.70518584238944,NaN,NaN,69.66092788391381,119.3094909300034,-0.003740052114296122,0.4348353260121982,0.43857537812649433,385271351,392278021.6,96.3166193850243,94.14599544562945,NaN,NaN,50.415891701396085,49.73252126030161
2011-05-24T09:30:00-04:00,32.16,32.16,32.03999,32.07001,7353176,9831766.55,65.47154117151928,73.74031234732686,NaN,NaN,58.35582148926146,104.73361558678377,-0.024989078097806705,0.4073390305042359,0.4323281086020426,377918175,391096166.8,94.22187851623438,94.0851242238754,NaN,NaN,47.52829384189125,49.41763162910013
2011-05-25T09:30:00-04:00,31.9201,31.96001,31.72501,31.86,23023008,10624510.7,57.737801621072194,73.02335612842128,NaN,NaN,1.7531442837398494,79.35948850666473,-0.054341387576152755,0.3644013741318517,0.41874276170800445,354895167,383247276.8,81.53886287012365,93.11149972872774,NaN,NaN,42.49503463138791,48.42868920085552
2011-05-26T09:30:00-04:00,31.83,31.97,31.67999,31.91,8428844,10759782.4,58.98015655577894,72.28360330347007,NaN,NaN,-3.3346564525336606,49.99725810702963,-0.07051689581347581,0.3305966419411597,0.4011135377546355,363324011,374863529,70.60614990062811,91.36245681861375,NaN,NaN,38.77565640392283,47.04968451557942
2011-05-27T09:30:00-04:00,32,32.14999,31.99001,32.03999,4347195,10174623.4,62.0994998238678,71.6200258657165,NaN,NaN,42.286239318805414,33.744295304637376,-0.07231999624099178,0.3107135424533958,0.38303353869438755,367671206,369815982,64.95899808880196,89.28363318436104,NaN,NaN,36.52903994345888,45.546735290990775
2011-05-31T09:30:00-04:00,32.21001,32.33,32.12,32.31,7570590,10166919.3,67.60938938989685,71.12368551800412,NaN,NaN,83.4423728189476,36.500584291644145,-0.055919647201221445,0.3131339796928607,0.36905362689408217,375241796,367810071,62.80906361697825,87.2032915863089,NaN,NaN,36.27970927625851,44.22287443174331
2011-06-01T09:30:00-04:00,32.27,32.32001,31.95,31.98,14211008,10361594.5,56.750478796653795,70.04506107312064,NaN,NaN,35.44574178285898,31.91856835036365,-0.06713324637161949,0.2851370689295578,0.3522703153011773,361030788,364432593.6,59.253060232584225,84.90028583345527,NaN,NaN,32.23115573906435,42.5097717613606
2011-06-02T09:30:00-04:00,31.92999,31.98,31.5,31.61,11745613,10376482,47.53238154125504,67.83669910531448,NaN,NaN,-71.66087741742031,17.235764010131614,-0.09746659421553355,0.23043707253176038,0.32790366674729393,349285175,363310595.2,58.07673739959744,82.44514196701448,NaN,NaN,25.208353397930505,40.03814056658487
2011-06-03T09:30:00-04:00,31.31,31.47,31.25,31.31,9226609,9986806.05,41.62815356978486,65.32443187530917,NaN,NaN,-165.16268443434785,-15.129841586231223,-0.13350432334854434,0.16102326256161348,0.2945275859101578,340058566,358657506.2,53.346774714941006,79.62973181250746,NaN,NaN,17.147204236985246,36.768006805213496
2011-06-06T09:30:00-04:00,31.23,31.28999,31.14,31.14999,6439289,9798362.7,38.85585162677646,62.60481226141546,NaN,NaN,-187.44644797616323,-61.076379045224954,-0.16199017273475935,0.09203986999170866,0.254030042726468,333619277,351847120.4,47.2776455190559,76.34526100390997,NaN,NaN,9.83300464988365,32.920149354452086
2011-06-07T09:30:00-04:00,31.2,31.28999,31.08,31.08,13204215,10198513.9,37.67398493623114,59.73367763526533,NaN,NaN,-179.1979634555541,-113.6044463001253,-0.17813530043667508,0.03136091718062417,0.20949621761729925,320415062,340881773.6,39.48798504427975,72.45889245629355,NaN,NaN,3.7943618630585254,28.759322569967292
2011-06-08T09:30:00-04:00,31.03999,31.14999,30.96001,31.10001,8355527,10235358,38.25225266651731,56.85583146469306,NaN,NaN,-168.26757810986078,-154.34711027866925,-0.17954955246733512,-0.014940722966869657,0.16460882950046546,328770589,334429733.8,35.75497999432562,68.23864649310347,NaN,NaN,-0.704795443129711,24.550162853810576
2011-06-09T09:30:00-04:00,31.17999,31.42,31.09,31.27,5887484,10175825.35,43.08349467027353,54.16162714126548,NaN,NaN,-115.05186392648267,-163.02530758048172,-0.1616760366147641,-0.03748621626798965,0.12418982034677443,334658073,331504313.4,34.17734039395529,63.85233757361122,NaN,NaN,-2.9571584530196136,20.620545524263406
2011-06-10T09:30:00-04:00,31.13,31.22,30.89,30.91,10786996,10197640.2,36.55965125459132,51.34358573279531,NaN,NaN,-135.19632725710753,-157.03203614503366,-0.166104512010298,-0.08344081966609806,0.08266369234419993,323871077,328266815.6,32.469853165171074,59.3068534886929,NaN,NaN,-7.198075939866426,16.64645674367343
2011-06-13T09:30:00-04:00,30.88,31.17999,30.87,31.05,10000914,10365198.2,40.34290053074636,49.46982415392604,NaN,NaN,-111.92947301572929,-141.92864115294688,-0.15199187776964182,-0.10732615486785235,0.04466572290178947,333871991,328317358.4,32.52652754290628,54.75041835711304,NaN,NaN,-9.372466335069879,12.929467732424385
2011-06-14T09:30:00-04:00,31.27,31.48,31.19,31.38,10591762,10327687.3,48.186460861807944,48.23517556037523,NaN,NaN,-56.44576140155866,-117.37820074214778,-0.11452606645733228,-0.09849186016987588,0.016034206287456398,344463753,333127096.6,37.87015485806694,50.7252952386725,NaN,NaN,-8.534863884440028,9.863134644300898
2011-06-15T09:30:00-04:00,31.17999,31.245,30.8,30.91,24775088,10866700.9,40.09991334485058,46.97532639778797,NaN,NaN,-98.75963077528036,-103.4766112752317,-0.11518005890347821,-0.12794086734189136,-0.012760808438413155,319688665,331310711.8,36.688464372617645,47.52169534599351,NaN,NaN,-10.765365823685961,6.9162060060170605
2011-06-16T09:30:00-04:00,30.92999,31.22,30.91,31.16,10212887,10861736.85,45.35318436441607,46.00197124126205,NaN,NaN,-74.22743691859772,-95.3117258736547,-0.0934812858759145,-0.1296124157833063,-0.036131129907391785,329901552,330359407.6,36.053929490612035,45.05367960242092,NaN,NaN,-10.629343253787853,4.409698968902073
2011-06-17T09:30:00-04:00,31.17,31.31,31.11,31.13499,13673324,10990246.4,44.92867784817075,44.77548395728369,NaN,NaN,-55.60093349705825,-79.39264712164484,-0.0762471509987512,-0.1314400686558308,-0.05519291765707959,316228228,328830837.8,35.00626485235,42.91419865696007,NaN,NaN,-10.667897880269622,2.2557565618775453
2011-06-20T09:30:00-04:00,31.12,31.42799,31.06,31.37,8469137,10797012.8,49.693613429023166,43.495785674364136,NaN,NaN,-35.15764464499715,-64.0382814474984,-0.045947155021955746,-0.11262686143452427,-0.06667970641256853,324697365,326995912.6,33.738852989346796,40.83775504070068,NaN,NaN,-9.090885221440416,0.6348077356892652
2011-06-21T09:30:00-04:00,31.45,31.47,31.28999,31.34,12758359,11053051.25,49.10947415050685,42.94999962821079,NaN,NaN,-17.09583022924106,-56.16829521303488,-0.025853702521044103,-0.09899683456387365,-0.07314313204282955,311939006,320490963.2,29.641673800242657,38.72265600981914,NaN,NaN,-8.038774221232583,-0.6042754010138558
2011-06-22T09:30:00-04:00,31.25999,31.28999,31.12,31.14,9307188,11150751.85,45.28750114752188,42.78965102865842,NaN,NaN,-46.792992011943866,-45.77496746036759,-0.024000922751458,-0.10314428548215204,-0.07914336273069404,302631818,317079593.8,27.739202452933526,36.55568922791458,NaN,NaN,-8.339358506196257,-1.7092872731827702
2011-06-23T09:30:00-04:00,30.95,30.95,30.58,30.86,18618336,10930518.25,40.5316394080523,42.71132858853467,NaN,NaN,-120.25690942343603,-54.98086196133524,-0.03872887919398492,-0.1275544617231752,-0.08882558252919028,284013482,307901979.8,23.389816585831696,34.41590650440678,NaN,NaN,-10.127315085047975,-2.911862674877799
2011-06-24T09:30:00-04:00,30.88,30.91,30.57001,30.61,8764965,10947324.3,36.81428558246808,42.56550244251264,NaN,NaN,-134.25650423640735,-70.71197610920507,-0.06107445519424946,-0.1651686515220021,-0.10409419632775264,275248517,299706037.6,20.324915273501674,32.49071148686719,NaN,NaN,-12.854874648034523,-4.332292956757331
2011-06-27T09:30:00-04:00,30.67,30.84,30.63,30.75,5038938,10981911.45,40.125984352334605,42.7406452579486,NaN,NaN,-121.85434049811211,-88.05131527982806,-0.061995125610873086,-0.181588103341344,-0.11959297773047092,280287455,290824055.6,17.62896337360496,30.9293527961047,NaN,NaN,-14.033986851477614,-5.718249227431657
2011-06-28T09:30:00-04:00,30.83,30.85899,30.74001,30.81,19095824,11558173.15,41.540141218437014,42.97549444022858,NaN,NaN,-105.99863592762692,-105.83187641950522,-0.05440293088631362,-0.18759664133836296,-0.13319371045204934,299383279,288312910.2,16.944638451226382,29.585756971597615,NaN,NaN,-14.555156366442748,-6.98066453300467
2011-06-29T09:30:00-04:00,30.91,31.03999,30.91,30.99001,9806852,11337965.35,45.6849938845842,43.16131581267934,NaN,NaN,-45.92927060236049,-105.65913213758854,-0.034090279487001995,-0.17580655981080184,-0.14171628032379985,309190131,289624572.8,18.719469708707734,28.481623351222787,NaN,NaN,-13.739270386287682,-7.9461796549022425
2011-06-30T09:30:00-04:00,30.99001,31.25,30.99001,31.23,10175652,11259467.3,50.70322901234132,44.17157136680434,NaN,NaN,29.391306432007386,-75.72948896649987,-0.0029640329130860565,-0.1454213214651574,-0.14245728855207135,319365783,296695033,27.68963010071056,28.140178846618465,NaN,NaN,-11.468678023801065,-8.449393707602074
2011-07-01T09:30:00-04:00,31.17,31.50999,31.12,31.47,8450512,11220662.45,55.16447539120847,45.23025528540878,NaN,NaN,113.26339966505245,-26.225508186207936,0.03331567015024314,-0.10081270086426741,-0.13412837101451056,327816295,307208588.6,38.54952328738474,28.570392828366924,NaN,NaN,-8.098779175485967,-8.399305917299772
2011-07-05T09:30:00-04:00,31.44501,31.57001,31.39999,31.46001,7251512,11261273.6,54.94159189902189,45.71276464520978,NaN,NaN,140.7677057920744,26.29890107182937,0.0548939069890326,-0.0655109872782198,-0.1204048942672524,320564783,315264054.2,45.324994729911495,29.102881390641535,NaN,NaN,-5.482029548528319,-7.982552150332421
2011-07-06T09:30:00-04:00,31.46001,31.7,31.42,31.63,8706570,11036391.35,58.04770126339613,46.99474949653445,NaN,NaN,153.82928306608613,78.26448487057198,0.07748717159755321,-0.02354592977031089,-0.1010331013678641,329271353,321241669,49.75242126532484,30.036021168692052,NaN,NaN,-2.308649420573267,-7.171994617509685
2011-07-07T09:30:00-04:00,31.89999,31.92,31.78999,31.85001,7480133,10992621.65,61.72523883687189,48.16418195885274,NaN,NaN,200.17416482838001,127.48517195672007,0.10254781028945073,0.02715166149394932,-0.07539614879550141,336751486,326753940,53.49243701857743,31.281628849261008,NaN,NaN,1.5791040433405437,-5.921837665959652
2011-07-08T09:30:00-04:00,31.64,31.74001,31.565,31.74001,5743578,10985426.35,58.94315825032207,49.16521627329212,NaN,NaN,132.4091111291949,148.08873289615758,0.10654703672545598,0.05778764711131856,-0.048759389614137415,331007908,329082365,55.015566838429486,32.71086470540954,NaN,NaN,4.006758129268257,-4.503466838069951
2011-07-11T09:30:00-04:00,31.55,31.5784,31.42,31.50999,8308527,10861502.9,53.51173603071932,49.43793931627041,NaN,NaN,75.72030768854917,140.58011450085695,0.08923349366829748,0.06278247747123444,-0.02645101619706304,322699381,328058982.2,54.17576097682033,34.170643847371934,NaN,NaN,4.492043531099652,-3.218393928188579
2011-07-12T09:30:00-04:00,31.44,31.64,31.37,31.41,5628504,10642882.4,51.29882852113782,49.594321771315485,NaN,NaN,61.472962149661896,124.72116577237443,0.06756395377017697,0.05800392601565818,-0.009560027754518797,317070877,327360201,53.57439566621971,35.880123980656016,NaN,NaN,4.240883793851258,-2.152782825040031
2011-07-13T09:30:00-04:00,31.56,31.57001,31.33,31.41,5897063,10408147.45,51.29882852113782,50.023702298002334,NaN,NaN,50.37214313323707,104.02973778580463,0.05052724881820269,0.053599033268234564,0.0030717844500318756,317070877,324920105.8,51.427651524797135,37.5721560572177,NaN,NaN,4.0375073600707045,-1.2684556557384976
2011-07-14T09:30:00-04:00,31.35001,31.4971,31.2,31.27,6827078,9510746.95,48.070806668885226,50.56221424520469,NaN,NaN,18.670034477428967,67.72891171561442,0.028237772527805655,0.03836900010978894,0.01013122758198329,310243799,319618568.4,47.01927504489235,39.25997451857917,NaN,NaN,2.9522280803616234,-0.6655008362956233
2011-07-15T09:30:00-04:00,31.37,31.38,31.14,31.36,10520863,9526145.75,50.23861382406882,51.52109483389046,NaN,NaN,8.98380939844482,43.04385136946439,0.018438115186887382,0.033178871565592516,0.014740756378705134,320764662,317569919.2,45.39975637541895,41.05103459728755,NaN,NaN,2.6254951538448505,-0.19535855198984137
2011-07-18T09:30:00-04:00,31.24001,31.28,30.99361,31.16,5921441,9138551.6,45.67546898483459,51.91748659335474,NaN,NaN,-29.37449618600808,22.024890594552932,-0.0015685980747988468,0.012780008785206576,0.014348606860005423,314843221,315998687.2,44.14390518732701,42.944959012553404,NaN,NaN,1.0239077392852363,-0.021177653236258864
2011-07-19T09:30:00-04:00,31.28,31.64661,31.24001,31.59,8400609,9135125.2,55.115010076904774,52.88712008324529,NaN,NaN,56.764654864632064,21.083229137546954,0.013284592082048945,0.030954346962566603,0.017669754880517658,323243830,317233277.8,45.42144379980047,44.97901653745156,NaN,NaN,2.4988310170238304,0.33882358537232526
2011-07-20T09:30:00-04:00,31.67,31.67,31.395,31.53999,3812532,8687833.85,53.94106575160612,53.47683950231829,NaN,NaN,63.81949302565381,23.772699116030303,0.018545270499652964,0.04085134300508386,0.022306072505430898,319431298,317705362,45.930698921021886,46.92267576690257,NaN,NaN,3.3283740551227474,0.7659022239080998
2011-07-21T09:30:00-04:00,31.67,31.86,31.60001,31.8,6895223,8567235.6,58.84876926713055,54.05866380623181,NaN,NaN,105.96225766069051,41.23114375268261,0.03726025865538427,0.06888139582466124,0.03162113716927697,326326521,320921906.4,49.39534292494969,48.47308382577679,NaN,NaN,5.604058820841436,1.4570674520414335
2011-07-22T09:30:00-04:00,31.82001,31.838,31.67,31.74001,8006227,8036630.15,57.33092615132978,54.213410289097624,NaN,NaN,98.83603822615589,59.20158951822483,0.04292050080940245,0.08527176318103002,0.04235126237162758,318320294,320433032.8,48.88265350881073,49.21116455587865,NaN,NaN,6.994257419567668,2.248094590259467
2011-07-25T09:30:00-04:00,31.49001,31.59,31.41,31.45,5910094,7893886.6,50.543934140473304,53.899291877772725,NaN,NaN,26.37274778618255,70.35103831266295,0.025324398300575257,0.07400676024734665,0.04868236194677139,312410200,319946428.6,48.34477787900149,49.42686335224222,NaN,NaN,6.094329513692156,2.7975567221784226
2011-07-26T09:30:00-04:00,31.45,31.5,31.34,31.37,5398895,7911884.45,48.82678427549741,53.240654950065675,NaN,NaN,-7.340845303725298,57.52993827899148,0.007418714429058462,0.057955754983094465,0.050537040554036,307011305,316699923.6,44.802714491959684,49.07331286843043,NaN,NaN,4.836114050865665,3.0887791977051715
2011-07-27T09:30:00-04:00,31.31,31.33,30.98,31.03,7625375,7338362,42.25621021032842,51.850010048169715,NaN,NaN,-124.92103529809496,19.78183261424173,-0.026351864850149585,0.01759720949134902,0.043949074341498605,299385930,312690850,40.82489999860855,48.168488795575506,NaN,NaN,1.5674422785859325,2.8714453521167087
2011-07-28T09:30:00-04:00,31.08,31.27,30.98,31.02901,6844176,7190228.2,42.2383866904339,50.65681207960627,NaN,NaN,-139.83871478250128,-29.37836187439663,-0.04660105620648724,-0.014302245916610445,0.03229881028987679,292541754,305933896.6,35.15900690764384,46.75016308623367,NaN,NaN,-1.0109219263705145,2.3168214551899626
2011-07-29T09:30:00-04:00,30.78999,31.10001,30.77,30.83,12659688,7314430,38.7042303676109,49.599133103669956,NaN,NaN,-194.50199340851626,-88.04596820133106,-0.069844768050143,-0.055007149772801966,0.01483761827734104,279882066,298246251,30.049212218026554,45.02683817489126,NaN,NaN,-4.327020025586604,1.367701243650453
2011-08-01T09:30:00-04:00,31.12,31.12,30.44,30.72,11186543,7451231.55,36.86798664621145,48.56835868403236,NaN,NaN,-195.48867605405755,-132.4182529693791,-0.08790731292754735,-0.09504652288209314,-0.007139209954545797,268695523,289503315.6,25.508709520618552,43.022146307348315,NaN,NaN,-7.646119220745595,0.08001260587958914
2011-08-02T09:30:00-04:00,30.45,30.61,30.28999,30.32001,12283043,7702808.1,31.0916018351613,47.12498534931975,NaN,NaN,-227.69993378743686,-176.4900706661214,-0.12008166005947982,-0.15724128502889556,-0.037159624969415744,256412480,279383550.6,21.465629651406843,40.88200188782044,NaN,NaN,-12.616062139398915,-1.7337123577316258
2011-08-03T09:30:00-04:00,30.28999,30.44,30.08,30.44,13508422,7942900.7,34.41142895137715,46.14931551235488,NaN,NaN,-197.30265650601777,-190.96639490770593,-0.1259567797860569,-0.19460559970198688,-0.06864881991592997,269920902,273490545,19.524905206640426,38.9181183279453,NaN,NaN,-15.62623592518537,-3.718358581653589
2011-08-04T09:30:00-04:00,30.2,30.34,29.45,29.49001,18917648,8514776.45,24.391895035383087,44.30312131316305,NaN,NaN,-239.73562352478697,-210.94577665616308,-0.1830366127434689,-0.2974445858452661,-0.1144079731017972,251003254,265182845,17.168350864175125,36.901589362856456,NaN,NaN,-22.709591014937832,-6.431391786408481
2011-08-05T09:30:00-04:00,29.78,30.125,29.22,29.91,24268432,9441019.15,33.59715576346122,43.44038465449352,NaN,NaN,-192.77865281986425,-210.6011085384327,-0.1813722482483862,-0.34112328341227993,-0.15975103516389375,275271686,264260769,16.924195009819385,34.95732435017734,NaN,NaN,-24.806181561452252,-9.056361754271878
2011-08-08T09:30:00-04:00,29.45,29.8,28.7,28.78,25886624,10319924,24.8358185523646,41.27758525988351,NaN,NaN,-216.61513550248395,-214.826400428118,-0.24147876429051343,-0.4615994905270355,-0.2201207262365221,249385062,260398676.8,15.903994841613098,32.84893513887825,NaN,NaN,-30.683261967111473,-12.145918927534677
2011-08-09T09:30:00-04:00,29.05,29.48,28.07001,29.48,28746496,11475823.6,35.974311198643704,39.99424564895763,NaN,NaN,-179.8912783230052,-205.26466933523164,-0.21981448492403288,-0.4948888323915632,-0.27507434746753034,278131558,264742492.4,21.62642442411979,31.112915531956663,NaN,NaN,-30.1970303688603,-14.724649133438337
2011-08-10T09:30:00-04:00,29.10001,29.14,28.31,28.35001,22101888,12286064.85,28.60511078527739,37.83398432882525,NaN,NaN,-175.97015198432447,-200.99816843089297,-0.264318217416556,-0.6054721192382253,-0.3411539018216693,256029670,261964246,20.658188078074915,29.06026161432275,NaN,NaN,-33.2718834042888,-17.374254029274116
2011-08-11T09:30:00-04:00,28.5,29.55,28.45,29.19,20125200,12950970.95,38.66355239568716,36.5006004891365,NaN,NaN,-116.89910167194756,-176.4308640603251,-0.22163986260761476,-0.6182037300811878,-0.39656386747357303,276154870,266994569.2,27.028487153137846,27.499249731774686,NaN,NaN,-30.895908187848498,-19.305918909070456
2011-08-12T09:30:00-04:00,29.49001,29.67999,29.21001,29.53999,12733211,13061588.35,42.31047653845893,35.912496374706905,NaN,NaN,-75.6558480160988,-153.006303099572,-0.15732022754817865,-0.5932141519087963,-0.4358939243606177,288888081,269717848.2,30.291540142898768,26.20973275062449,NaN,NaN,-27.659408399792085,-20.499274550602117
2011-08-15T09:30:00-04:00,29.75,29.97,29.53,29.96001,23864016,13958717.1,46.427198060051204,35.74109735931789,NaN,NaN,-45.17491904819605,-118.71825980871442,-0.07798028322362904,-0.533369278390154,-0.455388995166525,312752097,282391255.2,43.05365286002207,26.08479977691466,NaN,NaN,-23.591957270674076,-20.941086367755254
2011-08-16T09:30:00-04:00,29.83,30.16,29.77,30.03,13192840,14198328.65,47.104564139600285,36.08740835426588,NaN,NaN,-28.281466366360082,-88.3962974173854,-0.015545395054830213,-0.4748207389850627,-0.4592753439302325,325944937,291953931,50.4283057586744,26.770757331205083,NaN,NaN,-20.382143446021058,-20.86123737893608
2011-08-17T09:30:00-04:00,30.14999,30.395,30.03,30.23,12507883,14633096.2,49.085626616556006,36.57649692041746,NaN,NaN,-5.742751919938895,-54.35081740450829,0.041353156987110284,-0.4075838976963446,-0.4489370546834549,338452820,308438561,60.03617736469481,28.54769807813729,NaN,NaN,-17.21659599882274,-20.340574324634176
2011-08-18T09:30:00-04:00,29.74001,29.94,29.33,29.69,17609488,15168809.45,44.26514620315323,36.97370519438476,NaN,NaN,-46.37366420844536,-40.245729911807864,0.0444796012482242,-0.39333755312317464,-0.43781715437139884,320843332,317376253.4,64.09902516411918,30.979827574286762,NaN,NaN,-16.229296203451106,-19.75324887875088
2011-08-19T09:30:00-04:00,29.41,30.06,29.41,29.55,14881133,15512554.75,43.08382183236102,37.417693421966874,NaN,NaN,-38.752911006378916,-32.86514250986389,0.03916452423530975,-0.38886149907726164,-0.4280260233125714,305962199,320791077,65.54047766903415,33.83923958488788,NaN,NaN,-15.839197513937311,-19.194098683777515
2011-08-22T09:30:00-04:00,29.92999,30.00999,29.545,29.64,8850266,15659563.35,44.116324960999314,38.348030788098164,NaN,NaN,-27.604828626608807,-29.351124425546423,0.04342588915219986,-0.37374366187232155,-0.4171695510245214,314812465,321203150.6,65.71934638554391,37.00021935161195,NaN,NaN,-15.212695707944194,-18.62532683008704
2011-08-23T09:30:00-04:00,29.7,30.255,29.62,30.25,12722223,16025729.75,50.65076104873731,39.50798308076674,NaN,NaN,14.235558837600374,-20.847719384754342,0.08655240335332332,-0.30897904683286725,-0.39553145018619057,327534688,321521100.8,65.86656884822835,40.310338183153945,NaN,NaN,-12.57032436962025,-17.760326478591786
2011-08-24T09:30:00-04:00,30.17999,30.39999,30.0764,30.38,12641742,16276548.1,51.940496496824665,41.47574032801257,NaN,NaN,53.00299772807201,-9.098569455152141,0.1209483279776577,-0.24434604021411843,-0.36529436819177613,340176430,321865822.8,66.0368737801746,43.80094696286819,NaN,NaN,-10.050575248485991,-16.65893344571953
2011-08-25T09:30:00-04:00,30.41,30.44,29.83,29.91499,13771535,16622916.05,47.189654388286016,42.44663308692863,NaN,NaN,34.185946258950494,7.013352638327033,0.10982118313657163,-0.2280178892710616,-0.3378390724076332,326404895,322978135.4,66.61567890379365,47.35033866958064,NaN,NaN,-9.340050574803483,-15.61337874987438
2011-08-26T09:30:00-04:00,29.86,30.265,29.35001,30.17,9421281,16460995.7,49.89619655487426,44.23666008710789,NaN,NaN,24.324621422729894,19.628859124148796,0.11644405321336021,-0.19228400589093297,-0.3087280591042932,335826176,328950930.8,69.61058062141318,51.186523368137784,NaN,NaN,-7.928076839649413,-14.515478476985098
2011-08-29T09:30:00-04:00,30.36,30.74001,30.35001,30.71001,13130465,16558191.8,55.13932898948763,45.60558992931103,NaN,NaN,140.18296655438792,53.18641816034815,0.1517677416090889,-0.11901838209293203,-0.27078612370202093,348956641,335779766,72.63341473024981,54.82987981857565,NaN,NaN,-5.0452602064421015,-13.162590152621814
2011-08-30T09:30:00-04:00,30.63,30.95,30.48,30.78999,10714516,16479765.45,55.87580934294596,47.5534969691445,NaN,NaN,154.55621449504983,81.25054929183804,0.17352487151592627,-0.05388003430711308,-0.22740490582303935,359671157,342207059.8,75.13987813753448,58.721429108537045,NaN,NaN,-2.5088767230098474,-11.640631091248675
2011-08-31T09:30:00-04:00,30.96001,31.08501,30.74001,30.89,8987703,16253729.5,56.83019133315728,48.85111403610665,NaN,NaN,164.88121617434868,103.62619298109337,0.18652097021178213,0.005746306941688317,-0.1807746632700938,368658860,347903545.8,77.13840863896218,62.30070921466735,NaN,NaN,-0.15260058207143426,-9.999483875651926
2011-09-01T09:30:00-04:00,30.89999,31.14,30.74001,30.78,11725043,15894099.25,55.41057151455975,49.78683510582814,NaN,NaN,137.73186923745675,124.33537757679463,0.1795170807065271,0.04362168761306506,-0.13589539309346205,356933817,354009330.2,79.07971565728693,65.78557889426651,NaN,NaN,1.4209785731841158,-8.36798924010392
2011-09-02T09:30:00-04:00,30.42999,30.60001,30.31,30.34,10867660,15224060.65,50.02731801970766,50.04398653151789,NaN,NaN,66.74333089142448,132.81911947053354,0.13887575672288696,0.03769930281014666,-0.1011764539127403,346066157,356057326.4,79.70231219364749,68.40334027523976,NaN,NaN,1.2843305997397434,-6.98908640584054
2011-09-06T09:30:00-04:00,29.72,30.28,29.63,30.22,11784219,14518940.4,48.63943154021603,50.15361991727615,NaN,NaN,12.342737479435796,107.25107365554311,0.09938675231382585,0.02305698647954202,-0.07632976583428383,334281938,353122385.8,76.20235784590963,70.24434399575655,NaN,NaN,0.7812230005293092,-5.8790422049305615
2011-09-07T09:30:00-04:00,30.50999,30.75999,30.455,30.75999,8986273,13530929.25,54.726151140824946,50.556514526152505,NaN,NaN,93.28357679273127,94.9965461150794,0.10458257578420065,0.05439845389596698,-0.050184121888233665,343268211,349841796.6,72.37652154167898,71.12579715125541,NaN,NaN,2.113384618346141,-4.737266944462461
2011-09-08T09:30:00-04:00,30.64,30.985,30.58,30.67999,6404023,12746036,53.71059854918465,51.231189693726186,NaN,NaN,96.927731947151,81.40584926963987,0.09770893179302019,0.07195204285304158,-0.025756888939978614,336864188,343482862.2,65.51077325132746,71.22663630034172,NaN,NaN,2.9196387762944216,-3.643423270068621
2011-09-09T09:30:00-04:00,30.44,30.44,29.86,30,12023398,12340945.9,45.91177922721319,51.433186650501334,NaN,NaN,-17.943263818895296,50.27082265836946,0.04511804866355201,0.0306406718894614,-0.014477376774090611,324840790,337064256.8,59.386955620329076,70.7870990111485,NaN,NaN,1.264773546229843,-2.9422522963116977
2011-09-12T09:30:00-04:00,29.58,30.08,29.56,30.03,10435488,12226059.75,46.282365356491994,51.58790382160795,NaN,NaN,-63.02152021536623,24.317852437011318,0.011836456702825293,0.00031819410444100527,-0.011518262598384288,335276278,334906281,57.4427797552737,70.19591568041491,NaN,NaN,0.042093894039980095,-2.515917126261458
2011-09-13T09:30:00-04:00,30.05,30.2,29.82001,30.14,8856984,11475708.15,47.697396142809346,51.376949185470245,NaN,NaN,-34.943079925550805,14.860688956013997,-0.0025193341643459984,-0.014667430303816786,-0.012148096139470788,344133262,336876545.8,58.76993348604238,69.6890131545445,NaN,NaN,-0.578843362519347,-2.239192302869728
2011-09-14T09:30:00-04:00,30.19,30.78,30.03999,30.5,12343387,11433235.5,52.14073590537232,51.391252000366514,NaN,NaN,36.55188196284024,3.514349990035788,0.011699912745889236,0.0024767947928907574,-0.009223117952998478,356476649,339518233.4,60.54647489417743,69.29684180554469,NaN,NaN,0.15040064709467207,-1.8978218814462424
2011-09-15T09:30:00-04:00,30.64999,30.87,30.52,30.86,9792043,11297443.5,56.15233366577611,52.03144337733009,NaN,NaN,86.32587073478685,1.393977747562957,0.0430573768575041,0.04459860311888164,0.001541226261377546,366268692,345399134.2,64.24049979678355,69.12718615504397,NaN,NaN,1.971655999524033,-1.3450393270219174
2011-09-16T09:30:00-04:00,30.78,30.92,30.69,30.84,12832480,11058593.1,55.8721396566872,52.458296456031015,NaN,NaN,89.12836777868267,22.808304067078552,0.05916408468183904,0.07549633211367635,0.016332247431837303,353436212,351118218.6,67.43385811409752,68.97170597595,NaN,NaN,3.3761335893026456,-0.6705860532612656
2011-09-19T09:30:00-04:00,30.49001,30.66,30.381,30.58,6738262,10651449.55,52.22386064484977,52.25004871712831,NaN,NaN,31.998530185031886,41.812314147158176,0.04941648744943144,0.0781028567436266,0.028686369294195165,346697950,353402553,68.63853455582152,68.68635739206226,NaN,NaN,3.5709827122494144,-0.06464765818831142
2011-09-20T09:30:00-04:00,30.64,30.97,30.56,30.64,7135754,10565723.95,52.986774281530884,52.04368906988437,NaN,NaN,63.534738532119064,61.50787783869215,0.04428392009347743,0.08404126941104195,0.03975734931756452,353833704,355342641.4,69.6648863723332,68.29528655169075,NaN,NaN,3.9400777536868192,0.5074559720795644
2011-09-21T09:30:00-04:00,30.71001,30.75,30.00999,30.00999,12112051,10535215.35,44.8823718143755,51.19027338997139,NaN,NaN,-41.97973865229461,45.80155371566518,-0.001822736504376761,0.03747892868709357,0.03930166519147033,341721653,352391642.2,66.1202890357518,67.5082780086043,NaN,NaN,1.8594401233264568,0.7005965651148347
2011-09-22T09:30:00-04:00,29.32001,29.58,29.17,29.44,19977664,10902011.45,39.06127980485688,50.02246683927832,NaN,NaN,-193.32949931639652,-10.1295202945715,-0.06735968074500281,-0.04489793573978318,0.022461745005219632,321743989,343486701.6,56.738652385795575,65.91248777492635,NaN,NaN,-1.8843314056281022,0.3313211407229866
2011-09-23T09:30:00-04:00,29.28999,29.58,29.24001,29.5,13093859,10868127.65,39.94426184751854,49.30224854126482,NaN,NaN,-161.50728314354276,-60.25665047901659,-0.10128158157476402,-0.10414023196323541,-0.0028586503884713774,334837848,339767028.8,53.334488977515306,64.0290718309169,NaN,NaN,-4.6205389121210345,-0.3760874382547307
2011-09-26T09:30:00-04:00,29.64999,30.07001,29.53,30.07001,12087734,11001450.3,47.69771415625046,49.23498301383871,NaN,NaN,-82.24954630223338,-83.10626577646966,-0.08083105564977333,-0.10389746995068805,-0.02306641430091471,346925582,339812555.2,53.37136358042203,62.39828652623921,NaN,NaN,-4.629916979443031,-0.9837773727102022
2011-09-27T09:30:00-04:00,30.45,30.55,30.09,30.25,15289953,11109424.7,49.89735536134564,48.89006902959019,NaN,NaN,-9.336385698634837,-97.68049062262043,-0.05207893128163531,-0.08816507840295884,-0.036086147121323534,362215535,341488921.4,54.788053489687535,61.1419673796684,NaN,NaN,-3.958167461792881,-1.4086902425791563
2011-09-28T09:30:00-04:00,30.31,30.36,29.64,29.67999,12297910,11188594.4,43.63818670519118,48.17061104073351,NaN,NaN,-72.37926460595934,-103.76039581335337,-0.06737530915240243,-0.12030528356182657,-0.05292997440942414,349917625,343128115.8,56.189718956685994,60.476177787194004,NaN,NaN,-5.38692342689087,-1.9770092689094012
2011-09-29T09:30:00-04:00,30.05,30.24001,29.62,29.97,8661180,11172268.25,47.26287572480888,48.26711793341891,NaN,NaN,-57.13848094640157,-76.52219213935439,-0.054440544266517246,-0.12098065474257069,-0.06654011047605345,358578805,350495079,61.905735574813534,60.656090641085754,NaN,NaN,-5.4147385171531965,-2.4681134472299435
2011-09-30T09:30:00-04:00,29.77,30.09,29.63,29.66,14877816,11329906.9,44.00509281653683,48.1044556091364,NaN,NaN,-76.10658998934521,-59.44205350851487,-0.0626562632325527,-0.14486043951674432,-0.08220417628419162,343700989,352267707.2,63.15154209085178,61.06385937934133,NaN,NaN,-6.470273550056829,-3.0398506047766416
2011-10-03T09:30:00-04:00,29.48,29.83,29.23,29.23,17137568,11643402.3,39.89705629242061,47.547288476965775,NaN,NaN,-126.10782767653441,-68.21370978337508,-0.09121332752012706,-0.19622083568435045,-0.10500750816422338,326563421,348195275,58.42432445205082,61.0391730197705,NaN,NaN,-8.699632619250009,-3.8483908925585513
2011-10-04T09:30:00-04:00,28.95,29.52,28.7,29.50999,15177566,11813069.65,43.58978863522831,46.936506529098345,NaN,NaN,-138.59829755763587,-94.06609215517527,-0.0855051477217535,-0.21188894281641524,-0.12638379509466174,341740987,344100365.4,54.043645618930654,60.574685214395735,NaN,NaN,-9.380819956612555,-4.638737901709123
2011-10-05T09:30:00-04:00,29.46001,29.58,29.34,29.55,9946773,11861094.65,44.118153040780875,46.07692219874155,NaN,NaN,-90.80421231161036,-97.75108169630548,-0.07373948841114034,-0.21855815560858716,-0.14481866719744682,351687760,344454392.4,54.36224777515977,59.86909578427974,NaN,NaN,-9.766697891563252,-5.371303614545427
2011-10-06T09:30:00-04:00,29.61,29.92,29.44,29.89999,9943695,12038078.25,48.64916399258975,45.56099536559173,NaN,NaN,-43.21181358364882,-94.96574822375491,-0.03884362695777216,-0.19337320089466203,-0.15452957393688987,361631455,345064922.4,54.9423796127375,58.97684731989688,NaN,NaN,-8.727928229836468,-5.850821416729862
2011-10-07T09:30:00-04:00,30.03999,30.27499,29.88499,30.07001,10812531,11977534.9,50.738743520344855,45.454915570984234,NaN,NaN,12.101767271819458,-77.32407677152199,-0.002676234102041042,-0.15787486656444116,-0.15519863246240012,372443986,350813521.8,60.0870336968166,58.36602582996796,NaN,NaN,-7.244753618201094,-6.049954588368609
2011-10-10T09:30:00-04:00,30.31,30.53999,30.3,30.53999,5676344,11739577.7,56.061325793530884,45.67452639326996,NaN,NaN,69.71787326778023,-38.15893658265906,0.051541021623366795,-0.09077235543319162,-0.14231337705655842,378120330,361124903.6,67.29947318582583,58.197067745217474,NaN,NaN,-4.281994258871612,-5.797388827011895
2011-10-11T09:30:00-04:00,30.42999,30.55,30.35001,30.48,5435680,11568512.5,55.240858104173,46.41441827111264,NaN,NaN,63.2302351889869,2.2067699666654947,0.08029050386923753,-0.041950247220011505,-0.12224075108924903,372684650,367313636.2,70.71940613732428,58.52557610961551,NaN,NaN,-2.1204349730171765,-5.2721097050126495
2011-10-12T09:30:00-04:00,30.61,30.8974,30.60001,30.72,7715367,11337111.5,57.89571708283941,47.759735219539955,NaN,NaN,100.9100788443618,40.54962819785993,0.11053184639454647,0.01592405690393406,-0.09460778949061241,380400017,373056087.6,73.48988445949112,59.722092686308045,NaN,NaN,0.504469981915652,-4.446884035451464
2011-10-13T09:30:00-04:00,30.67,30.73,30.45,30.63,4139617,11054490.2,56.54133343166517,48.94524033269329,NaN,NaN,82.92122570154048,65.7762360548978,0.118811203398186,0.0539062147571201,-0.0649049886410659,376260400,375981876.6,74.79826957588945,61.255219871906206,NaN,NaN,2.3039105234196486,-3.4824848127555907
2011-10-14T09:30:00-04:00,30.86,30.9192,30.7,30.87,4205008,10623116.6,59.27714923429933,49.77234283826821,NaN,NaN,117.34433767600035,86.82475013573396,0.13368023007034088,0.10219529894686019,-0.031484931123480685,380465408,377586161,75.51194590355992,62.836690037844626,NaN,NaN,4.641482682733511,-2.3219180276857188
2011-10-17T09:30:00-04:00,30.75999,30.92999,30.53999,30.66,5765887,10574497.85,55.95772151760268,50.20522613514372,NaN,NaN,95.8549465208894,92.0521647863558,0.1228774420765357,0.12211187147218894,-0.0007655706043467568,374699521,376901999.2,74.54247036419389,64.24771981459507,NaN,NaN,5.719325313187532,-1.17316897898954
2011-10-18T09:30:00-04:00,30.63,31.13,30.40109,30.89,14981270,10966773.65,58.686457791474794,51.28010264130683,NaN,NaN,108.76831899316223,101.15978154719087,0.12435006752693273,0.15467201380431916,0.03032194627738643,389680791,380301227.4,76.17887127496155,65.67551640875762,NaN,NaN,7.42634352545295,0.05533280735938706
2011-10-19T09:30:00-04:00,30.91,31.07001,30.74001,30.8,7398520,10731097.1,57.193197489882536,51.98941133881209,NaN,NaN,105.64754767798745,102.107275313916,0.11273441547138785,0.17123996561662125,0.05850555014523339,382282271,380677678.2,76.3601019220347,66.70797114784484,NaN,NaN,8.446595889258795,1.2540846762021596
2011-10-20T09:30:00-04:00,30.87,31.10001,30.78,30.97,6276605,10046044.15,59.29981228507442,53.081891300850494,NaN,NaN,104.5159295124343,106.42621607609476,0.10985984436780516,0.19583035560498985,0.08597051123718469,388558876,383137373.4,77.56132657189235,67.73724146791916,NaN,NaN,9.904640180310778,2.489878319646248
2011-10-21T09:30:00-04:00,31.28,31.47,31.17,31.47,13734840,10078093.2,64.78843561918184,54.85984696704772,NaN,NaN,144.95800939705936,111.94895042030655,0.13342413948143772,0.25275068558898184,0.11932654610754412,402293716,387503035,79.5477556630403,69.24605798298985,NaN,NaN,12.892854863396257,3.9760178258962493
2011-10-24T09:30:00-04:00,31.48,31.48,31.17999,31.25,9755188,9961465.9,60.89708065210197,56.096082111110135,NaN,NaN,121.1416591663652,117.00629294940173,0.12607170589453176,0.2769161784757088,0.15084447258117706,392538528,391070836.4,81.026075306304,71.1733743892308,NaN,NaN,14.290811891976126,5.449559835336231
2011-10-25T09:30:00-04:00,31.17999,31.22009,30.85001,30.88,13392859,9866611.2,54.92237653266472,56.86781236053041,NaN,NaN,72.99909762047032,109.85244867486333,0.08986669994057764,0.2631778475068991,0.17331114756632146,379145669,388963812,77.46495830042322,72.82356799817819,NaN,NaN,13.698391572556135,6.627964369224789
2011-10-26T09:30:00-04:00,31.17999,31.22,30.75999,31.19,5286105,9516020.95,58.58833293967513,57.57775299960793,NaN,NaN,76.02939706451079,103.92881855216801,0.0806665738408941,0.2741443648674391,0.193477791026545,384431774,389393712.6,77.68049890287118,74.44771937604489,NaN,NaN,14.310440061614335,7.725460896709009
2011-10-27T09:30:00-04:00,31.57001,31.67999,31.27,31.59,21684464,10167185.15,62.793020070211085,58.4387727531698,NaN,NaN,120.79614720151089,107.18486208998334,0.09443460337967644,0.31152104525114055,0.21708644187146411,406116238,392905185,79.4126179658551,75.82811825240478,NaN,NaN,16.171770216944832,8.932076513885555
2011-10-28T09:30:00-04:00,31.45,31.58,31.34,31.50999,11994461,10023017.4,61.44903331292812,58.823609004555315,NaN,NaN,108.78828239568846,99.95091668970915,0.09102853267414007,0.3308721077141392,0.23984357503999915,394121777,391270797.2,76.43917385899286,76.48095401477384,NaN,NaN,17.267354157846597,10.122830463022847
2011-10-31T09:30:00-04:00,31.31,31.42999,31.03999,31.03999,8271602,9579719.1,54.120996036077315,58.743618856834196,NaN,NaN,66.67419620700086,89.05742409783628,0.051940897356333726,0.3047696967354163,0.2528287993790826,385850175,389933126.6,73.99707319435163,76.71507309027581,NaN,NaN,15.917646142149863,10.950661274326707
2011-11-01T09:30:00-04:00,30.53,30.8,30.46001,30.5,18721168,9756899.2,47.162128709585616,57.97693397303035,NaN,NaN,-29.220761752060575,68.6134522233301,-0.012047195063287275,0.2377698055499735,0.2498170006132608,367129007,387529794.2,69.68920478387658,76.44359597058904,NaN,NaN,12.390252145797156,11.1563171131082
2011-11-02T09:30:00-04:00,30.78999,30.84,30.60001,30.78999,4854324,9502276.75,50.819332669437095,57.568219632871205,NaN,NaN,-16.160425569256027,50.175487696576745,-0.03529320744253117,0.20570049131009682,0.240993698752628,371983331,385040105.6,65.43908677325047,75.7750829132577,NaN,NaN,10.66662255215736,11.08636074725808
2011-11-03T09:30:00-04:00,31.03,31.19,30.89,31.17,5172066,9263695.3,55.19575952981911,57.27669179683691,NaN,NaN,44.52945533776157,34.92214932382687,-0.025958972520879253,0.2085449831015289,0.23450395562240817,377155397,379247937.4,56.76546469880916,74.43604854148978,NaN,NaN,10.648362021115938,11.023789500666346
2011-11-04T09:30:00-04:00,30.92999,31.05,30.78999,30.99001,4886277,8967382.6,52.799187259268905,57.051082206955925,NaN,NaN,2.7432262467352198,13.71313809403623,-0.03237211178254157,0.19403881589423122,0.2264109276767728,372269120,374877406,51.245953640152386,72.77201163262968,NaN,NaN,9.869333611099918,10.858867230728285
2011-11-07T09:30:00-05:00,31,31.25,30.83,31.25,4930047,8930067.75,55.7855463612839,56.84387424765657,NaN,NaN,40.52900477595592,8.484099807827223,-0.020166934430212224,0.2012022596390075,0.22136919406921973,377199167,373147204.4,49.20617443450572,70.84539042973998,NaN,NaN,10.155620027028242,10.758403344485421
2011-11-08T09:30:00-05:00,31.31,31.58,31.14999,31.56,5827133,8949640.4,59.10772908299957,56.980626504307786,NaN,NaN,116.16305806775982,37.560863771791304,0.006305513404563173,0.2292510858249237,0.22294557242036053,383026300,376326663,52.9150862570811,69.17074645367187,NaN,NaN,11.441619564312916,10.856005661603634
2011-11-09T09:30:00-05:00,31.17,31.17,30.7,30.82001,6187621,8873253.1,49.53898024637495,56.28342421582925,NaN,NaN,-36.01847238386174,33.58925440887016,-0.026689599856799917,0.18958357259936065,0.21627317245616057,376838679,377297732.6,54.01939903099226,67.48918020075043,NaN,NaN,9.355244214969485,10.641611169227327
2011-11-10T09:30:00-05:00,31.09,31.2,30.82001,31.12,4501172,8891330.85,52.86997652678258,55.4321057092293,NaN,NaN,0.8378205344964827,24.850927448217142,-0.02879824496219635,0.18027536625341511,0.20907361121561147,381339851,378134623.4,54.99896996404077,65.73569550796473,NaN,NaN,8.762347678683497,10.373144956292494
2011-11-11T09:30:00-05:00,31.3,31.52,31.3,31.48,3135330,8837846.95,56.57458651589792,55.12335612807187,NaN,NaN,107.74027707728726,45.85033761432754,-0.007541976505709119,0.19964614058347507,0.2071881170891842,384475181,380575835.6,57.82171458962714,64.07824117105925,NaN,NaN,9.49714725426995,10.24800242743213
2011-11-14T09:30:00-05:00,31.38,31.38,31.14,31.21001,2725816,8685843.4,53.1973264464323,55.000138264769554,NaN,NaN,44.33971810295817,46.61248027972799,-0.012942621937482912,0.19100983966733054,0.20395246160481345,381749365,381485875.2,58.8577546929697,62.74915519909829,NaN,NaN,9.004224702504061,10.07031989529955
2011-11-15T09:30:00-05:00,31.19,31.45,31.13651,31.36,6358363,8254698.05,54.811213383434776,54.73034401075239,NaN,NaN,59.533510146856386,35.28657069554731,-0.00793655250294259,0.19403177097613522,0.2019683234790778,388107728,382502160.8,60.03827123633507,61.48899608006,NaN,NaN,9.107333499296114,9.932750410156201
2011-11-16T09:30:00-05:00,31.14,31.4948,31.03999,31.08,7333273,8251435.7,51.25782232696404,53.90640131480617,NaN,NaN,20.32890817558607,46.55604680743687,-0.024093050490065104,0.17185201036649644,0.19594506085656155,380774455,383289316,60.97235477127416,60.17183442330422,NaN,NaN,8.096828047612291,9.670475786935642
2011-11-17T09:30:00-05:00,30.95,31.23,30.77,30.97,6727316,8273971.25,49.889458098578174,53.080717370924035,NaN,NaN,-51.41236192547959,36.10601031544166,-0.04176296964359874,0.14374134880206313,0.18550431844566187,374047139,381830773.6,58.25516925633178,58.87297695168557,NaN,NaN,6.8653110278425356,9.269737964208055
2011-11-18T09:30:00-05:00,31.05,31.14751,30.92,31.06,8138617,7994160.1,51.041074771908065,52.86072299491195,NaN,NaN,-29.7165356517239,8.614647769639427,-0.04659646648508381,0.1272587353393071,0.1738552018243909,382185756,381372888.6,57.390503226874216,57.68679338258004,NaN,NaN,6.177399894318946,8.827975382795325
2011-11-21T09:30:00-05:00,30.74001,30.83,30.45,30.56,21788064,8595803.9,44.871420336526,52.69710096826484,NaN,NaN,-156.38146242346093,-31.529588335644394,-0.08067718149260608,0.07300872495863331,0.1536859064512394,360397692,377102554,49.94496923629154,56.276490843466824,NaN,NaN,3.6844273501265263,8.093182806699781
2011-11-22T09:30:00-05:00,30.49001,30.82001,30.49001,30.59,5778578,8215089.85,45.298663283370935,52.30276744068868,NaN,NaN,-133.48891247669172,-70.13407286035401,-0.09729567739811576,0.0320663097035947,0.12936198710171046,366176270,372716262.4,43.67697424647592,54.722054234411495,NaN,NaN,1.7882737054251585,7.192481506517693
2011-11-23T09:30:00-05:00,30.38,30.47,30.19,30.25999,5091289,8205349.05,41.48952218173291,51.32375048725396,NaN,NaN,-187.82852041179927,-111.76555857783107,-0.12485126427507717,-0.026702093242136016,0.09814917103294116,361084981,368778367.6,38.95085011148549,53.449581763888375,NaN,NaN,-0.9974360158684714,6.022493289033955
2011-11-25T09:30:00-05:00,30.28999,30.57001,30.23,30.37,3223575,7282304.6,43.20406630223638,50.638384704608775,NaN,NaN,-143.72607704210023,-130.2283016011552,-0.12945188876959238,-0.06366568992904931,0.06578619884054307,364308556,366830651,36.82819538274743,52.419741888359454,NaN,NaN,-2.83129764200401,4.757666013171389
2011-11-28T09:30:00-05:00,30.77,30.89,30.67999,30.85001,6760215,7020592.3,50.078062068975605,50.23070725515819,NaN,NaN,-36.265880948162945,-131.53817066044303,-0.09551603256367243,-0.05360884186404746,0.041907190699624966,371068771,364607254,34.51582894203618,51.370431496040204,NaN,NaN,-2.4332165057917203,3.7303970818909447
2011-11-29T09:30:00-05:00,30.94,31.2697,30.91,31.17,4812465,6847635.45,54.068947148443925,49.870794259832785,NaN,NaN,43.50625907783014,-91.5606263601848,-0.04919963269405786,-0.01959235016794736,0.0296072825261105,375881236,367703962.8,40.15211542850636,50.458790722570576,NaN,NaN,-0.8689352585000861,3.073349604692226
2011-11-30T09:30:00-05:00,31.6501,31.92999,31.62,31.89999,7077906,6265472.35,61.60897110155045,50.7329364637739,NaN,NaN,195.86163193843984,-25.690517477158487,0.02872604795780158,0.06551484247336248,0.0367887945155609,382959142,371060537.2,45.616079453339914,49.85855360988113,NaN,NaN,3.1126796453148695,3.078968181924032
2011-12-01T09:30:00-05:00,31.96001,32.10001,31.75999,31.85001,11693621,6607437.2,60.87217189965878,51.30452184755077,NaN,NaN,186.38471621619655,49.15212984844067,0.07253748476274605,0.12746065046899346,0.05492316570624742,371265521,373096645.2,48.677054678615534,49.40698823235075,NaN,NaN,6.014257591772821,3.4982952404738588
2011-12-02T09:30:00-05:00,32.00999,32.05,31.74001,31.74001,5688523,6633260.05,59.1942722132113,51.49164225450172,NaN,NaN,146.02852806124494,107.10305086910971,0.08867444273195846,0.1657662191211955,0.07709177638923703,365576998,373350333.6,49.0617507915298,48.78127653248665,NaN,NaN,7.876386485154432,4.123736846856798
2011-12-05T09:30:00-05:00,32.09,32.09,31.73599,31.92999,7178473,6747869.85,61.18427977127236,52.06213892056173,NaN,NaN,136.78174750536596,141.7125765598155,0.10556156330892011,0.20904373052538716,0.10348216721646705,372755471,373687673.6,49.60271099435117,48.120201982585336,NaN,NaN,10.03025372752458,4.967524972666481
2011-12-06T09:30:00-05:00,31.89999,32.11,31.83,31.97,5992938,6801014.4,61.608908534283074,52.54768857419375,NaN,NaN,125.28095192615548,158.06751512948057,0.11222228931163933,0.24376002885601622,0.1315377395443769,378748409,374261108.2,50.56380762066035,47.4434545814657,NaN,NaN,11.912831094303646,5.95971156147179
2011-12-07T09:30:00-05:00,31.92999,32.16,31.77,32.05,5951234,6807219.45,62.49244928282586,53.35016192818388,NaN,NaN,116.01946126085959,142.09908099396452,0.11442043412851086,0.27456328220501547,0.1601428480765046,384699643,374609208.4,51.17254369567893,46.743468076066044,NaN,NaN,13.733800005678573,7.070295624929902
2011-12-08T09:30:00-05:00,31.92999,31.959,31.63,31.67999,5215262,6758601.5,56.06556493258057,53.79131241632691,NaN,NaN,71.73512748213052,119.16916324715132,0.0847269149202553,0.26605149172682374,0.18132457680656844,379484381,376252980.4,54.049892716811016,46.44309118038599,NaN,NaN,13.550866936803954,7.996091526626195
2011-12-09T09:30:00-05:00,31.83,32.065,31.77,32.00999,3885007,6727793.25,60.01516737386081,54.432319030752105,NaN,NaN,88.78502291965204,107.72046221883275,0.0810807949597705,0.28267557050628156,0.20159477554651106,383369388,379811458.4,59.600177777838574,46.60092507688345,NaN,NaN,14.546527761440997,8.931868131599739
2011-12-12T09:30:00-05:00,31.78999,31.92,31.53999,31.72,5890457,6865549.6,55.30969362857692,55.17790998018431,NaN,NaN,54.00597073679248,91.16530686511803,0.05420070293607998,0.26934565421661105,0.21514495128053107,377478931,380756150.4,60.94875037530732,47.38690944395599,NaN,NaN,14.006167721083049,9.656768072954497
2011-12-13T09:30:00-05:00,31.89999,31.99001,31.37,31.64999,6460910,7052304.3,54.20474676917599,55.81405880059896,NaN,NaN,42.35374481495355,74.57986544287765,0.028082181502080916,0.2502476781581322,0.2221654966560513,371018021,379210072.8,57.56219665326512,48.37871104444094,NaN,NaN,13.244420698520077,10.169289876606722
2011-12-14T09:30:00-05:00,31.58,31.75999,31.45,31.49001,5653129,7017042.6,51.664796796361244,56.54086413021527,NaN,NaN,26.67298107644998,56.71056940599571,-0.001995506373752287,0.21967111368886094,0.22166662006261323,365364892,375343122.6,50.06874598893765,49.17284646425895,NaN,NaN,11.873521248123511,10.41275150110912
2011-12-15T09:30:00-05:00,31.61,31.88,31.60001,31.81,7244063,7012582.1,56.096237853648304,57.46173352674469,NaN,NaN,47.91587377228037,51.94671866402568,-0.0023428887088126904,0.21873800917659736,0.22108089788541005,372608955,373968037.4,47.69120245340946,49.94877554073481,NaN,NaN,11.94245832893471,10.631281047941348
2011-12-16T09:30:00-05:00,31.78,31.78,31.42999,31.49001,9366527,7144542.65,51.05534647297369,57.53153955560169,NaN,NaN,19.816359420915514,38.15298596427838,-0.02487436971936663,0.18998793573620176,0.2148623054555684,363242428,369942645.4,41.48139204815407,50.44631576260037,NaN,NaN,10.490306691275174,10.611141854131894
2011-12-19T09:30:00-05:00,31.53,31.77,31.3,31.36,4628855,6969054.55,49.123862340938665,57.178319212208464,NaN,NaN,5.219179760512566,28.395627769022393,-0.047948503043991675,0.1549266766505788,0.20287517969457047,358613573,366169573.8,36.66263241481181,50.1970669759079,NaN,NaN,8.71349510706666,10.340049461694003
2011-12-20T09:30:00-05:00,31.69,32.06,31.63,32.00999,6064207,6182861.7,57.73310356803199,56.901471531242855,NaN,NaN,61.56099250109239,32.23707730625017,-0.020266114013879732,0.1775425371772208,0.19780865119110053,364677780,364901525.6,35.18337146203294,49.451873547957405,NaN,NaN,9.805794990052759,10.263727394316682
2011-12-21T09:30:00-05:00,31.86,32.39999,31.86,32.35001,8074703,6297667.95,61.41175192955914,56.94001296195002,NaN,NaN,107.69582365069598,48.441645821099364,0.018042952654692218,0.2203623420094658,0.2023193893547736,372752483,366379043.8,38.306859098085134,48.71114529220523,NaN,NaN,11.932345254448688,10.50210137433554
2011-12-22T09:30:00-05:00,32.44,32.44,32.23,32.34,4135617,6249884.35,61.24276349083773,57.086333767494764,NaN,NaN,136.3670464603121,66.13188035870571,0.03862517001168431,0.25060085186937897,0.21197568185769466,368616866,365580626,37.26189739490975,47.868298621018084,NaN,NaN,13.55508356066294,10.938241686668025
2011-12-23T09:30:00-05:00,32.35001,32.61,32.32001,32.57001,5227691,6350090.15,63.71361440467397,57.26700052702345,NaN,NaN,178.6342920618476,97.89546688689214,0.06224706889595372,0.2897845179776368,0.2275374490816831,373844557,367701051.8,41.80242452358494,47.31113530167763,NaN,NaN,15.680463042084675,11.615701880298975
2011-12-27T09:30:00-05:00,32.5799,32.72,32.55,32.63,3918398,6207999.3,64.35194607482325,57.46293177991918,NaN,NaN,200.59249193439533,136.97012932166868,0.07554372943667195,0.32196711087752306,0.2464233814408511,377762955,371530928.2,48.9841149724034,47.19830011251643,NaN,NaN,17.601298326188374,12.470787086854603
2011-12-28T09:30:00-05:00,32.67,32.67,32.42,32.47,3647074,6149729.75,61.25678887089881,57.37467032192439,NaN,NaN,151.70040466592997,154.9980117546362,0.06746027039596736,0.3307487194358103,0.26328844903984294,374115881,373418548.4,52.1202056212051,47.26599025005402,NaN,NaN,18.349992472578695,13.310673570529474
2011-12-29T09:30:00-05:00,32.48,32.67999,32.48,32.64,2933273,5942498.1,63.2777763383107,57.88982827947654,NaN,NaN,142.33686107802095,161.92621924010118,0.0673059883413557,0.34742093446653755,0.28011494612518184,377049154,374277882.6,53.520992895596684,47.22821169139585,NaN,NaN,19.56400317378457,14.204006370994488
2011-12-30T09:30:00-05:00,32.56,32.61,32.46001,32.49001,2935038,5504568.95,60.2895852219862,57.90942955434264,NaN,NaN,105.05752664362005,155.66431527676278,0.05155523032113585,0.3445589840266017,0.29300375370546583,374114116,375377332.6,55.32198516928489,46.92262650507058,NaN,NaN,19.75967353708575,14.997673109007525
2012-01-03T09:30:00-05:00,32.69,32.7789,32.45,32.46001,20757872,6258036.4,59.68250257423813,58.221773050461294,NaN,NaN,98.60802426579001,139.65906171755128,0.03439456076496927,0.33599695466167745,0.3016023938967082,353356244,371279670,47.87605794285329,45.988862759895305,NaN,NaN,19.75779150631118,15.677690022908047
2012-01-04T09:30:00-05:00,32.39999,32.45,32.28999,32.39,6855145,6241870,58.20943584680775,58.50782227029214,NaN,NaN,56.00065968500288,110.74069526767278,0.014618039736760013,0.3198749435676582,0.3052569038308982,346501099,365027298.8,39.20526743495971,44.67765353001634,NaN,NaN,19.36620336243061,16.2046204999827
2012-01-05T09:30:00-05:00,32.33,32.39999,32.17,32.37,4562965,6170371.35,57.770765660104836,58.94396290341667,NaN,NaN,40.12330043212467,88.42527442091172,-0.00260312450717215,0.302002998196933,0.30460612270410514,341938134,358591749.4,32.650519906686284,43.43349452414124,NaN,NaN,18.92327680349138,16.592999971912512
2012-01-06T09:30:00-05:00,32.42,32.42,32.10001,32.16,6365906,6191104.95,53.23437092184824,58.739543836859525,NaN,NaN,21.90051194178777,64.33800459366509,-0.02943930181596449,0.26780699543414954,0.29724629725011403,335572228,350296364.2,26.500216024314838,41.91985263634877,NaN,NaN,17.320271641631077,16.69689592472945
2012-01-09T09:30:00-05:00,32.24001,32.25,32.12,32.21001,3304818,6095582.75,54.157564219829375,58.96113081877779,NaN,NaN,12.288423343762085,45.78418393369349,-0.04423485738782512,0.24195272551533265,0.28618758290315777,338877046,343248950.2,22.604561231045352,40.57150757798386,NaN,NaN,16.18766864925494,16.624149171090234
2012-01-10T09:30:00-05:00,32.44,32.44,32.28999,32.32001,5053559,6154010.35,56.20545321673226,59.46695873847733,NaN,NaN,39.359746390812816,33.934528358698046,-0.04677873520879888,0.22771416389215915,0.27449289910095803,343930605,341363822.4,21.686206765396946,39.50176288873994,NaN,NaN,15.718572299111303,16.494781046521815
2012-01-11T09:30:00-05:00,32.17999,32.28,32.10001,32.17999,5383953,6128685.15,52.96215807123438,59.126176917277505,NaN,NaN,2.8743718030421457,23.309270782305894,-0.05735921859881221,0.2027938758524428,0.260153094451255,338546652,339772933,20.913997195272913,38.48252186968565,NaN,NaN,14.451659919653792,16.202906599826385
2012-01-12T09:30:00-05:00,32.25999,32.32001,32.08,32.17,4733008,6042290.05,52.72837529809551,58.505935729315816,NaN,NaN,-2.256601999618535,14.83329029595725,-0.06399330015388527,0.18016146925889842,0.2441547694127837,333813644,338148035,20.125728998215934,37.183869719695,NaN,NaN,13.321275587748657,15.791245026672424
2012-01-13T09:30:00-05:00,32.09,32.17999,31.94,32.14,5588977,6039082.45,51.98625246441923,57.844756370285914,NaN,NaN,-37.55728020884314,2.941731865831075,-0.06893722175332434,0.15798324222112825,0.2269204639744526,328224667,336678522.8,19.413099784796245,35.90895560468689,NaN,NaN,12.164435093857147,15.273129321984527
2012-01-17T09:30:00-05:00,32.41,32.42,32.25999,32.25999,6746422,6014200.4,54.73063286758341,57.2031148319223,NaN,NaN,17.966598720803894,4.077366941239437,-0.06283348202778227,0.14837861143972475,0.21121209346750702,334971089,335897331.4,19.027390430086697,34.2821674551513,NaN,NaN,11.81234366366577,14.778731370796134
2012-01-18T09:30:00-05:00,32.25,32.36,32.17999,32.33,5147078,5803227.95,56.30012313132581,56.62798462167249,NaN,NaN,0.3660592727510969,-3.721370482372907,-0.05317164695702967,0.14474753477121993,0.1979191817282496,340118167,335134843.8,18.63814108088961,32.114597891471746,NaN,NaN,11.896713044002553,14.36701446696848
2012-01-19T09:30:00-05:00,32.36,32.46001,32.22,32.39,5962188,5869894.6,57.655097851295295,56.3707209774151,NaN,NaN,11.070568849607065,-2.0821310730599243,-0.04230378189137454,0.14503945436403143,0.18734323625540597,346080355,336641584.4,22.032461806133895,29.96547333325237,NaN,NaN,12.308570259753933,14.072951008794973
2012-01-20T09:30:00-05:00,32.34,32.45,32.24001,32.39999,11017707,6117569.6,57.88922036721176,55.9858241223366,NaN,NaN,3.9016079425373666,-0.8504890846287427,-0.0343448145260519,0.1444122180978411,0.178757032623893,357098062,341298468,31.538892938294012,28.395323336302177,NaN,NaN,12.719120431405662,13.8795466405965
2012-01-23T09:30:00-05:00,32.31,32.39999,32.21001,32.37,21798704,6803769.65,56.8726414255715,55.74175670830698,NaN,NaN,-20.178326855080453,2.6253015861237943,-0.031099461525332855,0.13988270571722694,0.1709821672425598,335299358,342713406.2,34.16543539108048,26.884141209287577,NaN,NaN,12.83570812786124,13.730426853062891
2012-01-24T09:30:00-05:00,32.21001,32.265,32.16,32.19,5885227,6891250.15,51.07522592351611,55.126951233255404,NaN,NaN,-81.60520776486624,-17.289059711010232,-0.040481043243144665,0.12038086318862895,0.16086190643177362,329414131,341602014.6,33.09151645946079,25.828102531902402,NaN,NaN,11.46723053933056,13.407113093958273
2012-01-25T09:30:00-05:00,32.09,32.60001,32.07001,32.56,7762012,7017966.2,60.08275190930868,55.26075952343405,NaN,NaN,33.15286939171638,-10.731697687217174,-0.022093165416439436,0.1332454496612243,0.15533861507766375,337176143,341013609.8,32.50890284143952,25.349790775222385,NaN,NaN,12.729350580470317,13.310289877745708
2012-01-26T09:30:00-05:00,32.64999,32.71001,32.345,32.44,6762441,7160168.35,56.45259960905692,55.166604805502054,NaN,NaN,92.14265073806739,5.482718690474892,-0.01848415174894444,0.1322334253914832,0.15071757714042763,330413702,337880279.2,29.527595551748377,25.126724749869677,NaN,NaN,12.75068373250638,13.230346142711518
2012-01-27T09:30:00-05:00,32.3,32.395,32.10001,32.22,5682176,7261923.45,50.43611544196455,54.96672941408179,NaN,NaN,-57.6619043249514,-6.829983763022862,-0.03066707154330392,0.11238373771129773,0.14305080925460165,324731526,331406972,24.523825651827693,24.985554008977736,NaN,NaN,10.928097056669682,12.901453416134112
2012-01-30T09:30:00-05:00,32.08,32.12,31.89,32.00999,9644191,7597469.35,45.455869611667275,54.345179799213064,NaN,NaN,-180.97873598782292,-38.99006558957136,-0.05140198558312786,0.0787983272756918,0.13020031285881967,315087335,327364567.4,22.014918580414417,24.943436676789812,NaN,NaN,7.758631266052757,12.166764537551062
2012-01-31T09:30:00-05:00,32.16,32.17,31.84,32.03,5874352,7744435.05,46.00297473584061,53.61643133629224,NaN,NaN,-154.34928742173986,-53.53888152094608,-0.06161367092551698,0.05318322420192345,0.11479689512744043,320961687,325674078.6,21.04528346068841,24.8976564407392,NaN,NaN,5.372562505219431,11.196164247217972
2012-02-01T09:30:00-05:00,32.16,32.41,32.16,32.25999,9538941,7183488.5,51.966627987957885,53.54532204462963,NaN,NaN,10.354808372905994,-58.098493724708156,-0.05115342390188264,0.050855115250087124,0.10200853915196977,330500628,324338975.6,20.28537471077732,24.8527548347038,NaN,NaN,5.0936322016736275,10.324373954997352
2012-02-02T09:30:00-05:00,32.31,32.41,32.26601,32.38,5452324,7113347.45,54.77353702833703,53.69140502536117,NaN,NaN,61.93204901041522,-64.14061407023858,-0.035186831253141496,0.0580250000855429,0.0932118313386844,335952952,325446825.6,22.77711937594296,25.0421398616843,NaN,NaN,5.724735418504044,9.667282735498308
2012-02-03T09:30:00-05:00,32.48,32.64999,32.41,32.48,6662375,7218317.95,57.02698894760471,54.05145763130299,NaN,NaN,150.02109815783493,-22.60401357368132,-0.017802756559421443,0.0709583856394076,0.08876114219882904,342615327,329023585.8,30.347155166643745,25.823143817530553,NaN,NaN,6.937158631138332,9.277265006304026
2012-02-06T09:30:00-05:00,32.41,32.53,32.37,32.46001,7379906,7269017.95,56.42178745550822,54.17225438758333,NaN,NaN,101.20815682964682,33.83336498981263,-0.008058438900515705,0.0786880935731844,0.08674653247370011,335235421,333053203,37.75078146271538,27.16052889128974,NaN,NaN,7.751891120460426,9.059354451183511
2012-02-07T09:30:00-05:00,32.38,32.58,32.37,32.49001,11209383,7664246.2,57.15663336864967,54.23343369024932,NaN,NaN,105.4515236206551,85.79352719829163,-0.0004047743511844809,0.08624056453471951,0.08664533888590399,346444804,338149826.4,45.62343018773278,29.08804954177854,NaN,NaN,8.63394618533412,8.998581841776454
2012-02-08T09:30:00-05:00,32.58,32.58,32.38499,32.5,4694691,7646302.8,57.414159327136844,54.21622379566658,NaN,NaN,100.87379021411121,103.89732356653266,0.004261222698611608,0.0919718672591685,0.0877106445605569,351139495,342277599.8,51.02566553798139,31.15899266548193,NaN,NaN,9.43786857022775,9.061337088698068
2012-02-09T09:30:00-05:00,32.53,32.72,32.46001,32.67999,5976199,7675915.1,61.86212553248261,54.50000273604307,NaN,NaN,152.1044794040537,121.93180964526036,0.017649299025409335,0.10977226834231857,0.09212296931690923,357115694,346510148.2,55.867309657607564,32.89673671686147,NaN,NaN,11.42884556313399,9.399552585046056
2012-02-10T09:30:00-05:00,32.5201,32.61,32.48,32.61,4576395,7668084.45,59.269728636618616,54.671223251117866,NaN,NaN,112.16811848510226,114.36121371071383,0.019809014660775393,0.11688423764287847,0.09707522298210308,352539299,348494942.6,57.96588472210262,34.59676881193448,NaN,NaN,12.417700061321227,9.830716510228223
2012-02-13T09:30:00-05:00,32.71001,32.78999,32.67999,32.75,5427340,7660002.6,62.642103153660166,55.49742876755672,NaN,NaN,174.81876442332296,129.08333522944903,0.028173717955595506,0.13229237042659747,0.10411865247100197,357966639,353041186.2,62.37873652003002,36.68871310197515,NaN,NaN,14.261300339111301,10.46365705721152
2012-02-14T09:30:00-05:00,32.62,32.85001,32.62,32.83,4678656,7556614.3,64.45329510198343,55.809610424176356,NaN,NaN,158.04470603881487,139.601971713081,0.03609582230479258,0.1492384303519927,0.11314260804720011,362645295,356281284.4,65.18407651945842,39.02265407897649,NaN,NaN,16.35500985453077,11.305278885399984
2012-02-15T09:30:00-05:00,32.92,33,32.73,32.82001,5330363,7565778.55,64.03578691536427,56.35126666034116,NaN,NaN,164.81401169586366,152.39001600943146,0.03750000316138502,0.16001761199893139,0.12251760883754637,357314932,357516371.8,66.21816930882417,41.64340934733905,NaN,NaN,17.97771094123262,12.258483464804646
2012-02-16T09:30:00-05:00,32.84,33.07001,32.82001,33.03,4185855,7476961.9,68.6349948277365,57.65118661646773,NaN,NaN,178.72238652333039,157.71359743328682,0.048698405959107655,0.18339061628643094,0.1346922103273233,361500787,358393390.4,66.96842055830332,44.67516612637302,NaN,NaN,20.836292572714544,13.483884765934631
2012-02-17T09:30:00-05:00,33.10001,33.2,32.99001,33.06,3525986,7102375.85,69.24020093144549,59.350067425023326,NaN,NaN,181.0177097020862,171.4835156766836,0.05385106371638784,0.20200603997280808,0.14815497625642024,365026773,360890885.2,69.0747088579928,48.03657971762862,NaN,NaN,23.379792073365138,14.897585809853275
2012-02-21T09:30:00-05:00,33.07001,33.07001,32.82001,32.87,5557949,6290338.1,61.187563830205924,60.4346809317637,NaN,NaN,113.27639077767454,159.17504094755392,0.04078163126681125,0.1991320153399343,0.15835038407312305,359468824,361191322.2,69.32808335382151,51.48535113856669,NaN,NaN,23.309980110765636,16.099356424269327
2012-02-22T09:30:00-05:00,32.87,32.88,32.7,32.78,3682344,6180193.95,57.76078193366183,60.84854907074255,NaN,NaN,66.89834546617942,140.94576883302685,0.02326488373618149,0.18743148874334992,0.16416660500716843,355786480,359819559.2,66.64326018762543,54.79662867262727,NaN,NaN,22.233899174802914,16.975719674345555
2012-02-23T09:30:00-05:00,32.71001,33,32.7,32.95,4279930,6006089.85,62.08069284463544,61.37048877190672,NaN,NaN,83.9756108462372,124.77808866310156,0.02041846933872707,0.18968969168057725,0.16927122234185019,360066410,360369854.8,67.19215091020155,57.96913092507432,NaN,NaN,22.59052079154619,17.777834119659932
2012-02-24T09:30:00-05:00,33,33.08,32.97,33.06,4660375,5900986.55,64.60330281685788,61.911654048281946,NaN,NaN,109.83460909760798,111.00053317795707,0.023040751632843942,0.1980721618829051,0.17503141025006116,364726785,361015054.4,67.85992853571875,60.64861473715111,NaN,NaN,23.661230190319827,18.618319272611345
2012-02-27T09:30:00-05:00,32.95,33.12,32.85001,33.06,5544797,5894117.6,64.60330281685788,62.49604800266406,NaN,NaN,93.18371175412355,93.43373358836455,0.021880785142419534,0.20238239167808558,0.18050160653566605,364726785,360955056.8,67.72188768336551,62.789408038626114,NaN,NaN,24.52239678513458,19.46175891725752
2012-02-28T09:30:00-05:00,33.07001,33.17999,33.00999,33.17,4875746,5655695.35,67.13868817508413,63.20905191740938,NaN,NaN,112.59023466376617,93.29650236558287,0.02538105803293264,0.21222792907683186,0.18684687104389922,369602531,362981798.2,69.94594728769232,64.52673068862323,NaN,NaN,26.007572774533074,20.396875182582598
2012-02-29T09:30:00-05:00,33.14,33.35001,33.13,33.23,12843348,6004145.15,68.46550323079967,63.99843362481387,NaN,NaN,136.981742339638,107.31318174027459,0.02837005683853569,0.22230944209206882,0.19393938525353313,382445879,368313678,74.85461163278782,66.22879826682369,NaN,NaN,27.64036556977767,21.431659523610467
2012-03-01T09:30:00-05:00,33.25,33.3,32.8667,33.17999,7828852,5918640.7,66.0709402230575,64.29906324556922,NaN,NaN,94.35930000187153,109.38991957140145,0.023796668401481674,0.22368522075538522,0.19988855235390354,374617027,371223801.4,77.05714960091969,67.74235826277456,NaN,NaN,28.350094677497705,22.420007402737216
2012-03-02T09:30:00-05:00,33.14999,33.27499,33.13,33.21001,4036404,5847844.7,66.82110201138269,64.83844705805237,NaN,NaN,111.53728204330905,109.73045416054167,0.0197761569420159,0.22460874853142343,0.20483259158940753,378653431,374009130.6,78.95701250731445,69.24172453314682,NaN,NaN,29.15018679380835,23.381461601461663
2012-03-05T09:30:00-05:00,33.19,33.41,33.17999,33.36,6070527,5818252.3,70.34858434107939,65.3889100000109,NaN,NaN,132.02022105314103,117.49775602034518,0.023924071181614298,0.2347376805664254,0.2108136093848111,384723958,378008565.2,81.3457061544209,70.59650807846046,NaN,NaN,30.885943875852206,24.45353049780317
2012-03-06T09:30:00-05:00,33.16,33.27,33.07001,33.08,9765871,5937550.55,57.96023515562174,64.9251200038422,NaN,NaN,71.80892774868946,109.34149463732983,0.00547887081961268,0.21766219790932695,0.21218332708971427,374958087,379079676.4,81.93707940279525,71.79315114155595,NaN,NaN,28.57199599430605,25.041882711589295
2012-03-07T09:30:00-05:00,33.14999,33.16499,32.98129,33.13,7278738,5741018.3,59.33728942946859,64.58951304056393,NaN,NaN,50.54978035044596,92.0551022394914,-0.00511298658610948,0.20579209385707742,0.2109050804431869,382236825,379037865.6,81.82802993341556,72.90814118616962,NaN,NaN,27.1111797045923,25.337496567732583
2012-03-08T09:30:00-05:00,33.24001,33.39999,33.24001,33.36,5795445,5796056,65.0143467792975,64.33089532281826,NaN,NaN,127.12688097793217,98.60861843470354,0.0012715549139128979,0.212494524085578,0.2112229691716651,388032270,381720914.2,83.35861441533926,74.07886931881505,NaN,NaN,27.641719174389685,25.666671225826455
2012-03-09T09:30:00-05:00,33.37,33.49001,33.31,33.47,5234195,5758955.8,67.36132474323855,64.19668988080348,NaN,NaN,147.90930771930397,105.88302356990252,0.010300868356193732,0.22409905461690727,0.21379818626071354,393266465,384643521,84.85502379826798,75.20603467169185,NaN,NaN,28.84116752671658,26.120170697382186
2012-03-12T09:30:00-04:00,33.39,33.64,33.39,33.59,7409551,5900613.6,69.74572428437843,64.80798705610152,NaN,NaN,176.66496555773256,114.81197247082082,0.021129240958791706,0.24020973745920315,0.21908049650041145,400676016,387833932.6,86.30295772452628,76.41852569817077,NaN,NaN,30.613319837005648,26.762049145899823
2012-03-13T09:30:00-04:00,33.69,33.84,33.63,33.84,5126188,5885556,74.00621374904388,65.96837504291453,NaN,NaN,221.72141561847798,144.7944700447785,0.04076572628679212,0.2700376543589016,0.22927192807210947,405802204,394002756,88.57700915600573,77.98522205305507,NaN,NaN,33.6486573636455,27.74585031986349
2012-03-14T09:30:00-04:00,33.8,33.84,33.67,33.74001,5727434,5937994.9,69.7739999490851,66.51789697894664,NaN,NaN,177.739107415372,170.23233545776375,0.04246513152512474,0.2823533424785154,0.23988821095339066,400074770,397570345,89.64748420796799,79.58917443146696,NaN,NaN,34.70165967817525,28.739537371050883
2012-03-15T09:30:00-04:00,33.71001,33.82001,33.63,33.8,5293324,5936142.95,70.85103426281714,66.96416351080087,NaN,NaN,150.69996173036526,174.94695160825034,0.04294560006449455,0.2935702110340088,0.25062461096951427,405368094,401037509.8,90.57216734710043,81.2114772037085,NaN,NaN,35.88884028340175,29.76086635852958
2012-03-16T09:30:00-04:00,33.69,33.69,33.55,33.60001,5354277,5994564.05,62.81525349641028,66.83644570219747,NaN,NaN,97.30073551394098,164.82523716717776,0.02594767779205187,0.2830592082095791,0.2571115304175272,400013817,402386980.2,90.91239532557871,82.86794203529517,NaN,NaN,34.27521652285371,30.405773524861598
2012-03-19T09:30:00-04:00,33.58,33.66,33.49001,33.62,4210090,6028769.25,63.263756981267186,66.55966490263911,NaN,NaN,80.55707289947338,145.60365863552593,0.012865167624964369,0.27319298994873265,0.2603278223237683,404223907,403096558.4,91.09438373216283,84.37854463847164,NaN,NaN,33.13723037393293,30.795981646157504
2012-03-20T09:30:00-04:00,33.48,33.66,33.45,33.60001,4792891,5990516.35,62.45254229926831,66.13016769324402,NaN,NaN,67.81561442532696,114.82249839689571,0.0003418161933596009,0.2607550925654678,0.2604132763721082,399431016,401822320.8,87.69798442777065,85.29592840954183,NaN,NaN,31.978932575727924,30.964974636096134
2012-03-21T09:30:00-04:00,33.56,33.72,33.53999,33.64999,4171074,6014952.85,63.705648851060275,65.96121830952993,NaN,NaN,76.70975863299027,94.61662864041936,-0.006710027730584822,0.25202574170887715,0.25873576943946197,403602090,402527784.8,87.96550918871475,86.07509695152719,NaN,NaN,31.366210436339532,31.022294036130905
2012-03-22T09:30:00-04:00,33.58,33.74001,33.48,33.67999,5471000,6074506.35,64.47210381521643,65.79343272408947,NaN,NaN,68.28393901353499,78.13342409705331,-0.011222550850897683,0.24470758087583988,0.25593013172673756,409073090,403268784,88.25443685011459,86.73919869029864,NaN,NaN,31.065632629840255,31.02848526380367
2012-03-23T09:30:00-04:00,33.72,33.77,33.60201,33.75999,3105865,5996780.85,66.50352565970466,65.51878567541986,NaN,NaN,82.4944248173763,75.17216195774036,-0.010690461313397959,0.2425670550849901,0.25325751639838806,412178955,405701811.6,89.17353532555569,87.29832934537968,NaN,NaN,31.364721911776133,31.07651907065688
2012-03-26T09:30:00-04:00,33.82001,34.02,33.8,33.99001,5562297,5997655.85,71.54196300390728,66.48890909315455,NaN,NaN,134.9480892295974,86.05036522376516,0.00257389234455202,0.25647488182907807,0.25390098948452605,417741252,408405280.6,90.10049476823367,87.881430442911,NaN,NaN,33.17422088440172,31.37619075833471
2012-03-27T09:30:00-04:00,34.10001,34.13,33.96001,33.97,3310542,5919395.65,70.54782524872971,67.28966165167319,NaN,NaN,145.76079892596718,101.63940212389319,0.007161046245575231,0.26285229729149506,0.25569125104591983,414430710,411405219.4,91.0193700243471,88.5379547351204,NaN,NaN,34.35907333970046,31.80231684138696
2012-03-28T09:30:00-04:00,33.95,33.98,33.8,33.89,3537152,5454085.85,66.56527704657981,67.4004423850505,NaN,NaN,100.2563185785875,106.34871411301265,0.002224290131497386,0.2584716137102916,0.2562473235787942,410893558,412863513,91.43553046465728,89.11487731007166,NaN,NaN,34.226081055074495,32.14856887191375
2012-03-29T09:30:00-04:00,33.78,33.899,33.64,33.875,5045387,5314912.6,65.81505706331995,67.28999469362773,NaN,NaN,70.33509425244077,106.75894516079379,-0.004279996817129539,0.25089732755738225,0.2551773243745118,405848171,412218529.2,89.46094474432579,89.44387166336152,NaN,NaN,33.90880376786053,32.40003099990615
2012-03-30T09:30:00-04:00,33.95,34.145,33.92,34.08,3775722,5301878.5,70.67879324436822,67.35664247648415,NaN,NaN,137.39490658487583,117.73904151429369,0.0026238247633238454,0.2584571053286666,0.25583328056534277,409623893,411707516.8,87.84237145044867,89.55382978664169,NaN,NaN,35.0631875687527,32.7804819383128
2012-04-02T09:30:00-04:00,34.08,34.4187,34.08,34.35001,9978805,5497292.4,75.6024902736757,67.47066222824357,NaN,NaN,184.0478012323804,127.5589839148503,0.021712485373710178,0.2829738872824805,0.26126140190877034,419602698,412079806,88.0125324457699,89.51351002162484,NaN,NaN,37.77279100570118,33.49366894793972
2012-04-03T09:30:00-04:00,34.24001,34.35001,34.03,34.16,4460883,5232043,67.06750242143036,67.27734097626823,NaN,NaN,140.25007006251252,126.45683814215936,0.01803081904123338,0.2837999257103121,0.2657691066690787,415141815,412222027,88.0811622921664,89.40162988478187,NaN,NaN,37.20725069255719,34.02418062574221
2012-04-04T09:30:00-04:00,34,34.2,33.98,34.05,5436121,5139912.15,62.65748148412253,66.69208720636148,NaN,NaN,98.802127130759,126.16599985259367,0.005335107346517209,0.2724379908522252,0.267102883505708,409705694,411984454.2,87.18324510616114,89.15956401042908,NaN,NaN,35.272656521952904,34.20253432520088
2012-04-05T09:30:00-04:00,33.98,34.07001,33.88,34.05,4562586,5078269.2,62.65748148412253,66.68081777691235,NaN,NaN,64.70468809640916,125.03991862138734,-0.005337119933347512,0.26043148358902357,0.2657686035223711,409705694,412755958.8,87.62445384753681,88.9247110477118,NaN,NaN,33.7647892633386,34.13999931636341
2012-04-09T09:30:00-04:00,33.75999,33.82001,33.7,33.74001,2747655,4953942.2,51.573842467095005,65.84582388304291,NaN,NaN,-27.407038115610984,92.07952968128998,-0.03395228382528037,0.22332824874077062,0.257280532566051,406958039,412222788,85.43559676207953,88.52051197842013,NaN,NaN,28.553589323878192,33.341940746008376
2012-04-10T09:30:00-04:00,33.7,33.71001,33.42,33.44,7105406,4938734.95,43.54550686520779,64.49532135203857,NaN,NaN,-111.3159278417832,33.0067838664573,-0.0715993941900944,0.167781289828433,0.23938068401852738,399852633,408272775,71.23784148361015,87.34478748240868,NaN,NaN,21.008243591021365,31.57998400958166
2012-04-11T09:30:00-04:00,33.62,33.735,33.50999,33.605,14575520,5411201.55,48.31119297893336,63.39571736117237,NaN,NaN,-71.8697785807944,-9.41718586220409,-0.08309498853773192,0.1355119483463625,0.2186069368840944,414428153,408130042.6,70.7801204677852,86.11725971662797,NaN,NaN,16.59769306973715,29.439656732461017
2012-04-12T09:30:00-04:00,33.58,33.66,33.47,33.63499,2666451,5258152.4,49.15139394941992,62.3013809421869,NaN,NaN,-76.42184556147076,-44.46198040065004,-0.0860233337383429,0.11107776971116579,0.19710110344950868,417094604,409607824.6,72.73352245556576,85.0086229741602,NaN,NaN,13.487491986143722,27.160776054415688
2012-04-13T09:30:00-04:00,33.59,33.81,33.59,33.63,5539367,5270454.55,49.00864657055172,61.051746721533114,NaN,NaN,-44.213551571730704,-66.24562833427801,-0.08546466175654091,0.09027027625383255,0.17573493801037346,411555237,409977733.2,73.21619677098441,83.86881307740511,NaN,NaN,11.015674010281336,24.85433290525364
2012-04-16T09:30:00-04:00,33.74001,33.8786,33.64,33.77,5805586,5293020,53.12215259604869,59.736045978114646,NaN,NaN,-18.17681763822259,-64.39958423880033,-0.07330196713920839,0.08410747908636296,0.15740944622557135,417360823,412058290,75.8099666980244,82.84806107239017,NaN,NaN,10.185982981869977,22.75885434477026
2012-04-17T09:30:00-04:00,33.98,34.2,33.9115,34.11,5715859,5368308.45,61.289483151938235,59.074735828343826,NaN,NaN,79.98742946299748,-26.13891277784419,-0.041573081716836546,0.10544309407952568,0.14701617579636223,423076682,416703099.8,80.37839467335746,82.08799140446233,NaN,NaN,12.228421250843853,21.25450675992363
2012-04-18T09:30:00-04:00,34.06,34.17999,34.00999,34.12,6362926,5446810.2,61.501933358854345,58.71306842207772,NaN,NaN,81.05848250714807,4.446739439744306,-0.020208843158538825,0.12175512184818871,0.14196396500672753,429439608,419705390.8,82.65818264018176,81.46103798842839,NaN,NaN,13.876422541605942,20.20049472873539
2012-04-19T09:30:00-04:00,34.16,34.16,33.87,34,6953938,5585953.4,57.428841774097364,58.114053044276105,NaN,NaN,44.207906332228205,28.5726898184841,-0.01471114940092949,0.12357502825556566,0.13828617765649515,422485670,420783604,83.40394642976321,81.02839525167391,NaN,NaN,13.978396393037398,19.311623537921392
2012-04-20T09:30:00-04:00,34.08,34.37,34.03,34.31,5243313,5574569.05,64.05213059286314,57.64071999774003,NaN,NaN,112.58739367385213,59.932878867600664,0.008028628397222487,0.14832196315302326,0.14029333475580077,427728983,424018353.2,85.42850951794196,80.85597654220915,NaN,NaN,16.32944207035743,18.885597613983684
2012-04-23T09:30:00-04:00,34,34.02,33.7,33.78,5378168,5688184.2,49.78962208577589,55.79694369860432,NaN,NaN,-31.74208375572265,57.21982564410065,-0.013241782765553822,0.12374110629885848,0.1369828890644123,422350815,425016351.6,85.99611795818285,80.71194693595292,NaN,NaN,13.061624048281903,18.053601390312
2012-04-24T09:30:00-04:00,33.86,33.96001,33.75999,33.78999,5679500,5694044.35,50.01555086115646,54.57894715858477,NaN,NaN,-28.19707375760553,35.582924999980044,-0.026490816662788547,0.10386936823592663,0.13036018489871518,428030315,426007078.2,86.55598204921935,80.60300549002811,NaN,NaN,10.731470212151834,17.007582650574832
2012-04-25T09:30:00-04:00,33.89999,34.08,33.86,34.00999,5500457,5803540.1,54.835246146423565,54.020216063034844,NaN,NaN,24.905040919280143,24.352236682406453,-0.02055494493194676,0.10466650373378172,0.12522144866572849,433530772,426825311,87.01761458697129,80.59117473865741,NaN,NaN,10.495487496744454,16.07728334288478
2012-04-26T09:30:00-04:00,34.05,34.38989,34,34.32001,4135023,5833433.65,60.600600306953034,53.873295978951305,NaN,NaN,102.4411811836888,35.99889165269858,0.0028862007427035985,0.128829199594108,0.1259429988514044,437665795,429861336,88.58398668066496,80.65971279816657,NaN,NaN,12.385203275322311,15.549843333232998
2012-04-27T09:30:00-04:00,34.32001,34.37,34.25,34.27,4870906,5824709.6,59.28589164287417,54.4241566343641,NaN,NaN,110.43596742022339,35.56860640197283,0.01308763766131954,0.1423025459280538,0.12921490826673426,432794889,430874517.2,89.05843231316985,80.9184867661016,NaN,NaN,13.394191481498504,15.241893068699499
2012-04-30T09:30:00-04:00,34.24001,34.24001,34.10001,34.17999,5605492,5916198.1,56.89349173059247,55.377584124748715,NaN,NaN,66.80760807213163,55.27854476754369,0.011873369520786298,0.14405662016771714,0.13218325064693084,427189397,431842233.6,89.5069894368138,82.22342590561614,NaN,NaN,13.431669066324789,14.983289639788826
2012-05-01T09:30:00-04:00,34.17999,34.41,34.09,34.27,5090988,5671807.25,58.688783695498884,56.118840604503404,NaN,NaN,94.06208256472334,79.73037603200946,0.015029006580136672,0.1509695088721017,0.13594050229196503,432280385,432692247.6,89.89871116103201,83.58903952656235,NaN,NaN,14.022726417071821,14.846066322257824
2012-05-02T09:30:00-04:00,34.25999,34.39999,34.16,34.3,10754941,5986510.15,59.29724259776992,56.84354407938554,NaN,NaN,99.87346990853115,94.72406182985966,0.016894239698786645,0.15705830191544834,0.1401640622166617,443035326,434593158.4,90.73197949169884,84.87464360057184,NaN,NaN,14.678774719865215,14.822167521916024
2012-05-03T09:30:00-04:00,34.35001,34.44,34.261,34.35001,2322616,5830834.9,60.34575421106075,57.65333748227904,NaN,NaN,109.83386302565845,96.20259819825358,0.01909138008782693,0.16402828732644537,0.14493690723861843,445357942,436131587.8,91.35362482645182,86.17017417596237,NaN,NaN,15.52089938051521,14.921986358858765
2012-05-04T09:30:00-04:00,34.32001,34.37,34.08,34.08,4986215,5852016.35,52.4845580115448,57.60779501195734,NaN,NaN,53.89290455805471,84.89398562581985,0.0009149339020989578,0.14608057461624213,0.14516564071414317,440371727,437646955.4,91.92795838712823,87.32145929661263,NaN,NaN,13.903056496050617,14.776424949886172
2012-05-07T09:30:00-04:00,34,34.2,34,34.13,4204621,5924864.65,53.687689796468746,57.064809772280945,NaN,NaN,30.889780258775065,77.71042006314853,-0.008658237023669552,0.13434284443455624,0.1430010814582258,444576348,441124345.6,93.06617091814115,88.2277290283829,NaN,NaN,12.930379799741637,14.512704214151238
2012-05-08T09:30:00-04:00,33.98,34.10001,33.895,34.05,8638684,6001528.55,51.44323251818265,56.346331140804395,NaN,NaN,-5.509394222021108,57.79612470579965,-0.02061376267352763,0.11723387811631625,0.13784764078984388,435937664,441855801.4,93.28079440478263,88.98648701156867,NaN,NaN,11.468131354258729,14.077765234166595
2012-05-09T09:30:00-04:00,33.89999,34.10001,33.78,33.88,6841316,5614818.35,46.95135057004632,55.59793891194361,NaN,NaN,-47.03139295443518,28.41515213320638,-0.03913238050914794,0.08893216515340896,0.1280645456625569,429096348,439068005.8,82.76572462318599,88.9408997396703,NaN,NaN,8.85751666741721,13.332015438916683
2012-05-10T09:30:00-04:00,34.03999,34.22,34.03999,34.12,3172046,5640098.1,53.16842227604469,54.820531175028,NaN,NaN,22.992202880133355,11.04682010410136,-0.03453940805498787,0.08489028559382206,0.11942969364880993,432268394,436450096.2,74.29609687806922,88.14572740825083,NaN,NaN,8.42932737047324,12.631631429139048
2012-05-11T09:30:00-04:00,34.05,34.22,34,34.03,3289586,5527609.05,50.76573010955472,54.890253176726496,NaN,NaN,-5.16923370251065,-0.7656075480117105,-0.036682416520936706,0.07357667299763904,0.11025908951857574,428978808,434171512.4,67.79336243458869,86.84553058513697,NaN,NaN,7.351175052337398,11.877280518167384
2012-05-14T09:30:00-04:00,33.85001,34.00999,33.75,33.89,6937902,5584224.85,47.19306160391087,54.688646801208954,NaN,NaN,-114.64305213626079,-29.87217402701889,-0.04604234382858079,0.052706159732849756,0.09874850356143054,422040906,429664424,57.14001430818127,84.74439003220569,NaN,NaN,5.35179511164067,10.945068317234997
2012-05-15T09:30:00-04:00,33.81,34.07001,33.78999,33.85001,3297389,5463301.35,46.19304608786171,54.07134679702596,NaN,NaN,-92.61540136096627,-47.29337545480793,-0.052947688821830624,0.03256389253414227,0.0855115813559729,418743517,426225594.6,50.60573200247061,82.14354127616991,NaN,NaN,3.425441407776465,9.870835901598063
2012-05-16T09:30:00-04:00,33.91,34.07851,33.88361,33.96001,4610645,5375687.3,49.37104341267608,53.26923559029189,NaN,NaN,-52.51354203639769,-48.38980527120043,-0.04825986968945084,0.025186744244159343,0.07344661393361018,423354162,425077157.4,48.60663260736455,79.28801598521987,NaN,NaN,2.692411251836648,8.84534666591786
2012-05-17T09:30:00-04:00,33.99001,34.03999,33.71001,33.72,5266938,5291337.3,43.35421309930829,52.131258551465756,NaN,NaN,-111.58905548111831,-75.30605694345077,-0.05877824961303153,-0.00002619808267922963,0.0587520515303523,418087224,422240923.4,43.985352972393606,76.06851031802158,NaN,NaN,0.192250564286713,7.609190079970554
2012-05-18T09:30:00-04:00,33.77,33.81,33.45,33.52,7303246,5394333.95,39.08018466367977,50.85887947525771,NaN,NaN,-180.0323601603778,-110.27868223502419,-0.07558887740563926,-0.035734045226696765,0.03985483217894249,410783978,418601957.4,38.87804804142054,72.45215736120778,NaN,NaN,-3.3302402198189798,6.046414322857763
2012-05-21T09:30:00-04:00,33.62,33.67,33.42,33.64999,4944938,5372672.45,43.012516930668625,49.739146134912694,NaN,NaN,-167.55795016573805,-120.86166184091965,-0.07423065014946514,-0.05293348050788893,0.021297169641576207,415728916,417339559.4,37.261648371014054,68.69236716192079,NaN,NaN,-5.064627167646892,4.4591226813570985
2012-05-22T09:30:00-04:00,33.64999,33.82001,33.58,33.69,4275406,5302467.75,44.20628564886294,48.6612206385622,NaN,NaN,-116.98741814154751,-125.7360651970359,-0.06712886377836626,-0.06261391008138162,0.004514953696984639,420004322,417591720.4,37.817779025578986,64.91278141434078,NaN,NaN,-6.116335041404315,2.9483430066768967
2012-05-23T09:30:00-04:00,33.62,33.7,33.36,33.60001,6277457,5341317.75,42.07157099522983,47.35592183743141,NaN,NaN,-143.08169205531766,-143.84969520081987,-0.06494270923895568,-0.07666343285170996,-0.01172072361275428,413726865,415666261,35.24842153261619,60.90526689335253,NaN,NaN,-7.623571261950489,1.4380695397301275
2012-05-24T09:30:00-04:00,33.64,33.92999,33.63,33.92,6473199,5458226.55,51.11192752153541,47.257876802430744,NaN,NaN,-50.08329376912812,-131.54854285842183,-0.03964019595055661,-0.061270968550950045,-0.021630772600393436,420200064,416088829,36.27173231938025,56.929822174227674,NaN,NaN,-6.137918682617644,0.35578550796616026
2012-05-25T09:30:00-04:00,33.92999,34.03,33.82001,33.89,2864500,5357906.25,50.31906857220867,47.01726100069788,NaN,NaN,-16.91673605040994,-98.92541803642824,-0.023420392528165513,-0.050906263260600326,-0.027485870732434813,417335564,417399146.2,39.466347778081975,53.10126337850917,NaN,NaN,-5.186605918193584,-0.435984695770946
2012-05-29T09:30:00-04:00,33.97,34.13,33.92999,34.13,3345322,5244897.75,56.1758836468883,47.35530750989114,NaN,NaN,37.88290170488246,-57.83724766230415,0.0035404244569866433,-0.02306034016120151,-0.026600764618188152,420680886,418389540.2,41.83952757930562,49.426887176689384,NaN,NaN,-2.473968729155531,-0.7271252719687438
2012-05-30T09:30:00-04:00,33.97,34.02,33.78,33.85001,3231598,5151928.25,48.92895936716799,47.496565281114115,NaN,NaN,-20.96190666995833,-38.63214536798631,0.002627553726222663,-0.023316322460409822,-0.025943876186632485,417449288,417878533.4,40.94752766419462,46.43987310819,NaN,NaN,-2.460526234622465,-0.9747539809192753
2012-05-31T09:30:00-04:00,33.89,33.97,33.69,33.78,5125891,4870475.75,47.28632240700961,47.076415290468745,NaN,NaN,-42.427552738685314,-18.50131750465984,-0.0023137059476581456,-0.028836008621205167,-0.02652230267354702,412323397,417597839.8,40.43754740819076,44.021405288912966,NaN,NaN,-2.9698188804289978,-1.259763252277807
2012-06-01T09:30:00-04:00,33.46001,33.53,33.13,33.16,14138875,5461288.7,35.81813311697965,46.0087297909991,NaN,NaN,-226.97651079771464,-53.879960910377164,-0.044614656290282204,-0.08229062303639978,-0.037675966746117576,398184522,413194731.4,33.40853032349035,41.56534585240595,NaN,NaN,-7.753355735050185,-2.1874193212452897
2012-06-04T09:30:00-04:00,33.17,33.28999,33.05,33.27,3855688,5404762.35,38.66053183656887,45.3992633790461,NaN,NaN,-205.78452160009832,-91.65351802031483,-0.061425870837431104,-0.11445830529290646,-0.053032434455475355,402040210,410135660.6,29.56365116068237,39.59560562758459,NaN,NaN,-10.447109397230324,-3.367375046386009
2012-06-05T09:30:00-04:00,33.2,33.27,33.07001,33.23,4985090,5443785.8,38.00147167763326,44.81415092117264,NaN,NaN,-169.02415275340425,-133.03492891197217,-0.07081198874827146,-0.1415474203908147,-0.07073543164254323,397055120,405410507.4,24.813344211953094,37.753292213976195,NaN,NaN,-12.743888542569534,-4.706876974412227
2012-06-06T09:30:00-04:00,33.31,33.69,33.30499,33.67999,5551621,5289432.65,48.61421751541619,44.760091928511216,NaN,NaN,-53.64174414044329,-139.57089640606915,-0.043620752184628325,-0.12526137187332864,-0.08164061968870032,402606741,402441998,22.38036707700533,35.87998753323625,NaN,NaN,-11.03022488962695,-5.610212390871473
2012-06-07T09:30:00-04:00,33.94,33.94,33.73,33.8,4819430,5188338.35,51.02215555132543,45.307802103655305,NaN,NaN,25.110717374975298,-126.06324238333704,-0.01588808019829331,-0.10150071993656695,-0.08561263973827364,407426171,401462552.8,21.626884716549895,34.28295408639027,NaN,NaN,-8.854322555428322,-6.0736567000938795
2012-06-08T09:30:00-04:00,33.78,34.09,33.77,34.09,4118023,5235637.2,56.345631413750006,46.54104830008889,NaN,NaN,76.4071770906551,-65.3865048056631,0.02161473735100218,-0.05859421804952092,-0.0802089554005231,411544194,404134487.2,28.68098387192434,33.554592359997685,NaN,NaN,-5.155478524055517,-5.942488389231256
2012-06-11T09:30:00-04:00,34.24001,34.24001,33.89,33.92999,5824492,5362382.5,52.92733692314501,47.249249728122905,NaN,NaN,89.50485897793239,-6.328628690056954,0.03450748194037,-0.0370746029750606,-0.0715820849154306,405719702,404870385.6,30.535431375791646,33.074148288910365,NaN,NaN,-3.320357752915089,-5.567898298328947
2012-06-12T09:30:00-04:00,33.94,34.11,33.84,34.09,4685219,5249748.35,55.81414038122139,48.07838220900566,NaN,NaN,83.47408751233573,44.17101936309105,0.051643529842616054,-0.007027672612160529,-0.05867120245477658,410404921,407540345.8,36.941940040122475,33.01158836137776,NaN,NaN,-0.8720777956972591,-4.897066797952991
2012-06-13T09:30:00-04:00,34.015,34.25,33.96001,34.045,5569332,5363345.5,54.79636884599832,48.98729634120341,NaN,NaN,98.97816313814297,74.69500081880831,0.05733993279773251,0.01300371354238905,-0.04433621925534346,404835589,407986115.4,37.970539803470274,33.20602538072448,NaN,NaN,0.754040566789569,-4.089765745846911
2012-06-14T09:30:00-04:00,34.10001,34.62,34.10001,34.50999,7900945,5527860.5,62.421703838892675,49.79513750672893,NaN,NaN,173.69413934958266,104.41168521372978,0.08798325413182038,0.06564284840943202,-0.02234040572238836,412736534,409048188,40.46241049868055,33.50535953638879,NaN,NaN,4.855590604122214,-2.811857695851322
2012-06-15T09:30:00-04:00,34.42,34.45889,34.28,34.33,6792219,5604124.55,58.32063290867028,50.36667781647619,NaN,NaN,139.98401170710875,117.12705213702051,0.09129479862123124,0.0917780925541507,0.0004832939329194527,405944315,407928212.2,38.697006955889336,33.45040662051789,NaN,NaN,6.8424859468398065,-1.432665746895447
2012-06-18T09:30:00-04:00,34.34,34.47,34.24001,34.42,3234719,5400698.2,59.74480481495989,50.62160075705274,NaN,NaN,130.20433671023852,125.26694768348175,0.09432376999574528,0.11838800642760106,0.024064236431855773,409179034,408620078.6,40.426209092162296,33.34945530000765,NaN,NaN,8.885012937049312,0.04128835081094717
2012-06-19T09:30:00-04:00,34.47,34.53999,34.3542,34.39,14235387,5865220.65,59.020852097164415,51.34245023776676,NaN,NaN,126.44343238620726,133.86081665825606,0.08914374372193287,0.13549391608427186,0.04635017236233899,394943647,405527823.8,35.59367789638482,32.967037459449806,NaN,NaN,10.298947713327294,1.5066682597418537
2012-06-20T09:30:00-04:00,34.31,34.31,33.99001,34.21001,7010047,6001952.7,54.735459362089244,51.87453144884388,NaN,NaN,61.64767372291824,126.39471877521112,0.06931483427383041,0.132993715204627,0.06367888093079659,387933600,402147426,31.202524553065714,32.307392969798016,NaN,NaN,10.220888863055317,2.7515569173580623
2012-06-21T09:30:00-04:00,34.23,34.28999,33.78999,33.80499,7127793,6044469.5,46.545598099691574,52.640778947609014,NaN,NaN,10.580799921906248,93.77205088967582,0.02682488142996077,0.09720998271824755,0.07038510128828677,380805807,395761280.6,24.942207822299764,31.702655648284402,NaN,NaN,7.480194179463067,3.4270765262302056
2012-06-22T09:30:00-04:00,33.94,34.00999,33.89,33.91,4075625,5924590.8,48.689253551364835,53.357116212951595,NaN,NaN,3.307691016276357,66.43678675150935,0.004846602888404494,0.07644335489879239,0.0715967520103879,384881432,391548704,21.830718630011816,31.150303324665078,NaN,NaN,5.924741473793503,3.7838858044535337
2012-06-25T09:30:00-04:00,33.78,33.81,33.62,33.7,5722035,6067467.55,44.818445653481625,53.84404292551219,NaN,NaN,-47.49873843066997,30.896171723327654,-0.023237466566645673,0.04254991880208081,0.06578738536872648,379159397,385544776.6,18.322474320628743,30.686669760999052,NaN,NaN,3.381012683804615,3.726332501503688
2012-06-26T09:30:00-04:00,33.8,33.87,33.64,33.78,4592316,6129817.25,46.56137255260657,53.69741114245436,NaN,NaN,-31.346282246917898,-0.661771203297372,-0.03511622875600221,0.02189209942372372,0.05700832817972593,383751713,383306389.8,17.2119303355191,30.31749570803575,NaN,NaN,1.8338062419424979,3.4559716072806608
2012-06-27T09:30:00-04:00,33.89,34.0399,33.78,33.98,3772436,6156859.15,50.74950613217641,53.67793618394371,NaN,NaN,7.630309483721702,-11.465244051136679,-0.028476957310766098,0.02141213154126831,0.049889088852034406,387524149,383224499.6,17.17092627694548,29.999212962349723,NaN,NaN,1.7777027479580452,3.2162189130917156
2012-06-28T09:30:00-04:00,33.83,34.14999,33.69,34.13,5746363,6187882.75,53.68151654430542,53.48764226469767,NaN,NaN,18.920196558096688,-9.797364723898623,-0.013704961162210996,0.03275788739927066,0.046462848561481654,393270512,385717440.6,23.171392292270994,29.605670706660195,NaN,NaN,2.6155416361856356,3.130407873533704
2012-06-29T09:30:00-04:00,34.5,34.77,34.38499,34.77,8007910,5881334.5,63.63026505567969,54.252137131307286,NaN,NaN,162.7625299131421,22.093603055474524,0.03669198847502518,0.09232783415526313,0.05563584568023795,401278422,388996838.6,30.322324190712337,29.590448764868817,NaN,NaN,6.905665958036071,3.669730457034042
2012-07-02T09:30:00-04:00,34.63,35,34.63,34.965,8832496,6130174.9,66.02477056317628,54.9814678585898,NaN,NaN,188.3610319638094,69.2655571343704,0.07829358854931277,0.15350283136687892,0.07520924281756615,410110918,395187142.8,41.40839442029186,29.909481220595204,NaN,NaN,11.193070022146825,4.7444932520501535
2012-07-03T09:30:00-04:00,34.99001,35.14,34.89,35.13,2151855,5988513.15,67.94772327349303,55.920850317696576,NaN,NaN,195.34645739184964,114.6041050621239,0.1101086324524985,0.21284503338318927,0.10273640093069078,412262773,400889354.8,49.3954957792525,30.725549504579647,NaN,NaN,15.302532726612169,6.252784605559013
2012-07-05T09:30:00-04:00,35.08,35.11,34.94,35,4472387,5934551.45,64.83418401125564,56.09317033000821,NaN,NaN,157.99004110465208,144.67605138630998,0.11504468469921447,0.24654225680470887,0.1314975721054944,407790386,404942602.2,54.17717156263527,31.705175294862126,NaN,NaN,17.645931104940214,7.88037696261347
2012-07-06T09:30:00-04:00,34.83,34.99001,34.78999,34.96001,3676693,5877414.6,63.864716716661924,56.48917631629333,NaN,NaN,119.39704307933178,164.771420690557,0.1083567675056945,0.2669435314876125,0.158586763981918,404113693,407111238.4,56.543184542598,32.979902265341316,NaN,NaN,19.227919931864655,9.501454529649353
2012-07-09T09:30:00-04:00,34.99001,34.99001,34.81,34.92,5360082,5939517.55,62.85208704862344,56.711125047269306,NaN,NaN,104.5663489701891,153.1321845019664,0.09448551978654601,0.2766936637151005,0.1822081439285545,398753611,406606276.2,55.820439155107245,34.07949012698024,NaN,NaN,20.226238391544367,11.03356650992007
2012-07-10T09:30:00-04:00,35.05,35.11,34.88,34.96001,5276645,5912125.2,63.47575805030975,57.029332615351116,NaN,NaN,105.55627215393011,136.57123253999055,0.08173039123140105,0.2843711329678058,0.20264074173640476,404030256,405390143.8,54.02925309329085,35.39631692675924,NaN,NaN,21.2244920939753,12.489413021927959
2012-07-11T09:30:00-04:00,35.03,35.03,34.77,34.91,6852824,6020505.45,62.07295551214361,57.55343948321214,NaN,NaN,81.96503142286602,113.89494734619382,0.06441232327029928,0.28315614582427884,0.21874382255397956,397177432,402373075.6,49.763033096304994,36.722067536990615,NaN,NaN,21.687517617382067,13.803427964135688
2012-07-12T09:30:00-04:00,34.845,35.05,34.78999,34.94,6885012,6086289.45,62.60681890631987,58.700669540828436,NaN,NaN,76.45155706378063,97.58725053801952,0.05010137759569128,0.28137054454859367,0.2312691669529024,404062444,401627487.2,48.73882538777106,38.421825934524286,NaN,NaN,22.215954942868084,15.00521753252603
2012-07-13T09:30:00-04:00,35.03999,35.35001,34.95,35.33,4999484,5941216.4,68.76261052951412,60.13448075355338,NaN,NaN,107.30074401569568,95.1679907252923,0.06128560913294617,0.3078761783690851,0.24659056923613892,409061928,402617134.2,50.20384310537704,40.448477682764654,NaN,NaN,24.516448176641443,16.36396476739966
2012-07-16T09:30:00-04:00,35.24001,35.31,35.12,35.14999,3956150,5799412.95,63.56143069727967,61.47326539953897,NaN,NaN,93.52127328336766,92.95897558792801,0.051347039071954426,0.31077436807608194,0.2594273290041275,405105778,403887567.6,52.09652495237958,42.86090987074686,NaN,NaN,24.978220893793544,17.59457278545593
2012-07-17T09:30:00-04:00,35.24001,35.38,35.02,35.3,6212242,5948289.1,65.87773506949333,62.85300557931658,NaN,NaN,89.71728950903999,89.79117905895,0.04963417757578986,0.32147005097386483,0.27183587339807497,411318020,405345120.4,54.24522262413132,45.50614503421916,NaN,NaN,26.05215444203186,18.80279873639535
2012-07-18T09:30:00-04:00,35.285,35.34599,35.23,35.31,4904086,5481724.05,66.03274489784035,63.94466549114971,NaN,NaN,89.60553831875436,91.31928043812766,0.044118584437831065,0.3269841039453638,0.28286551950753275,416222106,409154055.2,59.37360612629091,48.520622166315256,NaN,NaN,26.969662304946095,19.9694935319026
2012-07-19T09:30:00-04:00,35.38,35.39999,35.11,35.25999,5982797,5430361.55,64.4557702009949,64.71425503805611,NaN,NaN,78.52303853453854,91.73357673227926,0.032578396100415186,0.3235885146330517,0.29101011853263653,410239309,410389428.2,60.904177722658474,51.21582112562864,NaN,NaN,27.311648471361888,21.018372808968213
2012-07-20T09:30:00-04:00,35.09,35.17,34.92999,35.045,6919531,5419948.45,58.03880180004129,64.31486480551051,NaN,NaN,46.24458865964394,79.5223456610689,0.007264173018412756,0.3000903348056525,0.29282616178723975,403319778,409240998.2,58.690549625754805,53.242122942417396,NaN,NaN,25.790973916864964,21.700172967239176
2012-07-23T09:30:00-04:00,34.7997,34.83,34.64,34.74001,6449516,5538643,50.37667060975512,63.19714338026614,NaN,NaN,-7.240002903213648,59.37009042375265,-0.031116481053664102,0.2539305604701596,0.2850470415238237,396870262,407593895,55.57089897915702,54.25373041090777,NaN,NaN,22.03800607354297,21.74843483956829
2012-07-24T09:30:00-04:00,34.81,34.81,34.4501,34.63,3924134,5448747.95,47.91928816248314,61.76654087233687,NaN,NaN,-39.9338091746103,33.439870687022584,-0.0631608547782937,0.20609597305095662,0.2692568278292503,392946128,403919516.6,49.27815610462822,54.24534900557746,NaN,NaN,18.155524608199535,21.235161949372753
2012-07-25T09:30:00-04:00,34.72,34.75999,34.57001,34.64,5133375,5475800.9,48.16680445605244,60.57601376125092,NaN,NaN,-53.90528830001415,4.737705363268884,-0.08175123751490601,0.1670677809356178,0.24881901845052382,398079503,400290996,43.981595553156005,53.51709357632894,NaN,NaN,15.075834041903013,20.35525796259136
2012-07-26T09:30:00-04:00,34.95,35.27,34.95,35.21001,5811508,5577754.5,59.87331211579571,60.29091343261763,NaN,NaN,66.65749346409777,2.3645963491807267,-0.05500952324374986,0.1800571143958365,0.23506663763958635,403891011,399021336.4,42.2695720040059,52.49754982357236,NaN,NaN,15.848437180433098,19.711426422283036
2012-07-27T09:30:00-04:00,35.3,35.73,35.23,35.61,6313734,5606123.05,65.7234697049786,60.49601219378586,NaN,NaN,180.73260810293226,29.262200237838393,-0.011981275018981663,0.2200900438658593,0.23207131888484095,410204745,400398329.8,44.780091938245974,51.70895359379656,NaN,NaN,18.604525596898522,19.55329773294239
2012-07-30T09:30:00-04:00,35.605,35.808,35.53,35.78999,5766758,5494065.45,67.98533695745832,60.8181249728679,NaN,NaN,207.76583539442404,72.26336789736592,0.02498686700200828,0.2633049026373513,0.238318035635343,415971503,404218578,51.12971795619212,51.50184394114665,NaN,NaN,21.605388323065842,19.846453531531456
2012-07-31T09:30:00-04:00,35.82001,35.82001,35.63,35.63,5051902,5305035.75,63.945976338255065,60.95191217473301,NaN,NaN,168.34616399586042,113.91936253146007,0.03446504129758107,0.28139933725731936,0.2469342959597383,410919601,407813272.6,56.22989401960318,51.963762578525085,NaN,NaN,22.683862533986847,20.251797674739368
2012-08-01T09:30:00-04:00,35.78999,35.78999,35.38,35.45,8705473,5632716.65,59.651750179503,60.740835837103226,NaN,NaN,108.7440833243095,146.4492368563248,0.024860630579861542,0.2780100841845652,0.25314945360470364,402214128,408640197.6,57.33300989897701,52.57763290075409,NaN,NaN,22.158983992615184,20.52425286300734
2012-08-02T09:30:00-04:00,35.25999,35.405,35.02,35.16,6016059,5709900.25,53.42673389062594,59.645416077182645,NaN,NaN,15.968311277717687,136.31140041904877,-0.0032775010785520697,0.24905257725651353,0.2523300783350656,396198069,407101609.2,54.57691881008385,52.889995451090286,NaN,NaN,19.619016997899696,20.394933453706248
2012-08-03T09:30:00-04:00,35.5,35.81,35.5,35.75,7232273,5887679.25,62.093704807582355,59.54057851363284,NaN,NaN,130.20799497607453,126.20647779367724,0.014609851640316862,0.27059239288546166,0.2559825412451448,403430342,405746728.6,52.19733812701484,52.89719639213566,NaN,NaN,20.470687960993956,20.40575552617592
2012-08-06T09:30:00-04:00,35.89,35.948,35.7,35.73,4097207,5824535.5,61.674717870754165,59.24036299943719,NaN,NaN,138.34691904200065,112.32269452319255,0.021445327982150764,0.28278920122283324,0.2613438732406825,399333135,402419055,46.80020024947948,52.36540907966054,NaN,NaN,20.97064165277679,20.48645354426176
2012-08-07T09:30:00-04:00,35.87,35.87,35.53999,35.53999,6347746,5878090.55,57.69182750516238,58.64458318567448,NaN,NaN,92.10500687374656,97.07446309876978,0.010096856090309136,0.2739649433535689,0.2638680872632598,392985389,398832212.6,41.784963482243505,51.10907746222858,NaN,NaN,20.060718709948578,20.42563428221702
2012-08-08T09:30:00-04:00,35.58,35.82001,35.52,35.78999,4813500,5776124.35,61.23864143205244,58.41478827360715,NaN,NaN,93.71570057002354,94.0687865479126,0.01600334085523686,0.28387226333230586,0.267868922477069,397798889,397949164.8,40.630571603318664,49.66096273941859,NaN,NaN,20.46906692488363,20.431838945455105
2012-08-09T09:30:00-04:00,35.74001,35.75999,35.60001,35.64,3254950,5594621.25,58.0920674211115,58.41859296082645,NaN,NaN,74.76219653923836,105.82756360021672,0.006852368275811149,0.27643438282183297,0.2695820145460218,394543939,397618338.8,40.182680695185006,48.33897210152075,NaN,NaN,19.791612362758347,20.340378005069855
2012-08-10T09:30:00-04:00,35.57001,35.64999,35.47,35.63,3044879,5496891,57.878540639421516,58.95444082008834,NaN,NaN,51.0553305992654,89.99703072485491,-0.0023384009273093587,0.26665901338688514,0.2689974143141945,391499060,395232082.4,37.01326726880382,47.01342697935267,NaN,NaN,19.19204579283923,20.176330546179766
2012-08-13T09:30:00-04:00,35.63,35.64,35.50999,35.62,4432270,5520697,57.65033726744056,59.649515756156724,NaN,NaN,47.82642961896594,71.89293284024797,-0.011066988885797213,0.25516367820694796,0.2662306670927452,387066790,392778813.4,34.04057708363024,45.92502847785281,NaN,NaN,18.642747925139386,19.95724731460257
2012-08-14T09:30:00-04:00,35.78,35.81,35.66,35.75999,4091995,5414684.65,60.02640796176931,60.49663029227935,NaN,NaN,73.58287165262387,68.18850579602342,-0.009451088287695641,0.2544168067331256,0.26386789502082125,391158785,392413492.6,33.60771935098609,45.18403732055496,NaN,NaN,18.841967971032496,19.797921694092558
2012-08-15T09:30:00-04:00,35.83,35.88,35.71001,35.78,2833378,5311149.25,60.368688811451605,60.53201434196905,NaN,NaN,76.36058052200588,64.7174817864199,-0.009071473210745695,0.2525285535073891,0.2616000267181348,393992163,391652147.4,32.6751988197078,44.49872495024795,NaN,NaN,19.099331877497168,19.698123148864646
2012-08-16T09:30:00-04:00,35.72,35.87,35.62,35.87,4111172,5217568,61.94695043516446,60.26226296555377,NaN,NaN,70.28269343579426,63.821581165731075,-0.004999363984222738,0.2553508217378564,0.26035018572207913,398103335,392364026.6,34.505135168559676,43.76479946669893,NaN,NaN,19.743822880077627,19.704651681895072
2012-08-17T09:30:00-04:00,35.86,35.92999,35.81,35.89999,4605309,5101856.9,62.48310022276878,59.86924605593308,NaN,NaN,85.83716891826431,70.77794882953086,-0.00264464109866136,0.25704438434875243,0.2596890254474138,402708644,394605943.4,40.03315946501717,42.97218814590072,NaN,NaN,20.42720409721516,19.807873455512226
2012-08-20T09:30:00-04:00,35.85001,35.91,35.755,35.89999,5377414,5048251.8,62.48310022276878,59.764754904826916,NaN,NaN,81.72476971971797,77.55761684968127,-0.003397645230835855,0.25544196890886894,0.2588396141397048,402708644,397734314.2,46.7830411601137,42.297412941651466,NaN,NaN,21.002533035979667,19.978539109864716
2012-08-21T09:30:00-04:00,35.94,36,35.66,35.67999,6429754,5173532.8,55.79493450486541,59.48926807092423,NaN,NaN,61.65283119683836,75.17160875852417,-0.02009118084929068,0.23372563807809144,0.2538168189273821,396278890,398758335.2,48.81404671842336,41.688915571611915,NaN,NaN,19.76389996279513,19.94787637456906
2012-08-22T09:30:00-04:00,35.64999,35.7,35.5,35.57001,3998790,5116803.55,52.75487044990763,59.441277825158636,NaN,NaN,-27.31099570744308,54.43729351263437,-0.03883381882364936,0.20527454539782042,0.24410836422146978,392280100,398415922.6,48.15228217799046,41.230012955033814,NaN,NaN,17.862304429876357,19.649937525327246
2012-08-23T09:30:00-04:00,35.56,35.58,35.27,35.28999,5382309,5095343.6,45.89778297593252,58.28442626575508,NaN,NaN,-153.21181826670582,9.738391172134348,-0.06864131983080751,0.1583067144329604,0.22694803426376792,386897791,396174813.8,43.95238186514013,40.64108750775705,NaN,NaN,14.090818438378255,18.855777655763106
2012-08-24T09:30:00-04:00,35.27,35.64999,35.24001,35.60001,6677738,5113543.8,53.15725172679831,57.67603582690109,NaN,NaN,-86.8526217971872,-24.799566970955954,-0.06601008235597089,0.14443543131880432,0.2104455136747752,393575529,394348190.8,40.826751638993755,40.214412607008065,NaN,NaN,12.857075805713972,17.998820248613228
2012-08-27T09:30:00-04:00,35.64999,35.72,35.5699,35.64999,3317470,4991079.4,54.223656548562985,57.42830933000113,NaN,NaN,-3.4159874527355605,-41.82771840544665,-0.059629500828746684,0.13590863763884187,0.19553813846758855,396892999,393185061.8,38.928363652270214,40.01036976200997,NaN,NaN,12.168101142780136,17.165860376351358
2012-08-28T09:30:00-04:00,35.64999,35.78,35.56,35.67,5877059,5032337.25,54.668609704957355,56.959021349494336,NaN,NaN,10.264872337298364,-52.10531017735466,-0.05301009140384144,0.12927552421278676,0.1822856156166282,402770058,394483295.4,42.1610967077348,40.119692983753986,NaN,NaN,11.730818235788153,16.389425784842327
2012-08-29T09:30:00-04:00,35.67,35.7572,35.59,35.59,3848657,4789496.45,52.47260435096608,56.55763113019824,NaN,NaN,-6.569547949262601,-47.957020625718556,-0.05284957349689995,0.11622364874550328,0.16907322224240323,398921401,395811555.6,45.348571809725506,40.488685206221156,NaN,NaN,10.749077069644995,15.58366168267128
2012-08-30T09:30:00-04:00,35.55,35.55,35.42,35.45,4806762,4729031.6,48.779785662353135,55.90772006040764,NaN,NaN,-133.42584176081192,-43.999825324539785,-0.06045438323851049,0.09350524319426512,0.1539596264327756,394114639,397254925.2,48.6596157489718,41.320567240518876,NaN,NaN,8.846078360804663,14.621149779547478
2012-08-31T09:30:00-04:00,35.60001,35.73,35.46001,35.46001,8650855,4799960.7,49.05585006526703,55.29382811739524,NaN,NaN,-73.47483354495023,-41.32426767409239,-0.06281661770048236,0.07543885430717268,0.13825547200765503,402765494,399092918.2,52.59794131215942,42.64609325684239,NaN,NaN,7.346868189432737,13.581966695245372
2012-09-04T09:30:00-04:00,35.50999,35.74001,35.47,35.67,5942918,4892246.25,54.58567181357135,54.90520410680968,NaN,NaN,-19.741899471409788,-44.58945007782724,-0.048863647120337694,0.07717591310723293,0.12603956022757062,408708412,401456000.8,57.14919664393901,44.32762734919616,NaN,NaN,7.54773830344355,12.719934067845111
2012-09-05T09:30:00-04:00,35.69,35.72,35.565,35.61,4504980,4800107.95,52.821405721803565,54.36611245754911,NaN,NaN,-15.589723462708635,-49.760369237828634,-0.04253482079008894,0.07287103423995944,0.11540585503004838,404203432,401742675.6,57.68004984893626,46.11368813699819,NaN,NaN,7.228140972531719,11.935392197086054
2012-09-06T09:30:00-04:00,35.7,36.05499,35.7,36.05,4791777,4799021.8,62.415083482059465,54.399550532327325,NaN,NaN,161.19896886137371,-16.206665875701372,-0.009310650536253351,0.1037675418597317,0.11307819239598504,408995209,403757437.2,61.307955499561146,48.0281753034983,NaN,NaN,10.010178961599978,11.660361734873758
2012-09-07T09:30:00-04:00,35.98,36.07001,35.69,35.75999,6167563,4944652.45,54.542454438509914,53.83236154773741,NaN,NaN,90.89539378070262,28.657581232601537,-0.0075369775731615185,0.10365697042953315,0.11119394800269466,402827646,405500038.6,64.16902580451996,49.752165756319926,NaN,NaN,9.823908555273986,11.39801128064522
2012-09-10T09:30:00-04:00,35.72,35.78,35.63499,35.72,7045449,5144680.95,53.53962137984185,53.19354163038549,NaN,NaN,17.089617782596072,46.770471498110794,-0.009595975277956012,0.09919897890524965,0.10879495418320566,395782197,404103379.2,60.31921267851861,50.71903515049171,NaN,NaN,9.35959316817878,11.106808693150013
2012-09-11T09:30:00-04:00,35.71001,35.73,35.60001,35.61,4499691,5148052,50.77418972028587,52.83491700291552,NaN,NaN,-21.314251814377034,46.456001029517346,-0.018395284119340827,0.08580084903402962,0.10419613315337045,391282506,400618198,51.944443631312126,50.94263492998376,NaN,NaN,8.118391037453332,10.679891885193344
2012-09-12T09:30:00-04:00,35.64,35.7,35.39999,35.42,9593172,5423110.85,46.323431925201604,52.37552853686509,NaN,NaN,-91.8142339771656,31.211098926625947,-0.03602150162190401,0.059169256125990444,0.09519075774789446,381689334,396115378.4,43.53447533876081,50.612791584324505,NaN,NaN,5.649956681482612,9.961329713234669
2012-09-13T09:30:00-04:00,35.41,36.11,35.41,36.05,9155805,5739232.2,59.11955045933445,53.31994049996523,NaN,NaN,97.32011282153245,18.435327718657696,-0.005843674401149565,0.0878861647464575,0.09372983914760706,390845139,392485364.4,38.1693653052438,50.19971897290334,NaN,NaN,7.931083192971637,9.671294496054236
2012-09-14T09:30:00-04:00,35.99001,36.09,35.72,35.78,10535727,6060459.95,53.25953474927268,53.32724643014196,NaN,NaN,95.30994095114438,19.318237152746047,-0.004707748155346483,0.08784515395342396,0.09255290210877044,380309412,387981717.6,32.77299059081291,49.62445032660471,NaN,NaN,7.64316657110293,9.381561935346905
2012-09-17T09:30:00-04:00,35.78,35.96001,35.74001,35.88,5369625,6098675.75,55.037168271340306,53.38535441034035,NaN,NaN,94.98956649738157,34.89822689570315,0.0017889955864979351,0.09478914659189286,0.09300015100539492,385679037,385961085.6,30.677369033416852,49.03509356811519,NaN,NaN,8.037296009255957,9.189523945905341
2012-09-18T09:30:00-04:00,35.89999,36.14,35.82001,36.08,4888172,6074213.65,58.441441102965186,53.654842367340905,NaN,NaN,159.1450855089724,70.99009436037304,0.017682914735203697,0.11510379442439955,0.09742087968919586,390567209,385818026.2,30.528530105043544,48.20419595363724,NaN,NaN,9.524092379849444,9.237319436468784
2012-09-19T09:30:00-04:00,36.11,36.27,36.03,36.17999,17987216,6652086.75,60.0691996159911,54.19745631484269,NaN,NaN,189.68945275517174,127.2908317068405,0.032210908372189734,0.13768451515443303,0.1054736067822433,408554425,391191044.4,41.92508534250836,47.95966120597887,NaN,NaN,11.241939336754161,9.523693707938124
2012-09-20T09:30:00-04:00,36.14,36.39999,36.11,36.38,7029980,6803646.25,63.176177680907664,55.225770030453724,NaN,NaN,195.05890988134624,146.83859111880327,0.05143081248724905,0.16976212239130462,0.11833130990405556,415584405,396138897.6,50.05107773681774,48.05905134796786,NaN,NaN,13.693902902584432,10.119437878601882
2012-09-21T09:30:00-04:00,36.245,36.27,35.96001,35.96001,8846160,6976838.8,53.72328632637159,55.559158334818335,NaN,NaN,100.42964663247956,147.8625322550703,0.03289980326745917,0.15945606398837953,0.12655626072092035,406738245,401424664.2,56.976818256793784,48.3718282725846,NaN,NaN,12.620845224515548,10.476781785160977
2012-09-24T09:30:00-04:00,35.88,36.13,35.77,36.08,6189234,6952413.6,55.75994282057639,55.6430348353187,NaN,NaN,68.49244545444947,142.56310804648388,0.026063955852126897,0.159136205536079,0.1330722496839521,412927479,406874352.6,62.71669847527712,48.769506974823045,NaN,NaN,12.44157577547797,10.757466640920548
2012-09-25T09:30:00-04:00,36.11,36.23,35.82001,35.83,3766355,6974857.85,50.74854888142594,55.494973632434586,NaN,NaN,51.49978119284344,121.0340471832581,0.0032454532366244515,0.13712906622973264,0.1338836129931082,409161124,410593135.6,66.04566468442859,49.36705089164392,NaN,NaN,10.620651034894696,10.737921554345427
2012-09-26T09:30:00-04:00,35.82001,35.99001,35.8,35.825,4846184,6923314.1,50.65050180349258,54.6546463696798,NaN,NaN,17.08472660042366,86.51310195230846,-0.012766553819050175,0.11792542071929546,0.13069197453834563,404314940,409745238.6,64.62873715386368,49.604249581236964,NaN,NaN,9.171590658551846,10.514159997803487
2012-09-27T09:30:00-04:00,35.89,36.02,35.75,35.95,4990828,6980422.65,53.09053747597827,54.550938015213255,NaN,NaN,26.45975609040558,52.79327119412034,-0.01534761159825418,0.11150746004052792,0.1268550716387821,409305768,408489511.2,62.4905075848631,49.484355422690044,NaN,NaN,8.70468674876603,10.255663819369564
2012-09-28T09:30:00-04:00,35.81,35.89,35.6501,35.825,5648535,7022511.3,50.406522968326925,54.32714527153362,NaN,NaN,-28.617519975561855,26.983837872512044,-0.0252945429009878,0.09523689301254734,0.12053143591353514,403657233,407873308.8,61.4166966719844,49.562747136509024,NaN,NaN,7.513983336208595,9.863995178917998
2012-10-01T09:30:00-04:00,35.84,36.21001,35.84,36.06,5444156,6862176.35,55.01134912541716,54.62979951475728,NaN,NaN,72.29857823063512,27.745064427749192,-0.016304816097989006,0.10015041579104889,0.11645523188903789,409101389,407108090.8,60.03701365731488,50.14078785265208,NaN,NaN,7.876465484457891,9.580062365423696
2012-10-02T09:30:00-04:00,36.14,36.3,35.95,36.09,7288344,6929447.65,55.578398619923945,55.29086856438031,NaN,NaN,96.76435111259991,36.79797841170049,-0.0089626743007869,0.10525188901305427,0.11421456331384117,416389733,408553812.6,61.783741586986785,51.444306870382505,NaN,NaN,8.334783048749793,9.402165320184567
2012-10-03T09:30:00-04:00,36.13,36.35001,36.02,36.2,8157492,7112073.25,57.68447374217879,55.18836308458348,NaN,NaN,118.82558544895988,57.146150181407734,0.0020877467815887812,0.11682424679082715,0.11473650000923837,424547225,412600269.6,66.23252081279105,53.44881797806449,NaN,NaN,9.327381544388173,9.391481923642225
2012-10-04T09:30:00-04:00,36.32001,36.489,36.25,36.37,4704305,7107699.65,60.779297587232726,55.72548900158062,NaN,NaN,166.34137007271673,85.12247297786996,0.018707465577351312,0.1381208319809275,0.1194133664035762,429251530,416589422,69.94679427480095,56.10408966977793,NaN,NaN,11.091227859005386,9.634302771551248
2012-10-05T09:30:00-04:00,36.47,36.59,36.39999,36.50999,4746438,7036643.4,63.16816641419509,56.3062745832131,NaN,NaN,182.2548141117191,127.29693979532615,0.03598887297323006,0.16439945762011376,0.1284105846468837,433997968,422657569,74.53532389178648,59.23680073109004,NaN,NaN,13.300138841481063,10.15799363868408
2012-10-08T09:30:00-04:00,36.42999,36.48,36.36,36.39999,3024640,6835602.95,60.071965511361896,56.4227406123843,NaN,NaN,133.71428072212655,139.58008029362443,0.03674329033367679,0.1743396975639797,0.13759640723030292,430973328,427031956.8,77.233803202769,62.57289166664186,NaN,NaN,14.29405225088088,10.748859154712193
2012-10-09T09:30:00-04:00,36.3,36.42,36.03999,36.05,6898746,6955555.7,51.433704856046525,55.80591955810254,NaN,NaN,44.29397050460778,129.086004172026,0.011700016185587137,0.15222142746228684,0.1405214112766997,424074582,428568926.6,78.11147116365274,65.15763351100931,NaN,NaN,12.54192981904248,11.005012106759377
2012-10-10T09:30:00-04:00,36.11,36.23,35.87,35.89999,4799977,6715895.95,48.23229243759179,54.73849918357998,NaN,NaN,-28.949717309795478,99.53094362027494,-0.015464351696123119,0.1211909716565458,0.13665532335266892,419274605,427514402.6,75.94809295908846,67.00742031260008,NaN,NaN,10.08140975989818,10.873068914350634
2012-10-11T09:30:00-04:00,36.08,36.10001,35.81,35.82001,4780500,6497130.7,46.568008748661875,54.22740792802929,NaN,NaN,-67.43536376784608,52.775596852162366,-0.03802978160352283,0.0891180963482654,0.12714787795178822,414494105,424562917.6,70.09639239343439,67.94453275093154,NaN,NaN,7.5573244566324025,10.399391134676602
2012-10-12T09:30:00-04:00,35.92999,36.05,35.8,35.85001,3637785,6152233.6,47.30252898407681,53.623306939707895,NaN,NaN,-72.96337565630262,1.7319588985580254,-0.049424424929926894,0.06536734678937961,0.1147917717193065,418131890,421389702,64.35531591951678,68.06157685409153,NaN,NaN,5.699552209410253,9.727985573924267
2012-10-15T09:30:00-04:00,35.92999,36.11,35.83501,36.09,3933292,6080416.95,52.88260656157142,53.775739631146855,NaN,NaN,-30.937151422067746,-31.198327530280842,-0.03970639012251451,0.06515878406616338,0.10486517418867788,422065182,419608072.8,61.318678920803364,67.72393501383259,NaN,NaN,5.680021654738924,9.149705014040647
2012-10-16T09:30:00-04:00,36.17999,36.24001,36.05499,36.17999,4171848,6044600.75,54.81472259932896,54.0731839737066,NaN,NaN,29.006912489802705,-34.25573913324186,-0.026746923802059522,0.07143151943610349,0.09817844323816301,426237030,420040562.4,61.79001249667036,67.5211689668902,NaN,NaN,6.225640206300945,8.731981470077832
2012-10-17T09:30:00-04:00,36.21001,36.46001,36.21001,36.33501,5464469,5418463.4,58.009093649316455,54.42450941465933,NaN,NaN,95.09674999347844,-9.44644567258706,-0.008224123317456797,0.08789828909134201,0.0961224124087988,431701499,422525941.2,64.46937532253824,67.66251666243842,NaN,NaN,7.635986380574181,8.575410743005882
2012-10-18T09:30:00-04:00,36.24001,36.25,36.06,36.14,7520070,5442967.9,52.93897875922973,54.60539911400953,NaN,NaN,24.582688280265252,8.957164737035212,-0.00950468099282123,0.08424156116777226,0.09374624216059349,424181429,424463406,66.44471367398752,68.02166073401007,NaN,NaN,7.359788460100755,8.401750416876578
2012-10-19T09:30:00-04:00,36.12,36.149,35.64999,35.71001,4963703,5248845.05,43.84024686202612,53.807463238053025,NaN,NaN,-97.37316607473102,4.075206653349534,-0.03810468251198976,0.0461153890206063,0.08422007153259606,419217726,424680573.2,66.66840024145384,68.49533120430571,NaN,NaN,4.088174137736917,7.785525234142341
2012-10-22T09:30:00-04:00,35.67,35.75999,35.48,35.73,5963637,5237565.2,44.319371560993304,53.00324701955799,NaN,NaN,-148.78209909481765,-19.49378288120045,-0.05352520218407124,0.017313568802507007,0.07083877098657825,425181363,425303809.4,67.34125536771089,68.89229647435744,NaN,NaN,1.6641390130166924,6.911041488267248
2012-10-23T09:30:00-04:00,35.48,35.50999,35.14,35.25,5008172,5299656.05,36.30902836841551,51.47642949286061,NaN,NaN,-229.03111244811254,-71.1013878687835,-0.09166290781035571,-0.043739863776366406,0.04792304403398931,420173191,424091041.6,64.60811372630222,68.7762673967511,NaN,NaN,-3.369087341361473,5.442451655463145
2012-10-24T09:30:00-04:00,35.27,35.42,35.19,35.25,4127520,5263722.85,36.30902836841551,49.72855312008795,NaN,NaN,-196.1491482328037,-129.35056751403994,-0.11119866699833916,-0.09107528971393464,0.02012337728440452,420173191,421785380,59.6512911762821,68.04087431828546,NaN,NaN,-7.245150371012099,3.6299370802523963
2012-10-25T09:30:00-04:00,35.48,35.59,35.325,35.47,5155301,5271946.5,41.891751909679606,48.20880922690827,NaN,NaN,-128.05093262119823,-159.87729169433263,-0.1037576594652805,-0.1095736970471961,-0.005816037581915609,425328492,422014792.6,59.98029171748825,67.00122916297845,NaN,NaN,-8.76474678738594,1.8592679563040626
2012-10-26T09:30:00-04:00,35.49001,35.49001,35.23,35.35001,4537840,5216411.75,39.840584961127554,46.763710616177256,NaN,NaN,-135.6459038450665,-167.53183924839973,-0.10125908991628876,-0.13238989997727657,-0.0311308100609878,420790652,422329377.8,60.45644673510559,65.80284655814533,NaN,NaN,-10.65185430811007,0.07196477567347248
2012-10-31T09:30:00-04:00,35.61,35.71001,35.25,35.39,10607516,5474579.75,40.879550748606796,46.00984246564584,NaN,NaN,-99.73634228417302,-157.7226878862708,-0.09154898408314581,-0.14556704016492006,-0.05401805608177425,431398168,423572738.8,62.362515955683264,64.67792118614753,NaN,NaN,-11.866830135371877,-1.633577354475863
2012-11-01T09:30:00-04:00,35.46001,35.60001,35.38,35.41,4944180,5357371.55,41.4244016211511,45.52356455018579,NaN,NaN,-85.93152157663177,-129.10276971197464,-0.07889490325727502,-0.15263668515336803,-0.07374178189609301,436342348,426806570.2,66.83953012715192,64.0273095552949,NaN,NaN,-12.703185643027401,-3.2149499671260826
2012-11-02T09:30:00-04:00,35.53,35.61,33.56,35.2,4617793,5180386.6,37.51493013781143,44.876916077982195,NaN,NaN,-179.7276045830348,-125.81846098202087,-0.07955718900173266,-0.17318826814825883,-0.09363107914652617,431724555,429116843,69.61981251775113,63.99326813560325,NaN,NaN,-14.584482213642724,-4.839168859485603
2012-11-05T09:30:00-05:00,35.08,35.22,34.98,35.14,9441180,5417230.35,36.45628393772464,44.10218428895705,NaN,NaN,-108.57390228643081,-121.92305491506738,-0.0787772207193426,-0.19210260504570442,-0.11332538432636183,422283375,428507819.6,68.00120978120063,64.25368912572353,NaN,NaN,-16.449987352046463,-6.497857215565725
2012-11-06T09:30:00-05:00,35.2,35.50999,35.17999,35.39999,3443376,5352077.25,43.85035759766617,43.457023648678096,NaN,NaN,-59.83567853981803,-106.7610098540177,-0.056533599314193356,-0.18399238346910352,-0.12745878415491016,425726751,429495039.4,69.24924755174993,64.82015831364829,NaN,NaN,-15.92831507576324,-7.845065481308227
2012-11-07T09:30:00-05:00,35.2,35.31,34.81,34.98019,6083352,5505012.85,36.47084804450465,42.14674689476208,NaN,NaN,-107.2267665208966,-108.25909470136241,-0.06525678151986691,-0.2090297610547438,-0.1437729795348769,419643399,427144085.6,62.95242367983801,64.90318768387455,NaN,NaN,-17.851410710062535,-9.274543371130271
2012-11-08T09:30:00-05:00,34.95,35.06,34.59,34.60001,7502141,5535182.6,31.328866053039278,40.24101635217085,NaN,NaN,-140.94628552064168,-119.26204749016438,-0.0902548834308928,-0.2565915838234929,-0.1663367003926001,412141258,422303867.6,52.39006451118842,64.04037976877812,NaN,NaN,-21.33318712194226,-10.997206764103412
2012-11-09T09:30:00-05:00,34.5,34.85001,34.46001,34.60001,6354301,5612898.8,31.328866053039278,38.697436873157244,NaN,NaN,-144.56344500382428,-112.22921557432228,-0.09967543933984052,-0.29093099956740076,-0.19125556022756024,412141258,418387208.2,45.70711938961231,62.5591230341799,NaN,NaN,-24.001999055872457,-12.855034234356133
2012-11-12T09:30:00-05:00,34.60001,34.71001,34.545,34.60001,3303120,5539029.8,31.328866053039278,37.80376681537247,NaN,NaN,-132.96971407118946,-117.108377931274,-0.09861126960590244,-0.3145196472349383,-0.21590837762903586,412141258,416358784.8,42.671258270332345,60.84504146481408,NaN,NaN,-26.1076307752006,-14.748262311619628
2012-11-13T09:30:00-05:00,34.47,34.85001,34.47,34.58,4295410,5571911.05,31.041169514109953,36.85532381202366,NaN,NaN,-117.2232494107168,-128.58589210545375,-0.0920834989203502,-0.3310127512794736,-0.2389292523591234,407845848,412782604.2,37.89267822812729,58.741571669129534,NaN,NaN,-27.901345003006305,-16.62727412467487
2012-11-14T09:30:00-05:00,34.64999,34.67999,34.14,34.2,8883922,5819442.55,26.133182033143783,36.12847764521854,NaN,NaN,-144.14876578298038,-135.97029195787053,-0.10523728940894239,-0.3704758641203014,-0.26523857471135903,398961926,408646309.6,33.254095947929954,56.50199897067437,NaN,NaN,-31.11800795713468,-18.697378957883412
2012-11-15T09:30:00-05:00,34.11,34.23,33.96001,34.19,6756664,5948683.35,26.016603909049024,35.3933044695495,NaN,NaN,-152.5990221121736,-138.3008392761769,-0.10618516503085013,-0.3979700309999217,-0.29178486596907155,392205262,404659110.4,29.50469223337838,54.34867047475268,NaN,NaN,-33.721483294680596,-20.843679577425867
2012-11-16T09:30:00-05:00,34.11,34.45,34.08,34.41,7026371,6026778.45,33.0884562345944,34.764497635614845,NaN,NaN,-113.81350785677294,-132.15085184676664,-0.08451284032757855,-0.39742591637854474,-0.3129130760509662,399231633,402077185.4,27.35390813729572,52.01821450473892,NaN,NaN,-33.86947892311806,-22.704508055381893
2012-11-19T09:30:00-05:00,34.59,34.98,34.59,34.97,8628230,6082186.45,46.980967257755474,35.27452494251684,NaN,NaN,-27.894819173827752,-111.1358728672943,-0.027908083803045436,-0.347798180804773,-0.31989009700172755,407859863,401220906.4,26.65981272197328,49.60416921808662,NaN,NaN,-29.166795571427933,-23.627691986245612
2012-11-20T09:30:00-05:00,34.99001,35.11,34.8101,35.10001,5457996,6106901.1,49.597379836962304,35.89722702025652,NaN,NaN,5.232782552258134,-86.6446664746993,0.020246980264700898,-0.2945813716708514,-0.3148283519355523,413317859,402315308.6,29.134834061072695,47.23076336847157,NaN,NaN,-24.52419737877644,-23.755764185178588
2012-11-21T09:30:00-05:00,35.2,35.2,35.02,35.14999,3736963,5995567.4,50.60651257471174,36.55309208836799,NaN,NaN,32.877429490921976,-51.23942741991884,0.05542809816848204,-0.24554322922494976,-0.3009713273934318,417054822,405933887.8,36.73692466678801,45.080577264159864,NaN,NaN,-20.530209926769196,-23.29497071969153
2012-11-23T09:30:00-05:00,35.23,35.675,35.23,35.67,3058212,5898069.4,59.65685582839999,38.13465820912432,NaN,NaN,104.20748858913934,0.12187472034375162,0.11050303030577718,-0.1628425395112103,-0.2733455698169875,420113034,411515442.2,46.305210489937366,43.41524854788745,NaN,NaN,-13.608158750101362,-21.911140438321507
2012-11-26T09:30:00-05:00,35.5,35.52,35.31,35.41,4365086,5909947.7,54.299645575694406,39.40918404040787,NaN,NaN,81.0864255875062,39.10186140919958,0.12512962613482032,-0.11693353714846211,-0.24206316328328242,415747948,414818705.2,51.026073909120086,42.20273884273884,NaN,NaN,-9.740615254804299,-20.172493983533336
2012-11-27T09:30:00-05:00,35.45,35.60001,35.35001,35.38,3345074,5819436.35,53.70042237146212,40.11276009567901,NaN,NaN,86.91601969261754,62.064029182488625,0.1280301050066545,-0.08202553202496432,-0.2100556370316188,412402874,415727307.4,52.269166908914414,40.98987593967916,NaN,NaN,-6.942905750499817,-18.28255280738569
2012-11-28T09:30:00-05:00,35.36,35.74001,35.25999,35.72,6404363,5912762.5,59.196260576964704,41.736003847997594,NaN,NaN,105.847742269605,82.187021125958,0.14674956215247595,-0.02661868434102388,-0.17336824649349983,418807237,416825183,53.795288016975064,40.33579482090324,NaN,NaN,-2.6614350428018847,-16.05096455530229
2012-11-29T09:30:00-05:00,35.7,35.96001,35.69,35.91,14168730,6090823.2,61.916768936474966,43.92085405395728,NaN,NaN,145.03650019601756,104.61883526697711,0.1644956220306913,0.0322512810448643,-0.132244340985827,432975967,420009412,57.99067065431039,40.735838116840526,NaN,NaN,1.752148101138189,-13.507662747239365
2012-11-30T09:30:00-05:00,35.89,36.07001,35.84,36.03999,5690563,6128142.35,63.69996136996373,46.23307514802331,NaN,NaN,152.88864089278403,114.35506572770605,0.17649668077427721,0.08837650998201951,-0.08812017079225769,438666530,423720111.2,62.28802110408579,41.920188239302924,NaN,NaN,5.9073306755973265,-10.734092258262695
2012-12-03T09:30:00-05:00,36.00999,36.11,35.88,35.89951,8409398,6317722.6,60.408047513783124,48.31015953807645,NaN,NaN,129.67961281509244,124.0737031732233,0.16660473360583342,0.12013574621503409,-0.04646898739079933,430257132,426621948,65.2792271115521,43.5350431565329,NaN,NaN,8.314480591952035,-8.012867565374876
2012-12-04T09:30:00-05:00,35.84,35.94501,35.75999,35.825,5125164,6101921.8,58.67602037777573,50.28407745690971,NaN,NaN,98.68533934032784,126.42756710276535,0.14733955207946964,0.13770545270853773,-0.00963409937093191,425131968,429167766.8,67.69976493759522,45.66412077863776,NaN,NaN,9.760136855137933,-5.473866933873046
2012-12-05T09:30:00-05:00,35.82001,36.05,35.71001,35.89,6201836,6239844.8,59.75995193522192,52.685989592772444,NaN,NaN,95.10619529663676,124.27925770817171,0.13177670713338674,0.1550867845458015,0.023310077412414767,431333804,431673080.2,69.92200335693649,48.28325702213822,NaN,NaN,11.2631090081766,-3.0828703707230964
2012-12-06T09:30:00-05:00,35.97,36.00999,35.87,35.92999,4850086,6178181.5,60.44733402835775,55.14532745843735,NaN,NaN,90.23438413483785,113.31883449593576,0.11745381953477636,0.17012735183088523,0.05267353229610887,436183890,432314664.8,70.48207976157326,51.21021327415214,NaN,NaN,12.696896017666207,-0.8286180295246246
2012-12-07T09:30:00-05:00,36.07001,36.19,35.97,36.17999,4591453,6032647.1,64.52688478451546,57.39092949771743,NaN,NaN,100.21605334272638,102.78431698592424,0.1177935891801234,0.19991551877126312,0.08212192959113972,440775343,432736427.4,70.86613639539074,54.31822957830179,NaN,NaN,15.167506259475394,1.4565425831896635
2012-12-10T09:30:00-05:00,36.10001,36.24001,36.10001,36.14,7959039,6112884,63.400401718015715,58.56374624487887,NaN,NaN,96.9761822564246,96.24363087419066,0.10853085728944,0.2177855012029397,0.10925464391349972,432816304,433248261.8,71.35325077608326,57.51061801073821,NaN,NaN,16.896728769272144,3.6622834669157323
2012-12-11T09:30:00-05:00,36.27,36.44501,36.11,36.16,4862078,6190831.9,63.74132695417624,59.574028181822726,NaN,NaN,99.23428733566604,96.3534204732583,0.09731608905411421,0.23089975523114248,0.13358366617702827,437678382,435757544.6,73.67692043305624,60.692195608737045,NaN,NaN,18.42505289962863,5.77125052873186
2012-12-12T09:30:00-05:00,36.28,36.28999,36.05,36.08,4649234,6208523.1,61.282303955125364,60.336584708995126,NaN,NaN,81.32899558183767,93.59798053029849,0.0788621495038766,0.23216135305687402,0.15329920355299742,433029148,436096613.4,73.98400807019257,63.35270156612308,NaN,NaN,19.090321765817063,7.673974991172603
2012-12-13T09:30:00-05:00,36.19,36.23,35.94,36.02,4965633,6012608.65,59.43049249937614,60.32041589977914,NaN,NaN,67.11777791016765,88.97465928536445,0.05793483410988057,0.22571774619034812,0.16778291208046756,428063515,434472538.4,69.78459921089652,65.02980076047731,NaN,NaN,19.176575194507752,9.317203591649053
2012-12-14T09:30:00-05:00,35.92999,36.0955,35.92,35.96001,2437006,5796625.75,57.55775117367608,60.5531377282064,NaN,NaN,51.9430113980417,79.32005089642752,0.03642289207865687,0.21331152717878865,0.17688863510013178,425626509,431442771.6,62.64129956410331,65.85945973583325,NaN,NaN,18.7656584495674,10.666982857065959
2012-12-17T09:30:00-05:00,36.03999,36.12,35.92,36.03999,6632781,5776946.25,59.394867343694685,60.959883797651585,NaN,NaN,53.568469984688285,70.63850844208025,0.0245217522113213,0.20754082536428342,0.18301907315296212,432259290,431331368.8,62.38841935034685,66.58226348164986,NaN,NaN,18.872996367285893,11.839270501383092
2012-12-18T09:30:00-05:00,35.97,36.13,35.78,36.03,8218910,5756480.25,59.05104460996283,60.94951122858003,NaN,NaN,39.83435042610502,58.758521060168036,0.013470789118463639,0.19985755955104167,0.18638677043257804,424040380,428603768.4,56.38639513145885,66.76734256125584,NaN,NaN,18.877973997912022,12.844799572315797
2012-12-19T09:30:00-05:00,36.08,36.10001,35.67,35.67,16482199,6307690.4,48.21869189588312,59.971077154252036,NaN,NaN,-11.934122437260706,40.105897456348366,-0.018835513062709558,0.16284237910419108,0.18167789216690064,407558181,423509575,47.24470900502399,65.99977387202111,NaN,NaN,15.754639398905542,13.260490976114331
2012-12-20T09:30:00-05:00,35.73,35.89,35.63,35.87,5870613,6414372.9,53.339694155344745,59.23105806749354,NaN,NaN,-32.78239773686037,20.125862326942762,-0.02698987857393556,0.1479405439494812,0.17493042252341676,413428794,420582630.8,42.93735144195825,64.61758318186914,NaN,NaN,14.472899571892416,13.433692204082629
2012-12-21T09:30:00-05:00,35.17999,35.42999,34.94,35.17,8263828,6674653.7,38.85567390288072,57.69160280957193,NaN,NaN,-225.21675150199658,-35.30609025306488,-0.07695319480978341,0.07873892901118751,0.15569212382097092,405164966,416490322.2,37.75453855600239,62.651533999329864,NaN,NaN,7.788994385732828,12.627306801461229
2012-12-24T09:30:00-05:00,35.05,35.0901,34.99001,35.06,4714586,6692128.7,37.148569713790216,56.1539277621444,NaN,NaN,-237.00459415290538,-93.42070308058359,-0.11267457823888766,0.01484890102236136,0.12752347926124902,400450380,410128540.2,31.407650753040116,60.0592401290045,NaN,NaN,1.9736738570728334,11.105359237977172
2012-12-26T09:30:00-05:00,35.05,35.08,34.7,34.75999,11087559,7079252.95,32.90271570990305,54.23555374605019,NaN,NaN,-243.1454149592605,-150.0166561576567,-0.14946600629712603,-0.05930902861015852,0.09015697768696751,389362821,403193028.4,26.230581362212163,56.93842427223848,NaN,NaN,-4.465575819762573,8.88093994401435
2012-12-27T09:30:00-05:00,34.75999,34.89999,34.56,34.82001,6487988,7083434.2,34.51524680425351,52.38326180147131,NaN,NaN,-206.84943801286454,-188.99971927277747,-0.16168251337844683,-0.11194616403609103,0.049736349342355796,395850809,400851554,24.747466263449198,53.67166616522962,NaN,NaN,-8.931995556716817,6.336234872481327
2012-12-28T09:30:00-05:00,34.63,34.81,34.45,34.45,15265484,7138271.9,29.76599012397783,49.90034075429006,NaN,NaN,-182.8727736003,-219.01779444546543,-0.18493052941726276,-0.18142681242922265,0.003503716988040105,380585325,394282860.2,21.136848874001842,50.11957419941613,NaN,NaN,-14.518215247287058,3.357027712514415
2012-12-31T09:30:00-05:00,34.38,34.89999,34.33,34.89999,17880128,7747750.15,40.490449603425354,48.26391560324789,NaN,NaN,-130.84242858369575,-200.14292986180524,-0.16112220372387842,-0.19789903766680794,-0.03677683394292951,398465453,392942957.6,20.480448108566122,46.485802580307755,NaN,NaN,-15.447640846094608,0.6706464898559834
2013-01-02T09:30:00-05:00,35.39999,35.82001,35.28999,35.8,10814074,7867983.95,55.218767419598684,47.655161350778066,NaN,NaN,-0.024969968186355926,-152.74700502486144,-0.0799814912746463,-0.13675369803623738,-0.05677220676159109,409279527,394708787,23.837293965682164,42.925829261209614,NaN,NaN,-10.051362037144305,-0.8610690140012005
2013-01-03T09:30:00-05:00,35.75,35.82001,35.61,35.71001,6537258,7938588.65,53.78538407944315,47.11966707394362,NaN,NaN,11.85149433592245,-101.74762316582483,-0.030156672927292336,-0.09446804792070651,-0.06431137499341417,402742269,397384676.6,28.74604052070795,39.69454586481785,NaN,NaN,-6.710860751747629,-1.6967535479649758
2013-01-04T09:30:00-05:00,35.67,35.87,35.67,35.81,5942422,7925617.95,55.17763468393115,46.81589151569755,NaN,NaN,22.70608679088945,-55.836518205074036,0.00962086330706461,-0.052285295859583414,-0.061906159166648024,408684691,399951453,33.1938792006363,37.08092300694212,NaN,NaN,-3.6925164457507496,-1.9818625333629434
2013-01-07T09:30:00-05:00,35.7599,35.78999,35.47501,35.57001,3029822,7834604.75,51.191455596441465,46.36115611732365,NaN,NaN,0.3782157884254969,-19.186320327328925,0.019297096344224704,-0.03778478873636715,-0.05708188508059185,405654869,404965361.8,40.94823909328977,35.5314186875983,NaN,NaN,-2.6495622020079828,-2.077248200312235
2013-01-08T09:30:00-05:00,35.55,35.55,35.41,35.47,4506023,7830333.25,49.58388790630909,45.6603718717961,NaN,NaN,-15.067527870114784,3.9686598153872517,0.0184883861667286,-0.0339714023721811,-0.0524597885389097,401148846,405502040.4,41.72791265088288,34.05566820906516,NaN,NaN,-2.3607369714433872,-2.117746596188114
2013-01-09T09:30:00-05:00,35.56,35.62801,35.48,35.55,4310320,7647897.3,50.911832196417734,45.07899955654288,NaN,NaN,0.908607312202998,4.155375271465123,0.022595989525153605,-0.024214801632467697,-0.0468107911576213,405459166,404737968.2,40.899956003244796,32.949493985621295,NaN,NaN,-1.7142542320784053,-2.060104829886727
2013-01-10T09:30:00-05:00,35.66,35.78,35.58,35.75999,4083290,7608957.9,54.31349856649925,45.51434289015832,NaN,NaN,30.659195181043707,7.916915440489373,0.037813872896364384,0.00045654996283417404,-0.03735732293353021,409542456,406098005.6,43.06545471328706,32.650975821925805,NaN,NaN,-0.10904637117261197,-1.7813821929275675
2013-01-11T09:30:00-05:00,35.8,35.92,35.75999,35.92,3021828,7527587.6,56.771693456116544,45.759485697356304,NaN,NaN,60.66335058772684,15.508368199856857,0.05592192564212687,0.032545084119128376,-0.023376841522998494,412564284,406873924.2,44.31896363671885,32.74966240726585,NaN,NaN,1.9804617869924546,-1.2439759100818502
2013-01-14T09:30:00-05:00,35.91,36.06,35.88651,36.03,5080805,7533346.2,58.42770240835738,47.15748773346178,NaN,NaN,82.93285394362346,32.01929583089644,0.07157324776498711,0.06608971818323539,-0.005483529581751717,417645089,409271968.2,48.12061315672851,33.49009630731772,NaN,NaN,4.200421019527801,-0.4662049201376144
2013-01-15T09:30:00-05:00,35.96001,36.17,35.88,36.14,4265840,7624787.9,60.07482516591835,48.795077408613786,NaN,NaN,93.79666082269836,53.79213356945907,0.08470114065050256,0.10039289623137648,0.015691755580873924,421910929,413424384.8,53.97985235778628,35.10239642194244,NaN,NaN,6.533785421977749,0.5337937001645803
2013-01-16T09:30:00-05:00,36.05,36.17,36.02,36.09,3322521,7459274.9,58.93185716895307,50.65430179854592,NaN,NaN,97.71355481706121,73.15312307043071,0.08515533389547217,0.12213592295021414,0.03698058905474197,418588408,416050233.2,57.266606293154105,37.319255345581155,NaN,NaN,8.146007630992917,1.621252833140057
2013-01-17T09:30:00-05:00,36.25,36.4399,36.16,36.33,6186406,7357649.7,62.60918545014735,52.66101170182406,NaN,NaN,127.5367652948728,92.52863709319652,0.09595512445171768,0.15692449461938907,0.060969370167671386,424774814,419096704.8,60.76748823695009,39.89211405797407,NaN,NaN,10.639759322200707,2.909610903005864
2013-01-18T09:30:00-05:00,36.39999,36.48,36.245,36.48,5659426,6816511.05,64.73458709277783,55.15876862816692,NaN,NaN,130.98601074412568,106.5931691244763,0.10671090122643628,0.19435799670071674,0.08764709547428046,430434240,422670696,64.44728537237557,42.98571666500077,NaN,NaN,13.386990163741439,4.406379368825232
2013-01-22T09:30:00-05:00,36.45,36.505,36.325,36.49001,3817502,6713855.5,64.87806400925365,56.900741085726075,NaN,NaN,124.49880863689177,114.90636006312995,0.10769820493684468,0.2222698516453363,0.11457164670849163,434251742,425992026.6,67.4981899366957,46.34412679558146,NaN,NaN,15.679740870035715,6.016859583283873
2013-01-23T09:30:00-05:00,36.47,36.5,36.39,36.48,3602366,6480782.4,64.59504412830024,57.570475136347625,NaN,NaN,115.22522854029144,119.19207360664856,0.1009879672615904,0.24080660578547963,0.13981863852388923,430649376,427739716,69.00541633390807,49.570421250454736,NaN,NaN,17.51541792438518,7.659510774869774
2013-01-24T09:30:00-05:00,36.5,36.64,36.48,36.58,4568992,6473502.7,66.18218407968232,58.45596085065042,NaN,NaN,119.10645057116393,123.47065275746914,0.09659523071046194,0.26056267691196666,0.16396744620150472,435218368,431065708,71.69551286904357,52.638240703907286,NaN,NaN,19.531097559671643,9.355451744127183
2013-01-25T09:30:00-05:00,36.72,36.78999,36.655,36.75999,3930785,6115664,68.88578780358496,59.4351146449114,NaN,NaN,129.3953436277364,123.84236842404184,0.09876994833392053,0.28742988161890537,0.18865993328498484,439149153,433940575.8,73.81132429226174,55.53948678188052,NaN,NaN,22.073817624465484,11.172361155604083
2013-01-28T09:30:00-05:00,36.75999,36.85001,36.66,36.78999,5114645,6046996.85,69.32596341134345,60.73043663169012,NaN,NaN,122.34954735552355,122.11507574632142,0.09514988862253795,0.3075972940631573,0.21244740544061932,444263798,436706487.4,75.69385815140188,58.021316714602825,NaN,NaN,24.333038193146198,13.052457875252957
2013-01-29T09:30:00-05:00,36.765,37.05,36.74001,36.99001,4868824,5527163.85,72.15448364958691,62.34262204192425,NaN,NaN,135.65548173774323,124.34641036649172,0.09872095761237001,0.33584860245608184,0.23712764484371182,449132622,439682663.4,77.56282831068512,60.58095354744584,NaN,NaN,27.16037800859678,15.067875037159217
2013-01-30T09:30:00-05:00,36.97,37.06,36.8801,36.92,4374480,4851881.45,69.73075463135582,63.68683078727697,NaN,NaN,127.62094673157841,126.82555400474912,0.08915439662717262,0.3485706406276776,0.259416244000505,444758142,442504416.6,79.1961619369869,63.316396828427415,NaN,NaN,28.927389615910332,17.047805691266518
2013-01-31T09:30:00-05:00,36.95,37.00999,36.86,36.87,4374875,4529921.5,67.97460293004872,64.66262395610192,NaN,NaN,107.90943150988929,124.58615019249419,0.07292870917564753,0.35057713047006445,0.2776484212944169,440383267,443537396.4,79.77655136682651,65.93861801796595,NaN,NaN,29.97243523869338,18.89418134089893
2013-02-01T09:30:00-05:00,37.12,37.22,36.98351,37.17,4855383,4445827.75,72.45677377658718,65.78298683613555,NaN,NaN,125.83014051169536,123.87310956928597,0.07554975066764086,0.372085609628968,0.2965358589613271,445238650,444755295.8,80.4684108237212,68.52072138846611,NaN,NaN,32.23965128351464,20.800677046986888
2013-02-04T09:30:00-05:00,37.05,37.05,36.78999,36.82001,4500926,4373752.95,61.621387025439816,66.01110716592714,NaN,NaN,82.3647769703807,115.87615549225741,0.048193120944785284,0.3567772601423087,0.3085841391975234,440737724,444050081,78.78761369658145,70.71122142702704,NaN,NaN,30.961071773871197,22.25216200797036
2013-02-05T09:30:00-05:00,37.03,37.355,37.02,37.25999,7608625,4602693.1,68.08310553829173,66.58312719252524,NaN,NaN,121.35578195475966,113.01621553566069,0.05378534541816654,0.3758158209702316,0.32203047555206504,448346349,443892826.4,78.39438837857259,72.4551168570832,NaN,NaN,31.960919541054277,23.63912736983949
2013-02-06T09:30:00-05:00,37.16,37.32001,37.10001,37.31,2893646,4522074.25,68.72761364698721,67.2828240838134,NaN,NaN,115.6996734322218,110.63196087578937,0.05472655768791418,0.39043867266195775,0.3357121149740436,451239995,445189197,79.311097346531,74.02972336089583,NaN,NaN,32.951564316990336,24.969475505146754
2013-02-07T09:30:00-05:00,37.28,37.536,37.25999,37.50999,8721352,4742625.85,71.22962560410224,67.89856980909589,NaN,NaN,133.44640714846952,115.73935600350542,0.06214990603540971,0.41339949751830574,0.35124959148289603,459961347,449104813,81.82015527906992,75.53348529247582,NaN,NaN,34.587361418627985,26.343459207072645
2013-02-08T09:30:00-05:00,37.56,37.67,37.44,37.48,7203988,4898660.75,70.3210386363081,68.2976020622052,NaN,NaN,136.56076106655263,117.88548011447688,0.05842854897744132,0.4242852777046977,0.3658567287272564,452757359,450608554.8,82.68844978625967,76.83642560775327,NaN,NaN,35.613678625014074,27.667776266778564
2013-02-11T09:30:00-05:00,37.53,37.53,37.41,37.48,2957604,4895449.55,70.3210386363081,68.68638596413766,NaN,NaN,118.0698847767574,125.0265016757522,0.04969770742226476,0.42797886300508736,0.3782811555828226,452757359,453012481.8,84.00375801225495,78.0153947560075,NaN,NaN,36.43867150818551,28.92076130126527
2013-02-12T09:30:00-05:00,37.52,37.52,37.38499,37.44,3308302,4806824.4,68.96035174156103,68.99819365079914,NaN,NaN,104.93649128168416,121.74264354113711,0.03561872549471151,0.422804562451212,0.3871858369565005,449449057,453233023.4,84.1229413529461,79.09521797165306,NaN,NaN,36.74849619916891,30.039009143822934
2013-02-13T09:30:00-05:00,37.50999,37.50999,37.366,37.48,3165765,4751820.65,69.59395520093602,69.24189158803155,NaN,NaN,98.41905179998378,118.28651921468949,0.023949907114579116,0.4171232208497244,0.3931733137351453,452614822,453507988.8,84.28020081776971,79.99412425370494,NaN,NaN,37.17732094084678,31.0587679719692
2013-02-14T09:30:00-05:00,37.59,37.69,37.52,37.558,7964023,4983895.75,70.84378586175922,69.38174859218685,NaN,NaN,111.3554298697319,113.86832375894198,0.01677391583683213,0.41414070853118545,0.3973667926943533,460578845,453631488.4,84.35515402523303,80.74725494891717,NaN,NaN,37.877062055114024,32.03280998384703
2013-02-15T09:30:00-05:00,37.5,37.6875,37.42999,37.61,5690453,4959098.1,71.67955202923207,69.54986206489319,NaN,NaN,98.39711327229232,106.23559420008993,0.011092628460405707,0.4112325782698605,0.4001399498094548,466269298,456333876.2,85.9354416257739,81.47879662565802,NaN,NaN,38.69353983439257,32.98434281963925
2013-02-19T09:30:00-05:00,37.71001,38,37.7,37.99001,8141211,5083187.35,76.89249600079782,69.8882915185511,NaN,NaN,144.0156245443041,111.42474215359925,0.027553564569025912,0.43458190552073717,0.40702834095171125,474410509,460664506.2,88.02325524660041,82.2259699782234,NaN,NaN,41.0505993833628,34.13666518588548
2013-02-20T09:30:00-05:00,38.03,38.134,37.91,37.92,10454371,5415030.8,74.18330964663434,70.20633116249958,NaN,NaN,146.4162662953885,119.72069715634014,0.02824788270230022,0.44233819432958654,0.4140903116272863,463956138,463565922.4,89.18192398670404,82.93923869606034,NaN,NaN,42.22313831556001,35.291875632981835
2013-02-21T09:30:00-05:00,37.89,38.118,37.8,38.03999,9752320,5722528.5,75.75969591572117,70.76240923290474,NaN,NaN,132.60822811833873,126.55853242001112,0.031084566321650575,0.45294601952934954,0.42186145320769897,473708458,467784649.6,90.60512885014789,83.71270851629758,NaN,NaN,43.68437732100055,36.49080444555594
2013-02-22T09:30:00-05:00,38.12,38.25999,38.02,38.25999,6182352,5803196.5,78.36780085032001,71.18462545245708,NaN,NaN,153.72265680657506,135.03197780737975,0.041426896024425564,0.4736450732382309,0.43221817721380534,479890810,471647042.6,91.68382848097146,84.51380977752976,NaN,NaN,45.77736796474344,37.817456376868435
2013-02-25T09:30:00-05:00,38.39,38.44991,37.72,37.74001,7873809,6000347.7,61.51973365192596,71.1773644972061,NaN,NaN,106.53972284512668,136.66049972194662,0.008613242123220621,0.4429847298678311,0.4343714877446105,472017001,472796583.2,91.97901068836202,85.45605241979979,NaN,NaN,41.903613376596425,38.40119309111529
2013-02-26T09:30:00-05:00,37.83,37.9599,37.67,37.83,7656590,6127444.95,63.00218614486614,70.81444168338999,NaN,NaN,70.47704432528398,121.9527836781426,-0.010622371193344526,0.42109352375292985,0.4317158949462744,479673591,473849199.6,92.25026949055191,86.4457582135126,NaN,NaN,39.33092040592358,38.534011278945044
2013-02-27T09:30:00-05:00,37.88,38.22,37.71001,38.11,6406730,6204340.25,67.23217129637693,70.70762437263211,NaN,NaN,99.49366938235117,112.56826429553514,-0.008188964251793884,0.42147968963153204,0.4296686538833259,486080321,478274036.2,93.27920537863851,87.44348021580599,NaN,NaN,38.55452244198291,38.53694144509331
2013-02-28T09:30:00-05:00,38.14999,38.34,38.07001,38.09,8069629,6389097.7,66.64604151724026,70.38022550928483,NaN,NaN,116.90172192929997,109.42696305772738,-0.011428033263342963,0.4153836123041472,0.4268116455674902,478010692,479134483,93.4610177138392,88.27497038971809,NaN,NaN,37.76377797867305,38.42648952131899
2013-03-01T09:30:00-05:00,37.89999,38.25,37.89,38.22,6584785,6499593.2,68.56442779662501,70.25475330645033,NaN,NaN,95.54627003348688,97.79168570310976,-0.008454006586163298,0.41624413733478605,0.42469814392094934,484595477,480075416.4,93.66290658255235,89.05886016088185,NaN,NaN,37.704871466649415,38.32340122779477
2013-03-04T09:30:00-05:00,38.14999,38.50999,38.12,38.50999,5105930,6512120.55,72.3805946324834,70.40186444903428,NaN,NaN,132.17361138161257,102.91846341040696,0.008487821133542073,0.4353079203378769,0.42682009920433484,489701407,483612297.6,94.36693940646104,89.79908740332515,NaN,NaN,38.896928653974214,38.40533371724897
2013-03-05T09:30:00-05:00,38.64,38.705,38.53999,38.64,8253852,6699766.85,73.90978668639127,70.75539551652214,NaN,NaN,166.77910408614187,122.17887536257851,0.02306738202250347,0.4556543267324642,0.43258694470996073,497955259,487268631.2,94.98697000913705,90.57508945019593,NaN,NaN,40.36354725049024,38.685078507712014
2013-03-06T09:30:00-05:00,38.67,38.73,38.50999,38.55,5795684,6609119.8,70.98001207076058,70.85439957865246,NaN,NaN,145.66485689122035,131.41311286435234,0.021308935707077037,0.459223114343807,0.43791417863673,492159575,488484482,95.17707704127203,91.35343775187468,NaN,NaN,40.65602163363482,38.96664181141527
2013-03-07T09:30:00-05:00,38.64999,38.64999,38.515,38.55,3375848,6633229.9,70.98001207076058,70.86413002215257,NaN,NaN,129.39834335039177,133.91243714857072,0.015097346026045622,0.456785861169287,0.44168851514324137,492159575,491314258.6,95.59570728770147,92.15633441347957,NaN,NaN,40.88975071955044,39.241371655434584
2013-03-08T09:30:00-05:00,38.67,38.67999,38.46001,38.62,5178480,6456086.3,71.98184809894923,70.88572259856093,NaN,NaN,120.41463434445491,138.8861100107643,0.010853060712190388,0.45525484103347935,0.44440178032128896,497338055,493862774.2,95.93769654907409,92.87078119371529,NaN,NaN,41.36804774196947,39.54518252493957
2013-03-11T09:30:00-04:00,38.67999,38.73,38.62,38.66,3624278,6277100.8,72.56469677929385,70.57659408273922,NaN,NaN,120.49005929291928,136.54939959302567,0.006125069876916078,0.4520581176674341,0.445933047790518,500962333,496114959.4,96.21723835025328,93.45606570111907,NaN,NaN,41.926808916607996,39.88541486660649
2013-03-12T09:30:00-04:00,38.64999,38.67999,38.56,38.62,5323293,6395385.25,70.97467014853385,70.34740554716062,NaN,NaN,99.70217070444473,123.13401291668625,-0.003777622494663735,0.44121101967218834,0.4449886421668521,495639040,495651715.6,94.77263849275111,93.855402451551,NaN,NaN,41.97499147973109,40.183925811338575
2013-03-13T09:30:00-04:00,38.7,38.75,38.57001,38.72,4112969,6435618.6,72.59158667629254,70.12111203005857,NaN,NaN,100.81795251987204,114.16463204241657,-0.007461519140761985,0.43566174324089957,0.44312326238166155,499752009,497170202.4,95.03574687651358,94.17187516771999,NaN,NaN,42.44834299943806,40.507413981067074
2013-03-14T09:30:00-04:00,38.77,38.89,38.69,38.85001,4250832,6489871.95,74.57465947006034,69.85017336004003,NaN,NaN,112.56770443341775,110.79850425902175,-0.005122304752080975,0.43672038144156033,0.4418426861936413,504002841,499538855.6,95.42276434284258,94.4389420149965,NaN,NaN,43.41001769987366,40.9220716551823
2013-03-15T09:30:00-04:00,38.59,38.59,38.41319,38.485,9104398,6546890.7,61.188973886136594,69.82654766248365,NaN,NaN,43.91883390514547,95.49934417115988,-0.030709891711827808,0.40345532155385655,0.43416521326568436,494898443,499050933.2,93.80052152033244,94.5690499315658,NaN,NaN,40.19840747575267,40.818691058120926
2013-03-18T09:30:00-04:00,38.28,38.52699,38.2,38.37,5045262,6514631.15,57.6764016886205,69.44613448703753,NaN,NaN,9.122168544386192,73.22576602145327,-0.056435064948571756,0.36362138207996964,0.4200564470285414,489853181,496829102.8,86.58218322688133,94.1641866270179,NaN,NaN,36.4236667843732,40.19083044758553
2013-03-19T09:30:00-04:00,38.41,38.71001,38.41,38.69,8304820,6522811.6,63.888452633508486,69.20729743968978,NaN,NaN,60.399310464859695,65.36519397353625,-0.053008607819002684,0.35379568725478805,0.40680429507379073,498158001,497332895,86.82967104066488,93.70350560287693,NaN,NaN,35.00138307381168,39.4494808227607
2013-03-20T09:30:00-04:00,38.82001,39.13,38.82001,39.06,6377023,6318944.2,69.46849033164071,69.40890092643266,NaN,NaN,144.65757291899723,74.1331180533613,-0.028178393550797654,0.3715813031352937,0.39975969668609135,504535024,498289498,87.308361358302,93.26403014891,NaN,NaN,35.68506873801054,38.91170766779639
2013-03-21T09:30:00-04:00,38.99001,39.14,38.91,38.94,5588633,6110759.85,65.91123771669697,69.21938734929495,NaN,NaN,131.75145948705836,77.96986906408941,-0.022440790841558478,0.37170870813414325,0.39414949897570173,498946391,497278208,83.83912863534563,92.56233172410951,NaN,NaN,35.027622856138166,38.356838408988075
2013-03-22T09:30:00-04:00,39.11,39.33,39.03,39.3,6132457,6108265.1,70.75023296626608,69.10293294456514,NaN,NaN,167.89873216485728,102.76584871603177,0.0017127839470322814,0.3962904789094921,0.3945776949624598,505078848,499314289,85.1210296655961,91.90190959976202,NaN,NaN,36.17160083475204,38.04466161266864
2013-03-25T09:30:00-04:00,39.36,39.485,39.14,39.27,6282102,6028679.75,69.86025841546225,68.81368092521306,NaN,NaN,175.14725891990915,135.97086679113636,0.011250170286016603,0.40864040781998057,0.39739023753396396,498796746,501103002,86.15967284751389,91.27138837393179,NaN,NaN,36.75677353606936,37.86067760172589
2013-03-26T09:30:00-04:00,39.42,39.66,39.38,39.64,7227848,6007242.65,74.17500345862177,69.04189459577458,NaN,NaN,205.9109908212827,165.07320286242094,0.03662787142905427,0.4431750768202818,0.4065472053912275,506024594,502676320.6,87.01807961908771,90.68860284377577,NaN,NaN,38.78210926466712,37.99231069643178
2013-03-27T09:30:00-04:00,39.55,39.61,39.39,39.61,5357883,5954800.3,73.25924223458844,69.20469675033371,NaN,NaN,164.49235034195993,169.0401583470135,0.04499308612968195,0.46278856305332994,0.417795476923648,500666711,501902658,84.2508778726295,89.87825788555632,NaN,NaN,40.050999085069606,38.286409037665756
2013-03-28T09:30:00-04:00,39.64,39.8,39.49001,39.77,5040383,5803338,75.029876165943,69.42241304083326,NaN,NaN,162.4199323152608,175.17385291265398,0.05427949331827553,0.4856448435714924,0.4313653502532169,505707094,503254798.6,85.14027753514476,89.10701367027568,NaN,NaN,41.67268191076893,38.77016230525192
2013-04-01T09:30:00-04:00,39.73,39.8,39.62,39.75,5370023,5742599.9,74.36700358970711,69.55114924157706,NaN,NaN,143.71093701719482,170.3362938831215,0.052045583869914425,0.4964223300906099,0.44437674622069545,500337071,502306443.2,81.65715459485287,88.06700768774706,NaN,NaN,42.76172645087447,39.340385754626574
2013-04-02T09:30:00-04:00,39.87,40.23,39.85001,40.17999,8043809,5889493.85,78.71993493332447,70.10438244049068,NaN,NaN,173.36736209697415,169.9803145185345,0.07130675649170443,0.533510191835326,0.46220343534362157,508380880,504223270,83.15700992089347,87.23731993261437,NaN,NaN,45.227035145231845,40.18133566757018
2013-04-03T09:30:00-04:00,40.27,40.27,39.645,39.74001,11956645,6074633.5,66.31117392431668,69.65578152963526,NaN,NaN,121.09183339693585,153.01648303366514,0.04734895211633705,0.5213896254890429,0.47404067337270583,496424235,502303198.2,76.41655228971696,85.9073774621289,NaN,NaN,43.02548463785033,40.58764266332449
2013-04-04T09:30:00-04:00,39.82001,40.02,39.75999,39.95,8889738,6229336.2,68.83608488716845,69.24588334514297,NaN,NaN,108.82412964231605,141.88283889373636,0.03892988705561018,0.5227030321922186,0.4837731451366084,505313973,503232650.6,77.3726844343549,84.61808604009407,NaN,NaN,42.11789143516778,40.80624963073067
2013-04-05T09:30:00-04:00,39.61,39.72501,39.5,39.66,8528055,6486946.55,61.932668761516915,69.29900440767014,NaN,NaN,63.208863266369974,122.04062508395819,0.00869462124472975,0.49464142169252057,0.4859468004477908,496785918,501448415.4,71.38921771707726,83.01727862557586,NaN,NaN,38.94062631905371,40.53973201477682
2013-04-08T09:30:00-04:00,39.66,40.11,39.522,40.11,9479023,6701973.7,67.39665126278581,69.99330794868193,NaN,NaN,92.76260724983086,111.85095913048539,0.013575620473421535,0.5029163260395677,0.4893407055661462,506264941,502633989.4,72.88947056708743,82.03922772130487,NaN,NaN,38.18207651481138,40.202924086210324
2013-04-09T09:30:00-04:00,40.17999,40.22,39.9332,40.07001,6614449,6851482.25,66.48339298352836,70.1786608308262,NaN,NaN,103.51152726089722,97.87979216327001,0.008909985589625191,0.5004781875531776,0.49156820196355244,499650492,500887911.8,67.2928816042471,80.64374276156073,NaN,NaN,37.29739825519546,39.787848967493915
2013-04-10T09:30:00-04:00,40.17,40.42999,40.12,40.37,7325621,6951598.65,69.79043579622589,70.20165693543943,NaN,NaN,121.59344422908016,97.98011432969888,0.020181707368641444,0.5167953361743542,0.4966136288057128,506976113,502998287.4,70.2646351337057,79.42633374551815,NaN,NaN,37.68024164425359,39.48676220703101
2013-04-11T09:30:00-04:00,40.46001,40.71001,40.38,40.565,5973109,7044605.65,71.74221381001402,70.61815522781923,NaN,NaN,140.56177313038978,104.32764302731361,0.034105558547053105,0.5392455769895292,0.5051400184424761,512949222,504525337.2,72.2307664646312,78.59716501903856,NaN,NaN,38.642996787360005,39.366224289935154
2013-04-12T09:30:00-04:00,40.41,40.73,40.39999,40.71001,5782840,7121206.05,73.13236922947804,70.78830781804865,NaN,NaN,136.60647503613765,119.00716538126717,0.045693823284857715,0.5622572975485483,0.5165634742636905,518732062,508914566,76.94872308156124,78.01342883446465,NaN,NaN,39.87173588783631,39.43844023249246
2013-04-15T09:30:00-04:00,40.64,40.72,40.06,40.06,11248656,7228418.95,59.097689848948015,70.01955292044049,NaN,NaN,86.75394355255989,117.80543264181297,0.004370247148762441,0.5220262831996436,0.5176560360508812,507483406,509158259,77.18053461158499,77.37206181761258,NaN,NaN,35.988631598675155,38.945610427661414
2013-04-16T09:30:00-04:00,40.35001,40.83,40.28999,40.81,10341105,7493211.1,66.97329608488516,69.50514525088788,NaN,NaN,128.36078182947585,122.7752835555287,0.021384211214739546,0.5443863000693057,0.5230020888545661,517824511,512793062.8,80.35401900836179,76.896057488275,NaN,NaN,35.57703165249683,38.464384888352185
2013-04-17T09:30:00-04:00,40.64,40.7399,40.32001,40.46001,9761816,7566060.9,61.064437784677786,68.63408779017998,NaN,NaN,101.14585271360252,118.68576525243316,0.0038235842171063794,0.5277815691259491,0.5239579849088427,508062695,513010379.2,80.52837198964866,76.63016421091923,NaN,NaN,33.00213248736686,37.68406311678285
2013-04-18T09:30:00-04:00,40.39999,40.58,40.25999,40.38,10303523,7762385.9,59.76626840526464,67.54383009298866,NaN,NaN,77.60670599926199,106.09475182620761,-0.017266391397659953,0.5023749956617678,0.5196413870594278,497759172,509972369.2,71.03714157866688,75.6227973568851,NaN,NaN,30.6118886557668,36.673752479494844
2013-04-19T09:30:00-04:00,40.44,41.06,40.44,41.00999,11227602,8044334.35,65.91134059349558,66.93985416468784,NaN,NaN,134.8230406119526,105.73806494137061,0.005886971929625728,0.5270001019714599,0.5211131300418341,508986774,508023311.6,65.68804895258874,74.48214695386623,NaN,NaN,30.807177200986125,35.83567029685074
2013-04-22T09:30:00-04:00,41.07001,41.188,40.815,41.11,5973102,8036366.6,66.77879471416509,66.08691557760503,NaN,NaN,149.8334062789213,118.35395748664287,0.021721962335219835,0.5482655829608589,0.5265436206256391,514959876,509518605.6,67.69767400612088,73.37790867423962,NaN,NaN,31.255809838076765,35.18140451702589
2013-04-23T09:30:00-04:00,41.22,41.44,40.89999,41.42999,13184363,8381479.65,69.45689842440204,66.31161018475397,NaN,NaN,163.5310254845617,125.38800621766003,0.04612894295134917,0.5842047993148256,0.5380758563634764,528144239,511582551.2,70.28472897957192,72.93992129494355,NaN,NaN,32.53967911052938,34.80401517324067
2013-04-24T09:30:00-04:00,41.25,41.37,40.73,40.77,30015472,9520860.85,58.90872499680053,65.6025130497277,NaN,NaN,105.60910575926954,126.28065682679343,0.011984055329924637,0.5530559255258822,0.5410718701959576,498128767,509595765.6,64.8966771708624,72.0487779189798,NaN,NaN,29.86888242773526,34.09899620959704
2013-04-25T09:30:00-04:00,40.86,41.00999,40.75999,40.89999,12200719,9863002.65,60.19105503388393,65.47811206918249,NaN,NaN,86.17887103762065,127.99508983446518,-0.00668271355728578,0.5327184782493504,0.5394011918066361,510329486,512109828.4,68.21696654286427,71.82218854939315,NaN,NaN,28.23736476252112,33.261620288586194
2013-04-26T09:30:00-04:00,40.8,41.00999,40.8,40.89,9481738,10085070.4,60.03599419364017,64.9523508499578,NaN,NaN,80.16036669570657,117.06255505121597,-0.023587519937663615,0.5099167918845566,0.5335043118222202,500847748,510482023.2,63.99618581549385,71.18695392427932,NaN,NaN,26.927233924963573,32.356707950925816
2013-04-29T09:30:00-04:00,41.00999,41.07001,40.86,41.02,6695980,10151368.25,61.42850692694363,64.59128756020174,NaN,NaN,86.37606929011963,104.37108765345563,-0.029514188982284417,0.49661157559436475,0.5261257645766492,507543728,508998793.6,60.33310341380766,70.6898269106765,NaN,NaN,26.27961005568615,31.48855110874872
2013-04-30T09:30:00-04:00,40.98,41.03,40.765,40.94,11354863,10316920.95,60.042016893328025,63.89497192428047,NaN,NaN,67.72215158456893,85.20931287345708,-0.041583729036950734,0.4741461032804608,0.5157298323174115,496188865,502607718.8,47.67120263705734,69.07601030377305,NaN,NaN,25.348511351382953,30.611402571982183
2013-05-01T09:30:00-04:00,40.89,41.2,40.83501,40.89999,7556512,10096914.3,59.32088014649574,63.00773380545773,NaN,NaN,73.17667495491621,78.72282671258641,-0.054223950293822876,0.447949894450133,0.5021738447439559,488632353,500708436,44.67087865199294,67.1074468885846,NaN,NaN,24.384062059665563,29.721782498794095
2013-05-02T09:30:00-04:00,40.91,41.19,40.77,41.05,9193941,10112124.45,61.20237831953942,62.155591597604975,NaN,NaN,71.91701217721764,75.87045494050582,-0.05430902235731755,0.43428756679730895,0.4885965891546265,497826294,498207797.6,41.011064503531706,64.54047127586821,NaN,NaN,24.074374729953067,28.915009960388232
2013-05-03T09:30:00-04:00,41.27,41.37,41.10001,41.23,12843359,10327889.65,63.390459869225445,62.462218027624786,NaN,NaN,110.52413797361585,81.94320919608768,-0.04448263753648818,0.4329932922340163,0.47747592977050446,510669653,500172178.6,44.834564549880895,62.23004484288934,NaN,NaN,24.40972802260091,28.271398254990043
2013-05-06T09:30:00-04:00,41.2,41.2,40.88409,40.92999,14530719,10580474.45,57.56336019488285,61.79007974976748,NaN,NaN,56.839926446162806,76.03598062729631,-0.05949079076728925,0.4031124413113929,0.46260323207868215,496138934,497891219.8,41.47306489214649,59.45283383458825,NaN,NaN,23.053222326572662,27.52594455093042
2013-05-07T09:30:00-04:00,41.00999,41.25,40.94,41.2401,8152195,10657361.75,61.50270078106067,61.82138424950911,NaN,NaN,87.49559541628615,79.99066939363975,-0.0502059745374005,0.3998457639069315,0.450051738444332,504291129,499511672.6,44.64815354730546,56.889961088706585,NaN,NaN,23.008197795443273,26.880552157289397
2013-05-08T09:30:00-04:00,41.23,41.2999,41.14,41.28999,6623285,10622244.95,62.11204973362923,61.98894005867801,NaN,NaN,111.14386812151307,87.58410802695911,-0.04267372399882163,0.396709583445805,0.4393833074446266,510914414,503968084.8,52.31041960292377,55.55233809043923,NaN,NaN,23.143309326273986,26.346660324287196
2013-05-09T09:30:00-04:00,41.25999,41.3499,40.89999,41,12872438,10967211.4,56.512717941855925,61.31760986927518,NaN,NaN,59.79052696016968,85.15881098354951,-0.05822788623175168,0.36659844965493704,0.4248263358866887,498041976,504011221.2,52.37913682659571,54.60170151001115,NaN,NaN,21.642239023782118,25.674600138500757
2013-05-10T09:30:00-04:00,40.92,41.19,40.92,41.16,8304645,11093301.65,58.723688051048775,60.74224510762401,NaN,NaN,57.40719734772701,74.53542285837175,-0.05858676617311015,0.35159287817030105,0.4101796443434112,506346621,503146614.8,50.79913477669591,53.39466299362365,NaN,NaN,21.000746470952713,25.006906757422467
2013-05-13T09:30:00-04:00,41.12,41.38,41.05,41.23,7821555,10921946.6,59.68930229134329,60.04455966954839,NaN,NaN,100.6188514501212,83.29120785916342,-0.055012783128702336,0.34141366543253326,0.3964264485612356,514168176,506752463.2,56.66951896644396,52.42214799268594,NaN,NaN,20.735017046334537,24.39663679869562
2013-05-14T09:30:00-04:00,41.21001,41.73,41.21001,41.72,7373016,10773542.15,65.73251322304229,60.53197311427994,NaN,NaN,205.83952665115845,106.95999410613788,-0.022232307789834815,0.3686360638239421,0.3908683716137769,521541192,510202475.8,61.41334561611453,52.173338595918246,NaN,NaN,22.32765684569877,24.101068233981785
2013-05-15T09:30:00-04:00,41.7,42.2,41.66,42.13499,11728641,10871883.4,69.85441291752898,61.22221296311174,NaN,NaN,297.0888411732855,144.1489887164924,0.02239953337460776,0.41886778833203664,0.3964682549574289,533269833,514673559.6,66.52776997097801,52.052681697926296,NaN,NaN,25.071512962820336,24.239703195244434
2013-05-16T09:30:00-04:00,42.03,42.11,41.81,41.8768,9313180,10822366.25,64.64446945997007,61.551389767849585,NaN,NaN,223.268814917306,176.84464630791962,0.029108078178658403,0.43285335268075187,0.40374527450209347,523956653,519856495,71.2799463441149,52.572950307113516,NaN,NaN,25.73154879792567,24.45282399562747
2013-05-17T09:30:00-04:00,41.89,41.97,41.64,41.94,9368094,10729390.85,65.32618490880245,61.829795337982354,NaN,NaN,164.51422588980336,198.2660520163349,0.0321393782926061,0.4439194973678511,0.411780119075245,533324747,525252120.2,75.2235843498915,53.63655608826237,NaN,NaN,26.468475999231295,24.740774281856588
2013-05-20T09:30:00-04:00,41.91,41.95,41.48,41.50999,9866551,10924063.3,57.239218594029424,61.62959545946102,NaN,NaN,96.7989603564383,197.5020737975983,0.001158184798146833,0.4132278500729285,0.41206966527478167,523458196,527110124.2,76.42410474738094,55.69033481042834,NaN,NaN,24.559718702243472,24.714909199054713
2013-05-21T09:30:00-04:00,41.63,41.67,41.27,41.55,10408352,10785262.75,57.76313821133788,61.518328178378326,NaN,NaN,54.55771026280374,167.2457105199274,-0.01952435679144454,0.387664219285476,0.40718857607692055,533866548,529575195.4,77.9505996378198,58.0674577379874,NaN,NaN,23.19136710424087,24.49726032836702
2013-05-22T09:30:00-04:00,41.58,42.02,41.34,41.48,16898944,10129436.35,56.45975480648324,61.17956935601717,NaN,NaN,70.49929690831996,121.92780166693426,-0.039643771116784576,0.35763386218093984,0.3972776332977244,516967604,526314749.6,71.36847947510151,60.235844521670955,NaN,NaN,21.69094057203555,24.096357506033954
2013-05-23T09:30:00-04:00,41.14,41.45,41.05,41.31,12831887,10160994.75,53.31349812231097,60.45978637409471,NaN,NaN,-8.573875698632396,75.5592635437466,-0.06464694544607003,0.3164689514901369,0.3811158969362069,504135717,522350562.4,64.26335642082796,61.62361536959575,NaN,NaN,19.502298662783254,23.44006338556957
2013-05-24T09:30:00-04:00,41.32001,41.72,41.32001,41.7,16015762,10487695.95,58.963239889631836,60.55977778086249,NaN,NaN,54.08721445181149,53.47386125614821,-0.05551522301424716,0.311721868168398,0.36723709118264514,520151479,519715908.8,59.98881532558562,62.94616897198426,NaN,NaN,19.226475497223717,22.83812225866302
2013-05-28T09:30:00-04:00,42.06,42.19,41.64,41.77,15727324,10939263.15,59.90120503743447,60.445385227746335,NaN,NaN,104.60240948082249,55.03455108102505,-0.045762230573564266,0.3100343029656898,0.35579653353925406,535878803,522200030.2,62.52019556071499,64.22274340151351,NaN,NaN,19.274900484679574,22.329090576665386
2013-05-29T09:30:00-04:00,41.53,41.57001,40.89,40.97,21415680,11442304,46.749850334966496,59.348085270699,NaN,NaN,-57.25369823237703,32.672269381988905,-0.09154817224826861,0.24136131822891826,0.3329094904771869,514463123,518319345.2,56.50583412300508,64.5224158672336,NaN,NaN,14.856360637207342,21.26155772817138
2013-05-30T09:30:00-04:00,41.02,41.16,40.78999,40.81,15949195,11861938.15,44.63896924754376,58.49996036396242,NaN,NaN,-105.96454772141148,-2.620499543957385,-0.1286927054921322,0.17204360861202161,0.3007363141041538,498513928,514628610,51.437786939180754,64.4551765895611,NaN,NaN,10.618542070612126,19.741126919948627
2013-05-31T09:30:00-04:00,40.72,40.72501,40.03,40.05,33824752,13093478.7,36.26314895366311,56.89563614272059,NaN,NaN,-218.99804042546833,-44.70533248932457,-0.1964710751152814,0.05514747021005206,0.25161854532533345,464689176,506739301.8,42.63493019364533,63.8720191193432,NaN,NaN,3.654334119929429,17.44301366280303
2013-06-03T09:30:00-04:00,40.14999,40.5,39.67999,40.49001,39020432,14402332.35,42.93871887165655,55.699165898457245,NaN,NaN,-191.63252552959815,-93.8492804856065,-0.2028674536908209,-0.001965771788192683,0.20090168190262822,503709608,503450927.6,39.593406388686155,62.6522967923605,NaN,NaN,0.32892848289368803,14.99814435138741
2013-06-04T09:30:00-04:00,40.64,40.78,40.21001,40.5,12962742,14323933.5,43.08447141582892,54.08144862651344,NaN,NaN,-130.88696534835353,-140.9471554514417,-0.1974359765420897,-0.04589328877498389,0.1515426877671058,516672350,499609637,36.33275334771778,60.86082591604645,NaN,NaN,-2.134094137837481,12.550681710069568
2013-06-05T09:30:00-04:00,40.38499,40.4175,40,40.00999,17079152,14770281.35,37.96232937758615,51.80344265937466,NaN,NaN,-161.4059760220945,-161.7776110093852,-0.21633459095735452,-0.11887555092958735,0.09745904002776717,499593198,496635652,33.998299912323574,58.53729234042827,NaN,NaN,-6.008297613904072,9.899398949501906
2013-06-06T09:30:00-04:00,39.99001,40.19,39.7,40.17999,12352680,15056751.1,40.600729283415305,50.08603264676361,NaN,NaN,-148.63016462693335,-170.31073439048959,-0.20687877222753928,-0.16113942525665692,0.045739346970882354,511945878,499322042,37.88093678459546,56.1516488004626,NaN,NaN,-8.228375200499682,7.309716928073108
2013-06-07T09:30:00-04:00,40.39,40.845,40.39,40.67999,18700704,15348164.4,47.652337858781316,48.82361500033353,NaN,NaN,-63.095799141750014,-139.1302861337459,-0.1586152861328393,-0.15252976069516677,0.006085525437672525,530646582,512513523.2,52.62015560266659,54.537118175660815,NaN,NaN,-7.7479324620817955,5.158624158050979
2013-06-10T09:30:00-04:00,40.85001,40.85001,40.49001,40.67999,11190223,15492443.3,47.652337858781316,48.13883780495866,NaN,NaN,-53.752669242228514,-111.55431487627197,-0.12010527324315767,-0.14404606611627457,-0.023940792873116894,530646582,517900918,57.09732814445274,53.15663413259451,NaN,NaN,-7.376794987792747,3.3678499943590183
2013-06-11T09:30:00-04:00,40.45,40.86,40.32001,40.58,20334080,16118069.55,46.375454594237326,47.32543183230863,NaN,NaN,-57.638340971672555,-96.90459000093577,-0.09583469090527155,-0.14373415650470633,-0.04789946559943478,510312502,516628948.4,55.7576596304268,51.57142413206644,NaN,NaN,-7.456291826185353,1.8215440199955368
2013-06-12T09:30:00-04:00,40.73,40.89999,40.38,40.38,14908941,16494865.8,43.844743180309116,46.424359573296194,NaN,NaN,-55.351327411183924,-75.69366027875365,-0.0879253897174926,-0.15780620274630053,-0.06988081302880793,495403561,515791021,54.84474342391535,50.39115727126743,NaN,NaN,-8.26933894924336,0.37998931010426573
2013-06-13T09:30:00-04:00,40.47,41.88,40.22501,40.8,13050191,16560943.3,50.013670705075086,46.1886576149222,NaN,NaN,-3.22113774266693,-46.611854901900365,-0.050918289906083436,-0.13352867541141222,-0.08261038550532879,508453752,515092595.8,54.05037263581491,49.66165842948079,NaN,NaN,-7.076519210317787,-0.6852261928131704
2013-06-14T09:30:00-04:00,40.73,41.02499,40.59,40.7,8453270,16517947.8,48.643485329094645,45.45153228916955,NaN,NaN,-21.97124051035333,-38.386943175621035,-0.0306823590616411,-0.12096333433238016,-0.09028097527073906,500000482,508963375.8,47.54248393302735,48.77263475858376,NaN,NaN,-6.506579376473903,-1.5168480761932752
2013-06-17T09:30:00-04:00,40.83,41.23,40.77499,41.06,9877145,16543400.35,53.574480261244545,44.99962337658456,NaN,NaN,18.428654062485354,-23.950678514678266,0.007406983711520598,-0.08102224563133831,-0.0884292293428589,509877627,504809584.8,43.70215526232981,47.42848902298483,NaN,NaN,-4.4914790873789805,-1.9417953635055187
2013-06-18T09:30:00-04:00,41.06,41.25999,40.92999,41.21001,8441191,16472132.35,55.49216781349751,45.62407462505106,NaN,NaN,40.727727211141875,-4.277464878115377,0.041271839676473035,-0.036839429747267616,-0.07811126942374065,518318818,506410848,45.5288087262245,46.64441578035764,NaN,NaN,-2.244702398573269,-1.985067797086626
2013-06-19T09:30:00-04:00,41.21001,41.3,40.39,40.39,25795120,17241470.75,44.637740818907474,45.62398688014846,NaN,NaN,-22.380990121685613,2.316602579784285,0.008715140315789474,-0.06721734402900381,-0.07593248434479329,492523698,505834875.4,44.963676601147164,46.18197932764095,NaN,NaN,-3.7125922330897216,-2.2318570022299253
2013-06-20T09:30:00-04:00,40.05,40.28,39.10001,39.17,32296656,18011356.35,33.98637274443411,45.46136000806067,NaN,NaN,-193.84308944035467,-35.80778775975326,-0.08931291806386257,-0.1875736319246215,-0.09826071386075894,460227042,496189533.4,36.73942242615135,45.76087162996281,NaN,NaN,-9.287123174670771,-3.2397521697214744
2013-06-21T09:30:00-04:00,39.21001,39.63,39.0349,39.42999,22743456,18506934.8,37.41376274469419,45.066720284706214,NaN,NaN,-187.8164661734891,-68.97683289238041,-0.12858529660173998,-0.2589923346129339,-0.13040703801119394,482970498,492783536.6,34.350103896571795,45.38635002338321,NaN,NaN,-12.278906988251158,-4.531060000940001
2013-06-24T09:30:00-04:00,39.14999,39.64999,38.8701,39.265,24973024,18954797.9,36.13171509267932,44.57009483305267,NaN,NaN,-173.5007806541395,-107.36271983570539,-0.1558001891921252,-0.32515727450135046,-0.16935708530922525,457997474,482407506,28.309898230830072,44.81328894360552,NaN,NaN,-15.025548038543679,-6.030272577740526
2013-06-25T09:30:00-04:00,39.44,39.48,39.12,39.33,13004469,18818655.15,37.04694459376527,44.5047102056369,NaN,NaN,-144.1695104036264,-144.34216735865905,-0.15899850889514153,-0.36810522142815216,-0.20910671253301064,471001943,472944131,24.140532384808083,44.10916269164012,NaN,NaN,-16.860261383422305,-7.577413835695065
2013-06-26T09:30:00-04:00,39.57001,39.89,39.57001,39.74001,18133024,18654522.35,42.631446366091325,44.649761425828046,NaN,NaN,-77.69684134191016,-155.40533760270395,-0.1245959228292946,-0.3648516160696289,-0.2402556932403343,489134967,472266384.8,23.86940152512628,43.108338744535175,NaN,NaN,-16.59507268279737,-8.865650813852536
2013-06-27T09:30:00-04:00,39.99001,40.28999,39.89999,39.92,10033574,18358741.3,44.94052282762412,44.456060352173964,NaN,NaN,-32.34168211213287,-123.10505613705959,-0.08282461760732185,-0.34378646524948664,-0.2609618476421648,499168541,480054684.6,33.159720354756544,41.718307655398746,NaN,NaN,-15.653157047484836,-9.835294561514294
2013-06-28T09:30:00-04:00,39.84,40.0351,39.64,39.67,11033281,17219167.75,42.388476597792454,44.08007026210333,NaN,NaN,-61.1083906117159,-97.76344102470496,-0.06587664602537274,-0.34330765517388073,-0.277431009148508,488135260,481087637,34.30477836324319,40.090268385312356,NaN,NaN,-15.649994122691771,-10.66596592739679
2013-07-01T09:30:00-04:00,39.91,40.25,39.48,39.96001,11795281,15857910.2,46.204852683985465,44.067884411371054,NaN,NaN,-42.4790837576256,-71.55910164540218,-0.030763576896674527,-0.31588548026935115,-0.2851219033726766,499930541,489474250.4,42.86324222246348,39.16923857045783,NaN,NaN,-14.473701320318536,-11.209928126385611
2013-07-02T09:30:00-04:00,39.94,40.23,39.87,40.00999,5441172,15481831.7,46.85820284989378,44.2831315306271,NaN,NaN,-21.97000719093856,-47.119201002864614,-0.001353699078998516,-0.2868140272214248,-0.2854603281424263,505371713,496348204.4,48.755892338972664,38.73432063581906,NaN,NaN,-13.332375513769323,-11.513134896011856
2013-07-03T09:30:00-04:00,39.88,40.02,39.655,39.92999,3985391,14827143.65,45.897323882657915,43.989106757597305,NaN,NaN,-40.913680318209714,-39.762568798124526,0.014647879932390584,-0.26715047822693805,-0.28179835815932863,501386322,498798475.4,50.70739442332257,38.495536477783894,NaN,NaN,-12.65539452633002,-11.676314843200165
2013-07-05T09:30:00-04:00,40.02,40.2,39.64999,40.03,10602508,14739635.05,47.35081647689256,43.89677326815429,NaN,NaN,-28.826495533827455,-39.05953148246345,0.032860999983273964,-0.2407221081802362,-0.27358310816351017,511988830,501362533.2,52.73580436367279,38.86648793711571,NaN,NaN,-11.68791223702208,-11.677971613746154
2013-07-08T09:30:00-04:00,40.08,40.47,40.08,40.42999,7611691,14185184.4,52.81120283741977,43.84225345216681,NaN,NaN,19.643805897276177,-22.90909218066504,0.07057463519018059,-0.18536481417578443,-0.255939449365965,519600521,507655585.4,57.3722442189926,39.84292286259163,NaN,NaN,-9.241424014626626,-11.329893385300506
2013-07-09T09:30:00-04:00,40.7,40.82001,40.63,40.73,8937742,14072560.35,56.458773170243376,43.91129669193437,NaN,NaN,70.62202873309934,-0.28886968252004125,0.11199246053488743,-0.11594887369735574,-0.22794133423224316,528538263,513377129.8,61.10777069179171,40.955705860132134,NaN,NaN,-6.0354729287101,-10.573547605787592
2013-07-10T09:30:00-04:00,40.73,40.96001,40.67,40.78,7701484,13440930.55,57.05457337153556,44.79821330283637,NaN,NaN,77.3099311749559,19.56711799065885,0.13735050204923738,-0.05625320667069644,-0.19360370871993382,536239747,519550736.6,64.70210548528657,42.36559363757067,NaN,NaN,-3.227860977030313,-9.524163801679409
2013-07-11T09:30:00-04:00,41.21001,41.48,41.17,41.42,12282160,13309591.5,63.86959801334693,46.932729393473004,NaN,NaN,130.9047203651644,53.930798127333674,0.18865264382517352,0.04221209606153309,-0.14644054776364043,548521907,528977853.6,69.35887748971702,44.69555471353964,NaN,NaN,1.5483361662476463,-7.942378091975544
2013-07-12T09:30:00-04:00,41.35001,41.47,41.28,41.42999,5566016,12935382.75,63.965723050073315,48.82929798671437,NaN,NaN,127.50607356178116,85.1973119464554,0.2128909580621166,0.11967314981400534,-0.09321780824811127,554087923,537397672.2,72.8092492773219,47.442636526450364,NaN,NaN,5.407413732959168,-6.035264974127728
2013-07-15T09:30:00-04:00,41.5,41.5,41.39,41.49001,7075918,12866515.15,64.57551606262794,50.86099805599641,NaN,NaN,123.2961145994675,105.92777368689367,0.2216031531908286,0.18378613324042448,-0.03781701995040412,561163841,545710336.2,75.71657289461085,50.82882757386327,NaN,NaN,8.770946186467246,-3.9200919511855896
2013-07-16T09:30:00-04:00,41.13499,41.42,41.13,41.34,10156664,12880491.1,61.76232535819698,52.62638239631296,NaN,NaN,102.29498198147478,112.26236433656875,0.2062184676450909,0.2199560646059595,0.013737596960868605,551007177,550204119,77.13959804131225,54.614475120756424,NaN,NaN,10.880066995618476,-1.8057835302135805
2013-07-17T09:30:00-04:00,41.41,41.53999,41.36501,41.42,9365449,12926704,62.695676191738286,54.059541669573456,NaN,NaN,112.63190283577312,119.3267586687322,0.19074550201829404,0.25216947448373617,0.06142397246544212,560372626,555030694.8,78.59075905686012,58.52314351588027,NaN,NaN,12.913088892808993,0.29691253021821584
2013-07-18T09:30:00-04:00,41.41,41.705,41.35001,41.56,7136078,11993751.9,64.33627676523483,55.44495266511708,NaN,NaN,109.93916688206554,115.13364797211243,0.17942263481909237,0.2857022659893076,0.10627963117021522,567508704,558828054.2,79.68347772861101,61.846269042584154,NaN,NaN,15.111084090912588,2.4132227531745545
2013-07-19T09:30:00-04:00,41.57001,41.8,41.51601,41.8,8352656,10796551.9,67.0144308395598,57.20394939667189,NaN,NaN,109.70794070263713,111.57402140028361,0.17726735822581235,0.3278638289524807,0.15059647072666832,575861360,563182741.6,80.88815228004776,65.17365289378448,NaN,NaN,17.80138531499295,4.611531690577182
2013-07-22T09:30:00-04:00,41.84,41.85001,41.64999,41.71001,7887527,10053755.45,65.04213808149657,58.5494697822084,NaN,NaN,100.84192356845776,107.08318319408167,0.15950791392893976,0.349981363137843,0.19047344920890324,567973833,564544740,81.26238265023733,67.91644863862548,NaN,NaN,19.562600157095805,6.747398614365556
2013-07-23T09:30:00-04:00,41.75,41.75999,41.582,41.63,6122438,9111226.15,63.25949870784812,59.720990914919426,NaN,NaN,86.18498945872142,103.861184689531,0.13317240851847498,0.356938959856997,0.223766551338522,561851395,566713583.6,81.87113857809962,70.28182336999168,NaN,NaN,20.5983966795411,8.726112623676348
2013-07-24T09:30:00-04:00,41.74001,41.74001,41.27,41.36,8262855,8874145.45,57.52939275195806,60.551852977012295,NaN,NaN,62.0919407992461,93.75319228222558,0.09041390005316347,0.33678392640497634,0.24637002635181288,553588540,565356766.4,80.11752400803056,72.38254691175653,NaN,NaN,19.96208086165138,10.331250943387067
2013-07-25T09:30:00-04:00,41.28,41.6225,41.25,41.58,4720516,8203520.05,60.65657152310772,61.50226405174195,NaN,NaN,58.77326272397487,83.52001145060746,0.07066782681192696,0.3347048098667216,0.2640369830547946,558309056,563516836.8,77.68745417531389,74.16480761258806,NaN,NaN,20.26225325307579,11.749965559056884
2013-07-26T09:30:00-04:00,41.42,41.55,41.02,41.53,6073152,8005498.95,59.58278719653224,61.98594864882141,NaN,NaN,42.42151913957799,70.06272713799562,0.04898878842963034,0.3252729685918325,0.2762841801622022,552235904,558791745.6,71.6749894031681,75.18643226860058,NaN,NaN,20.221906433129714,12.960242826781574
2013-07-29T09:30:00-04:00,41.47,41.53999,41.34,41.44,7492996,7828484.7,57.60598155915192,62.067892105172014,NaN,NaN,45.77634121214519,59.04961066673311,0.024570294048633756,0.3069970477229944,0.28242675367436065,544742908,554145560.6,66.24584624279706,75.55343766510097,NaN,NaN,19.657469321340386,13.916989468861404
2013-07-30T09:30:00-04:00,41.50999,41.67999,41.32001,41.39999,5733586,7525399.95,56.705287214865606,62.04294309398131,NaN,NaN,45.09491448349379,50.83159567168759,0.0028490638888830633,0.28598808353546445,0.2831390196465814,539009322,549577146,61.32693892244573,75.31235433918377,NaN,NaN,18.943526935612685,14.635066249825872
2013-07-31T09:30:00-04:00,41.41,41.61,41.34,41.39,6735492,7590115.95,56.46788051994776,61.51424898730994,NaN,NaN,38.78970535257394,46.17114858235315,-0.014133597859175395,0.26547202232261213,0.27960562018178753,532273830,545314204,57.06864034287506,74.43448025726649,NaN,NaN,18.278613530171544,15.155573004160969
2013-08-01T09:30:00-04:00,41.60001,41.8,41.60001,41.73,6207730,7701232.9,62.259212692081164,61.3923553903105,NaN,NaN,84.1469191851802,51.24587987459422,-0.004888200048762781,0.273495370120834,0.2783835701695968,538481560,541348704.8,53.35713212299995,73.04504331767207,NaN,NaN,19.208376631093163,15.734544950865567
2013-08-02T09:30:00-04:00,41.61,41.77,41.44,41.75,3956349,7368924.95,62.57461920198939,61.249434185979176,NaN,NaN,78.98033360558672,58.55764276779596,-0.0000987328845341584,0.2782601540639291,0.2783588869484633,542437909,539389105.8,51.5721965052996,71.32044500414983,NaN,NaN,20.06998043562448,16.353892877259696
2013-08-05T09:30:00-04:00,41.74001,41.85001,41.64999,41.78,5010262,7238853.5,63.07313404014985,61.34306337754723,NaN,NaN,121.02898323527286,73.60817117242149,0.0022851731638103834,0.28121535340322623,0.27893018023941585,547448171,539930158.4,52.049157953851605,69.52827071218836,NaN,NaN,20.929687233826076,17.007577785340608
2013-08-06T09:30:00-04:00,41.75999,41.78999,41.58,41.73,3148564,6949394.6,61.60038509041913,61.264828298881575,NaN,NaN,90.99443740261344,82.78807575624543,-0.0020742696633779256,0.2763373431601934,0.27841161282357135,544299607,540988215.4,53.02352632726676,67.70203980293168,NaN,NaN,21.30123822213335,17.62095784773957
2013-08-07T09:30:00-04:00,41.59,41.63,41.46001,41.53,5987078,6863674.3,55.97063378968293,60.667282372056434,NaN,NaN,5.161132274573362,76.06236114064532,-0.01999970562124226,0.25341198079701854,0.2734116864182608,538312529,542195955.2,54.16835727645248,65.87953119920608,NaN,NaN,20.14858756416038,17.98204780722826
2013-08-08T09:30:00-04:00,41.64999,41.8,41.52,41.75,2915349,6395333.75,60.271762597344505,60.18566321189821,NaN,NaN,77.08165016190577,74.64930733599043,-0.018639360105109803,0.25011248628687355,0.26875184639198335,541227878,542745218.8,54.70894417699769,64.00958776327393,NaN,NaN,20.274902913356684,18.30959853667518
2013-08-09T09:30:00-04:00,41.67,41.73,41.46001,41.57001,4266289,6330347.4,55.49529780795816,59.5037460495026,NaN,NaN,16.743456817310324,62.20193197833514,-0.030746316426965792,0.23031895085827614,0.26106526728524193,536961589,541649954.8,53.35743889564036,62.016377495088435,NaN,NaN,19.023383602302335,18.41156783176477
2013-08-12T09:30:00-04:00,41.41,41.5,41.25999,41.45,4208605,6186981.75,52.50739215735827,58.73573843875334,NaN,NaN,-82.7953102991445,21.43707327145168,-0.04676178942942971,0.2026130304984548,0.24937481992788452,532752984,538710917.4,49.80212255274548,59.725733493277424,NaN,NaN,17.092071977522235,18.223068424015835
2013-08-13T09:30:00-04:00,41.55,41.57001,41.27,41.48,4178465,5888071.8,53.18593234424098,58.42549126677354,NaN,NaN,-70.32051209510642,-10.825916628092287,-0.05470762008130614,0.18099029482625184,0.23569791490755798,536931449,537237285.8,48.07251099967258,57.43680399268044,NaN,NaN,15.665745540263625,17.857736583479806
2013-08-14T09:30:00-04:00,41.46001,41.5,41.17,41.19,4871527,5663375.7,46.29959663881337,57.39999306075252,NaN,NaN,-145.94791408212384,-41.04772589943173,-0.07747598435942979,0.13885293445827074,0.21632891881770053,532059922,535986764.4,46.5936929458599,55.21582104771944,NaN,NaN,12.296019233963525,17.06320553354891
2013-08-15T09:30:00-04:00,40.88,40.89,40.5,40.53,8854285,5749286.05,35.146331320079554,55.65453192672019,NaN,NaN,-350.00935296617405,-126.46592652504769,-0.1317772224482941,0.051607390757332894,0.183384613205627,523205637,532382316.2,42.53235003594367,53.13420395006055,NaN,NaN,4.913122222874787,15.32747934630975
2013-08-16T09:30:00-04:00,40.46001,40.53,40.13,40.28999,8607273,5762016.9,32.11647022426875,53.8338525456571,NaN,NaN,-342.92286671921113,-198.39919123235197,-0.1758929667467513,-0.036481595227812136,0.13941137151893918,514598364,527909671.2,38.09502618172227,51.123431088555215,NaN,NaN,-2.237849116708004,12.818146708735785
2013-08-19T09:30:00-04:00,40.27,40.27,40.10001,40.11,5126566,5623968.85,30.02600028095125,51.92818919323464,NaN,NaN,-263.41521065409165,-234.5231713033414,-0.2070807888162165,-0.11943961450133145,0.08764117431488505,509471798,523253434,34.105827319263426,49.179065974042196,NaN,NaN,-8.751068346983566,9.73683027220445
2013-08-20T09:30:00-04:00,40.19,40.35001,40.06,40.12,7174098,5676551.85,30.297457282357797,50.05887324769251,NaN,NaN,-192.05317710670744,-258.8697043056616,-0.21593402556514096,-0.18227635764154115,0.03365766792359981,516645896,519196323.4,31.05437468531204,47.320904141359115,NaN,NaN,-13.725837791645723,6.385020548797283
2013-08-21T09:30:00-04:00,40.00999,40.17,39.77,39.81,7900680,5658443.1,26.823487982160373,47.527750054126734,NaN,NaN,-178.181873323356,-265.316496153908,-0.23025377072673409,-0.2541595454848178,-0.02390577475808371,508745216,514533382.2,27.95826693503787,45.50669948507611,NaN,NaN,-19.22629820897017,2.726260726259076
2013-08-22T09:30:00-04:00,39.82001,40.07001,39.8,39.98,5501887,5697511.65,31.464445932146788,45.305594820566554,NaN,NaN,-139.89919386125476,-223.29446433292418,-0.2160918792023841,-0.29402062376106386,-0.07792874455867975,514247103,512741675.4,26.850527084344733,43.740865955007905,NaN,NaN,-22.27707951590582,-0.8456450226216234
2013-08-23T09:30:00-04:00,40.08,40.25999,40.00999,40.21001,3352870,5561497.55,37.262052191060576,43.461946117060165,NaN,NaN,-98.31807074026165,-174.37350513713426,-0.1804984242301116,-0.30355177484631923,-0.12305335061620765,517599973,513341997.2,27.881567448033778,42.01460949030663,NaN,NaN,-22.973016388012287,-4.006698074820289
2013-08-26T09:30:00-04:00,40.22,40.27,39.74001,39.74001,17412768,6057486.15,31.414220095614482,41.30579147457412,NaN,NaN,-106.89591309097734,-143.06964562451142,-0.17759955864120447,-0.34505279891771323,-0.16745324027650876,500187205,511485078.6,26.6311698076033,40.12944116747353,NaN,NaN,-25.613730306501164,-7.093416965060413
2013-08-27T09:30:00-04:00,39.44,39.64,39.39999,39.528,11462836,6343948.65,29.188916496522182,39.39281166791979,NaN,NaN,-125.16256262476917,-129.69152272812377,-0.17847588719549723,-0.3905480992708803,-0.21207221207538307,488724369,505900773.2,23.253750736524424,37.921254986050094,NaN,NaN,-28.51392381208359,-10.15348937177801
2013-08-28T09:30:00-04:00,39.44,39.45,39.2,39.23,18628560,6938602.05,26.36215892902821,36.9706971201829,NaN,NaN,-127.0614621377413,-119.46744049100084,-0.18675339397301016,-0.4455139545416458,-0.2587605605686356,470095809,498170891.8,19.556533734045388,35.410368525839225,NaN,NaN,-31.906389709523292,-13.261046562884477
2013-08-29T09:30:00-04:00,39.08,39.56,39.05,39.39,7454957,7000963.4,30.266948728496132,35.16867218593561,NaN,NaN,-111.45103998953772,-113.77780971665743,-0.1695817565032911,-0.4707377561977495,-0.3011559996944584,477550766,490831624.4,16.821778821689918,32.80067852055704,NaN,NaN,-33.333681318740474,-16.128565813721046
2013-08-30T09:30:00-04:00,39.50999,39.575,39.35001,39.50999,8672383,7236765.1,33.13068639765635,33.78462177452833,NaN,NaN,-90.72148792010275,-112.25849315262568,-0.13952608766562663,-0.47556360927649166,-0.33603752161086503,486223149,484556259.6,14.902818904976684,30.307871117144987,NaN,NaN,-33.563978472651065,-18.619339050711048
2013-09-03T09:30:00-04:00,39.69,39.83,39.395,39.48,15164188,7744461.4,32.768471059011276,32.32623168272621,NaN,NaN,-77.12968070618145,-106.3052466756665,-0.11222389043915998,-0.476317384659815,-0.364093494220655,471058961,478730610.8,13.377190070588853,27.829633907924716,NaN,NaN,-33.854984162224795,-20.795859780927298
2013-09-04T09:30:00-04:00,39.46001,39.83,39.39,39.72501,6468844,7910475.4,38.66797797484272,31.781116063871163,NaN,NaN,-65.76390391718853,-94.42551493415036,-0.07027310367161521,-0.45193487381017405,-0.38166177013855884,477527805,476491298,12.833344659148025,25.418180458873874,NaN,NaN,-32.284889182749495,-22.437149695473327
2013-09-05T09:30:00-04:00,39.78999,39.82001,39.63,39.67,4525066,7837374.8,37.86460236029526,31.975278281029425,NaN,NaN,-56.330147151778114,-80.2792519369577,-0.04032640321332054,-0.43206977415520953,-0.391743370941889,473002739,477072684,13.813030143630556,23.366800466565792,NaN,NaN,-31.237693585667564,-23.69437025121536
2013-09-06T09:30:00-04:00,39.81,39.955,39.39,39.77,6976664,8040440.55,40.29308419384704,32.5593221359993,NaN,NaN,-53.02239708244052,-68.59352335553828,-0.009489198919976405,-0.4036048695918595,-0.3941156706718831,479979403,477558411.4,14.675851666570054,21.694002286912056,NaN,NaN,-29.655902181870598,-24.546017669880396
2013-09-09T09:30:00-04:00,39.78999,40.09,39.78,40.05,10347551,8344503.65,46.58783670642843,33.74231045210482,NaN,NaN,-14.353742303676,-53.31997423225293,0.0317984260111156,-0.35436763815798855,-0.38616606416910415,490326954,478379172.4,16.202431660736337,20.415188311302984,NaN,NaN,-26.336526686135244,-24.80180467220252
2013-09-10T09:30:00-04:00,40.16,40.24001,39.94501,40.09,6501813,8459164.05,47.440334488740874,34.966801681132175,NaN,NaN,12.41890804423407,-35.41025648216983,0.06208309225492681,-0.30856219885044567,-0.3706452911053725,496828767,483533133.6,25.246953606443725,20.000372519955242,NaN,NaN,-23.374386273788396,-24.597887758143358
2013-09-11T09:30:00-04:00,40.00999,40.39,40.00999,40.375,6812438,8590862.7,53.17490984560456,36.849046099949625,NaN,NaN,58.29911313914941,-10.59765307090223,0.09937757261870112,-0.24642332533199607,-0.3458008979506972,503641205,488755813.6,33.123968225443164,20.36935118355562,NaN,NaN,-18.97155171112813,-23.79412546571261
2013-09-12T09:30:00-04:00,40.39,40.50999,40.35001,40.39,7002941,8697433.4,53.462703295857764,38.42035019735755,NaN,NaN,110.85958945079389,22.840294249612167,0.12165335956254475,-0.19373419849751627,-0.315387558060061,510644146,496284095,42.525433949633204,21.488987388219083,NaN,NaN,-15.317029627728058,-22.58311177457196
2013-09-13T09:30:00-04:00,40.48,40.75,40.48,40.72,5064148,8507926.55,59.37793361618273,40.0000560134377,NaN,NaN,161.7557489816238,65.79592346242502,0.15317327835879935,-0.12392096011156184,-0.2770942384703612,515708294,503429873.2,49.746913467024946,23.050797818147025,NaN,NaN,-10.154314662806414,-20.807569330034024
2013-09-16T09:30:00-04:00,41.06,41.22,41.005,41.09,8178918,8486508.8,64.78293849909483,42.3835358994006,NaN,NaN,224.3378313420271,113.53423819156565,0.1910385073516178,-0.03829610428083896,-0.22933461163245675,523887212,510141924.8,55.41376369199403,25.10669738131779,NaN,NaN,-3.7307624774250807,-18.368025493947034
2013-09-17T09:30:00-04:00,41.08,41.27,41.08,41.23,5344480,8497404.5,66.59414380318478,45.055337849876494,NaN,NaN,197.07509955601105,150.46547649392105,0.21578241789399927,0.04039341073504232,-0.17538900715895694,529231692,516622509.8,60.092968215368714,27.738070058378103,NaN,NaN,2.1303841272240063,-15.439681262351172
2013-09-18T09:30:00-04:00,41.2,41.75,40.99001,41.72,12763945,8776896.85,72.0183962703291,48.316497659969414,NaN,NaN,196.4495881416904,178.09557149442927,0.25284939411332197,0.14067273548269554,-0.11217665863062644,541995637,524293396.2,64.80174756074015,30.969871045999156,NaN,NaN,9.372590505957229,-11.895071009735688
2013-09-19T09:30:00-04:00,41.78999,41.84,41.44,41.53,6148535,8689289.6,67.44529172645025,50.97209358839471,NaN,NaN,171.15739459495487,190.15513252326144,0.25172481070643693,0.20247935475241974,-0.049245455954017206,535847102,529333987.4,67.51426315609396,34.59076278417087,NaN,NaN,13.747760382883332,-8.231809382218685
2013-09-20T09:30:00-04:00,41.25999,41.25999,40.955,40.98,7279063,8778148.4,56.3004625017631,52.62707759583092,NaN,NaN,93.45192532529546,176.49436779199578,0.2031733594031284,0.20472124329989327,0.0015478838967648914,528568039,531905936.4,68.83403039628872,38.44299217640745,NaN,NaN,13.674894691733625,-5.102280228796927
2013-09-23T09:30:00-04:00,40.94,40.94,40.71001,40.8,5586840,8889846.9,53.2020135255189,54.0866163434386,NaN,NaN,59.710242519668085,143.56885002752398,0.1505902758469668,0.1897857287054734,0.0391954528585066,522981199,531724733.8,68.6225072200304,42.38908625851042,NaN,NaN,12.540255155164607,-2.5819180310881364
2013-09-24T09:30:00-04:00,40.8,40.87,40.55,40.61,6855012,8361959.1,50.06964617964953,54.90102121521051,NaN,NaN,40.742426039390516,112.30231532419984,0.09725533309173284,0.16076461922317264,0.0635092861314398,516126187,529103632.8,65.48764713754494,46.15010786411019,NaN,NaN,10.56716785695091,-0.7034771899397014
2013-09-25T09:30:00-04:00,40.59,40.66,40.205,40.269,8234719,8200553.25,44.9540219746402,55.407408330520866,NaN,NaN,6.010092247731741,74.21441614540812,0.03638691357417825,0.10899292809916261,0.07260601452498436,507891468,522282799,58.055211053267435,49.31026364336997,NaN,NaN,7.142359028603769,0.41735655556650864
2013-09-26T09:30:00-04:00,40.32001,40.48,40.25,40.48,4560258,7497138.15,48.462813586582854,55.990960430002,NaN,NaN,3.0074183880318137,40.58442090402352,0.009131897192106858,0.08402088601511792,0.07488898882301107,512451726,517603723.8,53.564109017076724,52.0879963112633,NaN,NaN,5.507222911449618,1.1444803206926668
2013-09-27T09:30:00-04:00,40.34,40.34,40.05,40.23,4453383,7347059.45,44.8176012706618,55.86451504173295,NaN,NaN,-27.424102108035115,16.40921541735741,-0.025066892769784827,0.04355537286078004,0.06862226563056487,507998343,513489784.6,49.90842926678449,54.495567568838176,NaN,NaN,2.944150650801436,1.4015760821367766
2013-09-30T09:30:00-04:00,39.95,40.11,39.73,39.8,8120813,7319480.95,39.33699597116483,55.28570514762038,NaN,NaN,-73.94813678521875,-10.322460443619956,-0.07325519537567884,-0.022946728589033683,0.050308466786645155,499877530,508869050.8,46.10253411576609,55.98525189093264,NaN,NaN,-1.1627860241118553,1.035238638386972
2013-10-01T09:30:00-04:00,39.78,40.06,39.74001,40.03999,7152758,6918909.45,43.49046543267159,54.59395911812516,NaN,NaN,-69.74578267474095,-32.42010218644625,-0.08476158304548492,-0.055643512020211006,0.02911807102527392,507030288,507049871,44.65863219532131,56.80915646020964,NaN,NaN,-3.1363293798055274,0.4393003500737579
2013-10-02T09:30:00-04:00,39.92,39.96001,39.5835,39.955,5827441,6886839.3,42.38372544074552,53.802603557045714,NaN,NaN,-87.7651987547062,-51.17516038693384,-0.09321954881927526,-0.08740636499882015,0.005813183820455106,501202847,505712146.8,43.57781076585408,56.88432623279685,NaN,NaN,-5.053196020446035,-0.3453419885719268
2013-10-03T09:30:00-04:00,39.89,39.92999,39.63,39.75,9686730,7144922.5,39.755744824981946,52.40101864338852,NaN,NaN,-97.36988747560497,-71.2506215596612,-0.10676973389102887,-0.12764898354333098,-0.02087924965230211,491516117,501525025,40.290891055674926,56.20889606055756,NaN,NaN,-7.474927081307964,-1.3638541446770747
2013-10-04T09:30:00-04:00,39.75999,39.96001,39.64999,39.81,5714020,7081790.3,40.91056650599447,50.69584921530992,NaN,NaN,-93.78713970052506,-84.52322907815918,-0.10564626954146744,-0.1529370865791364,-0.04729081703766897,497230137,499371383.8,38.675055813762015,55.013274069255274,NaN,NaN,-9.088480489953762,-2.4673721940023157
2013-10-07T09:30:00-04:00,39.58,39.88,39.55901,39.67999,5438941,6836359.8,39.158944247943786,48.736192104221274,NaN,NaN,-103.61929892568061,-90.45746150625156,-0.10726974495175975,-0.18137799822736866,-0.07410825327560891,491791196,497754117,37.460122607903735,53.39664224015063,NaN,NaN,-10.950410024264205,-3.6792347411825856
2013-10-08T09:30:00-04:00,39.75,39.935,39.64,39.67999,9532781,6987908.2,39.15894424794378,46.38908838833661,NaN,NaN,-92.52363101031003,-95.01303117336536,-0.10198841980267329,-0.2015937780289505,-0.09960535822627722,491791196,494706298.6,35.21499425913227,51.28330271860722,NaN,NaN,-12.464802391894645,-4.934315834141452
2013-10-09T09:30:00-04:00,39.73,39.91,39.58,39.71001,8706844,7082628.5,39.8486339678646,44.41789854843763,NaN,NaN,-87.79423852456233,-95.01883912733659,-0.09050789671580353,-0.21274022912103163,-0.1222323324052281,500498040,494565337.2,35.11018469993681,48.96872568602456,NaN,NaN,-13.546692843430886,-6.164655406897086
2013-10-10T09:30:00-04:00,39.97,40.47,39.97,40.45,6104996,7037731.25,53.76258334459168,44.23662146578253,NaN,NaN,-15.016387678105312,-78.54813916783667,-0.030228751865715997,-0.16001827223737308,-0.12978952037165709,506603036,497582721,39.27643687039569,46.857469005603626,NaN,NaN,-10.240797846273809,-6.746961469665189
2013-10-11T09:30:00-04:00,40.42,40.58,40.33009,40.57001,5451793,7057113.5,55.55803790031272,44.40490892112495,NaN,NaN,11.038672586635133,-57.582976710404616,0.017979713566016325,-0.10731487841413667,-0.125294591980153,512054829,500547659.4,43.13964732641497,45.03726472748824,NaN,NaN,-6.983902834446636,-6.780810236062539
2013-10-14T09:30:00-04:00,40.35001,40.75,40.31,40.74001,6808246,6988579.9,58.04344128191595,44.97446571414397,NaN,NaN,29.628644421754306,-30.933388040917627,0.05924460917770122,-0.05123883050802647,-0.11048343968572769,518863075,505962035.2,49.46261926764566,43.89261987963829,NaN,NaN,-3.4938509948405714,-6.311244630173687
2013-10-15T09:30:00-04:00,40.67999,40.72,40.32001,40.37,7793453,7111028.55,51.316605787124985,45.42893598646431,NaN,NaN,18.216233494182443,-8.78541514001914,0.0593970286440747,-0.03623715388063431,-0.09563418252470901,511069622,509817720.4,53.43380596382516,43.562519516106704,NaN,NaN,-2.5107358742768318,-5.768314807902708
2013-10-16T09:30:00-04:00,40.52,40.99001,40.52,40.97,7034848,6824573.7,59.51100508341888,46.2180925219526,NaN,NaN,81.48271572465669,25.069975709824654,0.09554134869999613,0.023792503350286154,-0.07174884534970997,518104470,513339006.4,56.77446654228723,43.791830767907456,NaN,NaN,1.2261392111759195,-4.769107090891476
2013-10-17T09:30:00-04:00,40.84,41.435,40.84,41.42999,8498742,6942084.05,64.45118958072234,47.62049168695693,NaN,NaN,155.96919576049635,59.26709239754498,0.14319708061265168,0.10724750541610462,-0.035949575196547054,526603212,517339041.6,60.261973629092815,44.53136965092948,NaN,NaN,6.173955483763493,-3.2058124373693375
2013-10-18T09:30:00-04:00,41.49001,41.55,41.35001,41.49001,5861445,6871203.15,65.0504017764216,49.45716353018956,NaN,NaN,181.62813389651444,93.38498465952085,0.16971822414011528,0.17619820497859706,0.006479980838481773,532464657,521421007.2,63.49847610721365,45.77393693603286,NaN,NaN,10.186058153959163,-1.292688067179552
2013-10-21T09:30:00-04:00,41.42999,41.50999,41.23,41.39999,3646448,6774183.55,63.326282658678366,50.87400761776147,NaN,NaN,153.72551286526314,118.2043583482226,0.17164031050245637,0.22103036896655226,0.04939005846409587,528818209,523412034,64.9960198864946,47.22660748540238,NaN,NaN,12.844024792864426,0.7268423413981593
2013-10-22T09:30:00-04:00,41.5,42.03101,41.48,41.92,9404844,6901675.15,68.51723992951102,52.74068722410186,NaN,NaN,184.91958972800057,151.54502959498626,0.19658291192520402,0.2951186983706009,0.09853578644539687,538223053,528842720.2,68.76073118891955,49.02538751562135,NaN,NaN,16.965621914949317,3.0466679947626103
2013-10-23T09:30:00-04:00,41.82001,42.09,41.8,42,8809996,6930439,69.23861540753286,54.84660655142693,NaN,NaN,166.56947925575022,168.56238230120496,0.20611833134673174,0.35618370062881155,0.1500653692820798,547033049,534628436,72.19211487085786,51.30404635956298,NaN,NaN,20.457105139178463,5.533873301107732
2013-10-24T09:30:00-04:00,42.08,42.08,41.86,41.92,7754816,7090166.9,67.57123342106655,56.750939902503504,NaN,NaN,137.3362003394046,164.8357832169866,0.19481635355258103,0.3935858112228061,0.19876945767022508,539278233,537163440.2,73.56235732652512,53.79599646761749,NaN,NaN,22.775884228600557,7.9970177193209935
2013-10-25T09:30:00-04:00,41.92999,42.05499,41.795,42.02,4301984,7082596.95,68.58948816124611,58.85312161059653,NaN,NaN,117.66787879048408,152.04373219578054,0.18208952083285132,0.42638135871128924,0.24429183787843792,543580217,539386552.2,74.73797204139525,56.45869999858117,NaN,NaN,24.9863188820375,10.424060742566208
2013-10-28T09:30:00-04:00,42.15,42.7,42.09,42.57,33007120,8326912.3,73.51521031859328,61.30714061564293,NaN,NaN,138.51810564818723,149.00225075236534,0.1974397081181034,0.49109147302606715,0.29365176490796374,576587337,548940377.8,79.04955038888308,59.5897397221348,NaN,NaN,28.61424548597632,13.022658563053367
2013-10-29T09:30:00-04:00,42.66,42.94,42.54,42.94,15133859,8725967.35,76.21718834204799,63.90489449951317,NaN,NaN,143.554098938375,140.72915259444025,0.2176461608978112,0.5657094660302278,0.34806330513241657,591721196,559640006.4,82.6259443723079,62.983722555875595,NaN,NaN,32.619658719401926,15.822230013960304
2013-10-30T09:30:00-04:00,42.99,42.99,42.46,42.57,11872078,9028199.2,68.67231966852765,64.96987566550861,NaN,NaN,118.11230135227402,131.037717013745,0.19211604031260404,0.5882083555231716,0.3960923152105676,579849118,566203220.2,84.38662771440426,66.20587904473335,NaN,NaN,33.53402583318591,18.35248655956396
2013-10-31T09:30:00-04:00,42.49,42.59,42.29,42.345,11588103,9123267.85,64.49145225259892,65.6079766906719,NaN,NaN,90.08919651933181,121.58831624973045,0.14807314265115018,0.5811837435245053,0.4331106008733551,568261015,571999776.6,85.75925017788678,69.25013639126705,NaN,NaN,32.92223870164779,20.433879722718792
2013-11-01T09:30:00-04:00,42.36,42.57,42.27,42.51,9055388,9290336.25,66.12040682824494,66.18490280112397,NaN,NaN,85.66870652310071,115.18848179625377,0.11928699668791337,0.5822193467332468,0.46293235004533345,577316403,578747013.8,87.17284611235218,71.94372402303179,NaN,NaN,32.92846767331065,22.218820858517628
2013-11-04T09:30:00-05:00,42.61,42.72,42.395,42.55,5305475,9283662.95,66.52136998787927,67.27095738689214,NaN,NaN,86.68750592626309,104.82236185186893,0.09332341728302401,0.5795866216491135,0.48626320436608944,582621878,579953922,87.41352037552166,74.3708464810101,NaN,NaN,33.05123248627837,23.76630823391202
2013-11-05T09:30:00-05:00,42.51,42.76,42.38,42.63,6804481,9147247.95,67.35354933903523,67.83113911943616,NaN,NaN,82.4688205638613,92.6053061769662,0.0728300252572297,0.5773007359376265,0.5044707106803968,589426359,579494954.6,86.74695024966279,76.51173817439408,NaN,NaN,33.38824183889832,25.140870177481492
2013-11-06T09:30:00-05:00,42.85,43.1,42.65,43.09,7356392,9079725.35,71.70827859063624,68.34950262014429,NaN,NaN,106.77710312823992,90.3382665321594,0.0809242560703729,0.605626030768363,0.5247017746979901,596782751,582881681.2,87.50415913875167,78.45760856794115,NaN,NaN,35.020784330436996,26.552286485046565
2013-11-07T09:30:00-05:00,43.06,43.08,42.37,42.46,11994933,9374222.2,59.91968241086939,67.983022665462,NaN,NaN,73.93744826827495,87.10791688194801,0.03676664578024247,0.5706600819232932,0.5338934361430507,584787818,586187041.8,88.21204268900243,80.22286332378322,NaN,NaN,32.571422019277215,27.412162989936657
2013-11-08T09:30:00-05:00,42.47,42.67,42.13,42.67,15162008,9859732.95,62.15318062822597,67.89922966328682,NaN,NaN,54.684148189568226,80.91100521524153,0.015696447655331847,0.5535139957122155,0.5378175480568836,599949826,590713726.4,89.12097662335225,81.94607451927303,NaN,NaN,31.299168900600517,27.96744954860292
2013-11-11T09:30:00-05:00,42.65,42.73,42.5,42.535,7981919,9918416.6,59.84442835508357,67.27974312225629,NaN,NaN,59.25617619430829,75.42473926885057,-0.011851342595723069,0.5230033698122298,0.5348547124079529,591967907,592582932.2,89.48164105773797,83.42613950990291,NaN,NaN,29.543763290091267,28.1926372259584
2013-11-12T09:30:00-05:00,42.44,42.641,42.4,42.61,5657137,9811600.8,60.71745160621009,66.67108856501895,NaN,NaN,49.388084173527886,68.80859199078388,-0.028586340405340582,0.4991217869012772,0.5277081273066178,597625044,594222669.2,89.80106680187343,84.68392179068974,NaN,NaN,28.38200379403094,28.219689592825905
2013-11-13T09:30:00-05:00,42.46,42.99,42.42,42.97,7651536,9842435.2,64.68617374872392,66.46501287413733,NaN,NaN,80.00082498855528,63.45333636284696,-0.0194136249125737,0.5034410961659006,0.5228547210784743,605276580,595921435,90.135300165063,85.86770342201388,NaN,NaN,28.574424317848727,28.27036598211488
2013-11-14T09:30:00-05:00,42.99,43.33,42.96,43.28,5891537,9712074.95,67.71131255987623,66.40228604546806,NaN,NaN,142.68791824683237,77.20343035855845,0.002370058846258627,0.5258172946362976,0.5234472357900389,611168117,601197494.8,91.10977107630522,87.03711763879316,NaN,NaN,29.68114249598092,28.471905484095743
2013-11-15T09:30:00-05:00,43.26,43.43,43.15,43.33,3054013,9571703.35,68.18471376615972,66.02153629172281,NaN,NaN,161.27690581053375,98.52198188275153,0.01431812206461569,0.5413448883708085,0.5270267663061928,614222130,604051955.6,91.59360240790477,87.93312135443757,NaN,NaN,30.712477104113628,28.791987144098297
2013-11-18T09:30:00-05:00,43.46,43.46,43.11,43.195,3924891,9585625.5,65.39677181111408,65.24864939665609,NaN,NaN,147.7661750457492,116.22398165303971,0.007636169955981265,0.5365719787511694,0.5289358087951881,610297239,607717822,92.18205425462148,88.61570063174568,NaN,NaN,30.768279874699683,29.07431467704135
2013-11-19T09:30:00-05:00,43.14,43.19,42.965,43.04,7013185,9466042.55,62.24963151427493,64.78988595706662,NaN,NaN,96.76422296180718,125.69920941069559,-0.011666193517622658,0.5143530668981597,0.5260192604157824,603284054,608849624,92.35987401896476,89.18521822492858,NaN,NaN,29.91320579041099,29.194156264665583
2013-11-20T09:30:00-05:00,43.09,43.2,42.73,42.86,7392132,9395149.35,58.71584277651661,64.37734242306074,NaN,NaN,58.49581163410352,121.39820673980523,-0.03943577652844632,0.47672453975522444,0.5161603162836708,595891922,606972692.4,88.7545789171649,89.39917027773416,NaN,NaN,28.166979051606827,29.047416662800046
2013-11-21T09:30:00-05:00,42.86,42.97,42.76,42.935,6777776,9346297.35,59.741344756186606,63.921695132199424,NaN,NaN,40.86771554187908,101.03416619881457,-0.05469333489415662,0.44779364766597496,0.5024869825601316,602669698,605273008.6,85.49976055474902,89.27966416647679,NaN,NaN,26.988479078375775,28.753282722168006
2013-11-22T09:30:00-05:00,43.01,43.19,42.86,43.16,5442985,9403347.4,62.73218329829879,63.651038940086536,NaN,NaN,79.07594386060906,84.59397380882963,-0.05161146544286577,0.43797265075654934,0.4895841161994151,608112683,604051119.2,83.13933143928193,88.97436495674539,NaN,NaN,26.788654783090966,28.472621588014142
2013-11-25T09:30:00-05:00,43.3,43.34,43.03,43.09,4447198,7975351.3,61.208667935153,63.21211883980923,NaN,NaN,91.58090463897885,73.35691972747556,-0.05590493247536149,0.41970295060521323,0.4756078830805747,603665485,602724768.4,80.54007409910442,88.53101666027693,NaN,NaN,26.203538025356377,28.148466793348746
2013-11-26T09:30:00-05:00,43.14,43.25,42.98,43.05,3854303,7411373.5,60.30735960612209,62.397767483772505,NaN,NaN,67.65725606735698,67.53552634858552,-0.06255409833137598,0.39741526016635476,0.45996935849773074,599811182,602030194,79.14464006287433,87.93390815485712,NaN,NaN,25.473157419657312,27.766279739964254
2013-11-27T09:30:00-05:00,43.19,43.19,42.96,43.08,3256987,6980618.95,60.77389180696691,62.45878244063662,NaN,NaN,57.618227489345564,67.36000951963392,-0.06572140040037239,0.37781760799726527,0.44353900839763766,603068169,603465443.4,79.91888503591102,87.34153975106486,NaN,NaN,24.974287240941944,27.367423668675354
2013-11-29T09:30:00-05:00,43.17,43.27,42.9631,43.01,2642078,6533317.7,59.03044320773788,62.2357297677446,NaN,NaN,53.718860819251034,69.9302385751083,-0.07277227651058671,0.35257366275940427,0.425345939269991,600426091,603016722,78.93226627755395,86.613774726365,NaN,NaN,24.100337104621012,26.90069701666759
2013-12-02T09:30:00-05:00,43.03,43.04,42.675,42.78,5041730,6332634.8,53.59049974724683,61.78902058147055,NaN,NaN,-21.882279144597724,49.738593974066944,-0.09193264648812038,0.3104301311598405,0.4023627776479609,595384361,600471057.6,73.39642168448981,85.46483048541869,NaN,NaN,21.84937276180895,26.1790792659735
2013-12-03T09:30:00-05:00,42.73,43.01,42.73,42.99,6124817,6373601.9,57.44644070658965,61.55537694578338,NaN,NaN,-4.009065072943323,30.620600031682518,-0.08938928918940592,0.2906261661612035,0.38001545535060943,601509178,600039796.2,72.46915082372031,84.2268364869792,NaN,NaN,20.875747472005333,25.42146043826376
2013-12-04T09:30:00-05:00,42.88,42.995,42.55,42.89,8093110,6438033.35,55.09880320708463,60.87056476423771,NaN,NaN,-42.610328803057605,8.567083057599591,-0.0929555226091171,0.263821052089213,0.35677657469833013,593416068,598760773.4,69.65836731008088,82.76419842590904,NaN,NaN,19.400984675787576,24.561392472195735
2013-12-05T09:30:00-05:00,42.74,42.79,42.44,42.5,6060008,6373214.15,47.027096570681294,59.3931207650095,NaN,NaN,-108.86028395628851,-24.728619231527226,-0.1184594393480441,0.20870227551327503,0.3271617148613191,587356060,595618351.6,63.17513911437603,80.76886757148553,NaN,NaN,15.596519458616434,23.28069632739869
2013-12-06T09:30:00-05:00,42.83,43.13,42.76,43.08,7108583,6128896.65,57.093876074602704,58.60091807275543,NaN,NaN,19.6546125125444,-31.54146889286855,-0.094203386601936,0.2094074816088991,0.3036108682108351,594464643,594426062,60.86064270402694,78.5736561640657,NaN,NaN,15.306119004008773,22.141470995485847
2013-12-09T09:30:00-05:00,43.26,43.38,43.15,43.23,5517088,5646650.65,59.250653721983454,58.16190963781753,NaN,NaN,101.63460389317558,-6.838092285313891,-0.06725717822773408,0.21953939542616752,0.2867965736539016,599981731,595345536,62.016353940815584,76.41896328450812,NaN,NaN,15.774534570256412,21.231908649024497
2013-12-10T09:30:00-05:00,43.14,43.19,42.7425,42.86,3341908,5414650.1,52.270884143732346,57.449141968493066,NaN,NaN,-22.747548617587615,-10.585788994242751,-0.07306928966356707,0.1954599615744428,0.26852925123800986,596639823,594371665,59.995652771772285,74.10723319542295,NaN,NaN,13.839049487721255,20.175785911695463
2013-12-11T09:30:00-05:00,42.85,43.13,42.85,42.93,21705780,6217082.25,53.3895798124525,57.06869461391706,NaN,NaN,-17.730203844632708,-5.609764002557769,-0.07086268906537818,0.17995088990628716,0.25081357897166534,618345603,599357572,66.0879053698608,72.48818508490123,NaN,NaN,12.662927995510323,19.102520495097586
2013-12-12T09:30:00-05:00,42.92,42.92,42.3,42.34,9662827,6317646.8,44.02360784972195,55.94599912059816,NaN,NaN,-199.04877639960412,-23.647462491220892,-0.10570393647935186,0.11868365837247552,0.22438759485182738,608682776,603622915.2,70.26043826246415,71.39966206402374,NaN,NaN,8.303349888400398,17.55978183699799
2013-12-13T09:30:00-05:00,42.47,42.47,42.14,42.27,5928994,6319519.65,43.05847802369508,54.54073445812646,NaN,NaN,-235.5429567990632,-74.6869763535424,-0.12851351569126515,0.06374570023774595,0.1922592159290111,602753782,605280743,71.7170377966812,70.58378394669512,NaN,NaN,4.588182382245868,15.706696200604828
2013-12-16T09:30:00-05:00,42.35,42.52,42.17,42.26,5893070,6461472.5,42.913739841717806,53.23395388002395,NaN,NaN,-188.3617537065846,-132.68624787349444,-0.13846419440600183,0.01917897292150883,0.15764316732751066,596860712,604656539.2,70.32047940427401,69.85381289706439,NaN,NaN,1.6262600247182397,13.695205318335315
2013-12-17T09:30:00-05:00,42.22,42.28,41.96,42.06,7249393,6627697.6,40.01653875839398,51.78460953375765,NaN,NaN,-202.06590745112146,-168.5499196402012,-0.15164330060434597,-0.0319109584279218,0.11973234217642417,589611319,603250838.4,67.14924003154385,68.99699860911221,NaN,NaN,-1.7711150485472555,11.485730980209233
2013-12-18T09:30:00-05:00,42.11,42.78,41.69,42.76,11754154,6864746.05,52.1841847871008,51.17105903233865,NaN,NaN,-100.89068880326576,-185.18201663192784,-0.1083735288877713,-0.01573456893328995,0.09263895995448135,601365473,599854812.4,60.097934311187394,67.58121641448909,NaN,NaN,-0.8149838175397124,9.728486009102241
2013-12-19T09:30:00-05:00,42.65,42.725,42.43,42.68,5698766,6780077.75,50.91308088136033,50.5912474375974,NaN,NaN,-44.586702057585825,-154.28960176352416,-0.08152173960764068,-0.00926321455506951,0.07225852505257117,595666707,597251598.6,55.303833179230324,65.89347119318025,NaN,NaN,-0.4793198162043093,8.270228034058448
2013-12-20T09:30:00-05:00,42.35,42.66,42.29,42.55,11007306,6991554.25,48.831559884065456,50.251323161655876,NaN,NaN,-63.842678787826465,-119.94954616127681,-0.06937311747019756,-0.014457871785175769,0.054915245685021784,584659401,593632722.4,49.40377427831477,64.17971066416774,NaN,NaN,-0.8589129865607731,6.966065031112845
2013-12-23T09:30:00-05:00,42.645,42.69,42.36,42.51,6601737,7049491.85,48.1788663397309,49.58935356402311,NaN,NaN,-52.67794812781764,-92.81278504552343,-0.0611753013861558,-0.021553881047672974,0.03962142033848283,578057664,589872112.8,44.13452464323115,62.1558087941328,NaN,NaN,-1.357155914505034,5.777033467453148
2013-12-24T09:30:00-05:00,42.51,42.655,42.44,42.57,5915271,7122895.5,49.27411886116261,49.17330468217153,NaN,NaN,-39.09527358997508,-60.21865827329414,-0.04936231979382218,-0.0220814794037949,0.027280840390027282,583972935,588744436,42.66501766160111,60.227712390669964,NaN,NaN,-1.451746835424721,4.744350567042024
2013-12-26T09:30:00-05:00,42.6,42.74,42.54,42.74,15154831,7687921.9,52.34722727750035,49.553314018372895,NaN,NaN,-5.996715470548139,-41.23986360675061,-0.028770228781650226,-0.0086819455870355,0.020088283194614726,599127766,588296894.6,42.06638331736037,58.71994411945456,NaN,NaN,-0.6475760154748037,3.9740753409681915
2013-12-27T09:30:00-05:00,42.81,42.92,42.76,42.84,3590964,7704620.75,54.108459727625466,49.340069993588806,NaN,NaN,42.14424168055484,-23.893674859122466,-0.008156696798639708,0.009892412196315092,0.0180491089949548,602718730,589707299.2,44.6997537069787,57.56559490537968,NaN,NaN,0.5292606712929774,3.4819589595860183
2013-12-30T09:30:00-05:00,42.84,42.975,42.83,42.95,3245678,7734800.75,56.033448814245446,49.11026964303609,NaN,NaN,68.10004284866767,2.49486946817636,0.012046445960831438,0.033107166445994096,0.021060720485162658,605964408,593968300.6,51.82436819819758,56.83759592376412,NaN,NaN,2.0707905542155998,3.28036347310453
2013-12-31T09:30:00-05:00,43.02,43.065,42.81,42.98,6516484,7808538.45,56.568522379270455,49.41724380271739,NaN,NaN,73.74413969928379,27.77928703359665,0.02580041318547957,0.05331123696701212,0.02751082378153255,612480892,600852946.2,60.64647878526261,56.884083496156286,NaN,NaN,3.502172947526039,3.3120505408790315
2014-01-02T09:30:00-05:00,42.85,42.87,42.38,42.45,14996968,8252146,45.93307200277997,48.88463610202649,NaN,NaN,-28.02550782196822,29.993240187198023,-0.00100553966150254,0.026253899204654374,0.027259438866156914,597483924,603555144,63.47376767168953,56.69735937485833,NaN,NaN,1.6897668820251934,3.0802957324713405
2014-01-03T09:30:00-05:00,42.54,42.605,42.34,42.37,6298975,8162439.25,44.570902113784406,48.92372854945952,NaN,NaN,-59.05753476403262,19.381076328501127,-0.02310821174394013,-0.0016258258137682446,0.021482385930171884,591184949,601966580.6,60.712327912128245,56.01535149269148,NaN,NaN,-0.202765084565725,2.611287044323188
2014-01-06T09:30:00-05:00,42.48,42.53,42.11,42.21,9498621,8334369.9,41.89492798039881,48.84061783208121,NaN,NaN,-94.12174773438026,-7.872121554485896,-0.04615704478389505,-0.036213920049696924,0.009943124734198122,581686328,597760100.2,54.0115264874138,54.7506721134581,NaN,NaN,-2.6055649455176346,1.866022474345928
2014-01-07T09:30:00-05:00,42.43,42.54,42.24,42.44,7479056,8352893.55,46.836202877596314,49.12079376321539,NaN,NaN,-56.272247306436824,-32.7465795855068,-0.04359656513693597,-0.04455258168697185,-0.0009560165500358733,589165384,594400295.4,49.3284899773072,53.25124429724618,NaN,NaN,-3.225260991066247,1.1386962650013315
2014-01-08T09:30:00-05:00,42.43,42.43,42.03,42.12,23824144,9268246.35,41.54287985885188,49.22981812753381,NaN,NaN,-114.97310040500845,-70.49002760636525,-0.06011923871582113,-0.07610506494481228,-0.015985826228991157,565341240,584972365,39.087050611203715,51.246802195793315,NaN,NaN,-5.428495773209321,0.2005259738283811
2014-01-09T09:30:00-05:00,42.23,42.395,42.06,42.34,24438635,10323082.7,46.056674731902206,48.79213883787678,NaN,NaN,-85.60090702947986,-82.00510744786757,-0.05313815481568474,-0.08240851974859709,-0.029270364932912345,589779875,583431555.2,37.70912130431093,49.64760126673071,NaN,NaN,-5.883635491694671,-0.6686399498177691
2014-01-10T09:30:00-05:00,42.45,42.55,42.2418,42.4,15903765,10032981.95,47.25290881027247,48.53069797565621,NaN,NaN,-34.0632877346426,-77.00625804198958,-0.04188104463213476,-0.0816216707230808,-0.03974062609094604,605683640,586331293.4,41.86288649479875,48.687533646414174,NaN,NaN,-5.892614702789251,-1.4149220573851236
2014-01-13T09:30:00-05:00,42.4,42.54,42.11,42.16,9275120,10013596.6,43.13260864580485,48.12363003006617,NaN,NaN,-73.7897818762159,-72.93986487035673,-0.047583764104780574,-0.09922033122192175,-0.05163656711714118,596408520,589275731.8,45.81411395265265,48.4311293374383,NaN,NaN,-7.15271103295133,-2.2346061967517246
2014-01-14T09:30:00-05:00,42.27,42.45,42.19,42.38,10885005,10261397.15,47.63972097701772,48.085119647015226,NaN,NaN,-50.06212525880787,-71.69784046083093,-0.03415305188164115,-0.09432788196919262,-0.060174830087551465,607293525,592901360,50.29386649207074,48.87108232664112,NaN,NaN,-6.843676777585439,-2.893044851156541
2014-01-15T09:30:00-05:00,42.43,42.54,42.29,42.39,4384219,10185954.6,47.842077571655196,47.98283098347898,NaN,NaN,-28.107685271659356,-54.32475743416111,-0.022757803163713022,-0.08862208404219274,-0.06586428087847972,611677744,602168660.8,59.508643814363346,50.074198480409855,NaN,NaN,-6.536588813409643,-3.4135511314784126
2014-01-16T09:30:00-05:00,42.27,42.46,42.18,42.4,6628929,10154931.4,48.05825811457289,47.67647604326987,NaN,NaN,-58.58873305773917,-48.922322639812975,-0.013183831668077961,-0.08234407046357717,-0.06916023879549921,618306673,607874020.4,63.94071220968164,51.63665054414709,NaN,NaN,-6.225397073101942,-3.8152434088532026
2014-01-17T09:30:00-05:00,42.35,42.38,42.03,42.07,8233818,9978914.6,41.888232366593456,46.80360266033902,NaN,NaN,-119.53819146219952,-66.01730338532437,-0.026921241936228885,-0.10281179121578532,-0.07589054927955644,610072855,608751863.4,64.58306500214923,53.056887065230704,NaN,NaN,-7.754492313479876,-4.377993252371299
2014-01-21T09:30:00-05:00,42.19,42.3399,41.95,42.23,5618444,9974898.5,45.53908742299504,46.05400541810684,NaN,NaN,-103.8211729181146,-72.02358159370411,-0.023217622704527124,-0.10491257766021533,-0.08169495495568821,615691299,612608419.2,67.33598441526374,54.164859652164004,NaN,NaN,-7.982280547904239,-4.8928914374474335
2014-01-22T09:30:00-05:00,42.26,42.38,42.18,42.23,3616038,9605335.1,45.53908742299504,45.26618863551574,NaN,NaN,-65.43759443326834,-75.0986754285962,-0.018934362463510213,-0.10536290803507598,-0.08642854557156576,615691299,614287974,68.48488043646064,54.724745484392436,NaN,NaN,-8.167053002754011,-5.360628803919802
2014-01-23T09:30:00-05:00,42.08,42.08,41.71,41.86,8917033,9721099.9,38.97249807641192,44.769004783632305,NaN,NaN,-175.38718658982916,-104.55457569223015,-0.03808171041741745,-0.13403068359333759,-0.09594897317592013,606774266,613307278.4,67.00294335856387,54.97682946202632,NaN,NaN,-10.327917373410859,-6.070241456704238
2014-01-24T09:30:00-05:00,41.8,41.98,41.44,41.48,18955651,10373118.9,33.61187969992977,43.986217468356976,NaN,NaN,-217.0603463949811,-136.24889835967855,-0.07146255475934289,-0.18527716662509874,-0.11381461186575585,587818615,607209666.8,58.523359745624504,54.820474592990344,NaN,NaN,-14.025972758087171,-7.206774499758943
2014-01-27T09:30:00-05:00,41.5,41.55,41.2401,41.31,8451542,10037954.45,31.522906318797766,43.24535877824262,NaN,NaN,-244.37153632170018,-161.21556733157868,-0.09845021284959904,-0.23687737792775465,-0.1384271650781556,579367073,601068510.4,51.45979713264614,54.63820821050693,NaN,NaN,-17.759465567767467,-8.714301795188732
2014-01-28T09:30:00-05:00,41.38,41.705,41.36,41.63,5022230,10109517.75,39.18482920320572,42.69883208721472,NaN,NaN,-166.09333552681005,-173.66999985331776,-0.08852096480166555,-0.24907837108023756,-0.160557406278572,584389303,594808111.2,45.438928113190734,54.36038236307004,NaN,NaN,-18.489016582386128,-10.110689621931217
2014-01-29T09:30:00-05:00,41.36,41.42,40.7949,40.9,36942375,11794352.6,30.735987198956124,41.92691118293645,NaN,NaN,-227.4778435499604,-206.07804967665615,-0.12278021259942196,-0.31403267202784946,-0.1912524594284275,547446928,581159237,35.6465513114309,54.11463241308627,NaN,NaN,-22.328494149000118,-11.856090268655345
2014-01-30T09:30:00-05:00,41.05,41.12,40.89,40.96,19016626,12419359.7,32.033135231156976,40.92522979002609,NaN,NaN,-184.90391275422084,-207.9813949095345,-0.13224423178319764,-0.35655774915742455,-0.22431351737422692,566463554,573097094.6,31.34899150042618,53.6603374270945,NaN,NaN,-24.78365060264216,-13.702884602082033
2014-01-31T09:30:00-05:00,40.49,41.035,40.32,40.76,21959509,12767486.75,30.015289947487815,39.69397129982718,NaN,NaN,-184.87000971546308,-201.5433275736309,-0.1419621437490723,-0.40176619706056726,-0.259804053311495,544504045,564434180.6,27.510961223363793,52.63519990770629,NaN,NaN,-27.447325840196633,-15.666376207526977
2014-02-03T09:30:00-05:00,40.71,40.82,39.83,39.88,42239307,14564503.35,23.115583210435787,38.26418376872939,NaN,NaN,-204.70686767683694,-193.61039384465826,-0.1944022127431223,-0.5028068192403978,-0.3084046064972755,502264738,549013713.6,22.281592585747134,50.954305524355895,NaN,NaN,-32.650088743749045,-18.0926208555587
2014-02-04T09:30:00-05:00,40.04,40.17,39.95,40.09,11693988,14674271.7,27.404234023660692,36.81879184348961,NaN,NaN,-175.50474127435314,-195.49267499416686,-0.20086637149932568,-0.5594875708714326,-0.35862119937210696,513958726,534927598.2,18.77148435231649,48.70270680008773,NaN,NaN,-35.072639957664116,-20.51833787014519
2014-02-05T09:30:00-05:00,39.99,40.19,39.885,40.12,9453904,14773014.1,28.021922146669624,35.40306645599064,NaN,NaN,-148.79025060602754,-179.7551564053803,-0.18920422293176864,-0.5951264780368177,-0.4059222551050491,523412630,530120738.6,17.74421138390956,45.719533055055315,NaN,NaN,-36.69280145150321,-22.828975524624905
2014-02-06T09:30:00-05:00,40.3,40.6,40.28,40.55,12794061,14221509.95,36.37790956971375,34.568755845643565,NaN,NaN,-95.52393031197053,-161.87915991693023,-0.1408339049740941,-0.5819646363226667,-0.4411307313485726,536206691,524069366,16.518639838388836,42.33224217139155,NaN,NaN,-35.173078393165994,-24.592418791559346
2014-02-07T09:30:00-05:00,40.7,40.96,40.6,40.93,7524590,13375807.7,42.707756215995,34.62729326345796,NaN,NaN,-56.54560943607139,-136.2142798610519,-0.07486116382729585,-0.5347071861326924,-0.45984602230539656,543731281,523914813.2,16.48731854684617,38.896831710298464,NaN,NaN,-31.686034243765178,-25.60579242758875
2014-02-10T09:30:00-05:00,40.9,41.12,40.832,41.09,5645799,12862909.4,45.180839291523405,34.60170411120999,NaN,NaN,-34.9142010984311,-102.25574654537073,-0.015183227251522768,-0.4788250563698,-0.4636418291182772,549377080,533337281.6,25.732902083824314,35.92518297233851,NaN,NaN,-28.092100570031064,-25.96097930508051
2014-02-11T09:30:00-05:00,41.15,41.59,40.99,41.57,9688069,12883556.85,51.89021657736836,35.05535619366522,NaN,NaN,3.858068426302575,-66.38318460523959,0.05787708978914746,-0.3912954668818429,-0.4491725566709904,559065149,542358566.2,33.3418330362847,33.41496530089737,NaN,NaN,-22.6584673688392,-25.489191885617466
2014-02-12T09:30:00-05:00,41.66,41.66,41.25,41.39,8852507,12781931.95,49.44622918854173,35.80347984453163,NaN,NaN,14.154185080447924,-33.7942974679445,0.09324370938508886,-0.3326179199396293,-0.42586162932471816,550212642,547718568.6,37.442795605826284,31.303526175701826,NaN,NaN,-19.11859953832284,-24.579107264575377
2014-02-13T09:30:00-05:00,41.09,41.62,41.03,41.6,5708566,12848149.3,52.27065655361028,37.136249619794526,NaN,NaN,18.949057719882525,-10.899699861573895,0.12780704064508958,-0.2661028285183562,-0.3939098691634458,555921208,551661472,40.350020148249,30.005430490175,NaN,NaN,-15.312983805452305,-23.25537534184351
2014-02-14T09:30:00-05:00,41.51,41.95,41.39,41.84,8170197,12925212.7,55.34149961061529,38.83757771206721,NaN,NaN,60.479823940968934,12.50538681383417,0.16167825121675167,-0.1918120551425062,-0.3534903063592579,564091405,555733496.8,43.28161570822329,29.421274674144797,NaN,NaN,-11.173025696102775,-21.529325392451977
2014-02-18T09:30:00-05:00,41.79,41.83,41.445,41.6,7130353,12870039.45,51.75547594697707,39.735481050908014,NaN,NaN,53.8788397179602,30.26399497711243,0.16233909305073202,-0.15056644004584285,-0.3129055330965749,556961052,557250291.2,44.37819444907291,29.345507983850666,NaN,NaN,-8.837012216607645,-19.716137795902785
2014-02-19T09:30:00-05:00,41.55,41.69,41.35,41.51,6085282,12893381.35,50.43565254941484,41.142600004512204,NaN,NaN,47.08424510658689,38.90923031316929,0.1513523226725278,-0.12371512975591514,-0.27506745242844294,550875770,555612415.4,43.40237735273892,29.89949555822981,NaN,NaN,-7.339162429023991,-17.947998457777242
2014-02-20T09:30:00-05:00,41.45,41.82,41.38,41.69,6793127,13052235.8,53.01625906042196,42.641394563745415,NaN,NaN,70.11512288103663,50.10141787328703,0.1505268059414489,-0.08690894500163182,-0.23743575094308073,557668897,557103666.4,44.5968809827105,30.845773378392977,NaN,NaN,-5.3159877566885605,-16.14342550047886
2014-02-21T09:30:00-05:00,41.74,41.8799,41.59,41.6,5702481,12891508.2,51.5704595119373,44.18104953263467,NaN,NaN,81.3074308562704,62.57309250056461,0.13853959082138875,-0.06426126241634478,-0.20280085323773353,551966416,556312708,44.06565767824722,32.028251696598936,NaN,NaN,-4.054476434926144,-14.416432776828472
2014-02-24T09:30:00-05:00,41.63,42.0256,41.62,41.75,3302302,12108840.75,53.83035806684167,46.37496202237794,NaN,NaN,94.06674136628028,69.29047598562688,0.1351853085787474,-0.03381921751429928,-0.16900452609304667,555268718,554548170.6,42.83968494891474,33.496686865396626,NaN,NaN,-2.3442115760044526,-12.691829748139327
2014-02-25T09:30:00-05:00,41.74,42.105,41.74,41.91,6304215,12001474.4,56.17929503522273,48.4303235232038,NaN,NaN,101.66885655489939,78.84847935301471,0.13774788040857336,0.003180324417670022,-0.13456755599090334,561572933,555470546.8,43.7211151776334,35.278803352919255,NaN,NaN,-0.21991356913334104,-10.910127436852758
2014-02-26T09:30:00-05:00,42,42.12,41.79,41.87,4877305,11994228.15,55.42018019414481,50.38734195516632,NaN,NaN,97.2181810847305,88.87526654864344,0.1308071994462222,0.028941443316874427,-0.10186575612934778,556695628,556634518.4,44.87629789506051,37.21680953228718,NaN,NaN,1.3426550280454659,-9.159729941867297
2014-02-27T09:30:00-05:00,41.81,42.06,41.79,42.06,4172664,10355742.6,58.30235934557607,51.953374082013625,NaN,NaN,92.52138066818432,93.35651810607298,0.13265383231826472,0.0639515342684831,-0.0687022980497816,560868292,557274397.4,45.53811505678527,39.289629190744066,NaN,NaN,3.5031910695048776,-7.350741225956987
2014-02-28T09:30:00-05:00,42.05,42.518,42.02,42.35,5404751,9675148.85,62.30790779207366,53.353384908876386,NaN,NaN,119.5489354291711,101.00481902065312,0.14599080118137756,0.11378620342694035,-0.03220459775443721,566273043,560135722.8,48.51482110486418,41.57730794488821,NaN,NaN,6.589680938447663,-5.359252345327751
2014-03-03T09:30:00-05:00,42.01,42.22,41.87,42.12,8829767,9018661.75,57.583342064895916,54.23927796411728,NaN,NaN,87.42389620979611,99.67624998935628,0.13231261634081265,0.13318617267157862,0.0008735563307659608,557443276,560570634.4,48.971357829204166,43.23719764098678,NaN,NaN,7.924138906486405,-3.4616250236400146
2014-03-04T09:30:00-05:00,42.4,42.78,42.4,42.69,7275455,7270469.15,64.72251696014564,55.15587084860137,NaN,NaN,150.14827685313466,109.37213404900334,0.15317145341815092,0.19233787310345463,0.0391664196853037,564718731,561199794,49.66669186342236,44.40325898578232,NaN,NaN,11.466162545234655,-1.329083942372205
2014-03-05T09:30:00-05:00,42.65,42.705,42.54,42.55,8090895,7090314.5,61.963919579347866,56.04999159080181,NaN,NaN,142.52575601767293,118.43364903559181,0.1489243219968596,0.2253218221813782,0.0763975001845186,556627836,561186235.6,49.65099041601194,45.275272900795585,NaN,NaN,13.506843982590578,0.7903343326224781
2014-03-06T09:30:00-05:00,42.63,42.66,42.535,42.54,6145920,6924915.3,61.76142803234856,56.72790383928311,NaN,NaN,133.83349625924572,126.69607215380411,0.13712076519339658,0.24779845667626432,0.11067769148286774,550481916,559108960.4,47.189543316051505,45.76381026992433,NaN,NaN,15.080184516958292,2.8317415018133083
2014-03-07T09:30:00-05:00,42.69,42.7,42.48,42.66,4123240,6491374.25,63.31085646062283,57.29714361428365,NaN,NaN,126.95733632123454,128.17775233221678,0.12918351964050495,0.27215709103349894,0.142973571392994,554605156,556775383,44.51945696854667,45.852227502804574,NaN,NaN,16.84509354485211,4.833648936533137
2014-03-10T09:30:00-04:00,42.54,42.71,42.54,42.7,4901207,6360205.1,63.83687283332321,58.16010053473695,NaN,NaN,120.69040747505103,134.83105458526776,0.11868583812631556,0.29133086905088845,0.1726450309245729,559506363,557188000.4,45.11084979225645,45.904560027317686,NaN,NaN,18.451089239957422,6.778997551308035
2014-03-11T09:30:00-04:00,42.81,42.85,42.59,42.68,10017425,6578786.4,63.34782863708627,59.08239882671348,NaN,NaN,114.41960456514767,127.68532012767037,0.10303406190522355,0.30143760830610233,0.1984035464008788,549488938,554142041.8,41.58672552154384,45.77487061080375,NaN,NaN,19.66099048849173,8.619282256619991
2014-03-12T09:30:00-04:00,42.48,42.79,42.48,42.77,5203662,6354566.05,64.65985344975581,59.91408414023733,NaN,NaN,97.23936542540959,118.6280420092177,0.09175739849730202,0.3131002945225063,0.2213428960252043,554692600,553754994.6,41.14684837463285,45.52843971022678,NaN,NaN,21.0463934924897,10.394583861744234
2014-03-13T09:30:00-04:00,42.8,42.97,42.49,42.56,9738911,6398886.25,59.323657966036365,60.46788402981583,NaN,NaN,85.37113558171139,108.93556987371082,0.06445967955322224,0.3019174954667321,0.23745781591350984,544953689,552649349.2,39.85013761127207,45.22733113401427,NaN,NaN,20.848414986754715,11.887988308174302
2014-03-14T09:30:00-04:00,42.4,42.765,42.39,42.58,5299565,6378436.2,59.665066010351175,60.884648882923656,NaN,NaN,63.14976241752973,96.17405509296987,0.04308241094239401,0.29131082959150234,0.24822841864910833,550253254,551778968.8,38.81317375634839,44.939723191688095,NaN,NaN,20.770127203996825,13.156865293291805
2014-03-17T09:30:00-04:00,42.72,42.89,42.65,42.83,4161426,6177997.65,63.75972755348799,61.426108348514035,NaN,NaN,88.90152359565609,89.81627831709088,0.041116466795953266,0.29962400214404994,0.2585075353480967,554414680,550760632.2,37.581007954567944,44.50114410432628,NaN,NaN,21.809593860974843,14.39296937438938
2014-03-18T09:30:00-04:00,42.9,42.99,42.77,42.92,3575056,6000232.8,65.13203203479323,62.11981205141749,NaN,NaN,97.83969319995037,86.50029604405142,0.04111568384901548,0.309902140159366,0.26878645631035053,557989736,552460791.8,40.95141615906138,44.22079540889778,NaN,NaN,23.06911066876612,15.632418130728915
2014-03-19T09:30:00-04:00,42.88,43,42.38,42.59,10676873,6229812.35,56.65993004349912,62.002495672697705,NaN,NaN,53.08605767321356,77.66963449361221,0.015449537150039772,0.28809837774790026,0.2726488405978605,547312863,550984844.4,38.98347472259886,43.75260681359874,NaN,NaN,21.759123419532365,16.507661743415124
2014-03-20T09:30:00-04:00,42.45,42.79,42.38,42.74,9907949,6385553.45,59.25434732746222,61.78438421093974,NaN,NaN,44.9484842506069,69.58510422739131,0.005639565505452582,0.27969829747967623,0.27405873197422365,557220812,553438269,43.81669969512277,43.41702671290293,NaN,NaN,21.384242791355412,17.204316178835164
2014-03-21T09:30:00-04:00,42.67,42.91,42.5,42.5,7454001,6473129.45,53.71393766735805,61.50799818254418,NaN,NaN,40.80944831056345,65.11704140599805,-0.018619550475820312,0.25078429387944823,0.26940384435526854,549766811,553340980.4,43.668980642166034,43.03828548525735,NaN,NaN,19.37802191896363,17.514845570282088
2014-03-24T09:30:00-04:00,42.52,42.74,42.4005,42.46,6111309,6613579.8,52.82736559675523,60.65834451373058,NaN,NaN,9.177368223096993,49.17221033148624,-0.03785743676944664,0.22208204839346024,0.2599394851629069,543655502,551189144.8,40.422921920175376,42.37801620359685,NaN,NaN,17.47821380629937,17.5096124611417
2014-03-25T09:30:00-04:00,42.62,42.83,42.616,42.77,9086132,6752675.65,58.538916920027106,60.41370146663623,NaN,NaN,68.24813550477337,43.253898792450855,-0.03051716469126725,0.22179302929882283,0.2523101939900901,552741634,550139524.4,38.90383174804366,41.61036201302768,NaN,NaN,17.472074832790675,17.50424994280584
2014-03-26T09:30:00-04:00,42.85,42.98,42.67,42.67,7102490,6863934.9,56.176055852390114,60.01474631092492,NaN,NaN,84.75427218331953,49.58754169447205,-0.03299869441562947,0.21106182597055323,0.2440605203861827,545639144,549804780.6,38.40810348873209,40.983116311076294,NaN,NaN,16.763461432957552,17.39842301282751
2014-03-27T09:30:00-04:00,42.57,42.86,42.57,42.64,10552473,7182925.35,55.45291347856992,59.453464669349714,NaN,NaN,42.78215426005199,49.15427569636107,-0.03696380617445061,0.19785576266811944,0.23481956884257005,535086671,545377952.4,32.5086125056917,40.12519884944379,NaN,NaN,15.976936603063328,17.195353525718343
2014-03-28T09:30:00-04:00,42.67,42.87,42.6699,42.75,4522550,7138815.3,57.60775387416902,59.0085276008387,NaN,NaN,85.45610428930533,58.083606892109444,-0.03263221977453182,0.19402929412440528,0.2266615138989371,539609221,543346434.4,30.214966034851898,39.06120715248632,NaN,NaN,15.906083720381742,17.01117212495597
2014-03-31T09:30:00-04:00,42.99,43.11,42.85,43.06,8973365,7145995.2,63.03457164147625,58.986152101152264,NaN,NaN,252.07001515994818,106.66213627947968,-0.010489584425935589,0.2135495333665176,0.2240391177924532,548582586,544331851.2,32.69556026655576,38.42612391998718,NaN,NaN,17.468932041502928,17.07656639874839
2014-04-01T09:30:00-04:00,43.01,43.135,42.89,42.99,6524202,7108432.55,61.131543540143106,58.73412996475137,NaN,NaN,196.68340747757972,132.34919067404095,-0.002570886553595192,0.2208255096004592,0.2233963961540544,542058384,542195201.2,30.189734677292975,37.64347294160576,NaN,NaN,18.20854304058617,17.238277347582358
2014-04-02T09:30:00-04:00,43.02,43.14,42.91,43.04,6705383,7039156.95,62.01370877096324,58.92627645081757,NaN,NaN,173.41890627090436,150.08211749155794,0.0036813908732115652,0.22799813474556885,0.22431674387235728,548763767,542820125.8,31.83524588886111,37.07098067571926,NaN,NaN,19.071005056228042,17.500095591674597
2014-04-03T09:30:00-04:00,43.04,43.18,42.99,43.09,4430352,6953378.55,62.92001889215245,59.15877308523194,NaN,NaN,170.1244599080167,175.55057862115086,0.008553042900104085,0.23500804749748738,0.2264550045973833,553194119,546441615.4,40.576681505721936,37.196945514960234,NaN,NaN,20.04350844275432,17.863440284685986
2014-04-04T09:30:00-04:00,43.22,43.32,42.89,42.95,8815742,7188003.65,58.69713124107125,58.797159062916464,NaN,NaN,129.5428492246556,184.3679276082209,0.00015911538398552527,0.2266538988273652,0.22649478344337967,544378377,547395446.6,42.662287278960974,37.55989403813116,NaN,NaN,19.727297720837324,18.129705632707605
2014-04-07T09:30:00-04:00,42.85,43.18,42.85,42.99,15087978,7697342.2,59.5328118983075,58.3972147674532,NaN,NaN,93.02043646482007,152.5580118691953,-0.004622580010972016,0.22071655842966464,0.22533913844063666,559466355,549572200.4,47.21536739867438,38.00731912667495,NaN,NaN,19.68476332865328,18.351856732128415
2014-04-08T09:30:00-04:00,43,43.23,42.94,43.21,7688043,7580873.1,63.863470485705335,58.91175337046793,NaN,NaN,123.62814115963855,137.94695860560705,0.004608181363103397,0.2310993651445159,0.2264911837814125,567154398,554591403.2,55.90939646211171,39.21631353664016,NaN,NaN,20.870930839013194,18.71172446168338
2014-04-09T09:30:00-04:00,43.22,43.4,43.17,43.4,5559127,7598646.35,67.13465278281271,59.474632331564386,NaN,NaN,167.74782055917547,136.81274146326126,0.02021275451728005,0.25175712692801255,0.2315443724107325,572713525,559381354.8,62.292380589672355,40.53600502910798,NaN,NaN,22.8828113510236,19.307594017303412
2014-04-10T09:30:00-04:00,43.4,43.63,42.9443,42.97,6121834,7417792.5,55.000156130281056,59.56650507891602,NaN,NaN,104.1621623155349,123.62028194476493,-0.0006187286192254893,0.23077096163670063,0.23138969025592612,566591691,562060869.2,65.3172132904421,42.08230736112771,NaN,NaN,20.824945201429326,19.52435847217854
2014-04-11T09:30:00-04:00,42.94,43.12,42.695,42.75,15474708,7926549.65,50.01880412681801,59.36589354534908,NaN,NaN,-12.583005889408946,95.19511092195202,-0.029792485577225747,0.19414908328439395,0.2239415688616197,551116983,563408590.4,66.76146460483464,43.96363183860337,NaN,NaN,17.42322147815981,19.22419604446158
2014-04-14T09:30:00-04:00,42.98,43.16,42.81,43.09,4333795,7935168.1,56.56598326021698,59.224969712505505,NaN,NaN,43.3768053950301,85.266384707994,-0.026859886763822283,0.19036671040684183,0.21722659717066412,555450778,562605475,65.02380874988239,45.82934448159185,NaN,NaN,16.695864833298565,18.86300587143829
2014-04-15T09:30:00-04:00,43.24,43.255,42.93,43.2,6318805,8072355.55,58.461788942601665,59.38823636180633,NaN,NaN,74.53819951001918,75.44839637807016,-0.018574221394998564,0.19400882042691592,0.21258304182191448,561769583,561528512,62.66825495608574,47.56221244354568,NaN,NaN,16.74326180632617,18.560185290707988
2014-04-16T09:30:00-04:00,43.44,43.62,43.31,43.62,4314815,7754252.65,64.7824716263219,60.05463337236002,NaN,NaN,185.3899851530746,78.97682929684997,0.012458104305796414,0.22815567220416,0.21569756789836358,566084398,560202686.6,59.7963785859741,49.511338592137285,NaN,NaN,19.01871735744553,18.625689871670495
2014-04-17T09:30:00-04:00,43.54,43.67,43.39,43.63,4209582,7469334.3,64.91934509857708,60.576889888389175,NaN,NaN,185.00451879563508,95.14530059287,0.029927193529940055,0.25310655981078867,0.2231793662808486,570293980,560943144.4,60.87476343106794,51.70132412043843,NaN,NaN,20.804249833517876,18.93691272336298
2014-04-21T09:30:00-04:00,43.52,43.68,43.44,43.65,3739671,7283617.8,65.21056594142237,60.73231805267104,NaN,NaN,169.66564027857908,131.59502982646762,0.038549316881111434,0.2713660123822379,0.23281669550112646,574033651,565526478,66.80934686147506,54.13802316293267,NaN,NaN,22.304607203006395,19.418011934740612
2014-04-22T09:30:00-04:00,43.69,43.72,43.56,43.63,5669358,7261520.25,64.63274662323249,60.98240398717742,NaN,NaN,159.13113804283176,154.74589635602794,0.03853377922025783,0.28098391952644874,0.24245014030619091,568364293,568109181,69.606944825943,56.95353817355052,NaN,NaN,23.34946532965177,19.979648134013633
2014-04-23T09:30:00-04:00,43.63,43.69,43.555,43.56,11037110,7359069.15,62.54387569428186,61.020273053128754,NaN,NaN,127.22342393618315,165.28294124126074,0.02982642801792859,0.27973317532860165,0.24990674731067306,557327183,567220701,67.49916248655111,59.50096078767125,NaN,NaN,23.635626550382653,20.501930764923493
2014-04-24T09:30:00-04:00,43.54,43.79,43.5,43.73,3946160,7201252.65,65.46316473937767,61.20192632793055,NaN,NaN,125.37268251820873,153.27948071428756,0.03137592906796416,0.28912665864562825,0.2577507295776641,561273343,566258490,65.1966304345186,61.25952856829957,NaN,NaN,24.7243573689104,21.105134565493053
2014-04-25T09:30:00-04:00,43.69,43.82,43.6,43.79,6647432,7006000.6,66.45684170810145,61.75619136128985,NaN,NaN,122.25660876791055,140.72989870874264,0.032181543887078334,0.297977659436512,0.26579611554943366,567920775,565783849,64.03621743053324,62.78623786484045,NaN,NaN,25.914027097480556,21.79211921291984
2014-04-28T09:30:00-04:00,43.89,44.38,43.79,44.29,7214210,7140583.6,73.34048511698285,62.742453734052376,NaN,NaN,188.72259851818694,144.54129035666423,0.06048509739968699,0.34140248729904243,0.28091738989935544,575134985,566004115.8,64.3533020800236,64.0103760563654,NaN,NaN,29.3244369594776,22.868164605285234
2014-04-29T09:30:00-04:00,44.25,44.33,44.1,44.1,4222316,6903031.15,67.6584400581429,63.01352298922649,NaN,NaN,162.8422682461891,145.2835163973357,0.060368061311199483,0.3563774665383548,0.2960094052271553,570912669,566513791,65.11963937852221,64.66825055039472,NaN,NaN,30.356497850894865,23.937926497515182
2014-04-30T09:30:00-04:00,44,44.24,44,44.24,4854968,6819569.45,69.5315788709747,63.18473199552377,NaN,NaN,138.92088718655123,147.6230090474093,0.06336592352110793,0.3752168096285402,0.3118508861074323,575767637,570201881.8,70.12466423768721,65.22769938239578,NaN,NaN,31.80093272631896,25.061213101630006
2014-05-01T09:30:00-04:00,44.15,44.24,43.95,44.2,9711055,6969853.05,68.31417007593097,64.13573299164162,NaN,NaN,119.5116749873322,146.450807541234,0.056527387503584436,0.3825101204869128,0.32598273298332836,566056582,571158529.6,71.27600854273369,65.65332761470232,NaN,NaN,32.595878662118515,26.137593895985507
2014-05-02T09:30:00-04:00,44.2,44.26,44.055,44.2,5245276,7010599.25,68.31417007593097,65.4425448451497,NaN,NaN,115.30689373959396,145.06086453557072,0.04630594420025791,0.3838651632336507,0.3375592190333928,566056582,570785691,70.14146612824074,65.89475629494561,NaN,NaN,33.23685116318771,27.151773505585822
2014-05-05T09:30:00-04:00,44.03,44.2172,43.894,44.1,3283103,6733967.3,65.01375205437823,66.0459569018755,NaN,NaN,88.77354311653072,125.07105345523946,0.02801267810076108,0.37257506665934415,0.34456238855858307,562773479,568313389.8,62.98232019485695,65.74893568387236,NaN,NaN,32.85539785132639,27.96657698354876
2014-05-06T09:30:00-04:00,43.97,44.05,43.81,43.82,4471866,6203161.7,56.746852745208336,65.92346145920455,NaN,NaN,49.868918655449484,102.47638353709154,-0.005931912960008889,0.33714749735857197,0.34307941031858086,558301613,565791178.6,56.631771159192176,65.31775826980854,NaN,NaN,30.010217671522515,28.258525653259294
2014-05-07T09:30:00-04:00,43.92,44.27,43.92,44.24,7554253,6196472.2,64.11736520528248,65.87595385770173,NaN,NaN,88.0919513646505,92.31059637271137,-0.003221135033874556,0.3390529915262377,0.34227412656011225,565855866,563808824.4,52.178598660832606,64.77363113229843,NaN,NaN,29.756608836080524,28.47253753651947
2014-05-08T09:30:00-04:00,44.24,44.47,44.16,44.3,4197943,6128413,65.0340333786475,65.88414587770676,NaN,NaN,106.68356789200867,89.74497495364666,-0.0006446027735242943,0.3414683730932069,0.3421129758667312,570053809,564608269.8,53.75780912114446,64.26527725301818,NaN,NaN,29.84187306861812,28.66815689824785
2014-05-09T09:30:00-04:00,44.26,44.52,44.21,44.51,2792522,5961947.4,68.10518103458199,66.09090409864673,NaN,NaN,112.53203781832443,89.19000376939275,0.011286839578425023,0.3562215253397625,0.34493468576133746,572846331,565966219.6,56.39209284702669,63.52118768055759,NaN,NaN,30.88990938695675,28.98555011092055
2014-05-12T09:30:00-04:00,44.57,44.7,44.48,44.55,4824942,5429459.1,68.66965729740022,66.37925486108729,NaN,NaN,132.72921533890857,97.98113821386832,0.01758156457771659,0.3669116414834832,0.3493300769057666,577671273,568945778.4,61.56572732446106,62.946815001880296,NaN,NaN,31.901731976080782,29.402147520229153
2014-05-13T09:30:00-04:00,44.54,44.7,44.53,44.64,2518562,5338697.45,69.95797207769935,66.90883317418853,NaN,NaN,132.07455909043995,114.42226630086641,0.023164135704540956,0.3782852465364428,0.35512111083190184,580189835,573323422.8,67.6402111546218,62.95688990674249,NaN,NaN,33.124215659416905,29.933871540113117
2014-05-14T09:30:00-04:00,44.61,44.63,44.345,44.4,3165658,5181040.1,62.56922142882455,66.70212293772046,NaN,NaN,94.32434852428368,115.66874573279304,0.0068950701668601955,0.3637399485404771,0.3568448783736169,577024177,575557085,70.22598103088322,63.31612923505425,NaN,NaN,31.945766283188714,30.221285074838203
2014-05-15T09:30:00-04:00,44.27,44.3,43.94,44.01,4726441,5201621.4,52.8086183466867,65.72724984047655,NaN,NaN,6.159073493174972,95.5638468530263,-0.031805691429021565,0.31708776408733996,0.34889345551636153,572297736,576005870.4,70.73201872676367,63.79440075621358,NaN,NaN,27.605747808513183,29.847636893934627
2014-05-16T09:30:00-04:00,44.07,44.3,44.01,44.28,6381738,5310229.2,57.72538302918281,64.61188540563369,NaN,NaN,29.231965906541944,78.90383247066981,-0.04034529794313402,0.298461833087444,0.338807131030578,578679474,577172499,72.06133885769398,64.34497481176146,NaN,NaN,25.55749936667916,29.234760104326703
2014-05-19T09:30:00-04:00,44.17,44.2499,44.06,44.19,2805306,5263510.95,55.644247179295,63.75372877143026,NaN,NaN,14.93929011452449,55.345847425792996,-0.05241522036549251,0.2732881055737124,0.3257033259392049,575874168,576813078,70.99154778200815,64.76439684058188,NaN,NaN,23.24939614445994,28.379708110060022
2014-05-20T09:30:00-04:00,44.19,44.19,43.96,44.03,6246802,5292383.15,52.0514817677581,62.5051504069148,NaN,NaN,-28.485952133188636,23.233745181067277,-0.07041292270509103,0.2376871725578411,0.30810009526293214,569627366,574700584.2,64.89370924449162,64.39075719821076,NaN,NaN,20.18399362798517,27.2088917554779
2014-05-21T09:30:00-04:00,44.03,44.31,43.99,44.28,5037718,4992413.55,56.750375666954845,61.67916509198793,NaN,NaN,9.958174829427687,6.360510442096073,-0.06485684590104118,0.22702903788663065,0.29188588378767183,574665084,574228765.6,63.580133829820575,63.84105186157412,NaN,NaN,19.067933118102292,26.045897664424242
2014-05-22T09:30:00-04:00,44.26,44.29,44.1,44.21,2898272,4940019.15,55.121513644155684,60.73683248971827,NaN,NaN,1.9650499019284928,5.521705723846781,-0.06510280591999212,0.2105073763876817,0.2756101823076738,571766812,574122580.8,63.269734763792925,63.3502139069707,NaN,NaN,17.665555601530425,24.848705941153696
2014-05-23T09:30:00-04:00,44.2,44.34,44.2,44.28,2709974,4743146.25,56.467118828662706,60.12635868788145,NaN,NaN,25.601494859735574,4.795611514485521,-0.05988962118673313,0.20074815582425742,0.26063777701099056,574476786,573282043.2,60.74179866496261,63.1901766548354,NaN,NaN,16.91966364069527,23.71598561251678
2014-05-27T09:30:00-04:00,44.39,44.4299,44.2755,44.4,3520746,4558473.05,58.75043829244142,60.26947194125524,NaN,NaN,64.78932373669497,14.765618238919618,-0.04820065029010073,0.20038696414836465,0.2485876144384654,577997532,573706716,61.57709816680485,63.54341429823631,NaN,NaN,16.96341698239633,22.751332951071
2014-05-28T09:30:00-04:00,44.44,44.48,44.33,44.34,3903133,4542513.9,57.13675057614896,59.77085661060285,NaN,NaN,63.87401406624222,33.23761147880579,-0.04444285770777748,0.19303404230374355,0.23747690001152102,574094399,574600122.6,63.34409264701789,64.34094958296383,NaN,NaN,16.54103013617733,21.864146834657618
2014-05-29T09:30:00-04:00,44.38,44.76,44.38,44.69,6683374,4633934.2,63.444353285332,59.65730803250889,NaN,NaN,141.42224553716034,59.53042562035231,-0.019586627309211235,0.21299361587500698,0.23258024318421822,580777773,575822660.4,65.67062326958697,65.19186487928116,NaN,NaN,18.10567806127763,21.327222724174764
2014-05-30T09:30:00-04:00,44.56,45.075,44.56,45.04,4482581,4372510.5,68.44505897877062,59.68158502852236,NaN,NaN,206.51783738958446,100.4409831178835,0.017235332383050583,0.25412440866303143,0.23688907627998085,585260354,578521368.8,70.17129687921322,66.17609373872305,NaN,NaN,21.170101460798453,21.30477682940672
2014-06-02T09:30:00-04:00,44.96,45.01,44.88,44.93,3272987,4273896.05,65.41625060761649,59.44919883639495,NaN,NaN,182.62435067789212,131.8455542815148,0.030231503244458446,0.2746784553355539,0.24444695209109546,581987367,580023485,72.3446162082812,66.94601437328163,NaN,NaN,22.697457637999538,21.503731230634266
2014-06-03T09:30:00-04:00,44.87,44.9,44.75,44.77,2673987,4243440.25,61.17571485962595,58.821894749389706,NaN,NaN,124.49239907313653,143.78616934880313,0.02435306359523126,0.27488828158513456,0.2505352179899033,579313380,580286654.6,72.71963771824043,67.30883055639724,NaN,NaN,22.643740499910677,21.666589697673754
2014-06-04T09:30:00-04:00,44.74,44.99,44.72,44.93,3149023,4177298.1,63.709188789615695,58.90332098944622,NaN,NaN,127.67789244463079,156.54694502448083,0.02731868812357685,0.2846835781443744,0.25736489002079754,582462403,581960255.4,75.03787985417645,67.6525376152039,NaN,NaN,23.387757728256226,21.912470844899822
2014-06-05T09:30:00-04:00,44.94,45.17,44.87,45.11,3905942,3994882.55,66.36808720838314,59.871854479567396,NaN,NaN,148.52416134390853,157.96732818583047,0.036886226262309585,0.3034726728486845,0.2665864465863749,586368345,583078369.8,76.47613641359253,68.06283173569167,NaN,NaN,24.847677992401813,22.331786151685822
2014-06-06T09:30:00-04:00,45.12,45.239,45.11,45.23,2562235,3913097.15,68.04877118404652,60.609239347771954,NaN,NaN,154.77571866218307,147.6189044403502,0.046177038792841296,0.32430774507742655,0.27813070628458525,588930580,583812415,77.39689187294451,68.44394266535242,NaN,NaN,26.574356003348154,22.937867559066156
2014-06-09T09:30:00-04:00,45.13,45.27,45.09,45.16,6310416,4088991.85,65.97752376496328,61.34733053246254,NaN,NaN,129.3100045239322,136.95603520955822,0.04257676239062125,0.3313516592728618,0.28877489688224056,582620164,583938974.4,77.55997732776201,68.91311620433484,NaN,NaN,27.38654586795904,23.57339303176514
2014-06-10T09:30:00-04:00,45.03,45.208,45.01,45.16,4362014,4065845.45,65.97752376496328,62.342047817977196,NaN,NaN,104.5989153486365,132.9773384646582,0.03545552903877153,0.33309430818070496,0.29763877914193343,582620164,584600331.2,78.4355874969913,69.88039322237054,NaN,NaN,28.04552343100497,24.212268803085117
2014-06-11T09:30:00-04:00,45.07,45.16,44.97,45.04,4977887,4188811.7,62.21271091647596,62.73221462151442,NaN,NaN,81.90531522003852,123.82282301973976,0.018761804922036718,0.32109103529447935,0.30232923037244264,577642277,583636306,73.90849752475808,70.61813348629464,NaN,NaN,27.567710830679243,24.691617664169993
2014-06-12T09:30:00-04:00,44.95,45.04,44.635,44.72,5186259,4289841.75,53.45329276188903,62.61305598706681,NaN,NaN,31.75817574982712,100.46962590092349,-0.01586295306497576,0.28250053904122296,0.2983634921061987,572456018,580853840.6,62.665973331782226,70.57500766972245,NaN,NaN,24.469060321984674,24.659823758143517
2014-06-13T09:30:00-04:00,44.78,44.79,44.609,44.71,1936733,4150356.35,53.20120468535968,62.37977640540231,NaN,NaN,9.61698098324506,71.43787836513589,-0.040091818009381885,0.24824871959447137,0.28834053760385325,570519285,577171581.6,51.50107031245819,69.91495564454357,NaN,NaN,21.892310752197396,24.26446475729407
2014-06-16T09:30:00-04:00,44.7,44.92,44.57,44.88,18205169,4741527.9,56.920669000197535,62.24907859881346,NaN,NaN,22.18029837687414,50.01193713572427,-0.04495606460975132,0.2321454568416641,0.2771015214514154,588724454,578392439.6,54.401794406597574,69.4024339473859,NaN,NaN,20.70870341227555,23.756498850862855
2014-06-17T09:30:00-04:00,44.95,44.95,44.7269,44.88,4897761,4846150.65,56.920669000197535,62.23364420053122,NaN,NaN,30.48717983505532,35.189590033008024,-0.048174490626577415,0.21688340816819363,0.26505789879477104,588724454,579613297.6,57.16108484279765,68.96079053279875,NaN,NaN,19.744382144887275,23.18333932143777
2014-06-18T09:30:00-04:00,44.83,45.42,44.78,45.41,22633415,5665481.3,66.53695712927907,62.454544475098835,NaN,NaN,106.20456694873886,40.0494403787481,-0.016259471744284604,0.2447335591144153,0.2609930308586999,611357869,586356416,68.49940537995515,69.16284639782505,NaN,NaN,21.89347791749401,22.99907340658866
2014-06-19T09:30:00-04:00,45.45,45.71,45.42,45.67,11404221,5983806.45,70.06693416255727,62.57039270251217,NaN,NaN,188.4077047957514,71.37934618793295,0.01880976112024635,0.2845052322590078,0.26569547113876146,622762090,596417630.4,77.89880818888187,69.7148114913728,NaN,NaN,24.924364783088873,23.274115031802978
2014-06-20T09:30:00-04:00,45.48,45.51,45.19,45.22,5165375,6097161.6,58.553981248792745,62.08023060545333,NaN,NaN,106.39459825420863,90.73486964212567,0.00866419450469591,0.27652571426963135,0.26786151976493544,617596715,605833116.4,83.00845969896065,70.47651459784991,NaN,NaN,23.529819450017257,23.310644234405018
2014-06-23T09:30:00-04:00,45.22,45.23,44.9,44.97,3370687,6130197.25,53.3129306954553,61.518603165155426,NaN,NaN,27.55302980880484,91.80941592851181,-0.01654549979033426,0.2471796450270176,0.2637251448173519,614226028,610933431.2,85.02776156236857,71.35566630100192,NaN,NaN,20.5230332435637,22.91241409285626
2014-06-24T09:30:00-04:00,44.9,44.95,44.7,44.81,3677179,6138018.9,50.21507829918431,60.55473813012462,NaN,NaN,-44.84395810305824,76.74318834088909,-0.04409426335780181,0.2086073156200996,0.2527015789779014,610548849,615298310.2,86.50576877611802,72.17480122399775,NaN,NaN,17.058641529904428,22.076160869577425
2014-06-25T09:30:00-04:00,44.65,44.77,44.57,44.74,6082966,6247010.55,48.87695825712575,59.30537177646337,NaN,NaN,-96.52619047822286,36.197036855496755,-0.06582086903241247,0.17042549268738583,0.2362463617197983,604465883,613919913,83.69593241943505,72.6905009387008,NaN,NaN,13.897228110978638,20.90774190406331
2014-06-26T09:30:00-04:00,44.65,44.71,44.395,44.58,15990159,6712349.8,45.868252273423906,57.72104899713319,NaN,NaN,-139.05637685791046,-29.295779475235626,-0.08835288503161517,0.12580525543027932,0.2141581404618945,588475724,607062639.8,71.29007506706577,72.25429973828088,NaN,NaN,10.321028002813128,19.395354203884715
2014-06-27T09:30:00-04:00,44.58,44.74,44.395,44.655,4692824,6722861.95,47.499664168609065,56.40120188310788,NaN,NaN,-114.58190948077397,-73.49108102223215,-0.09501002601373087,0.0953956079447309,0.19040563395846177,593168548,602177006.4,64.01017297017907,71.28645656988209,NaN,NaN,7.920694122618927,17.756117049418172
2014-06-30T09:30:00-04:00,44.5,44.89,44.5,44.62,12049143,7161669.75,46.790959987083525,55.03073304183075,NaN,NaN,-82.39281784095022,-95.48025055218315,-0.09817152050398398,0.06769123332848181,0.1658627538324658,581119405,595555681.8,55.70748519154522,69.66302069092167,NaN,NaN,5.767154367309139,16.043408094831168
2014-07-01T09:30:00-04:00,44.69,44.85,44.52,44.72,5099647,7282952.75,49.126476349849646,54.09600200135744,NaN,NaN,-71.20052369018676,-100.75156366960886,-0.0901371433610978,0.05319132463109355,0.14332846799219134,586219052,590689722.4,50.52125139893304,67.99250311050558,NaN,NaN,4.616108867687356,14.410936776667766
2014-07-02T09:30:00-04:00,44.74,44.925,44.74,44.84,3092969,7280150.05,51.85730123830493,53.982002606815726,NaN,NaN,-29.836517097719994,-87.4136289935083,-0.07402479204569676,0.05079747793507039,0.12482226998076715,589312021,587658950,47.55180770508752,66.91291985145595,NaN,NaN,4.409161118242154,12.982111682606964
2014-07-03T09:30:00-04:00,44.87,45.15,44.81,45.09,2303442,7200025.05,57.032058973764975,54.255635055987526,NaN,NaN,23.47567662171442,-54.90721829758331,-0.045228945324639794,0.06828608832496741,0.1135150336496072,591615463,588286897.8,48.230742141817956,66.67932498212453,NaN,NaN,5.770895391359915,11.951937926714528
2014-07-07T09:30:00-04:00,45,45.2,44.95,45.16,5813747,7362600.65,58.3810029563862,54.35994462428672,NaN,NaN,51.20718356509399,-21.749399688409717,-0.021376948843369853,0.08679384759539488,0.10817079643876473,597429210,589139030.2,49.191908178623315,66.30719025155493,NaN,NaN,7.293684227561833,11.286473112549858
2014-07-08T09:30:00-04:00,45.09,45.21,45.03,45.07,4629546,7278557.15,55.94896374964853,54.29053710639037,NaN,NaN,53.16882091755784,5.362928063291889,-0.012036126803503785,0.093125637934385,0.10516176473788878,592799664,591475082,51.8321506143279,65.92655209237851,NaN,NaN,7.895983332099502,10.802117429628378
2014-07-09T09:30:00-04:00,45.13,45.31,45.12,45.27,5296012,7325257.05,59.94247826080974,53.81950290149969,NaN,NaN,88.6465367816495,37.33234015765914,0.0062542661731165156,0.11297959745428443,0.10672533128116792,598095676,593850406.8,54.42548317722221,64.92127193504045,NaN,NaN,9.603840752774772,10.63093504722072
2014-07-10T09:30:00-04:00,44.99,45.25,44.95,45.2,3871150,7269920.2,57.961889104059516,52.95485682589271,NaN,NaN,56.865291776380936,54.67270193247932,0.01195024023913395,0.12166313158008535,0.1097128913409514,594224526,594832907.8,55.49287814024994,63.320848360138164,NaN,NaN,10.471424015441446,10.608147756966538
2014-07-11T09:30:00-04:00,45.2,45.305,45.06,45.26,3100544,7165634.45,59.20609672791854,53.00143650297313,NaN,NaN,70.66597972583298,64.11076255330303,0.0177227434352374,0.13186632063499815,0.11414357719976075,597325070,595974829.2,56.76044871414614,61.44599043265141,NaN,NaN,11.547422900656276,10.742329920350786
2014-07-14T09:30:00-04:00,45.38,45.49,45.35,45.42,4135565,7275576.05,62.401825016443496,53.65064324018657,NaN,NaN,116.95029334657514,77.25938450959924,0.029581982115849934,0.15112105484457317,0.12153907272872323,601460635,596781114.2,57.67699868456669,59.49236451280843,NaN,NaN,13.409037344021218,11.123288123732276
2014-07-15T09:30:00-04:00,45.36,45.36,44.98,45.02,7181775,6724406.35,51.53295647109024,53.74477739532271,NaN,NaN,31.005987109472684,72.82681774798223,0.008829272731435092,0.1325756636430171,0.123746390911582,594278860,597076953.4,58.028543608204465,57.4582770008146,NaN,NaN,11.764568143165203,11.214899555079837
2014-07-16T09:30:00-04:00,45.2,45.25,44.96,45.03,4513104,6705173.5,51.75917411312347,53.9506499564654,NaN,NaN,17.002335084645186,58.497977408581356,-0.00513096411684523,0.11733268576552547,0.1224636498823707,598791964,597216211,58.20453095613292,55.63746261057874,NaN,NaN,10.523190250722383,11.11608394017163
2014-07-17T09:30:00-04:00,45.04,45.11,44.72,44.75,3965388,5771772.15,45.37326557146972,53.915293763468675,NaN,NaN,-41.84756391703376,38.75540626989842,-0.03259742008976395,0.08171687477016576,0.11431429485992971,594826576,597336621,58.367083054853545,54.714391752563586,NaN,NaN,7.395896533866201,10.584628596413712
2014-07-18T09:30:00-04:00,44.8,45.225,44.79,45.2,5929302,5498026.2,54.98554739544382,54.44999970824259,NaN,NaN,29.796048438495344,30.581420012430897,-0.020428284841738614,0.08877893880775645,0.10920722364949506,600755878,598022782.6,59.33760392894551,54.3806368210469,NaN,NaN,7.8055202417962715,10.187613117182648
2014-07-21T09:30:00-04:00,45.03,45.03,44.84,44.99,5085306,5494022.75,50.518097340423985,54.71622380490976,NaN,NaN,-2.440339377428442,6.70329346763018,-0.026127352989956942,0.07654803241204888,0.10267538540200583,595670572,596864770,56.92576407341638,54.467656741180555,NaN,NaN,6.615132415700228,9.677258731256588
2014-07-22T09:30:00-04:00,44.93,45.03,44.82,44.91,13404154,5995696.1,48.88852565885687,54.699227326981706,NaN,NaN,-11.959942775395165,-1.8898925093433891,-0.034371264473944674,0.05971130480957498,0.09408256928351966,582266418,594462281.6,52.186515779687625,54.586604196948734,NaN,NaN,5.142718216877404,9.02946722920242
2014-07-23T09:30:00-04:00,44.99,45.01,44.81,44.85,2796973,5951685.8,47.64713291324841,54.398501018049096,NaN,NaN,-23.892773892776834,-10.06891430482779,-0.042423382655890046,0.04105334096365709,0.08347672361954714,579469445,590597777.8,45.60891570953045,54.44782619726608,NaN,NaN,3.5779221051347636,8.250675068621325
2014-07-24T09:30:00-04:00,44.93,45.05,44.87,44.97,3449640,5820019.5,50.36189713261248,53.922060886538205,NaN,NaN,-3.1984948259661277,-2.3391004866142606,-0.038349312213563,0.0355400833525934,0.0738893955661564,582919085,588216279.6,42.088351422689115,54.009084003042595,NaN,NaN,3.0983814318167906,7.514633120506391
2014-07-25T09:30:00-04:00,44.93,44.9699,44.69,44.79,2477792,5144401.15,46.46934746798731,53.071228351652564,NaN,NaN,-68.09797501630611,-21.91790517757455,-0.04594624447501679,0.016456589972385416,0.0624028344474022,580441293,584153362.6,36.86078576178297,53.12828954469686,NaN,NaN,1.4981446812674584,6.655134772043687
2014-07-28T09:30:00-04:00,44.75,44.825,44.5,44.56,30101182,6414819.05,42.00207128692753,52.0750217471725,NaN,NaN,-146.5007181775681,-50.729980937602484,-0.06354625378958036,-0.01702998278957324,0.04651627100000712,550340111,575087270.4,28.387804415274005,51.453693387621584,NaN,NaN,-1.2938312497100386,5.519568197507441
2014-07-29T09:30:00-04:00,44.61,44.73,44.35,44.36,6319059,6128314.85,38.53312699520648,50.545782371057975,NaN,NaN,-192.13160414309385,-86.76431321114221,-0.08443401175731415,-0.05902624369663556,0.02540776806067858,544021052,567438197.2,23.483215670629647,49.243531422864976,NaN,NaN,-4.771658673343207,4.049392930243063
2014-07-30T09:30:00-04:00,44.43,44.49,43.89,43.89,22407139,6993689.45,31.87148280287046,48.68218192097304,NaN,NaN,-278.3885939560636,-137.66347722379956,-0.12332582313726236,-0.12874951086089936,-0.005423687723637008,521613913,555867090.8,18.325314810776916,46.58870547075976,NaN,NaN,-10.298213334732761,1.999734892389374
2014-07-31T09:30:00-04:00,43.52,43.64,43.11,43.1399,10784463,7378264.15,24.570683531550543,46.20822383551819,NaN,NaN,-344.35511415885276,-205.89480109037686,-0.1890576965194481,-0.24174580837294712,-0.05268811185349904,510829450,541449163.8,14.153745792041931,43.54536954775232,NaN,NaN,-18.41095522377005,-0.9160779813476863
2014-08-01T09:30:00-04:00,43.08,43.66,43.08,43.47,11889965,7857590.3,31.957532746684834,44.03363153053543,NaN,NaN,-228.30901235687344,-237.93700855849033,-0.1987998861781134,-0.3011879695761408,-0.1023880833980274,522719415,529904788.2,11.831357310013331,40.27068087814137,NaN,NaN,-21.957971419104002,-3.922062758170017
2014-08-04T09:30:00-04:00,43.53,43.6899,43.35,43.61,5024430,7818124.45,34.8706823276995,42.84346909172181,NaN,NaN,-160.6562427719153,-240.7681134773598,-0.18461675783724882,-0.3331590306945884,-0.1485422728573396,527743845,525385535,11.065883261798561,36.91620513911237,NaN,NaN,-23.59186403251772,-6.732034368791117
2014-08-05T09:30:00-04:00,43.48,43.7,43.235,43.42,4571669,7815230.6,32.81718427103901,41.4904698172872,NaN,NaN,-142.65800613122988,-230.87339387498702,-0.17682025683343008,-0.3695675938991272,-0.1927473370656971,523172176,521215759.8,10.397456738728081,33.50141412358346,NaN,NaN,-25.595255125226412,-9.426780191139017
2014-08-06T09:30:00-04:00,42.99,43.82,42.97,43.79,27892415,8945050.75,40.20220664280981,41.12110846524007,NaN,NaN,-112.87118103644018,-197.7699112910623,-0.13729457471039822,-0.36436555545369487,-0.22707098074329665,551064591,527105895.4,17.938069740246902,30.61362745825441,NaN,NaN,-24.651438717801515,-11.60173140923366
2014-08-07T09:30:00-04:00,43.9,43.9,43.33,43.43,5532640,9028125.25,36.04995384346898,39.76856606867044,NaN,NaN,-95.21221071510142,-147.94133060231204,-0.12622763060749875,-0.3848555190026701,-0.25862788839517137,545531951,534046395.6,25.856013459525002,28.22208528186723,NaN,NaN,-25.332129000781222,-13.56321677945474
2014-08-08T09:30:00-04:00,43.47,43.9099,43.43,43.87,5259427,9136069.4,43.70330520554908,39.28179520189366,NaN,NaN,-66.9025167688544,-115.66003148470823,-0.08223639029786511,-0.36142337626750276,-0.27918698596963765,550791378,539660788.2,31.605005311926647,26.413459656046534,NaN,NaN,-23.116655098889712,-14.927993682231165
2014-08-11T09:30:00-04:00,44.03,44.39,43.99,44.18,23734623,10116022.3,48.38971980608126,39.24616621240968,NaN,NaN,-15.381091382383277,-86.60500120680186,-0.028023795412673302,-0.31421673023547925,-0.28619293482280594,574526001,549017219.4,39.960040509819294,25.540139993913076,NaN,NaN,-19.647236521987445,-15.602171230767777
2014-08-12T09:30:00-04:00,44.16,44.23,44.04,44.15,3954179,9954642.5,47.973518322487834,39.269479455926785,NaN,NaN,-15.905551197664355,-61.254510220088754,0.008119298894358695,-0.27604381120485755,-0.28416311009921624,570571822,558497148.6,47.02162479639362,25.641047785831876,NaN,NaN,-17.135578968170535,-15.82122947896817
2014-08-13T09:30:00-04:00,44.25,44.36,44.105,44.28,2704297,9864202.15,49.98118093487011,39.24228544180233,NaN,NaN,1.224424037375725,-38.43538920532557,0.04123442026247648,-0.23262008477112062,-0.2738545050335971,573276119,562939454.2,49.98992152795006,26.205445650493374,NaN,NaN,-14.474194266424497,-15.628795877176218
2014-08-14T09:30:00-04:00,44.43,44.47,44.23,44.46,2196061,9775735.8,52.70273009339328,39.687527057902756,NaN,NaN,22.002630832761472,-14.992420895752966,0.07381261907804049,-0.18158873118604646,-0.25540135026408695,575472180,568927500,53.751480532311966,27.4119238483883,NaN,NaN,-11.42240835965372,-15.027883374673005
2014-08-15T09:30:00-04:00,44.69,44.795,44.28,44.52,4542664,9706403.9,53.60884108759978,40.51658204366506,NaN,NaN,46.40868077337206,7.6698186126923265,0.09652012867699106,-0.13475118941784814,-0.2312713180948392,580014844,574772193.2,57.14009988082549,29.465659238784838,NaN,NaN,-8.683333903063383,-14.12151916444306
2014-08-18T09:30:00-04:00,44.63,44.82,44.58,44.78,4427579,9673517.55,57.415980334188,41.86535728216374,NaN,NaN,75.82466940201572,25.910970769572124,0.1243940601927124,-0.0757787428539487,-0.2001728030466611,584442423,576755477.6,58.25775726352299,31.949555066848642,NaN,NaN,-5.158578856180843,-12.8410991204056
2014-08-19T09:30:00-04:00,44.86,44.95,44.67,44.9,2627895,9134704.6,59.084915897922485,43.809173931810314,NaN,NaN,92.68014610279886,47.62811022966476,0.14482701516611104,-0.01913903408902229,-0.16396604925513333,587070318,580055176.8,60.121026224756314,34.93496302499003,NaN,NaN,-1.7342451548931361,-11.254405696760962
2014-08-20T09:30:00-04:00,44.79,44.92,44.735,44.87,5580009,9273856.4,58.46798610664106,46.23040983003107,NaN,NaN,93.67116437179759,66.11745829654915,0.14962224129917823,0.02306175236883945,-0.12656048893033878,581490309,581698014.8,61.053157534391566,38.28492100658644,NaN,NaN,0.9000761418070297,-9.518051148394106
2014-08-21T09:30:00-04:00,44.89,45.145,44.89,44.95,1723991,9187573.95,59.67709211772719,48.21037835653409,NaN,NaN,114.49025716884812,84.61498356376647,0.1510435919372024,0.06224400099116423,-0.08879959094603818,583214300,583246438.8,61.9557708752528,41.86523626124639,NaN,NaN,3.4542126555061876,-7.664870604979778
2014-08-22T09:30:00-04:00,45,45.07,44.839,44.84,5176513,9322510,57.210787603743924,49.80610016196584,NaN,NaN,101.90689325192405,95.71462605947687,0.13780613820429116,0.08345808180932579,-0.05434805639496538,578037787,582851027.4,61.56340062540246,45.472201787218104,NaN,NaN,4.987471358881665,-5.857393181571
2014-08-25T09:30:00-04:00,45.05,45.1501,45.0101,45.09,1985217,7916711.75,61.14138341223476,51.82925724347982,NaN,NaN,116.55072033921503,103.85983624691673,0.13873502998852216,0.11907073109068733,-0.019664298897834838,580023004,581967143.6,60.638922891024194,49.06087794095354,NaN,NaN,7.467849141185343,-3.9537871354629512
2014-08-26T09:30:00-04:00,45.12,45.185,45.03,45.06,1792293,7690373.45,60.42408461388956,53.273677098556945,NaN,NaN,107.13052305556752,106.74991163747048,0.13030926758742523,0.14322228558644667,0.012913017999021462,578230711,580199222.2,58.73892842497851,51.97522498986293,NaN,NaN,9.338408013386692,-2.0549021141987165
2014-08-27T09:30:00-04:00,45.1,45.1,44.99,45.08,2054478,6672740.4,60.75464177055607,55.03829766477745,NaN,NaN,91.24286418884897,106.26425160088074,0.11935576357190357,0.16210772246390093,0.04275195889199736,580285189,579958198.2,58.46995113806209,54.3047919669013,NaN,NaN,10.993795184217324,-0.19080250013928213
2014-08-28T09:30:00-04:00,44.96,45.11,44.9161,45.1,2801862,6273610.35,61.104506022767,56.281240580293016,NaN,NaN,82.13093864926951,99.79238789696504,0.1071200849348944,0.17665206506061537,0.06953198012572097,583087051,579932748.4,58.43952092425887,56.22154308206789,NaN,NaN,12.486291495495998,1.620210927808615
2014-08-29T09:30:00-04:00,45.14,45.17,44.99,45.13,3076358,5832930,61.65668124536343,57.228880683098886,NaN,NaN,81.78110622854338,95.7672304922889,0.09511620687407826,0.1884272387183188,0.09331103184424053,586163409,581557872.8,59.87556612945761,57.644080626327764,NaN,NaN,13.904933432916557,3.375171285681178
2014-09-02T09:30:00-04:00,45.18,45.35,45.01,45.15,11691947,6166305.85,62.043543809033096,58.2338825035664,NaN,NaN,84.870575847702,89.43120159398629,0.08303191433343818,0.19710092476103824,0.11406901042760006,597855356,585124343.2,62.904859167322,58.77859736710837,NaN,NaN,15.221062934514206,5.067441521228753
2014-09-03T09:30:00-04:00,45.26,45.28,45.13,45.18,2391429,6057293.85,62.65224954786092,59.13895883306575,NaN,NaN,83.15205123154321,84.63550722918141,0.07197962824784468,0.2040435457374059,0.13206391748956123,600246785,589527558,66.28879824054121,59.94280284657916,NaN,NaN,16.512404029013528,6.702436165198007
2014-09-04T09:30:00-04:00,45.25,45.44,45.19,45.32,4379644,4881655.3,65.43782108946996,60.04860818992838,NaN,NaN,97.29861035089154,85.84665646158993,0.0690094498018077,0.21832572974182085,0.14931627994001315,604626429,594395806,69.59162797856621,61.07424194988304,NaN,NaN,18.382899399537227,8.37107377010361
2014-09-05T09:30:00-04:00,45.33,45.58,45.18,45.58,5066997,4858373.15,69.92420990608093,61.213991676962756,NaN,NaN,117.30541541051929,92.88155181383989,0.07876151467278023,0.24776817328098844,0.1690066586082082,609693426,599717081,72.73596945147145,62.188232633500604,NaN,NaN,21.377863535025355,10.22918659366386
2014-09-08T09:30:00-04:00,45.43,45.52,45.22,45.24,4229622,4806882.9,59.117318772060784,61.335515851096524,NaN,NaN,93.97781422335864,95.32089341280293,0.05750630411462454,0.24088953875148889,0.18338323463686435,605463804,603577160,74.77373693182497,63.367945466950744,NaN,NaN,21.03966677887514,11.7735409058369
2014-09-09T09:30:00-04:00,45.27,45.27,45.0701,45.13,3452679,3792785.7,56.09661382544359,61.12206570306232,NaN,NaN,53.61200388078445,89.06917901941942,0.032477561466930205,0.2239801864705271,0.19150262500359688,602011125,604408313.8,75.2034958622936,64.44526472677482,NaN,NaN,19.86004568617825,12.928755874457092
2014-09-10T09:30:00-04:00,45.18,45.395,45.11,45.35,4186400,3804396.75,60.44934582608039,61.263591397307984,NaN,NaN,81.78506851343964,88.7957824757987,0.027381496186311194,0.2257294952364859,0.1983479990501747,606197525,605598461.8,75.8382487116148,65.50134266800507,NaN,NaN,20.120016718577336,13.956078852188556
2014-09-11T09:30:00-04:00,45.25,45.395,45.21,45.37,3924650,3865414.4,60.829547909886436,61.345909668176496,NaN,NaN,92.02534666582144,87.74112973878468,0.022220050350059806,0.22612306198774945,0.20390301163768965,610122175,606697611,76.43812865565408,66.5357967951766,NaN,NaN,20.439789925177386,14.88232329118696
2014-09-12T09:30:00-04:00,45.31,45.34,44.96,45.05,5778436,4044533.15,52.18553122677284,60.98696278410713,NaN,NaN,15.356769889958146,67.35140063467246,-0.004460452919617275,0.19832744548816805,0.20278789840778533,604343739,605627673.6,74.49914727624545,67.45977869880824,NaN,NaN,18.02872900761696,15.331809822105532
2014-09-15T09:30:00-04:00,45.19,45.305,45.14,45.27,6104911,4122645.5,56.737222442639364,60.67237985770747,NaN,NaN,57.66318899455318,60.08847558891138,-0.008758343690306702,0.19183996879490195,0.20059831248520865,610448650,606624642.8,75.13215612447868,68.49500964405499,NaN,NaN,17.3744052706179,15.623609171893014
2014-09-16T09:30:00-04:00,45.2,45.73,45.16,45.61,8388425,4320687.8,62.65415556341393,60.83167063981635,NaN,NaN,160.9800111049436,81.56207703374321,0.008876137661249561,0.21169348456177062,0.20281734690052106,618837075,609989832.8,77.1903497777156,69.81296831210763,NaN,NaN,18.770551345190885,16.073172339506996
2014-09-17T09:30:00-04:00,45.56,45.7,45.415,45.51,10475985,4713092.3,60.05267614700596,60.7815302381342,NaN,NaN,158.3860552120159,96.88227437345846,0.01123297371337001,0.21685856404223358,0.20562559032886357,608361090,610422545.8,77.44880934668257,71.1686010412948,NaN,NaN,19.05042943095354,16.498494781142217
2014-09-18T09:30:00-04:00,45.58,45.65,45.4869,45.6,6364783,4752331,61.598109602217484,60.816787636666376,NaN,NaN,153.38750518147282,109.15470607658874,0.015990282334707423,0.22561344324724786,0.20962316091254043,614725873,611343285.4,78.0195414486786,72.56717393589621,NaN,NaN,19.758027161934695,16.96414226411257
2014-09-19T09:30:00-04:00,45.5,45.588,45.37,45.43,5411862,4936724.55,57.104224614530885,60.49161216303548,NaN,NaN,92.19158734900593,124.52166956839831,0.005373736997997258,0.216340332160037,0.21096659516203975,609314011,612337339.8,78.64783521399039,73.90805029907712,NaN,NaN,18.953460664987475,17.2483306070947
2014-09-22T09:30:00-04:00,45.4,45.47,45.28,45.35,6516527,5003725.25,55.06820825070329,59.99337390886906,NaN,NaN,44.454912774553776,121.88001432439842,-0.008590963399039808,0.20022789091324,0.2088188543122798,602797484,610807106.6,75.08957425684935,74.77838709118622,NaN,NaN,17.675834384197394,17.30940257525223
2014-09-23T09:30:00-04:00,45.2,45.28,44.95,44.95,6715596,5240244.2,46.19873553566825,58.81812290799815,NaN,NaN,-95.17915284695874,70.64818153401795,-0.04432424173124,0.15341355214822983,0.19773779387946983,596081888,606256069.2,65.585757982833,74.72816992992135,NaN,NaN,13.549256285647004,16.77223881959434
2014-09-24T09:30:00-04:00,44.94,45.55,44.94,45.53,14707257,5885992.4,57.010805538014374,58.21619322575133,NaN,NaN,28.068660003645796,44.584702492343936,-0.029186111035074486,0.1612551550856267,0.1904412661207012,610789145,606741680.2,66.07910049940806,74.47727510998149,NaN,NaN,13.648885555246812,16.32604549611612
2014-09-25T09:30:00-04:00,45.39,45.4,44.93,44.93,11438429,6355189.95,46.581845626596156,56.54888149150242,NaN,NaN,-94.66523555232664,-5.025845654415977,-0.05819465478260841,0.11769794764244068,0.1758926024250491,599350716,603666648.8,60.194550781439354,73.58145949069346,NaN,NaN,9.588794688059654,15.363581094965197
2014-09-26T09:30:00-04:00,45.03,45.19,44.77,45.1,3935186,6411856.15,49.40585686099425,55.85520564071195,NaN,NaN,-125.22989399941922,-48.51014192410101,-0.06408056448122854,0.09579189682351341,0.15987246130474195,603285902,602461027,58.013216232037614,72.38427944070865,NaN,NaN,7.561217526894522,14.248957728097958
2014-09-29T09:30:00-04:00,44.83,45.15,44.8,45.09,11255763,6820826.4,49.24094962101865,55.36551534039588,NaN,NaN,-122.39821713420893,-81.88076790585357,-0.06650623292401148,0.0767396701497276,0.14324590307373908,592030139,600307558,54.23280224759825,70.88637275394471,NaN,NaN,5.990612434511541,13.06919411472847
2014-09-30T09:30:00-04:00,45.11,45.22,44.95,45.11,7123663,6592412.2,49.603258041283645,54.590794784338975,NaN,NaN,-81.1635315704761,-79.07764365055705,-0.06456982056346189,0.0625336273694117,0.1271034479328736,599153802,600921940.8,55.131145901023864,69.40729398175964,NaN,NaN,4.88753005558212,11.900384963421848
2014-10-01T09:30:00-04:00,45.07,45.07,44.75,44.825,18044817,7375081.6,44.70623057097018,53.43912926013066,NaN,NaN,-151.63730667419335,-115.01883698612487,-0.0793180701808287,0.027955860206837713,0.10727393038766642,581108985,594985908.8,45.78105476265484,67.21750298940256,NaN,NaN,2.3524746773629372,10.536397779699147
2014-10-02T09:30:00-04:00,44.8,45.02,44.695,44.91,16952601,8003729.45,46.405648162538085,53.02628046982819,NaN,NaN,-132.26034114552155,-122.53785810476386,-0.079957497536199,0.0073270584674176575,0.08728455600361666,598061586,594728082.8,45.42073495025455,65.14047353754606,NaN,NaN,0.8349417107388852,9.150475484133395
2014-10-03T09:30:00-04:00,45.18,45.46,45,45.44,9134079,8207083.55,55.57420090935444,52.94320750316498,NaN,NaN,27.232752854053327,-92.04532873406934,-0.04313916888299886,0.03336059489986809,0.07649976378286695,607195665,595510035.4,46.78860669818577,63.115934292810856,NaN,NaN,2.544574790796692,8.206775385085294
2014-10-06T09:30:00-04:00,45.56,45.56,45.16,45.46,6884126,8339808.75,55.88092435834446,52.45940527423145,NaN,NaN,60.437179930744286,-55.47824932107868,-0.017221807723322963,0.05497250412871324,0.0721943118520362,614079791,599919965.8,53.818120539710215,61.446489347239044,NaN,NaN,3.9695990638486367,7.601464482051486
2014-10-07T09:30:00-04:00,45.23,45.52,45.19,45.19,11318624,8733106,50.7834784331574,51.79731972324227,NaN,NaN,23.069638508944735,-34.63161530519451,-0.01796346322386093,0.04973998282221004,0.06770344604607097,602761167,600641438.8,54.86856438123888,59.833614706850206,NaN,NaN,3.5619848909823975,7.024395969041616
2014-10-08T09:30:00-04:00,45.26,45.87,45.195,45.85,9800332,9013802.6,60.31354984414326,51.705565454808394,NaN,NaN,132.26093024558355,22.148032078760867,0.02401577462757422,0.09772316433053874,0.07370738970296452,612561499,606931941.6,62.81118074235299,58.74730322782694,NaN,NaN,6.59322626206386,6.962800296616222
2014-10-09T09:30:00-04:00,45.81,46.11,45.39,45.39,15077445,9571442.35,52.65997294882768,51.38811890725817,NaN,NaN,115.82858419483412,71.765817146832,0.019040499491156923,0.09750801406691068,0.07846751457575375,597484054,606816435.2,62.59335058311547,57.600554325621594,NaN,NaN,6.353814015291263,6.875802256426942
2014-10-10T09:30:00-04:00,45.43,46.0799,45.43,45.61,11403399,9852690.5,55.56420959899125,51.423547574993016,NaN,NaN,125.9703595497503,91.51333848597139,0.02824847166412113,0.11377810415590517,0.08552963249178404,608887453,607154792.8,62.998167686450515,56.736882427735964,NaN,NaN,7.19028282468209,6.920728051891963
2014-10-13T09:30:00-04:00,45.59,45.66,44.95,44.98,20244903,10559690.1,46.724282336856035,51.46108663222072,NaN,NaN,-31.55375642886882,73.11515121404878,-0.00844586686733885,0.07497229890761048,0.08341816577494933,588642550,602067344.6,53.604778851934746,55.88109820410038,NaN,NaN,4.61766054252932,6.5917184076973
2014-10-14T09:30:00-04:00,45.12,45.21,44.8549,44.96,12853970,10782967.35,46.471518728808846,50.70828043156318,NaN,NaN,-79.38103288175685,52.625016935908455,-0.033039281844666854,0.04211906346911576,0.07515834531378261,575788580,596672827.2,45.805579132775755,54.43298953505522,NaN,NaN,2.6089157118004245,6.022746593997747
2014-10-15T09:30:00-04:00,44.54,44.81,43.78,44.42,22241288,11371232.5,40.155223746133046,50.2492360115301,NaN,NaN,-227.4702136068247,-19.321211834573194,-0.08186872689901294,-0.027177563309983555,0.05469116358902938,553547292,584869985.8,34.11150043173012,52.56991451007598,NaN,NaN,-1.3852512832631747,4.964461182960473
2014-10-16T09:30:00-04:00,43.83,44.3152,43.685,44.09,19593407,12032663.7,36.85825261777705,49.352978565586014,NaN,NaN,-248.91217576091185,-92.2693638257224,-0.12974082108846324,-0.10748486277154967,0.02225595831691357,533953885,572163952,26.32109991564856,50.30619191604819,NaN,NaN,-5.789530637149746,3.4281766372304414
2014-10-17T09:30:00-04:00,44.49,44.75,44.08,44.63,12534396,12388790.4,44.839420035882064,49.038583595219116,NaN,NaN,-130.0554600590264,-143.4745277474777,-0.1186862589239825,-0.12610186533806456,-0.007415606414082055,546488281,559684117.6,21.199856827616003,47.94669581462089,NaN,NaN,-6.657993958350891,1.9872951235759655
2014-10-20T09:30:00-04:00,44.55,45.31,44.51,45.27,17229314,12924429.75,52.502319442271386,49.24565940957539,NaN,NaN,-9.272865277978891,-139.01834951729975,-0.06462483219773635,-0.08819664666125249,-0.023571814463516142,563717595,554699126.6,19.562525687836427,45.4060800851075,NaN,NaN,-4.529291089732134,1.0563542359605227
2014-10-21T09:30:00-04:00,45.13,45.46,44.95,45.46,13863618,13281830.85,54.5221838330576,49.94679892829591,NaN,NaN,45.078370360700745,-114.12646886880823,-0.015012180919972848,-0.0423370406134822,-0.027324859693509354,577581213,555057653.2,20.04084014017687,43.56749332635907,NaN,NaN,-2.1748620353270156,0.5947519114908744
2014-10-22T09:30:00-04:00,45.49,45.8699,45.41,45.56,10426950,13067815.5,55.59256048158722,50.60300695108514,NaN,NaN,107.67436042077308,-47.09755406328867,0.023501912986166894,0.002052531539199265,-0.02144938144696763,588008163,561949827.4,28.805248469984647,42.380672863482644,NaN,NaN,0.00654405015007322,0.5107222170136171
2014-10-23T09:30:00-04:00,45.74,45.84,45.45,45.53,12604762,13126132.15,55.1730239822517,50.57435145629209,NaN,NaN,93.56045417727529,21.396971924348758,0.04469081179254087,0.03441413329370846,-0.01027667849883241,575403401,570239730.6,37.65683508851253,41.7284034627917,NaN,NaN,1.5878795490159419,0.6646018358710921
2014-10-24T09:30:00-04:00,45.69,45.948,45.62,45.91,9205587,13389652.2,59.35697090307133,50.82264049520115,NaN,NaN,119.1688330201544,71.24183054018492,0.07997323963190227,0.08968987104104542,0.009716631409143157,584608988,577863872,44.49208258701873,41.06225789474231,NaN,NaN,4.272554993106869,1.180023715476203
2014-10-27T09:30:00-04:00,45.79,46.21,45.74,46.02,4917193,13072723.7,60.50610436089358,51.51711377575373,NaN,NaN,130.82969610916902,99.2623428176145,0.10482661084250652,0.1407498949622763,0.035923284119769784,589526181,583025589.2,48.60083007837216,40.61456258739469,NaN,NaN,6.7987088400942515,1.982693018993067
2014-10-28T09:30:00-04:00,46.22,46.22,46,46.2,5633457,12998213.4,62.38050270783676,51.664753266017556,NaN,NaN,136.87982712581143,117.62263417063664,0.12606871203238235,0.1935091741602477,0.06744046212786536,595159638,586541274.2,51.247800944259495,39.78860688753087,NaN,NaN,9.46799038647135,3.052021214347107
2014-10-29T09:30:00-04:00,46.2,46.3,45.85,46.12,6381152,12415030.15,60.99493467758203,52.260107675214286,NaN,NaN,116.25510419711624,119.33878292590528,0.12705386440152672,0.22625779262977375,0.09920392822824704,588778486,586695338.8,51.36599908430006,38.98665320904405,NaN,NaN,11.27544758489095,4.226796410139085
2014-10-30T09:30:00-04:00,46.17,46.52,45.88,46.41,5020245,11818412.35,64.10721584895992,52.8703224073549,NaN,NaN,127.7814453193878,126.18298115432779,0.13861366453227383,0.27247100889358933,0.1338573443613155,593798731,590374404.8,54.22035580000467,38.3596666457265,NaN,NaN,13.76249977472427,5.589039747936968
2014-10-31T09:30:00-04:00,46.83,46.84,46.56,46.71,8184328,11770924.8,67.03735229800715,54.32125597600855,NaN,NaN,161.7438338537008,134.69798132103705,0.15651771324855435,0.3295044859220084,0.17298677267345408,601983059,593849219,56.79927634627118,38.587845038179104,NaN,NaN,16.800408949499506,7.190663919588759
2014-11-03T09:30:00-05:00,46.64,46.92,46.64,46.89,15004875,12176962.25,68.68898609948033,55.90821793105652,NaN,NaN,152.37834149814753,139.00771039883276,0.16944479906409232,0.3847927715035695,0.21534797243947718,616987934,599341569.6,60.57935330588676,39.64311462197275,NaN,NaN,19.84913162294426,8.999016448639544
2014-11-04T09:30:00-05:00,46.81,47.21,46.79,47.14,10508271,12136444.6,70.87199076583948,58.102272718178405,NaN,NaN,158.02713438441103,143.23717185055267,0.18265579924880393,0.44366772150048206,0.26101192225167813,627496205,605808883,64.51653927214835,41.81490311057405,NaN,NaN,23.12149752416026,11.016513745142504
2014-11-05T09:30:00-05:00,47.41,47.665,47.24,47.47,7780420,12035449,73.49854221255939,60.71943626066285,NaN,NaN,168.14434582005487,153.6150201751404,0.20004131259140462,0.5110635629909339,0.3110222503995293,635276625,615108510.8,69.26944244858011,44.8826418629263,NaN,NaN,26.782160347076356,13.268748973990197
2014-11-06T09:30:00-05:00,47.52,47.67,47.35,47.57,5637974,11563475.45,74.25610749731317,62.82062822219365,NaN,NaN,147.4322652670396,157.54518416467076,0.20399795527633463,0.5660196944949476,0.36202173921861297,640914599,624531684.4,73.18841163151086,48.596110063204506,NaN,NaN,30.02337820037174,15.662267434901846
2014-11-07T09:30:00-05:00,47.5,47.74,47.32,47.74,5911985,11288904.75,75.53638619022696,64.46591870419047,NaN,NaN,131.3563805763107,151.46769350919274,0.2033325121085276,0.6161873793542725,0.4128548672457449,646826584,633500389.4,76.28789145493067,52.647921903711236,NaN,NaN,33.144186508422365,18.15968444540478
2014-11-10T09:30:00-05:00,47.66,47.96,47.55,47.95,4209548,10487137,77.05442969398479,66.07536483711384,NaN,NaN,130.38535504759187,147.06909621908162,0.20189418933103692,0.665222603909541,0.4633284145785041,651036132,640310029,78.3357028090577,56.81184066577415,NaN,NaN,36.268768997515494,20.746696524277738
2014-11-11T09:30:00-05:00,47.93,48,47.76,47.86,3277790,10008328,74.90904218569545,67.45511353026443,NaN,NaN,118.76170484336265,139.21601031087192,0.18044138300229062,0.6888801433313674,0.5084387603290768,647758342,644362456.4,79.47187673423562,60.43088554179208,NaN,NaN,38.284422645418644,23.252085970155008
2014-11-12T09:30:00-05:00,47.66,47.93,47.645,47.86,4923730,9142450.1,74.90904218569545,68.8648291162247,NaN,NaN,102.50923952724494,126.08898905230994,0.15290080501761827,0.6995647666010996,0.5466639615834813,647758342,646858799.8,80.16206941149153,63.46697370771915,NaN,NaN,39.94685997479634,25.63705368510377
2014-11-13T09:30:00-05:00,47.9,48.26,47.86,48.03,7507089,8538134.2,76.3514511476446,70.07872056226564,NaN,NaN,108.6977326333002,118.34208252556206,0.13348876329106552,0.7135249156973131,0.5800361524062476,655265431,649728966.2,80.95491996662562,66.07146209197678,NaN,NaN,41.789088944610356,27.94448729360471
2014-11-14T09:30:00-05:00,48.05,48.07,47.64,47.76,7544498,8288639.3,69.51616782217766,70.72229652378593,NaN,NaN,85.22089113032207,109.11498463636433,0.0918051219460635,0.694792554838827,0.6029874328927635,647720933,649907836,81.00586819002784,68.38610767138076,NaN,NaN,41.545190969302446,29.887444961561528
2014-11-17T09:30:00-05:00,47.68,48.08,47.68,48.08,4049631,7629655.15,72.64218610462652,71.45527390927091,NaN,NaN,86.7835290514115,100.39461943712826,0.07579037800029242,0.697725405393129,0.6219350273928366,651770564,650054722.4,81.05069818646965,70.51488604582434,NaN,NaN,42.217197187415614,31.64883813668354
2014-11-18T09:30:00-05:00,48.08,48.34,48,48.26,5015424,7187245.45,74.24224916669633,72.40151065849336,NaN,NaN,98.59216330748146,96.36071112995202,0.06759670645917626,0.706430910466807,0.6388342040076307,656785988,651860251.6,81.62480003306541,72.67622897073616,NaN,NaN,43.24987247737507,33.30612875678233
2014-11-19T09:30:00-05:00,48.24,48.5068,48.18,48.46,4919496,6911872.75,75.92697251326155,73.24577899165776,NaN,NaN,104.66325377753662,96.79151398001035,0.06585694409245568,0.7211553841232003,0.6552984400307447,661705484,654649680,82.50659084630101,74.6966743311859,NaN,NaN,44.624287786380954,34.92300861815356
2014-11-20T09:30:00-05:00,48.31,48.39,48.18,48.25,4075960,6485432.65,70.69816358677895,73.50726551228432,NaN,NaN,89.52353070159671,92.95667359366965,0.041938224719009876,0.707721220929507,0.6657829962104971,657629524,655122498.6,82.65850007966905,76.54376174071432,NaN,NaN,44.27584677427501,36.25912835474234
2014-11-21T09:30:00-05:00,48.65,48.74,48.36,48.45,5042250,6277265.8,72.63127397647881,73.7888575034985,NaN,NaN,106.80781386650247,97.27405814090574,0.03144168003279779,0.7050850962514943,0.6736434162186965,662671774,658112666.8,83.62684028789981,78.19001081085811,NaN,NaN,44.53471207175962,37.44135460003052
2014-11-24T09:30:00-05:00,48.54,48.661,48.34,48.42,4912040,6277008.15,71.86539949009531,73.85981526951676,NaN,NaN,99.05068065007607,99.72748846063864,0.015158416000121133,0.6925914362188479,0.6774330202187268,657759734,659310500.8,84.01198293525444,79.58254250107997,NaN,NaN,44.53135000307575,38.45421108617984
2014-11-25T09:30:00-05:00,48.42,48.58,48.34,48.46,6157520,6303211.3,72.28503448907017,73.77313614641038,NaN,NaN,93.17443329858871,98.6439424588601,0.0005344313668118605,0.6781010594272416,0.6775666280604298,663917254,660736754,84.48010861920167,80.66901865612435,NaN,NaN,44.64031613852008,39.337940379371304
2014-11-26T09:30:00-05:00,48.46,48.69,48.45,48.68,3644780,6166392.7,74.53474364180566,73.79303872815986,NaN,NaN,108.56915476930513,99.42512265721379,-0.0007969742350985021,0.6765704102665566,0.6773673845016551,667562034,661908064,84.87186243390931,81.50355085629567,NaN,NaN,45.35467926377583,40.19747450571481
2014-11-28T09:30:00-05:00,48.83,49.42,48.8,49.3,4640929,6147426.9,79.56825622321594,74.08102944480193,NaN,NaN,172.93496956943434,116.10741043078133,0.03180182765408024,0.7171196690692554,0.6853178414151752,672202963,664822751.8,85.83035428263616,82.18515534398894,NaN,NaN,47.6531642137642,41.26257303543615
2014-12-01T09:30:00-05:00,49.08,49.19,48.9,48.975,8330430,6154732,71.58100652463924,73.69007064699153,NaN,NaN,138.19110633565208,122.38406892461123,0.02357836809355418,0.7147908015321178,0.6912124334385636,663872533,665062903.6,85.90956897202192,82.72614578420065,NaN,NaN,47.02157309862154,42.08528733017692
2014-12-02T09:30:00-05:00,48.96,49.19,48.93,49.15,6130948,5711035.65,73.144275351661,73.56401587313191,NaN,NaN,134.53999595854773,129.48193198630557,0.02205448529229681,0.7187805400539347,0.6967260547616378,670003481,667511653,86.72453526215453,83.24419282190914,NaN,NaN,46.99476031156978,42.78664061323304
2014-12-03T09:30:00-05:00,49.16,49.16,48.69,48.8,5909648,5481104.5,65.39622660339116,72.88452904582446,NaN,NaN,96.35780221117034,130.11860576882188,-0.008744888271494444,0.6857949444222697,0.6945398326937642,664093833,667546968.8,86.73645000120256,83.71379143545994,NaN,NaN,44.42403905201414,43.02055467591605
2014-12-04T09:30:00-05:00,48.81,48.87,48.54,48.76,8023886,5493277.8,64.55460693876618,72.04189731661886,NaN,NaN,65.1179396853355,121.42836275202797,-0.03647561107622488,0.648945318848483,0.6854209299247079,656069947,665248551.4,81.60326548994293,83.76010182998259,NaN,NaN,42.126232582729656,42.89279437688943
2014-12-05T09:30:00-05:00,48.73,48.86,48.55,48.85,6732101,5547984.15,65.62650641834733,71.76406435920241,NaN,NaN,63.69680676089562,99.58073019032022,-0.052449841130343566,0.6198586285117784,0.672308469642122,662802048,663368368.4,77.55958694495371,83.51393888390588,NaN,NaN,40.555703202360206,42.55892420909954
2014-12-08T09:30:00-05:00,48.8,49.01,48.62,48.75,4653631,5485066.45,63.334698860776285,71.09924384178454,NaN,NaN,64.37131868371311,84.81677265993244,-0.07222374608180382,0.5820287870398673,0.6542525331216711,658148417,662223545.2,75.11874099913544,83.09022765623914,NaN,NaN,38.581132663995824,41.99066827408472
2014-12-09T09:30:00-05:00,48.38,48.61,48.11,48.59,6120032,5580590.65,59.73995134448081,70.063365425912,NaN,NaN,-5.500749148396753,56.80862363854353,-0.09700708017697957,0.5329936829004467,0.6300007630774263,652028385,658628526,67.89307568814309,82.10939020303042,NaN,NaN,35.84931833738079,41.1133325688413
2014-12-10T09:30:00-05:00,48.59,48.73,48.08,48.13,5304833,5681942.8,50.810886324964066,68.26935926960503,NaN,NaN,-36.307741086396724,30.275514979030152,-0.14255524447193602,0.4518067074875063,0.5943619519594423,646723552,655154469.8,61.71516346412896,80.62428824716098,NaN,NaN,30.485547851137124,39.59507760916927
2014-12-11T09:30:00-05:00,48.3,48.81,48.14,48.53,5233674,5697440,56.850433779754326,67.28023571196042,NaN,NaN,-6.339518492960529,15.98402334337094,-0.14352258889608738,0.4149587158393331,0.5584813047354205,651957226,654331925.6,60.31572473561071,79.02837572258538,NaN,NaN,27.70284549231566,37.89618730676161
2014-12-12T09:30:00-05:00,48.24,48.71,47.9,47.91,6812470,5662709.05,47.1806696062,65.46233539979765,NaN,NaN,-83.28661103965429,-13.412660216739047,-0.1812637293883348,0.3319016430000019,0.5131653723883367,645144756,650800467.2,54.592097764637096,76.95446554235232,NaN,NaN,21.71672575912196,35.58483565709881
2014-12-15T09:30:00-05:00,48.11,48.25,47.4427,47.59,9451298,5758049.05,43.105396518827824,63.408049473278545,NaN,NaN,-178.1380378603907,-61.91453152555981,-0.22051708402990522,0.23751901735095515,0.45803610138086037,635693458,646309475.4,48.313251004341396,74.40455611871569,NaN,NaN,15.383359366066843,32.698910472665666
2014-12-16T09:30:00-05:00,47.38,48.37,47.38,47.41,9811489,6046141.95,40.96210102581975,61.17069708304637,NaN,NaN,-179.0887081510022,-96.63212332608092,-0.24922346351541858,0.14650677198658713,0.3957302355020057,625881969,641080192.2,42.223630155441526,71.38623622844709,NaN,NaN,9.623378719478433,29.402405936496063
2014-12-17T09:30:00-05:00,47.55,48.26,47.5,48.1,10126416,6301691.55,51.01660322512063,59.49082991042601,NaN,NaN,-119.08670726915284,-113.18791656263213,-0.2137249692468557,0.1285740239434361,0.3422989931902918,636008385,638937158.8,39.998578928985005,68.18100169238107,NaN,NaN,8.117476489358554,26.36170172976213
2014-12-18T09:30:00-05:00,48.79,49.05,48.31,49.02,8726337,6492033.6,60.64142089965323,58.13891310160011,NaN,NaN,57.665531598890006,-100.38690654426202,-0.12467980857729338,0.18644923246867506,0.31112904104596845,644734722,637492658,38.52491104112507,64.80204146084458,NaN,NaN,10.6363520885215,24.115223209584897
2014-12-19T09:30:00-05:00,48.84,49.02,48.59,48.62,13154449,6945958.05,55.532300625673834,56.99257696595972,NaN,NaN,42.28759869718962,-75.27206459689323,-0.0906956749767821,0.19775944732499084,0.28845512230177295,631580273,634779761.4,35.85323644322018,61.226589137358744,NaN,NaN,10.632548188722103,22.18912677803307
2014-12-22T09:30:00-05:00,48.75,49.09,48.74,49.09,5125693,6950130.2,59.81629850124908,56.04057861950173,NaN,NaN,81.64070995503243,-23.31631503380861,-0.037276149562771255,0.24185993534830885,0.2791360849110801,636705966,634982263,36.208853208645614,57.618326133536684,NaN,NaN,12.263605835604118,20.771195214828936
2014-12-23T09:30:00-05:00,49.3,49.54,49.17,49.43,5563467,6982701.55,62.62166904960901,55.84239593708872,NaN,NaN,142.44106625080758,40.98963984655335,0.017313426708807422,0.3007778682970894,0.283464441588282,642269433,638259755.8,41.8297590626952,54.41070535221473,NaN,NaN,14.574137191146066,19.88590121144567
2014-12-24T09:30:00-05:00,49.58,49.63,49.35,49.38,1478017,6748726.4,61.936866615165584,55.655414485402964,NaN,NaN,137.45797284207657,92.29857586879923,0.04484634270658949,0.33952236997151886,0.29467602726492936,640791416,639216362,43.397441497289314,51.681717924168034,NaN,NaN,16.094329957771436,19.344248175206495
2014-12-26T09:30:00-05:00,49.43,49.61,49.41,49.46,3302398,6731607.3,62.64081802206434,55.44215102852561,NaN,NaN,128.18741053004757,106.40295165503076,0.0621714296765713,0.3723903143606435,0.3102188846840722,644093814,639088180.4,43.22932402388782,49.22955628694905,NaN,NaN,17.512958011466903,19.08263529467227
2014-12-29T09:30:00-05:00,49.4,49.45,49.11,49.31,13478733,7173497.5,60.38575541611598,55.23151221104988,NaN,NaN,93.19011443992193,116.58345480357721,0.05737047354083724,0.3819319766101188,0.32456150306928155,630615081,638895142,42.95941970206297,46.93246190858673,NaN,NaN,17.98318832554174,18.925571441939336
2014-12-30T09:30:00-05:00,49.24,49.35,49.07,49.09,5094893,7011720.65,57.13687467758886,55.04557816341474,NaN,NaN,71.74138350476089,114.60358951352289,0.03435502091168263,0.36750527920888487,0.33315025829720224,625520188,636657986.4,39.853866182934695,44.92966122964327,NaN,NaN,17.403241397785102,18.708095721345874
2014-12-31T09:30:00-05:00,49.27,49.27,48.47,48.49,5218665,6966106.5,49.34013781965806,54.940524698750025,NaN,NaN,6.744714879092979,87.46431923917997,-0.023199431480742383,0.30415096894627425,0.32735040042701663,620301523,632264404.4,34.568570795759385,42.9906188961883,NaN,NaN,14.381321743985772,18.089985153151574
2015-01-02T09:30:00-05:00,48.62,48.73,48.05,48.35,7612139,7051231.05,47.70439050593004,54.287235893476854,NaN,NaN,-47.795348758222715,50.413654919120134,-0.06997615874129343,0.23988020200039983,0.30985636074169326,612689384,626643998,29.22858331527351,40.77010879473564,NaN,NaN,11.429553396079733,17.13849490214131
2015-01-05T09:30:00-05:00,48.26,48.37,47.88,48.01,8272747,7063674.1,43.89813859863027,54.05276939293616,NaN,NaN,-82.88532477728765,8.199107857653093,-0.12014954629359165,0.15966942787470373,0.2798189741682954,604416637,618708562.6,23.66916373187688,38.56132779239563,NaN,NaN,7.724542759404435,15.793644596036042
2015-01-06T09:30:00-05:00,48.35,48.47,47.81,47.95,11112405,7282689.3,43.24243683385363,54.06255798686657,NaN,NaN,-75.48124953666412,-25.53516493766412,-0.1516789318407194,0.09022030936739611,0.2418992412081155,593304232,611246392.8,19.846362951318085,36.52797864575111,NaN,NaN,4.541152374977125,14.18614570731334
2015-01-07T09:30:00-05:00,48.3,48.83,48.25,48.77,9226050,7511310.25,53.47132089513505,54.956073691817664,NaN,NaN,2.056074990497651,-39.472226640516766,-0.11336454450842459,0.10019356057258477,0.21355810508100936,602530282,606648411.6,17.925258705141403,34.79238068501538,NaN,NaN,4.8634355359046575,12.854329968540672
2015-01-08T09:30:00-05:00,49.2,49.57,49.1,49.51,12904121,7850514.7,60.40613690030998,55.626754668616904,NaN,NaN,100.46495174168274,-20.72817926799882,-0.0381289693067087,0.16589689344762348,0.20402586275433218,615434403,605674987.6,17.538201985364296,33.188068046185336,NaN,NaN,7.585992271366517,12.101710297515792
2015-01-09T09:30:00-05:00,49.67,49.67,49.11,49.11,6382812,7904413.65,55.58361751058759,55.26548299796936,NaN,NaN,79.05598628945953,4.642087741537628,-0.01636111512207533,0.183574468851738,0.19993558397381334,609051591,604947429,17.238588406552623,31.667616429430154,NaN,NaN,8.157807998407844,11.538295683357514
2015-01-12T09:30:00-05:00,49.09,49.35,48.83,48.96,6256356,7955547.75,53.84751820736608,55.145141396661664,NaN,NaN,42.17651796361427,29.654456289718013,-0.013255193269795074,0.1833665923865695,0.19662178565636457,602795235,604623148.6,17.098381684128398,30.32798394663788,NaN,NaN,8.043419845966016,11.0390277065873
2015-01-13T09:30:00-05:00,49.29,49.56,48.66,48.95,10134954,8121671.95,53.727038450943034,54.71019425021124,NaN,NaN,39.130185952517884,52.576743387554416,-0.01304434241633548,0.18031635763594522,0.1933607000522807,592660281,604494358.4,17.039108153455885,28.95871644269576,NaN,NaN,7.9171341427288935,10.593042911750384
2015-01-14T09:30:00-05:00,48.58,48.85,48.46,48.8,13315488,8314881.45,51.85291786346224,53.94099773691504,NaN,NaN,-17.543859649119852,48.65675645963091,-0.023563861367750433,0.16390587334259266,0.1874697347103431,579344793,599857260.6,15.020146462561044,27.04374411411475,NaN,NaN,7.261921106512327,10.117168368144947
2015-01-15T09:30:00-05:00,49.12,49.18,48.69,48.88,10898429,8369228.45,52.79859516555859,53.2882640619431,NaN,NaN,6.73636323870454,29.91103875903527,-0.025525748180333152,0.15556254948492665,0.1810882976652598,590243222,594819024.4,13.191268484990772,24.886160327521996,NaN,NaN,6.990361020258281,9.670481604161138
2015-01-16T09:30:00-05:00,48.76,49.32,48.67,49.27,12948494,8510332.35,57.210899437454216,52.900412734470954,NaN,NaN,30.154080399850976,20.130657581113564,-0.0021793774816994405,0.17836407581313551,0.18054345329483495,603191716,593647049.4,12.80081204461122,22.7126951861451,NaN,NaN,8.041134274278717,9.43771769989222
2015-01-20T09:30:00-05:00,49.46,49.69,49.0601,49.47,9978168,8572923.9,59.31144850331979,52.82367652641408,NaN,NaN,84.99260903123822,28.693875794638352,0.023685474509241328,0.2101502964313866,0.18646482192214528,613169884,595721979.2,17.459086227127216,20.89124279507826,NaN,NaN,9.539786106382566,9.452298900819413
2015-01-21T09:30:00-05:00,49.37,49.72,49.12,49.71,7588640,8294633.45,61.73875542917797,53.15238229438473,NaN,NaN,96.5153301368629,40.170904631507355,0.05227170606732312,0.2518044545062992,0.19953274843897606,620758524,601341627.8,28.586258875215776,20.086413701669766,NaN,NaN,11.528981791738294,9.748967885236397
2015-01-22T09:30:00-05:00,49.92,50.22,49.48,50.21,12061998,8641448.7,66.2552558169248,54.360605008475204,NaN,NaN,157.9846798274815,75.27661252682762,0.09753856292240365,0.32145595209198063,0.22391738916957699,632820522,612036773.6,44.04618710499541,20.76338629518663,NaN,NaN,14.710195115968336,10.457714632483816
2015-01-23T09:30:00-05:00,49.97,50.05,49.64,49.65,6423708,8684460.75,57.99761813859405,55.09583555366549,NaN,NaN,116.42409528218955,97.21415893552464,0.0830185153583114,0.32769053336746623,0.24467201800915483,626396814,619267492,51.664689730097976,22.36596532481695,NaN,NaN,14.926324729806215,11.096087503529873
2015-01-26T09:30:00-05:00,49.63,49.72,49.3768,49.65,4428644,8831992.1,57.99761813859405,56.10294123509148,NaN,NaN,81.58251507906017,107.49984587136646,0.06733503500411742,0.3288408117643016,0.26150577676018416,626396814,623908511.6,55.822439106258805,24.662627851558515,NaN,NaN,15.09690588697997,11.667632986879887
2015-01-27T09:30:00-05:00,49.15,49.3,48.8499,49.08,10344834,9184113.9,50.559031440349564,56.62555513555547,NaN,NaN,2.899597599909231,91.08124358510068,0.015214952931089432,0.28052446792404595,0.2653095149929565,616051980,624484930.8,56.324940214215296,27.26824051319403,NaN,NaN,12.89705951792038,11.8432653484571
2015-01-28T09:30:00-05:00,49.26,49.41,48.47,48.51,7765711,8898462.8,44.42318295127794,55.9792595681371,NaN,NaN,-40.08505541387174,63.76116647495373,-0.0570453423337991,0.19400283707570765,0.25104817940950674,608286269,621990479.8,53.48947175483693,29.80854144531514,NaN,NaN,8.929423720661642,11.427002258772035
2015-01-29T09:30:00-05:00,48.7,48.96,48.2872,48.9,9765613,9131998.8,48.985099729384444,55.16347119878528,NaN,NaN,-48.47503903344106,22.46922270276923,-0.07674615382509131,0.1551154871281426,0.23186164095323392,618051882,619036751.8,50.262826681827555,32.146014637919656,NaN,NaN,7.103483438655276,10.809356713041069
2015-01-30T09:30:00-05:00,48.64,48.67,47.95,48.02,10951567,9418643.9,40.839284404966634,54.11030454838379,NaN,NaN,-117.85529006072642,-24.38665436581396,-0.1433444630807969,0.052681062102237775,0.19602552518303468,607100315,615177452,46.33030816266267,34.22399462049894,NaN,NaN,2.5477236024122547,9.629123411522666
2015-02-02T09:30:00-05:00,48.11,48.62,47.68,48.59,14354132,9755743.55,46.98847213042723,53.620372685745295,NaN,NaN,-103.48751724624152,-61.4006608308743,-0.14298369839747466,0.01729590218619137,0.16027960058366603,621454447,614188978.6,45.35159024071054,36.2420809459691,NaN,NaN,0.9660222568309756,8.391537532280996
2015-02-03T09:30:00-05:00,48.89,49.04,48.605,49.02,6279580,9656085.2,51.1163447665603,53.43389456543225,NaN,NaN,-22.40245254968052,-66.46107086079226,-0.10928177942602885,0.023677376301129982,0.13295915572715883,627734027,616525388,48.140224910612865,38.46358928576603,NaN,NaN,1.1373498534273638,7.3552250067304765
2015-02-04T09:30:00-05:00,48.93,49.3899,48.93,49.04,7901316,9495530.75,51.306266761338044,53.39484805813766,NaN,NaN,8.786452984308529,-56.686769181156194,-0.08236514803904957,0.03000272067834686,0.11236786871739643,635635343,621995202.8,54.05165222259767,41.2515539829115,NaN,NaN,1.330173829032686,6.494503409916507
2015-02-05T09:30:00-05:00,49.19,49.31,49.07,49.29,8079470,9438201.75,53.726401581999085,53.46111994502627,NaN,NaN,23.684545246350854,-42.25485232519782,-0.046246628240877524,0.05455958341629952,0.10080621165717704,643714813,627127789,58.797694044357904,44.50915580858058,NaN,NaN,2.2523024033798063,5.888474694696979
2015-02-06T09:30:00-05:00,49.3,49.49,48.88,49.07,6304139,9108202.65,51.30964530062285,53.03960179239546,NaN,NaN,11.34155908328148,-16.415482496396237,-0.0361428321214287,0.05562767150539116,0.09177050362681986,637410674,633189860.8,63.58227571578343,48.13640321366431,NaN,NaN,2.2743362005836243,5.3721691955379285
2015-02-09T09:30:00-05:00,48.99,49.03,48.57,48.7,5656096,9071866.85,47.44426234403523,52.19194563816085,NaN,NaN,-61.21846910292009,-7.961672867731949,-0.0523644912504673,0.026314889563735733,0.07867938081420303,631754578,635249887,65.06683234642892,51.53695650790014,NaN,NaN,1.108005537601466,4.763002958689863
2015-02-10T09:30:00-05:00,49.16,49.32,48.86,49.27,5055068,9011802.45,53.283087407043695,51.58796935086554,NaN,NaN,16.119696985857637,-0.2572429606243226,-0.02412811628746178,0.0485192354548758,0.07264735174233758,636809646,637065010.8,66.36777385532423,54.235636149336464,NaN,NaN,1.9429230899925396,4.360134406018816
2015-02-11T09:30:00-05:00,49.3,49.61,49.14,49.5,4617951,8735952.3,55.43458538626968,50.81506432010446,NaN,NaN,63.83325143803397,10.752116730120768,0.008850482874858859,0.08371045533591115,0.07485997246105229,641427597,638223461.6,67.20714692595871,55.889990422262414,NaN,NaN,3.296780334147917,4.208226681465831
2015-02-12T09:30:00-05:00,49.62,49.73,49.47,49.73,7150649,8427710.35,57.540433518681745,50.782408275825006,NaN,NaN,97.28142410262929,25.471492501376453,0.04305245158978141,0.12867553694827905,0.08562308535849764,648578246,639196148.2,67.93086054585703,57.05185976624521,NaN,NaN,5.059819006153741,4.329882727849818
2015-02-13T09:30:00-05:00,49.62,49.65,49.39,49.5,5931999,8179388.85,54.75411632876961,50.55072957512326,NaN,NaN,65.0865532249431,36.22049132970877,0.04677403032164411,0.14409062326055277,0.09731659293890867,642646247,640243262.8,68.7308954819552,57.97389236450923,NaN,NaN,5.710954326021727,4.527178670445805
2015-02-17T09:30:00-05:00,49.43,49.56,49.19,49.51,4887541,7776341.2,54.856471496282815,50.85768957911849,NaN,NaN,43.43350878874851,57.150886908042494,0.04640563164838424,0.15532363249938896,0.10891800085100473,647533788,643399104.8,71.07312218198373,59.027333933635546,NaN,NaN,6.26708360886778,4.775736518791801
2015-02-18T09:30:00-05:00,49.5,49.78,49.39,49.78,5251178,7539991.7,57.642643924579815,51.801936791497205,NaN,NaN,80.52850772556691,70.03264905598436,0.05997985121200666,0.18389281486601305,0.12391296365400639,652784966,646594168.8,73.25720578876381,60.4393149360589,NaN,NaN,7.535853660492034,5.17003896760612
2015-02-19T09:30:00-05:00,49.69,49.7,49.4,49.46,4380204,7379569.9,53.43347095715686,52.11967759348095,NaN,NaN,57.50017664099571,68.7660340965767,0.04379232288722559,0.17865336726303838,0.13486104437581278,648404762,647989601.8,74.17434070122877,62.14728022315899,NaN,NaN,7.444995576335043,5.495032768853108
2015-02-20T09:30:00-05:00,49.29,49.62,49.1,49.6,5897954,7071367.7,54.982284277451676,53.12989187008702,NaN,NaN,51.67847711685662,59.64544469942217,0.03905559834426911,0.18368054230614916,0.14462494396188005,654302716,649134495.8,74.93388726910652,64.1903930164764,NaN,NaN,7.800733999571763,5.824418658955773
2015-02-23T09:30:00-05:00,49.52,49.75,49.52,49.74,4710570,6985710.8,56.53900101621396,53.81207250478608,NaN,NaN,97.95414189763123,66.2189624339598,0.04165530709166171,0.1966940778264572,0.1550387707347955,659013286,652407903.6,77.0153137916881,66.45208755583194,NaN,NaN,8.529231696966598,6.210820521528748
2015-02-24T09:30:00-05:00,49.79,49.95,49.6,49.91,4275835,6978070.35,58.419285895343684,54.33371115684203,NaN,NaN,120.46521752651121,81.62530418151235,0.050536658110430344,0.2182095933728334,0.16767293526240307,663289121,655558970.2,78.8370768972555,68.64471984059213,NaN,NaN,9.667034037709685,6.704565309554597
2015-02-25T09:30:00-05:00,49.9,49.95,49.68,49.74,3282613,6624959.3,55.818601890614,54.65602080893317,NaN,NaN,101.84790468217071,85.8891835728331,0.041076456748776774,0.21901850619837404,0.17794204944959727,660006508,657003278.6,79.63387583894664,70.4720215274742,NaN,NaN,9.948637382758973,7.168004177155222
2015-02-26T09:30:00-05:00,49.74,49.86,49.61,49.81,4124210,6442884.25,56.67389465112932,54.86655602815676,NaN,NaN,87.96268906468059,91.98168605757007,0.03583866284000184,0.22274037799959956,0.18690171515959772,664130718,660148469.8,81.2862406345792,72.07834628391858,NaN,NaN,10.41142346172347,7.6313497892364
2015-02-27T09:30:00-05:00,49.8,50.11,49.77,50.01,4578917,6183549.45,59.109539602236524,55.42369133541488,NaN,NaN,113.97255917898636,104.44050246999602,0.041736578667071644,0.2390724384934373,0.19733585982636564,668709635,663029853.6,82.67317313102936,73.441981813579,NaN,NaN,11.464284223267269,8.17891185124081
2015-03-02T09:30:00-05:00,50.05,50.14,49.94,50.1,5511247,5911533.45,60.19399117102597,56.33438625162851,NaN,NaN,130.77291901076393,111.00425789262256,0.04718989400335674,0.25632322733056156,0.20913333332720482,674220882,666071372.8,84.01952364294222,74.79574547761567,NaN,NaN,12.648739006557358,8.817458587714603
2015-03-03T09:30:00-05:00,50.1,50.11,49.69,49.91,5818232,5484738.45,56.77096505426768,56.58352036928736,NaN,NaN,95.33750910313447,105.97871620794722,0.03410216938134786,0.25176104505388963,0.21765887567254177,668402650,667094078.6,84.45686697334448,76.08782355747427,NaN,NaN,12.797062164051079,9.385973384334099
2015-03-04T09:30:00-05:00,49.81,49.83,49.435,49.56,3635830,5352550.95,51.015762879062784,56.26789019020116,NaN,NaN,20.46832437189001,89.70280014589108,-0.00020919168876579186,0.21739738606158454,0.21760657775035033,664766820,668046141,84.87193152727835,77.34959388613994,NaN,NaN,11.336656606843645,9.664642416121177
2015-03-05T09:30:00-05:00,49.69,49.81,49.57,49.73,5336282,5224299.25,53.482464212265036,55.978035239742816,NaN,NaN,39.772662298306535,80.06479479261625,-0.012838796694903232,0.2015580818817213,0.21439687857662454,670103102,669240617.8,85.39875364501604,78.59730053607987,NaN,NaN,10.752197884224392,9.820007482993065
2015-03-06T09:30:00-05:00,49.37,49.47,48.645,48.76,12065490,5423600.25,40.843962650643824,54.984452834162404,NaN,NaN,-151.94079444192514,26.88212406843395,-0.08393950681914569,0.10947249505269241,0.1934120018718381,658037612,667106213.2,80.03528522509033,79.40475694630382,NaN,NaN,5.950092120454379,9.267162431201823
2015-03-09T09:30:00-04:00,48.95,49.115,48.8,49.03,6436504,5430218.5,44.757203225791905,54.26307652912733,NaN,NaN,-138.86891549691904,-27.046242833102646,-0.10863633789564059,0.05761657950228738,0.16625291739792797,664474116,665156860,75.3789650412994,79.71231715054066,NaN,NaN,3.2520406816103775,8.40785932411733
2015-03-10T09:30:00-04:00,48.74,48.77,48.32,48.33,7996246,5547226,37.779498041899785,52.84428039465019,NaN,NaN,-247.3641285656686,-95.58657036686324,-0.16460899759713468,-0.03950832959849038,0.1251006679986443,656477870,662771904,70.01223442150838,79.48053348145098,NaN,NaN,-1.6280749048787384,6.9741544342607495
2015-03-11T09:30:00-04:00,48.4,48.4,47.91,47.96,8699521,5729448.65,34.700080853413056,51.506181101525634,NaN,NaN,-262.3582281189736,-152.151880865036,-0.21581555519296078,-0.14466877599255668,0.0711467792004041,647778349,659374209.8,63.117779457908036,78.69077910692806,NaN,NaN,-6.699625337221354,5.02075732404902
2015-03-12T09:30:00-04:00,48.18,48.66,48.13,48.66,9905450,5993823.6,44.000040395751384,50.72173510997561,NaN,NaN,-151.65704597747313,-190.4378225201919,-0.1925736923695238,-0.16957033626150064,0.02300335610802315,657683799,656890349.2,58.57651160168375,77.52239513068358,NaN,NaN,-7.741017248945173,3.1976466707641356
2015-03-13T09:30:00-04:00,48.56,48.58,47.985,48.28,5821361,5927359.2,40.61815527357206,49.58453184264405,NaN,NaN,-147.20545188437325,-189.49075400868153,-0.19237154131194173,-0.217461070531904,-0.025089529219962284,651862438,655655314.4,56.403470727134135,76.05012062607258,NaN,NaN,-9.774221694892155,1.3445226185275225
2015-03-16T09:30:00-04:00,48.43,48.88,48.43,48.87,22130524,6737285.45,47.38061431718357,48.7960553013469,NaN,NaN,-75.28704384814364,-176.77437967892644,-0.14427924476975076,-0.20543858518215075,-0.06115934041239998,673992962,657559083.6,58.93254709358058,74.62836849723865,NaN,NaN,-9.038245170727883,-0.1387299227946781
2015-03-17T09:30:00-04:00,48.7,48.74,48.38,48.52,7487530,6867284.9,44.167304683556914,47.9638197865571,NaN,NaN,-85.82479821600904,-144.46651360899455,-0.12835117288266995,-0.22159830651573742,-0.09324713363306747,666505432,659564596,61.468393152886485,73.33083401966293,NaN,NaN,-9.567134203575998,-1.4856448200491523
2015-03-18T09:30:00-04:00,48.4,49.05,47.84,48.85,19747285,7592090.25,47.764377599554145,47.3274257114446,NaN,NaN,-72.82689344215238,-106.56024667363029,-0.0897294400512604,-0.20540893369714297,-0.11567949364588256,686252717,667259469.6,69.30105519184369,72.47474934518179,NaN,NaN,-8.765837082241823,-2.5256722860766767
2015-03-19T09:30:00-04:00,48.74,48.85,48.54,48.63,20386665,8392413.3,45.65273287207483,46.36622523071876,NaN,NaN,-56.17370235765387,-87.46357794966644,-0.07380357879906321,-0.20793396714471157,-0.13413038834564836,665866052,668895920.2,70.66670458657171,71.61714444914911,NaN,NaN,-8.810606149488184,-3.4235199808497487
2015-03-20T09:30:00-04:00,48.57,48.95,48.5,48.94,7950997,8495065.45,49.06952201070359,45.571620290695726,NaN,NaN,-38.621790410436645,-65.74684565487912,-0.038946335015320355,-0.18281330711479882,-0.14386697209947846,673817049,673286842.4,74.00785082901629,70.90202496244011,NaN,NaN,-7.747192270624873,-4.041187450817624
2015-03-23T09:30:00-04:00,48.89,49.265,48.85,49.02,4669271,8493000.5,49.944120139242045,45.08398851105104,NaN,NaN,-7.851263790785548,-52.2596896434075,-0.008639837843181508,-0.15466676940345536,-0.14602693156027385,678486320,674185514,74.6444093262242,70.20113513050295,NaN,NaN,-6.630349019255695,-4.411067674880205
2015-03-24T09:30:00-04:00,49.14,49.265,48.74,48.74,6939753,8626196.4,46.90792460099742,44.790571491189226,NaN,NaN,-19.05000626644718,-38.90473125349513,-0.0057290441817069715,-0.15318823678740756,-0.1474591926057006,671546567,675193741,75.37310758496454,69.52264770605196,NaN,NaN,-6.597634709294524,-4.7234343940822505
2015-03-25T09:30:00-04:00,49.29,49.36,48.62,48.62,18476729,9385902.2,45.62771239214857,44.229517789752336,NaN,NaN,-20.985763711641905,-28.536505307393032,-0.009918051489950952,-0.15985675696813928,-0.14993870547818833,653069838,668557165.2,62.616548531606135,67.8953473408084,NaN,NaN,-6.941676962260495,-5.040326189536286
2015-03-26T09:30:00-04:00,48.38,48.6799,48.3,48.41,7616033,9560493.35,43.395658085382614,44.41178174937654,NaN,NaN,-71.79030999958036,-31.65982683577833,-0.024058466312934096,-0.18001178836935594,-0.15595332205642184,645453805,664474715.8,56.30382908570731,66.20024333085247,NaN,NaN,-7.87303643449338,-5.444999081673013
2015-03-27T09:30:00-04:00,48.42,48.77,48.4,48.71,4950066,9579050.8,47.357517548372115,44.5975184867037,NaN,NaN,-43.085346184062075,-32.55253799050341,-0.011093124006143928,-0.16981972706410176,-0.15872660305795783,650403871,659792080.2,50.068668530911545,64.39236500868192,NaN,NaN,-7.533406649460947,-5.7433430199284325
2015-03-30T09:30:00-04:00,48.81,49.2399,48.62,49.2,25326777,10569827.3,53.12812054699161,45.693848665638825,NaN,NaN,35.14945134463384,-23.952394963419536,0.03033255667474527,-0.12081090721452625,-0.15114346388927152,675730648,659240945.8,49.3756035316422,62.91831994512004,NaN,NaN,-5.47652358427721,-5.7052259576925435
2015-03-31T09:30:00-04:00,49,49.2,48.74,48.74,7411772,10649504.3,47.827695179999104,46.63153540325211,NaN,NaN,24.339988590990504,-15.274395991932,0.026729108787067662,-0.11773207790543694,-0.1444611866925046,668318876,658595407.6,48.528274886254216,61.876212475716194,NaN,NaN,-5.317703786226893,-5.649865647483165
2015-04-01T09:30:00-04:00,48.72,48.81,48.3345,48.8,8033379,10869381.75,48.548736932884005,46.956442298761594,NaN,NaN,-23.82458456831981,-15.842160163267579,0.028215438304006468,-0.10919188881249653,-0.137407327116503,676352255,663251891,54.582806621476294,61.59094783427281,NaN,NaN,-4.976444097496627,-5.553662568913659
2015-04-02T09:30:00-04:00,48.82,49.22,48.75,49.13,4820959,10843615.6,52.44181436220538,47.800989376521116,NaN,NaN,100.12687032022949,18.54127590069439,0.04998048638293873,-0.07493171913782959,-0.12491220552076832,681173214,670395772.8,61.973127977562186,61.98878049501767,NaN,NaN,-3.5179313481114955,-5.262843823084779
2015-04-06T09:30:00-04:00,49.05,49.7299,48.92,49.52,5615295,10521105.85,56.61942232549835,48.46090423425789,NaN,NaN,184.15612578805414,63.98957029511763,0.08703002679771128,-0.016124672023629216,-0.1031546988213405,686788509,677672700.4,67.73285665979134,62.617374035461296,NaN,NaN,-0.9716840628106654,-4.649821000188477
2015-04-07T09:30:00-04:00,49.6,49.7,49.29,49.29,7660788,10582320.05,53.62758121037606,49.136638271887826,NaN,NaN,170.761330249112,91.11194607601325,0.09195208216637397,0.011785403886626966,-0.08016667827974701,679127721,678352115,68.21689443691278,63.09940984146318,NaN,NaN,0.2718680499062588,-3.9467225644606576
2015-04-08T09:30:00-04:00,49.3,49.5,49.145,49.37,5039151,10434465.3,54.527632975700875,49.6197279416126,NaN,NaN,129.90393726386165,112.22473581058748,0.0960531284334378,0.039899732262050236,-0.05615339617138756,684166872,681521714.2,70.4443708063707,63.18107524250082,NaN,NaN,1.5503157515472865,-3.1614313764595225
2015-04-09T09:30:00-04:00,49.37,49.6,49.19,49.51,4785391,10238758.8,56.13226580811071,50.368266008472304,NaN,NaN,138.25141219121727,144.6399351624949,0.10303473379904504,0.07264002107741874,-0.030394712721626298,688952263,684041715.8,72.1175005822974,63.2847035279098,NaN,NaN,3.0782852354211814,-2.2700432890479934
2015-04-10T09:30:00-04:00,49.64,49.77,49.47,49.6,4605050,9973738.8,57.178406497172176,50.94747204322006,NaN,NaN,156.40740425112347,155.8960419486737,0.10803011032109805,0.10464292517974627,-0.003387185141351782,693557313,686518535.6,73.69375582330338,63.26226817035887,NaN,NaN,4.6472576686170175,-1.2818574379529917
2015-04-13T09:30:00-04:00,49.47,49.656,49.36,49.37,3712769,9868309.2,53.6568088055522,51.21266409081365,NaN,NaN,108.68730865696324,140.80227852245554,0.09085081629658212,0.11017633522937587,0.01932551893279375,689844544,687129742.6,74.0831201411056,63.22217608570754,NaN,NaN,5.052342441054156,-0.3769717409519706
2015-04-14T09:30:00-04:00,49.28,49.563,49.17,49.48,5722176,9047891.8,55.08169629189191,51.796504925877535,NaN,NaN,85.66168906407526,123.78235028544819,0.08216437365887412,0.1220309860063864,0.03986661234751228,695566720,690417542.4,76.12982245367552,63.27622714775833,NaN,NaN,5.780220157282788,0.5026271016529948
2015-04-15T09:30:00-04:00,49.55,49.75,49.31,49.34,6764313,9011730.95,52.85431228671757,52.312690632632474,NaN,NaN,88.68127522352,115.53781787737985,0.06311475823115197,0.11876006013645224,0.05564530190530027,688802407,691344649.4,76.6888646249554,64.28139258299755,NaN,NaN,5.81190308625965,1.2610950994539456
2015-04-16T09:30:00-04:00,49.4,49.705,49.36,49.52,5796421,8314187.75,55.35407490593102,53.16686326267165,NaN,NaN,90.38395185329902,105.9643258097962,0.05884612030622573,0.12920295228808243,0.0703568319818567,694598828,692473962.4,77.38369644066537,65.78709739406598,NaN,NaN,6.5084193713169745,2.0107128525772353
2015-04-17T09:30:00-04:00,49.29,49.32,48.79,49.06,5539765,7571842.75,48.305187458593515,53.2345539705446,NaN,NaN,-14.525117096410055,71.7778215402895,0.023088254723721058,0.09921715038650802,0.07612889566278697,689059063,691574312.4,75.45420152935071,67.60034975109735,NaN,NaN,5.119574637784679,2.4548359647497273
2015-04-20T09:30:00-04:00,49.14,49.52,49.14,49.23,3976240,7373104.9,50.79876433530692,53.068171383995704,NaN,NaN,34.597631024599714,56.95988601381678,0.009620543096403589,0.08815457453329145,0.07853403143688786,693035303,692212464.2,75.9129896490351,69.49587733091114,NaN,NaN,4.646461759424033,2.7679253639889136
2015-04-21T09:30:00-04:00,49.3,49.55,49.24,49.32,3948482,7337065.45,52.11564880510633,53.37445378578907,NaN,NaN,47.011090216119236,49.22976624422557,0.0057025275648301815,0.0856621908929256,0.07995966332809541,696983785,692495877.2,76.12640871050633,71.467172604072,NaN,NaN,4.614399413521941,3.0317073710650604
2015-04-22T09:30:00-04:00,49.36,49.45,49.07,49.35,2897749,7134965.25,52.57134552110023,53.661782970661655,NaN,NaN,25.469243293651584,36.58735985825188,0.004133408343206066,0.085126423757103,0.08099301541389693,699881534,694711702.6,77.78378396008837,73.12438527111571,NaN,NaN,4.709067432164111,3.2713302369363535
2015-04-23T09:30:00-04:00,49.07,49.42,49.06,49.18,6320769,6527167.25,49.68580628941615,53.464925251176716,NaN,NaN,5.265746753112578,19.5637188382146,-0.008654165991823795,0.07017530792411719,0.07882947391594099,693560765,694504090,77.24270156523662,74.21506909880675,NaN,NaN,4.015832987757852,3.377687772767996
2015-04-24T09:30:00-04:00,49.32,49.32,49.13,49.19,6555074,6474119.3,49.860146158849545,52.9821198107018,NaN,NaN,-7.098257862439747,21.04909068500866,-0.01629600079521297,0.05845947292192477,0.07475547371713774,700115839,696715445.2,78.9243843914791,75.01446393678445,NaN,NaN,3.4797839457746873,3.3922729403403804
2015-04-27T09:30:00-04:00,49.26,49.28,48.89,48.92,6888137,6571022.85,45.29643004105354,52.38703758432162,NaN,NaN,-77.95247886051503,-1.4609312920142756,-0.03814379212856636,0.027075733556429782,0.06521952568499614,693227702,696753925,78.95352922959269,75.78136642197587,NaN,NaN,1.7541820283033682,3.1582599529065214
2015-04-28T09:30:00-04:00,48.92,49.0299,48.71,48.97,3665122,5487940.1,46.27708353322271,51.79771262414461,NaN,NaN,-115.34526203543979,-33.932201742326086,-0.04724171463673292,0.0061673823890799895,0.05340909702581291,696892824,696735732.8,78.89797919198678,76.38519559237703,NaN,NaN,0.5481769659372174,2.7853909547680495
2015-04-29T09:30:00-04:00,48.81,48.91,48.46,48.53,9409329,5587817.95,39.55678914996501,50.61375000570563,NaN,NaN,-186.1624161652445,-76.2585336341053,-0.0790343200867649,-0.045383803082643226,0.03365051700412168,687483495,694256125,71.51252240086367,76.34198286513175,NaN,NaN,-2.5530515816892745,2.0227563067027177
2015-04-30T09:30:00-04:00,48.41,48.6,48.18,48.37,8286329,5600465.45,37.42828623936713,49.20302713014813,NaN,NaN,-241.35375517693677,-125.58243402011517,-0.10533581115178857,-0.09801924693561404,0.007316564216174534,679197166,691383405.2,64.03398038803115,75.65199890546945,NaN,NaN,-5.824951019910758,0.9016552600436498
2015-05-01T09:30:00-04:00,48.55,48.83,48.41,48.81,5158317,5617333.35,46.028941306269786,48.65817945162795,NaN,NaN,-136.7883838159586,-151.52045921081896,-0.08828613056662035,-0.1030410989921009,-0.014754968425480554,684355483,688231334,56.99140305795508,74.4311619709587,NaN,NaN,-6.200791626936191,-0.11298000952489873
2015-05-04T09:30:00-04:00,48.81,49.01,48.8,48.88,6710241,5672080.65,47.27069531855252,48.10025081067514,NaN,NaN,-70.81451621394905,-150.09286668150577,-0.06836986153492546,-0.10021729534413737,-0.031847433809211914,691065724,687798938.4,56.08023005678929,72.99904822832397,NaN,NaN,-6.13864389955578,-0.9737891366721675
2015-05-05T09:30:00-04:00,48.86,48.92,48.415,48.49,6537353,5615908.9,41.5366937252556,47.29184948485643,NaN,NaN,-121.01491868894549,-151.22679801220687,-0.07690121074459716,-0.12797394723995836,-0.051072736495361204,684528371,685326047.8,51.05308090539228,71.16792081978375,NaN,NaN,-7.869282373538561,-1.9588595990816522
2015-05-06T09:30:00-04:00,48.59,48.76,48.34,48.64,6233272,5675614.95,44.33355325526487,46.5046693669517,NaN,NaN,-110.54890579316529,-136.10409593779104,-0.06817893664670786,-0.13629640730374604,-0.06811747065703817,690761643,685981677.4,52.27459899389063,69.37441385929985,NaN,NaN,-8.450972077523106,-2.886304238859003
2015-05-07T09:30:00-04:00,48.48,48.86,48.37,48.76,6433797,5758035.25,46.53706197922555,46.37837468985399,NaN,NaN,-83.36799954354883,-104.50694481111346,-0.05085879806569377,-0.13169096823915538,-0.08083217017346161,697195440,689581332.2,58.4113234978946,68.15706542848156,NaN,NaN,-8.276685427293149,-3.656358694349595
2015-05-08T09:30:00-04:00,49.01,49.36,49.01,49.17,6946516,5875108.55,53.33394309776704,46.559458887172575,NaN,NaN,30.239615849708745,-71.10134487797998,-0.010434594883961118,-0.09387541377841302,-0.0834408188944519,704141956,693538626.8,63.90602346829746,67.2994249870003,NaN,NaN,-5.966388303437152,-3.986362924219246
2015-05-11T09:30:00-04:00,49.03,49.33,48.95,48.97,3988447,5888892.45,49.994962310437465,46.40798128041051,NaN,NaN,13.776238361615524,-54.18319396286707,0.003446692484436409,-0.07913245328890639,-0.0825791457733428,700153509,695356183.8,66.1200651402472,66.58468616055322,NaN,NaN,-5.066349423236698,-4.140646709793168
2015-05-12T09:30:00-04:00,48.51,49.02,48.51,48.86,4903389,5847953.1,48.207359836803555,46.096268017246466,NaN,NaN,-47.03710385542821,-39.38763099616361,0.005699448455401157,-0.07545483520409135,-0.08115428365949251,695250120,697500533.6,68.56965032845953,65.92653375829401,NaN,NaN,-4.86455785730297,-4.244062588008854
2015-05-13T09:30:00-04:00,48.85,49.19,48.78,48.84,3716893,5695582.1,47.872201447302274,45.966724814238326,NaN,NaN,-7.973796524351421,-18.87260914240083,0.006276172585721801,-0.07330906792734027,-0.07958524051306207,691533227,697654850.4,68.74478604257483,65.31953979238959,NaN,NaN,-4.796631523448794,-4.3230010073574165
2015-05-14T09:30:00-04:00,49.04,49.61,49.04,49.59,6174276,5714474.85,59.29968221297783,46.6409773895332,NaN,NaN,118.75445300151574,21.551881366612072,0.05489745606929575,-0.010963420426442383,-0.06586087649573813,697707503,697757263,68.86876464204212,64.60128123885838,NaN,NaN,-0.8936593569176157,-3.833095057294588
2015-05-15T09:30:00-04:00,49.6,49.75,49.55,49.75,5014345,5688203.85,61.251243897074204,47.78060695067753,NaN,NaN,161.56416994925496,47.81679218652132,0.09330578649521408,0.05077135662327947,-0.042534429871934606,702721848,697473241.4,68.06243175637988,63.82334570505747,NaN,NaN,2.904042506664976,-2.870646833871793
2015-05-18T09:30:00-04:00,49.7,49.715,49.51,49.59,6199937,5799388.7,58.24365951871612,48.635362378212776,NaN,NaN,132.4445727675019,71.5504590676986,0.10266509247180074,0.08579693571781632,-0.016868156753984415,696521911,696746921.8,65.93635901540239,62.8975156924443,NaN,NaN,5.074845264657754,-1.735576534081858
2015-05-19T09:30:00-04:00,49.62,49.62,49.3,49.46,5157182,5859823.7,55.84432921463208,49.79875809711757,NaN,NaN,97.77517628459363,100.51291509570297,0.09500693781362615,0.10189051551304829,0.006883577699422126,691364729,695969843.6,63.64569529300799,62.33559947045461,NaN,NaN,6.127188471023107,-0.6123243904954345
2015-05-20T09:30:00-04:00,49.39,49.59,49.35,49.35,5463241,5988098.3,53.823868951544654,50.9698711479874,NaN,NaN,87.66477184614007,119.64062876980127,0.07814383488140825,0.10456337130118243,0.026419536419774188,685901488,694843495.8,60.371812956177244,62.07401608246504,NaN,NaN,6.397623663002879,0.38909676000432447
2015-05-21T09:30:00-04:00,49.36,49.52,49.19,49.46,4313587,5887739.2,55.555571301087184,51.65034471904578,NaN,NaN,75.23854638966178,110.93744744743046,0.07025702085448908,0.11424081248788553,0.043983791633396455,690215075,693345010.2,56.22789988372649,62.01948014144871,NaN,NaN,7.1235811923252,1.3511659646215923
2015-05-22T09:30:00-04:00,49.23,49.4,49.22,49.25,5336919,5826831.45,51.57873526066696,51.95806185776824,NaN,NaN,52.94278600955735,89.21317065949094,0.047828028253716716,0.10376882695054235,0.05594079869682563,684878156,689776271.8,47.81101799370337,61.42882213694258,NaN,NaN,6.589385353860898,2.0994830202272072
2015-05-26T09:30:00-04:00,49.19,49.21,48.7615,48.86,8790115,5921930.35,45.11919764437463,52.21395499484817,NaN,NaN,-17.138923343494884,59.2964714372916,0.005863855467764294,0.063270618031531,0.05740676256376671,676088041,685689497.8,40.360209902904145,60.66504563676485,NaN,NaN,4.093539148275644,2.384348181376984
2015-05-27T09:30:00-04:00,48.96,49.25,48.915,49.17,7599854,6118666.95,50.43299724205884,52.649629565333456,NaN,NaN,14.937681566862489,42.72897249374537,-0.0014857587593621463,0.05554956411456402,0.05703532287392617,683687895,684154131,37.96639298234368,59.643030921654365,NaN,NaN,3.6028405727389092,2.558418523000116
2015-05-28T09:30:00-04:00,49.12,49.17,48.89,49.1,5741289,5935264.95,49.27284916434875,52.8450429356994,NaN,NaN,-1.3713224246733693,24.921753639582683,-0.011001685260763207,0.04328321629797216,0.05428490155873537,677946606,682563154.6,35.60950099707894,58.01432931445324,NaN,NaN,2.8546775495053094,2.6007412410722868
2015-05-29T09:30:00-04:00,49.02,49.07,48.695,48.79,6663595,5854128.25,44.40154684784009,52.20701463213319,NaN,NaN,-54.76422956672839,-1.0788015516953606,-0.03666773798582111,0.008450229076458982,0.04511796706228009,671283011,678776741.8,30.721496338321742,55.64400594802641,NaN,NaN,0.6791678379651791,2.3262307549141283
2015-06-01T09:30:00-04:00,48.89,48.99,48.62,48.79,5992277,5895826.25,44.40154684784009,51.80748495623338,NaN,NaN,-69.68144505120704,-25.603647763848237,-0.05124387107748428,-0.01893687178457526,0.03230699929290902,671283011,676057712.8,27.773254772708256,52.90494806463077,NaN,NaN,-1.0562337765663021,1.8430215361312097
2015-06-02T09:30:00-04:00,48.65,48.77,48.42,48.66,4998166,5810222.5,42.36454698726147,51.39014118126609,NaN,NaN,-105.40107925736471,-43.2560789466222,-0.06628445355634296,-0.050548567652519694,0.015735885903823275,666284845,674097073.6,25.847059272912958,49.85333441780602,NaN,NaN,-3.1125772321271223,1.135078854951448
2015-06-03T09:30:00-04:00,48.72,48.86,48.56,48.63,5892661,5777987.9,41.88697974283113,50.96262534523243,NaN,NaN,-92.11990561365806,-64.66759638272632,-0.07429484966689356,-0.07713267617979369,-0.00283782651290012,660392184,669437931.4,21.95103574987374,46.510923682613075,NaN,NaN,-4.942480606470564,0.2668560747483033
2015-06-04T09:30:00-04:00,48.54,48.66,48.18,48.28,7084781,5820563.35,36.690417940892985,49.347677897226376,NaN,NaN,-156.31156221591286,-95.6556443409742,-0.09773126238942653,-0.1250019044996833,-0.027270642110256753,653307403,664510090.8,18.734503003521027,42.92990499414729,NaN,NaN,-8.167150038230185,-0.9380019413914804
2015-06-05T09:30:00-04:00,48.15,48.27,47.56,47.59,9482272,5972987.1,29.041195783996017,47.04696017486365,NaN,NaN,-237.56813192436059,-132.21642481250063,-0.15108308437301288,-0.21612449757652286,-0.06504141320350998,643825131,659018514.8,15.932646380673717,39.20634889588257,NaN,NaN,-13.940644905183866,-2.7955223647903926
2015-06-08T09:30:00-04:00,47.56,47.735,47.46,47.57,10944033,6172862.95,28.853425190286714,44.94765772283297,NaN,NaN,-222.832755401441,-162.84668688254743,-0.17728633098747046,-0.28664932693784806,-0.1093629959503776,632881098,651338132.2,13.003536012453807,35.42543296710053,NaN,NaN,-18.495531247629447,-5.0383807766245425
2015-06-09T09:30:00-04:00,47.63,47.975,47.55,47.8,7096711,6328276.15,34.12810122437075,43.39649858067145,NaN,NaN,-159.09154962938516,-173.58478095695153,-0.16874127166544753,-0.320289585532187,-0.15154831386673948,639977809,646076725,11.45051736109663,31.697205971964003,NaN,NaN,-20.684712356858466,-7.273571002372245
2015-06-10T09:30:00-04:00,47.92,48.37,47.92,48.27,7091575,6437685.45,43.3678387656557,42.64963928167938,NaN,NaN,-88.9788444253663,-172.9565687192932,-0.1231637586914767,-0.30550301223108534,-0.18233925353960864,647069384,643412165,10.750283062962382,28.152810979591518,NaN,NaN,-19.545914354776382,-9.026762909858551
2015-06-11T09:30:00-04:00,48.31,48.465,48.2,48.25,7469331,6625307.35,43.09085051969893,41.75930208300879,NaN,NaN,-65.43483098506981,-154.7812224731246,-0.08775420990081176,-0.29203201591562333,-0.20427780601481157,639600053,640670695,10.068088915979516,24.855681624752446,NaN,NaN,-18.741699522384774,-10.414610997362297
2015-06-12T09:30:00-04:00,48.13,48.17,47.89,48.06,6748776,6654032.35,40.44784975845789,40.964238832851,NaN,NaN,-88.06924091559488,-124.88144427137145,-0.07122296438694492,-0.29330651149849274,-0.22208354711154782,632851277,638475924.2,9.54582283821469,22.122453399360403,NaN,NaN,-18.877044688483682,-11.623530096093923
2015-06-15T09:30:00-04:00,47.87,47.96,47.68,47.71,7632584,6784944.3,36.06013220462897,40.31716273001202,NaN,NaN,-107.23304931132733,-101.76150305334872,-0.07743936350794683,-0.3188827514964814,-0.24144338798853454,625218693,636943443.2,9.187453743028726,19.895827959369303,NaN,NaN,-20.38921064608364,-12.875770174663883
2015-06-16T09:30:00-04:00,47.84,48.26,47.77,48.23,5036370,6726765.95,45.51657143946312,39.96598945839805,NaN,NaN,-62.32404641401654,-82.40800241027499,-0.04188980418176513,-0.293805643215741,-0.25191583903397585,630255063,634998894,8.739127878041927,17.808166166204895,NaN,NaN,-18.51553322471744,-13.68145061038582
2015-06-17T09:30:00-04:00,48.38,48.57,48.12,48.49,10508750,6994344.35,49.5353823880298,39.98474183151813,NaN,NaN,-17.915119872979485,-68.19525749979763,0.001477164859868818,-0.25006938295913983,-0.25154654781900865,640763813,633737779.8,8.451101597864266,15.868280494832417,NaN,NaN,-15.616771695337839,-13.957925051093252
2015-06-18T09:30:00-04:00,48.64,49.22,48.6,49.03,8820968,7162230.7,56.682086085282016,40.861923205621125,NaN,NaN,63.950718490663355,-42.318147604651,0.06533614579650299,-0.16987636557337993,-0.23521251136988292,649584781,635734725.4,13.322640719273224,14.625505093471807,NaN,NaN,-10.526827161359996,-13.467768209702786
2015-06-19T09:30:00-04:00,48.76,48.91,48.66,48.66,8908167,7391959.7,51.31928113389497,41.35604708319647,NaN,NaN,42.00026802978878,-16.30424581557427,0.08046854112353316,-0.13462683496546646,-0.21509537608899962,640676614,637299792.8,17.048190988428672,13.859429108880407,NaN,NaN,-8.210857224366356,-12.716780926083295
2015-06-22T09:30:00-04:00,48.93,49.05,48.8,48.85,4445930,7347410.25,53.73970345346797,42.16855825935408,NaN,NaN,72.21721149927437,19.58580634654607,0.09982127906871188,-0.09031877725310977,-0.19014005632182165,645122544,641280563,25.78576229003805,13.85505075296077,NaN,NaN,-5.550622024952646,-11.693043940207488
2015-06-23T09:30:00-04:00,48.87,48.88,48.5449,48.64,5107522,7163280.6,50.73702033733821,42.80070401610458,NaN,NaN,41.59956547931722,40.37052872521283,0.0950501650895193,-0.07132734995992251,-0.16637751504944182,640015022,643232554.8,29.69631825193302,14.408285217393578,NaN,NaN,-4.379214440025558,-10.648211154467212
2015-06-24T09:30:00-04:00,48.62,48.695,48.42,48.42,6765086,7121542.2,47.72832313511755,43.58912581569205,NaN,NaN,18.737349139183152,47.70102252764535,0.07455398256840468,-0.07318503683893596,-0.14773901940734063,633249936,641729779.4,28.453280301219905,15.102483595800638,NaN,NaN,-4.384232576861968,-9.753357071952177
2015-06-25T09:30:00-04:00,48.61,48.61,48.33,48.33,6443662,7156660.85,46.51316192123283,44.837123396923246,NaN,NaN,9.321657715108016,36.77521037253429,0.0534024481758148,-0.08098595918757212,-0.13438840736338692,626806274,637174078,25.032453719745945,15.752469834305796,NaN,NaN,-4.761215861877428,-9.040194041941499
2015-06-26T09:30:00-04:00,48.4,48.595,48.34,48.43,4608042,7053883.2,48.0944595299183,46.21148299261122,NaN,NaN,20.271380685397908,32.42943290365612,0.044952591454328644,-0.07819766804547612,-0.12315025949980477,631414316,635321618.4,23.78047370785356,16.52225109826292,NaN,NaN,-4.604325206575174,-8.406498494032023
2015-06-29T09:30:00-04:00,48.18,48.27,47.66,47.68,8106247,7159581.7,38.82379921818627,46.546889992169476,NaN,NaN,-87.64230490820499,0.45752962216024284,-0.00944061461714571,-0.1349510277712369,-0.1255104131540912,623308069,630958723.4,21.103417643681823,17.211743975590434,NaN,NaN,-7.5537790029216385,-8.284681423873398
2015-06-30T09:30:00-04:00,48.18,48.18,47.59,47.6,10039870,7411666.9,37.98276132946765,46.16224160387032,NaN,NaN,-91.44578492010518,-26.15154045772424,-0.04699948841963922,-0.18425977367864022,-0.137260285259001,613268199,625609358.8,18.372452156743634,17.75618462514624,NaN,NaN,-10.153969188375415,-8.551722533087972
2015-07-01T09:30:00-04:00,47.92,48.21,47.72,48.21,6859599,7460013.8,47.34869724160942,46.466373512578215,NaN,NaN,-37.255722578642995,-37.35015480128947,-0.027896721288012405,-0.17213118686901652,-0.1442344655810041,620127798,622984931.2,17.196675092561705,18.265369352044967,NaN,NaN,-9.345516338606382,-8.66512164816203
2015-07-02T09:30:00-04:00,48.24,48.425,48.03,48.17,6956570,7453603.25,46.84906036935746,46.92360284192819,NaN,NaN,-3.863112228779675,-39.98710879006701,-0.015698833166882642,-0.1638580070396074,-0.14815917387272476,613171228,620257922,16.047461160456606,18.72977208934796,NaN,NaN,-8.872512560282658,-8.69474892132212
2015-07-06T09:30:00-04:00,47.85,48.31,47.8,48.13,8740692,7416524.25,46.32264989108962,47.656639819532515,NaN,NaN,-33.60672294244388,-50.76272951563537,-0.008432442074822466,-0.15869972646625286,-0.1502672843914304,604430536,614861166,14.046835817036225,19.076870808919924,NaN,NaN,-8.651193221888606,-8.688526678545903
2015-07-07T09:30:00-04:00,48.26,49.16,48.0962,49.12,17427002,7740672.7,58.69355217115041,48.59785272893875,NaN,NaN,103.91381315711874,-12.451505902570625,0.061113478963589485,-0.07387543568694355,-0.13498891465053303,621857538,614571059.8,13.946183513368425,19.44880335430039,NaN,NaN,-4.089934241006624,-8.031584901754577
2015-07-08T09:30:00-04:00,48.7,48.93,48.54,48.57,11754345,7973554.4,51.581190278725416,48.74398186398844,NaN,NaN,72.37678531683609,20.31300814481763,0.06763079845760989,-0.050450416578520674,-0.11808121503613056,610103193,613938058.6,13.715253041085631,19.824814171673346,NaN,NaN,-2.769323797142089,-7.279833315381365
2015-07-09T09:30:00-04:00,49.16,49.25,48.61,48.61,8359924,8036971.85,52.03640589952093,48.412147565005505,NaN,NaN,92.76647172391495,46.31744700532922,0.0717996402957306,-0.028331664666467304,-0.10013130496219791,618463117,613605122.4,13.587809890754784,19.843754826779172,NaN,NaN,-1.6116339963408037,-6.470090555518428
2015-07-10T09:30:00-04:00,49.06,49.295,49.01,49.18,7782475,8052629.05,58.083997471716735,48.89534158913563,NaN,NaN,141.2613372424456,75.34233689957428,0.10793768017841857,0.03479079526082529,-0.07314688491759327,626245592,616219995.2,19.884380820255643,20.046339814766814,NaN,NaN,1.4764344589990663,-5.334872696301643
2015-07-13T09:30:00-04:00,49.41,49.66,49.41,49.64,7031821,8066781.3,62.22360273433249,49.501334394911666,NaN,NaN,186.0472312962624,119.27312774731554,0.15495302345660947,0.12054439440316855,-0.03440862905344091,633277413,621989370.6,31.708264564455092,20.469375691510887,NaN,NaN,5.4934472170667314,-3.787969851534732
2015-07-14T09:30:00-04:00,49.65,49.74,49.56,49.72,6858313,8028067.75,62.90965435052643,50.37080825299654,NaN,NaN,177.56596895691288,134.00355890727434,0.18171754625595576,0.1927383037665038,0.01102075751054804,640135726,625645008.2,37.956511524990596,21.059389496729285,NaN,NaN,8.841503529068598,-1.9837593685913992
2015-07-15T09:30:00-04:00,49.71,49.73,49.49,49.59,5980479,8075273.2,60.971877030248635,51.31677638836305,NaN,NaN,147.19796967232065,148.96779577837128,0.18057032614402915,0.23673366519058447,0.05616333904655533,634155247,630455419,45.07755465852665,22.246837665108337,NaN,NaN,10.937181234137324,-0.13791071105872454
2015-07-16T09:30:00-04:00,49.84,50.1699,49.78,50.1,4451157,7772393.55,65.46600009048277,52.67055054330948,NaN,NaN,178.00610778877686,166.01572299134367,0.20242045403398995,0.30918890658904274,0.10676845255505281,638606404,634484076.4,50.22961844950796,24.046635145805624,NaN,NaN,14.227782402695324,1.9143311623347108
2015-07-17T09:30:00-04:00,49.98,50.075,49.775,50.07,4874380,7575064.15,64.99190839585063,53.87751117659036,NaN,NaN,147.0386041895197,167.17117638075848,0.2026165586875201,0.36003915091445293,0.15742259222693283,633732024,635981362.8,52.03066241522213,26.064505767760522,NaN,NaN,16.688370369000324,4.024908191858369
2015-07-20T09:30:00-04:00,50.1,50.22,49.961,50.16,6345397,7446925.65,65.79225287166147,55.80382929469573,NaN,NaN,136.93013772225532,157.3477576659571,0.19642637649036768,0.4029555628398924,0.20652918634952475,640077421,637341364.4,53.67060701594529,28.390733580065056,NaN,NaN,18.93508020335133,6.154932764928792
2015-07-21T09:30:00-04:00,50.04,50.19,49.9,50.04,6146042,7531931.25,63.701132241564814,57.64085578841696,NaN,NaN,110.40448812659136,143.91546149989276,0.17270848815101314,0.42241479653829117,0.24970630838727803,633931379,636100495,51.92629515996155,30.78743665172348,NaN,NaN,20.223125907201,8.16467464239625
2015-07-22T09:30:00-04:00,50.04,50.33,50.01,50.15,6107881,7581949.2,64.80540515925726,58.88776349682038,NaN,NaN,105.96810173850999,135.66948791313064,0.1535323291667482,0.4416217198457133,0.2880893906789651,640039260,637277297.6,53.470752379702674,33.37844217223355,NaN,NaN,21.610179928460308,10.085461111833972
2015-07-23T09:30:00-04:00,50.26,50.26,49.89,49.96,4535057,7470447.75,61.33456789368045,59.92244260570059,NaN,NaN,84.32584060035516,116.9334344754463,0.1187128537155252,0.43648045782337164,0.31776760410784644,635504203,636656857.4,52.512863818190866,35.98311379064314,NaN,NaN,21.853702100009126,11.766638395858994
2015-07-24T09:30:00-04:00,50.08,50.08,49.62,49.68,9950133,7645771.3,56.529624904642375,60.65151224952577,NaN,NaN,57.22191014601957,98.97009566674626,0.06989958465347562,0.40514208492469095,0.3352425002712153,625554070,635021266.6,49.971423995316904,38.549155803377474,NaN,NaN,20.710303647456048,13.044304860372858
2015-07-27T09:30:00-04:00,49.48,49.73,49.33,49.65,9567088,7893723.6,56.0232188451129,60.46077415480881,NaN,NaN,33.51001243274991,78.28607060884518,0.030669249747090732,0.37357906245507877,0.34290981270798804,615986982,630203178.8,43.320362760791404,40.647311463907684,NaN,NaN,19.62545956874908,13.984469818712318
2015-07-28T09:30:00-04:00,49.87,50.22,49.73,50.21,8765751,7926698.8,62.73418265194484,61.257416467181635,NaN,NaN,71.90988095514379,70.58714917455566,0.03708435152652684,0.3892652521161466,0.35218090058961976,624752733,628367449.6,41.07706356552001,42.60172650136729,NaN,NaN,20.564745244789272,14.92450916529474
2015-07-29T09:30:00-04:00,50.26,50.49,50.16,50.38,6105070,7729958.8,64.50500174207161,62.14803045593525,NaN,NaN,96.35334623470602,68.66419807379489,0.04679942685844174,0.41068018416267194,0.3638807573042302,630857803,626531158.2,38.90667780279047,44.41021706651269,NaN,NaN,21.871116328294754,15.916881617151885
2015-07-30T09:30:00-04:00,50.14,50.28,49.88,50.21,7029085,7738433.1,61.36473121021849,62.38236858011395,NaN,NaN,70.55471030233457,65.90997201419077,0.03626891032126861,0.40921689520581594,0.37294798488454733,623828718,624196061.2,36.281432011339746,45.58143500873299,NaN,NaN,22.06991302078151,16.79588610338469
2015-07-31T09:30:00-04:00,50.38,50.42,50.24,50.31,6168772,7699043.2,62.52058328765704,62.40358147677999,NaN,NaN,92.13859778637986,72.89330954226283,0.03074898114827518,0.41138421131989134,0.38063523017161616,629997490,625084745.2,37.99614575103858,46.030569379203236,NaN,NaN,22.558782361244464,17.619156997364655
2015-08-03T09:30:00-04:00,50.3,50.43,50.16,50.38,6961369,7610077.05,63.347207480652365,62.434835271788984,NaN,NaN,89.60216921622612,84.11174089895806,0.026674341809999613,0.4139781574341157,0.3873038156241161,636958859,629279120.6,45.45670843668997,46.566297730038904,NaN,NaN,23.192626007093903,18.415366855897403
2015-08-04T09:30:00-04:00,50.35,50.45,50.11,50.38,5633040,7020378.95,63.347207480652365,62.604501732532114,NaN,NaN,83.7733066137887,86.48442603068705,0.01919114877945194,0.41129275159843104,0.3921016028189791,636958859,631720345.8,49.2818010126181,46.86660104104544,NaN,NaN,23.71943300897087,19.173090592050755
2015-08-05T09:30:00-04:00,50.54,50.887,50.52,50.82,5239860,6694654.7,68.42407039496103,62.81579246856626,NaN,NaN,158.95569877254172,99.0048965382542,0.0379998532430334,0.43960141937277086,0.40160156612973746,642198719,633988529,52.6073730364002,47.03644065439489,NaN,NaN,25.65609759212617,20.099234449204385
2015-08-06T09:30:00-04:00,50.95,50.95,50.37,50.44,7889450,6671131,60.615243016792704,62.50317351291926,NaN,NaN,131.08749616881195,111.11145371154967,0.019884732646736347,0.4264574819381579,0.40657274929142156,634309269,636084639.2,55.510592219178285,47.28500706896318,NaN,NaN,25.070856979995316,20.809466239317373
2015-08-07T09:30:00-04:00,50.36,50.5,49.94,50.16,6889664,6626490.45,55.58176295765209,61.77385280477574,NaN,NaN,33.12038063876929,99.30781028202756,-0.014087456554450095,0.388963428598359,0.40305088515280907,627419605,635569062.2,54.624215456209804,47.353121957553505,NaN,NaN,23.024406302892373,21.125886248399517
2015-08-10T09:30:00-04:00,50.3,50.51,50.26,50.35,5779953,6563897.05,58.122984219785195,61.3754136603629,NaN,NaN,73.62891596430735,96.11315963164381,-0.026191260703024632,0.3703118092740283,0.3965030699770529,633199558,634817202,53.28792893710037,47.45038151306341,NaN,NaN,22.056189820293344,21.258786758670063
2015-08-11T09:30:00-04:00,50.02,50.2799,50.0001,50.17,5616152,6501789,54.91748698730824,60.66913379093797,NaN,NaN,2.4496200464911677,79.8484223181843,-0.04750672377902726,0.33711966525326886,0.3846263890322961,627583406,632942111.4,50.00261457335465,47.20265738403856,NaN,NaN,20.279646788256233,21.118909620039517
2015-08-12T09:30:00-04:00,49.85,50.225,49.51,50.2,8275075,6616518.8,55.35937397332493,60.2423342251983,NaN,NaN,-63.45708532922666,35.365865497830626,-0.05996849757985179,0.3096657670574814,0.3696342646373332,635858481,631674063.8,47.85397252740347,46.8698794346966,NaN,NaN,18.954433844175252,20.809698794916052
2015-08-13T09:30:00-04:00,50.15,50.28,49.935,50,4935225,6640722.2,51.71977803788745,59.8987737347158,NaN,NaN,-32.40822165159867,2.666721933748492,-0.08076906603441164,0.26867293209431864,0.3494419981287303,630923256,630996861.2,46.69984308173656,46.63619508372658,NaN,NaN,16.759123170939827,20.23104513434802
2015-08-14T09:30:00-04:00,49.99,50.17,49.87,50.16,5247043,6659355.35,54.30786081387616,59.776248161056024,NaN,NaN,-36.52804191036561,-11.26296257607849,-0.08254738124519306,0.24625777157223894,0.328805152817432,636170299,632747000,50.05249802444689,47.1170618882734,NaN,NaN,15.606701577450751,19.57042462621984
2015-08-17T09:30:00-04:00,50,50.225,49.82,50.21,4978436,6591007.3,55.11755334436508,59.232203210514626,NaN,NaN,-29.25478168871597,-31.83970210668316,-0.07914149526363973,0.22987828373788233,0.30901977900152205,641148735,634336835.4,52.947867771998645,47.964976474450445,NaN,NaN,14.867614391826379,18.89859459273506
2015-08-18T09:30:00-04:00,50.03,50.17,49.9,49.96,5108275,6539118.95,50.316427113888416,58.21873359421583,NaN,NaN,-55.01457691535723,-43.33254149905282,-0.09162971424943145,0.19448263618973272,0.28611235043916416,636040460,636028246.2,55.878252132780005,49.17723178373541,NaN,NaN,12.844893438140959,18.033780142078758
2015-08-19T09:30:00-04:00,49.85,49.87,49.26,49.5,9309247,6699187.25,42.90992057667628,56.900532834677094,NaN,NaN,-183.57637972180297,-67.3564003775681,-0.12661826398188164,0.12783952046181213,0.25445778444369377,626731213,634202792.6,52.10649660330305,50.30759354030421,NaN,NaN,8.657185154154694,16.69426657237532
2015-08-20T09:30:00-04:00,49.16,49.49,48.95,49.05,12756272,7110248,37.14902043288374,55.088278345050426,NaN,NaN,-240.37497839985906,-108.94975172722016,-0.17294866225564598,0.038271956624136294,0.21122061887978227,613974941,630813129.6,45.90959510286655,50.87283992257765,NaN,NaN,2.990699118790305,14.736614079006031
2015-08-21T09:30:00-04:00,48.67,48.78,47.71,47.71,23544294,7789956.05,25.968599884602625,52.41837780247545,NaN,NaN,-349.11940903562163,-171.46802515227137,-0.28036273124464817,-0.13923279517602793,0.14112993606862023,590430647,621665199.2,34.11709727557725,50.062867696783876,NaN,NaN,-7.521017316284449,11.556952451107392
2015-08-24T09:30:00-04:00,45.4,47.1,43.72,46.05,68723789,10747791.1,18.52898596157712,49.217076265398646,NaN,NaN,-408.2773830900134,-247.27254543253085,-0.4402146877064673,-0.40913842356446395,0.031076264142003387,521706858,597776823.8,19.80839825806757,47.95762464288741,NaN,NaN,-20.897247481258376,6.92063817505514
2015-08-25T09:30:00-04:00,47.71,47.71,45.65,45.7,35853861,12102196.6,17.397294061438075,45.57230652728986,NaN,NaN,-232.80924484962787,-282.83147901938503,-0.5399495145242912,-0.6438606290133606,-0.10391111448906941,485852997,567739331.2,12.63352363140585,45.10234968538781,NaN,NaN,-30.738074042196523,1.540822144019188
2015-08-26T09:30:00-04:00,46.61,47.13,45.75,47.05,24372846,13015585.4,34.11306059629865,43.67929349725457,NaN,NaN,-164.30871476672777,-278.97794602836996,-0.48705514206363565,-0.712730042068614,-0.22567490000497833,510225843,544438257.2,9.698734126903958,41.83007410736821,NaN,NaN,-31.15408301471392,-3.129878592942684
2015-08-27T09:30:00-04:00,47.43,47.89,46.87,47.74,19550365,13641649.4,40.71644071898278,42.61748476592105,NaN,NaN,-96.42705852618342,-250.18836205363482,-0.38227811575214643,-0.7035225446951614,-0.32124442894301497,529776208,527598510.6,8.213702435621187,38.51503746304045,NaN,NaN,-28.543367741482196,-6.760377042734042
2015-08-28T09:30:00-04:00,47.61,47.69,47.35,47.64,8695280,13767974.8,40.08934829651851,41.329367914259144,NaN,NaN,-80.80579618362597,-196.5256394832357,-0.30001929725931653,-0.6962685505171606,-0.3962492532578441,521080928,513728566.8,7.231555981771777,35.22529653765984,NaN,NaN,-26.95537340729438,-9.645376523385519
2015-08-31T09:30:00-04:00,47.52,47.52,47.18,47.31,12948307,14067321.7,38.00895112403598,40.12161535259684,NaN,NaN,-79.82304791423901,-130.83477244808083,-0.2501808563806307,-0.7089753237336325,-0.4587944673530018,508132621,511013719.4,7.053763422096935,32.15752145542714,NaN,NaN,-26.510700548087502,-12.054708526914373
2015-09-01T09:30:00-04:00,46.37,46.85,46.05,46.34,15589260,14565132.7,32.64614982683595,38.499242199276196,NaN,NaN,-106.471868548085,-105.56729718777224,-0.2635485855936054,-0.7882301993450085,-0.5246816137514031,492543361,512351792.2,8.251060399854012,29.328742017745036,NaN,NaN,-28.166256265543304,-14.356358203861364
2015-09-02T09:30:00-04:00,46.74,46.98,46.52,46.97,9637270,14785003.2,38.696044533440315,37.56897552038712,NaN,NaN,-78.47209762162372,-88.39997375875144,-0.21312301661334465,-0.7910853845180839,-0.5779623679047392,502180631,510742749.8,8.115676434767721,26.57273011439012,NaN,NaN,-27.215910475754335,-16.193437099846072
2015-09-03T09:30:00-04:00,47.16,47.58,47.055,47.29,7626783,14771869.85,41.56707076112724,36.65891908804791,NaN,NaN,-51.31793277062048,-79.37814860763886,-0.14465416117562868,-0.758780069374275,-0.6141259081986463,509807414,506748991,7.774688142198386,23.55288655137237,NaN,NaN,-25.462952651054966,-17.517653607161627
2015-09-04T09:30:00-04:00,46.67,46.79,46.34,46.52,10507112,14952742.25,37.06845797660697,35.3696979903509,NaN,NaN,-77.38387947606016,-78.69376526612571,-0.13769693135180194,-0.7862470723883987,-0.6485501410365968,499300302,502392865.8,7.409026747455627,20.30011219247644,NaN,NaN,-25.595744091509793,-18.671666533497078
2015-09-08T09:30:00-04:00,47.27,47.54,46.94,47.49,6867296,15007109.4,45.125335517193456,34.99890573344412,NaN,NaN,-38.23112778265756,-70.37538123980941,-0.05830213206566914,-0.7214278061186832,-0.663125674053014,506167598,501999861.2,7.375324471600621,16.83561735953506,NaN,NaN,-22.751996420988945,-19.254570803138773
2015-09-09T09:30:00-04:00,47.93,47.94,46.59,46.71,7587430,15105673.3,40.62169253172596,34.835460873090526,NaN,NaN,-45.253444570849915,-58.1316964443624,-0.049214903490371276,-0.7246443034159782,-0.6754293999256069,498580168,503207222.6,8.748613265598095,13.738625692556138,NaN,NaN,-22.06388962421405,-19.655902063292384
2015-09-10T09:30:00-04:00,46.49,47.12,46.47,46.79,14986290,15441234.05,41.26911847583889,35.12975359044446,NaN,NaN,-55.431686286203515,-53.523614177278354,-0.02967610408709742,-0.7125245300344787,-0.6828484259473813,513566458,505484388,11.41627696022961,11.274817253796357,NaN,NaN,-21.3250749305686,-19.894355330046128
2015-09-11T09:30:00-04:00,46.74,47.11,46.57,47.1,5127313,15450838.45,43.825118421945945,36.4052192002547,NaN,NaN,-44.418143562352704,-52.143656335624804,0.010134981801659393,-0.670179698695307,-0.6803146804969664,518693771,507261659.4,13.540729490091536,9.805076697690238,NaN,NaN,-19.906487375266313,-19.896088479363296
2015-09-14T09:30:00-04:00,47.08,47.1699,46.7601,46.95,6180096,15497491.1,42.85328312253145,38.14266899746572,NaN,NaN,-38.48424731944551,-44.36372990430186,0.03118615618332965,-0.6413319852678043,-0.672518141451134,512513675,509904334,16.738249431088363,9.585780352906012,NaN,NaN,-19.068425032282438,-19.77785084406603
2015-09-15T09:30:00-04:00,47.01,47.5951,46.82,47.51,7284509,15612794.75,47.531196576641776,40.295090605694554,NaN,NaN,-4.8727499934327625,-37.6920543464569,0.08461490587802589,-0.5667495091036017,-0.6513644149816276,519798184,512630451.2,20.0240893709653,10.113677905731686,NaN,NaN,-16.903483403175766,-19.36722692393885
2015-09-16T09:30:00-04:00,47.94,48.11,47.67,48.05,11470705,15930916.25,51.64193836944936,41.54715330377676,NaN,NaN,70.59802397476244,-14.521760637334427,0.15406726141255178,-0.4587803382159379,-0.6128475996284897,531268889,519168195.4,27.42145691092705,11.379586676019047,NaN,NaN,-13.780018845501067,-18.56905434130488
2015-09-17T09:30:00-04:00,48.01,48.62,47.91,48.05,13063925,16118650.15,51.64193836944936,42.32754599309579,NaN,NaN,115.55374490876153,19.67532560165858,0.19510940650206,-0.3689608415009147,-0.5640702480029747,531268889,522708681.6,31.13619893921077,13.016907854846874,NaN,NaN,-11.294650106386296,-17.52985373631651
2015-09-18T09:30:00-04:00,47.19,47.71,47,47.19,10970796,16029376.35,45.113627249722526,42.6864230611818,NaN,NaN,27.52092515187994,34.06313934450511,0.1608652003301565,-0.3629887475902791,-0.5238539479204356,520298093,523029546,31.478486151723985,14.748831438414891,NaN,NaN,-11.041891630478942,-16.603002006911144
2015-09-21T09:30:00-04:00,47.31,47.67,47.3,47.54,9770603,15340691.8,47.994988941791135,43.399711476735725,NaN,NaN,62.99646894538659,54.359282597471534,0.15808083448813992,-0.3262529048102607,-0.4843337392984006,530068696,526540550.2,35.26989395974418,16.76426933396112,NaN,NaN,-9.960199973093225,-15.654030287794297
2015-09-22T09:30:00-04:00,47.06,47.135,46.77,47.02,10674784,12438241.55,44.27602589845,44.23041691042244,NaN,NaN,-28.313806027326013,49.67107139069289,0.1192791824252602,-0.3352347612668254,-0.4545139436920856,519393912,526459695.8,35.22156147200134,18.690733696257357,NaN,NaN,-10.165127126150242,-14.869901264702289
2015-09-23T09:30:00-04:00,47.01,47.175,46.8601,47.1,6458479,10968472.45,44.98234245922344,44.679438190835526,NaN,NaN,-24.39685534591057,30.67209552655828,0.09795537675391358,-0.3320697227496936,-0.4300250995036072,525852391,525376396.2,34.53864143719002,20.578088339287525,NaN,NaN,-10.126941031297262,-14.192335517073
2015-09-24T09:30:00-04:00,46.75,47.25,46.73,47.18,7740110,10136835.65,45.72323621745931,44.9763071520021,NaN,NaN,-28.343181438823436,1.892710257041287,0.08848091560987359,-0.3194239549912652,-0.4079048706011388,533592501,525841118.6,35.11981126560343,22.531311419530745,NaN,NaN,-9.890513808706757,-13.577789558734965
2015-09-25T09:30:00-04:00,47.45,47.96,47.3,47.48,12257293,9772182.05,48.522765403858116,45.79447196823433,NaN,NaN,75.44054098631214,11.476633423927728,0.10076828109993896,-0.2819445192262151,-0.38271280032615407,545849794,530951458.8,41.29221891841657,24.95153943174224,NaN,NaN,-8.914515612534393,-12.911607566420598
2015-09-28T09:30:00-04:00,47.36,47.46,46.69,46.78,15815963,10128216.2,42.95539359739197,45.639476116819935,NaN,NaN,-39.352255392403045,-8.993111443630202,0.06200407881110592,-0.30520770181227164,-0.36721178062337756,530033831,530944485.8,41.28644720784189,27.373762484330904,NaN,NaN,-9.647789572979567,-12.44534785307188
2015-09-29T09:30:00-04:00,46.91,46.93,46.48,46.76,15304069,10246004.3,42.8042782758844,45.79537509854554,NaN,NaN,-82.76964800946163,-19.884279840057324,0.03652851796872969,-0.3215511331624654,-0.3580796511311951,514729762,530011655.8,40.47145645630024,29.63967985509534,NaN,NaN,-10.287271437390865,-12.137051222260306
2015-09-30T09:30:00-04:00,46.95,47.35,46.8669,47.19,12715608,10102321.7,47.11221502709322,46.21273913792085,NaN,NaN,-8.604964880580575,-16.725901746991322,0.04935218397349378,-0.29638942116432787,-0.34574160513782165,527445370,530330251.6,40.900548874064235,31.7456992775121,NaN,NaN,-9.63770752148028,-11.780002122148874
2015-10-01T09:30:00-04:00,47.22,47.33,46.835,47.19,13766236,10308770,47.11221502709322,46.44753175257422,NaN,NaN,-16.215095100901728,-14.300284479406983,0.057954746572861426,-0.2732981719217449,-0.3312529184946063,527445370,529100825.4,39.71099676117039,33.61500408258916,NaN,NaN,-9.104174622615545,-11.39774105078697
2015-10-02T09:30:00-04:00,46.93,47.86,46.69,47.84,13196654,10587263.55,53.28117501104793,47.19238117318254,NaN,NaN,58.384401236618224,-17.711512429345767,0.10481003367856412,-0.20024037639640113,-0.30505041007496525,540642024,528059271.4,38.684505176991685,35.18259377872511,NaN,NaN,-6.8502069072161405,-10.748093315991136
2015-10-05T09:30:00-04:00,48.19,48.72,48.0401,48.66,10515836,10587699.75,59.67189220221608,48.05957371786643,NaN,NaN,228.31405521748226,35.821749692631315,0.18379527543300728,-0.07530631578370617,-0.25910159121671344,551157860,532284077.2,44.90553416000765,36.95983983508528,NaN,NaN,-2.798324110544742,-9.612412000927366
2015-10-06T09:30:00-04:00,48.56,48.73,48.31,48.33,9443980,10716533.95,56.332252787223375,48.39459617627886,NaN,NaN,177.26953928958076,87.82958715243979,0.20496919340994374,-0.0028900994542837566,-0.2078592928642275,541713880,537680900.8,51.65350418207722,38.69070035445315,NaN,NaN,-0.40677526791097934,-8.297321039067882
2015-10-07T09:30:00-04:00,48.56,48.86,48.4,48.77,11943952,10934360.05,59.58046573700511,48.96163384538998,NaN,NaN,171.40358187527062,123.83129650361002,0.2374705567528163,0.0889789030767929,-0.1484916536760234,553657832,542923393.2,57.14455481821238,40.54844006009613,NaN,NaN,2.6313781048035083,-6.736078304229112
2015-10-08T09:30:00-04:00,48.7,49.37,48.61,49.35,12447140,10807402.55,63.44092444715808,50.27072650234965,NaN,NaN,185.8268801859399,164.23969156097834,0.2837611977298635,0.206209843486306,-0.07755135424355752,566104972,550655313.6,63.693981946886794,42.84954690260775,NaN,NaN,6.483851177422138,-4.847516949707505
2015-10-09T09:30:00-04:00,49.44,49.61,49.3,49.46,12459529,11174013.35,64.14044720938033,51.42397352146317,NaN,NaN,180.1605110069442,188.59491351504354,0.30562700773071805,0.30448240541984006,-0.0011446023108779985,578564501,558239809,68.7406150641782,45.24031269578161,NaN,NaN,9.809323785373081,-2.7536825589817076
2015-10-12T09:30:00-04:00,49.48,49.695,49.43,49.59,5652597,11147638.4,64.99295326050216,52.903754047324036,NaN,NaN,158.12284869635218,174.55667221081754,0.31161733247526896,0.3883770632832082,0.07675973080793924,584217098,564851656.6,72.34901411859268,47.89227359910956,NaN,NaN,12.797499681390725,-0.5320850960713601
2015-10-13T09:30:00-04:00,49.5,49.57,49.2199,49.29,10162638,11291544.85,61.36725321694255,54.07410481573255,NaN,NaN,119.8394924632494,163.07066284555125,0.27919135352276236,0.4257489227113922,0.14655756918862983,574054460,571319772.6,75.34708599955994,50.8071624964217,NaN,NaN,14.326665820426543,1.5905936062854833
2015-10-14T09:30:00-04:00,49.2,49.395,48.61,48.72,10771192,11256569.2,55.080040744198854,54.74244799621395,NaN,NaN,73.80196511362776,143.55033949322268,0.20651950025845184,0.40470694451169464,0.1981874442532428,563283268,573244859.8,76.17506705020351,53.739680766750276,NaN,NaN,13.821453476184889,3.3378593019853984
2015-10-15T09:30:00-04:00,49.02,49.19,48.82,49.16,5255634,10866154.65,58.60558152432801,55.462649147676075,NaN,NaN,77.65756785019855,121.9164770260744,0.1764170320404675,0.41870873430382716,0.24229170226335967,568538902,573731645.8,76.39099170698545,56.24673596593376,NaN,NaN,14.433876801891074,4.92300465911478
2015-10-16T09:30:00-04:00,49.2,49.68,49.19,49.63,6921941,10663711.9,62.03340105121691,56.82536396580643,NaN,NaN,97.76093212606261,105.43656124989812,0.17608669060244792,0.46240006551641955,0.28631337491397163,575460843,573110914.2,75.45193591242634,58.68712801626123,NaN,NaN,16.001666675738996,6.505670661489668
2015-10-19T09:30:00-04:00,49.63,49.86,49.48,49.85,6284328,10489398.15,63.55474248039111,58.307539980414056,NaN,NaN,101.8220359916116,94.17639870894998,0.17807850535123892,0.5089115066030203,0.3308330012517814,581745171,572616528.8,74.66468898449521,61.12950176827515,NaN,NaN,17.75232556567838,8.112335647802341
2015-10-20T09:30:00-04:00,49.84,49.91,49.74,49.82,6078420,10259579.95,63.18294357259002,59.455449162235254,NaN,NaN,99.56381329756759,90.12126287581363,0.1650610955001423,0.5371593706269593,0.372098275126817,575666751,572938987,74.84901559924528,63.55439224864522,NaN,NaN,19.07145914172762,9.677924718363094
2015-10-21T09:30:00-04:00,49.73,50.17,49.73,49.83,14418907,10657601.35,63.260098126925705,60.60886938365186,NaN,NaN,98.0631481607121,94.97349948523048,0.14549508750911833,0.5539671345132149,0.40847204700409656,590085658,578299465,77.74740803495001,66.27127876820092,NaN,NaN,20.179329705693384,11.17812543083885
2015-10-22T09:30:00-04:00,50.03,50.89,49.948,50.82,13590342,10950112.95,69.9696406660731,61.800902644725106,NaN,NaN,131.35647909326457,105.7132817338437,0.18505992534784904,0.6397969536889079,0.45473702834105884,603676000,585326884.6,80.86122689343685,69.283901747947,NaN,NaN,23.303768067675243,12.91036009324405
2015-10-23T09:30:00-04:00,51,51.13,50.46,50.74,13360200,11005258.3,68.87503863436447,62.45827024702142,NaN,NaN,133.33821910939554,112.82873913051029,0.19090608833197265,0.6933696387560246,0.502463550424052,590315800,588297876,82.00751573299557,71.9340432888747,NaN,NaN,25.525388745718708,14.712507043597572
2015-10-26T09:30:00-04:00,50.74,50.84,50.56,50.64,8893020,10659111.15,67.45450262532134,63.25271666402842,NaN,NaN,119.49896366176888,116.36412466454173,0.17360010676457716,0.7194636838797734,0.5458635771151963,581422780,588233397.8,81.8928793947147,74.09399866120596,NaN,NaN,26.967671634112694,16.463244842242588
2015-10-27T09:30:00-04:00,50.48,50.71,50.32,50.71,5126177,10150216.55,67.95277131129225,63.85073849076321,NaN,NaN,106.22742239760703,117.69684648454964,0.15314335076439178,0.737292765570686,0.5841494148062942,586548957,590409839,82.76848940449506,75.92427970308329,NaN,NaN,28.30515482874192,18.15494626888535
2015-10-28T09:30:00-04:00,50.72,50.73,49.88,50.42,10430877,10035980,63.607979949798526,63.8626710266661,NaN,NaN,82.84536232785422,114.65328931797804,0.10846072369463111,0.7197253194245832,0.6112645957299521,576118080,587616323.4,77.58269795350509,76.91633084641316,NaN,NaN,28.286333745377192,19.602287336955612
2015-10-29T09:30:00-04:00,50.4,50.55,50.155,50.44,5606876,9628012,63.779979427008065,63.83692332792522,NaN,NaN,80.75430637896251,104.53285477511763,0.07047239897194457,0.6993550944448828,0.6288826954729382,581724956,583226114.6,70.14458255780032,77.01661423881475,NaN,NaN,28.315208517556922,20.8469903627558
2015-10-30T09:30:00-04:00,50.28,50.28,49.87,49.88,8577051,9397031.85,55.824144640282874,63.18200842648099,NaN,NaN,37.335734228214946,85.33235779888152,0.0014964781583051145,0.6307532931708195,0.6292568150125144,573147905,579792535.6,64.90359266181082,76.48479842047318,NaN,NaN,26.075191050896773,21.59387617534737
2015-11-02T09:30:00-05:00,49.91,50.19,49.84,50.18,13054043,9523942.2,58.78982124041883,62.99790614244358,NaN,NaN,38.02425146963222,69.03741536045418,-0.0284062557025353,0.5937489953843453,0.6221552510868806,586201948,580748369.2,65.67251262380648,75.79375746506221,NaN,NaN,24.95838613416096,22.074520455177883
2015-11-03T09:30:00-05:00,49.89,50.07,49.59,49.94,12452943,9674390.35,55.57544686726897,63.033292294091446,NaN,NaN,6.4680248161613765,49.08553584416505,-0.0666479170926666,0.5388453547210474,0.605493271813714,573749005,578188378.8,61.769218247853054,74.76476826489433,NaN,NaN,23.076937846909217,22.21772293971093
2015-11-04T09:30:00-05:00,50,50.09,49.54,49.73,8067588,9480572.15,52.85241997124302,62.622352183156806,NaN,NaN,-13.067676372282689,29.902928104137676,-0.10604513162579698,0.47293685728146784,0.5789819889072648,565681417,576101046.2,58.70539511289291,73.50151136531629,NaN,NaN,20.69089241057373,21.99960429269133
2015-11-05T09:30:00-05:00,49.68,49.8,49.435,49.72,9691771,9342803.7,52.71995246329736,61.95710585544827,NaN,NaN,-39.57157683913853,5.837751460517464,-0.1310961263262972,0.4151118309993933,0.5462079573256905,555989646,570953984.2,51.87282754731038,71.81728933923658,NaN,NaN,18.686151725661226,21.526253925972743
2015-11-06T09:30:00-05:00,49.49,49.58,48.82,49.18,13747249,9407189.7,46.013293106268954,60.704145185868114,NaN,NaN,-107.25284356013098,-23.079964097151723,-0.1793665410646148,0.321999780994922,0.5013663220595368,542242397,564772882.6,45.086380599410525,69.70455302601624,NaN,NaN,14.855700214565385,20.573317681485978
2015-11-09T09:30:00-05:00,48.94,49.02,48.575,48.85,7895965,9519358.1,42.45860256979363,59.223835114239805,NaN,NaN,-147.6274545469645,-60.210305300471056,-0.22584950151313415,0.21905444516811912,0.44490394668125327,534346432,554401779.4,36.46587188016128,66.96289990322452,NaN,NaN,10.455681399312661,19.12794106974693
2015-11-10T09:30:00-05:00,48.8,49.06,48.8,48.98,7438649,9383158.65,44.284631218954225,57.868444620813264,NaN,NaN,-120.5637907871624,-85.61666842113581,-0.23890452459066497,0.14627329094292207,0.38517781553358704,541785081,548008994.6,32.358821489280274,63.72085800710526,NaN,NaN,7.299821081504698,17.438209642855185
2015-11-11T09:30:00-05:00,48.9,49.22,48.9,48.91,7264720,9207835.05,43.48442796214544,55.97664371338986,NaN,NaN,-113.79100081684898,-105.76133331004908,-0.24254221927526987,0.08200004143949968,0.32454226071476955,534520361,541776783.4,28.937166663773795,60.01199656212932,NaN,NaN,4.449879619552147,15.582733925240465
2015-11-12T09:30:00-05:00,48.79,48.835,48.25,48.25,8473552,9368730.95,36.74299244787894,53.68149755721232,NaN,NaN,-175.72586781865215,-132.9921915059518,-0.27718623987422975,-0.021940539128017633,0.2552457007462121,526046809,535788216,26.083075973614612,56.017393722173544,NaN,NaN,-0.3211706020452493,13.310747564199648
2015-11-13T09:30:00-05:00,48.11,48.33,47.79,47.83,9112391,9478253.45,33.21415341300499,51.235758327761154,NaN,NaN,-192.24044197595828,-149.98971118911726,-0.3135003252317038,-0.1366297057934176,0.17687061943828616,516934418,530726620.2,23.934342872359565,51.87749825629104,NaN,NaN,-5.597198691785004,10.60961238477327
2015-11-16T09:30:00-05:00,47.67,48.66,47.67,48.65,9735265,9650800.3,44.434618766071466,49.55589028881682,NaN,NaN,-128.79367014705065,-146.2229543091345,-0.26910909667496097,-0.15951575140541507,0.10959334526954591,526669683,529191270.4,23.30712709928433,47.63025809163313,NaN,NaN,-6.655305999040631,8.143195472799855
2015-11-17T09:30:00-05:00,48.78,49.03,48.49,48.63,8056342,9749696.4,44.23939332046389,48.17241981529291,NaN,NaN,-79.98422532497291,-138.1070412166966,-0.22945388597285135,-0.1772240121965183,0.05222987377633307,518613341,524556922.4,21.47756756479346,43.62274877815373,NaN,NaN,-7.537729425165404,5.903063344519104
2015-11-18T09:30:00-05:00,48.77,49.33,48.7,49.3,7826236,9420062.85,51.868502479393314,47.32160003332042,NaN,NaN,-40.129357956888235,-123.37471264470443,-0.15028875132817873,-0.13563106538389036,0.01465768594428838,526439577,522940765.6,20.862526329135022,40.102601904677634,NaN,NaN,-5.75106603002744,4.238187719583884
2015-11-19T09:30:00-05:00,49.33,49.65,49.32,49.429,7421069,9111599.2,53.19628294454281,47.133895626481845,NaN,NaN,-3.929152614323511,-89.0153696038387,-0.08469234662377596,-0.09120774733543158,-0.0065154007116556105,533860646,524503533,23.154107943838426,37.12049585339389,NaN,NaN,-3.903105454763926,3.0751458375341967
2015-11-20T09:30:00-05:00,49.65,49.88,49.04,49.08,5487155,8717946.95,49.23875184660366,46.45167638406648,NaN,NaN,-10.546536657316679,-52.67658854011039,-0.061351043218866565,-0.08320420473523882,-0.021853161516372253,528373491,526791347.6,26.509147167917035,34.32311260654465,NaN,NaN,-3.5945415907036224,2.1223333477859367
2015-11-23T09:30:00-05:00,49.09,49.6,49.09,49.51,5316647,8539128.3,53.799321704745466,46.32481030102908,NaN,NaN,3.218285801290623,-26.274197350442126,-0.015864216833798867,-0.041683432558620837,-0.02581921572482197,533690138,528195438.6,28.57032162528921,31.951762847790082,NaN,NaN,-1.8557616764555016,1.5540340586085883
2015-11-24T09:30:00-05:00,49.39,49.77,49.17,49.64,9786017,8772120.3,55.11234760516253,46.4862337034519,NaN,NaN,25.97684386876057,-5.081983511695428,0.022009358336503245,0.001692482195807088,-0.020316876140696157,543476155,533168001.4,35.47264113132026,30.292280420534894,NaN,NaN,-0.04505299317770634,1.3255930512105463
2015-11-25T09:30:00-05:00,49.64,49.89,49.6,49.77,5599005,8530526.7,56.44538938171046,46.75233634048141,NaN,NaN,61.08913489081244,15.161715057844697,0.053075535965347545,0.04602754381598828,-0.0070479921493592675,549075160,537695118,41.05701606412027,29.519722457449888,NaN,NaN,1.838554877941764,1.3988733121721488
2015-11-27T09:30:00-05:00,49.75,50.07,49.745,49.96,2712628,8385814.3,58.39032882241734,47.63641032020629,NaN,NaN,90.38465719814991,34.024477020339376,0.08195451827720543,0.09539515569714752,0.01344063741994209,551787788,541280546.4,45.10872340095559,29.52131837184596,NaN,NaN,3.9925730180541263,1.76940184158386
2015-11-30T09:30:00-05:00,49.97,50.07,49.41,49.42,10355176,8474720.55,51.36930452401073,48.2728890312218,NaN,NaN,54.83243274009403,47.10027089982152,0.06117503945260247,0.08990943673569518,0.02873439728309271,541432612,543892370.6,47.91730452821979,30.339277846707287,NaN,NaN,3.792644357357173,2.058436486694333
2015-12-01T09:30:00-05:00,49.52,49.87,49.52,49.84,10807852,8362411,55.81904673166187,49.09677585355807,NaN,NaN,75.16713124317175,61.490039988197736,0.07148542082398064,0.11809117331306851,0.04660575248908787,552240464,547602435.8,51.6979946889605,31.720647360970162,NaN,NaN,5.014031822638625,2.480664391829232
2015-12-02T09:30:00-05:00,49.77,49.91,49.52,49.59,7832017,8131364.7,52.72641628965443,49.75691787695156,NaN,NaN,67.60000149773253,69.81467151399212,0.05782107253502714,0.1188820931578718,0.06106102062284465,544408447,547788894.2,51.88702217846704,33.35992275487683,NaN,NaN,5.081462105844552,2.852206922402849
2015-12-03T09:30:00-05:00,49.77,49.95,49.14,49.33,12556022,8355786.4,49.645742964039755,50.6785429138202,NaN,NaN,41.30012515580378,65.8568695669904,0.029076173320760054,0.09740623727379472,0.06833006395303466,531852425,544344347.2,48.139083569620716,34.935351868877255,NaN,NaN,4.200227917663858,3.0447813502972787
2015-12-04T09:30:00-05:00,49.46,50.48,49.26,50.44,12783219,8510358.8,60.30810726967987,52.61382533215412,NaN,NaN,123.61356297626155,72.50265072261273,0.079749861010532,0.16801739021619966,0.08826752920566766,544635644,542913918.4,46.632674709262545,36.5566612857989,NaN,NaN,7.067114369554968,3.619400353048377
2015-12-07T09:30:00-05:00,50.63,50.74,50.38,50.58,9022022,8274097.45,61.41777842161025,53.826908164692604,NaN,NaN,169.1683965862922,95.36984349185236,0.11546028196693654,0.23259288166433834,0.11713259969740179,553657666,545358929.2,49.53935369906721,38.430391757211964,NaN,NaN,9.679373888325397,4.4851108580879515
2015-12-08T09:30:00-05:00,50.26,50.56,50.15,50.45,6436418,8201120.1,59.74741262076019,54.93462382899948,NaN,NaN,131.85465845518434,106.70734893425488,0.12242609137772217,0.2701652139195545,0.14773912254183233,547221248,544355086,48.37440433730387,40.35159438381985,NaN,NaN,11.244171820744473,5.450690995610311
2015-12-09T09:30:00-05:00,50.17,50.71,49.77,49.97,18821804,8770277.85,53.916679147664375,55.08092216244741,NaN,NaN,92.69906634034027,111.72716190277643,0.08839495974492875,0.25823282222299326,0.1698378624780645,528399444,541153285.4,44.75905164326142,42.05848904911459,NaN,NaN,10.729294819968135,6.204777256232857
2015-12-10T09:30:00-05:00,50.08,50.35,49.88,50.03,7842722,8799177.95,54.51422927258435,55.17506118587895,NaN,NaN,77.69281264160328,119.00569939993632,0.06471177633053798,0.250727582891237,0.186015806560699,536242166,542031233.6,45.951871864124264,43.68690075770644,NaN,NaN,10.498738249972549,6.818200255338527
2015-12-11T09:30:00-05:00,49.53,49.83,49.34,49.48,11597861,8955393.4,48.328006220399104,55.11000792686434,NaN,NaN,0.9908504962831803,94.48115690394064,0.009679731838677291,0.19811547135904561,0.18843573952036832,524644305,538032965.8,41.5515104069368,44.76135527477927,NaN,NaN,8.33984947695864,7.035578715569972
2015-12-14T09:30:00-05:00,49.48,50.01,49.29,49.97,16609549,9330251.3,53.40148501189714,55.081591020232324,NaN,NaN,21.980861440708797,65.04364987482397,0.004232007563732293,0.1937257489750337,0.1894937414113014,541253854,535552203.4,39.05269524727165,45.510096247778016,NaN,NaN,8.102296096366207,7.187966912826577
2015-12-15T09:30:00-05:00,50.36,50.53,50.095,50.29,11557471,9421361.6,56.41145123130877,55.17438413638562,NaN,NaN,111.75774090474431,61.024266364735965,0.019289704850975975,0.21360587247502139,0.1943161676240454,552811325,536670218.8,40.78113673389613,45.88927450510487,NaN,NaN,8.859787665029994,7.426798448855637
2015-12-16T09:30:00-05:00,50.51,51.365,50.5005,51.26,20860446,10061566.8,64.0020170595675,55.71414325623255,NaN,NaN,212.6718109834468,85.01881529335728,0.08784797008613024,0.3041261302317082,0.21627816014557796,573671771,545724684.2,52.524000116944286,46.7083447945923,NaN,NaN,12.206548326269683,8.109619859914787
2015-12-17T09:30:00-05:00,51.26,51.26,50.59,50.6,10235953,10182052.65,56.7593867135868,55.597647391316094,NaN,NaN,149.08213700647565,99.29668016633175,0.08212240196557422,0.3189311626025457,0.2368087606369715,563435818,551163414.6,57.92151047538173,47.62354387133702,NaN,NaN,12.466295867035551,8.732002146646325
2015-12-18T09:30:00-05:00,50.18,50.18,49.34,49.34,14720588,10547028.6,46.04641866631459,55.2174412586235,NaN,NaN,-54.818195570698755,88.13487095293536,-0.008340461899748741,0.22638318326228557,0.2347236451620343,548715230,555977599.6,62.035874315252165,48.632013141839344,NaN,NaN,8.551261405355568,8.706182040747645
2015-12-21T09:30:00-05:00,49.67,49.91,49.47,49.9,8155480,10680444.85,50.51668186763997,54.83870091119337,NaN,NaN,-36.07730403087539,76.52323785861851,-0.031005650549138564,0.19596658197561112,0.22697223252474968,556870710,559100970.8,64.46360983064969,49.54384279481714,NaN,NaN,7.143269411001316,8.48290880792674
2015-12-22T09:30:00-05:00,49.98,50.61,49.865,50.55,7185807,10773902.85,55.16058127480741,55.012569838704295,NaN,NaN,60.3778771012179,66.24726509791324,-0.004174165297972404,0.22175452590228417,0.22592869120025658,564056517,561350009.2,66.14256822333607,50.56209608373636,NaN,NaN,7.728886214726469,8.375191294612415
2015-12-23T09:30:00-05:00,50.77,50.99,50.68,50.92,6464116,10607807.8,57.599875420191395,55.58072215700084,NaN,NaN,135.37892828177294,50.788688557578475,0.03441489334846548,0.2689473078858384,0.23453241453737295,570520633,560719781.6,65.21277888361159,51.78164574902142,NaN,NaN,9.049337271864763,8.471497862791322
2015-12-24T09:30:00-05:00,50.81,51.02,50.81,50.87,2312094,10443462.25,57.147442743294945,55.354960405116216,NaN,NaN,122.44604861858267,45.46147087999987,0.051468611690589305,0.2988681791506096,0.2473995674600203,568208539,561674325.8,65.99253901281656,53.16449319927528,NaN,NaN,9.912292711603273,8.677325698335887
2015-12-28T09:30:00-05:00,50.65,50.805,50.6,50.8,4620852,10538873.45,56.4785923250228,55.002161398217105,NaN,NaN,85.158708655512,73.45685172524202,0.05273675118998089,0.3133205064474964,0.26058375525751554,563587687,564648817.2,68.37167281797731,54.509658850625996,NaN,NaN,10.388895449198174,8.921835662744785
2015-12-29T09:30:00-05:00,51.13,51.29,50.91,51.24,4133999,10227814.6,59.67352549092242,54.99688374608583,NaN,NaN,129.6942994889974,106.61117242921657,0.07647112854368043,0.35617266593711605,0.2797015373934356,567721686,566819012.4,70.01965333883804,56.0557480650213,NaN,NaN,11.776055936662326,9.329581416161577
2015-12-30T09:30:00-05:00,51.21,51.27,51,51.06,6942853,10034564.65,57.80404229466917,55.27455254230046,NaN,NaN,111.58494748509413,116.85258650599182,0.07330146852359587,0.3713283730479304,0.29802690452433456,560778833,566163475.6,68.85263051440258,57.776717984388526,NaN,NaN,12.360459750109461,9.76256403529699
2015-12-31T09:30:00-05:00,50.89,50.9,50.43,50.49,6801446,9983036.1,52.22446958948709,55.11099827922209,NaN,NaN,35.695779202883806,96.91595669021399,0.028379080148295155,0.33350075470970353,0.3051216745614084,553977387,562854826.4,63.13316693226542,59.0039533463986,NaN,NaN,11.17343318600489,9.964116771112405
2016-01-04T09:30:00-05:00,49.83,49.85,49.35,49.85,17281160,10219293,46.76609158221662,54.999432947923346,NaN,NaN,-103.98725883009082,51.62929520047929,-0.04489012177732199,0.24900902233975586,0.29389914411707785,536696227,556552364,53.941360299891215,59.88894262446678,NaN,NaN,8.410869195186354,9.742224260265827
2016-01-05T09:30:00-05:00,49.97,50.29,49.84,50.17,8630450,10011654.55,49.60240407873832,54.72807002412628,NaN,NaN,-41.77421691451721,26.242710086473455,-0.07071839369785443,0.20550115199475982,0.27621954569261425,545326677,552900162,49.44847419272867,60.631498263428,NaN,NaN,6.989636325655877,9.348997412464406
2016-01-06T09:30:00-05:00,49.67,50.2,49.64,50,12429050,10182005.95,48.13512916211413,54.13690416204095,NaN,NaN,-59.07926446370982,-11.512002704067982,-0.09656712282803304,0.15551064215757293,0.25207776498560597,532897627,545935350.2,42.22547824377699,60.73466551413377,NaN,NaN,5.390416004836767,8.783485782803314
2016-01-07T09:30:00-05:00,49.44,49.925,49.22,49.4,16031520,10661761.05,43.270117816807435,52.65605421612952,NaN,NaN,-108.16220148591016,-55.46143249826885,-0.14829514048204162,0.06670883938305394,0.21500397986509556,516866107,537152805,35.23597298922634,59.49980643358249,NaN,NaN,2.4856901499869237,7.883800692400973
2016-01-08T09:30:00-05:00,49.72,49.72,48.92,49.02,14691022,10455221.95,40.47965915921011,51.493216533674044,NaN,NaN,-129.8719898804557,-88.57498631493675,-0.19915424599366852,-0.033938827626990076,0.16521541836667844,502175085,526792344.6,29.113700985735406,57.44210575575061,NaN,NaN,-0.8221562388049167,6.64009255937156
2016-01-11T09:30:00-05:00,49.32,49.66,49,49.48,15890335,10857602.6,45.09553479226168,51.425296256955974,NaN,NaN,-98.79872373586471,-87.53727929609151,-0.19274186543825095,-0.07571191343113526,0.11702995200711569,518065420,523066183.2,27.277983259009304,54.95939925173326,NaN,NaN,-2.244537445423671,5.37085970154367
2016-01-12T09:30:00-05:00,49.78,49.9489,49.35,49.75,13171504,10936284.75,47.661217354051594,51.22133450598538,NaN,NaN,-64.70236997097564,-92.1229099073832,-0.16245503296009384,-0.08603883919300159,0.07641619376709223,531236924,520248232.6,25.945601658068284,52.20811295369173,NaN,NaN,-2.6583684385595494,4.223827110100353
2016-01-13T09:30:00-05:00,49.81,49.85,48.79,48.84,19407943,11076204.45,40.74958323792777,50.19197750335113,NaN,NaN,-117.15701508054151,-103.73846003074955,-0.1937264177703334,-0.16574182844582452,0.027984589324508875,511828981,516034503.4,24.053628796930923,49.20176013751993,NaN,NaN,-5.261411000579325,2.8687930942889706
2016-01-14T09:30:00-05:00,48.98,49.41,48.75,49.07,19025815,11449621.65,42.99949476649428,49.14909317094419,NaN,NaN,-111.25151960817723,-104.35632365520296,-0.18874832448576456,-0.20795081628269685,-0.019202491796932272,530854796,518832241.2,27.817280852439055,46.53065313529333,NaN,NaN,-6.676255760510716,1.5052146864604439
2016-01-15T09:30:00-05:00,48.24,48.62,47.92,48.3,24210917,11617145.2,37.82151315179319,47.76866962869407,NaN,NaN,-172.285290498239,-112.83898377875963,-0.22469818868265157,-0.30007522765024675,-0.07537703896759516,506643879,519726000,29.02729870508348,43.8902788275981,NaN,NaN,-9.605532405784201,-0.08203489814593401
2016-01-19T09:30:00-05:00,48.79,49.06,48.57,48.88,14945175,11852606.3,43.35478877323655,46.831255089280766,NaN,NaN,-106.16847049504655,-114.31293313059598,-0.19775037365945405,-0.32256500604191274,-0.12481463238245868,521589054,520430726.8,30.023384198581454,41.15111535478412,NaN,NaN,-10.277319722720673,-1.538504158799468
2016-01-20T09:30:00-05:00,48.34,48.56,47.385,48.27,28303167,12531735.25,39.385065349695964,45.38207936490744,NaN,NaN,-158.3800008405759,-133.04845930451603,-0.20828446766497663,-0.3851702169636795,-0.17688574929870285,493285887,512840519.4,25.820166723069363,37.994009167943496,NaN,NaN,-12.14970538759906,-3.054390048627981
2016-01-21T09:30:00-05:00,48.31,48.67,48.01,48.46,21000998,13174011.15,41.191296103372586,44.195454636957685,NaN,NaN,-114.55181715832506,-132.52741972007274,-0.1902304280023676,-0.41467378430166235,-0.22444335629929474,514286885,513332100.2,26.53748837851974,34.971499015380445,NaN,NaN,-13.079813104111052,-4.486593342268419
2016-01-22T09:30:00-05:00,49.01,49.39,48.63,49.29,13754517,13502446.65,48.421805597811755,43.92383578040945,NaN,NaN,-49.56725357706515,-120.19056651385031,-0.11392744412437578,-0.3668526614547645,-0.2529252173303887,528041402,512769421.4,26.224886182112627,32.335193247512386,NaN,NaN,-11.520448052257578,-5.491429729409727
2016-01-25T09:30:00-05:00,48.49,49.27,48.41,48.85,15869448,13972713.25,45.24591225312903,43.81525154261748,NaN,NaN,-65.30407212689684,-98.7943228395819,-0.08590384833946485,-0.36030502775471973,-0.2744011794152549,512171954,513875036.4,28.019113449354208,30.483604186759738,NaN,NaN,-11.25188900753806,-6.314352483428061
2016-01-26T09:30:00-05:00,49,49.62,48.95,49.29,10524137,14383315.4,48.858225515429105,43.76209593095253,NaN,NaN,-21.246466054342346,-81.80992195144105,-0.03325454447548448,-0.3159693600096105,-0.28271481553412603,522696091,514096443.8,28.394679003768317,28.979761673262573,NaN,NaN,-9.87253190598759,-6.822663829507993
2016-01-27T09:30:00-05:00,49.37,49.87,48.9451,49.25,17247388,15014642.2,48.54467863328401,43.79134946460753,NaN,NaN,-8.942083547944948,-51.92233849291487,0.0015130278268871145,-0.28082353075051714,-0.28233655857740425,505448703,516529007,32.55814257060531,28.289237696607454,NaN,NaN,-8.870959739408308,-7.115277530922324
2016-01-28T09:30:00-05:00,49.42,49.925,49.27,49.75,15649161,15590400.3,52.63638392107494,44.46036847205521,NaN,NaN,35.10202988647363,-21.991569083955127,0.05770819358744356,-0.21020131659309982,-0.2679095101805434,521097864,517891202.8,34.84285531857748,28.261157862989677,NaN,NaN,-6.762784366778687,-7.06492136461609
2016-01-29T09:30:00-05:00,50.09,50.83,49.86,50.76,20576334,16272074.35,59.621317046847594,45.8276297497436,NaN,NaN,151.2175884846707,18.165399328392045,0.1568033962594987,-0.07190526485616999,-0.2287086611156687,541674198,520617762,39.277052527045136,28.987111544511805,NaN,NaN,-2.5432277568397788,-6.41896513493376
2016-02-01T09:30:00-05:00,50.65,51.1361,50.5,50.93,18573126,16860658.35,60.67261236471808,46.9402781477762,NaN,NaN,193.7377372753711,69.97376120884564,0.22362855241974605,0.050827029409013846,-0.1728015230107322,560247324,530232836,51.747799469674064,30.734955559559285,NaN,NaN,1.1651563973227088,-5.3355192017542645
2016-02-02T09:30:00-05:00,50.56,50.56,50.155,50.28,14068583,16700029.5,54.79791212761602,47.45004206017365,NaN,NaN,114.72282502092926,97.16761942389996,0.21388420445497255,0.0945537325579835,-0.11933047189698906,546178741,534929366,56.45230465753021,32.914005773806565,NaN,NaN,2.523317222215822,-4.212828284044252
2016-02-03T09:30:00-05:00,50.47,50.56,49.7,50.17,25209773,17528995.65,53.847692222668,48.38562127336938,NaN,NaN,91.41718503118564,117.23947313972607,0.1906324426197858,0.11896008137774317,-0.07167236124204261,520968968,538033419,59.278226962610084,35.43004849992651,NaN,NaN,3.328143068656321,-3.135546662229885
2016-02-04T09:30:00-05:00,49.95,50.005,49.47,49.71,21240798,17969583.05,49.94718606523099,48.881884937564855,NaN,NaN,43.972438098895424,119.01355478221043,0.13736271899593835,0.10003103750288034,-0.037331681493058017,499728170,533759480.2,54.07497099506137,37.3055977958281,NaN,NaN,2.839431883813456,-2.281978298509408
2016-02-05T09:30:00-05:00,49.8,49.945,49.37,49.63,20073263,18171670.2,49.27864290426685,49.700251348455836,NaN,NaN,32.92107759971352,95.35425260521899,0.0920084402324225,0.0776788687974701,-0.014329571434952393,479654907,521355622,42.43362290272341,38.26319238137381,NaN,NaN,2.249285700757622,-1.6346548700426893
2016-02-08T09:30:00-05:00,49.3,49.64,48.885,49.5,21546933,18514465.75,48.150771151173565,50.04282151830848,NaN,NaN,-4.898290506569456,55.62704704883089,0.05059236615931839,0.0489108862641956,-0.001681479895122795,458107974,500927752,30.708516493571025,38.312130402444495,NaN,NaN,1.4436094935144637,-1.1949028181059531
2016-02-09T09:30:00-05:00,49.11,50.1,49.07,49.83,24376347,18938766.35,51.203875068338185,50.88702221249721,NaN,NaN,32.0715007193428,39.09678218851359,0.04305659665006125,0.05213926591745377,0.00908266926739252,482484321,488188868,25.9019764455182,38.317973954047986,NaN,NaN,1.5931525055280034,-0.7966092004439593
2016-02-10T09:30:00-05:00,50.01,50.3,49.705,49.77,14798708,19020126.55,50.62023455340302,51.560517816070806,NaN,NaN,59.84893278302426,32.78313173888132,0.032164359578684125,0.04928811874074768,0.017123759162063552,467685613,477532197,22.70092831265991,38.0439339493437,NaN,NaN,1.5611139518480108,-0.45979160725939217
2016-02-11T09:30:00-05:00,49.18,49.6,48.88,49.37,26010413,19350250.05,46.791110965180515,51.44403962802573,NaN,NaN,-15.332548598127442,20.922134399476757,-0.002031972048862147,0.01458379410098587,0.016615766149848017,441675200,465921603,19.826087029572903,37.58687686701944,NaN,NaN,0.4800921022825021,-0.3255225058962644
2016-02-12T09:30:00-05:00,49.67,50.08,49.44,50.07,12464006,19022159.6,53.43011761680499,52.02862572543115,NaN,NaN,47.43610532005462,23.825139943544958,0.021161831016552876,0.04306805492053911,0.021906223903986236,454139206,460818462.8,18.704862671549748,36.92157324003341,NaN,NaN,1.4242648954168953,-0.07555287713724163
2016-02-16T09:30:00-05:00,50.5,50.54,50.09,50.47,15217653,18572496.4,56.75091565898377,52.59238930711361,NaN,NaN,97.63082179554715,44.330962403968286,0.05991726995441996,0.09680281134701119,0.036885541392591224,469356859,463068239.8,20.830551982522934,36.381278452801595,NaN,NaN,3.222900911786861,0.39565480699477296
2016-02-17T09:30:00-05:00,50.69,51.1399,50.536,50.99,11040533,18377264.3,60.67660858255467,53.45895573206152,NaN,NaN,145.00889134257906,66.91844052861553,0.11391637270859419,0.17928100727833396,0.06536463456973977,480397392,462650854,20.72229499145648,35.53586076857668,NaN,NaN,5.991819018602781,1.1951068372244884
2016-02-18T09:30:00-05:00,50.82,50.915,50.49,50.76,13101903,17617201.1,58.16190274688059,53.8536356481905,NaN,NaN,113.77860618097984,77.70437520820664,0.12651630010875567,0.22351000970568435,0.09699370959692868,467295489,462572829.2,20.700636980913842,34.52570231588642,NaN,NaN,7.555927863961999,2.103795555329847
2016-02-19T09:30:00-05:00,50.62,50.94,50.34,50.84,9794968,17056899.6,58.801481929846,53.795075996976095,NaN,NaN,101.48367241041257,101.06761940991466,0.13200263696152878,0.26199700579883967,0.1299943688373109,477090457,469655880.6,28.052061099430333,33.723917213913936,NaN,NaN,9.021166840192219,3.0919914531673287
2016-02-22T09:30:00-05:00,51.13,51.24,50.95,51.09,9151997,16826773.6,60.817300551278485,53.8054108674447,NaN,NaN,131.20700933453392,117.82180021281052,0.14329085236677058,0.3091079342957741,0.16581708192900352,486242454,476076530.2,34.02293666414208,32.45785558494736,NaN,NaN,10.84201257741747,4.199137328060206
2016-02-23T09:30:00-05:00,50.99,51.175,50.87,51.08,9986502,16532626.3,60.68938384707269,54.22623027597732,NaN,NaN,113.01930066846646,120.89949598739437,0.14070464451329712,0.3416978875706249,0.2009932430573278,476255952,477456348.8,35.266243108304934,30.944565474288417,NaN,NaN,12.310332193139764,5.357879451643
2016-02-24T09:30:00-05:00,50.84,51.3,50.58,51.24,13271668,16670002.85,62.06422874283567,54.81312574170357,NaN,NaN,101.70353714557301,112.23842514799317,0.14008609874522743,0.3761008664888621,0.23601476774363467,489527620,479282394.4,36.95933411340713,29.350358842202493,NaN,NaN,13.93672276775576,6.583428496801965
2016-02-25T09:30:00-05:00,51.37,51.8475,51.25,51.82,9511955,16283231.2,66.62148601730077,56.00414716685141,NaN,NaN,155.85744946117794,120.65419380403277,0.16721740489147563,0.4450365238579792,0.2778191189665036,499039575,485631211.6,42.58224953531153,28.529450166506074,NaN,NaN,16.74144853342873,8.034574216320074
2016-02-26T09:30:00-05:00,51.96,51.96,50.99,51.09,28143926,16907969.45,57.29254599544686,56.57656881622142,NaN,NaN,108.92069050341034,122.14159742263232,0.1263372508216163,0.43574068249352393,0.30940343167190765,470895649,484392250,41.79872340609115,28.484100202460915,NaN,NaN,16.49468296870887,9.243161180947045
2016-02-29T09:30:00-05:00,51.06,51.46,50.91,50.92,13596765,16558991,55.34881112144523,57.09071452838367,NaN,NaN,72.5668255734634,110.41356067041822,0.0804217799047045,0.40993065655278826,0.32950887664808376,457298884,478603536,38.25677545015048,29.0232615565023,NaN,NaN,15.71162751441029,10.167227800013222
2016-03-01T09:30:00-05:00,51.21,51.5,51.13,51.41,13169709,16288820.15,59.60302741211985,57.690653981510934,NaN,NaN,93.55487248823307,106.52067503437154,0.0756935954111333,0.4241258709120004,0.3484322755008671,470468593,477446064.2,37.571212440210616,29.856778413266046,NaN,NaN,16.31109701045334,11.044923401504668
2016-03-02T09:30:00-05:00,51.47,51.56,51.15,51.56,16157730,16393277.5,60.83325066188423,58.42015513211673,NaN,NaN,90.68684379261005,104.31733636377896,0.07515813664831106,0.4423799463112559,0.3672218096629448,486626323,476865804.8,37.211206870550185,30.893226881686783,NaN,NaN,17.166001961986773,11.919363195859255
2016-03-03T09:30:00-05:00,51.35,51.82,51.17,51.82,10743936,15669985.65,62.939974442404655,59.573645380489886,NaN,NaN,98.25795015595747,92.79743650273487,0.08412730920365918,0.4723809461675188,0.3882536369638596,497370259,476531941.6,36.99157875918249,32.11933343380175,NaN,NaN,18.505568233939364,12.8602496298707
2016-03-04T09:30:00-05:00,51.8,52.1699,51.6,52.04,17384650,15477178.25,64.67157744971031,60.37660679712597,NaN,NaN,121.37861888847635,95.28902217974806,0.09583917198014014,0.5080526019390348,0.41221342995889465,514754909,485303793.6,46.008299239602,34.069578902948344,NaN,NaN,20.13765527785295,13.899879008153878
2016-03-07T09:30:00-05:00,51.82,52,51.63,51.72,14095858,15178308,60.261042779010054,60.627330162842135,NaN,NaN,99.18788520749234,100.61323410655385,0.07397616933205453,0.5046836416239628,0.4307074722919083,500659051,493975827,53.146751305966305,36.377878854622864,NaN,NaN,20.27065062701392,14.809989239419599
2016-03-08T09:30:00-05:00,51.575,52.15,51.4901,51.87,11554949,14678708.8,61.58361749858356,60.69211651398705,NaN,NaN,100.3269960096979,101.96765881084681,0.062040881555354865,0.5082585742361019,0.446217692680747,512214000,502324908.4,58.79517824989324,39.09737051593977,NaN,NaN,20.75422946393365,15.659166414350178
2016-03-09T09:30:00-05:00,52.03,52.33,52.02,52.26,11307512,14025267.05,64.85840587473433,61.1704381659766,NaN,NaN,134.53875373367757,110.73804079906031,0.07212859623321627,0.5363784379722674,0.4642498417390511,523521512,509703946.2,63.036547284766506,42.12136410907211,NaN,NaN,22.128225650738674,16.58331773383425
2016-03-10T09:30:00-05:00,52.45,52.57,51.83,52.28,13089841,13939823.7,65.02306982706921,61.61483730149255,NaN,NaN,125.01946740346605,116.09034424856205,0.0717141562470967,0.553892537047922,0.48217838080082526,536611353,517552165,66.93492233822579,44.89871134041464,NaN,NaN,23.299148513386534,17.54272213091315
2016-03-11T09:30:00-05:00,52.54,52.65,52.26,52.45,12880525,13283329.3,66.46161286472862,62.018002466738984,NaN,NaN,145.0360390219439,120.82182827525553,0.07414809331133343,0.574863497439992,0.5007154041286586,549491878,524499558.8,69.95563625891074,47.46533274004098,NaN,NaN,24.69479971187682,18.564447499622243
2016-03-14T09:30:00-04:00,52.42,52.54,52.26,52.42,10645085,13192383.25,65.94616148333004,62.39348658361451,NaN,NaN,127.33045771233498,126.45034277622408,0.06530721565888808,0.5823494237022686,0.5170422080433805,538846793,532137107.2,72.8880030891914,50.152601310104295,NaN,NaN,25.72667901174771,19.58762342992588
2016-03-15T09:30:00-04:00,52.27,52.62,52.18,52.55,6523735,12757687.35,67.13561935439168,62.75572877015422,NaN,NaN,120.36996863447185,130.45893730117888,0.05992493384292552,0.5919483753470374,0.5320234415041118,545370528,538768412.8,75.15534974646225,52.880888141036806,NaN,NaN,26.927791726406287,20.636218900851652
2016-03-16T09:30:00-04:00,52.51,52.7861,52.1541,52.67,13743414,12892831.4,68.23844615161744,62.87122592260541,NaN,NaN,118.19690120757103,127.19056679595755,0.05621782331575975,0.6022957206488115,0.5460778973330518,559113942,545886898.8,77.3455472073239,55.36398083189483,NaN,NaN,28.252158150471608,21.72421022222593
2016-03-17T09:30:00-04:00,52.65,53.155,52.6,52.99,13903391,12932905.8,71.03022138549804,63.85248845046622,NaN,NaN,148.652534042849,131.91718012383416,0.06639041153099823,0.6290659117467996,0.5626755002158014,573017333,553168094.8,79.3507337351197,58.0462672839683,NaN,NaN,30.20651968673343,22.935968717155575
2016-03-18T09:30:00-04:00,52.81,52.86,52.57,52.65,13037040,13095009.4,64.53916103533162,64.50894201574381,NaN,NaN,108.93139354361587,124.69625102816853,0.042458286842937065,0.6157483587694728,0.5732900719265357,559980293,555265777.8,79.90263593059966,61.02097160400039,NaN,NaN,30.155104890170787,23.967273884729178
2016-03-21T09:30:00-04:00,52.67,52.865,52.435,52.68,11421420,13208480.55,64.84443765841706,64.8833284619079,NaN,NaN,94.02383835122883,118.0349271559473,0.021920314935681695,0.6006904655961378,0.5787701506604561,571401713,561776761.8,81.55089074495751,64.16237719719659,NaN,NaN,30.193383907223748,24.856718173656972
2016-03-22T09:30:00-04:00,52.51,52.65,52.29,52.37,9853229,13201816.9,59.17538182854086,64.76490925952622,NaN,NaN,58.407329199639236,105.64239926898078,-0.017161599869242372,0.5573181508239031,0.5744797506931455,561548484,565012353,82.32659672790045,67.38490504415019,NaN,NaN,28.640597885913266,25.397272418265015
2016-03-23T09:30:00-04:00,52.26,52.94,52.24,52.38,11304315,13103449.25,59.2989953914108,64.50483932731238,NaN,NaN,63.43933368150328,94.69088576376724,-0.045356993093476516,0.5177835093262999,0.5631405024197764,572852799,567760124.4,82.981031852436,70.66986597938258,NaN,NaN,27.38446329252969,25.681156828874254
2016-03-24T09:30:00-04:00,52.2,52.37,52.15,52.32,9455483,13100625.65,58.16107378851931,64.03980335151302,NaN,NaN,25.582302595363466,70.07683947427014,-0.06961473509961613,0.4761220835452562,0.5457368186448723,563397316,565836121,80.72692377029466,73.14976773157491,NaN,NaN,26.016288616323692,25.729032798509888
2016-03-28T09:30:00-04:00,52.38,52.71,52.38,52.6,7363677,12061613.2,61.841110863720495,64.15266535756378,NaN,NaN,63.36059855070797,60.96268047568856,-0.06827613092634388,0.46039165498694246,0.5286677859132863,570760993,567992261,81.33870137220227,75.16347845059177,NaN,NaN,25.754799009870162,25.73271368584707
2016-03-29T09:30:00-04:00,52.57,53.01,52.5,52.99,10354692,11899509.55,66.28882451889453,64.48875157330026,NaN,NaN,104.59894106347605,63.07770101813801,-0.04378884656097837,0.4739317277120634,0.5177205742730417,581115685,569935055.4,81.89632833871923,76.81356059979362,NaN,NaN,26.787371985920107,25.883379157286075
2016-03-30T09:30:00-04:00,53.17,53.34,53.04,53.34,8932310,11687639.6,69.70189094980358,64.83471479294806,NaN,NaN,169.15159993715028,85.22655516564022,-0.008528984739245571,0.5070593433489847,0.5155883280882303,590047995,575634957.6,83.45808357858269,78.27224176363764,NaN,NaN,28.731953578791263,26.290318360358246
2016-03-31T09:30:00-04:00,53.25,53.34,53,53.06,8297414,11294623.8,64.10985079179059,64.76948486185674,NaN,NaN,145.00018010379708,101.53872445009897,-0.008551149211890263,0.5048993915733675,0.5134505407852578,581750581,577414514,83.92436016771758,79.48577303717275,NaN,NaN,28.71773469791655,26.637092122866576
2016-04-01T09:30:00-04:00,52.84,53.77,52.77,53.62,14840290,11499441.5,69.39785995030923,64.97921679654107,NaN,NaN,177.4057325789077,131.9034104468078,0.022940085064470428,0.5421256471158458,0.5191855620513753,596590871,584053225,85.55964141416987,80.60034483397699,NaN,NaN,30.42709067942307,27.17852048808893
2016-04-04T09:30:00-04:00,53.69,53.748,53.36,53.64,12949022,11277660.1,69.57030123115626,65.2380839213858,NaN,NaN,181.27845990714894,155.48698271809602,0.038018661067463544,0.5667088883857048,0.5286902273182412,609539893,591809005,87.19806505706589,81.62249211739659,NaN,NaN,31.829007395791898,27.842875760617925
2016-04-05T09:30:00-04:00,53.42,53.54,53.16,53.28,11748798,11160307.1,62.7193883553706,64.92263885002714,NaN,NaN,117.75363647028244,158.1179217994573,0.01768229249082265,0.5507930929317695,0.5331108004409468,597791095,595144087,87.83713701484297,82.52833406513807,NaN,NaN,30.89327215674943,28.278646674351
2016-04-06T09:30:00-04:00,53.14,53.71,53.14,53.7,11672409,11166180.1,66.8240671444585,64.82161177808722,NaN,NaN,131.702464369475,150.62809468592224,0.025952065054625884,0.5655508817592292,0.5395988167046033,609463504,599027188.8,88.55360970164733,83.32890995758974,NaN,NaN,31.400486302071208,28.724623764025313
2016-04-07T09:30:00-04:00,53.34,53.53,52.95,53.12,11243439,11162976.45,57.42173023063991,63.84957669559736,NaN,NaN,67.50822171712035,135.1297030085869,-0.012158716274216608,0.5244004213618325,0.5365591376360491,598220065,602321085.6,89.13811048931329,84.02800829717499,NaN,NaN,28.604601254652056,28.707477691257704
2016-04-08T09:30:00-04:00,53.35,53.47,53.24,53.41,7040184,10860493.6,60.42040225637254,63.555379639957415,NaN,NaN,87.45449712962169,117.13945591872971,-0.02179302041477227,0.5093178621175838,0.531110882532356,605260249,604054961.2,89.44368800643603,84.7095120168776,NaN,NaN,27.32582488598349,28.510098719075675
2016-04-11T09:30:00-04:00,53.47,53.64,52.99,53.03,6694269,10551180.8,54.958474970713375,62.849239447978576,NaN,NaN,54.346398850191335,91.75304370733821,-0.0557819382478012,0.4613834597226045,0.5171653979704057,598565980,601860178.6,86.14014567783917,85.03731594065485,NaN,NaN,24.397243370639526,27.922547955013368
2016-04-12T09:30:00-04:00,53.04,53.42,53.04,53.36,9361144,10486983.75,58.469578737915846,62.798824941505366,NaN,NaN,57.26390498262134,79.65509740980599,-0.057816421247835814,0.4448948714106109,0.5027112926584467,607927124,603887384.4,86.63129170981773,85.34479415364896,NaN,NaN,23.148624219881697,27.240558849994557
2016-04-13T09:30:00-04:00,53.49,53.55,52.71,52.95,14779973,10899795.65,52.94717710304533,62.345123635193545,NaN,NaN,15.816400057647991,56.47788454744059,-0.08680912850013006,0.39419988203328415,0.4810090105334142,593147151,600624113.8,81.61740313609987,85.24739210248208,NaN,NaN,20.225671963049333,26.238432151859524
2016-04-14T09:30:00-04:00,52.92,53.05,52.67,52.71,11811284,10803189.15,49.9718448157102,61.76017870856432,NaN,NaN,-38.68628726997541,35.238982750021435,-0.1201320244112607,0.33084398001933835,0.45097600443059904,581335867,597247274.2,76.67224594955846,84.95777225814378,NaN,NaN,16.871003424566315,24.900228047960493
2016-04-15T09:30:00-04:00,52.7,53.06,52.64,53.035,12384193,10727229.25,53.7611250609939,61.18303686551241,NaN,NaN,-18.127395964102348,14.122604131276626,-0.11809137217610888,0.303361789210463,0.42145316138657185,593720060,594939236.4,73.39881239676771,84.39063733132703,NaN,NaN,15.307225397011601,23.529799097824938
2016-04-18T09:30:00-04:00,52.95,53.34,52.9099,53.34,8476819,10499218.2,57.04900976735392,60.52305009754523,NaN,NaN,35.41381830510295,10.336088022258949,-0.0949997065825518,0.3027035281583821,0.3977032347409339,602196879,595665416.2,73.77814027727747,83.81076675550977,NaN,NaN,15.069517519176987,22.321187443732374
2016-04-19T09:30:00-04:00,53.23,53.355,53.07,53.31,5980137,10227154.05,56.622523900257356,59.58880959400621,NaN,NaN,41.49934167667402,7.183175361069485,-0.08108657074058934,0.29634502131519724,0.3774315920557866,596216742,593323339.8,70.29646088929273,82.8706508491319,NaN,NaN,14.752194331187232,21.23990271336878
2016-04-20T09:30:00-04:00,53.22,53.22,52.58,52.59,20207310,10744858.1,47.45354239726721,58.39907328011168,NaN,NaN,-65.8653358922652,-9.153171828913157,-0.11750508443779595,0.23055023650854167,0.3480553209463376,576009432,589895796,65.43008975465787,81.54963153391337,NaN,NaN,11.423698560833955,19.837587834435237
2016-04-21T09:30:00-04:00,52.51,52.58,51.73,51.77,30667357,11713010.2,39.59052595968941,56.269977995067414,NaN,NaN,-218.27166396395884,-45.07024716770984,-0.18967533083881644,0.11096115739781709,0.3006364882366335,545342075,582697037.6,56.5721324173548,79.47909517699802,NaN,NaN,5.599724588996252,17.803607370801096
2016-04-22T09:30:00-04:00,51.6,51.96,51.54,51.96,22004991,12340485.6,41.98910769993103,54.29989274283704,NaN,NaN,-234.97948739674777,-88.44066545423892,-0.21558263819821327,0.03115819048886692,0.2467408286870802,567347066,577422438.8,51.1120876357719,76.90152536119129,NaN,NaN,1.8508236608566546,15.524638269380462
2016-04-25T09:30:00-04:00,51.67,52.32,51.66,52.32,8947330,12419668.25,46.336807578374966,53.12970840162307,NaN,NaN,-161.69558068165037,-127.86254525158958,-0.1997947684774654,-0.0030026319097515852,0.19679213656771383,576294396,572241942.2,46.37764368208663,73.94013298028014,NaN,NaN,0.22246560273242139,13.338613602716457
2016-04-26T09:30:00-04:00,52.45,52.48,52.015,52.11,10821827,12443025,44.25329053309219,51.51751007223976,NaN,NaN,-124.14928208780432,-160.99227000448525,-0.1946214914360595,-0.046484727727360564,0.14813676370869894,565472569,566093107.6,41.46785265358603,70.57686461970431,NaN,NaN,-1.7600621926483695,11.181659917664339
2016-04-27T09:30:00-04:00,52.3,52.52,51.91,52.36,12012219,12597020.45,47.29175989406677,50.79394076248453,NaN,NaN,-98.74560344715256,-167.56832351546274,-0.16657272007519164,-0.06007913638529061,0.10649358368990103,577484788,566388178.8,41.786344191172326,67.19459559840853,NaN,NaN,-2.431209844334809,9.236964237378746
2016-04-28T09:30:00-04:00,52.16,52.72,52.15,52.41,11547041,12759501.8,47.90334951202372,49.89986556645962,NaN,NaN,-65.99480309636574,-137.1129513419441,-0.13804027483027195,-0.0660567598479389,0.07198351498233305,589031829,575126129.6,50.39434137177683,64.40535655307573,NaN,NaN,-2.7852826057897033,7.519500402640396
2016-04-29T09:30:00-04:00,52.4,52.41,51.99,52.3,13198539,12677414.25,46.6216776489135,49.30438004347392,NaN,NaN,-83.01928116186721,-106.720910094968,-0.12059659459433007,-0.07876222826057955,0.041834366333750525,575833290,576823374.4,51.88266834608818,61.95839388652208,NaN,NaN,-3.444098247593567,5.953272024035544
2016-05-02T09:30:00-04:00,52.45,52.95,52.28,52.9,14096369,12734781.6,53.87144496780918,48.97594191703773,NaN,NaN,-11.253885325693629,-76.63257102377665,-0.06543215863941748,-0.03995583196552133,0.025476326673896155,589929659,579550427,54.25743716227647,59.64597570455486,NaN,NaN,-1.802410907429183,4.845317319540583
2016-05-03T09:30:00-04:00,52.71,53.01,52.65,52.8,12837332,12789208.3,52.589435910276165,48.95038897469707,NaN,NaN,9.177085140305866,-49.967297578154614,-0.034040126207253205,-0.017073831085170355,0.01696629512208285,577092327,581874378.6,56.23951268819605,57.8332692439903,NaN,NaN,-0.8411976007687354,4.03295804521068
2016-05-04T09:30:00-04:00,52.65,53.06,52.5,52.96,11003150,12755745.35,54.456930832159834,49.270752261586324,NaN,NaN,18.690252674172235,-26.480126353889652,-0.002523621042298564,0.013811768819209647,0.01633538986150821,588095477,583996516.4,58.028018532846374,56.50153871422515,NaN,NaN,0.5066112513167421,3.5291942175115465
2016-05-05T09:30:00-04:00,52.84,53.26,52.8038,52.97,10555852,12721366,54.57735714987478,49.32905455364925,NaN,NaN,49.48230715506611,-3.384704303603269,0.01785185621100848,0.038650210125268813,0.020798353914260333,598651329,585920416.4,59.63854770459988,55.51866266478459,NaN,NaN,1.6418557350040737,3.2595744342961934
2016-05-06T09:30:00-04:00,52.89,53.24,52.72,53.24,8435388,12791126.2,57.820381485260945,49.384152533499744,NaN,NaN,63.22987753589692,25.865127435949557,0.0467281414216063,0.07920853069126821,0.03248038926966191,607086717,592171101.8,64.41597439225006,54.84993653013977,NaN,NaN,3.5525587780176284,3.301429340542113
2016-05-09T09:30:00-04:00,53.27,53.675,53.15,53.53,9845154,12948670.45,61.03802337149722,49.69954535287403,NaN,NaN,125.23901493037319,53.163707487162924,0.08058867617519602,0.13321623448865694,0.052627558313460915,616931871,597571544.2,67.9461318230048,54.682055882547786,NaN,NaN,6.157258265122838,3.709404901196502
2016-05-10T09:30:00-04:00,53.7,54.06,53.64,54.06,8567408,12908983.65,66.12415658779149,51.03316065219719,NaN,NaN,186.92571196854644,88.71343285281104,0.1309307782195387,0.21629103108788428,0.08536025286834559,625499279,607252934.6,73.0985167386272,55.229800667117026,NaN,NaN,10.115224156427828,4.62452193765812
2016-05-11T09:30:00-04:00,53.98,54.04,53.61,53.63,6462128,12493091.4,59.3543456474055,52.444862058462625,NaN,NaN,146.31060931985533,114.23750418194766,0.12740081617206647,0.24461127308342867,0.1172104569113622,619037151,613441269.4,75.77859756001484,56.60169103444989,NaN,NaN,11.474864717367517,5.603142334759462
2016-05-12T09:30:00-04:00,53.75,54.025,53.64,53.92,11906398,12497847.1,62.167512657674656,53.88617669830145,NaN,NaN,138.99551894734276,132.14014654040298,0.13594828018879918,0.28714580714736115,0.15119752695856198,630943549,619899713.4,78.21761989231163,58.53780048134558,NaN,NaN,13.500701825309244,6.7313651191237165
2016-05-13T09:30:00-04:00,53.79,53.87,53.145,53.24,10657717,12411523.3,52.918696761982055,54.35631163998767,NaN,NaN,71.70832003130677,133.83583503948495,0.08940458116298938,0.2629532534122987,0.1735486722493093,620285832,622539536.4,79.14214300002828,60.87812186119856,NaN,NaN,12.244856466523293,7.5190067401807985
2016-05-16T09:30:00-04:00,53.14,53.695,53.1,53.58,8139327,12394648.7,56.41057038156106,55.22468877202117,NaN,NaN,73.13329498666593,123.4146910507435,0.0756609520169047,0.2681248622704402,0.1924639102535355,628425159,624838194,79.94053458896664,63.6261705708686,NaN,NaN,12.359213153671444,8.210464799250891
2016-05-17T09:30:00-04:00,53.38,53.55,52.39,52.53,19898173,13090550.5,45.249231091785504,55.078793857572514,NaN,NaN,-3.518166682646873,85.32591532050483,-0.005682764342241409,0.1853604548257337,0.19104321916797512,608526986,621443735.4,75.35351397806392,66.02382555564657,NaN,NaN,8.337353271592454,8.228591723871114
2016-05-18T09:30:00-04:00,52.24,52.4,51.72,51.92,20132506,13086810.3,40.26489203246273,54.53318975188959,NaN,NaN,-96.60505821265984,36.742781814001795,-0.09704000946034214,0.06974320734254746,0.1667832168028896,588394480,615315201.2,67.79036904854419,67.26639896112995,NaN,NaN,3.173343826662204,7.50641345284127
2016-05-19T09:30:00-04:00,52.08,52.45,51.95,52.43,13237265,12215305.7,45.65481399959428,54.46412806265249,NaN,NaN,-67.8806646138339,-4.632454898233536,-0.1181874853739647,0.019048860085433716,0.13723634545939842,601631745,609452840.4,61.43798840579623,67.94892182253766,NaN,NaN,0.9753199430981222,6.5734000943065345
2016-05-20T09:30:00-04:00,52.57,52.6,52.1,52.16,7050783,11467595.3,43.42107871422391,53.71767333025355,NaN,NaN,-72.2627492541365,-33.42666875532219,-0.14372865709927882,-0.04242447591470011,0.1013041811845787,594580962,604311866.4,56.442982385535764,68.10503219562762,NaN,NaN,-1.5221597420552069,5.416891546254857
2016-05-23T09:30:00-04:00,52.25,52.35,52.11,52.21,8546688,11447563.2,43.96780965226672,53.101842883252864,NaN,NaN,-82.00579526017273,-64.45448680468992,-0.1499355627082007,-0.08611527220067217,0.06382029050752852,603127650,599252364.6,51.96524102161583,67.79972707658617,NaN,NaN,-3.2718871825812914,4.175637442135407
2016-05-24T09:30:00-04:00,52.33,52.77,52.31,52.65,11258205,11469382.1,48.66858581516039,52.68838966775291,NaN,NaN,-39.61259499843693,-71.67337246784794,-0.11846812626876582,-0.08426486732842875,0.034203258940337065,614385855,600424138.4,52.897241436644784,67.43324299828606,NaN,NaN,-3.223856339425927,3.1185669019123594
2016-05-25T09:30:00-04:00,52.75,52.95,52.63,52.73,9815277,11359535,49.49817116053064,52.32559066851404,NaN,NaN,-17.809894209625824,-55.91433966724113,-0.08774106327328443,-0.07547307015126847,0.012267993122015954,624201132,607585468.8,58.23117235647228,67.33271618770551,NaN,NaN,-2.930994009578627,2.2543439145565043
2016-05-26T09:30:00-04:00,52.79,53.06,52.79,52.94,7956961,11180031,51.70463729185915,51.88875179755677,NaN,NaN,1.0836996466466113,-42.121466815145034,-0.05059253949766551,-0.05097268125006593,-0.0003801417524004237,632158093,613690738.4,62.16479712930145,67.17191781178062,NaN,NaN,-2.026887083028818,1.6427394863300298
2016-05-27T09:30:00-04:00,53,53.085,52.834,53,7873341,10913771.1,52.3452753912842,51.26784122754155,NaN,NaN,2.0930830761112453,-27.25030034909553,-0.020823894452076795,-0.026410009817496416,-0.0055861153654196225,640031434,622780832.8,67.12852602223464,67.11351739743989,NaN,NaN,-1.1062898372399388,1.25002101153432
2016-05-31T09:30:00-04:00,53.08,53.16,52.54,52.66,8766367,10647271,48.42522768469284,50.003632020177356,NaN,NaN,-27.71639085683965,-16.392419468428916,-0.022720939645476716,-0.03398728992226552,-0.011266350276788802,631265067,628408316.2,69.77243031510883,66.87593979576,NaN,NaN,-1.4296027974214056,0.8672176102549306
2016-06-01T09:30:00-04:00,52.7,53.2,52.7,53.2,10175759,10514192.35,54.28130993642038,49.641272326535564,NaN,NaN,9.377433527309249,-6.594413763279675,0.011845350006414096,0.0035403372312288184,-0.008305012775185278,641440826,633819310.4,72.09641906600689,66.612927046188,NaN,NaN,0.056676315468694206,0.7514259967140398
2016-06-02T09:30:00-04:00,53.09,53.22,52.905,53.22,6309847,10279527.2,54.487430878775655,49.09269505661421,NaN,NaN,20.10341185364657,0.9882474493748056,0.03424194637159694,0.0344974201893109,0.00025547381771395816,647750673,638529218.6,73.9722249448192,66.30968454993855,NaN,NaN,1.3143019960457496,0.8318368537614269
2016-06-03T09:30:00-04:00,53.32,53.58,53.11,53.56,13362517,10419860.45,57.95759117602746,49.45261608618888,NaN,NaN,61.61501922642393,13.094511365330272,0.06818035626016235,0.08548091914291689,0.017300562882754545,661113190,644320238,76.09967340681526,66.09236529328048,NaN,NaN,3.424574163861121,1.2022278980613832
2016-06-06T09:30:00-04:00,53.65,53.76,53.355,53.62,10778063,10536994.2,58.55809382151844,49.606010617614416,NaN,NaN,77.63749766892971,28.203394283893964,0.08954950104384643,0.12923743918756259,0.039687938143716156,671891253,650692201.8,78.21014409613598,65.96876597236401,NaN,NaN,5.331556431024258,1.7921319741989366
2016-06-07T09:30:00-04:00,53.66,53.765,53.47,53.56,5572792,10323376.1,57.67100011076494,50.493279833255805,NaN,NaN,78.09604545502904,49.3658815462677,0.09405804700152072,0.15726049689561705,0.06320244989409633,666318461,657702880.6,80.27402839263031,66.32023128769018,NaN,NaN,6.687367686998731,2.491451361741764
2016-06-08T09:30:00-04:00,53.55,53.9,53.44,53.88,6024492,10196230.3,61.05921310461244,51.978588481266506,NaN,NaN,101.28631546321004,67.74765793344787,0.11179868576562293,0.202950807101125,0.09115212133550207,672342953,663883306,81.90151076811915,67.32816998194554,NaN,NaN,8.836588115704586,3.3978994694507385
2016-06-09T09:30:00-04:00,53.78,54.12,53.77,54.09,5946840,10170465.9,63.144150967384164,53.22782683610864,NaN,NaN,132.25451933243204,90.17787942920495,0.12962819551417132,0.2531873657282162,0.1235591702140449,678289793,669991130,83.36241270991978,68.89420028938292,NaN,NaN,11.275323701734475,4.523245788348415
2016-06-10T09:30:00-04:00,53.82,54.22,53.76,54.13,10563935,10103342.75,63.544534695149494,54.66521654903189,NaN,NaN,134.36904160580644,104.72868390508147,0.13543430378350005,0.29285204994341996,0.1574177461599199,688853728,675539237.6,84.58001573279486,70.90398838561572,NaN,NaN,13.418854534788746,5.794047037839891
2016-06-13T09:30:00-04:00,54.13,54.22,53.68,53.68,9118622,10026388,56.15381891234792,55.535645781894836,NaN,NaN,102.15478516630955,109.63214140455743,0.101820673703516,0.2846935882893149,0.1828729145857989,679735106,677108008.2,84.91616062732992,73.25762550030959,NaN,NaN,13.314902368153689,6.868454942170434
2016-06-14T09:30:00-04:00,53.66,53.91,53.34,53.89,9530933,10095968.3,58.57518438755646,56.243259965637414,NaN,NaN,79.25466939246124,109.86386619204386,0.08714918555418327,0.291809396528528,0.20466021097434473,689266039,681697523.8,85.88555080662405,75.61393331245095,NaN,NaN,13.906785425504935,7.873930725503934
2016-06-15T09:30:00-04:00,53.88,54.03,53.66,53.73,9347642,9568441.75,56.036073654220594,56.71025300090098,NaN,NaN,81.01269902662746,105.80914290472735,0.06130820241410326,0.2812954639919738,0.21998726157787055,679918397,683212612.6,86.20083020703498,77.61176601606257,NaN,NaN,13.701311170399014,8.70641364620323
2016-06-16T09:30:00-04:00,53.56,54.04,53.48,54.01,12205722,9172102.55,59.3564148860594,57.256808543343844,NaN,NaN,77.3011785886276,94.81847475596646,0.0577610615243995,0.2921885884833699,0.23442752695897043,692124119,685979477.8,86.78152459022651,79.37010369184294,NaN,NaN,14.46051888507219,9.528428680327368
2016-06-17T09:30:00-04:00,53.61,53.69,53.12,53.47,10077549,9014116.75,51.30829812798426,57.18273873882242,NaN,NaN,19.32274640149661,71.8092157151045,0.015911082566984536,0.2543163801677011,0.23840529760071655,682046570,684618046.2,84.88858621168447,80.63867941966078,NaN,NaN,12.695710528372365,9.980897515762367
2016-06-20T09:30:00-04:00,53.81,53.98,53.565,53.64,6497515,8986453.35,53.44824273221281,57.541525527931,NaN,NaN,55.534756955887865,62.485210073020156,-0.0024782514563375657,0.2353074832802946,0.23778573473663217,688544085,686379842,85.33439996710767,81.75024868051784,NaN,NaN,11.862550912150747,10.249705143817849
2016-06-21T09:30:00-04:00,53.71,53.92,53.69,53.78,6879071,8903072.5,55.19463342960079,57.60676292030102,NaN,NaN,61.66868370674008,58.968012935875926,-0.0071077899449158155,0.2289009973054874,0.23600878725040322,695423156,687611265.4,85.65300011738574,82.71857589847347,NaN,NaN,11.674528619281773,10.45325135459841
2016-06-22T09:30:00-04:00,53.85,54,53.745,53.81,5408273,8610575.9,55.57919831322246,57.684746308475795,NaN,NaN,66.09918949729283,55.985311030008994,-0.009874010035239883,0.22366627470635336,0.23354028474159325,700831429,691793871.8,86.70914463895969,83.62835587662637,NaN,NaN,11.626848357964608,10.62090806936501
2016-06-23T09:30:00-04:00,54.02,54.14,53.87,54.14,5642533,8401938.7,59.678874919610955,57.80769514730319,NaN,NaN,99.22534420641352,60.37014415356619,0.007840475587562623,0.24334087922604652,0.2355004036384839,706473962,694663840.4,87.3948313720635,84.43515287414411,NaN,NaN,12.76205349343313,10.926785987089026
2016-06-24T09:30:00-04:00,53.15,53.78,52.88,53.1,23775904,9192885.85,45.44424494334472,56.87099165600507,NaN,NaN,-71.24116026716402,42.25736281983406,-0.049984821294027426,0.1730193770209496,0.22300419831497703,682698058,694794138,87.42654685560484,85.0934673569633,NaN,NaN,9.0285016682929,10.655602512975294
2016-06-27T09:30:00-04:00,53.02,53.11,52.65,52.985,19371970,9767817.3,44.189111198188876,55.90799959082106,NaN,NaN,-142.70064472099676,2.6102824844571386,-0.09298042823632122,0.1067786630195755,0.19975909125589672,663326088,689750538.6,79.12731395868306,85.01155918310994,NaN,NaN,5.6737793845468705,9.943913494628376
2016-06-28T09:30:00-04:00,53.44,53.44,52.84,53.32,11868598,9922928.85,48.6392553183186,55.02085974894293,NaN,NaN,-93.2458299152216,-28.372620239935202,-0.09549730213882224,0.08038746358236892,0.17588476572119116,675194686,685704844.6,73.13037589937291,84.38504954962805,NaN,NaN,4.292714192540847,9.136599308615871
2016-06-29T09:30:00-04:00,53.6,53.965,53.43,53.94,10820963,9955189.05,55.6823485956693,54.48787386524901,NaN,NaN,37.053802379727685,-34.18169766344822,-0.054105259829712704,0.10825319093405028,0.16235845076376298,686015649,682741688.6,69.00530168157474,83.35954161903199,NaN,NaN,5.4806643308175875,8.614322883216117
2016-06-30T09:30:00-04:00,54.01,55.15,54,55.15,20984760,10688934.7,65.59752030353548,54.63451569441943,NaN,NaN,264.9324409647707,-1.0402783117767966,0.05041393973275951,0.22537587542971238,0.17496193569695287,707000409,682846978,69.07205913865721,82.25183043373643,NaN,NaN,10.480354332345065,8.880898804520251
2016-07-01T09:30:00-04:00,55.25,55.265,54.87,54.89,14933906,10767504.15,62.368565834824786,55.07842618888207,NaN,NaN,265.4647413942792,66.30090202051186,0.09509407995621161,0.29382953564221737,0.19873545568600576,692066503,684720667,70.2980707155041,81.2076811543203,NaN,NaN,13.112496916264888,9.485412820483772
2016-07-05T09:30:00-04:00,54.82,55.55,54.82,55.2,19917077,11224454.85,64.60564585813898,55.50917343678082,NaN,NaN,231.54520322335395,141.150071609382,0.136085380012531,0.3688421807016695,0.2327568006891385,711983580,694452165.4,75.68848840732122,80.4793195543701,NaN,NaN,15.9784814404448,10.412994051906775
2016-07-06T09:30:00-04:00,55.19,55.34,54.9118,55.25,19540038,11922817.15,64.9673856561647,56.14712429406255,NaN,NaN,178.67854132178167,195.53494585678263,0.1557129961320582,0.42739804585421126,0.27168504972215307,731523618,705717951.8,80.1742304341515,80.04884814202127,NaN,NaN,18.29885392196491,11.539545461915079
2016-07-07T09:30:00-04:00,55.39,55.49,55.03,55.1408,15618144,12402499.75,63.442353837493954,56.43897707630787,NaN,NaN,151.76837501318553,218.47786038347422,0.150406683477796,0.45969340406939807,0.30928672059160206,715905474,711695916.8,82.06524281137605,79.7119708721034,NaN,NaN,19.677998372300166,12.702181591970092
2016-07-08T09:30:00-04:00,55.35,55.74,55.18,55.69,10227475,12616531.5,67.56595962803266,57.60023861202561,NaN,NaN,152.5844502380494,196.00826223812993,0.171425175597965,0.5235681900890583,0.3521430144910933,726132949,715522424.8,83.17170929747073,79.5893368068024,NaN,NaN,22.215742084070794,14.061261662270192
2016-07-11T09:30:00-04:00,55.7,55.87,55.42,55.7,8213936,12499031.55,67.63754010629785,58.61375985303169,NaN,NaN,135.9465337570693,170.10462071068795,0.17304052428475336,0.568443669847035,0.3954031455622816,734346885,723978501.2,85.32616405227394,79.58874852717142,NaN,NaN,24.238703303127842,15.515181896678428
2016-07-12T09:30:00-04:00,55.61,55.69,55.38,55.4,15270849,12806642.9,63.13585079742568,59.180989665019176,NaN,NaN,103.18762894505977,144.43310585502914,0.1422318091806365,0.5731929070380772,0.43096109785744074,719076036,725396992.4,85.65787014881424,79.58909638655918,NaN,NaN,24.609687760574662,16.814397020092176
2016-07-13T09:30:00-04:00,55.47,55.78,55.36,55.71,9398867,12800039.6,65.67791491173892,59.9023265649132,NaN,NaN,99.65732357686795,128.62886230604641,0.13131996267074475,0.5951110511958717,0.46379108852512696,728474903,724787249.4,84.77079399277467,79.45064276897452,NaN,NaN,25.686974097410854,18.0819080311377
2016-07-14T09:30:00-04:00,55.68,56.02,55.6,55.7,15486751,13106995.05,65.52095617277025,60.31961808299601,NaN,NaN,99.26849051312031,118.12888540603335,0.1127301477744484,0.6047037732431875,0.4919736254687391,712988152,724203785,83.87567272967357,79.19927429451809,NaN,NaN,26.511759087006425,19.286172467690374
2016-07-15T09:30:00-04:00,55.74,55.955,55.59,55.7,10722169,13032817.4,65.52095617277025,61.75366888509784,NaN,NaN,87.78936575654727,105.16986850973292,0.09068368168403729,0.6053282275737857,0.5146445458897484,712988152,721574825.6,79.78754080528898,78.65363100520982,NaN,NaN,27.188187671220565,20.4150317824804
2016-07-18T09:30:00-04:00,55.7,55.74,55.55,55.64,9656863,13011783.1,64.44917985531089,63.20081664632083,NaN,NaN,73.86691879412079,92.75394551714322,0.06359061949109146,0.5941328202536127,0.5305422007625212,703331289,715371706.4,70.99476243055413,78.07273446748631,NaN,NaN,27.478609991040276,21.42411438370324
2016-07-19T09:30:00-04:00,55.48,55.6,55.325,55.6,5295589,12951686.8,63.70107220413451,64.2766607095934,NaN,NaN,59.00906025820506,83.9182317797723,0.03588612911067668,0.5753998621508671,0.5395137330401905,698035700,711163639.2,65.70488138531152,77.54234200219624,NaN,NaN,27.534860411464944,22.297078101954913
2016-07-20T09:30:00-04:00,55.59,55.655,55.37,55.4,6073198,12911393.15,59.95377675648929,64.58176272108054,NaN,NaN,52.13288770987056,74.41334460637282,-0.0010418954051507612,0.538211363783752,0.5392532591889028,691962502,703861159,57.673856149717686,76.732953035635,NaN,NaN,26.61645833511528,22.914132420977822
2016-07-21T09:30:00-04:00,55.32,55.35,55.03,55.24,6682377,12975098.35,57.061821975493764,63.97206998336327,NaN,NaN,26.322331447984826,59.82411279334572,-0.039260143118632795,0.4901780802906117,0.5294382234092445,685280125,698319553.6,52.43600837879788,75.54466369564507,NaN,NaN,25.056244411981726,23.220148419692666
2016-07-22T09:30:00-04:00,55.35,55.53,55.28,55.5,10602378,13223090.6,60.40424652083944,63.831761460935745,NaN,NaN,43.59067952085681,50.984375546207616,-0.04939071342772705,0.4676998316245857,0.5170905450523128,695882503,694898423.8,49.45020881869624,74.05553070301593,NaN,NaN,24.532170926932046,23.40758020644115
2016-07-25T09:30:00-04:00,55.45,55.49,55.19,55.44,4033429,12235966.85,59.25787170985695,63.44977759320131,NaN,NaN,33.26438371091971,42.8638685295674,-0.06169449144794659,0.43997243074237957,0.5016669221903262,691849074,692601980.8,47.49518777589498,72.04172351505692,NaN,NaN,23.787741865190746,23.46188901483395
2016-07-26T09:30:00-04:00,55.37,55.54,54.97,55.01,11737796,11854258.15,51.687053358901096,62.501182429111054,NaN,NaN,-4.132157632233642,30.235624951479668,-0.09818733097163923,0.3789327584757771,0.47712008944741635,680111278,689017096.4,44.535193834578095,69.49607804365881,NaN,NaN,20.94730452731938,23.102662659474724
2016-07-27T09:30:00-04:00,54.94,54.94,54.035,54.19,21562376,12338947.05,40.944207852878066,60.89417200163849,NaN,NaN,-169.3343858211249,-14.057829754719439,-0.1725934907766703,0.26137822597657845,0.43397171675324875,658548902,682334376.4,39.58284719553805,66.46162121395611,NaN,NaN,14.583084242754484,21.88558002851469
2016-07-28T09:30:00-04:00,54.51,54.53,54.03,54.43,10873813,12341589.55,44.5751878673414,59.251974018731964,NaN,NaN,-204.14602872188587,-60.15150178869358,-0.198822392259365,0.1854437264290425,0.3842661186884075,669422715,679162894.4,37.45420836573527,63.19608543311786,NaN,NaN,10.474740719661757,20.255460127249982
2016-07-29T09:30:00-04:00,54.5,54.78,54.39,54.7,9262256,11755464.35,48.417568421946875,57.879118898421176,NaN,NaN,-136.51489394796826,-96.1726164824586,-0.19111207285316617,0.1453760276219498,0.33648810047511596,678684971,675723388,35.24081095070231,59.61856021157702,NaN,NaN,8.251815922135885,18.540653812233682
2016-08-01T09:30:00-04:00,54.66,54.87,54.5,54.76,14918234,11754680.75,49.25939752398663,56.8879436646041,NaN,NaN,-109.72626397437956,-124.77074601951844,-0.17549962131943214,0.11711357382582577,0.2926131951452579,693603205,676074214.2,35.658478451803774,56.04717509036199,NaN,NaN,6.721194705689712,16.852159654155972
2016-08-02T09:30:00-04:00,54.78,54.89,54.445,54.68,11733514,11345502.6,48.131486556462555,55.63462735351294,NaN,NaN,-103.4227209922379,-144.6288586915193,-0.16428717076320287,0.08725423169125435,0.2515414024544572,681869691,676425896.8,36.10336656747213,52.57093027426895,NaN,NaN,5.137293858922337,15.178607397694025
2016-08-03T09:30:00-04:00,54.77,54.77,54.23,54.38,13290826,11033042,44.05748339962365,54.101522155431034,NaN,NaN,-121.89937960910221,-135.14185744911475,-0.17008577310919035,0.03893418606796928,0.20901995917715963,668578865,678431889.4,38.70673343518242,49.34457746751958,NaN,NaN,2.5424543630532632,13.37344267845963
2016-08-04T09:30:00-04:00,54.47,54.72,54.33,54.5,8943229,10699296.25,46.02548527101953,52.70898851959169,NaN,NaN,-97.01330251572409,-113.7153122078824,-0.1590515228535687,0.010205555610198758,0.16925707846376745,677522094,680051765.2,40.80415484223741,46.560049898730185,NaN,NaN,0.9439966110549372,11.597807525973245
2016-08-05T09:30:00-04:00,54.72,54.87,54.48,54.59,12028548,10789349.9,47.51673473779681,51.49952815405498,NaN,NaN,-68.47164293589603,-100.10666200546795,-0.13959721964656244,-0.005239446094435607,0.13435777355212683,689550642,682224899.4,43.59282281092888,44.60276849732838,NaN,NaN,0.02588293690222169,9.944675441820241
2016-08-08T09:30:00-04:00,54.82,54.86,54.36,54.53,8057686,10781537.4,46.59252356824879,50.27748896577742,NaN,NaN,-69.01863206847763,-91.96513562428757,-0.12513969636544428,-0.022066846904678528,0.10307284946076575,681492956,679802849.6,41.25982582195159,42.856693099945524,NaN,NaN,-0.9932320771978728,8.382117224817653
2016-08-09T09:30:00-04:00,54.53,54.9,54.53,54.7,7840923,10410041.1,49.58458382029965,49.536832327478166,NaN,NaN,-45.76847378779131,-80.43428618339826,-0.09960866383924552,-0.02143798033829114,0.07817068350095438,689333879,681295687.2,43.27488923898228,41.82819546346442,NaN,NaN,-1.0640981883664,7.032657880077075
2016-08-10T09:30:00-04:00,54.85,55.01,54.79,54.9,7303642,10305279.85,52.92588912982198,49.24140855278733,NaN,NaN,-14.252202009465426,-58.9048506634709,-0.06633379095262966,-0.004746555189832691,0.06158723576279697,696637521,686907418.4,50.19195581587257,41.66790599468404,NaN,NaN,-0.19678400182417763,5.999880468376896
2016-08-11T09:30:00-04:00,55.18,55.18,54.88,54.9,8082993,9935091.95,52.92588912982198,48.707240167714644,NaN,NaN,5.400666315982361,-38.422056897129615,-0.04256189740806621,0.00838486400271421,0.05094676141078042,696637521,690730503.8,54.28206612395094,42.0130386593451,NaN,NaN,0.5217863300123468,5.217295591467675
2016-08-12T09:30:00-04:00,55,55.145,54.9601,55.09,8783845,9838175.75,56.12935289938172,48.48377453839499,NaN,NaN,26.8955964888807,-19.34860901217426,-0.01377008585365265,0.03373415409371461,0.04750423994736726,705421366,693904648.6,57.40921525680462,42.721183479410065,NaN,NaN,2.0303127468704085,4.76201232795378
2016-08-15T09:30:00-04:00,55.16,55.25,54.95,54.95,8568188,9783742,53.253636347539164,48.59567332329771,NaN,NaN,32.49120551966332,0.953358505453933,-0.004369645529301955,0.04204218303573981,0.046411828565041766,696853178,696976693,60.24357371071055,43.84321061341954,NaN,NaN,2.577234143526808,4.449901158749927
2016-08-16T09:30:00-04:00,54.87,54.88,54.7,54.71,6712120,9854568.55,48.65188060045381,49.146221376695976,NaN,NaN,-20.136849884408704,6.079683286130451,-0.013987934709678282,0.02892691017794391,0.04291484488762219,690141058,697138128.8,60.392740099160335,45.32963153510684,NaN,NaN,1.7919009292631696,4.070186840251819
2016-08-17T09:30:00-04:00,54.69,54.94,54.49,54.86,12551992,10178508.25,51.47423401627045,49.63901038733377,NaN,NaN,-13.740613664325139,6.182000955158506,-0.010101818255733606,0.030287572067955182,0.04038939032368879,702693050,698349234.6,61.55803574555931,47.05133349080855,NaN,NaN,1.9009997422115288,3.760302969103206
2016-08-18T09:30:00-04:00,54.95,55.1071,54.945,55.05,6683841,10178581.45,54.8588289461236,50.09910042477497,NaN,NaN,58.87797909092415,16.877463510146864,0.004620612019874966,0.046165155348532494,0.04154454332865753,709376891,700897108.6,63.96031172124468,49.10272640299015,NaN,NaN,2.9588712483155666,3.6458127232764004
2016-08-19T09:30:00-04:00,54.98,54.99,54.81,54.92,5846500,9940787.55,52.17725391435327,50.307518738372586,NaN,NaN,37.08804368654888,18.915952949680502,0.00493107601080079,0.047708388342158514,0.042777312331357724,703530391,700518913.6,63.3277052965753,51.07909974904526,NaN,NaN,3.116394493458103,3.570181547588072
2016-08-22T09:30:00-04:00,54.92,55.06,54.82,55,9938559,10236044.05,53.67784878843328,50.70368746922763,NaN,NaN,66.58590753080777,25.734893351909392,0.009582594187283536,0.05475555506546215,0.04517296087817861,713468950,703842068,66.46622522147335,53.24787536718815,NaN,NaN,3.6640064645558814,3.583585107154902
2016-08-23T09:30:00-04:00,55.03,55.13,54.87,54.89,5687354,9933521.95,51.29450248041318,51.22061740356975,NaN,NaN,75.22770611995342,44.80780455278182,0.004563963962127958,0.05087791583083856,0.0463139518687106,707781596,707370175.6,69.45506098803841,55.444184478106436,NaN,NaN,3.4872161043429695,3.5698181067531976
2016-08-24T09:30:00-04:00,54.87,54.98,54.58,54.8,7793780,9245092.15,49.36328745721507,51.459031845440855,NaN,NaN,5.903572383165125,48.73664176227987,-0.004986691970685117,0.04008058690535421,0.04506727887603933,699987816,706829128.8,68.44753761028026,57.418711818680926,NaN,NaN,2.8149429888610635,3.4619788041971784
2016-08-25T09:30:00-04:00,54.83,54.83,54.481,54.59,7359658,9069384.4,45.09683113436733,51.286181588053026,NaN,NaN,-64.90921531039022,23.979202882016995,-0.02452402662983618,0.0144122455887441,0.03893627221858028,692628158,703479382.2,62.41117399671652,58.76287976052289,NaN,NaN,1.0186598936576472,3.112933245548674
2016-08-26T09:30:00-04:00,54.64,54.86,54.16,54.31,13499833,9281263.25,40.11801502729759,50.8237166922708,NaN,NaN,-134.86705009584276,-10.41181587446133,-0.0537079799236342,-0.028198702685962473,0.025509277237671726,679128325,698598969,54.82495817292822,59.73181778559266,NaN,NaN,-2.0846840849027113,2.3704164840556188
2016-08-29T09:30:00-04:00,54.41,54.63,54.36,54.63,8202816,8945492.35,47.28143292455799,50.65920591400353,NaN,NaN,-88.36103048033699,-41.401203476690284,-0.04899536619486559,-0.035734930505910256,0.01326043568895533,687331141,693371407.2,48.08305976204655,60.07525853724011,NaN,NaN,-2.667074733278315,1.6507748815793426
2016-08-30T09:30:00-04:00,54.53,54.61,54.23,54.31,7950912,8756362.25,41.885434567814,49.87060201671726,NaN,NaN,-131.99163570916983,-82.84507184251494,-0.06401571843386436,-0.06675921235337512,-0.0027434939195107606,679380229,687691133.8,42.03434717241324,59.492572205564436,NaN,NaN,-4.918872077282786,0.7122538874561815
2016-08-31T09:30:00-04:00,54.26,54.44,54.19,54.38,8154863,8499564.1,43.40695226027959,49.19067795460709,NaN,NaN,-141.27454695403412,-112.28069570995478,-0.06558212610581188,-0.08472115155177562,-0.019139025445963735,687535092,685200589,39.67753312546824,58.44939127710138,NaN,NaN,-6.265246862269458,-0.28453193393319554
2016-09-01T09:30:00-04:00,54.16,54.45,54.11,54.4,16677600,8886282.65,43.859211201354924,48.31423926189088,NaN,NaN,-136.0482120533134,-126.50849505853941,-0.061675156550417984,-0.09623297113398621,-0.03455781458356823,704212692,687517495.8,42.8857546151062,57.412001231265776,NaN,NaN,-7.219113723394309,-1.275186475284783
2016-09-02T09:30:00-04:00,54.6,54.95,54.56,54.82,10966741,8833192.3,52.45243860333917,48.25701085159089,NaN,NaN,10.391609843612342,-97.4567630706484,-0.028874754301463565,-0.07065125746039769,-0.04177650315893412,715179433,694727717.4,51.525877810945914,56.789308666996874,NaN,NaN,-5.366276758583498,-1.8596279443274566
2016-09-06T09:30:00-04:00,54.83,54.96,54.56,54.9392,9273315,8893973.75,54.57744855460107,48.68026570545855,NaN,NaN,21.594904968298643,-75.46557598092127,0.0011854986444735371,-0.0402946298533422,-0.04148012849781574,724452748,702152038.8,58.489377672287965,56.65335420793456,NaN,NaN,-3.1788442047932937,-2.0480874101082907
2016-09-07T09:30:00-04:00,54.84,54.94,54.35,54.46,13418458,9172850.5,45.72929819815137,48.269913147021484,NaN,NaN,-55.3979567475027,-60.14684018858784,-0.010238721058539957,-0.054278529820990684,-0.04403980876245073,711034290,708482851,63.32719137071645,56.77972246687436,NaN,NaN,-4.123474835041612,-2.344571327955908
2016-09-08T09:30:00-04:00,54.25,54.41,54.06,54.16,13344386,9474887.7,41.22348579636353,47.29596006489576,NaN,NaN,-148.03887742030744,-61.499706281842506,-0.03560626658317414,-0.0885476419914184,-0.052941375408244264,697689904,710513813.4,64.74663330048458,56.83588829396295,NaN,NaN,-6.455067406809811,-2.9317850535064656
2016-09-09T09:30:00-04:00,53.69,53.79,52.69,52.69,24921562,10316816.15,27.121654553405094,45.50627439625661,NaN,NaN,-337.791483341519,-101.84836053948364,-0.1429689227341167,-0.23165252882589016,-0.08868360609177345,672768342,704224943.4,57.345047286139796,56.40855557893184,NaN,NaN,-15.209412204383273,-4.6857317893460095
2016-09-12T09:30:00-04:00,52.63,53.76,52.63,53.68,23542651,11054756.45,41.60874452342311,44.644195520184454,NaN,NaN,-216.05688232358813,-147.13805897292372,-0.13877908978655876,-0.2621574683249719,-0.12337837853841313,696310993,700451255.4,53.40021400125288,55.4752690632018,NaN,NaN,-15.661180128134813,-6.253652980601553
2016-09-13T09:30:00-04:00,53.4,53.46,52.91,53.02,21780467,11715370.4,36.41211262706918,43.58116767351702,NaN,NaN,-204.0217618569032,-192.26139233796408,-0.16987279545078213,-0.3357193728518908,-0.16584657740110867,674530526,690466811,44.64868381438565,53.70338497936946,NaN,NaN,-18.336503140952793,-7.979774432080301
2016-09-14T09:30:00-04:00,53.05,53.24,52.71,52.86,19396233,12349576.05,35.262347084436854,42.57395764689001,NaN,NaN,-184.99340287556828,-218.18048156357722,-0.18915554975890508,-0.40229101459974004,-0.21313546484083495,655134293,679286811.6,37.28099813423235,51.47720358822318,NaN,NaN,-20.681394400048287,-9.794291570361441
2016-09-15T09:30:00-04:00,52.74,53.345,52.69,53.29,10903004,12267126.65,40.68327614854239,42.25870371933108,NaN,NaN,-133.15774104532613,-215.20425428858098,-0.1619410493165479,-0.4155617764865198,-0.2536207271699719,666037297,672956290.2,33.87257840974708,49.438732474868225,NaN,NaN,-20.357899786820248,-11.303378458426984
2016-09-16T09:30:00-04:00,52.9,52.95,52.48,52.79,14475119,12656690.55,36.82216481781966,42.023285847225516,NaN,NaN,-143.05034886780018,-176.2560273938372,-0.1659909304228464,-0.4611093901985299,-0.2951184597756835,651562178,668715057.4,31.776493715770698,47.79241358507125,NaN,NaN,-21.574913624437777,-12.770740624999954
2016-09-19T09:30:00-04:00,52.8,52.99,52.68,52.68,9579434,12843337.25,36.01240559598739,41.21835532375618,NaN,NaN,-116.80003509938788,-156.40465794899714,-0.1641572029365898,-0.5003149634464208,-0.336157760509831,641982744,657849407.6,27.142470365526066,46.29665719960551,NaN,NaN,-22.772002743400556,-14.19949235620004
2016-09-20T09:30:00-04:00,52.93,53.02,52.81,52.82,9705899,12831704.25,37.88466261487539,40.93258589854628,NaN,NaN,-93.61839916661103,-134.32398541093872,-0.14240330716837957,-0.5141618944703055,-0.3717585873019259,651688643,653281031,25.46125653525145,45.112865011236806,NaN,NaN,-23.079495555871663,-15.468064241867413
2016-09-21T09:30:00-04:00,52.83,53.2399,52.55,53.11,24882717,13791472.4,41.6906103919406,40.80999005080779,NaN,NaN,-76.62833063348761,-112.65097096252259,-0.09940699548670306,-0.4960173316603047,-0.39661033617360164,676571360,657568444.4,29.852656142685404,44.411088083895166,NaN,NaN,-22.089948508792833,-16.414047708571044
2016-09-22T09:30:00-04:00,53.3,53.68,53.3,53.58,17315981,14267582.45,47.323900636483316,41.05746786760267,NaN,NaN,-23.473310249227243,-90.71408480330281,-0.033636538612967226,-0.43865600943981065,-0.4050194708268434,693887341,663138453.2,35.194349680154076,43.861702017112876,NaN,NaN,-19.384672475722414,-16.838422675306955
2016-09-23T09:30:00-04:00,53.59,53.6,53.32,53.34,12930969,14546148,44.93652276966017,40.5206167366256,NaN,NaN,-28.28057570983623,-67.76013017171002,-0.002273361606285218,-0.4078611728346999,-0.4055878112284147,680956372,669017292,40.35672497401158,43.06390538590328,NaN,NaN,-17.942224553234226,-16.996108657867993
2016-09-26T09:30:00-04:00,53.2,53.22,52.84,52.89,12797243,14511018.5,40.78222605251586,39.53524370076237,NaN,NaN,-64.38350234691833,-57.27682362121609,-0.007516638555125688,-0.4149836094223218,-0.40746697086719613,668159129,674252569,44.58982942259447,42.07108051092518,NaN,NaN,-18.049049654427193,-17.146528800233593
2016-09-27T09:30:00-04:00,52.89,53.26,52.8601,53.11,12608728,14731314.1,43.530782552677344,39.3782068689428,NaN,NaN,-51.000013969199216,-48.75314658173373,0.007345696280900649,-0.3982848505160703,-0.40563054679697097,680767857,680068411.8,48.92644814628218,41.042455994894155,NaN,NaN,-17.273782247985036,-17.164707864198085
2016-09-28T09:30:00-04:00,53.22,53.32,52.96,53.2,9757545,14821645.75,44.662343284730184,39.62383954668327,NaN,NaN,-38.66265913468939,-41.16001228197409,0.02571769229829801,-0.37348343142409846,-0.39920112372239647,690525402,682859220.2,50.91181503015574,40.05425468987067,NaN,NaN,-16.31027722166335,-17.04264634383598
2016-09-29T09:30:00-04:00,53.17,53.2,52.64,52.68,15093971,15168601.15,39.711006061167986,40.52307894009492,NaN,NaN,-70.30762324295561,-50.52687488071977,0.006338994809554077,-0.3912773802104539,-0.39761637502000796,675431431,679168038.2,48.24078250106656,39.40395006236543,NaN,NaN,-16.98744729507038,-17.034760765440893
2016-09-30T09:30:00-04:00,52.93,53.39,52.93,53.21,17343111,15201876.7,46.25141959253593,40.854698587888684,NaN,NaN,-26.25705986307292,-50.1221717113671,0.03130885648489595,-0.358480304413888,-0.38978916089878396,692774542,681531672.2,50.0480100712135,39.164506924505474,NaN,NaN,-15.482514351008517,-16.813011277664838
2016-10-03T09:30:00-04:00,53.12,53.16,52.77,52.87,11454239,15226251.6,43.02669319845107,41.32716862870168,NaN,NaN,-55.641798555019875,-48.37383095298741,0.027173847721733646,-0.3558218512466169,-0.38299569896835056,681320303,684163907,52.055675882206494,39.693577786492675,NaN,NaN,-15.246795365272295,-16.589266147323045
2016-10-04T09:30:00-04:00,52.83,52.87,52.315,52.42,13346553,15429913.5,39.137339946534475,41.60395383313722,NaN,NaN,-130.39014373716216,-64.25185690658,-0.0020686437007103597,-0.3855815035942385,-0.3835128598935281,667973750,681605085.6,49.95379942250326,40.598777878512024,NaN,NaN,-16.294553453753636,-16.547164333955987
2016-10-05T09:30:00-04:00,52.51,52.6,52.24,52.37,15203813,15519181.25,38.718545772634094,41.46361594914377,NaN,NaN,-168.02715005342483,-90.12475509032708,-0.0199832987354287,-0.408491983312814,-0.3885086845773853,652769937,674053992.6,44.27273195506005,41.34164598889152,NaN,NaN,-17.253110470483154,-16.648013782031295
2016-10-06T09:30:00-04:00,52.17,52.6,52.0935,52.47,15413338,15622628.85,40.099112066272056,41.69768360974751,NaN,NaN,-169.49000366412946,-109.96123117456186,-0.020240574006819778,-0.41380940208591,-0.3935688280790902,668183275,672604361.4,43.2556941449844,42.1615888766925,NaN,NaN,-17.63743589123651,-16.78935979763204
2016-10-07T09:30:00-04:00,52.49,52.6,51.96,52.33,11402972,14946699.35,38.78185804028021,41.89550164148271,NaN,NaN,-163.7832123657335,-137.46646167509397,-0.024687165881823347,-0.4244277854313694,-0.39974061954954604,656780303,665405513.6,38.52297489946051,42.974482057687815,NaN,NaN,-18.3306926723002,-17.009550208298922
2016-10-10T09:30:00-04:00,52.45,52.635,52.23,52.33,8661735,14202653.55,38.78185804028021,41.95958702901162,NaN,NaN,-120.44945585167694,-150.42799313442538,-0.022535702570480487,-0.42791024776264663,-0.40537454519216615,656780303,660497513.6,35.65842825440184,43.70285146619857,NaN,NaN,-18.899590994671215,-17.279556034923534
2016-10-11T09:30:00-04:00,52.29,52.33,51.87,52.06,19642620,14095761.2,36.12739591896382,41.56221456665613,NaN,NaN,-164.31088913142443,-157.21214221327784,-0.033540895161906614,-0.4473006641445494,-0.4137597689826428,637137683,654330300.2,32.39834962990284,43.88468671528552,NaN,NaN,-20.12595424833529,-17.686184351125213
2016-10-12T09:30:00-04:00,52.15,52.48,52.05,52.35,7145429,13483221,40.81327569427811,41.0971699279272,NaN,NaN,-103.15113763018863,-144.2369397286306,-0.016401176182967603,-0.4342612392113523,-0.4178600630283847,644283112,652632935.2,31.543582441699158,43.62391762682445,NaN,NaN,-19.908268934797118,-18.003625005935486
2016-10-13T09:30:00-04:00,51.99,52.51,51.93,52.36,19180711,13897106.35,40.97408306346999,40.81413852034218,NaN,NaN,-95.96560636456228,-129.53206026871717,-0.0003508285509900011,-0.41829859871712216,-0.41794777016613216,663463823,651689044.8,31.052947144865414,42.95936206759972,NaN,NaN,-19.685504026599872,-18.24389343745897
2016-10-14T09:30:00-04:00,52.38,52.62,52.2882,52.37,10659073,13706304.05,41.14628586048555,40.840142792340025,NaN,NaN,-58.76040196992322,-108.5274981895551,0.014176136089766533,-0.400227600053924,-0.4144037361436905,674122896,655157563.4,35.05081661672996,42.278004010037975,NaN,NaN,-19.454748047330778,-18.416872667440657
2016-10-17T09:30:00-04:00,52.39,52.46,52.09,52.12,8464992,13650581.95,38.1497860303142,40.45578589788551,NaN,NaN,-85.57604939454644,-101.55281689812901,0.010361843419037009,-0.4014514318698943,-0.4118132752889313,665657904,656933083.6,37.06263033555158,41.43058845212864,NaN,NaN,-20.029841068743156,-18.647296724769586
2016-10-18T09:30:00-04:00,52.36,52.58,52.27,52.28,7844949,13557534.45,41.10589281492166,40.20175372147062,NaN,NaN,-53.58569875801822,-79.40777882344777,0.02139318294739756,-0.3850717966046844,-0.40646497955208194,673502853,664206117.6,44.62874809879295,40.981797957031304,NaN,NaN,-19.7570853441629,-18.80583795611149
2016-10-19T09:30:00-04:00,52.18,52.27,51.9,51.98,9032026,12764999.9,37.487989042063674,40.042966791534596,NaN,NaN,-99.56787043615529,-78.6911253846411,0.01174631133649634,-0.3917820903814615,-0.40352840171795784,664470827,668243660.6,48.34147285540955,40.98899012519866,NaN,NaN,-20.49426747747793,-19.04704217344955
2016-10-20T09:30:00-04:00,51.95,52.13,51.82,51.95,12176293,12508015.5,37.13599711839818,39.39186518623904,NaN,NaN,-109.74643120358631,-81.4472903524459,0.006848439548765628,-0.3949678522820008,-0.40181629183076645,652294534,666009802.8,46.48435992784918,40.73444368638692,NaN,NaN,-21.20409382909613,-19.355192409970492
2016-10-21T09:30:00-04:00,52.13,52.295,52.01,52.23,14028243,12562879.2,42.55722230052771,39.358331550673086,NaN,NaN,-67.9589360096957,-83.2869971604004,0.024951770183699706,-0.37062657910114183,-0.39557834928484154,666322777,664449779,45.17904336335189,40.243255649325874,NaN,NaN,-20.368174882220426,-19.499904191720482
2016-10-24T09:30:00-04:00,52.29,52.69,52.29,52.57,7609480,12303491.05,48.37866005470107,40.01842584411356,NaN,NaN,8.57396510407329,-64.45699426067645,0.060294992081181,-0.3202096091833653,-0.38050460126454627,673932257,666104649.6,46.88300567903155,40.0239132390779,NaN,NaN,-17.94075347248451,-19.27716837468677
2016-10-25T09:30:00-04:00,52.79,52.89,52.715,52.76,9414617,12143785.5,51.3460350378507,40.9203893630576,NaN,NaN,79.97577829053743,-37.744698850965314,0.0948810196800412,-0.2619033266644948,-0.356784346344536,683346874,668073453.8,48.91728469934064,40.35566700652652,NaN,NaN,-14.998603867212005,-18.665944873618947
2016-10-26T09:30:00-04:00,52.8,52.8975,52.61,52.69,12417730,12276794.75,50.20108796961871,41.641959070439505,NaN,NaN,79.6657504608922,-1.897974671555815,0.11037055021547781,-0.2188211585751887,-0.3291917087906665,670929144,669365117.2,50.263105399896915,40.85619638187741,NaN,NaN,-12.853949201369364,-17.83565977758329
2016-10-27T09:30:00-04:00,52.67,52.88,52.375,52.45,17905674,12417379.9,46.38227468113347,42.1848459733576,NaN,NaN,41.11531073676554,28.27437371651456,0.10197821990767553,-0.2017189339060721,-0.3036971538137476,653023470,669510904.4,50.421871611602974,41.706117575601866,NaN,NaN,-12.031641222186067,-17.006514269669402
2016-10-28T09:30:00-04:00,52.41,52.85,52.32,52.67,12751016,12187775.15,50.127456737576864,42.99524588030736,NaN,NaN,74.1950419183214,56.70516930211797,0.10818083807914469,-0.16847110621481676,-0.27665194429396145,665774486,669401246.2,50.29182972720997,42.7513605379453,NaN,NaN,-10.243420045903571,-16.040357951988568
2016-10-31T09:30:00-04:00,52.71,52.93,52.6699,52.8,8579097,12044018.05,52.24993789808901,44.14685602167344,NaN,NaN,147.55587165252135,84.5015506118076,0.11721597995608732,-0.1301319693488523,-0.2473479493049396,674353583,669485511.4,50.397696083862925,44.0370281417996,NaN,NaN,-8.124275359801949,-14.909489010247622
2016-11-01T09:30:00-04:00,52.8,52.89,52.4,52.57,11342289,11943804.85,48.330925753487016,44.68383102590265,NaN,NaN,78.48553414767413,84.20350178323494,0.1043113378464352,-0.11695877699689561,-0.2212701148433308,663011294,665418395.4,45.37465726633994,45.024962057845364,NaN,NaN,-7.384194143988932,-13.83444688649638
2016-11-02T09:30:00-04:00,52.44,52.735,52.4,52.44,9703303,11668779.35,46.22070636653096,45.05858983326414,NaN,NaN,41.014451262162794,76.47324194348906,0.0844757665843324,-0.11567540661291531,-0.2001511731972477,653307991,661894164.8,41.513580101936,45.772150126207556,NaN,NaN,-7.352798537876261,-12.908497122407791
2016-11-03T09:30:00-04:00,52.6,52.61,52.01,52.08,15641594,11680192.15,40.895658324389856,45.04068786640016,NaN,NaN,-54.66173191926723,57.3178334122825,0.046465236588368763,-0.14206962746178675,-0.18853486405015552,637666397,658822750.2,38.44332228335267,46.014471959537744,NaN,NaN,-8.921192495540533,-12.338882175712468
2016-11-04T09:30:00-04:00,52,52.08,51.57,51.61,11992424,11709664.75,35.19474073719421,44.82961320260588,NaN,NaN,-180.0906125460284,6.460702519412541,-0.008070277335786441,-0.19862271071988857,-0.19055243338410213,625673973,650802647.6,31.824604845845272,45.64032728170158,NaN,NaN,-12.195231241021807,-12.318360613613802
2016-11-07T09:30:00-05:00,52.05,52.51,52.02,52.48,11763039,11864729.95,49.28731271863499,45.4140003385854,NaN,NaN,-9.054816195357686,-24.861435050163266,0.0154295740217463,-0.17126546585691926,-0.18669503987866556,637437012,643419333.4,27.184476329188414,44.39430786958697,NaN,NaN,-10.204490610414537,-12.016379184585336
2016-11-08T09:30:00-05:00,52.1,52.855,52.05,52.7,13406760,11552936.95,52.12260991746348,46.45933040111395,NaN,NaN,43.42333428284205,-31.8738750231297,0.04509193090000391,-0.1303301262536607,-0.1754220571536646,650843772,640985829,25.846834561110754,42.78754799142276,NaN,NaN,-7.637828765608355,-11.390871981874339
2016-11-09T09:30:00-05:00,51.62,52.1456,51.27,51.98,34557160,12923523.5,43.54254997082148,46.91694131914419,NaN,NaN,-152.26668493101172,-70.5301022617646,0.016970499468519362,-0.1542089328180154,-0.17117943228653476,616286612,633581553.2,22.258094756677153,41.0571004791962,NaN,NaN,-8.592122045454712,-10.991050562385821
2016-11-10T09:30:00-05:00,52,52,50.49,50.59,52820781,14605527,32.44020446802834,46.19429718825138,NaN,NaN,-266.21892684225134,-112.84154124636143,-0.08869103307230919,-0.28204322362692125,-0.19335219055461206,563465831,618741440,17.12568001569049,39.05328881150609,NaN,NaN,-14.313940569920891,-11.465749134890832
2016-11-11T09:30:00-05:00,50.45,50.705,50.2145,50.54,20828070,15113976.85,32.12291495740983,45.033172538444866,NaN,NaN,-273.97633047333755,-131.61868483182326,-0.151696432333501,-0.3829727309714883,-0.23127629863798732,542637761,602134197.6,13.401489958344328,36.66175197431416,NaN,NaN,-18.469501474639124,-12.4662851834263
2016-11-14T09:30:00-05:00,50.54,50.58,50.255,50.45,20591812,15720317.85,31.525209391164836,43.6173992779673,NaN,NaN,-212.09708698223972,-172.22713898919966,-0.18686990619926802,-0.46486368138707235,-0.2779937751878043,522045949,579055985,10.110960670280562,33.88987168652415,NaN,NaN,-21.780955854868917,-13.796952422203818
2016-11-15T09:30:00-05:00,50.55,50.84,50.465,50.76,23028687,16479504.75,35.94621454240982,42.59919403316667,NaN,NaN,-147.42022602757285,-210.39585105128262,-0.17680203695653474,-0.4989963213834727,-0.322194284426938,545074636,557902157.8,8.138426310903327,30.88096603731032,NaN,NaN,-22.910499135077643,-15.098887666900078
2016-11-16T09:30:00-05:00,50.77,50.99,50.69,50.77,16034236,16829615.25,36.08956038523565,41.86400015488825,NaN,NaN,-113.13372451170996,-202.5692589674223,-0.15764787620563298,-0.5192541296839792,-0.36160625347834624,561108872,546866609.8,7.334539934913536,27.803299488975362,NaN,NaN,-23.733553664354595,-16.33241138082215
2016-11-17T09:30:00-05:00,50.73,50.78,50.45,50.68,15626709,17002136.05,35.323382213146374,40.80656626028608,NaN,NaN,-111.210309190899,-171.5675354371518,-0.13982515170844445,-0.5363876931139018,-0.3965625414054573,545482163,543269876.2,7.088772507536561,24.717366830427263,NaN,NaN,-24.626546634641752,-17.517287845653524
2016-11-18T09:30:00-05:00,50.68,50.72,50.43,50.5,14786066,17040027.2,33.77881343402491,39.48720022713864,NaN,NaN,-103.22873249850483,-137.4180158421853,-0.12919614226880283,-0.5580577192414609,-0.42886157697265803,530696097,540881543.4,6.922886441500253,21.61202328454421,NaN,NaN,-25.826681082241688,-18.704344022308977
2016-11-21T09:30:00-05:00,50.57,50.86,50.34,50.84,18968738,17607990.1,39.187924429567744,38.83412870400156,NaN,NaN,-82.0947991328544,-111.41755827230823,-0.09015355497313032,-0.5415535206890709,-0.4513999657159406,549664835,546405320.6,12.049194306060613,19.231633073095686,NaN,NaN,-25.241609160860694,-19.63823904210208
2016-11-22T09:30:00-05:00,50.99,51.2,50.96,51.1,11991815,17736850,43.02079732111057,38.60556377218581,NaN,NaN,-44.31016122241062,-90.79554531127577,-0.04024849939807695,-0.5017105899635368,-0.46146209056545984,561656650,549721723.4,15.073467187706427,17.343053579222147,NaN,NaN,-23.594457346633423,-20.203413085606556
2016-11-23T09:30:00-05:00,50.9,51.07,50.75,50.82,14783646,17855145.8,40.09028783410071,38.54803730859373,NaN,NaN,-54.38522079267845,-79.04584456746946,-0.020520968613898738,-0.48711330133283326,-0.4665923327189345,546873004,546874549.8,14.60902284266001,15.640603619172667,NaN,NaN,-23.058542722955433,-20.611288748084966
2016-11-25T09:30:00-05:00,50.93,51.23,50.93,51.22,10823549,17501039.55,45.77313311769934,39.30363676434409,NaN,NaN,-29.963892558337406,-62.796561240957146,0.02270050733970591,-0.4382166985443021,-0.46091720588400803,557696553,549317427.8,16.972836482914744,14.579763021820492,NaN,NaN,-20.840491020524418,-20.64403192986203
2016-11-28T09:30:00-05:00,51.21,51.42,51.085,51.33,15116511,17619314.3,47.25486088230015,39.15846163317731,NaN,NaN,-12.441964183602598,-44.639207577976705,0.059822930227374504,-0.3861385430997899,-0.4459614733271644,572813064,557740821.2,24.712048118785063,14.403161006791676,NaN,NaN,-18.586109852489905,-20.350043061666014
2016-11-29T09:30:00-05:00,51.34,51.46,51.22,51.4,7915374,17586128.15,48.224408215121336,38.88001865443858,NaN,NaN,1.8334616877701204,-27.8535554138518,0.08848751095031115,-0.33535208463927546,-0.4238395955895866,580728438,563953541.8,29.901980413340794,14.69281428195097,NaN,NaN,-16.455958131708343,-19.793745214529203
2016-11-30T09:30:00-05:00,51.14,51.29,50.57,50.58,16837588,17860893.1,39.14659805604535,38.56602208909743,NaN,NaN,-50.38527744722832,-29.06857865881535,0.0533488336381957,-0.357153553541842,-0.4105023871800377,563890850,564400381.8,30.274272808933247,15.265398428540689,NaN,NaN,-17.28697795106268,-19.435635605462558
2016-12-01T09:30:00-05:00,50.39,50.44,49.98,50.25,33621069,19056781.4,36.19380379577281,38.83413632679346,NaN,NaN,-114.12455032895491,-41.016444566070646,0.011210600280269878,-0.39648913682970033,-0.4076997371099702,530269781,561079737.2,29.039948462797867,16.11641760333407,NaN,NaN,-18.932889235784177,-19.363814695508502
2016-12-02T09:30:00-05:00,50.38,50.605,50.35,50.57,21587233,19354063.35,40.85281707124186,39.45770076349576,NaN,NaN,-74.24385128640837,-49.872436311684844,0.008350066875287443,-0.3972621535158609,-0.40561222039114836,551857014,559911829.4,28.598310099496885,17.20190475627354,NaN,NaN,-18.833200845628323,-19.288012716954192
2016-12-05T09:30:00-05:00,50.58,50.7071,50.48,50.63,21223431,19815613.7,41.7122155805058,40.185344062734394,NaN,NaN,-56.144640677380366,-58.6129716104404,0.013646364669159416,-0.3885542645546991,-0.4022006292238585,573080445,559965305.6,28.65181462855014,18.526251467578508,NaN,NaN,-18.49452438106744,-19.174657240398943
2016-12-06T09:30:00-05:00,50.61,50.78,50.58,50.78,16546284,20054775.95,43.90652354757369,40.75393756310324,NaN,NaN,-34.62856572144746,-65.90537709228391,0.02949005247045522,-0.36533806363578947,-0.3948281161062447,589626729,561744963.8,30.517834000911492,20.12478058829338,NaN,NaN,-17.569665550292264,-18.945372713240847
2016-12-07T09:30:00-05:00,50.76,51.545,50.75,51.51,11756499,19972262.9,53.15018794912411,41.97255381766671,NaN,NaN,92.1602568045535,-37.39627024192755,0.08806111891595209,-0.28475171746130457,-0.37281283637725665,601383228,569243439.4,37.88879687785756,22.30722751278938,NaN,NaN,-13.710920882869825,-18.1975938803307
2016-12-08T09:30:00-05:00,51.31,51.5466,51.21,51.3,17006369,19094723.35,50.568560771620724,43.06149514327202,NaN,NaN,126.66178390909394,10.760996605682223,0.1101531733500335,-0.23512136968971475,-0.34527454303974825,584376859,580064855,46.6797997961856,25.13515803340717,NaN,NaN,-11.355391097505542,-17.220136339927105
2016-12-09T09:30:00-05:00,51.33,52.05,51.33,52.04,14415862,17174477.4,58.261954158661354,44.81029090931748,NaN,NaN,193.95479317875078,64.40072549871405,0.1685985070354591,-0.13452640924542436,-0.30312491628088345,598792721,589451996.4,52.90656915626626,28.419706798747598,NaN,NaN,-6.597935464852734,-15.702679072059338
2016-12-12T09:30:00-05:00,51.91,52.3,51.91,52.25,9935922,16629870,60.15708020261611,46.308087750249506,NaN,NaN,209.02544470978256,117.43474257614665,0.21255793898258507,-0.0374274925526521,-0.24998543153523717,608728643,596581636,57.012676637375506,31.631384108127232,NaN,NaN,-2.156157553764295,-13.767461712302904
2016-12-13T09:30:00-05:00,52.35,52.61,52.23,52.49,10452370,16122897.9,62.26579489677576,47.68273043422558,NaN,NaN,209.77213143109546,166.3148820066552,0.24656352967204548,0.058218980554819666,-0.1883445491172258,619181013,602492492.8,60.11738726512891,34.84880697080027,NaN,NaN,2.1560787322883055,-11.492670220218445
2016-12-14T09:30:00-05:00,52.52,52.69,51.78,51.92,25363222,16239624.65,54.84196561027249,48.736421703952146,NaN,NaN,139.3507614779807,175.7529829413407,0.22029334039252757,0.08702212637343365,-0.13327121401909392,593817791,600979405.4,58.9437954255237,38.01557644100482,NaN,NaN,3.4896599067885643,-9.35233734493173
2016-12-15T09:30:00-05:00,51.92,52.31,51.76,52.14,16154516,16245638.65,56.974223196937935,49.536499566754905,NaN,NaN,113.47569978618785,173.11576611675946,0.20753444802826754,0.1261468460162405,-0.08138760201202704,609972307,606098495,61.67006306067404,41.20823548227334,NaN,NaN,5.25046188649078,-7.2662231690142285
2016-12-16T09:30:00-05:00,51.92,52.0759,51.81,52.05,15871085,16257857.45,55.81318644318879,50.14780853538981,NaN,NaN,91.01554840783301,152.52791716257587,0.18365652826354745,0.1481830583174073,-0.03547346994614016,594101222,605160195.2,60.872174785411744,43.79110167274667,NaN,NaN,6.310844027952876,-5.326642140876071
2016-12-19T09:30:00-05:00,52.105,52.23,51.97,52.15,7523220,15894715.15,56.86500181467749,50.76499379250096,NaN,NaN,96.38099227387985,129.99902667539536,0.1657679032935731,0.17173640917082622,0.005968505877253116,601624442,603739355,59.614387861650954,45.91341649048311,NaN,NaN,7.484151940285072,-3.496528700710194
2016-12-20T09:30:00-05:00,52.17,52.17,51.81,52.05,15316929,15712124.7,55.44370827464399,51.92907309382944,NaN,NaN,73.87511439736882,102.81962326865002,0.13942965220296277,0.18025557113095658,0.04082591892799381,586307513,597164655,54.04904795852442,47.61161471545391,NaN,NaN,8.056999245017451,-1.8460247084633876
2016-12-21T09:30:00-05:00,52,52.285,52,52.04,6553072,15440187.55,55.29487217975623,53.29343512125683,NaN,NaN,76.09550714861952,90.1685724027778,0.11460183516297154,0.18407821288170823,0.06947637771873669,579754441,594351985,51.82026509994399,49.238780189535774,NaN,NaN,8.488801732283093,-0.3696209312138905
2016-12-22T09:30:00-05:00,51.98,52.07,51.865,51.96,6537203,15027865.4,54.04494208989329,54.23572976544621,NaN,NaN,53.579287726571074,78.18928999085445,0.08729380688804966,0.17859363632879877,0.0912998294407491,573217238,587000971.2,46.43131864298226,50.51256651407045,NaN,NaN,8.526874983302372,0.901307056574147
2016-12-23T09:30:00-05:00,51.93,52.095,51.9259,52.06,6484307,14810903.3,55.40203809838726,55.21357423100918,NaN,NaN,55.24957193443435,71.03609469617471,0.07115098147086281,0.1802385562793276,0.1090875748084648,579701545,584121035.8,44.479737361635266,51.643132423576525,NaN,NaN,8.906983618015218,2.044975136780014
2016-12-27T09:30:00-05:00,52.02,52.15,51.96,52.05,13378478,14724001.65,55.226404052904016,56.02213712424706,NaN,NaN,53.44048264771956,62.44799277094266,0.05567041198301986,0.17867558978723963,0.12300517780421977,566323067,577060760.8,40.03690728750726,52.32306622976194,NaN,NaN,9.184605003196127,3.064922260553744
2016-12-28T09:30:00-05:00,52.01,52.04,51.73,51.73,8643605,14760413.2,49.78720027494154,55.7819237189483,NaN,NaN,25.880456116728983,52.849061114814695,0.021506088801291817,0.14988778880583453,0.12838170000454271,557679462,571335150.6,36.82457763183418,52.2470505693317,NaN,NaN,8.003997344696074,3.77050441543122
2016-12-29T09:30:00-05:00,51.76,52.03,51.73,51.97,10299366,14433502.1,53.4872418499722,55.99040093883055,NaN,NaN,30.89443138830757,43.80884596275231,0.013110976055034251,0.14477042007333552,0.13165944401830126,567978828,568980028,35.560696392242235,51.45282889762145,NaN,NaN,7.936833080470983,4.365694224722614
2016-12-30T09:30:00-05:00,51.98,52.08,51.6,51.71,8049944,13154945.85,49.25303604817146,55.34690678808126,NaN,NaN,8.466257748646681,34.786239967167425,-0.010631123615761628,0.11837053949859921,0.12900166311436084,559928884,566322357.2,34.136846393293254,50.11213441455196,NaN,NaN,6.697420549371312,4.698797985386714
2017-01-03T09:30:00-05:00,51.75,51.97,51.6,51.9,21730034,13162085.9,52.22915070246642,54.780626109499146,NaN,NaN,3.039329835349317,24.344191547350427,-0.014005638074481241,0.11149461552125928,0.12550025359574052,581658918,566713831.8,34.55254049530882,48.507838975832904,NaN,NaN,6.441647063616602,4.947776425133841
2017-01-04T09:30:00-05:00,51.97,52.15,51.89,51.9,9144625,12558145.6,52.22915070246642,54.06372295276277,NaN,NaN,26.988559463393244,19.05380691048516,-0.01653068152705965,0.10483690168691595,0.1213675832139756,581658918,569781002,37.861641966861484,46.91814288309952,NaN,NaN,6.230217880821403,5.130982347374921
2017-01-05T09:30:00-05:00,51.89,52.14,51.7,52.07,12312524,12346457.6,54.96953049178672,54.07283473001378,NaN,NaN,11.257054300594072,16.12912654725818,-0.007504246443739898,0.11198727515930074,0.11949152160304063,593971442,577039398,44.95457684051408,45.91891298417026,NaN,NaN,6.774357772739847,5.365750265284197
2017-01-06T09:30:00-05:00,51.97,52.15,51.78,52.12,9092386,12213251.95,55.77313018577831,53.98704237207381,NaN,NaN,19.32663034251191,13.815566338099046,0.0006482349914884028,0.12030181534240114,0.11965358035091274,603063828,584056398,50.80133365806611,45.14257516969827,NaN,NaN,7.445043026101321,5.662792088258072
2017-01-09T09:30:00-05:00,51.92,51.96,51.65,51.7,6903166,11708091.8,48.02088628164982,53.43044950339246,NaN,NaN,-132.5277172596911,-14.383228663568508,-0.022170206789751803,0.09194082186372299,0.11411102865347479,596160662,591302753.6,55.99900872216555,44.7944918794664,NaN,NaN,5.870656666195007,5.692487027963348
2017-01-10T09:30:00-05:00,51.65,51.73,51.36,51.44,10344310,11504514.2,43.948446441998755,52.507838405343975,NaN,NaN,-243.488102893847,-63.68871520940777,-0.052943086216054716,0.0479321708834064,0.10087525709946112,585816352,592134240.4,56.566038205007125,44.57675261827755,NaN,NaN,3.2814770725215228,5.348057034328802
2017-01-11T09:30:00-05:00,51.35,51.62,51.35,51.54,12087515,11612093.85,45.850531947792966,51.822611524854615,NaN,NaN,-197.70618757881624,-108.62766461784967,-0.06399346088878774,0.020883430988476448,0.08487689187726419,597903867,595383230.2,58.80020653469395,44.91612108800395,NaN,NaN,1.6487218173529026,4.819580574760816
2017-01-12T09:30:00-05:00,51.52,51.61,51.44,51.49,13257560,11752353.35,45.02776383982259,51.08924664343078,NaN,NaN,-164.9605756544474,-143.87119060885797,-0.07152966830090521,-0.004535193498867329,0.06699447480203788,584646307,593518203.2,56.98806620707913,45.2852497385136,NaN,NaN,0.05992198724242377,4.139629347972474
2017-01-13T09:30:00-05:00,51.49,51.62,51.39,51.52,6517691,10810076.8,45.65785843437858,50.49016923946545,NaN,NaN,-140.29721630050437,-175.79595993746122,-0.07119975962083983,-0.022005224724011896,0.04919453489682792,591163998,591138237.2,54.67252548956287,45.87390737041222,NaN,NaN,-1.105201306583742,3.3903678258930148
2017-01-17T09:30:00-05:00,51.56,52.275,51.51,52.25,19030129,10953857.45,58.21007071584048,50.69074299785497,NaN,NaN,55.31848812751927,-138.22671886001916,-0.021122172797567465,0.022791818899868588,0.04391399169743605,610194127,593944930.2,56.89679256162103,46.760839884696914,NaN,NaN,1.6743750197064902,3.145225996437797
2017-01-18T09:30:00-05:00,52.2,52.45,52.2,52.43,11652057,10742906.05,60.6251781568927,51.07636971956845,NaN,NaN,169.07578142031278,-55.713941997187206,0.022459571667281596,0.07198845628153805,0.04952888461425645,621846184,601150896.6,62.04625662509186,48.332936265952966,NaN,NaN,4.748688835611782,3.3742921163197948
2017-01-19T09:30:00-05:00,52.37,52.37,52.12,52.24,17283419,11230916,56.887939739542446,51.583565395611366,NaN,NaN,121.56224278758017,8.139744076092091,0.03602149540752008,0.09455575387365656,0.058534258466136475,604562765,602482676.2,62.92776416459063,50.19744958972127,NaN,NaN,6.1745345216977245,3.774326745659499
2017-01-20T09:30:00-05:00,52.49,52.77,52.31,52.58,11015593,11015849.2,61.46572078015867,52.15345674776755,NaN,NaN,196.71912027926962,80.47568326283549,0.06379790019459709,0.13828163370938285,0.07448373351478575,615578358,608669086.4,66.78675511740359,52.42788235580423,NaN,NaN,8.890288718167897,4.505178456017841
2017-01-23T09:30:00-05:00,52.58,52.61,52.39,52.56,16203816,11498386.4,61.055031412519696,52.996456416649565,NaN,NaN,165.53994634530616,141.6431157919976,0.07590781399040046,0.16936850100278633,0.09346068701238587,599374542,610311195.2,67.74648696037505,54.82857096773864,NaN,NaN,10.927110427375196,5.422597309068892
2017-01-24T09:30:00-05:00,52.6,52.955,52.58,52.91,10242502,11683651.35,65.41061233215353,53.937989390198645,NaN,NaN,202.72311715055463,171.12404159660466,0.10100297940126318,0.21971441126396485,0.11871143186270167,609617044,610195778.6,67.59863484117037,57.18900627815732,NaN,NaN,14.105235610683891,6.662974209299606
2017-01-25T09:30:00-05:00,53.03,53.1,52.89,52.9,8816756,11800273.8,65.18629251158234,54.86349951942121,NaN,NaN,189.2125463881179,175.1513945901657,0.10971695372447648,0.25585762401829726,0.14614067029382077,600800288,605986599.4,62.26188482003069,58.931880767669405,NaN,NaN,16.577091150232995,8.079276629432947
2017-01-26T09:30:00-05:00,52.92,52.93,52.67,52.67,9985411,11630620.45,60.082641479633054,55.2287217328388,NaN,NaN,122.89937836473732,175.4188217055971,0.09341676072628827,0.2629116212016811,0.16949486047539283,590814877,603237021.8,58.98591062379622,59.93411889504671,NaN,NaN,17.19802024283637,9.38195428849058
2017-01-27T09:30:00-05:00,52.54,52.68,52.24,52.38,16358712,12016375.8,54.30898162394698,55.124139692708,NaN,NaN,57.90094678985363,147.6551870077139,0.058250679784734166,0.24230821020631055,0.18405753042157638,574456165,595012583.2,50.437308963007816,59.90811713111397,NaN,NaN,15.962407695134662,10.322019060868305
2017-01-30T09:30:00-05:00,52.23,52.41,52.19,52.34,9951653,11998990.15,53.544679308129574,55.518696337456554,NaN,NaN,33.40607927883423,121.22841359441952,0.028924940717695136,0.2202137063186953,0.19128876560100017,564504512,588038577.2,44.54235156270152,59.08978447686654,NaN,NaN,14.735463863080733,10.95251117547008
2017-01-31T09:30:00-05:00,52.34,52.59,52.25,52.59,12061292,12199557.55,57.56433816733122,56.49126003212315,NaN,NaN,55.28109028962378,91.74000822223334,0.023238315208073873,0.2203366596110925,0.19709834440301863,576565804,581428329.2,39.79474608737795,57.891835039893024,NaN,NaN,14.85183997591022,11.50955814696153
2017-02-01T09:30:00-05:00,52.34,52.5,52.17,52.18,18479763,12037044,49.9334690471703,56.78289839636439,NaN,NaN,19.0191510249684,57.70132914960345,-0.009506292524220389,0.18521547874774313,0.19472177127196352,558086041,572885479.8,34.65401671582663,56.16710719568822,NaN,NaN,12.521238984365118,11.654083980876328
2017-02-02T09:30:00-05:00,52.42,52.87,52.42,52.66,18747453,12517185.4,57.10298203514618,57.645413981744646,NaN,NaN,76.13789930706602,48.34903333806919,-0.0006744053069258349,0.19387876463830622,0.19455316994523206,576833494,570089203.2,33.144717366092166,54.46401084990344,NaN,NaN,12.84184329632769,11.823763883083664
2017-02-03T09:30:00-05:00,52.93,53.15,52.79,53,17954739,12799296.15,61.32740884319278,58.76466758237424,NaN,NaN,120.28925045196378,60.82669407049123,0.024820905523920106,0.2255793018501322,0.2007583963262121,594788233,574155616.8,37.41363372695523,53.23123286686003,NaN,NaN,14.554159134482731,12.213820347569245
2017-02-06T09:30:00-05:00,52.97,52.98,52.71,52.71,19067927,13298073.2,56.240073876417405,58.62395352241544,NaN,NaN,82.74914089348367,70.6953063934211,0.01916232105926044,0.22471129765028763,0.2055489765910272,575720306,576398775.6,39.700946553933356,52.00295815202521,NaN,NaN,14.242326920425377,12.503607000834407
2017-02-07T09:30:00-05:00,52.81,53.24,52.81,53.14,8364416,13371135.7,61.35858738638221,58.67633989595041,NaN,NaN,116.18004866181373,82.87509806785908,0.04017875406550345,0.2557724191729065,0.21559366510740305,584084722,577902559.2,41.25103352777787,50.51758507364564,NaN,NaN,15.755566494737028,12.968172642820496
2017-02-08T09:30:00-05:00,53.2,53.46,53.12,53.36,8559239,13281882.15,63.698151354475165,59.162783582731315,NaN,NaN,146.77985865223079,108.42723959331155,0.06331957018580497,0.2947431278396593,0.2314235576538543,592643961,584814143.2,47.88245256940222,49.44291995970361,NaN,NaN,17.766091273931277,13.653589590122037
2017-02-09T09:30:00-05:00,53.3,53.6657,53.21,53.58,8840897,13119551.25,65.92024845595617,59.480964131002565,NaN,NaN,161.23455616667505,125.44657096523338,0.08643451055775186,0.33946669585104416,0.2530321852932923,601484858,589744416,52.04111229274155,48.389659757942034,NaN,NaN,20.138283790434034,14.579974475880894
2017-02-10T09:30:00-05:00,53.61,53.69,53.42,53.62,9354195,12924383,66.32387378637142,59.85731001484912,NaN,NaN,159.3268036620905,133.25408160725868,0.09663732792136603,0.3738288451949998,0.2771915172736338,610839053,592954580,54.582293133046534,47.449360198847145,NaN,NaN,22.13373799759442,15.659083550411397
2017-02-13T09:30:00-05:00,53.7,53.77,53.47,53.62,14059475,13301472.2,66.32387378637142,59.92254297586469,NaN,NaN,151.97229817994233,147.09871306455042,0.09543926561642746,0.3964905992941681,0.3010513336777406,610839053,599978329.4,59.62336679954347,46.87969819587379,NaN,NaN,23.725811857519563,16.811473308569706
2017-02-14T09:30:00-05:00,53.49,53.73,53.3,53.63,10483346,12874133.05,66.43911948253447,60.012030616646975,NaN,NaN,123.82855754690927,148.62841484156954,0.08757880845916483,0.41052484425169666,0.32294603579253184,621322399,607425864.8,64.16519904246354,47.015649211761854,NaN,NaN,25.05775174803989,17.989513085636876
2017-02-15T09:30:00-05:00,53.75,54.16,53.64,54.12,12675948,12925327.6,71.57268583458779,60.832748070572315,NaN,NaN,165.02984613954172,152.27841233903175,0.10638741824610753,0.45593030860016626,0.3495428903540587,633998347,615696742,68.41445628888627,47.68911675926829,NaN,NaN,27.872302672744,19.40134016950932
2017-02-16T09:30:00-05:00,54.06,54.205,53.81,54.19,11377402,12630026.75,72.22627759253679,62.11255492547158,NaN,NaN,154.2592341584271,150.88334793738215,0.11387980687364896,0.49189264894611995,0.378012842072471,645375749,624474920.2,72.18439309877809,49.2424799118233,NaN,NaN,30.36853492041604,20.96808227678171
2017-02-17T09:30:00-05:00,54.03,54.52,53.9299,54.46,15581773,12858335.75,74.6475369071073,63.61990189682713,NaN,NaN,157.1952859056238,150.45704438608882,0.12639062156582198,0.5360011190297485,0.40961049746392647,660957522,634498614,75.7445070636296,51.47120530474673,NaN,NaN,33.27893198520063,22.726775092270127
2017-02-21T09:30:00-05:00,54.62,55.09,54.5601,54.95,16499953,12873142.6,78.3383042184944,65.10375661476736,NaN,NaN,188.985879966431,157.85976074338654,0.15514286716007486,0.60353908141402,0.44839621425394516,677457475,647822298.4,79.50031793594054,54.307317579644064,NaN,NaN,37.13697208062728,24.785374662035434
2017-02-22T09:30:00-05:00,54.9,55.03,54.82,54.96,8098986,12765966.8,78.40739024984595,67.13760812924419,NaN,NaN,165.82832530742078,166.25971429548886,0.16158160616114536,0.6503732219553768,0.48879161579423147,685556461,660669110.8,82.33983281664155,57.71344730113084,NaN,NaN,40.208922633862784,26.988738658010767
2017-02-23T09:30:00-05:00,55,55.31,54.96,55.09,9790318,12814644.9,79.33030156214224,68.72527380974391,NaN,NaN,156.2396604827888,164.50167716413824,0.1609869846692129,0.6900253466307475,0.5290383619615346,695346779,672938797.2,84.54210121411681,61.38468900456117,NaN,NaN,43.045747663589154,29.28259708737911
2017-02-24T09:30:00-05:00,55.03,55.3,54.99,55.28,7762232,12703485.95,80.63319176354761,70.10425830405497,NaN,NaN,141.87149708086397,162.02412974862563,0.15947729804694133,0.7283849845202113,0.56890768647327,703109011,684485449.6,86.27649530063621,64.87489340268124,NaN,NaN,45.85508508417249,31.650095372635306
2017-02-27T09:30:00-05:00,55.19,55.19,54.91,55.03,12707464,12520923.55,74.02163903611839,71.37437010117647,NaN,NaN,112.76673872765458,153.13842031303176,0.129029953495152,0.7301951283422099,0.6011651748470579,690401547,690374254.6,87.07310797324438,68.25861921834631,NaN,NaN,46.322666919081044,33.746177022127554
2017-02-28T09:30:00-05:00,54.94,55.22,54.88,55.1,17735461,12910113.95,74.64845036956928,72.32364602854697,NaN,NaN,101.45463242809281,135.63217080536413,0.10216871273955497,0.7288760657715017,0.6267073530319467,708137008,696510161.2,87.86361847936344,71.588089572031,NaN,NaN,46.885425830870595,35.623212566233704
2017-03-01T09:30:00-05:00,55.13,55.48,55.05,55.36,16716139,13142856.3,76.87984238739519,73.26519538804125,NaN,NaN,107.79313694470518,124.025133132821,0.09085577595795358,0.7402770729793886,0.649421297021435,724853147,704369498.4,88.80773054447087,74.51132371310733,NaN,NaN,48.029447703965936,37.39553187162402
2017-03-02T09:30:00-05:00,55.3,55.47,55.19,55.35,9988467,12718291.5,76.60057851928761,74.02807610685065,NaN,NaN,100.15779058016658,112.80875915229656,0.0724434098039739,0.7399755592764024,0.6675321494724284,714864680,708273078.6,89.25483528237963,77.16944678379575,NaN,NaN,48.88175226308328,39.036420498975346
2017-03-03T09:30:00-05:00,55.18,55.2323,54.8999,55.14,10083246,12285081.15,70.7855623137116,74.3467681445178,NaN,NaN,72.20158126368521,98.87477598886082,0.03761781956870336,0.7145544239333077,0.6769366043646043,704781434,708607563.2,89.29429953721338,79.64887581266483,NaN,NaN,47.96665843899631,40.3121687761212
2017-03-06T09:30:00-05:00,54.95,54.98,54.81,54.9,6686606,11721674.5,64.73705195962054,74.23342372832131,NaN,NaN,50.074860938359585,86.3364004310018,-0.007669915091666923,0.6673492105000207,0.6750191255916876,698094828,710146219.4,89.4856040886886,81.78189276188948,NaN,NaN,45.37875171494562,41.035966338810404
2017-03-07T09:30:00-05:00,54.76,54.94,54.75,54.83,7846514,11160603.85,63.04495379473768,73.99098332205013,NaN,NaN,39.23611002577459,73.89269595053815,-0.046274577169986175,0.6171759041292049,0.663450481299191,690248314,706568480.6,85.6529108160667,83.31672931714685,NaN,NaN,42.74258820944503,41.27976946318678
2017-03-08T09:30:00-05:00,54.69,54.8,54.64,54.71,10787982,11281782.15,60.14277612401887,73.17456119986662,NaN,NaN,21.63084940327117,56.66023844225134,-0.08175211271830363,0.5612603404013115,0.6430124531196151,679460332,697489917.6,76.6782832456088,83.90700267119846,NaN,NaN,39.66936768622746,41.04971206647831
2017-03-09T09:30:00-05:00,54.69,54.89,54.69,54.8,7025304,11205085.4,61.571578481530395,72.41351126336617,NaN,NaN,24.619567413451076,41.55259380890824,-0.09982179589949125,0.518235208245251,0.6180570041447423,686485636,691814108.8,71.62542788247946,83.86707658431997,NaN,NaN,37.44442188330576,40.53467061173937
2017-03-10T09:30:00-05:00,55.03,55.12,54.9,55.05,6530445,11089562.8,65.29342958671174,71.74536074048076,NaN,NaN,48.68086619771445,36.848450795714086,-0.09559499153645323,0.4985632647241758,0.594158256260629,693016081,689461038.2,69.57836772232596,83.42663805994115,NaN,NaN,36.492832887563495,39.95726522257139
2017-03-13T09:30:00-04:00,55,55.16,54.93,55.09,10657995,11154752.8,65.86311487705811,70.85427578752103,NaN,NaN,50.78213173519776,36.98990495508171,-0.09079858588372791,0.48066002390596907,0.571458609789697,703674076,690576887.8,70.01599899462406,82.74918670698996,NaN,NaN,35.85866254180298,39.37175055389019
2017-03-14T09:30:00-04:00,55.02,55.14,54.9,54.93,7890811,10846319.6,61.513615865036876,69.64757761717753,NaN,NaN,35.20123153299706,36.182929256526215,-0.09845318510728251,0.44839212840559384,0.5468453135128764,695783265,691683878,70.46985101317097,81.90133086388494,NaN,NaN,34.08601094117168,38.6166448949304
2017-03-15T09:30:00-04:00,55,55.5,55,55.34,14102871,11027295.85,67.44623827919267,68.79871595410977,NaN,NaN,95.13183132109482,50.88312564009095,-0.0769101031313546,0.45070768459868304,0.5276177877300376,709886136,697769038.8,72.8983266981378,81.06963268417215,NaN,NaN,34.215117949757435,37.987855331334266
2017-03-16T09:30:00-04:00,55.35,55.42,55.23,55.42,8727176,10829857.25,68.46761790889174,67.92974639306291,NaN,NaN,114.4441790418907,68.84804796577887,-0.05908033956558312,0.4537673632730588,0.5128477028386419,718613312,704194574,75.2160450711111,80.27960052492037,NaN,NaN,34.62404166139506,37.50731052134295
2017-03-17T09:30:00-04:00,55.17,55.355,54.98,54.98,16469401,11084457.2,57.73777365190732,66.76661315133354,NaN,NaN,33.4450913772063,65.80089300167724,-0.07756320684936824,0.41589369427693157,0.4934569011262998,702143911,706020140,75.84800633482035,79.47780755074722,NaN,NaN,31.53412375674366,36.6539981264002
2017-03-20T09:30:00-04:00,55.03,55.16,54.99,55.0771,6559189,10633328,59.25528086852173,65.66710104411587,NaN,NaN,10.35619320627436,57.71570529589256,-0.08338397573827966,0.3892269314534502,0.4726109071917299,708703100,707025944.8,76.20796471764422,78.64526085348156,NaN,NaN,29.495921889672665,35.63141580686769
2017-03-21T09:30:00-04:00,55.11,55.27,54.9701,55.04,13135495,10465105.1,58.39255027333485,64.34658017882585,NaN,NaN,14.36169846295006,53.54779868188316,-0.08933753387215171,0.36093898985154027,0.450276523723692,695567605,706982812.8,76.15554780608916,77.74153351502572,NaN,NaN,27.59413062568235,34.4832322095555
2017-03-22T09:30:00-04:00,55.12,55.21,54.8043,54.93,7094715,10414891.55,55.79852435269661,62.86071916692649,NaN,NaN,-45.46168252166273,25.42909591333165,-0.09951091575853566,0.3258878790255224,0.42539879478405807,688472890,702700163.6,70.93821086288024,76.43320319934719,NaN,NaN,25.238067851207013,33.16249444407715
2017-03-23T09:30:00-04:00,54.88,55.08,54.72,54.81,7474716,10299111.45,53.03082752152219,61.59252382462726,NaN,NaN,-91.98628813847975,-15.856997522742352,-0.11220726706439416,0.2851397109535654,0.39734697801795954,680998174,695177136,62.79928862226526,74.54070241970804,NaN,NaN,22.437035088681647,31.630285964734934
2017-03-24T09:30:00-04:00,54.81,54.89,54.515,54.7,8343294,10328164.55,50.555349676362646,60.57954509010882,NaN,NaN,-149.8240939520093,-52.510834588585475,-0.12492548331214465,0.24119012387777872,0.36611560718992336,672654880,689279329.8,57.253407762534046,72.23840268212557,NaN,NaN,19.347773939008793,29.8756413896312
2017-03-27T09:30:00-04:00,54.5,54.719,54.4111,54.65,5739464,9979764.55,49.42594997754958,59.60675910316682,NaN,NaN,-163.4842071883985,-87.27891466752003,-0.13287690389496265,0.20001947732122005,0.3328963812161827,666915416,680921793,50.45382324928117,69.72418214164088,NaN,NaN,16.45081999533341,27.957809761874373
2017-03-28T09:30:00-04:00,54.45,54.89,54.45,54.75,8810225,9533502.75,51.74768872200907,59.007110003023264,NaN,NaN,-107.45335583315605,-111.64192552674126,-0.12754825978227213,0.17346105648834254,0.30100931627061467,675725641,676953400.2,47.565196874698344,67.64467597229013,NaN,NaN,14.587685376812837,26.047791992579867
2017-03-29T09:30:00-04:00,54.7,54.92,54.66,54.85,5558224,8975607,54.020854924182906,58.46777260606988,NaN,NaN,-58.536261087058534,-114.25684123982042,-0.11388455644118878,0.1586536207191287,0.2725381771603175,681283865,675515595.2,46.52584739590879,65.85184879467793,NaN,NaN,13.597238019221223,24.269141424957205
2017-03-30T09:30:00-04:00,54.8,54.9,54.69,54.74,5399136,8746140.45,51.16545291474048,57.458631415214775,NaN,NaN,-63.825088923225806,-108.62460139676963,-0.1088550168211242,0.13646940613391223,0.24532442295503643,675884729,674492906.2,45.759923061093374,64.15053131887561,NaN,NaN,11.960046289254892,22.510699262714017
2017-03-31T09:30:00-04:00,54.67,54.81,54.58,54.58,4762285,8480092.4,47.253016215794474,56.129338653695946,NaN,NaN,-100.30158324751976,-98.72009925587173,-0.11244364111608435,0.104769871559931,0.21721351267601535,671122444,674186419,45.518082592364365,62.40068014728564,NaN,NaN,9.417475417419507,20.64023871338623
2017-04-03T09:30:00-04:00,54.66,54.72,54.4,54.49,10666615,8679092.85,45.161109499691804,54.961302484742724,NaN,NaN,-127.75926672653384,-91.5751111634988,-0.11652232370559887,0.07156060804401676,0.18808293174961563,660455829,672894501.6,44.4516373952141,60.542236317431566,NaN,NaN,6.659406436577661,18.64297695955643
2017-04-04T09:30:00-04:00,54.53,54.655,54.43,54.65,5283980,8550966.15,49.44591570081953,53.67556515771607,NaN,NaN,-102.01974300028073,-90.48838859692373,-0.10447436015890321,0.05748998155098661,0.16196434170988983,665739809,670897335.2,42.78289633441274,58.39113414859406,NaN,NaN,5.43116107467192,16.755574690287215
2017-04-05T09:30:00-04:00,54.66,54.9,54.48,54.55,7268060,8374970.05,46.97545353731709,52.14041055974645,NaN,NaN,-77.87619701092935,-94.35637578169789,-0.09930457578931842,0.037833621973241804,0.13713819776256023,658471749,666334912,39.165692378516674,55.816108956265886,NaN,NaN,3.6862698566291803,14.888531142621781
2017-04-06T09:30:00-04:00,54.6,54.77,54.51,54.55,5061030,8276756.35,46.97545353731709,51.37167340870429,NaN,NaN,-82.44951104519481,-98.08126020609168,-0.09210880791754328,0.02200218786563113,0.11411099578317441,658471749,662852316,36.62050721292965,53.01414473327369,NaN,NaN,2.2472536166264754,13.08263435319388
2017-04-07T09:30:00-04:00,54.6,54.85,54.58,54.7,7629874,8331727.8,51.215676516559306,50.79741595499269,NaN,NaN,-46.311848025598465,-87.28331316170743,-0.07423782270111241,0.021313717406783894,0.09555154010789631,666101623,661848151.8,35.89615821099591,50.13472998279882,NaN,NaN,2.134225972143212,11.518576013043784
2017-04-10T09:30:00-04:00,54.72,54.9548,54.62,54.86,5260614,8061858.75,55.31997162473596,50.57794605152134,NaN,NaN,-10.74516622970004,-63.88049306234067,-0.04980526498894569,0.033294958871714186,0.08310022386065988,671362237,664029433.4,38.73116946315877,47.461560101160934,NaN,NaN,3.21040675476613,10.331694690432691
2017-04-11T09:30:00-04:00,54.87,54.925,54.69,54.88,6325114,7983573.9,55.820323487753136,50.579503132596805,NaN,NaN,-1.491106861845015,-43.77476583465353,-0.03136179246439366,0.04389798328016781,0.07525977574456147,677687351,666418941.8,41.76928549954087,45.37806543235098,NaN,NaN,4.242167321774889,9.461762209195863
2017-04-12T09:30:00-04:00,54.84,55.12,54.81,55.09,7377375,7647299.1,60.78598765645128,51.13344314223459,NaN,NaN,70.55498373176728,-14.088529686114203,-0.005442163819479998,0.06845707097021148,0.07389923478969147,685064726,671737537.2,47.95534350657276,44.31778363837294,NaN,NaN,6.641538951256738,9.058873172347417
2017-04-13T09:30:00-04:00,55.05,55.1,54.82,54.84,6719143,7546897.45,53.13001846483753,51.317348055697096,NaN,NaN,53.10119695325747,13.021611913576251,-0.005539096683207012,0.06697536393568271,0.07251446061888972,678345583,675712304,52.05462700301201,43.94644215554994,NaN,NaN,6.5034654174952,8.693814921654242
2017-04-17T09:30:00-04:00,54.93,55.23,54.92,55.23,10585810,7252717.9,61.315480338448005,52.16660022433269,NaN,NaN,143.37390128469752,50.958761775635445,0.018918304669984523,0.09616234145637037,0.07724403678638585,688931393,680278258,56.311614413457086,44.364855810133925,NaN,NaN,9.169720443836821,8.761801424823183
2017-04-18T09:30:00-04:00,55.16,55.64,55.06,55.48,11085516,7479034.25,65.47755647441691,53.14730506379039,NaN,NaN,228.0145746894173,98.71070995945891,0.048506198043369836,0.13787678434059814,0.0893705862972283,700016909,686009192.4,60.99302299849642,45.32398624754808,NaN,NaN,12.888440267865214,9.351321259543473
2017-04-19T09:30:00-04:00,55.55,55.59,55.185,55.27,7254574,7184988.2,59.67000758834933,53.550815968373705,NaN,NaN,188.06595265148667,136.62212186212525,0.050292057365294324,0.1522356580038462,0.10194360063855187,692762335,689024189.2,63.22557965137288,46.51682426579551,NaN,NaN,13.979463649023119,10.012484458040566
2017-04-20T09:30:00-04:00,55.08,55.25,54.9705,55.16,9738220,7317163.45,56.82678057466907,53.955196515511474,NaN,NaN,99.97564602802707,142.5062543213772,0.040825663272014465,0.15297567972856996,0.11215001645655549,683024115,688616067,62.70242202856115,47.72700276347179,NaN,NaN,13.91176626426578,10.56952471607274
2017-04-21T09:30:00-04:00,55.13,55.17,54.97,55,2887208,7087788.05,52.87986563061292,54.35711433085565,NaN,NaN,65.34281256780466,144.95457744428666,0.02151888561564122,0.13904862347610702,0.1175297378604658,680136907,688974331.8,62.99191297048314,48.975133504765985,NaN,NaN,12.563944417788406,10.854441816317836
2017-04-24T09:30:00-04:00,55.16,55.59,55.16,55.5,9831677,7162207.2,61.80718529206502,55.54611974459659,NaN,NaN,153.03677794415702,146.88715277617854,0.039127051596028306,0.1664385523555012,0.1273115007594729,689968584,689181770,63.17016047311111,50.312170867472915,NaN,NaN,14.550796118227256,11.382492430876324
2017-04-25T09:30:00-04:00,55.53,55.8,55.51,55.72,7283792,7239423.6,64.95346288985257,56.65380168667038,NaN,NaN,186.11527914971552,138.50729366823822,0.060991615595710036,0.20355102025411043,0.1425594046584004,697252376,688628863.4,62.30872372404607,51.706872823875294,NaN,NaN,17.284160427306958,12.225587858937843
2017-04-26T09:30:00-04:00,55.74,55.74,55.24,55.27,7930815,7195453.1,54.977110156027834,57.22534858800685,NaN,NaN,105.49474804690212,121.99305274732129,0.04148098385230062,0.19441063447377616,0.15292965062147554,689321561,687940708.6,61.1902831079197,53.28005787597551,NaN,NaN,15.915808439314405,12.752762227563066
2017-04-27T09:30:00-04:00,55.35,55.38,55.1143,55.2,5861399,7210611.85,53.598033052186935,57.69838998192613,NaN,NaN,55.57072032665152,113.11206760704617,0.02121612924141064,0.17944981217323885,0.1582336829318282,683460162,688027918,61.28512577657362,55.04181634480723,NaN,NaN,14.394853024219687,12.98734662708544
2017-04-28T09:30:00-04:00,55.04,55.2,54.89,55.18,7034843,7292397.2,53.18751432479225,57.839235539657054,NaN,NaN,19.416941035642687,103.92689330061378,0.004683386854459071,0.16408791649990206,0.159404529645443,676425319,687285600.4,59.94233578547943,56.75940045727034,NaN,NaN,13.090830065303352,13.002129975402285
2017-05-01T09:30:00-04:00,55.26,55.26,54.915,54.97,8353940,7471979.95,48.94820708389429,57.3841095010255,NaN,NaN,5.071237596707204,74.33378523112381,-0.02077949672991547,0.13343015873304864,0.1542096554629641,668071379,682906159.4,52.61751574745409,57.75128233472001,NaN,NaN,10.62209799131448,12.662125406246885
2017-05-02T09:30:00-04:00,54.85,54.96,54.55,54.6,7672102,7322254.3,42.51799769440359,56.43394337292911,NaN,NaN,-88.34822169707,19.44108506176672,-0.06066827891286297,0.0783743068218854,0.13904258573474837,660399277,675535539.6,43.076875772600154,57.84468163993853,NaN,NaN,6.261031123170452,11.747683365807394
2017-05-03T09:30:00-04:00,54.65,54.74,54.48,54.65,10973846,7606747.6,43.59632034423824,55.20610999348532,NaN,NaN,-111.23165673834045,-23.9041958952818,-0.08056620490318575,0.038334829605766174,0.11890103450895192,671373123,671945852,39.33598894398254,57.229013456896375,NaN,NaN,3.179460615876121,10.52365154438864
2017-05-04T09:30:00-04:00,54.79,55.36,54.74,55.07,11587680,7822728.6,51.77934588177645,55.109633380409534,NaN,NaN,-0.8961082397489631,-35.19756160856189,-0.06309500506865262,0.04003227817313615,0.10312728324178877,682960803,671845980.2,39.23390374018639,56.31324750955168,NaN,NaN,3.1882232782893642,9.475733220660173
2017-05-05T09:30:00-04:00,55.22,55.28,55.05,55.22,8539495,7996651.85,54.32784576382168,54.61051662507908,NaN,NaN,29.768195478930533,-33.12731071990434,-0.040204393243907705,0.052871791686904146,0.09307618493081185,691500298,674860976,43.961975518671814,55.43113044563845,NaN,NaN,4.035140690901614,8.69850571640895
2017-05-08T09:30:00-04:00,55.26,55.26,55.085,55.2,5323425,7881329.4,53.91866606364728,53.78488159573839,NaN,NaN,23.43930473791329,-29.453697291663115,-0.025874331576235865,0.06073327046051702,0.08660760203675288,686176873,678482074.8,49.08586163665597,54.580618919792705,NaN,NaN,4.576049078451982,8.109583339557956
2017-05-09T09:30:00-04:00,55.18,55.275,54.91,55,7256877,7981142.55,49.873415820787706,53.08512504091256,NaN,NaN,-22.560548663312108,-16.29616268491154,-0.029089269065198042,0.05024601570525533,0.07933528477045337,678919996,682186218.6,53.745018289036715,53.90343596534012,NaN,NaN,3.79482514993697,7.4931893124692435
2017-05-10T09:30:00-04:00,55.03,55.11,54.96,55.04,5232283,7926501,50.670542367831274,52.64539374042415,NaN,NaN,-36.93897611843965,-1.437626560931379,-0.027750000142232875,0.044647784592662276,0.07239778473489515,684152279,684742049.8,56.69002227679779,53.473978840214166,NaN,NaN,3.396432902064865,6.9079383966971895
2017-05-11T09:30:00-04:00,54.97,55.12,54.88,55.12,5058934,7810578.95,52.304174294669686,52.60427293071392,NaN,NaN,-36.58686217435841,-8.575777347853267,-0.021010495143604258,0.04613466580538983,0.06714516094899409,689211213,685992131.8,58.09535937777247,53.1242250121634,NaN,NaN,3.530606305296618,6.425462383639965
2017-05-12T09:30:00-04:00,55.07,55.105,54.93,54.96,5478808,7748562.2,48.821793339696335,51.676744934116165,NaN,NaN,-54.86330859271277,-25.502078162181927,-0.026507874929061925,0.03401031728766668,0.060518192216728606,683732405,684438553.2,55.67738981057362,52.58902710769644,NaN,NaN,2.6503551483666024,5.886161350029484
2017-05-15T09:30:00-04:00,54.93,55.2,54.93,55.14,7303665,7584454.95,52.64186675577114,50.7973452102532,NaN,NaN,-18.579745791138116,-33.90588826799221,-0.017628492790034575,0.03848257622918538,0.05611106901921996,691036070,685410392.6,56.8862366425223,52.20170660187331,NaN,NaN,2.99520153181957,5.4731670902852105
2017-05-16T09:30:00-04:00,55.31,55.3866,55.05,55.09,4797112,7270034.75,51.49210081555636,50.54841597164809,NaN,NaN,19.852233548910704,-25.423331825547642,-0.014841390462222957,0.03755933094144126,0.05240072140366422,686238958,686874185,58.71278512808169,52.02474246045632,NaN,NaN,2.9596716346850993,5.114096310913766
2017-05-17T09:30:00-04:00,55,55.2,54.86,55.01,14021743,7608393.2,49.62452108290035,50.264593688127626,NaN,NaN,-38.6589486381794,-25.767326329495596,-0.017899618986063952,0.030026197671084276,0.04792581665714823,672217215,684487172.2,54.64702512289287,51.55059241376483,NaN,NaN,2.416464136888059,4.72872028605295
2017-05-18T09:30:00-04:00,55.03,55.18,54.87,55.05,7906570,7516810.7,50.589488346407435,50.07902040395728,NaN,NaN,-31.85190734000098,-24.82033536262411,-0.01676235374163175,0.026972874480108544,0.043735228221740294,680123785,682669686.6,51.7107879873715,50.96262471389998,NaN,NaN,2.217428364965018,4.369964297326103
2017-05-19T09:30:00-04:00,55.07,55.45,54.99,55.35,6277618,7686331.2,57.2098689222458,50.669139106696676,NaN,NaN,60.56157080346037,-1.7353594833894852,0.003575745780626749,0.04820491044752373,0.04462916466689698,686401403,683203486.2,52.51774040864875,50.95549790398531,NaN,NaN,3.9501760385210867,4.309994546068244
2017-05-22T09:30:00-04:00,55.36,55.74,55.35,55.66,7101778,7549836.25,62.762170935449696,52.11515148105711,NaN,NaN,178.86088272212388,37.75276621926291,0.035512426252413264,0.08901969748241356,0.0535072712300003,693503181,683696908.4,53.294683579708284,51.68534131877875,NaN,NaN,7.259471755812291,4.731348433174536
2017-05-23T09:30:00-04:00,55.74,55.98,55.69,55.72,7518524,7561572.85,63.74278506220887,53.554184675197874,NaN,NaN,249.3907326339112,83.660466036263,0.057009343041059174,0.12476895003132427,0.06775960699026509,701021705,686653457.8,57.75517333467357,53.00099734668525,NaN,NaN,10.257021184080896,5.520730254732587
2017-05-24T09:30:00-04:00,55.76,55.98,55.69,55.94,5152943,7422679.25,67.15786794430896,54.652650536807336,NaN,NaN,232.771157243444,137.94648721258767,0.08091680469113365,0.16890561285418215,0.0879888081630485,706174648,693444944.4,65.82838176327495,54.900602919762996,NaN,NaN,13.937310902646358,6.723098918720269
2017-05-25T09:30:00-04:00,56.02,56.435,56,56.29,6036649,7431441.75,71.72134257704883,55.89504316632356,NaN,NaN,253.16010549973223,194.94888978053433,0.11319375104605325,0.22948099697061508,0.11628724592456183,712211297,699862446.8,71.39187862204145,56.85988171286083,NaN,NaN,18.77016666249626,8.444108596402554
2017-05-26T09:30:00-04:00,56.33,56.51,56.32,56.5,4207602,7290079.7,74.0511417418577,57.333077143338585,NaN,NaN,218.51305695038275,226.5391870099188,0.13983205301722032,0.29107731219608723,0.15124525917886691,716418899,705865946,75.42306695494449,58.74111066416715,NaN,NaN,23.60574708802885,10.610056952349167
2017-05-30T09:30:00-04:00,56.38,56.53,56.29,56.48,4250927,7084929.05,73.4306550301829,59.015737086866814,NaN,NaN,168.55417983914168,224.47784643332238,0.1465429699082941,0.33442397156423453,0.18788100165594043,712167972,709598904.2,77.54213797043754,60.44090492712436,NaN,NaN,27.239482256777258,12.985689138696037
2017-05-31T09:30:00-04:00,56.53,56.8,56.53,56.64,9780138,7190330.85,75.21954900986017,60.76923756129745,NaN,NaN,163.98855861400068,207.3974116293403,0.15156516895224129,0.37733746284624203,0.22577229389400075,721948110,713784185.2,79.6596788750678,62.08159468414364,NaN,NaN,30.870481280474298,15.54065944466436
2017-06-01T09:30:00-04:00,56.71,57.1,56.53,57.1,23243909,7803834,79.4942190800713,62.711383617397566,NaN,NaN,164.26736505646514,193.6966531919445,0.1740654918596043,0.44335415871850614,0.26928866685890185,745192019,721587659.4,82.8976141286093,63.85318430920342,NaN,NaN,35.70488876147845,18.421263632780658
2017-06-02T09:30:00-04:00,57.25,57.29,56.98,57.27,17247921,8086846.05,80.81159023984337,64.9963691102652,NaN,NaN,162.1011968627071,175.48487146453948,0.18743740711731505,0.5035854257555457,0.3161480186382306,762439940,731633388,85.9896088329101,66.01834281079888,NaN,NaN,40.098195309650094,21.51796815804772
2017-06-05T09:30:00-04:00,57.2,57.36,57.03,57.33,17359552,8527848.9,81.26897366788201,67.04116246113027,NaN,NaN,142.60380175325474,160.30302042511386,0.18693968462755495,0.5498226244226743,0.3628829397951193,779799492,744309506.6,88.7528258591613,68.29452775484454,NaN,NaN,43.74317593969993,24.69299784114089
2017-06-06T09:30:00-04:00,57.28,57.33,57.08,57.19,14846461,9004000.7,76.67631526615575,68.84003492188738,NaN,NaN,120.36874380090492,150.6659332174665,0.16458522721376995,0.5686144738123318,0.4040292465985618,764953031,754866518.4,90.44331175173667,70.56099394224846,NaN,NaN,45.37061210781868,27.646942736380574
2017-06-07T09:30:00-04:00,57.07,57.25,57.05,57.17,10077731,9145043.4,76.01542743666924,70.72509966144229,NaN,NaN,102.27527235878306,138.32327596642298,0.13698624601467463,0.5752620541169051,0.4382758081022305,754875300,761451956.4,91.31976353585522,73.18047525746006,NaN,NaN,46.48892008976024,30.338653786863382
2017-06-08T09:30:00-04:00,57.14,57.15,56.58,56.74,10593403,9413099.4,63.36903251743979,71.63792424508746,NaN,NaN,66.21965938045744,118.71373483122143,0.08106942158049357,0.5396125850778475,0.4585431634973539,744281897,761269932,91.07114641073977,75.99192943055778,NaN,NaN,43.46029744409361,32.21317430932484
2017-06-09T09:30:00-04:00,56.7,56.83,56.52,56.67,13410191,9830662.25,61.57317927056123,71.94958926996713,NaN,NaN,47.93663096950238,95.8808216525805,0.03312435931327906,0.49994861263895274,0.4668242533256737,730871706,754956285.2,82.6645372122185,78.1452720593842,NaN,NaN,40.45838429298799,33.39106144984815
2017-06-12T09:30:00-04:00,56.69,56.915,56.53,56.66,11442372,10128840.45,61.305889334040295,71.84556915558075,NaN,NaN,45.661536458192295,76.492368593568,-0.003557234763051642,0.4623777098718591,0.46593494463491075,719429334,742882253.6,69.45978646967116,79.29992226581011,NaN,NaN,37.96896361672357,34.0450474736875
2017-06-13T09:30:00-04:00,56.66,56.8,56.435,56.75,9520637,10239689.05,62.86818904646462,71.78309801159902,NaN,NaN,37.09363060139217,59.837345953665455,-0.02486632137269651,0.4348520429190401,0.4597183642917366,728949971,735681641.6,62.99682703599674,79.6743261016189,NaN,NaN,36.306109225625086,34.36805629539287
2017-06-14T09:30:00-04:00,56.98,57.2299,56.91,57.11,16040224,10801844.65,68.36954339629635,71.86964625816954,NaN,NaN,76.32114860699177,54.64652120330719,-0.01813571597838698,0.4370487193187529,0.45518443529713987,744990195,733704620.6,61.31005554720271,79.3515885147566,NaN,NaN,36.43284164512229,34.6630256310685
2017-06-15T09:30:00-04:00,56.83,57.07,56.63,56.98,10361114,10618813.2,64.64491141297131,71.36418688930686,NaN,NaN,50.70940188231065,51.54446970367784,-0.02541252461713711,0.4234187795257185,0.4488313041428556,734629081,731774057.4,59.63099237140871,78.51152521113997,NaN,NaN,35.40192576135793,34.76858279253842
2017-06-16T09:30:00-04:00,56.05,56.07,55.445,55.95,26268033,11536886.35,44.131176146944206,69.22704648967019,NaN,NaN,-98.61115354948222,22.23491279988091,-0.09846542382177187,0.32574952436564075,0.4242149481874126,708361048,727271925.8,55.79358057572075,77.10941904119542,NaN,NaN,26.178795126096826,33.541470268761046
2017-06-19T09:30:00-04:00,56.08,56.22,55.71,56.22,7883114,11617161.15,48.724543314612426,67.4623242242723,NaN,NaN,-80.25260911666525,-2.9479163150906063,-0.12572856302660995,0.26705424440415015,0.3927828074307601,716244162,726634891.4,55.25177683259651,75.51725038849249,NaN,NaN,20.704427302088067,31.707606987807765
2017-06-20T09:30:00-04:00,56.27,56.3,55.985,56,7231693,11623656.9,45.44585937418926,65.33563210743866,NaN,NaN,-83.16062834769276,-26.9987681049076,-0.1538464833945718,0.20047470318754534,0.35432118658211714,709012469,722647391,51.85717266223077,73.53135708757556,NaN,NaN,15.21949635535631,29.35216261174327
2017-06-21T09:30:00-04:00,56,56.12,55.78,55.84,12517762,11873618.8,43.1706451197131,62.741091110270204,NaN,NaN,-116.27165984977992,-65.51732979626193,-0.1768464691027004,0.13326310020374166,0.31010956930644207,696494707,712948293.4,44.66834565374467,70.80069505365665,NaN,NaN,10.129240964481465,26.606030947848726
2017-06-22T09:30:00-04:00,55.76,55.79,55.45,55.47,7227619,11977352.6,38.384848532365055,59.710609559736035,NaN,NaN,-164.19241246641047,-108.49769266600615,-0.20843157578668847,0.04957009957308145,0.2580016753597699,689267088,703875894.8,39.19497270633518,67.4582210446156,NaN,NaN,4.151806717632457,23.3982846292464
2017-06-23T09:30:00-04:00,55.46,55.66,55.42,55.49,10146430,12182841.65,38.77991717918984,56.67567695340089,NaN,NaN,-150.25106021058937,-118.82567399822759,-0.21837797988114138,-0.014970799491656805,0.20340718038948458,699413518,702086388.8,38.200662745572544,63.84735225078782,NaN,NaN,-0.28897274720866456,20.01439071832425
2017-06-26T09:30:00-04:00,55.66,55.89,55.61,55.71,6590516,12301987.35,43.101688576973416,54.277489332745006,NaN,NaN,-104.22521966006066,-123.62019610690668,-0.2009789971125155,-0.0478165660011598,0.1531624311113557,706004034,700038363.2,37.04247665461994,60.03300688670806,NaN,NaN,-2.581379343427795,16.786423566645386
2017-06-27T09:30:00-04:00,55.6,55.76,55.22,55.23,10585478,12618714.9,36.969509771280336,51.48849521378865,NaN,NaN,-126.25912346526296,-132.2398951304207,-0.2115668319375581,-0.11129610881059193,0.10027072312696617,695418556,697319580.6,35.503600637242215,56.046138108235695,NaN,NaN,-6.711273100935314,13.429609756991
2017-06-28T09:30:00-04:00,55.56,55.67,55.41,55.43,10734272,12666421.6,40.75191687730405,49.872986953778955,NaN,NaN,-99.63804419823511,-128.91317200011173,-0.19526301503688454,-0.14380804566913952,0.051454969367745025,706152828,699251204.8,37.4905293071929,52.21895117226806,NaN,NaN,-8.79281944815956,10.254977013398063
2017-06-29T09:30:00-04:00,55.36,55.51,54.64,54.84,19058635,12457157.9,34.22677113808655,47.91967208717363,NaN,NaN,-134.83778163532872,-123.04224583389541,-0.2129296153421579,-0.21470704980995237,-0.0017774344677944573,687094193,698816625.8,37.21276938629042,48.97239632755891,NaN,NaN,-12.97156438564255,6.936899670677976
2017-06-30T09:30:00-04:00,55.05,55.145,54.925,54.94,11222574,12155890.55,36.09449687957313,46.11885834042597,NaN,NaN,-120.92961810809837,-117.1779574133972,-0.2064426049563077,-0.2598306906631791,-0.05338808570687139,698316767,698597275.6,37.06350764367072,46.65837641141603,NaN,NaN,-15.585225527734755,3.7194532137618714
2017-07-03T09:30:00-04:00,54.98,55.205,54.87,54.89,5782551,11577040.5,35.55090952413886,44.16762408883128,NaN,NaN,-113.34780215628963,-119.002473912643,-0.19425876424307337,-0.2962115410107131,-0.10195277676763974,692534216,695903312,35.196302929862384,44.672624689549295,NaN,NaN,-17.806943631586,0.6442536644264614
2017-07-05T09:30:00-04:00,54.88,55,54.79,54.85,15837003,11626567.6,35.095549325136076,41.79091022660555,NaN,NaN,-114.43107306556847,-116.63686383270408,-0.1780620260532143,-0.3245303093341576,-0.1464682832809433,676697213,692159043.4,32.728389042043034,42.63107708203789,NaN,NaN,-19.721307772109654,-2.265112255078698
2017-07-06T09:30:00-04:00,54.66,54.83,54.53,54.54,7942458,11519803.95,31.706068851128563,39.438135757902494,NaN,NaN,-129.22267572440794,-122.55379013793865,-0.17702407110265517,-0.36774837215926226,-0.1907243010566071,668754755,684679428.8,28.43858162920884,40.40304774330933,NaN,NaN,-22.42903174127024,-5.145672181677489
2017-07-07T09:30:00-04:00,54.59,54.7,54.36,54.51,9841537,11482210.65,31.390118896865104,38.52806024003969,NaN,NaN,-127.9299958481889,-121.17223298051067,-0.16726933959042006,-0.3998109755446322,-0.23254163595421212,658913218,679043233.8,25.70448678121481,38.253826757987476,NaN,NaN,-24.705058624110205,-7.9398702448821625
2017-07-10T09:30:00-04:00,54.56,54.56,54.06,54.13,9119230,11267662.6,27.633791786489965,37.021577988030955,NaN,NaN,-140.6796456476882,-125.12223848842864,-0.17451740222230766,-0.4506883887320967,-0.27617098650978905,649793988,669338678,21.81543400850127,35.86551655626638,NaN,NaN,-27.901099002713025,-10.791474353143714
2017-07-11T09:30:00-04:00,54.18,54.2,53.86,53.98,11256392,11258363.6,26.296105651150356,35.65373843638532,NaN,NaN,-147.79867149321552,-132.01241235581384,-0.17696670826587774,-0.4973793718421362,-0.32041266357625847,638537596,658539354,18.467031999289148,33.4805065089134,NaN,NaN,-30.96430813243687,-13.673307750185593
2017-07-12T09:30:00-04:00,54.32,54.47,54.24,54.28,8100821,11187372.8,33.25510038804774,34.94548524126636,NaN,NaN,-103.67657149649084,-129.8615120419983,-0.14715855833439206,-0.5043608614942485,-0.35720230315985646,646638417,652527594.8,16.91095343853803,31.49783563639864,NaN,NaN,-31.499964311111743,-16.219972973175043
2017-07-13T09:30:00-04:00,54.35,54.41,54.24,54.29,10008222,10885772.7,33.48055965350967,34.595178892776694,NaN,NaN,-96.32966741750897,-123.2829103806185,-0.11686637078912188,-0.5032852666462588,-0.38641889585713696,656646639,650105971.6,16.31460424529915,29.863523603467495,NaN,NaN,-31.863964142685557,-18.454828854533687
2017-07-14T09:30:00-04:00,54.54,54.7984,54.52,54.72,6341071,10684770.55,42.47832506297431,34.85935088447558,NaN,NaN,-51.28978508891759,-107.95486822876424,-0.06078898346939632,-0.4624051251938823,-0.401616141724486,662987710,650920870,17.370567706904268,28.375659672134045,NaN,NaN,-29.3916829039039,-20.01723657587229
2017-07-17T09:30:00-04:00,54.82,54.84,54.62,54.78,7902171,9766477.45,43.62422341517087,34.89667480148969,NaN,NaN,-38.867682729177766,-87.59247564506215,-0.014963587003031686,-0.42032062547827564,-0.40535703847524396,670889881,655140048.6,22.802000276143957,27.358482787957183,NaN,NaN,-27.044885985507882,-21.021186491534518
2017-07-18T09:30:00-04:00,54.74,54.87,54.61,54.78,5310799,9637861.7,43.62422341517086,35.37201149033901,NaN,NaN,-33.19283139813079,-64.6713076260452,0.018238862417416013,-0.38255846045347397,-0.40079732287089,670889881,661610505.6,30.36193502840348,26.991220958754415,NaN,NaN,-25.14447338591257,-21.61022747644567
2017-07-19T09:30:00-04:00,54.76,54.98,54.685,54.98,5591984,9555876.25,47.65542366709013,35.86511911818088,NaN,NaN,-7.919112297938855,-45.51981578633481,0.054510928620274623,-0.33265866209554673,-0.38716959071582135,676481865,667579195.2,36.535960714312566,26.92303748783439,NaN,NaN,-22.327814970893677,-21.71273997565253
2017-07-20T09:30:00-04:00,54.94,55.16,54.84,54.99,9816651,9420820.7,47.856193866916435,36.83864931309729,NaN,NaN,19.64623951466305,-22.324634399900408,0.07855593194879029,-0.2889746757798335,-0.3675306077286238,686298516,673509570.6,42.03486850628665,27.267473139262687,NaN,NaN,-19.95349774060358,-21.461419656359823
2017-07-21T09:30:00-04:00,54.8,55.1,54.75,55.08,7772496,9448064.55,49.72517668145999,37.812269298946354,NaN,NaN,23.080098350665843,-7.4506577119837205,0.09860313858453545,-0.24427668449795448,-0.34287982308248993,694071012,679726231,47.199576526531295,27.991478059467017,NaN,NaN,-17.413682002128652,-20.883171420041084
2017-07-24T09:30:00-04:00,55.06,55.085,54.86,54.9,9302362,9405861.15,46.1615085628039,38.57016923027957,NaN,NaN,25.028148268224907,5.32850848749682,0.09763819027619347,-0.22083208523724807,-0.31847027551344154,684768650,682501984.8,49.3688064993226,29.003799742999885,NaN,NaN,-16.115269485002674,-20.202042572178453
2017-07-25T09:30:00-04:00,55.09,55.32,55.04,55.28,13799891,9766329.9,53.704677070488046,39.89939264066185,NaN,NaN,92.30858935675478,30.42879263847393,0.11906916905888965,-0.16963381418982948,-0.2887029832487191,698568541,688037716.8,53.47407879657323,30.48563472546633,NaN,NaN,-12.652711376505007,-19.123566687082246
2017-07-26T09:30:00-04:00,55.29,55.41,55.1,55.27,7593978,9616754.9,53.492277758827285,41.45555041978319,NaN,NaN,106.69640622774841,53.351896343611386,0.12825376212984485,-0.12838578058641303,-0.2566395427162579,690974563,690936256.4,55.50827084964679,32.419183955497616,NaN,NaN,-9.895631958808018,-17.805290297328785
2017-07-27T09:30:00-04:00,55.31,55.82,55.28,55.81,12859013,9722991.95,62.18870699704792,43.65544956979624,NaN,NaN,187.64245866103252,86.95114017288527,0.16408848517575078,-0.0515289362465694,-0.21561742142232018,703833576,694443268.4,57.90631208414354,34.71931433427824,NaN,NaN,-4.421231436411571,-15.893281888626326
2017-07-28T09:30:00-04:00,55.64,55.87,54.57,55.34,18412186,9690669.5,52.91445292662386,45.46121107980581,NaN,NaN,96.24270933563061,101.58366236987823,0.149918646689762,-0.028219113060117706,-0.1781377597498797,685421390,692713344,56.29448745750778,37.18210386635013,NaN,NaN,-2.62517993299029,-13.997838752106892
2017-07-31T09:30:00-04:00,55.2,55.4466,55.185,55.32,7279311,9493506.35,52.55528242807855,47.3368665638721,NaN,NaN,100.60392646865438,116.69881800996413,0.1335259779296161,-0.011230287337859579,-0.14475626526747568,678142079,691388029.8,55.03070202856296,39.79379458272683,NaN,NaN,-1.343269155092763,-12.190043095390589
2017-08-01T09:30:00-04:00,55.38,55.525,55.23,55.26,19015257,10155141.65,51.427493966256755,48.63489467660132,NaN,NaN,96.63904847707556,117.56490983402827,0.11374237373508508,-0.002578298098619314,-0.1163206718337044,659126822,683499686,48.10798884721168,42.022154254774954,NaN,NaN,-0.6500047137711328,-10.541466183730666
2017-08-02T09:30:00-04:00,55.15,55.31,54.97,55.22,17133677,10219975.35,50.64719665738141,49.86108303402073,NaN,NaN,57.808950665600086,107.78741872159863,0.09388759752524097,0.0010388250728468051,-0.09284877245239416,641993145,673703402.4,41.179854570945096,43.798243563749665,NaN,NaN,-0.3099297691931417,-9.07981812451102
2017-08-03T09:30:00-04:00,55.21,55.5,55.1,55.17,17803439,10713024.4,49.63343976966219,50.372162655927006,NaN,NaN,68.34369532153329,83.92766605369877,0.0741768667879701,-0.00012768896743153846,-0.07430455575540164,624189706,657774628.4,32.8866189342729,44.906532937133136,NaN,NaN,-0.30982170977142526,-7.8269614938339345
2017-08-04T09:30:00-04:00,55.14,55.32,54.94,55.02,17063732,11074134.15,46.618734734380375,50.58605632158482,NaN,NaN,33.62833591135696,71.40479136884406,0.049038859572355355,-0.013005981289957447,-0.0620448408623128,607125974,642115545.2,27.107108465469366,45.2140406649421,NaN,NaN,-1.1551312117042578,-6.8738428821011235
2017-08-07T09:30:00-04:00,55.03,55.47,55.03,55.43,16853974,11460871.35,54.71527480556403,51.37827427804148,NaN,NaN,71.42907846729739,65.56982176857267,0.05744303873814787,0.009758957560372039,-0.04768408117777583,623979948,631283119,23.96901351768706,44.757403414176636,NaN,NaN,0.511595064639171,-5.818780318281082
2017-08-08T09:30:00-04:00,55.29,55.445,55.19,55.22,9813162,11388709.85,50.49106698767114,51.58082022951155,NaN,NaN,60.556993494538325,58.3534107720652,0.04673237367678519,0.01073138591820566,-0.03600098775857953,614166786,622291111.8,21.721096751111872,43.69919884537659,NaN,NaN,0.6372124402692146,-4.896495638488182
2017-08-09T09:30:00-04:00,55.18,55.35,55.12,55.31,7251819,11346259.75,52.1944901323518,51.89069853418551,NaN,NaN,49.088228157625686,56.609266270470336,0.043641151943662596,0.01855045217099871,-0.025090699772663882,621418605,618176203.8,20.76152493687013,42.17967430470399,NaN,NaN,1.2466797392208502,-4.01889915595832
2017-08-10T09:30:00-04:00,55.17,55.34,55.06,55.08,6662766,11178986.95,47.67965314463632,51.744589710126675,NaN,NaN,11.340985634782704,45.208724333120216,0.02496657719215883,0.0061175217175346575,-0.018849055474624173,614755839,616289430.4,20.31829679114847,40.25958289503378,NaN,NaN,0.40293049043585455,-3.3872092064734383
2017-08-11T09:30:00-04:00,54.98,55.35,54.98,55.12,4928434,11108355.1,48.513767068065356,51.91260817478821,NaN,NaN,-0.21182577728544935,38.44069199539173,0.014677476086324368,-0.0005022103667187139,-0.015179686453043082,619684273,618801090.2,22.684544220743263,38.353564160849544,NaN,NaN,-0.04373148058884331,-2.9095695313470675
2017-08-14T09:30:00-04:00,55.24,55.519,55.24,55.39,10657802,11246136.65,53.86080456389679,51.92376013860312,NaN,NaN,88.33138539719133,41.821153381370515,0.024828208830988848,0.015855574585692978,-0.00897263424529587,630342075,620073515.6,23.917206748316886,36.242359014545514,NaN,NaN,1.1638286420817001,-2.327655506571529
2017-08-15T09:30:00-04:00,55.41,55.75,55.41,55.67,11059028,11533548.1,58.65607165832119,52.292602559995544,NaN,NaN,178.16843643684228,65.34344196983132,0.04783970339201997,0.05082699499472909,0.0029872916027091235,641401103,625520379,29.126296476105694,34.35793227357829,NaN,NaN,3.722724528949222,-1.4633155014971362
2017-08-16T09:30:00-04:00,55.7,55.94,55.7,55.86,5682844,11538091.1,61.574459598651636,52.24872774582438,NaN,NaN,244.02673422781962,104.33114318387011,0.07185314763100767,0.0928037261414687,0.02095057851046104,647083947,630653447.4,33.73099389886363,32.631123831772584,NaN,NaN,6.796963727826297,-0.28327561159378867
2017-08-17T09:30:00-04:00,55.66,55.93,55.345,55.35,6725638,11383540.45,51.13953498422757,52.12194789279607,NaN,NaN,102.60645329307106,122.58423671552778,0.050399637559590954,0.08395012545994973,0.03355048790035878,640358309,635773941.4,38.054585151314,31.328273667044453,NaN,NaN,6.092443448943154,0.627541397054346
2017-08-18T09:30:00-04:00,55.23,55.39,55.11,55.2,6810281,11335429.7,48.53432082507082,51.834736349724096,NaN,NaN,-36.05168117996436,115.41626563499199,0.02443243782144966,0.06409103517717085,0.03965859735572119,633548028,638546692.4,40.32502555389619,30.277868204568257,NaN,NaN,4.662484725784783,1.2039618725872656
2017-08-21T09:30:00-04:00,55.16,55.495,55.0001,55.4,6829335,11211778.35,52.04238592241034,51.87865720373507,NaN,NaN,-15.664941539122323,94.61700024772925,0.019277884232147623,0.06375595264590572,0.0444780684137581,640377363,640553750,41.9826735080521,29.840345680342576,NaN,NaN,4.612588850110213,1.6909085836619724
2017-08-22T09:30:00-04:00,55.43,55.57,55.33,55.41,7129438,10878255.7,52.21776230484446,51.990840464268146,NaN,NaN,45.56369843832935,68.09605264802667,0.01526920993458837,0.06356458083199357,0.048295370897405196,647506801,641774889.6,43.01975887165717,29.971767416107724,NaN,NaN,4.626365084549883,2.1102595123602454
2017-08-23T09:30:00-04:00,55.35,55.41,55.185,55.25,5367122,10766912.9,49.122491904087155,51.95434418815564,NaN,NaN,-29.311562740759264,13.42839325431089,0.0013050874413419802,0.04992673019908267,0.04862164275774069,642139679,640786036,42.3594330222229,30.648396993818437,NaN,NaN,3.7043056837898174,2.3379803939930413
2017-08-24T09:30:00-04:00,55.2,55.35,54.44,54.49,11807145,10714319.5,37.693153255306235,51.31680265393605,NaN,NaN,-260.2512205175688,-59.143141507817084,-0.05646046758504012,-0.021953941723559467,0.034506525861480654,630332534,638780881,40.985635789226,31.63972037408677,NaN,NaN,-1.280637363683256,1.8210350000392845
2017-08-25T09:30:00-04:00,54.7,54.89,54.635,54.67,7359198,10161670.1,41.183613126558356,50.35025539114993,NaN,NaN,-219.86323906997595,-95.9054530858194,-0.07853445728588303,-0.06366154574587313,0.014872911540009897,637691732,639609621.8,41.82540761856879,32.91517709557833,NaN,NaN,-4.071424556517556,0.9792550633883074
2017-08-28T09:30:00-04:00,54.62,54.69,54.35,54.51,6204742,10107941.65,39.08748985760285,49.53571416757363,NaN,NaN,-232.9714712477973,-139.3667590275544,-0.0985995200695127,-0.10837648854688098,-0.00977696847736828,631486990,637831547.2,40.49400251931317,34.256098936164136,NaN,NaN,-7.0113765739732266,-0.16226374194905457
2017-08-29T09:30:00-04:00,54.44,54.75,54.39,54.7,6219484,9468153,42.80995881309696,48.86539050191258,NaN,NaN,-163.4453569384694,-181.16857010291415,-0.09379267204669176,-0.12701780853573297,-0.03322513648904122,637706474,635871481.8,39.01946243389516,35.56023732880878,NaN,NaN,-8.2295015379285,-1.3147262842318326
2017-08-30T09:30:00-04:00,54.6,54.79,54.59,54.69,6497079,8936323.1,42.66218456425179,48.506999889027966,NaN,NaN,-120.73018686532296,-199.45229492782687,-0.08619833538730505,-0.14097305572317254,-0.054774720335867486,631209395,633685425,37.38440896351497,36.77924534112067,NaN,NaN,-9.235092701177585,-2.4462072009383684
2017-08-31T09:30:00-04:00,54.73,54.81,54.65,54.71,10117345,8552018.4,43.08533308599891,48.119254604594644,NaN,NaN,-97.3796505623875,-166.8779809367906,-0.07514396917287344,-0.14870468180195928,-0.07356071262908584,641326740,635884266.2,40.10317350956338,38.023433147464964,NaN,NaN,-9.927981582313446,-3.5150321125633797
2017-09-01T09:30:00-04:00,54.82,54.98,54.76,54.97,17904528,8594058.2,48.415034350401655,47.73027101791643,NaN,NaN,-51.47617870626856,-133.20056886404913,-0.04701290398664015,-0.13232684261238603,-0.08531393862574588,659231268,640192173.4,45.12986571657255,39.53862307376894,NaN,NaN,-8.968489503198368,-4.294097454082664
2017-09-05T09:30:00-04:00,54.81,55.09,54.76,55.05,20215854,8762152.2,49.96753534862287,47.109661281509396,NaN,NaN,-33.31677361180885,-93.26962933685145,-0.021033199206214714,-0.11160543763351427,-0.09057223842729956,679447122,649784199.8,54.32196317824193,41.338313552492956,NaN,NaN,-7.725094740077683,-4.7842399235105235
2017-09-06T09:30:00-04:00,55.15,55.33,55.005,55.28,17461950,9144591.6,54.23225771728828,46.58521828998345,NaN,NaN,19.927440069142882,-56.59506993532899,0.01185676398482123,-0.07575128344627302,-0.08760804743109425,696909072,661624719.4,62.64171869540819,43.40336532367471,NaN,NaN,-5.375486397048724,-4.8687037054445526
2017-09-07T09:30:00-04:00,55.32,55.44,55.18,55.36,16738124,9618906.85,55.64836240717963,46.907277391622884,NaN,NaN,45.6954711940291,-23.309938323458578,0.037754123518974725,-0.040415393032375846,-0.07816951655135057,713647196,678112279.6,70.65640850655711,45.732066991906365,NaN,NaN,-3.010781640639054,-4.6032862676151955
2017-09-08T09:30:00-04:00,55.17,55.265,54.88,55.09,9158225,9743679.8,50.022842116204224,47.01360034098956,NaN,NaN,-7.844494244364557,-5.402907059853991,0.03548884054954056,-0.033808465864424875,-0.06929730641396543,704488971,690744725.8,75.06953137681927,48.21381740782944,NaN,NaN,-2.5516998909287762,-4.3102024995171355
2017-09-11T09:30:00-04:00,55.19,55.51,55.18,55.43,9177812,9956148.7,56.04824833496826,47.299733370457986,NaN,NaN,52.58122698718215,15.408574078836143,0.05453839741887837,-0.0011243096403674713,-0.05566270705924584,713666783,701631828.8,78.12322590686158,50.79528543631584,NaN,NaN,-0.25933259975474954,-3.7315067995510804
2017-09-12T09:30:00-04:00,55.43,55.555,55.4,55.55,7453407,9795928.95,57.97408294719226,47.710899130625684,NaN,NaN,77.21970294342727,37.515869389883356,0.0717848836335102,0.0340683974826419,-0.0377164861508683,721120190,709966442.4,80.12980003677787,53.44600266239588,NaN,NaN,2.2216636919874824,-2.8810538721884287
2017-09-13T09:30:00-04:00,55.5,55.78,55.5,55.58,7972349,9641595,58.464077611526854,48.37815525258566,NaN,NaN,101.64116607919462,53.858614591893705,0.08108994877324402,0.06364594981568672,-0.017443998957557293,729092539,716403135.8,81.53814576277955,56.24448214386421,NaN,NaN,4.3766980936008215,-1.8442321627899645
2017-09-14T09:30:00-04:00,55.49,55.61,55.285,55.47,5817854,9648345.5,55.890890910797,49.67799365654928,NaN,NaN,75.22966137144938,59.76545262737776,0.07581040481306657,0.07731900705877592,0.0015086022457093534,723274685,718328633.6,81.9502834373439,59.17052840444406,NaN,NaN,5.472999775194029,-0.798913314506537
2017-09-15T09:30:00-04:00,55.26,55.26,54.995,55.22,12497722,9936949.7,50.455591139800994,50.340277800352325,NaN,NaN,15.075104513401634,64.34937237893101,0.0525590126564092,0.06720736806622085,0.014648355409811653,710776963,719586232,82.22931592910568,62.0565218551967,NaN,NaN,4.848740622468766,0.007894390775649018
2017-09-18T09:30:00-04:00,55.27,55.3899,55.14,55.3,8299356,10011403.45,52.06214656880401,51.26703899400955,NaN,NaN,41.863965267747226,62.20592003504402,0.0402021270591088,0.06490101423369765,0.024698887174588853,719076319,720668139.2,82.48024167289498,65.0555389375954,NaN,NaN,4.786257059737756,0.6905176291988071
2017-09-19T09:30:00-04:00,55.33,55.355,55,55.13,6207650,9980319.2,48.46565715240446,51.67101744681723,NaN,NaN,17.193592852065393,50.200698016771646,0.019275430739297356,0.04879317559871055,0.029517744859413192,712868669,719017835,80.61045893848674,68.02632440220908,NaN,NaN,3.6898528722463784,1.1189940924913173
2017-09-20T09:30:00-04:00,54.98,55.05,54.33,54.6,11029247,10175309.65,39.341047969397906,51.43379340432766,NaN,NaN,-90.11306138779011,11.849852523374699,-0.028943936495774137,-0.0066621757603044784,0.02228176073546966,701839422,713567211.6,74.59565331540406,70.68427042734402,NaN,NaN,-0.36886450814246174,0.9064428638293489
2017-09-21T09:30:00-04:00,54.53,54.58,54.03,54.08,10398659,10426886.5,32.81356508853989,50.70009569022345,NaN,NaN,-160.8772729574873,-35.37153434241263,-0.0910379364802416,-0.09151565986483234,-0.000477723384590744,691440763,707200427.2,68.19476983136619,72.6908130217585,NaN,NaN,-6.385554849046474,-0.13527109515291147
2017-09-22T09:30:00-04:00,54.17,54.17,53.88,53.92,11318160,10402437.25,31.10350835890202,49.46355811940204,NaN,NaN,-180.7953610339649,-74.54562745188593,-0.13539136454439296,-0.16971692906508196,-0.034325564520688995,680122603,701069555.2,62.622365072099356,73.940277261439,NaN,NaN,-11.758365470171983,-1.7957131487270646
2017-09-25T09:30:00-04:00,54.01,54.36,53.97,54.31,9185443,10493749.5,39.394365138867926,48.708331675848115,NaN,NaN,-124.3720729192188,-107.79283508927915,-0.1308919664248121,-0.19794052255170413,-0.06704855612689203,689308046,695115900.6,57.69227011008381,74.18101347085626,NaN,NaN,-13.468995963609458,-3.4633249794245495
2017-09-26T09:30:00-04:00,54.37,54.52,54.25,54.44,17321438,11049584.3,41.90400790742443,47.827742403714986,NaN,NaN,-89.12510186009749,-129.0565740317117,-0.11230269249851958,-0.20742692175004152,-0.09512422925152193,706629484,693868063.6,56.68498420801893,73.75553243604274,NaN,NaN,-13.983486096267558,-4.966205138973551
2017-09-27T09:30:00-04:00,54.33,54.38,53.72,54.02,11657799,11321500.05,36.626966790547066,46.46907128824123,NaN,NaN,-135.0156212826586,-138.0370860106854,-0.12070039238638164,-0.24599971973449897,-0.12529932734811733,694971685,692494516.2,55.53556928536846,72.67547249167214,NaN,NaN,-16.25136490183757,-6.578370819382696
2017-09-28T09:30:00-04:00,53.95,54.17,53.9,54.02,7768204,11385056.3,36.626966790547066,45.51222305069429,NaN,NaN,-120.17743640766126,-129.89711870072023,-0.11849426391887566,-0.2734171572467119,-0.15492289332783624,694971685,693200700.6,56.02923388513386,71.31545124226604,NaN,NaN,-17.991366670572358,-8.208798798124077
2017-09-29T09:30:00-04:00,54.02,54.15,53.93,53.98,14502777,11604327.9,36.12448920035041,44.08909739822159,NaN,NaN,-106.83541601320489,-115.1051296965682,-0.1120401443245494,-0.294973073733523,-0.1829329294089736,680468908,693269961.6,56.080736540259814,69.7409877160802,NaN,NaN,-19.532036576591736,-9.826404195048028
2017-10-02T09:30:00-04:00,53.98,54.2,53.84,53.88,17849974,11601600.2,34.83774999614336,42.436502187432374,NaN,NaN,-98.32758878730509,-109.89623287018546,-0.10683549948001053,-0.31647730375898675,-0.20964180427897622,662618934,687932139.2,51.111973540768716,67.66828582350811,NaN,NaN,-21.18486654490051,-11.449041673598382
2017-10-03T09:30:00-04:00,53.97,54.04,53.8001,53.94,20409189,11611266.95,36.30376532826258,40.853622738627784,NaN,NaN,-92.02756561495062,-110.47672562115608,-0.0922325113605702,-0.32493244347968897,-0.23269993211911877,683028123,683211867,47.1348902990385,65.21091043324088,NaN,NaN,-22.138139894173577,-12.976055705109124
2017-10-04T09:30:00-04:00,53.86,54.32,53.71,54.11,21389237,11807631.3,40.39546808478922,39.74680682248437,NaN,NaN,-71.11365436931288,-97.69633223848693,-0.06527417695005458,-0.314292653306687,-0.2490184763566324,704417360,685101002,48.850291951477786,62.84662532710759,NaN,NaN,-21.799918801775164,-14.236607576061415
2017-10-05T09:30:00-04:00,54.29,54.4875,54.21,54.35,19005045,11920977.35,45.69877706564406,39.407034388616026,NaN,NaN,-32.55297531443547,-80.1714400198418,-0.027368941763341592,-0.2832296535608094,-0.25586071179746783,723422405,690791146,53.721339944864546,60.81034132823322,NaN,NaN,-19.943283577505206,-15.051847004839098
2017-10-06T09:30:00-04:00,54.08,54.17,53.74,53.81,7605511,11843341.65,37.59381094970974,38.373581844395005,NaN,NaN,-77.58463644964016,-74.32128410712883,-0.034304854734068246,-0.29874178021505315,-0.2644369254809849,715816894,697860743.2,58.95168862087813,59.129730395946304,NaN,NaN,-20.79238078890895,-15.87192325970622
2017-10-09T09:30:00-04:00,53.88,53.955,53.56,53.66,12580285,12013465.3,35.699749865031265,37.46173132386836,NaN,NaN,-93.01492372775682,-73.2587510952192,-0.04401566204151747,-0.31945650303288176,-0.2754408409913643,703236609,705984278.2,63.98819944087756,57.942426146117086,NaN,NaN,-22.08584883645175,-16.75962691352701
2017-10-10T09:30:00-04:00,53.88,54.27,53.82,54.13,10646464,12173118.15,45.04288878976893,37.86900566818057,NaN,NaN,-46.64649953816336,-64.18253787986173,-0.015289390630983446,-0.2945525792800936,-0.27926318864911015,713883073,712155268.2,67.2731796521919,57.419392313030535,NaN,NaN,-20.084706344937594,-17.23463826087138
2017-10-11T09:30:00-04:00,54.1,54.39,54.1,54.24,10316307,12290316.05,46.984501059153054,38.88121538036722,NaN,NaN,-16.569707505947928,-53.27374850718875,0.013083107094387869,-0.2629093047811253,-0.27599241187551316,724199380,716111672.2,69.21226167961379,57.492070302191074,NaN,NaN,-17.859802309219738,-17.323947410635434
2017-10-12T09:30:00-04:00,54.2,54.52,54.15,54.47,8096278,12404237.25,50.89126518660816,40.29462658234623,NaN,NaN,17.801236900467643,-43.20290606420813,0.04737483372414841,-0.21677386972032764,-0.26414870344447605,732295658,717886322.8,70.06892772877866,58.02396763481102,NaN,NaN,-14.73609782840298,-16.954254613173653
2017-10-13T09:30:00-04:00,54.68,54.71,54.53,54.57,8315638,12195133.05,52.5292040929043,41.2328293647774,NaN,NaN,75.82016425077414,-12.521945924125268,0.07517471625704353,-0.17018030812317164,-0.24535502438021517,740611296,722845203.2,72.38147051829128,59.073196235397276,NaN,NaN,-11.696244304283148,-16.20311028333215
2017-10-16T09:30:00-04:00,54.51,54.62,54.49,54.59,4349599,11997645.2,52.86779198070978,42.0159567985835,NaN,NaN,88.65181564685753,23.8114019507976,0.09217156940838861,-0.1301405626197294,-0.222312132028118,744960895,731190060.4,75.77362687489531,60.43667071160274,NaN,NaN,-9.153211331730189,-15.195981861674728
2017-10-17T09:30:00-04:00,54.45,54.5,54.22,54.39,10375476,12206036.5,49.09658093370603,42.90664352309485,NaN,NaN,56.741095492835,44.48892095699726,0.08725632621372709,-0.11324172426095913,-0.20049805047468622,734585419,735330529.6,77.26564236168932,61.988818788482796,NaN,NaN,-8.055060894399187,-14.17585029492108
2017-10-18T09:30:00-04:00,54.33,54.405,54.155,54.32,4668545,11888001.4,47.81108417901835,43.70550905084281,NaN,NaN,42.210206533839575,56.24490376495477,0.07696209218626177,-0.10429543524185902,-0.1812575274281208,729916874,736474028.4,77.67457844727821,63.53491482863597,NaN,NaN,-7.507960632139262,-13.223294628809391
2017-10-19T09:30:00-04:00,54.07,54.115,53.85,54.03,8544450,11795290.95,42.81015012606349,44.18305625982231,NaN,NaN,-52.99549646956692,42.08555709094785,0.04962075345549519,-0.1192315856087518,-0.168852339064247,721372424,734289381.6,74.90253848161294,64.87932925301833,NaN,NaN,-8.49831295974556,-12.548297247514558
2017-10-20T09:30:00-04:00,53.93,53.96,53.73,53.9,11702607,11814513.3,40.75234079220758,44.60552703096975,NaN,NaN,-93.15204979149088,8.29111428249485,0.023125628386136188,-0.13994530358157675,-0.16307093196771294,709669817,728101085.8,67.54873044890564,66.05338331788525,NaN,NaN,-9.936007091295005,-12.175112939483194
2017-10-23T09:30:00-04:00,53.86,54.13,53.785,53.86,7326418,11721562.05,40.113416562739665,44.877644976289545,NaN,NaN,-66.81214124066034,-22.801677095008724,0.0042406936417846985,-0.15777006491548207,-0.16201075855726677,702343399,719577586.6,58.96214372427808,66.89818713397379,NaN,NaN,-11.300925060046302,-12.050228956706494
2017-10-24T09:30:00-04:00,53.82,53.8884,53.6001,53.67,10682309,11389605.6,37.1351708975318,44.64476660577116,NaN,NaN,-122.40152113480086,-58.6302004205359,-0.018466656726825542,-0.1850940794657987,-0.16662742273897316,691661090,710992720.8,51.817506970934204,67.11013106393497,NaN,NaN,-13.350653649666667,-12.236003912843662
2017-10-25T09:30:00-04:00,53.66,53.75,53.2,53.52,12213445,11417387.9,34.93024099016529,43.875585457522675,NaN,NaN,-171.14137877332792,-101.3005174819694,-0.039784670528976274,-0.2163582609001935,-0.17657359037121723,679447645,700898875,44.92464776522554,66.48179590824647,NaN,NaN,-15.750117799525995,-12.73802018236971
2017-10-26T09:30:00-04:00,53.71,53.94,53.545,53.56,14583737,11758164.55,36.0211763724619,43.763254416290685,NaN,NaN,-103.73701684073934,-111.44882155620387,-0.04689831614023979,-0.23519648554651695,-0.18829816940627717,694031382,695430666.6,41.68930275282724,65.24876834624283,NaN,NaN,-17.447528686403345,-13.410807111517371
2017-10-27T09:30:00-04:00,53.42,53.49,52.99,53.1,10230353,11544543.35,29.827846026648416,43.34383271354905,NaN,NaN,-197.53440475910455,-132.3252925497266,-0.07653797105590165,-0.28397063322615423,-0.20743266217025258,683801029,690256909,38.839252698236,63.45241500748273,NaN,NaN,-21.001690496088948,-14.495219023599025
2017-10-30T09:30:00-04:00,52.98,53.03,52.61,52.65,9299808,11117035.05,25.25351531256213,41.930306036605714,NaN,NaN,-236.28858762321752,-166.22058182623806,-0.11793011035810191,-0.35484530011787996,-0.23691518975977804,674501221,684688473.4,35.987624847474834,61.21773252143151,NaN,NaN,-25.789627326127647,-16.108705923960258
2017-10-31T09:30:00-04:00,52.91,53.21,52.82,53.09,10824939,10637822.55,35.64572529668692,41.12039348214385,NaN,NaN,-152.0493340427415,-172.1501444078262,-0.10745212747680122,-0.37123034910577957,-0.26377822162897835,685326160,683421487.4,35.35162837943297,58.79911585713288,NaN,NaN,-26.37200549925615,-17.574891577573958
2017-11-01T09:30:00-04:00,53.24,53.4,53.09,53.26,7556265,9946173.95,39.16498784802524,40.282802243673636,NaN,NaN,-100.61600535092535,-158.04506972334565,-0.08199809417574516,-0.3662758393486598,-0.28427774517291465,692882425,686108443.4,37.85974636756049,56.4984600456173,NaN,NaN,-25.64682623370475,-18.728025099878355
2017-11-02T09:30:00-04:00,53.2,53.29,52.93,53.13,10661369,9528990.15,37.47719009612033,39.2076583867605,NaN,NaN,-107.22189044340239,-158.74204444387826,-0.06745011399448814,-0.3685903876660248,-0.3011402736715367,682221056,683746378.2,36.51846796325524,53.93681700597186,NaN,NaN,-25.60846687319801,-19.710945353209734
2017-11-03T09:30:00-04:00,53.16,53.305,53.08,53.14,5922420,9444835.6,37.699600230484734,38.124216118887276,NaN,NaN,-87.10579132785422,-136.6563217576282,-0.0514122603958459,-0.3654055991663441,-0.3139933387704982,688143476,684614867.6,37.39667309320381,51.195606021565325,NaN,NaN,-25.51062099175517,-20.53947044443051
2017-11-06T09:30:00-05:00,53.03,53.04,52.56,52.57,10731143,9352378.5,30.942874638418715,36.827522812081035,NaN,NaN,-131.20268490124613,-115.63914121323391,-0.07217837986293862,-0.40421631359917143,-0.3320379337362328,677412333,685197090,38.01574207991914,48.3920417157246,NaN,NaN,-27.68363473729068,-21.560065343410535
2017-11-07T09:30:00-05:00,52.6,53.16,52.43,53.16,9536301,9296870.35,42.44204992228258,36.44402036517134,NaN,NaN,-93.81345967466822,-103.99196633961927,-0.0407309231829559,-0.38295158771492765,-0.34222066453197175,686948634,685521584.8,38.3814686325971,45.58539101467595,NaN,NaN,-25.457945970459466,-22.116905432988954
2017-11-08T09:30:00-05:00,53.32,53.74,53.25,53.74,12860392,9424074.6,51.06808256998245,37.03387268259412,NaN,NaN,-7.304812073661413,-85.32972768416649,0.021249121212099376,-0.31565926301684755,-0.3369083842289469,699809026,686906905,40.00885015609727,43.09298470571054,NaN,NaN,-20.259393720940817,-21.851546616982077
2017-11-09T09:30:00-05:00,53.5,53.91,53.46,53.73,10421255,9540323.45,50.92637103604123,37.76058912858225,NaN,NaN,14.308411160171138,-61.02366736345177,0.06141645103016791,-0.260137820441237,-0.3215542714714049,689387771,688340248,41.72380953714308,41.2483474977275,NaN,NaN,-16.45057193304724,-21.079978804991384
2017-11-10T09:30:00-05:00,53.65,54.33,53.62,54.28,7993623,9524222.7,57.85365427688343,39.0277489653068,NaN,NaN,75.11228767971215,-28.5800515619385,0.12140426735418164,-0.1697989372786779,-0.29120320463285954,697381394,690187831.6,43.94812040942237,40.17591726095209,NaN,NaN,-10.631375751747404,-19.58732122595653
2017-11-13T09:30:00-05:00,54.31,54.81,54.28,54.59,7809254,9697205.45,61.1799054933331,40.74523000786404,NaN,NaN,147.19404487319952,27.09929439295063,0.1750775759775153,-0.07235623466096541,-0.24743381063848072,705190648,695743494.6,50.11405625984227,40.05424221015981,NaN,NaN,-4.756279561316123,-17.468600988150758
2017-11-14T09:30:00-05:00,54.45,54.82,54.37,54.78,8903465,9623604.9,63.10199916111501,42.75749844864616,NaN,NaN,154.67673101348782,76.79733253058184,0.2139222731091173,0.019969030747915895,-0.1939532423612014,714094113,701172590.4,55.290002551323624,40.79462469488111,NaN,NaN,0.5526173655741613,-14.894141223332912
2017-11-15T09:30:00-05:00,54.61,54.66,54.16,54.2,10724836,9926419.45,54.26863851963574,44.06088860201572,NaN,NaN,108.04630744261989,99.8675564338381,0.19180920735213755,0.045808266828970545,-0.146000940523167,703369277,701884640.6,55.93575445955638,41.812228388218905,NaN,NaN,2.0494278579672924,-12.47363135457574
2017-11-16T09:30:00-05:00,54.69,55.1135,54.62,54.95,11134194,10055906.65,61.7291543351964,46.33955348119773,NaN,NaN,165.3351683761069,130.07290787702524,0.21708852110671814,0.12535971086023068,-0.09172881024648746,714503471,706907780.6,60.29268763180836,43.344616597759796,NaN,NaN,6.168069164242123,-9.810531280458903
2017-11-17T09:30:00-05:00,54.8,54.95,54.65,54.76,7298891,9835720.85,59.098822315015916,48.75707540994443,NaN,NaN,133.07096864642784,141.66464407036838,0.21026388415638803,0.17110104494899758,-0.03916283920739044,707204580,708872417.8,61.88026955385689,45.19409121964423,NaN,NaN,8.392525155962065,-7.21009464668448
2017-11-20T09:30:00-05:00,54.67,54.88,54.65,54.7,6946926,9816746.25,58.254646034922914,50.37199831981843,NaN,NaN,113.37097098873204,134.9000292934749,0.19149193397950454,0.2002020782669902,0.008710144287485691,700257654,707885819,60.570574319229905,46.99544450105829,NaN,NaN,9.820404457432895,-4.77716620323914
2017-11-21T09:30:00-05:00,54.8,55.11,54.735,54.88,10383910,9801826.3,60.09615971752707,51.867082024782846,NaN,NaN,111.82306192239253,126.32929547525582,0.1810954864414484,0.2350795023392962,0.0539840158978478,710641564,707195309.2,59.61948734252702,48.5497117135559,NaN,NaN,11.558398258326596,-2.443514137301178
2017-11-22T09:30:00-05:00,54.87,54.93,54.64,54.81,10470390,9714673.55,59.006041737980695,53.40485714205858,NaN,NaN,88.3636274711949,122.39275948097084,0.16012647145635583,0.2541421052182926,0.09401563376193676,700171174,706555688.6,58.70002466292981,50.13410862067551,NaN,NaN,12.621168122953033,-0.2914166715505764
2017-11-24T09:30:00-05:00,54.9,54.96,54.76,54.77,2331041,9102038.75,58.35464015125349,54.88021713639921,NaN,NaN,81.73598951623332,105.67292370899614,0.1351795757311245,0.2629901034258424,0.1278105276947179,697840133,703223021,54.02489123243883,51.32183848776373,NaN,NaN,13.295530413211964,1.6495757691297865
2017-11-27T09:30:00-05:00,54.74,54.895,54.72,54.8,8108867,8995964.45,58.722692536876245,56.86448984343189,NaN,NaN,72.27796501153097,93.51432298201675,0.11320631378916524,0.26931841993117445,0.1561121061420092,705949000,702971905,53.67797952543933,52.440569733872316,NaN,NaN,13.950324676296862,3.4068256130107972
2017-11-28T09:30:00-05:00,54.89,55.25,54.77,55.25,6985918,8880269.95,63.87941476828456,58.395730189574884,NaN,NaN,90.27571359860872,88.89527150399208,0.12079414130880792,0.3071047827780191,0.1863106414692112,712934918,705507357.8,56.7011799815217,53.749120544509786,NaN,NaN,16.055356509801648,5.213758598266633
2017-11-29T09:30:00-05:00,55.21,55.75,55.16,55.54,14739877,9076016.85,66.76129935309325,59.51667424551137,NaN,NaN,116.2813732355462,89.78693376662281,0.136026380059634,0.3563436165437537,0.2203172364841197,727674795,708914004,60.43730581070372,55.20829594841025,NaN,NaN,18.738198490662576,7.145821440037482
2017-11-30T09:30:00-05:00,55.75,56.2,55.605,56.05,14098318,9403119.5,71.12452614373368,60.959399610346544,NaN,NaN,147.1764521366928,101.54949869972238,0.16898134295232214,0.4315439151745224,0.26256257222220025,741773113,717234391.8,67.755477626285,57.06770081192038,NaN,NaN,22.54521804493424,9.345735240737019
2017-12-01T09:30:00-05:00,55.93,56.21,55.33,56.19,29328699,10336486,72.20322616068037,61.984369030617756,NaN,NaN,135.35577629158036,112.2734560547918,0.18731933410604784,0.49671173985476,0.3093924057487122,771101812,731886727.6,76.12938751423056,59.36636274797812,NaN,NaN,25.98552620587993,11.722848235757434
2017-12-04T09:30:00-05:00,56.25,56.77,56.08,56.72,22771284,11178929.2,75.87716872204547,63.03417354695436,NaN,NaN,183.47769326638402,134.51340170576242,0.21999633298887433,0.5843878219848051,0.36439148899593077,793873096,749471546.8,82.12810766494817,61.653080705485685,NaN,NaN,30.26431725045863,14.37162952357189
2017-12-05T09:30:00-05:00,56.72,56.93,56.48,56.63,22927975,11788770.8,74.08644717029705,63.818776976181645,NaN,NaN,185.08878610089963,153.47601620622058,0.2198793941354243,0.6392407316652111,0.4193613375297868,770945121,761073587.4,84.83578087292594,63.763493442742984,NaN,NaN,33.14421734523408,17.053427783809347
2017-12-06T09:30:00-05:00,56.62,56.99,56.62,56.99,16712198,12147565.65,76.47777949670089,65.40514418882915,NaN,NaN,169.91129787990727,164.2020011350928,0.22743077966264225,0.7036498121080896,0.4762190324454474,787657319,773070092.2,87.02477950254017,65.98413808867039,NaN,NaN,36.37948006661945,19.814292395639363
2017-12-07T09:30:00-05:00,56.89,56.915,56.41,56.44,7557540,11882423.05,66.39675437050059,65.73854419135088,NaN,NaN,121.9612954771583,159.1589698031859,0.18080023141868806,0.7022193217188075,0.5214190903001195,780099779,780735425.4,88.19717071051971,67.9773154514355,NaN,NaN,35.92671604115792,22.116067202142013
2017-12-08T09:30:00-05:00,56.45,56.59,56.2,56.59,8695470,11796133.8,67.64922449738194,66.34928720437702,NaN,NaN,96.5277958523904,151.39337371534788,0.1469142315305545,0.7050618797133126,0.5581476481827581,788795249,784274112.8,88.70457734060244,69.89333743620304,NaN,NaN,35.95355213585447,24.092850764100934
2017-12-11T09:30:00-05:00,56.53,56.605,56.2653,56.58,6737792,11733342.25,67.46868102375637,67.00743256072226,NaN,NaN,87.51691145099424,132.20121735226994,0.11224695429483733,0.6984563410513047,0.5862093867564674,782057457,781910985,86.04433033026164,71.71289143699101,NaN,NaN,35.920987429665615,25.782584573467318
2017-12-12T09:30:00-05:00,56.61,56.805,56.4,56.59,6220156,11653887.35,67.56191171546331,67.54070056057486,NaN,NaN,86.42668185686075,112.46879650346219,0.07992782327345771,0.6861191658482895,0.6061913425748318,788277613,785377483.4,86.67559604381435,73.6454706299401,NaN,NaN,35.920416107427044,27.23084622117585
2017-12-13T09:30:00-05:00,56.63,57.035,56.5475,56.91,11588967,11788162.45,70.47761505824293,68.36009865487931,NaN,NaN,94.74832303277594,97.43620153403592,0.07037599116754889,0.6941613315342678,0.623785340366719,799866580,787819335.6,87.11764447536268,75.67530061654246,NaN,NaN,36.7527810665037,28.591122627651256
2017-12-14T09:30:00-05:00,56.99,56.99,56.65,56.66,9118159,11707828.6,65.52250516345347,68.8720890128936,NaN,NaN,81.98871026057319,89.4416844907189,0.03905851427308893,0.6726084832080801,0.6335499689349912,790748421,789949064,87.50694087803177,78.06687559122767,NaN,NaN,36.02305234632536,29.652826873176128
2017-12-15T09:30:00-05:00,56.57,56.96,56.57,56.88,9090857,11605661.75,67.67623575853003,69.51162781444029,NaN,NaN,78.41804846094746,85.8197350124303,0.0256457465238058,0.6656071520897484,0.6399614055659426,799839278,792157869.8,87.91484248879514,80.51236580289594,NaN,NaN,36.01723000495348,30.56202732057289
2017-12-18T09:30:00-05:00,57,57.31,56.82,56.85,8799565,11680695.45,67.06104577685726,69.73888717219548,NaN,NaN,87.41241570073858,85.79883586237916,0.008145555245481662,0.6501433496227946,0.641997794377313,791039713,793954321,88.25083996706928,82.76591294472077,NaN,NaN,35.84070233503578,31.316123751210448
2017-12-19T09:30:00-05:00,57.07,57.18,56.9099,56.92,7888969,11727797.6,67.79663570363627,69.81283976866284,NaN,NaN,82.20318145727603,84.95413578246222,-0.004635963956100886,0.6362028394321868,0.6408388033882877,798928682,796084534.8,88.65367871077116,84.78136815186846,NaN,NaN,35.888724487103424,31.969352427766587
2017-12-20T09:30:00-05:00,56.97,57.02,56.48,56.82,13813849,11899294.55,65.5447290578414,69.41428283395625,NaN,NaN,56.569623522497615,77.31839588040656,-0.024628319108231045,0.6100534045029988,0.6346817236112299,785114833,793134185.4,84.34051821007999,85.9660139078538,NaN,NaN,35.329009527473495,32.44930344201043
2017-12-21T09:30:00-05:00,56.93,57.02,56.72,56.78,5553062,11653428.15,64.62012728215689,68.87263291406171,NaN,NaN,60.30622359585813,72.98189854746354,-0.04420706149408582,0.5794228967436226,0.6236299582377084,779561771,790896855.4,81.11755756914565,86.32231176891916,NaN,NaN,34.615575129809926,32.75877082598179
2017-12-22T09:30:00-05:00,56.86,56.955,56.8,56.87,4218648,11747808.5,65.78947556931098,68.1520834031521,NaN,NaN,63.16325775375298,69.93094040602465,-0.05410315625122264,0.5560010129236801,0.6101041691749027,783780419,787685083.6,76.59269487751064,85.92692514124506,NaN,NaN,34.29173229693436,32.97776532183216
2017-12-26T09:30:00-05:00,56.83,57.12,56.79,57,8506305,11767680.4,67.46233528706634,67.67893255434991,NaN,NaN,78.77087340613802,68.20263194710455,-0.054735566829310356,0.5416847106382647,0.5964202774675751,792286724,787934485.8,76.70137773851434,85.34589634592996,NaN,NaN,34.43196521989377,33.18550816441239
2017-12-27T09:30:00-05:00,57.08,57.2,56.91,56.99,5992589,11718013.95,67.19016118065099,67.01553124606063,NaN,NaN,92.23208877357783,70.20841341036491,-0.05833824712964508,0.5234974685555187,0.5818357156851638,786294135,785407576.4,73.00289332215796,84.34433304733122,NaN,NaN,34.483169643182606,33.37088837566528
2017-12-28T09:30:00-05:00,57.07,57.14,56.76,56.9,7291202,11345580.2,64.66168063716499,66.89159740796524,NaN,NaN,67.58877937604612,72.41224458107462,-0.06858622493328803,0.4961029345185537,0.5646891594518417,779002933,784185196.4,71.21398869500236,83.13124861765141,NaN,NaN,33.89889110160061,33.44631733651318
2017-12-29T09:30:00-05:00,56.9,57.19,56.88,56.89,5085427,10894935.65,64.37181823736208,66.65749696082096,NaN,NaN,81.11516715966377,76.57403329383574,-0.07720039555515845,0.4681886650078937,0.5453890605630521,773917506,783056343.4,69.51976310405809,81.76090474361253,NaN,NaN,33.32800137675908,33.42941505654831
2018-01-02T09:30:00-05:00,56.95,57.02,56.53,56.54,20146794,10435840.4,55.067345551693705,65.77168728424506,NaN,NaN,-39.4546815011901,56.05044544284713,-0.10586100880985228,0.41306279955073677,0.518923808360589,753770712,777054402,61.185056200164176,79.98524230574843,NaN,NaN,30.264117756413373,32.97722972795761
2018-01-03T09:30:00-05:00,56.63,56.72,56.47,56.52,17950422,10194797.3,54.58184377259785,64.84453957404038,NaN,NaN,-98.57103441192419,20.582063879234685,-0.12428279952405807,0.36357030895551645,0.4878531084795745,735820290,765761115.2,49.22615554326553,77.31028226999493,NaN,NaN,27.554937517018246,32.20261655496627
2018-01-04T09:30:00-05:00,56.67,56.9453,56.53,56.68,15455067,9821151.9,57.788155086758756,63.93814957607723,NaN,NaN,-32.680414345040745,-4.400436744489028,-0.12355094879190853,0.3334144224896889,0.4569653712815974,751275357,758757359.6,43.54218958817842,74.1977497780532,NaN,NaN,25.965494493675635,31.311599117639037
2018-01-05T09:30:00-05:00,56.77,56.9667,56.635,56.93,15555076,9763295.8,62.270100339632485,63.70583494580429,NaN,NaN,25.680037363466774,-12.782185147004903,-0.10482714414592326,0.32593144109919336,0.4307585852451166,766830433,756322859.6,41.7381254722654,70.92854867764132,NaN,NaN,25.754202199414678,30.517685272178415
2018-01-08T09:30:00-05:00,56.85,57.12,56.82,57.07,12890996,10029968.6,64.54067304028707,63.48186618021551,NaN,NaN,91.66034305264155,-10.673149968409348,-0.08258888488205207,0.3275224791425515,0.4101113640246036,779721429,757483644.2,42.95182176741408,67.71690434039981,NaN,NaN,26.21108895642761,29.902457227071157
2018-01-09T09:30:00-05:00,57.14,57.269,56.98,56.99,8357553,10013072.75,62.23585289094354,63.137209545507396,NaN,NaN,120.93236562536319,21.404259456901315,-0.07316524911281208,0.3186548026335885,0.39182005174640056,771363876,761002277,46.58428800750092,64.7407220575735,NaN,NaN,25.961942998721582,29.339526623021218
2018-01-10T09:30:00-05:00,56.85,56.86,56.325,56.71,9663462,10159356.25,54.85251379097978,62.21262940888907,NaN,NaN,-115.14532503791466,18.08940133170322,-0.08486434800933618,0.28573961673473036,0.37060396474406654,761700414,766178301.8,51.47868767291905,62.085365554869774,NaN,NaN,23.557804420619412,28.513566308392388
2018-01-11T09:30:00-05:00,56.82,56.82,56.525,56.63,11500832,10423390.05,52.92074666325025,61.310916380703986,NaN,NaN,-104.78612397457721,3.668259405795925,-0.09623252590405657,0.2503133073639958,0.3465458332680524,750199582,765963146.8,51.268397041346006,59.72307118567449,NaN,NaN,20.985512331251748,27.438130025943725
2018-01-12T09:30:00-05:00,56.72,56.92,56.5262,56.65,7308858,10209384.6,53.36294191529906,60.50683171164271,NaN,NaN,-75.49290112343662,-16.566328291584757,-0.10019625048143987,0.22130052016625257,0.32149677064769244,757508440,764098748.2,49.3857616330992,57.45651433309975,NaN,NaN,18.98088546792534,26.2299522319411
2018-01-16T09:30:00-05:00,56.76,57.11,56.725,56.91,13806680,10443810.65,58.78283435667517,60.006357339311585,NaN,NaN,33.16005923457609,-28.26638505519785,-0.0837666153368114,0.21678850147667816,0.30055511681348956,771315120,762417486.4,47.68524167910156,55.3916962474991,NaN,NaN,18.71940044836676,25.15701626285905
2018-01-17T09:30:00-05:00,57.1,57.77,57.05,57.56,12549652,10616750.4,68.60564510171447,60.08802232607216,NaN,NaN,249.92060650124324,-2.468736880021839,-0.030336276076955826,0.26263477171729477,0.2929710477942506,783864772,764917665.6,50.419331811573414,53.514407252717604,NaN,NaN,21.888572786242484,24.69009576619954
2018-01-18T09:30:00-05:00,57.55,57.65,57.285,57.39,12423340,10797939.15,64.29022717338151,59.88088418269577,NaN,NaN,202.65638957015122,61.091606041591334,-0.008776860794782737,0.2819999718007722,0.2907768325955549,771441432,766865869.2,52.50242146018661,52.05008783400536,NaN,NaN,22.997639074606212,24.448316238829065
2018-01-19T09:30:00-05:00,57.6,58.0895,57.54,58.03,9962828,10901632.1,71.54651114856861,60.37265779065318,NaN,NaN,276.6434780723675,137.37752645098027,0.04338860853968601,0.3450125932701624,0.3016239847304764,781404260,773106804.8,58.515313918921095,51.14303963571383,NaN,NaN,26.790649023698972,24.782935208096195
2018-01-22T09:30:00-05:00,58,58.47,57.97,58.47,7871602,10604519.75,75.26745693889295,61.15091769790539,NaN,NaN,279.76024089916865,208.42815485550136,0.09914033533545391,0.4255494038997938,0.3264090685643399,789275862,779460289.2,63.57126647540514,50.71814701938149,NaN,NaN,31.386882819084533,25.726356295380242
2018-01-23T09:30:00-05:00,58.2,58.44,58.01,58.28,10908949,10872314.1,70.95254999840189,62.28557515838454,NaN,NaN,198.54556113143076,241.50525523487227,0.11378617210323089,0.4686417836933785,0.3548556115901476,778366913,780870647.8,64.60257617947067,50.96225558933195,NaN,NaN,33.35240477751674,26.815791792828314
2018-01-24T09:30:00-05:00,58.43,58.47,58.12,58.4,16603484,11491555.9,72.04266493631233,63.532776670078434,NaN,NaN,166.50719008485655,224.82257195159497,0.12142400847110257,0.5066356221790258,0.38521161370792323,794970397,783091772.8,66.22430223287967,52.17640892430439,NaN,NaN,35.25245085105632,28.0210288011466
2018-01-25T09:30:00-05:00,58.5,58.735,58.13,58.43,12144584,11673469.85,72.32231742866364,64.57093112307163,NaN,NaN,146.89001568025992,213.66929717361668,0.11824863833206817,0.5330224116230085,0.4147737732909403,807114981,790226482.6,70.84499372766751,54.12660921998218,NaN,NaN,36.813405537220284,29.2770826205857
2018-01-26T09:30:00-05:00,58.32,58.73,58.24,58.71,6342713,11690976.05,74.85084545905372,65.46955577445887,NaN,NaN,135.57030817652978,185.45466319444913,0.12414712137927969,0.5699576750150399,0.4458105536357602,813457694,796637169.4,74.2532898273789,56.44912095963314,NaN,NaN,38.9648429905372,30.661048387721628
2018-01-29T09:30:00-05:00,58.81,58.95,58.44,58.48,10760833,11864457.6,69.25407054403114,65.8062270247263,NaN,NaN,122.35969434372304,153.97455388336,0.10259374663675014,0.5740527369316979,0.47145899029494776,802696861,799321369.2,75.54252109390572,58.77702805438254,NaN,NaN,38.950809613928286,31.845299991465435
2018-01-30T09:30:00-05:00,58.08,58.58,57.94,58.09,10898141,12155093.3,60.93407981118124,65.71324323331471,NaN,NaN,71.7375682225345,128.61295530158074,0.05451928466975514,0.5396080961321417,0.4850888114623865,791798720,802007730.6,76.79487556087429,60.93492716533778,NaN,NaN,36.13635758276413,32.45830821879382
2018-01-31T09:30:00-05:00,58.14,58.29,57.585,57.82,13960180,11845762.6,55.92490028882927,65.78984226887539,NaN,NaN,36.84463895723605,102.68044507605666,-0.00012407905486794268,0.4849337126438016,0.4850577916986695,777838540,798581359.2,71.74846178274225,62.38276817318229,NaN,NaN,32.11098620822293,32.40869078871226
2018-02-01T09:30:00-05:00,57.6,57.9,57.425,57.57,14094454,11652964.2,51.687921085792865,65.701783299057,NaN,NaN,5.639995471578955,74.43044103432047,-0.05474357164245369,0.4166283271456024,0.4713718987880561,763744086,789907180.2,60.847347463745045,63.06697891763936,NaN,NaN,27.364323465751326,31.68806688543213
2018-02-02T09:30:00-05:00,57.29,57.44,56.43,56.47,15569063,11658664,38.03392857530623,64.60685377477179,NaN,NaN,-84.78739390860235,30.35890061729404,-0.1606051007796901,0.2706155228134435,0.43122062359313357,748175023,776850646,48.822878750888385,63.026772997481444,NaN,NaN,17.195551418479504,29.617707533010325
2018-02-05T09:30:00-05:00,56.23,56.57,54.39,54.42,39487472,12855283.8,24.85598918264789,62.18350769091271,NaN,NaN,-220.60072379914124,-38.23318301127881,-0.35329543853280776,-0.010398674572876132,0.3428967639599316,708687551,758048784,37.37019550356517,62.289983984943134,NaN,NaN,0.3119875792297589,25.431176111041673
2018-02-06T09:30:00-05:00,53.53,55.13,53.24,55.02,38881650,14154816.5,32.25441600961004,59.58699132719096,NaN,NaN,-225.37091228439652,-97.65487911266503,-0.42038520457655026,-0.18258474176075623,0.23780046281579403,747569201,749202880.2,33.40045364840486,61.074349830431096,NaN,NaN,-8.13002428574467,20.63671891150077
2018-02-07T09:30:00-05:00,54.9,55.795,54.72,54.78,17526891,14613283.4,30.942096973631337,57.20498202720881,NaN,NaN,-147.9535483671595,-134.61451657754415,-0.4578827038541159,-0.33455291700185086,0.12332978685226505,730042310,739643634.2,29.72564829192889,59.44743746126983,NaN,NaN,-14.553693413742174,15.609517150751778
2018-02-08T09:30:00-05:00,54.91,55.02,53.58,53.6,32928438,15776532.2,25.457741806010816,53.91292707416896,NaN,NaN,-181.04041211809601,-171.95059809547914,-0.5338116594326819,-0.5439347874385874,-0.010123128005905438,697113872,726317591.4,25.511746454818862,57.090039785262526,NaN,NaN,-22.2291503328823,10.203993224518339
2018-02-09T09:30:00-05:00,54.01,54.1,52.66,53.71,34911995,16947090.35,26.76095026745398,50.448176597637605,NaN,NaN,-176.0998313924611,-190.21308559225088,-0.5463069348859642,-0.6930067966133606,-0.14669986172739646,732025867,723087760.2,24.601461645911314,54.30648229744155,NaN,NaN,-27.12081015501627,4.871878456013395
2018-02-12T09:30:00-05:00,54.02,54.52,53.89,54.26,21013577,17632326.3,33.062342902615086,47.74173323365283,NaN,NaN,-119.00981384384002,-169.89490360119063,-0.4890632694736968,-0.7580289485695175,-0.2689656790958207,753039444,731958138.8,31.798863197847567,51.963359941611316,NaN,NaN,-28.54911617365933,0.09745065177443468
2018-02-13T09:30:00-05:00,54.06,54.65,54.05,54.51,11994496,17541717.1,35.76760865016796,45.15065778464252,NaN,NaN,-95.52117546232017,-143.92495623677536,-0.409140019553121,-0.780390703537222,-0.37125068398410094,765033940,735451086.6,34.452277319765415,49.693929590674585,NaN,NaN,-28.669622749314755,-4.012131262666878
2018-02-14T09:30:00-05:00,54.22,54.66,53.94,54.48,20370526,17932760.8,35.58177133600125,42.52633306373806,NaN,NaN,-85.01811580316176,-131.3378697239758,-0.33612778727091974,-0.7914104180727506,-0.45528263080183085,744663414,738375307.4,36.673547232382674,47.25311198386852,NaN,NaN,-28.82147035940676,-7.556322562201147
2018-02-15T09:30:00-05:00,54.68,55.38,54.45,55.38,14788934,18051040.5,44.8408270792772,40.38276032232545,NaN,NaN,-51.94423717190461,-105.51863473473755,-0.21115813824973906,-0.7192303036140046,-0.5080721653642656,759452348,750843002.6,45.20028189662156,45.17789713167158,NaN,NaN,-25.72780650464108,-10.152248839692566
2018-02-16T09:30:00-05:00,55.4,55.835,55.1,55.6,11591638,18132481,46.851822811977065,38.78259977003587,NaN,NaN,-31.41842292209146,-76.5823530406636,-0.10308844178927867,-0.6369327176008639,-0.5338442758115852,771043986,758646626.4,49.76003903482168,43.33629127030843,NaN,NaN,-22.622377629377404,-11.933695809647542
2018-02-20T09:30:00-05:00,55,55,54.28,54.34,16069819,18542391.85,38.250535242938895,37.16234658658999,NaN,NaN,-62.05181725927227,-65.19075372375003,-0.1054916832912085,-0.6657088799255959,-0.5602171966343874,754974167,759033571,49.98228015946547,41.421105884493514,NaN,NaN,-22.852344036110452,-13.493502699142244
2018-02-21T09:30:00-05:00,54.42,54.58,53.67,53.69,15207358,18757312.3,34.71036867045606,35.64702289956334,NaN,NaN,-77.11100180357283,-61.50871899200056,-0.1378420283870435,-0.7325197321181918,-0.5946777037311483,739766809,753980144.8,47.05475605337879,39.65726976096756,NaN,NaN,-24.301676034899984,-15.03752746139335
2018-02-22T09:30:00-05:00,53.8,54.23,53.73,53.83,10239219,18439099.05,36.08252982437172,34.53235209517611,NaN,NaN,-74.14312471408593,-59.333720774185394,-0.13653665501616574,-0.7653485225013554,-0.6288118674851897,750006028,755048667.6,47.75160701219439,38.72185972871394,NaN,NaN,-24.956297031070996,-16.45449454277587
2018-02-23T09:30:00-05:00,53.94,54.36,53.75,54.35,10321054,18347922.55,41.03913937498899,34.747010009439165,NaN,NaN,-61.46131588116582,-61.23713651603763,-0.089643052253081,-0.740865682801541,-0.65122263054846,760327082,755223614.4,47.87257935098504,38.65398120014942,NaN,NaN,-23.854203489623746,-17.511595820896993
2018-02-26T09:30:00-05:00,54.44,54.73,54.29,54.69,10100410,18535807.4,44.091949127005066,36.12100714832182,NaN,NaN,-38.308095262873046,-62.61507098419395,-0.02791673548074436,-0.6861185498993905,-0.6582018144186461,770427492,755100315.6,47.78859952443705,39.398152915925984,NaN,NaN,-21.97531383391463,-18.149269822756654
2018-02-27T09:30:00-05:00,54.72,54.85,53.96,53.97,9832586,18489395.05,39.435435959830144,36.63393714476611,NaN,NaN,-51.90897122437237,-60.58650177721397,-0.02771245220752705,-0.692842379678055,-0.6651299274705279,760594906,756224463.4,48.67266835936793,40.48902539528048,NaN,NaN,-21.877028978661432,-18.681806845028767
2018-02-28T09:30:00-05:00,54.29,54.32,53.41,53.41,13726422,18630809.1,36.230522216167685,37.01168180494728,NaN,NaN,-84.51980722478189,-62.068262861455786,-0.05580570802338469,-0.7348870624997588,-0.6790813544763741,746868484,757644798.4,49.828591842508246,41.924949934607575,NaN,NaN,-22.841071582865663,-19.27598752186261
2018-03-01T09:30:00-05:00,53.28,53.79,52.82,53.29,27808582,19323229.2,35.56354251548984,37.73352471276721,NaN,NaN,-119.8699654689394,-71.21363101242648,-0.07195565365738577,-0.7690259215481063,-0.6970702678907206,719059902,751455573.2,45.06583905020805,43.32167083427824,NaN,NaN,-23.811200567463384,-19.923875099805578
2018-03-02T09:30:00-05:00,53.09,53.83,52.969,53.74,25965381,19916775.55,40.02258602683975,38.68078440986619,NaN,NaN,-106.25333983875431,-80.17203580394417,-0.04323308714722507,-0.751111626824752,-0.7078785396775269,745025283,748395213.4,42.88317332687035,44.62750738291817,NaN,NaN,-23.257015983672922,-20.400038083215197
2018-03-05T09:30:00-05:00,53.45,54.27,53.45,54.21,18859693,20081307.05,44.35385509427192,39.487320994984536,NaN,NaN,-45.48109506789753,-81.60663576494906,0.013483906478731655,-0.6910236565791124,-0.704507563057844,763884976,747086710.2,41.94769263537266,45.35242377131282,NaN,NaN,-21.450825490823902,-20.55015057001644
2018-03-06T09:30:00-05:00,54.23,54.3,53.82,54.25,20784273,19146147.1,44.71973985579572,40.126758938243654,NaN,NaN,-18.35118407935787,-74.89507833594617,0.057301738160457694,-0.632880390357272,-0.6901821285177296,784669249,751901578.8,46.56675470817553,46.21774358477069,NaN,NaN,-19.895131621769824,-20.456576434552638
2018-03-07T09:30:00-05:00,53.74,53.97,53.47,53.76,12592933,17831711.25,41.15027769622475,40.52450939254533,NaN,NaN,-73.68934041091026,-72.72898497317183,0.05678365781596695,-0.619202556247771,-0.6759862140637379,772076316,756943145.2,50.966178410784444,47.23864581179938,NaN,NaN,-19.58716834569117,-20.332375279001
2018-03-08T09:30:00-05:00,53.79,54.27,53.7,54.25,10717578,17491245.6,45.8084916932176,40.59362829354108,NaN,NaN,-13.568633732912135,-51.46871862596639,0.09091573446953916,-0.562341545976814,-0.6532572804463531,782793894,769689943.6,59.94570835540196,48.29189055885513,NaN,NaN,-17.92843465202608,-19.988955189433153
2018-03-09T09:30:00-05:00,54.4,54.61,54.2,54.6,11486803,16419163.85,48.91872788141565,40.741264369929546,NaN,NaN,51.582461504991336,-19.90155835721726,0.1358349101019477,-0.4834636428189185,-0.6192985529208662,794280697,779541026.4,65.24314602467983,49.39782677241642,NaN,NaN,-15.601461577651346,-19.362170387750037
2018-03-12T09:30:00-04:00,54.62,54.91,54.4,54.5,10915661,15219347.15,48.069837861841506,41.442643128422596,NaN,NaN,67.01420904556554,2.59750246547532,0.15613294902673203,-0.42413236663745124,-0.5802653156641833,783365036,783437038.4,67.09658695244462,50.62027725762922,NaN,NaN,-13.931607553543065,-18.58637569714904
2018-03-13T09:30:00-04:00,54.67,54.77,54.37,54.46,12406076,14788972.1,47.71317387958866,42.37141492907492,NaN,NaN,49.826773442385,16.23309396982389,0.16340808096829118,-0.3760052144538193,-0.5394132954221105,770958960,780694980.6,64.4900031606694,51.865652051007125,NaN,NaN,-12.650631187913186,-17.738412195829632
2018-03-14T09:30:00-04:00,54.59,54.6,53.795,53.91,13519000,14865197.3,42.98992660922361,42.864800413707194,NaN,NaN,-21.29877036699816,26.711207978606307,0.12921988405284068,-0.3778884403560596,-0.5071083244089003,757439960,777767709.4,61.73286376548464,52.864313247670715,NaN,NaN,-12.823798481666934,-17.036324522377818
2018-03-15T09:30:00-04:00,53.84,54.075,53.375,53.53,9280061,14310674.05,40.04069061608819,42.79348264521428,NaN,NaN,-87.77165974943213,11.870602775302316,0.0813899622583591,-0.4053708715859514,-0.4867608338443105,748159899,770840910.4,55.66793447588289,53.421124328020554,NaN,NaN,-13.818267452194167,-16.576602083780152
2018-03-16T09:30:00-04:00,53.23,53.5589,53.2,53.25,9629082,14052681.45,37.97349077881985,42.35644990605819,NaN,NaN,-133.728452858292,-25.191580097354354,0.033713257323776114,-0.44461926218959036,-0.47833251951336647,738530817,759690934.4,47.566904520808805,53.405288970618535,NaN,NaN,-15.256773207827424,-16.38805510150119
2018-03-19T09:30:00-04:00,53.21,53.31,52.54,52.73,10714816,14008840.35,34.41950623947655,41.99816921174722,NaN,NaN,-198.8590180983883,-78.36622552614513,-0.026761201245806665,-0.5117840210706248,-0.48502281982481815,727816001,748581127.4,41.14236955981112,52.86741048493592,NaN,NaN,-17.582042200462848,-16.55862468706714
2018-03-20T09:30:00-04:00,52.81,53.02,52.405,52.58,9888178,13699758.3,33.44706008969486,41.79935048842773,NaN,NaN,-190.21967889737,-126.37551599409612,-0.06841334300918511,-0.5705394985862995,-0.5021261555771144,717927823,737974900,36.12593647110366,51.88864938697844,NaN,NaN,-19.793788081639487,-17.020790886291763
2018-03-21T09:30:00-04:00,52.29,52.5,51.82,51.93,17028492,13790815,29.55088711903133,41.36987510296641,NaN,NaN,-218.74096849187657,-165.8639556190718,-0.12783745121068502,-0.6619229695904707,-0.5340855183797857,700899331,726666774.2,31.68948903819539,50.93319581469182,NaN,NaN,-22.976257807841353,-17.871571875084562
2018-03-22T09:30:00-04:00,51.78,52.19,51.46,51.5,15584092,14058058.65,27.286417102936483,40.460148751259034,NaN,NaN,-208.88296257056066,-190.0862161832975,-0.1809543202797419,-0.7602784187294631,-0.5793240984497212,685315239,714097842.2,27.628221628908662,49.84355640769456,NaN,NaN,-26.40614826048014,-19.090797072998217
2018-03-23T09:30:00-04:00,51.68,51.89,50.81,50.86,15936407,14338826.3,24.30154248046489,39.02784070741568,NaN,NaN,-206.98114694508618,-204.73675500065633,-0.24032273790653824,-0.8797275208328941,-0.6394047829263558,669378832,700267445.2,23.985572128930983,48.56054780009157,NaN,NaN,-30.382216588370298,-20.70385700376566
2018-03-26T09:30:00-04:00,51.24,51.635,51.08,51.59,12374650,14452538.3,33.26837121475201,38.20988580448398,NaN,NaN,-154.2311131472524,-195.81117401042917,-0.21251937094086748,-0.9050539966024402,-0.6925346256615728,681753482,691054941.4,21.913068207364987,46.799570192890826,NaN,NaN,-30.955777083422493,-22.168417015145206
2018-03-27T09:30:00-04:00,51.68,52.1,51.33,51.56,17326794,14827248.7,33.09487274917228,37.63449973683738,NaN,NaN,-115.97061570402442,-180.96136137176003,-0.1795529664967772,-0.9169758337825442,-0.737422867285767,664426688,680354714.4,19.775709800707688,44.571679577885334,NaN,NaN,-31.45993305397083,-23.49577644926315
2018-03-28T09:30:00-04:00,51.73,52.53,51.71,52.27,32397516,15760803.4,40.94445522516466,37.28706856054788,NaN,NaN,-69.50251633147364,-151.11367093967948,-0.09744431482567839,-0.859228260817865,-0.7617839459921866,696824204,679539689,19.618742867151397,41.6911820430103,NaN,NaN,-29.39481082592176,-24.338495645928667
2018-03-29T09:30:00-04:00,52.48,52.9501,52.48,52.63,13410339,15040891.25,44.500021715750776,36.97144669157182,NaN,NaN,-30.455992002451364,-115.42827682605761,-0.010952612866679035,-0.7754747120755354,-0.7645220992088564,710234543,684523549.8,23.611592834611017,38.71749967229109,NaN,NaN,-26.55481624346055,-24.65511287414751
2018-04-02T09:30:00-04:00,52.47,52.57,51.11,51.34,28604775,15172860.95,36.11024422247077,36.11719000304534,NaN,NaN,-88.88049273823337,-91.80814598468706,-0.03152191991740472,-0.8039244991056123,-0.7724025791882075,681629768,686973737,25.569083108227503,35.75124939770416,NaN,NaN,-26.799281442925032,-24.961422669687156
2018-04-03T09:30:00-04:00,51.57,52.15,51.41,52.02,24860579,15472905.25,42.287094119249765,35.72961287730685,NaN,NaN,-69.73385465119938,-74.90869428547646,0.007675926318271853,-0.7628076712903678,-0.7704835976086396,706490347,691921110,29.497664315134983,33.25179662302313,NaN,NaN,-24.832227156580426,-24.942966167814767
2018-04-04T09:30:00-04:00,51.69,53.02,51.63,52.83,28012534,15834318.3,48.654975627496434,36.134259235754904,NaN,NaN,-24.49596555197502,-56.61376425506658,0.09055865178818945,-0.6572852828734028,-0.7478439346615923,734502881,705936348.6,39.275773488967104,31.64771874612902,NaN,NaN,-20.910140999026094,-24.366848286559243
2018-04-05T09:30:00-04:00,52.92,53.17,52.64,52.96,18235847,16116464,49.615833444055504,36.81819800918114,NaN,NaN,8.15580145189238,-41.082100698393376,0.15287495093746495,-0.5567502459897611,-0.709625196927226,752738728,717119253.4,45.74204070468793,30.93872633390081,NaN,NaN,-17.56542523380429,-23.395216421879965
2018-04-06T09:30:00-04:00,52.8,53.225,52.16,52.42,13113405,16236255.35,45.78316161835735,37.37603164057668,NaN,NaN,-10.441100638560604,-37.07912242561522,0.15592762143819994,-0.5147156701294762,-0.6706432915676761,739625323,722997409.4,48.82669357441107,31.028711266300974,NaN,NaN,-16.041155067385272,-22.344636228380722
2018-04-09T09:30:00-04:00,52.58,52.92,52.24,52.39,14686733,16396251.85,45.572542987774035,38.172677122597925,NaN,NaN,-10.664999668492813,-21.436023811667106,0.15386658955419907,-0.47831005462492726,-0.6321766441791263,724938590,731659173.8,53.06139650520303,31.880070333828964,NaN,NaN,-14.910894473843141,-21.28267312058964
2018-04-10T09:30:00-04:00,52.69,52.78,52.2299,52.51,13154893,16508213.45,46.63016752689076,39.1143276538262,NaN,NaN,-2.759420695924213,-8.041137020612073,0.15793038727241604,-0.43476366008860623,-0.5926940473610223,738093483,737979801,55.927461464104475,33.29446497618617,NaN,NaN,-13.682484202865645,-20.196931846629067
2018-04-11T09:30:00-04:00,52.36,52.675,52.3,52.41,9025223,16339170.8,45.83093051475489,40.27718789637789,NaN,NaN,3.7068351516722298,-2.4005768798826184,0.1512202371976349,-0.4036687508639787,-0.5548889880616136,729068260,736892876.8,55.30211404137358,34.981081047841755,NaN,NaN,-12.89587070479368,-19.153923112081156
2018-04-12T09:30:00-04:00,52.63,52.79,52.3,52.33,9843733,16155407.45,45.164007426807345,41.554158633797236,NaN,NaN,16.595186816079757,-0.7126998070451286,0.13904063429424174,-0.38108819519381143,-0.5201288294880532,719224527,730190036.6,51.47938187112676,36.68473535085733,NaN,NaN,-12.421948598078398,-18.19221246722362
2018-04-13T09:30:00-04:00,52.55,52.69,52.33,52.59,8836670,16133237.9,47.821527088878085,43.23415753439817,NaN,NaN,35.73119469890855,8.521759260448706,0.14545246319624006,-0.33831325049275307,-0.4837657136889931,728061197,727877211.4,50.190184073972794,38.556493346931745,NaN,NaN,-11.295202741549295,-17.206925363555857
2018-04-16T09:30:00-04:00,52.73,53.46,52.66,53.16,7804682,16042017.9,53.17875282290746,44.65632764926642,NaN,NaN,121.61791476522048,34.97834214719136,0.18263288290972135,-0.25547461005184147,-0.4381074929615628,735865879,730062669.2,51.42800124808348,40.66470284984022,NaN,NaN,-8.752355797659698,-15.999129711284978
2018-04-17T09:30:00-04:00,53.3,53.41,52.99,53.28,8131299,15912842.05,54.2438497528888,46.1669688638176,NaN,NaN,134.4004249052444,62.41031126742509,0.20801519421714199,-0.17808850019013533,-0.3861036944072773,743997178,731243408.2,52.120293095349574,42.97503022802892,NaN,NaN,-6.331982176189421,-14.618108634842756
2018-04-18T09:30:00-04:00,53.24,53.36,52.78,52.88,14496596,16143262.95,50.14870457472075,46.824415245928755,NaN,NaN,97.22319941837645,81.11358412076592,0.1910128031520134,-0.14733769046726053,-0.33835049361927394,729500582,731329872.6,52.1740500866516,45.30040931513607,NaN,NaN,-5.338045703479323,-13.292385358933695
2018-04-19T09:30:00-04:00,52.16,52.2,51.08,51.35,23643073,16473992,38.252785808378015,46.37818410968784,NaN,NaN,-98.17802656129523,58.15894144529093,0.07578647827240304,-0.24361739577877017,-0.3194038740511732,705857509,728656469,50.29382427432206,47.20628298940115,NaN,NaN,-8.319270638934311,-12.581940398933783
2018-04-20T09:30:00-04:00,51.23,51.4,50.34,50.49,19102686,16649921.7,33.44968204808691,46.18814395437471,NaN,NaN,-176.7432248922415,15.664057527060924,-0.05237924901182034,-0.3848779353159486,-0.33249868630412827,686754823,720395194.2,44.90806402788875,48.58763876937696,NaN,NaN,-12.587386319061386,-12.58271838752344
2018-04-23T09:30:00-04:00,50.53,50.58,50.2,50.43,12344903,16470346.5,33.137066594291156,45.5345705597348,NaN,NaN,-195.9539252557117,-47.85031047712552,-0.13076296987945224,-0.49595239865344354,-0.3651894287739913,674409920,708104002.4,38.331232067340856,49.218607894534514,NaN,NaN,-15.986263689364716,-13.068939144929336
2018-04-24T09:30:00-04:00,50.52,50.58,49.76,50.11,18771503,16790189.15,31.44892944691543,44.30556726112188,NaN,NaN,-191.39370584456708,-113.00913662708781,-0.19012984672566813,-0.6028517371810764,-0.4127218904554083,655638417,690432250.2,31.245959278077038,48.64504973661381,NaN,NaN,-19.313045188267996,-13.960954293977716
2018-04-25T09:30:00-04:00,50.09,50.41,49.89,50.2,19012475,16874473.2,32.49061119964341,43.08233710080673,NaN,NaN,-160.0748921313938,-164.46875493704187,-0.20786663782810716,-0.6725551877405422,-0.4646885499124351,674650892,679462312.2,27.809535080162078,47.3641564777191,NaN,NaN,-21.67746683368864,-15.063313228222134
2018-04-26T09:30:00-04:00,50.31,50.7,50.145,50.5,11009891,15805091.95,35.982671927395586,42.382302122880894,NaN,NaN,-115.48154588641192,-167.9294588020652,-0.18470522628047326,-0.6955700827630267,-0.5108648564825534,685660783,675422967,26.64739329273729,45.77992074331382,NaN,NaN,-22.646116410179403,-16.146570825644602
2018-04-27T09:30:00-04:00,50.39,50.94,50.34,50.77,11096099,15689379.95,39.03897933501536,41.915619004826695,NaN,NaN,-86.31441864258606,-149.8436975521341,-0.13861732244917746,-0.6841365095440253,-0.5455191870948478,696756882,677423378.8,28.246587007563903,44.00743435062532,NaN,NaN,-22.57708492116355,-17.06521569643302
2018-04-30T09:30:00-04:00,50.86,51.0852,50.36,50.45,13892707,14953776.55,36.79675087684386,41.213232101251926,NaN,NaN,-80.92447934349404,-126.83780836969056,-0.11791202622509256,-0.6929092198762135,-0.5749971936511209,682864175,679114229.8,29.642841010393127,42.12996146107451,NaN,NaN,-23.163814951861387,-17.936444161494215
2018-05-01T09:30:00-04:00,50.26,50.29,49.66,50.01,10927127,14257103.95,33.912527171648065,40.3619175767443,NaN,NaN,-107.48572788933186,-110.05621277864353,-0.12159083684753169,-0.7269857397105355,-0.6053949028630038,671937048,682373956,32.37490111081911,40.49230339460633,NaN,NaN,-24.521323676701613,-18.877141235095273
2018-05-02T09:30:00-04:00,49.87,49.92,48.92,49.03,18818933,13797423.9,28.545693348974595,39.17489514261338,NaN,NaN,-130.45368339682688,-104.13197103173016,-0.17454469226001423,-0.8235757681880216,-0.6490310759280074,653118115,678067400.6,30.67990182850305,39.00662624870464,NaN,NaN,-27.515092769315675,-20.111134311412474
2018-05-03T09:30:00-04:00,49.15,49.26,48.755,48.98,16634626,13717362.85,28.29961852297528,37.78047310219175,NaN,NaN,-129.44177168105895,-106.92401619065954,-0.19585901251696813,-0.8938548415742176,-0.6979958290572494,636483489,668231941.8,27.179971967930584,37.36303966970162,NaN,NaN,-29.967522069940316,-21.51918970548788
2018-05-04T09:30:00-04:00,48.94,49.94,48.89,49.69,13132373,13718311.25,36.650678216626346,36.599896344600246,NaN,NaN,-92.06573318449607,-108.07427909904155,-0.14727712640082502,-0.8820922370582807,-0.7348151106574556,649615862,658803737.8,24.316308077385514,35.426490157508916,NaN,NaN,-29.514282571579802,-22.661345829215296
2018-05-07T09:30:00-04:00,49.8,49.89,49.265,49.38,9665279,13467238.55,34.747698352508664,35.20731410171595,NaN,NaN,-84.37024483558419,-108.76343219745957,-0.12219073772439104,-0.8875535328129445,-0.7653627950885534,639950583,650221019.4,22.039837683501048,33.277886199519735,NaN,NaN,-29.72340071216239,-23.67021081249345
2018-05-08T09:30:00-04:00,49.27,49.32,48.96,49.18,8290789,13224033.35,33.53782460935115,34.02082267561813,NaN,NaN,-96.78536039865632,-106.62335869932447,-0.10584750117957598,-0.8976721715630234,-0.7918246703834474,631659794,642165568.6,20.134568409810427,30.989351794031084,NaN,NaN,-30.255390077018195,-24.61095070742556
2018-05-09T09:30:00-04:00,49.09,49.37,48.99,49.25,9228168,13234180.6,34.39877609286516,33.7455362673672,NaN,NaN,-89.2790771393,-98.38843744781909,-0.07836902537675394,-0.8897859521043898,-0.8114169267276359,640887962,639719538,19.581039342755133,28.795581441776303,NaN,NaN,-30.443695805909964,-25.444200007209044
2018-05-10T09:30:00-04:00,49.48,49.785,49.41,49.54,10242660,13254126.95,37.98303424660355,34.06934713868982,NaN,NaN,-63.10435291639774,-85.12095369488684,-0.031133159538918043,-0.8503333761512835,-0.8192002166123654,651130622,642648964.6,22.334823264813977,27.183207101556672,NaN,NaN,-29.58488485616355,-26.035726414202546
2018-05-11T09:30:00-04:00,49.63,49.879,49.39,49.54,10065201,13315553.5,37.98303424660355,34.41548768528356,NaN,NaN,-57.34215558694898,-78.17623817537742,0.007573909728887163,-0.8097328294512565,-0.8173067391801436,651130622,642951916.6,22.629890171585416,26.061682680431286,NaN,NaN,-28.880082883435893,-26.44206305266445
2018-05-14T09:30:00-04:00,49.61,49.7,49.44,49.52,6708106,13260724.7,37.817767835636666,34.87040471304936,NaN,NaN,-55.954946605755076,-72.49317852941161,0.037612590256756895,-0.7702910013591975,-0.8079035916159544,644422516,643846303.2,23.553288576632497,25.512206201756676,NaN,NaN,-28.333136426391203,-26.712216391768273
2018-05-15T09:30:00-04:00,49.28,49.4599,49.0599,49.33,22686922,13988505.85,36.2060664705525,35.135794375257156,NaN,NaN,-73.80452356340625,-67.89701116236161,0.04970868583674837,-0.7457677343200189,-0.7954764201567672,621735594,641861463.2,22.90010057361313,25.161532308431756,NaN,NaN,-28.269325085159906,-26.93466049082422
2018-05-16T09:30:00-04:00,49.48,49.8,49.41,49.68,12151302,13871241.15,41.17907980232666,35.50696636632366,NaN,NaN,-32.39643568110351,-56.52048287072231,0.08427286177037574,-0.6901353429437975,-0.7744082047141733,633886896,640461250,22.427578203785345,24.860116944935186,NaN,NaN,-26.881999574221428,-26.92713750273811
2018-05-17T09:30:00-04:00,49.83,49.97,49.68,49.85,19572887,13667731.85,43.48359884666719,35.8244391885845,NaN,NaN,2.1958373942149,-43.460444808599775,0.11942842958777888,-0.6251226677294497,-0.7445510973172286,653459783,640927082.2,22.996841969711554,24.485135156517156,NaN,NaN,-25.069593021462378,-26.661774005413005
2018-05-18T09:30:00-04:00,49.73,49.81,49.35,49.54,15664711,13495833.1,40.37703444546601,36.080173729200375,NaN,NaN,-30.316877550693693,-38.055389201348724,0.12220707724256463,-0.5917922507640228,-0.7139993280065874,637795072,638259972.2,22.001319591807444,23.939312198046757,NaN,NaN,-24.288823497583824,-26.32278107572312
2018-05-21T09:30:00-04:00,49.73,49.92,49.6,49.75,7928385,13275007.2,43.330594602422046,36.75289283139852,NaN,NaN,5.192882628137941,-25.825823354570126,0.13745348781923272,-0.5421824682325465,-0.6796359560517792,645723457,638520160.4,22.354446464758468,23.22356543761385,NaN,NaN,-22.80943292251992,-25.820874196694092
2018-05-22T09:30:00-04:00,49.84,50.09,49.57,49.66,9383838,12805623.95,42.36205547514655,37.7397758404108,NaN,NaN,12.060776977010553,-8.652763246486764,0.1402566251706815,-0.5043151745884273,-0.6445717997591088,636339619,641440965.4,26.383634499819223,22.916689199850726,NaN,NaN,-21.807248699119246,-25.24749912561197
2018-05-23T09:30:00-04:00,49.55,49.89,49.48,49.84,18136227,12761811.55,45.00948837074413,38.933337972394284,NaN,NaN,9.976910201200653,-0.17809407002593075,0.15202471084990288,-0.45454091119673024,-0.6065656220466331,654475846,645558755.4,31.759971223977786,23.2438320038541,NaN,NaN,-20.23247438885411,-24.531067020360847
2018-05-24T09:30:00-04:00,49.84,49.925,49.545,49.8,9843796,12703506.8,44.52010988435656,39.49544023437502,NaN,NaN,23.7442818968335,4.131594830497788,0.15440856885657195,-0.41355491097591823,-0.5679634798324902,644632050,643793208.8,30.72390347610778,23.701517389477118,NaN,NaN,-19.02227082004251,-23.744096134601087
2018-05-25T09:30:00-04:00,49.81,50.2,49.74,49.88,12913469,12794375.3,45.78962503264639,40.28414928295628,NaN,NaN,86.30374088984011,27.45571851860455,0.1580918002809918,-0.3703487294812504,-0.5284405297622422,657545519,647743298.2,35.772185642161546,24.6823993865243,NaN,NaN,-17.657047125798535,-22.87451770477215
2018-05-29T09:30:00-04:00,49.7,49.99,49.55,49.77,14959287,12847704.3,44.28895533474445,41.05208719191295,NaN,NaN,63.67895137409307,39.15293226779558,0.14991069339620777,-0.3410521630169825,-0.49096285641319026,642586232,647115853.2,35.3317536803484,25.767912620134155,NaN,NaN,-16.836587501197243,-22.01195624711859
2018-05-30T09:30:00-04:00,49.96,50.555,49.8,50.47,17628106,13182753.25,54.506708826423015,42.4883681014528,NaN,NaN,207.39246907264067,78.21927068692159,0.18607274714942684,-0.2583719224764067,-0.44444466962583357,660214338,651890797,41.25898756425536,27.316337493098455,NaN,NaN,-13.06737496007627,-20.734158920398258
2018-05-31T09:30:00-04:00,50.38,50.43,49.47,49.66,18602977,13171955.45,44.3666130541167,42.94433801627516,NaN,NaN,73.02740715864324,90.82937007841011,0.1513437905139901,-0.25526493148334595,-0.40660872199733605,641611361,649317900,39.17539324446399,28.51923534878774,NaN,NaN,-12.706724974631914,-19.58738264243164
2018-06-01T09:30:00-04:00,49.8,49.89,49.53,49.66,10944596,12887453.95,44.36661305411669,43.40030793109753,NaN,NaN,15.597011869464534,89.19991607293632,0.12534963582776804,-0.24992167721262604,-0.37527131304039407,641611361,648713762.2,38.681429127389,29.66577384563085,NaN,NaN,-12.42277878971341,-18.563867806329036
2018-06-04T09:30:00-04:00,49.76,50.13,49.76,50.07,11665232,12814096.9,49.844111125359795,44.25933245179204,NaN,NaN,106.01394395726425,93.14195668642115,0.13207248731361065,-0.21018070389838073,-0.3422531912119914,653276593,647859977,37.95310179511206,30.694331932665108,NaN,NaN,-10.468028500369932,-17.407319334049163
2018-06-05T09:30:00-04:00,50.11,50.14,49.68,49.84,8980891,12779877.5,47.04579845307198,45.03359902197201,NaN,NaN,66.2688677001378,93.6599399516301,0.11780497669307399,-0.1949969703456489,-0.3128019470387229,644295702,648201871,38.45285952202508,31.8052432861231,NaN,NaN,-9.69495354344699,-16.305552792534566
2018-06-06T09:30:00-04:00,49.86,49.9,49.55,49.9,12071020,12968889.05,47.86803089927013,45.51138124318226,NaN,NaN,23.970538646798033,56.975553866461574,0.10936766137356918,-0.1760923703217614,-0.2854600316953306,656366722,647432347.8,37.71650691631697,32.89730962273251,NaN,NaN,-8.826641130691879,-15.237136840842755
2018-06-07T09:30:00-04:00,49.77,50.47,49.7,50.21,16618510,13338406.15,52.01380494454086,46.12068167874467,NaN,NaN,155.18209715709688,73.40649186615231,0.12073204246148717,-0.1345449786184716,-0.25527702107995875,672985232,653707122,46.68231677774734,34.58912925187792,NaN,NaN,-6.8386425997402345,-14.037351949256681
2018-06-08T09:30:00-04:00,50.23,50.86,50.23,50.83,17081511,13680348.7,59.03111026320915,47.453115665726315,NaN,NaN,277.7430524888061,125.83569999002061,0.16342030663672355,-0.05100163778405431,-0.21442194442077786,690066743,663398198.4,56.98202887751479,37.08775134371416,NaN,NaN,-2.752057871599115,-12.425167081019886
2018-06-11T09:30:00-04:00,50.87,51.35,50.87,51.25,13199647,13837071,62.98047450673265,48.856678516034215,NaN,NaN,307.47597538080737,166.12810627472922,0.21036798384066635,0.04853803538005508,-0.16182994846061127,703266390,673396157.8,64.58329596032789,40.104097736254836,NaN,NaN,2.0458048398273365,-10.357885378041711
2018-06-12T09:30:00-04:00,51.28,51.38,51.01,51.35,11362155,14069773.45,63.87344064411104,50.39320602810311,NaN,NaN,238.78382827669,200.63109839003968,0.23662318018616935,0.1339490267721004,-0.10267415341406894,714628545,687462726.4,72.06290362264242,43.36690267359935,NaN,NaN,6.166212252022846,-7.9973000023182035
2018-06-13T09:30:00-04:00,51.34,51.42,51.03,51.19,15696018,13720228.25,61.324595218056686,51.55857080291115,NaN,NaN,180.95238095239066,232.02746685115818,0.23140048494830517,0.18657645277131252,-0.04482403217699264,698932527,695975887.4,75.44302917046274,46.487121098348275,NaN,NaN,8.796892133134055,-5.598129697253595
2018-06-14T09:30:00-04:00,51.25,51.32,51.06,51.28,9751280,13600227.15,62.2374295107475,52.824093633367646,NaN,NaN,147.51244647147777,230.49353671403438,0.22214884685026476,0.2328620263858383,0.010713179535573554,708683807,703115602.4,77.86217087841034,49.854140198512745,NaN,NaN,11.222864852576935,-3.195130475849234
2018-06-15T09:30:00-04:00,50.84,51.57,50.74,51.54,17276024,13485384,64.82064409996408,54.18345213817606,NaN,NaN,129.5859235606632,200.8621109284058,0.22119961226870077,0.2872126948714495,0.06601308260274874,725959831,710294220,79.99594827476349,53.01298038655574,NaN,NaN,14.070751136742226,-0.7285759597647399
2018-06-18T09:30:00-04:00,51.37,51.39,50.56,50.79,21627254,13783511.15,53.46005319483295,54.8385305567538,NaN,NaN,73.3491942362119,154.0367546994867,0.16054392469600512,0.26669298847275513,0.10614906377675001,704332577,710507457.4,80.05743796053021,56.20767212085445,NaN,NaN,13.06537163437554,1.2419879822553
2018-06-19T09:30:00-04:00,50.6,51.154,50.57,51.06,12639235,14019053.65,56.421136739257655,54.975275407670566,NaN,NaN,66.2053955913549,119.52106816241965,0.1303731654809478,0.26911552062793476,0.13874235514698696,716971812,710976110.8,80.20148027873825,58.98927874331751,NaN,NaN,13.171032955201836,2.946137264104805
2018-06-20T09:30:00-04:00,51.21,51.22,50.885,51.11,9562522,14027987.85,56.96716566928271,55.87531488018242,NaN,NaN,73.71991894907327,98.07457576175618,0.1065543369663268,0.27193527635489545,0.16538093938856865,726534334,716496472.2,81.86324368147773,62.03841091738992,NaN,NaN,13.419092422316622,4.4422737152779215
2018-06-21T09:30:00-04:00,51.18,51.375,51.065,51.21,13272677,13784810.35,58.09797515981199,56.856126459160656,NaN,NaN,81.07406780617474,84.78690002869558,0.09091342221008808,0.27902271715117877,0.1881092949410907,739807011,722721113,83.54079842594483,65.24265158157247,NaN,NaN,13.949918702084277,5.800508713393115
2018-06-22T09:30:00-04:00,51.33,51.72,51.32,51.63,9957674,13790504.25,62.549246116994944,57.76363610142032,NaN,NaN,108.0255174875117,80.47481881406529,0.10143263030453392,0.3149000828217581,0.21346745251722415,749764685,727482083.8,84.70600751175645,68.58214484704708,NaN,NaN,15.764708620246365,7.22396584294358
2018-06-25T09:30:00-04:00,51.51,51.97,51.5,51.89,22124221,14251041.85,65.02610766567017,59.047943902320185,NaN,NaN,120.73324675230485,89.95162931728387,0.11735505063250931,0.3601612658078608,0.24280621517535148,771888906,740993349.6,87.42644312837858,72.08025796178661,NaN,NaN,18.054101358564818,8.7711280594609
2018-06-26T09:30:00-04:00,51.9,52,51.43,51.67,14054809,14205817.95,61.32997163245998,60.00951109754802,NaN,NaN,103.0786238317009,97.32627496535306,0.10492946559534577,0.3739680471695337,0.2690385815741879,757834097,749165806.6,88.73202670536554,75.72422366100436,NaN,NaN,18.87389961587057,10.214381138947996
2018-06-27T09:30:00-04:00,51.6,52.04,51.345,51.56,19862403,14317532.8,59.50861611215538,60.54485475237764,NaN,NaN,89.96146856503725,100.57458488854586,0.08216805723019299,0.3717486531119292,0.2895805958817362,737971694,751453278.6,89.07400256360386,78.75220121713697,NaN,NaN,19.020526483835322,11.472401902503329
2018-06-28T09:30:00-04:00,51.44,51.68,51.36,51.56,13177374,14046252.65,59.50861611215538,60.578962313016646,NaN,NaN,73.47059634776724,99.05389059686436,0.06095421107580823,0.3657733597264965,0.30481914865068827,737971694,751086215.2,88.60927460599578,81.01129019774275,NaN,NaN,19.140147968788018,12.567794197686855
2018-06-29T09:30:00-04:00,51.59,51.81,51.3,51.53,13019769,14150011.3,58.95483349932244,60.291416526773055,NaN,NaN,71.48325597984679,91.74543829533138,0.03976895491215238,0.35453034229087876,0.3147613873787264,724951925,746123663.2,82.35353385035782,82.28059290417346,NaN,NaN,19.092601844169355,13.499909575755783
2018-07-02T09:30:00-04:00,51.3,51.53,50.9,51.23,13255467,14229523.05,53.584701460540856,59.55650658508947,NaN,NaN,21.411322357609123,71.88105341639223,0.002390773812439906,0.3177498546442763,0.3153590808318364,711696458,734085173.6,69.52960902237585,82.09964328986871,NaN,NaN,17.558471922989256,14.079704196789136
2018-07-03T09:30:00-04:00,51.43,51.615,51.27,51.35,7736260,14167291.5,55.33719418849546,59.12883508297796,NaN,NaN,47.88900894726172,60.84313043950441,-0.016379423164048112,0.29488480187677624,0.31126422504082435,719432718,726404897.8,62.80981815506384,81.19727107448307,NaN,NaN,16.716167632106163,14.456341830405854
2018-07-05T09:30:00-04:00,51.57,52.09,51.47,52.06,11699894,14148735.2,63.99840492086174,59.25461904084326,NaN,NaN,137.1765762009735,70.28615196669168,0.015187222224158137,0.330248252821022,0.31506103059686386,731132612,725037081.4,61.66674850456222,80.04045519063678,NaN,NaN,18.560321239551197,15.042624603140903
2018-07-06T09:30:00-04:00,52.12,52.425,51.995,52.22,12335082,13934563.8,65.6165888378357,59.311472236405514,NaN,NaN,190.86855534646148,93.76574376643052,0.04151491965598231,0.36695468016684174,0.32543976051085943,743467694,726136281.4,62.261133188307,78.7736826844613,NaN,NaN,20.578451692883455,15.833457044532695
2018-07-09T09:30:00-04:00,52.26,52.335,51.96,52.02,15117910,13836383.75,61.87288730909047,59.91238895885248,NaN,NaN,148.10924760979617,109.09094209242039,0.040109824726341614,0.37557704141878645,0.33546721669244484,728349784,726815853.2,62.6467567661386,77.53006259914763,NaN,NaN,21.14995834168459,16.59295722984011
2018-07-10T09:30:00-04:00,52.15,52.67,52.04,52.64,15280538,13940428.3,67.9731456738001,60.73753245417695,NaN,NaN,187.99960131566516,142.4085978840316,0.07363507614257825,0.4275110618706677,0.3538759857280894,743630322,733202626,66.14776310654275,76.52622565827649,NaN,NaN,23.675944854889444,17.604812604847158
2018-07-11T09:30:00-04:00,52.58,52.63,52.29,52.47,11484604,13946550.75,64.90662933715305,61.304637001881964,NaN,NaN,161.45082203634817,165.12096050184886,0.07671275920872517,0.44976693473899587,0.3730541755302707,732145718,735745226,67.4555088812285,75.49710174397296,NaN,NaN,24.751391007968206,18.625752376721593
2018-07-12T09:30:00-04:00,52.62,52.71,52.23,52.4,11002279,13711863.8,63.633629319364914,61.70004087042146,NaN,NaN,135.4638024675028,164.77840575515475,0.06675208155463702,0.45649427747356697,0.38974219591892995,721143439,733747391.4,65.32025273045267,74.19563419429495,NaN,NaN,25.23029051837734,19.569257825529558
2018-07-13T09:30:00-04:00,52.43,52.795,52.41,52.74,14053472,13926973.4,67.01732141131947,62.019189105730355,NaN,NaN,144.21428064087908,155.44755081403827,0.07515446784681579,0.48368528072744965,0.40853081288063386,735196911,732093234.8,63.527196040164746,72.68286194632411,NaN,NaN,26.68767182168223,20.586174110694227
2018-07-16T09:30:00-04:00,52.7,52.73,52.335,52.49,10347404,13580542.4,62.418466138728384,61.832928996663085,NaN,NaN,108.54271837921212,147.53424496792144,0.056802286008298286,0.4795336703910067,0.4227313843827084,724849507,731393179.4,62.74223764452002,70.91970441176278,NaN,NaN,26.49791948822957,21.430709164627846
2018-07-17T09:30:00-04:00,52.46,53,52.46,52.94,14759326,13237146,66.83067891248723,62.225836659522166,NaN,NaN,130.8162316991175,136.09757104461193,0.06718581165772486,0.5067136489548645,0.4395278372971396,739608833,730588881.6,61.79746616471683,68.99580723028787,NaN,NaN,27.739317923173378,22.33193898727721
2018-07-18T09:30:00-04:00,52.88,52.93,52.47,52.51,10474162,13128892.35,59.62683448884966,62.23428082928605,NaN,NaN,96.4217932694566,123.09176529123363,0.038723326270316605,0.4879319951350354,0.4492086688647188,729134671,729986672.2,61.056136424694756,66.99453107750865,NaN,NaN,26.42249658088603,22.916304357792754
2018-07-19T09:30:00-04:00,52.17,52.77,52.07,52.54,15092767,13405404.6,59.95118575435477,62.265892946586,NaN,NaN,64.62425662281923,108.92385612229691,0.016672831315987957,0.4700497080097037,0.45337687669371574,744227438,734603472,64.5656242233882,65.27712747875097,NaN,NaN,25.486724475268957,23.283507231717927
2018-07-20T09:30:00-04:00,52.44,52.89,52.35,52.86,17895734,13636557.45,63.334867156699914,62.578752493541536,NaN,NaN,91.04443497223663,98.2898869885684,0.018266292878417967,0.4762097427917382,0.45794344991332026,762123172,739988724.2,68.16896360752347,64.26394388997709,NaN,NaN,25.734383473830462,23.633632409162576
2018-07-23T09:30:00-04:00,52.76,52.885,52.37,52.53,13337183,13805532.9,57.90185216589416,62.887120401066774,NaN,NaN,69.02452220083555,90.38624775289307,-0.006927317620014972,0.44928430288830157,0.45621162050831654,748785989,744776020.6,70.9928925198421,64.3684641397961,NaN,NaN,24.22254452509728,23.71776271143896
2018-07-24T09:30:00-04:00,52.41,52.725,52.32,52.63,15987683,13498706,59.04826512772811,63.152196896726245,NaN,NaN,58.223441827377975,75.86768977854517,-0.02013247104187893,0.4310460317059679,0.4511785027478468,764773672,749808988.4,73.64052807366895,65.14208627683932,NaN,NaN,23.341188892303126,23.663966451562413
2018-07-25T09:30:00-04:00,52.7,53.07,52.59,53.03,15258420,13558886.55,63.34781192235813,63.10572596826171,NaN,NaN,101.48546548854189,76.88042422236227,-0.005940070741112413,0.4437534143214563,0.44969348506256873,780032092,759988472.6,78.01198420615816,66.3096031126676,NaN,NaN,23.90475025945836,23.698364138404692
2018-07-26T09:30:00-04:00,53.24,53.76,53.17,53.31,15129434,13322238.1,66.03595572057387,63.13568074560015,NaN,NaN,166.17701298536142,97.1909754948707,0.017036015343233346,0.47098850424161043,0.4539524888983771,795161526,770175290.2,81.34594255323353,67.67280378159093,NaN,NaN,25.22140404037094,23.91594126725701
2018-07-27T09:30:00-04:00,53.28,53.6362,53.185,53.38,13414400,13334089.4,66.69362068479694,63.4800188438649,NaN,NaN,158.33021790789425,110.6481320820022,0.03087256318301279,0.4925431928771431,0.4616706296941303,808575926,779465841,83.76387484599067,69.18116935872321,NaN,NaN,26.481898658274076,24.28250660883088
2018-07-30T09:30:00-04:00,53.24,53.45,53,53.32,12143924,13290297.15,65.52246818357031,63.30497045170563,NaN,NaN,129.2072808520613,122.68468381224739,0.02988862969915196,0.4990314168180703,0.4691427871189183,796432002,788995043.6,85.79735459393028,70.58471160782233,NaN,NaN,27.181240415210272,24.69661143831365
2018-07-31T09:30:00-04:00,53.49,53.755,53.175,53.57,17898828,13522465.2,68.04072229801204,63.52883423462413,NaN,NaN,159.21243376270422,142.88248219931262,0.039382438611699544,0.5183708353835428,0.47898839677184324,814330830,798906475.2,87.54469083349225,72.01965317584117,NaN,NaN,28.517262849441238,25.24241878276045
2018-08-01T09:30:00-04:00,53.41,53.5,53.03,53.12,14917607,13881532.55,59.60191982140774,63.24085498477005,NaN,NaN,96.12649604605929,141.81068831081612,0.010183687103537342,0.4917180056512649,0.48153431854772755,799413223,802782701.4,88.1582823541369,73.65094100610432,NaN,NaN,27.141770723483642,25.513754774292334
2018-08-02T09:30:00-04:00,53.03,53.73,53,53.66,15902898,14091682.75,65.18245645268573,63.1097932020105,NaN,NaN,123.50420794249632,133.27612730224308,0.02142011162247509,0.5083094580758214,0.4868893464533463,815316121,806813620.4,88.77743348068888,75.45452939471319,NaN,NaN,27.70971328452892,25.82746313289756
2018-08-03T09:30:00-04:00,53.79,54.55,53.75,54.29,20418728,14495865.05,70.33165896004337,63.675021260675855,NaN,NaN,205.37973823839064,142.68603136834236,0.06310625815142379,0.5657721691426261,0.5026659109912023,835734849,812245405,89.56890453689533,77.37071988702573,NaN,NaN,30.003083741966975,26.42398036276462
2018-08-06T09:30:00-04:00,54.32,54.51,54.2201,54.34,13412054,14410572.25,70.70199336075112,63.951543721266134,NaN,NaN,188.08306518972324,154.46118823587477,0.08453436690131944,0.6083338696178515,0.5237995027165321,849146903,822788385.2,90.90906536368566,79.4501198298092,NaN,NaN,31.899424015310323,27.206186598842578
2018-08-07T09:30:00-04:00,54.29,54.36,53.8233,54.01,13766118,14334851.25,64.94037845617895,64.33108257607536,NaN,NaN,127.43979749867003,148.1066609830679,0.0676984499933353,0.6084225652082011,0.5407241152148659,835380785,826998376.2,91.38503887185861,81.61647000460663,NaN,NaN,31.62804146667653,27.837880151390287
2018-08-08T09:30:00-04:00,53.98,54.02,53.58,53.6,12591765,14390209.3,58.55573557753099,64.2314075634451,NaN,NaN,76.10176010864821,144.1017137955857,0.022502238117782403,0.5688519128620939,0.5463496747443115,822789020,831673535.6,91.89267416939379,83.56840214360702,NaN,NaN,29.28559493071021,28.04469654843599
2018-08-09T09:30:00-04:00,53.61,53.7,53.37,53.44,8047047,14242447.7,56.2323112184728,63.72408213928602,NaN,NaN,41.4050148702416,127.68187518113477,-0.02219726830150981,0.5186030893674243,0.5408003576689341,814741973,831558706,91.74967117900749,85.25273839871302,NaN,NaN,26.653857126361906,27.846005202425406
2018-08-10T09:30:00-04:00,53.28,53.46,53.13,53.24,13459229,14212735.55,53.38102570185076,63.401165963282914,NaN,NaN,7.052188193664494,88.01636517218955,-0.06674434186287403,0.45736993034034157,0.5241142722032156,801282744,824668285,83.36607812197042,86.13653737029361,NaN,NaN,23.591987990448345,27.238288457857255
2018-08-13T09:30:00-04:00,53.33,53.44,53,53.24,8696586,14130194.65,53.38102570185076,62.99636314714882,NaN,NaN,-5.618412070523992,49.276069720140114,-0.09594498563572684,0.4041830401585571,0.500128025794284,801282744,815095453.2,73.33969844192215,86.11504953945457,NaN,NaN,21.14829154221793,26.36828889848021
2018-08-14T09:30:00-04:00,53.31,53.66,53.28,53.61,8882529,13836354.8,57.955156788432944,62.6111734947256,NaN,NaN,34.92988876699139,30.774087973804388,-0.09016482488607502,0.38742199468669014,0.47758681957276516,810165273,810052350.8,68.65512775142791,85.44670264983097,NaN,NaN,20.348388122739838,25.508303073374442
2018-08-15T09:30:00-04:00,53.45,53.865,53.145,53.83,15591007,14092197.05,60.44058591395196,62.21150422282403,NaN,NaN,44.995221404501734,24.552780232975085,-0.07212952482854107,0.38742491353708886,0.4595544383656299,825756280,810645802.8,68.90681912151172,84.55819383327942,NaN,NaN,20.4106858774052,24.780072045378837
2018-08-16T09:30:00-04:00,54.38,54.7595,54.295,54.6,15526118,14113864.6,67.64885553439314,62.27973528350948,NaN,NaN,184.1988214451793,53.11154154796263,-0.012094268228168725,0.444436603080419,0.4565308713085877,841282398,815953887.8,71.13909907398767,83.6564241352792,NaN,NaN,22.875727428625552,24.508022814414083
2018-08-17T09:30:00-04:00,54.55,55.08,54.44,55.02,13037647,13870960.25,70.77675548103053,62.65504151904235,NaN,NaN,192.97370539050164,90.29584498733007,0.04880998305187567,0.5175433501234323,0.46873336707155666,854320045,826561348,75.00148712743803,82.88529074481546,NaN,NaN,26.018586797820788,24.72381766918647
2018-08-20T09:30:00-04:00,55.09,55.31,54.93,54.99,10189552,13713578.7,70.25424808607904,62.813150503904275,NaN,NaN,184.21554540337698,128.26263648211025,0.07823700532773109,0.5665296237312205,0.4882926184034894,844130493,835130897.8,77.60859308957,82.17556947739244,NaN,NaN,28.307176785664495,25.235726114397618
2018-08-21T09:30:00-04:00,54.97,55.045,54.385,54.6,13806258,13604507.45,63.67331756864676,63.10396462870706,NaN,NaN,112.80653529504482,143.83796578772095,0.06323942021025619,0.5673418936663097,0.5041024734560535,830324235,839162690.2,78.73239049453692,81.50229148742103,NaN,NaN,28.180409046079113,25.65639510463783
2018-08-22T09:30:00-04:00,54.55,54.66,54.185,54.26,13573885,13520280.7,58.526200571102706,62.62851778002256,NaN,NaN,64.37283298712394,147.71348810424539,0.024230297780704957,0.5343903456819348,0.5101600479012298,816750350,837361504.2,76.87611198189651,80.65219709465013,NaN,NaN,26.423721113530608,25.76601310590823
2018-08-23T09:30:00-04:00,54.1,54.26,53.97,54.13,10714330,13299525.5,56.64087804117072,61.650604857245945,NaN,NaN,28.5769419972443,116.58911221465837,-0.014437384746218584,0.4921133169684566,0.5065507017146752,806036020,830312228.6,69.92735080069431,79.24922897063577,NaN,NaN,24.418941325930085,25.573574280197064
2018-08-24T09:30:00-04:00,54.1,54.21,53.895,54.06,9570526,13107331.8,55.60223351991773,60.5720505829007,NaN,NaN,16.52813821087119,81.29999877873229,-0.047002069994308227,0.44779811422178994,0.49480018421609817,796465494,818741318.4,60.29360958649964,77.06241070083676,NaN,NaN,22.485064691859417,25.132358624720258
2018-08-27T09:30:00-04:00,54.15,54.32,53.88,54.09,10631636,13031717.4,55.97483608227836,59.93165469905066,NaN,NaN,17.521414281558624,47.961172554368616,-0.06754552656461366,0.4103682760103311,0.47791380257494476,807097130,811334645.8,55.064146291948525,74.46806123084319,NaN,NaN,21.006799641954473,24.542993055753715
2018-08-28T09:30:00-04:00,54.08,54.244,53.83,53.91,12621515,12767851.75,53.095588020173466,59.54164415923941,NaN,NaN,-0.45575762313265694,25.308713970733127,-0.09272514743332644,0.3620073682832867,0.45473251571661316,794475615,804164921.8,50.498249102633515,71.51131658321745,NaN,NaN,18.932015788964293,23.7414248747838
2018-08-29T09:30:00-04:00,53.99,54.065,53.85,53.97,8681006,12456021.7,53.94597629129744,59.37833452158402,NaN,NaN,-12.138147238213975,10.006517925665497,-0.10396309024995304,0.32477865290417185,0.4287417431541249,803156621,801446176,48.844300677389064,68.44664726167328,NaN,NaN,17.42064785908633,22.83845672968416
2018-08-30T09:30:00-04:00,53.89,54.065,53.69,53.8,11092511,12215502.35,51.11809866355231,59.21669687599128,NaN,NaN,-35.45581666608636,-2.8000338070006356,-0.12031465759226695,0.2783484211637912,0.39866307875605816,792064110,798651794,47.13548402023831,65.85874768297812,NaN,NaN,15.340278146676193,21.767288360683022
2018-08-31T09:30:00-04:00,53.8,53.965,53.555,53.78,10472931,11718212.5,50.78083685373547,59.030969101125905,NaN,NaN,-45.69163673604836,-15.243988796384546,-0.1291672985256863,0.23720395559895024,0.36637125412463656,781591179,795676931,45.317808529428,63.85718411779997,NaN,NaN,13.509254554997552,20.587569245585097
2018-09-04T09:30:00-04:00,53.71,53.94,53.56,53.71,9571079,11526163.75,49.54864873406236,58.43050424009943,NaN,NaN,-46.05112167089082,-27.958495986874436,-0.13575217238802084,0.1966810386396105,0.33243321102763135,772020100,788661525,41.27548484054936,61.90149533845149,NaN,NaN,11.62038461978591,19.306542870470928
2018-09-05T09:30:00-04:00,53.55,54.33,53.49,54.33,14723846,11574050.15,59.030908167095355,58.32981297246682,NaN,NaN,8.501777426862994,-26.16698897687531,-0.09622686912038925,0.21214962462714482,0.30837649374753406,786743946,787115191.2,40.419650202467864,59.86669755851979,NaN,NaN,12.502886212856826,18.3345919193832
2018-09-06T09:30:00-04:00,54.31,54.51,54.125,54.48,12333786,11561151.2,60.9434761059595,57.850857299007274,NaN,NaN,58.14141500862603,-12.111076527507304,-0.05964756333491694,0.2338170395788879,0.29346460291380483,799077732,786299413.4,39.94904428118074,57.63883650189074,NaN,NaN,13.806426925729498,17.6877112060041
2018-09-07T09:30:00-04:00,54.31,54.41,53.99,54.37,9247266,11621162.15,58.77651808230166,56.99369748481235,NaN,NaN,33.24862109789774,1.629811025289517,-0.04328894308180542,0.23935342406154803,0.28264236714335345,789830466,785852684.6,39.67661349357882,55.115631242329364,NaN,NaN,14.29354964840054,17.202830983489307
2018-09-10T09:30:00-04:00,54.5,54.88,54.5,54.56,8361574,11366279.4,61.33392019056528,56.356531206561364,NaN,NaN,91.90203233996063,29.148544840491315,-0.02121783928257087,0.25612006804013987,0.27733790732271074,798192040,789172856.8,42.79878247909243,52.62921619872383,NaN,NaN,15.446044465510209,16.951861480920865
2018-09-11T09:30:00-04:00,54.49,54.545,54.24,54.36,8121575,11337528.85,57.303966029912466,55.9015775252232,NaN,NaN,36.17442001859507,45.59365317838849,-0.021563794338982478,0.25038316439898267,0.27194695873796515,790070465,792782929.8,46.06738582395683,50.29600157939668,NaN,NaN,15.298326229122585,16.715642159235397
2018-09-12T09:30:00-04:00,54.36,55.11,54.33,54.99,15220029,11654403.85,65.08601619084509,56.37013578377623,NaN,NaN,108.31582334791558,65.556462362599,0.017075617158069267,0.29329148018555173,0.27621586302748247,805290494,796492239.4,49.27471285938326,48.32447307064574,NaN,NaN,17.669901204814817,16.851964880032458
2018-09-13T09:30:00-04:00,55.01,55.03,54.6,54.91,9746491,11362178.05,63.50317959672805,56.860300180601755,NaN,NaN,104.35598979753358,74.79937732038051,0.03277529924341033,0.31718498708174536,0.28440968783833503,795544003,795785493.6,48.680689760868425,46.80685442494388,NaN,NaN,19.093956131541624,17.172249344533768
2018-09-14T09:30:00-04:00,54.86,54.87,54.48,54.76,8925214,11032132.85,60.53075765964475,57.21233761915368,NaN,NaN,72.61324494703751,82.67230209020848,0.028731862068518965,0.32032451542398377,0.2915926533554648,786618789,795143158.2,48.11298202766489,45.93680959931283,NaN,NaN,19.389126485241825,17.488946078920634
2018-09-17T09:30:00-04:00,54.72,54.98,54.6,54.96,10279565,10894228.75,63.01644801034693,57.71530989973,NaN,NaN,100.55891336843315,84.40367829590298,0.034796480497937377,0.33508825397788655,0.3002917734799492,796898354,794884421,47.870811894641896,45.422999999505215,NaN,NaN,20.385659606361017,17.902762297126404
2018-09-18T09:30:00-04:00,54.91,54.93,54.51,54.73,15638469,11166674.6,58.45704853665492,58.09827136519296,NaN,NaN,84.31332236842721,94.0314587658694,0.019357811375930734,0.3244890376998626,0.30513122632393186,781259885,793122305,46.16651330304284,45.11359029953446,NaN,NaN,19.869885018953244,18.183779828815954
2018-09-19T09:30:00-04:00,54.68,54.91,54.55,54.63,7791898,10865956.6,56.54156511312012,58.283670566751724,NaN,NaN,78.383548541375,88.04500380456129,-0.0004972053203534665,0.30450971967349005,0.3050069249938435,773467987,786757803.6,40.55098211095154,44.52121040193178,NaN,NaN,18.882268363225673,18.2835639051602
2018-09-20T09:30:00-04:00,54.78,55.33,54.78,55.32,11817827,10778153.7,65.05114688999282,59.278888297211765,NaN,NaN,144.74611968317103,96.12302978168877,0.02833761731420481,0.3404289466365995,0.3120913293223947,785285814,784706165.8,38.908033287300235,43.93353534957906,NaN,NaN,20.745224673057674,18.635229729145554
2018-09-21T09:30:00-04:00,55.02,55.11,54.905,55.02,10314317,10758153.05,59.58792033765008,59.90796568891995,NaN,NaN,106.33121802142607,102.86662439656648,0.022934644571157847,0.340759635036342,0.31782499046518414,774971497,782376707.4,37.07148805795861,43.34451245875982,NaN,NaN,20.492926100821823,18.900614925099305
2018-09-24T09:30:00-04:00,54.83,54.95,54.135,54.18,10648724,10812062.95,47.54699105456141,59.764990140384164,NaN,NaN,1.041572594005036,82.96315624168086,-0.038158493414789996,0.27012687369669663,0.30828536711148663,764322773,775861591.2,32.4570084754704,42.714621289825615,NaN,NaN,15.772424232672725,18.453730540466935
2018-09-25T09:30:00-04:00,54.34,54.46,53.83,53.86,8319430,10696452.65,43.90707274546201,58.68471618169606,NaN,NaN,-65.25471895658877,53.04954797667767,-0.09768238872200563,0.18618238120897956,0.2838647699309852,756003343,770810282.8,29.401276249880212,41.927594578926495,NaN,NaN,10.68862845981434,17.34443024323085
2018-09-26T09:30:00-04:00,54.02,54.33,53.85,53.92,10369932,10583873.5,44.760960280923854,57.528822194193516,NaN,NaN,-68.95203728761878,23.582430810878915,-0.12862902199517456,0.12307849243701696,0.2517075144321915,766373275,769391340.4,28.58709263266607,41.11602660403259,NaN,NaN,7.088958088394342,15.87936279253992
2018-09-27T09:30:00-04:00,53.74,54.2,53.59,53.85,8892818,10594464.1,43.920928807412224,56.46770867455856,NaN,NaN,-94.8323295412219,-24.333259033999674,-0.14804483214209146,0.06665147425457718,0.21469630639666865,757480457,763830269,25.59552634930816,40.11023466515611,NaN,NaN,3.985428543914943,14.180229328450638
2018-09-28T09:30:00-04:00,53.79,54,53.7399,53.93,9249865,10502331.8,45.18699498060118,55.31435687384684,NaN,NaN,-93.87670907304684,-64.37484445289427,-0.1493054632001479,0.028064477396483767,0.17736994059663166,766730322,762182034,24.768215530967566,38.82233702600434,NaN,NaN,1.8608450144118664,12.420317283587956
2018-10-01T09:30:00-04:00,54.01,54.0899,53.83,53.89,8725512,10414960.85,44.64427469746013,54.4100932072431,NaN,NaN,-89.06294503861412,-82.39574797941808,-0.14643851767250832,-0.005678206494003746,0.14076031117850457,758004810,760918441.4,24.124439943864886,37.25498374885492,NaN,NaN,-0.0219763581041331,10.64284676334623
2018-10-02T09:30:00-04:00,53.86,54.315,53.73,54.2,9592449,10416029.35,49.68767420582315,53.31021163688439,NaN,NaN,-68.53668576570475,-83.05214134124128,-0.1184648317879415,-0.007320728556422296,0.1111441032315192,767597259,763237224.6,27.831464252281762,35.72332313406196,NaN,NaN,-0.19631356912553163,9.094395287278836
2018-10-03T09:30:00-04:00,54.32,54.38,53.55,53.62,15192931,10439483.6,41.9810361499558,51.77291567640066,NaN,NaN,-108.24087089152168,-90.90990806202186,-0.13274886976753525,-0.05479198397789986,0.07795688578963539,752404328,760443435.2,26.17232071004844,34.11558248757481,NaN,NaN,-2.8235558952518907,7.391830832631589
2018-10-04T09:30:00-04:00,53.47,53.5678,53.09,53.49,19963964,10820992.5,40.46605508586951,50.33972263541671,NaN,NaN,-163.88599406715912,-104.7206409672093,-0.14374992727840347,-0.10173052330836896,0.042019403970034515,732440364,755435416.6,23.471221429792294,32.35545673058392,NaN,NaN,-5.425325611652086,5.560808483448207
2018-10-05T09:30:00-04:00,53.38,53.65,53.36,53.44,13903111,11053784.75,39.870101107090875,48.68641214232699,NaN,NaN,-127.59149773517657,-111.46359869963526,-0.14668353435297124,-0.14133501397117954,0.005348520381791705,718537253,745796802.8,19.33521936474024,30.317200121305227,NaN,NaN,-7.702681525249043,3.6660241964914575
2018-10-08T09:30:00-04:00,53.39,54.245,53.39,54.18,14908292,11381120.65,51.3011687025198,48.17527786846019,NaN,NaN,-54.04637676892791,-104.46028504569801,-0.09365655939437059,-0.11172217886117153,-0.018065619466800943,733445545,740884949.8,17.630241365502997,28.278894982909524,NaN,NaN,-6.09169781233674,2.2720639095160005
2018-10-09T09:30:00-04:00,54.2,54.315,53.93,54.06,13477212,11648902.5,49.65272684677534,47.68321799229271,NaN,NaN,-27.641884663804575,-96.28132482531798,-0.06300406604381871,-0.09682070202157433,-0.033816635977755624,719968333,731359164.6,14.888317433797525,26.445847505969954,NaN,NaN,-5.320764817845253,1.1873740913215356
2018-10-10T09:30:00-04:00,53.88,54.29,53.32,53.41,26121647,12193983.4,41.814921796249976,46.02348762845394,NaN,NaN,-82.87861877006334,-91.2088744010263,-0.08166208146417518,-0.1358942378079746,-0.05423215634379942,693846686,719647636.2,12.346043124543613,24.54856249434448,NaN,NaN,-7.284323559850385,-0.022868430274453067
2018-10-11T09:30:00-04:00,53.26,53.54,51.92,52.09,44523284,13932823.05,31.084064632601653,43.98749793523619,NaN,NaN,-226.24519191943398,-103.68071397148128,-0.17282059483522516,-0.2702578998878309,-0.09743730505260573,649323402,703024243.8,9.79055034570257,22.599924086326194,NaN,NaN,-13.51727235413042,-1.950640419396734
2018-10-12T09:30:00-04:00,52.31,52.555,51.92,52.38,26263004,14799712.55,35.02892750364248,43.09335053874198,NaN,NaN,-222.2141472868183,-122.60524388180961,-0.2015020040104182,-0.3493148100656285,-0.14781280605521027,675586406,694434074.4,8.77926903459813,20.908656983406747,NaN,NaN,-16.732932576865846,-4.0623964418923215
2018-10-15T09:30:00-04:00,52.23,53.08,52.23,52.7,15892032,15080335.9,39.16691131596427,42.75476757949214,NaN,NaN,-151.35923439650028,-142.06781540732408,-0.18714665405422287,-0.3817461236229889,-0.194599469568766,691478438,686040653,7.91860163237034,19.37418022501318,NaN,NaN,-17.73085727933293,-6.015033704383837
2018-10-16T09:30:00-04:00,52.83,53.37,52.635,53.29,15468550,15071839.95,45.99626026516843,42.843003292652476,NaN,NaN,-85.2855266294886,-153.5965438004609,-0.12891191408960362,-0.3557393621807705,-0.2268274480911669,706946988,683436384,7.667436873880817,17.879919099385656,NaN,NaN,-16.04037427719998,-7.447225214786143
2018-10-17T09:30:00-04:00,53.24,53.66,53.05,53.54,15837833,15474136.7,48.627974941536905,43.179220873661386,NaN,NaN,-40.167109081763265,-145.0542418628009,-0.06763137321964127,-0.3113666646157185,-0.24373529139607722,722784821,689224011,14.182037304522765,17.06466988190099,NaN,NaN,-13.7967709097654,-8.35430317121175
2018-10-18T09:30:00-04:00,53.6,54.08,53.3,53.47,19370259,15851758.3,47.92375467732066,43.37470370914134,NaN,NaN,-6.879382677815298,-101.18108001447715,-0.027921717404536306,-0.2786374381517476,-0.25071572074721127,703414562,700042243,24.85475101634232,17.070850987999183,NaN,NaN,-12.289818263387282,-8.916519612951111
2018-10-19T09:30:00-04:00,54.08,54.85,54.08,54.69,28312362,16751660.55,59.053507382336576,44.403934615203944,NaN,NaN,127.81574068531233,-31.175102420051026,0.07857450534747451,-0.15249758906286814,-0.23107209441034265,731726924,711270346.6,34.02555125428337,17.77807322445765,NaN,NaN,-6.720886341576818,-8.602857717040498
2018-10-22T09:30:00-04:00,54.79,54.86,54.125,54.28,16645725,17051510.6,54.81372218502128,44.770080899432386,NaN,NaN,110.94861656323394,21.286467771895822,0.1171466671969418,-0.0846387604141654,-0.2017854276111072,715081199,715990898.8,37.4801281311036,18.46726350151635,NaN,NaN,-3.811979463286989,-7.918446537932854
2018-10-23T09:30:00-04:00,53.9636,54.66,53.65,54.52,30466629,18158870.55,56.770279839551364,45.82645544868921,NaN,NaN,86.97889429248622,55.7393519562908,0.15233780764940594,-0.011363168049349781,-0.16370097569875572,745547828,723711066.8,42.75904243728226,19.652029339175908,NaN,NaN,-0.8628210456636323,-6.910500039037251
2018-10-24T09:30:00-04:00,54.56,55.52,54.4,54.75,36761859,19478466.9,58.61947747651882,47.12312847659273,NaN,NaN,154.83892747289747,94.74055926722295,0.18257962634179686,0.06452355722849035,-0.1180560691133065,782309687,735616040,49.79836332908959,21.53253947484,NaN,NaN,2.098001499743072,-5.623571247782919
2018-10-25T09:30:00-04:00,54.62,55.08,54.15,54.88,30018203,20534736.15,59.66958506167387,48.53737733049151,NaN,NaN,116.8270853214127,119.48185286706855,0.20133607764891376,0.13361402794783572,-0.06772204970107805,812327890,757398705.6,59.59044862041743,24.407912993102656,NaN,NaN,4.7907257318956225,-4.13581453640027
2018-10-26T09:30:00-04:00,54.5,54.65,53.59,53.83,39310579,22037771.85,48.880103602896696,48.36444410908986,NaN,NaN,33.307647253965406,100.58023418079915,0.13614675006449725,0.10246138787954351,-0.033685362184953736,773017311,765656783,62.57113686939446,27.617976957666325,NaN,NaN,3.613266184555739,-3.028803004835126
2018-10-29T09:30:00-04:00,54.2,54.83,53.945,54.45,31687523,23185872.4,54.151871071156535,48.68581155368852,NaN,NaN,73.78892327623404,93.14829552339918,0.12802435943553367,0.12634508710946335,-0.001679272326070319,804704834,783581510,68.07558472759865,31.417067478652122,NaN,NaN,4.4492487178481355,-1.96050990159466
2018-10-30T09:30:00-04:00,54.82,55.58,54.68,55.53,33148141,24363657,61.58374101061279,50.097870069000145,NaN,NaN,151.67264483249554,106.08704563140104,0.18516054040264718,0.22977140317723865,0.044610862774591475,837852975,802042539.4,72.55266921292811,35.717540770679584,NaN,NaN,7.934636753089184,-0.5469175223541112
2018-10-31T09:30:00-04:00,55.52,55.52,54.57,55.01,30135113,25110766.1,56.808918050225,51.93535959883038,NaN,NaN,111.69008802885678,97.4572777425929,0.17767407632423896,0.26670345817989016,0.08902938185565121,807717862,807124174.4,73.64817644610709,40.27879977785134,NaN,NaN,8.993908333351985,0.8160575998896167
2018-11-01T09:30:00-04:00,55.13,55.57,54.8477,55.4,22589800,25242057.9,59.354293383081064,53.672885733075994,NaN,NaN,120.59792085543319,98.211444849397,0.18774496201211968,0.3237105843708008,0.13596562235868112,830307662,810720128.8,74.42604883491748,44.967855477874146,NaN,NaN,10.714836627904898,2.2301688896060856
2018-11-02T09:30:00-04:00,55.4,55.47,54.625,55.11,28704131,25982108.9,56.67943182099066,54.923780054863585,NaN,NaN,91.88454499044212,109.92682439669234,0.1644686017806759,0.341551374584526,0.1770827728038501,801603531,816437372.8,75.65642868141097,49.806271695662765,NaN,NaN,11.194146152477922,3.510737070016348
2018-11-05T09:30:00-05:00,55.2,55.9461,55.12,55.8,19972279,26235308.25,61.163988970518275,56.00718924810286,NaN,NaN,124.57726583194946,120.08449290783543,0.18367747244547533,0.40667961336069425,0.22300214091521892,821575810,819811568,76.37872091856977,54.71422055599769,NaN,NaN,13.110577803767304,4.882142889123627
2018-11-06T09:30:00-05:00,55.79,56.16,55.6,56.14,15626491,26342772.2,63.18630638668827,57.04707006561368,NaN,NaN,133.87958671062503,116.5258812834613,0.20575348156892326,0.480193992876373,0.27444051130744973,837202301,819681433.2,76.28471091060672,59.150125813575116,NaN,NaN,15.317828998452857,6.3729551904563735
2018-11-07T09:30:00-05:00,56.37,56.48,55.87,56.46,15067237,25790051.7,65.03192586552005,58.26908229334221,NaN,NaN,140.2261289983281,122.23308947735559,0.22672398957492723,0.5578454982761087,0.3311215087011815,852269538,828591768.4,78.25798234496492,62.964642337048154,NaN,NaN,17.70327533191812,7.991572353522337
2018-11-08T09:30:00-05:00,56.18,56.58,56.17,56.49,12890220,24208398.5,65.20802927351343,58.708690999854845,NaN,NaN,139.02291812237485,125.91808893074392,0.22687840987492125,0.6147195210448331,0.3878411111699118,865159758,835562187.6,79.6822253143226,66.22583334133667,NaN,NaN,19.64859484608665,9.656861281031524
2018-11-09T09:30:00-05:00,56.47,57,56.47,56.82,18510894,23820793,67.16681286320672,59.591054619725234,NaN,NaN,151.5561877521734,137.85241748309016,0.23260581206453745,0.6785983762505836,0.44599256418604616,883670652,851975611.8,82.57652785324674,69.44700475006118,NaN,NaN,21.871257297365165,11.401774997650616
2018-11-12T09:30:00-05:00,56.66,56.98,56.41,56.52,15950713,23823727.05,63.65805965482175,60.083038892244545,NaN,NaN,130.17839946292594,138.97264420928548,0.20079072754697025,0.696980973619759,0.4961902460727887,867719939,861204437.6,83.9600987376375,72.3899373429437,NaN,NaN,22.73129565975717,13.020277949380123
2018-11-13T09:30:00-05:00,56.55,56.76,56.115,56.39,23146484,24207623.75,62.14311120467223,60.334727015684074,NaN,NaN,102.43662677729459,132.6840522226194,0.15750389914764784,0.6930701200073486,0.5355662208597007,844573455,862678668.4,84.17626083205084,74.84550145029807,NaN,NaN,23.01791378489675,14.448511640168212
2018-11-14T09:30:00-05:00,56.49,56.49,55.74,56.01,17577624,24294613.3,57.812110911211846,60.20205029065107,NaN,NaN,67.14931352545722,118.06868912804521,0.09298257180030212,0.6517944356100784,0.5588118638097763,826995831,857623927,80.18605900304561,76.31661647762864,NaN,NaN,22.03378070124095,15.532121506035745
2018-11-15T09:30:00-05:00,55.82,55.92,55.39,55.92,25604689,24606334.8,56.80238068968189,60.76792722542144,NaN,NaN,31.755499681867246,96.6152054399437,0.036829382906475194,0.6048485924428704,0.5680192095363952,801391142,844870203.8,71.03632540213891,76.92127280139611,NaN,NaN,20.937960846592766,16.304384268972463
2018-11-16T09:30:00-05:00,55.89,56.2849,55.69,56.06,15212781,23951355.75,58.03036255984522,61.044962331756345,NaN,NaN,50.07905581501133,76.31977905251127,0.0034589450926942877,0.572342890902263,0.5688839458095687,816603923,831456858,62.90635575317507,76.55204216036587,NaN,NaN,20.334244290780475,16.88007855780218
2018-11-19T09:30:00-05:00,56.08,56.385,55.74,55.97,16727183,23955428.65,56.91035085249549,60.71114874903368,NaN,NaN,46.580367615999585,59.60017268312599,-0.02856831854072206,0.5331735476336661,0.5617418661743881,799876740,817888218.2,55.932734387749946,75.36490395856742,NaN,NaN,19.52970577613888,17.25859673185028
2018-11-20T09:30:00-05:00,55.8,56.08,54.89,55.04,33023203,24083257.35,46.84830516640484,59.99967640018939,NaN,NaN,-27.294292469531708,33.65398883376075,-0.11161650916738597,0.42222122971515574,0.5338377388825417,766853537,802344234.6,49.203433523544675,73.61885089267011,NaN,NaN,15.746642571666936,17.042603280395515
2018-11-21T09:30:00-05:00,55.01,55.14,54.48,54.6,16604574,23075393.1,42.97677002576056,58.829853303237925,NaN,NaN,-87.69980980703444,2.6841641672624,-0.1907650531377859,0.2953814224603093,0.4861464755980952,750248963,786994861,43.62226521737321,71.4185806342741,NaN,NaN,11.282917701434078,16.219791054829596
2018-11-23T09:30:00-05:00,54.55,55.03,54.42,54.79,8700837,22009524.8,45.08709504767487,58.00182924800107,NaN,NaN,-87.55856038378451,-21.17864784586795,-0.22268035632202254,0.20779603019556703,0.43047638651758957,758949800,778506592.6,40.861930662654316,68.93325934722006,NaN,NaN,8.184773144483287,15.071931353351552
2018-11-26T09:30:00-05:00,54.87,55.14,54.59,54.86,13125453,20700268.5,45.88173522690827,56.91023969488607,NaN,NaN,-85.81786556368189,-48.3580321216066,-0.2304683123934293,0.14239099602580296,0.37285930841923226,772075253,769600858.6,38.13536058375012,66.20159075187578,NaN,NaN,5.85704981018149,13.755519704327257
2018-11-27T09:30:00-05:00,54.77,55.37,54.74,55.35,15969471,19914365.9,51.204735642216356,56.05441321313808,NaN,NaN,-61.52095487516225,-69.97829661983897,-0.19539675448633803,0.12861336531130974,0.32401011979764777,788044724,767234455.4,37.420839551744066,63.42559994052846,NaN,NaN,5.314992893983908,12.549730159992492
2018-11-28T09:30:00-05:00,55.26,55.82,55.09,55.81,21973733,19355645.5,55.61805544139078,55.381993897128844,NaN,NaN,-13.915856618093036,-67.30260944955123,-0.13676937374914294,0.1530484026112191,0.28981777636036204,810018457,775867439.4,41.711525466863385,60.81513873494978,NaN,NaN,6.159354922893096,11.636819411835436
2018-11-29T09:30:00-05:00,55.72,56.07,55.65,55.9,13284960,18513137.85,56.448030203987535,54.756279677877,NaN,NaN,18.495288373319482,-46.06358981348045,-0.08975181433371804,0.17762800844321447,0.2673798227769325,823303417,790478330.2,48.186530478431465,58.56544624667184,NaN,NaN,7.0908924170539605,10.987401269723797
2018-11-30T09:30:00-05:00,55.89,56.4,55.75,56.26,16551866,18211241.15,59.69488868613012,54.22257080808581,NaN,NaN,47.53107776132018,-19.04566218445951,-0.03504047238999536,0.22357923228943832,0.2586197046794337,839855283,806659426.8,54.24806798310428,56.54198482737595,NaN,NaN,8.850887110071781,10.682184961202081
2018-12-03T09:30:00-05:00,56.46,56.46,55.73,56.31,20855748,17818822,60.13936837557596,53.97123571671112,NaN,NaN,46.70104583354062,7.458120094984994,0.0019215129792987673,0.2610215959035571,0.25910008292425835,860711031,824386582.4,59.79705579520504,54.81605318863077,NaN,NaN,10.422970484627873,10.64515432169148
2018-12-04T09:30:00-05:00,56.41,56.615,55.3301,55.36,27634987,18201957.4,49.06743558097895,53.03725888644731,NaN,NaN,-9.321524821942427,17.89800610562896,-0.03800110617435354,0.21159870020631644,0.24959980638066998,833076044,833392846.4,62.29883729499296,53.25338007884093,NaN,NaN,8.48523480753953,10.336594391098345
2018-12-06T09:30:00-05:00,55.18,55.44,54.245,55.42,32514026,19046334.15,49.69733026349422,52.45763169732462,NaN,NaN,-97.80784475397707,1.119608478452156,-0.059478243612003684,0.17525200186566536,0.23473024547766905,865590070,844507169,65.17862480959229,52.18142049359427,NaN,NaN,7.116857874166231,9.876632031536614
2018-12-07T09:30:00-05:00,55.37,55.5662,54.48,54.72,23139942,19449969.4,43.013723217846476,51.47272759219352,NaN,NaN,-98.68093783869237,-22.315636763950216,-0.11663410497767318,0.08893761425557756,0.20557171923325074,842450128,848336511.2,66.13833449680712,51.83156400035629,NaN,NaN,3.745206457265096,9.000714092354968
2018-12-10T09:30:00-05:00,55.03,55.03,53.88,54.72,44469000,21028908.4,43.013723217846476,50.40011049633647,NaN,NaN,-126.06833382371099,-57.03551908095644,-0.14821829720104565,0.02029884773194368,0.16851714493298933,842450128,848855480.2,66.27399728940473,52.072109824372696,NaN,NaN,1.0746696692308784,7.86842203190867
2018-12-11T09:30:00-05:00,55.1,55.57,54.87,55.17,25677396,21387233.5,48.20690531081262,49.77843581478769,NaN,NaN,-42.71498530367601,-74.91872530839977,-0.1330631988660838,0.0021881463503845566,0.13525134521646837,868127524,850338778.8,66.68483122398607,52.84011674124669,NaN,NaN,0.31339990536140905,6.789133156687633
2018-12-12T09:30:00-05:00,55.51,55.68,55.07,55.1,18735225,21526459.1,47.482030908316474,49.823701939209954,NaN,NaN,-26.501173505054403,-78.35465504502217,-0.1222891812360681,-0.017610131328616774,0.10467904990745133,849392299,853602029.8,67.61936159814196,54.1555401751465,NaN,NaN,-0.5155482585541272,5.745607240224524
2018-12-13T09:30:00-05:00,55.17,55.6162,55.1,55.44,16987811,21218525.45,51.31155639048351,50.41904382240445,NaN,NaN,-6.565095167299623,-60.10610512768668,-0.08838196797782831,-0.005798410064834059,0.08258355791299425,866380110,853760037.8,67.66665660555996,55.87299670287412,NaN,NaN,-0.11102018261671495,4.908946179818633
2018-12-14T09:30:00-05:00,55.09,55.1582,54.372,54.5,20262678,21352778.15,42.158678828191825,50.209871235298515,NaN,NaN,-102.24943976720012,-60.819805513388225,-0.1232379573160505,-0.07146388873206888,0.05177406858398162,846117432,854493498.6,67.90102742473974,57.8043607573088,NaN,NaN,-2.7081438584592963,3.820790460064643
2018-12-17T09:30:00-05:00,54.37,54.5,52.92,53.24,27324211,21438754.25,33.52590520609827,49.3273119480978,NaN,NaN,-223.34818480761456,-80.27577571016894,-0.21950694950768404,-0.22260961830062342,-0.0031026687929393837,818793221,849762117.2,64.64574551078383,59.697959680668355,NaN,NaN,-8.339143077449688,2.083657097562596
2018-12-18T09:30:00-05:00,53.38,53.49,52.31,52.61,27349684,22045599.4,30.196444750798562,47.826719741567956,NaN,NaN,-257.2951448347911,-123.19180761639196,-0.3085164135278561,-0.3887481857027595,-0.0802317721749034,791443537,834425319.8,55.37787509762773,60.980605076802895,NaN,NaN,-14.154863466277808,-0.23613155441460432
2018-12-19T09:30:00-05:00,52.86,53.2756,51.86,52.1,46289639,23523722.2,27.79040634525704,45.839030520415555,NaN,NaN,-240.14194723990818,-165.9199623633627,-0.37994843177447823,-0.5551673118930012,-0.17521888011852296,745153898,813577639.6,45.77180442753893,61.27062500256543,NaN,NaN,-19.688034984354427,-3.0149749015488645
2018-12-20T09:30:00-05:00,51.87,51.89,50.68,51.17,43414993,24043311.7,24.030275575123653,43.523476618353854,NaN,NaN,-256.39018788464364,-215.88498090683152,-0.4625561025813952,-0.753414008345267,-0.29085790576387177,701738905,780649398.6,35.34348475148195,60.35326459349761,NaN,NaN,-25.78773052431968,-6.2682257048018375
2018-12-21T09:30:00-05:00,50.72,51.83,50.18,50.18,38535666,25139866.3,20.80341877382405,40.74551448176056,NaN,NaN,-213.68331871757087,-238.17175669690567,-0.550612826204133,-0.979123938519038,-0.428511112314905,663203239,744066560,27.772877266263876,58.46217954229472,NaN,NaN,-32.125523300297374,-9.9621253613012
2018-12-24T09:30:00-05:00,50.05,50.22,48.69,48.73,23086842,25859166.55,17.167283636671527,37.67607985755309,NaN,NaN,-216.9872951031561,-236.89957875601394,-0.6655699989546713,-1.2604736110082442,-0.5949036120535729,640116397,708331195.2,22.665555379376656,55.809929512592696,NaN,NaN,-39.04014273649717,-14.116127843472054
2018-12-26T09:30:00-05:00,48.83,50.09,48.33,50.09,26670627,26536425.25,29.596777190787734,36.28531854396801,NaN,NaN,-162.75039011488713,-217.9906278120332,-0.6105170031306825,-1.358049865966926,-0.7475328628362435,666787024,683399892.6,19.914088879198857,52.78244748289312,NaN,NaN,-39.563200858578575,-17.75142398848727
2018-12-27T09:30:00-05:00,49.78,50.61,49.0401,50.57,35926853,27534294.35,33.395537321707735,35.12090476241183,NaN,NaN,-120.42155923599289,-194.04655021125012,-0.5065589487148496,-1.3807315487298055,-0.8741726000149559,702713877,674911888.4,19.065511173720836,49.48865365175944,NaN,NaN,-38.47885865264806,-20.712486083367384
2018-12-28T09:30:00-05:00,50.94,51.15,50.3719,50.57,24436663,27657440.85,33.395537321707735,34.43389148411621,NaN,NaN,-87.69919508654169,-160.30835165162972,-0.40687573233910457,-1.3827672654388365,-0.975891533099732,702713877,675106882.8,19.15074430409723,46.13239720942302,NaN,NaN,-37.68295594918196,-23.136838921340896
2018-12-31T09:30:00-05:00,50.7,50.82,50.31,50.78,14959571,27741171.4,35.17042124265021,33.87365562874504,NaN,NaN,-79.54303888421902,-133.48029568495934,-0.30076839905243147,-1.3518520319152714,-1.05108363286284,717673448,686000924.6,23.968241054033854,43.110557478325106,NaN,NaN,-36.475393765064204,-25.042346756158512
2019-01-02T09:30:00-05:00,50.24,50.64,49.95,50.48,20487343,27937945.25,33.78532065195665,32.84354243882675,NaN,NaN,-79.43812270710988,-105.97046120575014,-0.22805837201313595,-1.3361565978792598,-1.1080982258661238,697186105,697414866.2,28.757991135714178,40.40149747201997,NaN,NaN,-35.933713975039225,-26.598256358855757
2019-01-03T09:30:00-05:00,50.39,50.91,50.11,50.19,22074830,27998899.35,32.454733815677145,31.7701640750668,NaN,NaN,-70.60986387982467,-87.54235595873763,-0.1789347414819178,-1.331766652718521,-1.1528319112366032,675111275,699079716.4,29.456065506975406,37.67554775122236,NaN,NaN,-35.892634508748024,-27.926024665983224
2019-01-04T09:30:00-05:00,50.52,51.26,50.41,51.26,19003481,27567324.05,41.594578270728725,31.076094209370034,NaN,NaN,-46.892532896672975,-72.83655069087364,-0.05996989796028651,-1.2277942836869613,-1.1678243857266748,694114756,697359892.2,29.138432737005303,34.923531760611304,NaN,NaN,-32.88104178900915,-28.633884254986928
2019-01-07T09:30:00-05:00,51.13,51.53,50.73,51.19,15146322,26698938.85,41.20178963566815,31.007744981332625,NaN,NaN,-36.27413705408786,-62.55153908438289,0.023918277913088426,-1.1379265383353143,-1.1618448162484027,678968434,692610803.6,28.23307615321322,32.09010666978798,NaN,NaN,-30.61864396051654,-28.917421355776874
2019-01-08T09:30:00-05:00,51.49,51.79,51.24,51.66,28273829,26955633.2,44.96003263470153,31.82446836909,NaN,NaN,-17.22535745410573,-50.08800279836023,0.11583054512259294,-1.0170566348451615,-1.1328871799677545,707242263,690524566.6,27.824086385006026,29.459988160803853,NaN,NaN,-27.561733229488954,-28.723751623450028
2019-01-09T09:30:00-05:00,51.65,51.7001,51.06,51.18,15684516,25516409,42.006985816732964,32.668078445228176,NaN,NaN,-22.31380928688778,-38.66314011431581,0.14706318253493134,-0.9490582017990903,-1.0961213843340216,691557747,689398895,27.591830086788704,27.475270660029633,NaN,NaN,-25.847964915402784,-28.31292495087185
2019-01-10T09:30:00-05:00,51.08,51.57,50.94,51.48,32431666,25854122.5,44.4622417056054,33.85892382811019,NaN,NaN,-15.833989735651175,-27.707965285481112,0.18806832812450902,-0.8610359741783853,-1.0491043023028943,723989413,699174522.6,32.83514890974135,26.551223837329808,NaN,NaN,-23.69521891580691,-27.653252660148286
2019-01-11T09:30:00-05:00,51.59,51.66,51.35,51.63,11732378,25503980.15,45.70011077372142,35.40676919943861,NaN,NaN,3.9168414837257335,-17.54609040940137,0.22304783969028164,-0.7702945026900423,-0.9933423423803239,735721791,707495929.6,37.01618987368045,26.670702774629696,NaN,NaN,-21.566297470100345,-26.783687632998582
2019-01-14T09:30:00-05:00,51.5,51.61,51.3,51.38,7811522,25045165.7,43.94218144872357,37.059537961931426,NaN,NaN,10.928785632231206,-8.105505872137549,0.2263814801170161,-0.7103654922340539,-0.93674697235107,727910269,717284296.6,41.61987439711398,27.659773998261844,NaN,NaN,-20.249650404860855,-25.85025374326462
2019-01-15T09:30:00-05:00,51.37,51.94,51.34,51.89,11447704,24604417,48.310379794879694,39.28404483037487,NaN,NaN,51.721406955827824,5.683847009849162,0.2576908019724412,-0.6146334698855185,-0.8723242718579597,739357973,723707438.6,44.48729234406116,29.21846949573931,NaN,NaN,-17.84661383696703,-24.706876613793536
2019-01-16T09:30:00-05:00,51.87,51.87,51.42,51.61,13484834,23912448.15,46.18264499060056,40.46874967321863,NaN,NaN,58.94130461163999,21.934869789554714,0.2538901687013412,-0.5549615609812832,-0.8088517296826244,725873139,730570517,47.45689166573634,31.185812551920556,NaN,NaN,-16.39552549088884,-23.519540739092864
2019-01-17T09:30:00-05:00,51.53,51.935,51.47,51.83,10196398,23054783.85,48.11620696650767,41.52022607641863,NaN,NaN,80.92754659172367,41.28717705502968,0.2596126960837879,-0.4843358595778895,-0.7439485556616774,736069537,732986541.8,48.50129644832948,33.28836864296403,NaN,NaN,-14.632251394492707,-22.249927975578558
2019-01-18T09:30:00-05:00,52.13,52.61,52.07,52.45,11958918,21338247.8,53.21742156582831,42.93607495099867,NaN,NaN,148.68300132317646,70.24040902291982,0.2959395274066219,-0.3740241464034,-0.6699636738100219,748028455,735447874.6,49.60038812106047,35.463343201318544,NaN,NaN,-11.578365061292189,-20.725418987823364
2019-01-22T09:30:00-05:00,52.31,52.41,51.55,51.97,20877708,20211383.55,49.185490368499785,43.937151317130784,NaN,NaN,97.03442733031747,87.46153736253707,0.27867029476540617,-0.3216258053532641,-0.6002961001186703,727150747,735295970.2,49.53013076638124,37.28919246648622,NaN,NaN,-10.081884345299036,-19.204914038891317
2019-01-23T09:30:00-05:00,52.37,52.74,52.12,52.59,23804728,19474836.65,54.03019274275203,45.38321360933046,NaN,NaN,131.26047583907186,103.3693511391859,0.29827765349938984,-0.227449033244433,-0.5257266867438228,750955475,737615470.6,50.678939960282676,38.85497452538397,NaN,NaN,-7.307350332274745,-17.505262080803234
2019-01-24T09:30:00-05:00,52.31,52.32,51.585,51.94,17727217,19206855.4,48.77942956507961,46.54926330571635,NaN,NaN,76.42377515334832,106.86584524752755,0.2582424269884765,-0.20292365300822723,-0.4611660799967037,733228258,739086494.4,51.433959774760815,40.42482411594007,NaN,NaN,-6.490998668938129,-15.93179587910822
2019-01-25T09:30:00-05:00,52.1,52.31,51.66,51.73,12920339,18519341,47.18402254621066,46.94850932539363,NaN,NaN,67.12351563423191,104.10503905602918,0.21041428159531594,-0.19814822800255882,-0.40856250959787477,720307919,735934170.8,49.67889304022254,41.891999851884165,NaN,NaN,-6.296651308108004,-14.555346654679617
2019-01-28T09:30:00-05:00,51.62,51.97,51.445,51.95,10996666,17272831.65,49.063561897204295,47.510064486931924,NaN,NaN,47.66737010156888,83.90191281170767,0.18717093476586505,-0.17459884114054347,-0.3617697759064085,731304585,732589396.8,47.81455582778955,43.29067697149676,NaN,NaN,-5.592460695010246,-13.27493437472685
2019-01-29T09:30:00-05:00,52.05,52.18,51.84,52.07,11500374,16626017.2,50.1065347813576,47.87767178312164,NaN,NaN,75.73870320393851,79.64276798643189,0.17374695123518102,-0.14458608686243224,-0.31833303809761326,742804959,735720239.2,49.71675068676308,44.85443870733655,NaN,NaN,-4.7179406685157765,-12.052506702410984
2019-01-30T09:30:00-05:00,52.12,52.54,52,52.42,13938822,16574979.75,53.12154779507906,48.67156906728922,NaN,NaN,110.95086122227812,75.58084506307314,0.18146332001704213,-0.0915038880763106,-0.27296720809335273,756743781,736877900.4,50.43615912537465,46.486176495806966,NaN,NaN,-3.11543430473036,-10.775782074170895
2019-01-31T09:30:00-05:00,52.43,53.53,52.31,53.39,17886515,16444938.35,60.28452623774733,49.801732248156505,NaN,NaN,208.50071331668278,101.99623269574003,0.24117890722386406,0.028506425936477342,-0.21267248128738672,774630296,745158308,55.35619548551674,48.09482267979092,NaN,NaN,0.5963678273919365,-9.151189231090491
2019-02-01T09:30:00-05:00,53.55,53.55,53,53.22,14423443,16062369,58.594705534689446,50.72277473108279,NaN,NaN,205.89762522156195,129.75105461320604,0.2570543751233021,0.10864548761674087,-0.14840888750656123,760206853,753138094.8,59.52589595375118,49.70265882836741,NaN,NaN,3.138395190040328,-7.395534313786088
2019-02-04T09:30:00-05:00,53.21,53.56,53.11,53.56,13367542,15780572.05,60.95217615373778,51.93777435286952,NaN,NaN,189.7825546339381,158.17409151967988,0.27658061693421043,0.19731688366120181,-0.07926373327300862,773574395,761592056.8,63.42351439753518,51.26006168554035,NaN,NaN,5.991726876724323,-5.483068429427458
2019-02-05T09:30:00-05:00,53.6,53.71,53.42,53.57,11296082,15588060.05,61.02246889891279,52.84578071744331,NaN,NaN,170.7840848225799,177.18316784340817,0.2756812830119422,0.26533787049191915,-0.010343412520023063,784870477,770005160.4,66.84526439635937,52.85705968927594,NaN,NaN,8.332488544233723,-3.509417433190147
2019-02-06T09:30:00-05:00,53.42,53.67,53.42,53.58,19006094,15124673.3,61.09788629804841,53.911155096546736,NaN,NaN,141.7897169119294,183.3509389813384,0.26139840509098405,0.316404593843707,0.05500618875272295,803876571,779431718.4,70.20824233477101,54.48215616563556,NaN,NaN,10.28891247656706,-1.5382274460819745
2019-02-07T09:30:00-05:00,53.35,53.58,53.17,53.54,14518998,15066397.4,60.592849208517045,54.80234382811883,NaN,NaN,112.40408773003008,164.13161386400787,0.23568905010439312,0.34961750138321435,0.11392845127882123,789357573,782377173.8,71.19153447143555,56.10288745300027,NaN,NaN,11.808656539884161,0.3684702661989019
2019-02-08T09:30:00-05:00,53.43,53.79,53.23,53.79,11100066,13999817.4,62.66978141660562,55.477512388888634,NaN,NaN,113.00272003109586,145.55263282591466,0.22213546701874148,0.39159778505224807,0.1694623180335066,800457639,790427331,73.74234912176838,57.82731323876512,NaN,NaN,13.686388173106105,2.271029967185645
2019-02-11T09:30:00-05:00,53.84,53.98,53.6944,53.93,6876160,13757006.5,63.81976432925781,56.52281767179993,NaN,NaN,119.5061418019115,131.49735025950935,0.20938515280308523,0.4311937590373631,0.2218086062342779,807333799,797179211.8,75.68683735872686,59.695649423932664,NaN,NaN,15.604686970316163,4.175838110490004
2019-02-12T09:30:00-05:00,54.04,54.51,53.96,54.35,11694050,13951132.9,67.09469913274478,57.45599669965659,NaN,NaN,135.37020507811872,124.4145743106171,0.21519841924476724,0.49080663029023697,0.27560821104546973,819027849,804010686.2,77.50220182030253,61.611596699648366,NaN,NaN,18.23129998232934,6.183761235038481
2019-02-13T09:30:00-05:00,54.45,54.62,54.325,54.45,10809562,13919225.8,67.84109279426546,58.81754407316986,NaN,NaN,133.26082571458664,122.70879607114856,0.21143010422402664,0.5398958413255031,0.3284657371014764,829837411,809202854.2,78.79794605038505,63.566167147907244,NaN,NaN,20.66446429771906,8.252433101135706
2019-02-14T09:30:00-05:00,53.88,54.08,53.55,53.84,11388507,13814409.45,59.043062188141924,59.664618333307814,NaN,NaN,73.79417449194331,114.9868134235312,0.15606134758297535,0.5235424215801956,0.36748107399722024,818448904,815021120.4,80.17580381678711,65.74451791766185,NaN,NaN,20.45900356596519,9.996228881825632
2019-02-15T09:30:00-05:00,54.1,54.45,53.8405,54.35,12635410,13936360.05,63.32541871968308,60.6833223920563,NaN,NaN,98.84940097724693,112.1561496127614,0.14237304361332004,0.5454473785138703,0.4030743349005502,831084314,821146455.4,81.53620897790543,68.15320742838442,NaN,NaN,21.52423712879801,11.643087202821686
2019-02-19T09:30:00-05:00,54.48,54.84,54.3567,54.63,19831685,14329998.4,65.46063666088135,61.78004395487942,NaN,NaN,120.34008403569263,112.32293805951763,0.14052424376291828,0.5787296396041981,0.4382053958412798,850915999,829862895.4,83.29316485096007,70.55152272582707,NaN,NaN,23.05479507080657,13.273331183962384
2019-02-20T09:30:00-05:00,54.58,54.73,54.36,54.53,14478614,14010043.7,64.0269103891712,62.558998425885996,NaN,NaN,107.19245548331817,106.68738814055753,0.12162213744093142,0.5902330676424441,0.4686109302015127,836437385,833344802.6,83.95017635392304,72.9453810992948,NaN,NaN,23.912632557853083,14.793231380232484
2019-02-21T09:30:00-05:00,54.44,54.8068,54.28,54.69,11712184,13405416.5,65.33512885409223,62.91975575562492,NaN,NaN,103.68958309875418,100.77313961739102,0.10933761978738055,0.6052829549357384,0.4959453351483578,848149569,837007234.2,84.63465230193057,75.03669944332437,NaN,NaN,25.000118789183546,16.25135815293978
2019-02-22T09:30:00-05:00,54.18,54.43,54.04,54.43,24758739,13756992.6,61.42589139678715,63.12198331720332,NaN,NaN,72.83505965226567,100.58131664945549,0.07479223186617079,0.5894356249810713,0.5146433931149005,823390830,837995619.4,84.82276665486218,76.84361877911802,NaN,NaN,24.84413288029409,17.47889739970468
2019-02-25T09:30:00-05:00,54.54,54.7,54.06,54.13,15162584,13869104.85,57.17496307197739,62.85218238279187,NaN,NaN,66.51763485834202,94.11496342567452,0.02538191486625696,0.5463707866977217,0.5209888718314647,808228246,833424405.8,79.94775372829413,78.02392158845794,NaN,NaN,23.490400612896078,18.33768357301774
2019-02-26T09:30:00-05:00,54.16,54.39,54.035,54.16,15114394,14074991.25,57.491766632782394,62.59998936378255,NaN,NaN,49.62651661740069,79.97224994201613,-0.009753302693231047,0.5087972434649259,0.518550546158157,823342640,827909734,74.39295905136595,78.56304263524412,NaN,NaN,22.454751439217848,18.92583612533204
2019-02-27T09:30:00-05:00,54.04,54.1559,53.86,54.08,10811601,14040552.6,56.29579283837422,62.25698268809153,NaN,NaN,22.288236076657366,62.99140606068396,-0.041097031585647925,0.46717925667609705,0.508276288261745,812531039,823128464.8,69.86081601718953,78.5382264697026,NaN,NaN,21.25706416111112,19.258868701871908
2019-02-28T09:30:00-05:00,54.21,54.55,54.08,54.34,8469392,13767081.1,59.26188718134109,62.161913971864685,NaN,NaN,56.47145262743811,53.54777996642075,-0.04662956462722534,0.44998933247771333,0.4966188971049387,821000431,817698637.2,65.01659942811405,78.09715968089391,NaN,NaN,20.98144005161811,19.50495032326422
2019-03-01T09:30:00-05:00,54.5,54.52,53.85,54.24,10812214,13413366.05,57.641538014383116,61.80275372884879,NaN,NaN,31.53677077754178,45.28812219147597,-0.05856219639572452,0.423416151610283,0.48197834800600753,810188217,815058114.6,62.738298099455406,77.31115603644298,NaN,NaN,20.31439773644424,19.620585668004225
2019-03-04T09:30:00-05:00,54.34,54.44,53.7313,54.15,10113567,13197872.25,56.15342279233148,61.25515790478262,NaN,NaN,7.469156294928346,33.47842647879323,-0.07310910605101362,0.3905919654422405,0.4637010714932541,800074650,813427395.4,61.30944276493934,76.28419927974389,NaN,NaN,19.352422383368413,19.582276627341965
2019-03-05T09:30:00-05:00,54.14,54.29,54.01,54.11,10132429,13036116.6,55.468020065243834,60.42468082853255,NaN,NaN,6.95369653455977,24.94386246222505,-0.08517450776498647,0.35723293678702106,0.44240744455200753,789942221,806747311.6,55.71197628969199,74.72775459898598,NaN,NaN,18.35728312974977,19.407277556257366
2019-03-06T09:30:00-05:00,54.1,54.245,53.795,54.03,12001072,13071366.1,54.04714137136448,59.43939858403962,NaN,NaN,-27.320971275164297,15.022020991860742,-0.09741063670163375,0.3206441486749654,0.4180547853765991,777941149,799829333.6,50.563451661739975,72.71100499979705,NaN,NaN,17.134724316798064,19.082627093477466
2019-03-07T09:30:00-05:00,53.94,54.03,53.57,53.68,14336056,12837864.2,48.22659589400178,58.6667938487439,NaN,NaN,-102.33470584428882,-16.739210702484645,-0.12612108674139944,0.26040342694984986,0.3865245136912493,763605093,788350266,43.39697334005535,70.0839456800305,NaN,NaN,14.423923698854036,18.41709803710269
2019-03-08T09:30:00-05:00,53.73,53.97,53.45,53.71,12027153,12713271.95,48.73620781852657,57.62470735580415,NaN,NaN,-127.518707111553,-48.550306280303595,-0.13911410513604217,0.21263188227119656,0.3517459874072387,775632246,781439071.8,39.74457526516643,67.09882898626343,NaN,NaN,12.260927935512282,17.537645165446918
2019-03-11T09:30:00-04:00,53.8,54.45,53.8,54.41,10519247,12684231,58.901508158465376,57.15619817706014,NaN,NaN,11.707314922603558,-47.70267455476856,-0.09849972243524469,0.22862133436318288,0.32712105679842757,786151493,778654440.4,38.344283316833405,63.888194590968666,NaN,NaN,13.099809309506352,16.903668614598267
2019-03-12T09:30:00-04:00,54.42,54.62,54.3,54.43,10841806,12882513.3,59.15074387376703,56.80790056881699,NaN,NaN,81.51687105103304,-32.79003965147391,-0.06958584293316955,0.24013875313196564,0.3097245960651352,796993299,780064656,39.506670208704016,60.71365843773873,NaN,NaN,13.853427923842276,16.46791994449027
2019-03-13T09:30:00-04:00,54.47,54.95,54.43,54.74,11135269,12854574.25,62.905724228467946,56.63437166698669,NaN,NaN,145.1543690855565,1.7050284206702486,-0.0308556027821148,0.2711550925874917,0.3020106953696065,808128568,786102139.8,44.34439756435605,57.83578309934054,NaN,NaN,15.631715728535442,16.348462199353865
2019-03-14T09:30:00-04:00,54.76,54.845,54.6,54.69,8449574,12736574.85,61.91710925752816,56.66945865703961,NaN,NaN,134.4682478959693,49.06561916872188,-0.010906993952372157,0.28837695292914134,0.2992839468815135,799678994,793316920,49.53779903762942,55.3154282695382,NaN,NaN,16.819985703160203,16.415822699897628
2019-03-15T09:30:00-04:00,54.58,54.845,54.47,54.7,21846923,13259495.65,62.04558289521287,57.01736007298501,NaN,NaN,110.59165652234557,96.68769189550159,0.00007783226200441806,0.299381237209019,0.2993034049470146,821525917,802495654.2,55.25790059304917,53.55186733130642,NaN,NaN,17.837467322076396,16.61891478878031
2019-03-18T09:30:00-04:00,54.71,54.89,54.64,54.78,8103717,13032911,63.11754301688528,57.41920124327807,NaN,NaN,119.92189511992942,118.33060793496675,0.009335549520435027,0.31097284184755836,0.30163729232712333,829629634,811191282.4,59.89588553005263,52.51636207978403,NaN,NaN,18.992429979934027,16.957988387516554
2019-03-19T09:30:00-04:00,54.9,55.0201,54.535,54.74,13359700,12709311.75,62.17203315937743,57.83893269477829,NaN,NaN,112.57911277518237,124.54305627979663,0.009346046244745665,0.3133198501330554,0.30397380388830975,816269934,815046609.4,61.78721258302833,51.93967612020109,NaN,NaN,19.731598572786865,17.35421841398374
2019-03-20T09:30:00-04:00,54.71,54.82,54.33,54.51,19832747,12977018.4,56.89441305154501,57.66982739979286,NaN,NaN,57.97754971519831,107.10769240572499,-0.008586643624197143,0.2932404993580633,0.30182714298226043,796437187,812708333.2,59.940838109645725,51.577121740310496,NaN,NaN,18.98724569552777,17.58750802563289
2019-03-21T09:30:00-04:00,54.41,55.23,54.41,55.15,12699410,13026379.7,65.6358925835633,58.240852726162885,NaN,NaN,139.0941555696461,108.03287394046033,0.018715224221888316,0.32522117325962085,0.30650594903773254,809136597,814599853.8,60.957231288063525,51.44990268235393,NaN,NaN,20.94943476853547,18.06778327461897
2019-03-22T09:30:00-04:00,55.07,55.44,55,55.08,21007305,12838808,64.10465114851107,58.808797608747135,NaN,NaN,161.35281014995726,118.18510466598268,0.027584830385804726,0.3409869870199884,0.3134021566341837,788129292,807920528.8,55.59324013226089,51.04160249430547,NaN,NaN,22.09071560360554,18.642487893045622
2019-03-25T09:30:00-04:00,54.98,55.33,54.85,55.19,12538026,12707580.1,65.46798895000272,59.52308110051563,NaN,NaN,129.7155307961261,120.14383180122202,0.03586080068704345,0.358228157492988,0.3223673568059445,800667318,802128065.6,51.37141950332965,50.73156272385101,NaN,NaN,23.44286508830853,19.328256063797465
2019-03-26T09:30:00-04:00,55.38,55.855,55.34,55.66,12808701,12592295.45,70.60518243906868,60.70579831963736,NaN,NaN,185.14590029883294,134.65718930595213,0.06622347644730275,0.405146702365073,0.33892322591777024,813476019,801569282.6,50.969303759527364,50.760552159407254,NaN,NaN,26.32873640509702,20.328324683983116
2019-03-27T09:30:00-04:00,55.66,55.82,55.19,55.47,12740361,12688733.45,66.31053970457796,61.997508591821365,NaN,NaN,144.84521487448603,152.03072233780966,0.06656741484527862,0.4221324944743685,0.3555650796290899,800735658,802428976.8,51.597053876539654,51.34627219772756,NaN,NaN,27.396270104915764,21.33803117268778
2019-03-28T09:30:00-04:00,55.6,55.89,55.58,55.74,11920928,12861310.25,69.17950272186995,63.45774394206018,NaN,NaN,157.62018946058865,155.7359291159982,0.07728256515750154,0.4521682860759668,0.3748857209184653,812656586,803132974.6,52.13746764288025,52.2314787961357,NaN,NaN,29.216407765960444,22.463513543155305
2019-03-29T09:30:00-04:00,55.84,56.165,55.69,56.11,13888766,13015137.85,72.62046286002376,64.43766927788577,NaN,NaN,167.23815661977338,156.9129984099614,0.10014210807160423,0.5000633560079706,0.39992124793636635,826545352,810816186.6,57.68957881715584,53.613285617587294,NaN,NaN,31.9319702528093,23.816150215963017
2019-04-01T09:30:00-04:00,56.22,56.23,55.825,55.92,13799445,13199431.75,68.39750433775347,65.09815216817053,NaN,NaN,142.7260260770557,159.51509746614732,0.09344905012057664,0.5167325605870872,0.4232835104665105,812745907,813231904.4,59.28864381408905,55.02628373225765,NaN,NaN,32.81258557904852,25.101355267832375
2019-04-02T09:30:00-04:00,55.75,55.75,55.46,55.46,13964969,13391058.75,59.39260087598262,64.84721478585014,NaN,NaN,79.40717194779901,138.36735179594055,0.05114009711505285,0.4872086318603266,0.43606853474527374,798780938,810292888.2,56.49133097115032,55.893921832742954,NaN,NaN,30.540465771604165,25.878371054085488
2019-04-03T09:30:00-04:00,55.36,55.48,55.05,55.19,18616465,13721828.4,54.829658711549385,64.34096831828023,NaN,NaN,35.44101611611451,116.48651204426623,0.0007344938121610634,0.43698665201047504,0.436252158198314,780164473,806178651.2,52.740030040533945,56.12265261866471,NaN,NaN,27.12055553643103,26.055825980134852
2019-04-04T09:30:00-04:00,55.23,55.485,55.18,55.4,10671335,13538592.35,57.56065734324663,64.02061649313978,NaN,NaN,43.146523003095574,93.59177875276762,-0.02147278344999065,0.4094111788858257,0.43088396233581633,790835808,801814495.6,49.021412425159994,55.677189178101194,NaN,NaN,25.204397076618502,25.934193279632517
2019-04-05T09:30:00-04:00,55.48,55.6099,55.33,55.59,9045198,13389494.6,59.92166179523822,63.792339263022136,NaN,NaN,58.08933933935055,71.76201529668306,-0.026069166531667298,0.3982975041712322,0.4243666707028995,799881006,796481626.4,44.85907878675371,54.60313155357984,NaN,NaN,24.379219704305523,25.712054197442946
2019-04-08T09:30:00-04:00,55.56,55.83,55.49,55.82,6136908,13170377.65,62.63178729362421,63.82517884403977,NaN,NaN,81.52058178411923,59.520926438095785,-0.016774308867949395,0.40339878461796275,0.42017309348591214,806017914,795136027.8,43.84741924118187,53.32171774344795,NaN,NaN,24.54377342781612,25.545156944639114
2019-04-09T09:30:00-04:00,55.69,55.78,55.51,55.75,12062346,13231404.65,61.27375811375065,64.13798920562589,NaN,NaN,69.27889931708438,57.495271911952855,-0.0183670095231247,0.39721433158200625,0.41558134110513095,793955568,794170953.8,43.09673351258366,52.118567415086375,NaN,NaN,24.26615697274754,25.362442662940317
2019-04-10T09:30:00-04:00,55.8,55.98,55.7475,55.91,7060932,13027687.8,63.23596198877602,63.9665655917125,NaN,NaN,93.41124252280572,69.0893171932911,-0.01198040399734146,0.4006058361084541,0.4125862401057956,801016500,798341359.2,47.29588005211643,51.14275661251873,NaN,NaN,24.61461939418281,25.25561076740353
2019-04-11T09:30:00-04:00,56,56.13,55.82,56.02,6444919,12927455.05,64.5652690176262,63.999466868077896,NaN,NaN,103.05960196051525,81.07193298477503,-0.004090897783993186,0.40747261787580413,0.4115635156597973,807461419,801666481.4,50.43639415101913,50.77441047100145,NaN,NaN,25.29004346051379,25.26052972356214
2019-04-12T09:30:00-04:00,56.06,56.24,55.885,56.2,7635666,12216892.2,66.68787293950844,64.08660143875687,NaN,NaN,115.15777405467814,92.48561992784055,0.008803576962591375,0.42256798686303654,0.41376440990044516,815097085,804709697.2,53.18582845374065,50.904011110316524,NaN,NaN,26.484116144491253,25.43532778369487
2019-04-15T09:30:00-04:00,56.18,56.575,56.17,56.53,6504984,12136955.55,70.21095327345128,64.05844221264134,NaN,NaN,157.87847311420725,107.75719819385816,0.033711703790094916,0.4559040396380638,0.4221923358479689,821602069,807826528.2,55.88500841389361,51.255132871342695,NaN,NaN,28.61661224697352,25.889796992734677
2019-04-16T09:30:00-04:00,56.63,56.73,56.32,56.54,9345071,11936224.1,70.31341253059179,64.34436170021375,NaN,NaN,160.26811942531984,125.95504221550524,0.04434554161801857,0.4776242628704921,0.4332787212524735,830947140,815224842.6,61.55177137288159,51.966184121081405,NaN,NaN,30.369568962858505,26.52976441703808
2019-04-17T09:30:00-04:00,56.84,56.91,56.56,56.82,12720197,11580596.6,73.10300681633048,64.62461199267523,NaN,NaN,181.70413378638293,143.6136204682207,0.0626047850606517,0.5115347025782881,0.44892991751763645,843667337,823755010,66.84065743679787,53.0164119635041,NaN,NaN,32.75159314756271,27.418597092827312
2019-04-18T09:30:00-04:00,57.05,57.15,56.62,56.87,10622183,11476735.25,73.5804296371442,64.69318104818383,NaN,NaN,173.02154779920738,157.6060096359591,0.06986555365383129,0.5362618595849256,0.46639630593109427,854289520,833120630.2,71.47949125738687,54.00140570923488,NaN,NaN,34.85014804928394,28.480247229463973
2019-04-22T09:30:00-04:00,56.86,57.2,56.75,56.89,12432495,11047994.75,73.7809053688539,65.07770969326243,NaN,NaN,158.71751530648936,166.31795788632138,0.06777830215607777,0.5511191836261915,0.4833408814701137,866722015,843445616.2,75.54173647619879,55.162340899385576,NaN,NaN,36.641215342381045,29.646099817023554
2019-04-23T09:30:00-04:00,56.86,56.93,56.6,56.71,20408437,11441515.3,68.72631129134467,65.74440329435973,NaN,NaN,113.35098682942636,157.41246062936517,0.04702329671482003,0.5421200023636388,0.49509670564881875,846313578,848387918,77.21470581715856,56.642581959814734,NaN,NaN,36.83155072588252,30.672592804003408
2019-04-24T09:30:00-04:00,56.74,57.035,56.7,56.83,8221930,11212176.75,70.1924080083709,66.84174252984698,NaN,NaN,111.44007724952324,147.64685219420588,0.03469383997776909,0.5384640056210301,0.503770165643261,854535508,853105591.6,78.7115922551362,58.497693546572044,NaN,NaN,37.39370075058557,31.632751082086575
2019-04-25T09:30:00-04:00,56.52,56.565,56.27,56.47,9992063,11074761.85,60.95964146286096,67.08452710981943,NaN,NaN,45.66376351087299,120.43877813910387,-0.002419868477500753,0.5007453300463851,0.5031651985238859,844543445,853280813.2,78.7673855644392,60.62240591366341,NaN,NaN,35.18469274218446,32.140171319243414
2019-04-26T09:30:00-04:00,56.53,56.99,56.5,56.98,8405955,10899013.2,67.48466777551172,67.62474182269611,NaN,NaN,89.3693901004278,103.70834659934795,0.0024045790568283376,0.5061709223449213,0.503766343288093,852949400,853012789.2,78.42878695839357,63.02024221163769,NaN,NaN,35.204318011728404,32.577906561026985
2019-04-29T09:30:00-04:00,56.95,57.08,56.87,57.05,7211008,10565125.3,68.26858543894355,68.02737026164748,NaN,NaN,99.9972171024159,91.96428695853324,0.00517689217473305,0.5102374585065093,0.5050605663317762,860160408,851700467.8,76.6904606946473,65.36617374402807,NaN,NaN,35.461763521135644,32.989886126756794
2019-04-30T09:30:00-04:00,57.08,57.77,57.02,57.71,15965938,10673449.95,74.50884145280688,68.97273335729436,NaN,NaN,142.22885282775587,97.73986015819915,0.04415826043018156,0.5602583918695032,0.5161001314393217,876126346,857663021.4,78.97106453212024,67.92862595970927,NaN,NaN,37.87927752781285,33.688370612621945
2019-05-01T09:30:00-04:00,57.78,57.82,57,57,11992679,10574835.45,60.6833230153041,68.79040200204636,NaN,NaN,106.29550682399238,96.71094607309297,0.01626045018425215,0.5364256941696368,0.5201652439853847,864133667,859582653.2,79.66101169046473,70.24042107673414,NaN,NaN,34.78593804214994,33.845165959697376
2019-05-02T09:30:00-04:00,56.95,57.205,56.69,56.98,13925855,10340304.95,60.343649630786615,68.48885776012925,NaN,NaN,63.74178919823082,100.32655121056453,-0.008096356990247466,0.5100447977475753,0.5181411547378227,850207812,860715526.6,80.0764564196858,72.3575683816389,NaN,NaN,32.367647231645876,33.634091855690016
2019-05-03T09:30:00-04:00,57.25,57.54,57.16,57.41,13801294,10496802.9,64.89355311331889,68.36069205825858,NaN,NaN,109.97105446541556,104.4468840835621,-0.00022050600714762503,0.5178655222288882,0.5180860282360358,864009106,862927467.8,80.89692883053212,74.33693269426688,NaN,NaN,31.927408120641047,33.39027989354016
2019-05-06T09:30:00-04:00,56.99,57.415,56.92,57.32,10100265,10549556.25,63.257636585344606,67.86402658053666,NaN,NaN,83.9071902723597,101.22887871755086,-0.005739397071364616,0.5109117818968301,0.5166511789681947,853908841,861677154.4,78.9185631985159,75.98218660745418,NaN,NaN,31.040333245459372,33.05457322952862
2019-05-07T09:30:00-04:00,57.06,57.17,56.45,56.75,20115511,11248486.4,53.97686155553096,66.69713008231803,NaN,NaN,13.864485832042725,75.55600531840822,-0.04998394094804315,0.45417125278314074,0.5041551937311839,833793330,853210551.2,66.97433858080615,76.36951283659164,NaN,NaN,26.97857034743742,32.186572817801306
2019-05-08T09:30:00-04:00,56.71,57.06,56.46,56.74,11940177,11242377.95,53.8276554568293,65.32031927092508,NaN,NaN,-1.8485082967736826,53.927202294255004,-0.08032978641631772,0.40374296071078675,0.48407274712710446,821853153,844754448.4,57.59802515486556,75.70932481645363,NaN,NaN,23.826515307515127,30.992278887760424
2019-05-09T09:30:00-04:00,56.5,56.78,56.19,56.62,23531637,12065913.2,51.97110471460944,63.77679606217261,NaN,NaN,-61.37504828116893,28.903834798375055,-0.10721027280881401,0.35005990611608695,0.45727017892490096,798321516,834377189.2,48.605071362304436,74.07543768109058,NaN,NaN,20.700069138792156,29.521963209336384
2019-05-10T09:30:00-04:00,56.48,57.385,56.24,57.31,14029635,12445149,60.42368399471291,62.82270882116255,NaN,NaN,35.227148330619904,13.955053571415926,-0.0785729581627379,0.3590539812214786,0.4376269393842165,812351151,824045598.2,41.63520157611434,71.65354233108455,NaN,NaN,20.683333897844904,28.259301879123317
2019-05-13T09:30:00-04:00,56.72,56.91,56.56,56.77,13081752,12717453.3,52.6189487542204,61.672182925653665,NaN,NaN,-38.55027163798865,-10.536438810653742,-0.09495601956928679,0.318931914922608,0.41388793449189476,799269399,813117709.8,35.78931719773597,68.6945860011258,NaN,NaN,17.898176993387143,26.779141181161005
2019-05-14T09:30:00-04:00,56.93,57.4266,56.84,57.04,16497829,13217095.55,55.700069427714475,60.637015884178204,NaN,NaN,59.39635206754851,-1.4300655635525843,-0.08678942167680814,0.3054011573958846,0.3921905790726927,815767228,809512489.4,34.088798184136294,65.50724356748294,NaN,NaN,16.728548321054408,25.343342201145777
2019-05-15T09:30:00-04:00,56.96,57.61,56.85,57.49,9681802,13233932.1,60.33024029952145,60.59205865822538,NaN,NaN,112.69011445731847,21.47765898726584,-0.051978689362945474,0.3272172173690109,0.37919590673195636,825449030,810231664.8,34.754783180267054,62.3634862543278,NaN,NaN,17.365690088998974,24.203677613696232
2019-05-16T09:30:00-04:00,57.79,58.265,57.6301,57.94,12859911,13240917.8,64.34366698108792,60.36770145862368,NaN,NaN,234.16596296414033,80.5858612363277,-0.0021742959390550487,0.3764780368081375,0.37865233274719257,838308941,818229149.8,41.79764353081204,59.74697600950055,NaN,NaN,19.311491158129908,23.504793834329615
2019-05-17T09:30:00-04:00,57.62,58.075,57.61,57.75,15458746,13482745.95,61.5138743235093,59.88522209323552,NaN,NaN,162.87519203132965,106.11546997646965,0.013578656008935486,0.3956256527583619,0.38204699674942644,822850195,820328958.6,43.521474770617864,57.37776272921273,NaN,NaN,19.90551750782976,22.99061150197249
2019-05-20T09:30:00-04:00,57.62,57.94,57.57,57.61,9496806,13335961.5,59.43951871546946,58.80884189771142,NaN,NaN,120.08654327712307,137.842832959492,0.010322963041400957,0.39495070055117765,0.3846277375097767,813353389,823145756.6,45.83888239422895,55.011178290791925,NaN,NaN,19.71790140350137,22.523081487905188
2019-05-21T09:30:00-04:00,57.82,57.84,57.4,57.49,8124122,12721745.75,57.645153576821336,58.59182979496264,NaN,NaN,84.03407129988122,142.7703768059585,-0.003423486339939663,0.3803483795848521,0.3837718659247918,805229267,821038164.4,44.37184189685522,52.49052330553411,NaN,NaN,19.017771181405436,22.02232287269094
2019-05-22T09:30:00-04:00,57.51,57.88,57.39,57.75,11102018,12865750.15,60.4322601031546,58.598159114417506,NaN,NaN,91.25728381486255,138.48381067746735,0.001233788058352281,0.3853141009977321,0.38408031293937983,816331285,819214615.4,43.08694200478746,49.84841513304137,NaN,NaN,19.27429657591386,21.62974768743707
2019-05-23T09:30:00-04:00,57.53,57.75,57.41,57.73,17398019,13236047.95,60.10461805684606,58.256092324669446,NaN,NaN,76.25950696575336,106.90251947778992,-0.0006897399588962072,0.38321813799075954,0.38390787794965575,798933266,811339480.4,37.97293566090239,46.78241562092495,NaN,NaN,19.386827433967188,21.309330508369946
2019-05-24T09:30:00-04:00,57.83,57.88,57.3542,57.52,9530839,13292292.15,56.63268059403138,57.78288118243278,NaN,NaN,61.39390824440439,86.60626272040489,-0.018760936990209753,0.36045670671189356,0.3792176437021033,789402427,804649926.8,34.25375255686238,43.592072003663986,NaN,NaN,18.489747267598187,20.906532902545408
2019-05-28T09:30:00-04:00,57.53,57.67,56.535,56.58,14043124,13633897.95,44.29769996557128,57.09151249743566,NaN,NaN,-66.50848863339196,49.28725633830191,-0.09254999273413028,0.2635301527844405,0.35608014551857076,775359303,797051109.6,30.58879237167089,40.99310441729718,NaN,NaN,13.465591560293616,19.843541282223722
2019-05-29T09:30:00-04:00,56.36,56.37,55.88,56.17,11455050,13408353.55,40.18629713302299,56.11712976002093,NaN,NaN,-182.04722501217225,-3.9290029241087723,-0.1633594766743406,0.15188079967564505,0.31524027634998564,763904253,788786106.8,27.182149602379468,38.82054187783388,NaN,NaN,7.8529460063444505,18.130599099955255
2019-05-30T09:30:00-04:00,56.28,56.53,56.15,56.41,9770151,13297227.15,43.49248214509071,55.511513862198164,NaN,NaN,-123.74865217452057,-46.930190121985405,-0.1867356618035642,0.08182069909553036,0.26855636089909457,773674404,780254730.6,24.187684050576905,37.076442784139054,NaN,NaN,4.374599102047402,16.165456243111276
2019-05-31T09:30:00-04:00,55.97,56.05,55.52,55.61,13450786,13273473.7,36.29145742507758,53.78778339293849,NaN,NaN,-186.31397811675845,-99.44488713848776,-0.24510091794636302,-0.0378197865338592,0.20728113141250382,760223618,772512801,21.836760326875165,35.6622684091934,NaN,NaN,-1.3239592477371402,13.666968315847217
2019-06-03T09:30:00-04:00,55.69,56.42,55.68,56.31,17060649,13436441.45,44.88963023106232,53.23568921271293,NaN,NaN,-114.11610044594244,-134.54688887655715,-0.22605191248118484,-0.07528375918897723,0.1507681532922076,777284267,770089169,21.14392194001458,34.616168747927595,NaN,NaN,-3.049557456076766,11.278893205572363
2019-06-04T09:30:00-04:00,56.66,56.83,56.4801,56.82,16547017,13758779.05,50.16661353028632,52.84044236289663,NaN,NaN,-37.56588868297369,-128.75836888647348,-0.17108986603828596,-0.06309417925564986,0.1079956867826361,793831284,773783565.2,25.047743180186643,33.970379104788336,NaN,NaN,-2.529977454928877,9.306197396929328
2019-06-05T09:30:00-04:00,57.08,57.58,56.86,57.47,15069734,13506490.2,55.955227987637215,52.52794148347633,NaN,NaN,33.86314351255201,-85.57629518152862,-0.08717500120968621,-0.0009730647294716732,0.08620193648021454,808901018,782782918.2,33.662909582725206,33.89238813353534,NaN,NaN,0.04248152201938559,7.982809414799336
2019-06-06T09:30:00-04:00,57.59,58.19,57.49,58.07,20769577,13947960.2,60.514678248189135,52.254442288269274,NaN,NaN,98.92117409340493,-41.04232992794353,0.007495779667272481,0.09557166106430515,0.08807588139703267,829670595,793982156.4,42.51764142742847,33.94381655472223,NaN,NaN,3.8316205292356567,7.389782431147382
2019-06-07T09:30:00-04:00,58.27,58.86,58.27,58.63,18860802,13714418.45,64.23591028829657,52.448873428611215,NaN,NaN,156.93268530910998,27.607002757230163,0.1013755706262024,0.21479534467978567,0.11341977405358328,848531397,811643712.2,53.14050806404875,34.63089036139586,NaN,NaN,8.269137646775976,7.51540460480861
2019-06-10T09:30:00-04:00,58.71,58.78,58.47,58.65,15341778,13780025.6,64.36507787229712,52.800699082670334,NaN,NaN,142.14527867873736,78.85927858216613,0.1551456567642952,0.3073518450089523,0.1522061882446571,863873175,828961493.8,60.79175969301199,35.698953025594655,NaN,NaN,11.659556000627411,8.107426232782725
2019-06-11T09:30:00-04:00,58.82,58.985,58.69,58.84,18109721,14031424.05,65.63487002926396,53.37139311498767,NaN,NaN,144.81818821941474,115.3360939626438,0.19145243472308215,0.3915217316485098,0.20006929692542763,881982896,846591816.2,66.7448968423613,37.29702837884509,NaN,NaN,14.778884635256128,9.060491718850354
2019-06-12T09:30:00-04:00,58.95,59.27,58.84,58.93,10921154,13752590.3,66.24838473895218,53.78683058897321,NaN,NaN,142.4133682755655,137.0461389152465,0.2080921629335249,0.46018450059233373,0.25209233765880884,892904050,863392422.6,71.22808254843915,39.307109846248785,NaN,NaN,17.46300987731179,10.260851455773416
2019-06-13T09:30:00-04:00,59.07,59.24,58.72,59.06,11564631,13846731.75,67.16037602964084,54.2908133013157,NaN,NaN,126.38596509640743,142.539097115847,0.21361110574781023,0.5191062198435716,0.3054951140957614,904468681,878352039.8,74.52173981047666,41.91773871407552,NaN,NaN,19.93445238381443,11.64279444549356
2019-06-14T09:30:00-04:00,59.03,59.245,58.97,59.09,9726115,13690041.95,67.37942956470103,55.0584382277921,NaN,NaN,121.92341498580889,135.53724305118678,0.20500181431839437,0.5617473819937544,0.35674556767536003,914194796,891484719.6,77.00984665119385,44.97174543509919,NaN,NaN,22.0156449850038,13.124630236852166
2019-06-17T09:30:00-04:00,59.11,59.17,58.645,58.92,8796634,13356936.35,64.7439267951425,56.518883001332895,NaN,NaN,95.40858774581072,126.18990486460146,0.17475775929135662,0.5751927667895558,0.40043500749819916,905398162,899789717,78.4435129399096,48.389939761401955,NaN,NaN,23.074750168198154,14.546075941330164
2019-06-18T09:30:00-04:00,59.25,59.29,58.52,58.6,18120638,13788127.95,59.98748139714105,57.933253305912764,NaN,NaN,77.42462624207533,112.71119246913356,0.12256793906086338,0.5536449313242784,0.431076992263415,887277524,900848642.6,78.62653012396196,52.06453837008642,NaN,NaN,22.68922084917379,15.709382356736397
2019-06-19T09:30:00-04:00,58.56,58.96,58.27,58.84,13457174,14054780.55,62.228734782580034,59.271557065733425,NaN,NaN,62.51120162581791,96.73075913918404,0.09481734958886712,0.5495986792494989,0.4547813296606318,900734698,902414772.2,78.91169918306034,55.97339659383523,NaN,NaN,22.97497220922513,16.747323764234785
2019-06-20T09:30:00-04:00,59.09,59.43,58.96,59.36,13566320,14177995.65,66.59476187872245,61.43607881242235,NaN,NaN,90.15856663665154,89.48527944723287,0.10149236619516416,0.581646787404587,0.4801544212094228,914301018,904381239.6,79.28541995647782,60.076872281663995,NaN,NaN,24.514787783405446,17.856961481259166
2019-06-21T09:30:00-04:00,58.84,59.01,58.625,58.72,15416200,14078904.7,57.747314288055506,62.3544848164933,NaN,NaN,54.911756325250984,76.08294771512128,0.05513495869523466,0.5490731195784662,0.4939381608832315,898884818,901319244,76.99727516946245,64.06639751233884,NaN,NaN,23.145185087813164,18.612421996481167
2019-06-24T09:30:00-04:00,58.81,59.1,58.765,58.87,17796466,14492186.05,59.118208111963945,62.99388442947026,NaN,NaN,57.68010470888704,68.53725110773657,0.028258277769873996,0.529261008095574,0.5010027303257,916681284,903575868.4,77.5123538455064,67.81386970271883,NaN,NaN,22.438489604254677,19.159003083305954
2019-06-25T09:30:00-04:00,58.88,58.96,58.67,58.84,11861741,14383116.9,58.70794632425358,63.190507167800014,NaN,NaN,48.031636000977656,62.65865305951702,0.0034490730644919365,0.5053140716563149,0.501864998591823,904819543,907084272.2,78.32497634558655,71.00401732863749,NaN,NaN,21.749094904479144,19.52901620061641
2019-06-26T09:30:00-04:00,58.57,58.57,57.975,58,11672553,14393992.05,48.5487263949252,62.3357963211383,NaN,NaN,-0.22348017195856562,50.11171669996172,-0.07046390692144877,0.413785114940012,0.4842490218614608,893146990,905566730.6,77.02836082483427,73.46906871416648,NaN,NaN,17.84310302958299,19.288171461897353
2019-06-27T09:30:00-04:00,58.08,58.16,57.775,58.11,11524922,14481730.6,49.77443266366649,61.30283363366472,NaN,NaN,-21.33911621675897,27.812180129279632,-0.11049215928471945,0.3461338227555615,0.45662598204028093,904671912,903640909.4,75.32421943406959,75.05361952631083,NaN,NaN,15.064358492938565,18.684769609188955
2019-06-28T09:30:00-04:00,58.39,58.46,57.95,58.07,12409320,14429657.3,49.314371294151556,60.22778316379718,NaN,NaN,-24.22777078524891,11.984274707179651,-0.13650458928930365,0.2859952454286514,0.42249983471795505,892262592,902316464.2,74.10989734718724,76.00491507303762,NaN,NaN,12.682909283188906,17.827360991188947
2019-07-01T09:30:00-04:00,58.37,58.555,58.08,58.42,12665179,14209883.8,53.37523868159075,59.35209521039195,NaN,NaN,-20.30488771785097,-3.6127237781679575,-0.1271685483468059,0.26353914928444766,0.39070769763125357,904927771,899965761.6,71.89454123113651,76.372746815093,NaN,NaN,11.78645420057198,16.964374306815095
2019-07-02T09:30:00-04:00,58.44,58.93,58.4,58.93,11913548,13978210.35,58.58244986419568,58.804528433623624,NaN,NaN,27.313291567149378,-7.756392664933617,-0.08566551226558411,0.28362580729927345,0.36929131956485756,916841319,902370116.8,72.79047103368208,76.48434599261034,NaN,NaN,12.581191992866156,16.33820540482239
2019-07-03T09:30:00-04:00,59.01,59.715,58.96,59.66,11995833,13824515.3,64.66554172009548,58.62632598294181,NaN,NaN,156.4636695362716,23.581037276712415,-0.0119413494708559,0.3543646327262877,0.3663059821971436,928837152,909508149.2,75.3071041140324,76.54044344286433,NaN,NaN,15.317126231807837,16.192336951534596
2019-07-05T09:30:00-04:00,59.31,59.44,58.87,59.4,11008217,13336447.3,61.2169120685615,58.18614616178899,NaN,NaN,108.8647884003464,49.62181820013349,0.014961378455277063,0.38500770526623995,0.3700463268109629,917828935,912139553.8,76.18169224222382,76.48128955650932,NaN,NaN,16.45138630670434,16.22934400227313
2019-07-08T09:30:00-04:00,59.4,59.585,59.305,59.48,9257128,12856263.6,61.89036881221273,57.982320591579715,NaN,NaN,142.19276504499314,82.90592536618189,0.032770958325296584,0.41101002471758363,0.37823906639228705,927086063,919104248,78.36578829601211,76.47573779623094,NaN,NaN,17.564093732784073,16.420022535203266
2019-07-09T09:30:00-04:00,59.36,59.46,58.91,59.13,12499546,12714152,57.20978150040773,57.783913456098766,NaN,NaN,70.31064953996932,101.02903281774596,0.01643123446707684,0.3987781094761331,0.3823468750090563,914586517,921035997.2,78.94255460888655,76.49831097372555,NaN,NaN,17.089809376987645,16.515706369743892
2019-07-10T09:30:00-04:00,59.34,59.66,59.29,59.51,16804866,12648909.25,60.68613004207413,57.67372740320549,NaN,NaN,121.80288261269473,119.92695102685502,0.026093388418547026,0.41496361053224007,0.38887022211369304,931391383,923946010,79.81553578424503,76.56287073095302,NaN,NaN,17.753259487650475,16.692499672301974
2019-07-11T09:30:00-04:00,59.63,59.705,59.3435,59.66,12575287,12731615.9,61.99854560780735,57.34542624099726,NaN,NaN,123.53233379754703,113.34068387911012,0.036808974776552705,0.43488144058438394,0.39807246580783123,943966670,926971913.6,80.71101092710863,76.66469865742665,NaN,NaN,18.68992189696955,16.977845704397343
2019-07-12T09:30:00-04:00,59.64,59.9676,59.64,59.83,8731980,12589983.35,63.486275390851,57.75535203405408,NaN,NaN,143.9505360034288,120.35783339972662,0.04881556159218492,0.45909191779806235,0.41027635620587743,952698650,933945856.6,82.62432387627585,77.06663070791332,NaN,NaN,19.905439214020518,17.396073348629226
2019-07-15T09:30:00-04:00,59.93,60.07,59.77,59.97,7212607,12464307.95,64.71151397019618,58.15487388107067,NaN,NaN,141.45018794788774,120.20931798030554,0.05897612690923737,0.4839965148424241,0.42502038793318675,959911257,940510895.4,84.21195128711729,77.5451733823141,NaN,NaN,21.27147566311843,17.94970225069911
2019-07-16T09:30:00-04:00,59.98,60.23,59.775,59.99,13578987,12703425.6,64.89275142931982,58.59664567428969,NaN,NaN,129.05400923857007,131.95798992002568,0.059654469909907804,0.4995884753205715,0.4399340054106637,973490244,952291640.8,86.58133937790858,78.13491359890853,NaN,NaN,22.446694341374275,18.592129692224134
2019-07-17T09:30:00-04:00,59.99,60.08,59.775,59.92,9050086,12249898,63.6603931624904,59.67605044340149,NaN,NaN,105.88738141540829,128.7748896805684,0.048474425455463654,0.5005270372299933,0.4520526117745296,964440158,958901395.8,87.69696216936616,78.89695655208938,NaN,NaN,23.11698306653088,19.238537317125097
2019-07-18T09:30:00-04:00,59.99,60.5,59.775,60.32,9445260,12049302.3,67.46287073841755,60.93951030588371,NaN,NaN,126.319838473663,129.3323906157916,0.06033166885706881,0.5274671978458656,0.4671355289887968,973885418,964885145.4,88.61941767346762,79.84661356918923,NaN,NaN,24.787728226478922,20.031278875604215
2019-07-19T09:30:00-04:00,60.47,60.56,59.9,59.94,7460398,11744006.2,60.93920758171784,61.76985575499559,NaN,NaN,105.14327540677073,121.57093849645999,0.036091375833190276,0.5122497487802846,0.47615837294709434,966425020,967630419.4,89.02595170164089,80.91204602307879,NaN,NaN,24.40807571274717,20.656535566624637
2019-07-22T09:30:00-04:00,60.05,60.05,59.53,59.59,7135087,11329950.55,55.605674927101276,61.92917262967491,NaN,NaN,52.96319723200858,103.87354035328414,-0.007671167112719202,0.46656941405619534,0.47424058116891454,959289933,967506154.6,88.87119817121336,82.12466437594142,NaN,NaN,22.490796512703344,20.918572844635882
2019-07-23T09:30:00-04:00,60.13,60.235,59.83,60.02,10058256,10943040.05,60.21295806189782,62.04563750093935,NaN,NaN,80.40120093120818,94.14297869181178,-0.011580511366179824,0.4597649419611898,0.4713454533273696,969348189,966677743.6,87.77577722942358,83.19504338992294,NaN,NaN,22.195342723775877,21.10096854165588
2019-07-24T09:30:00-04:00,59.93,59.98,59.545,59.62,7975850,10748745.5,54.542375093404765,61.32255417046144,NaN,NaN,41.06043437454858,81.17758928363983,-0.0432479751190924,0.4172854844285041,0.4605334595475965,961372339,966064179.8,86.92121372665147,84.02462264796716,NaN,NaN,20.15720192725968,20.96614473959928
2019-07-25T09:30:00-04:00,59.5,59.8,59.36,59.7,9469200,10638577.85,55.44610387349527,60.910353585099564,NaN,NaN,24.76878096830359,60.867377782567964,-0.05992258011625484,0.38563023440227795,0.4455528145185328,970841539,965455404,86.0262957852256,84.72780861532443,NaN,NaN,18.77754799053693,20.653488061161802
2019-07-26T09:30:00-04:00,59.8,60.39,59.63,60.37,14727927,10798728.1,62.22032129659741,60.93392161969847,NaN,NaN,91.4881217416508,58.13634704954397,-0.028536844024214525,0.40988175948826466,0.4384186035124792,985569466,969284293.2,86.93724137427256,85.34005526377162,NaN,NaN,19.692015875185927,20.516134891736677
2019-07-29T09:30:00-04:00,60.37,60.61,60.33,60.48,6121309,10484327.55,63.209360144629485,61.3624629514286,NaN,NaN,141.69540393440852,75.88278839002396,-0.004345959867366134,0.43298615367827153,0.43733211354563767,991690775,975764461.6,88.3244917826591,86.0101936333268,NaN,NaN,20.73336189704696,20.547167321066716
2019-07-30T09:30:00-04:00,60.72,61.02,60.52,60.66,14124035,10557270.35,64.83180402766945,61.65858252182826,NaN,NaN,177.16934317164663,95.23641683811164,0.018544346151781133,0.4605125462353641,0.44196820008358295,1005814810,983057785.8,89.65596884643698,86.71308170919765,NaN,NaN,22.087078903951436,20.767154690050248
2019-07-31T09:30:00-04:00,60.47,60.56,58.85,59.43,16826760,10802930.95,48.94716981466991,60.72634139374702,NaN,NaN,-43.40564692206591,78.34320057878874,-0.050605644974277386,0.37871114386573623,0.4293167888400136,988988050,988580928,90.53614827159879,87.41487723380409,NaN,NaN,17.75324970018233,20.336596834354832
2019-08-01T09:30:00-04:00,59.6,60.3,59.18,59.22,30148243,11710551.45,46.83718763077431,59.537120839455824,NaN,NaN,-55.43483813866495,62.30247675739504,-0.10861039683894219,0.29355379279133587,0.40216418963027806,958839807,986180581.6,87.06865515248096,87.73232946781874,NaN,NaN,13.627240129800484,19.378117305132783
2019-08-02T09:30:00-04:00,59.13,59.59,59,59.23,24368724,12378576.8,46.95445185452108,58.26875925976474,NaN,NaN,-119.11412513332509,20.18202738239986,-0.14230139260876162,0.22428744886932606,0.3665888414780877,983208531,985708394.6,86.36789288819867,87.8863252964674,NaN,NaN,10.475072327077822,18.106253736839218
2019-08-05T09:30:00-04:00,58.85,59.1,57.37,57.69,26364783,13233959.55,34.378308182591454,56.08915617071271,NaN,NaN,-299.77327453418474,-68.1117083113188,-0.25757990468308406,0.04461396062423262,0.3021938653073167,956843748,978738989.2,76.57197563421173,87.1713707433462,NaN,NaN,2.433062868907672,15.867226469991854
2019-08-06T09:30:00-04:00,57.89,58.48,57.67,58.21,20126351,13615299.8,40.20232132748804,54.413579611069686,NaN,NaN,-243.47752421051985,-152.24108178775208,-0.28590133710235954,-0.05518280607063275,0.2307185310317268,976970099,972970047,69.54095198129008,85.87451287276936,NaN,NaN,-1.7774427873291938,13.346559433231704
2019-08-07T09:30:00-04:00,57.96,59.11,57.35,58.89,17550845,13652598.75,46.84589813622037,52.94093871091275,NaN,NaN,-161.6776158936639,-175.8954755820717,-0.24737264715608961,-0.07849727791338523,0.16887536924270438,994520944,974076625.8,70.10794193647172,84.55226460584107,NaN,NaN,-2.7202930353005765,11.05129479486995
2019-08-08T09:30:00-04:00,58.85,59.71,58.57,59.65,24011277,14224398.25,53.1154531940423,52.38209911179307,NaN,NaN,-43.06949776778717,-173.42240750789614,-0.16329410779917922,-0.03524226550626963,0.12805184229290958,1018532221,986015108.6,75.42331567517758,83.58064774680797,NaN,NaN,-1.1111619884185826,9.313800968685873
2019-08-09T09:30:00-04:00,59.62,59.77,58.9,59.32,10590199,14317309.2,50.339004879300774,52.00590839409303,NaN,NaN,-36.62874914790792,-156.9253323108127,-0.1242624145037704,-0.027276175836803418,0.09698623866696698,1007942022,990961806.8,77.2300373990614,82.74913626308283,NaN,NaN,-0.8595288504996061,7.860468137373662
2019-08-12T09:30:00-04:00,59.16,59.35,58.72,58.92,11773974,14545377.55,47.12358453616937,51.07095314225528,NaN,NaN,-69.9959275096584,-110.96986290590743,-0.11969533476552856,-0.052632929789943717,0.06706240497558484,996168048,998826666.8,79.7757046690319,82.17770250876913,NaN,NaN,-1.772307622551173,6.484357314527257
2019-08-13T09:30:00-04:00,58.88,59.855,58.78,59.59,13201453,14526500.85,52.58661459063543,50.93125596348604,NaN,NaN,-16.32893350683614,-65.54014476517071,-0.06841171081630172,-0.018452233544792307,0.049959477271509414,1009369501,1005306547.2,81.60085117366017,81.7976766121269,NaN,NaN,-0.6152060845871908,5.4701339717966215
2019-08-14T09:30:00-04:00,59.06,59.54,58.61,58.65,17281352,14938064.15,45.486125520948676,50.21982893830414,NaN,NaN,-67.05378543991037,-46.61537867441999,-0.09312594893430816,-0.06644795889637578,0.026677990037932375,992088149,1004819988.2,81.00967837361735,81.43934679701204,NaN,NaN,-2.193035034606132,4.375395542310514
2019-08-15T09:30:00-04:00,59.29,59.74,59,59.53,14441875,15187894.9,52.017908238141494,49.491085148414435,NaN,NaN,-3.629783383884643,-38.727435797639494,-0.047818212449096016,-0.03309477552343765,0.014723436925658369,1006530024,1002419548.8,78.00710362644178,80.80147981502411,NaN,NaN,-1.094072451938521,3.594042971703509
2019-08-16T09:30:00-04:00,59.79,60.45,59.79,60.21,18294626,15729606.3,56.368385351775274,49.00244409178199,NaN,NaN,88.94202667517918,-13.613280633022072,0.02634828936756292,0.04765879863511202,0.0213105092675491,1024824650,1005796074.4,79.1762779309137,80.14803596847086,NaN,NaN,1.3814955377009237,3.277964766845997
2019-08-19T09:30:00-04:00,60.69,60.93,60.555,60.81,13180762,16031890.05,59.82932379415307,48.64512407510225,NaN,NaN,146.1679713926854,29.619499147446685,0.10954950944062716,0.15824739606833305,0.04869788662770589,1038005412,1014163547.2,81.76357076554801,79.58429324840738,NaN,NaN,4.60821599214203,3.4680006561740018
2019-08-20T09:30:00-04:00,60.78,60.8499,60.1,60.15,8959335,15976944,54.69030394192776,49.05534794133496,NaN,NaN,95.20394837520938,51.926075523855786,0.11339202854364407,0.19043792230726098,0.07704589376361691,1029046077,1018098862.4,82.84324391550435,79.03480008011492,NaN,NaN,5.436707577268537,3.7492445020446494
2019-08-21T09:30:00-04:00,60.55,60.6,60.155,60.31,8735923,16014947.65,55.684075908014556,49.6872685325664,NaN,NaN,85.656162964595,82.46806520475687,0.1193646610718993,0.22625172010349104,0.10688705903159174,1037782000,1027237632.6,85.05590559773009,78.89103225477558,NaN,NaN,6.406474870188315,4.128848840350887
2019-08-22T09:30:00-04:00,60.36,60.755,60.195,60.63,7127628,15897869.05,57.68312676050075,50.45360245442209,NaN,NaN,91.9968959263633,101.59340106680645,0.1362980821647517,0.27725966173753136,0.14096157957277966,1044909628,1034913553.4,86.6171015998882,78.90883287703912,NaN,NaN,7.82789264407089,4.6572836694537445
2019-08-23T09:30:00-04:00,60.46,60.71,59.28,59.62,25296118,16426278.6,50.01452385727638,51.570475002613875,NaN,NaN,28.782390447519543,89.56147382127452,0.07402569149227975,0.23349369393812935,0.1594680024458496,1019613510,1033871325.4,85.31386171254725,79.53325331120594,NaN,NaN,6.528301015161371,4.924571861697691
2019-08-26T09:30:00-04:00,60.02,60.41,59.78,60.36,13629835,16801704.9,54.76005228811295,52.6103129283728,NaN,NaN,63.537329745219346,73.03534549178131,0.07688524625231608,0.2555745602612447,0.17868931400892862,1033243345,1032918912,84.06904820864831,80.57097447030296,NaN,NaN,7.030444716527056,5.225410840959029
2019-08-27T09:30:00-04:00,60.61,60.77,60,60.19,13393435,16765174.9,53.50337487746866,53.0858469813191,NaN,NaN,82.59334118913118,70.51322405456567,0.06216902890569634,0.25640060014104904,0.1942315712353527,1019849910,1031079678.6,81.59314094846502,81.39134582830248,NaN,NaN,7.027404194992819,5.482838462963856
2019-08-28T09:30:00-04:00,60.17,60.77,60.06,60.77,12435730,16545623.4,57.11904007320501,53.37181747268787,NaN,NaN,93.20322554403194,72.02263657045305,0.08492965860349094,0.3003936444897164,0.21546398588622545,1032285640,1029980406.6,80.07521920053519,81.7236246515423,NaN,NaN,8.172925953126112,5.867136675844178
2019-08-29T09:30:00-04:00,61.13,61.14,60.43,60.8,9657640,15521093.25,57.303980607858016,53.869315739013395,NaN,NaN,103.65915911448286,74.35508920807696,0.09469361319145145,0.33383100237553975,0.2391373891840883,1041943280,1029387137,79.21866497239867,81.86566947820924,NaN,NaN,9.135913051058381,6.334104729446207
2019-08-30T09:30:00-04:00,61,61.15,60.525,60.72,8566987,14731006.4,56.602913149262015,54.546410639948576,NaN,NaN,93.56372687260088,87.31135649309323,0.08856389205538351,0.3498422542533177,0.2612783621979342,1033376293,1032139693.6,80.27301839684588,81.9011918873388,NaN,NaN,9.722305346209094,6.818133388983763
2019-09-03T09:30:00-04:00,60.46,61.08,60.35,61.07,15570782,14191306.35,58.96806874573103,55.00222879388398,NaN,NaN,91.22542323511756,92.84897519107287,0.10003339341496409,0.3863201039666393,0.2862867105516752,1048947075,1035280439.6,81.43070102977617,81.88903830563281,NaN,NaN,10.893224736698295,7.400289295800125
2019-09-04T09:30:00-04:00,61.32,61.62,61.08,61.62,12200477,13795012.65,62.43292958888254,56.21271479873639,NaN,NaN,141.67765699652918,104.66583835255247,0.13446803269275992,0.4543717514176251,0.31990371872486517,1061147552,1043539968,84.07711487219711,82.10814091267423,NaN,NaN,12.929838798324289,8.190224939017863
2019-09-05T09:30:00-04:00,61.78,61.9199,61.15,61.24,15720085,13703474.65,58.742140749876064,56.693017121003145,NaN,NaN,136.59939408897213,113.34507206154053,0.1218347476205347,0.4721971532505336,0.3503624056299989,1045427467,1046168333.4,84.81857851878156,82.59467483355566,NaN,NaN,13.612258717194713,8.964801193043128
2019-09-06T09:30:00-04:00,61.4,61.54,61.25,61.44,13904196,13198120.6,60.07975165650791,56.95811471419834,NaN,NaN,122.97023538111077,117.20728731486611,0.11709901608172302,0.4967361757321527,0.37963715965042966,1059331663,1049646010,85.76322203429635,83.06517084094013,NaN,NaN,14.559639541596118,9.764063814264983
2019-09-09T09:30:00-04:00,61.41,61.47,61.13,61.3,27082417,14022731.5,58.646417911760956,56.873621436884605,NaN,NaN,102.3679068019616,118.96812330073824,0.09559667492695134,0.4991330033091188,0.40353632838216746,1032249246,1049420600.6,85.39233477792348,83.32436827039552,NaN,NaN,14.963366655845286,10.50682136306217
2019-09-10T09:30:00-04:00,61.03,61.03,60.59,60.92,31984951,15033280.35,54.823243037026984,56.88311708653455,NaN,NaN,45.12597257206076,109.74823316812687,0.04917841246675547,0.4650093439656118,0.4158309314988563,1000264295,1039684044.6,71.09108500707745,82.48492834836502,NaN,NaN,14.261674719394438,11.04322898539535
2019-09-11T09:30:00-04:00,60.9,61.1899,60.58,61.14,17422191,15244317.25,56.58773188063117,56.94766394172145,NaN,NaN,54.71072030907163,92.35484583063538,0.027755165995452635,0.4505248889931721,0.4227697229977195,1017686486,1030991831.4,61.23187046837428,80.78321155341102,NaN,NaN,14.140029225212981,11.485629019655011
2019-09-12T09:30:00-04:00,61.5,61.685,61.27,61.39,18296204,15295059.85,58.56807736932634,57.010874699494714,NaN,NaN,113.4338783720824,87.72174268725743,0.024972623569256114,0.4539855024592896,0.4290128788900335,1035982690,1029102876,59.30696720940987,78.83248766837687,NaN,NaN,14.569408692892042,11.926168972974587
2019-09-13T09:30:00-04:00,61.11,61.46,60.91,61.04,17830533,15464492.75,54.79917225110414,57.35263529905383,NaN,NaN,62.05899259053959,75.53949412914321,-0.00432793717115959,0.423602957426084,0.4279308945972436,1018152157,1020866974.8,51.67883511734026,76.42998576871923,NaN,NaN,13.913980608021651,12.210142063695596
2019-09-16T09:30:00-04:00,60.75,60.81,60.32,60.45,16741202,15386821.55,49.067080828715106,56.94599448052542,NaN,NaN,-48.06552926497811,45.45280691575526,-0.06401986931262321,0.34790605795646456,0.4119259272690878,1001410955,1014699316.6,46.82197018391173,73.76948019552377,NaN,NaN,11.665878656625758,12.132390148399905
2019-09-17T09:30:00-04:00,60.42,61.11,60.42,60.78,11683572,15311962.05,52.085978190035085,56.84475185999445,NaN,NaN,-4.170487932312928,35.59351481488052,-0.08077320960616097,0.3109594152613866,0.39173262486754756,1013094527,1017265363,48.97074748572451,71.43930923389944,NaN,NaN,10.595295684695762,11.9128052250136
2019-09-18T09:30:00-04:00,60.84,60.95,60.36,60.88,10969401,15412465.35,52.99518539238464,56.55019081136442,NaN,NaN,-15.385965277722295,21.574177697521733,-0.08422919880103763,0.28644612636625055,0.3706753251672882,1024063928,1018540851.4,50.051139684034524,69.29473212557795,NaN,NaN,9.956810641907982,11.633377427427083
2019-09-19T09:30:00-04:00,60.83,60.975,60.745,60.87,10684532,15509895.8,52.887108028293255,56.23469991282408,NaN,NaN,5.352793658554386,-0.04203924518387012,-0.08599746491347926,0.26317849402543914,0.3491759589389184,1013379396,1014020192.6,46.308860156302394,66.94403178157107,NaN,NaN,9.399237832129662,11.314214628098881
2019-09-20T09:30:00-04:00,60.64,60.78,60.32,60.32,13957878,15851408.3,47.187175866035815,55.56214724973649,NaN,NaN,-71.867547284716,-26.82734722023498,-0.12088073630645518,0.1980750385558494,0.3189557748623046,999421518,1010274064.8,43.41218721061352,64.31111526826875,NaN,NaN,7.289073563743864,10.739194476048164
2019-09-23T09:30:00-04:00,60.37,60.8097,60.32,60.56,8773667,15025285.75,49.73304279706748,54.90250253911767,NaN,NaN,-66.51983698091958,-30.518208763423285,-0.12399974667105318,0.1639560915234881,0.2879558381945413,1008195185,1011630910.8,44.759976131251726,61.691777775517004,NaN,NaN,6.181293218923143,10.088065725030305
2019-09-24T09:30:00-04:00,60.8,61.21,60.59,60.81,17305933,15209090.65,52.31185765458874,54.17956882952526,NaN,NaN,-7.797628016289711,-31.24363678021864,-0.1061252327784244,0.1552992972215108,0.2614245299999352,1025501118,1014112229,47.2350114889596,59.060198962428615,NaN,NaN,5.939201656032986,9.495370858030688
2019-09-25T09:30:00-04:00,61.07,61.15,60.67,60.85,17628501,15420843.95,52.729717300894436,53.75011001174086,NaN,NaN,-10.553010384490722,-30.277045801572324,-0.08918922467727824,0.1499379991533374,0.23912722383061563,1043129619,1017925367.2,50.87745774846993,56.63583319312064,NaN,NaN,5.848843245508693,8.974438341956118
2019-09-26T09:30:00-04:00,60.92,61.37,60.89,61.19,15581554,15578135.15,56.239692152184055,53.47582004714629,NaN,NaN,48.2517033037893,-21.697263872525344,-0.05438068792498246,0.17115136392438757,0.22553205184937003,1058711173,1026991722.6,58.25608193799633,54.67103747195635,NaN,NaN,6.727665341935153,8.653470770524551
2019-09-27T09:30:00-04:00,61.34,61.358,60.755,61.12,14312527,15810879.5,55.328791947972306,53.23884676401854,NaN,NaN,26.030587820755102,-2.1176368514311235,-0.03623601505488491,0.18023703303076388,0.2164730480856488,1044398646,1035987148.2,64.02929019543545,53.14510571606435,NaN,NaN,7.2284224153463095,8.449892434070517
2019-09-30T09:30:00-04:00,61.16,61.69,61.16,61.42,11080925,15936576.4,58.43588527099264,53.49689263787322,NaN,NaN,100.6600610079552,31.31834274634383,-0.005791978147313748,0.2092330754015066,0.21502505354882034,1055479571,1045444025.4,68.89905820521102,52.988532373073895,NaN,NaN,8.515971835133112,8.45933234850803
2019-10-01T09:30:00-04:00,61.45,61.62,61.01,61.26,16845914,16000333,56.19108637396345,53.46856081596839,NaN,NaN,63.042957845419004,45.486459918685576,0.00142221087326172,0.2168028171403975,0.2153806062671358,1038633657,1048070533.2,70.10940400619398,53.62264191148959,NaN,NaN,9.027606683068118,8.540514396302328
2019-10-02T09:30:00-04:00,60.96,61.02,59.8,60.03,18672725,16323945.4,42.6326418034052,52.3303154184026,NaN,NaN,-157.542268308009,16.088608333981924,-0.07458994022530593,0.12214318098550336,0.1967331212108093,1019960932,1043436795.8,65.28248499990414,54.04946461081061,NaN,NaN,5.1720975107133755,8.059311984075334
2019-10-03T09:30:00-04:00,60.33,60.66,59.79,60.45,21000409,16587961.6,47.308010851363235,51.795232461278246,NaN,NaN,-138.63189662538306,-21.28811165185255,-0.09331291552277665,0.08009197680733848,0.17340489233011513,1040961341,1039886829.4,61.773561614128376,54.77051650343834,NaN,NaN,3.430670075839414,7.398077425755917
2019-10-04T09:30:00-04:00,60.55,61.41,60.49,61.4,12017330,16493618.3,56.03588340242417,52.29300407368604,NaN,NaN,47.49235860741265,-16.99575749452104,-0.04111061516745443,0.1220166233707971,0.16312723853825153,1052978671,1041602834.4,62.81404497092087,55.912807559653274,NaN,NaN,4.919105835830782,7.043938627195184
2019-10-07T09:30:00-04:00,61.26,61.34,60.84,60.9,9418609,15610427.9,51.226498294964884,52.2316126526096,NaN,NaN,35.11061287385471,-30.10564712134114,-0.039632170056546484,0.11358702596756842,0.1532191960241149,1043560062,1039218932.6,60.35623697506697,56.72605680889202,NaN,NaN,4.465891528938327,6.675646184587062
2019-10-08T09:30:00-04:00,60.72,60.89,60.31,60.32,15290815,14775721.1,46.26597263492951,51.75095459850565,NaN,NaN,-86.07465094899999,-59.929168880224935,-0.0750390406372764,0.05942039522751941,0.1344594358647958,1028269247,1037146050.6,58.22291674416223,57.30975517032971,NaN,NaN,2.352103728013169,6.057997262219363
2019-10-09T09:30:00-04:00,60.62,60.93,60.485,60.78,8549051,14332064.1,50.370712093212056,51.57121203171414,NaN,NaN,-29.739234553152862,-34.36856212925371,-0.06516742632047494,0.05300015296420213,0.11816757928467707,1036818298,1040517523.8,60.65856150841108,58.33473383833746,NaN,NaN,2.041783653110886,5.484252460918152
2019-10-10T09:30:00-04:00,60.65,61.075,60.48,60.9,8685917,13851549.75,51.413415217303005,51.87308627109037,NaN,NaN,-2.220446557899077,-7.086272115756915,-0.04898309714588173,0.05693870785232491,0.10592180499820664,1045504215,1041426098.6,61.31314480401991,59.61337366643793,NaN,NaN,2.1370976508727235,5.006087488054519
2019-10-11T09:30:00-04:00,61.13,61.21,60.72,60.84,18187231,13869384.65,50.838282349571124,51.95203195341206,NaN,NaN,29.018406888441184,-10.781062459551205,-0.041066026975223796,0.0545892712791769,0.0956552982544007,1027316984,1036293761.2,55.67761793625527,60.393205223938175,NaN,NaN,2.037862064287865,4.582055284659283
2019-10-14T09:30:00-04:00,60.92,60.9766,60.51,60.54,7569968,13410822.95,47.95002893681292,51.64047275928522,NaN,NaN,-41.41323063085042,-26.085831160492226,-0.05396838201945767,0.028194820730078618,0.08216320274953628,1019747016,1031531152,50.99367421355577,60.6616811328379,NaN,NaN,1.0859096679763192,4.082605910847431
2019-10-15T09:30:00-04:00,60.69,60.73,60.19,60.28,12233274,13438308.05,45.535505817600985,51.126600510478546,NaN,NaN,-104.584670526191,-29.787835075930435,-0.07656787526552941,-0.013546641332375486,0.06302123393315393,1007513742,1027380051,47.261662059390176,60.40341001218935,NaN,NaN,-0.42993668907531724,3.437956968001324
2019-10-16T09:30:00-04:00,60.33,60.405,60.13,60.34,10406311,13410153.55,46.20866443184138,50.41009853045407,NaN,NaN,-116.0580410220307,-47.051596369706,-0.08346447799440655,-0.04130936355985426,0.04215511443455229,1017920053,1023600402,44.09712712227107,59.3920560967804,NaN,NaN,-1.4797014841774803,2.735434331975781
2019-10-17T09:30:00-04:00,60.54,60.79,60.45,60.62,13211138,13536483.85,49.35450165070594,49.98336350922075,NaN,NaN,-35.14990761043721,-53.63748858021363,-0.065927163383147,-0.04025383979438146,0.025673323588765538,1031131191,1020725797.2,41.80449063660392,57.80457041400672,NaN,NaN,-1.4949362029211006,2.1310956841333693
2019-10-18T09:30:00-04:00,60.51,60.97,60.51,60.74,9301249,13303652.4,50.685586348382245,49.4297707290343,NaN,NaN,-10.835971863789455,-61.608364330659754,-0.04405504262746523,-0.029395479695565996,0.01465956293189923,1040432440,1023348888.4,44.633236722091745,56.071297450926764,NaN,NaN,-1.140284665029042,1.6637556342530249
2019-10-21T09:30:00-04:00,60.75,60.965,60.665,60.94,9981664,13364052.25,52.9071230744669,49.1952019219274,NaN,NaN,14.527393053155022,-50.42023959385866,-0.01540669861261316,-0.00459881033386722,0.01080788827874594,1050414104,1029482306,50.67105635880957,54.68284404754217,NaN,NaN,-0.22583210559714767,1.393814528560143
2019-10-22T09:30:00-04:00,61.38,61.415,60.93,60.96,12497014,13123606.3,53.13448498026439,49.945333577417344,NaN,NaN,70.62222988022265,-15.378859512575934,0.004534992826838263,0.016476629312293767,0.011941636485455504,1062911118,1040561781.2,59.304412562722966,54.25583887345779,NaN,NaN,0.5965026375699256,1.2799128298472549
2019-10-23T09:30:00-04:00,60.93,61.28,60.91,61.24,7599184,12622140.45,56.31438627029733,50.58864610734121,NaN,NaN,74.43573461113775,22.719895614057755,0.03455640311718552,0.0551371403819374,0.020580737264751882,1070510302,1051079831,65.4808573264454,54.52064571005186,NaN,NaN,2.1831520294731477,1.4089470012223824
2019-10-24T09:30:00-04:00,61.36,61.55,61.12,61.45,9089533,12297539.4,58.584110951266695,50.77066236082997,NaN,NaN,120.63762145705573,53.877401427556336,0.0647758164712452,0.10155050785380837,0.03677469138256318,1079599835,1060773559.8,69.99997077236225,55.03392612444054,NaN,NaN,4.181972450100974,1.805093493919324
2019-10-25T09:30:00-04:00,61.39,61.4,61.035,61.09,7518628,11957844.45,53.45662839300155,50.92995736783258,NaN,NaN,73.9360296061509,70.83180172154441,0.05701147716182921,0.1080390378348497,0.051027560673020486,1072081207,1067103313.2,72.52897052306844,55.90340709215492,NaN,NaN,4.5642702000163915,2.1992615947903333
2019-10-28T09:30:00-04:00,61.09,61.31,60.825,60.97,11154157,11961506.05,51.828253669237874,51.327263155997464,NaN,NaN,50.621221572315456,78.0505674253765,0.04103297567464771,0.10231878026633012,0.06128580459168241,1060927050,1069205902.4,73.33314669840033,56.98270923174336,NaN,NaN,4.445769853492645,2.5201913460335206
2019-10-29T09:30:00-04:00,60.86,61.26,60.75,60.97,10072443,11622832.5,51.828253669237874,51.43137326857074,NaN,NaN,46.658756445633706,73.2578727384587,0.028308213126815585,0.09667107100020189,0.0683628578733863,1060927050,1068809088.8,72.89941902049638,57.85705619689231,NaN,NaN,4.347138248440904,2.7811837606631467
2019-10-30T09:30:00-04:00,61.02,61.36,60.85,61.25,7216383,11050015.4,55.49677013299478,51.72304147683444,NaN,NaN,79.73388640077239,74.31750309638564,0.03609430991528115,0.11348074526748775,0.0773864353522066,1068143433,1068335715,72.34968098135829,58.645380209559335,NaN,NaN,5.240533141313444,3.132519386470332
2019-10-31T09:30:00-04:00,61.27,61.488,60.77,61.16,12628109,10631400.4,54.07137696604191,51.953976806582354,NaN,NaN,70.01856648729948,64.19369210243438,0.032633254068824044,0.11817800293823666,0.08554474886941262,1055515324,1063518812.8,66.82721112540875,59.44177972307029,NaN,NaN,5.63052437275851,3.489377241654357
2019-11-01T09:30:00-04:00,61.27,61.38,61.02,61.15,10231960,10542131.9,53.90570696144504,52.379382379770355,NaN,NaN,79.95144451195327,65.39677508359486,0.027335170429311023,0.1197137119060514,0.09237854147674038,1045283364,1058159244.2,61.22721262373997,60.172746752369164,NaN,NaN,5.9176256210512745,3.836269867282488
2019-11-04T09:30:00-05:00,61.22,61.252,60.37,60.56,17082683,10925335.6,45.12159956355924,52.3498176473388,NaN,NaN,-41.79018366139113,46.91449403685354,-0.01591313973968303,0.0724871168021366,0.08840025654181963,1028200681,1051613970.4,55.14926478673524,60.73614694717953,NaN,NaN,3.699155385912038,3.8166820842295666
2019-11-05T09:30:00-05:00,60.48,60.89,60.29,60.76,17192219,11020405.8,48.20287962984974,52.49226159005368,NaN,NaN,-67.83220410104872,24.01630192751706,-0.03022854511547364,0.05061457514747758,0.08084312026295122,1045392900,1048507140.4,52.485906828534794,61.33534549762693,NaN,NaN,2.658569131503307,3.6512373766972437
2019-11-06T09:30:00-05:00,60.86,61.16,60.685,61.01,8284492,11007177.85,51.842751466150844,52.669993719728325,NaN,NaN,15.711511649881142,11.211826977338811,-0.022399148925702994,0.05284418410582248,0.07524333303152547,1053677392,1045613932.2,50.061313350755746,61.925118548637776,NaN,NaN,2.795891660847728,3.5290451315758844
2019-11-07T09:30:00-05:00,61.08,61.09,60.6939,60.8,9437822,11044773.1,48.744141783274834,52.53131910793494,NaN,NaN,-11.210365745785088,-5.033959469278104,-0.03040532318131217,0.03723667905488526,0.06764200223619743,1044239570,1043358781.4,48.19254001762849,62.17935449831897,NaN,NaN,2.0225371845322955,3.3138297105696575
2019-11-08T09:30:00-05:00,60.77,60.95,60.56,60.76,7574243,10514123.7,48.15375803109816,52.1917930334086,NaN,NaN,-38.39853547778954,-28.703955467226667,-0.03699892659114941,0.021393343997260672,0.05839227058841008,1036665327,1041635174,46.755931143492475,61.899702697224896,NaN,NaN,1.219319752676063,3.014614002299144
2019-11-11T09:30:00-05:00,60.79,60.885,60.57,60.67,5632194,10417235,46.78083208594439,51.737960683814315,NaN,NaN,-53.02791963853756,-30.95150266265595,-0.04546806552781689,0.0015571886786389655,0.047025254206455855,1031033133,1042201664.4,47.31184893657354,61.0430910096428,NaN,NaN,0.1654630894766616,2.6075924433245037
2019-11-12T09:30:00-05:00,60.76,60.87,60.59,60.87,7085094,10159826,50.18014800977882,51.29980080806299,NaN,NaN,-42.233878722000725,-25.831837586846355,-0.03605803411418503,0.001952711563724563,0.038010745677909595,1038118227,1040746729.8,45.983901885452525,59.65045133528617,NaN,NaN,0.16676629416146926,2.25890299344407
2019-11-13T09:30:00-05:00,60.96,61.45,60.88,61.33,9508395,10114930.2,56.98550343823493,51.185614557132155,NaN,NaN,90.1607687518349,-10.941986166455603,0.0007398016480116426,0.03893549773792415,0.03819569608991251,1047626622,1039536575.8,44.856147153134046,57.854463933912726,NaN,NaN,2.193128813405748,2.2495066820100242
2019-11-14T09:30:00-05:00,61.6,61.62,61.06,61.31,8442110,9876478.8,56.623343227074784,51.41180847385167,NaN,NaN,116.91969885261848,14.684026753225112,0.02214061443966836,0.06587146413949796,0.0437308496998296,1039184512,1038525564.2,43.887752548233216,55.808662649995924,NaN,NaN,3.7449047129215374,2.4631349721402405
2019-11-15T09:30:00-05:00,61.4,61.46,61.105,61.33,7221445,9772488.6,56.918202536028005,51.77537625005097,NaN,NaN,96.32831014908835,41.62939587860069,0.03527124916740054,0.08781991115908028,0.052548661991679735,1046405957,1040473690.2,46.293779942583974,53.87727931029475,NaN,NaN,5.111595589933612,2.841486488967865
2019-11-18T09:30:00-05:00,61.27,61.99,61.27,61.65,8615497,9704180.25,61.43524347990363,52.46158980795566,NaN,NaN,183.9300827193595,89.0209963501801,0.06159487576867892,0.1295422567025284,0.06794738093384947,1055021454,1045271354.4,51.777668227025856,52.368582825046865,NaN,NaN,7.651758658504446,3.5286682274730907
2019-11-19T09:30:00-05:00,61.74,61.84,61.44,61.57,8560914,9507375.25,59.74864023881833,52.765294815514494,NaN,NaN,152.4085538379629,127.94948286217281,0.06914023337308961,0.15437267265021148,0.08523243927712187,1046460540,1046939817,53.553840685066284,51.02602280388315,NaN,NaN,9.32371346699356,4.356531833118872
2019-11-20T09:30:00-05:00,61.57,61.86,61.44,61.71,11935881,9724210.1,61.72875633500579,53.31225048472619,NaN,NaN,145.32143596671287,138.9816163051484,0.07840249711445528,0.18323556067019098,0.1048330635557357,1058396421,1049093776.8,55.816419084712045,50.239537658119104,NaN,NaN,11.316579970416624,5.350824424161408
2019-11-21T09:30:00-05:00,61.6,61.75,61.26,61.4,7611141,9650290.5,55.24774212900927,53.40811013955221,NaN,NaN,90.37651290000677,133.6729791146261,0.059358697321904894,0.17903143520811682,0.11967273788621192,1050785280,1051413930.4,58.17964567316973,50.02185430450694,NaN,NaN,11.250211815827809,6.193594051542322
2019-11-22T09:30:00-05:00,61.45,61.49,61.06,61.3,5517052,9550211.7,53.30356991532732,53.99253659324993,NaN,NaN,40.37443904294709,122.48220489339784,0.0368379316628763,0.1657201524648073,0.128882220801931,1045268228,1051186384.6,57.85282778834298,50.214965947478916,NaN,NaN,10.640901842400392,6.828923735950617
2019-11-25T09:30:00-05:00,61.42,61.53,61.07,61.37,10396518,9512329.75,54.51031584534352,54.44306775149949,NaN,NaN,46.332804460810884,94.9627492416881,0.02408348865960433,0.15898658162643642,0.1349030929668321,1055664746,1051315043,57.99650047856801,50.60857977962415,NaN,NaN,10.459626525846456,7.3475955630785945
2019-11-26T09:30:00-05:00,61.45,61.93,61.34,61.87,7358892,9376652.2,62.0535843912863,55.17241296043774,NaN,NaN,126.83029176045636,89.8470968261868,0.045505700769147894,0.19178521892826694,0.14627951815911905,1063023638,1054627662.6,61.623818594099646,51.434473011291566,NaN,NaN,12.59791695636214,8.097641476404815
2019-11-27T09:30:00-05:00,61.98,62.09,61.81,62.02,5483250,9289995.55,63.98314478372558,56.26091317475565,NaN,NaN,159.2467816160216,92.63216595604854,0.06478629140116818,0.22726238241057928,0.1624760910094111,1068506888,1056649756,63.68537877071783,52.541104350797944,NaN,NaN,14.973336259130528,9.079883588222774
2019-11-29T09:30:00-05:00,62.04,62.14,61.88,62,3008494,8809014.8,63.51935930591911,57.35845612295714,NaN,NaN,143.1887668170255,103.1946167394523,0.07071717084854637,0.25087255457009405,0.18015538372154768,1065498394,1059592378.8,66.50524873859531,53.95176989330529,NaN,NaN,16.768620644357167,10.178274596241973
2019-12-02T09:30:00-05:00,61.88,62.17,61.59,62.14,17920081,9193420.85,65.40948759721658,58.68907437376231,NaN,NaN,119.40779656188953,119.0012882432408,0.0780194509251887,0.27767969737803355,0.19966024645284486,1083418475,1067222428.2,72.4738263591458,55.749053994917595,NaN,NaN,18.845443985350837,11.416441651828954
2019-12-03T09:30:00-05:00,62.02,62.09,61.62,62.04,20537424,9366157.9,62.90249337002028,59.59781332806527,NaN,NaN,99.26957169771731,129.58864169062207,0.0703044393331358,0.2875407956192646,0.2172363562861288,1062881051,1068665689.2,73.43800389277463,57.71006128115489,NaN,NaN,19.904619047079077,12.629038422578972
2019-12-04T09:30:00-05:00,61.97,62.49,61.9,62.45,17369149,9375004.4,68.27188834710802,60.403983678699056,NaN,NaN,145.04366000463867,133.23131533945852,0.08596808442117698,0.32469646181260003,0.23872837739142305,1080250200,1072111001.6,75.63229482506515,59.908357543435685,NaN,NaN,22.52991289012215,14.043449060799427
2019-12-05T09:30:00-05:00,62.47,62.48,62.062,62.43,13445168,9633038.2,67.75670274523969,61.19922364428227,NaN,NaN,134.95101418051843,128.3721618523579,0.08782637034245366,0.34851134031949016,0.2606849699770365,1066805032,1071770630.4,74.97334962900435,62.128757334919335,NaN,NaN,24.505937228527795,15.538090227617765
2019-12-06T09:30:00-05:00,62.56,62.91,62.52,62.67,10746704,9698482.3,70.62164098992136,62.178040676703226,NaN,NaN,174.00187461166112,134.534783411285,0.09732672870271586,0.3823433808554313,0.28501665215271543,1077551736,1074181298.8,76.53280366157298,64.28868760056142,NaN,NaN,27.09782213739681,17.18948050044334
2019-12-09T09:30:00-05:00,62.63,62.88,62.6201,62.72,6898808,9664710.55,71.19585560645342,62.87522725717106,NaN,NaN,160.06131171915,142.66548644273712,0.09877178210510718,0.4084813797840994,0.3097095976789922,1084450544,1074387712.6,76.66687277510734,66.06648792542437,NaN,NaN,29.398418430068883,18.933614490389846
2019-12-10T09:30:00-05:00,62.72,62.79,62.46,62.52,7194526,9742827.15,65.66696110712033,63.29796446204978,NaN,NaN,121.73566912374135,147.15870592794192,0.07891263750459254,0.4083503945597329,0.32943775705514033,1077256018,1077262706,78.50855991156993,67.84896787017463,NaN,NaN,29.805972556012065,20.48680849976445
2019-12-11T09:30:00-05:00,62.66,62.76,62.425,62.61,6201740,9698659.45,66.9121889520037,63.6682096489782,NaN,NaN,111.78223661341603,140.50642124969738,0.06506874814626151,0.4107736922379672,0.3457049440917057,1083457758,1077904217.6,78.90859741860197,69.4984091797382,NaN,NaN,30.49920413681184,21.917150733628365
2019-12-12T09:30:00-05:00,62.62,63.02,62.43,62.56,11843823,9815430.85,65.49106868338774,64.39987583143382,NaN,NaN,110.9155507958964,135.699328572773,0.04663804602142391,0.4040025016184856,0.3573644555970617,1071613935,1078865998.2,79.52396861373441,71.02300367549283,NaN,NaN,30.68592262682875,23.169832432656992
2019-12-13T09:30:00-05:00,62.4,62.88,62.29,62.78,10158294,9901240.05,68.64643565611767,65.49579481291883,NaN,NaN,95.6511308611914,120.02917982267904,0.04342305806652802,0.41164327818022173,0.3682202201136937,1081772229,1079710096.8,80.07346561380473,72.61019209159723,NaN,NaN,31.743954932358115,24.394707075471437
2019-12-16T09:30:00-05:00,62.96,63.15,62.88,63,10004622,10040398.9,71.45705381241186,66.70627609628085,NaN,NaN,130.88221315823728,114.1933601104965,0.04981455002417601,0.4304884076439137,0.3806738576197377,1091776851,1081175358.2,81.02538281429979,74.25511225843522,NaN,NaN,33.50134019218888,25.69565466357393
2019-12-17T09:30:00-05:00,62.92,63.04,62.82,62.9,8005483,10009898.2,68.45325372028304,67.16339533406634,NaN,NaN,104.63954318345064,110.77413492243838,0.04135695505510384,0.4323700514386175,0.39101309638351367,1083771368,1082478428.2,81.85551886682211,75.70023370648683,NaN,NaN,34.112939790790705,26.89812396746204
2019-12-18T09:30:00-05:00,63.01,63.22,62.7,62.8,5464078,9855056.4,65.48858474507253,67.27092675987682,NaN,NaN,93.25494089937351,107.06867577962987,0.02394134031254397,0.4209397717741936,0.39699843146164965,1078307290,1081448334.6,78.91626954776083,76.78815447627561,NaN,NaN,33.78418964787325,27.881847636092214
2019-12-19T09:30:00-05:00,62.89,63.28,62.88,63.14,9068128,9711668.75,70.21229036725853,67.7489932642582,NaN,NaN,109.42188766666912,106.7699431537844,0.029849172546759062,0.4343098971450985,0.4044607245983394,1087375418,1084600631.2,81.14726135520857,77.83401252031942,NaN,NaN,34.9096111491297,28.885813852240428
2019-12-20T09:30:00-05:00,62.82,63.36,62.78,63.1,15270570,10094640.2,69.01546108318696,68.00656279897038,NaN,NaN,98.18443559177125,107.27660409990037,0.025747246615001607,0.4366447828670914,0.4108975362520898,1072104848,1082667155,75.8459951336819,78.07488171850056,NaN,NaN,35.474506076921905,29.827055598623495
2019-12-23T09:30:00-05:00,63.22,63.22,62.81,62.83,6006541,10119114.65,61.40655448812937,67.89971002169246,NaN,NaN,75.37647989346885,96.1754574469467,0.0008496820602746924,0.41195963882743314,0.41110995676715845,1066098307,1077531446.2,63.90392715998531,77.39387623758704,NaN,NaN,33.64011787163672,30.371778780482526
2019-12-24T09:30:00-05:00,62.9,62.9898,62.8101,62.91,1700093,9684293.4,62.71810419179869,67.50301115345607,NaN,NaN,64.15420502039235,88.07838981433504,-0.013442768690739293,0.39430649590373434,0.40774926459447364,1067798400,1074336852.6,57.806794017723064,76.12062617991975,NaN,NaN,32.5084812980441,30.677021997277038
2019-12-26T09:30:00-05:00,62.98,63.09,62.8,62.97,8638550,9748276.3,63.71409450076242,67.2142534217077,NaN,NaN,70.1817533611831,83.46375230669696,-0.021584620166568647,0.38076848938626284,0.4023531095528315,1076436950,1073962784.6,57.11956319131313,74.84535572008465,NaN,NaN,31.85244085352725,30.844938976741354
2019-12-27T09:30:00-05:00,63.1,63.27,63.0401,63.25,10315292,9989878.4,68.0091987239273,67.02765040270812,NaN,NaN,112.23063059916656,84.02550089319644,-0.011355504110114434,0.3881587294151885,0.3995142335253029,1086752242,1073838149.4,56.876938608747935,73.44136535916859,NaN,NaN,32.54779084974846,31.088203530028082
2019-12-30T09:30:00-05:00,63.14,63.24,62.83,62.92,6238572,10151382.3,59.12625864955454,66.16553633435821,NaN,NaN,65.2148810305639,77.43158998095497,-0.029050942113634126,0.3632005558832603,0.3922514979968944,1080513670,1075519913.8,59.3839523093799,72.20687104018806,NaN,NaN,30.311214024651463,30.977205029259995
2019-12-31T09:30:00-05:00,62.79,63.02,62.66,62.98,4985440,9504650.25,60.145526084297835,65.77114811844231,NaN,NaN,32.27155558314054,68.8106051188893,-0.038366223650597775,0.3442937184336472,0.382659942084245,1085499110,1079400074.4,64.51040955800373,71.20700315779052,NaN,NaN,28.817914669852435,30.668734977916056
2020-01-02T09:30:00-05:00,63.1,63.1,62.31,62.48,14460720,9200815.05,49.14679890013382,64.5021916861659,NaN,NaN,-56.48152732982429,44.68345864884598,-0.07759111036749522,0.2856710541248759,0.36326216449237114,1071038390,1080048072.4,65.2981461209332,70.23482806509989,NaN,NaN,23.62886085330727,29.663038674400514
2020-01-03T09:30:00-05:00,62.25,62.65,62.0851,62.38,26388928,9651804,47.28440430335797,63.20171565902091,NaN,NaN,-145.41131225908168,1.5648455247930002,-0.10780261342541919,0.22850889771059713,0.3363115111360163,1044649462,1073690574.8,52.893611856945256,68.33265972532925,NaN,NaN,18.8789151839179,28.12244960433157
2020-01-06T09:30:00-05:00,62.29,62.59,62.18,62.51,22541708,10106631,49.94019390246494,61.86555553376,NaN,NaN,-132.56058371821985,-47.39339733868428,-0.1158571986714313,0.19149001279672717,0.30734721146815847,1067191170,1069778360.4,46.9792630113587,65.96878811086881,NaN,NaN,15.828586527220336,26.366183450458536
2020-01-07T09:30:00-05:00,62.32,62.38,61.975,62.03,15609921,10349791.85,41.605528674058,59.73330373816329,NaN,NaN,-193.671417379538,-99.17065702070467,-0.14826673535310125,0.12201379227678188,0.27028052762988314,1051581249,1063991876.2,39.876913271212,63.02961171493398,NaN,NaN,10.134033157718054,24.047304837209897
2020-01-08T09:30:00-05:00,62.08,62.52,61.96,62.26,11451390,10577420.95,46.23576039798582,58.146339929427775,NaN,NaN,-135.26552877238356,-132.67807389180948,-0.14859405110206914,0.08453796375229672,0.23313201485436585,1063032639,1059498582,35.40132489196678,59.71145500244432,NaN,NaN,7.036166297829731,21.617142188727016
2020-01-09T09:30:00-05:00,62.45,62.71,62.3,62.7,6854496,10560419.45,53.7853028348309,57.31039122155338,NaN,NaN,-49.656178229352584,-131.31300407171514,-0.11505530857223487,0.08931287913907227,0.20436818771130713,1069887135,1059268331,35.18340951323873,56.58767928569273,NaN,NaN,7.047058600695569,19.535701676151096
2020-01-10T09:30:00-05:00,62.76,62.845,62.58,62.66,7410845,10620874.7,53.05592425400636,56.08493649917823,NaN,NaN,-18.54203328692603,-105.93914827728402,-0.09241837742232845,0.08884521593339656,0.181263593355725,1062476290,1062833696.6,41.21739701451213,53.735546118500125,NaN,NaN,6.81383992973002,17.7182928552338
2020-01-13T09:30:00-05:00,62.68,63.08,62.65,63.07,9625668,10509966.95,59.16812071175577,55.38155504407599,NaN,NaN,41.56104140512045,-71.11482325261595,-0.04887256688439981,0.12017288475022525,0.16904545163462506,1072101958,1063815854.2,42.797180092544345,51.374916472704584,NaN,NaN,8.740662666398862,16.435774256828807
2020-01-14T09:30:00-05:00,62.99,63.12,62.91,63.09,7512310,10377667.75,59.445507838239465,55.241480283369576,NaN,NaN,64.56193749999947,-19.468152276708448,-0.019281717585864777,0.1449433046522941,0.16422502223815888,1079614268,1069422458,50.90796762486688,50.44663364876755,NaN,NaN,10.31690336481963,15.56164984368464
2020-01-15T09:30:00-05:00,63.04,63.67,63.01,63.54,12454341,10500153.7,65.17759625721561,55.41715828804221,NaN,NaN,148.46819774535513,37.27859302683928,0.02749677351982105,0.1985959891379352,0.17109921561811414,1092068609,1075229652,57.612047450873455,50.43272317970686,NaN,NaN,13.689392887484358,15.294184564227457
2020-01-16T09:30:00-05:00,63.62,63.76,63.55,63.71,8048560,10502307.55,67.07112498393192,55.65694617969717,NaN,NaN,187.44438601300243,84.69870587531027,0.06466432315089551,0.25192961955673354,0.18726529640583803,1100117169,1081275658.8,63.240452023477864,50.8699295248615,NaN,NaN,17.043879249564505,15.544140947847035
2020-01-17T09:30:00-05:00,63.7,63.96,63.62,63.82,14902841,10974245.7,68.27329680674511,55.67581032846987,NaN,NaN,185.50819834160032,125.50875220101554,0.08988309359067059,0.29961916339417627,0.20973606980350568,1115020010,1091784402.8,70.55815468413101,51.84715924453172,NaN,NaN,20.12636429505516,16.198744283162483
2020-01-21T09:30:00-05:00,63.73,64.07,63.51,64.04,11300540,11085866.3,70.58619017070272,56.49437686569474,NaN,NaN,173.93954323554001,151.98445256709948,0.11310567236933969,0.3511181602651803,0.2380124878958406,1126320550,1102628121.2,75.89137113123593,53.026260588949995,NaN,NaN,23.457786911235605,17.235750372887214
2020-01-22T09:30:00-05:00,64.06,64.24,64.04,64.09,8046512,10724663.4,71.10181431890484,57.27696888245238,NaN,NaN,180.73825192992638,175.21971545308483,0.1227529173791509,0.3914536346197792,0.26870071724062833,1134367062,1113578680,79.85912902584619,54.12259769379589,NaN,NaN,26.29321400748029,18.529673749257654
2020-01-23T09:30:00-05:00,63.88,64.2,63.64,64.03,14563298,11152501.25,69.5267445621042,58.73267928687884,NaN,NaN,128.92971729305398,171.3120193626246,0.1160859599068248,0.41380816712415935,0.29772220721733456,1119803764,1119125711,81.51841366679736,55.281188232786185,NaN,NaN,28.17036928247823,19.906915968289166
2020-01-24T09:30:00-05:00,64.08,64.16,63.39,63.59,11935126,11664252.9,59.17439261666138,59.58196416640051,NaN,NaN,82.89608773822611,150.40235970766935,0.07502777366951718,0.39150692430423106,0.3164791506347139,1107868638,1120676004.8,81.96559389326737,57.357758378237754,NaN,NaN,26.683694576480892,20.875027198030843
2020-01-27T09:30:00-05:00,63.05,63.69,63.01,63.39,8748391,11669744.95,55.15436510370873,59.95440496648935,NaN,NaN,33.7061514561942,120.04195033058814,0.02971140532262584,0.3536184072879962,0.32390700196537037,1099120247,1117496052.2,77.80693796277734,59.55973516048194,NaN,NaN,24.175975077161763,21.34659118076383
2020-01-28T09:30:00-05:00,63.43,63.6573,63.37,63.47,7899538,11548957.25,56.42943240555041,61.01325523302453,NaN,NaN,47.572542965126864,94.7685502765055,0.001902877400860259,0.3262855987164457,0.32438272131558543,1107019785,1113635899.2,72.9672440125303,61.92333021343325,NaN,NaN,22.50797294206757,21.51250286095008
2020-01-29T09:30:00-05:00,63.52,63.57,63.15,63.15,8300775,11652067.4,50.27220061514616,61.30157239139312,NaN,NaN,19.63675226901889,62.54825034432399,-0.03900570891017774,0.2756255851778633,0.314631294088041,1098719010,1106506288.8,64.93355990461964,64.03277557147989,NaN,NaN,19.107782870489352,21.168971433741405
2020-01-30T09:30:00-05:00,63.18,63.95,63.14,63.9,13824814,12094036.1,61.01026634373057,61.817641213457385,NaN,NaN,59.880060164214406,48.738318918556075,-0.017606860151098858,0.29262271889916747,0.3102295790502663,1112543824,1105054300.8,63.402558795476835,66.04842909163975,NaN,NaN,19.620604278527413,20.947776125853693
2020-01-31T09:30:00-05:00,63.93,64.21,63,63.18,15280045,12135002.35,49.87573289787187,61.59048468801921,NaN,NaN,31.730248721448024,38.50515111520046,-0.05204851741373295,0.2451689322831001,0.29721744969683306,1097263779,1102933329,61.13502918751631,67.4711171039972,NaN,NaN,15.776324942859432,20.208997385425942
2020-02-03T09:30:00-05:00,63.41,63.65,63.13,63.18,21797632,11905437.55,49.87573289787187,60.926742701313216,NaN,NaN,8.476290899649316,33.459179003891485,-0.07361708640631448,0.20519609168893993,0.2788131780952544,1097263779,1102562035.4,60.72559396137571,68.751718094628,NaN,NaN,12.95150498519601,19.172212756821665
2020-02-04T09:30:00-05:00,63.68,63.99,63.425,63.56,14290904,11492897.35,54.91243590209242,60.60295184873129,NaN,NaN,51.793989475299405,34.30346830592601,-0.06156789255559181,0.20185331240076465,0.26342120495635646,1111554683,1103469015,61.40555590982748,69.50154582926805,NaN,NaN,12.36869294229591,18.200281354746558
2020-02-05T09:30:00-05:00,63.77,64.095,63.69,64.07,20911423,11757972.45,60.63027524573417,60.27814320505404,NaN,NaN,93.6039367327848,49.09690519867919,-0.020642752913645868,0.2376177638142991,0.258260516727945,1132466106,1110218434.2,66.1080200442236,70.10840101450735,NaN,NaN,13.943623688967111,17.59218740249235
2020-02-06T09:30:00-05:00,64.14,64.52,64.01,64.18,9628492,11666827.55,61.75678955265999,59.898547817106056,NaN,NaN,136.7669918630331,64.47429153844294,0.010755890167006621,0.27170537943670325,0.26094948926969663,1142094598,1116128589,69.60086324667341,70.56271610187846,NaN,NaN,15.542913262608455,17.29943395393751
2020-02-07T09:30:00-05:00,64.18,64.39,63.99,64.26,14849207,12066563.1,62.59506212419364,59.49295962549523,NaN,NaN,123.95374218928299,82.91899023200992,0.03259849624395361,0.30169760957463865,0.26909911333068504,1156943805,1128064594.2,75.16702399765626,70.89192105284454,NaN,NaN,17.069507290341306,17.26658728770948
2020-02-10T09:30:00-05:00,64.29,64.65,64.27,64.53,7394081,12065724.9,65.35518031098552,59.119316064086846,NaN,NaN,166.524897818062,114.52871161569246,0.05935759551284503,0.34329610772174135,0.2839385122088963,1164337886,1141479415.6,79.67206150073542,71.16197036495166,NaN,NaN,19.232037638078666,17.54736590919079
2020-02-11T09:30:00-05:00,64.63,64.63,64.235,64.29,8375687,12003225.85,61.0432795224975,58.40084929291489,NaN,NaN,130.20841685234706,130.21159709110196,0.05511320475116743,0.35283001814785564,0.2977168133966882,1155962199,1150360918.8,82.00027012886603,71.31490901516736,NaN,NaN,19.686041388478817,17.852890977660508
2020-02-12T09:30:00-05:00,64.37,64.385,64.125,64.26,8479023,12051561.5,60.50589993734038,57.7565032482889,NaN,NaN,93.7094742639518,130.23270459733538,0.044935020312818985,0.3538855887877119,0.30895056847489294,1147483176,1153364332.8,82.72098095707253,71.40080667875843,NaN,NaN,19.889485042248303,18.143832986887336
2020-02-13T09:30:00-05:00,64.12,64.75,64.03,64.64,7950882,11826388.55,64.74010028878439,58.15405379629768,NaN,NaN,123.61141694449617,127.601589613628,0.05763403236605763,0.38099310893246496,0.32335907656640733,1155434058,1156032224.8,83.3584040032159,71.50029311518334,NaN,NaN,21.373338915273756,18.605190976656825
2020-02-14T09:30:00-05:00,64.71,64.81,64.58,64.79,5421252,11695023.15,66.27704129610257,58.948530667182965,NaN,NaN,149.69090844221049,132.7490228642135,0.06919690248334198,0.4098552046705848,0.3406583021872428,1160855310,1156814525.8,83.55003422441189,71.91051427672866,NaN,NaN,23.064856600171453,19.242286065730344
2020-02-18T09:30:00-05:00,64.7,64.84,64.43,64.56,6902340,11294998.1,61.8268898971811,59.334063345156586,NaN,NaN,112.29083255338668,121.90220981127842,0.05503309009903379,0.40944966481103506,0.3544165747120013,1153952970,1154737542.6,80.88691220853343,72.47620486215746,NaN,NaN,23.174759520887193,19.804067987895607
2020-02-19T09:30:00-05:00,64.57,64.74,64.46,64.49,4971272,10978534.7,60.49554686963428,60.06430236333431,NaN,NaN,92.08266029776225,114.27705850036148,0.035572176647613585,0.39888179552151826,0.36330961887390467,1148981698,1153341442.4,79.06266302675805,73.48542651373877,NaN,NaN,22.88145706282138,20.24369499859929
2020-02-20T09:30:00-05:00,64.38,64.59,63.94,64.54,13397700,11246094.1,61.13924237782002,60.07351493719784,NaN,NaN,54.983114233770436,106.5317864943252,0.02138835958202312,0.3900450683514336,0.3686567087694105,1162379398,1156320686.8,80.09436930061034,74.67769869267688,NaN,NaN,22.816295965313493,20.6112094224156
2020-02-21T09:30:00-05:00,64.36,64.79,64.34,64.65,10027832,11019320.8,62.583693027603665,60.98122637503583,NaN,NaN,82.79828660116156,98.3691604256583,0.015035974856087653,0.38745167733952,0.37241570248343236,1172407230,1159715321.2,81.229342665634,76.11300679825672,NaN,NaN,23.153102487883338,20.974337003196705
2020-02-24T09:30:00-05:00,63.77,64.26,63.085,63.16,19892660,11417197.5,40.58045410658742,60.31727788994408,NaN,NaN,-77.25184992288038,52.980608752640116,-0.08821734943167236,0.26214401569384194,0.3503613651255143,1152514570,1158047173.2,78.85010270601222,77.40761456573075,NaN,NaN,15.311028595856364,20.165292945005227
2020-02-25T09:30:00-05:00,63.2,63.505,61.805,62.02,25721459,12265850.9,31.465356062186856,58.64248647280797,NaN,NaN,-202.67269683216622,-10.012097124470454,-0.2242563479563665,0.0700409301800562,0.2942972781364227,1126793111,1152615201.4,71.5054377829382,78.12903469952438,NaN,NaN,4.323024026516791,17.90211167093545
2020-02-26T09:30:00-05:00,62.21,62.775,61.635,61.67,26066418,13174194.9,29.29008701528329,56.40390159920434,NaN,NaN,-212.18093093091855,-70.86481537020661,-0.3227863028369115,-0.1091856004097167,0.2136007024271948,1100726693,1142964200.4,60.689105982375445,77.74196940939237,NaN,NaN,-4.795573364504237,14.65958523730121
2020-02-27T09:30:00-05:00,61.12,61.67,59.15,59.16,39092321,14713772.2,19.095008939769983,53.356631555426475,NaN,NaN,-316.7609240032536,-145.2136230176114,-0.529751671353405,-0.4485888867645613,0.08116278458884357,1061634372,1122815195.2,45.286991858013955,76.00526431020239,NaN,NaN,-19.12140802896638,9.83372905640584
2020-02-28T09:30:00-05:00,57.81,58,56.04,57.99,50978903,16571476.65,16.254810811345706,50.046613604508764,NaN,NaN,-337.4919138711625,-229.27166311207625,-0.7071097090497254,-0.8027243517233131,-0.0956146426735878,1010655469,1090464843,31.475240710061613,72.88442264680278,NaN,NaN,-31.013701656349298,3.998381811726534
2020-03-02T09:30:00-05:00,58.11,61.135,58.11,61.09,27103055,17162627.15,41.20725222028704,48.32176159803031,NaN,NaN,-145.931393834123,-243.00757189432474,-0.5824999734090403,-0.8237396094348881,-0.24123963602584786,1037758524,1067513633.8,25.527024927108954,69.01692003440088,NaN,NaN,-27.463912039543324,-0.496231595597731
2020-03-03T09:30:00-05:00,61.18,62.2,59.82,60.26,35237524,17834621.75,37.947134758453444,46.67203697202716,NaN,NaN,-98.14782282204243,-222.1025970923,-0.5246307193151419,-0.8970280351697753,-0.3723973158546333,1002521000,1042659211.6,20.917029914037798,64.65383144762744,NaN,NaN,-26.744012044550242,-4.245914516876661
2020-03-04T09:30:00-05:00,61.11,63.25,61.03,63.22,26214329,18430793,52.40793796947538,46.093611117179655,NaN,NaN,-23.496326788458664,-184.365676263808,-0.26856202260063433,-0.7080998441054263,-0.4395378215047919,1028735329,1028260938.8,18.799024890844052,60.087977442896836,NaN,NaN,-18.620988668078358,-6.2994965384769035
2020-03-05T09:30:00-05:00,61.83,62.855,61.4,62.03,16556302,18213036.95,47.60483824168833,44.869663828101366,NaN,NaN,-35.69802629816801,-128.1530967227909,-0.16592049689733762,-0.6469384426264639,-0.4810179457291263,1012179027,1018369869.8,17.48891604689703,55.38301401744549,NaN,NaN,-15.372153925730563,-7.595590450941712
2020-03-06T09:30:00-05:00,60.39,61.89,59.94,61.54,24800220,18971623.35,45.745712641042985,43.40314035273997,NaN,NaN,-66.63279000377555,-73.98127194931354,-0.11977425694300503,-0.6307357669078826,-0.5109615099648775,987378807,1013714537.4,16.892222957334994,50.62174178408286,NaN,NaN,-13.941415853967598,-8.502136937088267
2020-03-09T09:30:00-04:00,58.14,60.495,58,58.86,19126264,19185476.2,37.19078436653719,41.64341852912254,NaN,NaN,-126.43215467422706,-70.08142411733435,-0.2509449237532819,-0.82464266465648,-0.573697740903198,968252543,999813341.2,15.222098612181853,45.93139795577203,NaN,NaN,-16.573409903662235,-9.655175932313119
2020-03-10T09:30:00-04:00,60.1,60.65,57.89,60.55,28174886,20224516.45,44.26864737757188,40.48435427968952,NaN,NaN,-93.83436442317266,-69.21873243756039,-0.2069230642954789,-0.8323515712725467,-0.6254285069770678,996427429,998594627,15.081320302192168,41.36130204687447,NaN,NaN,-15.499632365277613,-10.490098279879476
2020-03-11T09:30:00-04:00,59.05,59.36,56.87,57.58,17760940,20693779.1,36.48700264944542,38.72348001337705,NaN,NaN,-135.76894456846165,-91.673255993561,-0.35232031590208945,-1.0658289018546796,-0.7135085859525901,978666489,988580859,13.940493533828231,36.63602520639004,NaN,NaN,-18.086913787688154,-11.575357638137858
2020-03-12T09:30:00-04:00,53.89,56.71,51.91,52.17,26713965,21605526.2,27.13138266808909,36.19117213055458,NaN,NaN,-222.40092927668078,-129.01383658926355,-0.7637319229271771,-1.6681734896115614,-0.9044415666843844,951952524,976535558.4,12.696366856809647,31.740812648616867,NaN,NaN,-24.9300696177039,-13.483173635218721
2020-03-13T09:30:00-04:00,54.77,56.63,52.76,56.61,24835777,22449770.95,40.59414107890353,36.1921497714343,NaN,NaN,-149.8650823447766,-145.66029505746374,-0.6899646099649819,-1.7668973291406118,-1.07693271917563,976788301,974417457.2,12.485357753831337,27.000473723461088,NaN,NaN,-23.444079615442774,-14.906160203822157
2020-03-16T09:30:00-04:00,51.35,55.565,50.78,52.77,27436811,23550548.9,34.634321118309,36.418504418300174,NaN,NaN,-177.649053828952,-155.90367488840872,-0.8428012413712511,-2.130434270889694,-1.2876330295184428,949351490,970637246.6,12.098883130226454,22.757148391124534,NaN,NaN,-25.23040686045513,-16.38105258334115
2020-03-17T09:30:00-04:00,53.79,57.45,53.67,57.22,32318054,24821334.6,44.7563115225106,37.52323474024497,NaN,NaN,-93.02986830030973,-155.74277566383614,-0.5986875387321926,-2.0359924529336837,-1.437304914201491,981669544,967685669.6,11.791960567838032,19.264495147228995,NaN,NaN,-21.744975692982376,-17.1473273132899
2020-03-18T09:30:00-04:00,54.75,57,53.3,55.75,35524853,26349013.65,42.41949993848748,39.18926981158194,NaN,NaN,-97.99839840773548,-148.18866643169093,-0.49500594038828427,-2.0560623396868465,-1.5610563992985622,946144691,961181310,11.122360323119722,16.824164323307983,NaN,NaN,-20.340419680299238,-17.603483365719804
2020-03-19T09:30:00-04:00,55.16,55.44,53.39,53.89,26808121,27019534.7,39.60198240036946,40.85692492508364,NaN,NaN,-108.92082091497123,-125.49264475934902,-0.5085402953268632,-2.1967317684571412,-1.688191473130278,919336570,954658119.2,10.479648174006101,15.324479142161158,NaN,NaN,-20.441533397239606,-18.008919084508346
2020-03-20T09:30:00-04:00,54.04,54.06,49.955,50.4,26903720,27863329.1,34.91578993320219,40.407534761720434,NaN,NaN,-148.37374398129631,-125.19437708665296,-0.6976975715047984,-2.560313437511276,-1.8626158660064775,892432850,937787029,9.026797445886103,14.145891464930953,NaN,NaN,-22.39465892194612,-18.635453346999455
2020-03-23T09:30:00-04:00,50.01,50.6,47.66,48.63,31822218,28459807,32.79616609493921,40.039608428612276,NaN,NaN,-173.0465276068317,-124.27387184222889,-0.8756593796878134,-2.957190090616244,-2.0815307109284307,860610632,920038857.4,7.801485290482503,13.20906684896272,NaN,NaN,-24.674913860857696,-19.498233420407775
2020-03-24T09:30:00-04:00,50.75,51.4,49.8,51.11,28041782,28575823.15,38.43553054481066,39.04157932685051,NaN,NaN,-120.74194039693225,-129.81628626155342,-0.7640541572919082,-3.036598407543316,-2.272544250251408,888652414,901435431.4,6.7649137027427315,12.349487478384052,NaN,NaN,-24.406929704350773,-20.199475746685348
2020-03-25T09:30:00-04:00,51,52.61,50.08,50.97,25526399,28548822.2,38.24044723578441,38.37269425500023,NaN,NaN,-100.47462750005762,-130.31153208001783,-0.6422653053771619,-3.0753758819728603,-2.4331105765956984,863126015,884831696.2,5.998814531701257,11.528765941584355,NaN,NaN,-24.271803104669655,-20.78123679782596
2020-03-26T09:30:00-04:00,51.59,54.12,51.38,53.76,25754058,27881909.05,44.307084619153954,38.26993511057959,NaN,NaN,-59.27060007488006,-120.3814879119996,-0.33202831709997715,-2.84814597297067,-2.516117655870693,888880073,878740396.8,5.741912163625983,10.732315170605139,NaN,NaN,-22.100585888712974,-20.969715239381248
2020-03-27T09:30:00-04:00,52.59,54.99,52.5,53.51,26004756,26633201.7,43.891039672176625,38.748524775268116,NaN,NaN,-44.161708978813245,-99.53908091150298,-0.11318776167431777,-2.65760235796359,-2.5444145962892724,862875317,872828890.2,5.495922863419594,10.037588331407834,NaN,NaN,-20.5476731955022,-20.909423518827097
2020-03-30T09:30:00-04:00,54.03,55.76,54.03,55.6,15892759,26072686.9,48.26469961306728,39.03395707780351,NaN,NaN,-12.63805648539645,-67.45738668721594,0.18648660788857718,-2.311306336428551,-2.497792944317128,878768076,876460379,8.10053971964274,9.538961146940014,NaN,NaN,-17.855958125054602,-20.4732141768596
2020-03-31T09:30:00-04:00,55.4,55.665,54.335,54.47,15203395,25070980.45,46.16922586312328,39.725544450209064,NaN,NaN,-14.07124989470232,-46.123248586769954,0.3151987023059646,-2.103794566434672,-2.418993268740637,863564681,871442832.4,7.781427125184095,9.099027832036864,NaN,NaN,-16.289621015873436,-19.875558011004433
2020-04-01T09:30:00-04:00,52.99,54.38,52.86,53.55,11979962,24359262.1,44.476159567745384,40.9644570858988,NaN,NaN,-35.46139089625972,-33.120601266010375,0.3426909618768046,-1.990629566394631,-2.3333205282714355,851584719,869134573.2,7.6324660783227785,8.737320633573516,NaN,NaN,-15.500638667105957,-19.25056953330465
2020-04-02T09:30:00-04:00,52.81,55.23,52.68,54.92,14748132,24268853.6,47.56006424475829,41.462023026317,NaN,NaN,-10.181790046216086,-23.302839260277572,0.45066078836546763,-1.769994542814601,-2.2206553311800685,866332851,864625128.8,7.336968935339939,8.369578575109845,NaN,NaN,-13.93032346207979,-18.490534380272525
2020-04-03T09:30:00-04:00,54.7,55.515,54.465,55.35,15374067,23797545.95,48.52642296398017,42.45431601529351,NaN,NaN,26.541486430572622,-9.1622001784004,0.5423966868878489,-1.5426594725702572,-2.085056159458106,881706918,868391449,10.455195606403038,8.252172323408171,NaN,NaN,-12.367786054065725,-17.61585604795727
2020-04-06T09:30:00-04:00,56.73,57.81,55.92,57.41,14835521,23583008.8,52.995323933390125,43.042816901784896,NaN,NaN,101.19474313022886,13.60435974472467,0.7219350867353007,-1.1826373010389801,-1.9045723877742808,896542439,871946321.6,13.416795065493758,8.368231930383581,NaN,NaN,-9.696290447840482,-16.48448953365487
2020-04-07T09:30:00-04:00,58.3,58.76,56.74,56.75,22985560,23323542.5,51.45398966301374,43.68813759639392,NaN,NaN,125.4631210247481,41.51123392861475,0.7718652121238683,-0.9397408726194456,-1.7116060847433139,873556879,873944761.2,15.116451435158297,8.65352415267205,NaN,NaN,-7.898193516336183,-15.257875816895057
2020-04-08T09:30:00-04:00,57.17,57.91,56.53,57.59,13877581,23129374.55,53.31503253534764,44.66764117746379,NaN,NaN,125.71663360361775,73.74683882859026,0.8319092211084391,-0.6717195583577649,-1.503628779466204,887434460,881114709.4,21.100708569920386,9.412171323808787,NaN,NaN,-5.860112145117884,-13.915338149498318
2020-04-09T09:30:00-04:00,57.75,59.02,57.61,58.13,20376084,22812480.5,54.52202107676749,46.06808625914702,NaN,NaN,139.78303922438195,103.73980468270986,0.8741034216853674,-0.4109995023594948,-1.2851029240448621,907810544,889410248,27.47170607160696,10.72966479707456,NaN,NaN,-3.8158163366522326,-12.472549319091735
2020-04-13T09:30:00-04:00,57.94,58.24,57.14,57.7,10679473,22104665.3,53.33943202871213,47.53546239727366,NaN,NaN,108.89723265192795,120.21095392698093,0.8390024260296898,-0.23634989150775,-1.0753523175374398,897131071,892495078.6,29.743618183954,12.296960003751096,NaN,NaN,-2.391006848521932,-11.032328966153191
2020-04-14T09:30:00-04:00,58.69,60.22,58.46,60.15,17760368,21620843.15,58.82005560246486,48.99149990139182,NaN,NaN,150.13611574287384,129.99922844950993,0.9391769665793299,0.0986188906867227,-0.8405580758926072,914891439,896164878.6,32.454293933357334,14.131915734509281,NaN,NaN,0.4626566154267426,-9.39018816878463
2020-04-15T09:30:00-04:00,59.35,59.72,58.7601,59.2,12553358,20632608.35,56.069932157814385,50.26503453867968,NaN,NaN,124.80756071187429,129.86811638693516,0.8997676462907789,0.28415148197086637,-0.6156161643199125,902338081,901921119,36.58714993367429,16.316796834650212,NaN,NaN,2.1475649740320923,-7.741937719810812
2020-04-16T09:30:00-04:00,59.51,59.81,58.75,59.59,14486100,19580670.7,56.95960170349248,51.168785758989564,NaN,NaN,113.53189749118842,127.43116916444929,0.858400684953434,0.45738469187188,-0.401015993081554,916824181,907799063.2,40.5849426078299,18.80558472352192,NaN,NaN,3.8008088934327193,-6.092973917918879
2020-04-17T09:30:00-04:00,60.32,60.7,59.51,60.5,12083083,18844418.8,59.043840815704,52.25112869781295,NaN,NaN,117.01271147483516,122.87710361453992,0.8492039529890547,0.6604889481547644,-0.1887150048342903,928907264,912018407.2,43.34601393116488,21.509162656932297,NaN,NaN,5.793367069347587,-4.394925205452242
2020-04-20T09:30:00-04:00,59.9,60.3199,59.26,59.31,9264086,17962437.1,55.27432995477234,52.751816579363314,NaN,NaN,91.93308774684596,119.48427463352354,0.7247004038389354,0.717160499964379,-0.007539903874556414,919643178,916520828.6,46.21813568188791,24.231848082806952,NaN,NaN,6.524957144105273,-2.834942012658311
2020-04-21T09:30:00-04:00,58.47,58.805,57.84,58.05,13021939,17022423.15,51.52352699562342,53.13426666025618,NaN,NaN,52.03318400753122,99.86368828645502,0.5283324820404555,0.6528756986760129,0.12454321663555745,906621239,914866788.6,45.30938429528583,26.912416452099933,NaN,NaN,6.13226507950885,-1.5539124280630026
2020-04-22T09:30:00-04:00,58.75,58.94,58.14,58.61,15086941,16374681.1,53.04846682244484,53.74657432130614,NaN,NaN,55.86408783050133,86.07499371018041,0.41215926620443577,0.6397422993911022,0.2275830331866664,921708180,918740808.4,47.89357438888334,29.78820990285426,NaN,NaN,6.207015119690236,-0.4452084926696829
2020-04-23T09:30:00-04:00,58.47,58.845,57.99,58.09,21074219,16152072.1,51.43059814176458,54.02304102823517,NaN,NaN,43.57595926842641,72.08380606562801,0.28247805911530754,0.5806806070808008,0.2982025479654933,900633961,915502764.4,45.93966222968041,32.54554513816429,NaN,NaN,5.839743564605318,0.4526418012267458
2020-04-24T09:30:00-04:00,58.43,58.9,58.23,58.71,9638607,15346299.55,53.260904401189215,54.36121827375009,NaN,NaN,49.70994071873972,58.623251914408925,0.22323672008163414,0.577248448067536,0.3540117279859018,910272568,911775825.2,43.7283739757865,34.9222007359774,NaN,NaN,5.999749778764669,1.2450857980178776
2020-04-27T09:30:00-04:00,59.07,59.15,58.65,58.88,11024012,14597262.35,53.7752763174179,54.41692915832351,NaN,NaN,55.82493570013265,51.40162150506626,0.1820245042227589,0.5815423582643504,0.3995178540415915,921296580,912106505.6,43.986003098170045,37.10571559545428,NaN,NaN,6.265558081774978,1.9622961242688919
2020-04-28T09:30:00-04:00,59.56,59.64,58.96,59.21,13608999,14483074.35,54.814819811358376,54.65698845463384,NaN,NaN,66.81278702212892,54.35754210798579,0.16406896148890204,0.604604055902719,0.440535094413817,934905579,917763373.6,48.34299715898641,39.47904029001342,NaN,NaN,6.7537884912802975,2.6467950338419497
2020-04-29T09:30:00-04:00,59.51,59.51,58.4,58.96,16038644,14524836.8,53.8272198988385,54.69357326631176,NaN,NaN,48.44956418613744,52.87463737911302,0.12424331876819739,0.5958392428740638,0.47159592410586637,918866935,917195124.6,47.93960064999676,41.39610401001888,NaN,NaN,6.932503294668371,3.259039071102867
2020-04-30T09:30:00-04:00,58.79,58.82,57.92,58.26,16397060,14745691.7,51.05356853974353,54.44582665652433,NaN,NaN,7.253091350611839,45.610063795550104,0.043796522696888385,0.5263415774769769,0.48254505478008847,902469875,917562307.4,48.24015282913757,42.879564492699636,NaN,NaN,6.3986634723496225,3.7075568427095464
2020-05-01T09:30:00-04:00,57.94,58.43,57.38,57.62,13023683,14659469.25,48.58838638880915,54.10646625367412,NaN,NaN,-46.44624826766526,26.37882599826911,-0.05416443265527171,0.41483951396099883,0.46900394661627054,889446192,913397032.2,45.06204015117183,43.97373749035806,NaN,NaN,5.300413682583472,3.935107819834393
2020-05-04T09:30:00-04:00,57.51,57.72,57.02,57.59,11314423,14456487.05,48.47023902485768,53.3671936409879,NaN,NaN,-98.352869072238,-4.45673495620502,-0.11891542195951532,0.3203596691668764,0.43927509112639174,878131769,904764070,39.28519935210198,44.46165930598267,NaN,NaN,4.334562127699684,3.9921727209580062
2020-05-05T09:30:00-04:00,57.82,58.255,57.565,57.64,9705173,14199969.65,48.69415846944546,52.84035266324726,NaN,NaN,-71.06902969976109,-32.03309830058303,-0.15408024866744202,0.24667478029208922,0.40075502895953125,887836942,895350342.6,34.1448645629507,44.28721035093099,NaN,NaN,3.5545626028996677,3.929656989806815
2020-05-06T09:30:00-04:00,57.74,57.9,56.96,57.01,10700161,13585699.7,45.98281543358732,52.056296501111184,NaN,NaN,-120.80827519845516,-65.88466617750154,-0.21190247485813624,0.13587693538686096,0.3477794102449972,877136781,887004311.8,30.352889027820197,43.55634938093029,NaN,NaN,2.185871681760239,3.6805448029430186
2020-05-07T09:30:00-04:00,57.45,57.53,56.73,56.85,11203696,13452005.45,45.293047091190154,51.07409694936019,NaN,NaN,-140.59778771475177,-95.45484199057427,-0.25041751285627434,0.034757519174654306,0.28517503203092864,865933085,879696953.8,27.475786429625217,42.4227617022489,NaN,NaN,0.8275786729824977,3.2729782129486584
2020-05-08T09:30:00-04:00,57.42,58.24,57.39,58.12,13405116,13103457.05,51.51064367319939,50.80526221496212,NaN,NaN,-54.86590038313747,-97.1387724136687,-0.18298214597745135,0.05644734955911446,0.2394294955365658,879338201,877675355.6,26.721163799007584,41.03012085347173,NaN,NaN,1.1221381223577997,2.96571534286425
2020-05-11T09:30:00-04:00,57.86,58.49,57.8013,58.04,8807213,13009844.05,51.11653826164973,50.77619159110686,NaN,NaN,-40.12005103115185,-85.49220880545148,-0.1384109841153218,0.06641576539241356,0.20482674950773536,870530988,876155199.4,26.139784253079824,39.660863707599866,NaN,NaN,1.2748239758417885,2.724159433289613
2020-05-12T09:30:00-04:00,58.23,58.55,57.55,57.55,20587312,13151191.25,48.66078188287767,50.46278552399492,NaN,NaN,-55.81610034120053,-82.44162293373937,-0.1363569324943375,0.034380583889813465,0.17073751638415097,849943676,868576546.2,23.40568521886891,37.91172876688456,NaN,NaN,0.7905783863736188,2.447933569444471
2020-05-13T09:30:00-04:00,57.5,57.82,56.69,57.03,12186849,13132865.8,46.12809604216884,50.08403537402379,NaN,NaN,-114.5619444627343,-81.1923567865952,-0.16266320354253067,-0.03259148804401235,0.13007171549851831,837756827,860700555.4,20.95292673535242,36.12696194586113,NaN,NaN,-0.2896632049242228,2.056848315963229
2020-05-14T09:30:00-04:00,56.75,57.035,55.985,56.89,11793811,12998251.35,45.44233586408812,49.52556619280228,NaN,NaN,-150.64200572268916,-83.20120038818268,-0.1807447026166486,-0.09585916277229245,0.08488553984435615,825963016,852706541.6,18.799526686198107,34.346329996604815,NaN,NaN,-1.3910686926566873,1.5642887433032409
2020-05-15T09:30:00-04:00,56.88,57.56,56.675,57.39,20847888,13436491.6,48.393142807163926,49.141128084927,NaN,NaN,-89.1772343709159,-90.06346718573836,-0.1514679533165395,-0.10444940180131823,0.047018551515221274,846810904,846201082.2,17.246172439989095,32.43634209244903,NaN,NaN,-1.6306221248406538,1.1078729049969702
2020-05-18T09:30:00-04:00,58.3,58.6,57.88,58.3,15214100,13733992.3,53.33955162666166,49.03575178602009,NaN,NaN,32.01860978467491,-75.63573502257302,-0.06753223872337824,-0.03739674688900152,0.030135491834376714,862025004,844499885.4,16.853990484388063,30.187127329977724,NaN,NaN,-0.5285766414706894,0.8740943983587331
2020-05-19T09:30:00-04:00,58.38,58.41,57.23,57.23,15313175,13848554.1,47.56643574721024,48.58855291804665,NaN,NaN,-39.20739004596847,-72.3139929635266,-0.07994244718737875,-0.06979256714984672,0.010149880037532026,846711829,843853516,16.698613669234845,27.955628259923298,NaN,NaN,-1.1438613521837626,0.5858150054240909
2020-05-20T09:30:00-04:00,57.71,57.94,57.36,57.91,8519553,13520184.7,51.18257851982892,48.597767916624164,NaN,NaN,-22.149337308645435,-53.83147153270884,-0.04022673336957689,-0.040133536674439085,0.00009319669513780347,855231382,847348427,20.94252615552581,26.005797783236748,NaN,NaN,-0.6454158746891724,0.4099248796936248
2020-05-21T09:30:00-04:00,57.82,57.83,57.15,57.27,13913917,13162169.6,47.838550230675764,48.54420819104322,NaN,NaN,-56.31426212705982,-34.96592281358297,-0.054069096034838324,-0.0674931733484101,-0.013424077313571776,841317465,850419316.8,24.578511184105565,24.54268857130344,NaN,NaN,-1.1780882543155442,0.1830658605494578
2020-05-22T09:30:00-04:00,57.29,57.52,57.16,57.47,7216407,13041059.6,48.96079195987252,48.57924768640142,NaN,NaN,-55.29058773232057,-28.18859348586391,-0.04702491190923962,-0.0722052172001213,-0.02518030529088168,848533872,850763910.4,24.99537562652101,23.52198687661909,NaN,NaN,-1.309207713482929,-0.03011607859802598
2020-05-26T09:30:00-04:00,58.28,58.38,57.665,57.78,10487156,13014216.8,50.73022337888418,48.72468089421847,NaN,NaN,25.506901130361783,-29.49093521672653,-0.020131590360255903,-0.05034479324120156,-0.030213202880945655,859021028,850163115.2,24.738643882775932,22.85011397089232,NaN,NaN,-0.9342137773672089,-0.15927289270790923
2020-05-27T09:30:00-04:00,58.24,58.7,57.91,58.65,10937852,12880659.45,55.4030260472085,49.3975530809057,NaN,NaN,109.36579810912808,0.22370241429277654,0.05357676933383147,0.036757758786343686,-0.016819010547487787,869958880,854812525.4,30.67306040345686,22.872983354866367,NaN,NaN,0.745304827093366,-0.030047504164869926
2020-05-28T09:30:00-04:00,59.1,59.495,58.85,59.17,10184564,12587955.45,57.968905904431196,50.30297156756577,NaN,NaN,220.18797587691438,48.69116505140474,0.1303056793358519,0.1460630886223271,0.01575740928647519,880143444,859794937.8,36.45549192767853,23.514390890441604,NaN,NaN,2.933682846455667,0.39334254592377815
2020-05-29T09:30:00-04:00,58.99,59.42,58.46,59.23,12891046,12412654.75,58.26726573788025,50.78558742932869,NaN,NaN,179.90250050449828,95.93451757771636,0.1752524371448178,0.23482295571749745,0.05957051857267965,893034490,870138342.8,46.442536957321714,24.923060401749755,NaN,NaN,4.825812858305742,1.026552590549773
2020-06-01T09:30:00-04:00,59.26,59.86,59.2287,59.64,9101497,12216545.45,60.33907508742795,51.44434005974142,NaN,NaN,204.03229390416354,147.7990939050132,0.21985932094845365,0.3343946697582467,0.11453534880979307,902135987,880858765.8,54.43567012765591,26.944195107076617,NaN,NaN,7.038766055610492,1.88544022841559
2020-06-02T09:30:00-04:00,59.74,59.83,59.34,59.8,9827924,12142220.5,61.149641837781736,52.336401485091706,NaN,NaN,174.1506754698806,177.52784877291694,0.24545929193180493,0.42135946372454924,0.1759001717927443,911963911,891447342.4,60.677953856277036,29.606500009748626,NaN,NaN,9.131292463700849,2.920561976313484
2020-06-03T09:30:00-04:00,60.06,60.16,59.86,59.88,10155277,12164725.7,61.57252701294448,53.439575125861396,NaN,NaN,165.76233609009213,188.80715636910978,0.2521392409205615,0.49107422294344616,0.23893498202288468,922119188,901879404,65.66830400434173,32.80045552896216,NaN,NaN,11.013930553900925,4.076757487397404
2020-06-04T09:30:00-04:00,59.76,60.07,59.27,59.59,8973812,12078408.25,59.06275745690613,54.412462382491256,NaN,NaN,118.00398196611326,168.37035758694952,0.2224231007556498,0.5169638579674469,0.2945407572117971,913145376,908479790.4,68.40077316023927,36.34340170567938,NaN,NaN,12.016534701432196,5.21101137511666
2020-06-05T09:30:00-04:00,60.03,60.73,59.86,60.42,11502499,12093348.4,63.63187712401128,55.50094340512321,NaN,NaN,147.32982126105566,161.855821738261,0.2424212024272675,0.5975672602458815,0.35514605781861397,924647875,914802467.4,70.79840706560616,40.16856132179488,NaN,NaN,14.207455451590272,6.496217671755747
2020-06-08T09:30:00-04:00,60.43,61.1,60.22,61.07,13094203,12077802.75,66.76073150819943,56.459599110947316,NaN,NaN,150.2969521921741,151.10875339586312,0.28049118777791004,0.7057600425410016,0.4252688547630915,937742078,921923685.6,73.25942685947275,44.19752106287236,NaN,NaN,17.059340613572278,8.005235234872394
2020-06-09T09:30:00-04:00,60.84,60.93,60.2,60.57,13735357,12324209.95,62.31924850315288,57.51337145065751,NaN,NaN,116.24143497967341,139.52690529782166,0.25386297862344653,0.7425975780423997,0.48873459941895314,924006721,924332247.6,74.05583640850817,48.29446554424903,NaN,NaN,18.26748899858546,9.471271486831403
2020-06-10T09:30:00-04:00,60.71,60.88,60.28,60.4,9877863,11788737.5,60.83727555733568,58.20299266762227,NaN,NaN,100.35585570868263,126.44560922153978,0.2085603132707614,0.749434991007405,0.5408746777366435,914128858,922734181.6,72.51271019275835,51.97805011833707,NaN,NaN,18.86461440931342,10.813177618614548
2020-06-11T09:30:00-04:00,59.75,60.12,58.04,58.11,14738743,11916332.2,45.23297078151319,58.016879849824946,NaN,NaN,-4.633407296061829,101.91813136910477,0.018158902699453527,0.5635733061109605,0.5454144034115069,899390115,919983129.4,69.81569121187222,55.20927726317755,NaN,NaN,14.120925636357775,11.285713049720723
2020-06-12T09:30:00-04:00,58.91,58.92,57.615,58.12,17837453,12218514.3,45.29895187611462,57.75531984384224,NaN,NaN,-45.53467709148486,63.34523169859669,-0.10646719481130229,0.412330409897379,0.5187976047086813,917227568,918499068,68.33904487642789,58.305253638170896,NaN,NaN,10.461917591550472,11.16802798426783
2020-06-15T09:30:00-04:00,57.58,58.87,57.19,58.79,11366695,11744454.65,49.67371637583015,57.67985505790981,NaN,NaN,-47.30002293721982,23.82583667271791,-0.14097117601616044,0.34258363468848074,0.4835548107046412,928594263,916669505,66.47246986094083,61.28624120803982,NaN,NaN,8.729623999877735,10.819684557926388
2020-06-16T09:30:00-04:00,59.95,60.02,58.94,59.71,10840342,11525766.75,54.996107848394274,57.650789472280216,NaN,NaN,36.95641704059506,7.968833084902239,-0.10090388718603704,0.3574249517220949,0.4583288389081319,939434605,919755081.8,68.05708835056902,63.956528918547825,NaN,NaN,8.960022935091905,10.554018611807177
2020-06-17T09:30:00-04:00,59.82,60.07,59.44,59.62,8388420,11179529,54.390109759610695,57.39516117622161,NaN,NaN,42.5219002945552,-3.5979579979232397,-0.08042302455827566,0.3578000582102874,0.43822308276856303,931046185,923138547.2,69.7456651920347,66.33439843743041,NaN,NaN,8.955796063214356,10.325701104865345
2020-06-18T09:30:00-04:00,59.35,59.99,59.2731,59.93,6022734,11054688.05,56.18114524291277,57.246152569438216,NaN,NaN,39.03206883117941,5.135137227525011,-0.0475818292160487,0.37874579624850213,0.42632762546455083,937068919,930674308,73.15005844740722,68.24207854386509,NaN,NaN,9.488306646139568,10.206073325047377
2020-06-19T09:30:00-04:00,60.48,60.67,59.525,59.62,10777649,10897874.65,53.9016841635944,56.78633893202153,NaN,NaN,50.20508836960342,24.283090319742666,-0.04817350946853399,0.3661107386288833,0.4142842480974173,926291270,932487048.4,73.91057694316534,69.63314331640149,NaN,NaN,9.265622877008804,10.071723261041868
2020-06-22T09:30:00-04:00,59.1,59.22,58.78,58.99,9039672,10989037.9,49.505660779724884,55.95462599930318,NaN,NaN,-44.20166930830489,24.902761045525654,-0.0900011068338818,0.3017828645550651,0.3917839713889469,917251598,930218515.4,71.19290324975393,70.38421113022126,NaN,NaN,7.756586432970594,9.740989428460257
2020-06-23T09:30:00-04:00,59.38,59.59,58.84,58.9,7950967,10862228.45,48.892204074005384,55.04888864652181,NaN,NaN,-43.26460389515233,8.858556858376174,-0.12081523721302045,0.24076492487267132,0.36158016208569177,909300631,924191720.6,64.41629405308174,70.2947818479884,NaN,NaN,6.345876420944069,9.255973284529372
2020-06-24T09:30:00-04:00,58.6,58.6,57.7,57.91,14343242,11032497.95,42.633839349022104,53.87539449595867,NaN,NaN,-151.50845389375777,-29.94751397928642,-0.200271547290985,0.1112407279719605,0.3115122752629455,894957389,916973961.4,57.372882368256164,69.50707536284675,NaN,NaN,3.1371695041485466,8.381858458760682
2020-06-25T09:30:00-04:00,57.88,58.39,57.52,58.32,12128869,11129713.2,45.73196275923638,52.59682918418904,NaN,NaN,-131.06103388427172,-63.96613452237665,-0.21624941346716764,0.04120050842898593,0.25744992189615357,907086258,910977429.2,52.260285172255685,68.182923799036,NaN,NaN,1.3608366865274677,7.378855348441651
2020-06-26T09:30:00-04:00,58.3,58.46,57.08,57.13,14476538,11208987.8,39.12704041883949,50.62299410637761,NaN,NaN,-154.38376700411968,-104.88390559712127,-0.2932180205926159,-0.10907260384461637,0.18414541674799956,892609720,904241119.2,47.174597450259164,66.31972169837789,NaN,NaN,-2.4095652735274027,5.980509545303215
2020-06-29T09:30:00-04:00,57.5,58.32,57.45,58.21,9654292,11236627.55,46.65691102005961,49.50425571472808,NaN,NaN,-101.58137380721145,-116.35984649690258,-0.25884522094101275,-0.1394111094282664,0.11943411151274637,902264012,901243602,45.07268026522965,64.24949625957228,NaN,NaN,-3.1847195670221957,4.671191100685299
2020-06-30T09:30:00-04:00,58.22,58.855,58.13,58.64,7379844,11114223.55,49.343655269220406,48.68328283700557,NaN,NaN,-52.579269125611965,-118.22277954299452,-0.1973791843831014,-0.12728986896613037,0.07008931541697103,909643856,901312247,45.132971024187995,62.293800604674395,NaN,NaN,-2.9336565372497048,3.5847842952660125
2020-07-01T09:30:00-04:00,58.75,59.055,58.655,58.69,7261597,10969539.55,49.66115084761146,48.999581413155454,NaN,NaN,-28.725250459077294,-93.66613885605841,-0.14595462818351662,-0.11235396981242474,0.03360065837109187,916905453,905701859.8,48.98889995024401,60.80617265741524,NaN,NaN,-2.6379977776241343,2.6958154277102775
2020-07-02T09:30:00-04:00,59.18,59.5708,58.87,58.99,6857203,10863709.1,51.620453643857246,49.4511172537085,NaN,NaN,0.6970476916893764,-67.3145225408662,-0.08723256147212564,-0.07544004346906519,0.011792518003060456,923762656,909037139.4,51.76279743556212,59.62215498306768,NaN,NaN,-1.8079273220421854,2.0524236063170687
2020-07-06T09:30:00-04:00,59.44,59.58,58.95,59.28,10091331,10793150.7,53.5044126168791,49.72473841378343,NaN,NaN,16.672388474586803,-33.103291445124896,-0.02745422030408643,-0.02252525737704758,0.004928962927038849,933853987,917285992.8,57.865345103365385,59.00736035752658,NaN,NaN,-0.5634944752722795,1.678721023232876
2020-07-07T09:30:00-04:00,58.96,60.145,58.92,59.82,8160996,10546490.35,56.87221966339289,49.85874640056904,NaN,NaN,58.105508850042185,-1.1659149136741747,0.04586948348280672,0.06226581728054725,0.016396333797740532,942014983,925236187,62.75587260651351,58.62870209009405,NaN,NaN,1.5100943301612395,1.6546314956512136
2020-07-08T09:30:00-04:00,59.95,59.99,59.415,59.67,9327862,10326115.6,55.66605095298844,49.94988505723888,NaN,NaN,72.80163097357476,23.91026510616316,0.07970067456223218,0.11602217700053075,0.03632150243829858,932687121,929844840,65.27223969118737,58.30917169717638,NaN,NaN,2.887307993092084,1.8307281381427665
2020-07-09T09:30:00-04:00,59.59,59.75,58.86,59.2,7672545,10215849.7,51.94837822467649,49.64754455593629,NaN,NaN,39.48431354064141,37.552177906106905,0.06640193045319015,0.11932391550478627,0.05292198505159612,925014576,931466664.6,66.13925595882608,57.808400090849155,NaN,NaN,3.029207511362494,2.0019394771741563
2020-07-10T09:30:00-04:00,59.27,60.41,59.26,60.29,14142787,10186051.9,58.81757533873955,49.99867963987524,NaN,NaN,106.85200771412651,58.78316991059434,0.12366441029224204,0.20750249791689868,0.08383808762465664,939157363,934545606,67.78366129143784,57.3707632585829,NaN,NaN,5.286107764845041,2.471106375412854
2020-07-13T09:30:00-04:00,60.58,60.995,59.97,60.2,10906172,9839487.85,58.07929725460156,50.61108224522358,NaN,NaN,135.98943592788328,82.64657940125363,0.14656480497832786,0.26704409384756644,0.1204792888692386,928251191,933425046.8,66.51756485327883,57.036810515977535,NaN,NaN,6.894603975728492,3.1030346040293737
2020-07-14T09:30:00-04:00,60.03,61.23,59.91,61.08,14267161,9984511.15,62.97318557692844,51.6168666382895,NaN,NaN,154.51839272836813,101.92915617691882,0.20829631692976894,0.3808496850314498,0.17255336810168084,942518352,933525720.6,66.57796541637575,57.19121561335568,NaN,NaN,9.856745904271943,4.067850504064026
2020-07-15T09:30:00-04:00,61.39,61.86,60.94,61.13,14951357,10190061.9,63.235802438516664,53.08843543039626,NaN,NaN,180.18428204180123,123.40568639056411,0.23768694262744286,0.4696620463859844,0.23197510375854155,957469709,938482238.2,69.49560254141586,58.0571241971528,NaN,NaN,12.318677302131476,5.24654004664509
2020-07-16T09:30:00-04:00,61.1,61.38,60.975,61.26,7770231,10159152.45,63.95169708166653,54.38984502485555,NaN,NaN,147.7705258437319,145.06292885118222,0.24982989868760375,0.5442624771180462,0.29443257843044246,965239940,946527311,73.53412625781546,59.57668427469279,NaN,NaN,14.559400780366799,6.576948722891048
2020-07-17T09:30:00-04:00,61.54,61.69,61.325,61.59,6321685,10174100,65.77366087226471,56.29317505724306,NaN,NaN,149.2016947031406,153.53286624898502,0.26271991562893166,0.622832472966607,0.3601125573376754,971561625,953008163.4,76.26068695236647,61.65426209627187,NaN,NaN,16.99710094624591,8.06554189765603
2020-07-20T09:30:00-04:00,61.46,61.49,60.78,60.97,6818583,9976146.7,59.671491675129545,57.22278796117663,NaN,NaN,105.20084520983127,147.37514810537462,0.21417688741251778,0.6278336666033226,0.41365677919080485,964743042,960306533.6,78.89729461849798,64.07030597864818,NaN,NaN,17.412380398607205,9.400804540649053
2020-07-21T09:30:00-04:00,61.4,62.1572,61.33,61.5,7847604,9916543.3,62.84485672549489,58.18715949376766,NaN,NaN,124.937177012128,141.4589049621266,0.20257568334011816,0.6668763833659526,0.4643007000258344,972590646,966320992.4,80.79070255594732,66.61728680234528,NaN,NaN,18.70397774400925,10.729829283986223
2020-07-22T09:30:00-04:00,61.69,62.08,61.06,61.99,7022779,9870133.9,65.54429793234073,59.321669999819775,NaN,NaN,111.02948731614624,127.62794601699561,0.21172263573479588,0.7289539946943293,0.5172313589595334,979613425,970749735.6,82.06665911615534,68.97998388562466,NaN,NaN,20.61928411834291,12.142608546037179
2020-07-23T09:30:00-04:00,62.2,62.46,62,62.21,9467970,9626370.3,66.71361645702734,60.399753057903354,NaN,NaN,124.67925539786661,123.00969192782254,0.21568130434059862,0.7868329893852817,0.571151685044683,989081395,975518026.6,83.34907724954671,71.23614672948071,NaN,NaN,22.55343956369254,13.629870119987945
2020-07-24T09:30:00-04:00,62.31,62.83,61.83,62.13,6809254,9360389.55,65.83862369665187,61.28076813502997,NaN,NaN,113.51774625984632,115.87290223916368,0.1965436567658625,0.8168312560020112,0.6202875992361487,982272141,977660129.8,83.9058758255984,73.09618463821164,NaN,NaN,23.90949275481013,15.098387639248257
2020-07-27T09:30:00-04:00,62.07,62.45,61.94,62.44,6800902,8976607.75,67.61134041717385,62.04784818887148,NaN,NaN,105.36890852992214,115.90651490318184,0.18837383890692172,0.8557548978698009,0.6673810589628791,989073043,982526130,85.12288783324603,74.69382858297824,NaN,NaN,25.570234303888633,16.59436573419688
2020-07-28T09:30:00-04:00,62.42,62.9785,62.39,62.67,6699305,8828858.4,68.90078942477115,62.99318665114167,NaN,NaN,118.41041942149835,114.60116338505591,0.18197196439541774,0.8948460144571513,0.7128740500617335,995772348,987162470.4,86.1941105688783,76.18824793138474,NaN,NaN,27.343452017879976,18.12994948900875
2020-07-29T09:30:00-04:00,62.65,62.9583,62.49,62.76,7486444,8834188.4,69.41392753127191,64.24072588732706,NaN,NaN,112.47710259924524,114.89068644167571,0.1676645755133579,0.9224547694534309,0.754790193940073,1003258792,991891543.8,87.20604287036957,77.69301842506641,NaN,NaN,28.973508427667298,19.679029337388545
2020-07-30T09:30:00-04:00,62.61,62.98,62.32,62.76,10901714,9016194.25,69.41392753127191,64.99760818679366,NaN,NaN,102.60471620107805,110.475778602318,0.14302644911989104,0.9335732553399367,0.7905468062200457,1003258792,994727023.2,87.7841977392424,79.12162817133817,NaN,NaN,30.341349986738553,21.202218001581404
2020-07-31T09:30:00-04:00,62.51,62.71,61.9203,62.7,10277225,9187195.35,68.53953952413671,65.7447683489033,NaN,NaN,81.13499396457618,103.99922814326399,0.10904974185415639,0.9268589835377412,0.8178092416835848,992981567,996868908.4,88.21734621446521,80.67161255428005,NaN,NaN,31.297422944778486,22.644390136323842
2020-08-03T09:30:00-04:00,62.73,62.76,62.22,62.53,8614449,9113351.25,66.00265142695488,65.96115876676234,NaN,NaN,78.94563926939767,98.7145742911591,0.0637324187146524,0.8974747650769004,0.833742346362248,984367118,995927723.4,86.76153350728329,82.11329598934489,NaN,NaN,31.509056509335114,23.910771046754025
2020-08-04T09:30:00-04:00,62.44,63.33,62.33,63.31,7417357,9076169.3,71.25908400680203,66.53425030735416,NaN,NaN,106.25775185719392,96.28404077829819,0.07416414776479474,0.9264475310682414,0.8522833833034467,991784475,995130148.8,85.47426865493125,83.25462928316742,NaN,NaN,33.155344385865796,25.23142438091285
2020-08-05T09:30:00-04:00,63.41,63.535,63,63.18,7143577,8966955.05,69.33496562787539,66.91876948922622,NaN,NaN,115.9682263924658,96.98226553694232,0.06074834504567339,0.9282188146105383,0.867470469564865,984640898,991406570,79.54085197780091,83.68368112030922,NaN,NaN,34.027661561896394,26.488029692481927
2020-08-06T09:30:00-04:00,63.03,63.285,62.92,63.17,11983731,9182514.35,69.18022126747394,67.16209523174116,NaN,NaN,100.90157470851915,96.64163723843053,0.040608311855771184,0.9182308593845789,0.8776225475288078,972657167,985286245,70.83670126862096,83.29625357147026,NaN,NaN,34.716620616036735,27.663542681561186
2020-08-07T09:30:00-04:00,63.07,63.57,63,63.51,9176106,8934180.3,71.50853206206997,68.00759811652263,NaN,NaN,115.43197243793915,103.50103293310312,0.039553062875666734,0.9270638761233911,0.8875108132477244,981833273,983056586.2,67.92070504783138,82.51221145927978,NaN,NaN,35.95292357701305,28.847739952340024
2020-08-10T09:30:00-04:00,63.58,63.97,63.44,63.84,4345637,8606153.55,73.59368956910265,68.77537189106603,NaN,NaN,145.50171785097356,116.81224864941832,0.04978677873057624,0.9497442866609447,0.8999575079303684,986178910,983418944.6,68.15017209437008,81.60931642630999,NaN,NaN,37.620834438491876,30.101039164647432
2020-08-11T09:30:00-04:00,64.14,64.3001,63.22,63.4,8633508,8324470.9,66.59540315212169,68.8504508353361,NaN,NaN,124.6087005109282,120.48243838016518,0.017306655465789467,0.9215908272626052,0.9042841717968157,977545402,980571130,64.25978478267643,80.3373968310615,NaN,NaN,37.12116383517942,31.103914117580572
2020-08-12T09:30:00-04:00,63.66,64.499,63.66,64.22,8021616,7977983.85,71.94899668870582,69.22440656617027,NaN,NaN,155.34099145164257,128.35699139200054,0.04012779811942102,0.9544439194460921,0.9143161213266711,985567018,980756354,64.4021225720366,78.98404292552506,NaN,NaN,38.308464283398415,32.13313556984026
2020-08-13T09:30:00-04:00,64.08,64.36,63.99,64.17,5857118,7882328.2,71.19969257993432,69.60734005783331,NaN,NaN,144.55846665106756,137.08836978051022,0.0408015539888138,0.9653180638126884,0.9245165098238746,979709900,982166900.6,65.52803335159523,77.67133989166769,NaN,NaN,39.03838361872999,33.11959957682451
2020-08-14T09:30:00-04:00,64.1,64.37,63.92,64.16,3776370,7755062.45,71.04034220279469,69.85226875680623,NaN,NaN,124.94446451384925,138.99086819569223,0.030018149049885645,0.9620391961362316,0.9320210470863459,975933530,980986952,63.71266004373714,76.14203790670275,NaN,NaN,39.58641546750463,34.04343041835024
2020-08-17T09:30:00-04:00,64.31,64.73,64.19,64.52,5172926,7672779.6,73.35250569382482,70.17024849031006,NaN,NaN,141.0228043390418,138.09508549330587,0.036163019762828874,0.977224821789882,0.9410618020270531,981106456,979972461.2,62.119224344541266,74.42240317639298,NaN,NaN,40.728865539246165,34.99849257847823
2020-08-18T09:30:00-04:00,64.62,64.96,64.3307,64.78,4927298,7526764.3,74.91052291633065,70.5628624463857,NaN,NaN,142.51156757813123,141.6756589067465,0.04613189220363911,0.998726667281602,0.9525947750779629,986033754,981670131.6,63.75292224771407,72.74718027477472,NaN,NaN,42.15652255013293,36.021068288714616
2020-08-19T09:30:00-04:00,64.69,64.78,64.155,64.27,5871749,7469212.8,66.67551929730297,70.36726185824504,NaN,NaN,103.73994877958341,131.35545037233464,0.008730245024673344,0.9635075813588045,0.9547773363341312,980162005,980589129,61.92164778724481,70.89985527820347,NaN,NaN,40.94539593126726,36.72454366622214
2020-08-20T09:30:00-04:00,63.9,64.22,63.7878,64.14,10178891,7504758.85,64.7223796242398,70.09460757968098,NaN,NaN,63.25687181300141,115.0951314047214,-0.03217085572774114,0.9145637666744548,0.946734622402196,969983114,978643771.8,58.656329455929836,68.78835408116522,NaN,NaN,39.368443574642114,37.102243653139276
2020-08-21T09:30:00-04:00,64.06,64.385,63.865,64.3,5713949,7449993.6,66.04089279558617,70.09733910601179,NaN,NaN,68.52021086761368,103.81028067547432,-0.054540796502180355,0.8785586267744705,0.9330994232766509,975697063,978596478.4,58.57545998657715,66.7750631154005,NaN,NaN,38.412910494939986,37.28948177339652
2020-08-24T09:30:00-04:00,64.41,64.85,64.21,64.85,6978548,7458875.9,70.16841074859911,70.019433873283,NaN,NaN,103.59934636089214,96.32558907984438,-0.039109897554089446,0.884212051334039,0.9233219488881285,982675611,978910309.4,58.979616344715836,64.8825879503851,NaN,NaN,38.779013793383555,37.502272061966096
2020-08-25T09:30:00-04:00,65,65.05,64.43,64.71,4517276,7349774.45,67.90590204195993,69.91735790286047,NaN,NaN,103.26534339418728,88.47634424305559,-0.044740126479636766,0.8673967907885825,0.9121369172682192,978158335,977335225.6,56.025226193459005,63.20290039436067,NaN,NaN,38.414625055369086,37.63260820388081
2020-08-26T09:30:00-04:00,64.58,64.88,64.28,64.79,5375359,7244220.2,68.53033719368175,69.87093761187532,NaN,NaN,87.58994782019927,85.24634405117874,-0.049134058592607,0.8507193440274605,0.8998534026200675,983533694,978009563.4,57.01791227632721,62.215844037768264,NaN,NaN,38.28839436837587,37.726291941665814
2020-08-27T09:30:00-04:00,64.91,65.5,64.9,65.19,8711155,7134692.25,71.51461314301518,69.87137197479997,NaN,NaN,133.2705146517558,99.24907261892963,-0.03198912775253593,0.8598669929293976,0.8918561206819335,992244849,982461910.4,62.962788108633625,61.86170711353986,NaN,NaN,39.0440712778761,37.914546132553
2020-08-28T09:30:00-04:00,65.5,65.81,64.88,65.77,6868207,6964241.35,75.18869761193176,69.98530112071634,NaN,NaN,157.3429007908767,117.01361060358224,0.009317268684164715,0.9035027065371395,0.8941854378529748,999113056,987145109,67.97952481799508,61.84951802237025,NaN,NaN,40.8750348111746,38.3374730866418
2020-08-31T09:30:00-04:00,65.53,65.77,65.315,65.58,7661174,6916577.6,71.91631027796912,70.36536591541973,NaN,NaN,153.51689117786762,126.99711956697733,0.014441417035027881,0.9122372091467597,0.8977957921117318,991451882,988900363.2,69.63940025412282,62.2337762703307,NaN,NaN,41.39434325354853,38.77416882477133
2020-09-01T09:30:00-04:00,65.57,65.675,65.13,65.65,9723064,7031862.95,72.39302664130483,70.39708234060537,NaN,NaN,130.78582565338644,132.50121601881716,0.0131782946104958,0.9142686603748515,0.9010903657643557,1001174946,993503685.4,73.51675050294095,62.88482112253816,NaN,NaN,41.95596018835422,39.22871044814031
2020-09-02T09:30:00-04:00,65.95,67.105,65.85,66.84,11174358,7233402,78.93835899759773,70.94984422758134,NaN,NaN,218.94045029518338,158.77131651381399,0.07942371704730666,1.000370012073489,0.9209462950261824,1012349304,999266807.4,77.40694083233929,63.73331451401988,NaN,NaN,44.778053601831246,40.02147375581045
2020-09-03T09:30:00-04:00,67,67.61,65.205,65.69,26304590,7949444.95,63.31555777064938,70.39807391099951,NaN,NaN,152.96813245031646,162.71084007352613,0.03499513698561818,0.9646902162582052,0.929695079272587,986044714,998026780.4,74.85893037061682,64.52947668022559,NaN,NaN,41.3759451130138,40.21496966398235
2020-09-04T09:30:00-04:00,65.88,66.15,64.73,65.54,15604922,8270885.75,61.60297871791365,69.55882198414872,NaN,NaN,71.04315085238674,145.45089008582812,-0.012734841327138868,0.9137765276136633,0.9265113689408022,970439792,992292127.6,64.31517274649286,64.68633013750784,NaN,NaN,38.192847141669716,39.92609501793769
2020-09-08T09:30:00-04:00,65.38,65.51,63.89,64.16,16316979,8869452.85,48.58331313087293,67.67830699947316,NaN,NaN,-32.09558317612983,108.32839521502865,-0.13849868898810858,0.7533880077056665,0.8918866966937751,954122813,984826313.8,53.709104514755424,63.96891458515365,NaN,NaN,30.075946434759736,38.51893093462655
2020-09-09T09:30:00-04:00,64.53,65.725,64.41,65.09,12848573,9080206.1,55.42110615158531,66.87442034620763,NaN,NaN,20.715763732140026,86.31438283077935,-0.15884543553355646,0.6933299022768296,0.852175337810386,966971386,977985601.8,46.19250626703258,62.845404476567055,NaN,NaN,26.19384272549566,36.758204047607855
2020-09-10T09:30:00-04:00,65.09,65.27,64.15,64.29,11060570,9232153.8,49.34224169182786,65.77583906532105,NaN,NaN,-39.98716128681067,34.528860514380554,-0.22209469281894434,0.5745569717867056,0.79665166460565,955910816,966697904.2,36.99270817216183,61.298002956297914,NaN,NaN,20.70070869694363,34.46427614037011
2020-09-11T09:30:00-04:00,64.49,64.96,64.19,64.65,10212541,9449924.95,51.89904973471592,64.76570741811604,NaN,NaN,-40.1754659502432,-4.099859165731381,-0.23438409333648635,0.503671547935042,0.7380556412715283,966123357,962713632.8,34.389210428664185,59.570413702161275,NaN,NaN,17.4909314351988,32.03951261105992
2020-09-14T09:30:00-04:00,64.97,65.37,64.78,65.07,6397036,9580958.25,54.76741861730064,63.66563655159472,NaN,NaN,11.637294673500021,-15.981030401508736,-0.20972534361721873,0.4758989617500049,0.6856243053672236,972520393,963129753,34.90449442161561,57.85076213622555,NaN,NaN,16.001961503475055,29.74843388140494
2020-09-15T09:30:00-04:00,65.23,65.46,64.89,64.98,5672885,9605956.2,54.02397880424938,62.67407060604397,NaN,NaN,12.738443757539292,-7.014225014774911,-0.19526986360690146,0.44153697585859675,0.6368068394654982,966847508,965674692,38.106062641735825,56.57082188253103,NaN,NaN,14.615313551786056,27.586559548602242
2020-09-16T09:30:00-04:00,65.26,65.43,64.63,64.69,7270728,9723127.7,51.59367707300258,61.4643091688526,NaN,NaN,-14.35781463613715,-14.02894068843035,-0.2002858487740058,0.38644952849799097,0.5867353772719968,959576780,964195770.8,36.968193485727994,55.13869911177394,NaN,NaN,12.719369170361317,25.46267520885354
2020-09-17T09:30:00-04:00,64.15,64.62,63.82,64.28,10108734,9934976.95,48.28641126353229,59.80515189174668,NaN,NaN,-102.1660982578946,-26.464728082647138,-0.22444485255346436,0.3061793115801663,0.5306241641336307,949468046,962907216.8,35.96064039935635,53.20997427539699,NaN,NaN,10.100196183367032,23.268035348069752
2020-09-18T09:30:00-04:00,64.38,64.47,63.25,63.69,9988926,9925478.7,43.92307946151141,57.571893452430935,NaN,NaN,-154.29856982161886,-49.289348856922274,-0.27031149890595146,0.19273479050119136,0.4630462894071428,939479120,957578369.4,32.06813873771826,50.644875269662926,NaN,NaN,6.466546022898226,20.867822587330963
2020-09-21T09:30:00-04:00,62.88,63.07,62.11,62.83,11326358,10206099.15,38.46664720406166,55.182631804294694,NaN,NaN,-253.30715654652553,-102.27823910092738,-0.3439943443298353,0.033053358994848736,0.377047703324684,928152762,948704843.2,26.85525232085618,47.58886470300103,NaN,NaN,1.4559018637264778,18.094691055387464
2020-09-22T09:30:00-04:00,62.87,63.51,62.805,63.2,7148633,10214603.4,41.815610769480315,52.99853067059295,NaN,NaN,-166.54297164909252,-138.13452218225376,-0.35196950874073357,-0.06291418260123294,0.28905532613950063,935301395,942395620.6,23.882561689918745,44.04356550207087,NaN,NaN,-1.5366820192702026,15.290209187579226
2020-09-23T09:30:00-04:00,63.4,63.56,62.1801,62.25,7016242,10339551.7,36.345927660161465,49.95621414649035,NaN,NaN,-176.7895681847812,-170.62087289198257,-0.4017794068980351,-0.21316893248304325,0.18861047441499185,928285153,936137295.2,21.357157477157855,40.04000954812933,NaN,NaN,-6.018379164991057,12.246125137212044
2020-09-24T09:30:00-04:00,62.25,63.04,61.83,62.71,9141823,10527874.9,40.41047822826714,48.32013703632019,NaN,NaN,-156.206083970866,-181.42887003457685,-0.38430074600291736,-0.29176545808865484,0.0925352879142625,937426976,933729081.2,20.46057658255286,36.15441284898191,NaN,NaN,-8.321648339602328,9.307871783381419
2020-09-25T09:30:00-04:00,62.39,63.11,62.2473,63.04,7432117,10463923,43.21193668838839,47.00649117706838,NaN,NaN,-117.3298768103867,-174.0351314323304,-0.3329835773360881,-0.3236941837558476,0.009289393580240488,944859093,934805075.8,22.035440234426375,33.13443195526288,NaN,NaN,-9.286478411086364,6.651536041314593
2020-09-28T09:30:00-04:00,63.56,64.11,63.53,63.75,6077639,10424394.6,48.79017044701173,47.021266699649736,NaN,NaN,-43.57107038040725,-132.08791419910673,-0.23813756915880135,-0.2883825678682612,-0.05024499870945986,950936732,939361869.8,28.492654054255567,31.333256922370033,NaN,NaN,-8.28544676079721,4.51768135529862
2020-09-29T09:30:00-04:00,63.78,63.9266,63.21,63.33,8150441,10448857.95,45.91682945090745,46.342389792458455,NaN,NaN,-57.27501331564545,-110.23432253241731,-0.19255170856792417,-0.29093463441936507,-0.0983829258514409,942786291,940858849,30.528275737444176,30.21438331311372,NaN,NaN,-8.370379186411418,2.6765298493400436
2020-09-30T09:30:00-04:00,63.59,64.5,63.56,64.1,8284207,10376915.1,51.550253706336285,46.50010493635192,NaN,NaN,-15.002234926008704,-77.87685588066282,-0.10384895605975963,-0.22819412092614044,-0.12434516486638081,951070498,945415918,36.45834109392475,30.17621423609679,NaN,NaN,-6.592189633105602,1.352427066133523
2020-10-01T09:30:00-04:00,64.47,64.61,63.91,64.46,9262892,10281341.8,53.964595425708985,46.64764391427999,NaN,NaN,13.840844184328544,-43.867470249623906,-0.018699865259562742,-0.14771999644083422,-0.12902013118127148,960333390,949997200.8,41.833717608718565,30.707964748957814,NaN,NaN,-4.368956092685447,0.5350866148736702
2020-10-02T09:30:00-04:00,63.82,64.39,63.605,64.1,7462540,9339239.3,51.21607957013846,46.3939768394827,NaN,NaN,-1.2350617493569023,-20.648507237417963,0.013852106012797571,-0.1117049986652745,-0.12555710467807207,952870850,951599552.2,43.629916263185955,31.331209166212837,NaN,NaN,-3.3793043435853556,-0.024112093477619223
2020-10-05T09:30:00-04:00,64.25,64.615,64.15,64.53,4501173,8784051.85,54.21563670281175,46.40766668938,NaN,NaN,41.576149684262795,-3.6190632244839436,0.062115176281331896,-0.0479131343264072,-0.1100283106077391,957372023,952886610.4,45.09650437617501,31.830526432958496,NaN,NaN,-1.6241130297897963,-0.25268365580793023
2020-10-06T09:30:00-04:00,64.68,64.93,63.92,64.11,6552484,8295827.1,50.92217296820482,46.359702110465875,NaN,NaN,32.29923330103369,14.295786098851886,0.06330904183530546,-0.030892008313607278,-0.09420105014891274,950819539,954493260,46.951901874259455,32.54364846071074,NaN,NaN,-1.1398303037073743,-0.3794188912221365
2020-10-07T09:30:00-04:00,64.48,65.07,64.35,64.8,8073123,8057054.6,55.684987628943716,46.88817185085241,NaN,NaN,75.66803322799174,32.429839729651974,0.1056315700762768,0.03783841244643327,-0.06779315762984353,958892662,956057692.8,48.7674322495859,33.45841930715571,NaN,NaN,0.7701780276577906,-0.2151907599535755
2020-10-08T09:30:00-04:00,65.09,65.29,64.82,65.23,6659207,7836986.45,58.39474609052919,47.921862324353675,NaN,NaN,106.15255271201427,50.892181435189116,0.1546807821219262,0.12555782002256421,-0.02912296209936198,965551869,957101388.6,49.996941987049226,34.73904811067934,NaN,NaN,3.2094765369649085,0.2740474253204936
2020-10-09T09:30:00-04:00,65.49,66.03,65.41,65.74,7894034,7721061.1,61.40882174223703,49.560589077080486,NaN,NaN,149.02337254065796,80.9438682931921,0.2101277728276819,0.23353675393524043,0.023408981107558506,973445903,961216399.2,54.62099229513019,36.72231525169892,NaN,NaN,6.215934729298113,1.1228884687458678
2020-10-12T09:30:00-04:00,66.02,66.845,65.98,66.5,8685591,7835488.85,65.4281766561808,51.247200926130525,NaN,NaN,189.30856048568245,110.49035045347603,0.2821536366330798,0.37610102689890823,0.09394739026582846,982131494,966168293.4,59.47733240606713,39.26479887428094,NaN,NaN,10.126962349470343,2.4091847374207926
2020-10-13T09:30:00-04:00,66.3,66.65,66.14,66.45,7505697,7927129.45,64.94890554647677,53.29027077515305,NaN,NaN,168.28439882255822,137.68738355778095,0.3084597092093958,0.4795220267775733,0.17106231756817744,974625797,970929545,63.519793472666855,42.27641573110301,NaN,NaN,13.097983432648128,3.9361559795961263
2020-10-14T09:30:00-04:00,66.44,66.7117,65.84,66.11,6566256,7891905.85,61.64225321777936,54.80682613154677,NaN,NaN,138.4546610939957,150.2447091309817,0.28552033001030397,0.5279627300810574,0.24244240007075343,968059541,972762920.8,64.9689523150458,45.455585426281075,NaN,NaN,14.632743763913748,5.464239948784358
2020-10-15T09:30:00-04:00,65.63,66.325,65.57,66.15,6649980,7718968.15,61.88808792251912,56.14083693398469,NaN,NaN,107.51228056456807,150.51665470149248,0.2565173295082705,0.5630890619560915,0.30657173244782104,974709521,974594451.2,66.40472036104028,48.62481972103921,NaN,NaN,15.952833897993186,6.962610512957047
2020-10-16T09:30:00-04:00,66.35,66.71,66.15,66.17,6701213,7554582.5,62.01915975189067,57.08576474147604,NaN,NaN,110.86970505839855,142.88592120504057,0.22337314569848588,0.5857881645709284,0.36241501887244254,981410734,976187417.4,67.64673409266203,51.42153972378253,NaN,NaN,17.078563385017357,8.407746637537091
2020-10-19T09:30:00-04:00,66.17,66.45,65.13,65.31,7733956,7374962.4,53.499005272342266,57.62734872872138,NaN,NaN,60.93683167070824,117.21157544204576,0.1327021645605989,0.5282927245731912,0.3955905600125923,973676778,974496474.2,64.90373921257114,53.87692997200588,NaN,NaN,15.670150597670643,9.44523291755617
2020-10-20T09:30:00-04:00,65.95,66.08,65.11,65.24,7659686,7400515.05,52.862425333873325,57.72107527354545,NaN,NaN,46.04241707752252,92.76317909303862,0.060841123334706204,0.47164196418097504,0.41080084084626883,966017092,972774733.2,62.14075639965536,55.7113882081295,NaN,NaN,14.333129225788468,10.143503818732214
2020-10-21T09:30:00-04:00,65.17,65.67,65.14,65.3,7013914,7400398.65,53.37454122537577,57.678928544950224,NaN,NaN,33.3887902378319,71.75000492180587,0.012694489631663197,0.42666895288584783,0.41397446325418463,973031006,973769026.2,63.117235987039074,57.23163952086668,NaN,NaN,13.354034362436945,10.60215103926146
2020-10-22T09:30:00-04:00,65.31,65.49,64.96,65.27,7779561,7332285.55,53.06411625894583,57.810931165579326,NaN,NaN,17.852576160167157,53.818064040925684,-0.02383700981649195,0.3841782009835697,0.40801521080006165,965251445,971877411,59.94928578428343,58.39730877237365,NaN,NaN,12.451745479954255,10.866378816503289
2020-10-23T09:30:00-04:00,65.5,65.65,65.19,65.39,5093601,7215359.75,54.211280654616374,57.81062001927966,NaN,NaN,23.784537528264945,36.401030534898965,-0.041546347629971336,0.3560822762625975,0.3976286238925688,970345046,969664273.4,56.38359682703246,59.20352966172061,NaN,NaN,11.961625358912165,11.022842608275985
2020-10-26T09:30:00-04:00,64.89,65.02,63.9817,64.55,9352039,7379079.75,45.77695633227368,57.44310454528458,NaN,NaN,-57.88043559134351,12.637577082488601,-0.10770023115996707,0.26300333494260997,0.37070356610257704,960993007,967127519.2,52.52706241534883,59.601755414655564,NaN,NaN,9.099879468792631,10.748133588349791
2020-10-27T09:30:00-04:00,64.59,64.94,64.345,64.38,5331369,7238126.15,44.27561463241223,56.62814933124661,NaN,NaN,-64.31898589285126,-9.434703511586154,-0.157747016159351,0.17351979590338829,0.3312668120627393,955661638,965056428.4,49.547376212375255,59.65746569771195,NaN,NaN,6.2612498885151595,10.10715020265913
2020-10-28T09:30:00-04:00,63.46,63.79,62.43,62.5,10980604,7372946,31.839340047731326,54.73133461390391,NaN,NaN,-200.13301924695614,-56.13906540854377,-0.3038433164474804,-0.04853733349661127,0.25530598295086915,944681034,959386434,42.448103186339225,59.11826292623266,NaN,NaN,-1.1689925646636723,8.496272664470158
2020-10-29T09:30:00-04:00,62.34,63.1,61.715,62.48,8942690,7356935.9,31.73721052881153,52.61193381294494,NaN,NaN,-204.2706505951303,-100.56371075960325,-0.38308960757625254,-0.2235560265194465,0.159533581056806,935738344,953483813.8,36.573172524852225,57.82913294264137,NaN,NaN,-6.918948742486386,6.294098177762081
2020-10-30T09:30:00-04:00,62.24,62.54,61.49,62.26,10093310,7488474.4,30.575396296857278,50.122449501564695,NaN,NaN,-196.24628819011537,-144.5698759032793,-0.4281717805913786,-0.3756811446824173,0.05249063590896133,925645034,944543811.4,29.837456935773716,55.71199898047756,NaN,NaN,-11.957498113571498,3.686727279000141
2020-11-02T09:30:00-05:00,63.15,63.54,62.76,63.25,10935089,7810170.2,41.03590435897204,48.4143779881715,NaN,NaN,-109.37151452526064,-154.86809169006273,-0.3712820009200198,-0.4116118652410634,-0.040329864321043615,936580123,939661234.6,26.92128562309769,53.09781984836548,NaN,NaN,-13.06720208603012,1.2933087982815326
2020-11-03T09:30:00-05:00,63.89,64.875,63.81,64.29,20578757,8511483.85,49.623138498670826,47.55586979394946,NaN,NaN,-36.97934412963569,-149.40016333741963,-0.249423323112462,-0.3521090182116211,-0.10268569509915912,957158880,939960683,27.389996769215955,50.41360873794906,NaN,NaN,-11.002664381637677,-0.46325879884978316
2020-11-04T09:30:00-05:00,64.65,65.405,64.24,64.32,25605874,9388121.4,49.850025168527125,46.69600816866432,NaN,NaN,-15.694849705820344,-112.51252942919248,-0.1571187861117399,-0.299084177738834,-0.1419653916270941,982764754,947577427,38.24050678141961,48.40187919654759,NaN,NaN,-9.347918926440487,-1.7324959599341694
2020-11-05T09:30:00-05:00,65.07,65.3999,64.61,64.79,13919339,9751128,53.391652536691005,46.079757653292916,NaN,NaN,2.4633141350211583,-71.16573648316218,-0.05973909079031198,-0.21663925511498405,-0.15690016432467208,996684093,959766576.8,50.888592853216366,47.204869108015764,NaN,NaN,-6.818245273122538,-2.4590315761039365
2020-11-06T09:30:00-05:00,64.89,65.42,64.805,65.09,12703581,9991605.35,55.54948168443997,46.226220254157035,NaN,NaN,15.728791469376159,-28.77072055126386,0.02500396552618772,-0.1256452074169374,-0.15064917294312513,1009387674,976515104.8,62.31031334697322,47.01962440333019,NaN,NaN,-4.066619704143154,-2.6886870229666817
2020-11-09T09:30:00-05:00,66.64,67.28,64.85,64.94,15142823,10314466.95,54.19836085241213,46.321644219766945,NaN,NaN,57.97535605396456,4.698653564581187,0.06860931247026011,-0.06488753235529998,-0.1334968448255601,994244851,988048050.4,67.85427980186898,47.427733217774026,NaN,NaN,-2.235485434284213,-2.623943938869186
2020-11-10T09:30:00-05:00,64.93,66.4,64.88,66.22,15134568,10695910.5,62.56569869694358,46.97815546773608,NaN,NaN,71.2000087931373,26.334524149135795,0.17524736056622198,0.08556235588221739,-0.08968500468400459,1009379419,998492158.2,71.88718641487976,48.054158248334076,NaN,NaN,2.323007395312687,-1.9172366054146326
2020-11-11T09:30:00-05:00,66.6,67.075,66.15,66.79,10382144,10886704.9,65.58114929458668,47.87222925599614,NaN,NaN,124.91836660828662,54.45716741195719,0.2700929764114712,0.2479312158303344,-0.022161760581136794,1019761563,1005891520,74.34306751748565,49.082285514991376,NaN,NaN,7.128436379765447,-0.6249976075317643
2020-11-12T09:30:00-05:00,66.61,66.79,66.05,66.61,8945870,11001499.4,63.8324844966684,48.559458101857,NaN,NaN,108.57971279245115,75.68044714344319,0.30409651588110653,0.35795888427024636,0.05386236838913984,1010815693,1008717840,75.23306156316868,50.428675853286826,NaN,NaN,10.40262816276225,0.9503775025102377
2020-11-13T09:30:00-05:00,66.86,67.617,66.66,67.53,6167265,10974802,68.46131363379612,50.17976933768002,NaN,NaN,151.93286631379553,102.92126211232706,0.3676892315855698,0.5134739078711021,0.14578467628553232,1016982958,1010236896.8,75.72054368412338,52.08535308677072,NaN,NaN,14.844407890427188,2.9352389864983737
2020-11-16T09:30:00-05:00,68.15,68.18,67.63,68.15,12956031,11235905.75,71.14178111277008,52.098781229134154,NaN,NaN,173.35485561907186,125.9971620253485,0.4265108971972247,0.6789232977820632,0.2524124005848385,1029938989,1017375724.4,77.92003527942438,54.11197159155994,NaN,NaN,19.45830836103227,5.295677468574644
2020-11-17T09:30:00-05:00,67.64,68.065,67.47,67.67,8148092,11260326.05,66.43424989047219,54.569846217901365,NaN,NaN,139.58327773359647,139.67381581344034,0.4080870973233283,0.7625212722389989,0.3544341749156706,1021790897,1019858020,78.64447924999317,56.69742702467808,NaN,NaN,21.72644574174447,7.642930079027476
2020-11-18T09:30:00-05:00,67.77,68.0076,66.73,66.74,7607802,11290020.45,58.374557427235324,56.47251385350306,NaN,NaN,97.11842738789164,134.11382796936135,0.31256508044943715,0.745140525477467,0.43257544502802986,1014183095,1018742326.4,77.41503770545786,59.61470310900705,NaN,NaN,20.970242988898384,9.546831923294748
2020-11-19T09:30:00-05:00,66.56,67.02,66.395,66.92,8830197,11342552.25,59.40118755487262,58.53149894336129,NaN,NaN,70.27840906860796,126.45356722459272,0.243852024561652,0.7373904757300949,0.49353845116844286,1023013292,1021181846.2,78.21690645556657,63.07037807470654,NaN,NaN,20.698918088576956,11.139987089763634
2020-11-20T09:30:00-05:00,66.82,67.11,66.44,66.5,4663421,11321043.25,55.934637786327336,59.59569418817239,NaN,NaN,60.10149157304581,108.08729227644278,0.15669797159586474,0.6894109156632737,0.532712944067409,1018349871,1021455228.8,78.30984540775762,66.74098948789654,NaN,NaN,19.38131557118731,12.317319729967016
2020-11-23T09:30:00-05:00,66.62,66.7194,66.114,66.52,5825336,11144708.1,56.066120076324076,60.055907158004764,NaN,NaN,45.16222311817243,82.44876577626289,0.09027684410056358,0.6455589991931134,0.5552821550925499,1024175207,1020302472.4,76.82147101230521,70.27180907668864,NaN,NaN,18.370982387382718,13.182128681026402
2020-11-24T09:30:00-05:00,66.92,67.2,66.77,66.97,6064942,11181386.75,59.02836148764578,60.711502609370385,NaN,NaN,63.154816664379666,67.16307356241951,0.0675684541384205,0.6397427227655754,0.5721742686271549,1030240149,1021992322.8,77.496679404046,73.07582140687623,NaN,NaN,18.37263075736336,13.923628977645967
2020-11-25T09:30:00-05:00,66.94,67.2,66.84,66.93,5245413,10894627.2,58.64981458707279,61.087085612969084,NaN,NaN,59.02464287785699,59.5443166604126,0.042024115085925295,0.6247044124845615,0.5826802973986362,1024994736,1024154651,78.36516685547812,75.03843383560921,NaN,NaN,18.267578885550265,14.544193250203724
2020-11-27T09:30:00-05:00,67.1,67.1,66.72,66.92,3228570,10608921.2,58.54872623666225,61.30131736669925,NaN,NaN,50.33725497083373,55.55608584085775,0.017860083003861105,0.6050054011534627,0.5871453181496016,1021766166,1023905225.8,77.99125755843801,76.15850127928526,NaN,NaN,18.15392353074774,15.059869004567155
2020-11-30T09:30:00-05:00,66.75,66.98,66.23,66.91,11582087,10683360.05,58.44025084647968,61.60430950913265,NaN,NaN,32.45193871830779,50.02617526991014,-0.004212787661100004,0.5818793335732266,0.5860921212343266,1010184079,1022272067.4,75.4526794459808,76.70124411100754,NaN,NaN,18.03103131397325,15.48432076305374
2020-12-01T09:30:00-05:00,67.21,67.57,67.08,67.5,12126239,10742917.55,62.81738984429327,61.62228744822905,NaN,NaN,78.1285224448212,56.61943513523988,0.014482337577410798,0.6041950432060901,0.5897127056286793,1022310318,1021899089.6,74.85344638502676,76.91311982316088,NaN,NaN,19.099954019437536,16.000839799679998
2020-12-02T09:30:00-05:00,67.27,67.59,66.72,66.94,11392184,10283588.9,56.71200402858466,60.98877707208605,NaN,NaN,49.36732903281118,53.86193760892619,-0.015673298083454634,0.570121083024361,0.5857943811078157,1010918134,1018034686.6,68.76028245576936,76.51434946160973,NaN,NaN,18.337563714286357,16.33465750176662
2020-12-03T09:30:00-05:00,66.77,67.23,66.76,67.11,10951368,9550863.6,58.04510023369635,60.57539248187377,NaN,NaN,39.77426770416855,50.011862574188505,-0.028244218824760248,0.5504891075768654,0.5787333264016257,1021869502,1017409639.8,67.79896040299627,75.98334223588313,NaN,NaN,18.061544989533008,16.581355714304678
2020-12-04T09:30:00-05:00,67.17,67.64,67.09,67.63,11055789,9407686.1,61.909239423972544,60.107387181172086,NaN,NaN,84.98467093914392,56.94134576785054,-0.006733835865196824,0.5703160315701297,0.5770498674353265,1032925291,1019641464.8,69.44178616299463,75.5348595558025,NaN,NaN,18.916921667347992,16.915007993310866
2020-12-07T09:30:00-05:00,67.5,67.61,67.05,67.37,9466348,9245824.45,58.984015628500224,59.23897536086709,NaN,NaN,65.83852420698966,63.61866286558692,-0.014751991833206968,0.5586098776438178,0.5733618694770247,1023458943,1022296437.6,71.31651374060202,75.0631794458866,NaN,NaN,18.81678764355543,17.18669080048866
2020-12-08T09:30:00-05:00,67.13,67.88,66.985,67.74,7090952,8843230.9,61.75355630113571,58.904640104485914,NaN,NaN,91.02614309279494,66.19818699518166,-0.0006189879743934146,0.5725881345090329,0.5732071224834263,1030549895,1023944353,72.44643334973819,74.62046188158267,NaN,NaN,19.518995099561998,17.519877128927707
2020-12-09T09:30:00-05:00,67.84,67.87,67.29,67.47,10420075,8607506.25,58.64177926975773,58.9237273789518,NaN,NaN,84.49114613738816,73.22295041609706,-0.014184835735876922,0.5554760778135801,0.569660913549457,1020129820,1025786690.2,73.6940701064349,74.35467848165248,NaN,NaN,19.235991708721407,17.765036354612523
2020-12-10T09:30:00-05:00,67.45,67.62,67,67.17,5723441,8374571.1,55.30698783025565,58.63128454147917,NaN,NaN,25.294915644151928,70.32708000409374,-0.04628284272546479,0.5118073601426261,0.5580902028680909,1014406379,1024294065.6,70.89327379081362,73.83156186274154,NaN,NaN,18.04408215224516,17.804900039988613
2020-12-11T09:30:00-05:00,66.91,67.505,66.89,67.32,5000806,8177317.9,56.63486210862402,58.681300564500354,NaN,NaN,13.812606980729704,56.09266721241089,-0.059490380847220026,0.48372722680906577,0.5432176076562858,1019407185,1021590444.4,66.00027970337402,72.9523071695713,NaN,NaN,17.405253540922246,17.747807682979133
2020-12-14T09:30:00-05:00,67.65,67.905,67.04,67.06,6663423,8202125.8,53.65890991247533,58.509356981368306,NaN,NaN,34.27919472968014,49.78080131694898,-0.08619502963268622,0.43547382061542805,0.5216688502481143,1012743762,1019447408.2,62.328116222597494,71.91706754173502,NaN,NaN,16.027856964722915,17.50210043751396
2020-12-15T09:30:00-05:00,67.35,67.545,67.135,67.22,6121300,7860389.25,55.21836671968361,58.23721449794244,NaN,NaN,38.314556143594324,39.23848392710886,-0.09295962937158792,0.40546931353362936,0.4984289429052173,1018865062,1017110441.6,58.50533550176586,70.56054297728645,NaN,NaN,15.275562684479555,17.184023615651903
2020-12-16T09:30:00-05:00,67.27,67.67,67.11,67.35,10505527,7978261,56.499256721077785,58.08360322179993,NaN,NaN,65.69934933516511,35.480124566664244,-0.08857423729016012,0.38771114629251713,0.47628538358267725,1029370589,1018958595.4,60.56523003576986,69.28911891873585,NaN,NaN,14.973886840215533,16.868289790589564
2020-12-17T09:30:00-05:00,67.59,67.86,67.57,67.78,4673406,7831541.2,60.52161768713497,58.22452403969084,NaN,NaN,138.75362211411982,58.17186586065782,-0.058082958097599946,0.40368168596067733,0.4617646440582773,1034043995,1022886118.6,64.58836032200054,68.33176911613317,NaN,NaN,15.815130976613506,16.717838531450127
2020-12-18T09:30:00-05:00,67.88,68.08,67.405,67.93,6980529,7739057.8,61.84693916404033,58.46785891951661,NaN,NaN,141.16745214269292,83.64283489305046,-0.0305639809170542,0.42355966791195954,0.45412364882901374,1041024524,1027209586.4,68.40908029038506,67.82865489073347,NaN,NaN,16.893354561071856,16.742912249967517
2020-12-21T09:30:00-05:00,66.62,66.7733,65.945,66.64,8255571,7918665.3,47.17836482029769,57.35078570351693,NaN,NaN,-167.4957774678552,43.28784045354339,-0.09817834971380751,0.33140071168675433,0.42957906140056185,1032768953,1031214624.6,71.47897460313362,67.58762119202683,NaN,NaN,13.20783408782639,16.237901083947357
2020-12-22T09:30:00-05:00,66.61,66.61,66.06,66.17,9107878,8082792.4,43.161738282920496,56.38290957882663,NaN,NaN,-197.6344816523617,-3.9019671056478105,-0.16932174714124987,0.21792687747399953,0.3872486246152494,1023661075,1032173827.2,72.17634530440077,67.83162568121479,NaN,NaN,8.770504199003339,15.171130100383925
2020-12-23T09:30:00-05:00,66.37,66.645,66.235,66.39,4302588,7994674.7,45.500678753928895,55.48687947312895,NaN,NaN,-144.59020727683637,-45.9598784280481,-0.19452751034753785,0.14408923668082707,0.3386167470283649,1027963663,1031892442,71.62308795663492,68.10477764933184,NaN,NaN,5.912193076978325,13.848424811325982
2020-12-24T09:30:00-05:00,66.44,66.7577,66.28,66.72,1954906,7830149.35,48.89767438616406,54.55748197042834,NaN,NaN,-101.46228835299621,-94.00306052147133,-0.1821558160611605,0.1109219769519143,0.2930777930130748,1029918569,1031067356.8,69.93038614671306,68.13967764816887,NaN,NaN,4.585939435691751,12.525212614806806
2020-12-28T09:30:00-05:00,66.97,67.45,66.9,67.25,6315355,7984488.6,53.87076901054611,54.19225006914591,NaN,NaN,8.744123657859742,-120.48772621843796,-0.13370114135777184,0.12595136631586,0.25965250767363185,1036233924,1030109236.8,67.92291404121805,67.89727766964144,NaN,NaN,5.032899648760854,11.454882191085956
2020-12-29T09:30:00-05:00,67.42,67.605,66.88,67.05,4993578,7655063.15,51.82133715566414,53.48280584446936,NaN,NaN,0.16979752512007282,-86.9546112198429,-0.11145259032878968,0.12033676976264474,0.23178936009143442,1031240346,1029803515.4,67.25943467232737,67.5267777641121,NaN,NaN,4.766654523622446,10.499421095734025
2020-12-30T09:30:00-05:00,67.13,67.21,66.9,66.98,7359939,7416748.15,51.08875164359044,52.9433038711717,NaN,NaN,-26.79847484997901,-52.787409859366356,-0.09824551643667506,0.10898246454559057,0.20722798098226564,1023880407,1029847381.8,67.30877852995937,67.07068550864956,NaN,NaN,4.336673344516178,9.619028559845761
2020-12-31T09:30:00-05:00,67.05,67.55,66.715,67.45,6062326,7150255.25,55.624770242469374,52.96600261490125,NaN,NaN,14.734883204183431,-20.9223917631624,-0.0567123420219772,0.13633755345479415,0.19304989547677134,1029942733,1030243195.8,67.78063267362177,66.84835400027872,NaN,NaN,5.330881495995181,9.00643612215282
2021-01-04T09:30:00-05:00,67.42,67.4425,65.92,66.72,12992627,7252318.2,48.154852466759934,52.36028764048239,NaN,NaN,-88.5237635810857,-18.33468680878029,-0.07605409188263021,0.09798228062348358,0.17403637250611378,1016950106,1027649503.2,61.51493769587471,66.52797242831448,NaN,NaN,3.842273822206509,8.268698650731919
2021-01-05T09:30:00-05:00,66.62,66.865,66.1,66.72,10871674,7243112.45,48.154852466759934,51.967140680074145,NaN,NaN,-97.70371517004313,-39.62425457436086,-0.08577690120093118,0.06681524600494981,0.152592147205881,1016950106,1023792739.6,53.582991062982494,65.90332063119912,NaN,NaN,2.667259325879389,7.468493032895843
2021-01-06T09:30:00-05:00,66.59,67.1,66.48,66.77,14206565,7480123.3,48.70207491053919,51.50169126513526,NaN,NaN,-51.52580005069627,-49.96337408952413,-0.08557467310687442,0.04562380582228798,0.1311984789291624,1031156671,1023776004.6,53.55072455796546,65.5494198494991,NaN,NaN,1.86653413440476,6.66821319025426
2021-01-07T09:30:00-05:00,66.82,66.98,66.3,66.57,13963536,7823752.5,46.58401902118941,50.793460000857515,NaN,NaN,-71.7305496867479,-58.94978905687792,-0.0949215989379794,0.012546480256688142,0.10746807919466754,1017193135,1022438550.2,50.9120634042889,64.85990794725045,NaN,NaN,0.5905291551039484,5.799972613804216
2021-01-08T09:30:00-05:00,66.62,66.96,66.25,66.9,17960849,8200791.2,50.41580992915775,50.07161658957342,NaN,NaN,-50.18375826291788,-71.93351735029819,-0.07572406080637956,0.012813003186693095,0.08853706399307265,1035153984,1023480800.4,52.861338806665636,64.02226355329796,NaN,NaN,0.5682245397001774,5.052580031789353
2021-01-11T09:30:00-05:00,66.53,66.97,66.215,66.33,9648777,8397058,44.48047043660349,48.831154537613656,NaN,NaN,-76.13474347242735,-69.45571332856652,-0.09690507931630914,-0.03259428515231377,0.06431079416399536,1025505207,1025191820.6,55.9536033714878,63.13258663051958,NaN,NaN,-1.2356417558180102,4.15426263355973
2021-01-12T09:30:00-05:00,66.33,66.48,65.83,66.11,11089458,8701490.6,42.40540161211759,48.49022859417222,NaN,NaN,-122.41626541282318,-74.39822337712252,-0.1197272022624315,-0.08534820866404402,0.03437899359838748,1014415749,1024684949.2,54.80661319318663,61.94170367266622,NaN,NaN,-3.3618239871671203,3.0805359734558944
2021-01-13T09:30:00-05:00,66.04,66.46,66.01,66.21,8336325,8785135.7,43.6912825893233,48.528053187486705,NaN,NaN,-99.31313359591292,-83.95569008616584,-0.12168702934514473,-0.11772979308304343,0.003957236262101298,1022752074,1023004029.8,51.067969997245804,60.43396257929801,NaN,NaN,-4.7515567770333655,1.9616655805288574
2021-01-14T09:30:00-05:00,66.27,66.3,65.78,65.86,11549048,9056523.1,40.299907726485024,48.15656954266928,NaN,NaN,-128.12577138134583,-95.23473442508543,-0.13890863553969418,-0.16967855816251642,-0.030769922622822247,1011203026,1021806008,48.52718082192263,58.78425492681856,NaN,NaN,-6.951742433641278,0.6883215785045524
2021-01-15T09:30:00-05:00,65.62,65.92,65.36,65.63,13260265,9194260,38.201426636936084,47.39255184629586,NaN,NaN,-168.25605590278886,-118.84919395305963,-0.15681852362082627,-0.2267930771488551,-0.06997455352802882,997942761,1014363763.4,36.408680517200466,56.38984738185338,NaN,NaN,-9.431146736415096,-0.7573167521982545
2021-01-19T09:30:00-05:00,65.85,65.98,65.285,65.34,8130500,9367114.7,35.67872884840894,46.09312040614321,NaN,NaN,-171.94837855905632,-138.01192097038543,-0.177692586218926,-0.2920902863016863,-0.11439770008276032,989812261,1007225174.2,28.942575073948603,53.605537455619846,NaN,NaN,-12.306065857863137,-2.4071380530075235
2021-01-20T09:30:00-05:00,65.32,65.62,64.88,65.46,10700712,9553123.85,37.51743539733218,45.07141313769092,NaN,NaN,-184.6345166340793,-150.45557121463662,-0.17276004361177805,-0.3303477545974829,-0.15758771098570484,1000512973,1004444619,26.650162146795083,50.70487513236753,NaN,NaN,-14.193344474185993,-4.09088182746159
2021-01-21T09:30:00-05:00,65.355,65.41,65.13,65.24,8461251,9563407.85,35.51309078056107,43.958865933188825,NaN,NaN,-158.25331797632992,-162.24360809072004,-0.1732152434659643,-0.37410676531816023,-0.20089152185219591,992051722,998304548.6,22.426053769602618,47.49896622091348,NaN,NaN,-16.379948072606794,-5.84646271962519
2021-01-22T09:30:00-05:00,65.19,65.475,64.92,65.07,8329329,9524480.4,34.00145328952384,42.41434329369271,NaN,NaN,-144.6315022898181,-165.54475427241448,-0.17343783781986108,-0.41768881912702227,-0.2442509813071612,983722393,992808422,19.45367047237319,44.04704034939573,NaN,NaN,-18.666048479258407,-7.677832113858507
2021-01-25T09:30:00-05:00,64.87,65.945,64.84,65.72,17486199,10183660.95,43.843941812731344,42.10642110411924,NaN,NaN,-89.69970807786939,-149.8334847074306,-0.12077718654290925,-0.3952224644857978,-0.27444527794288853,1001208592,993461588.2,20.797190663899457,41.13862984711178,NaN,NaN,-17.828583040477287,-9.12793938908976
2021-01-26T09:30:00-05:00,65.8,66.44,65.5,66.31,9304200,10551125.65,50.988736904972775,42.308841421134446,NaN,NaN,-21.032340972368686,-119.65027719009308,-0.04128468397101398,-0.326051132906656,-0.284766448935642,1010512792,997601694.4,28.89338476449626,39.37508654007705,NaN,NaN,-14.763192636767567,-9.932975567329448
2021-01-27T09:30:00-05:00,65.94,66.83,65.03,65.19,17826773,11126696.55,40.46397267482538,41.72040554715488,NaN,NaN,-60.28216341758333,-94.77980654679389,-0.05817573414913102,-0.35748611662205576,-0.29931038247292474,992686019,996036303.6,27.738804719403277,37.53137798017975,NaN,NaN,-15.628359907551289,-10.746601901646853
2021-01-28T09:30:00-05:00,65.32,66.17,65.13,65.44,19925859,11873310.6,43.27841991558091,41.48429132532571,NaN,NaN,-65.86152615416115,-76.30144818236013,-0.04702987747371018,-0.35809772931506245,-0.31106785184135227,1012611878,1000148334.8,35.0778084034353,36.400359765833066,NaN,NaN,-15.329751895088418,-11.401337614995649
2021-01-29T09:30:00-05:00,65.19,65.21,64.06,64.09,19374812,12474054.25,33.94623532439822,40.30789313927145,NaN,NaN,-178.15146441483674,-83.00544060736388,-0.12089638647656098,-0.46218833493705347,-0.3412919484604925,993237066,1002051269.4,38.20556860998677,35.353519037498856,NaN,NaN,-18.67127019955628,-12.439899412790025
2021-02-01T09:30:00-05:00,64.36,64.5,63.94,64.15,13283499,12835112.9,34.621000037081785,39.60364525359133,NaN,NaN,-181.9864968330167,-101.46279835839333,-0.15391634156028566,-0.5336873754108495,-0.3797710338505639,1006520565,1003113664,39.94511218908465,34.21005538161292,NaN,NaN,-20.900416120371805,-13.648544656730278
2021-02-02T09:30:00-05:00,64.4,65.1,64.21,64.58,13278384,12849400.75,39.39890133880171,39.38889523406876,NaN,NaN,-120.91084764278224,-121.43849969247603,-0.13564016527934308,-0.5493212404497427,-0.41368107517039965,1019798949,1004970895.4,42.967652271695734,33.36441531579214,NaN,NaN,-21.03697843000424,-14.704035195769416
2021-02-03T09:30:00-05:00,64.43,64.835,64.245,64.68,9542039,12782919,40.48812917519536,39.16009856163106,NaN,NaN,-114.46091890902018,-132.2742507907634,-0.1069213126767995,-0.547332716016399,-0.4404114033395995,1029340988,1012301889.2,53.0190607351673,33.50377893992939,NaN,NaN,-20.787467336307554,-15.573096930132007
2021-02-04T09:30:00-05:00,64.74,65.165,64.6,65.15,7292368,12437209.15,45.450733926885526,39.528014718802524,NaN,NaN,-65.43477214763222,-132.18889998945764,-0.04930645166112668,-0.5020444679160079,-0.4527380162548812,1036633356,1017106184.8,58.21620855678647,34.19585234956252,NaN,NaN,-18.953106364171045,-16.05595542070901
2021-02-05T09:30:00-05:00,65.55,65.9577,65.52,65.76,8889285,12183496.6,51.144929610640155,40.45255064549567,NaN,NaN,31.100983011706724,-90.33841050414892,0.03244645371216642,-0.41217994911467315,-0.4446264028268396,1045522641,1027563299.8,66.8199485284971,36.368085778940845,NaN,NaN,-15.47382255273402,-15.97279358242687
2021-02-08T09:30:00-05:00,65.97,66.16,65.58,66.01,9411036,11756005.95,53.29665251586717,41.71097376459983,NaN,NaN,60.65959720553286,-41.809191696439015,0.10199468426164748,-0.3171330474997802,-0.4191277317614277,1054933677,1037245922.2,72.4721487641425,39.47734104252613,NaN,NaN,-11.969518082635757,-15.400897082456712
2021-02-09T09:30:00-05:00,66.02,66.185,65.77,65.95,12345518,11890843,52.69678308787215,42.79521288535268,NaN,NaN,74.12088822489825,-2.802844522902916,0.14023148560668786,-0.2438383747530679,-0.38406986035975577,1042588159,1041803764.2,74.66037221680588,42.906641761812615,NaN,NaN,-9.360931452453912,-14.538044849599169
2021-02-10T09:30:00-05:00,66.26,66.41,65.73,65.88,6957185,11684229.35,51.96197501464222,43.97013318778705,NaN,NaN,81.19195913293824,36.327731085488765,0.15588066085995012,-0.18921903428481812,-0.34509969514476824,1035630974,1043061761.4,75.2452735076207,46.679443171671046,NaN,NaN,-7.449097392646937,-13.525338070034564
2021-02-11T09:30:00-05:00,65.95,65.97,65.49,65.59,7478235,11641324.85,48.91864614791362,45.03564696338632,NaN,NaN,41.97193162065241,57.80907183914569,0.14215682445071742,-0.16740366458137146,-0.3095604890320889,1028152739,1041365638,72.80517666295802,50.490265042427104,NaN,NaN,-6.678965890585081,-12.547284901541781
2021-02-12T09:30:00-05:00,65.53,65.765,65.365,65.69,7131815,11420463.2,50.00599242736325,45.47579343586002,NaN,NaN,34.66670875585905,58.52221698797615,0.13530686429396183,-0.14042690866463658,-0.2757337729585984,1035284554,1039318020.6,69.85986257868944,53.99474160776924,NaN,NaN,-5.736714900957383,-11.574346330029725
2021-02-16T09:30:00-05:00,65.81,65.86,65.34,65.57,9246566,11219778.25,48.667216452006315,45.30997054636242,NaN,NaN,32.649562585985194,52.92021006406662,0.11877612508020205,-0.12726361660834584,-0.2460397416885479,1026037988,1033538882.8,62.210394579761974,56.374528023145366,NaN,NaN,-5.302293575485857,-10.678338793666315
2021-02-17T09:30:00-05:00,65.32,65.945,65.24,65.81,8887385,11257622.5,51.46586176330283,46.095819766967956,NaN,NaN,42.48961339035283,46.59395509715754,0.1197478739260755,-0.09635489928095353,-0.21610277320702903,1034925373,1032006325.6,60.324002431999645,58.702042145473676,NaN,NaN,-4.164975040977921,-9.747858257567973
2021-02-18T09:30:00-05:00,65.22,65.9365,65.17,65.77,7465429,11095858.35,50.96711904844639,46.64501256217263,NaN,NaN,33.9622882955544,37.14802092968077,0.11349702703181683,-0.07423148941725799,-0.18772851644907482,1027459944,1030372119.6,58.29413047395254,60.36035086479633,NaN,NaN,-3.3416315094678426,-8.832683007839384
2021-02-19T09:30:00-05:00,65.82,65.83,64.88,64.94,10242121,11184901.85,41.894767254269006,47.21276484287768,NaN,NaN,-25.921784649031853,23.56927767574392,0.052372239677155596,-0.12226321685263031,-0.1746354565297859,1017217823,1028185136.4,55.5978810530293,61.60265889644223,NaN,NaN,-5.223897598562758,-8.31714223508558
2021-02-22T09:30:00-05:00,64.77,65.17,64.64,65,8649582,11200914.5,42.688960021370136,47.78904769889829,NaN,NaN,-63.42536630459524,3.950862663653065,0.016736145753544263,-0.1537152743378556,-0.17045142009139985,1025867405,1026301706.6,53.31101432447855,62.557366191827505,NaN,NaN,-6.5406638033894255,-8.063359601986129
2021-02-23T09:30:00-05:00,65.21,65.64,64.86,65.09,12742995,10963754.3,43.92701603173024,48.11248446267889,NaN,NaN,-23.933529308809707,-7.365755715305918,0.0008203588567682052,-0.1694259715204396,-0.1702463303772078,1038610400,1028816189,55.91793826431666,63.48238661987186,NaN,NaN,-7.302577135388141,-7.95467639247213
2021-02-24T09:30:00-05:00,64.92,65.26,64.73,65.05,9103992,10953743.9,43.477475876120344,48.32600922703068,NaN,NaN,-43.324841095117094,-24.5286466123999,-0.010198955852777053,-0.18299502519317912,-0.17279606934040206,1029506408,1027732396,54.505286953929165,63.58854563549771,NaN,NaN,-8.058926792527547,-7.969569306765761
2021-02-25T09:30:00-05:00,64.95,65.32,64.202,64.34,17558542,10940332.35,36.36386826704234,47.676947394184744,NaN,NaN,-89.18686608216738,-49.15847748794425,-0.060306195244565486,-0.24817881339610892,-0.18787261815154344,1011947866,1024629980.4,50.56715163569418,63.04218442684826,NaN,NaN,-10.902992820398033,-8.388629808713228
2021-02-26T09:30:00-05:00,64.47,64.47,63.28,63.3,17718477,10829963.25,28.903835519823843,46.08829781626929,NaN,NaN,-183.0456793035164,-80.58325641884116,-0.15320866332322208,-0.37938344730557105,-0.22617478398234897,994229389,1020032293.6,45.33900153926205,61.507831070474325,NaN,NaN,-16.231373832602838,-9.50902181212603
2021-03-01T09:30:00-05:00,63.75,64.46,63.73,63.94,11264333,10424439.3,37.4129860720137,44.95375021313691,NaN,NaN,-130.605194242803,-94.01922200648272,-0.16050138202241065,-0.4268015115103623,-0.2663001294879516,1005493722,1015957557,41.26683476989359,59.278880070885116,NaN,NaN,-17.841302460284965,-10.699347619005877
2021-03-02T09:30:00-05:00,63.87,64.32,63.8,63.83,12942448,10407386.75,36.60212997026057,43.804132133307505,NaN,NaN,-133.66432434022045,-115.96538101276488,-0.1612507047296678,-0.4678635104000364,-0.3066128056703686,992551274,1006745731.8,33.86225646971559,56.36472894609295,NaN,NaN,-19.36183083341462,-11.936845221064269
2021-03-03T09:30:00-05:00,63.66,64.025,63.49,63.53,13450882,10416011.65,34.41164582459899,42.55053719116155,NaN,NaN,-149.59578224840496,-137.21956924342243,-0.16961730601293568,-0.5186344381865382,-0.34901713217360253,979100392,996664528.6,27.951358589556136,52.986592166231205,NaN,NaN,-21.31680092230771,-13.276838892670474
2021-03-04T09:30:00-05:00,63.66,64.43,62.99,63.3,25967478,11237283.6,32.79138553791893,41.39859000473336,NaN,NaN,-143.00834221573822,-147.9838644701366,-0.1774658502543141,-0.5708494449914951,-0.39338359473718104,953132914,984901538.2,22.923257962230863,49.42359797332212,NaN,NaN,-23.42602717507862,-14.726722933014495
2021-03-05T09:30:00-05:00,63.57,64.89,63.325,64.7,21719456,11958638,48.642731458299004,41.30121422122876,NaN,NaN,-64.66170938524343,-124.307070486482,-0.08015098012686461,-0.4935723198957618,-0.41342133976889717,974852370,981026134.4,21.547976962787274,45.97274900075768,NaN,NaN,-19.701648540786163,-15.43742659126759
2021-03-08T09:30:00-05:00,64.72,65.67,64.61,64.98,18946972,12461522.35,51.12551073851905,41.47680667026539,NaN,NaN,11.203572836442023,-95.94531707063301,0.006683771296589314,-0.40506662564816054,-0.41175039694474985,993799342,978687258.4,20.739283791765118,43.01052680161505,NaN,NaN,-15.916928275777947,-15.505926831911927
2021-03-09T09:30:00-05:00,65.2,65.51,64.87,64.92,17259567,12853948.9,50.561440050807846,41.41220511937289,NaN,NaN,17.2038079687815,-65.77169060883263,0.06068452682801201,-0.3358947384097348,-0.39657926523774684,976539775,975484958.6,19.651808802516,40.10537011379479,NaN,NaN,-13.174867322760232,-15.172918330604542
2021-03-10T09:30:00-05:00,64.97,66.055,64.76,65.77,15827666,13028056.3,57.68423479762205,41.89199910145687,NaN,NaN,64.08438986196684,-23.03565618675827,0.1492105227597445,-0.21006611178806622,-0.3592766345478107,992367441,978138368.4,23.24325288005744,37.60173599994515,NaN,NaN,-8.269131137307705,-14.186663017276423
2021-03-11T09:30:00-05:00,65.84,66.04,65.54,65.61,12386463,13299520.2,56.047323171039594,42.90289595265477,NaN,NaN,87.63564982930438,23.093142222250258,0.1899396701009206,-0.12185204692165996,-0.3117917170225806,979980978,983507981.2,30.056636497576235,35.777361388841356,NaN,NaN,-4.936315711550906,-12.865184830744207
2021-03-12T09:30:00-05:00,65.85,66.235,65.795,66.15,10518244,13451520.65,60.156750536090996,44.15059527513483,NaN,NaN,117.79366629076513,59.58421735745196,0.2428150432623804,-0.008272912944605082,-0.2510879562069855,990499222,986637351.6,33.74765497272341,34.379978578001705,NaN,NaN,-0.7484332172566175,-11.134220314531694
2021-03-15T09:30:00-04:00,66.388,66.5,66.04,66.44,8384558,13514157.8,62.20069331913612,45.455857938520964,NaN,NaN,135.95020400380062,84.5335435909237,0.28402378046853144,0.10394176937867883,-0.1800820110898526,998883780,987654239.2,34.94896358516958,32.88219467234834,NaN,NaN,3.323344790604622,-9.068853870940792
2021-03-16T09:30:00-04:00,66.36,66.73,66.36,66.52,13550248,13729341.9,62.76811468431499,46.83376071053487,NaN,NaN,143.9309030793811,109.87896261304361,0.3017108091301235,0.19705650032280175,-0.10465430880732174,1012434028,994833089.8,42.8300772033352,32.04825111873449,NaN,NaN,6.749217028716818,-6.809129456703991
2021-03-17T09:30:00-04:00,66.55,66.82,66.195,66.42,12254152,13897680.25,61.52484014304516,48.63097298739221,NaN,NaN,128.4178584110786,122.74565632286597,0.291552863847331,0.259786771001842,-0.031766092845488994,1000179876,996395576.8,44.4087283086658,31.608363738232466,NaN,NaN,9.190431028281411,-4.523477958848933
2021-03-18T09:30:00-04:00,66.25,66.52,65.83,66.15,14495554,14249186.5,58.17435292706256,50.721724230766405,NaN,NaN,95.15759695371436,124.25004574774796,0.25296121381911846,0.2844354244284091,0.03147421060929062,985684322,997536245.6,45.589934286393145,31.626287505884683,NaN,NaN,10.311079665542584,-2.4042554410787167
2021-03-19T09:30:00-04:00,66.22,66.5598,66.06,66.38,20807120,14777436.45,60.16446214711066,52.3468296647019,NaN,NaN,97.70601279842593,120.23251504928012,0.229903188706793,0.3188531964927819,0.08895000778598888,1006491442,1000734689.6,48.87054048362086,32.16940934257949,NaN,NaN,11.826305349084482,-0.3713181853411167
2021-03-22T09:30:00-04:00,65.91,66.76,65.86,66.72,14496857,15069800.2,62.96944510836699,54.23020931742379,NaN,NaN,94.24326938638788,111.89112812579756,0.2242860256816303,0.3693075398880268,0.14502151420639647,1020988299,1005155593.4,53.08145462482916,33.542209210801886,NaN,NaN,13.947360343030798,1.6742073187120141
2021-03-23T09:30:00-04:00,66.71,67.31,66.53,67,13216342,15093467.55,65.14602991807394,56.42552246695772,NaN,NaN,114.02861556695125,105.9106706233116,0.2255546650447698,0.4269648455123587,0.2014101804675889,1034204641,1009509716,56.85069042754791,35.60644719922987,NaN,NaN,16.391743441858466,3.776712479161507
2021-03-24T09:30:00-04:00,66.84,67.17,66.585,66.74,15831102,15429823.05,61.529447320809126,58.47824116573559,NaN,NaN,94.58209557554301,99.14351805620448,0.19609706460480647,0.446531511223597,0.25043444661879055,1018373539,1013148448.6,59.76006857295327,38.23764795713861,NaN,NaN,17.452838874584103,5.730444821364735
2021-03-25T09:30:00-04:00,66.83,67.47,66.5,67.39,14763964,15290094.15,66.5317315999173,59.75602689013688,NaN,NaN,102.70542731871177,100.65308412920396,0.20655219761135274,0.5086246936329815,0.3020724960216287,1033137503,1022639084.8,66.1675783024562,41.42476233854354,NaN,NaN,19.942841698782686,7.760787232424442
2021-03-26T09:30:00-04:00,67.47,68.62,67.275,68.58,15098162,15159078.4,73.36102463143546,61.34427788248805,NaN,NaN,155.09784125828233,112.13144982117524,0.2754665475775094,0.6464056804935154,0.37093913291600605,1048235665,1030987929.4,70.60225350650471,44.98640303245351,NaN,NaN,24.709624215884823,10.182049658633067
2021-03-29T09:30:00-04:00,68.38,69.335,68.35,69.27,11857274,15188725.45,76.371686867453,63.18786694081986,NaN,NaN,186.81867753189982,130.64653145027765,0.34487272219801146,0.8020300356635204,0.4571573134655089,1060092939,1038808857.4,74.03564177082835,48.870962530190106,NaN,NaN,29.79750660045229,12.98425779317867
2021-03-30T09:30:00-04:00,69.14,69.21,68.4,68.53,14042732,15243739.65,67.55385222072839,63.892839613898886,NaN,NaN,157.4774670687032,139.33630175062802,0.3189034826680365,0.8557866668005545,0.536883184132518,1046050207,1041177970.6,74.9885687659652,52.56705652204066,NaN,NaN,30.89256149063935,15.54258689281591
2021-03-31T09:30:00-04:00,68.5,68.78,68.16,68.31,18241132,15483252.15,65.14566240075219,64.54272098744978,NaN,NaN,128.90464423705666,146.20081148293076,0.26697447136630403,0.870601273340398,0.603626801974094,1027809075,1043065077.8,75.75197184589565,55.83100904692061,NaN,NaN,30.922494073288163,17.739716490026233
2021-04-01T09:30:00-04:00,68.04,68.33,67.53,67.98,21191774,15244466.95,61.598456724539844,64.64570000091041,NaN,NaN,87.18990873506134,143.09770776620067,0.19386815077986663,0.8459619904489273,0.6520938396690606,1006617301,1037761037.4,69.34536954205221,58.373702944729814,NaN,NaN,29.771288538802875,19.458512496994324
2021-04-05T09:30:00-04:00,68.27,69.22,68.15,68.85,20092997,15163144,66.74020109825489,64.96995055656176,NaN,NaN,124.25011907119033,136.92816332878226,0.18745998898412186,0.886418825899213,0.6989588369150911,1026710298,1033455964,64.57188307611875,60.4896257655119,NaN,NaN,30.51573067514069,21.038115093872378
2021-04-06T09:30:00-04:00,68.73,69.4,68.68,69.14,19302195,15180905.15,68.26550648301885,65.3626213993263,NaN,NaN,126.46313211879728,124.85705424616177,0.18575136314223506,0.9311480408428849,0.7453966777006499,1046012493,1030639874.8,61.58548875479406,61.82929801918753,NaN,NaN,31.61053951467647,22.548461439701533
2021-04-07T09:30:00-04:00,69.26,69.35,68.88,68.97,20763858,15356119.7,66.3447197164038,65.70689851170907,NaN,NaN,109.68352751635604,115.29826633569232,0.1572983940947359,0.9420196703190697,0.7847212762243339,1025248635,1026479560.4,57.364525844733556,62.754712128906654,NaN,NaN,31.87728852348665,23.881151023099406
2021-04-08T09:30:00-04:00,68.94,69.18,68.86,69.04,10244788,15076975.8,66.75946329209108,66.32012068063968,NaN,NaN,94.98188659273451,108.51371480682789,0.1285318649616538,0.9453861074264012,0.8168542424647474,1035493423,1028016430,58.49618772009955,63.6765873741714,NaN,NaN,32.21332154214464,25.071461097248726
2021-04-09T09:30:00-04:00,69.05,69.205,68.5,68.92,7020455,14808675.4,65.27442584288595,66.68511808748077,NaN,NaN,77.3819227806947,106.55211761595456,0.08865848518826935,0.927677348950084,0.8390188637618147,1028472968,1032387563.4,61.61672476156496,64.58702910831026,NaN,NaN,32.06330965206087,26.070296605079033
2021-04-12T09:30:00-04:00,69.01,69.3,68.915,69.29,10117926,14788659.5,67.66295251300403,67.02036861638342,NaN,NaN,87.06454748974765,99.11500329966604,0.07498235971349387,0.932746813403682,0.8577644536901882,1038590894,1034763682.6,63.234937112181335,65.31227785740684,NaN,NaN,32.61549491772564,27.00532493545712
2021-04-13T09:30:00-04:00,68.99,69.18,68.83,68.92,11982803,14968571.75,62.9965508815803,66.86683439949103,NaN,NaN,69.3781425794829,87.69800539180316,0.0310471196138159,0.896573353207458,0.8655262335936421,1026608091,1030882802.2,58.86947369528793,65.45647666224542,NaN,NaN,31.733593620963724,27.680791890529495
2021-04-14T09:30:00-04:00,68.88,68.96,68.57,68.86,12087520,14895435.35,62.24685897587155,66.91807808913833,NaN,NaN,53.08935827212205,76.37917154295636,-0.009838076313031463,0.8532286382023528,0.8630667145153843,1014520571,1028737189.4,56.54526417739212,65.22684777684819,NaN,NaN,30.799005169841532,28.126250930431215
2021-04-15T09:30:00-04:00,69.02,69.52,69.02,69.41,7714920,14668473.75,66.21580953612364,66.89551222743879,NaN,NaN,83.29956414436407,74.04270705328227,-0.007717096216732111,0.8534203442444692,0.8611374404612013,1022235491,1026085603,53.72246384862847,64.33791103014622,NaN,NaN,31.097555629060068,28.550723030235336
2021-04-16T09:30:00-04:00,69.7,69.95,69.43,69.81,7810039,14334198,68.78593822539223,66.56872034129285,NaN,NaN,108.88766567336658,80.34385563181664,0.011693075812040155,0.8757537852262516,0.8640607094142114,1030045530,1026400115.4,54.015695078145555,63.153156856691986,NaN,NaN,32.110070877681466,29.05920129415621
2021-04-19T09:30:00-04:00,69.82,69.96,69.32,69.54,10867366,13837210.3,65.18136966042329,65.76941196936215,NaN,NaN,97.1667305201315,82.36429223789341,-0.001862220537629078,0.8617329337421751,0.8635951542798042,1019178164,1022517569.4,49.81907928888729,61.4234023936962,NaN,NaN,31.9161113040759,29.46733129557331
2021-04-20T09:30:00-04:00,69.05,70.14,68.95,69.92,13168950,13770814.95,67.74335880264132,65.78294815378452,NaN,NaN,103.30040585037064,89.14874489207097,0.006116683072823315,0.8712410081208333,0.86512432504801,1032347114,1023665374,51.03035288418089,59.71210125928304,NaN,NaN,32.497499587253635,29.90021248009907
2021-04-21T09:30:00-04:00,70,70.47,70,70.27,10794944,13649745.05,69.93747765598583,66.12522067201549,NaN,NaN,161.86225456750745,110.90332415114804,0.025246067647189507,0.8966819096069969,0.8714358419598074,1043142058,1029389671.4,56.650258802104176,58.3476931847265,NaN,NaN,33.64291512420745,30.43488428640027
2021-04-22T09:30:00-04:00,70.15,70.19,69.6,69.75,10762899,13396334.9,63.07304303540315,66.23054826564858,NaN,NaN,115.76899265941255,117.39720985415775,-0.005217344696449411,0.8649141610892457,0.8701315057856951,1032379159,1031418405,58.46936542184336,57.57083574756872,NaN,NaN,32.55827204508211,30.738225394783388
2021-04-23T09:30:00-04:00,69.61,69.79,69.29,69.57,9133794,13114826.4,60.846731646517554,65.80958616195305,NaN,NaN,69.3205216197611,109.48378104343665,-0.04345772188078334,0.815809353434716,0.8592670753154993,1023245365,1030058372,56.750082881207,57.01213573364646,NaN,NaN,31.000815945760706,30.775738330637292
2021-04-26T09:30:00-04:00,69.53,69.53,68.69,68.79,8750052,12797420.9,52.2414663683122,64.66501186804544,NaN,NaN,-22.219467173600105,85.60654150469033,-0.12275947555301525,0.7058177308742302,0.8285772064272454,1014495313,1029121801.8,55.53894914114403,56.58024004695717,NaN,NaN,26.822923675940597,30.211050522823477
2021-04-27T09:30:00-04:00,68.75,68.885,68.44,68.74,10078892,12708501.8,51.736359863335316,63.62155759282626,NaN,NaN,-69.78455774120407,50.98954878637538,-0.17677388728601873,0.607609847319722,0.7843837346057407,1004416421,1023535663.2,48.84338177997228,55.971586899474225,NaN,NaN,23.336511241820585,29.228973482680207
2021-04-28T09:30:00-04:00,69.02,69.18,68.71,68.79,7925308,12402630.6,52.233723097255,62.58400472176653,NaN,NaN,-38.98739003731529,10.819619865410829,-0.20532248844252832,0.5277306240525803,0.7330531124951086,1012341729,1017375597.4,42.72631168085751,54.84516718238551,NaN,NaN,20.638874811574272,28.001816529665074
2021-04-29T09:30:00-04:00,68.76,69.63,68.76,69.52,9202883,11950718.15,58.89405378899538,62.12826386077436,NaN,NaN,21.948762233730893,-7.944426219725509,-0.1725490651578485,0.517366781047798,0.6899158462056465,1021544612,1015208688,40.791037217655536,53.35761807210626,NaN,NaN,20.175438075927772,26.88376246484546
2021-04-30T09:30:00-04:00,69.52,69.61,69.24,69.58,10784797,11430369.3,59.395200454910785,61.53771014233913,NaN,NaN,42.99578362895665,-13.209373817886398,-0.14542278249780016,0.5081373680833963,0.6535601505811964,1032329409,1017025496.8,43.11741190821755,51.92065198610885,NaN,NaN,19.9470684699712,25.892806179863424
2021-05-03T09:30:00-04:00,69.73,70.41,69.66,70.15,12671491,11059294,63.8981579378921,61.602110646361396,NaN,NaN,137.90317663556746,18.815154943947128,-0.0903795662547483,0.540585692762761,0.6309652590175093,1045000900,1023126614.2,50.19449649745227,51.30101075769202,NaN,NaN,21.11925520014172,25.210870325617467
2021-05-04T09:30:00-04:00,70,70.2685,69.57,69.79,11147284,10651548.45,59.41648883452859,61.399941350551195,NaN,NaN,89.68563804430883,50.709194101049704,-0.07986844726984388,0.5311296999302044,0.6109981472000483,1033853616,1029014053.2,55.89675969472398,51.25468900893001,NaN,NaN,20.75295012602737,24.574024582818883
2021-05-05T09:30:00-04:00,69.77,69.87,69.45,69.74,8726230,10049667.05,58.79964062541382,60.87021499978621,NaN,NaN,51.17779650153301,68.74223140881936,-0.07785468221171521,0.5136797944354043,0.5915344766471196,1025127386,1031571184.6,58.138552512812126,51.57012391351456,NaN,NaN,20.277936650889828,23.960297735400445
2021-05-06T09:30:00-04:00,69.87,70.66,69.87,70.64,10192046,10047029.95,65.70199657874056,60.64993345359681,NaN,NaN,151.1739508910847,94.58726914029013,-0.020468231669798498,0.5659491870598714,0.5864174187296699,1035319432,1034326148.6,60.46986676847518,52.03113617710953,NaN,NaN,22.042247603116298,23.686290573645568
2021-05-07T09:30:00-04:00,70.53,70.855,70.3597,70.64,9841789,10188096.65,65.70199657874056,60.68712109061947,NaN,NaN,166.65656482455066,119.31942537940893,0.011227206626526653,0.6004514270128283,0.5892242203863016,1035319432,1034924153.2,60.97787502801136,52.828193015618396,NaN,NaN,23.435079252263684,23.650403242019586
2021-05-10T09:30:00-04:00,70.94,71.64,70.88,71.18,10558652,10210132.95,69.28293373584053,60.79709072870513,NaN,NaN,216.43361499909503,135.02551305211446,0.059594438301824426,0.6637172682635821,0.6041228299617577,1045878084,1035099590,61.13567049777241,53.55000141658921,NaN,NaN,25.78059361505699,23.9547161524535
2021-05-11T09:30:00-04:00,71.21,71.36,70.24,70.56,14385702,10330277.9,61.361457236936126,60.184517841630154,NaN,NaN,128.23644845841955,142.73567513493657,0.041711419065173505,0.6562621037932246,0.6145506847280511,1031492382,1034627343.2,60.427317170451914,53.81979130004263,NaN,NaN,25.301398243241607,24.14709930828037
2021-05-12T09:30:00-04:00,70.4,70.48,69.61,69.62,13223132,10387058.5,51.70845741411303,59.37276172582371,NaN,NaN,15.568553742262425,135.61382658308247,-0.03727523772683372,0.5679566375695089,0.6052318752963426,1018269250,1033255716,58.31392881890859,53.80868868554728,NaN,NaN,21.51472085840554,23.771045244012537
2021-05-13T09:30:00-04:00,69.61,70.92,69.53,70.6,18497984,10926211.7,58.957538225171966,59.237819338584735,NaN,NaN,70.01425534805307,119.38188747447616,-0.027804987359356437,0.570475641097147,0.5982806284565034,1036767234,1033545276.4,58.64276925072633,53.943880569084385,NaN,NaN,20.844575320577675,23.352978112093272
2021-05-14T09:30:00-04:00,70.87,71.335,70.83,70.91,9672566,11019338.05,60.95420868685956,59.860158075623836,NaN,NaN,138.09565610519613,113.66970573060526,-0.006082569019755901,0.5906774171818086,0.5967599862015645,1046439800,1035769350,61.17607908025875,54.34653270759258,NaN,NaN,21.016159374949435,23.019146863929866
2021-05-17T09:30:00-04:00,70.95,71.255,70.66,70.81,10705805,11011260,59.9411810903981,60.446216734699746,NaN,NaN,107.37039377894999,91.85706148657623,-0.003970832983215877,0.5917964449725446,0.5957672779557605,1035733995,1033740532.2,57.70376061658039,54.97941691020744,NaN,NaN,20.819822728962468,22.704957701791667
2021-05-18T09:30:00-04:00,70.89,71.17,70.55,70.59,11169175,10911271.25,57.670386731195514,60.83454985140978,NaN,NaN,81.70031092951628,82.54983398079557,-0.021910462711220435,0.5683791995667349,0.5902896622779553,1024564820,1032355019.8,55.39151886552952,55.88407456625544,NaN,NaN,19.950301043935458,22.31143532209792
2021-05-19T09:30:00-04:00,70.25,70.46,69.86,70.36,13709689,11057008.5,55.31123588084974,60.57863428654223,NaN,NaN,22.01030302361397,83.83818383706588,-0.05206571326837228,0.52520752069249,0.5772732339608623,1010855131,1030872196,52.94624180108505,56.75230346507184,NaN,NaN,18.518380799576846,21.769570390309195
2021-05-20T09:30:00-04:00,70.37,71.26,70.33,71.01,11336452,11085686.15,60.25902893703651,60.640336320979785,NaN,NaN,83.08799511079543,86.45293178961437,-0.03201847779006006,0.5372501367232871,0.5692686145133472,1022191583,1027957065.8,48.420715482339254,57.131110863223384,NaN,NaN,18.812054701629112,21.347068149069184
2021-05-21T09:30:00-04:00,71.19,71.48,70.89,71.02,7779569,11017974.9,60.33179469566225,60.38559608939194,NaN,NaN,99.63171368943632,78.7601433064624,-0.022326534114483265,0.5413604468702431,0.5636869809847264,1029971152,1024663336.2,43.85919830443261,56.67858956372198,NaN,NaN,19.066796724760255,21.021315088453623
2021-05-24T09:30:00-04:00,71.11,71.48,70.97,71.23,6535992,10907271.9,61.909093147572634,60.56363925460937,NaN,NaN,101.62547959097125,77.61116046886664,-0.00681873497721841,0.5551635622632034,0.5619822972404218,1036507144,1024817966,44.125321716220206,55.837772565257424,NaN,NaN,19.73672031830197,20.83780154986053
2021-05-25T09:30:00-04:00,71.28,71.31,70.82,71.25,8271854,10816920,62.063803897300396,60.79679377402984,NaN,NaN,85.79244839750932,78.42958796246526,-0.0005884296136647871,0.5612467602233409,0.5618351898370056,1044778998,1028860801.6,50.70473608685181,55.306785677688836,NaN,NaN,20.327636013346755,20.76492075892999
2021-05-26T09:30:00-04:00,71.29,71.36,70.965,71.1,10622576,10951783.4,60.092448065347625,60.396111737358915,NaN,NaN,81.33935055041111,90.2953974678247,-0.011347342213668288,0.5476510120699203,0.5589983542835886,1034156422,1033521059.8,56.991600144715036,55.058338061705975,NaN,NaN,20.300467603373605,20.69857030813622
2021-05-27T09:30:00-04:00,71.22,71.45,70.59,70.66,12693907,11126334.6,54.61263361764738,59.60401438299511,NaN,NaN,45.261917013875156,82.73018184844064,-0.05067202713953556,0.4956583203591691,0.5463303474987047,1021462515,1033375246.2,56.747734770547964,54.75618518617288,NaN,NaN,18.74401753194121,20.419348482965503
2021-05-28T09:30:00-04:00,70.77,71.105,70.76,70.81,8476372,11010913.35,56.08292243708744,58.66115643308417,NaN,NaN,38.75895908781873,70.55563092811711,-0.06807180633132504,0.4612405895845484,0.5293123959158734,1029938887,1033368793.2,56.73616439173645,54.44193475002745,NaN,NaN,17.82716213161077,20.049036147057684
2021-06-01T09:30:00-04:00,71.08,71.26,70.33,70.57,8894050,10822041.3,53.11799537452813,58.07233772862646,NaN,NaN,6.127435720912734,51.45602215410541,-0.09555109366075953,0.409873528839924,0.5054246225006835,1021044837,1030276331.8,51.33440893519426,53.7924413046519,NaN,NaN,16.218995261802743,19.501887449164123
2021-06-02T09:30:00-04:00,70.67,70.955,70.5,70.83,6411362,10585245.2,55.84159665400756,58.367561960047496,NaN,NaN,6.58416725431313,35.614365925466174,-0.09578089958986313,0.38569849801335465,0.4814793976032178,1027456199,1026811772,46.04523227444931,52.91610583719052,NaN,NaN,15.565394783037812,18.939531354003222
2021-06-03T09:30:00-04:00,70.62,71.33,70.62,71.27,9409968,10619432.1,60.06933332669807,58.446975895870786,NaN,NaN,66.89018559958743,32.72453293530143,-0.06721372814907456,0.3974622374168746,0.46467596556594915,1036866167,1027353721,46.965747548942495,52.08203285849168,NaN,NaN,16.188884568333183,18.546581813193217
2021-06-04T09:30:00-04:00,71.48,71.685,71.29,71.52,6078231,10413741.35,62.27911061994681,58.54161174823417,NaN,NaN,155.11832273516544,54.69581407955949,-0.03406686995788599,0.4220923781185917,0.4561592480764777,1042944398,1031650097.6,53.708416206555135,51.54862836751285,NaN,NaN,17.35741136589072,18.376700320721433
2021-06-07T09:30:00-04:00,71.53,71.62,71.08,71.4,7307053,10287004.55,60.54705865937848,58.58488871744705,NaN,NaN,112.29398312435039,69.40281888686582,-0.023322056238671673,0.42700667777813806,0.45032873401680973,1035637345,1032789789.2,55.330798667222794,51.379131085415885,NaN,NaN,17.858877273583296,18.3027255997017
2021-06-08T09:30:00-04:00,71.42,71.51,70.785,70.8,8545311,10186337.5,52.66096366219477,58.227072783946994,NaN,NaN,36.47545974911377,75.47242369250603,-0.05776099383365568,0.37812749172474014,0.4358884855583958,1027092034,1033999228.6,57.0510244804759,51.49766720076919,NaN,NaN,15.976209440267553,17.970366148353964
2021-06-09T09:30:00-04:00,70.67,71.02,70.44,70.46,8273863,9880745.55,48.7834460453771,57.76080208141324,NaN,NaN,-56.95192499502733,62.76520524263795,-0.10199064379987866,0.3084001808085475,0.41039082460842613,1018818171,1032271623,53.86028674951902,51.56295612565733,NaN,NaN,13.1868710013342,17.287009698779713
2021-06-10T09:30:00-04:00,70.59,71.075,70.56,70.9,8213077,9630242.8,53.55004603993947,57.28158901733487,NaN,NaN,-23.238925199720956,44.73938308277626,-0.10002809617992525,0.28535570438351954,0.3853838005634448,1027031248,1030304639.2,50.40382303673333,51.70460666525691,NaN,NaN,12.211061996405558,16.56187431272626
2021-06-11T09:30:00-04:00,71.04,71.07,70.6,70.94,6232513,9016969.25,53.96945381801151,56.827136097502674,NaN,NaN,-26.200873362464073,8.475543863250358,-0.09451513525600524,0.26723988149343825,0.3617550167494435,1033263761,1028368511.8,47.19339878380937,51.94276384235525,NaN,NaN,11.546064799701297,15.845330096579836
2021-06-14T09:30:00-04:00,70.88,70.92,70.465,70.9,10449377,9055809.8,53.449719604216995,56.222895130120136,NaN,NaN,-56.13084806968143,-25.20942237555601,-0.09195583657117534,0.24681022103547434,0.3387660576066497,1022814384,1025803919.6,43.262601477551705,51.881140968164644,NaN,NaN,10.855456446675277,15.132491003736328
2021-06-15T09:30:00-04:00,70.96,71.12,70.664,70.73,5151605,8778099.8,51.19329920856221,55.44643050949598,NaN,NaN,-30.281594198349904,-38.56083316504875,-0.09946870916595707,0.21443017114920337,0.31389888031516044,1017662779,1023918068.6,40.585620257706985,51.15834698036859,NaN,NaN,9.644287681257527,14.348461957667928
2021-06-16T09:30:00-04:00,70.75,70.83,69.77,69.79,10507098,8744995.95,40.90933378172549,54.07620806066583,NaN,NaN,-216.65684816862114,-70.5018177997675,-0.16181367822352621,0.11163178253575268,0.2734454607592789,1007155681,1021585570.6,37.495269599480785,49.76575194142328,NaN,NaN,5.169968684241251,13.037248632892688
2021-06-17T09:30:00-04:00,69.8,70.19,69.61,70.04,9239730,8521498,44.12423623370186,53.327036818955435,NaN,NaN,-250.75560881433586,-116.00515452269046,-0.1789462907243223,0.049762597353876004,0.2287088880781983,1016395411,1019458403.2,34.88637524329327,48.204226260905095,NaN,NaN,2.458397449178777,11.525984178076415
2021-06-18T09:30:00-04:00,69.56,69.65,68.78,68.8,16882484,8798799.6,34.188583908481235,51.763155495483566,NaN,NaN,-322.94904431725104,-175.35478871364785,-0.26152301848130405,-0.09819488502343177,0.16332813345787228,999512927,1012708236.4,28.184605625048462,46.164829206141675,NaN,NaN,-3.7908761654659644,9.337861271856076
2021-06-21T09:30:00-04:00,68.76,69.21,68.72,69.14,14278434,9123742.85,38.29161918723097,50.70412862496234,NaN,NaN,-239.40941425219913,-212.01050195015142,-0.27936206860536433,-0.18587445229883315,0.0934876163065312,1013791361,1010903631.8,26.707475601018004,44.405762539414795,NaN,NaN,-7.332240372854837,6.956418179754516
2021-06-22T09:30:00-04:00,69.15,69.53,69.0417,69.24,8351059,9214496.2,39.486601091268646,49.53591465619528,NaN,NaN,-159.7147874892706,-237.89714060833552,-0.2703691607339454,-0.24447383461090055,0.02589532612304485,1022142420,1011799560,28.705221810900397,43.16719036344701,NaN,NaN,-9.694599732648104,4.577701335125571
2021-06-23T09:30:00-04:00,69.18,69.19,68.81,68.81,7072865,9154546.75,36.237051494707025,47.83360881105306,NaN,NaN,-158.1173883088679,-226.1892486363849,-0.2782370603190739,-0.3219009992757975,-0.04366393895672363,1015069555,1013382334.8,32.22011449604484,42.11393085966862,NaN,NaN,-12.737654365143344,2.1040790922300117
2021-06-24T09:30:00-04:00,68.83,69.23,68.77,69.15,6343771,8940606.5,40.41268504651509,46.27172127009366,NaN,NaN,-122.66097759306207,-200.57032239213012,-0.24648677939085448,-0.35177241319529173,-0.10528563380443726,1021413326,1014385917.8,34.427582391920794,40.73672844433759,NaN,NaN,-13.90659079358316,-0.18315946288615548
2021-06-25T09:30:00-04:00,69.19,69.76,69.065,69.68,9241292,8767975.75,46.3145861572737,45.25511609137188,NaN,NaN,-71.44982545030284,-150.27047861874047,-0.17888184328494777,-0.328887937910622,-0.1500060946256742,1030654618,1020614256,46.149238779247284,40.080902738053624,NaN,NaN,-12.96031187518714,-2.0084669503577244
2021-06-28T09:30:00-04:00,69.73,69.93,69.585,69.74,7570632,8722688.75,46.955119368800695,44.84755578470088,NaN,NaN,-44.095564765542804,-111.20770872140925,-0.1219344604856755,-0.3024241702327686,-0.18048970974709308,1038225250,1025501033.8,53.21571462722019,39.80695203424965,NaN,NaN,-12.013303861820003,-3.437729366280907
2021-06-29T09:30:00-04:00,69.78,69.9,69.32,69.43,13155421,8935757.3,44.03198525646914,44.50816572835031,NaN,NaN,-55.7683691031307,-90.41842504418126,-0.09798692384759963,-0.30297336455659263,-0.204986440708993,1025069829,1026086515.6,53.994638422076086,39.81654858228944,NaN,NaN,-12.100791040493005,-4.675309605454064
2021-06-30T09:30:00-04:00,69.58,70.0592,69.55,69.97,8815138,9055946.1,49.884645921456624,44.24635143417297,NaN,NaN,-25.675343913297034,-63.9300161650671,-0.04151007464690773,-0.25687403401762765,-0.21536395937071992,1033884967,1029849598,58.74853137311318,40.41259917774515,NaN,NaN,-10.320450123744848,-5.481758250924176
2021-07-01T09:30:00-04:00,70,70.17,69.65,69.76,11633080,9167101.7,47.79161627928599,43.805077324264,NaN,NaN,-21.431167436608607,-43.684054133776414,-0.015373730294640897,-0.23458112223902106,-0.21920739194438016,1022251887,1030017310.2,58.95211243383161,41.25250729560388,NaN,NaN,-9.49308092361389,-6.054804347022706
2021-07-02T09:30:00-04:00,69.92,70.14,69.83,69.93,20733310,9899855.65,49.63391884109689,43.532520126898284,NaN,NaN,-4.934341299704211,-30.380957303656686,0.014661415144496592,-0.20088062301375942,-0.215542038158256,1042985197,1032483426,61.92749556871522,42.58571401640126,NaN,NaN,-8.260798459336765,-6.369946363067572
2021-07-06T09:30:00-04:00,69.77,69.8,69.31,69.64,7595657,9914285.85,46.61219989424787,43.20529874730439,NaN,NaN,-39.86810367743609,-29.535465086035327,0.016176219930987473,-0.19532176324452166,-0.21149798317550914,1035389540,1031916284,60.83537323142408,44.03212494309535,NaN,NaN,-8.097023306014382,-6.616671640631402
2021-07-07T09:30:00-04:00,69.62,70.275,69.61,70.01,7880556,9881048.1,50.7333369541821,43.90701325962272,NaN,NaN,12.19398020812711,-15.942995223783765,0.04181840839953893,-0.15922497267608549,-0.20104338107562442,1043270096,1035556337.4,65.09067053144634,46.00322500966431,NaN,NaN,-6.719431684346468,-6.6313516468764115
2021-07-08T09:30:00-04:00,69.68,70.06,69.48,69.75,9212884,9927999.15,47.933270113635665,44.17908710818943,NaN,NaN,-8.972086763502173,-12.602343793824792,0.040938526826815064,-0.14987022254210558,-0.19080874936892064,1034057212,1035590786.4,65.12928502256426,48.1634328510408,NaN,NaN,-6.3770587769248985,-6.595024094026195
2021-07-09T09:30:00-04:00,70.02,70.275,69.88,70.15,6287124,9831701.5,52.295473274800074,45.47243634864077,NaN,NaN,47.21399730820564,1.1266891551380567,0.06550760135207365,-0.10892424767882858,-0.17443184903090223,1040344336,1039209276.2,69.00725361806988,51.07933627911377,NaN,NaN,-4.762210746636674,-6.3331936158276925
2021-07-12T09:30:00-04:00,70.03,70.14,69.771,70.04,7384238,9889287.75,51.02933006583495,46.38227283996963,NaN,NaN,39.84883316034382,10.083324047147661,0.07204332342494657,-0.08437769474971901,-0.15642101817466558,1032960098,1037204256.4,64.71278417281758,53.79400117709946,NaN,NaN,-3.7990750819149413,-5.971176682411585
2021-07-13T09:30:00-04:00,70.02,70.45,69.875,70.02,12057924,9969715.1,50.78855771886743,47.189555456226685,NaN,NaN,71.97463576423608,32.451871935482096,0.07251286463055945,-0.06577993738646626,-0.1382928020170257,1020902174,1034306783.2,58.998747649227575,55.95782445126569,NaN,NaN,-3.0763349751000235,-5.5576278670813615
2021-07-14T09:30:00-04:00,70.11,70.74,70.01,70.64,7616097,10092939.7,57.48541522718453,48.70729572283222,NaN,NaN,143.59571895503672,58.73221968486403,0.10983366042112741,-0.0010007264906164437,-0.11083438691174385,1028518271,1031356418.2,53.79041378972702,57.498560115100126,NaN,NaN,-0.4018389277073698,-4.821086590027934
2021-07-15T09:30:00-04:00,70.53,70.94,70.325,70.93,8662510,10000710.3,60.21275840313526,50.12158667687652,NaN,NaN,176.23069206568996,95.77277545070245,0.14698552868406675,0.07289752394333959,-0.07408800474072716,1037180781,1031981132,54.70226204776113,58.94675151908872,NaN,NaN,2.6985011445019658,-3.746859770809377
2021-07-16T09:30:00-04:00,71.05,71.31,70.95,71.04,8634370,9970442.3,61.22875206005275,51.18688424136074,NaN,NaN,203.29905923053224,126.98978783516777,0.17026176488130645,0.1387392013609059,-0.031522563520400546,1045815151,1033075295,56.32774247274026,59.67378749719536,NaN,NaN,5.5549178716630045,-2.418034393313323
2021-07-19T09:30:00-04:00,70.8,71.27,70.2,70.83,20734492,10163042.7,58.174591926104526,51.98827513831101,NaN,NaN,136.62832609723705,146.3456864225464,0.1628111315275786,0.1719913508890727,0.009180219361494109,1025080659,1031499407.2,53.35790974471112,59.68394429130186,NaN,NaN,7.127376421068482,-1.054404276973065
2021-07-20T09:30:00-04:00,70.82,71.54,70.66,70.85,20405246,10469383.3,58.38748217737396,53.0136677755185,NaN,NaN,154.02878485986636,162.7565162416725,0.150799049305683,0.19767903099359785,0.04687998168791486,1045485905,1036416153.4,60.37718331738248,60.13984035525232,NaN,NaN,8.481058453586783,0.3078046845354847
2021-07-21T09:30:00-04:00,71.18,71.235,70.65,70.67,9366680,10520164.35,55.64244045235766,53.42493881344,NaN,NaN,112.3938014253953,156.51613273574418,0.12345039820185713,0.20119297944023629,0.07774258123837915,1036119225,1037936344.2,62.26791524498916,60.39122491752918,NaN,NaN,8.911283779307636,1.536873126645792
2021-07-22T09:30:00-04:00,70.49,70.74,70.1,70.55,9632121,10648127.15,53.825621385649974,53.85593917818028,NaN,NaN,50.11210136430714,131.29241459546762,0.09147043572402522,0.19208062589341068,0.10061019016938547,1026487104,1035797608.8,58.06958158538226,60.328186999782794,NaN,NaN,8.795221952210822,2.5737801017265105
2021-07-23T09:30:00-04:00,70.57,71.49,70.47,71.4,9732614,10817569.3,63.03310315991363,54.81302377238148,NaN,NaN,126.64661273631387,115.96192529662395,0.11995875375539969,0.25055863236363507,0.13059987860823538,1036219718,1033878522.2,54.51759349611615,59.79890828031143,NaN,NaN,11.507565264690083,3.850035125007021
2021-07-26T09:30:00-04:00,71.29,71.63,71.115,71.52,5952169,10653113.15,64.12085274044294,56.06364183282398,NaN,NaN,145.5137016354755,117.73900040427164,0.13799370898690438,0.3030920148418659,0.1650983058549615,1042171887,1037296767.8,59.29373744242002,59.68879143823971,NaN,NaN,14.056101070695645,5.308044545819682
2021-07-27T09:30:00-04:00,71.5,71.98,71.27,71.67,14720771,11010620.1,65.48789540630139,57.11753886511821,NaN,NaN,150.71890836765618,117.0770251058296,0.1501312911146498,0.3527624197482737,0.20263112863362392,1056892658,1039578118.4,62.150459795776094,59.47877638569184,NaN,NaN,16.584158105813454,6.918917911533078
2021-07-28T09:30:00-04:00,71.5,71.59,70.89,71.04,9114115,10808554.8,55.861068389502115,57.68381017053724,NaN,NaN,84.30510200114931,111.4592852209804,0.10781628456184297,0.33740148433592765,0.22958519977408468,1047778543,1041909982,64.86468830377453,59.459876620063945,NaN,NaN,15.901870140248711,8.202196801349597
2021-07-29T09:30:00-04:00,71.3,71.5899,71.23,71.39,8811096,10808352.7,59.42925300791289,58.19336586575959,NaN,NaN,100.82879901699276,121.60262475151754,0.0958852483315531,0.349441760188526,0.2535565118569729,1056589639,1047930489,70.70564902735038,59.5811905778697,NaN,NaN,16.44255604450617,9.379390978943393
2021-07-30T09:30:00-04:00,71.5,71.88,71.4,71.51,10403736,10746885.5,60.60513306005155,58.87735179391792,NaN,NaN,112.41533283995227,118.7563687722452,0.0887271361437893,0.36446543203670956,0.27573829589292026,1066993375,1054085220.4,75.23767699980868,60.33296863694049,NaN,NaN,17.237396545463024,10.501963202731911
2021-08-02T09:30:00-04:00,71.51,71.58,71.13,71.21,12050103,10312725.15,56.218287707096756,59.26518965022001,NaN,NaN,71.5547455430689,103.96457755376386,0.057930194453730044,0.3481510389600828,0.29022084450635277,1054943272,1056639497.4,76.83910566531598,61.60727992380396,NaN,NaN,16.57677388414937,11.369793300077262
2021-08-03T09:30:00-04:00,71.23,71.66,71.06,71.53,8647748,10365329.7,59.579228923258036,59.41474777136812,NaN,NaN,79.13464313301762,89.64772450683617,0.05336623590049905,0.3569286393819766,0.30356240348147756,1063591020,1057979169.8,77.65532260417854,63.31191626769334,NaN,NaN,17.034670325223466,12.17906144652672
2021-08-04T09:30:00-04:00,71.28,71.46,70.55,70.6,8886513,10415627.55,48.03759953073589,58.54509356619673,NaN,NaN,0.6942227399277862,72.92554865459185,-0.01440985900953723,0.28555007971955604,0.29995993872909327,1054704507,1059364362.6,78.49905387957641,65.01168711282301,NaN,NaN,13.47160890315961,12.363711083188562
2021-08-05T09:30:00-04:00,70.97,71.09,70.765,70.94,7063013,10308134,51.71991446443386,57.86589088079539,NaN,NaN,1.3421967061884776,53.028228192431,-0.0371718854436191,0.2534950819245694,0.2906669673681885,1061767520,1060399938.8,79.1334169830002,66.64066386355586,NaN,NaN,11.804067142890453,12.283761948860262
2021-08-06T09:30:00-04:00,71.1,71.23,70.81,70.94,13492349,10668395.25,51.71991446443386,57.40484249067605,NaN,NaN,4.724456688256152,31.490052962091784,-0.05214002623825381,0.2254919345703712,0.277631960808625,1061767520,1059354767.8,76.67462395758781,68.30614345018991,NaN,NaN,10.513153391349897,12.030817869215923
2021-08-09T09:30:00-04:00,71.17,71.32,71.005,71.2,9055182,10751942.45,54.574822693351855,57.132509670388764,NaN,NaN,31.906586666218978,23.5604211867218,-0.04472702557335845,0.22172317884192694,0.2664502044152854,1070822702,1062530653.8,78.82739834350457,69.62401595205576,NaN,NaN,10.31485480729916,11.7856802889421
2021-08-10T09:30:00-04:00,71.34,71.74,71.22,71.71,11291745,10713633.5,59.618921105472104,57.41654400275407,NaN,NaN,108.32862448445954,29.399217457010185,-0.007618202887607561,0.25692745080577595,0.2645456536933835,1082114447,1066235339.2,81.02714952620626,70.96396125785698,NaN,NaN,11.756569476964,11.781521601516657
2021-08-11T09:30:00-04:00,71.89,72.24,71.83,71.95,14992786,11082467.95,61.77028431382706,57.9840199261953,NaN,NaN,188.65051950323885,66.9904768096724,0.028944674127153625,0.3007264963523255,0.2717818222251719,1097107233,1074715884.4,84.8957623430101,72.88011702625897,NaN,NaN,13.621861891429774,12.044427357218531
2021-08-12T09:30:00-04:00,71.99,72.04,71.78,71.91,6432131,10970949,61.185203761441066,57.85202711201869,NaN,NaN,143.3596956414406,95.39397659672281,0.04531375990546305,0.3284240221070007,0.2831102622015377,1090675102,1080497400.8,86.86246711079143,75.19046514159291,NaN,NaN,14.943675871706835,12.458605716431146
2021-08-13T09:30:00-04:00,72,72.58,71.89,72.51,8808600,10979660.5,66.33603449146662,58.010254379948954,NaN,NaN,190.00272267060708,132.449629793193,0.08890769964882128,0.3942448867625643,0.305337187113743,1099483702,1088040637.2,88.8942958544383,77.30479074245136,NaN,NaN,17.77251406723567,13.217735480831792
2021-08-16T09:30:00-04:00,72.51,72.95,72.38,72.93,7903158,10338093.8,69.39743736994878,58.28950737735234,NaN,NaN,222.49674387074543,170.5676612340983,0.1355905659486495,0.47482539454955486,0.33923482860090537,1107386860,1095353468.8,90.4382157424675,79.32534473864361,NaN,NaN,21.18087176039368,14.35532637791206
2021-08-17T09:30:00-04:00,72.8,73.25,72.63,72.97,15666042,10101133.6,69.68023542749428,59.27659073720893,NaN,NaN,202.59586667815273,189.42110967283693,0.15720256800273313,0.5357380386043218,0.37853547060158865,1123052902,1103541159.8,91.81091282639734,81.25007506168811,NaN,NaN,23.97842901420266,15.730055325953575
2021-08-18T09:30:00-04:00,72.83,72.945,72.01,72.06,10669391,10166269.15,56.81669107029237,59.08997917023603,NaN,NaN,103.1612703443993,172.32325984106902,0.1009826241130572,0.5047637507429101,0.40378112662985294,1112383511,1106596415.4,92.25757926939224,82.78949865040538,NaN,NaN,22.30669707402647,16.669575575678273
2021-08-19T09:30:00-04:00,71.74,72.785,71.7,72.64,13035570,10336441.6,61.6732068731786,59.16627015688796,NaN,NaN,94.57372220857181,162.56606515449525,0.09378442598021963,0.5210116591051275,0.42722723312490785,1125419081,1113545211.2,93.1700372075862,84.0703815223895,NaN,NaN,22.54151516141393,17.508424087926223
2021-08-20T09:30:00-04:00,72.63,73.05,72.36,72.76,10454479,10372534.85,62.6101233094311,59.62282984276899,NaN,NaN,120.17610127682657,148.60074087573915,0.08811957078575167,0.5373766966070974,0.44925712582134575,1135873560,1120823182.8,93.97141444953711,85.29411786411957,NaN,NaN,23.02882487207144,18.29705277137554
2021-08-23T09:30:00-04:00,72.77,72.9,72.5,72.53,8794517,10514652.25,59.60269327036357,59.62450586756224,NaN,NaN,96.64807735900955,123.43100757339195,0.06117572164652202,0.5257267778794983,0.46455105623297627,1127079043,1124761619.4,94.35725450830958,86.48711300012893,NaN,NaN,22.477011684274938,18.894189758932598
2021-08-24T09:30:00-04:00,72.49,72.51,71.88,71.98,8494246,10203326,53.04145324587873,59.981923990072445,NaN,NaN,33.50397904875352,89.61263004751211,0.0017459681739420696,0.46673351645040384,0.46498754827646177,1118584797,1123867998.4,92.90433334794288,87.51606153358367,NaN,NaN,19.853284197495523,19.031203250155873
2021-08-25T09:30:00-04:00,71.93,72.03,71.61,71.86,8007585,10147999.5,51.70409361379656,59.98079392931265,NaN,NaN,-3.4134435338122926,68.29768727186979,-0.04749229887120837,0.4056221746874513,0.4531144735586597,1110577212,1123506738.6,92.28567341081316,88.45550842128459,NaN,NaN,17.33489222584831,18.78887310382622
2021-08-26T09:30:00-04:00,71.76,71.81,71.29,71.53,13077963,10361342.85,48.11156945752897,59.72305500024801,NaN,NaN,-39.69900345739964,41.44314213867555,-0.10105505319055763,0.32679565707046265,0.4278507102610203,1097499249,1117922772.2,83.0768549522811,88.91281063519126,NaN,NaN,14.088741130974554,18.117425679133124
2021-08-27T09:30:00-04:00,71.6,71.905,71.365,71.78,9126224,10297467.25,50.89518710127073,59.46022388652792,NaN,NaN,-23.32923329234173,12.74207522484188,-0.11727589434264674,0.28125584233271184,0.39853173667535857,1106625473,1112073154.8,74.67084255610004,88.61591379323379,NaN,NaN,12.216412661486428,17.27442381946931
2021-08-30T09:30:00-04:00,71.8,72.165,71.7299,72.1,5645819,9977253.05,54.27641158777606,59.07861606383535,NaN,NaN,11.709591545404974,-4.245621937879045,-0.10450669250480427,0.2678983710443532,0.3724050635491575,1112271292,1109111604.6,70.76678880445476,87.88303088453726,NaN,NaN,11.645223253962246,16.470252310111157
2021-08-31T09:30:00-04:00,72.16,72.34,71.98,72.26,8037108,9946721.05,55.91109605101956,58.660102616491955,NaN,NaN,32.7843023225498,-4.389557283119777,-0.08420911033086176,0.2671436756355803,0.35135278596644204,1120308400,1109456325.2,70.95713187082846,86.88741442223856,NaN,NaN,11.65372946293356,15.782177617657215
2021-09-01T09:30:00-04:00,72.32,72.71,72.195,72.64,8399323,9922361.55,59.6048748440165,58.547221979533056,NaN,NaN,69.6503055842873,10.223192540500136,-0.046025102372847126,0.29382140800038314,0.33984651037323027,1128707723,1113082427.4,72.95216679892206,85.89382154281932,NaN,NaN,12.769696136653547,15.351823120370977
2021-09-02T09:30:00-04:00,72.79,73.04,72.66,72.92,6623255,9900373.65,62.122994354377894,58.24629054116958,NaN,NaN,112.39724714433599,40.642442660847266,-0.004908763907800151,0.33371055548848005,0.3386193193962802,1135330978,1120648773.2,76.56903010369062,85.01344541776594,NaN,NaN,14.472736781922944,15.226239357735544
2021-09-03T09:30:00-04:00,72.7,72.935,72.49,72.83,6011766,9526344.5,60.81080268164991,57.63295949200538,NaN,NaN,87.19602702851299,62.7474947250182,0.012288768559852337,0.3539802800960956,0.3416915115362433,1129319212,1125187521,78.43215085164002,84.15586935413539,NaN,NaN,15.497788525774995,15.265032096026895
2021-09-07T09:30:00-04:00,72.71,72.71,71.94,71.99,9206272,9533899,50.1611824257471,56.238741420452,NaN,NaN,-9.691275873222787,58.46732124129265,-0.03429832270948319,0.2988186081493893,0.3331169308588725,1120112940,1126755850.6,79.0519906620149,83.24451777096522,NaN,NaN,13.074387580934873,14.952082879585177
2021-09-08T09:30:00-04:00,71.9,72.69,71.86,72.61,10662931,9502458.3,56.25117626798545,56.1983475060015,NaN,NaN,16.2812023560924,55.166701248001175,-0.025170246128704832,0.30165412319799145,0.3268243693266963,1130775871,1128849344.8,79.88309013165129,82.36062568969798,NaN,NaN,12.971691612862395,14.669169841481922
2021-09-09T09:30:00-04:00,72.54,72.56,72.12,72.19,7741475,9139892.75,51.647150233081604,55.48220060313743,NaN,NaN,-6.713715312200655,39.89389706870358,-0.0479124928674613,0.2669337532423697,0.314846246109831,1123034396,1127714679.4,78.07506959324229,81.28241371724485,NaN,NaN,11.356263093265703,14.195897448879606
2021-09-10T09:30:00-04:00,72.33,72.36,71.74,71.88,10270187,9331795.55,48.49231851615672,54.4737859750464,NaN,NaN,-72.41753854369567,2.930939931097251,-0.08230910939542507,0.21195985936554962,0.2942689687609747,1112764209,1123201325.6,71.17443860660653,79.65405829989267,NaN,NaN,9.004138345567478,13.454217576977873
2021-09-13T09:30:00-04:00,72.16,72.68,71.8875,72.06,13798064,9581268.75,50.38735556923162,53.81554756782269,NaN,NaN,-23.62493489445382,-19.233252453496107,-0.09074907726811748,0.18083262217582785,0.27158169944394533,1126562273,1122649937.8,70.35630933636196,77.93970507332499,NaN,NaN,7.691762029220084,12.631009641583903
2021-09-14T09:30:00-04:00,72.24,72.29,71.61,71.73,9145485,9643385.1,46.97511476134191,53.38223767607006,NaN,NaN,-86.10391852236926,-34.5157809833254,-0.1148176566085024,0.12805962868331733,0.24287728529181973,1117416788,1122110707.4,69.51476531245059,76.26902164221839,NaN,NaN,5.525913549743463,11.615995914178125
2021-09-15T09:30:00-04:00,71.73,72.115,71.56,71.99,8824670,9301316.5,49.856346382473184,53.25025573097554,NaN,NaN,-77.03271165331638,-53.17856378520717,-0.10950611782282724,0.10599463801328568,0.21550075583611292,1126241458,1121203824.8,68.04074245224622,74.53724085946362,NaN,NaN,4.5977367784353484,10.61338746621487
2021-09-16T09:30:00-04:00,71.9,72.12,71.15,71.75,9789850,9257339.45,47.30132623004105,53.19238121472641,NaN,NaN,-111.2973111705126,-74.09528295686955,-0.11771737513874611,0.06835403691268027,0.18607141205142638,1116451608,1119887267.2,65.8574809764328,73.30728557547445,NaN,NaN,3.054981917145417,9.533615244919234
2021-09-17T09:30:00-04:00,71.56,71.82,71.35,71.36,13149976,9263059.75,43.408321572006834,52.65760510549327,NaN,NaN,-127.04933857944326,-85.02164296401907,-0.1432783592570164,0.006973462980155887,0.1502518222371723,1103301632,1117994751.8,62.74094595797157,72.45515010417955,NaN,NaN,0.5366157365080486,8.248329600860494
2021-09-20T09:30:00-04:00,70.43,70.84,69.67,70.21,17880715,9634371.55,34.414061307254556,51.23886579974174,NaN,NaN,-298.5152053249476,-139.99969705011782,-0.2265487311283712,-0.13293409167329173,0.09361463945507949,1085420917,1109766480.6,51.36069913467218,71.06900084205223,NaN,NaN,-5.035028448606968,6.3507070223651425
2021-09-21T09:30:00-04:00,70.41,70.97,69.995,70.13,11140503,9751670.85,33.888025208466445,49.66578931098794,NaN,NaN,-225.63880594397057,-167.90667453443808,-0.272823808066252,-0.24741512062773552,0.025408687438516486,1074280414,1101139205.8,42.62972222809561,69.04561443899989,NaN,NaN,-9.52922192110344,4.082145744726773
2021-09-22T09:30:00-04:00,70.59,70.77,70.19,70.33,10026007,9828258.9,36.50120791931342,48.01552738779486,NaN,NaN,-174.65371090878918,-187.43087438553263,-0.27499436834464397,-0.31833427299228845,-0.043339904647644506,1084306421,1092752198.4,36.18910067080374,66.41968114413429,NaN,NaN,-12.359418820023722,1.7333508069052743
2021-09-23T09:30:00-04:00,70.43,70.91,70.36,70.59,8440457,9849902.5,39.830806460147194,46.42322825249267,NaN,NaN,-126.19648708961735,-190.41070956935357,-0.24495146005071491,-0.34952922971103817,-0.10457776966032326,1092746878,1088011252.4,33.141036979349494,63.31768163525278,NaN,NaN,-13.688559128468691,-0.469779183862435
2021-09-24T09:30:00-04:00,70.49,70.93,70.49,70.62,6717401,9531874.4,40.220311112392245,44.95247885468854,NaN,NaN,-105.73048358520468,-186.14693857050585,-0.21041244138259618,-0.3675933213885685,-0.1571808800059723,1099464279,1087243781.8,32.66145462855883,60.04834619074699,NaN,NaN,-14.644877036355428,-2.494793162790005
2021-09-27T09:30:00-04:00,70.51,70.84,70.24,70.3,8467099,9498918.15,37.4364562035936,44.04356983882044,NaN,NaN,-109.38634331987447,-148.32116616949125,-0.1967225500878798,-0.40308406761582205,-0.20636151752794224,1090997180,1088359034.4,34.152640040090716,56.841249717752405,NaN,NaN,-16.27772154531292,-4.46378293172185
2021-09-28T09:30:00-04:00,70.11,70.1901,69.22,69.47,14982977,9965776.05,31.371247406742924,42.266432063017405,NaN,NaN,-152.07455449682465,-133.60831588006207,-0.22891677270171962,-0.49250748340509176,-0.26359071070337214,1076014203,1088705792.2,34.637298266569175,53.60940744167511,NaN,NaN,-19.7455945398711,-6.646898875743171
2021-09-29T09:30:00-04:00,69.61,70.46,69.46,70.1,13329570,10230399.15,39.39710641977174,41.39142893349527,NaN,NaN,-105.28702890958061,-119.73497948022035,-0.19448705783871406,-0.5066995330017647,-0.3122124751630507,1089343773,1089713262.6,36.10869477596516,50.61180924044104,NaN,NaN,-20.102600391327996,-8.569141949398146
2021-09-30T09:30:00-04:00,70.27,70.33,68.81,68.84,16260419,10623453.95,31.470260185388753,40.1755676241547,NaN,NaN,-133.8499970341669,-121.26568146913026,-0.24027572150076837,-0.6125571270390111,-0.37228140553824274,1073083354,1085780557.8,32.987027280824265,47.884137002885154,NaN,NaN,-23.35608148814506,-10.681561883504848
2021-10-01T09:30:00-04:00,69.05,69.35,68.37,69.02,15889231,11086752.75,33.527866893821695,38.97131843305399,NaN,NaN,-143.09253897476546,-128.7380925470424,-0.2414983204532315,-0.6741543061047821,-0.4326559856515506,1088972585,1083682219,31.425923254369195,45.10339513988567,NaN,NaN,-25.13080670752585,-12.745739715507849
2021-10-04T09:30:00-04:00,69,69.49,68.32,68.8,20351648,11803746.85,32.25321624411737,37.919754253252236,NaN,NaN,-132.20938856711751,-133.30270159649103,-0.23970032478119913,-0.7322813916280495,-0.4925810668468504,1068620937,1079206970.4,28.344932923141513,42.162692826363596,NaN,NaN,-26.952586491165953,-14.775289254887578
2021-10-05T09:30:00-04:00,68.97,69.455,68.82,69.15,16186326,12152749.55,36.39606680285772,36.95830571185113,NaN,NaN,-105.3227663195413,-123.95234396103437,-0.19918093891872302,-0.7415572404952542,-0.5423763015765312,1084807263,1080965582.4,31.199444349730854,39.53117153332679,NaN,NaN,-27.103836810832355,-16.53651033430826
2021-10-06T09:30:00-04:00,68.79,69.89,68.71,69.82,14910182,12365112.1,43.51675059357119,36.68797888067471,NaN,NaN,-77.44934459396958,-118.38480709791216,-0.11564020293327004,-0.6869265552431187,-0.5712863523098487,1099717445,1083040316.8,34.513892391270105,37.29234377724374,NaN,NaN,-24.851214261189238,-17.724325181005543
2021-10-07T09:30:00-04:00,70.17,70.75,70.075,70.13,8396819,12397879.3,46.50112919700315,36.90889371103159,NaN,NaN,-12.616968140337834,-94.13820131914635,-0.03222465313793266,-0.6115671687322646,-0.5793425155943319,1108114264,1090046498.8,44.27641225401639,35.9734485126755,NaN,NaN,-22.047895444395106,-18.34197807577548
2021-10-08T09:30:00-04:00,70.18,70.34,69.92,70.05,7285705,12248655.2,45.82818373833544,37.724188170394505,NaN,NaN,-24.00426827908091,-70.32054718000943,0.02192420903474912,-0.5519372543008956,-0.5738614633356447,1100828559,1092417693.6,47.14814167570829,35.67255155132094,NaN,NaN,-20.02161502956373,-18.581926212030943
2021-10-11T09:30:00-04:00,70.16,70.41,69.97,70.03,8218354,11969669.7,45.65032103222743,38.564352157806006,NaN,NaN,-13.953310973332547,-46.66933166125244,0.05866979568553332,-0.500524218728728,-0.5591940144142613,1092610205,1097215547.2,52.48404940090515,36.376432063664474,NaN,NaN,-18.443267533737732,-18.562117829417627
2021-10-12T09:30:00-04:00,70.09,70.6,69.905,70.06,12401220,12132456.45,45.98893969904644,39.2420472849298,NaN,NaN,-1.1024808956839298,-25.825274576480957,0.08563824488407035,-0.4521462083091734,-0.5377844531932437,1105011425,1101256379.6,56.470112106382494,37.82507573763439,NaN,NaN,-17.05467907517094,-18.346769435953814
2021-10-13T09:30:00-04:00,70.13,70.38,69.585,70.19,9548277,12168636.8,47.514946050710826,39.79091439854148,NaN,NaN,-6.741444463251482,-11.68369455033734,0.11125142257076603,-0.3987201749797862,-0.5099715975505522,1114559702,1104224831,59.179240415970845,39.68494741167878,NaN,NaN,-15.465901845840838,-17.93521692308053
2021-10-14T09:30:00-04:00,70.45,71.09,70.4,70.98,9975213,12177904.95,55.705159220886486,40.89697497771965,NaN,NaN,99.14898656429364,10.669496390588954,0.17653855085547354,-0.2892984089812103,-0.46583695983668383,1124534915,1107508961.2,61.99718773013627,41.78035691893432,NaN,NaN,-11.50072838730497,-17.016004275112593
2021-10-15T09:30:00-04:00,71.22,71.245,70.605,70.81,11575233,12099167.8,53.76099317438547,42.06301333277621,NaN,NaN,116.7715537874647,38.82466080389807,0.2016027592838821,-0.2138335107318312,-0.4154362700157133,1112959682,1109935185.8,63.97571688017987,43.910576693226396,NaN,NaN,-8.753204898792212,-15.835604364209681
2021-10-18T09:30:00-04:00,70.5,70.72,70.02,70.39,10043296,11707296.85,49.192991829758085,43.33599507727729,NaN,NaN,45.62001130965816,50.739325260496216,0.18372820414849317,-0.18577601483009687,-0.36950421897859004,1102916386,1111996422,65.61364306699234,46.123172750399476,NaN,NaN,-7.681565978170397,-14.67074173763264
2021-10-19T09:30:00-04:00,70.27,70.43,69.93,70.42,10203062,11660424.8,49.52291276420849,44.05926695902277,NaN,NaN,30.755840610309757,57.11098956169495,0.16817667256618668,-0.1592833782708567,-0.3274600508370434,1113119448,1113618026.6,66.88911712593163,48.32177434682565,NaN,NaN,-6.715479637115713,-13.53427572327308
2021-10-20T09:30:00-04:00,70.49,71.07,70.43,70.83,8829799,11600614.4,53.926297670540016,45.66326963653358,NaN,NaN,96.50657813254654,77.76059408085455,0.17876380772104034,-0.10400529118574298,-0.2827690989067833,1121949247,1115095935.6,68.05220818863256,50.826430125954815,NaN,NaN,-4.587969538752194,-12.25623198262724
2021-10-21T09:30:00-04:00,70.93,70.9867,70.66,70.74,7976583,11577420.7,52.83668717171248,47.04247108495434,NaN,NaN,96.50075537594816,77.23094784318546,0.17286288689056167,-0.0666904902935812,-0.23955337718414288,1113972664,1112983485.4,64.56129796926923,53.19324260559053,NaN,NaN,-3.1230196251642335,-10.951487360132525
2021-10-22T09:30:00-04:00,70.88,71.4,70.82,71.29,9575787,11720340,58.372212776874406,48.908113694437,NaN,NaN,137.16204852869564,81.30904679143164,0.19738622337346673,0.007179402032690518,-0.1902068213407762,1123548451,1115101239.2,66.42097778346988,55.91296009561399,NaN,NaN,-0.15013256594878144,-9.408436675249133
2021-10-25T09:30:00-04:00,71.24,71.395,70.74,71.24,6844587,11639214.4,57.70909477022568,50.430472834963275,NaN,NaN,120.82320691035076,96.34968591157016,0.20095285968246485,0.06098425326230483,-0.13996860642016,1116703864,1117858734.8,68.72250628391092,58.593178805198285,NaN,NaN,2.098781687670438,-7.764548337689194
2021-10-26T09:30:00-04:00,71.25,71.67,71.2,71.49,8805735,11330352.3,60.1469129941134,51.618341577859155,NaN,NaN,140.81674060609697,118.3618659107276,0.2098845602818003,0.12238709393209035,-0.08749746634970994,1125509599,1120336765,70.66815378619873,61.175626047693186,NaN,NaN,4.729540816547095,-5.979678458512582
2021-10-27T09:30:00-04:00,71.86,71.91,71.04,71.07,10335096,11180628.6,54.46652535321854,52.18729844616025,NaN,NaN,112.53162335731876,121.56687495568205,0.17847456060939637,0.13559573441203554,-0.04287882619736084,1115174503,1118981816.2,68.17106897703961,62.88238724219484,NaN,NaN,5.4230287473448175,-4.35072028624724
2021-10-28T09:30:00-04:00,71.09,71.35,70.97,71.32,8614806,10798347.95,57.06575054996702,52.98998178984822,NaN,NaN,89.83561573232723,120.23384702695787,0.16577678397319007,0.16434215376912675,-0.001434630204063321,1123789309,1120945145.2,69.83439167941577,64.50283367103108,NaN,NaN,6.766720687056389,-2.76251443291815
2021-10-29T09:30:00-04:00,71.14,71.53,71.07,71.25,8105319,10409152.35,56.100101150071644,53.73639465540852,NaN,NaN,88.60870624625441,110.52317857046963,0.14467361340789786,0.179407386555809,0.034733773147911144,1115683990,1119372253,66.82164786045456,65.52694784671318,NaN,NaN,7.60817424663474,-1.280987478696309
2021-11-01T09:30:00-04:00,71.4,71.52,71.105,71.36,7033899,9743264.9,57.32225186426171,54.545916952923896,NaN,NaN,87.42231716662795,103.84300062172505,0.13056580689751202,0.19794103176980116,0.06737522487228914,1122717889,1120575058,67.95997387393419,66.34765225868117,NaN,NaN,8.650328680362367,0.13777197259778773
2021-11-02T09:30:00-04:00,71.4,72,71.19,71.84,9942655,9431081.35,62.259672687048806,55.59911171266232,NaN,NaN,124.92117249145903,100.66388699879747,0.14489706331121738,0.24849655401131088,0.1035994907000935,1132660544,1122005247,69.30836166730975,67.07116091949109,NaN,NaN,11.030620280505664,1.6938931594417699
2021-11-03T09:30:00-04:00,71.85,72.51,71.8,72.51,10471142,9209129.35,67.85066495434441,56.46664783648073,NaN,NaN,187.41729198239634,115.64102072381297,0.18809721167545876,0.33872100529441695,0.1506237936189582,1143131686,1127596683.6,73.92802689754508,67.92336371716314,NaN,NaN,15.000905489196665,3.5948949208353262
2021-11-04T09:30:00-04:00,72.25,72.643,72.06,72.58,11701782,9374377.5,68.37775384754235,57.510702170277646,NaN,NaN,176.662800459857,133.00645766931893,0.20840788918464193,0.41113365509976063,0.2027257659151187,1154833468,1133805515.4,77.90502295988037,68.91831415142747,NaN,NaN,18.359644358972016,5.704144840569139
2021-11-05T09:30:00-04:00,72.86,73.12,72.72,73,9929095,9506547,71.4068294855767,59.09740485997899,NaN,NaN,207.54811653451966,156.79433972697197,0.23516834912793472,0.49668620232503713,0.2615178531971024,1164762563,1143621230,82.46017792506493,70.12163806986122,NaN,NaN,22.23645822296623,8.065903895197295
2021-11-08T09:30:00-05:00,73.03,73.08,72.08,72.42,12813578,9736308.2,62.50291353370491,60.02454777208586,NaN,NaN,141.32334085747866,167.5745444651421,0.2002149201630824,0.5117865034009554,0.31157158323787304,1151948985,1149467449.2,84.50867781009096,71.38017811872975,NaN,NaN,22.82144165825353,10.173837861348185
2021-11-09T09:30:00-05:00,72.44,72.74,72.2,72.67,13527563,9792625.35,64.55454144582964,60.783708041749414,NaN,NaN,124.2161519487762,167.43354035660553,0.1809250683977594,0.5377279187350723,0.3568028503373129,1165476548,1156030650,86.42541512500989,72.6925500427567,NaN,NaN,23.945237504273756,12.141180667480409
2021-11-10T09:30:00-05:00,72.74,73.08,72.605,72.89,11350551,9882739.05,66.30186869015668,61.74550672163828,NaN,NaN,134.39486111271904,156.8290541826701,0.17013715452890543,0.5694742934984447,0.39933713896953926,1176827099,1162769732.6,88.05914187732479,74.37096746476065,NaN,NaN,25.408848895637913,14.03656184293148
2021-11-11T09:30:00-05:00,72.94,72.98,72.67,72.84,6319124,9699934.6,65.51143980846626,62.25545150960913,NaN,NaN,112.83699068217551,144.06389222713378,0.14762506467368708,0.5838684698116481,0.436243405137961,1170507975,1165904634,88.7381432495221,75.96505071233582,NaN,NaN,26.359027039617494,15.796914013886624
2021-11-12T09:30:00-05:00,72.99,73.18,72.72,72.84,7469917,9494668.8,65.51143980846626,62.81276186948345,NaN,NaN,105.00336461467855,123.55494184316555,0.12179902520192387,0.5884921866403658,0.466693161438442,1170507975,1167053716.4,88.98538199106216,77.41239897713233,NaN,NaN,27.132082446482585,17.416223789971763
2021-11-15T09:30:00-05:00,72.97,73.265,72.83,73.19,6381465,9311577.25,68.55483478434502,63.41332771164286,NaN,NaN,106.66931601498473,116.62413687466679,0.11730828769735846,0.61332852106014,0.49602023336278156,1176889440,1172041807.4,90.01059482168836,78.79400190823874,NaN,NaN,28.68221098306342,19.025650531842
2021-11-16T09:30:00-05:00,73.14,73.38,72.7,72.73,6562151,9129531.7,60.94312150176936,63.87594172225363,NaN,NaN,84.42734828807232,108.66637614252599,0.07446583900391746,0.5891025321176784,0.5146366931137609,1170327289,1173011955.6,90.20161855670469,80.36761259250054,NaN,NaN,27.78874997771582,20.277521881252547
2021-11-17T09:30:00-05:00,72.66,72.795,72.445,72.57,10444910,9210287.25,58.509690871489305,63.97908031664809,NaN,NaN,49.59271591438656,91.7059471028595,0.028806729123025177,0.5506451045175424,0.5218383753945173,1159882379,1169623011.6,84.14816327977364,81.39002484966895,NaN,NaN,26.324341202703717,21.14135321288843
2021-11-18T09:30:00-05:00,72.38,72.48,71.9647,72.31,11270219,9374969.05,54.68825652862257,63.878234272258865,NaN,NaN,11.452678336089422,71.42908463364228,-0.022671706178750584,0.49349874267107907,0.5161704488498297,1148612160,1165243848.6,76.96079415328816,82.11424958487135,NaN,NaN,23.933279190159823,21.540199781070058
2021-11-19T09:30:00-05:00,72.47,72.49,72.01,72.05,11924034,9492381.4,51.094432083982014,63.43339000223888,NaN,NaN,-0.7655009722333218,50.275311516259904,-0.07504732386826918,0.4223612940144932,0.49740861788276236,1136688126,1158479878.8,67.38675720734068,82.07330553725753,NaN,NaN,20.809737902726766,21.435848084163872
2021-11-22T09:30:00-05:00,72.14,73.12,72.06,72.62,13425797,9821441.9,57.66297849057136,63.1050547024905,NaN,NaN,41.642043570380935,37.269857027339185,-0.07209995267095942,0.4072836770440631,0.4793836297150225,1150113923,1153124775.4,60.924712862086444,81.47447347974158,NaN,NaN,19.998525919609474,21.230516346370386
2021-11-23T09:30:00-05:00,72.63,73.22,72.51,73.1,13405650,10051437.65,62.259881027704935,62.70571299344482,NaN,NaN,78.20310793218943,36.02500895616261,-0.04021096925936746,0.4291199181408132,0.46933088740018064,1163519573,1151763232.2,59.36594651610061,80.43432488106696,NaN,NaN,20.774704165967258,21.16540032059851
2021-11-24T09:30:00-05:00,73,73.11,72.5499,72.88,9556367,10012501.2,59.092893331602,62.04250867087766,NaN,NaN,61.59010760733837,38.424487294752964,-0.036434332948139636,0.4237879712150061,0.46022230416314575,1153963206,1150579397.6,57.976993650342536,79.01089421609997,NaN,NaN,20.40921336558856,21.057373612739948
2021-11-26T09:30:00-05:00,72.39,72.72,71.7,71.96,11715564,10167539.1,48.078948835704125,60.376231481601046,NaN,NaN,-53.782873732873135,25.37737688096045,-0.0950652721464561,0.3413907139800756,0.4364559861265317,1142247642,1149306494,56.447718354065,77.15286138959998,NaN,NaN,16.183404408806062,20.36109229789225
2021-11-29T09:30:00-05:00,72.04,72.42,71.68,72.14,13646622,10444604.25,50.04091479307466,59.48608871441318,NaN,NaN,-76.64965616356658,10.2005458426938,-0.1193224367382979,0.2873029402036593,0.4066253769419572,1155894264,1153147721.6,59.88631875804368,75.3941214573109,NaN,NaN,13.504444463379878,19.381571178676197
2021-11-30T09:30:00-05:00,71.69,71.75,70.14,70.29,23715133,11278665.95,35.28366118289232,57.39531155277479,NaN,NaN,-289.8944709990937,-56.10675707120113,-0.25004108226661154,0.09407402410869281,0.34411510637530435,1132179131,1149560763.2,55.481199951366094,73.1838203734792,NaN,NaN,4.639532450936455,17.27556564614195
2021-12-01T09:30:00-05:00,70.77,71.3601,69.92,69.95,22902452,11926655.8,33.3378116217595,55.040736047889276,NaN,NaN,-277.8278349868665,-127.3129456550123,-0.34370066757408524,-0.0855107280923022,0.25818993948178304,1109276679,1138712184.4,44.757851257754474,70.09087104350988,NaN,NaN,-2.7466011105892028,14.415256109466071
2021-12-02T09:30:00-05:00,70.19,71.14,70.19,70.69,18704007,12338299.05,40.96839426760557,53.287661366399234,NaN,NaN,-188.99429163002003,-177.429825502484,-0.33951612139351417,-0.16620521226010965,0.1733109091334045,1127980686,1133515680.4,40.69994927846348,66.65957147414855,NaN,NaN,-5.782954844769527,11.52979740171813
2021-12-03T09:30:00-05:00,71.08,71.68,70.87,71.57,22867553,12896587.6,48.51564905850894,52.073676312830855,NaN,NaN,-94.31744088290264,-185.5367389324899,-0.2645158311253216,-0.15733387977324753,0.10718195135207408,1150848239,1135235799.8,42.55649341389293,63.343222290065036,NaN,NaN,-5.315696741463614,9.123298238406452
2021-12-06T09:30:00-05:00,72.08,73.1,72.07,72.83,18524398,13326352.75,56.993912475289136,51.247896147898295,NaN,NaN,43.49214038816187,-161.50837962214422,-0.12420764620400096,-0.04807760640292713,0.07613003980107383,1169372637,1137931474.4,45.43935168192438,60.15956206579618,NaN,NaN,-1.446131911043918,7.613379645627828
2021-12-07T09:30:00-05:00,72.95,73.35,72.81,72.99,13169467,13344147.2,57.941073819315825,51.03346417058018,NaN,NaN,78.95842668554765,-87.73780008521594,-0.02023726088924767,0.05083346368951425,0.07107072457876192,1182542104,1148004069,54.606505824867085,57.617054013522065,NaN,NaN,1.7331570240687786,6.773347842547963
2021-12-08T09:30:00-05:00,72.87,73.19,72.14,72.76,14489774,13392257.75,56.030724425374224,50.85639513871481,NaN,NaN,41.24316484588285,-23.92360011866607,0.030664232133425298,0.10940101474554353,0.07873678261211824,1168052330,1159759199.2,62.52085878821563,56.07224654983934,NaN,NaN,3.503751192570918,6.306262606836957
2021-12-09T09:30:00-05:00,72.75,73.22,72.44,72.96,8613861,13255423.25,57.34763482436513,51.04635073126785,NaN,NaN,59.173276788948144,25.70991356512758,0.07300653666155209,0.16999495343905835,0.09698841677750626,1176666191,1169496300.2,67.56535564491507,55.40114379924126,NaN,NaN,5.325211651432349,6.166112470350584
2021-12-10T09:30:00-05:00,73.39,74.24,73.255,74.19,10889958,13483964.95,64.40789071879672,51.997312062326046,NaN,NaN,148.40108000927708,74.25361774356352,0.17333025115707423,0.31365123072384904,0.1403209795667748,1187556149,1176837882.2,70.76084718596793,55.64215022628607,NaN,NaN,9.487394044498059,6.6405812666573665
2021-12-13T09:30:00-05:00,74.17,75.39,74.06,75.16,16518053,13936371.75,68.79477295577095,52.792440238411736,NaN,NaN,208.9811959683536,107.35142885960188,0.2877488079465639,0.5000069894999797,0.2122581815534158,1204074202,1183778195.2,73.42620878871509,56.53511422104526,NaN,NaN,14.600440203567938,7.777703971930305
2021-12-14T09:30:00-05:00,75.01,75.33,74.7201,75.21,16048344,14419715.7,69.00682927168485,53.27436511298173,NaN,NaN,198.61895921624267,131.28353536574087,0.34563564055767443,0.6443027322505088,0.2986670916928344,1220122546,1191294283.6,75.9798749497987,57.721823394880836,NaN,NaN,18.53787901683907,9.3148718354887
2021-12-15T09:30:00-05:00,75.22,76.06,75.195,75.97,21276952,15155455.75,72.10932480343995,54.204110218113,NaN,NaN,207.1157721754896,164.45805683166222,0.4095777280071504,0.8106392517017724,0.401061523694622,1241399498,1205963717.2,80.01626722583163,59.29605722170148,NaN,NaN,22.918688681948193,11.25827424212577
2021-12-16T09:30:00-05:00,75.91,76.78,75.895,76.51,14498964,15358158.45,74.09366438139543,56.06230418566238,NaN,NaN,197.88853516997796,192.20110850786818,0.45898978546507596,0.974798755525967,0.515808970060891,1255898462,1221810171.4,83.28404637599816,61.2129377946967,NaN,NaN,27.17463794383943,13.532040485227721
2021-12-17T09:30:00-05:00,76.24,76.62,75.16,75.2,23809878,15985141.4,62.48020441029491,56.95082487260669,NaN,NaN,130.25969892850694,188.57283229171415,0.377595631288407,0.9878035091713997,0.6102078778829927,1232088584,1230716658.4,84.78953537447029,62.99173898158432,NaN,NaN,26.85054618102499,15.434684156055901
2021-12-20T09:30:00-05:00,74.12,74.745,74.03,74.71,14116653,16094772.35,58.76961527204308,58.62839302183174,NaN,NaN,63.45754328810667,159.46810175566478,0.2699513613630581,0.9476470795868153,0.6776957182237572,1217971931,1233496204.2,85.23641478282303,65.11711146954553,NaN,NaN,25.31594811912978,16.846293293637885
2021-12-21T09:30:00-05:00,74.71,74.76,74.17,74.61,11872071,16017086.05,58.01241635211,60.39086478828535,NaN,NaN,57.37589697973583,131.2194893083634,0.1757705330696827,0.8974088845608605,0.7216383514911778,1206099860,1230691667,82.59949270245004,67.82008585845236,NaN,NaN,23.88090204044787,17.851237400325026
2021-12-22T09:30:00-05:00,74.58,75.11,74.285,75.08,7650200,15729313.55,60.58295280391558,61.791904683736064,NaN,NaN,64.1357985832803,102.62349458992153,0.1309408955830933,0.8853144709700445,0.7543735753869512,1213750060,1225161779.4,77.50785357517694,70.44922187964617,NaN,NaN,23.494213374073382,18.65737682514622
2021-12-23T09:30:00-05:00,75.26,75.505,75.135,75.25,8089032,15655946.8,61.50104763686234,62.71943315361845,NaN,NaN,75.75570669573763,78.19692889507347,0.09994993214429437,0.8793109905673191,0.7793610584230247,1221839092,1218349905.4,71.64884149625487,72.52724674267202,NaN,NaN,23.456214147506685,19.342925014054856
2021-12-27T09:30:00-05:00,75.3,76.05,75.3,76.05,7343188,15437328,65.56567535518678,63.331701930754,NaN,NaN,87.3624810589209,69.61748532115625,0.11923470110455958,0.9284044348037241,0.8091697336991646,1229182280,1217768644.6,71.15456431709238,74.36404764518402,NaN,NaN,24.680717321933354,20.10546677232321
2021-12-28T09:30:00-05:00,75.96,76.555,75.96,76.48,7285332,15119263.5,67.5488678396215,64.01797293220442,NaN,NaN,99.61025480062398,76.84802762365973,0.14513609005925887,0.9905898462732381,0.8454537562139792,1236467612,1221467780.8,72.45680046190274,75.63906869068657,NaN,NaN,26.310056591342356,20.991836746468802
2021-12-29T09:30:00-05:00,76.56,77.015,76.43,76.83,7891629,14328088.3,69.10841243629481,64.95209350441303,NaN,NaN,109.69913578744662,87.31267538520189,0.16839064701953688,1.0559420649884004,0.8875514179688635,1244359241,1229119657,74.97367737820159,76.52855573282842,NaN,NaN,28.13415287085677,22.01216762138137
2021-12-30T09:30:00-05:00,77.02,77.1,76.535,76.59,6802853,13523108.35,66.73986993637058,65.62296744098485,NaN,NaN,105.98049047136412,95.68161376281864,0.15073096066228242,1.0759651187967165,0.9252341581344341,1237556388,1233880922.6,76.41769658268696,77.16086579981213,NaN,NaN,28.9578790928806,23.00441211730983
2021-12-31T09:30:00-05:00,76.54,77.23,76.5,77.11,11288954,13152355.7,69.20272755693728,65.96545578656631,NaN,NaN,111.38486576534176,102.80744557673947,0.15651064732663467,1.1208724672927275,0.9643618199660928,1248845342,1239282172.6,77.97056896069404,77.67584592657828,NaN,NaN,30.39262614203207,24.05987126369872
2022-01-03T09:30:00-05:00,76.66,77.14,76.02,77.1,22320270,13124991.55,69.09676451578977,65.98702661228194,NaN,NaN,95.57038265137591,104.44902589523046,0.14249861693192023,1.1424850911309932,0.9999864741990729,1226525072,1238750731,77.43030442556945,77.96185275778215,NaN,NaN,31.527930128416592,25.126736815801273
2022-01-04T09:30:00-05:00,77.08,77.865,77.05,77.62,23066025,13352072.9,71.53735278201401,66.16777829159116,NaN,NaN,127.2999985049005,109.98697463608578,0.15031463415180313,1.1878797668888268,1.0375651327370237,1249591097,1241375428,78.23252201783701,78.1227561197849,NaN,NaN,33.22088981821275,26.28304438757434
2022-01-05T09:30:00-05:00,77.52,78.18,77.49,77.55,29748494,14181024.25,70.72758816495765,66.06908281741386,NaN,NaN,128.6358746720717,113.77432241301081,0.13340730108975984,1.2043242590992236,1.0709169580094637,1219842603,1236472100.4,73.01151519815934,77.62241668923687,NaN,NaN,34.40140951117597,27.442810833803144
2022-01-06T09:30:00-05:00,77.5,77.98,77.23,77.34,25023939,14707732.5,68.23229349682397,65.65041346851591,NaN,NaN,108.5511656875605,114.28845745625009,0.09265162621986645,1.1867314907842967,1.0940798645644303,1194818664,1227924555.6,64.88263758899896,76.30803034730836,NaN,NaN,34.741793007120854,28.48552257284853
2022-01-07T09:30:00-05:00,77.22,77.719,77.0104,77.42,12650260,14909552.45,68.68553879663966,66.09365163896909,NaN,NaN,91.82035029870477,110.37555436292268,0.057380703255675236,1.1658057436340243,1.108425040378349,1207468924,1219649272,58.13428531912612,74.40408391478378,NaN,NaN,35.145943741088516,29.43701131116853
2022-01-10T09:30:00-05:00,77.3,77.46,76.56,76.81,18578272,15293968.15,61.48238503964622,66.2874209080836,NaN,NaN,56.35885485394936,102.53324880343737,-0.01676849367091715,1.0874644232897026,1.1042329169606198,1188890652,1212122388,52.75921001750949,72.08428357440424,NaN,NaN,33.53642877689828,30.022642377701352
2022-01-11T09:30:00-05:00,76.73,76.79,75.875,76.72,19571756,15446653.3,60.474691680451954,66.46329771725088,NaN,NaN,16.903594037983215,80.4539679100539,-0.07817541211700862,1.006513651814359,1.0846890639313675,1169318896,1196067947.8,43.517000750499584,69.29267700640779,NaN,NaN,31.91479554602771,30.292949973176547
2022-01-12T09:30:00-05:00,76.67,76.81,76.39,76.75,11155243,15201998.25,60.705881480573375,66.47207833701216,NaN,NaN,27.466855853637732,60.22016414636712,-0.12054036789982359,0.9340136040565881,1.0545539719564117,1180474139,1188194255,39.83168909996231,66.6015224010353,NaN,NaN,30.609769422090928,30.33820989445003
2022-01-13T09:30:00-05:00,76.83,77.05,76.58,76.89,14287366,14852518.95,61.827977542378356,66.49543047312044,NaN,NaN,39.85481138985255,46.48089328682553,-0.14145467050131155,0.8777356338297722,1.0191903043310837,1194761505,1188182823.2,39.82641549833472,64.32849197261244,NaN,NaN,29.760193053364553,30.255636060009248
2022-01-14T09:30:00-05:00,76.7,77.13,76.35,77.03,21391719,15197156.7,62.9668569578359,66.30980058759538,NaN,NaN,36.92266736152658,35.50135669938989,-0.14750535314793234,0.8348086128961683,0.9823139660441006,1216153224,1189919683.2,41.10230129051467,62.18190175642832,NaN,NaN,29.303711871954086,30.119646890287083
2022-01-18T09:30:00-05:00,76.46,76.48,75.68,75.92,16684336,14840879.6,50.18283772668086,65.06936986524248,NaN,NaN,-34.19027113293942,17.39153150201213,-0.22335850521538803,0.7031158345248656,0.9264743397402536,1199468888,1192035330.4,42.69617050309936,60.05614247365664,NaN,NaN,25.067262240709386,29.397877654633128
2022-01-19T09:30:00-05:00,76.06,76.925,76.038,76.4,18518492,15060971.55,54.48614142957281,64.0249219361909,NaN,NaN,-6.4566709014644355,12.719478514122603,-0.23700698056023917,0.6302156140399546,0.8672225946001938,1217987380,1201769027.2,49.47121925282237,58.23453832184384,NaN,NaN,22.639891565665312,28.432451070494867
2022-01-20T09:30:00-05:00,76.33,76.98,75.835,75.9,15677902,15251263.1,49.672714775292555,62.805839424685324,NaN,NaN,-45.094972601610884,-1.7928871769271226,-0.27295241770064027,0.5260320724743934,0.7989844901750337,1202309478,1206136095,52.20169354402837,56.50482381908252,NaN,NaN,19.046184293226286,27.091555816599357
2022-01-21T09:30:00-05:00,76.28,76.93,75.8361,75.96,25270618,16132284,50.240792408526794,61.451415485513145,NaN,NaN,-63.08115122828491,-22.380079700554614,-0.28462883380821313,0.44319844791476726,0.7278272817229804,1227580096,1212699813.2,56.04619822651258,54.938797338069556,NaN,NaN,16.300609113751268,25.549992001906773
2022-01-24T09:30:00-05:00,75.66,76.16,74.11,75.71,35520550,17503859.9,47.81878129650303,59.931559541278375,NaN,NaN,-197.80010231231194,-69.32463363532231,-0.29961654977148544,0.35330659450862356,0.652923144280109,1192059546,1207881077.6,52.695253700224036,53.17200800054489,NaN,NaN,13.271058820647966,23.79585869029837
2022-01-25T09:30:00-05:00,75.05,75.305,73.97,74.87,28638455,18568623.25,40.716274678823154,57.73005396247903,NaN,NaN,-245.7265095010818,-111.6318813089508,-0.3528635784262518,0.2118436712472942,0.564707249673546,1163421091,1200671518.2,48.064946035863805,51.017181144689665,NaN,NaN,8.217365479802,21.57035966022746
2022-01-26T09:30:00-05:00,74.64,75.31,73.855,74.3,33222240,19865468.65,36.729609958026955,55.30162694769827,NaN,NaN,-216.7136653868282,-153.68328020602354,-0.40926448913837693,0.05312663825057484,0.4623911273889518,1130198851,1183113812.4,39.06281024192227,48.59227364781558,NaN,NaN,2.558295251751273,18.854350459016576
2022-01-27T09:30:00-05:00,74.89,75.98,74.505,74.8,23821391,20661956.75,42.086371176470614,53.43406106767303,NaN,NaN,-128.8662273508987,-170.43753115588112,-0.3954678662442665,-0.03194370541638136,0.36352416082788513,1154020242,1173455965.2,35.16173244356794,46.46935185171337,NaN,NaN,-0.5275440747566698,16.085508382763255
2022-01-28T09:30:00-05:00,74.41,75.72,73.76,75.68,25111502,21577389.2,50.0947619843396,52.10614843822303,NaN,NaN,-113.17479616754095,-180.45626014373232,-0.31324396749512784,-0.028030798541024637,0.2852131689541032,1179131744,1163766294.8,31.73718712436336,44.58384483780174,NaN,NaN,-0.5381521802161511,13.710699730909054
2022-01-31T09:30:00-05:00,75.22,76.04,75.05,75.97,15453029,21785592.95,52.42931578686165,51.459500634452695,NaN,NaN,-52.18760568369666,-151.33376081800927,-0.22937996582541187,-0.001511788327661634,0.22786817749775024,1194584773,1164271340.2,32.10834199703781,43.10878283633948,NaN,NaN,0.22465232367116975,11.78412152987507
2022-02-01T09:30:00-05:00,75.97,76.14,75.12,75.9,15621141,21450636.5,51.79942189882288,50.83983850719347,NaN,NaN,-44.582238659682616,-111.10490664972943,-0.17133582459882427,0.01369839674921991,0.18503422134804418,1178963632,1167379848.4,34.470002249442885,42.46256865769258,NaN,NaN,0.6357489423448853,10.191496874513616
2022-02-02T09:30:00-05:00,75.98,76.925,75.91,76.81,13630426,20978856.55,58.739381928745786,50.699374253491506,NaN,NaN,31.218226574617493,-61.51852825744028,-0.0695860219374228,0.09805169392626567,0.16763771586368847,1192594058,1179858889.8,43.03664158973614,42.691493835533564,NaN,NaN,3.317045784043028,9.209432433017819
2022-02-03T09:30:00-05:00,76.46,77.21,76.345,76.83,14414670,20212165.35,58.879513584054514,50.488769685039806,NaN,NaN,60.49126993073022,-23.6470288011145,-0.0024153703750450783,0.1646185028948821,0.1670338732699272,1207008728,1190456587,49.11986228661534,43.35531146326789,NaN,NaN,5.462254870893559,8.674121352714353
2022-02-04T09:30:00-05:00,76.31,76.67,75.46,75.89,17939700,19857953.4,50.24265777535309,49.57989831486246,NaN,NaN,-6.999380664463744,-2.4119457004990665,-0.021698909508493847,0.13991023638430988,0.16160914589280373,1189069028,1192444043.8,50.19407399052272,44.00472379898276,NaN,NaN,4.583393364321747,8.089731640086837
2022-02-07T09:30:00-05:00,76.19,76.4,75.59,76.03,10949447,19772912.75,51.38641530862569,49.66586814214424,NaN,NaN,-0.007640624537462464,8.024047311332772,-0.02518685236108792,0.13012558044144384,0.15531243280253176,1200018475,1193530784.2,50.80567668649731,44.58397424065404,NaN,NaN,4.242404575857658,7.540113488054097
2022-02-08T09:30:00-05:00,76.21,76.53,75.91,76.32,11472902,19417644.25,53.75763335396385,49.61383185102931,NaN,NaN,32.7583496072279,23.49216496471488,-0.008961522244555764,0.14411052999683704,0.1530720522413928,1211491377,1200036333.2,54.41444069722867,44.93706148668307,NaN,NaN,4.687289482507605,7.132567201547456
2022-02-09T09:30:00-05:00,76.69,76.86,76.21,76.34,14899285,19184020.7,53.92455017690517,49.917534379715924,NaN,NaN,57.9299350414119,28.834506658073757,0.0015588027348418243,0.1550205556599451,0.15346175292510328,1226390662,1206795654,57.87235674968774,45.34210885851588,NaN,NaN,5.093338632849821,6.841248834590651
2022-02-10T09:30:00-05:00,75.92,76.27,75.245,75.52,19828502,19617683.65,46.51161773416506,49.65116476011866,NaN,NaN,-29.102349410587166,10.915782789810283,-0.04565854223444005,0.09638857513205323,0.14204711736649328,1206562160,1206706340.4,57.80995611350181,45.46809156472939,NaN,NaN,3.1788799401309604,6.318053278239267
2022-02-11T09:30:00-05:00,75.74,76.02,75.0311,75.25,18498403,19828235.5,44.34974922794501,49.40337675522166,NaN,NaN,-51.03854297791775,2.1079503271194824,-0.0913857487634957,0.027814931412123656,0.11920068017561936,1188063757,1206505286.2,57.6592374682699,45.822661833875536,NaN,NaN,0.9354610664631289,5.5491115336998185
2022-02-14T09:30:00-05:00,75.25,75.53,74.04,75.04,23550827,19936190.9,42.68782186158964,49.544201553990696,NaN,NaN,-107.57464386600039,-19.405450321173102,-0.12974452322419783,-0.04297997385462793,0.0867645493695699,1164512930,1199404177.2,52.45726882600436,46.136399176028426,NaN,NaN,-1.4158477469823552,4.554117350745222
2022-02-15T09:30:00-05:00,75.49,75.97,74.82,75.17,12300393,19716993.75,44.084705493124616,50.069565520783385,NaN,NaN,-48.19810269113159,-35.596740780844996,-0.13948035716155757,-0.08758589708237707,0.051894460079180506,1176813323,1192468566.4,47.91078796311089,46.768397584684756,NaN,NaN,-2.966230084641006,3.479782002832904
2022-02-16T09:30:00-05:00,75.13,75.58,74.585,75.31,13507754,19466456.85,45.62182388158523,50.322097856863,NaN,NaN,-60.93235668926202,-59.36919912697979,-0.1298094374085605,-0.1103673366815201,0.019442100727040383,1190321077,1185254649.4,43.6710907507287,47.3762088923391,NaN,NaN,-3.842293838569187,2.4337711683468912
2022-02-17T09:30:00-05:00,75.12,76.1,74.9,75.89,12873541,19326238.8,51.56258756930144,50.42694254150314,NaN,NaN,0.6623461384650645,-53.416260017169336,-0.08010607196226238,-0.08069048922578759,-0.0005844172635252123,1203194618,1184581141,43.2859626857998,48.2011214324417,NaN,NaN,-2.904612751834046,1.6711448940353288
2022-02-18T09:30:00-05:00,75.83,76.32,75.58,76.03,16470132,18886214.5,52.90017344355293,50.460575231266795,NaN,NaN,48.25026458574246,-33.558498504437296,-0.03581387179834773,-0.04535175701145988,-0.009537885213112147,1219664750,1190901339.6,47.9268141562049,49.33101230095364,NaN,NaN,-1.742576162498646,1.1834704573876182
2022-02-22T09:30:00-05:00,76.09,76.15,74.96,75.44,21545843,18187479.15,47.00865521475547,50.11837761097627,NaN,NaN,-14.095080893036737,-14.862585909844565,-0.043740423052379206,-0.06421341402858616,-0.020472990976206952,1198118907,1197622535,52.38869219444014,50.6109187255963,NaN,NaN,-2.427286558861439,0.6676480264948959
2022-02-23T09:30:00-05:00,75.69,75.73,74.73,74.83,15134257,17512269.25,41.822530641081975,48.91003109042885,NaN,NaN,-76.44716685011399,-20.512398741641043,-0.08515781313955892,-0.1269202574006556,-0.04176244426109668,1182984650,1198856800.4,53.18203842703235,51.33558992826032,NaN,NaN,-4.639233081352546,-0.09047784605473863
2022-02-24T09:30:00-05:00,73.84,74,72.19,73.54,30125661,17357440.3,33.424544195082035,47.09181899121653,NaN,NaN,-287.4568523111516,-65.81729786601895,-0.18859736366883834,-0.2775091488471446,-0.08891178517830628,1152858989,1191364382.8,47.95794080322343,51.25259553658946,NaN,NaN,-9.703126542277591,-1.4637133740865746
2022-02-25T09:30:00-05:00,73.97,76.02,73.94,75.91,21141593,17223450.4,52.353890761519004,47.242621347371234,NaN,NaN,-37.394336363127344,-73.42863436633743,-0.09148622951602588,-0.20326957207333862,-0.11178334255731275,1174000582,1185525575.6,44.305440922203196,50.831978888852355,NaN,NaN,-6.729092551187339,-2.2159103993866838
2022-02-28T09:30:00-05:00,74.78,75.21,74.09,74.9,20975349,17016642.75,46.31077105597753,46.88007532932494,NaN,NaN,-101.93100313619664,-103.46488791072525,-0.08925972571860574,-0.2233579997055699,-0.13409827398696417,1153025233,1172197672.2,37.31864667385288,49.868619602234894,NaN,NaN,-6.9199981938660855,-2.8879229414551695
2022-03-01T09:30:00-05:00,74.7,75.31,74.055,74.46,18750304,17181506.5,43.9317061498808,46.17822338617615,NaN,NaN,-102.63373951513118,-121.17261963514416,-0.11004227766899274,-0.2716511210732051,-0.16160884340421236,1134274929,1159428876.6,32.09647637638142,48.27447929360295,NaN,NaN,-7.982184126465819,-3.615674539313834
2022-03-02T09:30:00-05:00,74.48,75.59,74.38,75.25,18934983,17347198.6,48.997789983786795,45.826311943810545,NaN,NaN,-45.581551399794634,-114.99949654508028,-0.06541046918203869,-0.2433719298817607,-0.17796146069972202,1153209912,1153473929,29.988831754498918,46.28279893680375,NaN,NaN,-6.898643992650641,-4.084670175504806
2022-03-03T09:30:00-05:00,75.58,76.31,75.515,75.86,19576471,17644500.85,52.562042311919875,46.25848512793589,NaN,NaN,51.71710438477175,-47.16470520589561,0.006544024192079917,-0.16978143045962213,-0.17632545465170205,1172786383,1157459407.8,33.15264957548635,44.521562755516925,NaN,NaN,-4.742840075609704,-4.178694446948363
2022-03-04T09:30:00-05:00,75,76.03,74.71,75.87,22081363,18027835.5,52.620497732438956,46.849252878256884,NaN,NaN,19.13398251464586,-35.859041430340966,0.053546360237827634,-0.1093925043544175,-0.16293886459224513,1194867746,1161632840.6,36.39409834321313,43.0026242465843,NaN,NaN,-3.102629529238564,-4.0249708872755345
2022-03-07T09:30:00-05:00,75.46,75.79,74.4,74.49,20057306,18133715.8,44.475619727347286,46.97695272581101,NaN,NaN,-58.138566246098584,-27.10055405232136,-0.00638336834228162,-0.17091807502009715,-0.16453470667781553,1174810440,1165989882,39.682474030040005,42.09013890401542,NaN,NaN,-4.5334467632169,-4.097610298124301
2022-03-08T09:30:00-05:00,74.57,74.755,72.43,72.48,29710386,19071762.75,35.78690679630439,46.38425281889528,NaN,NaN,-224.64034777901244,-51.50187570509761,-0.1703850072276261,-0.37751596571234813,-0.20713095848472204,1145100054,1168154907,41.30627064837353,41.61838766724846,NaN,NaN,-9.216022692095414,-4.828812068691603
2022-03-09T09:30:00-05:00,73.61,73.625,72.655,72.97,18254234,19410829.35,38.91961477909316,45.905523597288706,NaN,NaN,-197.231845848749,-81.83193459488848,-0.23108716493315173,-0.4959899146511617,-0.26490274971801,1163354288,1170183782.2,42.85871212944136,41.5603606228708,NaN,NaN,-11.629645603339647,-5.800359716498466
2022-03-10T09:30:00-05:00,72.45,72.73,71.6,72.28,21892496,19760489.9,36.23856424534455,44.81095050272035,NaN,NaN,-222.6195832765237,-136.69927212714757,-0.29863925057801,-0.6382018129405225,-0.3395625623625125,1141461792,1163918864,39.39377111833909,41.28234693948075,NaN,NaN,-14.496567988880338,-7.042675183981591
2022-03-11T09:30:00-05:00,72.54,72.94,71.34,71.44,14276506,19482890.1,33.23683823228863,43.406426559058616,NaN,NaN,-190.61669507789335,-178.6494076456554,-0.37583553670813535,-0.8093569832476817,-0.43352144653954633,1127185286,1150382372,33.15642510106319,40.22731914982777,NaN,NaN,-17.87912273841537,-8.590739120329273
2022-03-14T09:30:00-04:00,71.89,72.54,71.43,71.82,18438859,19479912.9,35.82650997887292,42.60770189935272,NaN,NaN,-150.99145350168754,-197.2199850967732,-0.376315708914033,-0.9039160826820876,-0.5276003737680546,1145624145,1144545113,30.885443392228566,38.69137280681265,NaN,NaN,-19.681216294488102,-10.175093002351963
2022-03-15T09:30:00-04:00,72.47,73.52,72.3,73.43,17078070,19156275.05,45.47634232464359,42.868688448178546,NaN,NaN,-71.9712860672237,-166.68617275441545,-0.24933310961267652,-0.8392667607839002,-0.5899336511712236,1162702215,1148065545.2,33.82908401902182,37.309018920526185,NaN,NaN,-17.86517174330046,-11.273675679630319
2022-03-16T09:30:00-04:00,73.61,73.89,72.455,73.51,18783201,19480415.45,45.91157077116052,43.76061891789844,NaN,NaN,-53.77652592431086,-137.99510876952783,-0.1461886972282842,-0.772669522706579,-0.6264808254782948,1181485416,1151691770.8,36.814311969076535,36.513045432372834,NaN,NaN,-16.333245108342968,-11.996471312303555
2022-03-17T09:30:00-04:00,73.46,74.15,73.285,74.02,14484621,19529258.8,48.72172754226106,43.50117868795144,NaN,NaN,-21.20907905517427,-97.71300792525794,-0.03561781006276432,-0.6710030880567501,-0.6353852779939858,1195970037,1162593419.8,44.867051154857705,36.553160448991015,NaN,NaN,-14.18590658570169,-12.30924777993186
2022-03-18T09:30:00-04:00,74.09,74.26,73.53,74.19,20278562,19899509.85,49.660580992918945,43.740450826304404,NaN,NaN,-7.356623635528383,-61.06099363678495,0.05219471350177074,-0.5701418861167724,-0.6223365996185432,1216248599,1180406082.4,54.966201258351525,37.813700062169495,NaN,NaN,-12.180444399809396,-12.290847297057223
2022-03-21T09:30:00-04:00,74.04,74.61,73.54,73.95,17659167,19958961.6,48.31565226023034,44.0535898341865,NaN,NaN,0.7067888933136667,-30.721345157784704,0.09485525360018499,-0.503767532618312,-0.598622786218497,1198589432,1190999139.8,59.69459917177734,39.784994547554916,NaN,NaN,-10.919981972423397,-12.095009393538104
2022-03-22T09:30:00-04:00,74.5,74.645,73.87,74.5,11667376,19465038.25,51.55370680397742,44.236155321342984,NaN,NaN,25.265285497720573,-11.274030844795854,0.15717882930191374,-0.40214924959110476,-0.5593280788930185,1210256808,1200510058.4,63.409363147672615,42.172175361353034,NaN,NaN,-8.896975514065279,-11.638147410756272
2022-03-23T09:30:00-04:00,74.59,74.78,73.83,73.9,14027765,19409713.65,48.0193177779664,43.911674997489165,NaN,NaN,17.79559682070276,3.0403937042068754,0.15481115422409275,-0.3658141361129026,-0.5206252903369953,1196229043,1203458783.8,64.50173782195972,44.411395950386854,NaN,NaN,-8.177842147820483,-11.14381808747973
2022-03-24T09:30:00-04:00,74.2,74.4453,73.95,74.42,9458792,18376370.2,51.14537493244999,43.80630908320423,NaN,NaN,21.944057825910335,11.671021080423795,0.18314331141564333,-0.2916961510674412,-0.4748394624830845,1205687835,1205402343.4,65.23836886503992,46.47170098766019,NaN,NaN,-6.653515408642724,-10.5023462762173
2022-03-25T09:30:00-04:00,74.6,75.185,74.53,75.04,12508507,17944715.9,54.64748164977528,44.53287064909195,NaN,NaN,71.20993547324133,27.384332902177732,0.23519665595136596,-0.18084364254387708,-0.41604029849524304,1218196342,1205791892,65.3933756225695,48.30819395855515,NaN,NaN,-4.30693286106087,-9.61728721690924
2022-03-28T09:30:00-04:00,75.07,75.35,74.63,75.35,11602568,17476076.85,56.332993460824056,46.00044826798621,NaN,NaN,82.5460803940589,43.75219120232678,0.27906972228622323,-0.06720314563746399,-0.3462728679236872,1229798910,1212033787.6,67.86598236167364,50.205316223790874,NaN,NaN,-1.858732110763809,-8.508922201745607
2022-03-29T09:30:00-04:00,75.94,76.16,75.34,76.02,16595130,17368318.15,59.80956294394896,47.49258742261876,NaN,NaN,123.77758820951072,63.45465174468482,0.3378539527163068,0.07604457297169631,-0.2618093797446105,1246394040,1219261234,70.4947276075606,52.17931732937082,NaN,NaN,1.3003007283810497,-7.107604640298942
2022-03-30T09:30:00-04:00,75.72,76.08,75.4,76.07,13367526,17089945.3,60.065086022230815,49.19448183525349,NaN,NaN,117.17429910974036,83.33039220249233,0.3625656563625214,0.1913976907085413,-0.17116796565398013,1259761566,1231967738.6,74.45176596606116,54.68345981849382,NaN,NaN,3.9541924970616975,-5.527347906390279
2022-03-31T09:30:00-04:00,75.98,76.35,75.76,75.89,12388517,16730547.6,58.62017307618914,51.00757718124639,NaN,NaN,126.04498205157475,104.1505770476252,0.3491215088274442,0.2652339203803251,-0.08388758844711908,1247373049,1240304781.4,76.66323983080821,57.791089442047046,NaN,NaN,5.802030664567084,-3.90886525339637
2022-04-01T09:30:00-04:00,76.03,76.735,75.735,76.65,12643956,16258677.25,62.700105355670495,52.9271197081605,NaN,NaN,141.91455662212178,118.29150127740131,0.3716596628527723,0.3806869901188463,0.009027327266074012,1260017005,1248668914,78.65908784011765,61.203492616896256,NaN,NaN,8.627347278895778,-2.1179777487832063
2022-04-04T09:30:00-04:00,76.52,76.52,75.54,76.41,9618395,15736731.7,60.6659160023235,54.012089256566206,NaN,NaN,117.23349014735211,125.22898322805995,0.3509045877582774,0.4476580619639208,0.09675347420564337,1250398610,1252788854,79.58524714485097,64.47178998302691,NaN,NaN,10.454410179808436,-0.3219223304129719
2022-04-05T09:30:00-04:00,76.06,77.27,76.06,76.48,12717155,14887070.15,61.062705673059384,55.094313178130406,NaN,NaN,124.60526306094326,125.39451819834646,0.3230858639605443,0.5006108041563238,0.17752494019577944,1263115765,1256133199,80.33143844274879,67.58015615971779,NaN,NaN,12.084375644178802,1.4504059516715673
2022-04-06T09:30:00-04:00,76.48,77.55,76.15,77.45,23849593,15166838.1,66.15735191008113,56.33971491868899,NaN,NaN,128.56070399997157,127.67179917639268,0.3489976048693745,0.6137719462824975,0.26477434141312306,1286965358,1261573957.4,81.51517343397441,70.19787917965469,NaN,NaN,15.071871286815783,3.3963295709778833
2022-04-07T09:30:00-04:00,77.71,78.56,77.49,78.39,18311502,14987788.4,70.22333131232165,57.808482798646324,NaN,NaN,161.79080934716234,134.8209646355102,0.40451825779765016,0.7704221636601858,0.36590390586253563,1305276860,1273154719.6,83.75613153364374,72.254302770747,NaN,NaN,19.019941065897967,5.62827407025218
2022-04-08T09:30:00-04:00,78.6,78.96,78.245,78.72,13879445,14967935.35,71.51709764921398,59.46572889785945,NaN,NaN,164.39100844956815,139.3162550009995,0.4358359649258111,0.9106988620197995,0.47486289709398843,1319156305,1284982579.6,85.6673043126711,74.10949599509657,NaN,NaN,22.695794849093705,8.066491324372398
2022-04-11T09:30:00-04:00,78.86,79.12,78.25,78.4,18229905,14957487.65,68.41297456387382,60.66996230928061,NaN,NaN,145.29881831359745,144.92932063424854,0.4078671687516219,0.9846968580335158,0.5768296892818939,1300926400,1295088137.6,87.06733432184238,75.79935107896583,NaN,NaN,24.88011953269064,10.468438211275004
2022-04-12T09:30:00-04:00,78.41,78.96,78.135,78.42,19804785,15093823.4,68.5049846796093,62.13322423082654,NaN,NaN,128.39494693388266,145.68725740883642,0.36497330530702343,1.0330463209156733,0.6680730156086498,1320731185,1306611221.6,88.45246817783811,77.51011753295714,NaN,NaN,26.689730575731684,12.785765691911672
2022-04-13T09:30:00-04:00,78.36,78.965,78.35,78.86,11715719,14740449.3,70.53824429638772,63.518429185393515,NaN,NaN,124.56032387378539,144.8871813835992,0.3409448368585617,1.094254061681852,0.7533092248232902,1332446904,1315707530.8,89.4161395727651,79.2371011549375,NaN,NaN,28.83412937467212,15.078389075163164
2022-04-14T09:30:00-04:00,78.99,79.39,78.79,78.84,12195559,14625996.2,70.31603236656967,64.63761137945026,NaN,NaN,121.22523548681944,136.7740666115306,0.2998672369261103,1.128143270980928,0.8282760340548178,1320251345,1318702427.8,89.7203128503509,80.97473952835047,NaN,NaN,30.549903189769473,17.28860537724978
2022-04-18T09:30:00-04:00,78.66,78.95,77.965,78.19,11426673,14183401.75,63.333046704728645,65.1376151825863,NaN,NaN,82.4614624387759,120.38815740937216,0.20936834104704094,1.089986460363619,0.880618119316578,1308824672,1316636101.2,87.84448401036502,82.40177536039985,NaN,NaN,30.155864391731846,19.126785236461505
2022-04-19T09:30:00-04:00,78.22,79.49,78.15,79.38,12814184,13941152.6,69.33679674830714,65.8181318828976,NaN,NaN,98.88453383771429,111.10530051419555,0.2095845446069362,1.1425988000752483,0.9330142554683121,1321638856,1320778592.4,88.36947177330062,83.67854280080986,NaN,NaN,31.610696884594912,20.910201186194847
2022-04-20T09:30:00-04:00,79.82,80.75,79.77,80.57,21659592,14440763.4,73.93321851052404,66.80871277491853,NaN,NaN,140.1983969634799,113.465990520115,0.2661701957320327,1.265727000133353,0.9995568044013202,1343298448,1325292045,88.9304398173085,84.71273379018467,NaN,NaN,34.45405411257063,22.845037318534246
2022-04-21T09:30:00-04:00,80.73,81.34,80.44,80.5,18501822,14664466.25,73.23775692392614,67.85282590689975,NaN,NaN,139.66487754257696,116.4869012538733,0.2741038990709759,1.34218667824004,1.0680827791690641,1324796626,1323761989.4,87.3916070748326,85.47904573618642,NaN,NaN,36.46913289313849,24.79133668633485
2022-04-22T09:30:00-04:00,80.69,80.79,79.17,79.24,19747884,15178920.85,61.9428665007754,67.79873741726439,NaN,NaN,89.23369370646198,110.0885928978018,0.17455984806904024,1.2862825892553644,1.1117227411863242,1305048742,1320721468.8,84.27096218344053,85.87989390356663,NaN,NaN,34.48896545204516,26.176712224293468
2022-04-25T09:30:00-04:00,79.49,79.83,78.18,79.59,30868248,16096907.9,63.62119732607235,68.00982894038931,NaN,NaN,60.83961954739111,105.76422431952483,0.11521766802148004,1.2557448262131743,1.1405271581916943,1335916990,1326139932.4,85.27975625338925,86.2866445541765,NaN,NaN,33.4311471978689,27.213060077661385
2022-04-26T09:30:00-04:00,79.47,79.8501,78.34,78.36,26864520,16860005.5,54.52142644232659,67.54259470962269,NaN,NaN,39.83058800064499,93.95343515211097,-0.016910456218607317,1.1193890879184352,1.1362995441370425,1309052470,1323622655.2,82.62839298213405,86.45071273556115,NaN,NaN,29.338744512916275,27.5167292826978
2022-04-27T09:30:00-04:00,78.53,79.47,78.32,78.65,29441663,17502332.15,56.115177675423745,66.8252965500043,NaN,NaN,33.458539479712854,72.60546365535755,-0.09069163422327353,1.0229350013579506,1.113626635581224,1338494133,1322661792.2,81.58570950501033,86.45575102634943,NaN,NaN,26.6101227796839,27.387214067981528
2022-04-28T09:30:00-04:00,78.76,79.9,78.35,79.81,22128498,17940380.75,61.871073811005814,66.22870672848174,NaN,NaN,61.575530412348904,56.98759422931194,-0.06830627332634331,1.028243793923295,1.0965500672496382,1360622631,1329826993.2,83.28008209363192,86.42174749492003,NaN,NaN,26.167482559038007,27.212966709561027
2022-04-29T09:30:00-04:00,79.41,79.53,77.54,77.64,27802853,18711097.55,48.93966069593443,64.61603266039035,NaN,NaN,-21.896513993636823,34.76155268929218,-0.19917620320859486,0.8475798132388945,1.0467560164474894,1332819778,1335381200.4,84.47276867354358,86.33642352069663,NaN,NaN,20.77916295962334,26.293851888141358
2022-05-02T09:30:00-04:00,78.18,78.29,75.49,76.62,55145075,20836153.5,44.25726583836615,62.89062489428265,NaN,NaN,-136.94483977482594,-4.795339175151203,-0.34539888607949965,0.6150074088481148,0.9604062949276144,1277674703,1323732743,72.75171977120775,85.31387962422274,NaN,NaN,14.69594519126166,24.637008074301402
2022-05-03T09:30:00-04:00,76.49,77.12,75.9,76.4,47646908,22737579.15,43.29509331081039,61.08991836793988,NaN,NaN,-167.56266073457388,-46.273988922194974,-0.4417377774513105,0.40823407311347637,0.8499718505647869,1230027795,1307927808,60.48786529089045,83.31640798944076,NaN,NaN,9.764651751766303,22.512385742510673
2022-05-04T09:30:00-04:00,76.43,78.23,76.2,78.12,37161586,23959800.7,52.068697752022715,59.770665043342376,NaN,NaN,-93.47446498560565,-71.66058981525867,-0.37694715328748474,0.3787879089554309,0.7557350622429156,1267189381,1293666857.6,51.97427740886733,80.64198926344805,NaN,NaN,8.683106995532855,20.536774492942413
2022-05-05T09:30:00-04:00,77.7,77.88,76.0702,76.64,32186055,24376623.8,45.53945006601835,58.00090916473156,NaN,NaN,-146.74251688442035,-113.32419927461254,-0.4179174873691035,0.2333382030315363,0.6512556904006398,1235003326,1268542996.6,41.02042037860709,77.16342551546634,NaN,NaN,5.330102838269218,18.3643928279891
2022-05-06T09:30:00-04:00,76.36,77.11,75.975,76.72,34046906,25163394,45.934109729653926,56.758127952226225,NaN,NaN,-145.3882034876455,-138.02253717341426,-0.42252093449059847,0.12310452228739166,0.5456254567779901,1269050232,1255789087.4,36.78242404110973,73.5161355176624,NaN,NaN,2.9618735116298405,16.164032925652062
2022-05-09T09:30:00-04:00,76.13,77.37,75.77,76.69,33323773,26135610.4,45.80007330241632,55.076933420376875,NaN,NaN,-122.04596283461943,-135.04276178537296,-0.41014593344728445,0.03294303996888459,0.44308897341616904,1235726459,1247399438.6,34.27394912892609,69.65216961449279,NaN,NaN,1.0955992097914062,14.011399537671968
2022-05-10T09:30:00-04:00,77.08,77.33,75.85,76.16,32511168,26849673.55,43.3911235905701,52.89535521180874,NaN,NaN,-113.5988758309783,-124.25000480465386,-0.41875191438737336,-0.08035091956804763,0.33840099481932573,1203215291,1242036937.8,32.737145099261184,65.63836284891798,NaN,NaN,-1.1923939071316727,11.839429045557162
2022-05-11T09:30:00-04:00,76.25,77.11,75.765,75.83,30110114,27364940,41.912926640900096,50.65786733444975,NaN,NaN,-108.71503019536664,-127.29811784660603,-0.42633927554267226,-0.1945230996090146,0.23181617593365766,1173105177,1223220097,27.9938420307613,61.395665345770034,NaN,NaN,-3.5086161996520446,9.646851153384418
2022-05-12T09:30:00-04:00,75.98,76.36,75,75.81,29049703,28231639.2,41.81994107011246,49.22051551797382,NaN,NaN,-117.7443328934987,-121.4984810484217,-0.412135254309543,-0.28335289195327107,0.1287823623562719,1144055474,1205030526.6,24.324821456316215,57.11379815097543,NaN,NaN,-5.403412357657117,7.496813508949913
2022-05-13T09:30:00-04:00,76.19,77.01,75.73,76.95,15405428,28392132.65,48.79346792459597,48.16139198929694,NaN,NaN,-67.6601092339946,-105.95286219769153,-0.3100495853891826,-0.2587796193802063,0.05126996600897625,1159460902,1183112660.6,20.789059695283058,52.50731982539641,NaN,NaN,-5.036533776801901,5.706335325271082
2022-05-16T09:30:00-04:00,76.9,77.645,76.57,77.3,14613712,28551484.6,50.74543585236202,47.89167837572804,NaN,NaN,-34.23687548298842,-88.39104472736531,-0.20794219039655876,-0.2086577719867222,-0.0007155815901634457,1174074614,1170782291.6,19.106476926360642,47.970040107126884,NaN,NaN,-4.158450949914184,4.297080143101758
2022-05-17T09:30:00-04:00,77.03,77.23,75.992,76.77,20637155,28942633.15,47.77551291841029,47.29598803594137,NaN,NaN,-54.30860278942768,-76.53299011905519,-0.1668594181379779,-0.2092898542626358,-0.04243043612465792,1153437459,1160826725.2,17.85027059509474,43.41750875641863,NaN,NaN,-4.265751988572573,3.0738184100054253
2022-05-18T09:30:00-04:00,75.93,75.96,71.6,71.83,40188903,29869098.7,30.095424587270173,45.02629880567453,NaN,NaN,-212.35910816878004,-97.26180571373786,-0.4472349150433187,-0.6014740799288063,-0.1542391648854876,1113248556,1148855401,16.4497171064708,38.643911257335695,NaN,NaN,-11.4983627188608,0.9920782487388218
2022-05-19T09:30:00-04:00,71.43,71.45,70.08,70.55,38772025,30882608.85,27.27854679029184,43.47907638384292,NaN,NaN,-298.9903287871087,-133.51100489245988,-0.6798044921223616,-1.0039947800384397,-0.32419028791607807,1074476531,1134939612.4,14.978509972306469,33.680035635818754,NaN,NaN,-18.244605038789558,-1.7560193637652324
2022-05-20T09:30:00-04:00,70.95,70.968,69.575,70.7,26184985,31204463.9,28.127524152962764,42.32695197774268,NaN,NaN,-251.82090614415642,-170.34316427449224,-0.7774098920682521,-1.2959526530013932,-0.5185427609331411,1100661516,1123179735.2,13.85110617207566,29.47284895016647,NaN,NaN,-22.90927965741842,-4.777913691429973
2022-05-23T09:30:00-04:00,71.48,72.42,71.27,72.16,17711123,30546607.65,35.96373052612985,41.803283207408356,NaN,NaN,-149.02129462886458,-193.30004810366748,-0.6999327101282371,-1.3934586485934375,-0.6935259384652004,1118372639,1112039340.2,12.863354853191638,26.07109820461655,NaN,NaN,-23.955494812151713,-7.517568137247364
2022-05-24T09:30:00-04:00,71.99,73.45,71.87,73.34,23272422,30367002.75,41.51394099608297,41.04937201055551,NaN,NaN,-96.91814826231462,-201.82195719824486,-0.5330522973183971,-1.3598413101131968,-0.8267890127947997,1141645061,1109680860.6,12.65756239508319,23.262761417917687,NaN,NaN,-22.82164326584773,-9.703864584190274
2022-05-25T09:30:00-04:00,73.2,73.57,72.74,73.36,16647243,29727281.75,41.606321841518614,40.7684342802341,NaN,NaN,-73.06997929714197,-173.96413142391725,-0.3916973744415756,-1.3164107308467692,-0.9247133564051936,1158292304,1118689610.2,18.05065369968507,21.622063797994684,NaN,NaN,-21.93030917855749,-11.450499526242734
2022-05-26T09:30:00-04:00,73.7,74.52,73.58,74.14,16580542,29449883.95,45.239182870486324,40.71879664743642,NaN,NaN,-37.57734048300396,-121.68153376309628,-0.2243572107289753,-1.2051598698164128,-0.9808026590874375,1174872846,1138768873.2,28.62866911668472,21.03965273196433,NaN,NaN,-20.023998228558103,-12.67528505514493
2022-05-27T09:30:00-04:00,74.25,75,74.12,75,16921336,28905808.1,49.00612945461991,40.947800658308104,NaN,NaN,-11.482988118640149,-73.61395015799303,-0.043885480805141874,-1.0356595100938648,-0.9917740292887229,1191794182,1156995406.4,36.6254398720372,21.20761635647227,NaN,NaN,-17.228990677949824,-13.325814429831343
2022-05-31T09:30:00-04:00,74.6,74.96,73.695,74.47,19212303,27109169.5,46.86647362762752,41.19603994666935,NaN,NaN,-19.211096748464925,-47.65191058191313,0.04674970530250211,-0.9333368976605954,-0.9800866029630975,1172581879,1167837254.4,40.869543773349314,21.78850197604999,NaN,NaN,-15.592189078733746,-13.6495822368174
2022-06-01T09:30:00-04:00,74.57,74.63,73.005,73.5,17552234,25604435.8,43.15296287657659,41.28461396350338,NaN,NaN,-38.20649711392813,-35.909580352235814,0.04813951583126885,-0.9199122081740114,-0.9680517240052803,1155029645,1170514171.2,41.904050095114556,22.782088266360937,NaN,NaN,-15.33767206331694,-13.890737926317334
2022-06-02T09:30:00-04:00,73.67,74.57,72.46,74.57,17618503,24627281.65,48.04352534806038,41.72915569764252,NaN,NaN,-27.577195308055185,-26.811023554418455,0.12359751224679671,-0.8135548336967844,-0.9371523459435811,1172648148,1173385340,43.0548172199628,24.119945106621408,NaN,NaN,-13.583100633046016,-13.846789741564288
2022-06-03T09:30:00-04:00,74.26,74.55,73.63,73.82,9750326,23505495.2,45.11382757335841,41.46632424398269,NaN,NaN,-18.126605933195062,-22.920876644456676,0.12509452789664155,-0.7807841860727791,-0.9058787139694207,1162897822,1170990335.2,42.30209316983061,25.656590354803377,NaN,NaN,-13.01842037710325,-13.728451260926997
2022-06-06T09:30:00-04:00,74.33,74.555,73.595,73.85,10924278,22349363.8,45.25762670057161,41.074337875997664,NaN,NaN,-13.792317134221559,-23.38274244757296,0.12964841967547525,-0.7438181893750766,-0.8734666090505518,1173822100,1167395918.8,41.13962504332059,27.23038664887195,NaN,NaN,-12.525379919024235,-13.55658392636946
2022-06-07T09:30:00-04:00,72.89,74.34,72.89,74.24,9070421,21136696.2,47.19449693296746,41.032836734180314,NaN,NaN,-16.640082603237115,-22.86853961852741,0.1585584436591596,-0.6752685544766024,-0.833826998135762,1182892521,1169458047.2,42.12228347408849,28.964101854514357,NaN,NaN,-11.562076987523833,-13.271654363677227
2022-06-08T09:30:00-04:00,73.82,73.9873,73.28,73.33,7896633,19905969.45,43.34114437933805,41.97895957647087,NaN,NaN,-25.474277840877825,-20.32209576391735,0.11789455849425345,-0.6864588000179452,-0.8043533585121987,1174995888,1173451295.8,44.06954048268836,30.936946381387042,NaN,NaN,-11.82713138245358,-13.065293937788134
2022-06-09T09:30:00-04:00,73.26,73.975,72.205,72.23,9442193,18872573.4,39.17709743134264,42.82885605083164,NaN,NaN,-56.71345992107545,-26.1493486865214,0.023360701328053457,-0.7751524818521318,-0.7985131831801853,1165553695,1172032405.2,43.50939329285999,32.97486661856944,NaN,NaN,-13.30557825653682,-13.099620269037946
2022-06-10T09:30:00-04:00,71.34,72.49,70.97,71.92,17720473,18306111.9,38.06710806036059,43.53882632993149,NaN,NaN,-99.27886817082913,-42.379801134048215,-0.0496194789990726,-0.860537531929026,-0.8109180529299534,1147833222,1169019485.2,42.28046438479944,35.005535062335426,NaN,NaN,-14.847935955633476,-13.349379652837307
2022-06-13T09:30:00-04:00,70.85,71.34,70.08,70.37,22813158,18676498.4,33.02830345864372,43.329152967968184,NaN,NaN,-143.95073479234895,-68.4114846656737,-0.18428530090507944,-1.0412746790613028,-0.8569893781562233,1125020064,1159259078,38.48789995494477,36.83585971246065,NaN,NaN,-17.81943498994308,-13.98795898670956
2022-06-14T09:30:00-04:00,70.35,70.67,69.04,69.54,19864775,18939051.55,30.685970781580536,42.555726524075155,NaN,NaN,-165.23691813565156,-98.13085177215659,-0.3041863415676672,-1.2372223051158073,-0.9330359635481401,1105155289,1143711631.6,33.35533616421563,38.314272124541546,NaN,NaN,-21.064876150358042,-14.998947152945057
2022-06-15T09:30:00-04:00,70.03,70.59,68.83,69.61,20069317,18910659.65,31.129579097797944,41.80738775666653,NaN,NaN,-144.92811536142062,-122.02161927626514,-0.3504184930707277,-1.3710590798865496,-1.020640586815822,1125224606,1133757375.2,30.54662066573745,39.20684119354529,NaN,NaN,-23.542927294749635,-16.219515744631426
2022-06-16T09:30:00-04:00,68.66,69.61,68.22,69.08,19017076,17852068.3,29.58566753539482,40.68927951844571,NaN,NaN,-147.48732528199662,-140.17639234844938,-0.38554476993785514,-1.5025715492381408,-1.1170267793002857,1106207530,1121888142.2,27.56595052609623,39.13093272278896,NaN,NaN,-26.090581491775104,-17.62966799422338
2022-06-17T09:30:00-04:00,69.2,69.58,68.52,68.83,24825417,17154737.9,28.858602451342676,39.25017044678305,NaN,NaN,-134.71886106435068,-147.26439092715367,-0.39312104187559105,-1.6084280816447745,-1.2153070397691834,1081382113,1108597920.4,24.663889337498944,38.27653625603624,NaN,NaN,-28.417637701352817,-19.170806523813297
2022-06-21T09:30:00-04:00,69.13,70.335,68.8,70.14,16147172,16652847.25,37.522819248129096,38.582766562533166,NaN,NaN,-99.90689600389095,-138.4556231694621,-0.2825807858315239,-1.5685330220585882,-1.2859522362270643,1097529285,1103099764.6,23.55889997390534,37.04006169893309,NaN,NaN,-27.986075497920858,-20.43013066297152
2022-06-22T09:30:00-04:00,69.79,70.57,69.52,70.09,15207223,16527652.25,37.33591588346597,38.16726320588241,NaN,NaN,-79.23239729126112,-121.254719000584,-0.18995004524769876,-1.5233897927866877,-1.333439747538989,1082322062,1098533119.2,22.65117918631158,35.66485663401859,NaN,NaN,-27.68726627576984,-21.466864321942708
2022-06-23T09:30:00-04:00,70.57,71.515,70.5,71.45,16570694,16192565.85,45.31484638372035,37.9723575655724,NaN,NaN,-35.506156942028554,-99.37032731670558,-0.022984657916868212,-1.3621705699350741,-1.339185912018206,1098892756,1093266749.2,21.616782575405608,34.13356844512165,NaN,NaN,-25.00554354339416,-21.972389925007203
2022-06-24T09:30:00-04:00,72.08,72.88,71.815,72.85,13436969,16032052.15,52.07916660321585,38.46988178199079,NaN,NaN,14.89981098009508,-66.89290006428725,0.18442473762989708,-1.1086549899808347,-1.2930797276107318,1112329725,1094491188.2,22.50290185012527,32.71934049371413,NaN,NaN,-20.43803017692535,-21.753195675281223
2022-06-27T09:30:00-04:00,72.92,73.04,72.445,72.65,10936489,15749849.5,51.10660219181195,38.887665745650814,NaN,NaN,25.452877151154844,-34.858552421186126,0.303782307362815,-0.913351843407213,-1.217134150770028,1101393236,1098493412.8,25.468799765192756,31.59999583099071,NaN,NaN,-17.05093452538029,-21.08144408243823
2022-06-28T09:30:00-04:00,72.86,73.32,71.62,71.68,11004296,15453997.5,46.56470189218456,38.842680385594896,NaN,NaN,11.82686077387915,-12.511801065632117,0.31186179502158695,-0.8273069069930443,-1.1391687020146313,1090388940,1097065343.8,25.09967659955295,30.38409533995246,NaN,NaN,-15.488472805270062,-20.28244818569992
2022-06-29T09:30:00-04:00,71.96,72.425,71.79,72.13,9230621,14954913.4,48.83638262212767,39.235197402937004,NaN,NaN,13.523326422200078,6.039343677060124,0.33968108306426226,-0.7145673481843033,-1.0542484312485656,1099619561,1100524843.6,27.82851165638195,29.22402185235914,NaN,NaN,-13.510919718072376,-19.31508697603884
2022-06-30T09:30:00-04:00,71.76,72.495,71.3302,72.18,12670600,14710831.7,49.09533435440738,39.94364289744163,NaN,NaN,12.90374713421023,15.721324492307875,0.3521132950899062,-0.6141068123861828,-0.966220107476089,1112290161,1103204324.6,29.957043337126535,28.255996855521037,NaN,NaN,-11.833726066318016,-18.24632113179301
2022-07-01T09:30:00-04:00,72.2,73.27,72.08,73.22,11664106,14413111.85,54.278832078362456,41.101623184441756,NaN,NaN,55.249654170431775,23.791293130375216,0.41662641862242167,-0.44543708419806194,-0.8620635028204836,1123954267,1105529233,31.83554789611,27.50993139204322,NaN,NaN,-8.797303193225476,-16.896461426283363
2022-07-05T09:30:00-04:00,72.73,72.9801,71.58,72.75,12828763,14567033.7,51.7158914810426,42.436450900327394,NaN,NaN,41.19248496741078,26.9392146936264,0.4130867157264849,-0.34570510816237743,-0.7587918238888623,1111125504,1107475686.6,33.44490341351073,27.149717353369358,NaN,NaN,-6.976547430267551,-15.479330855423962
2022-07-06T09:30:00-04:00,73.02,73.47,72.73,72.96,11768055,14609222.55,52.78855004608675,44.015206562077836,NaN,NaN,75.45700044996929,39.66524262884443,0.4095328799144389,-0.2468757239958137,-0.6564086039102526,1122893559,1113976610.4,38.65437135543118,27.528219867027612,NaN,NaN,-5.16382980240432,-14.005687847849728
2022-07-07T09:30:00-04:00,72.9,73.15,72.6,73.03,8476258,14579514.4,53.16207392677798,45.58895619271927,NaN,NaN,73.34469798639125,51.62951694168267,0.3962886026022845,-0.1610478506573969,-0.5573364532596814,1131369817,1120326661.6,43.32117695219141,28.440688173202894,NaN,NaN,-3.560026342358577,-12.513450489922421
2022-07-08T09:30:00-04:00,73.06,73.48,72.665,72.9,10732544,14721309.95,52.33397024944417,47.21383495800851,NaN,NaN,80.47436523378,65.14364056159661,0.3639980765449435,-0.10233885757850203,-0.4663369341234455,1120637273,1121996084,44.5161991860007,29.651420220338927,NaN,NaN,-2.4201169330098384,-11.071545696077767
2022-07-11T09:30:00-04:00,72.81,73.3,72.55,72.8,7172507,14607825.65,51.66725631953601,48.84302452002232,NaN,NaN,73.2298687889143,68.73968348529313,0.3225473581636139,-0.06315273641892816,-0.38570009458254206,1113464766,1119898183.8,43.281224729754506,30.981229891214326,NaN,NaN,-1.6194031176171995,-9.721239613440543
2022-07-12T09:30:00-04:00,72.9,73.55,72.33,72.59,11032428,14273423.4,50.220352766645874,49.74999119991637,NaN,NaN,65.34398561361799,73.56998361453456,0.2697730301538253,-0.04848380689026044,-0.31825683704408575,1102432338,1118159550.6,42.23548123349092,32.31527140975616,NaN,NaN,-1.2869502928286205,-8.516341139067412
2022-07-13T09:30:00-04:00,72.17,73.285,71.99,72.64,13851601,13825345.55,50.57525117131171,50.69565800619107,NaN,NaN,51.73395458697307,68.82537444193532,0.2286455257707959,-0.03244992983059092,-0.2610954556013868,1116283939,1116837626.6,41.41611476219957,33.65562395089101,NaN,NaN,-0.9162587473232434,-7.43061508310396
2022-07-14T09:30:00-04:00,71.71,72.81,71.695,72.7,10801733,13372193.45,51.02646213180062,51.103630559625365,NaN,NaN,35.824590364849826,61.32135291762704,0.19709104377498782,-0.014731650882652048,-0.21182269465763987,1127085672,1115980797.6,40.86276359575715,35.030336880916124,NaN,NaN,-0.48896878043840336,-6.438951325580309
2022-07-15T09:30:00-04:00,73.18,73.41,72.645,72.94,9300300,12833742.6,52.87952233322269,51.16079882605443,NaN,NaN,66.82706690443752,58.59189325175854,0.18422885396978353,0.01846337280458954,-0.165765481165194,1136385972,1119130537.4,43.83356446412652,36.55395563905907,NaN,NaN,0.33285544237272296,-5.471550358729876
2022-07-18T09:30:00-04:00,73.07,73.19,72.1,72.23,8473577,12306567.65,47.19077143344757,50.8810966290284,NaN,NaN,31.52199702367583,50.25031889871084,0.12271021257245043,-0.012377715449630955,-0.1350879280220814,1127912395,1122020063.2,46.48932858241108,38.0554219831461,NaN,NaN,-0.35307033493620343,-4.740338926759351
2022-07-19T09:30:00-04:00,72.83,73.125,72.625,72.99,8729080,11501750.8,53.01726910743929,51.34199428726089,NaN,NaN,63.06105683802201,49.793733143591645,0.12745184320187414,0.024226875980261298,-0.10322496722161284,1136641475,1128861890.6,52.24696025124178,39.994513672552436,NaN,NaN,0.5902124716133608,-3.9788315841346784
2022-07-20T09:30:00-04:00,73.07,73.14,72.1231,72.5,10232158,11206000.1,49.24480313805918,51.371167181256,NaN,NaN,20.882951477285943,43.62353252165421,0.09341299624650704,0.013541278086520947,-0.07987171815998609,1126409317,1130886966.2,53.83044180029312,41.85179439711752,NaN,NaN,0.3693296634802496,-3.3576656916182603
2022-07-21T09:30:00-04:00,72.36,72.89,72.15,72.72,11944794,11042878.65,50.93294618080905,51.50242516885612,NaN,NaN,4.179161371407161,37.29444672296568,0.08194930404421871,0.02256491189528731,-0.0593843921489314,1138354111,1133140654,55.59517612600186,43.683089596322894,NaN,NaN,0.6409449240088688,-2.786435603671528
2022-07-22T09:30:00-04:00,72.88,73.405,72.77,73.2,9369807,10682834.3,54.48960777276687,51.517480575599286,NaN,NaN,115.45858545279701,47.02075043263759,0.10164204072786143,0.06766815876089538,-0.033973881966966046,1147723918,1135408243.2,57.36115051784405,45.50634692644676,NaN,NaN,1.870318787854778,-2.121184976310627
2022-07-25T09:30:00-04:00,73.29,73.73,73.14,73.56,8157474,10418859.55,57.006700889294194,51.89539553333155,NaN,NaN,173.14977565591542,75.3463061590855,0.1319409152102092,0.13095226204579546,-0.0009886531644137456,1155881392,1141002042.6,61.435592216161254,47.505681840921795,NaN,NaN,3.6385465290075394,-1.2983661898366032
2022-07-26T09:30:00-04:00,72.89,73.495,72.645,73.39,9764234,10360246.8,55.44715179860588,52.08529565851149,NaN,NaN,93.24766789034797,81.38362836955069,0.1331751124648357,0.16548023741663087,0.032305124951795175,1146117158,1142897179.2,62.73481672913426,49.22571365332916,NaN,NaN,4.708881966792981,-0.4401878817466628
2022-07-27T09:30:00-04:00,73.25,74.1,72.695,73.89,10995557,10359809.85,58.9998954511675,52.5022829102536,NaN,NaN,159.83256593893694,109.1735512618809,0.15858173618796234,0.23053229518674812,0.07195055899878577,1157112715,1149037858.8,66.65485859437024,50.89240519919906,NaN,NaN,6.656118876517556,0.5735702265767969
2022-07-28T09:30:00-04:00,73.94,75.225,73.81,75.07,9372002,10366878.9,65.90904049915753,53.47193078523314,NaN,NaN,323.8403463850312,173.10578826460568,0.24084188286726116,0.3730029125828622,0.13216102971560106,1166484717,1154663980,69.7903817353821,52.69770395272631,NaN,NaN,10.68398542840564,2.0179152554094886
2022-07-29T09:30:00-04:00,74.21,74.61,74.01,74.49,13199059,10393301.85,60.51136279092081,54.103652676046345,NaN,NaN,214.25059108570284,192.86418939118687,0.24155648779489206,0.4341066394592161,0.19255015166432407,1153285658,1155776328,70.38334760016055,54.633569872041015,NaN,NaN,12.42868459292915,3.505168017912297
2022-08-01T09:30:00-04:00,74.39,75.66,74.36,75.42,13150520,10467622.55,65.40384675478114,55.18818796091314,NaN,NaN,242.9161601304427,206.81746628609235,0.2869365824482517,0.5512208797246387,0.264284297276387,1166436178,1157887285.2,71.52560098904135,56.72572128315176,NaN,NaN,15.582202392665002,5.230458642876969
2022-08-02T09:30:00-04:00,75.37,75.51,74.71,74.82,10632744,10357821.6,60.220012674591956,55.87709949686173,NaN,NaN,176.2574569910042,223.4194241062236,0.25963822904484707,0.5888320835824459,0.3291938545375988,1155803434,1159824540.4,72.57110775114579,58.95107792521935,NaN,NaN,16.51036908479428,6.841874420293728
2022-08-03T09:30:00-04:00,74.84,75.46,74.53,75.31,12808570,10409847.35,62.81226370576325,56.718942466430484,NaN,NaN,149.5949083609024,221.37189259061665,0.2571869427266344,0.6506775329458918,0.3934905902192574,1168612004,1162124398.2,73.80096960354123,61.303806925775355,NaN,NaN,18.112880863761998,8.452018197932052
2022-08-04T09:30:00-04:00,75.14,75.345,74.505,74.81,11983556,10585212.25,58.6148779154949,57.12861072230708,NaN,NaN,111.58754673356898,178.92133266032423,0.206672148923554,0.6518307763736999,0.4451586274501459,1156628448,1160153144.4,70.86789027610703,63.234830198059676,NaN,NaN,18.09564530001415,9.82967921251521
2022-08-05T09:30:00-04:00,74.44,74.69,73.94,74.64,7125722,10404871.15,57.21494404678917,57.84462305183148,NaN,NaN,65.84871842976742,149.24095812913714,0.14926893016369885,0.6317447901547695,0.4824758599910706,1149502726,1159396558,69.72254703976353,64.89434580215628,NaN,NaN,17.65078270860922,10.94697971195721
2022-08-08T09:30:00-04:00,74.93,75.16,74.42,74.6,6966070,10394549.3,56.87076495911635,58.11987275552269,NaN,NaN,78.25236001292306,116.30819810563324,0.09851343388406708,0.6056176523461545,0.5071042184620874,1142536656,1154616653.6,62.815415141087065,65.64923543714522,NaN,NaN,17.191519869625445,11.839056877338386
2022-08-09T09:30:00-04:00,74.71,74.82,74.35,74.49,8086277,10247241.75,55.87533092119524,58.593481882889556,NaN,NaN,58.473248135543635,92.7513563345411,0.049893519741432746,0.5694711181388783,0.5195775983974456,1134450379,1150346042.6,57.34896286702045,65.9005583704829,NaN,NaN,16.531630012379413,12.509424468058533
2022-08-10T09:30:00-04:00,75.2,75.27,74.78,75.04,11262253,10117774.35,59.67585327308045,59.217975246623226,NaN,NaN,83.48495455540778,79.52936557344216,0.04716682404486061,0.5785361284535213,0.5313693044086607,1145712632,1145766168.2,52.11149801919379,65.65172421999661,NaN,NaN,17.022852679225856,13.154199926796723
2022-08-11T09:30:00-04:00,75.36,75.5956,74.69,74.86,8959652,10025670.3,57.91765716424949,59.46283591744342,NaN,NaN,77.59773609898944,72.73140344652626,0.026653649145210734,0.5646863658401742,0.5380327166949634,1136752980,1141791074.6,48.01292921463205,64.98399412691005,NaN,NaN,16.942693669268564,13.695413318578415
2022-08-12T09:30:00-04:00,75.09,75.51,74.7999,75.51,11094609,10115385.75,62.24363587473149,59.83690270211751,NaN,NaN,86.63427988073076,76.88851573671892,0.048975500097862446,0.5992520918172914,0.550276591719429,1147847589,1141460047.2,47.67664565798199,64.00121222989723,NaN,NaN,18.123624922569814,14.328014976291472
2022-08-15T09:30:00-04:00,75.47,76.3401,75.35,76.26,10207219,10202067.85,66.52024299786677,60.62783778777901,NaN,NaN,132.30230549208903,87.69850483255213,0.10324550840064872,0.67933347722024,0.5760879688195912,1158054808,1144563677.6,51.132521248660204,63.1724768384348,NaN,NaN,20.489894656862827,15.20828350208738
2022-08-16T09:30:00-04:00,76.54,77.4,76.48,77.12,12312584,10381243.05,70.62849653717399,61.45845215106518,NaN,NaN,194.66718444835757,114.93729209511494,0.18147970490156362,0.8029375999465458,0.6214578950449822,1170367392,1151747080.2,58.04031872315345,62.55715256191932,NaN,NaN,23.922102805892436,16.453114831202388
2022-08-17T09:30:00-04:00,76.8,77.2,76.71,76.9,9667715,10353020.9,68.31895864620589,61.630589161568636,NaN,NaN,177.4780369281643,133.73590856966624,0.20129631856500607,0.8730782932512398,0.6717819746862337,1160699677,1154744489.2,60.54646311179119,61.896872660234244,NaN,NaN,25.992323283279145,17.815858895784782
2022-08-18T09:30:00-04:00,76.78,77.27,76.695,77.16,5777663,10044664.35,69.58477727227333,62.27869019595096,NaN,NaN,169.99949043492072,152.21625943685248,0.21363278701333532,0.9388229584529029,0.7251901714395675,1166477340,1160689361.2,65.01018145276836,61.513075078277666,NaN,NaN,28.08323549871884,19.28262698191822
2022-08-19T09:30:00-04:00,76.92,77.28,76.773,76.91,6456485,9898998.25,66.8201852350994,62.3798572302594,NaN,NaN,146.0588544129242,164.10117434329118,0.18760022641214136,0.9596904544547442,0.7720902280426029,1160020855,1163124014.4,66.67315129434263,61.166471528656324,NaN,NaN,29.015716838057052,20.673068389938052
2022-08-22T09:30:00-04:00,76.68,76.7,76,76.13,7113667,9846807.9,58.95072029855437,62.289193489113856,NaN,NaN,78.0647715640158,153.25366755767652,0.10463243089082908,0.9028807666561391,0.7982483357653101,1152907188,1162094490.4,65.26068414409438,60.644298413866935,NaN,NaN,27.415304373918755,21.63624495907815
2022-08-23T09:30:00-04:00,75.85,75.91,75.47,75.8,10183480,9867770.2,55.948582399850544,61.798930538691515,NaN,NaN,27.33078236666695,119.7863871413384,0.018807512322369546,0.821757726168272,0.8029502138459025,1142723708,1156565753.6,58.137738480764945,59.52549619081149,NaN,NaN,25.160875514790877,22.139763609894256
2022-08-24T09:30:00-04:00,75.93,76.15,75.6699,75.99,8061857,9721085.2,57.29699951684737,61.704796367359556,NaN,NaN,36.50994492869216,91.59276874144398,-0.03116679250982668,0.7639917232086191,0.7951585157184458,1150785565,1154582931.2,55.78606863594982,58.44822321651454,NaN,NaN,23.689725609068883,22.36118675263349
2022-08-25T09:30:00-04:00,76.02,76.34,75.66,76.34,6105129,9557741.55,59.74166427610804,61.88527638373948,NaN,NaN,45.72736432027461,66.73834351851475,-0.045769029920658455,0.7379472283176227,0.7837162582382812,1156890694,1152665602,53.53119251305858,57.29169789317847,NaN,NaN,23.13972305404511,22.47240622426372
2022-08-26T09:30:00-04:00,76.38,76.475,74.36,74.45,11212541,9458415.65,44.82015590844482,61.02451859440579,NaN,NaN,-46.41872371386236,28.242827893157433,-0.18028251740272094,0.5583631114848799,0.7386456288876009,1145678153,1149797061.6,50.25814468882458,56.394750003731154,NaN,NaN,17.30076863445013,21.73360085429035
2022-08-29T09:30:00-04:00,74.01,74.7463,73.815,74.33,13214253,9461602.3,44.067565645289555,60.18110678898397,NaN,NaN,-108.31122843773561,-9.032372107192861,-0.269534468793851,0.4017275428952871,0.6712620116891381,1132463900,1145708404,45.945961226190356,55.58024988652901,NaN,NaN,12.526999478072124,20.418372086259176
2022-08-30T09:30:00-04:00,74.47,74.47,73.37,73.56,10316672,9445798.7,39.48591849471775,58.73896859052949,NaN,NaN,-135.92106584767646,-41.68274175006153,-0.366605789356948,0.21300477499295312,0.5796105643499011,1122147228,1141593108,42.03645523607195,54.860603973448875,NaN,NaN,6.893135464868863,18.486195426060558
2022-08-31T09:30:00-04:00,73.79,73.92,73.11,73.11,10397814,9325260.9,37.06084781131894,57.24919649389159,NaN,NaN,-148.73036165346235,-78.73080306649243,-0.4422322788316893,0.026820215810289483,0.4690524946419788,1111749414,1133785877.8,35.810994318184754,53.98903719513121,NaN,NaN,1.4805021722973164,16.056810675522954
2022-09-01T09:30:00-04:00,72.86,73.68,72.585,73.52,15968221,9524494.15,40.63807217223054,55.70594194371295,NaN,NaN,-140.24303070415996,-115.92488207137936,-0.44456197038950357,-0.08664996834490069,0.3579120020446029,1127717635,1127951266,31.9972015898648,52.8690769045514,NaN,NaN,-1.8258961933499047,13.502138265683975
2022-09-02T09:30:00-04:00,74.08,74.37,72.33,72.56,15846738,9960544.95,35.544014800634244,53.493354215339195,NaN,NaN,-139.07716056827573,-134.45656944226204,-0.4872454755008813,-0.2511448423314988,0.2361006331693825,1111870897,1121189814.8,28.243407592400274,51.234140214818545,NaN,NaN,-6.440993787993812,10.653119400872862
2022-09-06T09:30:00-04:00,72.6,73.18,72.05,72.15,21871799,10705831.4,33.606473436512076,50.848923993863345,NaN,NaN,-155.00069254393193,-143.7944622635013,-0.5167741831972622,-0.40986709582719527,0.10690708737006696,1089999098,1112696854.4,24.375194485349027,48.829488483546804,NaN,NaN,-10.827108213260924,7.584515455996607
2022-09-07T09:30:00-04:00,72.38,73.54,72.32,73.45,19632256,11283130.35,44.025333307782596,49.11366504111883,NaN,NaN,-107.25959391323283,-138.06216787661256,-0.4262037370489954,-0.4258475839411773,0.0003561531078181135,1109631354,1110193679.6,23.35970055445071,46.17329115802249,NaN,NaN,-11.138902238882597,4.909741499585293
2022-09-08T09:30:00-04:00,73.09,73.54,72.4,73.26,14843912,11462213.3,42.96413758605616,47.21219077781759,NaN,NaN,-95.20294874816501,-127.35668529555309,-0.35922223498524924,-0.44867164062374343,-0.0894494056384942,1094787442,1106801285.2,22.020759728562936,43.10261817772209,NaN,NaN,-11.728133699344783,2.532902185452425
2022-09-09T09:30:00-04:00,73.45,74.475,73.18,73.98,18139028,11921182.1,48.07220155229645,45.87304908618881,NaN,NaN,-50.03082044717131,-109.31424324415536,-0.2516442928889626,-0.4040047717496975,-0.15236047886073487,1112926470,1103843052.2,20.895979756474148,39.832820210731484,NaN,NaN,-10.529853254962996,0.6667942653930792
2022-09-12T09:30:00-04:00,74.04,74.515,73.94,74.27,8680018,11800452.55,50.014011769368246,45.23471276267551,NaN,NaN,-30.01112971908068,-87.50103707431634,-0.15112874934852202,-0.3412714155463874,-0.19014266619786538,1121606488,1105790170.4,23.65994370691172,36.861338750932724,NaN,NaN,-8.945327669829178,-0.7063660110672432
2022-09-13T09:30:00-04:00,73.65,73.75,71.59,71.79,12940792,11937131.2,37.20212733452668,43.89568025800952,NaN,NaN,-104.91464813785494,-77.48382819310095,-0.23673944707289196,-0.48606697503898033,-0.24932752796608837,1108665696,1109523490,28.797058730289933,34.765575911613084,NaN,NaN,-12.168533040577966,-2.3438184438544893
2022-09-14T09:30:00-04:00,72.01,72.1,71.34,71.76,12291507,11936077.35,37.07839122401625,42.45149395137872,NaN,NaN,-123.63884306971383,-80.75967802439716,-0.2776297592772603,-0.5963647270626637,-0.31873496778540344,1096374189,1106872057,27.387480864552273,32.737105356513254,NaN,NaN,-14.606165655672173,-4.095582331257015
2022-09-15T09:30:00-04:00,71.72,71.79,70.975,71.16,11234718,12014427.5,34.599735850190115,40.65564192095602,NaN,NaN,-132.97794623363043,-88.31467752149025,-0.32408995647766653,-0.7238474133824866,-0.39975745690482006,1085139471,1104942462.8,26.375636091184873,30.79742275495085,NaN,NaN,-17.419385633973555,-5.998982803073663
2022-09-16T09:30:00-04:00,70.91,71.41,70.895,71.33,13452587,12398173.7,35.90707336163314,40.01899316761233,NaN,NaN,-128.75210321748432,-104.05893407555286,-0.3217274616708571,-0.8019167839933914,-0.4801893223225343,1098592058,1102075580.4,24.90349100490228,28.98637606324212,NaN,NaN,-19.218809204218452,-7.887529431808633
2022-09-19T09:30:00-04:00,70.6,71.39,70.6,71.34,9370429,12543870.9,35.988132965415005,39.44189083333557,NaN,NaN,-124.34006660582533,-122.92472145290178,-0.2983652394951348,-0.8531458716914528,-0.554780632196318,1107962487,1099346780.2,23.555794883027588,27.387078467301915,NaN,NaN,-20.619213542407643,-9.70634144760849
2022-09-20T09:30:00-04:00,70.87,71.11,70.4,70.95,9169943,12646684.7,34.172927267004184,39.06239145992746,NaN,NaN,-129.53366342304503,-127.84852450993978,-0.2879125121207903,-0.9146712723473058,-0.6267587602265156,1098792544,1097372149.8,22.602584819163695,25.998944866094185,NaN,NaN,-22.328564245427938,-11.50951613301127
2022-09-21T09:30:00-04:00,71.38,72.08,70.64,70.68,14189602,12846990.8,32.93441496828679,38.76764625685373,NaN,NaN,-104.02304806220158,-123.92536550843734,-0.27778482471878163,-0.9739897911249926,-0.696204966406211,1084602942,1095017900.4,21.48622961696357,24.97574738743553,NaN,NaN,-24.11119561733238,-13.309756059342856
2022-09-22T09:30:00-04:00,70.74,71.06,70.45,70.58,10428448,12965320.35,32.4651091612582,38.183863184641424,NaN,NaN,-113.29194983217762,-119.98816622814677,-0.2569096455285623,-1.017342023316914,-0.7604323777883516,1074174494,1092824905,20.471914968398707,24.152512628759382,NaN,NaN,-25.71535619016439,-15.081984649460217
2022-09-23T09:30:00-04:00,70.19,70.19,68.655,69.38,15909499,13455538.85,27.416380573907674,37.60331788273238,NaN,NaN,-163.78608079747875,-126.99496174414567,-0.30000633923654896,-1.1354403018340378,-0.8354339625974888,1058264995,1084759492.4,17.24711678134034,23.367063285112245,NaN,NaN,-28.758968116048756,-17.035839430401438
2022-09-26T09:30:00-04:00,69.23,70.03,69.0975,69.43,11637977,13476810.65,27.919368064161347,37.197096070421615,NaN,NaN,-139.228412279465,-129.97263087887362,-0.30048430873368026,-1.2110393485145892,-0.9105550397809089,1069902972,1077147589.4,14.8669032183834,22.68789962318613,NaN,NaN,-31.076627531323204,-19.04166630196169
2022-09-27T09:30:00-04:00,69.77,70.15,68.095,68.23,17159282,13674062.1,23.678384769960147,35.743742603434306,NaN,NaN,-153.5211413105278,-134.77012645637018,-0.35331184685724737,-1.3521948483524682,-0.9988830014952208,1052743690,1067937818.6,12.600985242588592,21.919419958053123,NaN,NaN,-34.563197393114564,-21.2590278864121
2022-09-28T09:30:00-04:00,68.54,69.385,67.94,69.05,14259204,13871188.7,31.352097537608188,34.914311171402304,NaN,NaN,-138.25774629568812,-141.61706610306746,-0.3064648234960674,-1.381964030865305,-1.0754992073692375,1067002894,1064417809,11.857138811313888,21.193447035392477,NaN,NaN,-35.127724987080924,-23.240270329364787
2022-09-29T09:30:00-04:00,68.89,69.03,67.49,67.91,13508239,14026709.95,27.25004767614223,33.42701446596271,NaN,NaN,-149.83419414723306,-148.92551496607857,-0.32398364014743164,-1.4804787575535272,-1.1564951174060956,1053494655,1060281841.2,11.033017628269079,20.48894974052069,NaN,NaN,-36.990153016619374,-25.20453928468687
2022-09-30T09:30:00-04:00,68.08,68.19,66.6827,66.73,13427409,13899669.35,23.78158539358263,31.553269724835168,NaN,NaN,-168.5928566329825,-149.88687013317931,-0.3827416353294548,-1.6349221615679141,-1.2521805262384593,1040067246,1056642291.4,10.351216425910295,19.538326363306304,NaN,NaN,-39.802024327075294,-27.28989429074236
2022-10-03T09:30:00-04:00,67.21,68.05,66.84,67.88,12703306,13742497.75,32.7636168102412,31.23623325881478,NaN,NaN,-131.0796195887413,-148.2571115950346,-0.314699855175663,-1.645555345208038,-1.330855490032375,1052770552,1053215807.4,9.740908989463463,18.177172810390125,NaN,NaN,-38.97192932025226,-28.958756437815204
2022-10-04T09:30:00-04:00,68.29,69.265,68.275,68.91,13366359,13317225.75,39.62619455441467,31.4182192109861,NaN,NaN,-72.2932230150981,-132.01152793594864,-0.1776901499415673,-1.5529681774593342,-1.375278027517767,1066136911,1055894451.6,14.009258486066201,17.22158549764112,NaN,NaN,-35.81740912559647,-29.938563964641098
2022-10-05T09:30:00-04:00,68.55,68.875,67.7877,68.51,10596111,12865418.5,38.003939980241576,31.661376648846918,NaN,NaN,-79.15319179569532,-120.19061703595005,-0.09548922800855619,-1.4946395625284623,-1.3991503345199061,1055540800,1053602032.8,13.424171907042165,16.296480913059497,NaN,NaN,-33.889622719160215,-30.5030009295724
2022-10-06T09:30:00-04:00,68.49,68.61,67.36,67.51,10606982,12653572,34.230992003403756,31.54165655183053,NaN,NaN,-91.16255082501793,-108.45628837150703,-0.09002345680889579,-1.511679655531026,-1.4216561987221301,1044933818,1051889865.4,12.987877041852087,15.445365629984481,NaN,NaN,-33.54994201586786,-30.93827822761461
2022-10-07T09:30:00-04:00,67.38,67.46,66.24,66.5,13741647,12433702.95,30.894851293631376,31.1778507181317,NaN,NaN,-123.75803748179287,-99.48932454126911,-0.13337331121025686,-1.5883728377349513,-1.4549995265246944,1031192171,1050114850.4,12.533107016543639,14.658030782378484,NaN,NaN,-34.40820707781095,-31.43398234907123
2022-10-10T09:30:00-04:00,66.62,67.015,66.175,66.74,11798999,12589652,32.576407223721034,31.063813572182905,NaN,NaN,-121.65113498525528,-97.60362762057191,-0.12497131849559695,-1.6112136746441905,-1.4862423561485936,1042991170,1048158974,12.03312304347314,13.903069226972013,NaN,NaN,-34.5345132388646,-31.876915333327425
2022-10-11T09:30:00-04:00,66.78,67.9,66.67,67.29,10783602,12481792.5,36.39603657038391,31.311072258046988,NaN,NaN,-86.07214193613025,-100.35941140477834,-0.06450440625279752,-1.5668728639645906,-1.502368457711793,1053774772,1045686546.2,11.413289515515103,13.183573505439982,NaN,NaN,-33.424111477023985,-32.097943353855506
2022-10-12T09:30:00-04:00,67.95,68.42,67.64,67.65,10963399,12415387.1,38.83841284246862,31.766308235276306,NaN,NaN,-52.71583793291986,-95.07194063222326,0.01344767589291429,-1.4855588628456502,-1.4990065387385645,1064738171,1047526020.4,14.924493155215345,12.787329090212596,NaN,NaN,-31.766723259500484,-32.05062619751907
2022-10-13T09:30:00-04:00,67,69.025,66.69,68.77,18475634,12777432.9,45.8102288207147,33.08015453861966,NaN,NaN,-35.33181645138955,-83.90579375749758,0.14674352136183444,-1.3155771370362714,-1.4623206583981059,1083213805,1055182017.8,27.758617712376093,13.538150585286578,NaN,NaN,-28.071973203033316,-31.482247198306823
2022-10-14T09:30:00-04:00,69.18,69.26,67.42,67.53,11611899,12685398.5,40.329055165118554,33.9665607601166,NaN,NaN,-34.61480037313228,-66.07714633576545,0.15679603223641725,-1.2663256181025844,-1.4231216503390016,1071601906,1063263964.8,38.33421434614312,15.214387094412272,NaN,NaN,-26.637462720832094,-30.790135130096147
2022-10-17T09:30:00-04:00,68.24,68.6,68.1,68.26,9105418,12672147.95,44.53637213690517,35.456417000612674,NaN,NaN,-13.069278434489057,-44.36077502561221,0.21443846722314897,-1.1550735663100653,-1.3695120335332143,1080707324,1070807195.6,46.244113399506126,17.617467677049238,NaN,NaN,-24.07351986944771,-29.830618664289226
2022-10-18T09:30:00-04:00,69.28,69.62,68.74,69.15,11000749,12763688.25,49.23586642177855,36.7338290637677,NaN,NaN,55.26228415927323,-16.093889806531507,0.30860971054929864,-0.9837498953465911,-1.2923596058958897,1091708073,1078393855.8,52.80152651420478,20.5420667986843,NaN,NaN,-20.37336495648877,-28.479582420317733
2022-10-19T09:30:00-04:00,69.25,69.62,68.55,68.83,8985484,12503482.35,47.67182139079205,38.192527186242685,NaN,NaN,58.493850955048224,6.148047971062103,0.3428171339011956,-0.8638381885193951,-1.2066553224205907,1082722589,1081990739.4,55.56881746060428,23.723195358136817,NaN,NaN,-17.889126618503155,-26.96666016291565
2022-10-20T09:30:00-04:00,68.86,69.015,67.81,67.87,10023179,12483218.9,43.234656026986805,39.58203223148585,NaN,NaN,3.100987287856097,13.834608718911232,0.2960225324920227,-0.8366271568055623,-1.132649689297585,1072699410,1079887860.4,53.59053831525306,26.811718350232727,NaN,NaN,-17.16014219076849,-25.565729024037484
2022-10-21T09:30:00-04:00,67.83,69.08,67.61,68.91,9613387,12168413.3,48.79501582718228,40.72713216126734,NaN,NaN,41.55500664402444,29.068570122342585,0.32787111396747126,-0.722810796838246,-1.0506819108057173,1082312797,1082030038.6,55.33495483237186,30.068435910440467,NaN,NaN,-14.734168983940696,-24.01836330402366
2022-10-24T09:30:00-04:00,69.4,70.29,69.25,70.15,11076224,12140325.65,54.51577247085688,41.79067344101322,NaN,NaN,184.6883221476447,68.62009023876934,0.4193584118084198,-0.5264838960451925,-0.9458423078536123,1093389021,1084566378,57.37771259089439,33.16618263221391,NaN,NaN,-10.728707053471474,-22.119840982516205
2022-10-25T09:30:00-04:00,70.31,71.16,69.91,71.07,10619789,11813351,58.24327929866729,43.23634053518648,NaN,NaN,226.37724659134648,102.84308272518399,0.5220527312752797,-0.29327639375951264,-0.8153291250347924,1104008810,1087026525.4,59.321088686659294,36.444533830758,NaN,NaN,-6.150950398758963,-19.838570899122313
2022-10-26T09:30:00-04:00,71.23,72.05,71.01,71.54,9483721,11574576.85,60.04474598076195,45.08018010499779,NaN,NaN,236.59937188507664,138.46418691118964,0.5964801763674464,-0.06972890457548431,-0.6662090809429307,1113492531,1093180513.8,63.77104856839521,40.07190322551107,NaN,NaN,-1.8802852812492201,-17.273101525140444
2022-10-27T09:30:00-04:00,71.61,72.07,71.49,71.6,9988167,11398573.25,60.280328775982454,47.17914278230858,NaN,NaN,194.46319509165627,176.7366284719497,0.6217641414219741,0.11099609583453685,-0.5107680455874373,1123480698,1103336771.4,69.66824997116896,44.1529848651272,NaN,NaN,1.5749473320361005,-14.580523116972365
2022-10-28T09:30:00-04:00,71.73,73.3,71.7,73.17,9545473,11204476.45,65.93951055520937,49.5622215917006,NaN,NaN,202.40498659130367,208.90662446140556,0.7098680441447959,0.3765670095935576,-0.3333010345512383,1133026171,1113479446.2,74.18712251981336,48.59255625629436,NaN,NaN,6.549903823009916,-11.561890696974897
2022-10-31T09:30:00-04:00,72.96,73.185,72.55,72.74,9201120,11029367.15,63.280198404778154,51.4825188655859,NaN,NaN,167.7230654940778,205.51357313069215,0.7034744541086734,0.5460420330846034,-0.15743242102406993,1123825051,1119566652.2,76.45434234743365,53.238345744288544,NaN,NaN,9.774313657472456,-8.513861503482419
2022-11-01T09:30:00-04:00,72.92,73.27,72.25,72.51,9535244,10837811.4,61.843512566049505,53.125740274413104,NaN,NaN,132.7871410906202,186.79555203054693,0.6493470010708627,0.6542513303145086,0.004904329243645783,1114289807,1121622851.6,77.18336450399198,57.68540798348687,NaN,NaN,11.96435796761373,-5.588401579040113
2022-11-02T09:30:00-04:00,72.36,73.08,71.21,71.25,16293502,11122680.95,54.538446701159906,53.74918440873062,NaN,NaN,87.2125665562244,156.91819096477647,0.5009261510947891,0.6310620181121323,0.1301358670173431,1097996305,1118523606.4,73.48990792075925,60.9519287126571,NaN,NaN,11.642216590977288,-3.126884697609056
2022-11-03T09:30:00-04:00,70.65,71.335,70.485,71.01,10624456,11123554.65,53.248236136555406,54.671983049547535,NaN,NaN,47.870646812081745,127.59968130886156,0.36513679796277165,0.5865568644708077,0.22142006650803603,1087371849,1111301836.6,65.61112453348775,62.900279440324574,NaN,NaN,10.993459294926225,-1.1096926986754445
2022-11-04T09:30:00-04:00,71.86,72.25,70.905,71.85,11938621,11033403.35,57.0757216786014,55.56765087395441,NaN,NaN,67.1839515518522,100.55547430097127,0.31247378091324735,0.6120122926495952,0.2995385117363479,1099310470,1104558696.4,59.2262956893562,63.82757817531387,NaN,NaN,11.576503586703257,0.7026210563786557
2022-11-07T09:30:00-05:00,72,72.62,71.865,72.49,7133604,10800133.6,59.777618208157726,56.32063314441007,NaN,NaN,83.23563134860754,83.65798747187722,0.30119769955353753,0.6760356361782698,0.37483793662473225,1106444074,1101082501,56.19057421278418,64.06965301092667,NaN,NaN,12.877004094336492,2.441818633229775
2022-11-08T09:30:00-05:00,72.71,73.15,71.95,72.7,9091943,10715550.65,60.652810398167105,57.247846644936864,NaN,NaN,86.09887249496244,74.32033375274567,0.28832517257884305,0.735244402348286,0.446919229769443,1115536017,1101331743,56.36327773876481,64.12640017365243,NaN,NaN,14.194563079774936,4.120782125593369
2022-11-09T09:30:00-05:00,72.52,72.97,71.85,71.91,9465239,10640642.65,55.73932328709131,58.141037163515755,NaN,NaN,66.39478319214696,70.1567770799302,0.21065200834767017,0.7102342402040307,0.4995822318563605,1106070778,1102946637.6,57.53145477830944,64.40789420672789,NaN,NaN,13.898574413624152,5.517609595312052
2022-11-10T09:30:00-05:00,73.45,73.79,72.375,73.6,19286103,10681166.1,62.700547820828625,59.1342894487762,NaN,NaN,101.42148258900343,80.86694423531452,0.2542225034291544,0.8173603611428035,0.5631378577136491,1125356881,1110543644,62.603370202859196,64.92706673319127,NaN,NaN,15.837650651167612,6.991901174719989
2022-11-11T09:30:00-05:00,73.802,73.88,72.37,73.52,14289511,10815046.7,62.201825633518894,59.6832932461092,NaN,NaN,95.19728171020353,86.46961026698479,0.2579654484723105,0.8855946683040372,0.6276292198317267,1111067370,1112895024,64.03506012618936,65.40259155714091,NaN,NaN,17.225765998786656,8.45388186387237
2022-11-14T09:30:00-05:00,73.45,74.115,72.895,72.94,14760538,11097802.7,58.56479726508796,59.70625881513926,NaN,NaN,93.61417999492801,88.54531999624888,0.20405225802826843,0.8826945423670622,0.6786422843387938,1096306832,1110867575.6,61.83681905667333,65.58228658357048,NaN,NaN,17.309305506506476,9.71894238424867
2022-11-15T09:30:00-05:00,73.86,74.0996,72.95,73.55,15064305,11300980.5,61.13845140929286,59.784380631462895,NaN,NaN,99.72014968823316,91.26957543490303,0.19230548094766287,0.9190241355233724,0.7267186545757095,1111371137,1110034599.6,60.91164134828061,65.37804321070514,NaN,NaN,18.140233740926124,10.921984006631163
2022-11-16T09:30:00-05:00,73.65,74.28,73.61,73.91,9748595,11339136.05,62.61430581069895,59.95109327679978,NaN,NaN,114.4272439582718,100.876067588128,0.19121086128437503,0.9657322311811782,0.7745213698968032,1121119732,1113044390.4,63.06213569829194,64.90617790549965,NaN,NaN,19.259243036187254,12.113021010853462
2022-11-17T09:30:00-05:00,73.26,73.93,73.26,73.89,7827227,11229338.45,62.47235969893398,59.703439644208686,NaN,NaN,97.80098283758971,100.15196763784525,0.17216366881365253,0.9897259559138689,0.8175622871002164,1113292505,1110631515.2,60.20263878778308,63.907286210354634,NaN,NaN,20.133589769212936,13.258816547761958
2022-11-18T09:30:00-05:00,74.49,74.7701,74.175,74.68,9071049,11202221.55,65.7730162640725,59.88149806272973,NaN,NaN,149.543978081747,111.02130691215393,0.19416254867560367,1.060265472944721,0.8661029242691173,1122363554,1112890752,61.94272291848758,62.87074196542991,NaN,NaN,21.846323286095586,14.485603224666761
2022-11-21T09:30:00-05:00,74.82,75.4995,74.665,75.39,8054931,11051156.9,68.45807172970741,60.35396657441958,NaN,NaN,182.0903748061022,128.7165458743888,0.23518714501845794,1.1600868555421897,0.9248997105237318,1130418485,1119713082.6,66.68045714531127,62.12053429695272,NaN,NaN,24.12265811168098,15.862325351383078
2022-11-22T09:30:00-05:00,75.95,76.01,75.655,75.94,6307095,10835522.2,70.3955240971864,61.486614959850044,NaN,NaN,197.73050063574334,148.31861606389083,0.27523924944412137,1.2689487723288835,0.9937095228847621,1136725580,1124783971.2,69.69981288824007,61.84981322320135,NaN,NaN,26.638011809938693,17.401709131176737
2022-11-23T09:30:00-05:00,76,76.35,75.9,76.2,6286419,10675657.1,71.29320671970976,62.77554143007535,NaN,NaN,184.91299147398885,162.41576556703424,0.29344776884767754,1.360519233944359,1.0670714650966815,1143011999,1129162424.6,72.05457637811463,62.31005978353185,NaN,NaN,28.99483568317424,19.05787006717638
2022-11-25T09:30:00-05:00,76.3,76.305,76.1,76.25,2978024,10325149.95,71.47235502407497,63.80387238332346,NaN,NaN,159.64019500354564,174.78360800022543,0.2829400954393293,1.4207465843958431,1.1378064889565138,1145990023,1135701928.2,75.15962792667335,63.448154943340214,NaN,NaN,30.992338575960453,20.76279413985982
2022-11-28T09:30:00-05:00,75.97,76.3801,75.85,75.96,8698808,10282816.7,68.79089303879256,64.4476777283688,NaN,NaN,127.96774754319286,170.4683618925146,0.23264161489636304,1.4286085075769677,1.1959668926806046,1137291215,1138687460.4,76.44633101730392,64.89499471509161,NaN,NaN,31.99573079691727,22.367499376582312
2022-11-29T09:30:00-05:00,75.76,75.92,75.275,75.67,7755123,10210516.85,66.11944084036952,64.83815133138327,NaN,NaN,91.85776769046828,152.42184046938783,0.15950951948291037,1.3953537920342427,1.2358442725513323,1129536092,1138510981.8,76.19508327426658,66.31155225334174,NaN,NaN,32.15450186218217,23.765642588810863
2022-11-30T09:30:00-05:00,75.62,77.21,75.225,77.19,11704238,10318966.55,72.210898599689,66.01469242514024,NaN,NaN,118.23604743631142,136.52294982950144,0.19104587896549718,1.4746516212582037,1.2836057422927065,1141240330,1139413931.8,76.61850595454992,67.67491305164464,NaN,NaN,34.11605587292727,25.24427305797035
2022-12-01T09:30:00-05:00,77.05,77.14,76.52,76.84,10215834,10015083.15,69.12885233003512,66.4738570329407,NaN,NaN,115.06806903647065,122.55396534199778,0.16675874659475798,1.492054175536154,1.325295428941396,1131024496,1137016431.2,72.91020091839067,68.41111524561117,NaN,NaN,34.848560426093975,26.61631411055944
2022-12-02T09:30:00-05:00,76.28,77.29,76.19,77.19,6087179,9788219.3,70.48546847861041,67.0655458075901,NaN,NaN,106.49054839577803,111.92403602044428,0.1530479903796098,1.5166054169159082,1.3635574265362984,1137111675,1135240761.6,70.20020720005243,68.85148289374425,NaN,NaN,35.85376514636589,27.935949972817504
2022-12-05T09:30:00-05:00,76.36,76.45,76,76.22,8633024,9622939.45,62.312700767305905,67.33325320060567,NaN,NaN,69.61264614831721,100.25301574146913,0.062096898769258946,1.441178549997872,1.379081651228613,1128478651,1133478248.8,67.5176314677011,69.25725520881767,NaN,NaN,34.264258726236676,28.839994080448815
2022-12-06T09:30:00-05:00,76.3,76.59,75.38,75.75,8136329,9673075.7,58.757657851112114,67.16319651787846,NaN,NaN,49.397602063593986,91.76098261609428,-0.04073183164544747,1.3281668616718036,1.3688986933172511,1120342322,1131639494.8,64.73823509070415,69.53058333327648,NaN,NaN,31.844170086208944,29.26916208127169
2022-12-07T09:30:00-05:00,75.89,76.23,75.75,76.07,7298685,9583412.8,60.41362168450347,67.00600479457879,NaN,NaN,49.80876285180741,78.07552569919346,-0.09510599349039439,1.2500162014542582,1.3451221949446526,1127641007,1128919630.2,60.754244961804204,69.36573399495595,NaN,NaN,30.305276300216878,29.41717839826386
2022-12-08T09:30:00-05:00,75.95,76.485,75.85,76.48,7803383,9500320,62.49166172967413,67.00738351106023,NaN,NaN,58.7437168122255,66.81065525434443,-0.11029903152311982,1.2072484055407529,1.3175474370638727,1135444390,1129803609,61.58175667471148,69.46424241545083,NaN,NaN,29.59614108958717,29.442744497024332
2022-12-09T09:30:00-05:00,76.11,76.44,75.88,75.89,9761718,9024100.75,57.790377471564426,66.43719502588108,NaN,NaN,42.568203261382656,54.02618622746536,-0.16370392606949635,1.1129175294770022,1.2766214555464985,1125682672,1127517808.4,58.166409228651645,69.19450572331968,NaN,NaN,27.58776499674215,29.17774742555545
2022-12-12T09:30:00-05:00,76.03,76.7,75.79,76.69,6996833,8659466.85,61.968321259335525,65.97364142085452,NaN,NaN,60.26939927682271,52.15753685316645,-0.1491800321044663,1.0901464154159157,1.239326447520382,1132679505,1128357979.2,59.065059897505655,68.65054877704786,NaN,NaN,27.07228428487392,28.87696697688666
2022-12-13T09:30:00-05:00,77.45,77.62,76.1,76.58,11349134,8488896.65,61.07318515147228,65.30776006758921,NaN,NaN,86.87806874494227,59.653630189436115,-0.15057511862593054,1.051107549237969,1.2016826678638994,1121330371,1128555589,59.28658800460809,67.90674699964556,NaN,NaN,26.392539894671092,28.522048822284436
2022-12-14T09:30:00-05:00,76.7,77.27,76.08,76.53,13820240,8426693.4,60.64436831936901,64.54712875327915,NaN,NaN,75.46440071623175,64.784757762321,-0.1577025299910988,1.004554505375026,1.1622570353661248,1107510131,1124529413.8,52.99398763363533,66.5452763750399,NaN,NaN,25.715588012550818,28.121125849465347
2022-12-15T09:30:00-05:00,75.89,76.04,74.665,75.23,11281678,8503347.55,50.68064961441927,63.062006938303746,NaN,NaN,-77.28812022929125,37.57839035401763,-0.2474618646397404,0.8529297045664492,1.1003915692061896,1096228453,1116686226.4,43.342899870491095,64.27265294245545,NaN,NaN,21.993322816907604,27.245725416242813
2022-12-16T09:30:00-05:00,74.84,75.1,74.21,74.86,14561475,8840059.95,48.25080447834618,61.594857755414715,NaN,NaN,-174.50490787080517,-5.8362318724199325,-0.32439351231718794,0.6948996788097048,1.0192931911268928,1081666978,1107883087.6,35.52318078356632,61.349570782902774,NaN,NaN,18.15078209573603,25.94644779902756
2022-12-19T09:30:00-05:00,74.31,74.935,73.84,74.28,8093914,8791203.2,44.637941169561635,60.06046492178559,NaN,NaN,-218.1036450333648,-61.51084073445744,-0.4019144811890112,0.5169000896406288,0.91881457082964,1073573064,1096061799.4,28.172728848807935,57.91940260965572,NaN,NaN,13.744383319783127,24.20329573056407
2022-12-20T09:30:00-05:00,74.15,74.51,73.81,74.22,7368975,8756905.4,44.268664953616145,58.06459108992324,NaN,NaN,-207.307269615562,-120.34790840655828,-0.44163981829607424,0.3667647979595472,0.8084046162556214,1066204089,1085036543,23.325054485791156,54.11272750474438,NaN,NaN,10.06715160561865,22.18384656985758
2022-12-21T09:30:00-05:00,74.58,75.25,74.53,74.96,7953290,8839215.15,49.78608922052746,56.68296515352984,NaN,NaN,-104.46004251880076,-156.33279705356478,-0.4035324002873092,0.3039891158964849,0.7075215161837941,1074157379,1078365992.6,20.97360690028013,50.40297078916505,NaN,NaN,8.430669760005822,20.219107025593043
2022-12-22T09:30:00-05:00,74.69,74.825,73.96,74.79,6888351,8869311.75,48.59583998199609,55.11942026091453,NaN,NaN,-121.30628523763417,-165.13643005523338,-0.37579291517212554,0.23778037221863713,0.6135732873907627,1067269028,1072574107.6,19.16682490215996,46.75772919645845,NaN,NaN,6.738534309800601,18.293310923336982
2022-12-23T09:30:00-05:00,74.83,75.23,74.58,75.18,4874660,8964143.55,51.46269622524226,54.344419936481415,NaN,NaN,-68.26774109263458,-143.88899669959926,-0.3194115993748129,0.21430878817224652,0.5337203875470594,1072143688,1070669449.6,18.599393746499857,43.263569359229784,NaN,NaN,6.109472192805447,16.55276253326105
2022-12-27T09:30:00-05:00,75.28,75.69,75.12,75.54,4839729,8771189.6,54.01229567507664,54.00546549533602,NaN,NaN,-24.93928084829713,-105.25612386258572,-0.24922026699944932,0.22219505379774773,0.47141532079719706,1076983417,1071351520.2,19.51827059744815,40.03357189542579,NaN,NaN,6.300099052900309,15.088096321780943
2022-12-28T09:30:00-05:00,75.76,75.86,74.595,74.6,5028990,8634882.95,47.06097580789682,53.051705075578404,NaN,NaN,-58.04809212812885,-75.4042883650991,-0.2564475689686261,0.15085585958641445,0.40730342855504054,1071954427,1072501587.8,21.134837181455367,37.20361419682944,NaN,NaN,4.371559999707255,13.557162561484702
2022-12-29T09:30:00-05:00,74.9,75.19,74.7801,74.92,5574893,8328415.7,49.44623170604879,52.11988864531945,NaN,NaN,-56.38460160175063,-65.78920018168908,-0.23082575169105546,0.11877123894122121,0.34959699063227667,1077529320,1073175976,22.1226591687646,34.38510723211895,NaN,NaN,3.4730108298894975,12.116569456971101
2022-12-30T09:30:00-05:00,74.77,74.83,74.0101,74.55,6249894,8130118.7,46.81946259775404,51.3362518686187,NaN,NaN,-90.75902837245893,-59.679748808654026,-0.22946597031739058,0.06276452773553842,0.292230498052929,1071279426,1073978055.6,23.352318189189262,31.898386443585917,NaN,NaN,1.9413939238949511,10.662972952245937
2023-01-03T09:30:00-05:00,74.59,74.62,73.52,74.27,14433360,8547427.75,44.8765676281968,50.11541232353737,NaN,NaN,-110.15931331898967,-68.05806325392504,-0.23711785589494977,-0.004166821815758226,0.23295103407919154,1056846066,1070918531.2,21.929887469347634,29.245874127288914,NaN,NaN,0.09357008482417664,9.153058256899971
2023-01-04T09:30:00-05:00,74.48,75.02,74.09,74.56,12197256,8725639.35,47.3151278206072,49.13269394276129,NaN,NaN,-66.48014127786676,-76.36623533983898,-0.2131004473127509,-0.03342452506174709,0.17967592225100382,1069043322,1069330512.2,21.207810627261168,26.52596145747842,NaN,NaN,-0.7781590667415959,7.734312924951176
2023-01-05T09:30:00-05:00,74.42,74.485,73.66,73.81,9848196,8811232.7,42.124925125569746,47.80987657177563,NaN,NaN,-107.92664004304325,-86.34194492282185,-0.23637704227732836,-0.11579538059565664,0.12058166168167173,1059195126,1066778652,20.0645075150495,24.17385573472229,NaN,NaN,-3.1081688537062027,6.18538695657155
2023-01-06T09:30:00-05:00,74.76,76.075,74.7,75.78,9982384,8945417.65,55.83048010204393,48.177721606605964,NaN,NaN,33.45175380277429,-68.37467384191686,-0.1139536081795562,-0.021860348542773522,0.09209325963678268,1069177510,1065108290,19.329935530824272,22.45864399617466,NaN,NaN,-0.5931714551978038,5.217021469175928
2023-01-09T09:30:00-05:00,75.73,76.245,75.04,75.04,11081840,9109340.5,50.949621779570315,48.370494270979115,NaN,NaN,32.42701203930558,-43.73746575956396,-0.07931200287706532,-0.007046743959548962,0.07226525891751635,1058095670,1062471538.8,18.19738380635107,21.221087069230713,NaN,NaN,-0.2300352563118882,4.438870508391955
2023-01-10T09:30:00-05:00,75.13,75.245,74.69,74.94,8427855,9042647.35,50.30955064674885,48.77560923363534,NaN,NaN,-11.624267845493536,-24.030456664864733,-0.060482244498284224,-0.003337546705338923,0.0571446977929453,1049667815,1061035888.6,17.592974584209003,20.46539033604507,NaN,NaN,-0.15761885579788054,3.7822291706505498
2023-01-11T09:30:00-05:00,75.19,75.405,74.3214,74.98,9848317,9185221.55,50.5770119460581,49.22620544738119,NaN,NaN,-11.162563541345426,-12.966941117560463,-0.04347780828985252,0.0027974374306296568,0.046275245720482173,1059516132,1059130450.6,16.79562430896729,19.999002466271943,NaN,NaN,-0.018518009368894726,3.239265287790629
2023-01-12T09:30:00-05:00,75.14,75.15,74.21,74.39,9841291,9109829.4,46.59329769821642,48.99814891007326,NaN,NaN,-44.813619501028256,-0.344337009157465,-0.06861488278534751,-0.03949335776120222,0.029121525024145296,1049674841,1057226393.6,16.01454645661984,19.644783863153346,NaN,NaN,-1.1206730965691973,2.6164169471677967
2023-01-13T09:30:00-05:00,74.19,74.76,74.14,74.74,9274343,8882534.55,49.15194302474187,49.03787055598367,NaN,NaN,-41.24779937485687,-15.284247644683697,-0.05870272160538571,-0.044256876982586846,0.014445844622798867,1058949184,1055180728.4,15.196851915147775,19.361214364081054,NaN,NaN,-1.2660008507367986,2.061785833181426
2023-01-17T09:30:00-05:00,74.86,75.42,74.68,74.79,9007022,8768801.75,49.52397997365187,48.89939082372722,NaN,NaN,38.54096965012327,-14.061456122520156,-0.04635349415713127,-0.04349602307361522,0.0028574710835160486,1067956206,1057152835.6,19.46595473067231,19.423111577236224,NaN,NaN,-1.2771068703663706,1.5848011612460267
2023-01-18T09:30:00-05:00,74.61,74.66,72.64,72.75,16069923,8844224.15,37.47609338207766,47.718233517084435,NaN,NaN,-211.54211422153168,-54.045025397727784,-0.16639739608408505,-0.20513927402159027,-0.03874187793750522,1051886283,1057596529.2,20.436411803818928,19.488693091976987,NaN,NaN,-5.409174057299316,0.5856618443109778
2023-01-19T09:30:00-05:00,72.46,72.79,72.035,72.06,12421545,9060605.7,34.42553309374726,46.81570189464518,NaN,NaN,-290.98802338202194,-110.01011736586308,-0.2765967474418677,-0.38448781223983985,-0.10789106479797216,1039464738,1053586250.4,18.291001394147983,19.285561964312176,NaN,NaN,-9.859981509503076,-0.9065729205196014
2023-01-20T09:30:00-05:00,72.11,72.65,71.6,72.62,12349611,9309637.5,38.78100404998804,46.05389991921226,NaN,NaN,-228.14112714888063,-146.67561889543356,-0.2944463934202955,-0.4759490565733415,-0.18150266315304603,1051814349,1054014152,19.26491863230001,19.081437640278995,NaN,NaN,-12.04483667420092,-2.4977534567597894
2023-01-23T09:30:00-05:00,72.76,73.225,72.545,72.85,12000433,9511994.65,40.52817778064857,45.60452243227616,NaN,NaN,-136.43460753976186,-165.71298052841456,-0.2738660514095566,-0.5238352274149918,-0.24996917600543517,1063814782,1054987271.6,21.55486429077341,18.95304807610643,NaN,NaN,-13.230990479099002,-4.031073031379677
2023-01-24T09:30:00-05:00,72.83,73.35,72.4,73.15,13465588,9840856.5,42.820462854098594,45.45765780555487,NaN,NaN,-108.21372453746504,-195.06391936593224,-0.22518596037959998,-0.5314516264799352,-0.3062656661003352,1077280370,1056852104.4,25.892786272116453,19.236112276304205,NaN,NaN,-13.496402909246086,-5.383263013932021
2023-01-25T09:30:00-05:00,72.71,73.33,72.35,73.33,11606801,10177463.55,44.209936051947665,45.23585839350776,NaN,NaN,-91.59770020965736,-171.07503656355738,-0.1685902571628009,-0.5170034875538363,-0.3484132303910354,1088887171,1064252282,40.05828341656242,20.58257461839715,NaN,NaN,-13.302941562333043,-6.514645663703596
2023-01-26T09:30:00-05:00,73.25,73.31,72.83,73.07,8081676,10339560.9,42.5996569154566,45.269767807071105,NaN,NaN,-76.54526359632303,-128.18648460641757,-0.1376955626421673,-0.5205326836937445,-0.3828371210515772,1080805495,1072520433.4,51.26678086409733,22.811308429043425,NaN,NaN,-13.599457101858967,-7.526761583440077
2023-01-27T09:30:00-05:00,73.02,73.195,72.505,72.86,10341793,10605201.05,41.29146283861233,44.23126657396885,NaN,NaN,-82.19024343993617,-98.99630786462868,-0.12102459416774058,-0.5341178637612529,-0.41309326959351234,1070463702,1076250304,55.32514833689508,25.38239505804848,NaN,NaN,-14.211506670919011,-8.481725167365639
2023-01-30T09:30:00-05:00,72.71,73.495,72.71,72.95,10463129,10849612.85,42.11193343126539,43.60000312051849,NaN,NaN,-60.382784850227196,-83.78594332672175,-0.09472156265846188,-0.5314952229165897,-0.4367736602581278,1080926831,1079672713.8,58.721936852248184,28.277005989898274,NaN,NaN,-14.500486721282407,-9.341548246496606
2023-01-31T09:30:00-05:00,73.09,73.75,72.87,73.74,8002698,10937253.05,48.86703663177014,43.49696640516287,NaN,NaN,-28.037121107739885,-67.75062264077671,-0.018871934744548458,-0.4603635786888134,-0.44149164394426493,1088929529,1082002545.6,60.90137294110783,31.37046301539105,NaN,NaN,-12.823362457247644,-9.838950276603898
2023-02-01T09:30:00-05:00,73.68,74.66,73.36,74.33,15447622,10987966.15,53.254304701055204,43.68820160194838,NaN,NaN,20.162962855401123,-45.398490027765014,0.07133585728104552,-0.35232182234295806,-0.4236576796240036,1104377151,1085100541.6,63.649731652903,34.71718496852932,NaN,NaN,-10.046816053457745,-9.868645387583019
2023-02-02T09:30:00-05:00,73.83,74.17,73.36,73.69,12238803,10990043.5,48.40280118536871,43.81745185103069,NaN,NaN,-4.38581925151824,-30.96660115880406,0.08715591154445113,-0.3147127901934397,-0.4018687017378908,1092138348,1087367112.2,65.55730862100941,38.25595369455716,NaN,NaN,-9.055413781995728,-9.752469443927692
2023-02-03T09:30:00-05:00,73.91,73.93,72.86,73.4,12874814,11141374.4,46.34262224630996,43.6167860811427,NaN,NaN,-27.926702508696174,-20.113892972556062,0.07765939590653481,-0.3047944568547223,-0.3824538527612571,1079263534,1089127078.6,67.00521205863907,41.95655084766368,NaN,NaN,-8.831182534315355,-9.620857028268787
2023-02-06T09:30:00-05:00,73.28,73.63,73.23,73.49,7209101,11002710.25,47.095212545398915,43.44330269341034,NaN,NaN,-18.097921914011145,-11.65692038531285,0.0768664785384871,-0.2863707545881482,-0.3632372331266353,1086472635,1090236239.4,67.92047374768286,45.41758792030729,NaN,NaN,-8.43446867282766,-9.451372977491483
2023-02-07T09:30:00-05:00,72.96,73.32,72.4489,73.18,9268430,10912039.75,44.766141674874724,43.964020428610134,NaN,NaN,-53.16641237723658,-16.682778639212188,0.055868114207790975,-0.2934020903668966,-0.34927020457468755,1077204205,1087891174.6,63.885442793009965,48.52109013382094,NaN,NaN,-8.743920114596609,-9.350308282792215
2023-02-08T09:30:00-05:00,72.78,72.91,72.49,72.62,8933483,10937321.15,40.837221998977284,44.421998207555134,NaN,NaN,-79.4801887925047,-36.611408968793356,0.007224385434182745,-0.34023972278195913,-0.3474641082161419,1068270722,1080669888.8,53.3708056062431,51.02679043468487,NaN,NaN,-10.150521862538348,-9.464624508470234
2023-02-09T09:30:00-05:00,73,73.26,72.205,72.3,8341482,10861979.4,38.7446433609385,44.41940101548017,NaN,NaN,-83.3924312614154,-52.41273137077278,-0.040897164069783165,-0.3985855633033708,-0.35768839923358764,1059929240,1074228067.2,46.084228762261326,52.94245544396782,NaN,NaN,-11.950368113747437,-9.819730737795549
2023-02-10T09:30:00-05:00,72.3,73.03,72.145,72.97,8197163,10779773,45.08908995110057,44.74518045622674,NaN,NaN,-63.81760501375371,-59.590911871784286,-0.022896110492689803,-0.3863085373494499,-0.3634124268567601,1068126403,1072000641,43.854689399461755,54.53530009458842,NaN,NaN,-11.674363793212143,-10.084678317140776
2023-02-13T09:30:00-05:00,73.19,73.8275,73.15,73.8,7440544,10688083.05,51.75541142579539,45.38339106849079,NaN,NaN,59.846339711129936,-44.00205954675607,0.0458686757921144,-0.30607658211661715,-0.35194525790873155,1075566947,1069819503.4,41.72589879401052,55.666236703295134,NaN,NaN,-9.326059689812983,-9.97630422752252
2023-02-14T09:30:00-05:00,73.75,73.78,72.88,73.13,9344740,10704968.95,46.814681873926226,45.56944434148926,NaN,NaN,32.143226703588766,-26.940131730591002,0.04701538283880502,-0.29317602936022524,-0.34019141219903026,1066222207,1067623103.8,39.63922283969906,55.63630380494776,NaN,NaN,-8.872503905337267,-9.818618467210342
2023-02-15T09:30:00-05:00,72.98,73.29,72.68,73.27,9006025,10351774.05,47.93317754404467,45.95041010067412,NaN,NaN,1.372463743330879,-10.769601223423887,0.057305425645299723,-0.2685596301424056,-0.3258650557877053,1075228232,1069014605.8,41.630769302004566,54.948017264798274,NaN,NaN,-8.16664607669191,-9.582622411421994
2023-02-16T09:30:00-05:00,72.62,73.18,72.309,72.74,8355096,10148451.6,44.148001267122304,46.15444855985341,NaN,NaN,-70.16201706834946,-8.123518384810717,0.029898467708190324,-0.2884919711524674,-0.3183904388606577,1066873136,1070403385,43.62979904082021,54.112635172221495,NaN,NaN,-8.720367446088325,-9.459443130660041
2023-02-17T09:30:00-05:00,72.53,73.71,72.53,73.68,11116125,10086777.3,51.46805477802901,46.82274294176509,NaN,NaN,33.99010296887907,11.438023211715839,0.07404429919638222,-0.2258350648651799,-0.2998793640615621,1077989261,1072375956.6,46.43583898279483,53.23505675297482,NaN,NaN,-6.838416313949286,-9.08501072827279
2023-02-21T09:30:00-05:00,73.38,73.79,73.0103,73.4,8974751,9935493.2,49.39150357356435,46.86020486617896,NaN,NaN,47.92579503253659,9.05391427599717,0.08269752366131378,-0.19650745948491988,-0.27920498314623365,1069014510,1071065469.2,44.83891544611294,52.08773836047519,NaN,NaN,-5.9579348932149605,-8.638285608978814
2023-02-22T09:30:00-05:00,73.5,74.01,73.1099,73.29,8851001,9704763.85,48.56255844049515,46.52508013328181,NaN,NaN,56.512209961541316,13.927710927587679,0.07931157178947279,-0.18006551840939267,-0.25937709019886546,1060163509,1069853729.6,43.35426640559739,50.63806227138194,NaN,NaN,-5.494369155783447,-8.189154687093762
2023-02-23T09:30:00-05:00,73.36,73.56,72.745,73.2,12700140,9759430.8,47.85488270867832,46.4859430992325,NaN,NaN,-7.967443329199119,12.059729513081681,0.0696527807806529,-0.17231111422304934,-0.24196389500370225,1047463369,1064300757,37.26493050762576,48.61717812042597,NaN,NaN,-5.31624145357233,-7.778738510876415
2023-02-24T09:30:00-05:00,72.66,72.825,72.27,72.71,11340619,9922377.95,44.087925698043826,46.32489334578492,NaN,NaN,-115.01508639188908,3.089115648373756,0.03088280720716824,-0.20336038599474193,-0.23424319320191017,1036122750,1058150679.8,31.917905724867268,46.110941953727966,NaN,NaN,-6.252640060051971,-7.560724446472923
2023-02-27T09:30:00-05:00,73.06,73.255,72.47,72.63,10162251,9913400.85,43.48606893074835,46.06709737330988,NaN,NaN,-77.24128014328403,-19.157160974058865,0.001993748459214434,-0.23175100762789214,-0.23374475608710657,1025960499,1047744927.4,25.30254306146027,43.066804047569214,NaN,NaN,-7.192930444797888,-7.508182446233632
2023-02-28T09:30:00-05:00,72.33,72.455,71.995,72.03,9757334,9878111.1,39.16745141239283,45.66719092598974,NaN,NaN,-167.42200537201558,-62.2267210549693,-0.052377461445973134,-0.299216582894573,-0.24683912144859985,1016203165,1037182658.4,20.628827887536062,39.97704584003536,NaN,NaN,-9.294102870349526,-7.763313935393046
2023-03-01T09:30:00-05:00,71.81,71.89,70.93,71.5,10475023,10001727.35,35.786612448689965,45.306433100969215,NaN,NaN,-230.27730154844122,-119.5846233569658,-0.11528354606107477,-0.3909435540249433,-0.2756600079638685,1005728142,1026295585,17.118803817223196,37.38761714081966,NaN,NaN,-12.148206431681285,-8.38972714914851
2023-03-02T09:30:00-05:00,71.51,72.62,71.44,72.48,9876126,9723152.55,45.20497104430782,45.767885078352734,NaN,NaN,-111.00852145986897,-140.19283898309976,-0.08361405700782953,-0.38017757922365547,-0.29656352221582594,1015604268,1019923764.8,15.460734407985129,35.20022468694278,NaN,NaN,-11.770729438596273,-8.872727476212475
2023-03-03T09:30:00-05:00,72.48,72.605,71.87,72.54,12384269,9730425.85,45.72980374938524,45.81365034965878,NaN,NaN,-79.29095892604462,-133.04801348993087,-0.05284827492308264,-0.3626238658696792,-0.30977559094659657,1027988537,1018296922.2,15.05967240020567,33.14343775842449,NaN,NaN,-11.31145828583135,-9.221117591872314
2023-03-06T09:30:00-05:00,72.34,72.84,72.31,72.73,8356010,9504485.65,47.44640411523708,45.505864113190334,NaN,NaN,-31.551758228757237,-123.91010910702553,-0.015844963788438915,-0.3295817956821452,-0.31373683189370627,1036344547,1020373731.8,17.98458387628709,31.44762955001567,NaN,NaN,-10.428833050648958,-9.39364837169755
2023-03-07T09:30:00-05:00,72.74,72.98,71.885,72.01,10059504,9647005.8,42.02204348331531,45.163532799575265,NaN,NaN,-77.53525121086659,-105.93275827479575,-0.03490982519759889,-0.3573741133907049,-0.322464288193106,1026285043,1022390107.4,20.834893437843945,30.104463164168873,NaN,NaN,-11.292795562427232,-9.664955113230361
2023-03-08T09:30:00-05:00,71.94,72.21,71.69,72.13,11170813,9742124.95,43.187832721595996,44.824579597971784,NaN,NaN,-109.99127961002664,-81.87555388711282,-0.03443131523793913,-0.36550343224052995,-0.3310721170025908,1037455856,1028735650.2,29.176607355994506,29.2148801680253,NaN,NaN,-11.655322975786788,-9.94929337930985
2023-03-09T09:30:00-05:00,72.41,72.53,71.245,71.46,15612688,10076085.2,38.52951678344173,44.42325927770889,NaN,NaN,-129.98750583663775,-85.67135076246657,-0.07206596148889777,-0.42115456886371305,-0.3490886073748153,1021843168,1029983430.2,30.72245923880807,28.292927325024436,NaN,NaN,-13.401694493379503,-10.442493538462658
2023-03-10T09:30:00-05:00,71.6,71.875,70.845,71.11,19026628,10610342.5,36.32529828047089,43.34163381359758,NaN,NaN,-163.24363390404565,-102.46188575806677,-0.11103042000803082,-0.4878766323848538,-0.376846212376823,1002816540,1024949030.8,28.061174592791474,26.980451297167047,NaN,NaN,-15.539567514817442,-11.170646963656198
2023-03-13T09:30:00-04:00,71.04,72.575,71,71.47,29831406,11692054.65,40.11987156112679,42.67937438413776,NaN,NaN,-99.04201888500864,-115.95993788931703,-0.10322219569594276,-0.5058739569967514,-0.40265176130080865,1032647946,1024209710.6,27.681945583946913,25.754953449869475,NaN,NaN,-16.213525344803937,-11.891058160963018
2023-03-14T09:30:00-04:00,71.68,72.16,71.425,72.12,19139214,12276988.15,46.33798371619261,42.520476189544716,NaN,NaN,-66.76396413227415,-113.80568047359854,-0.047764693172786865,-0.46235762776679223,-0.41459293459400537,1051787160,1029310134,34.28049301038102,25.106826778782594,NaN,NaN,-14.875837276635645,-12.317455177487679
2023-03-15T09:30:00-04:00,71.65,72.68,71.485,72.59,21438247,12881663.5,50.35257845169844,42.69888302833187,NaN,NaN,-21.237589512310336,-96.0549424540553,0.02327296580206789,-0.3855017273414205,-0.4087746931434884,1073225407,1036464044.2,42.241040023200505,25.462263172752216,NaN,NaN,-12.483580424307943,-12.341187355604859
2023-03-16T09:30:00-04:00,72.54,72.7079,72.125,72.64,15716990,13217211.75,50.774490351923944,43.176494789323314,NaN,NaN,12.869950022767808,-67.48345128217417,0.07349559093532021,-0.3169052044743381,-0.39040079540965833,1088942397,1049883890,53.596150185318415,27.010709205641582,NaN,NaN,-10.437050309494309,-12.069167777589065
2023-03-17T09:30:00-04:00,72.54,72.66,71.785,72.11,13283970,13463655.45,46.28444539342183,43.376378822371414,NaN,NaN,-24.44038950849643,-39.722802403064335,0.0708572467798011,-0.30182923693490693,-0.37268648371470803,1075658427,1064452267.4,62.26829885457934,29.651120333721515,NaN,NaN,-9.987139311677868,-11.771735139601752
2023-03-20T09:30:00-04:00,72.04,72.83,72.01,72.76,14132853,13614491.85,51.902081103271044,44.28599522886272,NaN,NaN,30.773672062584737,-13.759664213545662,0.11036832282801956,-0.23472608017968355,-0.3450944030077031,1089791280,1075880934.2,67.41326602784082,32.99286591517186,NaN,NaN,-7.839833751564839,-11.210034941310765
2023-03-21T09:30:00-04:00,72.87,73.03,72.19,72.7,12499653,13790736.95,51.368046819586525,45.39895482678391,NaN,NaN,57.69591008428067,11.1323106297653,0.1286645099510877,-0.1842637655688435,-0.3129282755199312,1077291627,1080981827.6,69.41765656219907,36.72849825409872,NaN,NaN,-6.269413710968609,-10.504231908404742
2023-03-22T09:30:00-04:00,72.83,73.14,72.02,72.03,11942225,13945298.15,45.71188607970257,45.43516304359782,NaN,NaN,30.43155852295235,21.466140236817843,0.0934824719614607,-0.19607518556810533,-0.289557657529566,1065349402,1079406626.6,68.0261294145546,40.48316932599653,NaN,NaN,-6.602422877260411,-9.946830618241266
2023-03-23T09:30:00-04:00,72.22,72.48,71.48,71.75,12160406,13918311.45,43.55354483291084,45.279715978135364,NaN,NaN,-54.97897428342553,7.896355375579172,0.05130144250927826,-0.22543085439296817,-0.27673229690224643,1053188996,1072255946.4,61.95468595465466,43.83281315131431,NaN,NaN,-7.530756154932115,-9.601677123482816
2023-03-24T09:30:00-04:00,71.94,73.035,71.86,72.97,12352559,13968908.45,53.79123175573756,45.73291795245683,NaN,NaN,91.60766395538357,31.105966068355173,0.10255434942790248,-0.14853936011736835,-0.2510937095452708,1065541555,1070232572,60.31428520842809,46.85636324646724,NaN,NaN,-4.981866563892551,-8.941704186398493
2023-03-27T09:30:00-04:00,73.22,73.69,73.21,73.36,10865542,14004073,56.506889877457986,46.76754983775273,NaN,NaN,227.33773248715548,70.41877815326932,0.15648067239988941,-0.055492869045409066,-0.21197354144529848,1076407097,1067555735.4,58.12175876489616,49.519710769828116,NaN,NaN,-2.010309656411814,-7.951504967828967
2023-03-28T09:30:00-04:00,73.47,73.89,73.39,73.49,11593405,14095876.55,57.405492603492156,47.783096972173894,NaN,NaN,209.17728446953072,100.71505303031934,0.1923064901044616,0.028409571185278537,-0.16389691891918307,1088000502,1069697510.4,59.393665051585224,51.67807203379888,NaN,NaN,0.6377329187538279,-6.724470984031425
2023-03-29T09:30:00-04:00,73.9,73.98,73.7052,73.9,9483497,14046300.25,60.19849885155996,49.33088140561091,NaN,NaN,211.96215139920872,137.0211716055706,0.23233985368744164,0.126527898190119,-0.10581195549732264,1097483999,1076124429.8,63.02288580770433,53.98524536014861,NaN,NaN,3.733787724249061,-5.230434025705642
2023-03-30T09:30:00-04:00,74.09,74.3,73.88,74.11,10737853,14089386.6,61.587834625718536,51.13534828741432,NaN,NaN,196.33126333539232,187.28321912933419,0.25961872815467435,0.21871145469602027,-0.04090727345865405,1108221852,1087131001,68.25553358347888,56.85627100234057,NaN,NaN,6.6981864983512995,-3.526345379411793
2023-03-31T09:30:00-04:00,74.49,74.74,74.365,74.71,10338734,13987109.85,65.31335312639939,52.934882684933775,NaN,NaN,201.56688835141617,209.2750640085407,0.3017704975558533,0.3363058484861625,0.034535350930309267,1118560586,1097734807.2,72.31955487982142,60.04467166633161,NaN,NaN,10.446987769599755,-1.5301549295530006
2023-04-03T09:30:00-04:00,74.76,75.26,74.4825,75.1,9607702,14049694.45,67.51856908923996,54.44778164015145,NaN,NaN,181.20640846468405,200.04879920404642,0.3369451385537242,0.4557167741224646,0.11877163556874035,1128168288,1108087045.4,75.60334496239406,62.996303948618255,NaN,NaN,14.28826967108659,0.7296200133955122
2023-04-04T09:30:00-04:00,75.07,75.39,74.785,74.95,7272864,13910362.45,65.78622130240498,55.5501847009162,NaN,NaN,152.41690184270567,188.6967226786814,0.330673233244108,0.5321131771238754,0.20143994387976735,1120895424,1114666029.8,77.43540282411763,65.51018700582662,NaN,NaN,16.93026998572546,3.043998580871219
2023-04-05T09:30:00-04:00,75.16,75.63,75.16,75.3,12410027,13972323.15,67.85846101385594,56.77046831962563,NaN,NaN,145.46278517895865,175.3968494346314,0.3299073800240951,0.6138241689098862,0.28391678888579114,1133305451,1121830320.2,79.26173715589279,67.3434432180105,NaN,NaN,19.79404823757022,5.4368628175425044
2023-04-06T09:30:00-04:00,75.23,75.49,74.91,75.36,8616848,13622531.15,68.21388302243912,58.33685672169829,NaN,NaN,120.41047530728389,160.21269182900969,0.3133737127156101,0.6756339297803038,0.3622602170646937,1141922299,1128570409.6,80.83345201164241,68.66952558637215,NaN,NaN,22.243784292967497,7.837851599746075
2023-04-10T09:30:00-04:00,75.1,75.38,74.64,75.36,9423434,13142371.45,68.21388302243912,59.5019854302103,NaN,NaN,101.67861481726769,140.23503712218,0.2832805052613542,0.7163608486413864,0.4330803433800322,1141922299,1133242752.2,81.85980564849257,69.70142127356156,NaN,NaN,24.264694112619036,10.184543387299355
2023-04-11T09:30:00-04:00,75.5,75.79,75.44,75.58,12944305,12298016.4,69.64145934888256,60.807229182302876,NaN,NaN,115.870730629542,127.16790155515157,0.25966020886374547,0.757655604459714,0.49799539559596856,1154866604,1138582415.4,82.98141213932887,70.67026095764227,NaN,NaN,26.396724566330498,12.50056927001809
2023-04-12T09:30:00-04:00,75.57,75.82,75.14,75.24,10386357,11860373.55,64.79790949096405,62.17051656882155,NaN,NaN,93.60523478099206,115.40556814280885,0.20500551280541357,0.7542522866027355,0.5492467737973219,1144480247,1143299380,83.92685004444293,71.80602671692,NaN,NaN,26.977231955173842,14.568663939326054
2023-04-13T09:30:00-04:00,75.27,75.7,74.92,75.66,12918992,11434410.8,67.77909312102042,63.90091287511509,NaN,NaN,86.20318747212404,103.55364860144194,0.18179832122534623,0.7764946753290047,0.5946963541036585,1157399239,1148118137.6,84.85262215819417,73.4415935886014,NaN,NaN,28.318587708003516,16.532938763422834
2023-04-14T09:30:00-04:00,75.46,75.79,74.975,75.18,8789738,11088048.2,61.38126274589929,64.44305794584093,NaN,NaN,72.70820754413087,94.01319504881133,0.12166812295955842,0.7467815078031066,0.6251133848435482,1148609501,1149455578,85.10898288944279,75.21264342295959,NaN,NaN,27.65706529253188,18.1220996961527
2023-04-17T09:30:00-04:00,75.33,75.665,75.24,75.66,9683477,10908023.55,64.94474635107676,65.04576197967084,NaN,NaN,77.81629970167117,89.24073202569203,0.10253507477600277,0.7532822283135516,0.6507471535375489,1158292978,1152729713.8,85.74502719695725,77.18573402524966,NaN,NaN,28.119423844728175,19.55028886023491
2023-04-18T09:30:00-04:00,75.65,75.96,75.405,75.89,7233258,10563043.8,66.53805235691993,65.69808767634426,NaN,NaN,85.17408321222385,83.10140254222839,0.09391311788830525,0.7681385508979304,0.6742254330096251,1165526236,1154861640.2,86.15957316339923,79.09758460466495,NaN,NaN,28.969536619903774,20.89589568304475
2023-04-19T09:30:00-04:00,75.98,76.06,75.615,75.84,6283769,10252249.6,65.83749095993407,66.10087282694239,NaN,NaN,85.69882331558833,81.52012024914765,0.07424829375705655,0.7670358002059459,0.6927875064488893,1159242467,1157814084.2,86.73489535461597,80.79129957230148,NaN,NaN,29.47061931577228,22.120856202005825
2023-04-20T09:30:00-04:00,75.57,76.26,75.53,76.02,7329495,10021613.1,67.17728429655082,66.50011923200186,NaN,NaN,89.09416747704739,82.09831625013231,0.06320171274668795,0.7717896473822492,0.7085879346355612,1166571962,1159648628.8,87.09389025919486,82.13689647770978,NaN,NaN,30.26320552736752,23.28404896277178
2023-04-21T09:30:00-04:00,76.53,76.97,76.405,76.57,10431036,9935144.6,70.92894622512293,66.90123302476782,NaN,NaN,146.64967553826585,96.88660984895932,0.08160444571632175,0.8105934917809634,0.7289890460646417,1177002998,1165327328.2,88.1618767297379,83.26849089556096,NaN,NaN,32.07289582632102,24.539598514707386