time,open,high,low,close,Volume,Volume MA,RSI,RSI-based MA,Upper Bollinger Band,Lower Bollinger Band,CCI,Smoothing Line,Histogram,MACD,Signal,OnBalanceVolume,Smoothing Line,RSI,RSI-based MA,Upper Bollinger Band,Lower Bollinger Band,True Strength Index,Signal
1998-12-22T09:30:00-05:00,25.313,25.46899,25.313,25.46899,3700,NaN,NaN,NaN,NaN,NaN,NaN,NaN,NaN,NaN,NaN,NaN,NaN,NaN,NaN,NaN,NaN,NaN,NaN
1998-12-23T09:30:00-05:00,25.5,25.75,25.46875,25.57812,12000,NaN,NaN,NaN,NaN,NaN,NaN,NaN,NaN,NaN,NaN,12000,NaN,NaN,NaN,NaN,NaN,NaN,NaN
1998-12-24T09:30:00-05:00,25.9375,26.04687,25.8125,26.04687,1600,NaN,NaN,NaN,NaN,NaN,NaN,NaN,NaN,NaN,NaN,13600,NaN,NaN,NaN,NaN,NaN,NaN,NaN
1998-12-28T09:30:00-05:00,25.92187,25.9375,25.8125,25.8125,8600,NaN,NaN,NaN,NaN,NaN,NaN,NaN,NaN,NaN,NaN,5000,NaN,NaN,NaN,NaN,NaN,NaN,NaN
1998-12-29T09:30:00-05:00,25.89062,26.375,25.89062,26.375,1100,NaN,NaN,NaN,NaN,NaN,NaN,NaN,NaN,NaN,NaN,6100,NaN,NaN,NaN,NaN,NaN,NaN,NaN
1998-12-30T09:30:00-05:00,26.35937,26.40625,26.15625,26.15625,31700,NaN,NaN,NaN,NaN,NaN,NaN,NaN,NaN,NaN,NaN,-25600,2220,NaN,NaN,NaN,NaN,NaN,NaN
1998-12-31T09:30:00-05:00,26.15625,26.25,26.125,26.125,32400,NaN,NaN,NaN,NaN,NaN,NaN,NaN,NaN,NaN,NaN,-58000,-11780,NaN,NaN,NaN,NaN,NaN,NaN
1999-01-04T09:30:00-05:00,26.15625,26.53125,25.90625,25.96875,5200,NaN,NaN,NaN,NaN,NaN,NaN,NaN,NaN,NaN,NaN,-63200,-27140,NaN,NaN,NaN,NaN,NaN,NaN
1999-01-05T09:30:00-05:00,26.125,26.40625,26.125,26.40625,1300,NaN,NaN,NaN,NaN,NaN,NaN,NaN,NaN,NaN,NaN,-61900,-40520,NaN,NaN,NaN,NaN,NaN,NaN
1999-01-06T09:30:00-05:00,26.71875,27.15625,26.71875,27.15625,8100,NaN,NaN,NaN,NaN,NaN,NaN,NaN,NaN,NaN,NaN,-53800,-52500,NaN,NaN,NaN,NaN,NaN,NaN
1999-01-07T09:30:00-05:00,27.03125,27.3125,27,27.125,13700,NaN,NaN,NaN,NaN,NaN,NaN,NaN,NaN,NaN,NaN,-67500,-60880,NaN,NaN,NaN,NaN,NaN,NaN
1999-01-08T09:30:00-05:00,27.28125,27.40625,27.10937,27.15625,18600,NaN,NaN,NaN,NaN,NaN,NaN,NaN,NaN,NaN,NaN,-48900,-59060,NaN,NaN,NaN,NaN,NaN,NaN
1999-01-11T09:30:00-05:00,27.25,27.28125,26.79687,27.01562,63100,NaN,NaN,NaN,NaN,NaN,NaN,NaN,NaN,NaN,NaN,-112000,-68820,NaN,NaN,NaN,NaN,NaN,NaN
1999-01-12T09:30:00-05:00,26.60937,26.6875,26.28125,26.3125,3300,NaN,NaN,NaN,NaN,NaN,NaN,NaN,NaN,NaN,NaN,-115300,-79500,NaN,NaN,NaN,NaN,NaN,NaN
1999-01-13T09:30:00-05:00,25.6875,26.4375,25.6875,26.4375,3400,NaN,62.10713169573098,NaN,NaN,NaN,NaN,NaN,NaN,NaN,NaN,-111900,-91120,NaN,NaN,NaN,NaN,NaN,NaN
1999-01-14T09:30:00-05:00,26.1875,26.3125,25.71875,25.84375,36600,NaN,53.54682739380774,NaN,NaN,NaN,NaN,NaN,NaN,NaN,NaN,-148500,-107320,NaN,NaN,NaN,NaN,NaN,NaN
1999-01-15T09:30:00-05:00,26.1875,26.20312,26.04687,26.17187,34800,NaN,57.06841440112514,NaN,NaN,NaN,NaN,NaN,NaN,NaN,NaN,-113700,-120280,NaN,NaN,NaN,NaN,NaN,NaN
1999-01-19T09:30:00-05:00,26.46875,26.57812,26.15625,26.15625,4100,NaN,56.8474780103927,NaN,NaN,NaN,NaN,NaN,NaN,NaN,NaN,-117800,-121440,NaN,NaN,NaN,NaN,NaN,NaN
1999-01-20T09:30:00-05:00,26.53125,26.84375,26.42187,26.59375,3500,NaN,61.35972969554687,NaN,NaN,NaN,NaN,NaN,NaN,NaN,NaN,-114300,-121240,NaN,NaN,NaN,NaN,NaN,NaN
1999-01-21T09:30:00-05:00,26.53125,26.5625,26.28125,26.34375,31500,15915,57.65007372908416,NaN,NaN,NaN,14.425999364016022,NaN,NaN,NaN,NaN,-145800,-128020,1.504319332737552,NaN,NaN,NaN,NaN,NaN
1999-01-22T09:30:00-05:00,25.9375,26.54687,25.875,26.46875,12300,16345,58.985268901759625,NaN,NaN,NaN,-12.893909217244696,NaN,NaN,NaN,NaN,-133500,-125020,3.818442191940207,NaN,NaN,NaN,NaN,NaN
1999-01-25T09:30:00-05:00,26.34375,26.46875,26.21875,26.40625,8100,16150,58.00062441912193,NaN,NaN,NaN,-7.598740454755623,NaN,NaN,NaN,NaN,-141600,-130600,3.6468170796860306,NaN,NaN,NaN,NaN,NaN
1999-01-26T09:30:00-05:00,26.5625,27.03125,26.48437,27.03125,3700,16255,64.40041180029323,NaN,NaN,NaN,83.96691421776605,NaN,NaN,NaN,NaN,-137900,-134620,3.5239321324286834,NaN,NaN,NaN,NaN,NaN
1999-01-27T09:30:00-05:00,27.0625,27.125,27,27,1900,15920,63.876308122891864,NaN,NaN,NaN,105.59109371128022,36.698271524212394,NaN,NaN,NaN,-139800,-139720,3.368838589551274,NaN,NaN,NaN,NaN,NaN
1999-01-28T09:30:00-05:00,27.0625,27.28125,27.0625,27.28125,4300,16080,66.51735163985143,NaN,NaN,NaN,117.85099369884637,57.38327039117846,NaN,NaN,NaN,-135500,-137660,5.1840585990248655,NaN,NaN,NaN,NaN,NaN
1999-01-29T09:30:00-05:00,27.375,27.5625,27.1875,27.46875,6800,14835,68.18720625813894,NaN,NaN,NaN,131.30417602906587,86.22288744044059,NaN,0.3219777653199998,NaN,-128700,-136700,6.069596098299641,NaN,NaN,NaN,NaN,NaN
1999-02-01T09:30:00-05:00,27.59375,27.60937,27.4375,27.53125,6100,13520,68.74672902966354,NaN,NaN,NaN,130.35191370915823,113.81301827322334,NaN,0.35806280339700436,NaN,-122600,-132900,9.66604319174128,NaN,NaN,NaN,NaN,NaN
1999-02-02T09:30:00-05:00,27.3125,27.3125,26.9375,27.1875,20900,14305,62.26072109494053,61.39673401373919,NaN,NaN,64.64536930269755,109.94870929020965,NaN,0.3548324166664827,NaN,-143500,-134020,9.549981439505856,NaN,NaN,NaN,NaN,NaN
1999-02-03T09:30:00-05:00,27.125,27.65625,27.09375,27.625,23100,15395,66.58212006958749,61.716376040443215,NaN,NaN,101.9227574295492,109.21504203386344,NaN,0.38315809752813834,NaN,-120400,-130140,13.428054231727359,NaN,NaN,NaN,NaN,NaN
1999-02-04T09:30:00-05:00,27.79687,27.82812,27.4375,27.46875,19500,15965,63.77347103248891,62.4468505860633,NaN,NaN,109.43031968931321,107.5309072319568,NaN,0.3885197210234175,NaN,-139900,-131020,13.288888729503256,NaN,NaN,NaN,NaN,NaN
1999-02-05T09:30:00-05:00,27.1875,27.35937,26.78125,26.78125,5800,15570,53.14971366347132,62.1669433905166,NaN,NaN,24.42119010362876,86.15431004686938,NaN,0.33344954318041786,NaN,-145700,-134420,12.739533869817095,NaN,NaN,NaN,NaN,NaN
1999-02-08T09:30:00-05:00,27.01562,27.21875,26.67187,27.21875,8200,15050,57.9502676921472,62.24571408207049,NaN,NaN,35.5601102324934,67.19594935153643,NaN,0.32140368255493,NaN,-137500,-137400,12.261106516874833,NaN,NaN,NaN,NaN,NaN
1999-02-09T09:30:00-05:00,26.875,26.90625,26.375,26.375,9400,12365,47.781674181198035,61.275852973902715,NaN,NaN,-32.8114520774891,47.7045850754991,NaN,0.24099563012692826,NaN,-146900,-138080,12.148987346535876,7.871328524955272,NaN,NaN,NaN,NaN
1999-02-10T09:30:00-05:00,26.34375,26.53125,26.21875,26.375,9200,12660,47.78167418119802,60.57096729191085,NaN,NaN,-58.366808831481606,15.646671823292937,-0.14448753615008336,0.17525147930582108,0.31973901545590444,-146900,-143380,11.282972421177178,8.569803745558103,NaN,NaN,NaN,NaN
1999-02-11T09:30:00-05:00,26.53125,27.26562,26.45312,27.23437,12200,13100,56.746852397352065,60.41108039873888,NaN,NaN,27.008950258199054,-0.837602062929897,-0.10355193750816277,0.19029909357070096,0.29385103107886373,-134700,-142340,12.5995340643385,9.197024593586551,NaN,NaN,NaN,NaN
1999-02-12T09:30:00-05:00,26.875,26.90625,26.57812,26.75,5800,11560,51.39126598240538,59.93898336754484,NaN,NaN,-18.11649867569421,-9.34513981879449,-0.10605627924058303,0.16128068202813495,0.267336961268718,-140500,-141300,13.974357179851197,9.934706029312634,NaN,NaN,NaN,NaN
1999-02-16T09:30:00-05:00,26.98437,27.25,26.96875,27.09375,9300,10285,54.66152614915081,59.24334867817753,NaN,NaN,38.338851157962765,-8.78939163370062,-0.08256624482225144,0.16412915524090366,0.2466954000631551,-131200,-140040,15.704411790831685,10.804740290627135,NaN,NaN,NaN,NaN
1999-02-17T09:30:00-05:00,27.15625,27.54687,27,27,14700,10815,53.60235745058684,58.50949505872717,NaN,NaN,47.93084883078116,7.359068547953433,-0.07174686819387702,0.15701181482080884,0.22875868301468585,-145900,-139840,15.99320729216528,11.706480912242423,NaN,NaN,9.383357333180436,NaN
1999-02-18T09:30:00-05:00,27,27.03125,26.76562,27.03125,3500,10815,53.92286061527377,57.609888556971626,NaN,NaN,-3.3114009620069886,18.370150121848358,-0.06129565039512114,0.15213912002078445,0.21343477041590558,-142400,-138940,17.36518120785884,12.576561098587705,NaN,NaN,8.746621405184483,NaN
1999-02-19T09:30:00-05:00,27.0625,27.17187,26.98437,27.17187,900,9285,55.41532430742324,56.69761127477765,NaN,NaN,26.864688293989627,18.34129772900647,-0.04450361444735687,0.1578052523567095,0.20230886680406637,-141500,-140300,16.91560827900409,13.35127625435231,NaN,NaN,8.687310848712002,NaN
1999-02-22T09:30:00-05:00,27.25,27.85937,27.25,27.85937,14000,9370,61.911048489961196,56.20934837908463,NaN,NaN,143.79283679899126,50.72316482394357,0.010384493930326394,0.21528948421697436,0.20490499028664796,-127500,-137700,21.120033871838686,14.169418445787837,NaN,NaN,10.786181567529342,NaN
1999-02-23T09:30:00-05:00,27.875,27.90625,27.5,27.71875,6800,9305,59.985960194998945,56.046865457660225,NaN,NaN,142.61909118153093,71.5792128286572,0.03340080500114076,0.2466559965380739,0.21325519153693315,-134300,-138320,20.84909121775928,14.976497715663083,NaN,NaN,11.8940110294959,NaN
1999-02-24T09:30:00-05:00,27.90625,28.09375,27.375,27.375,9000,9570,55.44715002448615,55.251510454438694,NaN,NaN,105.27625196106338,83.04829345471364,0.02219452867817398,0.24099835238465062,0.21880382370647664,-143300,-137800,21.755724548671765,15.571331309730539,NaN,NaN,11.458182554333025,NaN
1999-02-25T09:30:00-05:00,27.3125,27.34375,26.65625,27.0625,19100,10430,51.62305967961563,54.383623929233465,NaN,NaN,-34.161067381309834,76.87836017085309,-0.007930634725218488,0.20889053029995353,0.216821165025172,-162400,-141800,19.87025093796467,16.041428610334926,NaN,NaN,9.93222602148301,NaN
1999-02-26T09:30:00-05:00,27.03125,27.40625,27.03125,27.29687,8500,10640,54.17565441333166,54.45690541136635,NaN,NaN,17.840798256811656,75.07358216341748,-0.013416537853091187,0.20005049270880804,0.21346703056189922,-153900,-144280,18.78333493655265,16.473128686530323,NaN,NaN,9.442737989518157,NaN
1999-03-01T09:30:00-05:00,27.21875,27.3125,27.0625,27.3125,8600,10730,54.348651473912405,54.19964711006386,NaN,NaN,16.83659542922711,49.68233388946466,-0.017100346654895238,0.19209159724328018,0.20919194389817541,-145300,-147840,17.31881961369413,16.8343939077317,NaN,NaN,9.098857694923772,NaN
1999-03-02T09:30:00-05:00,27.375,27.70312,27.375,27.375,18100,11330,55.07894611167061,54.72088081938333,NaN,NaN,79.5640316370431,37.071321980567085,-0.01643141724868763,0.18865267233731586,0.2050840895860035,-127200,-146420,19.99825749715305,17.395056061347216,NaN,NaN,9.017571010366469,NaN
1999-03-03T09:30:00-05:00,27.40625,27.45312,27.23437,27.23437,1000,10335,53.02354811375336,55.09530038599443,NaN,NaN,33.67233354172299,22.750538296699013,-0.025995173772714736,0.17259012237011007,0.1985852961428248,-128200,-143400,25.525966627141173,18.412412790344643,NaN,NaN,8.401745464185673,NaN
1999-03-04T09:30:00-05:00,27.84375,27.90625,27.5625,27.8125,5400,9450,59.68421403048824,55.30511193121844,NaN,NaN,130.5778629860019,55.698324370161366,0.004457600627499864,0.20415729692719964,0.19969969629969977,-122800,-135480,37.68598877749667,20.204302412713083,NaN,NaN,9.810186989130877,NaN
1999-03-05T09:30:00-05:00,28.4375,28.84375,28.4375,28.65625,24800,9715,67.03125992982717,56.42225435603428,NaN,NaN,265.0828811499392,105.14674094878687,0.07533666469685138,0.293870527170764,0.21853386247391263,-98000,-124300,50.07756508856726,22.783102977621375,NaN,NaN,13.624102871699606,10.02177636767252
1999-03-08T09:30:00-05:00,28.875,28.875,28.40625,28.78125,12300,10040,67.96274069028907,57.37234110897272,NaN,NaN,211.07827385382845,143.99507663370713,0.12179789291599191,0.3707812286189025,0.2489833357029106,-85700,-112380,59.35742114610141,25.901175074426355,NaN,NaN,16.97066939740683,11.014475371920279
1999-03-09T09:30:00-05:00,28.71875,29.03125,28.64062,28.85937,12100,10235,68.56057797534551,58.440785432169776,NaN,NaN,186.63104258532871,165.40847882336428,0.14724954620461916,0.4330452684586845,0.28579572225406535,-73600,-101660,65.5580583331296,29.441521577352376,NaN,NaN,19.85128814553583,12.2768771967225
1999-03-10T09:30:00-05:00,28.875,28.92187,28.71875,28.78125,5600,10045,67.20991903945873,59.38986103389727,NaN,NaN,154.5134317905378,189.57669847312724,0.1478921039314538,0.4706608521683826,0.3227687482369288,-79200,-91860,70.05570315809575,33.20513028808359,NaN,NaN,21.83240771605784,13.641952985198976
1999-03-11T09:30:00-05:00,29,29.26562,28.92187,29.09375,13100,10240,69.775048612201,60.41555562709568,NaN,NaN,161.1612722200772,195.6933803199423,0.15754249707449297,0.519696869580045,0.36215437250555205,-66100,-80520,74.24657339590965,37.300199225005414,NaN,NaN,24.322749656671174,15.167781081123575
1999-03-12T09:30:00-05:00,29.40625,29.5625,28.5,29.21875,13700,10315,70.76038197541335,61.04765087605655,NaN,NaN,134.56686810202376,169.5901777103592,0.16000805420634523,0.5621644402634836,0.4021563860571383,-52400,-71400,77.0307877186591,41.293824499778296,NaN,NaN,26.689039717439066,16.81367517202579
1999-03-15T09:30:00-05:00,29.1875,29.29687,29,29.28125,7100,10380,71.26479531108657,61.85328195577709,NaN,NaN,121.63536082472855,151.70159510453922,0.15348775203035647,0.5940160760950839,0.4405283240647274,-45300,-63320,79.17852133775905,45.460212365492566,NaN,NaN,28.798801702050685,18.525836104886487
1999-03-16T09:30:00-05:00,29.46875,29.46875,29,29.125,6200,10225,68.10180278455033,62.75718572435311,NaN,NaN,105.39493599550437,135.45437378657437,0.1273671487452206,0.5997372599962532,0.47237011125103257,-51500,-58900,80.26558306408404,49.6394879737363,NaN,NaN,29.764912303358177,20.13141841895387
1999-03-17T09:30:00-05:00,29.09375,29.09375,28.71875,29,6700,9825,65.5936188266229,63.755082806282196,NaN,NaN,73.47985326511576,119.24765808148996,0.09203474813084717,0.5874135464145915,0.49537879828374437,-58200,-54700,81.26644580583941,54.024930464298784,NaN,NaN,29.925849351133387,21.53062283783666
1999-03-18T09:30:00-05:00,28.8125,29.5,28.8125,29.5,7000,10000,70.30481779521449,64.9071659049881,NaN,NaN,91.7167079511251,105.35874522769954,0.09245702831523861,0.6109500836777926,0.518493055362554,-51200,-51720,81.96533753127238,58.5379306496359,NaN,NaN,31.451163258621456,22.947842897948775
1999-03-19T09:30:00-05:00,29.46875,29.46875,29.0625,29.0625,13100,10610,62.27019632097001,65.47299053692079,NaN,NaN,78.05205649219288,94.05578290573337,0.05522772501725015,0.5875277116341167,0.5322999866168665,-64300,-54100,79.41704763721694,62.97351836560182,NaN,NaN,30.381108639420784,24.00973800387335
1999-03-22T09:30:00-05:00,29,29,28.625,28.75,18600,10840,57.23838494225969,65.62723616767717,NaN,NaN,38.77217728600481,77.48314619798862,0.004202093042749766,0.5375526029203037,0.533350509877554,-82900,-61620,71.81929254988387,66.6750208693683,NaN,NaN,27.909869933346638,24.566899708083817
1999-03-23T09:30:00-05:00,28.53125,28.53125,27.8125,27.875,9800,10990,46.024088570720245,65.12727477174623,NaN,NaN,-27.7020010621092,50.86375878646591,-0.08870297584039688,0.4224717900770578,0.5111747659174547,-92700,-69860,64.53389154332062,69.46130122052398,NaN,NaN,21.64592339287387,24.14961737733954
1999-03-24T09:30:00-05:00,28,28,27.59375,27.65625,12900,11185,43.718032014445804,63.98683319917176,NaN,NaN,-58.61726232450128,24.444335668542504,-0.16090451330411382,0.31004412428731243,0.47094863759142624,-105600,-79340,57.32863057243323,70.86434706301945,NaN,NaN,15.863101836684873,22.9658294429603
1999-03-25T09:30:00-05:00,28.09375,28.5,27.9375,28.5,10200,10740,53.41398917873458,63.014171002665144,NaN,NaN,-13.900081285849645,3.3209778211475496,-0.14817155272723104,0.2857341966823874,0.43390574940961846,-95400,-88180,51.54887271579763,70.96944046496448,NaN,NaN,14.136727802662975,21.70452920863211
1999-03-26T09:30:00-05:00,28.4375,28.5625,28.1875,28.3125,6300,10630,51.29902650719207,61.823905703872505,NaN,NaN,-17.11407837445743,-15.712249152182517,-0.14834502993810217,0.24847446198699075,0.3968194919250929,-101700,-95660,47.21156267129168,70.10187914533522,NaN,NaN,12.067904191446146,20.32786849189126
1999-03-29T09:30:00-05:00,28.79687,29,28.73437,29,5100,10455,57.883959250305196,61.06129008065533,NaN,NaN,42.938682941813134,-14.878948021020852,-0.100420354182236,0.27129404919729794,0.37171440337953393,-96600,-98400,45.69485376949854,68.68307881936155,NaN,NaN,12.639834257494698,19.229577886977463
1999-03-30T09:30:00-05:00,28.875,29.09375,28.78125,29.03125,36300,11365,58.16088173967132,60.414930273527666,NaN,NaN,46.625129685127334,-0.013521871573553312,-0.06651244223799524,0.2885738505820399,0.3550862928200351,-60300,-91920,49.80208073241797,67.23639150324172,NaN,NaN,13.167548982397875,18.36357375775181
1999-03-31T09:30:00-05:00,29.1875,29.21875,28.59375,28.59375,24400,12535,52.91517898017768,59.21065387124029,NaN,NaN,12.633961959499773,14.23672298522666,-0.07293040967990849,0.2639232807201495,0.33685369040005797,-84700,-87740,52.307847242264366,65.6693396351242,NaN,NaN,11.881172453321698,17.437516428547507
1999-04-01T09:30:00-05:00,28.75,28.75,28.39062,28.5625,4100,12470,52.5505871632806,57.909954241802225,NaN,NaN,-45.54323303508049,7.908092635380465,-0.0781952675385692,0.2391096059768465,0.3173048735154157,-88800,-86420,53.103957846892094,63.96028035856941,NaN,NaN,10.760798217167206,16.483699541207464
1999-04-05T09:30:00-04:00,28.75,29.03125,28.65625,28.9375,9600,11710,56.430115968879626,56.850334288787444,NaN,NaN,19.848384516185092,15.30058521350897,-0.05635723734325576,0.246858326836346,0.30321556417960177,-79200,-81920,55.81199220741908,62.29124256354513,NaN,NaN,11.016845589462955,15.702720405243962
1999-04-06T09:30:00-04:00,29.04687,29.28125,28.9375,29.09375,10900,11640,57.97202942819802,56.12677904904799,NaN,NaN,65.97241435197846,19.90733149554203,-0.032508092030692604,0.262580449141236,0.2950885411719286,-68300,-76260,59.017556068119504,60.77352634954766,NaN,NaN,11.69382219105447,15.13002066035975
1999-04-07T09:30:00-04:00,29.32812,29.40625,29.25,29.34375,13600,11715,60.38754593696981,55.75491669978705,NaN,NaN,104.62854855354246,31.50801526922506,-0.002591631830185459,0.2918490013841968,0.29444063321438224,-54700,-75140,59.64146567378354,59.22888491154367,NaN,NaN,12.990861008600572,14.824426424394153
1999-04-08T09:30:00-04:00,29.4375,30,29.4375,30,20800,12475,65.92402731028777,55.442003093720885,NaN,NaN,175.71571195391104,64.12436526810731,0.05549126629944667,0.3638047160886906,0.3083134497892439,-33900,-64980,64.8666723513804,58.00755168440853,NaN,NaN,15.957785212319738,14.986334822669237
1999-04-09T09:30:00-04:00,29.875,30.32812,29.875,30.28125,72900,15465,67.9889773174894,55.85048745061513,NaN,NaN,205.30239341615984,114.29349055835537,0.10412544079882924,0.43847025078778046,0.3343448099889512,39000,-39420,73.99010874624075,57.619913192195945,NaN,NaN,19.077994811705615,15.570857678245863
1999-04-12T09:30:00-04:00,29.8125,30.65625,29.8125,30.53125,21100,15835,69.74408486772487,56.7437517310055,NaN,NaN,192.45926278453445,148.81566621202526,0.14205622965125497,0.51191509705302,0.369858867401765,60100,-11560,80.06630634139337,58.20898560587519,NaN,NaN,22.217795196113936,16.520420180798446
1999-04-13T09:30:00-04:00,30.625,30.65625,30.21875,30.375,32700,17115,67.26187853924243,58.26073672875709,NaN,NaN,170.80161749304946,169.78150684023944,0.1450402483015824,0.551159177778743,0.4061189294771606,27400,7580,83.00387930972148,59.5282704463324,NaN,NaN,24.062134580999327,17.597807952255714
1999-04-14T09:30:00-04:00,30.375,30.4375,29.6875,29.6875,49700,19290,57.55554848095817,59.2491307620794,NaN,NaN,98.34072879728397,168.52394288898776,0.09173017126453453,0.5207816435578287,0.4290514722932942,-22300,14060,83.8705198665082,61.42411968162347,NaN,NaN,22.639748931848455,18.318085235054678
1999-04-15T09:30:00-04:00,29.875,29.9375,29.1875,29.625,35800,20745,56.753736538087416,59.487684144890316,NaN,NaN,51.49951524407355,143.68070354702027,0.04560761624813192,0.48606099260345914,0.4404533763553272,-58100,9220,80.56609007102747,63.496778064139896,NaN,NaN,21.262315773707403,18.738689597719354
1999-04-16T09:30:00-04:00,29.625,29.75,29.40625,29.71875,11600,20975,57.70553457846149,59.94529186426671,NaN,NaN,52.474832433609414,113.11519135051017,0.01627544232531042,0.46079767926196524,0.4445222369366548,-46500,-7880,70.06312059354845,65.12903220144395,NaN,NaN,20.41142184473694,18.977651347293296
1999-04-19T09:30:00-04:00,30.1875,30.5625,28.96875,29.0625,37400,22190,49.49388375634001,59.346000757554904,NaN,NaN,39.20919847416456,82.46517848843621,-0.04889554787412925,0.38340280209399324,0.4322983499681225,-83900,-36680,56.66470340122468,65.91259288942437,NaN,NaN,17.0477807472106,18.701955547281482
1999-04-20T09:30:00-04:00,29.25,29.5625,29.15625,29.4375,15600,22040,53.560620401483554,59.01741066197007,NaN,NaN,20.803608011834584,52.46557659219322,-0.06718983415017105,0.3483110572804087,0.4155008914305797,-68300,-55820,49.84286887946543,65.9155063284992,NaN,NaN,15.461463362554989,18.239028092320556
1999-04-21T09:30:00-04:00,29.625,29.9375,29.46875,29.9375,45100,23805,58.37340458297622,59.40728391931282,NaN,NaN,57.42267532257599,44.28196589725164,-0.04701334664289114,0.35673420812696577,0.4037475547698569,-23200,-56000,49.78217042362469,65.7351008414535,NaN,NaN,15.640801537729981,17.867852870236188
1999-04-22T09:30:00-04:00,30.09375,30.3125,29.875,30.01562,35700,24945,59.086832331881354,59.87415857421286,NaN,NaN,84.55745608880153,50.89355406619722,-0.030598051330732623,0.3654999906064411,0.39609804193717374,12500,-41880,54.466549654691256,65.83242882772488,NaN,NaN,16.002491538961415,17.601372680054077
1999-04-23T09:30:00-04:00,30.125,30.40625,30.125,30.34375,2000,24535,62.03045969773309,60.27418312627383,NaN,NaN,103.94450924078365,61.18748942763206,-0.0013759220459417798,0.39437813937974653,0.3957540614256883,14500,-29680,58.10307081005326,65.99607729934161,NaN,NaN,17.214105787665765,17.546048838284317
1999-04-26T09:30:00-04:00,30.46875,30.5,30.15625,30.15625,94400,28940,59.400495648836426,60.376216427748,NaN,NaN,94.48653261261259,72.24295625532166,0.0014382443692620983,0.39755186688726596,0.39611362251800386,-79900,-28880,58.3380395563488,65.94754040564371,NaN,NaN,17.43689120031978,17.530454890003668
1999-04-27T09:30:00-04:00,30.34375,30.375,30.125,30.23437,4100,28890,60.15842197014113,60.35985043011738,NaN,NaN,82.45981337751796,84.57419732845833,0.0045008578247981434,0.4017396947990015,0.39723883697420337,-75800,-30380,57.68479586775793,65.80777827664187,NaN,NaN,17.836666644353212,17.574199426339316
1999-04-28T09:30:00-04:00,30.40625,30.59375,30.125,30.125,6000,27375,58.511517971606594,59.83038547735445,NaN,NaN,79.98224701138686,89.08611166622052,-0.004416786340661283,0.3917178540483768,0.39613464038903806,-81800,-42100,52.717717351511865,64.93999577665126,NaN,NaN,17.71457551390185,17.594253153133963
1999-04-29T09:30:00-04:00,29.875,30.09375,29.3125,29.4375,17900,27050,49.36332304248711,58.49998160056857,NaN,NaN,-23.07340383478065,67.55993968150408,-0.05726078547734964,0.324558658542351,0.38181944401970064,-99700,-64540,44.76900110699141,62.85277380241917,NaN,NaN,14.800104915653955,17.195089119208248
1999-04-30T09:30:00-04:00,29.71875,29.78125,28.46875,29.34375,37300,28710,48.25536601591739,56.96507311115375,NaN,NaN,-101.80604263130438,26.409829307086472,-0.096844556355273,0.26076374857560936,0.35760830493088236,-137000,-94840,36.718395504817586,59.756494456949476,NaN,NaN,12.09438171839148,16.466416633377282
1999-05-03T09:30:00-04:00,29.40625,30.09375,29.40625,30.0625,90600,32760,56.345234361057145,56.18531281271195,NaN,NaN,2.469185969074606,8.006359978378875,-0.07396944618998669,0.265146497193399,0.3391159433833857,-46400,-88140,39.316970518561575,56.63600097186662,NaN,NaN,12.152204254230188,15.85010057921341
1999-05-04T09:30:00-04:00,30.40625,30.4375,29.53125,29.71875,191400,41785,52.14620980159682,55.79893147847185,NaN,NaN,3.2014044425849097,-7.845321808607738,-0.08078314696653488,0.23813700967521712,0.318920156641752,-237800,-120540,32.3902591695372,52.958839493511555,NaN,NaN,10.863425268847076,15.13771839201822
1999-05-05T09:30:00-04:00,29.78125,29.78125,29,29.46875,49700,43590,49.270405387795186,55.26440782487955,NaN,NaN,-102.41961371149688,-44.32569395318448,-0.09968100670417046,0.19431889826153892,0.2939999049657094,-287500,-161680,26.10206585233543,49.06855204931927,NaN,NaN,8.89767255443818,14.246283272363929
1999-05-06T09:30:00-04:00,29.1875,29.3125,28.8125,28.8125,12000,43150,42.62508601610217,54.187232927568175,NaN,NaN,-165.7304665251974,-72.85710649126783,-0.1508610588831264,0.10542358136180141,0.2562846402449278,-299500,-201640,21.696117841282685,45.61376613844315,NaN,NaN,4.937535556854033,12.916462170148229
1999-05-07T09:30:00-04:00,29.15625,29.46875,29.125,29.46875,25600,40785,49.90181788951271,54.216371079937645,NaN,NaN,-84.0156026583718,-69.29901849668131,-0.1354874943381245,0.0869252723222722,0.2224127666603967,-273900,-229020,19.293089396732825,42.94436513812229,NaN,NaN,3.9908680240509593,11.641377292134333
1999-05-10T09:30:00-04:00,29.5625,29.90625,29.25,29.4375,19200,40690,49.57935437652253,53.931994935297574,NaN,NaN,-45.29261042285351,-78.85137777506694,-0.12277116031416632,0.06894881626768878,0.1917199765818551,-293100,-278360,15.879805291727294,40.51843202471242,NaN,NaN,3.156148673537819,10.429201775191974
1999-05-11T09:30:00-04:00,29.71875,30.21875,29.71875,30.03125,31100,40610,55.46751236544808,53.72443120547414,NaN,NaN,51.683014992233275,-69.15505566513725,-0.07222107794952473,0.1014436291449492,0.17366470709447393,-262000,-283200,15.588462126845286,38.07602428922818,NaN,NaN,4.3823794951537725,9.565370020900803
1999-05-12T09:30:00-04:00,30.0625,30.21875,29.6875,30.21875,12500,38750,57.16855843679399,53.587411641539326,NaN,NaN,60.47015066845224,-36.57710278914743,-0.026368773414512103,0.14070374032633381,0.16707251374084592,-249500,-275600,18.128529099553532,35.48045139243262,NaN,NaN,5.913035373864498,9.043607928467045
1999-05-13T09:30:00-04:00,30.40625,30.40625,29.875,30.0625,13600,37640,55.27376612364474,53.10479067196159,NaN,NaN,68.38951870975791,10.246894257843625,-0.007741820751949596,0.15739523780090892,0.1651370585528585,-263100,-268320,20.593445406701292,32.80119243505034,NaN,NaN,6.581590763336862,8.691891190591305
1999-05-14T09:30:00-04:00,29.375,29.625,29.34375,29.46875,10200,37570,48.67211095758964,52.33847747972967,NaN,NaN,-56.175758034286105,15.814863182660758,-0.0350582295832029,0.12131427157385488,0.15637250115705778,-273300,-268200,20.63586128288462,30.108179701231467,NaN,NaN,5.072432403265939,8.174825649544823
1999-05-17T09:30:00-04:00,29,29.15625,28.5625,28.875,10400,36220,43.125218219365856,51.121820068960005,NaN,NaN,-153.4355324995644,-5.813721232681422,-0.08965917124202424,0.04429853710452747,0.1339577083465517,-283700,-266320,21.344722545486533,27.512460178212077,NaN,NaN,1.9253303723857944,7.282040609950677
1999-05-18T09:30:00-04:00,29.09375,29.53125,29.0625,29.0625,5100,35695,45.24727808815787,50.17437436299939,NaN,NaN,-87.25345346946492,-33.60101492502106,-0.1084373566574001,-0.0015889874751984223,0.10684836918220168,-278600,-269640,20.988208031965186,25.246066655387317,NaN,NaN,0.06365466517453404,6.250842617839799
1999-05-19T09:30:00-04:00,29.34375,29.34375,28.71875,28.71875,700,33475,42.14280802064877,49.65862329001094,NaN,NaN,-118.81920871932945,-69.4588868025774,-0.1374341321852364,-0.06494429604934382,0.07248983613589258,-279300,-275600,20.331680656534957,23.500543766068994,NaN,NaN,-2.473767729157019,5.004469711125968
1999-05-20T09:30:00-04:00,29.125,29.1875,28.96875,28.96875,7500,32065,45.093350982242015,49.432765073319835,NaN,NaN,-91.07204643668844,-101.35119983186668,-0.13311068506144647,-0.09389852019091549,0.03921216487053096,-271800,-277340,20.13367021052038,22.315920530762053,NaN,NaN,-3.6680202774620403,3.76554256989911
1999-05-21T09:30:00-04:00,28.9375,28.9375,28.75,28.78125,5100,32220,43.30944028980169,48.50163692537301,NaN,NaN,-113.97498460743353,-112.91104514649616,-0.13574625188543935,-0.13047064998626823,0.005275601899171117,-276900,-278060,20.046669064224403,20.939470426880824,NaN,NaN,-5.186553010579373,2.486671772687898
1999-05-24T09:30:00-04:00,28.71875,28.875,28.15625,28.15625,3600,27680,37.92381594398823,47.48575164982954,NaN,NaN,-161.21929022035874,-114.46779669065504,-0.17021626781895202,-0.20749473287451892,-0.037278465055566895,-280500,-277420,20.3760344746496,20.081311520103135,NaN,NaN,-8.246997797420729,0.9532904055295226
1999-05-25T09:30:00-04:00,28.5625,28.59375,27.875,27.875,7000,27825,35.76831056364672,46.52131630524752,NaN,NaN,-178.05151175812026,-132.6274083483861,-0.20050724528142128,-0.2879125216573435,-0.08740527637592221,-287500,-279200,20.127686852983487,19.65457016300657,NaN,NaN,-11.460828759809912,-0.8201551895189678
1999-05-26T09:30:00-04:00,28.15625,28.1875,27.8125,28.1875,5100,27780,39.858588959695965,46.323709372647066,NaN,NaN,-163.2183908045992,-141.50724476544005,-0.18824224483743945,-0.32270808242272153,-0.13446583758528208,-282400,-279820,20.03608388392834,19.535996308909827,NaN,NaN,-12.908305337276706,-2.5470337820557876
1999-05-27T09:30:00-04:00,28,28.03125,27.625,27.625,11900,27480,35.47901140102863,45.29350890918392,NaN,NaN,-171.64131202259586,-157.62109788262154,-0.2053583471651958,-0.39116377154177684,-0.18580542437658104,-294300,-284320,19.347822680617938,19.539905829187337,NaN,NaN,-15.569606275964826,-4.40740128118565
1999-05-28T09:30:00-04:00,27.84375,28.1875,27.84375,28.01562,1100,25670,40.37828192377079,44.63628944827308,NaN,NaN,-120.71142692275689,-158.9683863456862,-0.17869875618588452,-0.4091788696089367,-0.23048011342305216,-293200,-287580,18.842839892554963,19.751551157817882,NaN,NaN,-16.252551303787996,-6.099565570128842
1999-06-01T09:30:00-04:00,28.0625,28.1875,27.76562,28.1875,29600,22620,42.44908219949155,43.70640157927619,NaN,NaN,-105.48391465272638,-147.82131123215973,-0.13955113370091976,-0.40491903054920186,-0.2653678968482821,-263600,-284200,21.140996116476416,20.148160728505818,NaN,NaN,-16.171836218276646,-7.538461377007099
1999-06-02T09:30:00-04:00,28.5,28.53125,28.125,28.125,6400,13370,41.87947649833448,42.61432429795765,NaN,NaN,-74.07403259779113,-127.02581540009392,-0.10926795684421231,-0.4019528429035475,-0.2926848860593352,-270000,-280700,23.554999214555764,20.53576573672026,NaN,NaN,-16.270905189297526,-8.785953350191445
1999-06-03T09:30:00-04:00,28.84375,28.875,28.65625,28.78125,4200,11095,49.536460103247265,42.20451672507212,NaN,NaN,-13.69367052675157,-97.12087134452437,-0.04001034730062719,-0.3426978201851192,-0.302687472884492,-265800,-277380,25.873021241809198,20.912878296370824,NaN,NaN,-13.971965510450723,-9.526812230228485
1999-06-04T09:30:00-04:00,29.15625,29.15625,28.875,29,4900,10740,51.81523473496541,42.429025566313236,NaN,NaN,13.71669686491985,-60.04926956702123,0.02221604701034241,-0.274917414121564,-0.2971334611319064,-260900,-270700,30.44317963572783,21.613401035859624,NaN,NaN,-11.372489254745904,-9.790480376588116
1999-06-07T09:30:00-04:00,28.875,29.125,28.875,29.07812,2900,9605,52.63777025334945,43.10849356874064,NaN,NaN,17.907057298384164,-32.32557272279301,0.0677480884891053,-0.2124483505205248,-0.2801964390096301,-258000,-263660,34.99203769776972,22.588209261022712,NaN,NaN,-9.013155241273289,-9.679433928685997
1999-06-08T09:30:00-04:00,28.96875,29,28.64062,28.64062,4200,8855,47.724334312001595,43.28542615615805,NaN,NaN,-9.440748225572102,-13.116939437362172,0.06736949276818899,-0.19598457304939387,-0.26335406581758286,-262200,-263380,35.173624575107084,23.601453299818562,NaN,NaN,-8.379984769375758,-9.49379833449882
1999-06-09T09:30:00-04:00,28.53125,28.59375,28.35937,28.35937,4900,7545,44.827450913304126,43.477186362776294,NaN,NaN,-43.02798940248535,-6.90773079830101,0.04805280697069836,-0.20328805710420994,-0.2513408640749083,-267100,-262800,35.5750699957172,24.690266824045864,NaN,NaN,-8.696804233614733,-9.379942034372522
1999-06-10T09:30:00-04:00,28.21875,28.21875,27.89062,27.95312,7800,7310,40.95990398720015,43.18194014884473,NaN,NaN,-88.37113095481985,-21.843222883914667,0.009791975749419535,-0.23910089438813387,-0.2488928701375534,-274900,-264620,34.84585766418698,25.741137356450622,NaN,NaN,-10.139960674182003,-9.488516125773877
1999-06-11T09:30:00-04:00,28.09375,28.25,27.76562,27.8125,2600,6760,39.68363733066821,42.92295422319234,NaN,NaN,-91.18689577797278,-42.8239414124932,-0.021407414672318714,-0.2756521384779518,-0.25424472380563307,-277500,-267940,33.49700176317448,26.701875406375628,NaN,NaN,-11.705103089291363,-9.805171406276376
1999-06-14T09:30:00-04:00,28.0625,28.125,27.84375,27.84375,1300,6315,40.13009335294264,43.08054546668909,NaN,NaN,-84.90547738170918,-63.38644834851186,-0.035528173494638104,-0.2986549406739307,-0.2631267671792926,-276200,-271580,32.0329406989961,27.53451156525752,NaN,NaN,-12.86166915986899,-10.241813942503892
1999-06-15T09:30:00-04:00,27.875,27.875,27.625,27.65625,4900,6040,38.298370468291026,43.26126403130654,NaN,NaN,-108.27446793571052,-83.15319229053955,-0.0520832814537141,-0.3282308689964353,-0.2761475875427212,-281100,-275360,30.540148034603888,28.27825879251612,NaN,NaN,-14.358964487922302,-10.829978306135093
1999-06-16T09:30:00-04:00,28.1875,28.45312,28.15625,28.40625,19800,6775,48.43686732158764,43.873998200013084,NaN,NaN,-5.535807856036592,-75.65475598124979,-0.009348578012437436,-0.28783331005826795,-0.2784847320458305,-261300,-274200,31.59368493533158,29.103801724759204,NaN,NaN,-12.685508684480052,-11.095054074470086
1999-06-17T09:30:00-04:00,28.34375,28.40625,28.25,28.26562,3200,6900,46.881337550421975,44.6884500678269,NaN,NaN,-6.06606846917532,-59.19374348412089,0.011490988184307382,-0.2641209968154463,-0.2756119849997537,-264500,-272120,33.540231300831366,30.117545197631593,NaN,NaN,-11.766482003941777,-11.190972350108899
1999-06-18T09:30:00-04:00,28.1875,28.46875,28.15625,28.4375,5100,6780,49.03561254593737,45.30683082655309,NaN,NaN,10.290308636396269,-38.89830260124708,0.037432129872886855,-0.22882182265864515,-0.266253952531532,-259400,-268500,36.905281022960274,31.407719564089117,NaN,NaN,-10.369334359058003,-11.073595494244485
1999-06-21T09:30:00-04:00,28.59375,28.9375,28.59375,28.9375,4700,6760,54.78082375517746,46.18766950910208,NaN,NaN,108.81252789273493,-0.15470154635825964,0.08606549918891654,-0.15867207854538634,-0.24473757773430288,-254700,-264200,40.74336285436743,32.807888616795616,NaN,NaN,-7.3572382226272826,-10.542687312584885
1999-06-22T09:30:00-04:00,28.8125,28.875,28.65625,28.75,2800,6720,52.39549055833165,46.93881337053045,NaN,NaN,86.43714716313599,38.787621473411036,0.10230167102139737,-0.11686048895755619,-0.21916215997895355,-257500,-259480,44.718561037310835,34.31957160413526,NaN,NaN,-5.551958951858046,-9.829726118195337
1999-06-23T09:30:00-04:00,28.5625,28.5625,28.15625,28.34375,5200,6630,47.5630454089784,46.79785517808266,NaN,NaN,3.809726984127339,40.65672844144383,0.08318749999087066,-0.11517778499036524,-0.1983652849812359,-262700,-259760,44.52772823038695,35.65205067474796,NaN,NaN,-5.438077559701167,-9.20234775269617
1999-06-24T09:30:00-04:00,28.25,28.28125,27.875,28.28125,5900,6670,46.84718580422008,46.44299454017228,NaN,NaN,-39.85835245601243,33.89827164407641,0.06466613613158931,-0.11753261481674926,-0.18219875094833857,-268600,-260580,43.936397878802964,36.61585197782476,NaN,NaN,-5.553382876206275,-8.681067056054756
1999-06-25T09:30:00-04:00,28.375,28.375,28.15625,28.1875,1200,6135,45.73523628436269,45.94995639953037,NaN,NaN,-27.15014650428505,26.410180615940146,0.04534556362210426,-0.12551679642070823,-0.1708623600428125,-269800,-262660,42.39830591669801,37.14487113631964,NaN,NaN,-5.961642016476835,-8.292577764686481
1999-06-28T09:30:00-04:00,28.28125,28.8125,28.28125,28.73437,2300,6195,52.77659358597891,46.31083206195733,NaN,NaN,47.21262706993724,14.090200451380616,0.06731639903351086,-0.08671686125092393,-0.1540332602844348,-267500,-265220,40.51825380054682,37.52663036670818,NaN,NaN,-4.22353619504362,-7.711286111880358
1999-06-29T09:30:00-04:00,28.85937,29.21875,28.85937,29.21875,8200,5125,57.97779945274088,47.2501426719171,NaN,NaN,132.23651238501145,23.250073495755707,0.10987474798280827,-0.016689825305924444,-0.12656457328873272,-259300,-265580,40.24797459528168,37.86040926667708,NaN,NaN,-1.0490248004583642,-6.75953449596293
1999-06-30T09:30:00-04:00,28.96875,29.78125,28.96875,29.78125,11300,5370,63.06527782869312,48.82909794630945,NaN,NaN,176.04552859297266,57.697233817524776,0.16784098171638434,0.08323665385674772,-0.08460432785963662,-248000,-262640,43.55917004919953,38.48278872274941,NaN,NaN,3.4289619980062245,-5.3040349968244795
1999-07-01T09:30:00-04:00,29.5625,29.9375,29.5625,29.9375,2900,5305,64.35617104557659,50.59142178308862,NaN,NaN,191.1122945436368,103.89136321745464,0.20611742390144605,0.17304245201717094,-0.033074971884275106,-245100,-257940,48.474881645327336,39.552637285760326,NaN,NaN,7.45099191203082,-3.481888295559437
1999-07-02T09:30:00-04:00,29.8125,30.25,29.8125,30.09375,10900,5605,65.64911039875565,52.41420871493241,NaN,NaN,194.12847131245186,148.147086780802,0.22957638854804524,0.25389551380078146,0.02431912525273621,-234200,-250820,54.88519044642561,41.18494083914815,NaN,NaN,11.141233724437532,-1.3928708641312988
1999-07-06T09:30:00-04:00,30.1875,30.57812,30.15625,30.34375,17000,6310,67.66983176661344,54.51217023624116,NaN,NaN,195.01861752681245,177.70828487217705,0.24797794259977918,0.3342915535024602,0.08631361090268101,-217200,-240760,62.066248231475385,43.43680513892468,NaN,NaN,14.868236316111016,0.9301444473318892
1999-07-07T09:30:00-04:00,30.21875,30.25,30.0625,30.0625,20000,7100,63.167869211251535,55.564384656931445,NaN,NaN,139.94710351893286,179.25040309896133,0.2277766440033623,0.3710344159068839,0.1432577719035216,-237200,-236340,64.72310770419932,45.80319247955809,NaN,NaN,16.697021470177983,3.1825554505956166
1999-07-08T09:30:00-04:00,29.71875,30.125,29.71875,29.8125,4200,7065,59.385864826448774,56.45756517664764,NaN,NaN,99.94141775778901,164.0295809319246,0.18591396363024384,0.3756502264413264,0.18973626281108255,-241400,-235020,65.5002404336284,48.08605027475788,NaN,NaN,17.117086144255598,5.173202692547043
1999-07-09T09:30:00-04:00,29.84375,30,29.8125,29.8125,16800,7515,59.38586482644878,57.19686891096989,NaN,NaN,86.49259542891717,143.10564110898068,0.14819954011492095,0.37498568795473375,0.2267861478398128,-241400,-234280,65.95306026093135,50.16089164889867,NaN,NaN,17.45668866517474,6.9279864029224285
1999-07-12T09:30:00-04:00,29.84375,29.84375,29.60937,29.625,4600,7615,56.44624294565259,57.31582742457526,NaN,NaN,62.309573657802986,116.7418615780509,0.1027586273383585,0.35523443201276095,0.25247580467440245,-246000,-236640,63.1082050936094,51.758380380273096,NaN,NaN,16.92151973659031,8.35563402201784
1999-07-13T09:30:00-04:00,29.59375,29.625,29.34375,29.40625,31200,9110,53.14124220606733,57.369095399413524,NaN,NaN,35.848642735043995,84.90786661969722,0.05262847882317895,0.31826140320337615,0.2656329243801972,-277200,-248640,51.0501748305184,52.21063850835935,NaN,NaN,15.524079009162147,9.379697591609883
1999-07-14T09:30:00-04:00,29.5,29.625,29.40625,29.46875,20900,9910,53.97049972753016,57.82677070788151,NaN,NaN,33.72676622667375,63.66379916124538,0.02001588041377017,0.2906527748974099,0.27063689448363976,-256300,-252460,47.9118337982535,52.452360334635536,NaN,NaN,14.577438342516336,10.12223198459652
1999-07-15T09:30:00-04:00,29.84375,29.96875,29.71875,29.85937,108400,14340,58.86964429360147,58.68551774283731,NaN,NaN,62.65409665154597,56.20633493999677,0.020986780949295514,0.2968703706702591,0.2758835897209636,-147900,-233760,60.66116321061505,53.64698642976497,NaN,NaN,15.098744205070872,10.83316230180714
1999-07-16T09:30:00-04:00,29.9375,30.03125,29.8125,30.03125,2800,14320,60.84448680825059,59.76474992311502,NaN,NaN,68.29641577061027,52.567099008335376,0.02894896289015375,0.3120697933336558,0.28312083044350206,-145100,-214500,69.06074230086969,55.55144617149154,NaN,NaN,16.099675194021902,11.58552128640925
1999-07-19T09:30:00-04:00,30.0625,30.0625,29.8125,29.96875,6100,14370,59.72158778508886,60.26082093733716,NaN,NaN,62.77089835649787,52.659363948074336,0.025852189250243407,0.31543606700630633,0.2895838777560629,-151200,-195540,74.77150470619713,57.99810695046656,NaN,NaN,16.628325327775475,12.305921863747281
1999-07-20T09:30:00-04:00,29.75,29.8125,29.1875,29.1875,22700,15270,47.83713193237129,59.536487543025046,NaN,NaN,-4.391185135859167,44.611398373893714,-0.029941653746349384,0.2521568105731262,0.2820984643194756,-173900,-174880,79.26313472519392,60.78490410260315,NaN,NaN,13.39295278182073,12.461211994900632
1999-07-21T09:30:00-04:00,29.375,29.39062,28.90625,28.90625,8800,15570,44.410841726588984,58.20402782144618,NaN,NaN,-48.455939208620194,28.174857286834946,-0.08386311846469774,0.17726956623860346,0.2611326847033012,-182700,-160160,81.7554751448417,63.513211609434734,NaN,NaN,9.573634776112451,12.048700963645178
1999-07-22T09:30:00-04:00,28.875,29,28.4375,28.53125,10700,15845,40.269347816227956,56.48354044792127,NaN,NaN,-106.91815136330693,-5.739592316135633,-0.1395761254428657,0.08666252789971907,0.22623865334258478,-193400,-169260,75.69831917532498,65.45774286157743,NaN,NaN,4.946434571216319,11.034091479012485
1999-07-23T09:30:00-04:00,28.53125,28.53125,28.3125,28.3125,1500,15625,38.04081364701618,54.511519251368455,NaN,NaN,-148.70143093133024,-49.13916165652373,-0.183201836319629,-0.002763642056951454,0.18043819426267754,-194900,-179220,69.61864756733391,66.51013265592802,NaN,NaN,0.40908447145981114,9.51623333507639
1999-07-26T09:30:00-04:00,28.15625,28.65625,28.15625,28.46875,30200,17075,40.57070531660568,52.575867362082185,NaN,NaN,-147.69489582977704,-91.23232049377872,-0.19261535434312688,-0.06033099866623104,0.13228435567689584,-164700,-181920,68.02371135900549,66.9356657364659,NaN,NaN,-2.560650509159374,7.7909642144712805
1999-07-27T09:30:00-04:00,28.75,28.75,28.40625,28.625,26000,18260,43.07388733499459,51.140582942349546,NaN,NaN,-124.03686582351861,-115.1614566313106,-0.17965285116199364,-0.09228170827559623,0.08737114288639741,-138700,-174880,69.95640581427227,67.30947274432825,NaN,NaN,-4.2905932727642995,6.065027430580484
1999-07-28T09:30:00-04:00,28.4375,28.65625,28.3125,28.53125,2400,17970,41.93263944391806,49.89392398645449,NaN,NaN,-123.50177906906897,-130.17062460340037,-0.1688899579882221,-0.12374130459888022,0.04514865338934188,-141100,-166560,72.1024403676525,67.7810584539014,NaN,NaN,-6.05015578699029,4.334286970927517
1999-07-29T09:30:00-04:00,28.3125,28.3125,27.6875,28.09375,7100,17760,37.00521156823372,48.29530589658198,NaN,NaN,-149.98403617527882,-138.78380156579473,-0.18162233395868693,-0.18187926405901678,-0.00025693010032985103,-148200,-157520,74.2543245852994,68.37400590564197,NaN,NaN,-9.137402901470093,2.409759846299287
1999-07-30T09:30:00-04:00,27.84375,27.84375,27.4375,27.5625,15200,18375,32.07623226209992,46.55459084775679,NaN,NaN,-160.4283387398885,-141.1291831275064,-0.21398258920752194,-0.2677351666097323,-0.053752577402210344,-163400,-151220,75.66320113643452,69.27079133727234,NaN,NaN,-13.517605147550563,0.13442199003502298
1999-08-02T09:30:00-04:00,27.65625,27.84375,27.35937,27.35937,157800,25720,30.408417798600325,44.930817675794856,NaN,NaN,-144.45164761790184,-140.48053348513136,-0.23552127942301726,-0.3481541766809819,-0.11263289725796466,-321200,-182520,58.52703555247495,69.80485281741208,NaN,NaN,-17.650770239894133,-2.4063197570977133
1999-08-03T09:30:00-04:00,27.5625,27.5625,27,27.01562,10700,25405,27.77637318494014,43.05980863703843,NaN,NaN,-150.5264273845848,-145.7784457973446,-0.25758536784125197,-0.4346146070595296,-0.17702923921827765,-331900,-221160,44.98283861123818,69.59563887548242,NaN,NaN,-22.024162899165937,-5.208868777393174
1999-08-04T09:30:00-04:00,27.09375,27.09375,26.46875,26.46875,3800,24595,24.189238412252067,40.582636788370614,NaN,NaN,-167.0947620795093,-154.49704239943267,-0.2911976844174153,-0.5410263447400467,-0.24982866032263146,-335700,-260080,35.956783761181256,67.83104034338001,NaN,NaN,-27.09387762068085,-8.335298612148556
1999-08-05T09:30:00-04:00,26.28125,26.28125,25.8125,26.23437,49400,26855,22.828511766976433,37.86720999970817,NaN,NaN,-182.62850380136436,-161.0259359246498,-0.309680113307567,-0.6369288019570902,-0.3272486886495232,-385100,-307460,28.467949686945815,64.93155515667117,NaN,NaN,-31.67164966278719,-11.669063047954074
1999-08-06T09:30:00-04:00,26.0625,26.26562,25.84375,26.03125,13000,26665,21.689781927924628,35.15065243848216,NaN,NaN,-160.9535153954339,-161.13097125575885,-0.3150097784565581,-0.7210109117202208,-0.4060011332636627,-398100,-354400,23.292167546703354,61.25445964527874,NaN,NaN,-35.7785973346993,-15.11328223177482
1999-08-09T09:30:00-04:00,26.125,26.125,25.5625,25.6875,1700,26520,19.882260085898082,33.15387587801978,NaN,NaN,-149.44112146660635,-162.12886602549975,-0.3200728633076511,-0.8060922123982266,-0.4860193490905755,-399800,-370120,21.858853623183535,57.154153852278,NaN,NaN,-39.84405683582895,-18.646250032353983
1999-08-10T09:30:00-04:00,25.54687,25.75,25.15625,25.6875,6800,25300,19.882260085898082,31.401834332256147,NaN,NaN,-141.2141705629403,-160.26641466117084,-0.30203661278141025,-0.8635651150673382,-0.561528502285928,-399800,-383700,20.675229868430478,52.7912791896772,NaN,NaN,-43.060528350536636,-22.134004077808648
1999-08-11T09:30:00-04:00,26.125,26.28125,26.10937,26.25,3000,24405,30.822838714223067,30.72708368211294,NaN,NaN,-90.95446213190142,-145.03835467164927,-0.23388179797153408,-0.8538807497503456,-0.6199989517788115,-396800,-395920,19.64441311407529,48.78742875673079,NaN,NaN,-42.50065001582069,-25.043524926096083
1999-08-12T09:30:00-04:00,26.5625,26.78125,26.5625,26.5625,5200,19245,36.0477576536487,30.584722539729547,NaN,NaN,-60.906565252257245,-120.69396696182784,-0.15330777806686036,-0.8116336743623869,-0.6583258962955265,-391600,-397220,19.532841586396174,45.20987118666381,NaN,NaN,-40.35432460544157,-27.230782023145437
1999-08-13T09:30:00-04:00,26.875,27.09375,26.875,27.09375,8200,19515,43.81663354219856,30.816574555843328,NaN,NaN,-33.34121970658877,-95.17150782405884,-0.05486393087710417,-0.7269058098919068,-0.6720418790148026,-383400,-394280,20.630722934903744,41.82465772779941,NaN,NaN,-35.867684761658666,-28.46462527150447
1999-08-16T09:30:00-04:00,27.0625,27.46875,26.96875,27.46875,11900,19805,48.5663407444508,31.208892656518767,NaN,NaN,-9.054765096409666,-67.0942365500195,0.039773324743217264,-0.622325223085781,-0.6620985478289982,-371500,-388620,22.814098800120078,38.457350083931395,NaN,NaN,-30.514035271781577,-28.757398128686916
1999-08-17T09:30:00-04:00,27.6875,27.6875,27.25,27.40625,24100,19875,47.840422816471815,31.63087718312975,NaN,NaN,8.247667752203796,-37.20186888699067,0.09905276182084444,-0.5382825955529427,-0.6373353573737871,-395600,-387780,23.151974015221086,34.960888201614864,NaN,NaN,-26.5083265984533,-28.436102195796398
1999-08-18T09:30:00-04:00,27.375,27.59375,27.3125,27.3125,3900,19630,46.712546124593764,32.32425822286976,NaN,NaN,12.465114215246102,-16.51795361756115,0.1308430139096497,-0.47378158998672504,-0.6046246038963747,-399500,-388320,23.08202342383413,31.305723832938774,NaN,NaN,-23.586261538376974,-27.74326781616505
1999-08-19T09:30:00-04:00,27.15625,27.15625,26.85937,27.07812,5400,19365,43.924455077791514,33.170559852562015,NaN,NaN,-12.67133901445578,-6.8709083700008575,0.13446418409787864,-0.43654437377402644,-0.5710085578719051,-404900,-390980,22.717903721495688,27.523916874728858,NaN,NaN,-21.920465328159484,-26.911438889307114
1999-08-20T09:30:00-04:00,27.34375,27.375,27.26562,27.375,2200,19400,48.146263692428874,34.43754884497834,NaN,NaN,20.550303878948633,3.9073963471066167,0.15383699275656615,-0.37871231692619745,-0.5325493096827636,-402700,-394840,22.1713255149822,24.927080443479372,NaN,NaN,-19.215297690578165,-25.81199014663155
1999-08-23T09:30:00-04:00,27.73437,27.84375,27.67187,27.8125,9100,18345,53.68064800380222,36.287854189182774,NaN,NaN,67.90734095412219,19.299817557212982,0.1906904828681769,-0.2941862060975424,-0.48487668896571934,-393600,-399260,21.532477275684712,23.252054633796984,NaN,NaN,-15.09388440447841,-24.280832183466817
1999-08-24T09:30:00-04:00,27.875,27.96875,27.59375,27.78125,8600,17475,53.24351597043276,38.363159729052825,NaN,NaN,76.59026244159796,32.96833649509181,0.20621945251054352,-0.2271023733275399,-0.43332182583808343,-402200,-400580,21.334766525598624,22.207624831255373,NaN,NaN,-11.910741699878196,-22.513676400097015
1999-08-25T09:30:00-04:00,27.625,28.0625,27.5,28.0625,3000,17505,56.66387832691356,40.77997162619119,NaN,NaN,93.51854324983724,49.17902230201004,0.22704157569518052,-0.1495198562191078,-0.3765614319142883,-399200,-400520,21.370108106079556,21.70063614690778,NaN,NaN,-8.142249962593423,-20.460615480453644
1999-08-26T09:30:00-04:00,28,28,27.46875,27.51562,20100,18155,49.13687664821908,42.74047839192651,NaN,NaN,73.8161909169788,66.47652828829696,0.1967230192563067,-0.13065765784390493,-0.3273806771002116,-419300,-403400,20.885081866701853,21.528701455479098,NaN,NaN,-7.074580530238796,-18.548324773280093
1999-08-27T09:30:00-04:00,27.53125,27.53125,27.1875,27.40625,3800,17585,47.770206556938106,44.73247456842937,NaN,NaN,43.86015025662497,71.13849756383222,0.1634123189595893,-0.123115278400725,-0.2865275973603143,-423100,-407480,20.186104068235252,21.409219344411362,NaN,NaN,-6.620886489861711,-16.844405018506038
1999-08-30T09:30:00-04:00,27.1875,27.20312,26.8125,26.8125,6200,10005,41.08877623826607,46.24722572216994,NaN,NaN,-1.7621582209249702,57.2045977288228,0.09868795308328993,-0.16316765600620187,-0.2618556090894918,-429300,-414620,18.98842910992518,21.2887335759467,NaN,NaN,-8.373733434056811,-15.634309077870434
1999-08-31T09:30:00-04:00,26.4375,26.5,26.09375,26.5,4300,9685,38.07067383970989,46.76492823113328,NaN,NaN,-61.709985306351676,29.544548179232873,0.035390856557840356,-0.21761703839219138,-0.25300789495003173,-433600,-420900,17.97807025984254,21.169709086358644,NaN,NaN,-10.817942090001496,-14.946256651032014
1999-09-01T09:30:00-04:00,26.64062,26.6875,26.53125,26.53125,1100,9550,38.55671147452436,46.944139218338684,NaN,NaN,-36.37982025121824,3.564875479021778,-0.0018368577795448426,-0.2553039671744628,-0.25346710939491796,-432500,-427560,16.948139763208914,20.985087527559557,NaN,NaN,-12.611899824774186,-14.612777104423753
1999-09-02T09:30:00-04:00,26,26.25,26,26.21875,22200,8190,35.55187566635044,46.35379937006382,NaN,NaN,-84.34778004888072,-28.06791871415013,-0.04270638547475064,-0.30685009123835627,-0.26414370576360563,-454700,-434640,15.905000609846056,20.647535932912575,NaN,NaN,-15.07546423743088,-14.678875266281914
1999-09-03T09:30:00-04:00,26.84375,26.9375,26.65625,26.9375,5000,7790,45.97963086944229,46.16903437899178,NaN,NaN,-13.297430307715755,-39.49943482701827,-0.017806780750441176,-0.2864021817016571,-0.2685954009512159,-449700,-439960,15.15041619467894,20.100130032523918,NaN,NaN,-13.906524152882236,-14.568539392939103
1999-09-07T09:30:00-04:00,26.625,26.8125,26.48437,26.51562,32700,9340,41.713332766922896,45.73138508973828,NaN,NaN,-51.271867173240835,-49.401376617481446,-0.025741393034770077,-0.3007721422446785,-0.27503074920990844,-482400,-450580,13.748192465183749,19.428431350378393,NaN,NaN,-14.346386016072021,-14.536803196243806
1999-09-08T09:30:00-04:00,26.23437,26.54687,26.23437,26.375,6500,9325,40.36879099251297,45.27825972316108,NaN,NaN,-93.8880144945085,-55.83698245511281,-0.03583188498132517,-0.3198206054365649,-0.2839887204552397,-488900,-461640,12.45530045719643,18.669379709904273,NaN,NaN,-15.126712270135936,-14.62107592108554
1999-09-09T09:30:00-04:00,26.625,26.625,26.375,26.46875,5600,9455,41.71758556909322,45.1206261868255,NaN,NaN,-83.10189652068549,-65.18139770900625,-0.031706066289386325,-0.3236213033169726,-0.29191523702758626,-483300,-471800,11.39516685399164,17.860612790796843,NaN,NaN,-15.345882726151816,-14.724619750380722
1999-09-10T09:30:00-04:00,26.89062,27.04687,26.79687,26.96875,18700,10130,48.418711702014775,45.14008675893877,NaN,NaN,-19.633898002264694,-52.238621299683054,0.007112168726113921,-0.28302502611994385,-0.29013719484605777,-464600,-473780,11.195183533221837,17.076602649242528,NaN,NaN,-13.418009493513678,-14.537961142256858
1999-09-13T09:30:00-04:00,26.84375,26.89062,26.76562,26.89062,1200,9780,47.49967387084894,44.69858860658496,NaN,NaN,-31.281638406694245,-55.83546291947876,0.02872890611174389,-0.2542260622063779,-0.2829549683181218,-465800,-477000,10.861348283579616,16.31437914980645,NaN,NaN,-12.142822439680199,-14.195798470460192
1999-09-14T09:30:00-04:00,26.67187,26.85937,26.67187,26.75,1600,9265,45.81415435056434,44.167919919451506,NaN,NaN,-40.74600983955089,-53.73029145274076,0.03437744813738769,-0.23998315814638715,-0.27436060628377484,-467400,-474000,13.450836362179345,15.751241280990788,NaN,NaN,-11.576809849553662,-13.821657238902116
1999-09-15T09:30:00-04:00,26.84375,26.9375,26.51562,26.51562,2800,8200,43.07078616805677,43.19698476524745,NaN,NaN,-51.66889547021949,-45.28646764788296,0.0236594314422916,-0.24478631698091036,-0.26844574842320196,-470200,-470260,16.699685370485213,15.417639657019764,NaN,NaN,-11.892386225570792,-13.546047094140498
1999-09-16T09:30:00-04:00,26.07812,26.07812,25.67187,25.95312,11400,8575,37.29833200062623,42.35137443327653,NaN,NaN,-151.04324280728966,-58.87473690520379,-0.017748747522110198,-0.29063168282583973,-0.27288293530372953,-481600,-469920,17.004694037898375,15.140469097819514,NaN,NaN,-13.984616446586436,-13.608699858775632
1999-09-17T09:30:00-04:00,26.0625,26.34375,26.0625,26.28125,2000,8405,42.167530990791136,41.95118332140889,NaN,NaN,-92.00740782390774,-73.3494388695324,-0.01934386155285006,-0.2970627622447921,-0.27771890069194205,-479600,-472920,16.432941794785222,14.872386078287372,NaN,NaN,-14.245913685174482,-13.699730405404038
1999-09-20T09:30:00-04:00,26.20312,26.29687,26.125,26.25,9800,8785,41.83433477288064,42.00443750245279,NaN,NaN,-85.17605473568031,-84.12832213532963,-0.01879200272657222,-0.3012089041001573,-0.2824169013735851,-489400,-477640,15.547220202805732,14.626585442064554,NaN,NaN,-14.553489185276696,-13.821695945385846
1999-09-21T09:30:00-04:00,25.89062,25.90625,25.65625,25.65625,6900,8675,36.011881786406036,41.8573809272168,NaN,NaN,-142.9031223195251,-104.55974463132445,-0.0527779973808592,-0.3483893980996591,-0.2956114007187999,-496300,-483420,14.515450086858053,14.37925542970852,NaN,NaN,-16.679758394812072,-14.229990581018164
1999-09-22T09:30:00-04:00,25.79687,25.9375,25.75,25.9375,13300,8910,40.25375177802485,41.978598091752545,NaN,NaN,-115.99283470300578,-117.42453247788171,-0.05066929991600205,-0.35894802561380246,-0.3082787256978004,-483000,-485980,14.070077487320646,14.173679552859356,NaN,NaN,-17.13397483178712,-14.644845473985159
1999-09-23T09:30:00-04:00,26.01562,26.07812,25.82812,26.0625,6000,9060,42.091157501081014,42.445689651376156,NaN,NaN,-91.40747840863571,-105.49737959815093,-0.03590371449447194,-0.35315836881589036,-0.3172546543214184,-477000,-485060,15.078501508474304,14.114643902761376,NaN,NaN,-16.95011130462584,-14.974169164076685
1999-09-24T09:30:00-04:00,25.59375,25.8125,25.53125,25.53125,6900,8400,36.89758727947403,41.796972252092715,NaN,NaN,-141.51707205185102,-115.39931244373959,-0.05577758334557509,-0.3869766335033873,-0.3311990501578122,-483900,-485920,14.902445195413975,14.096931688528164,NaN,NaN,-18.432206841899852,-15.468174546622851
1999-09-27T09:30:00-04:00,25.95312,26.01562,25.84375,25.96875,4100,8415,43.121804572432154,41.897577381057665,NaN,NaN,-78.2482647685014,-114.01375445030381,-0.03437047979337937,-0.37416214989953644,-0.3397916701061571,-479800,-484000,17.2261139829901,14.345354654085758,NaN,NaN,-17.694198885970565,-15.786178023672525
1999-09-28T09:30:00-04:00,25.79687,25.89062,25.34375,25.89062,8500,8530,42.31902033460258,42.036879476921214,NaN,NaN,-110.0984251906737,-107.45281502453352,-0.02103942294431682,-0.3660909487865531,-0.3450515258422363,-488300,-482400,19.205997784229623,14.827547320302417,NaN,NaN,-17.350663384428326,-16.009675932351925
1999-09-29T09:30:00-04:00,25.73437,25.8125,25.70312,25.70312,1700,8400,40.37635858288184,41.941077549334686,NaN,NaN,-92.83201816892068,-102.82065171771649,-0.020400896529316204,-0.37055264650388153,-0.35015174997456533,-490000,-483800,18.782651268922976,15.355224778511797,NaN,NaN,-17.646307425179256,-16.243480431327256
1999-09-30T09:30:00-04:00,25.78125,26.3125,25.78125,26.07812,75900,12140,45.74108262750468,41.749818329726814,NaN,NaN,-32.66568148648659,-91.07229233328667,0.008192658762300797,-0.3399109265216893,-0.3481035852839901,-414100,-471220,33.060936023345675,16.91706424209207,NaN,NaN,-16.2608666701142,-16.24596417972539
1999-10-01T09:30:00-04:00,26.21875,26.34375,26.04687,26.21875,1600,11110,47.64360604145294,41.760099199055674,NaN,NaN,-6.423077380884088,-64.05349339909328,0.03783334456240928,-0.3008119045809785,-0.3386452491433878,-412500,-456940,44.90210295348933,19.348546718514196,NaN,NaN,-14.552204105314251,-16.003998454809512
1999-10-04T09:30:00-04:00,26.5625,27.07812,26.5625,27.0625,6100,11165,57.31437528237074,42.58154355132756,NaN,NaN,120.37065231654587,-24.32970998208382,0.11136178368871691,-0.19944301953249166,-0.31080480322120857,-406400,-442260,53.92529087026171,22.23957918337722,NaN,NaN,-9.691243280061439,-15.102176286988358
1999-10-05T09:30:00-04:00,27.34375,27.59375,26.85937,27.10937,7900,9925,57.78089092338476,43.63226531956526,NaN,NaN,152.6694630787794,28.22386767180679,0.1574348980996112,-0.11401118059669457,-0.27144607869630577,-398500,-424300,62.10242869441556,25.482632277943676,NaN,NaN,-5.724802846433468,-13.762551509766231
1999-10-06T09:30:00-04:00,27.17187,27.59375,26.95312,27.40625,8600,10030,60.71001081214663,45.30452809181673,NaN,NaN,146.17102321198465,76.02447594798785,0.19948054623975953,-0.022095395896606362,-0.2215759421363659,-389900,-404280,68.75843747802898,29.179328237952994,NaN,NaN,-1.4612134223853501,-12.005217497283247
1999-10-07T09:30:00-04:00,27.5,27.60937,27.32812,27.32812,3900,9945,59.53929010026141,46.54536802820746,NaN,NaN,137.7031130277608,110.09823485083734,0.21241083556983895,0.0439376023259328,-0.16847323324390615,-393800,-400220,69.91251514298273,32.99929776282424,NaN,NaN,1.648147577063799,-10.054736772376527
1999-10-08T09:30:00-04:00,27.90625,28.10937,27.78125,28.10937,78400,12930,66.49656570740376,48.30695595210197,NaN,NaN,183.2069239172229,148.02423511045873,0.2607738515940906,0.15749408124870712,-0.10327977034538348,-315400,-380800,74.7225053485004,37.226103844659576,NaN,NaN,6.867718241674413,-7.637243198940679
1999-10-11T09:30:00-04:00,27.25,28.39062,27.25,28.3125,106700,18205,68.03557528873606,50.59436263083983,NaN,NaN,156.3478565310424,155.21967595335803,0.2913215208849997,0.2608721307608661,-0.030449390124133557,-208700,-341260,81.28333651717516,41.99523858968223,NaN,NaN,11.602915100667424,-4.888649156139522
1999-10-12T09:30:00-04:00,28,28,27.73437,27.73437,14800,18865,59.63872402024191,51.979003505283906,NaN,NaN,122.07020667835518,149.0998246732732,0.25857934797364,0.29277479484291646,0.03419544686927645,-223500,-306260,84.9957421066435,47.06135749106243,NaN,NaN,12.993336688527604,-2.3340797497585037
1999-10-13T09:30:00-04:00,27.625,27.75,27.40625,27.40625,5200,18985,55.4554482108873,52.9335956988415,NaN,NaN,83.44777051802807,136.5551741344819,0.20325042639758503,0.28825847986625774,0.08500805346867271,-228700,-274020,87.46260953048228,52.23165092120586,NaN,NaN,12.769395077856643,-0.17644048867062567
1999-10-14T09:30:00-04:00,26.75,27.10937,26.625,27.01562,7400,18785,50.87981451453834,53.93232621563181,NaN,NaN,26.37729620820392,114.29001077057049,0.13221251083192315,0.25027369200857663,0.1180611811766535,-236100,-242480,89.31363586518742,57.54673596904682,NaN,NaN,11.074745971208767,1.430871862740716
1999-10-15T09:30:00-04:00,26.5,26.65625,26.32812,26.32812,5500,18960,43.99897564819884,53.99498129247229,NaN,NaN,-17.41672803702474,74.16528037972095,0.0358055381723259,0.16281810389206086,0.12701256571973496,-241600,-227720,90.05371109280631,62.74870719117655,NaN,NaN,7.197473370684591,2.2546720781612697
1999-10-18T09:30:00-04:00,26.29687,26.5,25.90625,26.5,8700,18905,45.966395870074784,54.25550811643458,NaN,NaN,-30.117399443387473,36.87222918483498,-0.016686439314242033,0.10615451657693242,0.12284095589117446,-232900,-232560,87.90391241523487,67.65570109339122,NaN,NaN,4.763958646976449,2.6131415879920095
1999-10-19T09:30:00-04:00,26.84375,27.15625,26.67187,26.76562,5200,18820,48.951141375917956,54.867992601651444,NaN,NaN,16.47514475493306,15.753216800150554,-0.032881332825678705,0.08173928985907608,0.11462062268475479,-227700,-233400,87.51344073283875,72.56504319795663,NaN,NaN,3.7135911516366615,2.770348668512674
1999-10-20T09:30:00-04:00,26.73437,27.23437,26.70312,27.23437,47600,20535,53.801121865931265,55.44370969011048,NaN,NaN,30.37300203222782,5.138263102990494,-0.012438728954212025,0.09907221149198975,0.11151094044620177,-180100,-223680,88.16837454739712,76.50128880681744,NaN,NaN,4.3783617264421615,3.000064819645458
1999-10-21T09:30:00-04:00,26.78125,27,26.73437,27,1500,20310,51.18279778641599,55.696509100464986,NaN,NaN,12.105896654183192,2.2839831921863483,-0.014947211988248887,0.09282692546089066,0.10777413744913955,-181600,-212780,88.87318206733782,79.64208017209232,NaN,NaN,4.097316320759982,3.15681503409039
1999-10-22T09:30:00-04:00,27.32812,27.79687,27.28125,27.70312,4600,20195,57.815586963260166,55.732309934814225,NaN,NaN,78.99376821642366,21.566082442876034,0.02815299653955039,0.14296538312357754,0.11481238658402715,-177000,-199860,89.65948346671546,82.19452250041046,NaN,NaN,6.048554490172947,3.5699206706736124
1999-10-25T09:30:00-04:00,27.15625,27.46875,27.15625,27.21875,2500,20115,52.52147977461774,55.3566377099023,NaN,NaN,38.25576221979198,35.240714775511925,0.02173346121966553,0.14197921310860906,0.12024575188894353,-179500,-189180,90.27149233407792,84.20659847467206,NaN,NaN,5.918363870466361,3.9054125563582907
1999-10-26T09:30:00-04:00,27.3125,27.3125,26.29687,26.54687,19100,20645,46.20166208056885,54.32032708621817,NaN,NaN,-38.5749767153055,24.230690481464215,-0.027403552634640102,0.0859913110956434,0.1133948637302835,-198600,-183360,90.59805723108899,85.76657131417633,NaN,NaN,3.619318304272396,3.8645419489174486
1999-10-27T09:30:00-04:00,26.5,26.625,26.21875,26.625,15200,21320,47.00030339784095,53.42468517890243,NaN,NaN,-79.540975478607,2.2478949792972513,-0.05281286671841928,0.047378780332259396,0.10019164705067868,-183400,-184020,90.22816854226092,87.21768941412479,NaN,NaN,2.0890836957893977,3.610905055613441
1999-10-28T09:30:00-04:00,27.125,27.75,27.125,27.625,11200,18085,56.00300387440756,52.67514504797413,NaN,NaN,57.148804943392086,11.25647663713903,-0.0030661590870097594,0.09635894819191648,0.09942510727892624,-172200,-182140,90.34903931799963,88.33387041194615,NaN,NaN,3.84081586372433,3.64374945677214
1999-10-29T09:30:00-04:00,28.625,29.0625,28.39062,28.39062,12300,18620,61.407992031987796,52.20174624392069,NaN,NaN,197.37806236594022,34.93333546704234,0.0762284866760034,0.1947107156239305,0.11848222894792709,-159900,-178720,90.57737315477256,88.99773017177453,NaN,NaN,7.273318900775634,4.162259377344068
1999-11-01T09:30:00-05:00,28.5,28.625,28.1875,28.1875,12700,18950,59.32571363716928,52.1793883594155,NaN,NaN,136.72107503889802,54.62639803086355,0.10788998747483905,0.2533447132914759,0.14545472581663685,-172600,-177340,90.67326179899311,89.40326729265666,NaN,NaN,9.234956850007828,4.8869304448674615
1999-11-02T09:30:00-05:00,28.04687,28.54687,27.98437,27.98437,3300,18720,57.23552430971187,52.30653665218868,NaN,NaN,101.10646909577152,82.56268719307896,0.10778966634547454,0.28019180874848004,0.1724021424030055,-175900,-172800,90.99782846869549,89.65578293110046,NaN,NaN,10.119501923906556,5.634440656158761
1999-11-03T09:30:00-05:00,28.0625,28.09375,27.75,27.75,3100,18445,54.834962776452876,52.589047242325435,NaN,NaN,57.1269970750514,109.89628170381063,0.08554757128876198,0.279336606513958,0.193789035225196,-179000,-171920,91.06275011682301,89.78071966336014,NaN,NaN,10.089133214299427,6.270825307321713
1999-11-04T09:30:00-05:00,27.9375,28.125,27.9375,28.09375,18600,19180,57.641150395441876,53.56348829569994,NaN,NaN,72.21745294106073,112.91001130334436,0.08729269625483044,0.30290490554373406,0.21561220928890362,-160400,-169560,91.24510080912415,89.86581892881142,NaN,NaN,10.927032972084751,6.93599783085929
1999-11-05T09:30:00-05:00,28.35937,28.5,28.20312,28.28125,7000,15610,59.132686165873025,54.50393760254268,NaN,NaN,99.4455664144069,93.3235121130377,0.09381059600332481,0.33287545429305965,0.23906485828973484,-153400,-168260,91.3498005649359,90.11195379664721,NaN,NaN,12.059980176734415,7.6679953088414505
1999-11-08T09:30:00-05:00,28.21875,28.375,28.1875,28.1875,2500,10400,58.032377415632844,55.15259731966517,NaN,NaN,87.47768200091113,83.47483350544033,0.08481576817335285,0.3450845685064259,0.26026880033307304,-155900,-164920,91.62685859534956,90.40576935825513,NaN,NaN,12.673635723258286,8.383086796615284
1999-11-09T09:30:00-05:00,28.0625,28.0625,27.78125,27.89062,11900,10255,54.569543758080854,55.20748459767585,NaN,NaN,49.57691246388557,73.16892217906313,0.0534127926233563,0.3270347911122684,0.2736219984889121,-167800,-163300,91.76463682785307,90.66264523543056,NaN,NaN,12.210934793827377,8.92992222478844
1999-11-10T09:30:00-05:00,28.07812,28.20312,28,28,7500,10370,55.6202652855341,55.52444656189857,NaN,NaN,61.15106298219352,73.97373536049156,0.035415845613574415,0.31789180550588014,0.28247595989230573,-160300,-159560,92.08830714503569,90.89229702669469,NaN,NaN,12.11425377799709,9.384826732389676
1999-11-11T09:30:00-05:00,28.0625,28.21875,28.03125,28.0625,5700,10285,56.243016649382724,55.41212011090733,NaN,NaN,59.20815707150254,71.37187618657993,0.02369247531985097,0.3120915540421194,0.28839907872226844,-154600,-158400,92.1908242619888,91.07310708349993,NaN,NaN,12.198870400860368,9.786832970742632
1999-11-12T09:30:00-05:00,28.5625,28.71875,28.21875,28.71875,7900,10405,62.235272203567924,56.10596242726091,NaN,NaN,98.48173587890291,71.17911007947913,0.05435355776310996,0.3563410259261559,0.30198746816304595,-146700,-157060,92.31470927163377,91.2190511504682,NaN,NaN,14.010032485622029,10.390147187153975
1999-11-15T09:30:00-05:00,28.46875,29.03125,28.46875,28.76562,6200,10280,62.628903045680204,57.27933678191173,NaN,NaN,114.0588268768752,76.49533905467193,0.07095999872195385,0.39068746656548825,0.3197274678435344,-140500,-153980,92.60509596189696,91.36241105981163,NaN,NaN,15.60820529051583,11.135584059062811
1999-11-16T09:30:00-05:00,28.875,29.125,28.6875,28.89062,5100,10275,63.71514821211496,58.47325426864558,NaN,NaN,123.12869306298757,91.20569517449233,0.08271106748936785,0.4231163022052442,0.34040523471587636,-135400,-147500,93.18825097900829,91.57384551957931,NaN,NaN,17.25566093123822,12.00988075508787
1999-11-17T09:30:00-05:00,28.96875,29.09375,28.625,28.64062,13500,8570,59.961291684046984,58.75598911219125,NaN,NaN,102.03029786032985,99.3815421501196,0.06668273340371317,0.42375865147051783,0.35707591806680467,-148900,-145220,93.3858876659103,91.79076325871578,NaN,NaN,17.67428066041954,12.819080741563823
1999-11-18T09:30:00-05:00,28.82812,28.82812,28.60937,28.76562,2200,8605,61.19242797134391,58.740591679288116,NaN,NaN,91.28472552693627,105.79685584120634,0.05786268003822681,0.4294042681145882,0.3715415880763614,-146700,-143640,93.52606701838587,92.00138424897388,NaN,NaN,18.358988637503764,13.610496155269528
1999-11-19T09:30:00-05:00,28.67187,28.71875,28.45312,28.5,14700,9110,57.16964146098971,58.58658652384672,NaN,NaN,62.340722023456685,98.5686530701171,0.02896266255972374,0.40774491627601606,0.3787822537162923,-161400,-146580,89.71579215406523,91.93299356005046,NaN,NaN,17.869474560238245,14.218921641693631
1999-11-22T09:30:00-05:00,28.125,28.21875,28.09375,28.17187,2100,9090,52.571819430278495,58.253464746744335,NaN,NaN,2.819527201435872,76.32079313502922,-0.015063354671790319,0.3599530603765544,0.3750164150483447,-163500,-151180,83.95272579595579,91.42977194056905,NaN,NaN,16.144461448067315,14.493998756889871
1999-11-23T09:30:00-05:00,28.09375,28.125,27.89062,28.0625,10100,8640,51.09673527529264,57.98644849666147,NaN,NaN,-32.51925695637732,45.19120313115627,-0.05226705436731016,0.309682597089207,0.36194965145651714,-173600,-158820,75.30094762027258,90.30392890510117,NaN,NaN,14.282149569390768,14.463734587247142
1999-11-24T09:30:00-05:00,28,28.28125,27.95312,28.21875,4200,8090,53.12046978964263,57.66354273910438,NaN,NaN,-31.746103679054972,18.435922823279306,-0.06617400313459204,0.2792321475382771,0.3454061506728691,-169400,-162920,71.0682119794981,88.86272256012788,NaN,NaN,13.220741713729947,14.286164176744686
1999-11-26T09:30:00-05:00,28.21875,28.5625,28.21875,28.5625,6700,7865,57.30634595668194,57.53308986701929,NaN,NaN,27.613822298938054,5.701742177679658,-0.05263333861402136,0.2796144774053424,0.33224781601936376,-162700,-166120,67.86195819015472,87.1850195333578,NaN,NaN,13.431060294045198,14.164006479216187
1999-11-29T09:30:00-05:00,28.46875,28.875,28.46875,28.8125,8900,7695,60.09690786367267,57.68055632759358,NaN,NaN,92.48591218489867,11.730780209968055,-0.02846180979988372,0.2966705537695091,0.32513236356939285,-153800,-164600,68.58691378506468,85.53930918976603,NaN,NaN,14.402176782764627,14.198030808294536
1999-11-30T09:30:00-05:00,28.85937,28.96875,28.40625,28.40625,6900,7405,53.92835161313444,57.634756888668825,NaN,NaN,55.70890805258138,22.30865638019715,-0.04070964434117569,0.27424530814292325,0.31495495248409894,-160700,-164040,68.86556574081153,83.90366125497735,NaN,NaN,13.458500869581805,14.092383674192718
1999-12-01T09:30:00-05:00,28.75,28.85937,28.67187,28.75,8800,7680,57.868995853758086,57.79538050068482,NaN,NaN,84.70340228287586,45.75318822804778,-0.027186345170680748,0.28097202102074803,0.3081583661914288,-151900,-159700,71.0117171849081,82.39819054353966,NaN,NaN,13.815140668490772,14.052777530521011
1999-12-02T09:30:00-05:00,28.625,28.625,28.39062,28.625,157100,15380,55.99347085970869,57.777555801422395,NaN,NaN,30.898281896383665,58.282065343135514,-0.028071679082825707,0.27306876733789665,0.30114044642072235,-309000,-187620,48.060059490012335,79.24599305982706,NaN,NaN,13.563652920963968,13.982902586298577
1999-12-03T09:30:00-05:00,28.89062,29.1875,28.875,28.95312,8800,14890,59.68690551063507,57.59552960907005,NaN,NaN,129.58956579658476,78.67721404266487,-0.008960613538935625,0.2899396794970528,0.2989002930359884,-300200,-215120,35.789978188932295,75.20851226820552,NaN,NaN,14.441104888130832,14.0483600579889
1999-12-06T09:30:00-05:00,28.96875,29.21875,28.75,29,11900,15135,60.200862231669454,57.422098122354996,NaN,NaN,112.7543355822978,82.7308987221447,0.0037543174327365203,0.3035931898269091,0.29983887239417256,-288300,-242020,28.204460812576173,70.6084669003969,NaN,NaN,15.305443197356553,14.22794336361285
1999-12-07T09:30:00-05:00,28.78125,28.90625,28.51562,28.51562,6400,15330,52.72169776281182,56.63685166169048,NaN,NaN,30.018344879859917,77.5927860876004,-0.022118591452323477,0.27219063307876823,0.2943092245310917,-294700,-268820,22.979024495577832,65.59352215158044,NaN,NaN,13.83547987764181,14.171877151331273
1999-12-08T09:30:00-05:00,28.4375,28.6875,28.25,28.35937,11000,15285,50.54043563205093,55.9639333722622,NaN,NaN,-31.33910263721194,54.38428510358284,-0.049830407379642616,0.2320212153065384,0.281851622686181,-305700,-299580,18.69729073474278,60.25862237078275,NaN,NaN,11.96253326833916,13.856256596618113
1999-12-09T09:30:00-05:00,29.23437,29.23437,28.21875,28.3125,18200,15820,49.87385752810852,55.15546405488824,NaN,NaN,4.78464565059365,49.16155785442484,-0.0701481657865412,0.1941664154530045,0.2643145812395457,-323900,-302560,18.340741444705912,54.888241972662755,NaN,NaN,10.236311731731004,13.339121615919955
1999-12-10T09:30:00-05:00,28.9375,29.09375,28.90625,29.09375,16100,16340,59.46949510915644,55.31973931547158,NaN,NaN,128.61855524197176,48.96735574350224,-0.03175781609711498,0.22461731111815197,0.25637512721526695,-307800,-304080,18.150614254890797,49.77644355129315,NaN,NaN,11.624807252016957,13.094219563933812
1999-12-13T09:30:00-05:00,29.375,29.96875,29.375,29.96875,4400,16165,67.07229728983398,56.355487734011255,NaN,NaN,274.2636385068752,81.26921632841773,0.0474724412839983,0.31571567882026486,0.26824323753626655,-303400,-307100,17.756756839583502,45.0481600544094,NaN,NaN,15.646582660127395,13.45884286339004
1999-12-14T09:30:00-05:00,29.90625,30,29.5625,29.57812,20900,16900,61.52378037962253,57.10027667003482,NaN,NaN,209.24580667350986,117.11470868714771,0.0672692314381419,0.35232977683394395,0.28506054539580206,-324300,-313020,16.978973601138293,40.882304767328385,NaN,NaN,16.97184149795271,13.960699811184707
1999-12-15T09:30:00-05:00,29.375,29.73437,29.375,29.71875,800,16685,62.71945510829583,57.78591847851005,NaN,NaN,158.33069435791322,155.04866808617277,0.08252694719365,0.3882192293878646,0.30569228219421457,-323500,-316580,16.510622700371528,36.98533410453363,NaN,NaN,18.40782700130609,14.596003695487761
1999-12-16T09:30:00-05:00,29.9375,30.375,29.85937,30.375,8900,16455,67.75512623703811,58.53225992710692,NaN,NaN,203.57869955001348,194.8074788660567,0.12685739259201845,0.46426402293423763,0.3374066303422192,-314600,-314720,17.786620881208478,33.40852429675176,NaN,NaN,21.422409024019498,15.57120445670658
1999-12-17T09:30:00-05:00,30.34375,30.40625,30.10937,30.1875,857800,59235,65.05148559633687,58.88615833658294,NaN,NaN,167.22528339223516,202.5288244961094,0.1329508989933087,0.5035952540838551,0.3706443550905464,-1172400,-487640,7.029850593372771,29.011591211630908,NaN,NaN,22.911079215605028,16.619757993692073
1999-12-20T09:30:00-05:00,30.03125,30.14062,29.23437,29.3125,880000,102500,54.18524507884008,58.90450786984763,NaN,NaN,73.29983955066704,162.33606470486774,0.07058113526258963,0.4588707741687834,0.3882896389061938,-2052400,-837440,3.033388318720654,24.30929282433871,NaN,NaN,20.348498715773204,17.152435239703664
1999-12-21T09:30:00-05:00,29.3125,29.5,29.28125,29.4375,648500,134820,55.33311945445044,58.72337384132565,NaN,NaN,47.841466883467206,130.05519674685922,0.03222624137629304,0.4285724406265601,0.39634619925026704,-1403900,-1053360,2.201442950913858,19.39427323619626,NaN,NaN,18.75208544170776,17.38095669713282
1999-12-22T09:30:00-05:00,29.46875,29.51562,29.28125,29.5,553500,161990,55.92769824598837,58.718675797488494,NaN,NaN,43.6467806766063,107.11841401059785,0.006871975467714897,0.40493616858491066,0.39806419311719576,-850400,-1158740,1.9240847556493605,16.098846469456042,NaN,NaN,17.686768862584557,17.42464414934021
1999-12-23T09:30:00-05:00,29.59375,30.1875,29.59375,30.07812,177600,170660,61.08752694554829,58.81872018569658,NaN,NaN,97.98078359789373,85.99883082017391,0.02388536502193761,0.42792089939461775,0.40403553437268014,-672800,-1230380,1.7615964671425814,13.668247775042488,NaN,NaN,18.435108335645857,17.568996175955302
1999-12-27T09:30:00-05:00,30.53125,30.5625,30.3125,30.375,1388800,239765,63.453772110655976,59.051070891338476,NaN,NaN,137.82006698262123,80.11778753825112,0.048559590878157366,0.46473502297037683,0.41617543209221947,716000,-852700,33.59840227658695,14.053529308186118,NaN,NaN,19.811313420269556,17.88932721085734
1999-12-28T09:30:00-05:00,30.21875,30.84375,30.21875,30.6875,10600,239850,65.81054050495854,59.985988230063235,NaN,NaN,139.68609899569066,93.39503942725585,0.07762817160042157,0.5132106465927464,0.43558247499232483,726600,-296900,56.13010544439162,16.421463661672814,NaN,NaN,21.703984228469057,18.434278213373297
1999-12-29T09:30:00-05:00,30.60937,30.8125,30.60937,30.8125,1400,239575,66.73462450787424,61.142716006907754,NaN,NaN,140.91498514475063,112.00974307951253,0.09578448351345648,0.5553130793841454,0.45952859587068895,728000,129480,65.73563211862674,19.781345189093095,NaN,NaN,23.51696177858211,19.160375865545983
1999-12-30T09:30:00-05:00,30.53125,30.96875,30.53125,30.71875,2000,239235,65.30889383885977,62.245218600532844,NaN,NaN,125.36270933043124,128.35292881027752,0.09197098669702763,0.5744923292419735,0.48252134254494583,726000,444760,70.82286397826111,23.53006822720418,NaN,NaN,24.58587638946956,19.935447368963636
1999-12-31T09:30:00-05:00,30.96875,31.09375,30.8125,31.0625,19100,232335,68.00779258335257,62.85509699154686,NaN,NaN,135.69472472985356,135.89571703666948,0.10229775663724727,0.6103935383415049,0.5080957817042576,745100,728340,74.49137417567091,27.554408221545618,NaN,NaN,26.310397388106633,20.846154514555494
2000-01-03T09:30:00-05:00,31,31,29.85937,30.125,212900,242540,55.35850540433805,62.01839757115429,NaN,NaN,59.419002466255606,120.21550413339635,0.03894648644712939,0.5567788897631694,0.51783240331604,532200,691580,73.20643980808472,31.51509986215285,NaN,NaN,23.774559678812874,21.264498109449406
2000-01-04T09:30:00-05:00,29.6875,29.8125,29.03125,29.21875,177200,250805,46.378345810212345,60.93658081619642,NaN,NaN,-47.225156441055304,82.83325304604716,-0.06535823857584366,0.43613460509623536,0.501492843672079,355000,617260,70.55655374598894,35.34206987249932,NaN,NaN,18.27551184829914,20.837500072142223
2000-01-05T09:30:00-05:00,29.34375,29.34375,28.71875,28.85937,124600,256715,43.373548245726006,59.554730326012866,NaN,NaN,-92.74227220566561,36.101801575963904,-0.15481503918840672,0.30797404468657064,0.46278908387497736,230400,517740,67.05624391965594,38.9524713881625,NaN,NaN,12.823299657370157,19.692614298603356
2000-01-06T09:30:00-05:00,29.04687,29.40625,29,29.1875,135800,262955,46.764914082616016,58.05542945783986,NaN,NaN,-76.3951995377478,-4.24978019767191,-0.18604783828269855,0.2302292860216042,0.41627712430430275,366200,445780,64.56215122331939,42.29358069831328,NaN,NaN,9.557012811079238,18.244671228957053
2000-01-07T09:30:00-05:00,29.5,30.5625,29.5,30.5625,69400,265515,58.091496462689186,57.55828737686502,NaN,NaN,36.80601722298629,-24.02752169904536,-0.1119168478955671,0.2763810644348439,0.388297912330411,435600,383880,62.411728906462,46.249429149248215,NaN,NaN,10.772628720083839,17.177236584832308
2000-01-10T09:30:00-05:00,30.53125,30.59375,30.15625,30.40625,41900,266805,56.617310818926676,57.73200635829978,NaN,NaN,53.424995621765746,-25.226323067943337,-0.07309766109502724,0.2969258359616269,0.37002349705665416,393700,356180,61.425744608200084,50.42031174135389,NaN,NaN,11.1746770190069,16.319728075428678
2000-01-11T09:30:00-05:00,30.5,30.625,30.09375,30.23437,29600,268065,54.964910977661916,57.705705752814886,NaN,NaN,40.35297814831952,-7.710696150068374,-0.059277060326687725,0.2959271716482945,0.35520423197498224,364100,358000,61.46881635033902,54.65369555559854,NaN,NaN,10.942340734444603,15.551529883859525
2000-01-12T09:30:00-05:00,30.3125,30.3125,29.9375,30.0625,53100,269675,53.29007734718803,57.51730426004343,NaN,NaN,9.279440260968157,12.693646343258386,-0.061713845122339905,0.27806192557205733,0.33977577069439724,311000,374120,61.87487104946612,58.935894576585454,NaN,NaN,10.229002253989016,14.791168793878024
2000-01-13T09:30:00-05:00,30.21875,30.3125,29.95312,30.21875,70600,273165,54.643187954193486,57.056994332089516,NaN,NaN,14.082520622101164,30.78919037522818,-0.053132193757712276,0.2733605284972569,0.32649272225496917,381600,377200,61.95736330199821,63.235592207646576,NaN,NaN,10.059613323187008,14.115232298065022
2000-01-14T09:30:00-05:00,30.25,30.32812,30.14062,30.14062,102600,277850,53.8038821151923,56.36771647527068,NaN,NaN,20.155435591052605,27.459074048841437,-0.052930749443908465,0.2603292854500836,0.31326003489399207,279000,345880,60.52326181133454,65.15879646012854,NaN,NaN,9.680264537015224,13.481665475057909
2000-01-18T09:30:00-05:00,30,30.125,29.65625,29.96875,53800,237650,51.914835671766674,55.37516613004269,NaN,NaN,-19.194291662774937,12.935216591933301,-0.06385404452327265,0.23344247923990125,0.2972965237631739,225200,312180,58.9423514410995,65.35967117417911,NaN,NaN,8.830524251943721,12.817216728898739
2000-01-19T09:30:00-05:00,29.95312,30.26562,29.90625,29.90625,113800,199340,51.21070317852987,54.266314606518094,NaN,NaN,-7.118842798278934,3.440852402613609,-0.07405221937875511,0.20473124953973,0.2787834689184851,111400,261640,56.556425832804415,64.70401358233465,NaN,NaN,7.933989234879486,12.119612801181702
2000-01-20T09:30:00-05:00,30.0625,30.0625,29.34375,29.5,161400,174985,46.77021882470458,52.94212353407844,NaN,NaN,-71.4937169547984,-12.713779040539698,-0.105029839698345,0.14749616929555387,0.2525260089938989,-50000,189440,53.24083491235087,63.44815436334107,NaN,NaN,5.889497737716902,11.229596363543873
2000-01-21T09:30:00-05:00,29.53125,29.53125,28.89062,28.89062,170200,155820,41.023942508821094,51.0147056716119,NaN,NaN,-146.71144482718728,-44.87257213039739,-0.16013161362609366,0.052361491961281814,0.21249310558737547,-220200,69080,48.170994770550436,61.56812726297532,NaN,NaN,2.30021541873381,9.953970514285293
2000-01-24T09:30:00-05:00,29.09375,29.125,27.8125,27.8125,5100,147195,33.24229299324061,49.434976213676364,NaN,NaN,-212.18350995892575,-91.34036124039305,-0.25701433303140525,-0.10877481070188111,0.14823952232952414,-225300,-31780,44.358997353488355,59.507595659075584,NaN,NaN,-3.762713626722765,7.994444208427
2000-01-25T09:30:00-05:00,27.90625,28.0625,27.625,27.98437,63000,80905,35.347699271006476,48.64707288944738,NaN,NaN,-198.98222561627296,-127.29794803109266,-0.2946485581392283,-0.22007117534451126,0.07457738279471705,-162300,-109280,41.63272498154326,57.4416078901866,NaN,NaN,-7.923871822859803,5.720399061100314
2000-01-26T09:30:00-05:00,27.71875,28.20312,27.71875,28.1875,38100,82280,37.84278087121718,48.25201807698246,NaN,NaN,-152.74844908254792,-156.42386928794645,-0.29050762275148445,-0.2885571456446385,0.0019504771068459409,-124200,-156400,40.022166931411356,55.510602391026275,NaN,NaN,-10.54873433977688,3.3962371466892862
2000-01-27T09:30:00-05:00,28.40625,28.40625,27.65625,28.10937,119100,88165,37.24735912159105,47.57219272262354,NaN,NaN,-129.88645101408912,-168.1024160998046,-0.27768713124952205,-0.34515843695505666,-0.06747130570553458,-243300,-195060,38.699389105720876,53.663262239769246,NaN,NaN,-12.84770980234863,1.0756732968267269
2000-01-28T09:30:00-05:00,27.65625,27.76562,26.90625,27,12400,88685,30.02380865079236,45.56735787891663,NaN,NaN,-168.61781406992733,-172.4836899483526,-0.32527695596838013,-0.4740675006660098,-0.14879054469762962,-255700,-202160,38.44806049754353,51.95157163913221,NaN,NaN,-17.465511000341746,-1.573067317054483
2000-01-31T09:30:00-05:00,26.875,27.20312,26.875,27.20312,10800,88270,32.601131276026194,43.85191648299516,NaN,NaN,-154.61412678932766,-160.969813314433,-0.32373464173845967,-0.5534588468707042,-0.22972420513224454,-244900,-206080,38.3001663872535,50.299744623350314,NaN,NaN,-20.351085704185806,-4.255641372358958
2000-02-01T09:30:00-05:00,27.4375,28.1875,27.4375,28.1875,129900,84120,43.46806698654411,43.030713340772465,NaN,NaN,-83.00890327874549,-137.7751488469275,-0.24088206055614453,-0.5308267808274252,-0.28994472027128065,-115000,-196620,38.91086950716096,48.68846270598045,NaN,NaN,-19.22290426429424,-6.39382178549257
2000-02-02T09:30:00-05:00,28.25,28.28125,28,28,5300,75525,42.07645919771146,42.22974061580986,NaN,NaN,-64.3607720035422,-120.09761343112636,-0.18564667343588498,-0.5220030620661369,-0.3363563886302519,-120300,-195840,38.96451295825193,47.05200855660801,NaN,NaN,-18.783077287170162,-8.163715428589368
2000-02-03T09:30:00-05:00,28.28125,28.28125,28.03125,28.10937,26200,70605,43.21837984792012,41.41368289393319,NaN,NaN,-55.74014093481221,-105.26835141527097,-0.13124806260598654,-0.5004164668877351,-0.3691684042817486,-94100,-166000,41.095544186127285,45.56187861976008,NaN,NaN,-18.07762174214616,-9.579987759097481
2000-02-04T09:30:00-05:00,28.35937,28.35937,28,28.0625,23100,64970,42.828709607739036,40.62974200054367,NaN,NaN,-50.67979164619153,-81.6807469305238,-0.08989732292442276,-0.48154005793727706,-0.3916427350128543,-117200,-138300,43.08219339539101,44.31608801862126,NaN,NaN,-17.62332779424866,-10.729036335547649
2000-02-07T09:30:00-05:00,27.875,27.875,27.46875,27.46875,20800,62540,38.13760107209123,39.645653814852565,NaN,NaN,-76.8861487582498,-66.13515132430823,-0.09358812000763017,-0.508627885022392,-0.4150397650147618,-138000,-116920,44.63431704833004,43.29408556199487,NaN,NaN,-18.636778741176606,-11.858713822066072
2000-02-08T09:30:00-05:00,27.6875,28.26562,27.6875,28.09375,205700,70730,44.97038999066127,39.19991715857624,NaN,NaN,-45.986119710635506,-58.73059461068624,-0.047325518019362633,-0.4741966625389651,-0.42687114451960245,67700,-80380,47.280355552957964,42.631509113434404,NaN,NaN,-17.36018733676932,-12.644638609880822
2000-02-09T09:30:00-05:00,28.1875,28.1875,27.57812,27.625,28600,70680,41.28713379021552,38.808268227541305,NaN,NaN,-56.44896407201864,-57.14823302438153,-0.04187096066483725,-0.47920984535064903,-0.4373388846858118,39100,-48500,49.54596903664369,42.36759012231246,NaN,NaN,-17.439286565525684,-13.329588317830089
2000-02-10T09:30:00-05:00,27.67187,27.67187,27.28125,27.375,10100,68530,39.43215397983512,38.69456904689945,NaN,NaN,-78.88768931210387,-61.77774269983986,-0.04822448566420079,-0.4976194917660628,-0.449395006101862,29000,-23880,51.287023799853095,42.59016362440551,NaN,NaN,-18.07450529778742,-14.007433600681136
2000-02-11T09:30:00-05:00,27.54687,27.54687,26.76562,26.98437,33000,66650,36.660535043729,38.93872919336291,NaN,NaN,-106.05246317745943,-72.85227700609344,-0.07051079034828345,-0.5375334940372163,-0.46702270368893284,-4000,-1240,52.89670871275711,43.200000150067574,NaN,NaN,-19.46407286378919,-14.786953495410858
2000-02-14T09:30:00-05:00,26.96875,27.3125,26.96875,27.125,2800,61660,38.34080075761717,39.152522156692235,NaN,NaN,-105.64072147617415,-78.60319154967831,-0.06755068731775687,-0.551461062836129,-0.48391037551837207,-1200,26120,54.83887030046337,44.14329624427615,NaN,NaN,-20.100661588753535,-15.546054651602669
2000-02-15T09:30:00-05:00,27.15625,27.1875,26.75,27.1875,7900,59365,39.11385290638469,39.24331301634707,NaN,NaN,-112.3472112728603,-91.87540986212328,-0.05375391092168347,-0.5511027641704764,-0.49734885324879297,6700,13920,53.77414868497988,45.12558065524534,NaN,NaN,-20.402341600816122,-16.239809930061732
2000-02-16T09:30:00-05:00,27,27,26.125,26.125,18000,54575,31.811967045854814,38.85507072522305,NaN,NaN,-171.2342072930507,-114.8324585063297,-0.10556052317669617,-0.6292995072196632,-0.523738984042967,-11300,3840,52.860944537598144,46.13712032895086,NaN,NaN,-23.021110617007707,-17.208567171054014
2000-02-17T09:30:00-05:00,26.3125,26.3125,25.25,25.375,67000,49855,27.858491585515026,38.70040522056038,NaN,NaN,-226.67374466743658,-144.38966957739623,-0.17558666654055122,-0.7432223172186561,-0.5676356506781048,-78300,-17620,50.87989907754412,47.025108798950896,NaN,NaN,-26.643137265583682,-18.556362898843968
2000-02-18T09:30:00-05:00,25.23437,25.32812,24.82812,25,7500,41720,26.11118243843532,38.23683744644675,NaN,NaN,-240.01497751672892,-171.18217244525013,-0.229029751422409,-0.8539228399561161,-0.6248930885337071,-85800,-33980,49.361160077026184,47.8151797767918,NaN,NaN,-30.183065243730113,-20.217320376684846
2000-02-22T09:30:00-05:00,25.34375,25.375,24.78125,25.0625,70700,45000,26.933732816769208,37.05581357717711,NaN,NaN,-194.7826166426224,-189.01055147853978,-0.24083508864328818,-0.9259369493378173,-0.6851018606945292,-15100,-36760,49.09299475877432,48.54247443762132,NaN,NaN,-32.72843278446435,-22.004622149224776
2000-02-23T09:30:00-05:00,25.3125,25.3125,24.84375,24.98437,343000,59000,26.536044829801853,35.94578397946928,NaN,NaN,-163.92827902376592,-199.3267650287209,-0.23434960318270526,-0.9780388646729108,-0.7436892614902055,-358100,-109720,42.558287863880935,48.79917264516625,NaN,NaN,-34.9053637256814,-23.84758523157572
2000-02-24T09:30:00-05:00,24.78125,24.78125,23.89062,24.1875,108900,62540,22.832968687662827,34.48968318230805,NaN,NaN,-175.69311331390816,-200.2185462328924,-0.26207394182470245,-1.0712816887710837,-0.8092077469463812,-467000,-200860,36.09488619309353,48.44198278852098,NaN,NaN,-38.062262082416424,-25.878253353124393
2000-02-25T09:30:00-05:00,24.1875,24.65625,24.1875,24.28125,31300,58150,24.173618234085552,33.15717665561852,NaN,NaN,-139.9157396220324,-182.86694522381157,-0.2523523725410455,-1.124648212622688,-0.8722958400816425,-435700,-272340,31.99125368927575,47.64977280951275,NaN,NaN,-40.20578819266736,-27.925044044487674
2000-02-28T09:30:00-05:00,24.6875,25.21875,24.51562,25.15625,259700,70515,35.44627404720313,32.96493901098365,NaN,NaN,-91.25997067653336,-153.11594385577246,-0.16923734238315136,-1.0838425180605817,-0.9146051756774304,-176000,-290380,31.03235185838757,46.678203867374,NaN,NaN,-38.5353820111321,-29.440806611151164
2000-02-29T09:30:00-05:00,25.4375,25.84375,25.4375,25.6875,17600,70855,41.165215545449456,32.69314083632567,NaN,NaN,-47.88362840488462,-123.73614620822488,-0.06602933583969228,-0.9971418454770458,-0.9311125096373535,-158400,-319040,29.518572510696075,45.409505078641004,NaN,NaN,-35.24451533679846,-30.269907857672205
2000-03-01T09:30:00-05:00,25.70312,25.70312,25.1875,25.39062,345700,81645,39.08152817835716,32.53559757833578,NaN,NaN,-54.03163393896984,-101.75681719126565,-0.008336602934131965,-0.9415332633050184,-0.9331966603708864,-504100,-348240,28.01892004550946,43.871858722131414,NaN,NaN,-33.200054962704876,-30.6885003012483
2000-03-02T09:30:00-05:00,25.65625,25.6875,25.32812,25.35937,208600,91810,38.85856012982998,32.4946265890497,NaN,NaN,-46.5459290468009,-75.9273803378442,0.03477457668523476,-0.889728439514343,-0.9245030161995778,-712700,-397380,25.65663672640008,42.04111678831334,NaN,NaN,-31.63808597202212,-30.82415539707313
2000-03-03T09:30:00-05:00,25.75,26,25.64062,25.82812,208000,100900,44.01792268775694,33.02015427790884,NaN,NaN,-21.112570927437538,-52.16674659892523,0.09831593553734697,-0.801608096777894,-0.899924032315241,-504700,-411180,25.01870523818252,40.049830825843735,NaN,NaN,-28.712659827300328,-30.522513172819874
2000-03-06T09:30:00-05:00,25.57812,25.625,25,25.21875,600200,129755,39.367210150837785,33.09346923456746,NaN,NaN,-48.61382346293352,-43.63751715620526,0.10230441028659554,-0.7720435194569966,-0.8743479297435921,-1104900,-596960,18.389642195519784,37.44631453263348,NaN,NaN,-27.576356470404463,-30.101633643903387
2000-03-07T09:30:00-05:00,25.125,25.125,24.32812,24.51562,6300,129030,34.7985361488621,32.785232323315846,NaN,NaN,-83.94519093069245,-50.84982966136682,0.06254049196961908,-0.7961723147815682,-0.8587128067511873,-1111200,-787520,14.225894752066566,34.621439251711095,NaN,NaN,-28.05584436562412,-29.809378032720634
2000-03-08T09:30:00-05:00,24.09375,24.90625,24.03125,24.8125,172200,127355,38.06674236863732,33.23200198922888,NaN,NaN,-85.93321878471546,-57.23014663051595,0.06111367117083688,-0.7823207177876412,-0.8434343889584781,-939000,-874500,12.801163688944555,31.760026333950123,NaN,NaN,-27.41462740257518,-29.467270799842712
2000-03-09T09:30:00-05:00,24.51562,25.34375,24.28125,25.3125,306400,141245,43.22804911334294,34.32982752693088,NaN,NaN,-51.45051890952598,-58.21106460306096,0.09661395014346397,-0.7226669512791482,-0.8192809014226121,-632600,-858480,14.499599900821366,29.161433535612787,NaN,NaN,-25.223936733241832,-28.86108021889973
2000-03-10T09:30:00-05:00,25.09375,25.29687,24.875,24.96875,440300,162755,40.71583594225163,35.373017062917754,NaN,NaN,-40.60400140717829,-62.10935069900911,0.09933207998930416,-0.695115801435982,-0.7944478814252861,-1072900,-972120,12.621559362656683,26.537176341729253,NaN,NaN,-24.186801329993198,-28.193326091913082
2000-03-13T09:30:00-05:00,24.23437,24.9375,24.23437,24.76562,442900,183250,39.263729519532724,36.253731113115144,NaN,NaN,-76.4085017048218,-67.66828634738677,0.09010814698315639,-0.6818126976963406,-0.771920844679497,-1515800,-1054300,11.465061274275442,23.84946680712219,NaN,NaN,-23.77463100021889,-27.562083935956768
2000-03-14T09:30:00-05:00,24.8125,25.03125,24.60937,24.8125,229300,194575,39.797370007392466,37.20096862580019,NaN,NaN,-52.39770420234263,-61.35878900171681,0.08963237358467302,-0.6598803776986557,-0.7495127512833287,-1286500,-1089360,11.001902234786542,21.595439262186883,NaN,NaN,-23.287752386656813,-26.95146514319963
2000-03-15T09:30:00-05:00,24.8125,26.5,24.5625,26.3125,721800,230270,53.788160365214495,39.41205374562531,NaN,NaN,99.52261112459117,-24.267623019855506,0.18719515131254139,-0.5155188121426519,-0.7027139634551933,-564700,-1014500,18.56639831665821,20.343404413870072,NaN,NaN,-18.036961051491286,-25.677964558669867
2000-03-16T09:30:00-05:00,26.84375,28.3125,26.71875,28.28125,151400,236940,65.2145376636555,42.343547990594594,NaN,NaN,333.4355137884615,52.70958351974199,0.37058006583971326,-0.23948888115555178,-0.610068946995265,-413300,-970640,22.711341078554725,19.680553513104286,NaN,NaN,-8.384882391789297,-23.2075242491155
2000-03-17T09:30:00-05:00,28.25,28.5,28.0625,28.26562,24300,234805,65.07696388179252,44.4600258359224,NaN,NaN,288.9626592028478,118.6229156417472,0.470660170155701,-0.021743734300638806,-0.4924039044563398,-437600,-843580,33.30262358457894,19.84271577926081,NaN,NaN,-1.4073652249031712,-20.093215817085166
2000-03-20T09:30:00-05:00,28.28125,28.28125,27.6875,28,81100,238485,62.65786657654886,45.99521519528664,NaN,NaN,199.62456550871042,173.82952908445367,0.4962535613605818,0.12791304724438746,-0.36834051411619434,-518700,-644160,45.8458454692761,21.00894956201652,NaN,NaN,3.222319724737815,-16.76242502539617
2000-03-21T09:30:00-05:00,27.9375,28.375,27.75,28.3125,157200,242810,64.33748989376588,47.79921246067298,NaN,NaN,168.07019166610704,217.92310825814357,0.5095816815349703,0.26863658780251853,-0.24094509373245174,-361500,-459160,54.411214457481464,22.89411344858596,NaN,NaN,7.483262035643342,-13.298755445247668
2000-03-22T09:30:00-05:00,28.0625,28.3125,27.75,28.1875,133300,232325,63.11460021643434,49.53178675257329,NaN,NaN,134.8829052521645,224.99516708365826,0.4854418177117983,0.36585717840729615,-0.11958463930450215,-494800,-445180,54.99056047793563,24.989393716552787,NaN,NaN,10.498275251098146,-9.89917963148398
2000-03-23T09:30:00-05:00,27.78125,28.39062,27.78125,28.26562,9000,227330,63.58050163268657,50.92911382006827,NaN,NaN,115.252398699481,181.35854406586216,0.4509394227225668,0.44408963909870636,-0.006849783623860448,-485800,-459680,54.22091213518379,27.075265637767163,NaN,NaN,13.066769452518104,-6.618329762340825
2000-03-24T09:30:00-05:00,28.5,28.84375,28.35937,28.35937,19600,226745,64.1654734347955,52.70041834035096,NaN,NaN,114.36637795820722,146.43928781693404,0.41172035443729316,0.507800659422756,0.09608030498546284,-466200,-465400,53.90042610703553,29.61175020287543,NaN,NaN,15.343889948099804,-3.48086980370645
2000-03-27T09:30:00-05:00,28.35937,28.5625,28.21875,28.28125,14000,214460,63.25375046841309,54.73293364889032,NaN,NaN,92.34452103554364,124.9832789223007,0.35969415922259634,0.5456980040137083,0.18600384479111193,-480200,-457700,54.29208954273301,32.47362125935161,NaN,NaN,16.993303334303313,-0.5559879268479127
2000-03-28T09:30:00-05:00,28.125,28.6875,28.125,28.375,20800,214620,63.916371805090115,56.57933575149409,NaN,NaN,83.3003067359043,108.02930193626017,0.3125165302190035,0.5766495075648663,0.26413297734586283,-459400,-477280,53.0576473630231,35.34908437892865,NaN,NaN,18.5587312275725,2.174686238069289
2000-03-29T09:30:00-05:00,28.625,29.03125,28.625,28.9375,12300,197950,67.68196404186932,58.326043960674546,NaN,NaN,92.51230568564486,99.5551820229562,0.30005325938046506,0.6391995515714441,0.3391462921909791,-447100,-467740,53.6110851147553,38.14276189420964,NaN,NaN,21.028234859915408,4.868050326904449
2000-03-30T09:30:00-05:00,29.53125,29.89062,29.375,29.57812,22500,188645,71.34907752531426,60.51413264517902,NaN,NaN,110.92551786197983,98.68980585545597,0.31430317478761605,0.7320252606754991,0.41772208588788307,-424600,-455500,54.35464886237729,41.1236968584754,NaN,NaN,24.345125614829776,7.650489653750924
2000-03-31T09:30:00-05:00,29.32812,29.70312,29.17187,29.26562,374600,196975,67.33527292104566,62.51924288814423,NaN,NaN,92.14061033466075,94.24465233074667,0.2830071414504075,0.7714810127008924,0.4884738712504849,-799200,-522100,49.68772612490296,43.8538872049488,NaN,NaN,26.005248699789924,10.272598088899352
2000-04-03T09:30:00-04:00,29.65625,30.29687,29.65625,30.14062,41000,169015,72.0726719394394,64.82462159757615,NaN,NaN,109.42146914494269,97.6600419526265,0.29994282485532375,0.8634024023196396,0.5634595774643159,-758200,-577700,46.12703195738009,46.3628250422769,NaN,NaN,29.013192284411037,12.949825831115307
2000-04-04T09:30:00-04:00,30.64062,30.75,28.59375,29.76562,71000,172250,67.55098475144717,65.80768048230706,NaN,NaN,92.43867164869036,99.48771493518373,0.2657657072594748,0.8956667115386594,0.6299010042791846,-829200,-651660,41.83258675552772,48.024695645053306,NaN,NaN,30.12256429682235,15.40307418335917
2000-04-05T09:30:00-04:00,29.60937,29.9375,29.5,29.8125,11900,164235,67.82276608037468,65.99398251207272,NaN,NaN,93.18990985944967,99.62323576994467,0.2276613594009168,0.9144777035303306,0.6868163441294138,-817300,-725700,38.01682229853756,49.1179443036235,NaN,NaN,31.092098747830736,17.644363406855106
2000-04-06T09:30:00-04:00,29.65625,30.32812,29.65625,30.125,13600,149595,69.64773829457087,66.32046639869974,NaN,NaN,106.27409078325864,98.69295035420045,0.2055253541499933,0.9437230368169054,0.7381976826669121,-803700,-801520,34.54211797649823,49.20647961733202,NaN,NaN,32.44303474430996,19.7584593122058
2000-04-07T09:30:00-04:00,30.3125,30.5,30.125,30.125,55700,130365,69.64773829457087,66.81974294998703,NaN,NaN,113.48216010453821,102.96126030817592,0.1741469488619677,0.9558813687443717,0.781734419882404,-803700,-802420,34.501806631273396,48.396191128903254,NaN,NaN,33.54259590560631,21.727621682691588
2000-04-10T09:30:00-04:00,30.34375,30.85937,30.25,30.82812,15800,109010,73.56070549710552,67.47854406451128,NaN,NaN,126.63767930539355,106.40450234026609,0.1830950538019981,1.0106032371349016,0.8275081833329035,-787900,-808360,34.21797470289614,46.95381686071859,NaN,NaN,35.70429070162081,23.724288685395763
2000-04-11T09:30:00-04:00,30.51562,31.07812,30.51562,31.04687,46100,99850,74.6554264519791,68.30288879562163,NaN,NaN,131.1184191502744,114.14045184058288,0.18552128716434513,1.059409792288335,0.8738885051239899,-741800,-790880,35.88940730726233,45.589448777099065,NaN,NaN,37.83128578239505,25.739573984967087
2000-04-12T09:30:00-04:00,31.29687,31.9375,30.98437,30.98437,107000,69110,73.7162793662628,69.0268729194485,NaN,NaN,146.65940504268727,124.83435087723042,0.1653609921201734,1.0805897452742066,0.9152287531540332,-848800,-797180,35.53892210595838,44.25502091786869,NaN,NaN,39.32231651473161,27.679965774933446
2000-04-13T09:30:00-04:00,30.9375,30.9375,30.375,30.40625,37400,63410,65.50737675964422,69.1227231569377,NaN,NaN,87.41696993161901,121.06292670690247,0.09881817965629636,1.0387514777244036,0.9399332980681072,-886200,-813680,34.586268136819115,42.875438205710374,NaN,NaN,38.26279728479911,29.1917988477714
2000-04-14T09:30:00-04:00,29.375,29.4375,28,28,117600,68075,43.69641087315661,67.72577032870508,NaN,NaN,-63.381012786898246,85.69029212861518,-0.1102002243367155,0.8021830176472129,0.9123832419839284,-1003800,-853700,32.323075946536605,41.3062229488392,NaN,NaN,28.51657329651662,29.095338054735002
2000-04-17T09:30:00-04:00,28.375,28.375,27.375,28.03125,140600,71050,43.95738475277515,66.30012839639687,NaN,NaN,-102.6216952404742,39.83841721944164,-0.2417557546074166,0.6101885487246577,0.8519443033320743,-863200,-868760,31.48805730747854,39.765537944871724,NaN,NaN,21.42256525641872,27.999227654975535
2000-04-18T09:30:00-04:00,27.875,28.71875,27.71875,28.625,52100,65795,48.81212855983637,64.95228300482309,NaN,NaN,-73.56839460149611,-1.0989455309124678,-0.2814142518878744,0.5001764884722313,0.7815907403601057,-811100,-882620,30.70196666812413,38.12917234154094,NaN,NaN,17.28449196569394,26.468551127935307
2000-04-19T09:30:00-04:00,28.40625,28.96875,28.40625,28.84375,8400,59550,50.51298744186994,63.46399085600564,NaN,NaN,-49.76349553169111,-40.38352564578815,-0.28468472919874765,0.42573482886167113,0.7104195580604188,-802700,-873400,31.919557864456095,36.526665841689415,NaN,NaN,14.591838335693025,24.771877871900696
2000-04-20T09:30:00-04:00,28.8125,29.21875,28.8125,29.21875,14300,59815,53.373239731345464,62.46670277102705,NaN,NaN,-28.838854502954245,-63.63469053270281,-0.25435609266577874,0.3924744422281954,0.6468305348939741,-788400,-853840,34.5469976687839,35.44518523768091,NaN,NaN,13.309158870088417,23.134346585927513
2000-04-24T09:30:00-04:00,29.21875,30.0625,29.21875,29.53125,12300,59450,55.67250828425094,61.29526250994216,NaN,NaN,8.913598089888147,-49.175768357345525,-0.20796693474371897,0.38687186646432536,0.5948388012080443,-776100,-808300,40.32177404394782,35.030523958150035,NaN,NaN,12.980212742024369,21.683756036798492
2000-04-25T09:30:00-04:00,29.71875,30.125,29.71875,30.0625,25600,60030,59.34299337259287,60.708977411452565,NaN,NaN,35.05333577348797,-21.640762154553094,-0.13950903679992677,0.4204525052081358,0.5599615420080626,-750500,-785760,43.00223210127257,35.11407005427467,NaN,NaN,13.862862411166368,20.566485518851046
2000-04-26T09:30:00-04:00,29.9375,30.15625,29.9375,30.03125,11900,59585,59.03333460248538,60.08116087731762,NaN,NaN,36.70200842499882,0.4133184507458935,-0.09638702286737111,0.4394777634238487,0.5358647862912198,-762400,-776020,44.16919416065327,35.55352518728293,NaN,NaN,14.473135971404336,19.696007012072943
2000-04-27T09:30:00-04:00,29.3125,29.40625,29.0625,29.40625,3300,59135,53.06890717198783,58.89695865427598,NaN,NaN,-39.08698845908255,2.5486198652676064,-0.10907762979104452,0.3995177490524142,0.5085953788434587,-765700,-768620,45.089040671322934,36.30687680834184,NaN,NaN,13.183455103496453,18.765642453704874
2000-04-28T09:30:00-04:00,29.1875,29.375,28.65625,28.65625,4300,58225,46.94003227799177,57.27497965309175,NaN,NaN,-70.8529325034607,-5.854195734833692,-0.16381384160686369,0.3038280768348791,0.4676419184417428,-770000,-764940,45.569311357864805,37.09741286024122,NaN,NaN,10.07977438331927,17.524804157935503
2000-05-01T09:30:00-04:00,28.78125,29.53125,28.78125,29.53125,6700,39830,53.663526866069624,55.853752608017764,NaN,NaN,-33.76602875752175,-14.390121104315671,-0.13795699275480344,0.2951956774982385,0.43315267025304194,-763300,-762380,45.92364410929789,37.93353210355564,NaN,NaN,9.588437107268701,16.391037436411672
2000-05-02T09:30:00-04:00,29.09375,29.4375,29.09375,29.32812,65300,41045,52.01569394960397,54.23662885784812,NaN,NaN,-29.863253830618742,-27.373439025137014,-0.13143073956582452,0.2688642457957613,0.4002949853615858,-828600,-778000,44.03982665644142,38.51570491421129,NaN,NaN,8.672778050975257,15.288428952777899
2000-05-03T09:30:00-04:00,28.15625,28.40625,27.78125,27.9375,167300,45860,42.4137400179991,52.00073319011499,NaN,NaN,-125.91118534653366,-59.89607777944347,-0.2128459265845457,0.13423757713090367,0.3470835037154494,-995900,-824700,38.90183812797705,38.75591320149833,NaN,NaN,4.433717016920585,13.737755819083997
2000-05-04T09:30:00-04:00,27.8125,27.8125,27.34375,27.48437,22800,46405,39.83342963498186,50.16687982406768,NaN,NaN,-144.55901589305296,-80.99048326623756,-0.284799645407486,-0.008916053043908079,0.2758835923635779,-1018700,-875300,34.240544026577666,38.731218622195364,NaN,NaN,0.15223324799105872,11.796966880356434
2000-05-05T09:30:00-04:00,27.53125,27.875,27.53125,27.82812,15100,46480,42.682212647883176,50.094437093691006,NaN,NaN,-116.38364678478852,-90.09662612250312,-0.2955470304818823,-0.09355019573877499,0.2019968347431073,-1003600,-922020,30.595288805617074,38.60780525498683,NaN,NaN,-2.3454657319052252,9.776619364319055
2000-05-08T09:30:00-04:00,27.5625,27.84375,27.375,27.75,54600,46425,42.1932771334637,49.96842940659734,NaN,NaN,-109.45104607036613,-105.23362958507201,-0.2936172220108783,-0.1650246927704906,0.12859252924038772,-1058200,-981000,26.72695934809566,38.26772682931663,NaN,NaN,-4.466379751363328,7.741905204935858
2000-05-09T09:30:00-04:00,28.1875,28.375,28.03125,28.03125,17900,46530,44.651522978913256,49.67124329367425,NaN,NaN,-67.21341008587112,-112.70366083612248,-0.26023939108480787,-0.1967067096156221,0.06353268146918575,-1040300,-1023340,24.34712188638656,37.8138093449068,NaN,NaN,-5.482118357421198,5.852758981741992
2000-05-10T09:30:00-04:00,27.90625,28.09375,27.78125,28.03125,63000,47375,44.651522978913256,49.252567260605915,NaN,NaN,-73.96794512231186,-102.31501279127812,-0.22625584972014845,-0.2192871306809998,0.006968719039148634,-1040300,-1032220,23.867118253992558,37.23863508701654,NaN,NaN,-6.3002789897825,4.116610700095636
2000-05-11T09:30:00-04:00,28.4375,28.5,28.28125,28.28125,18100,42930,46.97605659947674,48.79562560832958,NaN,NaN,-36.161640945801864,-80.6355378018279,-0.17720403537783927,-0.21453632518315047,-0.03733228980531119,-1022200,-1032920,23.827239609879328,36.47293808280908,NaN,NaN,-6.3457702625399,2.62198484829056
2000-05-12T09:30:00-04:00,28.59375,28.6875,28.4375,28.6875,3000,41210,50.60633130582454,48.433755824156265,NaN,NaN,-4.904956321518903,-58.339799709173974,-0.11090370280337417,-0.1759619183095289,-0.06505821550615473,-1019200,-1036040,23.637662385001747,35.28121582145578,NaN,NaN,-5.356587089829203,1.482188857130594
2000-05-15T09:30:00-04:00,28.4375,28.96875,28.3125,28.78125,26700,36665,51.4327002930412,47.86873488990257,NaN,NaN,2.7974226996921736,-35.89010595516232,-0.056958154120798826,-0.13625590815715327,-0.07929775403635445,-992500,-1022900,26.297292998258342,34.088005885526194,NaN,NaN,-4.305972975527231,0.6553085953223332
2000-05-16T09:30:00-04:00,29.25,29.25,28.75,29,7700,30020,53.39210299254971,47.46578977490717,NaN,NaN,31.4519835998988,-16.15702721800833,-0.005477232300554552,-0.08614429441204763,-0.08066706211149308,-984800,-1011800,28.56084620368597,32.973123888599964,NaN,NaN,-2.8718177044068356,0.15143340964673768
2000-05-17T09:30:00-04:00,28.4375,28.48437,28.25,28.3125,9500,27890,46.977380606540905,47.0306807345181,NaN,NaN,-40.31021340861166,-9.42548087526829,-0.016062079954285324,-0.10074466205434973,-0.08468258210006441,-994300,-1002600,30.466956549935674,31.928689308500875,NaN,NaN,-3.37384401381575,-0.3521776508479034
2000-05-18T09:30:00-04:00,28.3125,28.875,28.3125,28.875,1600,27550,52.05308177078219,47.39589855543171,NaN,NaN,-2.6994830495378133,-2.7330492960154804,0.014815014205424415,-0.06616381434328389,-0.0809788285487083,-992700,-996700,31.72507586814025,30.939815344949118,NaN,NaN,-2.308905702344327,-0.6317102296331067
2000-05-19T09:30:00-04:00,28.3125,28.625,28.125,28.14062,1900,26930,45.8782552996774,46.83980772926083,NaN,NaN,-41.627122474237275,-10.077482526559155,-0.012736596321321153,-0.09689957395035975,-0.0841629776290386,-994600,-991780,32.81674098726009,30.003607979089274,NaN,NaN,-3.2716640441156066,-1.0088464888448925
2000-05-22T09:30:00-04:00,27.90625,27.90625,27.53125,27.71875,8500,26740,42.74156785867736,46.177370151337506,NaN,NaN,-96.14087710998568,-29.865142488494723,-0.055493198643710856,-0.15352947593367716,-0.0980362772899663,-1003100,-993900,32.57504542344992,29.18469503387559,NaN,NaN,-5.057611088795242,-1.5872414316949424
2000-05-23T09:30:00-04:00,27.6875,28.0625,27.59375,27.59375,20000,26460,41.829014974082774,46.13560407677205,NaN,NaN,-85.88566345170396,-53.332671898815285,-0.08646659342591453,-0.20611951907235948,-0.11965292564644495,-1023100,-1001560,31.66750765833632,28.667957143186975,NaN,NaN,-6.778594128949465,-2.3288632455884457
2000-05-24T09:30:00-04:00,27.34375,27.34375,26.625,27.09375,3900,26060,38.305965952518044,46.02649952802464,NaN,NaN,-163.78592967333395,-78.02781515175974,-0.1321653745398153,-0.2848596438212141,-0.1526942692813988,-1027000,-1008100,30.876569761637143,28.42767326711979,NaN,NaN,-9.339629987288923,-3.3304013515456568
2000-05-25T09:30:00-04:00,27.1875,27.28125,26.84375,26.84375,21000,26945,36.64408606886941,45.59520477238079,NaN,NaN,-148.77695009206502,-107.24330856026518,-0.1684424893313395,-0.3632473809455732,-0.19480489161423367,-1048000,-1019160,29.533183725879113,28.351808618567077,NaN,NaN,-11.969306282139309,-4.56453062734475
2000-05-26T09:30:00-04:00,26.79687,26.79687,26.28125,26.28125,40300,28745,33.15835853274332,44.9498534437579,NaN,NaN,-183.70122035892823,-135.6581281372034,-0.21647168533496797,-0.46539449828294366,-0.2489228129479757,-1088300,-1037900,27.3609706370555,28.397095139207067,NaN,NaN,-15.34295337086315,-6.104305304990236
2000-05-30T09:30:00-04:00,26.3125,26.5,26.14062,26.48437,92000,33010,35.542742593152724,44.29922627334644,NaN,NaN,-168.99601842673763,-150.22915640055376,-0.21999562581702198,-0.5239173452192531,-0.30392171940223117,-996300,-1036540,27.776141484860744,28.64202511052665,NaN,NaN,-17.433432155627298,-7.722751997938388
2000-05-31T09:30:00-04:00,26.5,27.125,26.5,27.10937,28000,31145,42.356567228848185,44.1353008626275,NaN,NaN,-100.66730221026305,-153.1854841522656,-0.1680149930219541,-0.5139404606796738,-0.3459254676577197,-968300,-1025580,31.189394834393738,29.16504486626959,NaN,NaN,-17.199963322488074,-9.076639330016913
2000-06-01T09:30:00-04:00,27,27.3125,27,27.3125,1500,22855,44.41325838787338,43.952243847512975,NaN,NaN,-61.429483268028555,-132.7141948712045,-0.11050989734382471,-0.4840628393375006,-0.3735529419936759,-966800,-1013540,34.83287981840337,29.951162024021304,NaN,NaN,-16.392801971608474,-10.12180542167285
2000-06-02T09:30:00-04:00,27.78125,28.0625,27.75,28.0625,23700,22900,51.3195610796003,44.0031888313541,NaN,NaN,17.923646695057748,-99.37407551377996,-0.017404847273471247,-0.3953090010855149,-0.3779041538120437,-943100,-992560,40.72284390275357,31.17153213243215,NaN,NaN,-13.482591650553077,-10.60191774008431
2000-06-05T09:30:00-04:00,27.75,28.125,27.75,27.90625,1200,22205,49.92781378005634,43.89569693756946,NaN,NaN,13.448656613007971,-59.9441001193927,0.03533775528353306,-0.33373195970762737,-0.3690697149911604,-944300,-963760,47.709631020546944,32.70098484830991,NaN,NaN,-11.530894304706337,-10.734628677887457
2000-06-06T09:30:00-04:00,27.65625,27.65625,26.9375,27.01562,5600,19755,42.80243568227037,43.139292129692365,NaN,NaN,-60.19639394811237,-38.18417522366765,0.01307014546386348,-0.35273203316133106,-0.36580217862519454,-949900,-954480,49.76430416841769,34.21551756007646,NaN,NaN,-12.032917234078816,-10.92009847162908
2000-06-07T09:30:00-04:00,26.9375,27.375,26.90625,27.01562,21100,19915,42.80243568227037,42.841081777958756,NaN,NaN,-63.804002798176015,-30.811515341250253,0.0017630290386133063,-0.3635983923269279,-0.36536142136554123,-949900,-950800,50.59337334144915,35.653118759470274,NaN,NaN,-12.428219017154907,-11.135544263847056
2000-06-08T09:30:00-04:00,27.04687,27.04687,26.59375,26.75,15800,17555,40.788984620003994,42.03650341004602,NaN,NaN,-83.48595875973443,-35.22281043959141,-0.019036790902967782,-0.38915740999425097,-0.3701206190912832,-965700,-950580,50.64581324577493,37.004600000729894,NaN,NaN,-13.353421001991059,-11.452383797867627
2000-06-09T09:30:00-04:00,26.8125,27,26.28125,26.3125,67700,20035,37.647661782544766,41.44860387310798,NaN,NaN,-97.02002151090477,-58.211544080783916,-0.05562168393271488,-0.4396477240071768,-0.3840260400744619,-1033400,-968640,46.301222300632205,37.96777723739933,NaN,NaN,-15.092377292950676,-11.972382868593778
2000-06-12T09:30:00-04:00,25.71875,25.84375,25.59375,25.65625,12400,20505,33.48223026696536,40.78722261655712,NaN,NaN,-154.70330687467654,-91.84193677832081,-0.11401585531147129,-0.526545859213801,-0.41253000390232974,-1045800,-988940,41.94555895837691,38.63709963275126,NaN,NaN,-17.93623314621251,-12.824361479682167
2000-06-13T09:30:00-04:00,25.59375,26.4375,25.59375,26.15625,115400,24940,39.01836236827524,40.5864617161423,NaN,NaN,-113.6015319173216,-102.52296437216266,-0.10896950190152355,-0.5487418812792342,-0.43977237937771063,-930400,-985040,43.053914199956544,39.45041438572413,NaN,NaN,-18.63048187012849,-13.653807249745928
2000-06-14T09:30:00-04:00,26.1875,26.5625,26.1875,26.25,44600,26785,40.02625869546506,40.70933976920993,NaN,NaN,-84.58272388353325,-106.6787085892341,-0.09010195717449998,-0.5523998258458356,-0.4622978686713356,-885800,-972220,46.65897808133197,40.57772926570233,NaN,NaN,-18.888170495398825,-14.401573427696341
2000-06-15T09:30:00-04:00,26.40625,26.46875,26.1875,26.1875,135800,33100,39.55687053621678,40.91739580259189,NaN,NaN,-83.4371991518138,-106.66895666765,-0.07332677474799115,-0.5539563371063245,-0.4806295623583334,-1021600,-983400,44.040552091426534,41.61396986324144,NaN,NaN,-19.23131971097898,-15.091537182451004
2000-06-16T09:30:00-04:00,26.03125,26.03125,25.75,25.84375,18600,33950,36.987706092764014,41.19092062830765,NaN,NaN,-118.04324272949073,-110.87360091136718,-0.0765240186547127,-0.5762845856767242,-0.49976056702201155,-1040200,-984760,43.71914274172911,42.78241072786098,NaN,NaN,-20.26061613861266,-15.829977033331241
2000-06-19T09:30:00-04:00,25.59375,25.875,25.5,25.8125,22300,34970,36.75400184402505,41.2774391462271,NaN,NaN,-122.08161432075816,-104.34926240058351,-0.07195455398736517,-0.589703759506218,-0.5177492055188528,-1062500,-988100,42.891263799178134,43.86206232174079,NaN,NaN,-21.171625141688345,-16.593069620239397
2000-06-20T09:30:00-04:00,25.6875,25.6875,25.1875,25.25,14100,35250,32.74355941468258,40.590795730929564,NaN,NaN,-143.0775381275083,-110.24446364262084,-0.09649574066017474,-0.6383688813440713,-0.5418731406838966,-1076600,-1017340,36.39387211561972,44.23381069897122,NaN,NaN,-23.154763352499707,-17.530454439133727
2000-06-21T09:30:00-04:00,25.26562,25.26562,25.01562,25.07812,162300,42365,31.60859978806802,39.676177259514894,NaN,NaN,-153.80341895304983,-124.08860265652416,-0.1128480409156799,-0.6829331918284964,-0.5700851509128165,-1238900,-1087960,26.107359160995543,43.61055922344209,NaN,NaN,-25.143186705986924,-18.617987620112757
2000-06-22T09:30:00-04:00,24.9375,25.875,24.75,24.96875,256900,55015,30.875231217204828,38.2158679836295,NaN,NaN,-128.68851023476947,-133.1388648731153,-0.11896404553232331,-0.7187902078282207,-0.5998261622958974,-1495800,-1182800,18.531907244531794,42.02549231928339,NaN,NaN,-27.01249921564673,-19.817203562331898
2000-06-23T09:30:00-04:00,24.90625,25.125,24.8125,25.125,40900,56010,33.25768667052323,37.02514461866285,NaN,NaN,-129.45030976918594,-135.42027828105432,-0.10112113629733732,-0.726227582667569,-0.6251064463702317,-1454900,-1265740,14.554499991288608,39.657268674336365,NaN,NaN,-27.969729818118637,-20.98185017030143
2000-06-26T09:30:00-04:00,25.28125,25.40625,24.9375,25.125,13100,54650,33.25768667052324,36.34337683210948,NaN,NaN,-102.21282266396477,-131.44651994969564,-0.07893763325473657,-0.7237784879386524,-0.6448408546839158,-1454900,-1344220,11.942590461765732,36.9557176952898,NaN,NaN,-28.768725999394775,-22.09426100302905
2000-06-27T09:30:00-04:00,25.1875,26,25.1875,25.84375,132300,56665,43.62376254945566,36.40204303690843,NaN,NaN,-50.5036333314634,-112.93173899048668,-0.009147565288217474,-0.6562753112941877,-0.6471277460059702,-1322600,-1393420,10.652015006881797,34.102763528534986,NaN,NaN,-26.562192926920268,-22.732536992156366
2000-06-28T09:30:00-04:00,25.75,25.875,25.625,25.75,32900,56910,42.69235166615546,36.53799782591924,NaN,NaN,-39.79545379325851,-90.1301459585284,0.03499186189456449,-0.6033879186377646,-0.6383797805323291,-1355500,-1416740,10.095155059296758,31.206287943786545,NaN,NaN,-24.976565487530944,-23.05311249149559
2000-06-29T09:30:00-04:00,25.5,25.59375,25.15625,25.3125,154900,64580,38.55527596473347,36.602827410361286,NaN,NaN,-69.0445131475044,-78.2013465410754,0.038723027191017056,-0.5899759965435578,-0.6286990237345749,-1510400,-1419660,10.02448826136549,28.615092655267492,NaN,NaN,-24.731139150511897,-23.292830585640775
2000-06-30T09:30:00-04:00,25.46875,25.78125,25.34375,25.59375,32700,65030,42.41829682446569,37.24111787875417,NaN,NaN,-43.716700450007465,-61.0546246772397,0.06271217118206107,-0.5503088097569986,-0.6130209809390597,-1477700,-1424220,9.90784801468837,26.326684730718313,NaN,NaN,-23.39774231300956,-23.307817975264886
2000-07-03T09:30:00-04:00,25.6875,25.9375,25.59375,25.9375,43300,67135,46.81910984354104,37.79831412698744,NaN,NaN,-7.787308186298177,-42.16952178170639,0.10198674345352665,-0.4855375516221514,-0.587524295075678,-1434400,-1420120,10.911564934999802,24.03080264036426,NaN,NaN,-20.935418177007296,-22.968903718370946
2000-07-05T09:30:00-04:00,26.15625,26.375,26.0625,26.25,56000,69655,50.52129973981652,38.54795991586969,NaN,NaN,58.069269637116875,-20.454941187990336,0.14655633765415266,-0.40432887300798726,-0.5508852106621399,-1378400,-1431280,10.56648489294463,21.452767412622304,NaN,NaN,-17.708594957564976,-22.217431038255807
2000-07-06T09:30:00-04:00,26.25,26.59375,26.21875,26.4375,7700,68985,52.65114712175973,39.48326538626561,NaN,NaN,99.08781149073783,7.32171186880894,0.18379709772657593,-0.32113883850392,-0.5049359362304959,-1370700,-1434320,10.469356354056444,19.054824859953012,NaN,NaN,-14.36981371902893,-21.096342849794823
2000-07-07T09:30:00-04:00,26.5625,27.75,26.5625,27.71875,177500,77070,64.04173661446971,41.41569613781602,NaN,NaN,226.96438826669433,66.5234921516487,0.2838737234066375,-0.15009378197219903,-0.43396750537883655,-1193200,-1370880,25.798072441475526,17.7747484099349,NaN,NaN,-6.985474083853936,-19.08050445466041
2000-07-10T09:30:00-04:00,27.46875,28.28125,27.46875,28.125,123900,79880,66.7713062992934,43.559789313192326,NaN,NaN,257.4166663490077,126.75016551145173,0.36160100875177503,0.01803375556088227,-0.34356725319089276,-1069300,-1289200,40.03375159834074,17.570640395589372,NaN,NaN,0.005728044556294515,-16.353899811915166
2000-07-11T09:30:00-04:00,28.15625,28.5625,28.15625,28.32812,64100,82465,68.07613915373295,46.08354500883878,NaN,NaN,229.79585738125235,174.26679862496184,0.40745812392302294,0.16575540171288594,-0.241702722210137,-1005200,-1203360,50.73147223354217,18.594754689726688,NaN,NaN,6.014249332643999,-13.158449934121
2000-07-12T09:30:00-04:00,28.46875,28.46875,28.09375,28.40625,8600,77125,68.58711371195287,48.72486743197341,NaN,NaN,179.75162744683658,198.60327018690577,0.4220304788192165,0.28583537631388367,-0.13619510250533284,-996600,-1127000,57.92255981820855,20.867269022384765,NaN,NaN,10.949986784729013,-9.714387545713855
2000-07-13T09:30:00-04:00,28.3125,28.3125,27.875,27.875,26600,76225,61.391647204708896,50.90461143108085,NaN,NaN,131.40108685855157,205.06592526046853,0.37637914433176994,0.3342788279093796,-0.04210031642239036,-1023200,-1057500,63.188883533755885,24.057053043043624,NaN,NaN,12.981716637370367,-6.472086948130395
2000-07-14T09:30:00-04:00,28,28.25,27.75,28.21875,7500,69810,64.02181878536814,53.10204943928405,NaN,NaN,114.05069215872635,182.48318603887492,0.35035649809133695,0.3958453061917808,0.04548880810044388,-1015700,-1022000,65.55998328705752,27.700301849884255,NaN,NaN,15.508846488338216,-3.3319536000634504
2000-07-17T09:30:00-04:00,28.125,28.21875,27.875,28.0625,99500,73855,61.95574239158473,55.151910562217026,NaN,NaN,97.33272354145033,150.46639747736347,0.3052935182517446,0.42710570591512464,0.12181218766338005,-1115200,-1031180,64.40470282704949,31.447595590261667,NaN,NaN,16.939088832394013,-0.43609039542667016
2000-07-18T09:30:00-04:00,27.96875,28.15625,27.90625,28.125,230700,84275,62.47736495833377,56.49859644856546,NaN,NaN,85.57092448149035,121.62141089741108,0.26392299032848154,0.451715925573982,0.18779293524550045,-884500,-1007040,66.09658942671446,35.40792233453543,NaN,NaN,18.25125589361221,2.2335305030074557
2000-07-19T09:30:00-04:00,27.96875,28.04687,27.71875,27.76562,68600,87000,57.58794428688547,57.56256735004617,NaN,NaN,65.24831835586517,98.72074907921679,0.19951060127449988,0.4371811868386253,0.2376705855641254,-953100,-998340,66.71070470129797,39.45189016610694,NaN,NaN,17.950705150468057,4.4788411669303985
2000-07-20T09:30:00-04:00,27.875,28.0625,27.6875,27.6875,49300,81350,56.55190797921762,58.84804106536647,NaN,NaN,57.00230272208547,83.84099225192357,0.141527255037658,0.4145796543611979,0.2730523993235399,-1002400,-994180,67.01834113439358,43.52287965703753,NaN,NaN,17.40778270088412,6.325832814638073
2000-07-21T09:30:00-04:00,27.6875,27.8125,27.5,27.625,110000,74005,55.68870489443778,59.795927356078764,NaN,NaN,42.505564542496046,69.5319667286775,0.09128735377659569,0.38716159154428453,0.29587423776768884,-1112400,-1013520,64.05465841648353,47.39050897145147,NaN,NaN,16.718502404933837,7.810499898966039
2000-07-24T09:30:00-04:00,27.60937,27.60937,27,27.1875,13900,72655,49.94205364168439,60.018994770231856,NaN,NaN,14.81473245040944,53.02836851046933,0.02439486617608022,0.3263678204877891,0.3019729543117089,-1126300,-1015740,63.706399469561845,51.16156858106304,NaN,NaN,14.435156763167084,8.75687945099476
2000-07-25T09:30:00-04:00,27.0625,27.25,26.84375,27.25,17400,72870,50.72434187990996,60.033497780238534,NaN,NaN,-1.443964549690001,35.62539070423325,-0.017575294118933715,0.28000383666304174,0.29757913078197545,-1108900,-1060620,56.963692954243456,54.47565487115581,NaN,NaN,12.750109329314457,9.327340862183288
2000-07-26T09:30:00-04:00,27.0625,27.375,26.90625,27.15625,83400,70425,49.47535287585315,59.80665533410235,NaN,NaN,-5.00460082577719,21.574806867904755,-0.051655929650606836,0.23300921871871694,0.2846651483693238,-1192300,-1108460,50.79244087940253,57.35587519439481,NaN,NaN,10.985026331537592,9.564153072091045
2000-07-27T09:30:00-04:00,27.09375,27.375,27.0625,27.375,3500,68955,52.41932862573589,58.97648333490707,NaN,NaN,-1.179076265894991,9.938531070308658,-0.05894424642034679,0.2109848403438903,0.2699290867642371,-1188800,-1145740,46.55940466446671,58.83882749603704,NaN,NaN,10.222062088392649,9.658140074419846
2000-07-28T09:30:00-04:00,27.125,27.125,26.53125,26.53125,8300,61625,42.20432915783235,57.22169925337414,NaN,NaN,-62.8346279058372,-11.129507419357987,-0.11672951318061645,0.12401719528846655,0.240746708469083,-1197100,-1162680,44.734994536232115,59.17463056302928,NaN,NaN,6.262553043522649,9.173056212863104
2000-07-31T09:30:00-04:00,26.78125,26.78125,26,26,15700,60775,37.2785418915495,55.02187087750389,NaN,NaN,-119.76743825491049,-38.04594156042198,-0.18292702062174507,0.01208793269190167,0.19501495331364674,-1212800,-1179980,42.886765741272484,58.61429438501002,NaN,NaN,1.150105825746001,8.026920443274946
2000-08-01T09:30:00-04:00,26.125,26.375,25.90625,26.375,86000,62910,42.389878142370954,53.1506397653909,NaN,NaN,-130.41738056051545,-63.84062476258707,-0.1926752893061103,-0.04582915831899115,0.14684613098711916,-1126800,-1183560,42.49549904425962,57.5123614725851,NaN,NaN,-1.5133975625793823,6.664017871010042
2000-08-02T09:30:00-04:00,26.125,26.5,26.09375,26.375,113300,65775,42.38987814237096,51.793370546652476,NaN,NaN,-120.42638651954134,-86.9249819013399,-0.19002372636162848,-0.09068352696491644,0.09934019939671204,-1126800,-1170460,44.49115082699184,56.17680913638766,NaN,NaN,-3.60871669139785,5.196484362094629
2000-08-03T09:30:00-04:00,26.34375,26.5625,26.15625,26.25,15700,66175,41.09521242574846,50.155755806679636,NaN,NaN,-118.98227164750658,-110.48562097766221,-0.1872832939548756,-0.13476391804688248,0.05251937590799313,-1142500,-1161200,45.919864083372595,54.7739434789816,NaN,NaN,-5.719221548421414,3.63709780344948
2000-08-04T09:30:00-04:00,26.25,26.25,26.01562,26.14062,8400,57720,39.94553420922791,48.583598079368436,NaN,NaN,-120.90511908476344,-122.09971921344746,-0.183207129466699,-0.17648953592538064,0.006717593541318373,-1150900,-1151960,47.37538173707466,53.55756340112625,NaN,NaN,-7.80416090709913,2.0026322733711073
2000-08-07T09:30:00-04:00,26.0625,26.9375,26.0625,26.84375,5600,51805,49.689318588465675,47.670166195806424,NaN,NaN,-66.42715058853103,-111.43166168017157,-0.12623737712979233,-0.15107912787092204,-0.02484175074112971,-1145300,-1138460,49.51335700811646,52.37304679979783,NaN,NaN,-6.730784830217395,0.7550012585727499
2000-08-08T09:30:00-04:00,27.09375,27.84375,27.09375,27.64062,4500,48825,58.00529780047653,47.699977161062925,NaN,NaN,30.587010856072556,-79.23078339685398,-0.032831408879995916,-0.0658810118411246,-0.03304960296112869,-1140800,-1141260,49.068088678046486,51.112859940994156,NaN,NaN,-2.8835024578069133,0.2352150133756552
2000-08-09T09:30:00-04:00,27.3125,27.3125,27,27.15625,84100,52600,52.34189936259247,47.39926225987542,NaN,NaN,-2.705082836452445,-55.686522660236186,-0.0031753357522941172,-0.037018772651496334,-0.03384343689920222,-1224900,-1160880,45.94985112131799,49.60796779720304,NaN,NaN,-1.5959987780158305,-0.02638695682312847
2000-08-10T09:30:00-04:00,26.71875,26.71875,26.375,26.375,4500,51495,44.75224856946053,46.61808680809133,NaN,NaN,-71.36793753946655,-46.16365583862819,-0.0339700330058136,-0.07630597815646922,-0.04233594515065562,-1229400,-1178260,43.323407306873186,48.127164146516584,NaN,NaN,-3.214708111393161,-0.4818614074759902
2000-08-11T09:30:00-04:00,26.40625,26.9375,26.40625,26.75,22500,52245,48.60457184805818,46.52255239426089,NaN,NaN,-40.651889534348804,-30.11300992854526,-0.027173194726570954,-0.07630243855886931,-0.04912924383229836,-1206900,-1189460,41.67043720945563,46.553166842223284,NaN,NaN,-3.1552606148730384,-0.8637755799612827
2000-08-14T09:30:00-04:00,27,27.21875,27,27.09375,400,47290,51.91449864529035,46.60756359178806,NaN,NaN,15.345337531821906,-13.758512304474674,0.0008966194747538347,-0.048008469488856065,-0.0489050889636099,-1206500,-1201700,39.87965858616275,45.33287867307466,NaN,NaN,-1.9736109045428576,-1.0223234834729362
2000-08-15T09:30:00-04:00,27,27,26.3125,26.3125,3900,35950,44.84568447866953,46.27687299198923,NaN,NaN,-51.54484096075822,-30.18488266784083,-0.030968458557610302,-0.08761566216062278,-0.05664720360301247,-1210400,-1215620,37.88563227365429,44.41096377266407,NaN,NaN,-3.467746686978659,-1.371669655402325
2000-08-16T09:30:00-04:00,25.78125,25.9375,25.625,25.79687,10400,33040,40.88845337449084,45.453239045471726,NaN,NaN,-142.81310024749482,-58.206486150049294,-0.08170731462065894,-0.15878134687883616,-0.07707403225817722,-1220800,-1214800,38.08203856856611,43.80543762295689,NaN,NaN,-6.0896569516002375,-2.045667840573455
2000-08-17T09:30:00-04:00,25.90625,25.90625,25.59375,25.8125,26500,31900,41.05823838770332,45.37137541903394,NaN,NaN,-135.3995088905673,-71.01280042026944,-0.10752607485320657,-0.21148162582468544,-0.10395555097147886,-1194300,-1207780,39.83595267677478,43.45550606156707,NaN,NaN,-8.034875683129263,-2.9012689609385705
2000-08-18T09:30:00-04:00,25.92187,26.17187,25.90625,26.15625,3200,26560,44.8125941373967,45.909522008023025,NaN,NaN,-83.98025534936032,-79.67847358327175,-0.09518701420008022,-0.22293931872157913,-0.1277523045214989,-1191100,-1204620,40.650920224834636,43.29580281039295,NaN,NaN,-8.442298205167653,-3.6928445672570107
2000-08-21T09:30:00-04:00,26.03125,26.03125,25.5,25.53125,11200,26425,39.84335186003288,45.727627273570306,NaN,NaN,-129.8618460920789,-108.71991030805191,-0.12118461596806601,-0.2792330744815814,-0.1580484585135154,-1202300,-1203780,40.88017232222393,43.18042233024754,NaN,NaN,-10.432717533131356,-4.655683562381917
2000-08-22T09:30:00-04:00,25.78125,26.3125,25.78125,26.03125,14100,26260,45.08927512185877,45.92044134353372,NaN,NaN,-69.78925149936705,-112.36879241577367,-0.09777698174555999,-0.2802696856954654,-0.1824927039499054,-1188200,-1199340,42.15213689793672,43.0133499067436,NaN,NaN,-10.370515651834793,-5.472088146589471
2000-08-23T09:30:00-04:00,26.01562,26.15625,25.875,25.875,32100,23695,43.80373926768687,46.11390754652932,NaN,NaN,-74.1198517832869,-98.6301427229321,-0.08628765796861085,-0.29035227641066896,-0.20406461844205812,-1220300,-1199240,42.182308912905775,42.74638168028169,NaN,NaN,-10.724368269494425,-6.222413878433035
2000-08-24T09:30:00-04:00,26.0625,26.0625,25.8125,25.875,4200,23730,43.80373926768688,46.38949362213352,NaN,NaN,-77.00832937061753,-86.95190681894215,-0.07270261262227048,-0.29494288421989623,-0.22224027159762574,-1220300,-1204440,40.98520424453668,42.28994043081469,NaN,NaN,-11.00500356209152,-6.905640976098533
2000-08-25T09:30:00-04:00,26.0625,26.10937,25.875,26.10937,1000,23365,46.45924237238956,46.158773892413805,NaN,NaN,-53.11236856633629,-80.77832946233734,-0.043393510293047444,-0.27648215946393506,-0.23308864917088762,-1219300,-1210080,39.670201595212355,41.58685790132154,NaN,NaN,-10.470916034219856,-7.4149659844015785
2000-08-28T09:30:00-04:00,25.96875,26.07812,25.6875,25.6875,26300,23895,42.56064075457336,45.05558410342072,NaN,NaN,-82.85272557227565,-71.37650535837669,-0.04754610636379408,-0.2925212821256302,-0.24497517576183614,-1245600,-1218740,37.6715526629819,40.77281961453121,NaN,NaN,-11.151909584721839,-7.948815070161616
2000-08-29T09:30:00-04:00,25.8125,25.8125,25.5,25.57812,8500,20020,41.586255918377155,44.28732385740535,NaN,NaN,-102.54206426056774,-77.92706791061683,-0.05240341182257369,-0.3104794405400533,-0.2580760287174796,-1254100,-1231920,34.798064583430374,39.97626343325352,NaN,NaN,-11.991000453661728,-8.526270124947347
2000-08-30T09:30:00-04:00,25.5,25.5,25.28125,25.28125,4600,14585,38.977973061759926,43.874875606855305,NaN,NaN,-127.88737135238942,-88.68057182443734,-0.06929352330833138,-0.3446929328528938,-0.27539940954456243,-1258700,-1239600,33.208508892570606,39.253770689374775,NaN,NaN,-13.460592781113373,-9.231173361542494
2000-08-31T09:30:00-04:00,25.125,25.125,24.71875,24.92187,15100,14555,36.03176962103505,42.97681830492508,NaN,NaN,-166.03981108248095,-106.48686816681001,-0.0966714651529198,-0.3962387409857122,-0.2995672758327924,-1273800,-1250300,31.078470016687604,38.49720160417706,NaN,NaN,-15.598466916700671,-10.140786726565091
2000-09-01T09:30:00-04:00,24.8125,25.42187,24.8125,25.42187,162500,22260,42.539286173793734,42.30716027124676,NaN,NaN,-112.94355743209678,-118.45310593996211,-0.074123821176656,-0.3922220523036124,-0.3180982311269564,-1111300,-1228700,39.51289722039523,38.47100436376509,NaN,NaN,-15.545201532441402,-10.91284598454742
2000-09-05T09:30:00-04:00,25.5625,25.875,25.5,25.6875,1223500,83155,45.69970702925999,42.36816188200322,NaN,NaN,-50.233312089434875,-111.92922324339398,-0.036253774669433136,-0.3634154494637478,-0.3271616747943147,112200,-957140,77.23399239451949,41.28160151525547,NaN,NaN,-14.557625154022178,-11.433528723043814
2000-09-06T09:30:00-04:00,26.0625,26.23437,26,26.0625,30500,84455,49.88993540532881,43.011124884205934,NaN,NaN,15.560881462235887,-88.30863409883324,0.01629721406232798,-0.3067901572164047,-0.32308737127873266,142700,-677780,86.53602569308042,44.74260059557792,NaN,NaN,-12.439944409469035,-11.57730239253313
2000-09-07T09:30:00-04:00,26.1875,26.1875,25.84375,25.84375,114800,85990,47.58323616066378,43.47719615370311,NaN,NaN,3.367155732340356,-62.05772868188727,0.037366240758431535,-0.27637957033069327,-0.3137458110891248,27900,-420460,90.41919940284725,48.35568964744024,NaN,NaN,-11.341269105338194,-11.543583351505283
2000-09-08T09:30:00-04:00,26,26.48437,26,26.32812,5870102,379270.1,52.788466985353615,44.04690135712861,NaN,NaN,65.07892063492275,-15.833982338406543,0.08238482092559218,-0.21076478493213457,-0.29314960585772676,5898002,1013900.4,96.49227409181823,52.344357780796216,NaN,NaN,-8.780202269677428,-11.148814625529875
2000-09-11T09:30:00-04:00,26.46875,26.875,26.46875,26.8125,2624200,509355.1,57.349731016976,45.29735701119597,NaN,NaN,149.75290999011105,36.70531114603502,0.1398674353714302,-0.118315311643439,-0.2581827470148692,8522202,2940600.8,98.17015616159513,56.43649948360844,NaN,NaN,-5.114710812004755,-10.286799795026287
2000-09-12T09:30:00-04:00,26.75,27,26.51562,26.8125,1121100,565390.1,57.349731016976,46.173103860847206,NaN,NaN,171.62986355923704,81.0779462757694,0.17091814522242005,-0.04453506548684416,-0.2154532107092642,8522202,4622601.2,98.73778613459658,60.47833157194129,NaN,NaN,-2.1959924505535215,-9.13097017438732
2000-09-13T09:30:00-04:00,26.96875,26.96875,26.70312,26.8125,87800,569585.1,57.349731016976,47.14067470008214,NaN,NaN,171.94028510581052,112.35382700448433,0.1833845627990462,0.013777492789543544,-0.16960707000950265,8522202,6298501.6,99.05300149826618,64.54052389946703,NaN,NaN,0.17714915534947825,-7.801238841567778
2000-09-14T09:30:00-04:00,26.75,26.84375,26.53125,26.65625,17000,569915.1,55.201048215922064,47.95476819638465,NaN,NaN,124.66905095837198,136.61420604969067,0.17315971532151014,0.04684257414238502,-0.12631714117912513,8505202,7993962,99.25555185479392,68.70269158591398,NaN,NaN,1.6183239840161938,-6.455587009341496
2000-09-15T09:30:00-04:00,26.45312,26.45312,26.20312,26.35937,43900,570785.1,51.270492051054546,48.29842888771787,NaN,NaN,58.456815676875756,135.28978505808124,0.13987908183091205,0.04853171110951493,-0.09134737072139712,8461302,8506622,99.30402527397054,72.962250420111,NaN,NaN,1.8002947651404884,-5.276175327272641
2000-09-18T09:30:00-04:00,26.01562,26.125,25.8125,25.82812,16300,571440.1,45.08415846912219,48.47868015304279,NaN,NaN,-12.380896154644699,102.86302382913011,0.078616395542272,0.00692312370644288,-0.07169327183582912,8445002,8491182,99.09474784772998,77.34962150473586,NaN,NaN,0.13500817677574273,-4.503149112408586
2000-09-19T09:30:00-04:00,25.625,25.6875,25.3125,25.39062,3054300,723595.1,40.72601463219907,48.417234346887206,NaN,NaN,-87.66496874806428,51.00405736766985,0.008830315224312046,-0.06065537780543906,-0.0694856930297511,5390702,7864882,90.74104349596772,81.3455485699171,NaN,NaN,-2.6685878038242596,-4.241068925467968
2000-09-20T09:30:00-04:00,25.5,25.5,24.84375,24.89062,13800,723580.1,36.39583502694781,48.23279591582921,NaN,NaN,-131.8091418117818,-9.745828015848616,-0.06664849176253544,-0.1527963077329204,-0.08614781597038497,5376902,7235822,83.15826730031932,84.91338845618486,NaN,NaN,-6.513281052321326,-4.565670657875591
2000-09-21T09:30:00-04:00,25.48437,25.8125,25.39062,25.8125,3800,722165.1,47.48305204484337,49.05074466038694,NaN,NaN,-37.19384109705142,-42.118406426933305,-0.05084570053054169,-0.14970494163356207,-0.09885924110302038,5380702,6610922,76.33415004486213,88.1459370296259,NaN,NaN,-6.2618641497935545,-4.807984013863872
2000-09-22T09:30:00-04:00,25.5625,25.6875,25.5625,25.64062,1400,722025.1,45.87732859598911,49.28917626197232,NaN,NaN,-40.01520061297956,-61.812809684904366,-0.0483431007233327,-0.15928811700718626,-0.11094501628385356,5379302,5994522,70.21348819219328,90.33883638475433,NaN,NaN,-6.590691276412892,-5.062656479942303
2000-09-25T09:30:00-04:00,25.59375,25.59375,25.21875,25.25,3009700,872460.1,42.370537383158236,49.05137843010791,NaN,NaN,-72.49853344980232,-73.83633714393589,-0.06815728572902052,-0.1961416234451292,-0.12798433771610868,2369602,4779442,60.00032962645018,89.10786047274938,NaN,NaN,-8.011378833958071,-5.4839025305159845
2000-09-26T09:30:00-04:00,25.25,25.25,24.45312,24.6875,7800,871535.1,37.880220215510896,48.193541630835206,NaN,NaN,-130.88103994442733,-82.47955138320852,-0.11173414260407974,-0.26765201597120836,-0.15591787336712862,2361802,4173662,55.65392582361921,86.90199619635929,NaN,NaN,-10.734118330845087,-6.2339333591344275
2000-09-27T09:30:00-04:00,24.84375,24.96875,24.75,24.92187,3300,871275.1,40.7001036521843,47.70188930880095,NaN,NaN,-108.3990980275433,-77.79754262636081,-0.11681156452380453,-0.30193232902188427,-0.18512076449807974,2365102,3571302,51.64754699405571,84.13259245287418,NaN,NaN,-12.026730056211218,-7.061475744431112
2000-09-28T09:30:00-04:00,24.89062,25.40625,24.875,25.3125,4300,871260.1,45.16781454556261,47.15755699167302,NaN,NaN,-68.41552582151665,-84.04187957125386,-0.08725373429219921,-0.29418793236332874,-0.20693419807112953,2369402,2969042,47.93222566071069,80.66401756493794,NaN,NaN,-11.678017650995901,-7.720981731083224
2000-09-29T09:30:00-04:00,25.125,25.25,24.89062,24.89062,10100,871010.1,41.528763440456885,46.02748787906451,NaN,NaN,-91.84156098394129,-94.40715164544619,-0.08919029042964308,-0.3184220611081834,-0.2292317706785403,2359302,2365042,44.47667992993665,76.8287692626766,NaN,NaN,-12.550344716149887,-8.41089072894989
2000-10-02T09:30:00-04:00,24.875,25,24.5,24.5,1008000,913285.1,38.44060540221107,44.67683604943844,NaN,NaN,-124.09672009812861,-104.72678897511146,-0.10856717743865096,-0.36494074247685404,-0.2563735650382031,1351302,2161382,43.34205573579521,72.87193137704794,NaN,NaN,-14.270330377514801,-9.247953535887735
2000-10-03T09:30:00-04:00,24.53125,24.8125,24.5,24.6875,10400,852630.1,40.71934647495586,43.48895143929415,NaN,NaN,-109.61503460819446,-100.47358790786488,-0.10071784316226323,-0.38227086899103213,-0.2815530258287689,1361702,1961362,42.2033309451947,68.81124062325712,NaN,NaN,-14.967770435688479,-10.06507023585927
2000-10-04T09:30:00-04:00,24.6875,25.46875,24.6875,25.125,2012600,951735.1,45.76419572908752,42.814890547377395,NaN,NaN,-58.755457316781104,-90.54485976571245,-0.060031143624819205,-0.35659195535979293,-0.29656081173497373,3374302,2163202,43.807701074062116,64.85067985320485,NaN,NaN,-13.990704236487522,-10.625875093091878
2000-10-05T09:30:00-04:00,25.09375,25.09375,24.79687,24.79687,5400,946265.1,42.820838704052065,42.21134387973435,NaN,NaN,-72.33081732801503,-91.32791806701212,-0.04961937855790677,-0.35858503493235716,-0.3089656563744504,3368902,2363102,45.42353744861991,61.00207357996553,NaN,NaN,-14.076502789608803,-11.11882190688001
2000-10-06T09:30:00-04:00,24.5625,24.5625,24.01562,24.01562,12000,653360,36.75893772496525,41.616685255151715,NaN,NaN,-130.5102865847757,-99.061663187179,-0.08753312505196797,-0.41838206268941036,-0.3308489376374424,3356902,2562622,47.059842001286476,57.28529459093385,NaN,NaN,-16.15128603577953,-11.837745353865655
2000-10-09T09:30:00-04:00,24.15625,24.375,24.15625,24.17187,4400,522370,38.630151470440985,41.46698074359757,NaN,NaN,-119.02425612429559,-98.04717039241238,-0.09372029920381131,-0.4479993116422065,-0.3542790124383952,3361302,2964622,50.29351506253246,54.396185417117046,NaN,NaN,-17.223212976572018,-12.607097871395135
2000-10-10T09:30:00-04:00,24.3125,24.3125,24.0625,24.1875,4600,466545,38.82514528030991,41.64050290455201,NaN,NaN,-117.51003904819846,-99.62617128041319,-0.08845796293102665,-0.46485146610217853,-0.3763935031711519,3365902,3365462,53.35310550311906,52.2672452887456,NaN,NaN,-18.01873018937154,-13.38018820253462
2000-10-11T09:30:00-04:00,24,24,23.34375,23.5,118400,468075,33.746042203902064,40.65928791591334,NaN,NaN,-173.12438552637192,-122.49995692233135,-0.12096565607037008,-0.5276005732591145,-0.4066349171887444,3247502,3340102,53.13028494022174,50.60982635269986,NaN,NaN,-20.33399380368452,-14.373589002698893
2000-10-12T09:30:00-04:00,22.23437,22.23437,21.5625,21.85937,45600,469505,25.25524961881382,39.186282274686526,NaN,NaN,-304.62486300993135,-168.95876605871462,-0.23599358964289546,-0.7016269042423637,-0.4656333145994683,3201902,3306702,52.81742161190003,49.3672501683932,NaN,NaN,-25.836906220031064,-16.01120574803206
2000-10-13T09:30:00-04:00,21.9375,22.375,21.75,22.3125,87600,471690,30.459520778688727,38.33549537436728,NaN,NaN,-220.4195428173956,-186.9406173052386,-0.2625569079614368,-0.7938294495512643,-0.5312725415898275,3289502,3293222,52.68258504022997,48.844554126520336,NaN,NaN,-28.30052132231912,-17.7668222586445
2000-10-16T09:30:00-04:00,22.5625,22.85937,22.5625,22.70312,4400,471095,34.681643135202464,38.10702558291668,NaN,NaN,-141.2648412793495,-191.38873433624937,-0.23567064810531602,-0.8258608517214725,-0.5901902036161565,3293902,3279742,52.53814422961674,48.62199829837731,NaN,NaN,-28.782974232969522,-19.340558254976646
2000-10-17T09:30:00-04:00,23.03125,23.03125,22.07812,22.07812,6400,318700,31.396977255522827,37.44251655458371,NaN,NaN,-139.79604475905967,-195.8459354784216,-0.24097000495700638,-0.8914027098124144,-0.650432704855408,3287502,3264062,52.35831951127946,48.6727677638933,NaN,NaN,-30.321521651962303,-20.909267311688883
2000-10-18T09:30:00-04:00,21.82812,22.53125,21.82812,22.5,4400,318230,35.81586367647152,36.77452006393435,NaN,NaN,-125.7233722994227,-186.36573283303176,-0.19880622649725133,-0.8989404879769722,-0.7001342614797209,3291902,3272942,52.45756429256313,48.99600623759704,NaN,NaN,-30.06169665730381,-22.216757218205302
2000-10-19T09:30:00-04:00,22.53125,23.46875,22.53125,23.42187,29600,319520,44.26416722878772,36.96990604881512,NaN,NaN,-59.58172714683991,-137.35710566041345,-0.09674245594046682,-0.8210623314053045,-0.7243198754648377,3321502,3296862,52.74313810439209,49.58646753577242,NaN,NaN,-26.846031751097094,-22.878082151475557
2000-10-20T09:30:00-04:00,22.95312,23.15625,22.78125,23,2100,319555,41.567721567364565,37.19327148918323,NaN,NaN,-61.41686881698713,-105.55657086033177,-0.048018734250199424,-0.7843432932775869,-0.7363245590273875,3319402,3302842,52.81943814185016,50.2634234219192,NaN,NaN,-25.184477083124335,-23.207567141711095
2000-10-23T09:30:00-04:00,23.0625,23.1875,23,23.14062,4300,169285,42.8181270947695,37.34318439059849,NaN,NaN,-46.46306862540724,-86.59621632954331,0.0007245423052124611,-0.735418881145872,-0.7361434234510844,3323702,3308802,52.90105892818356,51.027546849275545,NaN,NaN,-23.478742090999322,-23.246306420180844
2000-10-24T09:30:00-04:00,23.15625,23.5,23.15625,23.15625,16800,169735,42.96422432546963,37.143186433197215,NaN,NaN,-31.29387140064762,-64.89578165786091,0.03894665119073737,-0.6874601094626627,-0.7264067606534,3340502,3319402,53.05660407262099,51.68818277774404,NaN,NaN,-22.089201394980638,-23.0810057022951
2000-10-25T09:30:00-04:00,23.25,23.25,22.8125,22.8125,141800,176660,40.512662733725136,36.978316721031,NaN,NaN,-47.49311438033426,-49.249730074043235,0.045547070583887295,-0.669472922423541,-0.7150199930074282,3198702,3300762,52.72684117125793,52.20984732936104,NaN,NaN,-21.640259834792,-22.875184864080374
2000-10-26T09:30:00-04:00,22.8125,22.84375,22.53125,22.73437,3400,176615,39.95462610672017,37.206580176870645,NaN,NaN,-59.58892692043645,-49.25117002876256,0.048829059602045644,-0.6539836685048712,-0.7028127281069169,3195302,3275522,52.253249803203396,52.58080502949797,NaN,NaN,-21.43129937813358,-22.66891550894512
2000-10-27T09:30:00-04:00,22.5,23,22.5,22.95312,5700,176395,42.349009070188735,37.472212862566906,NaN,NaN,-46.19149685255708,-46.206095635876544,0.06869397019252976,-0.6169452653662546,-0.6856392355587844,3201002,3251842,51.7833136120579,52.68721921160692,NaN,NaN,-20.586309456723427,-22.371400358627735
2000-10-30T09:30:00-05:00,22.84375,23.84375,22.84375,23.53125,48700,128430,48.22518444085382,38.14364423117719,NaN,NaN,6.244702039091824,-35.66454150297673,0.12068960789096883,-0.5347772256950734,-0.6554668335860422,3249702,3237042,51.47174109234779,52.55283603940897,NaN,NaN,-18.112985833384386,-21.763055426450112
2000-10-31T09:30:00-05:00,24.0625,24.64062,24,24.57812,150200,135420,56.809870372391906,39.79106052892646,NaN,NaN,96.88661114937352,-10.02844499297249,0.21973728132668857,-0.3807952319276815,-0.6005325132543701,3399902,3248922,51.72284322574477,52.45230448837491,NaN,NaN,-13.010342828599205,-20.51266791247141
2000-11-01T09:30:00-05:00,24.75,24.9375,24.5625,24.78125,161300,42855,58.25618888408728,42.148270476445994,NaN,NaN,133.6012409383087,26.190426070756104,0.28873767512116477,-0.23961041935291405,-0.5283480944740788,3561202,3321422,53.31058677782867,52.48753057165552,NaN,NaN,-8.42654129249756,-18.78607839533229
2000-11-02T09:30:00-05:00,24.59375,25.03125,24.4375,25,7500,42960,59.81675827295891,44.245216011751005,NaN,NaN,140.5205953577545,66.2123305263943,0.3356266418302051,-0.1088147921863225,-0.4444414340165276,3568702,3396102,54.953996767418616,52.649774266454706,NaN,NaN,-4.179475455586004,-16.699420832511393
2000-11-03T09:30:00-05:00,25.03125,25.03125,24.3125,24.64062,13900,43055,56.10577434163359,45.775511097924664,NaN,NaN,118.88540201501618,99.22771029990895,0.3285387303064614,-0.03376802113345079,-0.3623067514399122,3554802,3466862,56.515803027677144,52.93389275203045,NaN,NaN,-1.6677512318358116,-14.552039460986311
2000-11-06T09:30:00-05:00,24.5625,25.03125,24.5625,24.96875,2200,42945,58.62945369228797,47.720687986265034,NaN,NaN,126.9694450514748,123.37265890238555,0.3311171930749672,0.05158973990379678,-0.2795274531711704,3557002,3528322,57.881740217810666,53.328422802496966,NaN,NaN,1.2076408628034523,-12.300656557587773
2000-11-07T09:30:00-05:00,24.78125,24.9375,24.65625,24.71875,16700,43550,55.988246903493575,49.161572502480894,NaN,NaN,112.43507148393749,126.48235096929834,0.3019695956579857,0.09793454140131175,-0.20403505425667395,3540302,3556402,58.522799135666176,53.76165386271862,NaN,NaN,2.8614375345431258,-10.134643115854788
2000-11-08T09:30:00-05:00,25.09375,25.3125,25,25,23100,38785,58.26603545603914,50.16170594728457,NaN,NaN,119.64844846579493,123.69179247479558,0.28767956768584135,0.15556440535062777,-0.1321151623352136,3563402,3556842,58.53344953010431,54.17524753598377,NaN,NaN,4.921226172054592,-7.983804646153448
2000-11-09T09:30:00-05:00,24.1875,24.28125,23.65625,24.03125,14800,37245,48.881856202314786,50.684144135495295,NaN,NaN,32.003829606892516,101.98843932462317,0.20302332358379482,0.12166399214452994,-0.08135933143926488,3548602,3552822,58.38593914981884,54.57285475083868,NaN,NaN,3.889056172568719,-6.287681672050281
2000-11-10T09:30:00-05:00,23.15625,23.28125,22.92187,22.92187,30500,34390,40.781605735800305,50.53867832414035,NaN,NaN,-44.55359100638306,69.30064072034332,0.06926330935078688,0.005219805249218723,-0.06404350410156816,3518102,3545482,58.09804379113669,54.944067955335335,NaN,NaN,0.12974288615752633,-5.370906735163452
2000-11-13T09:30:00-05:00,22.875,23.5625,22.8125,23.5625,22300,35285,46.314119033362296,50.77795651756126,NaN,NaN,-26.420878106928683,38.622576088662626,0.023261609036850074,-0.03496649280550557,-0.05822810184235564,3540402,3542162,57.95883305401744,55.29422716829222,NaN,NaN,-1.1060218878330266,-4.761637471259105
2000-11-14T09:30:00-05:00,24.1875,24.28125,24.09375,24.26562,60600,37995,51.65291137270181,51.573688563202445,NaN,NaN,40.21019353564388,24.177600499003898,0.03861155277061744,-0.009963660879083847,-0.048575213649701285,3601002,3554302,58.35181499184418,55.696011012619806,NaN,NaN,-0.2937979109498375,-4.12337467692921
2000-11-15T09:30:00-05:00,24,24.5,24,24.5,14500,38500,53.31937333048719,52.52831336490009,NaN,NaN,43.97169475799105,9.042249757443123,0.06160895372255143,0.028435978503488002,-0.03317297521906343,3615502,3564722,58.70858741945063,56.15710655663747,NaN,NaN,0.8947359818527841,-3.406501725674639
2000-11-16T09:30:00-05:00,24.40625,24.40625,24.125,24.23437,10200,37530,51.166816007686315,53.158156717578485,NaN,NaN,33.042256674110966,9.249935170886813,0.05614418159044603,0.03700725176899411,-0.019136929821451917,3605302,3576062,59.11902439055837,56.68108589795894,NaN,NaN,1.1716071221103508,-2.752486175991069
2000-11-17T09:30:00-05:00,24.0625,24.28125,23.90625,24.21875,4200,37635,51.0363378597342,53.35895339035566,NaN,NaN,18.13284944114834,21.787223260393098,0.04895343334286974,0.04205486185713525,-0.006898571485734483,3601102,3592662,59.7497422322962,57.272371693669534,NaN,NaN,1.3523704979811793,-2.1660780797093193
2000-11-20T09:30:00-05:00,23.98437,24,23.59375,23.625,64600,40650,46.212264356679185,52.60198153209046,NaN,NaN,-24.167908800717885,22.23781712163526,0.004051346849365442,-0.0018343879240276806,-0.005885734773393122,3536502,3591882,59.70313190238707,57.8423923134297,NaN,NaN,0.03671616625575676,-1.8513931874285943
2000-11-21T09:30:00-05:00,23.70312,23.70312,23.4375,23.4375,89700,44295,44.77302449738483,51.638898361611716,NaN,NaN,-48.23715575550547,4.548347263405388,-0.03621694220854316,-0.05115691253407206,-0.01493997032552891,3446802,3561042,57.783771736894856,58.16190552479157,NaN,NaN,-1.4718316368823252,-1.7971701087791272
2000-11-22T09:30:00-05:00,23.28125,23.46875,23.0625,23.1875,64800,40445,42.85649292697738,50.42745083689875,NaN,NaN,-81.40072615954514,-20.52613692010185,-0.07537598480415642,-0.10915995133072443,-0.03378396652656801,3382002,3514342,54.9053071975786,58.15842769837442,NaN,NaN,-3.2961296945611,-2.011307192462266
2000-11-24T09:30:00-05:00,23.0625,23.34375,23.0625,23.34375,700,40310,44.456770695022534,49.595379147855105,NaN,NaN,-87.39678299065535,-44.613944853055116,-0.08568926844447926,-0.14089555208216709,-0.05520628363768783,3382702,3469822,52.233956660987296,57.85258152932515,NaN,NaN,-4.373585411660242,-2.3487755094905483
2000-11-27T09:30:00-05:00,24,24.25,23.9375,24.1875,2800,40165,52.23555393272447,49.138672022171995,NaN,NaN,3.489451797346126,-47.54262438181556,-0.03331200278593925,-0.0968462871201119,-0.06353428433417264,3385502,3426702,49.71117943653007,57.26897004494797,NaN,NaN,-3.0256746368989633,-2.4454753848346074
2000-11-28T09:30:00-05:00,24,24.21875,23.71875,24.09375,37100,39585,51.374617046958576,48.8091270324195,NaN,NaN,-15.898163984220993,-45.88867541851618,-0.004140353196167887,-0.0687097258293825,-0.06456937263321462,3348402,3389082,47.553280114857074,56.48543297203303,NaN,NaN,-2.176295576934929,-2.4070211265632246
2000-11-29T09:30:00-05:00,24.21875,24.4375,24.1875,24.4375,28700,33510,54.34588072118854,48.52911597993017,NaN,NaN,31.23896840836231,-29.993450585742625,0.03688690435649776,-0.018460742187592416,-0.055347646544090176,3377102,3375142,46.74357349879788,55.64329896979685,NaN,NaN,-0.5865889476743872,-2.1469593867219623
2000-11-30T09:30:00-05:00,24.1875,24.1875,23.5,23.96875,43700,27630,49.87073496735266,48.599750177432874,NaN,NaN,-27.563888300563082,-19.226083013946212,0.03125838609543735,-0.016274663924793487,-0.04753305002023084,3333402,3365422,46.153454500961836,54.76955006630707,NaN,NaN,-0.5127808089771854,-1.9135053041869943
2000-12-01T09:30:00-05:00,24.15625,24.375,23.84375,24,51600,29835,50.165357072665216,49.270018130066084,NaN,NaN,4.420313650230473,-0.8626636857690491,0.028519575378842664,-0.011883580796677506,-0.04040315617552017,3385002,3365882,46.18807811825391,53.91883823252972,NaN,NaN,-0.3702606857583074,-1.6930417872686103
2000-12-04T09:30:00-05:00,24.46875,24.90625,24.40625,24.90625,4100,29345,57.893961145062136,50.097149709473214,NaN,NaN,104.03088627777981,19.245623210317692,0.08351100431086575,0.06398559921306202,-0.01952540509780373,3389102,3366602,46.24633966134642,53.08223156162465,NaN,NaN,2.139951732074468,-1.1454712845053134
2000-12-05T09:30:00-05:00,24.8125,25.71875,24.8125,25.5,180900,38280,62.04691476414945,50.839578523148035,NaN,NaN,182.1369398390139,58.852643974964664,0.1516705290460164,0.17006275620971678,0.018392227163700373,3570002,3410922,49.845995910728625,52.474673055830685,NaN,NaN,5.640682912876289,-0.17602068487937028
2000-12-06T09:30:00-05:00,25.75,25.75,25.25,25.34375,26700,38780,60.359735955199774,51.342461567770364,NaN,NaN,179.20364249078574,88.44557879144936,0.176301590528531,0.23876921532436413,0.06246762479583312,3543302,3444162,52.41951727246192,52.02545375961721,NaN,NaN,7.9729451189567975,0.9881172870972251
2000-12-07T09:30:00-05:00,25.46875,25.46875,24.96875,25,17200,38485,56.70647309616278,51.7381513598044,NaN,NaN,138.0086904782095,121.56009454720387,0.15999101463417525,0.2624563930885522,0.10246537845437693,3526102,3482702,55.284460498193724,51.75155633873402,NaN,NaN,8.852100910939978,2.111543519074761
2000-12-08T09:30:00-05:00,25.375,25.5,25.1875,25.26562,6500,38070,58.7824317746473,52.29144378229819,NaN,NaN,136.5685460668051,147.98974103051881,0.15739795885901542,0.2992128270281462,0.1418148681691308,3532602,3512222,57.40030149493361,51.58373914320811,NaN,NaN,10.200940518183847,3.2671716618046305
2000-12-11T09:30:00-05:00,25,25,24.65625,24.95312,13500,37220,55.41574402340445,52.948835187064276,NaN,NaN,74.21259600614567,142.02608297619196,0.1262857016177553,0.2996719951913249,0.17338629357356963,3519102,3538222,59.23011051950963,51.54995190157401,NaN,NaN,10.360716906865548,4.280535268241905
2000-12-12T09:30:00-05:00,24.65625,25.15625,24.5,25,15500,36880,55.82449525625683,53.73822595555514,NaN,NaN,67.4263602129605,119.0839670509813,0.1015760787052799,0.3003563919551695,0.1987803132498896,3534602,3531142,58.49330982037448,51.600633193251134,NaN,NaN,10.605215862690063,5.184061067448784
2000-12-13T09:30:00-05:00,24.96875,25.0625,24.5,24.5,53700,36535,50.50601290850258,54.284620239949795,NaN,NaN,38.758264694985066,90.99489149182116,0.04704270579553457,0.2575836954943078,0.21054098969877325,3480902,3518662,57.14390149345356,51.76053278581362,NaN,NaN,9.276832760959733,5.768742737950348
2000-12-14T09:30:00-05:00,24.40625,24.5625,24.1875,24.42187,115300,41575,49.70906305012378,54.65978397959988,NaN,NaN,2.372327942452734,63.8676189846698,0.003490651682092033,0.2149043043013883,0.21141365261929626,3365602,3486562,53.7116372898504,51.86608140216099,NaN,NaN,7.955531881030015,6.081141186961729
2000-12-15T09:30:00-05:00,23.90625,24.03125,23.5625,23.71875,8900,41510,43.11553310057389,54.00835392016055,NaN,NaN,-67.2135935961856,23.11119105207167,-0.07078881152101285,0.12292763821803021,0.19371644973904306,3356702,3451382,50.156063072018156,51.897858804695844,NaN,NaN,4.741137604625068,5.889712103770778
2000-12-18T09:30:00-05:00,23.9375,24.28125,23.9375,24.23437,72800,44940,48.50934513118216,53.80369164046225,NaN,NaN,-22.972916788984747,3.6740884930455877,-0.08249528562887778,0.09059734270294584,0.17309262833182362,3429502,3433462,48.398542199842616,51.9582346679091,NaN,NaN,3.571525875786873,5.55854264263022
2000-12-19T09:30:00-05:00,24.29687,24.29687,23.625,23.65625,97200,46570,43.52597086614218,53.03084093653036,NaN,NaN,-58.364221402213026,-21.48402782998911,-0.12398045787623257,0.018117055986532904,0.14209751386276548,3332302,3393002,44.59864963991266,51.80502582084587,NaN,NaN,0.9653417513266961,4.902371086729717
2000-12-20T09:30:00-05:00,22.90625,23.5,22.8125,23.375,31500,43660,41.30297503306962,52.41885808408157,NaN,NaN,-127.67038240652582,-54.7697572502913,-0.16272749352824584,-0.06131185304754183,0.101415640480704,3300802,3356982,41.47656727701472,51.47096244770679,NaN,NaN,-1.8835046509055053,3.9329602670675428
2000-12-21T09:30:00-05:00,23.34375,24.25,23.34375,24.09375,97100,45275,48.53663910753494,52.30252108657226,NaN,NaN,-57.842960107305025,-66.81281486024285,-0.13353858188169573,-0.06550758687141567,0.06803099501028007,3397902,3363442,42.25728376053201,51.19019142215523,NaN,NaN,-2.075140191962091,3.0746602014918807
2000-12-22T09:30:00-05:00,24.1875,24.625,24.1875,24.5,27200,46600,52.12773054053368,51.89064747196308,NaN,NaN,0.8687897807295989,-53.19633818485981,-0.08293752409015365,-0.03564091010241199,0.047296613987741654,3425102,3377122,43.96212323055036,51.027033105669794,NaN,NaN,-1.0787486752123296,2.4813160762484223
2000-12-26T09:30:00-05:00,24.28125,24.42187,24,24.03125,73400,50130,47.96846428491059,50.88504386630316,NaN,NaN,-37.61770209714452,-56.12529524649176,-0.07721976342736943,-0.04922809029647013,0.027991673130899297,3351702,3361562,42.427704142329645,50.49715512221273,NaN,NaN,-1.573305013322283,1.9020844920240358
2000-12-27T09:30:00-05:00,24.1875,25.3125,24.1875,25.1875,79400,52245,57.068085406067084,50.64992596993654,NaN,NaN,55.412202637412456,-33.370010438566666,0.003945984831482931,0.03292415417025296,0.02897816933877003,3431102,3381322,45.05065344476971,49.97080770594901,NaN,NaN,1.1810655270355144,1.7990817827399614
2000-12-28T09:30:00-05:00,25.34375,25.5,25.1875,25.5,30200,52320,59.14757825764766,50.82429062432832,NaN,NaN,106.22012441106313,13.408090924951125,0.07429107985759419,0.12184201916076276,0.047550939303168574,3461302,3413422,49.107018369717196,49.529561839629245,NaN,NaN,4.073483449453195,2.123996306556138
2000-12-29T09:30:00-05:00,25.59375,26.0625,25.46875,25.59375,13900,50830,59.777022591121614,50.89533282550506,NaN,NaN,129.1319217928217,50.803067304976466,0.12003695458863264,0.19759713253895939,0.07756017795032674,3475202,3428882,50.983756391976286,49.071237189418014,NaN,NaN,6.54251074994608,2.7552126556118437
2001-01-02T09:30:00-05:00,25.78125,25.9375,25.4375,25.54687,167100,56605,59.285111996807714,51.171716252176715,NaN,NaN,110.02158305512945,72.63362595985645,0.1387181736967689,0.25095789507128785,0.11223972137451896,3308102,3405482,48.092954899689175,48.27572607371655,NaN,NaN,8.364639248069174,3.5565593116771765
2001-01-03T09:30:00-05:00,25.3125,27.5625,25.3125,27.5625,1034400,108120,70.51847391123133,52.22128615610347,NaN,NaN,201.76918697982447,120.51100377525024,0.2707648936379961,0.4506958384220141,0.179930944784018,4342502,3603642,65.78526224090693,48.7965798180403,NaN,NaN,14.42261508565357,5.108852993673804
2001-01-04T09:30:00-05:00,27.40625,28.3125,27.40625,27.95312,259900,112070,72.12364328642383,53.76540261166927,NaN,NaN,249.09089415484988,159.24674207873773,0.3626233361474624,0.633210114968346,0.2705867788208836,4602402,3837902,76.13927394977661,50.153392136349076,NaN,NaN,19.73954681695838,7.1989521112858865
2001-01-05T09:30:00-05:00,27.6875,27.6875,26.75,27.03125,91300,115300,63.356431417497376,54.74021463791024,NaN,NaN,159.50972213315796,169.9046616231567,0.3398906360755017,0.6954500739152607,0.355559437839759,4511102,4047862,81.53325000599398,52.140650187502196,NaN,NaN,21.07873786796152,9.181778647953834
2001-01-08T09:30:00-05:00,26.78125,26.9375,26.375,26.67187,27600,115820,60.28014317353349,55.966258214550216,NaN,NaN,106.22221437941633,165.3227201404756,0.2816482317429998,0.7076197275185088,0.42597149577550897,4483502,4249522,85.03294108238472,54.63185575967123,NaN,NaN,21.070125916002002,10.880113971960714
2001-01-09T09:30:00-05:00,26.90625,26.90625,26.4375,26.45312,96500,120320,58.42070412821292,56.67421242862383,NaN,NaN,90.60167300258814,161.43873812996736,0.21253494056435984,0.6916401714809588,0.47910523091659896,4387002,4465302,87.71561947134391,57.44021842192133,NaN,NaN,20.454860146673887,12.247934854062596
2001-01-10T09:30:00-05:00,26.21875,26.625,25.9375,26.625,130900,126190,59.47838911446286,57.81367087493245,NaN,NaN,69.45160320238091,134.97522137447862,0.16467570493866746,0.6849498620899332,0.5202741571512658,4517902,4500382,88.08938513626924,60.546699528803934,NaN,NaN,20.288244267810686,13.396550484598038
2001-01-11T09:30:00-05:00,26.59375,27,26.21875,26.85937,43800,127605,60.937539852547346,59.21613979060943,NaN,NaN,77.87383534847977,100.73180961320462,0.13625959635915674,0.6905986526002117,0.554339056241055,4561702,4492242,87.42467899324973,63.82870750853501,NaN,NaN,20.586346535036178,14.4236642060892
2001-01-12T09:30:00-05:00,26.5625,27,26.5625,26.84375,71700,128505,60.78045255095708,60.09069789371102,NaN,NaN,75.82745701732806,83.99535659003865,0.10525534154299698,0.6859082331698012,0.5806528916268042,4490002,4488022,87.0579146531668,67.02875257229464,NaN,NaN,20.782478415924636,15.33206623606569
2001-01-16T09:30:00-05:00,26.8125,27.5,26.8125,27.46875,19900,123735,64.70145113465294,60.98882079329097,NaN,NaN,91.26067757381037,81.00304922891746,0.11489715465652417,0.7242743349474594,0.6093771802909352,4509902,4493302,87.1306617102461,70.11221960655863,NaN,NaN,22.105677271186636,16.29972495536868
2001-01-17T09:30:00-05:00,27.46875,27.5,26.90625,27.09375,170800,131830,60.77538373663473,61.9036007541284,NaN,NaN,79.01345103130002,78.68540483465985,0.08543015825300637,0.7161648781071932,0.6307347198541868,4339102,4483722,86.18408780304583,73.23767558232407,NaN,NaN,22.08315222656685,17.125928851254134
2001-01-18T09:30:00-05:00,27.09375,27.125,26.6875,26.6875,7200,128550,56.75735820507955,61.88140595405786,NaN,NaN,54.864140489715766,75.76791229212682,0.030806211745418866,0.6692424845359604,0.6384362727905415,4331902,4446522,82.43886520154807,75.90826213637966,NaN,NaN,20.879557621773458,17.662161532756894
2001-01-19T09:30:00-05:00,26.03125,26.09375,25.625,25.625,223100,134845,47.84760914850192,61.074265303404594,NaN,NaN,-11.893615109926953,57.814422200445485,-0.07867270164693052,0.5400953957318784,0.6187680973788089,4108802,4355942,74.00571448646376,77.68674043043299,NaN,NaN,16.88247774436227,17.550778134414806
2001-01-22T09:30:00-05:00,26.3125,26.6875,26.125,26.59375,90800,137810,54.812705091394236,60.719671196281205,NaN,NaN,24.508726271218233,47.55067605122349,-0.08698563938945125,0.5100360481419948,0.597021687531446,4199602,4297862,69.1230201570197,78.9824021279361,NaN,NaN,15.676805545582017,17.28306776458155
2001-01-23T09:30:00-05:00,26.6875,26.90625,26.5,26.90625,57400,135825,56.816237397219105,60.5433230105963,NaN,NaN,41.639315362125,37.62640360888641,-0.07313600958514799,0.505601675550011,0.578737685135159,4257002,4247282,65.09511199047428,80.19684192013503,NaN,NaN,15.356949962719796,17.0079080786013
2001-01-24T09:30:00-05:00,26.875,26.96875,26.6875,26.9375,392800,154105,57.02145584088863,59.57925029128611,NaN,NaN,45.715209435737144,30.966755289773836,-0.06390335847152884,0.498858487045748,0.5627618455172768,4649802,4309422,67.59353313514255,80.32600412686614,NaN,NaN,15.16708336782414,16.744933119918848
2001-01-25T09:30:00-05:00,27.0625,27.625,26.8125,27.35937,5793699,440119.95,59.79891085764889,58.69891226065933,NaN,NaN,85.04278310493035,37.00248381281675,-0.03297442646236359,0.5215438124393224,0.554518238901686,10443501,5531741.8,87.12124861308922,81.11043088853134,NaN,NaN,15.84458797027011,16.61631238425474
2001-01-26T09:30:00-05:00,27.3125,27.375,27,27.0625,432000,457749.95,57.00703477473629,58.24538392903354,NaN,NaN,68.49422500086519,53.08005183497518,-0.035861183942594854,0.5096917589734424,0.5455529429160373,10011501,6712281.6,92.08318168722414,81.86399743719062,NaN,NaN,15.584400191830996,16.468896356765633
2001-01-29T09:30:00-05:00,27.34,27.62,27.17999,27.60001,358700,474174.95,60.59432530667191,58.267825509972,NaN,NaN,110.57169249392456,70.29264507951645,-0.006461714650397576,0.5374757996030404,0.543937514253438,10370201,7946401.4,94.47823979850791,82.53866163119942,NaN,NaN,16.437309225654733,16.464383909464075
2001-01-30T09:30:00-05:00,27.60001,27.81,27.25,27.67999,720600,509509.95,61.11424849019977,58.460221535828204,NaN,NaN,118.59495309150752,85.68377262539295,0.01244919916225462,0.5594990132062563,0.5470498140440017,11090801,9313161.2,95.94231470692775,83.12628271945542,NaN,NaN,17.280841090513235,16.581020649613954
2001-01-31T09:30:00-05:00,27.95,28.63,27.95,28.57001,117500,507029.95,66.42334788345343,58.95629001932752,NaN,NaN,213.67129637316455,119.27499001287842,0.0754612344023029,0.6413763570468802,0.5659151226445773,11208301,10624861,96.81510169711736,83.74954818808742,NaN,NaN,19.697048116199838,17.026167430554796
2001-02-01T09:30:00-05:00,28.5,28.53,28.17999,28.53,43800,457499.95,65.98719026312365,59.31697933436868,NaN,NaN,180.33057588581997,138.33254856905637,0.10328746986482584,0.6950244599756097,0.5917369901107838,11164501,10769061,96.89419142463383,84.42594193318628,NaN,NaN,21.511993688783733,17.66699975315893
2001-02-02T09:30:00-05:00,28.53999,28.61,27.92,27.99001,138800,451444.95,60.238139993365984,59.27824272311217,NaN,NaN,141.89306757828632,153.0123170845406,0.07545826185310722,0.6860598174271679,0.6106015555740607,11025701,10971901,97.00679045638753,85.13657591913064,NaN,NaN,21.394439002632335,18.199491074512274
2001-02-05T09:30:00-05:00,28.16,28.16,27.75,27.83,22200,447989.95,58.60867708296533,58.84304457656306,NaN,NaN,95.59711110689814,150.0174008071353,0.038281604421450566,0.6584535611008739,0.6201719566794234,11003501,11098561,97.0780276237917,85.84710205581246,NaN,NaN,20.827690027224204,18.574948067756836
2001-02-06T09:30:00-05:00,27.98,28.24001,27.86,27.86,19400,447579.95,58.833518075053405,58.70433988645011,NaN,NaN,92.8876360039931,144.8759373896324,0.009233751379589261,0.63171414590391,0.6224803945243207,11022901,11084981,96.81198964700457,86.60623790180951,NaN,NaN,20.423721007158754,18.839058487671394
2001-02-07T09:30:00-05:00,28.02,28.08,27.75,27.92,96400,447574.95,59.30959038975664,58.88664218535562,NaN,NaN,76.029224541716,117.3475230233427,-0.011302903768765638,0.6083517648133636,0.6196546685821293,11119301,11067181,96.43892853133694,87.60624242536585,NaN,NaN,20.21064602269892,19.0349995641039
2001-02-08T09:30:00-05:00,27.64999,27.64999,26.99001,27.10001,211700,451614.95,50.68309678953936,59.089177016858294,NaN,NaN,-7.426114184553465,79.79618500926802,-0.08156148394755602,0.5177028136476842,0.5992642975952402,10907601,11015801,95.29738986710177,89.1270763811257,NaN,NaN,17.50124202226681,18.815891343841457
2001-02-09T09:30:00-05:00,27.5,27.5,26.56,26.75,1637800,531314.95,47.50679546246057,58.56732632907732,NaN,NaN,-48.22280245710849,41.77301100218906,-0.1491228118307557,0.4128607828067956,0.5619835946375513,9269801,10664621,87.65975552677665,90.45112890753693,NaN,NaN,14.24234956151095,18.162528232079957
2001-02-12T09:30:00-05:00,26.82001,27.5,26.82001,27.5,3422000,698829.95,54.13912883262314,58.37610428874904,NaN,NaN,-9.033200835336073,20.846948613742207,-0.14091192835343092,0.38584368419576265,0.5267556125491936,12691801,11002281,88.60536698087049,92.13043283542235,NaN,NaN,13.307852594140881,17.4690031409458
2001-02-13T09:30:00-05:00,27.64,28.05,27.42999,27.87,28500,699259.95,57.023925139208174,58.37628066720043,NaN,NaN,52.177836790269794,12.704988770997554,-0.10956846428916434,0.38979503218773814,0.4993634964769025,12720301,11341761,89.47832452734748,93.69363222057986,NaN,NaN,13.402171246856218,16.88802715607586
2001-02-14T09:30:00-05:00,27.98,27.98,27.58,27.60001,93800,695409.95,54.33792199180943,57.986210033926184,NaN,NaN,40.165229067525715,5.532189676159495,-0.10596196101756128,0.3669110452049509,0.47287300622251216,12626501,11643201,90.19652270582768,93.91329465577546,NaN,NaN,12.67655291838767,16.286387979263264
2001-02-15T09:30:00-05:00,27.74001,27.77,27.46001,27.59,14500,695774.95,54.23592026949809,57.78827328355203,NaN,NaN,22.199473386048147,11.457307190279817,-0.10309668129515759,0.3440021546035652,0.4470988358987228,12612001,11984081,90.94891663919401,93.83227572377334,NaN,NaN,12.06098033649643,15.682758316010858
2001-02-16T09:30:00-05:00,27.3,27.72,27.24001,27.24001,9300,685084.95,50.65547443613424,57.0783553642279,NaN,NaN,-17.871340028269987,17.527599676047522,-0.12230793998494505,0.29421391091754145,0.4165218509024865,12602701,12650661,92.20823721995747,93.67013268244828,NaN,NaN,10.504583926120366,14.943019117455073
2001-02-20T09:30:00-05:00,27.7,28,27.47,27.60001,74900,684289.95,54.01802817420086,56.5714824845137,NaN,NaN,19.741279565373393,23.282495756189412,-0.10876059166277435,0.2805711113240186,0.3893317029867929,12677601,12647821,92.14940990328307,93.39921091075938,NaN,NaN,10.11848017531952,14.253799268578565
2001-02-21T09:30:00-05:00,27.38,27.38,26.36,26.41,131800,688009.95,43.47231768892741,54.9321231849047,NaN,NaN,-148.43431701142975,-16.839935004150497,-0.17406108719578006,0.17175534399206782,0.3458164311878479,12545801,12612921,91.37789866502715,93.01083926561009,NaN,NaN,6.284769622490844,13.115366461994604
2001-02-22T09:30:00-05:00,26.32001,26.48,25.84,26,35600,670149.95,40.536044784189095,53.114184222123654,NaN,NaN,-223.29962118348254,-69.53290505435214,-0.23518358745977153,0.05183694686313345,0.287020534322905,12510201,12589661,90.83206807987399,92.5778304552701,NaN,NaN,2.1513653825918735,11.5490805935085
2001-02-23T09:30:00-05:00,26.12,26.46001,25.71001,26.42999,94600,385195,44.750767918417125,52.00794335962731,NaN,NaN,-176.20169330142608,-109.213138391847,-0.2363410283676095,-0.00840575113660691,0.2279352772310026,12604801,12588221,90.79590874399962,92.1341960472424,NaN,NaN,0.04938085587877746,9.906266345275682
2001-02-26T09:30:00-05:00,26.89999,27.24001,26.7,27.24001,90500,368120,51.69647065317181,51.51421432892778,NaN,NaN,-56.94537248147618,-117.02794488248824,-0.175061561031141,0.009108325942076334,0.18416988697321734,12695301,12606741,90.846379212165,91.68907830355478,NaN,NaN,0.5343549831024974,8.567421864965228
2001-02-27T09:30:00-05:00,27.10001,27.34,26.82001,27.10001,93800,354875,50.514456683266914,50.91999565808589,NaN,NaN,-48.65908410369027,-130.70801761630096,-0.13808927641951385,0.011558291448825031,0.14964756786833888,12601501,12591521,90.40762647542135,91.23162379129883,NaN,NaN,0.5452145182094627,7.421392244000119
2001-02-28T09:30:00-05:00,27.16,27.16,26.39999,26.53,79900,322840,45.91164033587884,49.962999225666046,NaN,NaN,-88.22823552611403,-118.6668013192378,-0.14541791150926145,-0.03212482151823792,0.11329308999102353,12521601,12586681,90.25834189243874,90.79015331709182,NaN,NaN,-0.9188723793152968,6.229925869240774
2001-03-01T09:30:00-05:00,26.52,26.52,25.85001,26.10001,127600,323345,42.74734052291648,49.39615949233583,NaN,NaN,-137.54828068469826,-101.51653321948095,-0.170862139531896,-0.10028458442384647,0.07057755510804953,12394001,12563441,89.49418915246738,90.37563898033223,NaN,NaN,-3.148317650928198,4.890176794930921
2001-03-02T09:30:00-05:00,25.66,26.35001,25.64999,26.3,243900,333350,44.65783407504524,49.1926622503776,NaN,NaN,-128.74445018677616,-92.02508459655098,-0.16573376054026676,-0.13658964556728392,0.029144114972982832,12637901,12570061,89.52140378522826,90.5086138559359,NaN,NaN,-4.3754061671998095,3.5665220860551026
2001-03-05T09:30:00-05:00,26.14999,26.5,26.02,26.02,4300,326625,42.51857657920247,48.36262280370469,NaN,NaN,-107.26883822105582,-102.08977774446691,-0.17196600155398306,-0.185813386969496,-0.01384738541551294,12633601,12557721,89.05828851685979,90.54096539422085,NaN,NaN,-6.038726167205696,2.1943437641607026
2001-03-06T09:30:00-05:00,26.7,26.8,26.42999,26.67999,114800,331255,48.75046083357763,47.77166106758823,NaN,NaN,-47.11442732802472,-101.7808463893338,-0.12461224360838519,-0.16961268992599443,-0.04500044631760924,12748401,12587101,89.20152249651139,90.5211938205897,NaN,NaN,-5.565539610314897,1.0857889963784741
2001-03-07T09:30:00-05:00,26.92999,27.34,26.92999,27.34,76300,334100,54.10867761899574,47.755286469530105,NaN,NaN,28.19570192237393,-78.49605889963621,-0.045868889025359225,-0.10233655759930826,-0.05646766857394904,12824701,12647721,89.50674725399925,90.4719241454591,NaN,NaN,-3.4246157075135253,0.4414454672510457
2001-03-08T09:30:00-05:00,27.36,27.8,27.36,27.78,271300,342845,57.312839346647706,47.975066403612225,NaN,NaN,89.53462394705005,-33.079477973286544,0.03448502010788658,-0.013361393439090818,-0.0478464135469774,13096001,12788121,90.19780810251072,90.41827353569602,NaN,NaN,-0.6053050157498068,0.29190968396520967
2001-03-09T09:30:00-05:00,27.35001,27.57001,27.28999,27.5,59600,335240,54.695698661978994,48.26365384831542,NaN,NaN,61.356306729216705,4.94067340991203,0.06560879265113294,0.03416457726693878,-0.03144421538419416,13036401,12867821,90.57717814479498,90.30176931604156,NaN,NaN,0.9071195510724238,0.37979680783766884
2001-03-12T09:30:00-05:00,27,27.17999,26.39999,26.48,264800,266590,46.385941311656104,47.71850478670508,NaN,NaN,-35.99058312075333,19.196324429972528,0.016869902804873226,-0.010356836878102627,-0.027226739682975853,12771601,12895421,90.71124845770579,90.19904349850033,NaN,NaN,-0.4721028520588804,0.2580968564238761
2001-03-13T09:30:00-05:00,26.34,26.39,25.78999,26.36,242100,107595,45.509935186622705,47.864048893683325,NaN,NaN,-89.23285037048576,10.772639821480317,-0.021972935972341012,-0.05469290964840212,-0.03271997367606111,12529501,12851641,88.55879050005252,89.99767862957356,NaN,NaN,-1.8376542656502313,-0.04129616101528205
2001-03-14T09:30:00-05:00,25.64999,26,25.53,25.78999,181000,115220,41.50069520510805,47.93295249517754,NaN,NaN,-125.53983427921587,-19.97446741883764,-0.08124542199323179,-0.13427675116760085,-0.05303132917436906,12348501,12756401,83.89501128116567,89.50217457252295,NaN,NaN,-4.282144541917193,-0.6471316440012693
2001-03-15T09:30:00-05:00,25.89,26.09,25.64999,26.08,42000,112630,44.19439289995956,47.89321142243057,NaN,NaN,-98.15192606855103,-57.51177742195786,-0.09514601147061608,-0.17196384351263916,-0.07681783204202308,12390501,12615301,77.39227377690733,88.54477207487352,NaN,NaN,-5.4593760006373175,-1.3345951235207048
2001-03-16T09:30:00-05:00,25.92,25.92,25.38,25.5,67200,115265,40.206912360194906,47.07252868721793,NaN,NaN,-126.75851796658979,-95.13474236111915,-0.13518483201600437,-0.24579887206202855,-0.11061404004602418,12323301,12472681,71.37059601082926,87.15364470334954,NaN,NaN,-7.726578702415332,-2.2477356347913657
2001-03-19T09:30:00-05:00,25.60001,25.96001,25.39999,25.8,121200,120860,43.06821721942895,46.54065443980094,NaN,NaN,-100.32561060000306,-108.0017478569691,-0.13304003054234037,-0.27691407822394964,-0.14387404768160927,12444501,12407261,68.72895125856685,85.60516790214565,NaN,NaN,-8.723228060965189,-3.172805981387626
2001-03-20T09:30:00-05:00,26,26.62,25.86,25.86,134600,123845,43.64902081728131,46.379038759901114,NaN,NaN,-46.403547898718934,-99.43588736261573,-0.11958080023246459,-0.29335004797219,-0.1737692477397254,12579101,12417181,68.91682508378861,84.08077384438492,NaN,NaN,-9.358781825420408,-4.056516816249452
2001-03-21T09:30:00-05:00,25.7,26.06,25.5,25.7,190800,126795,42.40662038867675,46.35470160745542,NaN,NaN,-85.56521068589242,-91.44096264395105,-0.11350279742557512,-0.3156477445216943,-0.2021449470961192,12388301,12425141,69.07736624029367,82.62242935065822,NaN,NaN,-10.237961962177149,-4.939580408524837
2001-03-22T09:30:00-05:00,25.12,25.12,24.19,24.89999,247200,137375,36.770877211840734,45.791347545797954,NaN,NaN,-188.22401897198054,-109.45538122463695,-0.15295507115533855,-0.3933387860402924,-0.24038371488495383,12141101,12375261,66.75079933546385,80.99595760424647,NaN,NaN,-12.752021606192878,-6.055643436763129
2001-03-23T09:30:00-05:00,24.72,25.17999,24.36,25.17999,120100,138650,39.787040198456985,45.596237804316125,NaN,NaN,-147.40417124387832,-113.58451188009467,-0.14960435612302275,-0.4273891600387323,-0.27778480391570953,12261201,12362841,66.1533358628918,79.35988955753449,NaN,NaN,-13.96053512102382,-7.1849136773717985
2001-03-26T09:30:00-05:00,25.71001,25.8,25.5,25.62,96600,138955,44.28484104736575,45.27726496244385,NaN,NaN,-64.06682400602035,-106.33275456129812,-0.10904876400819752,-0.4140957589259564,-0.3050469949177589,12357801,12345501,65.274893561548,77.65084463360851,NaN,NaN,-13.652310356602415,-8.108827488690459
2001-03-27T09:30:00-05:00,25.62,26.17999,25.56,26.17999,77200,138125,49.459180693385235,44.94515803918596,NaN,NaN,-22.216667858052727,-101.49537855316487,-0.03939447937358753,-0.3542900941347433,-0.3148956147611558,12435001,12316681,63.759464131190065,75.8117529819793,NaN,NaN,-11.787802368239271,-8.634395328626002
2001-03-28T09:30:00-05:00,25.64999,25.85001,25.46001,25.75,186200,143440,45.93175883403031,44.13222371685615,NaN,NaN,-52.361121658586,-94.85456074770359,-0.01824151354075515,-0.33769750668709975,-0.3194559931463446,12248801,12288781,62.25270889518704,73.81567446717045,NaN,NaN,-11.276537436541892,-9.011844201185415
2001-03-29T09:30:00-05:00,25.5,26.02,25.5,26,165600,145340,48.24300331936657,43.67131690666955,NaN,NaN,-30.658934348239693,-63.34154382295543,0.014839841189845049,-0.3009061916590383,-0.31574603284888336,12414401,12343441,64.0453888195842,71.92054665822683,NaN,NaN,-10.158018931575363,-9.175583448383978
2001-03-30T09:30:00-05:00,25.92,26.09,25.75,26.09,22500,134270,49.086768295860956,43.864233119827034,NaN,NaN,-12.94596139439106,-36.449901853057966,0.04341885050026084,-0.2614724697235573,-0.30489132022381815,12436901,12378581,65.18994850179385,70.09759666137599,NaN,NaN,-9.00022332568555,-9.150532002284203
2001-04-02T09:30:00-04:00,25.84,26.24001,25.83,26.10001,61500,137130,49.185991246221455,44.12680855265552,NaN,NaN,-2.4122852273623177,-24.118994097326365,0.06247398276180827,-0.22679884177155785,-0.2892728245333661,12498401,12406701,66.11941343646711,68.49478401397702,NaN,NaN,-8.023717058880713,-8.989558438940847
2001-04-03T09:30:00-04:00,26.25,26.25,25.19,25.22,214100,142095,41.52433934274681,44.12849741962972,NaN,NaN,-60.24750796286226,-31.725162118288267,0.017619443882122443,-0.26724851968071306,-0.2848679635628355,12284301,12376561,64.14250358145578,67.0838906068549,NaN,NaN,-9.383048675391485,-9.045771329862367
2001-04-04T09:30:00-04:00,25.5,25.69,25.25,25.49001,89200,142740,44.3867766329619,44.14223911484417,NaN,NaN,-66.43937391298473,-34.54081256916801,0.008410341780808406,-0.274355036336825,-0.2827653781176334,12373501,12401501,65.07308835937647,66.20394879131698,NaN,NaN,-9.680454273315338,-9.13644032178422
2001-04-05T09:30:00-04:00,26,26.10001,25.8,26.06,43700,131360,49.955887993952224,44.83859451725541,NaN,NaN,24.1928407938352,-23.570457540753033,0.04115071915664914,-0.231326979171822,-0.27247769832847113,12417201,12402061,65.09499319350152,65.75569144722213,NaN,NaN,-8.240430724429727,-9.008438950733577
2001-04-06T09:30:00-04:00,25.8,26.08,25.49001,25.98,138500,135305,49.211022835638005,45.27736634698463,NaN,NaN,17.945922887019243,-17.392080684470976,0.05689327877161804,-0.20136109986394857,-0.2582543786355666,12278701,12370421,62.70225026375991,65.32521280473591,NaN,NaN,-7.286456936738195,-8.762441520162808
2001-04-09T09:30:00-04:00,25.85001,26.08,25.64999,25.74001,64000,125265,46.94945621476027,45.51311173251884,NaN,NaN,24.920523994623203,-11.92551884007387,0.05081682520332448,-0.194733347131411,-0.24555017233473547,12214701,12313681,58.54616500563998,64.58445137058244,NaN,NaN,-7.125047799343613,-8.528528131474351
2001-04-10T09:30:00-04:00,25.99001,26.31,25.98,26,102200,118270,49.6490761056702,46.03042999801837,NaN,NaN,99.81192907039166,20.086368566576915,0.06317490834493705,-0.16658153690356414,-0.2297564452485012,12316901,12320201,58.88342220485312,63.856312510908126,NaN,NaN,-6.218424143617593,-8.198513276066242
2001-04-11T09:30:00-04:00,26.08,26.08,25.39999,25.71001,193300,118885,46.789061972106,46.746014623751606,NaN,NaN,1.8938932753117381,33.7530220042362,0.05119714367941691,-0.16576001564923004,-0.21695715932864695,12123601,12270221,55.177535381063976,63.029650799879555,NaN,NaN,-6.248570428138797,-7.919950012076607
2001-04-12T09:30:00-04:00,25.42,25.55,25,25.27,206200,127095,42.7637715753751,46.95863829353147,NaN,NaN,-104.97560432784873,7.919332979899417,0.014903420715702914,-0.1983278834340183,-0.21323130414972122,11917401,12170261,48.59083176507103,61.775186221463784,NaN,NaN,-7.449622685763953,-7.852760394031942
2001-04-16T09:30:00-04:00,25.8,25.89,25.39,25.39,25100,124990,44.174327232036504,46.950744449579396,NaN,NaN,-32.66754956216375,-2.203361509937183,0.0009760651034315115,-0.21201122277043183,-0.21298728787386334,11942501,12103021,44.72336625543347,60.30721998531275,NaN,NaN,-8.050919356425567,-7.881068817231031
2001-04-17T09:30:00-04:00,25.46001,25.8,25.46001,25.74001,126300,125245,48.185354717100985,46.859756879844795,NaN,NaN,-4.536755026884668,-8.094817314238757,0.016474086438456853,-0.19239467982579228,-0.20886876626424913,12068801,12073841,43.11942897044528,58.83293175954526,NaN,NaN,-7.430250095402334,-7.816666142684075
2001-04-18T09:30:00-04:00,25.94,27.61,25.91,27.32001,157700,126400,61.59851259315007,47.97881071978192,NaN,NaN,267.4196115044992,25.426719172582754,0.12806047263584325,-0.04879317546944506,-0.1768536481052883,12226501,12055761,42.11167790462461,57.39428668879079,NaN,NaN,-2.081262301472978,-6.997322736796775
2001-04-19T09:30:00-04:00,27.14999,27.42999,27.08,27.39999,19700,117845,62.13289191256542,48.970945619296124,NaN,NaN,262.12007377042994,77.47195527160639,0.19800399383488404,0.07065134418831676,-0.12735264964656728,12246201,12080281,44.02241589891164,55.96407433731418,NaN,NaN,2.2376134498320788,-5.678046138706939
2001-04-20T09:30:00-04:00,27.25999,27.32001,26.97,27.11,10800,106025,58.930824861211704,49.67409251682118,NaN,NaN,197.50220240219025,137.9675166176142,0.21411810681521462,0.14029498387245098,-0.07382312294276364,12235401,12143881,48.74786881343773,54.78964007386018,NaN,NaN,4.765195337277703,-4.186154499280562
2001-04-23T09:30:00-04:00,27.12,27.28,26.78999,26.92999,96500,104845,56.96818973898156,50.22996383773262,NaN,NaN,148.35360962847741,174.1717484557424,0.20217890933284732,0.17890051372329552,-0.023278395609551805,12138901,12183161,51.47255067484826,53.743435590887394,NaN,NaN,6.2248593165218065,-2.698866811308795
2001-04-24T09:30:00-04:00,26.25999,26.52,26.25999,26.46001,6400,100335,52.09040933052683,50.98468312257405,NaN,NaN,51.394363111080864,185.3579720833355,0.15431629818784823,0.16961697712525847,0.015300678937410252,12132501,12195901,52.35722525948987,52.90162999646127,NaN,NaN,5.971520738658507,-1.4602400184563233
2001-04-25T09:30:00-04:00,26.44,26.67999,26.34,26.48,127600,102855,52.27757681948873,51.548311707325965,NaN,NaN,57.18666689082057,143.3113831605998,0.11736364715891404,0.1620052378860528,0.04464159072713877,12260101,12202621,52.84554395734103,52.02823396774444,NaN,NaN,5.822885194677555,-0.419793559437198
2001-04-26T09:30:00-04:00,26.67999,27.25999,26.67999,27.14,13400,94215,58.0980467074526,52.12989447257599,NaN,NaN,111.05007616831935,113.09738364017767,0.1297627143258182,0.2068449836344115,0.07708226930859331,12273501,12208081,53.26468437308166,51.183211909143026,NaN,NaN,7.475416511663216,0.7080935935771469
2001-04-27T09:30:00-04:00,27.46001,27.81,27.39999,27.78999,97300,90800,62.89744506921612,53.10749606068871,NaN,NaN,157.85252610789775,105.16744838131918,0.17150993247777585,0.29146968490581315,0.11995975242803729,12370801,12235161,55.38294038126196,50.66040406039317,NaN,NaN,10.473747904426101,2.103187066555569
2001-04-30T09:30:00-04:00,27.83,27.89999,27.10001,27.3,98200,94585,57.54643036012435,53.86442278535757,NaN,NaN,113.68648950920893,98.23402435746547,0.15632177871159497,0.315361975817531,0.15904019710593603,12272601,12261901,57.4345193347188,50.58100079818451,NaN,NaN,11.290005265537207,3.4155896664100887
2001-05-01T09:30:00-04:00,27.39999,27.67999,27.23,27.60001,112500,97135,59.801432286134926,54.5895910839622,NaN,NaN,106.02173908182468,109.15949955161425,0.15630349042785247,0.3544195601407516,0.19811606971289913,12385101,12312421,61.07610249434273,50.73762081886234,NaN,NaN,12.670231533329105,4.737681361684234
2001-05-02T09:30:00-04:00,27.55,27.83,27.5,27.82001,39000,88380,61.419769980840506,55.63464165601466,NaN,NaN,112.43414843060535,120.2089958595712,0.1603320400877465,0.39853111982258227,0.23819907973483576,12424101,12345221,63.27301687012307,51.315869496652276,NaN,NaN,14.296091908272967,6.103168582625481
2001-05-03T09:30:00-04:00,27.49001,27.63,27.31,27.5,106100,89225,57.77615278910901,56.7069545998528,NaN,NaN,81.47821421185748,114.29462346827881,0.13185828035102648,0.40302193017361887,0.2711636498225924,12318001,12354121,63.86892395990623,52.407161796283354,NaN,NaN,14.56281156070171,7.311689008064943
2001-05-04T09:30:00-04:00,26.95,27.75,26.95,27.75,19200,88000,59.78335680481053,57.82188528362237,NaN,NaN,74.24885348262885,97.57388894322504,0.12058151915453358,0.4218905487657594,0.3013090296112258,12337201,12347401,63.03724735049066,53.71529616021602,NaN,NaN,15.378722114009605,8.464122308914181
2001-05-07T09:30:00-04:00,27.55,27.66,27.37,27.53999,293700,95760,57.31838307007608,58.47424445169202,NaN,NaN,71.8134055598608,89.19927215335541,0.09104305673166058,0.4151128505258015,0.3240697937941409,12043501,12301581,57.53583956416682,54.74503977405327,NaN,NaN,15.344276678277618,9.447001504537528
2001-05-08T09:30:00-04:00,27.5,27.52,27.23,27.52,24500,93785,57.07714173761856,58.15128939058263,NaN,NaN,57.91975510156829,79.57887535730414,0.06352609571446266,0.4034774134372192,0.33995131772275655,12019001,12228361,50.0229768451464,55.31013255551911,NaN,NaN,15.24922604291267,10.275890724305405
2001-05-09T09:30:00-04:00,27.41,27.45,27.10001,27.10001,21200,89735,52.114351022689945,57.435679327020104,NaN,NaN,33.747757427033,63.84159715658966,0.013046802832293092,0.35625982126312294,0.34321301843082985,11997801,12143101,42.984493333664844,55.23599522943005,NaN,NaN,13.745499502555033,10.771549121198209
2001-05-10T09:30:00-04:00,27.99001,28.17999,27.84,27.88,34300,81785,59.20805311650168,57.4554813452551,NaN,NaN,111.20793150379673,69.78754061497753,0.027371557062577434,0.37742746475905165,0.3500559076964742,12032101,12085921,39.01923222553661,54.54109261600855,NaN,NaN,14.520469589817992,11.307109188143892
2001-05-11T09:30:00-04:00,28.23,28.23,27.84,28,42700,73610,60.18526401788135,57.685272365176516,NaN,NaN,117.73302175520506,78.48437426949278,0.039381900014377524,0.39928328271444613,0.3599013827000686,12074801,12033441,35.75878557651778,53.41868082327066,NaN,NaN,15.441161241016676,11.897688052840005
2001-05-14T09:30:00-04:00,28.00999,28.03999,27.84,27.92999,4500,72580,59.29282302045073,58.19973048588536,NaN,NaN,105.05989617343546,85.13367239220771,0.03709625917247278,0.4062717066656596,0.3691754474931868,12070301,12038801,36.3438375900799,52.2748674183128,NaN,NaN,15.942201788587473,12.475475729375358
2001-05-15T09:30:00-04:00,28.16,28.2,27.77,27.83,48200,68675,57.97067858618538,58.606380612077984,NaN,NaN,104.75223451383874,94.5001682746618,0.023972186277968155,0.399140680340647,0.3751684940626788,12022101,12039421,36.41597164702407,51.10132653900445,NaN,NaN,15.99692452518876,12.978539843062986
2001-05-16T09:30:00-04:00,27.63,28.28999,27.53999,28.17,332600,77420,61.14351253485695,58.823913885464,NaN,NaN,109.10176297582572,109.57096938442035,0.03276727617738284,0.4161275892844074,0.38336031310702456,12354701,12110801,44.248879905148634,50.45734050558065,NaN,NaN,16.9318740106924,13.543301867010046
2001-05-17T09:30:00-04:00,28.39999,28.64,28.34,28.60001,211100,86990,64.76625978256064,58.957400650702894,NaN,NaN,178.89675437424916,123.10873395851084,0.06050936419523073,0.458997018351063,0.39848765415583226,12565801,12217541,53.47814928966217,50.32128399903781,NaN,NaN,18.817084540930082,14.296699391855766
2001-05-18T09:30:00-04:00,28.52,28.58,28.22,28.58,90200,90960,64.46506176014182,59.451588607847,NaN,NaN,143.44678877534318,128.25148736253846,0.06981563932182888,0.48575720330811833,0.41594156398628945,12475601,12297701,58.97124601691421,50.4310501906232,NaN,NaN,20.2774233616087,15.151088530391899
2001-05-21T09:30:00-04:00,28.5,28.95,28.25999,28.89999,51200,88695,67.10001548917106,59.972915979492434,NaN,NaN,157.74495037629222,138.7884982031098,0.08861773550294838,0.526713733364975,0.4380959978620266,12526801,12389001,64.1617007425285,50.65145006549362,NaN,NaN,22.30645541284203,16.173283799313346
2001-05-22T09:30:00-04:00,29.10001,29.10001,28.82001,29,298300,103290,67.90113769932664,60.43587081652716,NaN,NaN,175.61208537817555,152.9604683759772,0.09814540397427002,0.5607777528298641,0.46263234885559407,12825101,12549601,71.08997399992094,51.20980414619346,NaN,NaN,24.230886111578794,17.324369843922696
2001-05-23T09:30:00-04:00,28.85001,28.85001,28.25,28.48,127600,103290,59.753841440501354,60.57713429162662,NaN,NaN,101.12777605691602,151.36567099219525,0.061569301735598214,0.5395939760250918,0.47802467428949363,12697501,12618161,73.44967716100464,51.89414366055764,NaN,NaN,23.627446417026814,18.22480935436614
2001-05-24T09:30:00-04:00,28.48,28.60001,28.25,28.38,59900,105615,58.30499108804169,60.471536740428846,NaN,NaN,75.88926863165607,130.76417384367662,0.024676718823436805,0.5088705728187897,0.48419385399535286,12637601,12632521,73.92965803726071,52.67217299532693,NaN,NaN,22.714530553204924,18.866198097057396
2001-05-25T09:30:00-04:00,28.32001,28.39999,28.2,28.24001,368300,119165,56.24884939062826,60.39514147761114,NaN,NaN,49.19885968695648,111.91458802599928,-0.013088569495115276,0.46783314212645877,0.48092171162157404,12269301,12591261,70.01319961361894,53.56341299885922,NaN,NaN,21.367664172031937,19.22355039348233
2001-05-29T09:30:00-04:00,28.25,28.25,27.85001,28.02,22100,115360,53.08064226034028,60.10967722923412,NaN,NaN,5.77574934621839,81.52074781998452,-0.05449799179870746,0.41279922187318974,0.4672972136718972,12247201,12535341,64.98824380572047,54.63236063890023,NaN,NaN,19.312532936801965,19.236262185385137
2001-05-30T09:30:00-04:00,27.88,27.94,27.50999,27.50999,381400,128805,46.5370037976334,59.71129528458722,NaN,NaN,-62.93459602936939,33.81141153847553,-0.11440364690253574,0.3242926550437275,0.43869630194626325,11865801,12343481,51.366461599332965,55.23107265787652,NaN,NaN,15.464295529352407,18.69740980595189
2001-05-31T09:30:00-04:00,27.86,27.95,27.53999,27.95,4000,127055,52.03127214238606,59.1986680721504,NaN,NaN,-36.25908471413558,6.334039384265216,-0.12187322293120634,0.28635477328225534,0.4082279962134617,11869801,12177941,42.9930799938814,55.51491892704401,NaN,NaN,13.724342553340962,17.98697162700747
2001-06-01T09:30:00-04:00,27.7,27.89,27.58,27.85001,213500,132425,50.754796968275656,58.525063282892845,NaN,NaN,-47.44437858909518,-18.332690059885028,-0.13026907766698026,0.24539164912973632,0.3756607267967166,11656301,11981681,35.586467256759846,55.50261047563273,NaN,NaN,11.922438524976029,17.120609755288694
2001-06-04T09:30:00-04:00,27.75,27.75999,27.42999,27.75999,11500,132040,49.57560881271562,57.830976553768906,NaN,NaN,-72.76806411366677,-42.72607482000968,-0.13787220968563335,0.2033204646896749,0.34119267437530826,11644801,11856781,31.828503202277815,55.18008659078971,NaN,NaN,10.093358939744276,16.11671678163949
2001-06-05T09:30:00-04:00,27.75,28.10001,27.75,28.09,8400,117775,53.81210623532381,57.533935671564514,NaN,NaN,-16.430087785210247,-47.1672422462954,-0.11746033773090214,0.1943672522116806,0.31182758994258275,11653201,11737981,28.721681743787187,54.630494454844225,NaN,NaN,9.709497374751114,15.201399723512578
2001-06-06T09:30:00-04:00,28.09,28.09,27.8,27.8,10100,117055,49.84863986753958,56.72715905247041,NaN,NaN,-39.127283582265704,-42.405779756874665,-0.11985910195747485,0.1620037124957392,0.28186281445321404,11643101,11693441,27.63264871372546,53.443620798314,NaN,NaN,8.209401859006682,14.202542885726022
2001-06-07T09:30:00-04:00,27.60001,28.14,27.60001,28.00999,11600,116575,52.572653712628764,55.85618719033243,NaN,NaN,-45.61729347897359,-44.27742150984227,-0.1042480069719442,0.15155280573828378,0.255800812710228,11654701,11650421,26.584171043361394,51.52262235214966,NaN,NaN,7.728446176794741,13.277671927307267
2001-06-08T09:30:00-04:00,28.10001,28.11,27.95,28.11,10500,115385,53.858093178844946,55.09854657738265,NaN,NaN,-15.849756588610628,-37.95849710974536,-0.08494810490804611,0.14961568157517036,0.23456378648321646,11665201,11652201,26.70808693524843,49.21811098917353,NaN,NaN,7.692280467282238,12.479758861589406
2001-06-11T09:30:00-04:00,27.98,28.08,27.69,27.69,14000,113950,47.9771401855232,53.73262691283637,NaN,NaN,-64.86735486541791,-36.37835526009562,-0.0973400722367661,0.11288869618725883,0.21022876842402494,11651201,11653481,26.803762428293496,46.54968682387103,NaN,NaN,5.914426713291104,11.541854268975364
2001-06-12T09:30:00-04:00,27.5,27.89999,27.39999,27.89999,44400,115945,50.86591452877168,52.515825257796735,NaN,NaN,-79.69470997598624,-49.03127969825082,-0.08851993418012488,0.09957885069886885,0.18809878487899373,11695601,11661961,27.479188579733005,43.43463072242904,NaN,NaN,5.255822688615139,10.643849757495332
2001-06-13T09:30:00-04:00,27.8,27.89,27.60001,27.60001,22900,114680,46.86256234715038,51.59501960827167,NaN,NaN,-82.79090563097716,-57.7640041079931,-0.09921016480758299,0.064086078869515,0.163296243677098,11672701,11667881,27.978831587802375,40.18671318148601,NaN,NaN,3.488229128984676,9.621618239136666
2001-06-14T09:30:00-04:00,27.7,27.7,27.27,27.31,41600,100130,43.31340976780386,50.52419237111183,NaN,NaN,-125.0748605472738,-73.65551752165315,-0.12070633485130816,0.01241332511296278,0.13311965996427094,11631101,11663161,27.814292098078923,36.89275847154446,NaN,NaN,0.8919585003648348,8.37452399074069
2001-06-15T09:30:00-04:00,27.14999,27.25,26.84,26.98,20400,90595,39.63497640499052,49.33748715785198,NaN,NaN,-183.5695757683518,-107.19948135760137,-0.15012554784344903,-0.05453727484004034,0.09558827300340869,11610701,11652261,27.413358910533688,33.84991270703837,NaN,NaN,-2.4888319032769717,6.822616005881024
2001-06-18T09:30:00-04:00,27.25999,27.53999,27.25999,27.27,35000,87835,44.125748147577696,48.69785186408323,NaN,NaN,-111.14361152236965,-116.45473268899173,-0.14305944884505178,-0.08323603805290603,0.059823410792145745,11645701,11651161,27.370480637037687,31.16292962356103,NaN,NaN,-3.995906205588009,5.277112832814019
2001-06-19T09:30:00-04:00,27.7,27.7,27.31,27.36,41700,87360,45.48128220847411,48.62244317914328,NaN,NaN,-86.64003685299926,-117.84379806439433,-0.12593295105627428,-0.0975927780281971,0.02834017302807717,11687401,11649521,27.301915397004905,29.444033466251877,NaN,NaN,-4.826195598991012,3.833783056841872
2001-06-20T09:30:00-04:00,27.58,27.81,27.48,27.75999,21000,73495,51.153155672867,48.55972057417763,NaN,NaN,-31.862536472528593,-107.65812423270464,-0.08332872524636623,-0.07582073352988061,0.007507991716485609,11708401,11656661,28.145857079675537,28.3835175438086,NaN,NaN,-3.817280919778575,2.740773917324665
2001-06-21T09:30:00-04:00,27.60001,28.49001,27.60001,28.25999,72800,70755,57.15381065262581,49.016792980202645,NaN,NaN,89.54250287022549,-64.73465154920476,-0.020416609436621755,-0.018012770079291585,0.0024038393573301703,11781201,11686681,31.73416760139844,28.10835328271136,NaN,NaN,-0.9698732506161325,2.210681464761694
2001-06-22T09:30:00-04:00,28.23,28.23,27.84,27.98,26200,69070,53.21171970953463,49.276515187118285,NaN,NaN,73.38094119113147,-13.344548157308108,0.0021955353093441434,0.005148258494010349,0.002952723184666206,11755001,11715541,35.09014602091143,28.341327769756617,NaN,NaN,0.16137436980144054,1.9179233083388008
2001-06-25T09:30:00-04:00,27.96001,27.96001,27.32001,27.62,28400,52075,48.57277665278603,48.90227735979416,NaN,NaN,-33.62758196289623,2.1586577545865735,-0.006747982410800359,-0.005482254828834243,0.0012657275819661158,11726601,11731721,36.96121783960297,28.929866062314893,NaN,NaN,-0.362975072897197,1.5920806824479439
2001-06-26T09:30:00-04:00,27.17999,27.42999,27.07001,27.25,187800,60360,44.298302117318734,48.50582466334981,NaN,NaN,-139.0263324956002,-8.318601373933618,-0.03562394067386364,-0.04326419826036343,-0.007640257586499794,11538801,11702001,34.96734501009709,29.453772940627154,NaN,NaN,-2.1949492731867872,1.0510764030715538
2001-06-27T09:30:00-04:00,27.25,27.5,27.05,27.12,32700,42925,42.87079700343718,47.812834898407566,NaN,NaN,-126.34812952013458,-27.215719983454818,-0.06008200758325744,-0.0827427670655716,-0.022660759482314156,11506101,11661541,32.40452230339076,29.86951231634354,NaN,NaN,-4.118438111612546,0.3125743295452539
2001-06-28T09:30:00-04:00,27.42,27.88,27.42,27.55,16000,43525,48.753350132958495,47.448210395129955,NaN,NaN,-14.028014698255323,-47.92982349715099,-0.04461406271200828,-0.0784283378723245,-0.03381427516031622,11522101,11609721,29.42947028753983,30.06389684150721,NaN,NaN,-3.912265783354856,-0.2909742580119047
2001-06-29T09:30:00-04:00,27.7,27.96001,27.50999,27.67,55400,35620,50.29162770867862,47.613530932498215,NaN,NaN,14.28582346913226,-59.748847041550825,-0.024613913691812504,-0.06458166727508186,-0.03996775358326935,11577501,11574221,27.56255729915972,30.118096475140508,NaN,NaN,-3.2719835997163083,-0.716832735398248
2001-07-02T09:30:00-04:00,27.64,27.95,27.64,27.94,33000,36695,53.661969908878426,47.81324917393441,NaN,NaN,47.36744530960472,-43.549841587050636,0.0068072418860764955,-0.031458701225673735,-0.03826594311175023,11610501,11551001,26.38360998823292,30.03984086146193,NaN,NaN,-1.693560904484239,-0.856365330981961
2001-07-03T09:30:00-04:00,27.64999,27.89999,27.64999,27.89,33600,37955,52.94604267253948,48.24778348289077,NaN,NaN,42.523099295938394,-7.23995522874292,0.02330254671339612,-0.009137759720005079,-0.0324403064334012,11576901,11558621,27.479863353575126,30.00420027330284,NaN,NaN,-0.6207859841678489,-0.8227111385799449
2001-07-05T09:30:00-04:00,27.5,27.64999,27.32001,27.32001,34500,39175,45.494545816546506,48.403578914943814,NaN,NaN,-59.816086872200835,6.066453300843828,-0.0036597519103362813,-0.03701499632132155,-0.033355244410985266,11542401,11565881,28.571242995009854,30.05826819451219,NaN,NaN,-1.9566256245322222,-0.9846989222874132
2001-07-06T09:30:00-04:00,27.25999,27.3,26.60001,26.67,90000,43095,38.79002739312443,48.34322541409624,NaN,NaN,-181.77975906240508,-27.483895571986125,-0.06154537436035151,-0.11028696236142466,-0.048741588001073144,11452401,11551941,27.70896293627409,30.079382767779368,NaN,NaN,-5.418016621803727,-1.6180300222183153
2001-07-09T09:30:00-04:00,26.63,26.97,26.63,26.86,72600,46200,41.50368475735075,48.155935171937166,NaN,NaN,-162.68498057095942,-62.87805638000445,-0.08203092697906852,-0.1512802467249088,-0.06924931974584028,11525001,11541441,27.046827624230502,30.056264695435996,NaN,NaN,-7.332737315337765,-2.4344167783782367
2001-07-10T09:30:00-04:00,27.10001,27.16,26.74001,26.74001,50500,48025,40.28891347300575,47.78505169083228,NaN,NaN,-130.1127457071263,-98.37409458335064,-0.0975968263993418,-0.19124535274501753,-0.09364852634567573,11474501,11514241,25.356466487581727,29.91730405904862,NaN,NaN,-9.252001022458161,-3.4083573846753685
2001-07-11T09:30:00-04:00,26.85001,27.23,26.67999,27.03,167100,54160,44.51561237134442,47.31094145500924,NaN,NaN,-97.0755489180866,-126.29382422615565,-0.08287678361417553,-0.19724450586339515,-0.11436772224921962,11641601,11527181,27.672354472250902,29.88348244423258,NaN,NaN,-9.575616096718358,-4.289394343538652
2001-07-12T09:30:00-04:00,27.5,28.34,27.5,28.2,12900,53660,57.56656123343411,47.34042363935269,NaN,NaN,111.21119788355941,-92.0883672750036,0.006403327332935388,-0.1063635630830504,-0.11276689041598578,11654501,11549601,31.63034510890212,29.876066551911414,NaN,NaN,-5.151081210726645,-4.412492467422651
2001-07-13T09:30:00-04:00,28.08,28.72,27.92,28.66,29600,53060,61.40986122096827,47.92600517588367,NaN,NaN,162.19694516372283,-23.293026429778017,0.09241089780236307,0.0027467318369680527,-0.08966416596539502,11684101,11595941,39.05404529003189,30.15920221399145,NaN,NaN,-0.15756609829544016,-3.8046458432616213
2001-07-16T09:30:00-04:00,28.69,28.92,28.59,28.74001,47300,54405,62.0536409391394,48.888924053480345,NaN,NaN,188.11260042695056,46.86648976980398,0.14739794713227627,0.09458326794995031,-0.052814679182325956,11731401,11637221,44.80362303313051,30.719374013529126,NaN,NaN,3.8918807084489733,-2.7051420501601076
2001-07-17T09:30:00-04:00,28.63,28.89999,28.56,28.89999,9000,53105,63.36950154099132,50.251152583742666,NaN,NaN,165.61945263721984,106.0129294386732,0.1848269716300847,0.17821903535527994,-0.006607936274804771,11740401,11690401,51.1918032106716,31.878263884998738,NaN,NaN,7.554924400557557,-1.2394182714861557
2001-07-18T09:30:00-04:00,28.75,28.92,28.60001,28.92,293800,65710,63.53980553463724,51.727510335971246,NaN,NaN,144.427957598623,154.31363074201514,0.19993505854633375,0.24331088690811242,0.04337582836177867,12034201,11768921,58.77782563432165,33.76207126577952,NaN,NaN,10.511264987389069,0.43925076549601916
2001-07-19T09:30:00-04:00,29.10001,29.35001,28.89999,29.12,148600,72090,65.2774510852198,52.90780326113275,NaN,NaN,155.38541636571313,163.14847443844587,0.21129167220321374,0.30749041861579585,0.09619874641258211,12182801,11874581,66.3557064646363,36.39965956414355,NaN,NaN,13.506498177082168,2.3060003957226116
2001-07-20T09:30:00-04:00,29.06,29.34,29.06,29.14999,35300,70215,65.54263999977687,53.99716128192548,NaN,NaN,141.30718506522916,158.97052241874712,0.20837038515892387,0.35666172786123695,0.1482913427023131,12218101,11981381,71.96558763676855,39.57130458825846,NaN,NaN,16.026825810165537,4.266118312071601
2001-07-23T09:30:00-04:00,29.12,29.19,28.61,28.61,20400,69925,57.08821346821318,54.24189296473511,NaN,NaN,89.78179312527806,139.30436095841264,0.15980341497853634,0.3480456114254835,0.18824219644694717,12197701,12074641,75.76558754117778,43.0985886991831,NaN,NaN,15.824826962631258,5.917362405008695
2001-07-24T09:30:00-04:00,28.60001,28.60001,28.02,28.2,48200,70915,51.641416430435726,54.14870537601342,NaN,NaN,33.59318762561458,112.89910795609157,0.09310400955426079,0.30462220838977316,0.21151819883551237,12149501,12156461,78.5168882692833,46.74409047887654,NaN,NaN,13.966948439779173,7.067303267118763
2001-07-25T09:30:00-04:00,27.96001,28.75,27.85001,28.75,45300,63790,57.499461269630395,55.00619933694798,NaN,NaN,45.55695407994677,93.12490725235634,0.07958879244482447,0.31100418939154295,0.23141539694671848,12194801,12188581,79.500772085215,50.38191398531976,NaN,NaN,14.18601469546614,8.08426204259696
2001-07-26T09:30:00-04:00,28.64999,28.86,28.34,28.78,29800,63645,57.799748872959526,56.36403658550763,NaN,NaN,59.88810418231919,74.02544481567755,0.06675030009357158,0.31485327206368297,0.24810297197011139,12224601,12196941,79.76058457130242,54.09988695925035,NaN,NaN,14.449965453838315,8.993648244202868
2001-07-27T09:30:00-04:00,28.75,28.89999,28.55,28.7,56600,65675,56.650276809991226,57.445936017839095,NaN,NaN,59.6113718578338,57.68628217419848,0.04783690023801157,0.3078990972676259,0.2600621970296143,12168001,12186921,78.47674829900001,57.77345272173388,NaN,NaN,14.332699170332559,9.756369805078538
2001-07-30T09:30:00-04:00,28.89999,28.89999,28.57001,28.89,29600,64385,58.748540590934525,58.76448081197686,NaN,NaN,61.00379887846106,51.93068332483508,0.043229076981322945,0.31409854325626796,0.270869466274945,12197601,12186901,78.47403314639267,61.567564625934665,NaN,NaN,14.830212650217451,10.48120449724124
2001-07-31T09:30:00-04:00,28.81,29.25,28.81,28.89999,39300,64700,58.86129174013234,59.78917219546172,NaN,NaN,74.34963789509257,60.08197337873069,0.03624291622631415,0.31617311155783767,0.2799301953315235,12236901,12204381,79.15291575356639,65.24474757460005,NaN,NaN,15.269038384860373,11.165180766901116
2001-08-01T09:30:00-04:00,28.8,29.17999,28.73,28.87,26400,64340,58.345723272310664,59.84482662681005,NaN,NaN,63.6725911793621,63.70510079861375,0.025498250557575486,0.31180300852849285,0.28630475797091737,12210501,12207521,79.27933367210343,68.64824675768587,NaN,NaN,15.501313293040642,11.784628270635334
2001-08-02T09:30:00-04:00,29.10001,29.12,28.85001,29.05,87600,66995,60.57764931169036,59.78538291900448,NaN,NaN,67.61172879471756,65.24982572109343,0.026304035506612533,0.319184802354183,0.2928807668475705,12298101,12222221,79.89403013116232,71.56538853205232,NaN,NaN,16.2914969184291,12.428466648891586
2001-08-03T09:30:00-04:00,28.85001,28.86,28.75,28.86,10600,63025,57.09972597724329,59.431531850297624,NaN,NaN,44.95435427875552,62.31842220527777,0.010634690724714457,0.3061741302534635,0.29553943952874906,12287501,12246121,80.88681534292846,74.14275941132361,NaN,NaN,16.061289988239682,12.9474414116556
2001-08-06T09:30:00-04:00,28.8,28.8,28.34,28.34,10300,59910,48.83589924426275,58.39341740053129,NaN,NaN,-7.954725949327229,48.526717239720114,-0.03562360092156486,0.251009938376793,0.28663353929835783,12277201,12262041,81.54066248309331,76.31053507363946,NaN,NaN,13.422473876413143,13.01530319233525
2001-08-07T09:30:00-04:00,28.5,28.73,28.34,28.66,54300,60100,53.31372999242088,57.662983433230124,NaN,NaN,-11.022692973259199,31.45225106604975,-0.044941484770510465,0.23045668333521974,0.2753981681057302,12331501,12280961,82.31496701150375,77.99175945772389,NaN,NaN,12.432475136471162,12.932042041497523
2001-08-08T09:30:00-04:00,28.69,28.92999,28.17999,28.3,6200,52055,48.20267371507533,56.443356478219805,NaN,NaN,-68.95898370802527,4.92593608857228,-0.07391095845976492,0.18300947003102408,0.256920428490789,12325301,12303921,83.23405915365902,79.19735607836836,NaN,NaN,9.988828137553673,12.511582912362687
2001-08-09T09:30:00-04:00,28.3,28.34,27.92,28.2,271600,64990,46.85884066791174,55.108799383086584,NaN,NaN,-170.7505434925794,-42.74651836888711,-0.09691798964822054,0.13577294143051333,0.23269093107873387,12053701,12255041,74.37251066229658,79.36927915162038,NaN,NaN,7.585154279910926,11.807807393441006
2001-08-10T09:30:00-04:00,27.71001,28.22,27.69,28.17999,43100,65665,46.57900942026357,54.35814195109019,NaN,NaN,-182.10305392571735,-88.15800000978169,-0.10965614016498498,0.09562075587250263,0.2052768960374876,12010601,12199661,65.82210450629242,78.65903036341426,NaN,NaN,5.546584380361449,10.91334696300107
2001-08-13T09:30:00-04:00,28,28,27.59,27.86,16300,64115,42.235359047585725,53.686280709458046,NaN,NaN,-190.93779245071866,-124.75461331005997,-0.1341842945865596,0.03754652780428813,0.17173082239084772,11994301,12143081,58.430955383597215,77.22432087157954,NaN,NaN,2.459157994702016,9.705605681815491
2001-08-14T09:30:00-04:00,27.89999,28.10001,27.89,27.94,160800,71705,43.650160700195755,52.69704495449842,NaN,NaN,-130.93743921565624,-148.7375625585394,-0.13898412815922162,-0.001999337808179291,0.13698479035104233,12155101,12107801,54.333991564864895,75.42669369155453,NaN,NaN,0.2851461579946159,8.35982574984108
2001-08-15T09:30:00-04:00,28,28.16,27.7,27.7,15600,57795,40.44941163610925,51.45773515186626,NaN,NaN,-134.4053354840767,-161.82683291374968,-0.1512718966976244,-0.05210508052098817,0.09916681617663622,12139501,12070641,50.33098430874625,73.32457938708623,NaN,NaN,-2.5375907035117966,6.80305197079067
2001-08-16T09:30:00-04:00,27.69,27.91,27.50999,27.91,412300,70980,44.2982307981857,50.57544615102301,NaN,NaN,-131.9981809117202,-154.07636039757784,-0.1385460847061057,-0.07401578970599587,0.0645302950001098,12551801,12170261,59.04266538472976,71.93643060749551,NaN,NaN,-3.8795435140548853,5.27696690152702
2001-08-17T09:30:00-04:00,27.7,27.7,27.16,27.17999,547200,96575,35.66812808012345,48.92684525739365,NaN,NaN,-177.4289833705698,-153.14154628654833,-0.1704828207382254,-0.14857323092267194,0.02190958981555345,12004601,12169061,58.908631458321864,70.53890191549046,NaN,NaN,-8.010759583805434,3.378720260765241
2001-08-20T09:30:00-04:00,27.55,27.55,27.25999,27.52,35200,97315,41.39493209894696,47.67924814016612,NaN,NaN,-137.6900306670626,-142.49199392981708,-0.16006425866669627,-0.17817073351781687,-0.018106474851120616,12039801,12178161,59.65657088072825,69.14630585314487,NaN,NaN,-9.61824377632302,1.522011112609775
2001-08-21T09:30:00-04:00,27.5,27.5,26.75,26.84,312800,110545,34.735186065099796,45.99278119679392,NaN,NaN,-165.85589077017906,-149.47568424072168,-0.18837421098940793,-0.25357423858788053,-0.0652000275984726,11727001,12092541,50.367275136437804,67.08115881488304,NaN,NaN,-13.420903907855369,-0.6126910331709594
2001-08-22T09:30:00-04:00,26.86,27.09,26.64999,26.91,169800,116770,35.87881683408007,44.22857887696461,NaN,NaN,-156.1810236456154,-153.83082187302938,-0.19118180056341544,-0.3041772783027419,-0.11299547773932646,11896801,12044001,45.994660969117,64.65977530330836,NaN,NaN,-15.97903903338641,-2.8078836046303097
2001-08-23T09:30:00-04:00,26.85001,26.92999,26.67,26.77,71600,118860,34.57393780196185,42.61959400730165,NaN,NaN,-145.00664859922688,-156.43251541053075,-0.19082379215073397,-0.35152521792774394,-0.16070142577700997,11825201,11898681,35.936134520755814,61.449012387438906,NaN,NaN,-18.44979959894185,-5.042443032389102
2001-08-24T09:30:00-04:00,26.8,27.42999,26.8,27.28,23400,117200,42.743252683912765,42.18440496727665,NaN,NaN,-92.82209329075145,-139.51113739456707,-0.14658400813691772,-0.3439314359481571,-0.1973474278112394,11848601,11867481,34.20651848657094,58.06800210197302,NaN,NaN,-17.912591314146933,-6.881035644068792
2001-08-27T09:30:00-04:00,27.25,27.39999,27.10001,27.25,23300,116885,42.40781142761758,41.405410784076416,NaN,NaN,-76.15609329610666,-127.2043499203759,-0.1112865437444541,-0.33645560749180703,-0.22516906374735293,11825301,11824581,31.930814742500587,54.46913408275851,NaN,NaN,-17.59402497475382,-8.41146269130951
2001-08-28T09:30:00-04:00,27,27.02,26.75,27.02,65200,118180,39.82721489239248,40.80716372531335,NaN,NaN,-101.89005964058508,-114.4111836944571,-0.09595419167826724,-0.345111803345187,-0.24915761166691974,11760101,11831201,32.675148362174454,50.85778331193818,NaN,NaN,-18.111525068355622,-9.797185888030382
2001-08-29T09:30:00-04:00,26.8,26.99001,26.52,26.52,29400,118330,34.86084551148993,39.950164071283226,NaN,NaN,-116.39450062675435,-106.45387909068488,-0.11095140267890741,-0.387846865015554,-0.2768954623366466,11730701,11797981,30.85198130657659,47.749174072243896,NaN,NaN,-20.165000215351693,-11.278302220504855
2001-08-30T09:30:00-04:00,26.64999,26.72,25.94,25.98,89300,118415,30.44526970714081,38.79775409177446,NaN,NaN,-149.47772192561874,-107.34809375596326,-0.14647224350902682,-0.4599857667229301,-0.3135135232139033,11641401,11761221,28.92846927018779,45.11391441252214,NaN,NaN,-23.451891406299584,-13.017386389904102
2001-08-31T09:30:00-04:00,26.14999,26.56,26.10001,26.37,58200,120795,36.682982950255855,38.40115579910804,NaN,NaN,-124.28264573743985,-113.64020424530095,-0.13331056951408543,-0.4801517351065101,-0.34684116559242467,11699601,11731421,27.4351762081794,42.89993018570658,NaN,NaN,-24.092173394443012,-14.599498819123946
2001-09-04T09:30:00-04:00,26.44,27.17,26.44,26.50999,81000,124330,38.804447055420695,38.055033395909824,NaN,NaN,-77.11882682685719,-113.83275095145105,-0.10597680744046012,-0.4793121748929998,-0.3733353674525397,11780601,11722481,26.985137196799997,40.94644058798766,NaN,NaN,-23.916690883517184,-15.930526256894408
2001-09-05T09:30:00-04:00,26.46001,26.55,26.02,26.52,178100,130520,38.96193153905717,37.94878481754896,NaN,NaN,-108.50931146361317,-115.15660131605667,-0.07924661345484818,-0.4723936342710999,-0.39314702081625175,11958701,11762201,32.29881347525419,39.65842838559538,NaN,NaN,-23.730551080785926,-17.04481551745034
2001-09-06T09:30:00-04:00,26.39999,26.39999,25.56,25.56,174100,138915,30.780706627733025,36.98324737680234,NaN,NaN,-155.7572196601577,-123.02914512273733,-0.11601911820978827,-0.5381709185784871,-0.4221518003686988,11784601,11772981,33.708860218149056,37.848870873696754,NaN,NaN,-26.352179688143888,-18.37443897040656
2001-09-07T09:30:00-04:00,25,25.3,24.41,24.63,540900,152380,25.249425280015288,36.23905431965175,NaN,NaN,-239.0137200075175,-140.93634473911706,-0.18848724786747367,-0.6577608602030409,-0.46927361233556725,11243701,11693441,28.922318550710216,35.706991380295925,NaN,NaN,-30.78146952347765,-20.14687190655957
2001-09-10T09:30:00-04:00,24.2,24.7,24.11,24.42,219800,161215,24.192255934310296,35.01029173646342,NaN,NaN,-228.76461914216725,-161.83273942006255,-0.23315148605680291,-0.7607129699065709,-0.527561483849768,11023901,11558301,22.957629263740586,33.085638407653946,NaN,NaN,-34.56411338680219,-22.206477832308515
2001-09-17T09:30:00-04:00,22.25,22.85001,22,22.14999,793400,200070,16.264786328239424,33.69097746954482,NaN,NaN,-300.47721997244287,-206.5044180491797,-0.38898103679722573,-1.0137877798463002,-0.6248067430490745,10230501,11248281,15.208752035555094,30.574315329019466,NaN,NaN,-42.031468669926234,-25.038619380539618
2001-09-18T09:30:00-04:00,22.14999,22.85001,22.05,22.28,84400,196250,17.92364710558411,32.408465346080824,NaN,NaN,-224.368208921757,-229.67619754080846,-0.4522677732874454,-1.1901414596583813,-0.7378736863709359,10314901,10919521,10.977357695321402,28.073079380891212,NaN,NaN,-46.58120265791786,-28.11613127730794
2001-09-19T09:30:00-04:00,22.53,22.61,21.25,21.77,85200,199730,16.5394410775872,31.120287008625493,NaN,NaN,-193.83111825395196,-237.2909772595673,-0.4940460046349442,-1.355431192164616,-0.8613851875296719,10229701,10608541,8.553218041323063,26.117156775217445,NaN,NaN,-50.614337439227064,-31.33016072901067
2001-09-20T09:30:00-04:00,21.39999,21.58,21.02,21.02,83000,183265,14.737006917498547,29.11984088245305,NaN,NaN,-176.45488635830895,-224.77921052972562,-0.5343432462619278,-1.5293142453570816,-0.9949709990951539,10146701,10389141,7.32431969540049,24.19699971870528,NaN,NaN,-54.54716439126807,-34.646875537904585
2001-09-21T09:30:00-04:00,20.11,21.35001,20,21.05,142900,163050,15.135398205617378,27.171811366595893,NaN,NaN,-156.05801368357476,-210.2378894380071,-0.5206041301069786,-1.6457261617288772,-1.1251220316218986,10289601,10242281,6.636926815862793,22.390293438231147,NaN,NaN,-57.317151907729944,-37.885486447879636
2001-09-24T09:30:00-04:00,21.64999,22.42,21.64999,22.21001,312100,176895,28.957994750465716,26.395438499315414,NaN,NaN,-96.35161369627872,-169.4127681827743,-0.4004151385136825,-1.6256409547640018,-1.2252258162503193,10601701,10316521,11.175204601375981,20.854583169602684,NaN,NaN,-54.62247214137018,-40.27648440409257
2001-09-25T09:30:00-04:00,22.39,22.74001,22.17,22.27,282100,175360,29.596637911179826,26.01942367072183,NaN,NaN,-76.72291857486735,-139.88371011339638,-0.28909401227101017,-1.5865933315890821,-1.297499319318072,10883801,10430301,17.772215129191167,19.920314156932303,NaN,NaN,-52.37933378385501,-42.00546288691578
2001-09-26T09:30:00-04:00,22.77,22.77,22.16,22.34,51300,169435,30.38307099837796,26.0149809058102,NaN,NaN,-67.44807726960681,-114.60710191652734,-0.1878690110716028,-1.5323355831575753,-1.3444665720859725,10935101,10571381,25.191283445613294,19.653372312319842,NaN,NaN,-50.38414127612726,-43.20241694251742
2001-09-27T09:30:00-04:00,22.39999,22.42999,21.83,22.39999,104100,171060,31.093456919615022,25.615729046478716,NaN,NaN,-66.22928266407422,-92.5619811776804,-0.09848907062071355,-1.4675779103618645,-1.369088839741151,11039201,10749881,33.38129338365984,20.078094967711305,NaN,NaN,-48.581874045859685,-43.970910814423455
2001-09-28T09:30:00-04:00,22.78,23.16,22.63,22.97,180800,178930,37.60817286950007,25.530280890341526,NaN,NaN,-38.79461260835088,-69.10930096263561,0.011553932472703865,-1.3546464241502711,-1.366200356622975,11220001,10935961,40.67302372321845,21.055801148169763,NaN,NaN,-45.00174996381633,-44.11817355005101
2001-10-01T09:30:00-04:00,23,23.03999,22.47,22.95,96700,182600,37.474297486504625,25.4240213151592,NaN,NaN,-36.902993784202046,-57.21957698022029,0.09110011328252421,-1.2523252150198196,-1.3434253283023438,11123301,11040281,44.35048692474987,21.916634965990884,NaN,NaN,-42.16981141706693,-43.839836102481854
2001-10-02T09:30:00-04:00,23.25,23.59,23.06,23.59,74100,183045,44.30645704054288,26.39014634464562,NaN,NaN,-11.260580411124742,-44.12710934747176,0.1892735569985622,-1.1068333820541412,-1.2961069390527034,11197401,11103001,46.497778837399935,22.830129153080236,NaN,NaN,-37.56130230229292,-42.942902702454866
2001-10-03T09:30:00-04:00,23.64999,24.55,23.62,24.42,80000,185575,51.68048512285562,28.278079190562785,NaN,NaN,25.14582269055224,-25.608329355439942,0.30566975749350234,-0.9140197421858254,-1.2196894996793277,11277401,11171461,48.81919171124824,24.25133437883295,NaN,NaN,-31.024166060244507,-41.24022603928196
2001-10-04T09:30:00-04:00,24.55,24.55,23.89999,23.89999,22500,182235,47.44226380934516,29.938794038779566,NaN,NaN,28.38043210668505,-6.68638640128809,0.34053478019999783,-0.7940210244293304,-1.1345558046293283,11254901,11214601,50.28309566825438,26.2031534077268,NaN,NaN,-26.845223338877407,-39.183797082081306
2001-10-05T09:30:00-04:00,24.10001,24.10001,23.59,24.10001,115400,185095,49.16902354355294,32.28909669701624,NaN,NaN,28.057620077953086,6.684060135972709,0.367644442919552,-0.6750002509798882,-1.0426446938994403,11370301,11244661,51.3277683136262,28.78308314187473,NaN,NaN,-22.929777882715136,-36.86179433931471
2001-10-08T09:30:00-04:00,23.67,23.92,23.61,23.61,111500,186620,45.24707430316362,34.24077006827192,NaN,NaN,28.185926400440156,19.70184417290115,0.34359802431288533,-0.6131471635083336,-0.956745187821219,11258801,11271761,52.30085545152848,31.734761553032378,NaN,NaN,-20.792849680971926,-34.566230816694315
2001-10-09T09:30:00-04:00,23.5,23.64999,23.42,23.63,28300,179130,45.43837099034688,36.30497934775476,NaN,NaN,31.946909816223247,28.343342218370747,0.3205130353106165,-0.5561038936829483,-0.8766169289935648,11287101,11289701,52.97116061478407,34.90747173685103,NaN,NaN,-19.029229321592585,-32.346659174536924
2001-10-10T09:30:00-04:00,23.75,24.61,23.75,24.61,69600,173905,53.93178455230854,39.104606321669756,NaN,NaN,93.29281629525845,41.972740939312004,0.3597752482523999,-0.4268978686780649,-0.7866731169304648,11356701,11305561,53.59205783182884,38.21231017516733,NaN,NaN,-14.68578642326398,-29.823677352926502
2001-10-11T09:30:00-04:00,25,25.42999,25,25.39999,137000,153710,59.41617227908339,42.26751875548876,NaN,NaN,154.13671666857394,67.12399785168978,0.4231112945587391,-0.25778399873204094,-0.68089529329078,11493701,11353321,55.497457538441374,41.70234808392295,NaN,NaN,-9.06589582884203,-26.858279992343007
2001-10-12T09:30:00-04:00,25.10001,25.10001,24.35001,24.85001,45600,145000,54.54748913194483,44.09533978273726,NaN,NaN,115.73637048823306,84.65974793374578,0.41173806181242756,-0.16622271602524563,-0.5779607778376732,11448101,11368881,56.12942836988205,44.91336406738766,NaN,NaN,-5.970298344380223,-23.874282614062608
2001-10-15T09:30:00-04:00,24.52,24.89999,24.5,24.78,18900,106275,53.94155120436761,45.83426216082211,NaN,NaN,100.10090451198212,99.04274355605416,0.38382683374274984,-0.09817723565923586,-0.4820040694019857,11429201,11402961,57.55127115010652,47.754725211738766,NaN,NaN,-3.7198094012797354,-20.995072155093627
2001-10-16T09:30:00-04:00,25.21001,25.21001,24.71001,25.03,19300,103020,55.828500080886364,47.65179280957271,NaN,NaN,104.22789518998829,113.49894063080717,0.3665605348991344,-0.02380340077806764,-0.39036393567720207,11448501,11435241,58.90969794955077,50.16318339059144,NaN,NaN,-1.2977014225186323,-18.181162050440058
2001-10-17T09:30:00-04:00,25.35001,25.35001,24.39999,24.39999,18300,99675,50.24234665058633,49.01957064749923,NaN,NaN,81.0312100432035,111.0466193803962,0.29987575144166234,-0.01551924637512414,-0.3153949978167865,11430201,11449941,59.54461412468444,52.03199201495034,NaN,NaN,-0.9047171892653922,-15.713098498843678
2001-10-18T09:30:00-04:00,24.39999,24.5,24.2,24.39999,16800,96365,50.24234665058633,49.92201163186253,NaN,NaN,53.79851649846128,90.97897934637365,0.2452344346491923,-0.008851954505296078,-0.2540863891544884,11430201,11437241,58.700713119038014,53.31968411465174,NaN,NaN,-0.5912564294225213,-13.552835346069227
2001-10-19T09:30:00-04:00,24.27,24.27,24.06,24.06,25900,90515,47.28136976609281,50.62251679469026,NaN,NaN,30.38957622993916,73.90962049471487,0.1787498111546236,-0.030649125211208883,-0.20939893636583248,11404301,11428481,58.08916696917015,54.3010184035389,NaN,NaN,-1.1851212577213357,-11.786019047733813
2001-10-22T09:30:00-04:00,24.64999,24.64999,24.27,24.60001,4500,75135,52.109054030483776,51.17984515111461,NaN,NaN,55.85051446881078,65.0595424860806,0.16407940346892597,-0.0042996820296750116,-0.16837908549860098,11408801,11424401,57.78720082229825,55.107405688174495,NaN,NaN,-0.2855659022179516,-10.143097169802976
2001-10-23T09:30:00-04:00,24.75,25.19,24.64999,24.64999,21300,62095,52.542226882063424,51.241398133915176,NaN,NaN,79.61954094846818,60.137871637776584,0.1510076495057185,0.02038047638354712,-0.13062717312217137,11430101,11420721,57.49687897477375,55.727240492712035,NaN,NaN,0.5687429243014047,-8.612834299216637
2001-10-24T09:30:00-04:00,24.75,24.89999,24.55,24.55,10400,60050,51.53788991554965,51.53394285578692,NaN,NaN,60.07327800370595,55.946285229877084,0.12970823164583298,0.03150811643511986,-0.09820011521071312,11419701,11418621,57.3199048873936,56.22986972265055,NaN,NaN,1.0060611499201395,-7.238706377911383
2001-10-25T09:30:00-04:00,24.34,24.78,24.2,24.78,21500,55920,53.72886325319006,51.859645692189574,NaN,NaN,45.61983583147941,54.3105490964807,0.12513198371767148,0.058214864436376246,-0.06691711928129523,11441201,11420821,57.46760245541388,56.66842930420681,NaN,NaN,1.9733447588843285,-5.9226990726548525
2001-10-26T09:30:00-04:00,24.7,25.10001,24.64999,25.03999,10600,47410,56.142606552083016,52.637897995683815,NaN,NaN,84.53314073752323,65.13926199799752,0.13290607983476482,0.09921548051216078,-0.03369059932260403,11451801,11430321,58.14123030391184,57.0855989365199,NaN,NaN,3.4656191231076092,-4.581510758974501
2001-10-29T09:30:00-05:00,24.77,24.77,24.17,24.17,12400,43195,47.258682758019866,52.76792026480331,NaN,NaN,-6.075882185623408,52.75398266711068,0.07559799776819322,0.06080689788763749,-0.014791099880555724,11439401,11436441,58.596169328950346,57.48738527324607,NaN,NaN,2.2162772039749967,-3.610398192838858
2001-10-30T09:30:00-05:00,23.89999,24,23.5,23.71001,341000,56540,43.35256061143863,52.01226141188403,NaN,NaN,-121.19008652232922,12.59205717295119,0.00649479066288566,-0.006672611551948648,-0.013167402214834308,11098401,11370101,51.99882715399192,57.37358308197201,NaN,NaN,-0.06608888529642082,-3.1040682917613673
2001-10-31T09:30:00-05:00,23.89999,24.39,23.89999,24.17999,365000,70790,48.074900227849774,51.20217055108163,NaN,NaN,-46.32172383465358,-8.686943194720719,-0.007045158124227194,-0.0219738498701183,-0.014928691745891107,11463401,11378841,52.75355362379666,57.177589945211665,NaN,NaN,-0.5870478228060332,-2.7444939390534624
2001-11-01T09:30:00-05:00,24.08,24.73,24.08,24.63,169300,78130,52.18514118442814,51.0334314119733,NaN,NaN,7.640569939687542,-16.282796373079098,0.01369227204645046,0.002186648312171968,-0.011505623734278492,11632701,11417141,56.01712679385461,57.16956840406685,NaN,NaN,0.23876665557182225,-2.318313854106993
2001-11-02T09:30:00-05:00,24.8,25.16,24.8,25,35100,74115,55.31696181389315,51.13167502693941,NaN,NaN,92.4149395067122,-14.706436619241297,0.04968975018845643,0.05060656400129204,0.0009168138128356155,11667801,11460341,59.42188105731666,57.303183397439,NaN,NaN,1.899203569998655,-1.7158113649490434
2001-11-05T09:30:00-05:00,25.35001,25.7,25.3,25.59,100600,73570,59.83468999392321,51.417831449299186,NaN,NaN,175.59468554555903,21.627676926995196,0.10729151652342092,0.13503120946711178,0.02773969294369085,11768401,11526141,63.99387261414875,57.66633873062457,NaN,NaN,4.777877835365434,-0.7881414791898324
2001-11-06T09:30:00-05:00,25.45,26,25.39999,25.89999,42300,74270,62.00813365273992,52.25824480659587,NaN,NaN,199.31911574058697,85.72951737957843,0.15730072926484656,0.22436560452474907,0.0670648752599025,11810701,11668601,71.48488296356697,58.51921507625904,NaN,NaN,7.839822085459954,0.44442474433156554
2001-11-07T09:30:00-05:00,25.92999,26.06,25.64999,25.72,27300,72155,59.97867816676988,52.95369705775183,NaN,NaN,174.64856475302287,129.92357509711374,0.16830161183980263,0.2774418900596558,0.10914027821985316,11783401,11732601,74.09259491011252,59.61863520419293,NaN,NaN,9.740782288207663,1.772475822028151
2001-11-08T09:30:00-05:00,26.14999,26.42,25.85001,25.94,142100,72410,61.63164097669248,53.97871642993753,NaN,NaN,188.96439135355408,166.18833937988703,0.1794189782738025,0.3334140010621063,0.1539950227883038,11925501,11791161,76.23421485228587,60.91471005298691,NaN,NaN,11.811281479413676,3.2065909159403687
2001-11-09T09:30:00-05:00,25.75,25.99001,25.75,25.8,12400,70750,59.93518139782738,54.53772552760493,NaN,NaN,130.41311055236883,173.78797358901835,0.16664327269636559,0.3622991136587608,0.1956558409623952,11913101,11840221,77.88367776313905,62.3501726916184,NaN,NaN,13.0510984576974,4.612949136191373
2001-11-12T09:30:00-05:00,25.64999,25.95,25.3,25.89,120100,75810,60.684392040511845,55.11930875320838,NaN,NaN,98.2938230343834,158.32780108678324,0.15385982501622664,0.3879806222326785,0.23412079721645185,12033201,11893181,79.53491353273782,63.924318017187254,NaN,NaN,14.28887387882514,5.995224099424768
2001-11-13T09:30:00-05:00,26.10001,26.59,26.10001,26.55,105900,80140,65.74345846986658,56.133992221373866,NaN,NaN,151.8140342556083,148.8267847897875,0.1777670448993547,0.4563296033406452,0.2785625584412905,12139101,11958861,81.39057591126756,65.64365166174967,NaN,NaN,16.91908065395574,7.555775035786335
2001-11-14T09:30:00-05:00,27.14999,27.16,26.84,27.14999,116400,85045,69.57615353016212,57.26594152687187,NaN,NaN,175.40989232042395,148.9790503032677,0.21918314336410843,0.5525414876464261,0.33335834428231764,12255501,12053281,83.68136332194797,67.5160631522164,NaN,NaN,20.44847295663702,9.39758902447929
2001-11-15T09:30:00-05:00,27.25,27.5,27.00999,27.14999,88500,88630,69.57615353016212,58.225480596734656,NaN,NaN,159.80582625094294,143.1473372827455,0.2306128445682185,0.6216243999925908,0.39101155542437227,12255501,12119281,85.06529055429893,69.43921031295834,NaN,NaN,23.273644807750305,11.37988270780372
2001-11-16T09:30:00-05:00,27.5,27.5,26.85001,26.85001,124700,93570,65.33738083505975,59.51681617366608,NaN,NaN,129.94312129713992,143.05333943169973,0.20297885296562707,0.6447351216314061,0.44175626866577905,12130801,12162821,85.91397641306064,71.39048224753765,NaN,NaN,24.47467731836567,13.250567652169712
2001-11-19T09:30:00-05:00,27.02,27.74001,27.02,27.74001,255400,106115,70.98520980173353,61.49057683011572,NaN,NaN,143.97838120312434,152.1902510654479,0.2277882287295357,0.7264915545776987,0.49870332584816296,12386201,12233421,87.1855756250062,73.90382142403867,NaN,NaN,27.391069833108116,15.270639392303769
2001-11-20T09:30:00-05:00,27.35001,27.48,27.25,27.39999,122100,111155,66.52549183556995,62.80847623066716,NaN,NaN,119.80551605116496,145.78854742455923,0.20515136438971426,0.7551425313353057,0.5499911669455915,12264101,12258421,87.61203892375626,76.39371323117862,NaN,NaN,28.41695072390296,17.14868386824651
2001-11-21T09:30:00-05:00,27.00999,27.21001,26.91,27.14,24000,111835,63.25315084312095,63.599048349145214,NaN,NaN,90.4837706250104,128.80332308547653,0.15860252395166052,0.7482443218851671,0.5896417979335066,12240101,12255341,87.22689030865043,78.62298205366405,NaN,NaN,28.255070975845882,18.735310597903563
2001-11-23T09:30:00-05:00,27.2,27.60001,27.06,27.45,102500,115885,65.43628586415178,64.32185720987798,NaN,NaN,97.99412940164937,116.44098371561783,0.13552023024661508,0.7590420857417755,0.6235218554951604,12342601,12272761,87.55998489802386,80.63284661371456,NaN,NaN,28.774950430710216,20.169544859733087
2001-11-26T09:30:00-05:00,27.7,27.7,27.36,27.67,823500,156530,66.93749736934598,64.82920059383675,NaN,NaN,99.69386373928141,110.39113220404613,0.12230385762772111,0.7764016775298117,0.6540978199020906,13166101,12479821,90.67334626559685,82.5385233031037,NaN,NaN,29.649665442901036,21.52384780018565
2001-11-27T09:30:00-05:00,27.39999,27.44,27.10001,27.17,887400,200280,60.50546676613896,64.72186724479381,NaN,NaN,69.83178131469843,95.56181222636094,0.06973660412289795,0.7412685750557131,0.6715319709328151,12278701,12458321,88.20487460826752,83.73280842058232,NaN,NaN,28.442567715946847,22.512236359580108
2001-11-28T09:30:00-05:00,26.89999,27.3,26.81,27,21900,184325,58.44901088107112,64.61260529581534,NaN,NaN,50.212879560722705,81.6432849282725,0.0161615283567782,0.6917338813787879,0.6755723530220097,12256801,12456861,88.02961719632154,84.72831001245439,NaN,NaN,26.833044356699432,23.129494644882868
2001-11-29T09:30:00-05:00,27.00999,27.19,26.85001,27.19,16500,166900,60.08199865520961,64.50191655856656,NaN,NaN,47.289016715306964,73.0043341463318,-0.012299213295589362,0.660198336402523,0.6724975496981124,12273301,12463501,88.14498531495741,85.57907933121665,NaN,NaN,25.95206545453419,23.53271904626163
2001-11-30T09:30:00-05:00,27.45,27.7,27.25,27.39999,38700,160370,61.86579770691764,64.63981772350158,NaN,NaN,73.87473673531757,68.18045561306545,-0.022223070269710155,0.6447187118609747,0.6669417821306849,12312001,12457381,87.3097505837177,86.25237024697226,NaN,NaN,25.70924578363794,23.843651437315387
2001-12-03T09:30:00-05:00,27.14999,27.45,27,27,22500,159740,56.67094981759505,64.35314327900753,NaN,NaN,41.00578133158078,56.44283913152532,-0.05888498976874512,0.5933355449197535,0.6522205346884986,12289501,12282061,67.55987035988181,85.39701002033969,NaN,NaN,23.972234554992454,23.862020454126398
2001-12-04T09:30:00-05:00,27.14999,27.60001,27.05,27.60001,106100,160015,61.84643826116102,64.07478469267141,NaN,NaN,66.66730730673011,55.80994432993166,-0.04643205583440346,0.5941804648954943,0.6406125207298977,12395601,12305441,68.58056951532083,84.48200956348634,NaN,NaN,23.98183038784666,23.879136158943577
2001-12-05T09:30:00-05:00,27.7,28.55,27.56,28.42,624600,189130,67.55084313201857,63.930119664232585,NaN,NaN,157.4557957031573,77.25852755841856,0.010296751078906818,0.6534834595785313,0.6431867084996244,13020201,12458121,74.27331031652045,83.81000577738438,NaN,NaN,25.873498451141337,24.16404505782897
2001-12-06T09:30:00-05:00,28.39999,28.44,28.10001,28.10001,501300,212830,63.5573445642665,63.50020473809718,NaN,NaN,162.39219731659392,100.27916367867597,0.01902867083354276,0.6669725470415528,0.6479438762080101,12518901,12507241,75.79290138137397,83.14769226503259,NaN,NaN,26.129849101311457,24.444874206897897
2001-12-07T09:30:00-05:00,28,28.28999,28,28.11,456400,228545,63.629635555059245,63.37822293238286,NaN,NaN,140.27737817716445,113.55969196704532,0.018234512425616467,0.6707370167400306,0.6525025043144141,12975301,12639901,79.34185597097007,82.67825509059755,NaN,NaN,26.3535962110401,24.71754877891821
2001-12-10T09:30:00-05:00,27.96001,28.14999,27.66,27.74001,18000,228825,58.96440347967731,62.51959390937884,NaN,NaN,90.57103830932846,123.47274336259485,-0.012779772167492154,0.6365277891050489,0.6493075612725411,12957301,12773461,82.17522341144335,82.32037278962878,NaN,NaN,25.123780332795558,24.775581858043545
2001-12-11T09:30:00-05:00,27.60001,27.60001,27.25,27.55,478800,246760,56.666603837974506,61.815387623836315,NaN,NaN,15.074044771842905,113.15409085561741,-0.04959459552554035,0.5873143168656156,0.636908912391156,12478501,12790041,82.49617342536719,81.95495382545812,NaN,NaN,23.420066036940003,24.58193674074304
2001-12-12T09:30:00-05:00,27.60001,27.64,27.34,27.60001,29900,242960,57.14001591568339,61.37873512901934,NaN,NaN,18.15323836863096,85.29357938871216,-0.07268463854762752,0.5460531142066216,0.6187377527542491,12508401,12687681,73.67613326191413,80.98704260783411,NaN,NaN,22.159248926616858,24.235838481582157
2001-12-13T09:30:00-05:00,27.14999,27.45,27.14999,27.28999,1132700,293775,53.25581920160993,60.50870179598064,NaN,NaN,-39.88231080033543,44.838677765326274,-0.10877244744904124,0.48277219344294764,0.5915446408919889,11375701,12459041,58.60411289392262,78.91876603611259,NaN,NaN,19.949485937709284,23.623502403886032
2001-12-14T09:30:00-05:00,27.25,27.66,27.2,27.50999,71600,292930,55.56422052473288,59.69632487850828,NaN,NaN,-4.129515703903278,15.95729898911273,-0.11704266903337823,0.4452413046002661,0.5622839736336444,11447301,12153441,45.27292086809316,75.67587850771945,NaN,NaN,18.708134256781157,22.92130695429962
2001-12-17T09:30:00-05:00,27.5,27.89,27.45,27.81,128100,293100,58.568963273320584,59.558003200449825,NaN,NaN,53.008171461897376,8.444725619626507,-0.10207101192217505,0.4346952087309255,0.5367662206531005,11575401,11877061,37.06175516243847,72.0227985473031,NaN,NaN,18.48114744876936,22.286998453509582
2001-12-18T09:30:00-05:00,28.3,28.3,27.85001,28.10001,134200,287040,61.29366208575318,59.76119257221283,NaN,NaN,121.63998875350049,29.75791441595802,-0.07372217067504416,0.4446135073092954,0.5183356779843395,11709601,11723281,33.42876243780914,68.12273749312365,NaN,NaN,19.066388293944804,21.82691128785747
2001-12-19T09:30:00-05:00,27.89999,28.24001,27.8,28.24001,205500,291210,62.5732626327818,59.93913999918227,NaN,NaN,106.29877755580443,47.387022253392715,-0.04788012268290931,0.4584855246307029,0.5063656473136122,11915101,11604621,30.91086050340978,64.03458572087024,NaN,NaN,19.918254931352582,21.554246094071058
2001-12-20T09:30:00-05:00,28.3,28.39999,28.07001,28.07001,1060300,343025,59.98024117845923,59.80445739000667,NaN,NaN,107.36879821417342,76.8372440562945,-0.04463831429478449,0.45056775444513164,0.4952060687399161,10854801,11500441,28.855836612065403,59.859306151466505,NaN,NaN,19.928975287494495,21.322064550274405
2001-12-21T09:30:00-05:00,28.25999,28.45,28.14999,28.42999,13100,338555,63.435576320665994,60.28764499736888,NaN,NaN,119.82185603734443,101.62751840454402,-0.021808013985828434,0.46794605125763056,0.489754065243459,10867901,11384561,26.727351929896415,56.94269769218183,NaN,NaN,20.92363444641653,21.265145964008994
2001-12-24T09:30:00-05:00,28.5,28.64999,28.41,28.53,16400,298200,64.35633909225646,60.46692362816141,NaN,NaN,131.1689533116574,117.25967477449603,-0.004437801688020826,0.48420681313343295,0.48864461482145377,10884301,11246341,24.414091581509965,53.787949268338195,NaN,NaN,22.0125535917394,21.371918482256195
2001-12-26T09:30:00-05:00,28.55,28.95,28.55,28.8,118600,259760,66.78792725078488,60.412429636644724,NaN,NaN,147.13233538498406,122.35814410079274,0.01945803731240353,0.5129671614619582,0.49350912414955467,11002901,11105001,22.28962356530336,50.074828786108405,NaN,NaN,23.651782956715323,21.697613407178928
2001-12-27T09:30:00-05:00,28.75,29,28.7,28.83,17600,259545,67.05684230512944,60.662393760992074,NaN,NaN,142.14096850938927,129.5265822915097,0.030830765221994794,0.5320475806770482,0.5012168154550534,11020501,10926081,19.925854384486556,46.08432542918788,NaN,NaN,25.085352782644836,22.181576175102627
2001-12-28T09:30:00-05:00,28.95,29.10001,28.85001,29.03999,17700,259605,68.95187437541367,61.04255367673168,NaN,NaN,148.94132257093426,137.8410871628619,0.04517434428344613,0.557684745809361,0.5125104015259149,11038201,10962761,21.757742006095285,41.97117443169683,NaN,NaN,26.85707903970444,22.849505155760028
2001-12-31T09:30:00-05:00,28.89999,29.14999,28.60001,28.60001,30600,259200,61.030229855868534,61.19011270360248,NaN,NaN,107.76688925990207,135.43009380737342,0.01904555275586728,0.536317342470749,0.5172717897148817,11007601,10990701,23.199043711238787,37.758590167396505,NaN,NaN,26.21081836826583,23.32969275754657
2002-01-02T09:30:00-05:00,28.85001,28.85001,28.25,28.69,1201300,318140,61.992041037231054,61.57050107497794,NaN,NaN,75.01994169690384,124.2002914844227,0.0026972164770577844,0.520643310311204,0.5179460938341462,12208901,11255621,35.358118785706495,34.39158626456361,NaN,NaN,25.93772297508693,23.70226850290948
2002-01-03T09:30:00-05:00,28.75,28.85001,28.50999,28.60001,83400,317005,60.386985691378186,61.80242748752757,NaN,NaN,76.87290046386013,110.14840450019793,-0.018155963764495353,0.49525113912852703,0.5134071028930224,12125501,11480141,43.51939740221648,32.23753370315663,NaN,NaN,25.269350106105087,23.926137303365994
2002-01-04T09:30:00-05:00,29,29.25,28.89999,29.07001,52800,288415,65.42242027052082,62.67147042102119,NaN,NaN,124.49399798688147,106.61901039569636,-0.00496090008681116,0.5072059777845084,0.5121668778713195,12178301,11711701,50.465556081666094,31.656208216566878,NaN,NaN,26.1117765567412,24.238371482419595
2002-01-07T09:30:00-05:00,29.32001,29.45,28.89999,28.89999,44400,265570,62.33552750202431,63.15513520511344,NaN,NaN,109.4136163247066,98.71346914645082,-0.011950038088235915,0.49722933026102467,0.5091793683492606,12133901,11930841,55.98266912578691,32.42119023497358,NaN,NaN,25.935293808479436,24.480788957571
2002-01-08T09:30:00-05:00,29,29.3,28.95,29,37600,244630,63.4286382569278,63.502254846799666,NaN,NaN,97.3300713584415,96.62610556615871,-0.01396394019139291,0.4917244431100194,0.5056883833014123,12171501,12163621,60.95722139703369,34.12800925173038,NaN,NaN,26.09313565777029,24.711124200456613
2002-01-09T09:30:00-05:00,29,29.2,28.60001,28.60001,856200,286540,56.38082924063493,63.15133821500551,NaN,NaN,55.786225676912274,92.77936236216038,-0.044630894008308,0.4498997657910273,0.4945306597993353,11315301,11984901,55.74801156936659,35.72224133255592,NaN,NaN,24.14973589100698,24.630925870535236
2002-01-10T09:30:00-05:00,28.7,28.89999,28.60001,28.8,354900,280345,58.843203874799016,62.884905446578166,NaN,NaN,46.51476376435893,86.70773502226014,-0.05325836837106196,0.42795769933550787,0.48121606770656983,11670201,11893841,53.251038028774225,37.317968298653376,NaN,NaN,23.213309642617364,24.428409266546968
2002-01-11T09:30:00-05:00,28.55,28.74001,28.21001,28.25999,27700,280235,50.54583653662848,62.211019400733115,NaN,NaN,-11.642694673770702,59.480396490129706,-0.09472334215578881,0.3628118900118338,0.4575352321676226,11642501,11786681,50.39065430136725,38.85616956217494,NaN,NaN,19.719916773888173,23.755767481881424
2002-01-14T09:30:00-05:00,28.10001,28.3,28.05,28.05,562500,251725,47.72749180980831,61.08901336424328,NaN,NaN,-68.72017200649981,23.853638823888417,-0.13331956289627317,0.29088577854728115,0.4242053414435543,11080001,11575901,45.24279119305627,40.17870093811492,NaN,NaN,15.9308451393413,22.63792143294712
2002-01-15T09:30:00-05:00,28,28.3,28,28.23,45400,250415,50.28633168421865,60.084012835097724,NaN,NaN,-75.62767657530942,-10.737910762861764,-0.14290231417329358,0.24557744872693732,0.3884797629002309,11125401,11366681,40.78854990867658,41.348305104341115,NaN,NaN,13.55254268093771,21.340010182660063
2002-01-16T09:30:00-05:00,28.05,28.10001,27.75,27.75,48500,246435,44.08839074984512,58.46261737074489,NaN,NaN,-142.56180858860026,-50.40751761596427,-0.17559159605773023,0.16899026782806814,0.34458186388579837,11076901,11319001,39.826247724089015,42.60092111568294,NaN,NaN,9.435507837076432,19.639366990433828
2002-01-17T09:30:00-05:00,27.85001,28.10001,27.64999,28.08,49900,242220,48.76391980468172,57.15598004928434,NaN,NaN,-122.53074691520557,-84.21661975187718,-0.16895746104789433,0.13338503757593045,0.3023424986238248,11126801,11210321,37.646074651261074,43.86665113473826,NaN,NaN,7.443741764137686,17.897134815248666
2002-01-18T09:30:00-05:00,27.98,28.13,27.89999,28,366700,250280,47.722061414209605,55.63956483776976,NaN,NaN,-106.89082270011482,-103.266245357146,-0.16380409640445243,0.09758737811825924,0.26139147452271166,10760101,11033841,34.35704400258895,44.76660127734495,NaN,NaN,5.525826731074563,16.12980508893808
2002-01-22T09:30:00-05:00,28.35001,28.53,28.14999,28.17999,31900,198860,50.295134158656765,54.87277228796892,NaN,NaN,-54.29037336932024,-100.38028562971007,-0.1428837007436934,0.08278684859309493,0.22567054933678832,10792001,10976241,33.33342158575151,45.490485411238716,NaN,NaN,4.696928781812185,14.496537045062954
2002-01-23T09:30:00-05:00,28.25,28.78999,28.25,28.78999,22000,199305,57.864328724284654,54.57793569418703,NaN,NaN,8.229906142548963,-83.60876908613841,-0.08540962273465152,0.11890852091847393,0.20431814365312545,10814001,10913961,32.21577776433318,45.26603248114062,NaN,NaN,6.409192347855974,13.3412020883191
2002-01-24T09:30:00-05:00,28.7,28.94,28.7,28.8,4050300,401000,57.97741825956724,54.405823734771964,NaN,NaN,46.63158630668038,-45.770090107082275,-0.04613258524001637,0.14665241210310498,0.19278499734312135,14864301,11671441,52.90041328840532,45.93610504443983,NaN,NaN,7.792127488808659,12.548477145531894
2002-01-25T09:30:00-05:00,28.7,28.8,28.45,28.5,30800,396610,53.355487303139554,53.54389995138759,NaN,NaN,1.6628189792761825,-20.931376928185927,-0.039999035878937994,0.14278620249444884,0.18278523837338684,14833501,12412781,64.36237504615187,46.928734970474466,NaN,NaN,7.570144082385285,11.837286707939521
2002-01-28T09:30:00-05:00,28.75,29,28.75,28.99001,37700,397615,59.091921703922964,53.312213822951776,NaN,NaN,69.00158083369847,14.247103778576752,-0.0044529550902915604,0.1772190445105224,0.18167199960081395,14871201,13235001,72.38823122307173,48.10056083456624,NaN,NaN,9.229310939852894,11.464718741070003
2002-01-29T09:30:00-05:00,29.14999,29.25,28.38,28.38,26000,398030,50.728066997067224,52.40503016153317,NaN,NaN,22.98843692304227,29.702865837049263,-0.022525611077641117,0.15351498575376255,0.17604059683140366,14845201,14045641,77.71654532243457,49.2976554006663,NaN,NaN,7.8615346732341385,10.949978159950593
2002-01-30T09:30:00-05:00,28.3,29.2,28.3,29.10001,166700,404835,58.2410762001362,52.53790494435469,NaN,NaN,63.55990204180623,40.768865016900705,0.011672055636750167,0.19063066637734138,0.17895861074059122,15011901,14885221,81.66326542021253,51.14874496144101,NaN,NaN,9.382503302937613,10.72605318037731
2002-01-31T09:30:00-05:00,29.19,29.53999,29.10001,29.53999,206800,355110,62.049226196974786,52.766906538795816,NaN,NaN,152.103172309521,61.86318221746883,0.05894158640336039,0.2526355937447917,0.19369400734143133,15218701,14956101,81.95385797565179,53.198946386217976,NaN,NaN,11.996126880795774,10.90749228043709
2002-02-01T09:30:00-05:00,29.45,29.5,29.10001,29.24001,532000,377540,58.15521275579352,53.310433411593316,NaN,NaN,114.86323129899624,84.50326468141284,0.06456950308524081,0.27440588619798234,0.20983638311274153,14686701,14926741,81.3785643854387,55.412368535080226,NaN,NaN,12.732382765610323,11.168190921176123
2002-02-04T09:30:00-05:00,29.25,29.34,28.75,28.75,838500,416825,52.37333828140592,53.642279588136,NaN,NaN,57.248228135552075,82.15259414178357,0.0315278004849085,0.24924613371887716,0.21771833323396866,13848201,14722141,77.3060032307746,57.70259796634581,NaN,NaN,11.329020879372125,11.191166629489837
2002-02-05T09:30:00-05:00,28.8,29,28.64,28.72,1511000,490155,52.032260289782286,53.76698877424769,NaN,NaN,32.04505971498612,83.96391870017233,0.005265735620681722,0.22430050275982083,0.2190347671391391,12337201,14220541,68.28381379481512,59.66654538678428,NaN,NaN,10.139620074309212,11.040945693035463
2002-02-06T09:30:00-05:00,28.7,28.78,28.39999,28.49001,64200,491485,49.37738625850344,54.14477416772329,NaN,NaN,-6.693893311066236,69.91315962959784,-0.028145179081301264,0.18385329328751254,0.2119984723688138,12273001,13672761,60.04259403470771,61.11057012325705,NaN,NaN,8.327192960952834,10.653266731309373
2002-02-07T09:30:00-05:00,28.45,28.86,28.14999,28.14999,959900,496670,45.66751530198823,53.923602417530894,NaN,NaN,-36.27112327550038,32.23830051259357,-0.07124310800130193,0.12294458736718639,0.19418769536848832,11313101,12891641,50.65430673978233,62.039729558151414,NaN,NaN,5.6257754111280205,9.93505368556918
2002-02-08T09:30:00-05:00,28.25999,28.53999,28.14999,28.39999,15600,479705,48.718311864911215,53.994763164009576,NaN,NaN,-36.76988967518921,1.9116763177564693,-0.08033732965473409,0.09376603330007072,0.1741033629548048,11328701,12220041,44.24812300930151,62.746235201488034,NaN,NaN,4.320432709661496,9.132964974725224
2002-02-11T09:30:00-05:00,28.60001,29.25,28.60001,29.25,885100,522575,57.46375032843286,54.50680717613644,NaN,NaN,86.01986441536985,7.6660035737200305,-0.02916761073611146,0.13764384953466546,0.16681146027077692,12213801,11893161,41.497284843150545,63.32936829130226,NaN,NaN,6.078739340680794,8.696647027004591
2002-02-12T09:30:00-05:00,29.14999,29.25,28.89999,29,722500,530575,54.51887561765323,54.26784623994848,NaN,NaN,80.94919270350232,17.446830171423265,-0.013041612084332022,0.1505094451653619,0.16355105724969393,11491301,11723981,40.107519904808356,63.893064158479056,NaN,NaN,6.534180217833869,8.387723197123059
2002-02-13T09:30:00-05:00,29.48,29.60001,29.3,29.42999,43100,530460,58.46184238116803,54.30244796291997,NaN,NaN,138.51282966101698,46.488174765839915,0.023699407808957268,0.19317531701089052,0.16947590920193326,11534401,11576261,38.88302583920556,62.89182219782193,NaN,NaN,8.218941237005984,8.363611488534906
2002-02-14T09:30:00-05:00,29.5,29.7,29.3,29.53999,275400,541805,59.43080566196645,54.73639927426474,NaN,NaN,139.41696014878633,81.62579145069725,0.05096046867332288,0.23317649504358684,0.18221602637026396,11809801,11675601,40.20512604190689,61.16630441180444,NaN,NaN,9.8641478869561,8.577973831166505
2002-02-15T09:30:00-05:00,29.60001,29.60001,29.14999,29.2,607200,569670,55.14873539563171,54.454743109386804,NaN,NaN,94.76801002352494,107.93337139044009,0.04201714526075101,0.2347374579462027,0.1927203126854517,11202601,11650381,39.96873633898331,58.85062620579812,NaN,NaN,9.925963305415532,8.770543756059222
2002-02-19T09:30:00-05:00,29.10001,29.39,28.83,28.86,241400,563405,51.1775588475394,54.486849670134816,NaN,NaN,29.959323525820412,96.72126321253019,0.010754035220415792,0.20616285671097145,0.19540882149055566,10961201,11399861,37.603587833489165,55.98541495658774,NaN,NaN,8.744551297251899,8.766830547658175
2002-02-20T09:30:00-05:00,29.10001,29.45,28.89,29.42999,158500,569735,56.79445194253074,54.38351936602014,NaN,NaN,73.82687567182487,95.29679980619471,0.02518910449192932,0.22689520210546732,0.201706097613538,11119701,11325541,36.90586747321377,52.78845796037354,NaN,NaN,9.51647574937283,8.873922719331697
2002-02-21T09:30:00-05:00,29.39999,29.75,29.14999,29.14999,746200,605945,53.53609374385141,53.775438476511326,NaN,NaN,85.97676476245721,84.78958682648276,0.013208409918473996,0.2182166100116305,0.2050082000931565,10373501,11093361,34.73739859379218,49.41585371881214,NaN,NaN,9.124050046902786,8.909655194698995
2002-02-22T09:30:00-05:00,28.91,29.19,28.60001,29.19,17100,404285,53.94271163267215,53.4745455391455,NaN,NaN,1.624976271487793,57.231190051023056,0.005691060092383571,0.212122025208636,0.20643096511625242,10390601,10809521,32.24320875476975,45.90618545947864,NaN,NaN,8.932170341355338,8.91287164422133
2002-02-25T09:30:00-05:00,29.39999,29.7,29.39999,29.67999,28000,404145,58.708500181014415,53.927057103403264,NaN,NaN,129.51453356197194,64.18049475871244,0.030069021471838958,0.24401724195605112,0.21394822048421216,10418601,10652721,30.922334046079428,42.59306623200042,NaN,NaN,10.232353002045382,9.101368981053337
2002-02-26T09:30:00-05:00,29.89999,30.19,29.55,30,206000,412560,61.509727819850646,54.60401906983672,NaN,NaN,168.10819721779464,91.81026949710729,0.06224415310388476,0.2917534118640681,0.22950925876018335,10624601,10585401,30.347517484876008,39.88333078129049,NaN,NaN,12.195219597710468,9.543347640575785
2002-02-27T09:30:00-05:00,30.25,30.25,29.7,29.95,398300,431175,60.81551398517065,55.42102819317008,NaN,NaN,154.8380885239195,108.01251206752622,0.07386468562213641,0.3218401157878539,0.24797543016571746,10226301,10406721,28.81638415684141,37.65288721858575,NaN,NaN,13.578361226249932,10.119778152814948
2002-02-28T09:30:00-05:00,29.89,30.05,29.56,29.7,376400,441660,57.33136718435339,56.25416047048189,NaN,NaN,105.24410438259439,111.86597999155364,0.059060940784635196,0.32180160614651143,0.26274066536187624,9849901,10302001,27.92707321411703,36.02951339532393,NaN,NaN,13.751782716744165,10.63863594766198
2002-03-01T09:30:00-05:00,29.7,30,29.7,29.98,216600,442150,60.089243169690405,57.06636984939468,NaN,NaN,116.10765037208145,134.76251481167236,0.062159757582798014,0.3404403623403738,0.27828060475757577,10066501,10237181,27.364135989536763,34.8235143224836,NaN,NaN,14.70141082517543,11.21903235873533
2002-03-04T09:30:00-05:00,30.05,30.45,29.89999,30.42999,159300,423515,64.10468458733084,57.54072229645883,NaN,NaN,152.97696801518742,139.45500170231549,0.08702379809803373,0.38706035238011793,0.3000365542820842,10225801,10198621,27.015271660982407,33.78908480947158,NaN,NaN,16.754799207889075,12.009856194328721
2002-03-05T09:30:00-05:00,30.2,30.2,29.36,29.53999,251200,394150,52.79162255550407,57.41734707773389,NaN,NaN,60.32563944051933,117.89849014686042,0.03851306890898876,0.34817789041832015,0.3096648215093314,9974601,10068621,25.82011717942264,32.7685560433726,NaN,NaN,14.918061598803437,12.42531410925368
2002-03-06T09:30:00-05:00,29.45,29.98,29.45,29.95,113500,324275,56.59218161732158,57.28379988031629,NaN,NaN,68.02432732015707,100.53573790610794,0.029431290224245288,0.346453934289638,0.3170226440653927,10088101,10040981,25.56119147373977,31.81699644583933,NaN,NaN,14.647221305305136,12.742729422975316
2002-03-07T09:30:00-05:00,30.36,30.36,29.91,30.17999,526600,347395,58.60531336903018,57.22483614510656,NaN,NaN,113.68578159391309,102.22407334837168,0.03398335999125662,0.3595018440544635,0.3255184840632069,10614701,10193941,29.75908701088349,31.070850800766227,NaN,NaN,15.073191712988354,13.075652607262892
2002-03-08T09:30:00-05:00,30.55,30.59,30.14999,30.35001,236300,311215,60.07924954487873,57.57701572719562,NaN,NaN,136.6711350158629,106.33677027712797,0.04293763456647581,0.37919052727130165,0.33625289270482583,10851001,10350841,33.87822614813426,30.635814358562726,NaN,NaN,15.87404262125787,13.475422609262175
2002-03-11T09:30:00-05:00,30.14999,30.39,29.91,30.21001,517300,336300,58.24029763620772,58.08149706924337,NaN,NaN,97.64445657110561,95.2702679883116,0.03429911226980503,0.37912678304208214,0.3448276707722771,10333701,10372421,34.44762673926772,30.410388566118343,NaN,NaN,15.98313565711863,13.833667330384525
2002-03-12T09:30:00-05:00,30.00999,30.44,29.89999,30.27,304500,307270,58.82192842307999,58.22631681785403,NaN,NaN,94.85324684597585,102.1757894694029,0.02777133130825732,0.37954183490759874,0.3517705035993414,10638201,10505141,37.98468326220644,30.487446836760675,NaN,NaN,16.23730174244392,14.17704367496444
2002-03-13T09:30:00-05:00,30.25,30.31,30,30.2,602300,301260,57.8101212966164,58.53160450019438,NaN,NaN,81.74851756066778,104.92062751750504,0.014549764587089398,0.36995770933320316,0.35540794474611376,10035901,10494701,37.81184881606113,30.707050424065603,NaN,NaN,16.17163698674516,14.461985576647399
2002-03-14T09:30:00-05:00,30.3,30.42,30.14,30.2,76100,302910,57.81012129661641,58.80784804761897,NaN,NaN,88.97095117160373,99.97766143304315,0.002259833617723972,0.3582327367682687,0.35597290315054475,10035901,10378941,35.86328529971712,30.96562732013327,NaN,NaN,16.117187699363978,14.698443022749768
2002-03-15T09:30:00-05:00,30.35001,30.64999,30.28999,30.55,58300,292055,61.63672527380525,59.017006982818316,NaN,NaN,120.14847546917711,96.67312952370601,0.013529124096617717,0.3728843082713169,0.3593551841746992,10094201,10227581,33.43695115884728,31.145242828188113,NaN,NaN,17.10776465866686,15.042631827880781
2002-03-18T09:30:00-05:00,30.75,30.75,30.2,30.56,29800,263185,61.74348986237122,59.03370427156979,NaN,NaN,111.86275038437634,99.51678828636015,0.017245282024311026,0.38091178670508796,0.36366650468077694,10124001,10185641,32.77526994301549,31.318653718055224,NaN,NaN,17.960610794622482,15.459485965986739
2002-03-19T09:30:00-05:00,30.7,30.82001,30.47,30.69,287000,265465,63.17813781469247,59.20246311653563,NaN,NaN,130.85800117873185,106.71773915291135,0.023651289830197153,0.39323061696852335,0.3695793271383262,10411001,10140201,32.03558067886344,31.548596326771083,NaN,NaN,19.072895058138226,15.975687264865522
2002-03-20T09:30:00-05:00,30.5,30.74001,30.42,30.57001,86800,261880,60.90775561214045,59.457919432806136,NaN,NaN,106.12328896318357,111.5926934334145,0.015399746062609299,0.38882900971658785,0.37342926365397855,10324201,10197861,34.06893983656673,31.98730108551749,NaN,NaN,19.45674617472046,16.472981394844798
2002-03-21T09:30:00-05:00,30.55,30.55,29.89999,30.19,186900,233915,54.25766029350657,59.04137779879301,NaN,NaN,28.820955101446096,99.56269421938298,-0.018235275590137767,0.3506351691663063,0.3688704447564441,10137301,10218141,34.80770557739625,32.51898462750746,NaN,NaN,17.992834877274415,16.69010332090617
2002-03-22T09:30:00-05:00,29.85001,30.3,29.75999,30.05,249700,245545,52.00488881147845,58.17710667194642,NaN,NaN,-27.04005290503798,70.12498854453995,-0.05065852663277448,0.305547286465476,0.3562058130982505,9887601,10176821,33.972447714363526,33.01592577417754,NaN,NaN,16.119730867148057,16.60862154179787
2002-03-25T09:30:00-05:00,30.05,30.14,29.5,29.5,561900,272240,44.23459455215383,57.56589038599282,NaN,NaN,-121.86049277016035,23.380339913632625,-0.10667236407223679,0.22286535800795448,0.3295377220801913,9325701,10017161,30.888141754185128,33.37792752951771,NaN,NaN,12.010199891224046,15.951704163144466
2002-03-26T09:30:00-05:00,29.60001,30.12,29.60001,29.89999,383400,281110,50.07667970586387,57.10049739231727,NaN,NaN,-74.85852165724432,-17.762964653562605,-0.11366671577710996,0.18745432735880385,0.3011210431359138,9709101,9876781,28.443021929574172,33.583772562077314,NaN,NaN,10.159775918913446,15.124285842540035
2002-03-27T09:30:00-05:00,29.85001,30.16,29.78,30.10001,165100,269450,52.74280137488543,56.68174653559266,NaN,NaN,-36.400641090693895,-46.267750664338095,-0.10207249681074809,0.1735304221224787,0.2756029189332268,9874201,9786781,26.969028260353525,33.38448265132517,NaN,NaN,9.420203909709045,14.30941699499275
2002-03-28T09:30:00-05:00,30,30.2,29.95,30.03999,246700,262965,51.848022035606725,56.093801713501804,NaN,NaN,-28.37828302943462,-57.70759829051425,-0.09579761141664511,0.15585590466242039,0.2516535160790655,9627501,9684821,25.365296166582638,32.77641622407148,NaN,NaN,8.557203061065783,13.487672147288897
2002-04-01T09:30:00-05:00,29.35001,29.60001,29.10001,29.48,54300,254850,44.29714415615043,55.097862179211994,NaN,NaN,-200.05266928592005,-92.31012156669064,-0.12487429635876213,0.09556064563061284,0.22043494198937497,9573201,9621941,24.40157420435081,32.05884104300599,NaN,NaN,5.382185353291906,12.329745462432184
2002-04-02T09:30:00-05:00,29.3,29.3,28.89999,28.95,291500,261460,38.57164108829507,53.651413083870224,NaN,NaN,-227.2488930330032,-113.38780161925922,-0.172385907323525,0.004952557834968729,0.17733846515849372,9281701,9613141,24.262641425893662,31.078695197555078,NaN,NaN,0.6557481360920906,10.662031558669314
2002-04-03T09:30:00-05:00,29.05,29.32001,27.92,28.73,104400,254120,36.46474737452842,52.12674351800679,NaN,NaN,-249.93121212649183,-148.40233971310872,-0.20878515748307364,-0.08364298169534834,0.1251421757877253,9177301,9506781,22.588634700476007,29.99132276072757,NaN,NaN,-3.8917922999468555,8.58291386458129
2002-04-04T09:30:00-05:00,28.75,29.25999,28.75,29.12,267400,261815,42.464545876970035,51.030630988032044,NaN,NaN,-150.45972504427613,-171.21415650382517,-0.19690664779627354,-0.12099113395761663,0.07591551383865691,9444701,9420881,21.309845560588897,28.95179135078984,NaN,NaN,-5.816678315438002,6.525829267435677
2002-04-05T09:30:00-05:00,29.35001,29.55,29.23,29.3,191400,245055,45.04401016836997,49.84543705192952,NaN,NaN,-86.12683140029644,-182.76386617799753,-0.16834418396076511,-0.13451471611229948,0.03382946784846563,9636101,9422601,21.4057899265096,28.092422691337152,NaN,NaN,-6.565000160353099,4.655710777751566
2002-04-08T09:30:00-04:00,29.06,29.77,29.06,29.74001,238200,245150,50.84540975844597,49.06700275879201,NaN,NaN,-54.681032068022205,-153.68953873441797,-0.11384491122123208,-0.10847667117807447,0.005368240043157613,9874301,9482821,24.86014076402502,27.52705632140926,NaN,NaN,-5.318619415594962,3.2308064644163483
2002-04-09T09:30:00-04:00,29.77,30.03999,29.77,29.95,1285500,283560,53.37503957621973,48.36678145604395,NaN,NaN,5.038758881708168,-107.23200835147568,-0.06036575452314423,-0.07008895311077268,-0.009723198587628447,11159801,9858441,41.9874910445379,28.237907061814578,NaN,NaN,-3.488789472227158,2.2708641877529905
2002-04-10T09:30:00-04:00,30.13,30.42999,30.09,30.3,1083400,322505,57.31774526330468,48.110352145412826,NaN,NaN,56.78865918648997,-45.88803408887933,-0.0012567556847221783,-0.01129414319353117,-0.010037387508808992,12243201,10471621,58.583868122094984,29.988973367923737,NaN,NaN,-0.661058405348614,1.8520181030241898
2002-04-11T09:30:00-04:00,30.5,30.53999,29.84,29.84,31800,293980,51.190821797025194,47.89129225280701,NaN,NaN,28.14234010044481,-10.167621059935152,0.0065928844551076515,-0.0017962819399244268,-0.008389166395032078,12211401,11024961,67.59358919838252,32.33082219799419,NaN,NaN,-0.20624247166225654,1.5579808780689832
2002-04-12T09:30:00-04:00,30,30.48,30,30.45,60400,293195,57.654985290312055,48.2948705727237,NaN,NaN,62.73537506861836,19.6048202338478,0.05017253428203637,0.05432650145751339,0.004153967175477016,12271801,11552101,73.50648229656977,35.15468181100892,NaN,NaN,2.4219667168381536,1.681407426464579
2002-04-15T09:30:00-04:00,30.45,30.45,29.87,29.99001,135400,297050,52.056284681244485,48.8535627248016,NaN,NaN,36.18339460532376,37.77770556851699,0.0454639292568907,0.06098387874659039,0.015519949489699692,12136401,12004521,77.32968372511469,38.47193480893246,NaN,NaN,2.693758324064598,1.8260289832645817
2002-04-16T09:30:00-04:00,30.10001,30.42999,30.10001,30.42999,30300,297075,56.415895613237595,49.306363861042584,NaN,NaN,71.96973243816814,51.16390027980899,0.06806637586023562,0.10060291931499421,0.03253654345475859,12166701,12205901,78.79643244073313,42.06860698830095,NaN,NaN,4.425773381242096,2.1974210401185124
2002-04-17T09:30:00-04:00,30.5,30.5,30.00999,30.12,21200,283785,52.77472163508314,49.30864387962813,NaN,NaN,60.54678506818082,51.91552545614716,0.05858553254927181,0.10576845914134836,0.04718292659207655,12145501,12186361,78.26729151975587,45.73276864968683,NaN,NaN,4.608238082875319,2.541823474798056
2002-04-18T09:30:00-04:00,30.08,30.19,29.58,29.92,708800,314885,50.509653215468525,49.21304610676111,NaN,NaN,16.22397038567483,49.53185151319316,0.03637828271333962,0.09265577998375107,0.05627749727041145,11436701,12031421,74.02253833262515,49.2082859472613,NaN,NaN,4.022827050647456,2.753395414205113
2002-04-19T09:30:00-04:00,30.09,30.14,29.98,30.05,57100,308395,51.953158109472035,49.75990424628408,NaN,NaN,45.735594946923996,46.13189548885428,0.028335424146112384,0.09169677745305194,0.06336135330693955,11493801,11875821,69.92132364979244,52.45969662193571,NaN,NaN,3.997058769052601,2.931061607754754
2002-04-22T09:30:00-04:00,30.10001,30.10001,29.64999,29.75999,45000,298160,48.55103107902884,50.472717817050786,NaN,NaN,9.269887547048778,40.74919407719929,0.002723512409186085,0.06676574381842215,0.06404223140923607,11448801,11738301,66.41880434515748,55.47085111616884,NaN,NaN,2.9314747945555815,2.9311206344405867
2002-04-23T09:30:00-04:00,29.62,30.02,29.62,29.81,44100,272270,49.16918160025498,51.380177404602684,NaN,NaN,4.850111429248399,27.32526987541534,-0.010864648134864763,0.05046142124065511,0.061326069375519876,11492901,11603541,63.08400304220461,58.3633774262923,NaN,NaN,2.2502889588475288,2.8338589664987213
2002-04-24T09:30:00-04:00,29.92,30.08,29.48,29.55,53300,255765,46.07006734229136,51.63771465212563,NaN,NaN,-13.880787376223974,12.439755386534383,-0.03596359177022501,0.01637157966273861,0.05233517143296362,11439601,11462361,59.702068877668395,61.10567909179798,NaN,NaN,0.7625280772674422,2.537954553751396
2002-04-25T09:30:00-04:00,29.38,29.64,29.33,29.63,348600,264940,47.17338038394936,51.78981252466701,NaN,NaN,-39.331114852701745,1.328738338859091,-0.04518156914855247,-0.004141790002726964,0.0410397791458255,11788201,11532661,60.82819320278434,63.92156504010332,NaN,NaN,-0.1597077111392875,2.152574230195584
2002-04-26T09:30:00-04:00,29.83,29.92999,29.39,29.45,124600,258835,44.94535130547119,51.36837977802596,NaN,NaN,-25.52412717407304,-12.923206085340315,-0.06045205759346771,-0.03452529284600914,0.025926764747458572,11663601,11566621,61.389507329844925,66.53080550909046,NaN,NaN,-1.5695630639826774,1.620840331027261
2002-04-29T09:30:00-04:00,29.37,29.58,29.13,29.13,1014800,306860,41.21821564985631,50.500035211857146,NaN,NaN,-78.35069751375597,-30.447323097501272,-0.08751232894774875,-0.08346364643722737,0.0040486825105213835,10648801,11406621,57.22864973410106,67.6194597012021,NaN,NaN,-3.883931019547557,0.834444423802287
2002-04-30T09:30:00-04:00,29.05,29.28999,29.05,29.2,174500,301010,42.34454034052206,49.43052057451553,NaN,NaN,-98.83863899350656,-51.18507318205227,-0.09545531649571855,-0.11527046310912681,-0.019815146613408257,10823301,11272701,53.93362658766608,67.28729959160005,NaN,NaN,-5.500922844754321,-0.07060804313437119
2002-05-01T09:30:00-04:00,29.25,29.47,28.7,29.36,99800,300780,44.941423695471144,48.984134995833095,NaN,NaN,-112.68773973443159,-70.94646365369378,-0.08503842466628463,-0.12611317744626405,-0.04107475277997942,10923101,11169401,51.4718192963177,66.13574459859542,NaN,NaN,-6.182558712390353,-0.943743853028083
2002-05-02T09:30:00-04:00,29.55,29.69,29.48,29.63,128100,293815,49.10720770246922,48.37357945384433,NaN,NaN,-39.863567715052476,-71.05295422616393,-0.05644622402460112,-0.11163253281073082,-0.0551863087861297,11051201,11022001,48.098134474279206,64.32086261128894,NaN,NaN,-5.620933844271418,-1.6119138517771308
2002-05-03T09:30:00-04:00,29.60001,29.60001,29.17999,29.23,87700,288630,43.81784121986143,47.78511920660268,NaN,NaN,-95.01701465933785,-84.9515317232169,-0.06059012473303958,-0.13092396470242917,-0.07033383996938959,10963501,10881981,45.07571404106115,62.01700763385655,NaN,NaN,-6.654961244289756,-2.3323491935646485
2002-05-06T09:30:00-04:00,29.2,29.53999,28.7,28.7,59800,279710,37.98044667127245,46.468301425033744,NaN,NaN,-150.3225452847472,-99.34590127741515,-0.09319334858735731,-0.18682552570358624,-0.09363217711622893,10903701,10932961,46.396445951581725,59.70272288463145,NaN,NaN,-9.42546912858176,-3.345652041424236
2002-05-07T09:30:00-04:00,29.03,29.24001,28.91,29.12,178700,224370,44.311705817029505,45.863800295172766,NaN,NaN,-112.80602585818875,-102.13937865035157,-0.08108602285279984,-0.19498970568222873,-0.11390368282942889,11082401,10984781,47.771254139034625,57.52443450029422,NaN,NaN,-9.799524130860949,-4.267633768486624
2002-05-08T09:30:00-04:00,29.57001,29.62,29.27,29.55,18500,171125,49.94558692546361,45.8235098458867,NaN,NaN,-37.41354554937456,-87.08453981334017,-0.0407666887583632,-0.1648620437773829,-0.12409535501901969,11100901,11020341,48.742776122601164,55.71873719957822,NaN,NaN,-8.267330176407745,-4.839018969618213
2002-05-09T09:30:00-04:00,29.3,29.33,28.99001,29.10001,349900,187030,44.833845848252956,45.31498754151391,NaN,NaN,-91.99579393733255,-97.51098505779619,-0.040944210952118976,-0.1752756187091684,-0.13433140775704944,10751001,10960301,47.14810584657773,54.09207878506288,NaN,NaN,-8.656523534396635,-5.384376764586559
2002-05-10T09:30:00-04:00,29.2,29.25,28.62,28.62,532000,210610,40.11718855525985,44.712570218387555,NaN,NaN,-136.5855595726534,-105.8246940404593,-0.06831755823498292,-0.21972835555077808,-0.15141079731579515,10219001,10811401,43.35946649304182,52.44498322419747,NaN,NaN,-10.588393689411085,-6.127807753847206
2002-05-13T09:30:00-04:00,28.83,29.05,28.83,28.92999,10100,204345,44.19987110314882,44.35761946859425,NaN,NaN,-105.23434000187873,-96.80705298388561,-0.060730101765741173,-0.2273234245229716,-0.16659332275723043,10229101,10676481,40.206754138605795,50.81089401679757,NaN,NaN,-10.80636886207743,-6.796173626451523
2002-05-14T09:30:00-04:00,29.78,29.96001,29.64999,29.96001,259400,215800,55.14329973966113,45.00570749697781,NaN,NaN,75.91646447155539,-59.062554917936794,0.01446141085120084,-0.14851655919322937,-0.1629779700444302,10488501,10557701,37.61377505508946,49.23315874375621,NaN,NaN,-6.938158668204158,-6.816457203844757
2002-05-15T09:30:00-04:00,29.89,30.19,29.78,29.78,405600,235020,53.18036797112628,45.43477803891903,NaN,NaN,94.56493846273099,-32.66685811551568,0.050829924583982194,-0.09944056431445247,-0.15027048889843467,10082901,10354101,33.612322620964136,47.28916798791192,NaN,NaN,-4.64190911454599,-6.505807476802076
2002-05-16T09:30:00-04:00,30,30.16,29.89999,30,132200,206190,55.275763998175776,46.17266465982649,NaN,NaN,112.81371503407568,8.295043678765964,0.08637028918039899,-0.04230762742293592,-0.1286779166033349,10215101,10246921,31.700458837228894,45.16852166701077,NaN,NaN,-2.1165522180831395,-5.8787710112708
2002-05-17T09:30:00-04:00,30.2,30.32001,30.10001,30.25,207500,213710,57.59810199681817,47.34265654175234,NaN,NaN,149.23717244364641,65.45959008202594,0.12124617585681799,0.022879803217687567,-0.09836637263913042,10422601,10287641,33.253788876266654,43.45603160573688,NaN,NaN,0.6882453388081567,-4.940625818402378
2002-05-20T09:30:00-04:00,30.37,30.41,30.10001,30.14999,470500,234985,56.33781175371299,48.342175928408835,NaN,NaN,137.02118028943673,113.91069414028902,0.13126416396363239,0.06571383231541006,-0.06555033164822233,9952101,10232241,32.18143520692453,41.902303649969625,NaN,NaN,2.5471783558273358,-3.8709395077981332
2002-05-21T09:30:00-04:00,30.14999,30.14999,29.39999,29.39999,162900,240925,47.87733412751285,48.55188381641181,NaN,NaN,31.53972384800031,105.03534601557801,0.08339652244751265,0.03869532141116849,-0.04470120103634416,9789201,10092381,29.587420392703237,40.33913229971146,NaN,NaN,1.4507619643228735,-3.1106964403522754
2002-05-22T09:30:00-04:00,29.2,29.37,29.03999,29.27,326800,254600,46.571907997264596,48.370790980325765,NaN,NaN,-45.64505575942589,76.99334717114665,0.041134102780095314,0.006716427438774986,-0.03441767534132033,9462401,9968281,27.471441039656227,38.86579705438124,NaN,NaN,0.16465599278685233,-2.642788949903829
2002-05-23T09:30:00-04:00,29.45,29.56,29.24001,29.55,55300,239935,49.75017009121679,48.79452875685115,NaN,NaN,-1.7839882817086095,54.07380650798979,0.03067124449834483,0.003921380281610709,-0.026749864216734122,9517701,9828801,25.28289371189956,37.45202417372684,NaN,NaN,0.07311974731821325,-2.2548019931578227
2002-05-24T09:30:00-04:00,29.64999,29.78999,29.31,29.32001,21900,234800,47.26315534329119,49.45757937628106,NaN,NaN,3.968289202276871,25.020029859715883,0.008071939212702113,-0.016659940200856482,-0.024731879413558595,9495801,9643441,22.695283379081403,35.759083989976816,NaN,NaN,-0.7581187501428225,-2.040990101298537
2002-05-28T09:30:00-04:00,29.2,29.25,28.66,28.86,790400,223580,42.66867927259003,49.34022033739253,NaN,NaN,-96.58958199453599,-21.70212259707866,-0.035647299619867116,-0.06929100393839249,-0.033643704318525376,8705401,9394101,19.76488299110838,33.758628907982086,NaN,NaN,-2.916677206386774,-2.1660882591682853
2002-05-29T09:30:00-04:00,28.88,29.02,28.8,28.8,26500,216180,42.09389998794402,48.77938555614112,NaN,NaN,-98.84018677511403,-47.778104721701524,-0.06470331778607735,-0.11452285155112207,-0.04981953376504472,8678901,9172041,17.586948070867237,31.533212618572524,NaN,NaN,-4.825059339958853,-2.545941270709795
2002-05-30T09:30:00-04:00,28.66,28.74001,28.39999,28.55,120900,217235,39.69453630023,48.41229201699663,NaN,NaN,-137.8667779168375,-66.22244915318385,-0.09502343300332625,-0.16859882501920254,-0.07357539201587629,8558001,8991161,16.036799750303032,29.310976468838618,NaN,NaN,-7.152825692275404,-3.2040676166477393
2002-05-31T09:30:00-04:00,28.8,29.28999,28.75999,29.05,207900,221225,46.28866667471425,48.853111882671946,NaN,NaN,-54.105610957033264,-76.68677368824878,-0.0764666037329074,-0.16915864668201053,-0.09269204294910313,8765901,8840801,14.863947296723026,27.275582240530134,NaN,NaN,-7.2209959183749035,-3.777914516894477
2002-06-03T09:30:00-04:00,29,29.03999,28.28,28.28,38600,218770,39.18301210906919,48.49476481166626,NaN,NaN,-119.31662419340681,-101.34375636738551,-0.10912158240636834,-0.22909402095706355,-0.11997243855069521,8727301,8687101,13.75641316425994,25.386272170934,NaN,NaN,-9.6288403160202,-4.613761059626723
2002-06-04T09:30:00-04:00,28.28,28.28,27.75,28.12,718100,251685,37.8817250582573,47.26179519156599,NaN,NaN,-169.3811812361364,-115.90207621570559,-0.1329858171315023,-0.2862047099650731,-0.1532188928335708,8009201,8547861,12.824174298300136,23.6155864025919,NaN,NaN,-11.971885719098138,-5.664921725265497
2002-06-05T09:30:00-04:00,28.3,28.73,28.3,28.7,145400,250020,45.01097736304828,46.678267290988984,NaN,NaN,-88.72594367112555,-113.87922759490789,-0.10256100843418825,-0.2814201533763061,-0.17885914494211785,8154601,8443001,12.156067896300925,22.082996779401668,NaN,NaN,-11.690141361338679,-6.525667387561666
2002-06-06T09:30:00-04:00,28.60001,28.60001,28.14,28.25,489800,273585,41.072362743487396,45.66373862993982,NaN,NaN,-108.04437038244286,-107.91474608802898,-0.10520223426777173,-0.3103619377768325,-0.2051597035090608,7664801,8264361,11.095548674939906,20.61121748209531,NaN,NaN,-12.743439864025163,-7.4139205984850225
2002-06-07T09:30:00-04:00,28.00999,28.48,28.00999,28.28,1344700,323325,41.44025247437959,44.50960652119421,NaN,NaN,-103.93042341608108,-117.87970857983855,-0.09755789672256304,-0.3271070744122646,-0.22954917768970157,9009501,8313081,13.316679898237538,19.187138269378945,NaN,NaN,-13.457768309636922,-8.277327414363866
2002-06-10T09:30:00-04:00,28.45,28.96001,28.45,28.75,609600,327205,47.0206664139397,43.844096139781826,NaN,NaN,-48.78940948903778,-103.77426563896475,-0.05556536986145494,-0.2990058900165202,-0.2434405201550653,9619101,8491441,21.089202785253434,18.3948359535453,NaN,NaN,-12.322808726885082,-8.855253316152611
2002-06-11T09:30:00-04:00,29.10001,29.38,28.60001,28.60001,568200,355110,45.52955612765894,43.67639771122084,NaN,NaN,-31.955210383507698,-76.28907146843899,-0.033685049692252333,-0.2855468322703807,-0.25186178257812836,9050901,8699781,29.08769215095066,18.359141079134396,NaN,NaN,-11.8458427482775,-9.282480377884738
2002-06-12T09:30:00-04:00,28.61,28.84,28.42,28.84,106500,347465,48.351782511858154,43.80353160512038,NaN,NaN,-45.72803141213476,-67.68948901664083,-0.0005932860004776996,-0.25260339007872545,-0.25201010407824775,9157401,8900341,35.83072138134989,18.956232532112516,NaN,NaN,-10.60330540315308,-9.471169667208788
2002-06-13T09:30:00-04:00,28.55,28.66,28.16,28.17999,457000,350035,41.91919220748107,43.2441760419964,NaN,NaN,-84.12148847311406,-62.90491263477507,-0.019643676861875903,-0.27656470015559265,-0.25692102329371674,8700401,9107461,41.96784051855593,20.14801444687368,NaN,NaN,-11.50408317908058,-9.761585883190472
2002-06-14T09:30:00-04:00,27.89999,28,27.39999,28,2402900,463570,40.3429477412437,42.749875498993006,NaN,NaN,-142.98575879539305,-70.71597971063747,-0.03969858016874117,-0.30654424850464324,-0.26684566833590206,6297501,8565061,33.05272468935486,20.88783168332179,NaN,NaN,-12.722204090309056,-10.18453134135027
2002-06-17T09:30:00-04:00,28.09,28.75999,28.09,28.74001,625900,484490,48.85757904886086,43.191939768726634,NaN,NaN,-41.098687495372246,-69.17783531190436,-0.0005290494386273603,-0.2675069801341863,-0.2669779306955589,6923401,8025921,26.92921260663168,21.399569513002024,NaN,NaN,-11.041708321417481,-10.306985195645586
2002-06-18T09:30:00-04:00,28.5,28.72,28.5,28.64999,123700,467150,47.96081798848113,43.61100534019358,NaN,NaN,-18.441943348245335,-66.47518190485188,0.02073850796456489,-0.24105479573985278,-0.26179330370441767,6799701,7575681,23.08315575391883,21.792155776077134,NaN,NaN,-9.98212016188598,-10.2605759051085
2002-06-19T09:30:00-04:00,28.5,28.77,28.46001,28.53,442600,481135,46.729620335039726,44.11351134267999,NaN,NaN,-17.753447474550576,-60.88026511733504,0.027710692164020112,-0.2271549384993925,-0.2548656306634126,6357101,7015621,19.376068060752473,22.030674941109236,NaN,NaN,-9.482314702998119,-10.149395733378444
2002-06-20T09:30:00-04:00,28.39999,28.45,28.11,28.11,142800,471935,42.60667340056378,43.85051182309781,NaN,NaN,-86.89317132181576,-61.43460168707539,0.006148224375373601,-0.2471803501941956,-0.2533285745695692,6214301,6518401,16.796972647121493,22.168748180423414,NaN,NaN,-10.292669593642827,-10.169863427701928
2002-06-21T09:30:00-04:00,27.75,28.02,27.61,27.62,533600,495850,38.35492018401195,43.79136239987944,NaN,NaN,-173.36663648352604,-67.510777224702,-0.03665011979381866,-0.29914122431184254,-0.2624911045180239,5680701,6395041,16.220118222669484,22.344727113166954,NaN,NaN,-12.32854283084433,-10.478246199579415
2002-06-24T09:30:00-04:00,27.8,28.12,27.11,27.92,499800,519745,42.16053268025934,44.09699151573672,NaN,NaN,-155.8507939493354,-90.46119851549463,-0.040015652496262155,-0.31251067013835154,-0.2724950176420894,6180501,6246461,15.52839484243988,22.537885723462647,NaN,NaN,-12.865767048459482,-10.81932060656228
2002-06-25T09:30:00-04:00,28,28.3,27.45,27.45,36500,482050,38.18346677071748,43.609312187713094,NaN,NaN,-132.04552333761202,-113.18191451336797,-0.06753743349954416,-0.3569168095165196,-0.28937937601697544,6144001,6115321,14.923461505948396,22.73555669558033,NaN,NaN,-14.581835458884873,-11.356822728322651
2002-06-26T09:30:00-04:00,26.92,27.39,26.71001,27.2,1435000,552475,36.225959301062716,43.263140513254186,NaN,NaN,-211.92798027457704,-152.01682107337325,-0.09456332820346536,-0.40758353627130717,-0.3130202080678418,4709001,5785701,13.499904959406635,22.90729643018509,NaN,NaN,-16.60734418757823,-12.10689722250202
2002-06-27T09:30:00-04:00,27.39999,27.41,26.62,27.36,155500,554205,38.40244686321913,43.04615439817129,NaN,NaN,-169.20632677840527,-168.47945216469117,-0.09348089780489355,-0.42987133032395874,-0.3363904325190652,4864501,5515741,12.452238297924666,22.84555060159132,NaN,NaN,-17.626317246224204,-12.895385797319475
2002-06-28T09:30:00-04:00,27.39999,27.84,27.39999,27.47,508000,569210,39.920530605895976,42.53900184045388,NaN,NaN,-88.82702771099368,-151.5715304101847,-0.07781527788649961,-0.4336595298771897,-0.3558442519906901,5372501,5454101,12.219065280879803,22.211969351278917,NaN,NaN,-18.03127118877929,-13.629083710385164
2002-07-01T09:30:00-04:00,27.47,27.63,26.64,26.64,31000,568830,33.2597984211458,41.66259057570294,NaN,NaN,-151.30398330093814,-150.66216828050523,-0.11364166221262822,-0.49789632975647535,-0.38425466754384713,5341501,5286301,11.58318845039264,20.961647658381914,NaN,NaN,-20.526466115388473,-14.614424053957064
2002-07-02T09:30:00-04:00,26.5,26.60001,25.98,26.27,106300,538240,30.793250714380974,40.408409733026005,NaN,NaN,-194.3316962406097,-163.1194028611048,-0.15024902127500972,-0.5720659441376093,-0.42181692286259953,5235201,5104541,10.92027096923401,19.182329771802213,NaN,NaN,-23.41181224293061,-15.871193795238998
2002-07-03T09:30:00-04:00,26.05,26.7,25.82001,26.61,88800,535410,35.525014301550954,39.95168273974527,NaN,NaN,-157.381861069319,-152.21017902005318,-0.13977387269695846,-0.5965342637337976,-0.45676039103683913,5324001,5227541,14.486880611665754,17.2194040641672,NaN,NaN,-24.34545260032576,-17.08180219596568
2002-07-05T09:30:00-04:00,26.95,27.66,26.95,27.66,27300,512285,47.469807723223234,40.46074416702953,NaN,NaN,-43.32475746280946,-127.03386515693401,-0.05470833082768983,-0.5251458045714514,-0.4704374737437616,5351301,5324901,17.309123733931827,16.094861138779837,NaN,NaN,-21.036245213051615,-17.646722626977954
2002-07-08T09:30:00-04:00,27.75,27.75,27.23,27.28,13200,445710,44.273076852905106,40.133279724461254,NaN,NaN,-39.770513236180854,-117.22256226197146,-0.018484819675412767,-0.4935434983380276,-0.4750586786626148,5338101,5318021,17.26575867936903,15.404614429689648,NaN,NaN,-19.441129524644044,-17.90306646950168
2002-07-09T09:30:00-04:00,27.3,27.42999,26.61,26.66,31700,416815,39.58869235076561,39.53527075033872,NaN,NaN,-87.02301667308512,-104.36636893640085,-0.030047552133392164,-0.512618118829355,-0.4825705666959629,5306401,5311001,17.218357418871733,14.985700262900567,NaN,NaN,-19.70753456504283,-18.16084762600756
2002-07-10T09:30:00-04:00,26.67,26.82001,25.72,25.78999,73200,392065,34.1313246920662,38.63539249012633,NaN,NaN,-152.34720238752527,-95.96947016578395,-0.08684220845269064,-0.5911233272618261,-0.5042811188091355,5233201,5310601,17.21545720284813,14.8313709159074,NaN,NaN,-21.903658204329858,-18.695534851482172
2002-07-11T09:30:00-04:00,25.7,25.82001,25.02,25.77,110900,392285,34.015297558436345,38.02172278711722,NaN,NaN,-182.1799284631805,-100.92908364455624,-0.11456586706957816,-0.6474884526461082,-0.53292258557653,5122301,5270261,16.906182241628073,14.839171601229298,NaN,NaN,-23.605277967066023,-19.396926725137007
2002-07-12T09:30:00-04:00,25.55,25.73,25.13,25.44,511900,395030,32.07672412285417,37.57328021132024,NaN,NaN,-162.28236081844736,-124.72060431568381,-0.14213806270430673,-0.7105951639569135,-0.5684571012526067,4610401,5122081,15.784438350187926,14.808051610337758,NaN,NaN,-25.622201467159595,-20.28625168828309
2002-07-15T09:30:00-04:00,24.8,25.05,24.2,25.05,125400,281155,29.90741142411639,36.698057264452885,NaN,NaN,-183.59966776759617,-153.48643522196687,-0.17167504265266442,-0.7830509045684373,-0.6113758619157729,4485001,4951461,14.584485170696311,14.740629490927502,NaN,NaN,-27.993486556446044,-21.387285240877798
2002-07-16T09:30:00-04:00,25.14999,25.14999,24.35001,24.37,132500,256485,26.537481686100946,35.86620118698028,NaN,NaN,-164.53568856744738,-168.9889696008393,-0.21901097440679274,-0.8851395799242638,-0.6661286055174711,4352501,4760681,13.361353498787878,14.629050347558893,NaN,NaN,-31.167105214350034,-22.78440237994526
2002-07-17T09:30:00-04:00,25,25.07001,23.82001,24.24001,49800,252790,25.935853357762582,35.131193619601696,NaN,NaN,-153.37294458677295,-169.19411804068886,-0.2394219929799165,-0.9654060967423668,-0.7259841037624503,4302701,4574581,12.27951705491924,14.541879782952652,NaN,NaN,-33.879161855571716,-24.36936801932047
2002-07-18T09:30:00-04:00,24.3,24.42999,23.82001,23.84,24000,231860,24.123454975535594,34.1112656276243,NaN,NaN,-151.8798189966485,-163.13409614738245,-0.25857337270418224,-1.049200819642678,-0.7906274469384958,4278701,4405861,11.379906151068113,14.465284629605756,NaN,NaN,-36.73040251602557,-26.13523009027834
2002-07-19T09:30:00-04:00,23.3,23.5,22.67999,22.67999,64700,227955,19.80193665317023,32.67422320242961,NaN,NaN,-183.20533457958598,-167.3186908996102,-0.32384337171096,-1.1954316615771958,-0.8715882898662358,4214001,4326581,10.973102702222207,14.376287302558781,NaN,NaN,-40.879592462970855,-28.241567572091558
2002-07-22T09:30:00-04:00,22.89999,23.09,21.89999,22.31,123100,207430,18.654090042870322,31.63095831826708,NaN,NaN,-174.65942897851303,-165.53064314179355,-0.36344273129624804,-1.3258917039865459,-0.9624489726902978,4090901,4247761,10.568600491627478,14.303816734075554,NaN,NaN,-44.610367827483635,-30.57996760857614
2002-07-23T09:30:00-04:00,22.35001,22.69,21.88,21.95,124600,188670,17.58592443709358,30.687577869889406,NaN,NaN,-158.6898041723484,-164.36146626277377,-0.38341046958771186,-1.4417120596749378,-1.058301590087226,3966301,4170521,10.17284723606997,14.250429324563838,NaN,NaN,-47.9984633383272,-33.06832414139772
2002-07-24T09:30:00-04:00,21.2,23.24001,21.2,23.24001,100500,191870,32.50132801551371,30.4716002780296,NaN,NaN,-123.70236016001626,-158.42734937742244,-0.28385309265161385,-1.4131179559017433,-1.1292648632501294,4066801,4123341,9.928289282003647,13.924815658159401,NaN,NaN,-45.785426549656435,-34.88505305686325
2002-07-25T09:30:00-04:00,23.14999,23.39,22.03,22.86,52800,122760,30.73660655510126,29.276371623163747,NaN,NaN,-101.01684977533414,-148.25475553315954,-0.22052846759995548,-1.4049254477500739,-1.1843969801501184,4014001,4070401,9.648012068255767,13.377593396325398,NaN,NaN,-44.629220276917955,-36.277076945442495
2002-07-26T09:30:00-04:00,22.74001,23.21001,22.71001,23.13,102000,120085,33.49943438356924,28.506825732496896,NaN,NaN,-81.21090596618636,-127.85586981047963,-0.14124866232450062,-1.360957808055744,-1.2197091457312434,4116001,4050801,9.540626216098389,12.825798220377495,NaN,NaN,-42.80072079722048,-37.209026067125066
2002-07-29T09:30:00-04:00,23.60001,24.49001,23.55,24.39999,142500,101810,44.677637462587924,28.870321811912778,NaN,NaN,-29.45071435841109,-98.81412688645923,0.008014522329946372,-1.2096909928188104,-1.2177055151487568,4258501,4084321,11.357742251565938,12.407182851284222,NaN,NaN,-37.151808352059454,-37.20085210782998
2002-07-30T09:30:00-04:00,24.14999,24.66,23.88,24.31,65900,103555,44.11181495764947,29.58321397374015,NaN,NaN,-18.734860695688855,-70.82313819112733,0.10650829743417112,-1.0845701433560428,-1.191078440790214,4192601,4129581,13.873456587630827,12.168468521625844,NaN,NaN,-33.00296719815055,-36.60115426359006
2002-07-31T09:30:00-04:00,24.14999,24.25,23.73,24.19,84000,102440,43.323882369416125,30.248112888810134,NaN,NaN,-25.35869157118654,-51.154404473361375,0.16585966170958377,-0.9837538636532344,-1.1496135253628181,4108601,4137941,14.356948329391116,11.986380385037492,NaN,NaN,-29.960509400670134,-35.652490711744356
2002-08-01T09:30:00-04:00,24.14999,24.14999,23.42,23.45,45100,100255,38.72965087099424,30.72332194224871,NaN,NaN,-39.787803288695834,-38.908595176033714,0.15762104531726306,-0.9525872187162392,-1.1102082640335023,4063501,4147841,14.965727304178174,11.927901024608223,NaN,NaN,-28.767634563833838,-34.66893983347143
2002-08-02T09:30:00-04:00,23,23.07001,22.22,22.41,28300,100305,33.37327933497413,30.970883935881407,NaN,NaN,-92.30984075285461,-41.12838213336737,0.08794567097184514,-1.000276175318696,-1.088221846290541,4035201,4131681,14.781028950692175,11.9419398660365,NaN,NaN,-29.515204311593124,-33.932691901774525
2002-08-05T09:30:00-04:00,22.55,22.55,21.89,21.89,26900,100990,31.060222214800817,31.29393683078854,NaN,NaN,-109.20794801779641,-57.07982886524443,0.01640016443696224,-1.0677216407443382,-1.0841218051813004,4008301,4081641,14.196757083259087,12.001611550641586,NaN,NaN,-30.897909916866027,-33.49915161821617
2002-08-06T09:30:00-04:00,22.25,22.96001,22.25,22.53999,41500,101480,36.943326479487396,32.08018491091174,NaN,NaN,-73.13854663165901,-67.96056605243845,0.02206167814996962,-1.0565447074938383,-1.078606385643808,4049801,4053081,13.860013335071173,12.114504142081012,NaN,NaN,-30.103794646950377,-33.01410062232105
2002-08-07T09:30:00-04:00,23.05,23.05,22.39999,22.86,319800,113810,39.67287520533672,33.19085778446897,NaN,NaN,-54.22248389854213,-73.73332451790958,0.05470943476809875,-1.0102195921836845,-1.0649290269517833,4369601,4105281,17.702344866677905,12.566106907481709,NaN,NaN,-28.5900077830124,-32.382087359562675
2002-08-08T09:30:00-04:00,22.8,23.16,22.31,23.16,115000,114015,42.198903776630324,34.7906411504304,NaN,NaN,-40.828861105839465,-73.9415360813383,0.10115851095755701,-0.938480888254837,-1.039639399212394,4484601,4189501,23.621890294757293,13.469591735519929,NaN,NaN,-26.571796239475486,-31.55204577097879
2002-08-09T09:30:00-04:00,22.75,23.27,22.75,23.25,37100,90275,42.97039665293299,36.52752019400631,NaN,NaN,-17.724326398483452,-59.02443321046407,0.14019077944058433,-0.8644009249116635,-1.0045917043522479,4521701,4286801,29.895653573448868,14.850095527078599,NaN,NaN,-24.71823128106561,-30.575786558134048
2002-08-12T09:30:00-04:00,22.60001,22.94,22.60001,22.92,47100,86360,40.81902902781807,38.187027664772344,NaN,NaN,-36.65231077771973,-44.51330576244875,0.14540525858157083,-0.8228351311252844,-0.9682403897068552,4474601,4380061,35.374979917687696,16.650247861479865,NaN,NaN,-23.771411885635775,-29.603733033491437
2002-08-13T09:30:00-04:00,22.8,23.39999,22.66,22.66,238300,91650,39.15567728279659,38.66233832672111,NaN,NaN,-22.85927975117824,-34.45745238635259,0.13328587937979974,-0.8016330404821055,-0.9349189198619052,4236301,4417361,37.4797329838748,18.618208125899233,NaN,NaN,-23.445791289339763,-28.7240270700412
2002-08-14T09:30:00-04:00,22.66,23.89999,22.63,23.89999,238400,101080,49.685962123278806,40.01586372444808,NaN,NaN,51.80320318322257,-13.25231496999965,0.20635936353529716,-0.6769697154427838,-0.883329078978081,4474701,4438381,38.691528966815376,20.692745047224918,NaN,NaN,-19.800868824750996,-27.449290177856884
2002-08-15T09:30:00-04:00,24.25,24.88,24.16,24.88,66000,103180,56.145886083511336,41.633467417301084,NaN,NaN,180.47879060275991,31.009215371720217,0.3119378002244433,-0.49340682869752683,-0.8053446289219701,4540701,4449601,39.367085898419845,22.823206453105023,NaN,NaN,-14.42096276031371,-25.588100546779287
2002-08-16T09:30:00-04:00,24.7,24.92999,24.33,24.85001,35900,101740,55.90931967146546,42.435730432220915,NaN,NaN,151.26072984048375,64.80622661951365,0.36718830552368176,-0.346359247017368,-0.7135475525410497,4504801,4446221,39.22685829158379,24.813857598820587,NaN,NaN,-10.292137160389188,-23.40296292015213
2002-08-19T09:30:00-04:00,24.7,25.42999,24.7,25.42999,29400,97055,59.46623346691431,43.53247461145411,NaN,NaN,163.59894210713105,104.85647719648382,0.4260878796328784,-0.1809377029999517,-0.6070255826328301,4534201,4458141,40.03804398848151,26.68275669888135,NaN,NaN,-5.65394923647427,-20.86738953676958
2002-08-20T09:30:00-04:00,25.24001,25.46001,25.02,25.25,30400,92345,57.905018216339755,44.5739843148058,NaN,NaN,144.79880244975453,138.38809363667036,0.43471635593830127,-0.06363013770995352,-0.4983464936482548,4503801,4511641,43.672121615591756,28.776697647895677,NaN,NaN,-2.347510421269332,-18.221692520269546
2002-08-21T09:30:00-04:00,25.7,25.8,25.25,25.67,161900,95415,60.51033985389852,46.12974781358468,NaN,NaN,146.1830170812129,157.26405641626843,0.44868271667221393,0.0625069021920126,-0.38617581448020133,4665701,4549841,46.18027530437815,31.006308219338536,NaN,NaN,1.2374336867932891,-15.441817347831998
2002-08-22T09:30:00-04:00,25.7,26.08,25.55,26.06,38700,94710,62.81196329186473,48.23251095336258,NaN,NaN,145.39168282966475,150.2466348616494,0.46232545166089745,0.19173100009592048,-0.27059445156497697,4704401,4582581,48.30489013737762,33.40086973267321,NaN,NaN,4.959282232473013,-12.527374550645568
2002-08-23T09:30:00-04:00,25.7,25.7,25.2,25.34,34100,91315,56.289241644109694,50.034583769741786,NaN,NaN,99.49022655586603,139.89253420472588,0.40315882952972293,0.23335408534717672,-0.1698047441825462,4670301,4615681,50.43521561165611,35.98933105613014,NaN,NaN,6.258492399076235,-9.843679272113881
2002-08-26T09:30:00-04:00,25.3,25.49001,24.87,25.49001,45400,86460,57.284519119437675,51.4875261011668,NaN,NaN,82.57071572466717,123.68688892823309,0.3560614501826538,0.275272068545771,-0.08078938163688276,4715701,4651981,52.73556742221725,38.766156348069146,NaN,NaN,7.608444062647318,-7.350518795719424
2002-08-27T09:30:00-04:00,25.55,25.55,24.94,24.97,65600,86445,52.79666727891202,52.4249398207079,NaN,NaN,68.96102411430711,108.5193332611436,0.27542711366277184,0.263494510441582,-0.011932603221189803,4650101,4681241,54.566002661574935,41.399274761990355,NaN,NaN,7.43917050660016,-5.237706038245198
2002-08-28T09:30:00-04:00,24.8,24.89999,24.60001,24.67999,54700,84980,50.42406441947083,53.012451295196506,NaN,NaN,40.20899855312023,87.32452955552506,0.19204975584094625,0.22812959157999302,0.036079835739046766,4595401,4667181,53.49393995679403,43.53299259499299,NaN,NaN,6.599231397058829,-3.546714976058909
2002-08-29T09:30:00-04:00,24.5,24.95,24.37,24.91,82800,86865,52.25659145166522,53.67575092367738,NaN,NaN,37.67437459444011,65.78106790848013,0.14407264557701616,0.21617064271031694,0.0720979971333008,4678201,4661941,53.07541429616467,45.18868978947268,NaN,NaN,6.411374290764655,-2.124130795084114
2002-08-30T09:30:00-04:00,24.7,25.16,24.7,24.92,49700,87935,52.339077382845005,54.49861152046502,NaN,NaN,43.60325027661377,54.60367265262967,0.10642986914536781,0.20513533356501057,0.09870546441964276,4727901,4673461,53.92881454926889,46.513963691728485,NaN,NaN,6.279372778766823,-0.9236302845339803
2002-09-03T09:30:00-04:00,24.42,24.60001,23.97,24.03,58300,89505,44.90340238163311,54.909163313239056,NaN,NaN,-7.557396343345116,36.57805023902722,0.019559276856533553,0.1231545604903097,0.10359528363377615,4669601,4664241,53.09651159740151,47.62944787840896,NaN,NaN,3.9427350298798145,-0.22843523961772394
2002-09-04T09:30:00-04:00,23.95,24.52,23.89999,24.48,73400,91100,48.85949575077073,54.85013000091705,NaN,NaN,-7.367748283980446,21.312295759369704,-0.008141366748401269,0.09341857519827457,0.10155994194667584,4743001,4682821,54.6165600929288,48.76695010170278,NaN,NaN,3.093546491491113,0.24613357911210992
2002-09-05T09:30:00-04:00,23.8,24.3,23.67,24.03,47400,77480,45.35255675585702,54.0791779060846,NaN,NaN,-38.19526624093475,5.631442800558713,-0.054720660933995635,0.03315911577918129,0.08787977671317693,4695601,4702861,56.26297112690655,49.97379904659469,NaN,NaN,1.3077149616511754,0.3977880623319764
2002-09-06T09:30:00-04:00,24.58,25,24.52,24.78,112200,77340,51.58925115805338,53.77060158369802,NaN,NaN,20.183000948098456,2.1331680712903767,-0.033985047957151335,0.045398466766737755,0.07938351472388909,4807801,4728781,58.3667640431276,51.34093517170496,NaN,NaN,1.6510624557191829,0.5768272613872916
2002-09-09T09:30:00-04:00,24.55,25.14999,24.49001,25.11,11900,76080,54.072904383074544,53.38536379199518,NaN,NaN,29.51066491953855,-0.6853490001246684,0.0011292896217676707,0.08079512675109868,0.07966583712933101,4819701,4747141,59.84031897000882,52.7553833846712,NaN,NaN,2.6948300038935913,0.8793990817453343
2002-09-10T09:30:00-04:00,25.05,25.48,25.05,25.42,106800,79065,56.3389853304992,53.27350430014943,NaN,NaN,69.94251764116758,14.814633796777873,0.042136254463669726,0.13233615520891817,0.09019990074524845,4926501,4798521,63.711160140625545,54.186743279316474,NaN,NaN,4.2464307567424,1.360403606744915
2002-09-11T09:30:00-04:00,25.89999,25.89999,25.39999,25.42999,37400,69020,56.41362087530728,52.980881515964334,NaN,NaN,98.54848431552468,35.997880316678895,0.06544497668789322,0.17200612160511497,0.10656114491722175,4963901,4842701,66.6847085220257,55.65134565200558,NaN,NaN,5.5205954884354185,1.9547167327007011
2002-09-12T09:30:00-04:00,25.17,25.17,24.72,24.8,23200,58260,50.545643098177386,52.104715787843816,NaN,NaN,-13.127897836140765,41.0113539976377,0.03544771074640257,0.15087078335022497,0.1154230726038224,4940701,4891721,69.6557618172968,57.176407914856945,NaN,NaN,4.926619412877968,2.3792742584403106
2002-09-13T09:30:00-04:00,24.64999,25.16,24.50999,25.05,88100,59365,52.65044590658774,51.84480180659225,NaN,NaN,-14.137148902055927,34.147324027606814,0.029689903859809116,0.1525354524285838,0.12284554856877468,5028801,4935921,72.07405191297661,58.722039079236986,NaN,NaN,5.035097574292473,2.7586775892763336
2002-09-16T09:30:00-04:00,25.10001,25.28,24.94,25.12,113300,63235,53.25041288805666,51.5566513614936,NaN,NaN,19.22857142857408,32.09090532941393,0.027871905280063586,0.15768543016885417,0.12981352488879058,5142101,5000401,75.18144435323805,60.32531600288132,NaN,NaN,5.290517101629559,3.120368948183937
2002-09-17T09:30:00-04:00,25.55,25.55,24.55,24.84,65000,65015,50.4942910613043,51.392195917378764,NaN,NaN,-3.086355452725189,17.48513071063537,0.006218896663706647,0.1375871457184239,0.13136824905471725,5077101,5030521,76.49704841759717,61.89181927116863,NaN,NaN,4.745210386423033,3.352489153646665
2002-09-18T09:30:00-04:00,24.5,24.87,24.3,24.87,63200,66655,50.788186406730524,51.41820463075446,NaN,NaN,-53.57214730026019,-12.938995612521598,-0.006961923824002819,0.12266584427471372,0.12962776809871654,5140301,5065801,77.9701049791219,63.64011677276348,NaN,NaN,4.369557292311129,3.497784602027303
2002-09-19T09:30:00-04:00,24.55,24.7,23.98,24,421800,79650,42.84460657729931,50.74591999687118,NaN,NaN,-125.93935870678318,-35.50128778665008,-0.07156161033924649,0.040175755174658434,0.11173736551390492,4718501,5021361,71.86044454161953,64.98190464743882,NaN,NaN,1.6577116224230894,3.2349170335124153
2002-09-20T09:30:00-04:00,24.10001,24.33,24,24.33,20500,78740,46.27697121783993,50.312912413656534,NaN,NaN,-114.0166124952069,-55.47718050528027,-0.08825892365194206,0.0014137109489773536,0.08967263460091941,4739001,4963401,64.73566281883407,65.75382238097919,NaN,NaN,0.3416161421236312,2.821588334742589
2002-09-23T09:30:00-04:00,24,24,23.39999,23.57001,44400,79255,40.27792856851781,49.982521427005445,NaN,NaN,-186.93727483369594,-96.71034975773429,-0.1434161121542785,-0.0895975055919287,0.05381860656234979,4694601,4873901,55.572943075211974,65.93071034367993,NaN,NaN,-2.739831970141402,2.027099719759162
2002-09-24T09:30:00-04:00,23.14999,23.39,23.06,23.2,121600,83065,37.71453081797529,49.18645250323434,NaN,NaN,-205.92439000767592,-137.27795666872444,-0.19457328750434716,-0.18939800281808417,0.005175284686262993,4573001,4773081,47.42902586318679,65.41731504155551,NaN,NaN,-6.129922202115086,0.8618108737771264
2002-09-25T09:30:00-04:00,23.60001,23.84,23.06,23.66,20400,80805,42.605015136348676,48.99019953041231,NaN,NaN,-136.16434453882042,-153.79639611643648,-0.18712881741298557,-0.22873573707996897,-0.041606919666983405,4593401,4663701,40.495520609452115,64.29106857602305,NaN,NaN,-7.507396695586188,-0.33379020756048994
2002-09-26T09:30:00-04:00,23.75,24.36,23.75,24.23,163900,86265,48.048362832411726,48.73727893572362,NaN,NaN,-51.632423118589806,-138.9350089987978,-0.1358977752379636,-0.2114791387144379,-0.07558136347647432,4757301,4671461,41.15278940087629,63.06149895871938,NaN,NaN,-6.968483896635195,-1.2816035917140192
2002-09-27T09:30:00-04:00,24.14999,24.3,23.5,23.52,65400,85395,42.62548699949717,47.91960626546809,NaN,NaN,-85.01230754992544,-133.13414800974152,-0.14128464502141685,-0.2521871697532454,-0.11090252473182854,4691901,4662041,40.56700186253924,61.68483345104299,NaN,NaN,-8.275675622809285,-2.2807567390133427
2002-09-30T09:30:00-04:00,22.8,22.89999,22.36,22.67,133600,89590,37.21088732543816,46.553313550820874,NaN,NaN,-189.9866502451827,-133.74402309203884,-0.19048859318330816,-0.34901326621096374,-0.15852467302765558,4558301,4634781,38.84385304887995,59.908597230204016,NaN,NaN,-11.27284541821366,-3.565340836041959
2002-10-01T09:30:00-04:00,22.64999,23.3,22.23,23.3,83500,90850,42.99112597309017,45.59456391494822,NaN,NaN,-136.47898171383062,-119.8549414332698,-0.169692580440728,-0.37064039857856557,-0.20094781813783757,4641801,4648541,40.22408902305388,58.018552980277455,NaN,NaN,-11.790341629436364,-4.7403409493840165
2002-10-02T09:30:00-04:00,23.14999,23.5,22.78,22.78,17700,88065,39.73928741342969,44.82268136603767,NaN,NaN,-112.50194710551938,-115.1224619466096,-0.17911565935378074,-0.4248423923300635,-0.24572673297628275,4624101,4654681,40.86543044089356,55.96210073910579,NaN,NaN,-13.313100737984751,-5.965020919184122
2002-10-03T09:30:00-04:00,22.75,23.07001,22.53999,22.67,40800,87735,39.066117902026946,43.852372222854754,NaN,NaN,-119.63769549422653,-128.72351642173695,-0.1804120231236886,-0.4712417618808935,-0.2908297387572049,4583301,4619881,38.35373865700632,53.55350693510792,NaN,NaN,-14.722223579159824,-7.216049870609222
2002-10-04T09:30:00-04:00,22.74001,22.81,21.89,22.38,56600,84955,37.273473200656234,42.711162245183296,NaN,NaN,-132.159974280387,-138.15304976782926,-0.18762274574443316,-0.5253581709377464,-0.33773542519331323,4526701,4586841,36.08599269582834,50.76097467386437,NaN,NaN,-16.43396964287338,-8.532895552361245
2002-10-07T09:30:00-04:00,22.45,22.45,21.42,21.50999,116700,90195,32.46101480467344,41.423071083995374,NaN,NaN,-152.0990800529688,-130.57553572938644,-0.23474972891892965,-0.6311725863419753,-0.3964228574230456,4410001,4557181,34.134801317529806,47.735099881002405,NaN,NaN,-19.530385854304043,-10.10396559549593
2002-10-08T09:30:00-04:00,21.85001,22.27,21.36,22.14999,187800,94245,38.72814303388803,40.56163941450664,NaN,NaN,-127.97062232819994,-128.8738638522603,-0.20752462391188126,-0.6558286373128972,-0.44830401340101594,4597801,4548381,33.555084686765596,44.56259843154839,NaN,NaN,-20.096546318418856,-11.531477127342063
2002-10-09T09:30:00-04:00,21.39999,21.71001,21.25,21.35001,43800,94565,34.42776426281614,39.96043639204355,NaN,NaN,-145.69517740890348,-135.51250991293713,-0.22654742441213338,-0.7314882939161826,-0.5049408695040493,4554001,4534361,32.605020637853585,41.7586395812794,NaN,NaN,-22.028971785807926,-13.031119221408614
2002-10-10T09:30:00-04:00,20.95,21.89999,20.67,21.73,92300,98020,37.95215813738304,39.36580688629663,NaN,NaN,-129.07144948197563,-137.39926071048697,-0.1977410332966325,-0.7521171611248398,-0.5543761278282073,4646301,4546961,34.4026012602659,39.59199232709595,NaN,NaN,-22.43860942671205,-14.375046393594818
2002-10-11T09:30:00-04:00,22.39999,23.10001,22.3,22.78,58900,96560,46.507870039430145,39.81080270564751,NaN,NaN,-36.11541274982809,-118.19034840437519,-0.09725714535612351,-0.6759475595233617,-0.5786904141672382,4705201,4582661,39.33944695303141,38.432456889797336,NaN,NaN,-19.84103026731209,-15.155901232697286
2002-10-14T09:30:00-04:00,22.75,23.22,22.75,22.96001,114800,96635,47.83585626582876,40.53375452335133,NaN,NaN,-11.534128162925787,-90.07735802636658,-0.012413783114529786,-0.5942076430604004,-0.5817938599458706,4820001,4664661,48.85984847952355,38.534658505249965,NaN,NaN,-17.369798754114214,-15.472172307185419
2002-10-15T09:30:00-04:00,23.89999,24.2,23.82001,24.10001,996700,143220,55.38916051029642,41.44690776434759,NaN,NaN,82.76306034273838,-47.93062149217892,0.11947138399169599,-0.4324546299562506,-0.5519260139479466,5816701,4908441,65.96281481866737,40.353750948765345,NaN,NaN,-12.548867700771101,-15.054557363411945
2002-10-16T09:30:00-04:00,24.10001,24.14999,23.5,23.67,96200,144870,52.31217092616254,41.751465485329796,NaN,NaN,68.17870891345618,-5.15584422770699,0.17346113482518732,-0.3350995954164624,-0.5085607302416497,5720501,5141741,74.68744107093077,42.74908321091209,NaN,NaN,-9.689800248181504,-14.288163489807596
2002-10-17T09:30:00-04:00,24.3,24.3,23.92999,23.92999,414300,144495,53.976886383266965,42.56227972702764,NaN,NaN,95.82889152662138,39.82422397401241,0.21943615089173407,-0.2342655416269821,-0.45370169251871617,6134801,5439441,81.28105305750776,45.65722972483842,NaN,NaN,-6.8695231459780794,-13.22835772640338
2002-10-18T09:30:00-04:00,23.64999,24.32001,23.64999,24.25999,44000,145670,56.07295929555483,43.909570582035975,NaN,NaN,99.64872438508176,66.97705140099438,0.2619453354338783,-0.12627002322636827,-0.3882153586602466,6178801,5734161,85.34969490266926,48.97907557153765,NaN,NaN,-3.9047208247962497,-11.89640959760236
2002-10-21T09:30:00-04:00,24,24.82001,23.92999,24.8,33100,145105,59.336629788330704,45.077106568838865,NaN,NaN,128.4243351127782,94.9687440561352,0.31285912339684463,0.0028585455858092246,-0.3100005778110354,6211901,6012541,88.0023327724754,52.391807267924904,NaN,NaN,-0.3714490446745535,-10.249986661469817
2002-10-22T09:30:00-04:00,24.53999,25,24.36,24.66,88700,143460,58.13078485772195,46.39078495771689,NaN,NaN,122.82104134338016,102.98034025626353,0.3222620502639276,0.0928269850188741,-0.2294350652450535,6123201,6073841,88.49627582771559,55.79401050984076,NaN,NaN,2.137733092801589,-8.480312410859616
2002-10-23T09:30:00-04:00,24.7,25.03999,24.45,24.94,116800,148280,59.88657656449633,47.8779605764647,NaN,NaN,118.53059591785994,113.05071765714429,0.33122277503511344,0.18459340354883835,-0.1466293714862751,6240001,6177741,89.30033844061455,59.433053351527064,NaN,NaN,4.7504241475438285,-6.590207188230552
2002-10-24T09:30:00-04:00,25.14999,25.3,24.62,24.63,65300,143350,57.03485661751393,49.28948796338311,NaN,NaN,113.69917950644815,116.62477525310965,0.30102925474385933,0.22965719694354902,-0.07137205780031028,6174701,6185721,89.36184053875706,63.2384710545934,NaN,NaN,6.152310417576716,-4.769847530258086
2002-10-25T09:30:00-04:00,24.63,25.16,24.62,25.13,31400,141650,60.317120949797484,51.279209830891965,NaN,NaN,110.28194821024658,118.75142001814261,0.29888360754613624,0.30223245163236,0.0033488440862237817,6206101,6191181,89.40670735942209,67.18646434329999,NaN,NaN,8.326859883547952,-2.898889328285795
2002-10-28T09:30:00-05:00,25.3,25.39999,24.7,24.73,1021700,186055,56.59242954183975,52.55523029574566,NaN,NaN,96.21284800712287,112.30912259701154,0.2563131885620224,0.3237403297887518,0.06742714122672938,5184401,5985681,76.35415761806496,70.24354098124994,NaN,NaN,9.112016282235823,-1.1830456696398497
2002-10-29T09:30:00-05:00,24.60001,24.78999,24.10001,24.7,266300,195195,56.31156736612807,54.11835908883937,NaN,NaN,63.899693222086064,100.52485297275271,0.21366526349657486,0.33450872059744796,0.1208434571008731,4918101,5744661,64.46675423807991,72.51937909555183,NaN,NaN,9.676619915772436,0.3683351282761911
2002-10-30T09:30:00-05:00,24.5,24.64999,24.16,24.27,52500,196935,52.304678148193275,55.14353908961153,NaN,NaN,49.10214555751772,86.63916290068427,0.14719038194256368,0.3048314345290777,0.157641052586514,4865601,5469781,54.11834569527955,73.92764655519566,NaN,NaN,9.045795280379004,1.607972292862307
2002-10-31T09:30:00-05:00,24.3,24.47,24.08,24.2,25500,196170,51.66024122241134,55.511565602681614,NaN,NaN,38.86218765819569,71.67176453103377,0.09190483112232833,0.2725220914894244,0.18061726036709608,4840101,5202861,46.339552068681826,74.4276540634564,NaN,NaN,8.346080088301067,2.57055912078213
2002-11-01T09:30:00-05:00,24,24.60001,23.96001,24.56,141200,200400,54.748156018060726,56.00530129926961,NaN,NaN,42.91789874825172,58.1989546386348,0.07376282170273538,0.2728207874955153,0.19905796579277993,4981301,4957901,40.5754713804142,73.83591284209145,NaN,NaN,8.566667564996639,3.4271460413842023
2002-11-04T09:30:00-05:00,24.84,25,24.45,24.45,78000,198465,53.62103413213352,55.87900655797226,NaN,NaN,57.14360808767815,50.385106654745854,0.04969027616946481,0.2611708110046109,0.21148053483514612,4903301,4901681,39.36523171264169,71.93608547737533,NaN,NaN,8.452973072340995,4.145121331520887
2002-11-05T09:30:00-05:00,24.53999,24.81,24.45,24.78,26100,190380,56.513459639219775,56.17909860890493,NaN,NaN,58.56486565237224,49.31814114080309,0.05112902599764246,0.2753918173321992,0.22426279133455673,4929401,4903941,39.44342534581151,69.41865578272396,NaN,NaN,9.12597280486927,4.856671541999227
2002-11-06T09:30:00-05:00,24.89999,25.12,24.60001,25.06,1081300,242255,58.8579876565512,56.5277486998538,NaN,NaN,80.58010643303749,55.61373331590706,0.06517492329556643,0.30573144545401476,0.24055652215844833,6010701,5132961,46.91438178504825,66.96389354897684,NaN,NaN,10.344675665999342,5.6406721311421
2002-11-07T09:30:00-05:00,24.60001,24.88,24.31,24.45,17900,238535,52.248998675636365,56.25460865557391,NaN,NaN,31.62242771392753,54.16578132705344,0.029440159608951022,0.2773567216696371,0.24791656206068607,5992801,5363501,53.17669174322966,64.66582189473117,NaN,NaN,9.57168257697888,6.202245051975925
2002-11-08T09:30:00-05:00,24.3,24.63,24.06,24.13,154500,243315,49.13225462755366,55.525724715518415,NaN,NaN,-26.27982714885917,40.326236147631256,-0.01718286018151649,0.22643798683379046,0.24362084701530695,5838301,5534901,57.21754087861126,62.466908188026586,NaN,NaN,8.007704751756565,6.460167866230303
2002-11-11T09:30:00-05:00,23.85001,24.00999,23.62,23.74001,49300,240040,45.56493442971204,54.62816397066056,NaN,NaN,-143.08040220528213,0.28143408903919037,-0.0726138072955104,0.15285358789591896,0.22546739519142936,5789001,5712041,60.96671924811598,60.50051128948375,NaN,NaN,5.602537132883708,6.337649190037932
2002-11-12T09:30:00-05:00,23.8,24.28,23.73,24.10001,27600,191585,49.22948469601463,53.86694312291187,NaN,NaN,-89.79796152800488,-29.39113134703623,-0.08263149953326904,0.12217802077484308,0.20480952030811211,5816601,5889481,64.33800500145185,58.7174874724007,NaN,NaN,4.584854918402971,6.087250008375794
2002-11-13T09:30:00-05:00,24.05,24.3,23.69,24.17,19100,187730,49.93514080884405,53.35982056514973,NaN,NaN,-93.8987570236512,-64.28690403837398,-0.08197932621669249,0.10233536253724651,0.184314688753939,5835701,5854481,63.17887119831193,56.84727537665462,NaN,NaN,3.942362943169674,5.780837570489206
2002-11-14T09:30:00-05:00,24.5,24.85001,24.45,24.85001,41100,169070,56.29153830291307,53.07227894751513,NaN,NaN,51.64191391350305,-60.28300679845887,-0.035556777134009926,0.13986871733642658,0.1754254944704365,5876801,5831281,62.376652702982824,54.91655718690895,NaN,NaN,5.2455255438698885,5.704364423829303
2002-11-15T09:30:00-05:00,24.72,25.11,24.67999,25.05,154500,174595,57.98119850156398,53.17147673035258,NaN,NaN,98.95884597534167,-35.2352721736187,0.006567496128526973,0.18363486463109524,0.17706736850256827,6031301,5869881,63.21358867413684,53.97794511948552,NaN,NaN,6.827996513607124,5.864883293797563
2002-11-18T09:30:00-05:00,25.12,25.12,24.55,24.64,10200,173450,53.4217508933035,52.96506126800796,NaN,NaN,50.85417871227607,3.551644009892945,0.004846363962674488,0.18312532345591137,0.17827895949323688,6021101,5916301,64.24371320504414,53.96201361712583,NaN,NaN,6.857825058506763,6.006732117327449
2002-11-19T09:30:00-05:00,24.48,24.48,24.05,24.13,17000,169865,48.33057601065915,52.68119682961267,NaN,NaN,-71.70603510310792,7.170029294872336,-0.030658806532422977,0.13995545132770815,0.17061425786013112,6004101,5953801,65.0940913106966,54.745995446798474,NaN,NaN,5.328917716910754,5.909901488696493
2002-11-20T09:30:00-05:00,24.14999,24.46001,24,24.36,19200,164985,50.61631046344796,52.60663034682957,NaN,NaN,-53.12227759421135,15.325325180760307,-0.03818296919304562,0.1228855463688241,0.1610685155618697,6023301,5991321,65.96623080301589,56.14790107067948,NaN,NaN,4.732717793785626,5.741732389423512
2002-11-21T09:30:00-05:00,24.64999,25,24.55,25,63000,164870,56.396596918221,52.72437612541245,NaN,NaN,77.88564411439539,20.57407122093877,-0.0015224803098027873,0.15916541517461624,0.16068789548441903,6086301,6033221,66.95906163129236,58.03244323145649,NaN,NaN,6.003563385677988,5.779136817459865
2002-11-22T09:30:00-05:00,24.89999,25.28,24.8,25.07001,846000,205600,56.98966350280717,52.964992509031994,NaN,NaN,120.9305474550631,24.96841151688306,0.024538328597500436,0.1913608062312946,0.16682247763379415,6932301,6213421,70.89188732896942,60.28434720405132,NaN,NaN,7.203790634113559,5.982658791267536
2002-11-25T09:30:00-05:00,24.99001,25.28,24.89999,25.23,35600,156295,58.38273699561649,53.09851232020319,NaN,NaN,134.2773878892086,41.653053352269566,0.04827569835529136,0.22716710057790834,0.17889140222261699,6967901,6402781,74.34732544281336,62.777482925265744,NaN,NaN,8.605229178557755,6.357311703737567
2002-11-26T09:30:00-05:00,24.95,25.08,24.52,24.53999,276600,156810,50.7484084698771,52.519256664012175,NaN,NaN,38.923474920210694,63.77895535693328,0.01495738499307972,0.19758813346396664,0.18263074847088692,6691301,6540221,76.52551067876715,64.89256356053137,NaN,NaN,7.540712564403868,6.526368969547039
2002-11-27T09:30:00-05:00,24.84,25.60001,24.84,25.56,49400,156655,59.234583837903116,53.018227032745514,NaN,NaN,148.35265663304085,104.07394220238373,0.05671966642138224,0.2535303314976147,0.1968106650762325,6740701,6683701,78.57112792119997,66.70645185895783,NaN,NaN,9.416670402967284,6.9392691743213595
2002-11-29T09:30:00-05:00,25.60001,25.64,25.32001,25.32001,26700,156715,56.75669274948322,53.56282975574049,NaN,NaN,148.7250501672756,118.24182341295977,0.06281223030693395,0.2753259529598999,0.21251372265296598,6714001,6809241,80.19716702915672,68.34785372685393,NaN,NaN,10.114403430934061,7.392859782408888
2002-12-02T09:30:00-05:00,26.05,26.28,25.3,25.5,887700,194040,58.16999390687754,54.463191146966594,NaN,NaN,172.52720893949345,128.56115570984585,0.07288730467925458,0.3036228535020342,0.23073554882277963,7601701,6943121,81.78457731642311,69.83484358887587,NaN,NaN,11.117985330373134,7.925020574975209
2002-12-03T09:30:00-05:00,25.25,25.25,24.60001,24.7,255100,202895,50.30100757346641,54.539728495355995,NaN,NaN,23.539269590734083,106.41353205015093,0.02222359014814307,0.2585150365079585,0.23629144635981542,7346601,7018861,82.63275543928685,71.14161147729266,NaN,NaN,9.415466291693992,8.13794139164932
2002-12-04T09:30:00-05:00,24.37,24.84,24.22,24.7,78800,205530,50.30100757346641,54.565861835686164,NaN,NaN,-21.04021253948058,94.42079455821269,-0.012850665931404881,0.2202281139455593,0.23307877987696418,7346601,7149921,84.01941553586371,72.63022178711778,NaN,NaN,8.085273955736367,8.130417472233184
2002-12-05T09:30:00-05:00,24.38,24.66,24.31,24.53,15800,152255,48.67814373709615,54.02204793812781,NaN,NaN,-32.07053573204726,58.33615608519507,-0.04713481459228777,0.17416026163660447,0.22129507622889225,7330801,7267941,85.16786747537981,74.25816569943186,NaN,NaN,6.5077025689495205,7.898601057478374
2002-12-06T09:30:00-05:00,24.05,24.53,24.05,24.5,38300,153275,48.38149554641632,53.33635486990298,NaN,NaN,-52.933014972942864,18.00454305715137,-0.07008460479407658,0.13368932023629654,0.20377392503037312,7292501,7383641,86.21385261785753,75.9010416954119,NaN,NaN,5.139912542553724,7.504502698203424
2002-12-09T09:30:00-05:00,24.2,24.2,23.69,23.7,131200,152110,41.1754152316285,52.46161660835476,NaN,NaN,-124.9329870617387,-41.487496143095065,-0.1337070369202315,0.03664012888008372,0.17034716580031523,7161301,7295561,81.50172186377058,77.13375659960664,NaN,NaN,1.633197990338389,6.665744882794134
2002-12-10T09:30:00-05:00,23.85001,24.13,23.56,24.13,50300,152160,45.84443836176439,52.28403534771942,NaN,NaN,-116.32760661005746,-69.46087138325338,-0.14068662814240152,-0.0055111193776866685,0.13517550876471485,7211601,7268561,80.05724018978313,78.20255294811282,NaN,NaN,0.06879435341895876,5.72332337859768
2002-12-11T09:30:00-05:00,23.8,24.14,23.8,24.10001,48500,153205,45.57275370035118,51.923781293212514,NaN,NaN,-104.06889539962866,-86.06660795528299,-0.14083253623101993,-0.040865161524060056,0.09996737470695986,7163101,7231861,78.0327796628527,79.06444929524403,NaN,NaN,-1.2663104577389017,4.724804259121026
2002-12-12T09:30:00-05:00,24.05,24.17,23.83,23.95,32100,153855,44.162930113277504,51.04994795000226,NaN,NaN,-107.31253947548306,-101.11500870397015,-0.1440259855526959,-0.08006510723391003,0.06396087831878589,7131001,7191901,75.78559148290627,79.69491571321646,NaN,NaN,-2.7817382193894824,3.652441047905239
2002-12-13T09:30:00-05:00,23.7,23.88,23.45,23.52,56700,154635,40.31312379405497,49.85876654223425,NaN,NaN,-140.17950897072657,-118.56430750352688,-0.16650221212596922,-0.14416688683867562,0.02233532528729358,7074301,7148261,73.30287394457339,79.86712904290245,NaN,NaN,-5.246134270760502,2.381216002381562
2002-12-16T09:30:00-05:00,23.55,24.10001,23.45,24.10001,627700,178295,47.02170508376763,49.047264262816476,NaN,NaN,-91.53782879096649,-111.88527584937245,-0.13505029812004604,-0.14647754736276397,-0.011427249242717936,7702001,7256401,75.44918602497874,79.94583337019996,NaN,NaN,-5.41059989433786,1.2680994457073587
2002-12-17T09:30:00-05:00,23.85001,23.97,23.67999,23.75,44300,180000,43.82087557639526,48.55244048471064,NaN,NaN,-92.1499753857759,-107.04974960451614,-0.13048992842121865,-0.17453965976924124,-0.0440497313480226,7657701,7345621,77.08596651007464,79.98586592957908,NaN,NaN,-6.5236669946601396,0.15498995422628759
2002-12-18T09:30:00-05:00,23.55,23.55,23.23,23.45,35600,180930,41.23024453619641,47.26641624887443,NaN,NaN,-127.81663130241371,-111.79929678507315,-0.13953478552376647,-0.2184682132527307,-0.07893342772896422,7622101,7437421,78.66226346608983,79.99237561135693,NaN,NaN,-8.244478525269413,-1.0449341142730981
2002-12-19T09:30:00-05:00,23.24001,23.69,23.13,23.24001,864700,223205,39.471238577717585,46.03174095089118,NaN,NaN,-119.14193006992865,-114.16517490396227,-0.15057073293171624,-0.26714684389360954,-0.1165761109618933,6757401,7362701,74.18870469411183,79.5631997302823,NaN,NaN,-10.199708224628576,-2.3527589871810237
2002-12-20T09:30:00-05:00,23.39999,23.50999,23.27,23.48,313500,235730,42.49095903270492,44.91180988845027,NaN,NaN,-99.91057504656435,-106.11138811912981,-0.13321628104774627,-0.28309646227157614,-0.14988018122382987,7070901,7362021,74.14737718458633,79.0176854351511,NaN,NaN,-10.972471937728043,-3.584146551544883
2002-12-23T09:30:00-05:00,23.35001,23.42999,23.09,23.14999,423300,214595,39.567718193949005,44.14514636134188,NaN,NaN,-109.17236851284929,-109.63829606350639,-0.13504946747034577,-0.3186920155617621,-0.1836425480914163,6647601,7151141,62.51661751102027,77.58081844027492,NaN,NaN,-12.493994783645643,-4.856982013273563
2002-12-24T09:30:00-05:00,23,23.14,22.96001,23.03,123400,218985,38.52978992234149,43.30434510054725,NaN,NaN,-117.96418886942979,-114.80113876023715,-0.13510220438665518,-0.3525203035747353,-0.2174180991880801,6524201,6924441,52.90849546299767,75.35860986364163,NaN,NaN,-14.052138674886782,-6.170575822075452
2002-12-26T09:30:00-05:00,23.25,23.5,23.17999,23.28999,120000,211155,42.07535907335152,42.83271762456549,NaN,NaN,-81.72756674323995,-105.58332584840241,-0.10947886433956755,-0.35426667961253955,-0.244787815272972,6644201,6728861,46.29761555174708,72.58216329766786,NaN,NaN,-14.387749211233455,-7.344457734812309
2002-12-27T09:30:00-05:00,23.05,23.08,22.64999,22.75,35000,210435,37.26736713189239,42.038851309242354,NaN,NaN,-130.53963201772058,-107.86286623796079,-0.11990880472965226,-0.39467382118503735,-0.2747650164553851,6609201,6699221,45.372355893526446,69.66491353164422,NaN,NaN,-16.12243792829994,-8.598454905310541
2002-12-30T09:30:00-05:00,22.84,23.07001,22.56,22.97,1010600,259630,40.26242446118025,41.973637682781764,NaN,NaN,-118.77182056186714,-111.63511534102136,-0.10361540537391384,-0.4042842731727774,-0.30066886779886354,7619801,6809001,49.40545081812662,67.37232274266964,NaN,NaN,-16.698706573153526,-9.755633715002396
2002-12-31T09:30:00-05:00,22.97,23.2,22.75999,23.11,59900,218240,42.155060198535175,41.710110671122536,NaN,NaN,-92.48815273934957,-108.2982721863214,-0.0762957139377351,-0.3960385102210324,-0.3197427962832973,7679701,7015421,55.98557692412013,65.65291822369372,NaN,NaN,-16.636007927422575,-10.738544316776707
2003-01-02T09:30:00-05:00,23.33,23.98,23.25,23.98,81100,209540,52.27429544671833,42.188792224434465,NaN,NaN,15.264813763417866,-81.65247165975187,0.003263688342949378,-0.3156631858546106,-0.31892687419756,7760801,7262741,62.3103473808976,64.5298873464112,NaN,NaN,-13.323285208037463,-11.107793015528244
2003-01-03T09:30:00-05:00,23.82001,23.82001,23.32001,23.42999,227300,216965,46.71093846450744,42.37079282095089,NaN,NaN,-10.787510945382552,-67.46446050018041,0.020766134592729246,-0.29296920595664844,-0.3137353405493777,7533501,7440601,66.08475223737352,63.836970257444584,NaN,NaN,-12.26456471663212,-11.273046115685942
2003-01-06T09:30:00-05:00,23.60001,23.92,23.57001,23.86,273400,229845,51.093314350050306,43.14080643209342,NaN,NaN,44.72140271367914,-32.412253553900456,0.06095023256482024,-0.23754754984335236,-0.2984977824081726,7806901,7680141,70.38611588924974,63.62863039635004,NaN,NaN,-9.930374724833028,-11.081235916992668
2003-01-07T09:30:00-05:00,23.85001,24,23.73,23.73,31000,229480,49.76098976008009,43.336469623258594,NaN,NaN,61.674362133604625,3.676982985193901,0.07736678577955686,-0.20178930018372654,-0.2791560859632834,7775901,7711361,70.90406023058138,63.30397855389309,NaN,NaN,-8.476503833786376,-10.709131333677483
2003-01-08T09:30:00-05:00,23.60001,23.91,23.49001,23.50999,53100,225575,47.503353410845904,43.59950375429078,NaN,NaN,26.84935654374817,27.544484841813443,0.07210515707294884,-0.18902463962209737,-0.2611297966950462,7722801,7719981,71.0545914067765,62.873166046514655,NaN,NaN,-7.958659095004155,-10.316206728152721
2003-01-09T09:30:00-05:00,23.7,24.28,23.7,24.16,49400,225530,54.12549777292938,44.520593271200276,NaN,NaN,111.8138742030644,46.85429692974275,0.10889018882174772,-0.12501706066786156,-0.23390724948960928,7772201,7722261,71.09718521492749,62.33280331428877,NaN,NaN,-5.364628405198238,-9.608838396302081
2003-01-10T09:30:00-05:00,24.05,24.45,24,24.22,27700,224490,54.69362072353076,45.607906281615506,NaN,NaN,142.43786247776194,77.49937161437165,0.13219967802055627,-0.06865765196391393,-0.2008573299844702,7799901,7775541,72.12930164021361,62.18570309615318,NaN,NaN,-3.1239444044849605,-8.682424968899635
2003-01-13T09:30:00-05:00,24.39999,24.62,24.16,24.34,47400,225255,55.87071840820817,46.56360337986574,NaN,NaN,159.5878066574827,100.47265240313236,0.14936878629437528,-0.01414634711650109,-0.16351513341087637,7847301,7783621,72.29090216387414,62.053097737530884,NaN,NaN,-0.9376337694530531,-7.576026226121552
2003-01-14T09:30:00-05:00,24.35001,24.39,24.16,24.37,46000,224720,56.177251561636545,47.74999862041484,NaN,NaN,127.33630100270587,113.60504017695261,0.15570515831528337,0.031116314483227825,-0.12458884383205553,7893301,7807101,72.78473380672587,62.786534615795574,NaN,NaN,0.9380512354880176,-6.359729445891614
2003-01-15T09:30:00-05:00,24.2,24.28,23.98,24.08,11100,193890,52.38889164639427,48.73993445784719,NaN,NaN,88.6995743475079,125.97508373770457,0.1341430820527773,0.04309000873391611,-0.0910530733188612,7882201,7838981,73.47593040272407,64.25563711149032,NaN,NaN,1.5176673633799673,-5.234387044567103
2003-01-16T09:30:00-05:00,24.05,24.24001,23.82001,23.99001,97600,196555,51.23428939703693,49.394143766681864,NaN,NaN,68.49155431376903,117.31061975984548,0.10868355027813012,0.04480136452880146,-0.06388218574932866,7784601,7841461,73.53224541132673,66.20096781574601,NaN,NaN,1.688981082273275,-4.245334455018478
2003-01-17T09:30:00-05:00,23.8,23.95,23.62,23.75,182100,203880,48.184166700768294,50.17391516445871,NaN,NaN,25.33044894359302,93.8891370530117,0.07229416189880762,0.02648551662418086,-0.04580864527462676,7602501,7801981,70.94971870983976,68.02792230262553,NaN,NaN,0.9997037220908913,-3.4960432868599964
2003-01-21T09:30:00-05:00,23.72,23.72,23.05,23.08,27400,162015,40.86962107654176,50.21728635127025,NaN,NaN,-55.38765569334763,50.89404458284564,0.0033560127321103153,-0.04161362935948887,-0.044969642091599184,7575101,7747541,67.4327883666686,69.31558927037852,NaN,NaN,-1.8716402646008081,-3.2639857122515408
2003-01-22T09:30:00-05:00,23.10001,23.2,22.73,22.75,80500,150365,37.82401034125138,49.90792564717855,NaN,NaN,-107.7971074758366,3.8673628871371393,-0.06067886076148336,-0.12081821804345338,-0.06013935728197003,7494601,7667801,62.54253493290967,69.7839434138635,NaN,NaN,-5.270256371771255,-3.550595806468643
2003-01-23T09:30:00-05:00,22.89999,23.28999,22.7,23.28,13100,129855,44.922914998616385,49.3828270437427,NaN,NaN,-75.14234132848327,-28.901020248061094,-0.06326215189332535,-0.1392170471486267,-0.07595489525530136,7507701,7592901,58.268075566613575,69.4952097128432,NaN,NaN,-6.05131424934363,-3.9078412983079267
2003-01-24T09:30:00-05:00,23.2,23.2,22.52,22.63,195800,133475,39.03637277273121,48.8346437800444,NaN,NaN,-115.93217476870761,-65.78576606455641,-0.10235401739005208,-0.20389741699286645,-0.10154339960281437,7311901,7498361,53.31501422871172,68.58308556936737,NaN,NaN,-8.710204098413673,-4.593893126894462
2003-01-27T09:30:00-05:00,22.39999,22.67999,22.17999,22.27,38300,129390,36.20658584466235,47.771306029659534,NaN,NaN,-151.36889211121579,-101.12563427551818,-0.14353908180764274,-0.2809672518623678,-0.13742817005472507,7273601,7432581,50.12245944004852,67.13568153728157,NaN,NaN,-11.84783940028557,-5.630171165950334
2003-01-28T09:30:00-05:00,22.3,22.60001,22.28,22.60001,64100,130845,40.466995526984824,47.10744929872417,NaN,NaN,-128.73597104727938,-115.79529734630452,-0.13951515281172872,-0.31182211106938595,-0.17230695825765724,7337701,7385101,47.89318236580421,65.4920474040832,NaN,NaN,-13.06187699588404,-6.6918434273694345
2003-01-29T09:30:00-05:00,22.10001,22.83,22.10001,22.8,56800,83155,42.953396532245385,46.78245237882413,NaN,NaN,-112.59772465163404,-116.75542078146403,-0.11534563299047124,-0.31648899949574627,-0.20114336650527503,7394501,7365081,46.94507020757508,63.76993874699739,NaN,NaN,-13.269122910814286,-7.63145478214727
2003-01-30T09:30:00-05:00,22.67,22.69,22.06,22.14999,129200,86620,37.475022113576145,45.59313268887032,NaN,NaN,-131.6091289461419,-128.04877830499575,-0.1337983715075119,-0.3683913308896649,-0.23459295938215302,7265301,7316601,44.64045787246126,61.8801725082498,NaN,NaN,-15.253607298688143,-8.720333713081681
2003-01-31T09:30:00-05:00,22,22.47,22,22.34,702500,117690,39.88855099211031,44.53562770805458,NaN,NaN,-116.22539639356164,-128.10742262996655,-0.12408552526246297,-0.38969986596023176,-0.2656143406977688,7967801,7447781,51.56870917746123,60.411558760910346,NaN,NaN,-16.091056988511543,-9.773294181000232
2003-02-03T09:30:00-05:00,22.35001,22.66,22.34,22.42,30600,107855,40.92254715579528,43.46790119002508,NaN,NaN,-84.44001749464931,-114.72164770665324,-0.10396596478105746,-0.3955717966740906,-0.29160583189303313,7998401,7592741,57.846791630577805,59.3798365799606,NaN,NaN,-16.452957043883725,-10.727531732840731
2003-02-04T09:30:00-05:00,21.98,22.05,21.8,21.96001,251400,106755,36.983322562233425,42.096906261496294,NaN,NaN,-120.61693784317494,-113.09784106583236,-0.11260231885530636,-0.4323587304621661,-0.31975641160685975,7747001,7674601,60.927038623764986,58.53285835260625,NaN,NaN,-17.981386353692994,-11.76379667867677
2003-02-05T09:30:00-05:00,21.85001,22.37,21.8,21.89999,126400,111525,36.48974972232696,40.96125326692005,NaN,NaN,-101.07651598984992,-110.79359933347553,-0.113027796667999,-0.4610411574418585,-0.34801336077385947,7620601,7719821,62.554813733328,57.75277859050653,NaN,NaN,-19.361037859316504,-12.849116847339587
2003-02-06T09:30:00-05:00,21.95,22.08,21.67999,21.82001,50700,111405,35.80402892792692,39.859091804840766,NaN,NaN,-104.2154697348245,-105.31486749121204,-0.10930073941906865,-0.48463928504769527,-0.3753385456286266,7569901,7780741,64.6890453738386,57.12112144497165,NaN,NaN,-20.692643586142122,-13.96962066716852
2003-02-07T09:30:00-05:00,22.2,22.2,21.52,21.64999,33300,110600,34.3272393831969,38.86931128215709,NaN,NaN,-101.60021240186293,-102.38983069287232,-0.10866335609688299,-0.5111677407497304,-0.4025043846528474,7536601,7694501,59.51746234858637,56.304531704882116,NaN,NaN,-22.23590415409202,-15.150518308157592
2003-02-10T09:30:00-05:00,21.64999,21.8,21.36,21.66,219200,120175,34.49853902131849,38.41423399249828,NaN,NaN,-110.3210844436533,-107.56604408267313,-0.0982591734360479,-0.5253283514479072,-0.42706917801185934,7755801,7645981,56.7677264240354,55.54274156612261,NaN,NaN,-23.46835319669644,-16.338780435091714
2003-02-11T09:30:00-05:00,21.7,22.07001,21.55,21.74001,30000,119305,35.93691978152742,38.27944180966086,NaN,NaN,-88.87290174015772,-101.21723686206967,-0.07758756561198904,-0.5240536350268457,-0.4464660694148566,7785801,7653741,57.10902783543825,55.15463391630322,NaN,NaN,-24.146465377849385,-17.45416399834281
2003-02-12T09:30:00-05:00,21.60001,21.67999,21.44,21.56,43100,119160,34.121456441028386,37.50790905554744,NaN,NaN,-107.75060545569977,-102.55205475523965,-0.06798120563854043,-0.5314425764630322,-0.46346137082449174,7742701,7678161,58.22665734134011,55.15167547164082,NaN,NaN,-25.213606009224172,-18.562655714183006
2003-02-13T09:30:00-05:00,21.39999,21.42999,20.97,21.28999,52400,121225,31.54707096548806,36.97295892645864,NaN,NaN,-136.895267081986,-109.08801422467195,-0.07140255673669882,-0.5527145667453652,-0.4813120100086664,7690301,7702241,59.35145015176737,55.5828494661448,NaN,NaN,-26.859200941028693,-19.747876460875247
2003-02-14T09:30:00-05:00,21.25,21.82001,21.2,21.75,34500,118070,39.870557827037594,37.23467121091401,NaN,NaN,-89.16646347984191,-106.60126444026773,-0.036059160057529294,-0.526385960080578,-0.49032680002304874,7724801,7739881,61.11401157805992,56.36796033314562,NaN,NaN,-25.996478488984774,-20.640533893462322
2003-02-18T09:30:00-05:00,22.05,22.38,22.05,22.35001,43500,111140,48.64245301388648,37.81863245997842,NaN,NaN,7.532774605401739,-83.03049263045673,0.03074512932865081,-0.4518953883622352,-0.482640517690886,7768301,7742381,61.23424426063979,57.32089332563387,NaN,NaN,-22.4419234469816,-20.897875258250792
2003-02-19T09:30:00-05:00,22.22,22.3,21.89999,22.03999,33000,111420,44.99036152438764,37.96412995941716,NaN,NaN,-11.424847844420873,-67.54088185130936,0.05562044255350174,-0.41311496449900886,-0.4687354070525106,7735301,7732281,60.4214389973959,58.283491096335354,NaN,NaN,-20.54782661132099,-20.847868308689392
2003-02-20T09:30:00-05:00,22.2,22.2,21.73,21.83,28200,108805,42.654308627755725,38.33407899614427,NaN,NaN,-32.31477738707718,-52.45371623758484,0.059168391468180315,-0.39477491771728523,-0.45394330918546555,7707101,7725161,59.81864073955083,59.367647015413176,NaN,NaN,-19.681483391877208,-20.68124189200194
2003-02-21T09:30:00-05:00,22.07001,22.22,21.82001,22.16,77600,112030,47.28648586965152,38.86250291596864,NaN,NaN,3.6599039937780895,-24.342682022432033,0.08348881582033707,-0.3495822894100442,-0.4330711052303813,7784701,7744041,60.931684626608714,60.03643097606657,NaN,NaN,-17.49967695738102,-20.226732615627522
2003-02-24T09:30:00-05:00,22.2,22.2,21.53999,21.53999,36800,104080,40.64374210840604,38.842588269726555,NaN,NaN,-53.96962171034336,-17.30331366853232,0.058736401812125305,-0.35965060296522466,-0.41838700477734997,7747901,7748661,61.214809653697074,60.27700369200367,NaN,NaN,-17.707985858172126,-19.86691165027675
2003-02-25T09:30:00-05:00,21.25,22,21.14,21.98,98600,107095,46.39860628285086,39.51510853548494,NaN,NaN,-60.04138822066717,-30.81814623374611,0.07203777372135023,-0.3283397876256622,-0.4003775613470124,7846501,7764301,62.21313902483882,60.36886800636608,NaN,NaN,-15.96108738876354,-19.308936755774866
2003-02-26T09:30:00-05:00,21.89999,21.94,21.61,21.67999,84100,108095,43.314961360739396,40.002623652514394,NaN,NaN,-46.3167107509614,-37.796518815054206,0.061102705287923886,-0.32399917973710757,-0.38510188502503145,7762401,7769721,62.5726762942581,60.37014390357537,NaN,NaN,-15.533415142582685,-18.76957652531884
2003-02-27T09:30:00-05:00,21.75,22.06,21.66,21.98,76500,109080,47.10105314086933,40.80955395343886,NaN,NaN,1.982350050483597,-30.93709332754205,0.07370254916093999,-0.29297369857385647,-0.36667624773479646,7838901,7796081,64.34932537397427,60.34587818929935,NaN,NaN,-13.952664227677488,-18.08144619708436
2003-02-28T09:30:00-05:00,22.07001,22.31,22.06,22.24001,53000,105270,50.20522305673995,41.94369564440622,NaN,NaN,93.33412345386539,-13.002249435524593,0.09767242591379832,-0.24458571534254858,-0.3422581412563469,7891901,7817521,65.77248089487175,60.79266522831973,NaN,NaN,-11.65853793884066,-17.163887874478117
2003-03-03T09:30:00-05:00,22.39999,22.41,21.87,21.89999,48200,72555,46.3729024554743,42.79186446113164,NaN,NaN,56.616451852520605,9.114965277048201,0.08899715041760503,-0.23101170323434062,-0.32000885365194565,7843701,7836681,67.03879963981942,61.52631331516145,NaN,NaN,-10.934503512354947,-16.273975822746237
2003-03-04T09:30:00-05:00,22,22,21.28999,21.28999,51400,73595,40.41294107221375,43.11158026760923,NaN,NaN,-101.02659504607385,0.9179239119668636,0.04288296282455273,-0.26640515012125476,-0.3092881129458075,7792301,7825841,65.56094646289142,62.13002178855096,NaN,NaN,-12.280786159278325,-15.703520156536536
2003-03-05T09:30:00-05:00,21.33,21.56,21.17,21.56,88600,65455,43.852809965565655,43.80667694793332,NaN,NaN,-117.59712744483105,-13.338159426807067,0.03178261574473684,-0.26955984326488647,-0.3013424590096233,7880901,7849541,67.26029911845609,62.77528191548782,NaN,NaN,-12.265818998708806,-15.212419991132574
2003-03-06T09:30:00-05:00,21.28,21.67,21.25999,21.31,62600,62265,41.465952792149835,44.515168506980594,NaN,NaN,-110.499392588276,-35.83450795455899,0.009951901732107249,-0.28890258184448925,-0.2988544835765965,7818301,7845421,66.6446529638294,63.296224973492244,NaN,NaN,-13.011893053460577,-14.898059000036575
2003-03-07T09:30:00-05:00,21,21.67999,21,21.63,63800,62920,45.55114425431397,44.92092468035747,NaN,NaN,-92.16987659205385,-72.93530796374283,0.01889338968879206,-0.2752377464656064,-0.29413113615439845,7882101,7843461,66.33358920727642,63.6690519470077,NaN,NaN,-12.352507992292457,-14.53440885607313
2003-03-10T09:30:00-05:00,21.47,21.57001,21.12,21.12,101200,66315,40.67841014287035,44.3520644752849,NaN,NaN,-121.75500974492779,-108.60960028323252,-0.006358152716077536,-0.3020788270494954,-0.29572067433341787,7780901,7830901,64.26360312748189,63.885434723210714,NaN,NaN,-13.360040003960993,-14.366641877199967
2003-03-11T09:30:00-05:00,21.25,21.41,20.94,20.94,1483000,129505,39.08907379595836,43.93054392325423,NaN,NaN,-145.96832763384666,-117.59794680078707,-0.030643175967443093,-0.3340246442927217,-0.3033814683252786,6297901,7532021,35.70799944397078,62.12018904082321,NaN,NaN,-14.67590669226867,-14.410822565066924
2003-03-12T09:30:00-05:00,20.8,20.98,20.64999,20.89999,1349900,195500,38.726876631216456,43.65001306635857,NaN,NaN,-171.65590342484694,-128.40970199679026,-0.04404566593569992,-0.3584385507449035,-0.3143928848092036,4948001,6945441,18.41412213898225,59.16272342649688,NaN,NaN,-15.83795869317495,-14.614699154796643
2003-03-13T09:30:00-05:00,21.42,22.08,21.33,22.00999,276600,207175,52.01190022916675,43.9875426634668,NaN,NaN,29.357208008475993,-100.43838187743985,0.02356672634803242,-0.28493447687416307,-0.3085012032221955,5224601,6426701,12.601644934369276,55.71057773419407,NaN,NaN,-12.441443867516961,-14.304234113756689
2003-03-14T09:30:00-05:00,22.17999,22.35001,21.98,22.05,287600,218935,52.41241289249381,44.82816200518736,NaN,NaN,89.33019970127529,-64.13836661877403,0.07007534853586272,-0.22090701755236708,-0.2909823660882298,5512201,5952721,9.615152692351302,52.02488795124081,NaN,NaN,-9.678219482421717,-13.643374880708835
2003-03-17T09:30:00-05:00,22.00999,23.2,22,23.11,1039200,269170,61.56479082289876,45.91146090090506,NaN,NaN,191.19569558266505,-1.548225553255446,0.16585214067188775,-0.0836671902483701,-0.24951933092025785,6551401,5706821,8.490883683545647,48.18758399829129,NaN,NaN,-3.815562904678947,-12.239401741275994
2003-03-18T09:30:00-05:00,23.25,23.28,22.85001,22.96001,377600,285875,59.811844651095846,47.089809707359095,NaN,NaN,210.18683790799713,69.68280755511331,0.20989174392119891,0.01284534898124079,-0.19704639493995812,6173801,5682001,8.384319852952913,44.31698710962663,NaN,NaN,0.15795910301841912,-10.468350192091078
2003-03-19T09:30:00-05:00,23.2,23.39999,22.87,23.39999,137800,291115,63.12837351529188,48.23461830553213,NaN,NaN,200.98607278152616,144.21120279638794,0.256366972099279,0.12341232018414061,-0.1329546519151384,6311601,5954721,20.23086488533977,41.1656685032956,NaN,NaN,4.57540912964495,-8.31924171755736
2003-03-20T09:30:00-05:00,23.22,23.60001,22.88,23.58,577400,318575,64.42201931829894,49.250103752786345,NaN,NaN,177.09631435955643,173.759024066604,0.28475750428924856,0.2229922284464223,-0.06176527584282625,6889001,6287601,31.819618383828782,38.7404640382211,NaN,NaN,8.525090378424848,-5.912908560988473
2003-03-21T09:30:00-05:00,23.75,24.28,23.53,24.28,217400,325565,68.97980320203655,50.86488237754079,NaN,NaN,204.3144678814642,196.7558777026418,0.33286014783787365,0.35430990895451586,0.02144976111664218,7106401,6606441,40.70524219078226,36.85949564900416,NaN,NaN,13.534692116111133,-3.1346798928313864
2003-03-24T09:30:00-05:00,23.55,23.58,23.10001,23.17,55500,326500,56.598017698631125,52.02095927942774,NaN,NaN,109.6336015101919,180.44345888814718,0.27452771372080065,0.364609403267643,0.09008168954684234,7050901,6706341,43.202894985851685,35.26249197207275,NaN,NaN,13.583495099294723,-0.7463691796705136
2003-03-25T09:30:00-05:00,23.19,23.67,23.10001,23.50999,34000,323270,59.024164053196436,53.10462742854423,NaN,NaN,105.89843316684284,159.5857779399163,0.24445098766732942,0.3956454241310041,0.1511944364636747,7084901,6888561,47.5433158150338,33.8541360218283,NaN,NaN,14.46435439700586,1.4265913312832539
2003-03-26T09:30:00-05:00,23.28999,23.61,23.28999,23.53999,205300,329330,59.24067219755472,54.374250243216004,NaN,NaN,95.79703333838681,138.54797005128844,0.21332107284816687,0.4178457775238833,0.20452470467571643,7290201,7084281,51.80364972697898,32.79406436205327,NaN,NaN,15.209728163999442,3.395610878814138
2003-03-27T09:30:00-05:00,23.2,23.55,23.13,23.45,32800,327145,58.24647227911223,55.28105938784445,NaN,NaN,77.60571314382456,118.64984980814206,0.17501923793197113,0.42329875209068035,0.24827951415870922,7257401,7157961,53.33998763639273,31.865949964133016,NaN,NaN,15.49870005019728,5.1246236175831585
2003-03-28T09:30:00-05:00,23.25,23.39999,23.07001,23.21001,63200,327655,55.56814748735034,56.344612055307316,NaN,NaN,59.825529513400916,89.75206213452941,0.12425847410057811,0.4036026067844318,0.2793441326838537,7194201,7175521,53.71863793575403,31.112738164723883,NaN,NaN,14.935682467776815,6.52620345332511
2003-03-31T09:30:00-05:00,22.84,23.10001,22.55,22.73,881100,369300,50.560363109036814,57.163989863384344,NaN,NaN,25.431706861450795,72.9116832047812,0.052748932246032276,0.34528029799139404,0.29253136574536176,6313101,7027961,50.04352912197081,32.136704570295315,NaN,NaN,12.908343146856097,7.437937695258108
2003-04-01T09:30:00-05:00,22.73,23.03,22.61,23,1005100,416985,53.11959265772961,58.192041008135284,NaN,NaN,27.997122546250377,57.3314210806627,0.019726767198420425,0.3171898247433873,0.2974630575449669,7318201,7074621,51.180883738255694,34.47718754167199,NaN,NaN,11.972335058156528,8.085708747100739
2003-04-02T09:30:00-05:00,23.35001,23.78,23.34,23.60001,668300,445970,58.287128148094936,58.64027157377301,NaN,NaN,75.85802797195215,53.343620007375776,0.033574326711041436,0.33943096593376865,0.3058566392227272,7986501,7213881,54.50969614644536,37.470619771105994,NaN,NaN,12.744503992906047,8.751250925072926
2003-04-03T09:30:00-05:00,23.89999,23.92,23.66,23.72,1354800,510580,59.25439022558861,59.12898424042264,NaN,NaN,87.12978971245913,55.24843532110269,0.04536273194118606,0.3625600541492098,0.3171973222080237,9341301,7630661,62.705775458758595,41.26280711156365,NaN,NaN,13.658213741799008,9.452245613176652
2003-04-04T09:30:00-05:00,23.85001,23.89,23.61,23.89,130300,513905,60.64672447888718,59.063408072993234,NaN,NaN,85.78862239335741,60.441053897094,0.05833066200343373,0.3901106497123159,0.3317799877088822,9471601,8086141,69.23040948080781,45.60134466851095,NaN,NaN,14.819373107699468,10.218978112394197
2003-04-07T09:30:00-04:00,24.47,24.64,24.10001,24.10001,65300,512110,62.35796673940501,59.24527393644389,NaN,NaN,125.79068918185473,80.51285036117478,0.07377849240845552,0.42400310321945156,0.35022461081099604,9536901,8730901,75.7089163388123,50.41024441750091,NaN,NaN,16.287063519337355,11.08584745624322
2003-04-08T09:30:00-04:00,24,24.21001,23.86,24.12,66800,441300,62.52501026053336,59.202176561104,NaN,NaN,103.42266622811539,95.5979590975478,0.07767608692183026,0.44731971946328386,0.3696436325414536,9603701,9188001,79.07294134707988,54.61324987905378,NaN,NaN,17.538985539096856,12.007724325222311
2003-04-09T09:30:00-04:00,24.09,24.23,23.8,23.8,277600,387685,58.08159441682922,58.74928906814188,NaN,NaN,90.32307191564925,98.49096788628722,0.0522554919629899,0.43496299749519096,0.38270750553220106,9326101,9455921,80.75524115699056,58.10865150570819,NaN,NaN,17.41601117654424,12.780336732554016
2003-04-10T09:30:00-04:00,23.64999,24.08,23.62,24.07001,44600,376085,60.624354734925895,58.15247132049111,NaN,NaN,82.07662779937516,97.48033550367043,0.04732537241664675,0.4418642210530095,0.39453884863636274,9370701,9461801,80.79173672932937,60.97197254417584,NaN,NaN,18.01096116943484,13.527568794965562
2003-04-11T09:30:00-04:00,24.39999,24.39999,23.82001,23.82001,333300,378370,57.16664736110372,58.19308772495344,NaN,NaN,88.3606528117724,97.99474158735342,0.02220304344713714,0.4222926529452842,0.40008960949814704,9037401,9374961,78.42627214768189,63.487928055735146,NaN,NaN,17.561694575454652,14.103872477892574
2003-04-14T09:30:00-04:00,23.8,24.44,23.8,24.42999,147100,333765,62.74924644403075,58.45916503858446,NaN,NaN,112.66772831916825,95.37014941481611,0.04057289209923626,0.45080572462219237,0.4102328325229561,9184501,9304481,76.46937583432913,65.55407519997053,NaN,NaN,18.803285453183353,14.7752171886484
2003-04-15T09:30:00-04:00,24.39999,24.64999,24.35001,24.61,425300,336150,64.23083918687936,58.815605537821945,NaN,NaN,146.9008483936865,104.06578584793033,0.057707662540154525,0.48236741069814926,0.42465974815799473,9609801,9305701,76.48031580978343,67.31669420588513,NaN,NaN,20.27165119092785,15.560422046116893
2003-04-16T09:30:00-04:00,24.85001,24.85001,23.35001,24.27,161100,337315,59.42335447091227,58.89966855152194,NaN,NaN,75.74436167557117,101.15004379991471,0.03985272610755258,0.47447565579243545,0.43462292968488286,9448701,9330221,76.71463682202638,68.98631200485896,NaN,NaN,20.125545017136805,16.21258247054831
2003-04-17T09:30:00-04:00,24.28,24.75999,24.21001,24.73,81100,312500,63.413251843399884,59.46003314838263,NaN,NaN,130.14310231727893,110.76333870349549,0.05196620317153566,0.4995806836493024,0.44761448047776675,9529801,9362041,77.03439527006674,70.65172324302415,NaN,NaN,21.204781752595643,16.92575379655507
2003-04-21T09:30:00-04:00,24.75,24.81,24.5,24.74001,41000,303680,63.49736631349009,60.38410480584356,NaN,NaN,134.09208252639976,119.90962464642095,0.05339254071623778,0.514355156373064,0.46096261565682617,9570801,9468721,78.11924320233267,72.65713139162143,NaN,NaN,22.097263233279396,17.66454085894426
2003-04-22T09:30:00-04:00,24.60001,25.32001,24.53999,25.24001,68900,304350,67.51483573377385,61.41233645413244,NaN,NaN,163.81405678860014,130.13889034030734,0.07919393997707341,0.5599550406281679,0.4807611006510945,9639701,9559761,79.02964014043287,74.64632827749122,NaN,NaN,24.104936720944927,18.584597410658642
2003-04-23T09:30:00-04:00,25.42999,25.52,25.17,25.5,475600,326430,69.40070311941565,62.20616323779821,NaN,NaN,184.56457723254238,137.67163610807853,0.10342322721275199,0.6100401346670346,0.5066169074542826,10115301,9660861,80.02364451804083,76.46875316117662,NaN,NaN,26.367078094817366,19.69638036553846
2003-04-24T09:30:00-04:00,25.2,25.28,25,25.10001,181400,325235,63.31117513643797,62.495933588573166,NaN,NaN,130.90980676030472,148.70472512502522,0.08304290159247008,0.6104205344448701,0.5273776328524,9933901,9757901,80.95670301033248,77.77239084343191,NaN,NaN,26.484543098972118,20.666117898886124
2003-04-25T09:30:00-04:00,25.09,25.09,24.71001,24.72,335600,340375,58.095695102233606,62.31371720452648,NaN,NaN,85.77284879630292,139.83067442083,0.03685631056428862,0.5734480210577608,0.5365917104934722,9598301,9771601,81.09098445157133,78.61957476991499,NaN,NaN,24.97296334369152,21.281381533858323
2003-04-28T09:30:00-04:00,24.94,25.38,24.94,25.28999,20900,338260,63.016926714860816,62.360785774201894,NaN,NaN,116.62568250729383,136.33739441700885,0.03745880739003793,0.5834152197310196,0.5459564123409817,9619201,9781281,81.19190003868194,79.01121646276283,NaN,NaN,25.202738661993223,21.841575409306166
2003-04-29T09:30:00-04:00,25.39999,25.64999,25.28999,25.5,35400,295975,64.663554529643,62.51353893628116,NaN,NaN,134.07632445993892,130.38984795127658,0.04429775532792024,0.601328606500882,0.5570308511729618,9654601,9784261,81.22511946320597,79.16494347105755,NaN,NaN,25.901936314188205,22.42162696714646
2003-04-30T09:30:00-04:00,25.28999,25.52,25.25,25.39,74000,249420,63.079329355773396,62.870520003348595,NaN,NaN,112.49211845890274,115.97535619654866,0.034163826907825046,0.5997356348077432,0.5655718078999181,9580601,9677321,76.0350897708958,78.82778980062221,NaN,NaN,25.996718683010588,22.93235435512705
2003-05-01T09:30:00-04:00,25.39,25.39,24.84,25.16,37400,217875,59.78138630216656,62.810307972437215,NaN,NaN,72.47084602655308,104.28756404979833,0.006186879748841356,0.5733054075859698,0.5671185278371285,9543201,9599181,72.39504889999773,78.22802638424137,NaN,NaN,25.10182354917106,23.242278525704766
2003-05-02T09:30:00-04:00,25.07001,25.45,25.07001,25.39999,126200,156445,62.01310704964327,63.15648366447575,NaN,NaN,86.23690287091468,104.38037486472066,-0.0015275654119399906,0.5652090710722035,0.5667366364841435,9669401,9613401,72.65163576772545,77.81555235710164,NaN,NaN,24.989371865506524,23.491863288533587
2003-05-05T09:30:00-04:00,25.39999,25.39999,25.12,25.31,126400,156250,60.65398676041679,63.00682225850333,NaN,NaN,74.65629233356273,95.98649682997447,-0.017192533983284797,0.5452459690050375,0.5624385029883223,9543001,9598161,71.88050397233778,77.48777579553082,NaN,NaN,24.51193580864846,23.637587934264282
2003-05-06T09:30:00-04:00,25.32001,25.81,25.27,25.64,890800,197525,63.788202311602056,62.97520533884066,NaN,NaN,103.43278710345713,89.8577893586781,-0.01017758717407058,0.549716519020734,0.5598941061948046,10433801,9754001,74.82330311309278,77.36941774576721,NaN,NaN,24.989454479075267,23.830711726380137
2003-05-07T09:30:00-04:00,25.35001,25.8,25.35001,25.62,105700,199470,63.45827586100962,63.26341400956189,NaN,NaN,97.25700709057935,86.81076708501344,-0.011628029446985044,0.5453590693860733,0.5569870988330583,10328101,9903501,77.27977935907904,77.4097850698424,NaN,NaN,25.29094498846592,24.039316478106677
2003-05-08T09:30:00-04:00,25.3,25.64,25.28999,25.38,42000,187690,59.48241400023722,62.982639877907424,NaN,NaN,71.22162254193735,86.56092238809029,-0.03232176242271956,0.5165848958046588,0.5489066582273784,10286101,10052081,79.42806849409676,77.58076172870167,NaN,NaN,24.45257057308248,24.098352777388936
2003-05-09T09:30:00-04:00,25.5,25.67,25.27,25.67,46200,187770,62.5367701414473,62.914025865618655,NaN,NaN,82.1465081117663,85.7428434362606,-0.030094987871184253,0.511287923388398,0.5413829112595823,10332301,10184661,81.14158293059145,77.79664313786303,NaN,NaN,24.570047655669157,24.165737760000397
2003-05-12T09:30:00-04:00,25.56,26.21001,25.49001,26.06,108100,176510,66.22427104659903,62.82184267367759,NaN,NaN,140.28001387823156,98.86758774519434,-0.007168455500422666,0.5324223418840539,0.5395907973844766,10440401,10364141,83.18363810696621,78.09335727832969,NaN,NaN,25.75464397252104,24.39272436178906
2003-05-13T09:30:00-04:00,25.95,26.24001,25.92,26.03,319100,185110,65.68864883478534,62.556695939061136,NaN,NaN,156.1997182021011,109.42097396492314,0.0007433568959986925,0.5405199935044749,0.5397766366084762,10121301,10301641,79.93753990035559,78.08720694849502,NaN,NaN,26.574843558172066,24.704455675558062
2003-05-14T09:30:00-04:00,26.10001,26.10001,25.7,25.83,56700,166680,62.08359563579655,62.46901168901532,NaN,NaN,113.9457590428175,112.75872435537076,-0.012021213693233945,0.5247501194919337,0.5367713331851677,10064601,10248941,77.20185081698004,77.81900322039841,NaN,NaN,26.27621341556159,24.928992495558568
2003-05-15T09:30:00-04:00,26,26,25.56,25.89,178900,167570,62.74416972339225,62.801045590526655,NaN,NaN,97.96829903575785,118.10805965413488,-0.020456209316787488,0.5112010715391833,0.5316572808559707,10243501,10240421,76.74457597051185,77.50854547175132,NaN,NaN,26.20372930627121,25.111097754231803
2003-05-16T09:30:00-04:00,25.87,25.94,25.61,25.92999,919900,209510,63.204295273436735,62.81442905899636,NaN,NaN,93.31700173368492,120.34215837851859,-0.026965702434998406,0.49795015281222277,0.5249158552472212,11163401,10406641,79.3183117205387,77.3747177347411,NaN,NaN,26.262426218437078,25.27557324911827
2003-05-19T09:30:00-04:00,25.95,25.95,25.08,25.14999,213200,218120,50.18508481406197,61.78025265074057,NaN,NaN,-17.692248086810974,88.74770598551008,-0.0841954753637556,0.41967151104252665,0.5038669864062822,10950201,10508601,80.72731845828852,77.33916052010412,NaN,NaN,22.32941098895648,24.854692926238016
2003-05-20T09:30:00-04:00,25.35001,25.60001,24.96001,25.16,262100,227780,50.326497053419445,60.86933605771528,NaN,NaN,-63.00104190943033,44.907553963203796,-0.1196071666860738,0.35435802804869,0.4739651947347638,11212301,10726801,83.34273246757095,77.86113499843805,NaN,NaN,19.204407686280494,24.047509320529798
2003-05-21T09:30:00-04:00,25.2,25.3,24.99001,25.27,33100,205655,51.94102439798661,60.309310207416715,NaN,NaN,-71.90448796964586,7.737504560711116,-0.13283363063774567,0.3079231564375817,0.4407567870753274,11245401,10962961,85.61764445138182,78.8056061092512,NaN,NaN,17.02959637539748,23.04495032836804
2003-05-22T09:30:00-04:00,25.35001,25.82001,25.31,25.7,87800,200975,57.72544795101116,60.00304884322871,NaN,NaN,34.08635969285015,-5.038883307870421,-0.11073706364137859,0.30233545752360413,0.4130725211649827,11333201,11180901,87.33646690003954,79.85452261870219,NaN,NaN,16.76285817117913,22.147508591626767
2003-05-23T09:30:00-04:00,25.55,25.67,25.48,25.61,65500,187470,56.20074108489729,59.68495986640589,NaN,NaN,19.77551615382845,-19.74718042384172,-0.10059183673974265,0.2873327252403044,0.38792456198004704,11267701,11201761,87.49056620861668,80.9695270641507,NaN,NaN,16.102613094426253,21.283952092026695
2003-05-27T09:30:00-04:00,25.39999,26.2,25.39999,26.2,123900,192620,63.084451011677075,59.63469191641125,NaN,NaN,112.98507065278494,6.388283324077466,-0.054844027292347663,0.3193695278646125,0.37421355515696014,11391601,11290041,88.14788258043939,81.92128274038974,NaN,NaN,17.66450492923666,20.766888211628117
2003-05-28T09:30:00-04:00,26.3,26.44,26.17,26.21001,188500,200275,63.19015382606274,59.61554034248646,NaN,NaN,177.58216487244215,54.504924680451964,-0.026067990813419706,0.3416285666401855,0.3676965574536052,11580101,11363601,88.68157011712249,82.73569636596427,NaN,NaN,18.93896559081959,20.505756408655472
2003-05-29T09:30:00-04:00,26.3,26.61,26.17999,26.17999,189500,206050,62.611138427647816,59.83902065873008,NaN,NaN,157.3842979236617,100.36268185911347,-0.011933227074163444,0.3527800236109009,0.3647132506850643,11390601,11392641,88.89417897790547,83.41184711480776,NaN,NaN,19.816454867621403,20.40728475993632
2003-05-30T09:30:00-04:00,26.52,26.77,26.49001,26.74001,307700,219565,68.42383458703667,60.25952526198647,NaN,NaN,196.62627944813073,132.87066581016958,0.029965875485975957,0.4021705950425343,0.3722047195565583,11698301,11465661,89.43174093503625,84.00400125798238,NaN,NaN,22.45784748338749,20.700222291857916
2003-06-02T09:30:00-04:00,27.05,27.37,26.92999,26.99001,1025300,264520,70.61973313417428,60.573486839670416,NaN,NaN,232.63926124920434,175.44341482924477,0.06721765711477162,0.45622679095002283,0.3890091338352512,12723601,11756841,91.25046642870385,84.58020328096363,NaN,NaN,25.381072268039134,21.36891514559809
2003-06-03T09:30:00-04:00,27.05,27.06,26.67999,26.95,806000,298500,69.78332591367523,60.86596377387684,NaN,NaN,165.94996144525373,186.03639298773854,0.08094282474768077,0.4901876647698522,0.40924484002217143,11917601,11862041,91.79955215713838,85.42748987073385,NaN,NaN,27.495661736178327,22.244164658538125
2003-06-04T09:30:00-04:00,27,27.42999,26.95,27.37,406900,274305,73.35138303317709,61.67080573083259,NaN,NaN,179.28019257516533,186.37599852828316,0.10837474900925248,0.544713276283737,0.4363385272744845,12324501,12010921,92.51541268591946,86.52131571851523,NaN,NaN,30.508159764372696,23.424735387943063
2003-06-05T09:30:00-04:00,27.42999,27.64,27.13,27.52,175400,277790,74.50908613105138,62.51115690280824,NaN,NaN,166.2953918687433,188.1582173172995,0.12548199877704896,0.5931910257457957,0.4677090269687468,12499901,12232781,93.43511132519833,87.71349681527855,NaN,NaN,33.35714300154969,24.843650761315438
2003-06-06T09:30:00-04:00,27.85001,28.00999,27.32001,27.38,136100,282495,71.3916923963799,63.09597098301846,NaN,NaN,152.27766640577067,179.28849470882747,0.11642803092838228,0.6132440656292246,0.49681603470084235,12363801,12365881,93.91795963250318,88.75632880899029,NaN,NaN,34.81767802471779,26.268511798944346
2003-06-09T09:30:00-04:00,27.3,27.33,26.85001,26.99001,458500,303110,63.43029550345774,64.04205746083245,NaN,NaN,85.19516047668836,149.79967455432427,0.07523220184908985,0.5908562870122047,0.5156240851631149,11905301,12202221,85.58271095314616,89.10314255862299,NaN,NaN,33.66620594356267,27.325325248175535
2003-06-10T09:30:00-04:00,27.05,27.28999,27.05,27.28999,395500,317480,66.52282540791128,65.19893805758186,NaN,NaN,89.52876662001347,134.51543558927625,0.05991083437333755,0.5905126281297868,0.5306017937564492,12300801,12278861,86.20035118766424,89.30725818148679,NaN,NaN,33.63181935332628,28.226252977482783
2003-06-11T09:30:00-04:00,27.14999,27.64999,27.14,27.59,157000,309375,69.31738244046677,66.44010648918758,NaN,NaN,99.93542685452687,118.64648244514854,0.061475615179160004,0.6074463127303993,0.5459706975512393,12457801,12305521,86.4183202183191,89.3644493076966,NaN,NaN,34.47746961422664,29.11928392558905
2003-06-12T09:30:00-04:00,27.85001,27.85001,27.50999,27.75999,73900,310235,70.80452320542979,67.3743261502175,NaN,NaN,108.22679640422274,107.03276335224442,0.06510459018149761,0.6273514352781113,0.5622468450966137,12531701,12311881,86.47321146736724,89.30278820536286,NaN,NaN,35.633016322225714,30.04981712510857
2003-06-13T09:30:00-04:00,27.85001,27.85001,27.39,27.46001,19900,302285,64.83269435540458,67.99089424096802,NaN,NaN,86.7501712637467,93.92726432383962,0.03969635125519022,0.6118672841656014,0.5721709329104112,12511801,12341481,86.74177939393692,89.24930343288574,NaN,NaN,34.76486770130426,30.72339577885081
2003-06-16T09:30:00-04:00,27.75,28.10001,27.69,28.10001,171400,264860,70.5413246818277,68.52352807455021,NaN,NaN,110.0941694660229,98.90706612170654,0.05731694267343157,0.6438171112522006,0.5865001685787691,12683201,12497061,88.08126028042108,89.24454469717016,NaN,NaN,35.88658013150009,31.460993543514995
2003-06-17T09:30:00-04:00,28.2,28.25999,27.97,28.10001,171200,262760,70.5413246818277,69.04861170710485,NaN,NaN,113.79386705609602,103.76008620892303,0.0600095290761975,0.661512079924016,0.6015025508478185,12683201,12573541,88.68636724637965,89.24488734925997,NaN,NaN,36.75525776187647,32.21731700328092
2003-06-18T09:30:00-04:00,28.10001,28.10001,27.69,27.84,921100,295710,65.52935793275927,69.25705595746994,NaN,NaN,88.91864104793848,101.55672904760534,0.03647437668557851,0.6470955217047916,0.610621145019213,11762101,12434401,80.66286021724268,88.65693600921261,NaN,NaN,35.918752198388106,32.746093459724804
2003-06-19T09:30:00-04:00,27.75,27.89999,27.3,27.38,97600,298935,57.71638760005988,68.49223831554302,NaN,NaN,51.477830473119155,90.20693586138464,-0.015112089756053382,0.5917310328241463,0.6068431225801997,11664501,12260961,71.92743779890885,87.40662864234638,NaN,NaN,32.62223075407225,32.72839878748872
2003-06-20T09:30:00-04:00,27.52,27.52,27.25,27.38,97700,299430,57.716387600059875,67.570570777392,NaN,NaN,29.94238908944533,78.84537942652436,-0.05218575972159123,0.5416109229282107,0.5937966826498019,11664501,12091501,64.56973991656936,85.5008624629082,NaN,NaN,30.035422380497597,32.34368787220428
2003-06-23T09:30:00-04:00,27.14999,27.27,26.82001,27.03999,82900,300300,52.364349452669124,66.32635817303442,NaN,NaN,-26.016119018628522,51.62332172959407,-0.09979932894672117,0.4690475214664005,0.5688468504131217,11581601,11871181,56.480343887592184,82.97806187222635,NaN,NaN,26.11504119517504,31.453881204057243
2003-06-24T09:30:00-04:00,27.10001,27.28,26.94,27.03999,288800,308545,52.36434945266914,64.82728434585528,NaN,NaN,-32.62586454119527,22.33937541013581,-0.1295970141268652,0.4068505827545401,0.5364475968814053,11581601,11650861,49.7659877626892,79.92453152056703,NaN,NaN,22.98677907669527,30.244295185862676
2003-06-25T09:30:00-04:00,27,27.25,26.78999,26.88,36500,300945,49.84210624869628,63.06535721140134,NaN,NaN,-64.18732230618069,-8.281817260688026,-0.15658081466737295,0.3407215785471891,0.49730239321456204,11545101,11607461,48.541812722850956,76.7178673346851,NaN,NaN,19.60518610678556,28.72442246028023
2003-06-26T09:30:00-04:00,27,27.11,26.8,27.08,704700,326705,52.89650821946273,61.74427262733583,NaN,NaN,-73.21004775363481,-33.21939290603882,-0.15705579126942082,0.300982654127786,0.45803844539720684,12249801,11724521,51.97340854514129,73.72182797130209,NaN,NaN,17.568416494993595,27.13070732238214
2003-06-27T09:30:00-04:00,27.05,27.27,26.83,26.92,35700,313105,50.25968316285636,60.80351460300716,NaN,NaN,-78.93626680557404,-54.9951240850427,-0.16350704858669723,0.2536546346638353,0.41716168325053254,12214101,11834441,55.00753919453573,71.53788713140133,NaN,NaN,15.079823975242624,25.409152558505067
2003-06-30T09:30:00-04:00,27.13,27.27,26.99001,27.09,64200,265050,52.94370277470601,59.83357727206393,NaN,NaN,-54.802271584763005,-60.752354598269584,-0.15193344261008035,0.22724487998793208,0.37917832259801243,12278301,11973781,58.579840250574925,69.56499349303782,NaN,NaN,13.704975771604428,23.737127303233546
2003-07-01T09:30:00-04:00,26.85001,27.11,26.57001,27.03,527400,251120,51.879654756382465,58.58802529462934,NaN,NaN,-102.7442157426793,-74.7760248385664,-0.14400068469963162,0.19917746672347292,0.34317815142310454,11750901,12007641,59.42295094078109,67.63675283035653,NaN,NaN,12.265617125179043,22.098340134940045
2003-07-02T09:30:00-04:00,27.05,27.34,27.05,27.28,47200,233135,55.860268551251295,57.520578533616586,NaN,NaN,-30.600523591159632,-68.05866509556219,-0.11865410562778417,0.19486051938837434,0.3135146250161585,11798101,12058241,60.710022957048764,65.7965250796195,NaN,NaN,12.109231840476419,20.671324664302386
2003-07-03T09:30:00-04:00,27.05,27.5,27.05,27.25,49600,226845,55.26942542377884,56.83748789564332,NaN,NaN,-19.085862766568294,-57.23382809814888,-0.10132009953289373,0.18686450060004134,0.28818460013293506,11748501,11957981,56.86142957329739,63.66221437814524,NaN,NaN,11.82021803557684,19.406880860198736
2003-07-07T09:30:00-04:00,27.55,27.92999,27.55,27.8,262000,233140,62.996838350954526,56.29859601486667,NaN,NaN,85.7139940698982,-24.30377592305443,-0.052671722177182134,0.22234494741145738,0.2750166695886395,12010501,11917261,55.32735561462303,61.32264975915966,NaN,NaN,13.906252439779623,18.621076800138862
2003-07-08T09:30:00-04:00,27.92999,28.19,27.84,28.19,267300,223580,67.30943350641387,56.06774664519425,NaN,NaN,132.29192515356186,13.115063424610543,0.0029628913944222957,0.27872028383166736,0.27575739243724506,12277801,11917161,55.323408185286375,58.93958125479586,NaN,NaN,17.149162961766983,18.410803394657165
2003-07-09T09:30:00-04:00,28,28.16,27.78999,27.84,107200,209165,60.49531445481296,55.70817211105523,NaN,NaN,92.0325047801179,52.070407529169984,0.012828059851106022,0.2917924672511276,0.2789644074000216,12170601,12001101,58.03025939553421,57.322966910388104,NaN,NaN,17.74381487530936,18.31551932046462
2003-07-10T09:30:00-04:00,27.64999,27.7,27.25,27.48,46000,203615,54.3955092231515,55.47096651270463,NaN,NaN,5.181971777793912,59.22690660296068,-0.007178736002083574,0.2699909873974171,0.2771697233995007,12124601,12066401,60.057691904842216,56.475127917954765,NaN,NaN,16.23404274980543,18.018165524656165
2003-07-11T09:30:00-04:00,27.64999,27.89,27.59,27.89,73600,203600,59.41465192880242,55.592271107614806,NaN,NaN,63.399186240166934,75.72391640430776,0.0042960518607588205,0.28253978822544923,0.2782437363646904,12198201,12156341,62.72832035328424,56.343597949148695,NaN,NaN,16.643615514702326,17.821801237519903
2003-07-14T09:30:00-04:00,28.10001,28.44,28.03999,28.03999,72400,206225,61.10128391349939,56.21633785481696,NaN,NaN,119.44683017805922,82.47048362593996,0.018298336815803007,0.30111665738444415,0.28281832056864115,12270601,12208361,64.21850783001386,56.89632394503597,NaN,NaN,17.522479245558007,17.779040952953917
2003-07-15T09:30:00-04:00,28,28.25,27.8,27.87,816800,238495,58.1517099000126,56.62972074391293,NaN,NaN,84.58449287181446,72.92899716959047,0.012688703388110123,0.29867919980377877,0.28599049641566865,11453801,12043561,56.510179975436145,57.378051960232185,NaN,NaN,17.31024774224101,17.712070494280646
2003-07-16T09:30:00-04:00,28.03999,28.07001,27.67999,27.78999,33100,231590,56.76278664268412,57.124055057769205,NaN,NaN,67.38450191016645,67.99939659560019,0.0007941589865047005,0.28698319514879955,0.28618903616229485,11420701,11893581,50.56198851944571,57.52235023141752,NaN,NaN,16.719639126531387,17.57029458460218
2003-07-17T09:30:00-04:00,27.8,27.91,27.45,27.47,25000,186785,51.46820552164487,57.02203343649649,NaN,NaN,28.305665658286916,72.62413537169878,-0.029732887194191537,0.24902292716955543,0.27875581436374697,11395701,11747801,45.54390595776613,57.06310004660501,NaN,NaN,14.569147661618992,17.141559309890297
2003-07-18T09:30:00-04:00,27.72,27.78999,27.53,27.64999,21200,182965,54.063702572612,57.293749108621896,NaN,NaN,35.146187786917594,66.97353568104893,-0.038362823494317744,0.23080228499584976,0.2691651084901675,11416901,11591541,40.86253052017298,56.05274228415052,NaN,NaN,13.558736851506811,16.62972753012123
2003-07-21T09:30:00-04:00,27.55,27.59,27.24001,27.34,22900,179225,49.18493342892502,57.02526558392325,NaN,NaN,-13.698722924383572,40.34442506056037,-0.06399762230030348,0.18916808061478818,0.25316570291509166,11394001,11416221,36.34819001973613,54.46476726766203,NaN,NaN,11.171084223611958,15.849921343477048
2003-07-22T09:30:00-04:00,27.5,27.58,27.10001,27.53999,50900,177625,52.18294034271721,57.04692884009002,NaN,NaN,-14.680767183347852,20.491373049527905,-0.06625532525278083,0.1703465463491156,0.23660187160189644,11444901,11414441,36.30433687045163,52.81343769120993,NaN,NaN,10.083840194177947,15.026195465005747
2003-07-23T09:30:00-04:00,27.60001,27.60001,27.14,27.42,75900,166980,50.26673407358104,56.64739066311357,NaN,NaN,-22.279350129362278,2.558602641622161,-0.0740117316744898,0.1440872070087842,0.21809893868327399,11369001,11404101,36.032382404303554,51.05074908029956,NaN,NaN,8.617000641718558,14.110596204536149
2003-07-24T09:30:00-04:00,27.5,27.78999,27.39,27.39,47900,167550,49.774601191147916,56.254903217925644,NaN,NaN,-0.46897163196947583,-3.1963248164291183,-0.07889637598717439,0.119478468699306,0.1983748446864804,11321101,11389181,35.61777463468506,49.53334515611296,NaN,NaN,7.281160373494192,13.134962514387299
2003-07-25T09:30:00-04:00,27.3,27.79201,27.25,27.75,301700,147400,55.41553730616868,55.71338171472665,NaN,NaN,9.760460645273856,-8.273470244757863,-0.056656284629974796,0.1275544888990119,0.18421077352898668,11622801,11430361,37.7469303848068,48.27760049684037,NaN,NaN,7.750427824175354,12.36574327292845
2003-07-28T09:30:00-04:00,27.85001,27.94,27.7,27.89,81500,149690,57.4184387799359,55.0068820914068,NaN,NaN,61.11786492929953,6.689847325978756,-0.0324915516941259,0.1435963339113293,0.1760878856054552,11704301,11492421,40.91800673651277,47.248643250499406,NaN,NaN,8.73258353498957,11.846720453222895
2003-07-29T09:30:00-04:00,27.95,28.02,27.60001,27.71001,186300,155795,54.05621433364534,54.54694636846626,NaN,NaN,38.710880861921254,17.36817693503258,-0.028734205360448073,0.1401701289048951,0.16890433426534318,11518001,11507041,41.6717872091577,46.080180951472514,NaN,NaN,8.598998654277985,11.382760196230764
2003-07-30T09:30:00-04:00,27.71001,27.71001,27.47,27.53,20600,130455,50.84925915624388,54.293642792258574,NaN,NaN,-28.478786754177325,16.12828961006957,-0.037900565182691054,0.12152862778697937,0.15942919296967042,11497401,11532721,43.04628526375572,44.86508047710919,NaN,NaN,7.556141983709377,10.836100451584851
2003-07-31T09:30:00-04:00,27.7,28,27.55,27.59,216600,138925,51.87412080208742,53.755033426064635,NaN,NaN,8.386303146384545,17.89934456574037,-0.039283477373674214,0.11032484625257766,0.14960832362625187,11714001,11611301,47.1503066924956,43.752365215624295,NaN,NaN,6.977920784780968,10.284931927755725
2003-08-01T09:30:00-04:00,27.64999,27.64999,27.39999,27.56,183800,145635,51.298161678831974,53.054810409302675,NaN,NaN,-59.05873273465089,4.135505889755424,-0.04136943559004047,0.09789652913870128,0.13926596472874175,11530201,11592781,46.303441129655084,42.472717594170085,NaN,NaN,6.342120046157815,9.721673087527453
2003-08-04T09:30:00-04:00,27.31,27.46001,27,27.35001,50900,135080,47.33631721567186,52.2822823604212,NaN,NaN,-134.04246675086486,-34.896560446277455,-0.055178952056924746,0.07029227465758581,0.12547122671451055,11479301,11547781,44.22492558603153,41.595199423498336,NaN,NaN,4.684366066642607,9.002057798829618
2003-08-05T09:30:00-04:00,27.3,27.3,26.82001,26.89999,436800,143555,40.175329171738596,51.09746396963937,NaN,NaN,-197.013320454469,-82.0414007095555,-0.09080503989268976,0.01196492684864836,0.10276996674133812,11042501,11452681,40.12558439819181,40.849741986265904,NaN,NaN,0.9440112417956937,7.8509082906819145
2003-08-06T09:30:00-04:00,26.8,27.21001,26.8,26.99001,118000,144095,42.06342139471351,50.42569367485856,NaN,NaN,-174.40354912749004,-111.22635318421806,-0.10356669938959737,-0.026688407495658595,0.07687829189393877,11160501,11385301,37.475101843110465,40.273398835219076,NaN,NaN,-1.5951891925435093,6.501465793078283
2003-08-07T09:30:00-04:00,27.14999,27.27,26.98,27.22,72200,145405,46.692414420980455,49.89917309259916,NaN,NaN,-113.57014292885307,-135.61764239926558,-0.09215978302097036,-0.038321436882274185,0.053838346138696175,11232701,11289041,34.01800204684412,39.78450394426701,NaN,NaN,-2.4276142760227777,5.2258829260638455
2003-08-08T09:30:00-04:00,27.39999,27.53999,27.36,27.48,75400,145495,51.41802495990534,50.058679630526335,NaN,NaN,-24.472419322318046,-128.700379716799,-0.06407722204934811,-0.02625818142298897,0.03781904062635914,11308101,11244621,32.52682848664651,39.51154954904632,NaN,NaN,-1.7111471569702916,4.23487862848754
2003-08-11T09:30:00-04:00,27.45,27.64999,27.42999,27.60001,45000,144125,53.4684559117344,50.15050217117041,NaN,NaN,14.98875698672582,-98.89413496928087,-0.03580261415914604,-0.006934227072573407,0.028868387086572633,11353101,11219381,31.677137900485093,39.18103533690585,NaN,NaN,-0.5012539433941463,3.558288261075871
2003-08-12T09:30:00-04:00,27.7,27.97,27.55,27.97,76100,107090,59.187465008045315,50.78769723791787,NaN,NaN,108.765615077543,-37.73834786287846,0.0071449043528069925,0.03779951752758137,0.03065461317477438,11429201,11296721,37.09931803596267,39.257245024881506,NaN,NaN,2.396581381878034,3.39233013547618
2003-08-13T09:30:00-04:00,28.10001,28.10001,27.75999,27.87,136100,112240,57.14322098445332,51.314027223153964,NaN,NaN,132.9394247020934,23.73024690303822,0.02702779059320111,0.06443935141627577,0.03741156082307466,11293101,11323241,38.89022333905688,39.49099136090807,NaN,NaN,4.155924734709396,3.5014150782237823
2003-08-14T09:30:00-04:00,27.87,28.07001,27.66,28,58600,113920,59.11992965520019,51.578626676656214,NaN,NaN,120.62064870347,70.56840522950283,0.046028379286473665,0.09494703493116674,0.048918655644693075,11351701,11347041,40.526764581411285,39.68955094637982,NaN,NaN,6.218620701469954,3.8895873101160925
2003-08-15T09:30:00-04:00,28.10001,28.2,28,28.2,28400,114280,62.02211560028399,51.907460735252506,NaN,NaN,165.5001196712694,108.56291302822032,0.06784224719412582,0.13372146463735035,0.06587921744322453,11380101,11361441,41.54675271457758,39.73446137338444,NaN,NaN,8.865477503139426,4.600428766262283
2003-08-18T09:30:00-04:00,28.25,28.41,28.2,28.36,362700,131270,64.2110712837648,52.632807660261044,NaN,NaN,181.27101403286886,141.8193644374489,0.08756857225251091,0.17533993275886317,0.08777136050635226,11742801,11439381,46.859084357717414,40.10498259828156,NaN,NaN,11.765932571574915,5.624072167021231
2003-08-19T09:30:00-04:00,28.39999,28.53999,28.32001,28.39,138500,135650,64.62280417498124,53.616632304456566,NaN,NaN,168.91351147867414,153.84894371767513,0.09645649655387248,0.20834198119869285,0.11188548464482037,11881301,11529801,52.27768142009535,40.764368038020116,NaN,NaN,14.256932022860378,6.857337860712537
2003-08-20T09:30:00-04:00,28.48,28.63,28.35001,28.56,1176100,190660,66.94358918370516,54.69302290314355,NaN,NaN,161.61078092867191,159.58321496299087,0.10679983062465717,0.24538527292564183,0.13858544230098466,13057401,11882661,66.5933898252701,42.15315969036116,NaN,NaN,17.087676104046682,8.318814752617415
2003-08-21T09:30:00-04:00,28.64999,28.84,28.60001,28.78,273300,201930,69.71264257968345,56.00834296749008,NaN,NaN,173.02404151292325,170.0638935248815,0.12046063745290889,0.28916123911712077,0.16870060166421189,13330701,12278461,75.47900409566539,44.237128473647594,NaN,NaN,20.39504017641908,10.04398981316051
2003-08-22T09:30:00-04:00,28.95,28.98,28.38,28.39,593000,216495,60.101260857137724,56.92012465616621,NaN,NaN,126.02872717361781,162.1696150253512,0.09628132077984702,0.2890522526390207,0.19277093185917366,12737701,12549981,79.50608764613567,46.75721147794075,NaN,NaN,20.432282625838212,11.528031643543038
2003-08-25T09:30:00-04:00,28.37,28.44,28.19,28.3,84600,216650,58.110179159145,58.20118536955238,NaN,NaN,73.21576925800994,140.5585660703794,0.06857792205513999,0.27849333442809865,0.20991541237295866,12653101,12732041,81.6788072184631,49.72529882224585,NaN,NaN,19.859264878119188,12.71820781991106
2003-08-26T09:30:00-04:00,28.3,28.50999,28.08,28.49001,139000,214285,61.044407725038965,59.556970107432775,NaN,NaN,72.52946925897072,121.28175762643873,0.05783123600145276,0.2822044573747746,0.22437322137332186,12792101,12914201,83.55716633940011,53.0168748576951,NaN,NaN,20.251971802380336,13.79445981740667
2003-08-27T09:30:00-04:00,28.45,28.57001,28.33,28.53,86200,217565,61.653206986185396,60.62559814780455,NaN,NaN,80.95933186677885,105.15146781406011,0.048570312974014096,0.2850861125908395,0.2365157996168254,12878301,12878381,81.78159667656685,56.428560188389575,NaN,NaN,20.747488271367246,14.787749596543895
2003-08-28T09:30:00-04:00,28.60001,28.73,28.39999,28.73,200700,216770,64.63034143071405,61.569335038576604,NaN,NaN,90.02542978919205,88.55174546931389,0.05082687313488887,0.3000493910354365,0.2492225179005476,13079001,12828041,79.23339048818127,59.7647431884992,NaN,NaN,22.05058378702217,15.82529733804079
2003-08-29T09:30:00-04:00,28.66,29.10001,28.64999,29,130500,214105,68.21768801006358,62.62285161702869,NaN,NaN,116.12030017917824,86.57006007042597,0.0645354677571911,0.32989185259703646,0.26535638483984536,13209501,12922401,80.46227847929886,63.249396086985904,NaN,NaN,24.296024079912975,17.035401158308247
2003-09-02T09:30:00-04:00,29.25,29.42,28.92,29.39999,386000,230860,72.64420260677088,63.5840471597948,NaN,NaN,145.20254441891433,100.96741510260684,0.09285191726912007,0.38142128142624543,0.28856936415712536,13595501,13110881,82.66848090537567,66.50433629194399,NaN,NaN,27.7736955448731,18.569443213531798
2003-09-03T09:30:00-04:00,29.39999,29.45,29.25,29.39,112500,214645,72.37308698084045,64.6718947309653,NaN,NaN,150.42010598285216,116.54554244738313,0.10246429803712354,0.4166497367035298,0.31418543866640625,13483001,13249061,84.08715870515354,69.73268881809373,NaN,NaN,30.434413343522227,20.264438946387575
2003-09-04T09:30:00-04:00,29.42,29.52,29.25,29.48,84200,212955,73.33847151354294,65.68750486370409,NaN,NaN,150.51143194520878,130.4559624630691,0.10599702533440353,0.44668172033441067,0.34068469500000714,13567201,13386841,85.3728386521542,72.93597982314681,NaN,NaN,32.921167777801976,22.07254306516106
2003-09-05T09:30:00-04:00,29.25,29.39,29.03999,29.19,164400,217565,65.40734840553094,65.929307206936,NaN,NaN,111.51144500384295,134.7531655059993,0.08104165130377239,0.44198675912972263,0.36094510782595024,13402801,13451601,85.9475407931487,76.10746468590189,NaN,NaN,32.699687193149515,23.590706512016553
2003-09-08T09:30:00-04:00,29.17999,29.22,29.00999,29.2,104000,218995,65.5457154797933,66.02463893522375,NaN,NaN,92.23734658071697,129.97657478630703,0.05849927803946697,0.43406920537528393,0.37556992733581696,13506801,13511061,86.47305590167399,78.93703408189879,NaN,NaN,32.56128164518361,24.872217245326134
2003-09-09T09:30:00-04:00,29,29.02,28.59,28.63,85300,221010,52.624665830276726,65.16762905345915,NaN,NaN,23.496167435388635,105.6352993896019,0.001503458661835988,0.37744925066311197,0.375945792001276,13421501,13476261,84.4817642615262,81.23732571342956,NaN,NaN,28.133650138295994,25.338136230036113
2003-09-10T09:30:00-04:00,28.60001,28.60001,28.21001,28.27,97100,222060,46.402934398864886,63.70043942597056,NaN,NaN,-49.50066516738195,65.65114515955506,-0.0607010155172511,0.3000695226047121,0.3607705381219632,13324401,13444541,82.6143184607454,82.38167775882064,NaN,NaN,22.157941469395357,24.88382269280172
2003-09-11T09:30:00-04:00,28.35001,28.59,28.32001,28.5,64600,218485,50.43482355817845,62.32345235300592,NaN,NaN,-36.969150978989376,28.15502857471544,-0.08511854074765612,0.254372362187393,0.33949090293504913,13389001,13408901,80.46220018641498,82.73762033673133,NaN,NaN,18.586812855345315,23.984249858879377
2003-09-12T09:30:00-04:00,28.39999,28.48,28.08,28.39999,91700,220140,48.71864280422964,61.510408206369625,NaN,NaN,-73.1061791966753,-8.7684962653882,-0.10543839627564616,0.20769290759049142,0.3131313038661376,13297301,13387801,79.14764670213823,82.7120174121601,NaN,NaN,15.183030611688297,22.726932823566365
2003-09-15T09:30:00-04:00,28.55,28.64,28.46001,28.5,42700,220855,50.531428937524616,60.96906890482531,NaN,NaN,-35.94027551032755,-34.40402068359712,-0.10911958686555301,0.17673182028419632,0.2858514071497493,13340001,13354441,77.0055616071687,82.37821415421048,NaN,NaN,12.976386949886193,21.333997698754914
2003-09-16T09:30:00-04:00,28.64,28.97,28.60001,28.92,30100,204225,57.35004427515797,60.70518580126238,NaN,NaN,22.135523538461893,-34.67614946298246,-0.08150929066707119,0.18396479381591035,0.26547408448298154,13370101,13344161,76.32009020012651,81.86128014426238,NaN,NaN,13.224768085803044,20.175536325476074
2003-09-17T09:30:00-04:00,28.96001,29.05,28.78999,28.91,111700,202885,57.14806641852726,60.38339004642966,NaN,NaN,36.093228322560215,-17.557370764994026,-0.06298929339757237,0.18673746773601607,0.24972676113358844,13258401,13330961,75.39206791168664,81.40488523248521,NaN,NaN,13.357875716519382,19.201584809910834
2003-09-18T09:30:00-04:00,28.8,29.10001,28.75,29.10001,24600,145310,60.02864677324942,60.05469757089647,NaN,NaN,45.380150013779506,-1.0875105664402482,-0.038230031966865446,0.20193922117500662,0.24016925314187207,13283001,13309761,73.83913482051358,81.01958125622323,NaN,NaN,14.353096240149329,18.50894358565919
2003-09-19T09:30:00-04:00,29,29,28.78,28.89,31400,133215,55.5814376908855,59.152108262383756,NaN,NaN,22.89852804028024,18.113430880950858,-0.03629924993583439,0.19479519072207907,0.23109444065791346,13251601,13300621,73.13965528013559,80.49653674199729,NaN,NaN,13.843335509382923,17.84242814619115
2003-09-22T09:30:00-04:00,28.55,28.57001,28.3,28.45,85800,107855,47.62118933992218,57.36475017189457,NaN,NaN,-71.69369364584782,10.962747253846809,-0.06337282248415269,0.1518784125527226,0.2152512350368753,13165801,13265781,70.40193152064955,79.62035464308828,NaN,NaN,10.76877303506878,16.831905987459383
2003-09-23T09:30:00-04:00,28.5,28.8,28.5,28.71001,60600,106655,51.99634219513416,55.909268401486976,NaN,NaN,-28.2811848002479,0.8794055861048484,-0.062389078834691,0.13726488649351154,0.19965396532820254,13226401,13237041,68.13620262948456,78.48100063768335,NaN,NaN,9.619498304909136,15.801562032809347
2003-09-24T09:30:00-04:00,28.8,28.8,28.14999,28.14999,202600,109835,43.557242052735944,53.78203772571504,NaN,NaN,-96.82450872233427,-25.70414182287405,-0.09606132395039119,0.07957731039021354,0.17563863434060473,13023801,13190121,64.4873698918318,76.98918144051746,NaN,NaN,5.596525431252512,14.343699661158372
2003-09-25T09:30:00-04:00,28.14999,28.45,28.03999,28.03999,256700,118360,42.11147722611282,52.118046927185176,NaN,NaN,-129.72055630017144,-60.72428308566424,-0.12075194843659215,0.024698698794864526,0.14545064723145668,12767101,13086941,57.229366423515714,74.93788327125796,NaN,NaN,1.9650358502108258,12.575319116737294
2003-09-26T09:30:00-04:00,27.96001,27.97,27.66,27.73,456800,131165,38.257625711377244,50.16889765801261,NaN,NaN,-179.92933169240032,-101.28985503220035,-0.15100642025104238,-0.043307378082346304,0.10769904216869608,12310301,12898681,46.86508630917178,72.10874258607923,NaN,NaN,-2.381226595325304,10.43866972929978
2003-09-29T09:30:00-04:00,27.85001,27.85001,27.38,27.69,119700,130625,37.777205444670436,49.10836477332644,NaN,NaN,-172.98771329565693,-121.54865896216218,-0.16558790914420082,-0.09928584426155496,0.06630206488264587,12190601,12703641,38.98745866735339,68.8591493293526,NaN,NaN,-5.938411461382078,8.099086702059516
2003-09-30T09:30:00-04:00,27.7,27.82001,27.39999,27.58,115600,117105,36.422663720104445,48.39548829627212,NaN,NaN,-156.25496984001953,-147.1434159701165,-0.17367131836319388,-0.15078708307134647,0.022884235291847396,12075001,12473361,32.122048654439,65.25255862890215,NaN,NaN,-9.257485153530604,5.619576436975214
2003-10-01T09:30:00-04:00,27.82001,28.39999,27.82001,28.34,1702300,196595,49.81221879226683,48.35101652727844,NaN,NaN,-57.977110213934154,-139.37393626843647,-0.12134091187666887,-0.1287919045539887,-0.007450992677319829,13777301,12624061,39.6159121349801,62.33496662522822,NaN,NaN,-7.816276878176168,3.7001688205250165
2003-10-02T09:30:00-04:00,28.25,28.5,28.19,28.49001,188400,201805,51.96269079304331,48.582734240765134,NaN,NaN,-16.72987759328739,-116.77580052705966,-0.07253911876517842,-0.09812489113379286,-0.025585772368614434,13965701,12863781,49.2198014389557,60.19726339214376,NaN,NaN,-5.952265012071193,2.321249701582701
2003-10-03T09:30:00-04:00,28.92,29.13,28.75,28.81,471700,217170,56.26738334027039,48.99244526953269,NaN,NaN,84.02646299273216,-63.98464159003316,-0.017494204972053087,-0.04745352858368079,-0.029959323611627706,14437401,13289201,61.05707158739703,59.058085533588645,NaN,NaN,-2.9380874380417232,1.5699158244934979
2003-10-06T09:30:00-04:00,28.92999,29.11,28.75,29.02,156200,219780,58.872139960397185,49.10116638990691,NaN,NaN,100.93854559386754,-9.199389812128269,0.03159879856507051,0.009539174594710431,-0.022059623970360077,14593601,13769801,69.66118806280744,58.58244966663728,NaN,NaN,0.38076785822334447,1.4000375435977617
2003-10-07T09:30:00-04:00,28.78,29.16,28.74001,29.14,347300,232880,60.326296191304586,49.32818280224814,NaN,NaN,104.72069515940258,42.99574318775616,0.06857211389633998,0.06365551840006489,-0.004916595496275083,14940901,14342981,76.36744630335413,58.65211955175639,NaN,NaN,3.5178959081961065,1.7025887385403824
2003-10-08T09:30:00-04:00,29.17999,29.17999,28.88,28.92999,23200,229185,56.557451837990875,49.08024030687254,NaN,NaN,89.95143951706035,72.58145313395505,0.07479408421763407,0.08857600977576752,0.01378192555813344,14917701,14571061,78.41232879914418,58.97877626451571,NaN,NaN,4.987484825451698,2.1718596080991417
2003-10-09T09:30:00-04:00,29.37,29.63,29.22,29.3,244400,238175,61.1613322531382,49.4788042041763,NaN,NaN,137.36771836016786,103.40097232464612,0.0982605917939719,0.1366076653005983,0.03834707350662642,15162101,14810341,80.3348004359345,59.49271520421563,NaN,NaN,7.745296656284332,2.9680649006970263
2003-10-10T09:30:00-04:00,29.39999,29.5,29.25,29.36,115400,239360,61.86705092599338,50.49636574603853,NaN,NaN,119.35261559817386,110.46620284573444,0.11129741841096323,0.17746884652033046,0.06617142810936723,15277501,14978361,81.57556020127453,60.29083153854599,NaN,NaN,10.170574464020445,3.9969948383146576
2003-10-13T09:30:00-04:00,29.39999,29.77,29.39999,29.66,402100,257330,65.26551609091199,51.444163881451225,NaN,NaN,136.7276870116368,117.6240311292883,0.13217628105206247,0.23139177942444533,0.09921549837238286,15679601,15195561,83.0632202739955,61.35704708458248,NaN,NaN,13.325794216547354,5.329680463776471
2003-10-14T09:30:00-04:00,29.67999,29.82001,29.52,29.82001,51100,258380,66.95701697955997,53.115576376224375,NaN,NaN,134.92145455380125,123.66418300816804,0.1476407842283959,0.28376647865787774,0.13612569442948183,15730701,15353521,84.07057297990261,62.75584730515897,NaN,NaN,16.464627764060857,6.920387220959955
2003-10-15T09:30:00-04:00,29.89999,29.89999,29.50999,29.7,190400,262315,64.42301236202907,54.709257457361254,NaN,NaN,119.14390475013518,129.502676054783,0.14069427154126324,0.3119935338560609,0.17129926231479764,15540301,15478041,84.83623051712848,64.72776616898845,NaN,NaN,18.329306663057352,8.550232855545298
2003-10-16T09:30:00-04:00,29.60001,29.91,29.59,29.83,60700,264120,65.92729193139216,56.68566218736231,NaN,NaN,115.65148327035114,125.15942903681966,0.13569949938475015,0.3409236365457353,0.20522413716098517,15601001,15565821,85.37007843498591,67.47812274940375,NaN,NaN,20.33021122415895,10.233086908204392
2003-10-17T09:30:00-04:00,29.83,29.85001,29.36,29.41,373500,281225,57.472378309406345,58.09246024912916,NaN,NaN,80.36222727613908,117.3613513724127,0.0967808728832501,0.3262002282650478,0.2294193553817977,15227501,15555821,85.00293698577283,70.76494262929086,NaN,NaN,19.56676638248862,11.566469690244995
2003-10-20T09:30:00-04:00,29.39999,29.47,29.25,29.38,29300,278400,56.91094729441621,59.55590907586571,NaN,NaN,56.137865239276834,101.2433870179407,0.06330791610660008,0.3085542505150478,0.24524633440844773,15198201,15459541,81.37436202689929,74.28296501303802,NaN,NaN,18.786884348185644,12.59795749852223
2003-10-21T09:30:00-04:00,29.45,29.56,29.33,29.47,105400,280640,58.22925087999882,60.157125653560854,NaN,NaN,60.510505905081146,86.36119728819669,0.042516735430443264,0.2983922536965018,0.25587551826605853,15303601,15374121,78.18549417717333,77.03793515890895,NaN,NaN,18.50504572443669,13.44182724508144
2003-10-22T09:30:00-04:00,29.14999,29.2,28.95,29.06,264300,283725,50.62982256145034,60.06192077987565,NaN,NaN,15.720512960668389,65.67651893030333,-0.0012415817750447422,0.25432354104725263,0.2555651228222974,15039301,15273921,74.49755473590525,78.84348896583393,NaN,NaN,15.939987092177644,13.79870722323804
2003-10-23T09:30:00-04:00,28.97,29.14999,28.89,29.06,98900,275835,50.62982256145034,59.65923786710279,NaN,NaN,7.252728943400429,43.9967680649132,-0.030933299933386393,0.21689849790556437,0.24783179783895076,15039301,15161581,70.48338502041113,79.51679706819209,NaN,NaN,13.876504471077688,13.80982111578656
2003-10-24T09:30:00-04:00,28.89999,29.09,28.67999,29.09,189000,262445,51.170611463551396,59.10912868875666,NaN,NaN,-11.445370250820456,25.63524855952129,-0.048266824232944344,0.18749826754777033,0.23576509178071467,15228301,15161741,70.48582426088488,79.57569965376904,NaN,NaN,12.315976437088736,13.596414733115443
2003-10-27T09:30:00-05:00,29.22,29.49001,29.22,29.41,348200,273870,56.62801187885438,58.84496552358165,NaN,NaN,41.22644819120763,22.652965149907427,-0.03832868769082248,0.18785423216718655,0.22618291985800903,15576501,15237401,71.67774383361488,79.24072090593053,NaN,NaN,12.454232414229567,13.43324583041746
2003-10-28T09:30:00-05:00,29.7,30.07001,29.53,30.07001,81700,272175,65.25377268672834,59.46613129849147,NaN,NaN,121.14864222688693,34.78059241426858,0.00996782669445434,0.23864270322607695,0.2286748765316226,15658201,15308321,72.78711764653941,78.83892010931591,NaN,NaN,15.435915911254044,13.719341556251258
2003-10-29T09:30:00-05:00,30,30.11,29.89,30.00999,70700,190595,64.0071170468669,59.66940164090067,NaN,NaN,137.55230090153384,59.14695000244168,0.03380149492431425,0.2709267451870154,0.23712525026270118,15587501,15417961,74.45311029189233,78.41879938474146,NaN,NaN,17.415756392991778,14.247400818642761
2003-10-30T09:30:00-05:00,30.25,30.3,29.86,30.11,95400,185945,65.20014450819943,59.90747975391538,NaN,NaN,146.42882739561617,86.98216969288482,0.051188625132637944,0.3011110316784986,0.24992240654586068,15682901,15546681,76.28846453974371,78.04114969463213,NaN,NaN,19.39692137739971,14.983046612750897
2003-10-31T09:30:00-05:00,30.17999,30.17999,29.95,30.09,170800,170900,64.73801422157587,59.8698010489628,NaN,NaN,126.46850773779302,114.56494529060751,0.055848301037035974,0.31973278284215567,0.2638844818051197,15512101,15603441,77.07072822434817,77.61311454822874,NaN,NaN,20.871970979757684,15.824321522323295
2003-11-03T09:30:00-05:00,30.3,30.44,30.21001,30.32001,64870,166333.5,67.58366252507511,59.91456144507102,NaN,NaN,156.0638754728706,137.5324307469401,0.06811415180088265,0.349027171556223,0.28091301975534033,15576971,15603535,77.07207727529405,77.11322199789956,NaN,NaN,22.995337239326467,16.848752339038032
2003-11-04T09:30:00-05:00,30.19,30.32001,30.10001,30.14,58800,151908.5,63.27965373534318,59.83289297173632,NaN,NaN,115.22933066147445,136.34856843385762,0.058182644996587485,0.3536413260010747,0.2954586810044872,15518171,15575529,75.64410075188073,76.45664130038186,NaN,NaN,23.56886228123691,17.808768045066444
2003-11-05T09:30:00-05:00,30.14999,30.16,29.85001,30.11,150500,158273.5,62.56454998234914,59.59269711823324,NaN,NaN,78.55741248606918,124.54959075076468,0.04429956823278142,0.35083314129546395,0.30653357306268253,15367671,15531563,73.34660573384663,75.59782182172906,NaN,NaN,23.840913632521982,18.670503128988663
2003-11-06T09:30:00-05:00,30.10001,30.33,29.95,30.33,26600,147383.5,65.6317914547796,60.17551234290276,NaN,NaN,99.93806811108892,115.25143889385924,0.0445209460751706,0.36218475565664576,0.31766380958147517,15394271,15473837,70.32639622918708,74.54949748197294,NaN,NaN,24.953318154953642,19.568048132697946
2003-11-07T09:30:00-05:00,30.48,30.62,30.36,30.41,65300,144878.5,66.70025046548793,60.8747482836936,NaN,NaN,132.77933732655754,116.51360481161214,0.044535172647485466,0.373332775390832,0.3287976027433465,15459571,15463331,69.76336165596612,73.72014031262056,NaN,NaN,26.18605838095935,20.51347816816386
2003-11-10T09:30:00-05:00,30.25,30.32001,30.05,30.05,102000,129873.5,57.96694622391962,60.8560122368308,NaN,NaN,66.31131318552056,98.56309235414213,0.016237538289698317,0.3490945256054694,0.33285698731577107,15357571,15419451,67.33846185327329,72.94535228948484,NaN,NaN,24.713490724668777,21.113479961950276
2003-11-11T09:30:00-05:00,30.14999,30.14999,29.95,30,119600,133298.5,56.85352194907564,61.30056219308975,NaN,NaN,43.39170543161859,84.19556730817096,-0.008575546105327514,0.32213755468411165,0.33071310078943916,15237971,15363411,64.26615285840751,72.21453786966357,NaN,NaN,23.183139893996067,21.409145666528246
2003-11-12T09:30:00-05:00,30.14999,30.32001,30.07001,30.3,296600,138608.5,61.617301951925924,62.085382149552295,NaN,NaN,70.86801919624624,82.65768865020638,-0.007548111464570351,0.3212779614587262,0.3288260729232966,15534571,15396791,65.28222938599279,71.8430267529194,NaN,NaN,23.226551763790038,21.668775108994218
2003-11-13T09:30:00-05:00,30.21001,30.21001,30.03,30.19,78800,139513.5,59.043162497763184,62.64770722342457,NaN,NaN,51.83457315758425,73.03698965950545,-0.016526238420238926,0.3081682748979979,0.32469451331823684,15455771,15409091,65.66960202652959,71.49901087903689,NaN,NaN,22.50454095022799,21.788170229170472
2003-11-14T09:30:00-05:00,30.25,30.34,29.85001,29.86,453900,143533.5,52.021809812392014,62.31869279010583,NaN,NaN,27.921372320262307,52.0653966582464,-0.045307228693555135,0.2680604774512929,0.31336770614484805,15001871,15317551,60.279041433533514,70.68481785045965,NaN,NaN,19.672761609353735,21.48596899776808
2003-11-17T09:30:00-05:00,29.67,29.75,29.36,29.59,255200,154828.5,47.08786091885428,61.02112766382912,NaN,NaN,-53.11689811076618,28.179754398989054,-0.08105919881272938,0.21204370762893632,0.2931029064416657,14746671,15195371,53.91735809358092,69.33697788239117,NaN,NaN,15.648645416382143,20.65206562899866
2003-11-18T09:30:00-05:00,29.73,29.77,29.21001,29.21001,173900,158253.5,41.169780908098154,59.38988936820277,NaN,NaN,-82.07424959668718,3.0865633933278955,-0.12614082123061632,0.1354268799033953,0.2615677011340116,14572771,15062331,47.979519313697914,67.44600709823443,NaN,NaN,10.113607959528462,19.146571676217203
2003-11-19T09:30:00-05:00,29.14999,29.46001,29.09,29.39999,177900,153933.5,44.89846803187924,57.93976961989419,NaN,NaN,-103.09321905840463,-31.70568425760228,-0.13804518152953663,0.08901122422209085,0.22705640575162747,14750671,14905551,42.09604097881747,65.00369112959685,NaN,NaN,6.763013475098166,17.377491933200197
2003-11-20T09:30:00-05:00,29.33,29.67999,29.25,29.37,122600,155118.5,44.41985351721378,56.488472426725465,NaN,NaN,-92.28090161770405,-60.52877921265995,-0.1422539690623654,0.049238944423670716,0.19149291348603611,14628071,14740011,36.94462622853247,62.13754098703858,NaN,NaN,3.9607376778255965,15.460812753860969
2003-11-21T09:30:00-05:00,29.44,29.53999,29.27,29.5,34900,147413.5,47.0545729102872,55.02210888281204,NaN,NaN,-106.51428790608927,-87.41591125793026,-0.13088427547156892,0.027887569146574975,0.1587718446181439,14662971,14672231,35.0531718003721,59.13619059597272,NaN,NaN,2.410805745649724,13.596526038402219
2003-11-24T09:30:00-05:00,29.75,30.10001,29.72,30.09,161800,138093.5,57.01401306164628,54.57456312040512,NaN,NaN,5.583252843990802,-75.67588106697886,-0.0806918727482808,0.05790700368279289,0.1385988764310737,14824771,14687851,35.868032397502034,56.29504285637425,NaN,NaN,4.290153998512484,12.267044318417971
2003-11-25T09:30:00-05:00,29.95,30.42,29.95,30.38,87900,138403.5,60.906618438644585,54.45613943871193,NaN,NaN,70.70970481773814,-45.11909018409379,-0.02775870279639478,0.1039004979355802,0.13165920073197498,14912671,14755831,39.42982799324049,53.87241587490238,NaN,NaN,7.18999772117721,11.541751947383577
2003-11-26T09:30:00-05:00,30.5,30.5,30.05,30.37,245200,147128.5,60.7024885226636,54.104046372132224,NaN,NaN,78.49228717334935,-8.801988937743,0.005035451273479208,0.137953514823824,0.1329180635503448,14667471,14739191,38.86089118883612,51.6248798005916,NaN,NaN,9.379730677204137,11.232891765929372
2003-11-28T09:30:00-05:00,30.45,30.45,30.35001,30.36,31800,143948.5,60.48418102240887,53.66004141191228,NaN,NaN,91.26306768693956,27.906804923185724,0.023476259787950093,0.16226338828528242,0.13878712849733232,14635671,14740711,38.94755088982659,49.423750460153066,NaN,NaN,11.061716468585187,11.20843815202306
2003-12-01T09:30:00-05:00,30.60001,30.66,30.36,30.64999,61300,138473.5,64.47418985532991,54.12484452844159,NaN,NaN,119.12558784123296,73.03478007265016,0.05104512554833196,0.20259353543274727,0.1515484098844153,14696971,14747511,39.36164163637979,47.42540615894638,NaN,NaN,13.773664326083907,11.574899034031752
2003-12-02T09:30:00-05:00,30.55,30.59,30.39,30.42,1550700,212765,59.35533033818537,54.30354512766371,NaN,NaN,95.9550860425349,91.10914671235898,0.04958982425364483,0.21353569020147134,0.1639458659478265,13146271,14411811,28.929729505467606,44.90137591945067,NaN,NaN,14.535001044730201,11.997770749845817
2003-12-03T09:30:00-05:00,30.55,30.64,30.3,30.3,100500,214850,56.82049749697426,53.96091623802431,NaN,NaN,79.63283958008233,92.89377366482782,0.03692530624187271,0.2101024987501674,0.1731771925082947,13045771,14038431,21.95888500310474,41.806851320672955,NaN,NaN,14.407509566686052,12.342019152251565
2003-12-04T09:30:00-05:00,30.39999,30.39999,29.84,30.23,65800,210615,55.33593552102172,53.69611431111421,NaN,NaN,23.51460389146252,81.89823700845047,0.02100568626048574,0.19943430033390186,0.17842861407341612,12979971,13700931,17.786853654127057,38.38665500835849,NaN,NaN,13.87321291841263,12.560761118846003
2003-12-05T09:30:00-05:00,30.10001,30.11,29.78999,29.92,45100,211540,49.20469714783151,53.49489197793131,NaN,NaN,-19.157487044024744,59.81412606225759,-0.011483751312543478,0.16407392493273676,0.17555767624528024,12934871,13360771,14.745941151712415,35.13429070251412,NaN,NaN,11.53510066528921,12.414238196909318
2003-12-08T09:30:00-05:00,29.95,30.05,29.77,30.05,70900,211820,51.62531077762108,53.818995539271796,NaN,NaN,-10.817844171530385,33.82543965970493,-0.024549733665535145,0.1448705091633613,0.16942024282889645,13005771,13022531,12.464070177494875,32.17334156565083,NaN,NaN,10.293420666511398,12.111264263995329
2003-12-09T09:30:00-05:00,30.14999,30.2,29.89999,29.89999,202400,216840,48.739018912733655,54.359655396745765,NaN,NaN,0.2600313830960817,14.686428727817162,-0.042570160432669896,0.11620754228805907,0.15877770272072897,12803371,12953951,12.056686381668186,29.607424927648708,NaN,NaN,8.388832800153386,11.579488340589338
2003-12-10T09:30:00-05:00,29.8,30.02,29.64,29.75999,134300,217575,46.146008753313,54.448765448276745,NaN,NaN,-39.344350273575316,-9.109009242914373,-0.062015435605077995,0.08125840821438146,0.14327384381945946,12669071,12878611,11.607829683351412,27.429695549401135,NaN,NaN,6.014272369552703,10.784457487584104
2003-12-11T09:30:00-05:00,29.73,30.37,29.73,30.22,129700,209230,54.67816568370803,55.18150203159776,NaN,NaN,27.77169350339306,-8.25759132052826,-0.04290184250826462,0.0896465406841287,0.13254838319239332,12798771,12842371,11.388204438944399,25.604236850144844,NaN,NaN,6.509346315982856,10.173727320212498
2003-12-12T09:30:00-05:00,30.39999,30.42,30.19,30.38,85600,209570,57.21708392166578,55.90739567526766,NaN,NaN,73.14808392810286,10.203522873897267,-0.019670419268280226,0.10796035910704305,0.12763077837532327,12884371,12832271,11.323899385924292,23.90928882054143,NaN,NaN,7.717812948772829,9.82288241000683
2003-12-15T09:30:00-05:00,30.85001,30.85001,30.23,30.25,213600,197555,54.543508970340916,55.730931097317274,NaN,NaN,87.22679726302924,29.81245116080919,-0.013538139107217309,0.11070810449130164,0.12424624359851895,12670771,12765271,10.88481401215148,22.12477322158782,NaN,NaN,7.90298131701407,9.54861082529358
2003-12-16T09:30:00-05:00,30.25,30.25,29.95,30.17999,254300,197510,53.10438426131663,55.173628656079565,NaN,NaN,18.617376647849476,33.48392021375987,-0.014585457011800751,0.10601442233376801,0.12059987934556876,12416471,12687891,10.384022240580975,20.050072810683567,NaN,NaN,7.632465506736434,9.274875779785416
2003-12-17T09:30:00-05:00,30.25,30.46001,30.10001,30.46001,48200,191225,57.890162575222774,54.97274823126236,NaN,NaN,59.408530209411914,53.234496310357315,0.002293434316129911,0.12346667224073116,0.12117323792460125,12464671,12647011,10.119143696875767,17.997090846972114,NaN,NaN,8.851821711649642,9.214439484337449
2003-12-18T09:30:00-05:00,30.53,30.87,30.41,30.85001,64900,185575,63.48013580322343,55.186745001320546,NaN,NaN,139.95348127233117,75.67085386414495,0.036536746394102926,0.16684417091722992,0.130307424523127,12529571,12593171,9.76582316631945,15.912681723864464,NaN,NaN,11.765283124006737,9.578845718575918
2003-12-19T09:30:00-05:00,30.89999,30.89999,30.62,30.86,79200,183405,63.613381571210084,55.125258695311985,NaN,NaN,150.1864263248453,91.07852234349343,0.05553402492694848,0.1997249556818126,0.1441909307548641,12608771,12538051,9.403815272170021,13.772836983563765,NaN,NaN,14.106121489125128,10.225599400082949
2003-12-22T09:30:00-05:00,30.85001,31.03,30.78,30.96001,292000,196260,64.99050460997205,55.527771143296754,NaN,NaN,174.89754887881705,108.612672666651,0.06959780908693122,0.23118819211352815,0.16159038302659692,12900771,12584051,12.324734716652188,12.58676592721981,NaN,NaN,16.457673886729207,11.115895755318128
2003-12-23T09:30:00-05:00,31,31.17,30.94,31.06,157000,196020,66.36128617168362,56.20925604863313,NaN,NaN,182.50979108127694,141.3911555533365,0.07967222390833129,0.26118066291201103,0.18150843900367974,13057771,12712311,20.063519700120665,12.451382691292375,NaN,NaN,18.826527903586037,12.217414633642115
2003-12-24T09:30:00-05:00,30.98,31.00999,30.85001,30.94,35400,193395,63.164841617116636,56.76846362692562,NaN,NaN,129.5656877554543,155.42258706254498,0.07249722486554822,0.272129970085615,0.1996327452200668,13022371,12823851,26.1669058591321,13.049957848792731,NaN,NaN,19.93563908406434,13.320018126559575
2003-12-26T09:30:00-05:00,31,31.17,31,31.08,11800,181725,65.26682071004817,57.91575816708396,NaN,NaN,139.98241464702335,155.42837373748338,0.07131410944776456,0.2887753820297725,0.21746127258200793,13034171,12924771,31.2795230582462,14.230927984973716,NaN,NaN,21.48726499167919,14.48676767871952
2003-12-29T09:30:00-05:00,31.25,31.36,31.07001,31.36,122000,186235,69.0685470377826,59.16170361423836,NaN,NaN,148.61365436739368,155.11381934599308,0.08272054512293808,0.3208619539856805,0.23814140886274243,13156171,13034251,36.42275535927936,15.942262640815462,NaN,NaN,24.02088039268496,15.848783780714582
2003-12-30T09:30:00-05:00,31.39999,31.39999,31.2,31.25999,39200,185130,66.27808361506357,60.41449395011907,NaN,NaN,130.12288995635546,146.15888756150076,0.07698003603437586,0.3343664539057123,0.2573864178713364,13116971,13077491,38.38420696639259,17.822799825438636,NaN,NaN,25.328013618535834,17.202959471831903
2003-12-31T09:30:00-05:00,31.42,31.57001,31.28,31.49001,144500,114820,69.34565649147761,62.071611645702255,NaN,NaN,132.14740271106612,136.0864098874586,0.08167937164775596,0.3594856324310314,0.2778062607832754,13261471,13118231,40.25446434763914,19.8689880157449,NaN,NaN,27.39471074212411,18.658923939016503
2004-01-02T09:30:00-05:00,31.62,31.77,31.14999,31.22,63800,112985,62.19365413134033,62.60843224910457,NaN,NaN,106.97405920182311,131.56808417673236,0.060578942480001174,0.3535299388832769,0.2929509964032757,13197671,13153291,41.88917885845106,22.047629045709666,NaN,NaN,27.003617053243506,19.851022955334646
2004-01-05T09:30:00-05:00,31.39999,31.53,31.21001,31.49001,178200,118605,65.97300071434186,63.23385487715286,NaN,NaN,100.0601904376704,123.58363933486177,0.0587385830867575,0.3663742252617226,0.3076356421749651,13375871,13221631,45.04554317024623,24.456317887446946,NaN,NaN,27.855209464678993,20.994478170955265
2004-01-06T09:30:00-05:00,31.49001,31.64999,31.39999,31.61,84800,120590,67.52656809496935,64.16121624319776,NaN,NaN,109.46874525916738,115.75465751321649,0.05935873394068947,0.38183405960082695,0.3224753256601375,13460671,13282531,47.76819523839899,27.090845117893195,NaN,NaN,29.03391890306831,22.14296970411427
2004-01-07T09:30:00-05:00,31.5,31.77,31.36,31.75,71200,120605,69.28844634804146,65.31722067796382,NaN,NaN,109.99740824024767,111.72956116999494,0.06263027650833691,0.4007631712955586,0.3381328947872217,13531871,13365511,51.30806345819138,30.01399091915108,NaN,NaN,30.55390330321652,23.344531646843166
2004-01-08T09:30:00-05:00,31.72,31.86,31.55,31.64999,170300,119000,66.51225465000059,65.93308439759079,NaN,NaN,110.20579052742,107.34123873326573,0.05193253580694113,0.4030485645458981,0.351116028738957,13361571,13385531,52.15062886213109,33.016239859526465,NaN,NaN,30.993130549262972,24.437188632903137
2004-01-09T09:30:00-05:00,31.39999,31.78999,31.39999,31.52,187200,121645,62.98007332787234,65.89736564935143,NaN,NaN,87.3243233532552,103.41129156355214,0.03100829391201232,0.3898763961289724,0.3588681022169601,13174371,13380871,51.92539539889035,36.02763787613867,NaN,NaN,30.326653312160435,25.278540729939895
2004-01-12T09:30:00-05:00,31.5,31.53,31.27,31.45,59400,118130,61.09840122798331,65.7177241962638,NaN,NaN,58.46591066508326,95.0924356090347,0.008528910003294754,0.36952923972107854,0.3610003297177838,13114971,13328691,49.35495821584605,38.8812909435441,NaN,NaN,29.233168271632525,25.84348752161027
2004-01-13T09:30:00-05:00,31.55,31.59,31.31,31.39999,97100,118705,59.72548522198064,65.34165138283585,NaN,NaN,55.592617700280606,84.31721009725734,-0.01249052435304443,0.34538717427647825,0.3578776986295227,13017871,13240131,45.25990943290017,41.23380342327609,NaN,NaN,27.938662411521857,26.14279822016907
2004-01-14T09:30:00-05:00,31.7,31.74001,31.52,31.64999,281600,122105,64.07176645590113,65.17811426027995,NaN,NaN,86.15581519194446,79.5488914875967,-0.012318611378438704,0.3424794344064743,0.35479804578491303,13299471,13193651,43.232453742781516,42.88872728346616,NaN,NaN,28.010488176882003,26.40961107112806
2004-01-15T09:30:00-05:00,31.64999,31.88,31.46001,31.74001,92300,114005,65.51488775051362,65.34597469837975,NaN,NaN,95.97119437420555,76.70197225695381,-0.009054857654034687,0.34347947371736964,0.35253433137140433,13391771,13199691,43.58610829612618,44.13295602896574,NaN,NaN,28.48014620276878,26.705401804219594
2004-01-16T09:30:00-05:00,31.89999,31.89999,31.66,31.74001,48600,114025,65.51488775051362,65.36369377269871,NaN,NaN,110.30482657066139,81.29807290043505,-0.009748517654565247,0.34034868430319776,0.350097201957763,13391771,13243171,46.18518024311017,45.197645827884585,NaN,NaN,28.865645670376168,27.01400807081339
2004-01-20T09:30:00-05:00,31.88,31.88,31.45,31.50999,183700,119965,58.54604751523849,64.61208666394555,NaN,NaN,67.70451536626352,83.1457938406711,-0.027543365294272815,0.31566799533992196,0.3432113606341948,13208071,13261791,47.30481910860396,45.97493609569349,NaN,NaN,27.23000609592977,27.0448649315443
2004-01-21T09:30:00-05:00,31.7,31.98,31.49001,31.89999,142100,123110,65.28797592435112,64.54136468603753,NaN,NaN,114.58956238503339,94.94518277762165,-0.015493065902107694,0.32384502825656014,0.33933809415866784,13350171,13328251,51.20692963609143,46.89084485781484,NaN,NaN,27.784492630777045,27.15052603143469
2004-01-22T09:30:00-05:00,32,32.21001,32,32.14999,140600,115540,68.79183412316381,64.50180594544368,NaN,NaN,193.76367751921424,116.46675524307561,0.005732735743383677,0.3465040138378974,0.34077127809451374,13490771,13366511,53.348647307372886,47.82614364065296,NaN,NaN,29.393648925118594,27.47097215910382
2004-01-23T09:30:00-05:00,32.25,32.34,31.89999,32.05,61800,110780,65.92553513446515,64.7683688742383,NaN,NaN,167.84824756136382,130.84216588050725,0.009248262622092107,0.3523316063721289,0.3430833437500368,13428971,13373951,53.77356724249698,48.675028525227674,NaN,NaN,29.81347305902638,27.805615144807042
2004-01-26T09:30:00-05:00,32.10001,32.17999,31.82001,32.11,60100,112015,66.81895183822436,64.82879395451563,NaN,NaN,139.27912768356742,136.6370261030885,0.011668152026849732,0.357668533783599,0.34600038175674924,13489071,13393411,54.929908156765734,49.38105459569335,NaN,NaN,30.422104556352735,28.179399346456428
2004-01-27T09:30:00-05:00,32.2,32.24001,31.83,31.89,64400,114645,60.54999539684225,64.33046733322085,NaN,NaN,112.44803263080406,145.58572955599658,-0.004621077459958878,0.34022403493180065,0.3448451123917595,13424671,13436731,57.47979637719723,50.074740391321804,NaN,NaN,29.029734471894315,28.300875792947554
2004-01-28T09:30:00-05:00,31.95,31.95,31.10001,31.13,129800,115035,44.88387305682301,62.58728352670524,NaN,NaN,-84.63773557349344,105.74026996429123,-0.06623391797701872,0.2620527149204861,0.3282866328975048,13294871,13425671,56.599364782368724,50.4526904859059,NaN,NaN,21.785751082146966,27.370143691404614
2004-01-29T09:30:00-05:00,31.05,31.39999,30.96001,31.33,261900,126170,48.64914352099441,61.31134701749052,NaN,NaN,-136.60804827244476,39.66592480595942,-0.0916089551515138,0.21377543895811257,0.30538439410962637,13556771,13438871,57.4373049421955,50.8303102059105,NaN,NaN,17.3837058392005,25.943509712518313
2004-01-30T09:30:00-05:00,31.35001,31.39999,31.12,31.31,194300,128660,48.29384455050687,60.26233067625013,NaN,NaN,-114.52139658310887,-16.808004022935116,-0.1067717285553666,0.1719197334154181,0.2786914619707847,13362471,13425571,56.25869801419923,51.139831821289704,NaN,NaN,13.907665358911961,24.224103376288834
2004-02-02T09:30:00-05:00,31.3,31.45,31,31.22,240300,137485,46.64301379399581,59.229803002393886,NaN,NaN,-124.81946330597401,-69.62772222084341,-0.11896267733523955,0.12998811530173526,0.2489507926369748,13122171,13352191,50.144882827256474,51.196255007819026,NaN,NaN,10.592657611931187,22.276753981380597
2004-02-03T09:30:00-05:00,31.25,31.31,31.05,31.05,58000,131475,43.61056431977024,58.07873722366457,NaN,NaN,-138.6541094009911,-119.84815062720244,-0.13348614743507264,0.08209310834313399,0.21557925577820664,13064171,13280091,44.97334121173256,51.175785849164185,NaN,NaN,6.866314780456059,20.075262666962807
2004-02-04T09:30:00-05:00,31.05,31.2,30.87,31.00999,55600,130015,42.903587953767996,56.5667244735122,NaN,NaN,-144.74842902714704,-131.87028931793316,-0.1401103523571472,0.04044131533177264,0.18055166768891984,13008571,13222831,41.32799715616276,51.039753235834276,NaN,NaN,3.6521566002627184,17.729104657434224
2004-02-05T09:30:00-05:00,31.14999,31.3,31.10001,31.25,161500,134530,48.316269896703844,55.33825176966865,NaN,NaN,-84.92094368814365,-121.53286840107292,-0.12324663707535083,0.026493371344731287,0.14974000842008212,13170071,13145491,36.96925142889469,50.5671206024606,NaN,NaN,2.4843861403227954,15.551287726418305
2004-02-06T09:30:00-05:00,31.35001,31.63,31.25,31.58,89000,130465,54.67808738378006,54.564194600616254,NaN,NaN,-17.265813528335585,-102.08175179011826,-0.08652131668436325,0.041588362564628056,0.1281096792489913,13259071,13124811,35.87957996950699,49.83100629720322,NaN,NaN,3.4915271525168086,13.828464787289521
2004-02-09T09:30:00-05:00,31.60001,31.86,31.60001,31.62,117000,126955,55.39479761585116,54.339105322088585,NaN,NaN,30.910512873538732,-70.93575655421571,-0.05758225189970982,0.056131864374354024,0.11371411627406385,13376071,13175591,40.515991643054555,49.34609004966398,NaN,NaN,4.515634658140975,12.498060483125442
2004-02-10T09:30:00-05:00,31.60001,31.94,31.60001,31.89,50500,126510,59.993681268264915,53.96094141808243,NaN,NaN,53.459707264022065,-32.512993221213094,-0.02023119060198425,0.08842512802158353,0.10865631862356778,13426571,13248071,46.46609768389936,49.00745919593597,NaN,NaN,6.866320142510856,11.69352614875193
2004-02-11T09:30:00-05:00,31.89,32.34,31.78999,32.21001,225000,132905,64.64619382449371,53.664824253891716,NaN,NaN,111.98875234413241,18.834443053042783,0.02367197513300323,0.13824628753982182,0.11457431240681859,13651571,13376671,55.05625645115032,49.12943127763436,NaN,NaN,10.463147319953114,11.517757744637814
2004-02-12T09:30:00-05:00,32.25,32.28,31.98,32.05,74100,122530,60.83648870145478,53.30132093724812,NaN,NaN,97.52635344266744,55.32390247920502,0.03869268829410917,0.16294017277445505,0.12424748448034588,13577471,13458151,59.491460536983,49.5378522272405,NaN,NaN,12.22141106931501,11.618279648163128
2004-02-13T09:30:00-05:00,31.95,32.07001,31.63,31.73,338000,134815,53.9846626319224,52.38458599394083,NaN,NaN,33.902374771126105,65.55754013909736,0.024524652626002008,0.15490330026284838,0.13037864763684637,13239471,13454231,59.188836168962474,49.84206137096884,NaN,NaN,11.503202146290455,11.60184000503846
2004-02-17T09:30:00-05:00,31.85001,32.17999,31.85001,32.14,298400,147305,60.17379383639997,52.35771445390924,NaN,NaN,78.84140367440506,75.1437182992706,0.039335384455801675,0.17954787820659845,0.14021249375079678,13537871,13486591,60.95457531186376,50.09025986630216,NaN,NaN,13.011036666345538,11.803153813796614
2004-02-18T09:30:00-05:00,32.12,32.12,31.89,31.95,62100,141225,56.38872500486858,53.17948959305535,NaN,NaN,59.369395432920015,76.3256559330502,0.033152791716675206,0.18165348339664078,0.14850069167996557,13475771,13496431,61.5000554446716,50.44030919932379,NaN,NaN,12.96127950447786,11.968600341036792
2004-02-19T09:30:00-05:00,32.08,32.32001,31.98,31.98,104800,139360,56.85025187413297,53.76528304685096,NaN,NaN,74.4134016176753,68.81058578775878,0.0281004156951081,0.1836262112988507,0.1555257956037426,13580571,13482231,60.1931805722283,50.63715745861185,NaN,NaN,13.067525556043655,12.125589657466344
2004-02-20T09:30:00-05:00,31.98,31.98,31.56,31.74001,220400,143350,52.10024191171998,54.0371685726519,NaN,NaN,16.19018975370126,52.543353049965546,0.006727113930245721,0.16393468801654976,0.15720757408630404,13360171,13438771,56.25321938399268,50.636766127882815,NaN,NaN,11.655005978342738,12.058363417591544
2004-02-23T09:30:00-05:00,31.89999,31.89999,31.46001,31.50999,290100,154765,47.963748112436306,54.13150673825479,NaN,NaN,-6.092062886832625,44.5444655183738,-0.023134474450560993,0.12828948102310278,0.15142395547366377,13070071,13404891,53.32301628830655,50.86377566081496,NaN,NaN,9.143790080035869,11.641995797940734
2004-02-24T09:30:00-05:00,31.39999,31.67,31.36,31.57001,84500,155985,49.09936262450807,54.52356376002177,NaN,NaN,-20.141283237039456,24.7479281360849,-0.03818855926937181,0.10368825638694901,0.14187681565632082,13154571,13328231,47.31710881036461,51.031187632145816,NaN,NaN,7.463223380377928,11.045028309717475
2004-02-25T09:30:00-05:00,31.64,31.75,31.5,31.74001,64300,155980,52.27621765073147,55.19303730980488,NaN,NaN,11.509522431954313,15.175953535891765,-0.03606672160464636,0.09679341365051286,0.13286013525515922,13218871,13276851,43.75959047567413,51.20487286925378,NaN,NaN,6.992170203504619,10.466048580258496
2004-02-26T09:30:00-05:00,31.60001,31.98,31.58,31.94,147900,156885,55.773276826628845,55.725680661942384,NaN,NaN,45.066569003200804,9.30658701299687,-0.02129448362473893,0.10624203072423555,0.12753651434897448,13366771,13234091,40.997042941661356,51.49257226302283,NaN,NaN,7.645786625299989,10.063154015264423
2004-02-27T09:30:00-05:00,32,32.16,31.82001,31.99001,72000,147390,56.62913048538117,55.86504088348532,NaN,NaN,74.17005617769756,20.90256029779613,-0.008890443714886481,0.11642345970536638,0.12531390342025286,13438771,13249811,42.43580337821735,51.960873935073565,NaN,NaN,8.428310312260129,9.829604914835238
2004-03-01T09:30:00-05:00,32.08,32.28999,32.02,32.19,123800,143865,59.96557887335791,56.191525259021525,NaN,NaN,105.57454607424535,43.23588209001173,0.010970651594450737,0.1390272179133163,0.12805656631886556,13562571,13348311,50.56934103106314,52.67897031993132,NaN,NaN,10.091830651406843,9.867065734345468
2004-03-02T09:30:00-05:00,32.3,32.3,32.02,32.10001,149200,139310,57.810497642190484,56.035583571444775,NaN,NaN,92.62365764842984,65.78887026710558,0.015933682838029706,0.1479736698664027,0.132039987028373,13413371,13400071,54.22915245543128,53.233474232183596,NaN,NaN,10.870265972671149,10.01038005410628
2004-03-03T09:30:00-05:00,32.13,32.2,31.87,32.13,116400,142230,58.34773613545026,55.5856937365131,NaN,NaN,69.74820138374366,77.43660605746345,0.01891925306844766,0.15568905336393257,0.1367698002954849,13529771,13462251,58.23013379551135,53.46017975678081,NaN,NaN,11.66191182743377,10.246313164581636
2004-03-04T09:30:00-05:00,32.3,32.35001,32.12,32.25999,137900,146345,60.68465163609971,55.57484823184488,NaN,NaN,110.03168758527994,90.42962977387928,0.02684752609775476,0.17032920791767836,0.1434816818199236,13667671,13522431,61.717989125519914,53.61921751310488,NaN,NaN,12.994500018496282,10.638911286569442
2004-03-05T09:30:00-05:00,32.12,32.58,32.12,32.49001,125700,144555,64.48210110548689,56.3246652656709,NaN,NaN,145.63160175755542,104.72193888985085,0.04378066628129956,0.19820751467154807,0.1544268483902485,13793371,13593351,65.38613578521718,54.06188177140878,NaN,NaN,15.28608352224467,11.302793034523047
2004-03-08T09:30:00-05:00,32.3,32.50999,32.03999,32.03999,229700,151590,53.578471402865596,55.85357080613274,NaN,NaN,78.1251451623758,99.23205870747695,0.02197187045781504,0.1818916864625173,0.15991981600470226,13563671,13593571,65.39721226285246,54.37921298219369,NaN,NaN,14.01140875881707,11.689738137993622
2004-03-09T09:30:00-05:00,32.14999,32.14999,31.75999,31.83,163500,153915,49.38228673802694,55.35311092992976,NaN,NaN,-22.18486405496053,76.27035436679887,-0.0077082916755357445,0.15028445141028257,0.15799274308581832,13400171,13590931,65.12788242081776,54.638343480489844,NaN,NaN,11.593124703317152,11.675936218754126
2004-03-10T09:30:00-05:00,31.88,31.88,31.3,31.44,131300,157955,42.69444053769354,54.34198154875552,NaN,NaN,-139.431185168547,34.434477056340725,-0.05223643948289228,0.09269719373220298,0.14493363321509525,13268871,13538751,59.87880257674232,54.61588790938371,NaN,NaN,7.182071574063925,11.033955555226955
2004-03-11T09:30:00-05:00,31.39999,31.45,30.86,30.86,68000,150105,35.08454062752466,53.126574314170135,NaN,NaN,-231.90062173113134,-33.951984806941525,-0.1157430766835253,0.0002547873606886242,0.11599786404421393,13200871,13445391,51.82987797386852,54.29993495151769,NaN,NaN,0.3667836452229051,9.510073853797804
2004-03-12T09:30:00-05:00,31.02,31.37,31.02,31.35001,72600,150030,44.14286569088264,52.85365414120202,NaN,NaN,-151.43157194782617,-93.36461954801784,-0.1192666001539037,-0.033085386148165696,0.086181214005738,13273471,13341411,44.63370856062349,53.67927011382604,NaN,NaN,-1.9821457701864376,7.868328193228627
2004-03-15T09:30:00-05:00,31.3,31.3,30.73,30.73,90600,137660,37.09041724355982,51.995872328277144,NaN,NaN,-186.18791876343454,-146.22723233317993,-0.15557621156550044,-0.10828905045113757,0.04728716111436288,13182871,13265251,40.2280395463006,53.17290802353576,NaN,NaN,-6.773538982738811,5.776632882376136
2004-03-16T09:30:00-05:00,31.08,31.08,30.74001,31,416600,143570,41.47539731577553,51.22438516149458,NaN,NaN,-152.60880690176472,-172.31202090254075,-0.1533791492672416,-0.14443677546968914,0.008942373797552479,13599471,13305111,43.378165176485425,53.145663359308,NaN,NaN,-8.79947916428227,3.6943311614249352
2004-03-17T09:30:00-05:00,31.10001,31.45,31.09,31.44,780700,179500,47.85425995475985,50.65874109921822,NaN,NaN,-72.29292892451654,-158.88436965373467,-0.11596343856643916,-0.13601192441049648,-0.02004848584405731,14380171,13527371,56.98980584836729,54.28800356692985,NaN,NaN,-8.026264423865204,2.019960363526344
2004-03-18T09:30:00-05:00,31.3,31.5,31.08,31.36,251100,186815,46.85431439225519,49.96053994970923,NaN,NaN,-67.19711391447647,-125.94366809040369,-0.09135563577869178,-0.13424303056742204,-0.04288739478873026,14129071,13713011,64.63654331550435,55.8737707053075,NaN,NaN,-7.791350031265991,0.6183445928417248
2004-03-19T09:30:00-05:00,31.25,31.45,31.11,31.14,292500,190420,44.12379071843261,48.82898365292885,NaN,NaN,-73.36649029544023,-110.3306517599265,-0.08479181818622249,-0.14887716752150837,-0.06408534933528588,13836571,13825631,68.31668120057323,57.141437860272504,NaN,NaN,-8.521786279532995,-0.6873883889260921
2004-03-22T09:30:00-05:00,30.85001,30.89999,30.59,30.66,632700,207550,38.80958246862437,47.471775426245564,NaN,NaN,-137.4073923676842,-100.57454648077643,-0.10628104199578602,-0.1969366518300184,-0.09065560983423239,13203871,13829831,68.44855154290111,58.157109223663205,NaN,NaN,-10.991131141716416,-2.1593516393247096
2004-03-23T09:30:00-05:00,30.66,30.87,30.55,30.60001,548700,230760,38.190507154314126,46.03197335616441,NaN,NaN,-125.19844760756307,-95.09247462193609,-0.11718057508385618,-0.23713132868905262,-0.11995075360519644,12655171,13640971,56.966678447555196,58.06686241309491,NaN,NaN,-13.10525991927361,-3.7230528221745525
2004-03-24T09:30:00-05:00,30.60001,30.84,30.55,30.75,106400,232865,40.73595348430912,44.607066345322224,NaN,NaN,-105.41250697488088,-101.71639023200896,-0.10720381236675022,-0.2539555190636342,-0.146751706696884,12761571,13317251,43.49783390165331,56.7654227542473,NaN,NaN,-14.023036645908393,-5.194479082707958
2004-03-25T09:30:00-05:00,30.95,31.35001,30.84,31.28999,404200,245680,48.895661703439515,43.493749245175984,NaN,NaN,-43.505392220651906,-96.97804589324404,-0.05953196220509244,-0.22116665945324954,-0.1616346972481571,13165771,13124591,37.77374701246928,54.79310927047959,NaN,NaN,-12.129931128975652,-6.185257946460486
2004-03-26T09:30:00-05:00,31.31,31.46001,31.14999,31.25999,116700,247915,48.496167057199166,43.13072750619981,NaN,NaN,-23.198955365495067,-86.94453890725501,-0.02697234348334815,-0.1953501266023423,-0.16837778311899415,13049071,12967091,33.85186217762609,52.53986997867771,NaN,NaN,-10.770067525146205,-6.840230743415589
2004-03-29T09:30:00-05:00,31.5,31.7,31.47,31.55,138300,248640,52.53358295180976,43.355820092898576,NaN,NaN,20.3117513527179,-55.400710163174594,0.014892158353855989,-0.14976258517667418,-0.16465474353053017,13187371,12963791,33.77274165410148,50.3002170667694,NaN,NaN,-8.348777731357867,-7.055737455978771
2004-03-30T09:30:00-05:00,31.60001,31.8,31.56,31.78999,137100,248035,55.633058967144855,44.28000712357368,NaN,NaN,46.6959957871618,-21.021821484229626,0.05716807251274933,-0.0931946528895935,-0.15036272540234283,13324471,13097651,39.90815325702029,48.873742115360685,NaN,NaN,-5.3501481335948045,-6.812081838495347
2004-03-31T09:30:00-05:00,31.8,31.95,31.67999,31.75,77900,246110,54.98871415615049,45.70173380418981,NaN,NaN,62.90439744581487,12.641559399909532,0.07948771154981446,-0.051003085965074746,-0.1304907975148892,13246571,13194651,43.959631456437165,48.31158164982987,NaN,NaN,-3.122585322296853,-6.285010907609848
2004-04-01T09:30:00-05:00,31.88,32.00999,31.71001,31.89,474500,262940,56.87195756586947,46.61095465240316,NaN,NaN,82.49284951064956,37.84120774616982,0.09943448433524045,-0.006197692095838647,-0.1056321764310791,13721071,13305711,48.26081665973911,48.5706607997667,NaN,NaN,-0.7069276039172963,-5.488141864225198
2004-04-02T09:30:00-05:00,32.35001,32.35001,32.00999,32.17999,465200,279915,60.55352613685576,48.28689100192429,NaN,NaN,141.0771752170429,70.69643386267741,0.12619372782699229,0.05210998335266126,-0.07408374447433103,14186271,13533151,55.7508824938104,49.679435296017395,NaN,NaN,2.5021702168157125,-4.346668709790782
2004-04-05T09:30:00-04:00,32.07001,32.50999,32.07001,32.50999,92600,273060,64.28935087464774,49.91645911327229,NaN,NaN,167.14695412174456,100.06347441648275,0.15808585591384916,0.12352357541798042,-0.034562280495868736,14278871,13751451,61.510341549075434,50.97459075120239,NaN,NaN,6.461370042601759,-2.8026631737347047
2004-04-06T09:30:00-04:00,32.3,32.53999,32.27,32.44,77400,268755,62.92812610724793,50.99316383845001,NaN,NaN,159.66321177336033,122.65691761372246,0.1656366015773239,0.17248347147578613,0.006846869898462241,14201471,13926851,65.4064638092639,51.575780605552154,NaN,NaN,9.309775202024147,-1.072314834340583
2004-04-07T09:30:00-04:00,32.39999,32.39999,32.08,32.2,335600,278970,58.36460285238031,51.81532729988752,NaN,NaN,113.3342560745531,132.74288933947008,0.14630765739859852,0.1897314416467104,0.04342378424811188,13865871,14050711,67.87911148832569,51.80739261789653,NaN,NaN,10.44927609986746,0.5736267276891371
2004-04-08T09:30:00-04:00,32.5,32.5,31.89,32,121100,281625,54.79824008861363,52.57778796918616,NaN,NaN,87.79607050776889,133.80353353889396,0.1133635413728233,0.185128210964141,0.0717646695913177,13744771,14055451,67.97345441141002,51.78287641867059,NaN,NaN,10.38348088070984,1.9750344638349517
2004-04-12T09:30:00-04:00,32.14999,32.37,32.13,32.27,122500,284120,58.486205701390496,53.98326105724089,NaN,NaN,93.2294789638255,124.23399428825049,0.10334860795509236,0.20095042953518316,0.0976018215800908,13867271,13991651,65.19769978480608,51.550672721663794,NaN,NaN,11.414844768548056,3.3235787930796805
2004-04-13T09:30:00-04:00,32.39999,32.39999,31.59,31.67,113900,285285,48.93196193658889,54.750507827403375,NaN,NaN,40.08958943674276,98.82252135125012,0.05247332143848195,0.16319347337819323,0.11072015193971128,13753371,13886551,60.79351335531504,51.824018072218074,NaN,NaN,9.264034009573493,4.1722152525787966
2004-04-14T09:30:00-04:00,31.39999,31.73,31.39999,31.62,417800,285345,48.22496388231314,55.28543714154652,NaN,NaN,-5.449799753570154,65.79991904586402,0.01363464156859627,0.12776345390045662,0.11412881233186035,13335571,13713371,54.28618869126613,52.59461484290471,NaN,NaN,7.33810806573966,4.62448565445892
2004-04-15T09:30:00-04:00,31.64999,31.78,31.47,31.59,164400,254530,47.77889937921227,55.20566840410172,NaN,NaN,-3.294716886008372,42.474124453751735,-0.014378461496074302,0.09615573546176748,0.11053419695784178,13171171,13574431,49.690672026602144,53.44582377248563,NaN,NaN,5.654644820707609,4.771651249637304
2004-04-16T09:30:00-04:00,31.59,31.94,31.59,31.89,132900,248620,52.50950885848135,55.49233567562187,NaN,NaN,22.274009397332122,29.36971223166438,-0.013045209111355621,0.09422768556864725,0.10727289468000287,13304071,13486291,46.97402506673968,54.38312112170803,NaN,NaN,5.576319748457854,4.886603892325954
2004-04-19T09:30:00-04:00,31.77,31.96001,31.7,31.91,105200,239255,52.81637979633398,55.51253545023075,NaN,NaN,26.198408681738833,15.963498175247043,-0.011227334156053703,0.09323872698493574,0.10446606114098944,13409271,13394691,44.26551199417813,55.13260471742779,NaN,NaN,5.599359500147333,4.988426122014722
2004-04-20T09:30:00-04:00,32.10001,32.19,31.7,31.71001,175500,216395,49.380281131113904,55.06590846194282,NaN,NaN,21.421143339202544,12.229808955739,-0.023214661668913464,0.07544773405484761,0.09866239572376108,13233771,13290771,41.35236837179705,55.23576293991185,NaN,NaN,4.640363644990063,4.9387029110112
2004-04-21T09:30:00-04:00,31.5,31.83,31.47,31.75,146900,196305,50.07964385082326,54.71526058299088,NaN,NaN,-25.211633597887882,8.277442186875454,-0.027858553248504378,0.0638392041631306,0.09169775741163498,13380671,13299791,41.71093968490261,55.07514209908795,NaN,NaN,4.035809553398248,4.809718145637921
2004-04-22T09:30:00-04:00,31.95,32.42,31.86,32.39,62100,194090,59.68052102581964,54.915872258701604,NaN,NaN,86.54137537169368,26.244660638415866,0.010698450764441703,0.10507082086718711,0.0943723701027454,13442771,13354111,43.93405562117332,54.76608773919039,NaN,NaN,6.441264431252616,5.042796186440021
2004-04-23T09:30:00-04:00,32.35001,32.35001,32.05,32.25999,57700,176765,57.27090015836923,54.681398974523994,NaN,NaN,75.08822509963738,36.80750377887692,0.02514709408197384,0.1258062377052127,0.10065914362323887,13385071,13370311,44.612519305060495,53.97049036856539,NaN,NaN,7.689772269952874,5.420935626941857
2004-04-26T09:30:00-04:00,32.3,32.39,31.91,32,92500,175555,52.68943662960992,53.85283367130701,NaN,NaN,36.54903656777516,38.877629356084185,0.015375326957059371,0.11987830231956309,0.10450297536250372,13292571,13346971,43.790321861434066,52.704774676591015,NaN,NaN,7.3582752784849825,5.697698434305161
2004-04-27T09:30:00-04:00,32.3,32.44,32.14999,32.22,368500,187065,55.90398722924917,53.35110946573567,NaN,NaN,75.53623020195212,49.70064672863409,0.021531724949505837,0.13141763154938602,0.10988590659988018,13661071,13432431,47.59843915472418,51.43277291555246,NaN,NaN,8.05910121863381,6.035041689209254
2004-04-28T09:30:00-04:00,32.2,32.2,31.82001,31.84,1162200,238320,49.6311748026391,52.72729317646844,NaN,NaN,-18.379353127247295,51.06710282276221,-0.0009908137452316473,0.10864738941834062,0.10963820316357227,12498871,13256071,41.36965848201581,49.539240557958905,NaN,NaN,6.681369008791761,6.127374163435326
2004-04-29T09:30:00-04:00,31.84,32.14,31.42,31.63,135300,241190,46.52432686956817,52.13629937510806,NaN,NaN,-82.83142076060965,17.192543596301544,-0.029456824543105636,0.07281717248469022,0.10227399702779585,12363571,13040231,35.28403478562434,47.204282013259935,NaN,NaN,4.553144916764058,5.902484271053717
2004-04-30T09:30:00-04:00,31.73,31.8,31.27,31.39,115100,223220,43.19628721729334,51.04416234052968,NaN,NaN,-137.12774803510808,-25.25065103064755,-0.06200324504005021,0.024769940727733086,0.0867731857677833,12248471,12812911,30.238832573790276,44.707220069615936,NaN,NaN,1.7097766772978578,5.303526043374308
2004-05-03T09:30:00-04:00,31.35001,31.60001,31.3,31.55,1311900,265555,45.97106510056212,50.832669709384916,NaN,NaN,-122.31700180366273,-57.02385870493513,-0.06973266667836307,-0.00039264758017054646,0.06934001909819253,13560371,12866471,32.68127221568507,42.69920284535666,NaN,NaN,0.19952973272113173,4.574383713280998
2004-05-04T09:30:00-04:00,31.46001,31.7,31.3,31.49001,472500,284550,45.081870149984475,50.60816301421858,NaN,NaN,-108.54870052270029,-93.8408448498656,-0.07538239817312212,-0.024887978618210127,0.05049441955491199,13087871,12751831,30.240749035988145,40.98167144140824,NaN,NaN,-1.2908326852495393,3.736495656348064
2004-05-05T09:30:00-04:00,31.39999,31.58,31.36,31.56,217100,291535,46.384861899360786,50.50858890851491,NaN,NaN,-100.37246471440913,-110.23946716729797,-0.0709656202387576,-0.03821260574353502,0.03275301449522258,13304971,12913051,37.32869126651483,40.09867281568771,NaN,NaN,-2.1594645366207823,2.894215628781086
2004-05-06T09:30:00-04:00,31.17,31.28999,30.82001,31.09,682300,308870,39.59163779955387,49.58588383287723,NaN,NaN,-186.7002091175247,-131.01322483868097,-0.09477003929411738,-0.08570953462242414,0.009060504671693236,12622671,12964871,39.457998408826874,39.56181376869394,NaN,NaN,-5.058828316311783,1.758066493767819
2004-05-07T09:30:00-04:00,30.78999,31.07001,30.34,30.34,422900,323960,31.630812252443476,48.072629008313626,NaN,NaN,-246.78064026142977,-152.94380328394533,-0.15266803668476325,-0.18177454118426084,-0.029106504499497577,12199771,12955131,39.188488774616495,39.199169253010965,NaN,NaN,-10.625897366347314,-0.01107120053434274
2004-05-10T09:30:00-04:00,29.92999,30.24001,29.8,29.96001,406000,338135,28.503648129137403,46.581440936743874,NaN,NaN,-286.47132598944097,-185.77466812110097,-0.204938984652126,-0.2852802353146551,-0.08034125066252908,11793771,12601811,30.93431368474397,38.455022489650034,NaN,NaN,-16.36417334961178,-2.3472286504025477
2004-05-11T09:30:00-04:00,30.2,30.47,30.2,30.39999,568700,360875,36.35026393566152,45.60077094280375,NaN,NaN,-180.77638668755552,-200.220205354072,-0.1981472103874542,-0.3280252636468468,-0.1298780532593926,12362471,12456731,28.2985673081037,37.49699589130726,NaN,NaN,-18.399434416892298,-4.640400902758226
2004-05-12T09:30:00-04:00,30.39999,30.5,29.81,30.5,954800,387725,38.015503644885385,44.053269701308444,NaN,NaN,-157.48904881798035,-211.64352217478626,-0.17593657568720608,-0.3497987728684002,-0.17386219718119414,13317271,12459191,28.409952645910238,36.388131393074175,NaN,NaN,-19.424223550840722,-6.752375566770011
2004-05-13T09:30:00-04:00,30.35001,30.46001,30.17999,30.39999,494500,404230,36.973765615743076,42.603474376835145,NaN,NaN,-121.40195414717196,-198.5838711807157,-0.157589830223736,-0.3708494849608641,-0.21325965473712813,12822771,12499211,30.306735695162317,35.36628970665287,NaN,NaN,-20.56743294962667,-8.72595519289239
2004-05-14T09:30:00-04:00,30.5,30.56,30.14999,30.41,382900,416730,37.15938082491943,41.494184676500105,NaN,NaN,-100.93686716357325,-169.41511656114443,-0.13524626391821165,-0.3823174846348927,-0.24707122071668103,13205671,12700391,39.04925203295449,35.027641861761474,NaN,NaN,-21.419880435698886,-10.53937308472189
2004-05-17T09:30:00-04:00,30.3,30.3,29.73,29.92999,451500,434045,32.25396134840642,39.804897113582776,NaN,NaN,-120.03889128416944,-136.12862962009012,-0.14253253243785724,-0.4252368862640026,-0.28270435382614534,12754171,12892471,46.01262822363814,34.91436965239819,NaN,NaN,-23.73210336085077,-12.424048838454587
2004-05-18T09:30:00-04:00,30.3,30.46001,30,30.39999,1168200,483680,40.531930083392886,39.15495106220804,NaN,NaN,-81.10686804802621,-116.19472589218427,-0.1070559698886333,-0.41652431618693697,-0.30946834629830366,13922371,13204451,55.00431166282706,35.888273451027565,NaN,NaN,-23.037850852105247,-13.940306268976109
2004-05-19T09:30:00-04:00,30.61,30.84,30.27,30.27,227600,487715,39.10858960816622,38.625255543536475,NaN,NaN,-58.79333867722218,-96.45558386403263,-0.08468219121360432,-0.4153210853153091,-0.33063889410170477,13694771,13279951,56.87616195174846,37.43056824860786,NaN,NaN,-22.924814351515078,-15.223807423624532
2004-05-20T09:30:00-04:00,30.25,30.41,30.14,30.34,80500,488635,40.323893187179564,38.4200845413855,NaN,NaN,-66.6046778622913,-85.49612860705649,-0.05873795164676093,-0.40406133366015595,-0.345323382013395,13775271,13470451,61.255812688293425,39.646066828215226,NaN,NaN,-22.467302906447404,-16.258592492599227
2004-05-21T09:30:00-04:00,30.34,30.66,30.3,30.49001,114200,491460,42.95161248968694,38.2044093548944,NaN,NaN,-43.78111841443508,-74.06497885722885,-0.026675929317848568,-0.37866829366070576,-0.3519923643428572,13889471,13607211,64.07646727321139,41.88858076089567,NaN,NaN,-21.308783741200163,-16.980048385256502
2004-05-24T09:30:00-04:00,30.8,30.88,30.57001,30.81,158300,494750,48.19214017209929,38.42657149933119,NaN,NaN,-11.54094371169376,-52.36538934273369,0.018448382869350077,-0.3289318857561696,-0.3473802686255197,14047771,13865931,68.7164370722075,44.636844192054205,NaN,NaN,-18.70219806665281,-17.226069768313117
2004-05-25T09:30:00-04:00,30.7,31.42999,30.60001,31.42999,110600,481855,56.52516297501587,39.15087871902083,NaN,NaN,42.86540051501005,-27.57093563012645,0.08849764582088704,-0.23675821134941089,-0.3252558571702979,14158371,13913131,69.49065926800164,46.93412762073183,NaN,NaN,-13.51656192028861,-16.69614007573819
2004-05-26T09:30:00-04:00,31.36,31.48,31.27,31.45,342400,440865,56.766859712223045,40.37768028421148,NaN,NaN,81.43118802253908,0.47396970982580056,0.13200626094675288,-0.1602480309868568,-0.2922542919336097,14500771,14074331,72.03605638626954,49.26113176197773,NaN,NaN,-9.370334935896066,-15.649596484332172
2004-05-27T09:30:00-04:00,31.39999,31.77,31.39999,31.59,64500,437325,58.50503610226841,42.297267702056125,NaN,NaN,108.53852265106185,35.50260981249643,0.16395553120446793,-0.0873098779280248,-0.25126540913249273,14565271,14232331,74.29936277428382,51.76905133338254,NaN,NaN,-5.416925426648389,-14.187786333234488
2004-05-28T09:30:00-04:00,31.59,31.62,31.5,31.59,315900,447365,58.50503610226841,44.4402239858512,NaN,NaN,104.7331375453753,65.2054610044585,0.17767663374509324,-0.029169616951126187,-0.20684625069621942,14565271,14367491,76.08269765660808,54.993935902801404,NaN,NaN,-2.2259785429308714,-12.4789566489054
2004-06-01T09:30:00-04:00,31.45,31.59,31.32001,31.56,242200,393880,57.926253998016456,45.98136613316226,NaN,NaN,94.10727849865083,86.33510544652742,0.17693390012758492,0.014321124463261725,-0.1626127756643232,14323071,14422551,76.78926034643136,58.45755683411052,NaN,NaN,0.2629992555643087,-10.658677233981157
2004-06-02T09:30:00-04:00,31.7,31.7,31.44,31.67999,204400,380475,59.64582000602877,47.526388730386785,NaN,NaN,107.30297465972988,99.22262027547139,0.17633319278834705,0.057803715321110616,-0.11852947746723644,14527471,14496371,77.73879263936266,61.98104540507141,NaN,NaN,2.869071802772097,-8.72614165730212
2004-06-03T09:30:00-04:00,31.64,31.77,31.46001,31.48,289200,384080,55.569291874323525,48.85464060599968,NaN,NaN,101.27282350564833,103.19094737209325,0.15503071975688726,0.07525892222887265,-0.07977179752801461,14238271,14443871,75.37706438888247,65.20035459748,NaN,NaN,4.066850573298321,-6.898571338644914
2004-06-04T09:30:00-04:00,31.74001,31.77,31.50999,31.61,460800,373005,57.5979864404608,50.314541007109774,NaN,NaN,98.9178279451362,101.26680843090811,0.14257533639973893,0.09844737297165906,-0.044127963428079876,14699071,14470631,75.78095214493732,67.82404746262162,NaN,NaN,5.649114070273095,-5.106044851656627
2004-06-07T09:30:00-04:00,31.8,32.05,31.71001,32.05,244300,364075,63.64799283664464,52.55697182769821,NaN,NaN,116.81464595235208,103.68311011230347,0.15577658698276325,0.1505927703003742,-0.005183816682389056,14943371,14546251,76.93243596625716,70.03260515852298,NaN,NaN,8.928136887798285,-3.1011617460202108
2004-06-08T09:30:00-04:00,31.95,32.17,31.89,32.16,464500,367000,64.99277437673331,54.30417499150825,NaN,NaN,117.36990485445492,108.3356353834643,0.1629520118863717,0.19850619817557558,0.03555418628920387,15407871,14763211,79.88707061470782,71.80994508365733,NaN,NaN,12.059046142048826,-0.9354177620103483
2004-06-09T09:30:00-04:00,32,32.17999,31.91,31.92,119000,344515,59.79528595373954,55.781796159049186,NaN,NaN,99.13708182199099,106.7024568159165,0.14326683543041557,0.21463773057722335,0.07137089514680778,15288871,14915491,81.66245025760303,73.58039424836123,NaN,NaN,13.27189040569006,1.094197690518281
2004-06-10T09:30:00-04:00,31.91,32.12,31.91,32.05,145100,304030,61.587215924780644,57.300604926020696,NaN,NaN,93.68314707528275,105.1845215298434,0.13106388541132677,0.23520075191096623,0.10413686649963946,15433971,15154631,84.0443546327906,75.20814724439674,NaN,NaN,14.809400221685381,3.0535123378278666
2004-06-14T09:30:00-04:00,32.05,32.05,31.56,31.64,1383300,348470,53.48990088244082,58.053339811217405,NaN,NaN,58.868361695456485,97.17462827990745,0.08943008920458423,0.21592447800536974,0.1264943888007855,14050671,15024951,78.1186093304807,76.21115739134454,NaN,NaN,13.710166423170826,4.575891492876861
2004-06-15T09:30:00-04:00,31.85001,32.02,31.77,31.83,261800,342415,56.35376048781665,58.636312690911495,NaN,NaN,67.9294530348142,87.39758969639988,0.06961889019885698,0.21351800154935674,0.14389911135049976,14312471,14898771,72.74415078802481,76.49885122818864,NaN,NaN,13.651897061244581,5.872463716929392
2004-06-16T09:30:00-04:00,31.95,31.95,31.77,31.86,71200,323400,56.80601207370026,58.65637334081753,NaN,NaN,63.75182548158338,76.67397382182557,0.054154706389053286,0.21159249433681637,0.15743778794776309,14383671,14693931,64.93396983352537,76.17337341144034,NaN,NaN,13.735038054929277,6.995688622357947
2004-06-17T09:30:00-04:00,31.82001,31.95,31.72,31.94,43200,267150,58.054186566866214,58.74832525900632,NaN,NaN,62.48379050293175,69.34331555801373,0.04529325921769267,0.21405436196987893,0.16876110275218625,14426871,14521531,59.17543915124934,75.25475789465317,NaN,NaN,14.153905096906941,8.018290975864947
2004-06-18T09:30:00-04:00,31.78,32.03,31.78,31.89,50000,258270,56.94658293529118,58.63700717565081,NaN,NaN,65.03339086519773,63.61336431599672,0.03263528236267277,0.20955520570552721,0.17691992334285445,14376871,14310111,52.971398183898046,73.73133185248275,NaN,NaN,14.200984234249232,8.901532869919844
2004-06-21T09:30:00-04:00,32,32,31.75999,31.78,104900,259490,54.48380300948066,58.34977624045168,NaN,NaN,51.25253842055407,62.09019966101623,0.014357824076989795,0.1948672034390917,0.1805093793621019,14271971,14354371,54.05732234303608,72.15809075865619,NaN,NaN,13.571870795831048,9.568724002192873
2004-06-22T09:30:00-04:00,31.74001,31.74001,31.41,31.64,87700,258165,51.43495129483338,57.88611176165289,NaN,NaN,-21.78765745946123,44.14677756216115,-0.008430936036474462,0.16997070931650882,0.17840164535298328,14184271,14328731,53.28965749978489,70.47954769818143,NaN,NaN,12.187492601728684,9.942833802126561
2004-06-23T09:30:00-04:00,31.55,31.89,31.55,31.89,67800,253640,56.153421864419876,57.63665475153797,NaN,NaN,17.495508029088363,34.895514071662134,-0.00794456357784179,0.16847094088068104,0.17641550445852283,14252071,14302411,52.46599819416418,68.67434809495298,NaN,NaN,12.26226946352959,10.274181753755565
2004-06-24T09:30:00-04:00,31.8,32.06,31.8,31.89999,90900,252655,56.335984232307965,57.691418491393996,NaN,NaN,61.80819726168377,34.76039542341254,-0.008194055610708073,0.16617293494513774,0.1743669905558458,14342971,14285631,51.915077680751985,66.99849190151508,NaN,NaN,12.373148018922492,10.57403407735084
2004-06-25T09:30:00-04:00,31.85001,32.09,31.81,31.87,296500,250360,55.58772834682812,57.54782862756309,NaN,NaN,57.584881672758044,33.27069358492461,-0.011424448755357364,0.1600864296116491,0.17151087836700646,14046471,14219551,49.70175131844696,65.13569184248006,NaN,NaN,12.269905338828002,10.816301400419006
2004-06-28T09:30:00-04:00,32.10001,32.14,31.77,31.81,725600,283415,54.04123177101092,56.86163140858925,NaN,NaN,45.67585639048235,32.15535717891026,-0.018242999882134237,0.14870712851433865,0.16695012839647289,13320871,14029331,43.89966741216372,62.77620837433052,NaN,NaN,11.780588324647292,10.954056675308761
2004-06-29T09:30:00-04:00,31.7,31.71001,31.53999,31.57001,173400,276290,48.25805545542068,55.666294342781214,NaN,NaN,-93.36308655750292,17.84027135930192,-0.0383980610243817,0.11895255211599576,0.15735061314037746,13147471,13821971,38.60852968730043,59.82774116523,NaN,NaN,9.734838330979294,10.779882626118837
2004-06-30T09:30:00-04:00,31.55,31.72,31.42,31.63,440000,286180,49.70689419313361,54.945694931309355,NaN,NaN,-107.89078352761379,-7.236986952038512,-0.04662408692322567,0.09907050448634536,0.14569459140957103,13587471,13689051,35.64293795365833,56.54063314351966,NaN,NaN,8.379490693323762,10.436969492862398
2004-07-01T09:30:00-04:00,31.7,31.71001,31.28,31.44,606100,306265,45.37340154559103,53.78756533279581,NaN,NaN,-150.96728970039882,-49.792084344455034,-0.06278951481744044,0.06720769788777048,0.12999721270521092,12981371,13416731,30.477762594164062,52.714447997903484,NaN,NaN,5.946178100610591,9.795427865397853
2004-07-02T09:30:00-04:00,31.5,31.5,31.24001,31.27,186400,301125,41.857216040471585,52.95665927265515,NaN,NaN,-191.28048392975856,-99.56515746495835,-0.08166432434662294,0.027916807271932242,0.10958113161855518,12794971,13166431,26.654392343402137,49.038432498826445,NaN,NaN,2.7872389242242552,8.794258016658768
2004-07-06T09:30:00-04:00,31.10001,31.19,30.97,31.07001,557100,305940,38.11514475398372,51.65390100595281,NaN,NaN,-237.50242910975018,-156.20081456500486,-0.10297563531420664,-0.01913841252420312,0.08383722279000352,12237871,12949831,23.86443986386692,45.5470245756723,NaN,NaN,-1.1225006020228119,7.37757821398997
2004-07-07T09:30:00-04:00,31,31.12,30.92999,30.98,159000,301675,36.53213379616652,50.20576684327182,NaN,NaN,-201.33734618819457,-177.79566649114318,-0.11744355507493458,-0.0629672210536647,0.054476334021269876,12078871,12736111,21.475809446238216,42.442870262294655,NaN,NaN,-4.88061861857418,5.626407237909378
2004-07-08T09:30:00-04:00,30.8,30.85001,30.56,30.56,154600,286180,30.22423307570523,48.217913022474605,NaN,NaN,-232.21980445958667,-202.66147067753778,-0.1476552508095462,-0.13009272949066286,0.017562521318883327,11924271,12403471,18.390460388487114,39.52965749352592,NaN,NaN,-10.509155493326123,3.3213268477328777
2004-07-09T09:30:00-04:00,30.75,30.75,30.58,30.73,580900,309275,35.10831746262933,46.65803691728447,NaN,NaN,-183.40021632838872,-209.14805600313576,-0.14816213546749304,-0.167640148015483,-0.01947801254798994,12505171,12308231,17.610356386446824,37.00386879370797,NaN,NaN,-13.680701309643627,0.8924656823933774
2004-07-12T09:30:00-04:00,30.60001,30.86,30.55,30.81,211300,312585,37.331393548502035,45.43286481292886,NaN,NaN,-142.19137978450698,-199.33023517408543,-0.13542994655579055,-0.18876544574272813,-0.05333549918693758,12716471,12292531,17.47873247617217,34.39111237464627,NaN,NaN,-15.584254574718411,-1.4613514971940211
2004-07-13T09:30:00-04:00,30.75,31,30.75,30.92999,58700,246355,40.61737016575172,44.66018044656589,NaN,NaN,-98.76615242069954,-171.5829798362753,-0.11220646457687602,-0.1935935799080326,-0.08138711533115658,12775171,12399991,21.787703266733615,32.140972786571176,NaN,NaN,-16.18451169083912,-3.564660096286178
2004-07-14T09:30:00-04:00,30.8,31.11,30.72,30.8,105200,238525,38.275895997682106,43.38321431322748,NaN,NaN,-88.62972732041922,-149.04145606272021,-0.09932205502520966,-0.20553968411266865,-0.10621762908745899,12669971,12518211,26.34432202385348,30.275138774406123,NaN,NaN,-17.387812971557988,-5.539396221325008
2004-07-15T09:30:00-04:00,30.84,30.89,30.64999,30.64999,151100,242520,35.717028263848604,41.9104317440518,NaN,NaN,-98.6390972487786,-122.32531462055863,-0.09464465238443831,-0.22452344456800688,-0.12987879218356857,12518871,12637131,30.716957123605994,28.76098730603856,NaN,NaN,-19.178751809480676,-7.487875591061532
2004-07-16T09:30:00-04:00,30.77,30.77,30.31,30.31,217200,251220,30.706501100154142,40.133201226432234,NaN,NaN,-122.0778703243393,-110.06084541974874,-0.10726480531939417,-0.2639597988328113,-0.15669499351341712,12301671,12596431,30.05923993422705,27.357950778594276,NaN,NaN,-22.415986246964675,-9.620462827619123
2004-07-19T09:30:00-04:00,30.31,30.44,30.07001,30.19,164200,256930,29.15205025487063,38.35540254670793,NaN,NaN,-136.47653394720376,-108.9178762522881,-0.11578143565720189,-0.3014217880849195,-0.1856403524277176,12137471,12480631,28.208522270032432,26.23715469701347,NaN,NaN,-25.568520935163775,-11.898756842982644
2004-07-20T09:30:00-04:00,30.2,30.56,30.2,30.53,987900,301080,38.63133729871725,37.66777982122911,NaN,NaN,-99.20721266331347,-109.00608830081089,-0.09165958702602445,-0.30021483621024814,-0.2085552491842237,13125371,12550671,30.976615341076467,25.69201795799747,NaN,NaN,-25.237262053837384,-13.804257587390463
2004-07-21T09:30:00-04:00,30.53,30.77,30.25999,30.25999,212700,307330,34.66470854387474,36.59333798913919,NaN,NaN,-90.81993608768356,-109.44413005426375,-0.0870655816199632,-0.3173872262091777,-0.2303216445892145,12912671,12599211,32.90734337311984,25.496618345101865,NaN,NaN,-26.278108816963293,-15.586236334472297
2004-07-22T09:30:00-04:00,30.05,30.36,29.87,30.31,92300,308555,35.97596175835001,35.92209229005054,NaN,NaN,-115.72919999776089,-112.8621506040602,-0.07433070653783563,-0.32323502776150903,-0.2489043212236734,13004971,12696431,36.72500554165268,25.94284998420819,NaN,NaN,-26.680330701545923,-17.17110695833996
2004-07-23T09:30:00-04:00,30.2,30.27,29.96001,30.13,131300,310575,33.37929495308397,35.31652649809429,NaN,NaN,-116.20504454164421,-111.68758544752117,-0.0716701613917391,-0.33849202296334724,-0.26682186157160814,12873671,12810831,40.980711069424466,26.96615846463836,NaN,NaN,-27.833160305879325,-18.69425743655987
2004-07-26T09:30:00-04:00,30.10001,30.11,29.74001,29.87,222500,306875,30.009886281879602,34.73757946437256,NaN,NaN,-137.5096549583308,-111.89420964974661,-0.08040554356046165,-0.3673287910221852,-0.28692324746172354,12651171,12913571,44.585353894189694,28.446223752518563,NaN,NaN,-29.912637846758756,-20.296883209445426
2004-07-27T09:30:00-04:00,29.85001,30.42999,29.85001,30.38,183200,279755,42.3111545291266,35.150366659584,NaN,NaN,-85.35349171371979,-109.12346545982787,-0.04650288738874786,-0.34505185669765837,-0.2985489693089105,12834371,12855371,42.98380134770965,29.98250888833795,NaN,NaN,-27.445383240478606,-21.318097499593023
2004-07-28T09:30:00-04:00,30.3,30.38,29.89999,30.25,90800,275625,40.3637227023142,35.8746159186275,NaN,NaN,-85.08837873249824,-107.97715398879079,-0.028390083435707147,-0.33403657360354444,-0.3056464901678373,12743571,12821551,42.03879540581905,31.671675675290235,NaN,NaN,-26.14853679565769,-22.00816025617369
2004-07-29T09:30:00-04:00,30.45,30.58,30.3,30.39999,264800,266865,43.58975709772292,36.48043303541989,NaN,NaN,-34.18780367916974,-91.66887472507257,-0.0031905416310799017,-0.3096346672066872,-0.3064441255756073,13008371,12822231,42.06637452673881,33.41853411388252,NaN,NaN,-24.03235469125795,-22.297330889757156
2004-07-30T09:30:00-04:00,30.39999,30.45,30.25,30.42999,131500,243135,44.23948109506082,36.973867860174096,NaN,NaN,-37.31308862032905,-75.89048354080953,0.01747961895260175,-0.2845946018848551,-0.30207422083745683,13139871,12875471,44.30099746058655,35.334410184197836,NaN,NaN,-22.159583748157274,-22.27765272667146
2004-08-02T09:30:00-04:00,30.42999,30.67999,30.27,30.61,218500,244740,48.10209107211182,37.50849078205696,NaN,NaN,3.136422509194957,-47.761268047304384,0.043760735324001765,-0.24737330168245464,-0.2911340370064564,13358371,13016911,49.83676637583875,37.33791469199105,NaN,NaN,-19.376675174803406,-21.86322736211888
2004-08-03T09:30:00-04:00,30.48,30.53999,30.28999,30.3,72600,220515,42.62591379437175,37.819206338963355,NaN,NaN,-27.445809924695126,-36.179731689499455,0.04080995751820804,-0.24012159010869638,-0.2809315476269044,13285771,13107191,53.044656903354664,39.24508146909829,NaN,NaN,-18.660974272595475,-21.40576263504411
2004-08-04T09:30:00-04:00,30.05,30.27,29.96001,30.14,198500,222490,40.089131693841324,38.1314994411057,NaN,NaN,-94.8667543807856,-38.13540681915693,0.02917151483101882,-0.2444671540881309,-0.27363866891914973,13087271,13175931,55.38417087850233,41.00702530873374,NaN,NaN,-18.86312156513938,-21.04252819648629
2004-08-05T09:30:00-04:00,30.23,30.23,29.58,29.61,654500,247485,33.068655507185184,38.30022475589364,NaN,NaN,-165.12284808263897,-64.32241569985078,-0.010981104894140725,-0.28736505003682566,-0.27638394514268494,12432771,13060811,50.81769156059842,42.48977185347455,NaN,NaN,-21.4781167362682,-21.10475513074085
2004-08-06T09:30:00-04:00,29.25,29.44,29.13,29.17999,362600,236570,28.680219579762607,38.26652256481449,NaN,NaN,-252.4938466605907,-107.3585673079031,-0.060494835335812625,-0.3520024893124507,-0.2915076539766381,12070171,12846871,43.61979856557586,43.59057730315622,NaN,NaN,-25.309257099189374,-21.705398269090637
2004-08-09T09:30:00-04:00,29.14999,29.39,29.12,29.14,119400,231975,28.304036607574346,37.528858229732855,NaN,NaN,-216.4646162738391,-151.27877506450992,-0.08825229184368433,-0.4018230187812435,-0.31357072693755916,11950771,12565351,36.32801083838508,43.97281983867827,NaN,NaN,-28.365285793831113,-22.65681077262499
2004-08-10T09:30:00-04:00,29.2,29.57001,29.2,29.57001,46400,231360,37.75796445136192,37.749805080267656,NaN,NaN,-145.72601955429022,-174.93481699042894,-0.07072279878273963,-0.4019742254159837,-0.3312514266332441,11997171,12307631,31.18802637076709,43.85001148136735,NaN,NaN,-27.74844812164471,-23.384187536770664
2004-08-11T09:30:00-04:00,29.25,29.39,29.12399,29.36,188800,235540,35.309176022891634,37.70217752773491,NaN,NaN,-147.2290556833811,-185.40727725094803,-0.06641063771083977,-0.4142647237717938,-0.347854086060954,11808371,12051851,27.091167092197935,43.161880163549164,NaN,NaN,-28.074203857430863,-24.054189868293548
2004-08-12T09:30:00-04:00,29.36,29.36,28.92999,28.96001,243900,240180,31.163606142167424,37.543914041240875,NaN,NaN,-152.43839231335534,-182.87038609709128,-0.08258161137154457,-0.4510811002753847,-0.36849948890384016,11564471,11878191,24.717171930227707,42.00019879646368,NaN,NaN,-29.788306349652512,-24.873349365630542
2004-08-13T09:30:00-04:00,28.89999,29.17999,28.89999,29.03,208700,239755,32.6535936485883,37.732750281720065,NaN,NaN,-135.05179716441148,-159.38197619785547,-0.08056206205993688,-0.4692020664787613,-0.3886400044188244,11773171,11818791,23.94426886998083,40.52583558044876,NaN,NaN,-30.638378607439837,-25.6969249716033
2004-08-16T09:30:00-04:00,29.05,29.75999,29.05,29.72,351900,249140,45.23820886303011,37.941825591284605,NaN,NaN,-56.86731866535343,-127.46251667615834,-0.027495706491285854,-0.42300963753293175,-0.3955139310416459,12125071,11853651,25.418225089807805,39.27115156202721,NaN,NaN,-26.88292357821409,-25.866353343976268
2004-08-17T09:30:00-04:00,29.72,30.17,29.72,30.10001,536300,226560,50.70190196388426,38.68026696711104,NaN,NaN,18.6597622993136,-94.58536030543755,0.035063802921465825,-0.3516841773898136,-0.38674798031127944,12661371,11986491,30.912826944050963,38.476439529043766,NaN,NaN,-21.81954247720469,-25.288237505866043
2004-08-18T09:30:00-04:00,29.95,30.36,29.89,30.36,628800,247365,54.07771541985435,39.42940684726328,NaN,NaN,53.12463290671422,-54.514622587418515,0.09255465088171383,-0.27105466670913714,-0.36360931759085097,13290171,12282851,41.30243169748582,38.421872184097126,NaN,NaN,-16.582557176366922,-24.044568887366168
2004-08-19T09:30:00-04:00,30.14999,30.38,30.12,30.22,587800,272140,52.01228630197048,39.984607219185406,NaN,NaN,58.059386932986484,-12.415066738150148,0.11811741666895526,-0.21596254675465687,-0.3340799634236121,12702371,12510431,47.79495169747221,38.67144034387467,NaN,NaN,-13.137871828049333,-22.486469307463764
2004-08-20T09:30:00-04:00,30.3,30.53,30.14999,30.49001,160300,273590,55.53928198309708,40.51583514139863,NaN,NaN,77.32548629995284,30.060389954722712,0.1482249035334548,-0.1487988340067936,-0.2970237375402484,12862671,12728331,53.13946596108671,38.90734745710667,NaN,NaN,-9.12502895380713,-20.577692114084243
2004-08-23T09:30:00-04:00,30.49001,30.5,30.32001,30.33,1027100,313820,53.05088611874719,41.26047602171116,NaN,NaN,69.68154301863888,55.37016229152116,0.15182194297876328,-0.10724630881679431,-0.2590682517955576,11835571,12670431,51.62702356456836,38.80608793290765,NaN,NaN,-6.659364728260268,-18.589359630395105
2004-08-24T09:30:00-04:00,30.35001,30.58,30.31,30.41,268800,318100,54.15680092257382,42.26530953804921,NaN,NaN,74.01924334963093,66.44205850158463,0.15358502939729402,-0.06708696504894007,-0.2206719944462341,12104371,12559031,48.751975018975244,38.332359657227144,NaN,NaN,-4.337765136748696,-16.55341755987419
2004-08-25T09:30:00-04:00,30.3,30.64,30.23,30.64,80600,317590,57.2729599430806,43.99418842632745,NaN,NaN,79.45279958779537,71.70769183780087,0.16332880390839008,-0.01651098956074648,-0.17983979346913656,12184971,12337991,43.56753933580851,37.814491641170726,NaN,NaN,-1.4219165724857041,-14.391774561675836
2004-08-26T09:30:00-04:00,30.45,30.67,30.45,30.63,527200,330710,57.09125316869349,46.023547968393935,NaN,NaN,88.314529247701,77.75872030074376,0.16187543564522117,0.022504501087389883,-0.13937093455783128,11657771,12129071,39.31223310148606,37.50680839373574,NaN,NaN,0.875435648689809,-12.210744531623602
2004-08-27T09:30:00-04:00,30.60001,30.69,30.55,30.63,220300,335150,57.09125316869349,48.079777722759594,NaN,NaN,90.27400666782104,80.3484243743174,0.15374933295808807,0.05281573163977882,-0.10093360131830925,11657771,11888091,35.05870484598215,37.41614367999267,NaN,NaN,2.7555295214655158,-10.072705381182299
2004-08-30T09:30:00-04:00,30.60001,30.60001,30.36,30.39,633300,355890,52.458707740382216,49.12983081483247,NaN,NaN,67.85691767835782,79.9834993062612,0.1262002081906267,0.05681665891997412,-0.06938354927065257,11024471,11725871,32.5087637810866,37.51048206644407,NaN,NaN,3.1435390987186915,-8.184670455482157
2004-08-31T09:30:00-04:00,30.35001,30.48,30.13,30.37,495700,377045,52.07946258451108,50.32770842637672,NaN,NaN,51.752198814202146,75.53009039917545,0.10167353035050038,0.057708363667472895,-0.04396516668302748,10528771,11410751,28.21557973401582,37.59079725514534,NaN,NaN,3.364195947662706,-6.5348323978900344
2004-09-01T09:30:00-04:00,30.3,30.48,30.3,30.47,354100,384825,53.87499626584177,51.94995057806774,NaN,NaN,60.520481436390156,71.7436267688944,0.08775337778670936,0.06572655555035922,-0.02202682223635014,10882871,11150331,25.248081399079496,37.62871936006332,NaN,NaN,4.024268732360012,-5.026389379282885
2004-09-02T09:30:00-04:00,30.3,30.96001,30.3,30.95,680900,386145,61.35917552969103,54.00034928386079,NaN,NaN,93.35812905633976,72.75234673062216,0.10526161173498967,0.10955019243238695,0.004288580697397279,11563771,11131531,25.043313677821004,37.707222560623336,NaN,NaN,6.8545160726941115,-3.3291171718576003
2004-09-03T09:30:00-04:00,30.95,31.08,30.86,30.92,85800,372305,60.696295926165845,55.10449835979906,NaN,NaN,113.6441316765252,77.42637173236298,0.10876381787306949,0.14024335303873414,0.03147953516566465,11477971,11095571,24.631807914619273,37.65104990525272,NaN,NaN,8.985883283261895,-1.5698313925548153
2004-09-07T09:30:00-04:00,31.10001,31.24001,30.99001,31.13,596600,396165,63.65614051801159,56.0298011136653,NaN,NaN,130.92931307008558,90.04085081070855,0.11837207026333733,0.17944462299483632,0.06107255273149899,12074571,11305591,31.691481915302106,37.706668117484945,NaN,NaN,11.700126126994352,0.3258768245236372
2004-09-08T09:30:00-04:00,31.19,31.35001,31.03,31.03,267300,407210,61.28921351369454,56.54490812036817,NaN,NaN,127.2728094621199,105.14497294029209,0.11125052400770417,0.2001357077411292,0.08888518373342504,11807271,11561291,39.16315696630854,37.55386277954371,NaN,NaN,13.33109335879978,2.1837649008488
2004-09-09T09:30:00-04:00,31,31.07001,30.78,30.87,826800,439110,57.59889877986756,56.94395186878939,NaN,NaN,91.02104032070193,111.24508471715444,0.08993376501645346,0.20130239000399186,0.1113686249875384,10980471,11580811,39.70535213567431,36.97603423941529,NaN,NaN,13.70546085987772,3.8297214664243597
2004-09-10T09:30:00-04:00,30.82001,31.21001,30.78,31.14999,93700,431600,61.9199024244249,57.39971047174138,NaN,NaN,111.71371923442084,114.91620275277066,0.08871133808102016,0.2222577975888136,0.13354645950779342,11074171,11482891,37.881488818029005,35.88617872919688,NaN,NaN,15.2978875805447,5.468030911298694
2004-09-13T09:30:00-04:00,31.14999,31.37,31.14999,31.25,309100,436620,63.35635646866177,58.135815496735276,NaN,NaN,139.9000936213842,120.16739514174246,0.08845963660833797,0.2441210052682159,0.15566136865987792,11383271,11463951,37.52246124146768,34.878709991832544,NaN,NaN,17.04325363307303,7.121634157266456
2004-09-14T09:30:00-04:00,31.2,31.39999,31.198,31.39,198900,428970,65.32805786836137,58.93376242143439,NaN,NaN,138.06263720341684,121.59405996840871,0.09118001262743866,0.26963638444417626,0.1784563718167376,11582171,11365471,35.63147934684383,33.941531729537445,NaN,NaN,19.09757949267617,8.832483490896415
2004-09-15T09:30:00-04:00,31.27,31.34,31.19,31.21001,75200,405915,60.79864975123402,59.18559740773106,NaN,NaN,107.42003082552604,117.62350424108995,0.07499179069593997,0.27219611018666257,0.1972043194907226,11506971,11305411,34.48989018772937,33.29312821896037,NaN,NaN,19.57706068064707,10.367423089432222
2004-09-16T09:30:00-04:00,31.21001,31.53999,31.21001,31.39999,2177200,483335,63.66244276538235,59.654968093208836,NaN,NaN,118.92684699630489,123.20466557621053,0.07124033885518513,0.286254743059704,0.21501440420451887,13684171,11846151,50.0168780387212,34.057745714477164,NaN,NaN,20.820816681541647,11.86076503116214
2004-09-17T09:30:00-04:00,31.39999,31.55,31.34,31.42,235800,465735,63.96107474895346,60.14566963465598,NaN,NaN,115.46447075973893,123.95481588127416,0.06447121140972592,0.29560341846667626,0.23113220705695034,13919971,12415311,60.60176471221133,35.88224999063639,NaN,NaN,21.923514756369794,13.298300706191805
2004-09-20T09:30:00-04:00,31.35001,31.36,31.10001,31.17999,130900,464265,57.82279595863797,60.528818793102815,NaN,NaN,66.24256277480477,109.22330971195827,0.039424700325617956,0.2804130824639728,0.24098838213835483,13789071,12896471,66.96990331981041,38.343759957688086,NaN,NaN,21.133535383035454,14.417619945740897
2004-09-21T09:30:00-04:00,31.3,31.48,31.2,31.42,263500,426085,61.773546002409496,61.221253322952705,NaN,NaN,88.69673901571905,99.35013007441871,0.03477915688590913,0.28446232824574125,0.24968317135983212,14052571,13390551,71.97853422200768,41.46968527825894,NaN,NaN,21.59661495076231,15.443190660743955
2004-09-22T09:30:00-04:00,31.2,31.22,30.99001,31,573400,441315,52.5050824113832,61.12340233334852,NaN,NaN,24.68553928629734,82.80323176657296,0.0009645067668558327,0.2508888048184019,0.2499242980515461,13479171,13784991,75.21035882946993,45.03841938042968,NaN,NaN,19.019370674288492,15.954073519821746
2004-09-23T09:30:00-04:00,31.10001,31.19,30.97,31.11,1387100,506640,54.43340577761637,60.62870449391462,NaN,NaN,24.386880356364696,63.89523843858493,-0.015538990966669497,0.23050055934320923,0.24603955030987873,14866271,14021411,76.92799146865684,48.74446779406081,NaN,NaN,17.512799433477948,16.17674865034406
2004-09-24T09:30:00-04:00,31.14999,31.34,31.10001,31.2,333500,496955,56.00720311619974,60.29376929320275,NaN,NaN,48.699202963333974,50.54218487930397,-0.021567989908494345,0.21907956292426078,0.24064755283275513,15199771,14277371,78.65255250493513,52.6030924076548,NaN,NaN,16.7465779693898,16.258152838779164
2004-09-27T09:30:00-04:00,31.19,31.19,30.98,30.98,170800,494480,51.33934727927813,59.41399834757893,NaN,NaN,3.431453349221969,37.9799629941874,-0.04045004381718545,0.19008499806127332,0.23053504187845877,15028971,14525351,80.19693482228195,56.06776761529621,NaN,NaN,14.649875095863377,16.02839887550548
2004-09-28T09:30:00-04:00,31.05,31.05,30.77,30.96001,296200,477625,50.92403843176088,58.67362869886938,NaN,NaN,-42.19617833277821,11.801379524487952,-0.053541950334810295,0.1636076039599459,0.2171495542947562,14732771,14661391,81.00864227176372,59.05673085140016,NaN,NaN,12.834914719746077,15.572186853254138
2004-09-29T09:30:00-04:00,31.10001,31.10001,30.83,31.07001,1111800,508430,53.16904901060515,58.357210858207786,NaN,NaN,-36.11397393919198,-0.3585231206099081,-0.05390071421361378,0.14977366152773897,0.20367437574135275,15844571,15134471,83.53594149463578,62.187487234183116,NaN,NaN,11.93163982482438,15.0521087063356
2004-09-30T09:30:00-04:00,31,31.3,31,31.2,1225900,552020,55.74542750781423,57.91617693559273,NaN,NaN,16.003269411337545,-2.035245309615341,-0.044861218242612216,0.14759785293808747,0.1924590711806997,17070471,15575311,85.47561837674621,65.58706791694864,NaN,NaN,11.885887049954595,14.5997913268526
2004-10-01T09:30:00-04:00,31.21001,31.66,31.21001,31.59,580100,546980,62.424560674873455,57.84962009317928,NaN,NaN,150.49286458292056,18.323487014301975,-0.013709461828065428,0.1753222438956179,0.18903170572368333,17650571,16065471,87.27125926707271,69.14055349020614,NaN,NaN,13.915489045188275,14.502033858043411
2004-10-04T09:30:00-04:00,31.8,32.00999,31.8,31.89,1069100,596145,66.60040657703277,57.94050214379867,NaN,NaN,272.9279804395468,72.22279243236694,0.02395646139279295,0.21897728246467452,0.19502082107188157,18719671,16803611,89.39710543514718,72.98095535365637,NaN,NaN,17.04743817424477,14.865663046072177
2004-10-05T09:30:00-04:00,31.89999,31.89999,31.69,31.85001,245100,578570,65.55458333068896,58.280211685188306,NaN,NaN,191.2416074039226,118.9103495797071,0.04197885908946297,0.24749439493371028,0.2055155358442473,18474571,17551971,91.03234630160216,77.019702218933,NaN,NaN,19.231857814366368,15.48940515582849
2004-10-06T09:30:00-04:00,31.85001,32.05,31.71001,32.02,374400,583925,67.86463304907122,58.580368134023225,NaN,NaN,183.2463791529097,162.78242019812743,0.06004906641516214,0.2805768688632,0.22052780244803785,18848971,18152851,92.08753677124086,80.02474927125583,NaN,NaN,21.792170813289328,16.389800249751467
2004-10-07T09:30:00-04:00,32,32.11,31.78999,31.78999,70000,546085,61.823080552091,58.42765426281876,NaN,NaN,149.24399457911858,189.43056523168363,0.051538040266389085,0.2849503527810242,0.23341231251463512,18778971,18494551,92.61938360487378,82.31172204930316,NaN,NaN,22.143556362874236,17.211765408769004
2004-10-08T09:30:00-04:00,31.64999,31.92999,31.46001,31.53999,283200,555560,55.98883804645795,58.29665726909162,NaN,NaN,72.09053509480565,173.75009933406065,0.025419393275850327,0.265186554109448,0.2397671608335977,18495771,18663591,92.87454596172594,84.16205366658285,NaN,NaN,20.598726322091945,17.695616967815138
2004-10-11T09:30:00-04:00,31.64999,31.72,31.59,31.66,127400,546475,58.03609269082183,58.02969631826393,NaN,NaN,67.3013556987334,132.62477438589798,0.013189051142342062,0.25625347476152527,0.2430644236191832,18623171,18644291,92.48142068152897,85.62654555654863,NaN,NaN,19.950142018409466,18.017691975042897
2004-10-12T09:30:00-04:00,31.39999,31.64,31.39999,31.58,493100,561185,56.160672594912405,58.29080990280173,NaN,NaN,34.39079132450443,101.25461117001436,-0.002489467279231744,0.23995258952014353,0.24244205679937528,18130071,18575391,91.00052400628769,86.75441449774992,NaN,NaN,18.85725781586783,18.1376299523036
2004-10-13T09:30:00-04:00,31.60001,31.82001,31.39999,31.48,179000,566375,53.819493165152984,58.24695900191149,NaN,NaN,36.9638152310403,71.99809838564047,-0.020778021229562266,0.21646953026242244,0.2372475514919847,17951071,18395811,87.08631848216886,87.48000928442934,NaN,NaN,17.25703080493665,18.011830074108325
2004-10-14T09:30:00-04:00,31.57001,31.57001,31.17,31.21001,135300,464280,48.001304480129235,57.675109099335025,NaN,NaN,-23.79655947368084,37.389987575080596,-0.0505447860250699,0.17406656896064732,0.22461135498571722,17815771,18203171,82.96380956172868,87.78795621705744,NaN,NaN,14.04883239760597,17.4456875488937
2004-10-15T09:30:00-04:00,31.38,31.53,31.25,31.42999,1494500,527215,52.50639513624696,57.75846966054708,NaN,NaN,-2.207645298429487,22.53035149643357,-0.05456150547836,0.1564094731377672,0.2109709786161272,19310271,18366071,83.6678759948067,88.0358805865235,NaN,NaN,12.654102016366094,16.761175329961187
2004-10-18T09:30:00-04:00,31.25,31.69,31.25,31.64999,890800,565210,56.55986047731671,58.16102837808679,NaN,NaN,25.346683343800525,14.139417025446983,-0.04210239924045059,0.15834297956556398,0.20044537880601457,20201071,18681651,84.96427475012909,88.31842576354961,NaN,NaN,12.719270595953484,16.183760367960087
2004-10-19T09:30:00-04:00,31.75,31.89999,31.45,31.45,963900,600230,52.198521764696544,58.09170500337904,NaN,NaN,39.229503468339054,15.107159454213908,-0.04667651232824019,0.14209973839571433,0.18877625072395451,19237171,18903071,85.81505176809463,88.48121935451096,NaN,NaN,11.407553319759698,15.501445075360031
2004-10-20T09:30:00-04:00,31.39,31.39,31.17999,31.28,415600,592340,48.75682777802802,57.59251930839431,NaN,NaN,-42.790243915347126,-0.8436523750635715,-0.05966665778348401,0.1141929284945995,0.1738595862780835,18821571,19077171,86.46362690033872,88.55179139191043,NaN,NaN,9.231825318792183,14.605785110136052
2004-10-21T09:30:00-04:00,31.28,31.64,31.28,31.56,215500,533760,54.12231690724879,56.99950189642112,NaN,NaN,6.282420051706196,5.172143530013836,-0.04839690329068516,0.11336345716472707,0.16176036045541223,19037071,19321431,87.33833212422955,88.55658231027876,NaN,NaN,9.04869789993228,13.811915508678371
2004-10-22T09:30:00-04:00,31.60001,31.71001,31.28999,31.28999,205000,527335,48.81435973026221,55.72906997879465,NaN,NaN,-15.090265097450322,2.595619570209669,-0.05750233959978027,0.0898824359556869,0.14738477555546717,18832071,19225791,85.0216791658995,88.24405186247536,NaN,NaN,7.161409354388787,12.861843200922717
2004-10-25T09:30:00-04:00,31.28999,31.3,31.06,31.25999,140900,525840,48.248175182975274,54.49289796824367,NaN,NaN,-86.28540071916136,-19.730797242382707,-0.06345329179676862,0.0680681608095064,0.131521452606275,18691171,18923811,77.98763437273895,87.31228672469942,NaN,NaN,5.49274556262127,11.809114966879653
2004-10-26T09:30:00-04:00,31.2,31.78,31.2,31.78,449000,533480,57.458907791209846,53.74963187839642,NaN,NaN,22.404503130706562,-23.095797309909205,-0.03187013955351263,0.09168377816438422,0.12355391771789685,19140171,18904411,77.5437900104864,86.27344767035981,NaN,NaN,7.055830339160366,11.130074305776898
2004-10-27T09:30:00-04:00,31.7,32.33,31.66,32.32001,404200,498100,64.52074617869445,53.94232228029667,NaN,NaN,181.71505459671027,21.805262392502268,0.022932012938234936,0.15221893389069052,0.1292869209524556,19544371,19048971,78.52458366183929,85.26667624585734,NaN,NaN,11.04760617752821,11.118293144598514
2004-10-28T09:30:00-04:00,32.39999,32.59,32.25,32.5,446200,459115,66.51591145722745,54.69425609535164,NaN,NaN,238.07427277294212,68.16363293674945,0.06638666354528239,0.21227025038405856,0.14588358683877617,19990571,19239671,79.77924302432393,84.33129746461434,NaN,NaN,14.896548744016593,11.658043944515383
2004-10-29T09:30:00-04:00,32.5,32.58,32.37,32.46001,1289000,494560,65.6328049669161,55.23687840078695,NaN,NaN,190.8732947580313,109.35634490784578,0.08626103689694137,0.2537098829599529,0.16744884606301152,18701571,19213571,79.09812103030991,83.37534748952727,NaN,NaN,17.5819083851761,12.504310293181199
2004-11-01T09:30:00-05:00,32.48,32.67999,32.38,32.59,403200,461265,67.15912455809709,56.022482112442994,NaN,NaN,175.29637131246633,161.67269931417133,0.10096502194269763,0.29365512349138356,0.19269010154868593,19104771,19296291,79.68995591573602,82.56744976877359,NaN,NaN,20.24934449948706,13.610743751224893
2004-11-02T09:30:00-05:00,32.55,32.95,32.55,32.71001,681300,483075,68.54793425856894,57.07451361911556,NaN,NaN,172.21561901997572,191.63492249202514,0.11079048057906302,0.3311782022725147,0.2203877216934517,19786071,19425471,80.61314778260737,82.10508043309063,NaN,NaN,22.866559675485966,14.933003168976475
2004-11-03T09:30:00-05:00,33.14999,33.14999,32.66,32.78999,331800,480945,69.47442382546511,58.60830785806812,NaN,NaN,160.760290343434,187.4439696413699,0.11423597159879689,0.3631826861919478,0.24894671459315093,20117871,19540171,81.420686916912,81.9948573870323,NaN,NaN,25.28845241415098,16.412353061144263
2004-11-04T09:30:00-05:00,32.85001,33.55,32.84,33.50999,307700,492830,76.25539730142299,60.3046651555807,NaN,NaN,178.88398600618945,175.60591228801937,0.1540862184940281,0.44155448771068606,0.28746826921665797,20425571,19627171,82.03204471260119,81.87801229544618,NaN,NaN,30.0325774133756,18.35809939717731
2004-11-05T09:30:00-05:00,33.55,33.85001,33.53,33.63,357000,496520,77.16590092663517,61.77652518767487,NaN,NaN,179.69971545093037,173.37119642659917,0.17602409152869603,0.507498383627528,0.33147429209883195,20782571,20043371,84.63653367235715,81.85460221846247,NaN,NaN,34.098153409097165,20.60667854173729
2004-11-08T09:30:00-05:00,33.61,33.77,33.56,33.64999,96900,494995,77.32189338645819,63.57105173208642,NaN,NaN,149.471940301908,168.20631022448748,0.17880057884715966,0.5549750156577815,0.37617443681062185,20879471,20398311,86.4415145105261,81.89934955720757,NaN,NaN,37.34360415577065,22.997667915170624
2004-11-09T09:30:00-05:00,33.58,33.77,33.56,33.67999,206100,480645,77.56955052216311,65.6291033566675,NaN,NaN,129.0983975601417,159.5828659325207,0.1696528248912616,0.5882404679246989,0.41858764303343726,21085571,20658211,87.59112764720878,81.97988532484115,NaN,NaN,40.035384678101266,25.431627452732144
2004-11-10T09:30:00-05:00,33.75,33.87,33.63,33.67999,357700,489580,77.56955052216311,67.3039057577328,NaN,NaN,117.62666067038131,150.95613999791016,0.1512095248741584,0.6075995491261352,0.45639002425197683,21085571,20851751,88.38117289821317,82.05437395155425,NaN,NaN,42.22596781559648,27.830818933141334
2004-11-11T09:30:00-05:00,33.75,34.00999,33.61,33.99001,1205900,543110,80.16553646057828,69.54327552418395,NaN,NaN,116.56453517794544,138.49224983226136,0.14734689997657452,0.640573649222695,0.4932267492461205,22291471,21224931,89.73788813179443,82.39124602054676,NaN,NaN,44.98319298376641,30.28115808323063
2004-11-12T09:30:00-05:00,34.05,34.27,33.91,34.21001,120300,474400,81.77727753024143,71.93821140613154,NaN,NaN,122.17503044550348,126.987312831176,0.1467449454619716,0.676657931073585,0.5299129856116134,22411771,21550771,90.75317711049688,83.30307050181518,NaN,NaN,47.86210652336442,32.79272214610688
2004-11-15T09:30:00-05:00,34.21001,34.41,34.14999,34.31,356900,447705,82.47433392761181,73.72502755873168,NaN,NaN,119.09845116089755,120.91261500297392,0.14022505217515957,0.7051943008305628,0.5649692486554032,22768671,21928611,91.76999097123847,84.31922771329748,NaN,NaN,50.46763420863557,35.317709583610984
2004-11-16T09:30:00-05:00,34.35001,34.35001,33.92,33.99001,525900,425805,72.86803227901194,74.32126228018294,NaN,NaN,93.36360241118311,113.76565597318222,0.10321594938650258,0.6939891853885314,0.5907732360020288,22242771,22160051,92.32660200843566,85.30508616662578,NaN,NaN,49.88444178006231,37.398671325961175
2004-11-17T09:30:00-05:00,34.05,34.32001,33.98,34.02,729400,441495,73.18329137005728,74.79750370252792,NaN,NaN,86.01361356528588,107.44304655216312,0.07113653503487305,0.6796939047956201,0.608557369760747,22972171,22537371,93.14105313631188,86.25950117462493,NaN,NaN,49.50147604447604,39.127643428606156
2004-11-18T09:30:00-05:00,34.05,34.21001,33.95,34.17999,443200,452880,74.86143042723941,75.45669123540814,NaN,NaN,79.28364573807512,99.98686866418907,0.05196277154417328,0.6735108341909637,0.6215480626467904,23415371,22762151,93.57833123876307,87.29380190380016,NaN,NaN,49.649690115387465,40.6307929552892
2004-11-19T09:30:00-05:00,34.24001,34.24001,33.71001,33.75,661800,475720,63.381591095539015,75.186867416654,NaN,NaN,57.51925215984554,87.05571300705748,0.004113561387945608,0.6266900143817224,0.6225764529937768,22753571,22830511,93.70967292560137,88.29521026164768,NaN,NaN,46.139541810619086,41.41775707747919
2004-11-22T09:30:00-05:00,33.64999,34,33.61,33.96001,1544000,545875,66.11469061970055,75.01306429959196,NaN,NaN,49.015985954889636,73.03921996585589,-0.018366599334240563,0.5996182038259761,0.6179848031602166,24297571,23136291,94.27384252758196,89.27097417200301,NaN,NaN,44.02362695037247,41.79002420217823
2004-11-23T09:30:00-05:00,34.05,34.25,33.94,34.14999,114600,529155,68.41156221319346,74.93714561300112,NaN,NaN,71.0655080966167,68.57960110294258,-0.025003890790780248,0.5867299396717414,0.6117338304625216,24412171,23570171,94.96402686241115,90.23835559668153,NaN,NaN,42.95775836114476,41.95684336774488
2004-11-24T09:30:00-05:00,34.35001,34.39999,34.23,34.38,2217200,619805,70.97661790513723,74.56008994183786,NaN,NaN,95.08492083129687,70.39386255614477,-0.01875163092573373,0.5882942918053544,0.6070459227310882,26629371,24301611,95.86817140670057,91.22665036054575,NaN,NaN,42.85155408874916,42.08465918503121
2004-11-26T09:30:00-05:00,34.2,34.50999,34.2,34.42,104100,602700,71.41138801359139,74.14905330519187,NaN,NaN,99.11213822395489,74.35956105332072,-0.016831459339964883,0.586006598556132,0.6028380578960969,26733471,24965231,96.48480759115354,92.07295564045978,NaN,NaN,42.89539984306215,42.200479279035626
2004-11-29T09:30:00-05:00,34.45,34.5,33.94,34.19,903200,583410,65.34951856803609,73.29388367530457,NaN,NaN,71.06370899134465,77.06845241962054,-0.03491962225889145,0.5591885300724826,0.594108152331374,25830271,25580571,96.94072446583515,92.82289920869614,NaN,NaN,41.08691763529758,42.04139904421591
2004-11-30T09:30:00-05:00,34.19,34.19,33.8,33.82001,686600,597580,56.97146176590215,71.82259162128592,NaN,NaN,17.920481770542928,70.84935158275121,-0.07345465610521384,0.5022898321998568,0.5757444883050706,25143671,25749791,97.05388813621514,93.4988106721966,NaN,NaN,36.75949299132847,41.28684103666056
2004-12-01T09:30:00-05:00,33.95,34.37,33.95,34.35001,832000,605115,64.07627734821398,70.85878639457528,NaN,NaN,72.23584041292384,71.08341804601262,-0.06518264509790106,0.49426618193269434,0.5594488270305954,25975671,26062491,97.25588802676184,94.13271889566434,NaN,NaN,35.26484137980917,40.42655537139608
2004-12-02T09:30:00-05:00,34.3,34.59,34.07001,34.39,467200,611885,64.55188580810331,69.74352563368421,NaN,NaN,99.19207023247061,71.90484792624737,-0.05912924667934094,0.4855372686814192,0.5446665153607602,26442871,26025191,96.40675642041018,94.60906663056548,NaN,NaN,34.261760699620496,39.54587041828528
2004-12-03T09:30:00-05:00,34.3,34.39999,34.10001,34.28,480800,620540,62.115780018568955,68.33913295427904,NaN,NaN,69.6371131011366,66.00984290168371,-0.0642210046798315,0.4643902595109708,0.5286112641908023,25962071,25870911,92.79779498415554,94.75511076439822,NaN,NaN,32.68717945850238,38.56605742403058
2004-12-06T09:30:00-05:00,34.17,34.27,34.07001,34.22,256300,615505,60.768648382700356,66.78872684392822,NaN,NaN,41.508001656953475,60.09870143480548,-0.07269415658698364,0.43774356845707274,0.5104377250440564,25705771,25846011,92.19790690471922,94.78567618821829,NaN,NaN,31.009404074559527,37.486535516963286
2004-12-07T09:30:00-05:00,34.23,34.3,33.97,33.98,216600,621490,55.576534284962015,65.55361984435322,NaN,NaN,-3.332305979339334,55.84814388482903,-0.09416401886195447,0.3927327014666133,0.4868967203285678,25489171,25915111,92.34578258409778,94.78704622933701,NaN,NaN,27.973554481025086,36.12753822611497
2004-12-08T09:30:00-05:00,34.00999,34.2,33.92999,34.17999,85300,615450,58.740084328093715,64.52196219849868,NaN,NaN,-4.787949847786361,40.443385832686985,-0.0943607290000853,0.3689458090784612,0.4633065380785465,25574471,25834871,90.20768886786003,94.57752021016188,NaN,NaN,26.340410007271043,34.72937705199441
2004-12-09T09:30:00-05:00,34.17999,34.48,34,34.44,380900,616610,62.4810161513135,63.6376468930754,NaN,NaN,86.98722236639354,38.00241625947158,-0.07716812426686354,0.36684638274496706,0.4440145070118306,25955371,25737371,87.55498406647648,94.1472811264271,NaN,NaN,26.082384216120303,33.49409236115525
2004-12-10T09:30:00-05:00,34.55,34.55,34.33,34.39999,193500,565990,61.556134883466285,63.507257163641626,NaN,NaN,134.9967717660484,51.074347992453944,-0.06894819234270366,0.35782926658345104,0.4267774589261547,25761871,25697331,86.43092619659689,93.62737064578394,NaN,NaN,25.602244043193572,32.3666854585893
2004-12-13T09:30:00-05:00,34.5,34.55,34.31,34.52,251000,572525,63.310474082244035,63.30695598239474,NaN,NaN,132.49475779337098,69.27169921973743,-0.05641381087871861,0.35626019532775643,0.41267400620647504,26012871,25758751,86.71272817872483,93.087291049437,NaN,NaN,25.70672195527755,31.415262100973337
2004-12-14T09:30:00-05:00,34.39999,34.77,34.39999,34.7,579700,583665,65.8292027583104,63.122501735617384,NaN,NaN,181.56919112779596,106.25199864116448,-0.037875288877622426,0.365329895109447,0.40320518398706945,26592571,25979431,87.70105281639452,92.56850718900725,NaN,NaN,26.534176723244578,30.717964189869228
2004-12-15T09:30:00-05:00,34.8,34.96001,34.69,34.85001,564300,585585,67.81237574799823,62.89648443867889,NaN,NaN,218.3792055320664,150.88542971713505,-0.018372874157308094,0.3802390912904343,0.3986119654477424,27156871,26295911,88.96833373359105,92.075661640928,NaN,NaN,27.820791594823017,30.304082390576912
2004-12-16T09:30:00-05:00,34.85001,34.92,34.67,34.78999,160200,557125,66.1579473619442,62.521238677846945,NaN,NaN,169.9427419610938,167.4765336360751,-0.012650407395108532,0.38279895620385673,0.39544936359896526,26996671,26504171,89.71906072441516,91.59239400758955,NaN,NaN,28.428226136706634,30.0361029257383
2004-12-17T09:30:00-05:00,34.8,34.8,34.46001,34.53,732800,571605,59.397820318704376,62.09611737432325,NaN,NaN,93.88093684560992,159.2533666519874,-0.028597711610957754,0.3597022240852681,0.38829993569622584,26263871,26604571,90.06989911354285,91.10162076814011,NaN,NaN,26.99901171392617,29.60223275262228
2004-12-20T09:30:00-05:00,34.60001,34.73,34.42999,34.49001,189100,547970,58.4091910349915,62.19881232211535,NaN,NaN,71.69410660235967,147.09323641378515,-0.04318615841458606,0.33431723767799326,0.3775033960925793,26074771,26616951,90.11469478107185,90.60596409991558,NaN,NaN,25.54275328960883,29.022307115048932
2004-12-21T09:30:00-05:00,34.5,34.74001,34.45,34.67999,1178200,529680,61.67289072055918,62.02714184871144,NaN,NaN,86.44302983529217,128.06800415528437,-0.04138357109112667,0.325773932228671,0.3671575033197977,27252971,26749031,90.6018057059582,90.13067250557246,NaN,NaN,25.194968466757174,28.475544451007252
2004-12-22T09:30:00-05:00,34.55,34.97,34.55,34.92,1200500,583975,65.3700704781325,62.08558361085638,NaN,NaN,131.10897230242804,110.61395750935671,-0.026114776479694957,0.334514032720179,0.36062880919987395,28453471,27008351,91.4885991380192,89.77937555683025,NaN,NaN,25.985065229213482,28.119761705036712
2004-12-23T09:30:00-05:00,34.95,34.95,34.83,34.86,105100,478370,63.71538516852893,62.199841121567815,NaN,NaN,130.65115974325968,102.75564106578989,-0.022292455931824773,0.332763239285093,0.35505569521691777,28348371,27278691,92.30388273555414,89.74409611050156,NaN,NaN,26.166042058679317,27.840658898414226
2004-12-27T09:30:00-05:00,34.95,35.05,34.84,34.88,28600,474595,64.0421189045048,62.43366044455384,NaN,NaN,123.53062763362253,108.68557922339241,-0.020688713809362602,0.3291948029552145,0.34988351676457713,28376971,27701311,93.37262635714899,89.82800464281799,NaN,NaN,26.40511050987585,27.63558055719446
2004-12-28T09:30:00-05:00,34.96001,35.28999,34.95,35.28999,257800,442325,70.0049098649814,63.46425870026951,NaN,NaN,162.91194511496718,126.92914692591394,0.004375800000855856,0.35535326676564694,0.3509774667647911,28634771,28213311,94.3891849413036,89.97396195404697,NaN,NaN,28.46231962466509,27.753686138261692
2004-12-29T09:30:00-05:00,35.28,35.33,35.21001,35.32001,117600,413875,70.39206561107729,64.29654307762549,NaN,NaN,169.44589120284098,143.5297191994237,0.018572376709077465,0.3741929376511379,0.35562056094206046,28752371,28513191,94.88414630154014,90.30799462788127,NaN,NaN,30.244825836529877,28.10956323801429
2004-12-30T09:30:00-05:00,35.35001,35.46001,35.3,35.42,461700,395360,71.70220844311558,64.95519966989706,NaN,NaN,167.07017665756032,150.72196007045014,0.0296359247129121,0.3926654668332006,0.3630295421202885,29214071,28665311,95.1193512187346,90.84830656732827,NaN,NaN,32.130891550054244,28.684038711162852
2004-12-31T09:30:00-05:00,35.41,35.46001,35.28999,35.28999,105500,377275,67.51871060643172,65.38109793582315,NaN,NaN,134.14139416411717,151.42000695462164,0.023410172608475055,0.3922922578808823,0.36888208527240723,29108571,28817351,95.34948761773475,91.48534666883812,NaN,NaN,32.56204057256898,29.238038977078013
2005-01-03T09:30:00-05:00,35.45,35.55,35.03999,35.06,429200,374695,60.764510846753055,65.19924341900237,NaN,NaN,96.56817845034625,146.0275171179664,0.00024033981119642167,0.3691825100364028,0.36894217022520637,28679371,28877831,95.44156690456059,92.10883514925497,NaN,NaN,30.941084129665803,29.48133114173341
2005-01-04T09:30:00-05:00,35.06,35.21001,34.59,34.64999,845100,404135,50.974693985219616,64.13820707806732,NaN,NaN,11.648059513269335,115.77473999762681,-0.04382411720489143,0.3141620237190921,0.3579861409239835,27834271,28717731,90.34220249079527,92.29748869742646,NaN,NaN,26.22874650876401,29.016676194166354
2005-01-05T09:30:00-05:00,34.8,34.8,34.52,34.52,130300,399820,48.316885571568996,62.74567206546523,NaN,NaN,-41.877341552903864,73.51009344647784,-0.08070488198531472,0.2571050384423401,0.33780992042765484,27703971,28508051,84.01128741859132,91.94341396064077,NaN,NaN,21.511599139869148,27.944522329266754
2005-01-06T09:30:00-05:00,34.48,34.55,34.33,34.34,129200,402015,44.83113711321909,61.22232847627058,NaN,NaN,-100.29400953213803,20.037256208538174,-0.11415727562785122,0.1951133258928408,0.309270601520692,27574771,28180191,75.14408314822401,90.90234413376996,NaN,NaN,16.42932956062106,26.299494790888797
2005-01-07T09:30:00-05:00,34.50999,34.50999,34.19,34.33,215000,393720,44.63846514098315,60.16808882071906,NaN,NaN,-117.54543692164022,-30.30011000861331,-0.13259801253575276,0.14352308585100104,0.2761210983867538,27359771,27830431,67.01757172574922,89.25574932035613,NaN,NaN,12.324328646640769,24.30304248456765
2005-01-10T09:30:00-05:00,34.2,34.61,34.2,34.46001,122200,390155,47.78064972735611,59.40890729874511,NaN,NaN,-97.1225501828888,-69.03825573526032,-0.13142571112241025,0.11183895948374101,0.24326467060615126,27481971,27590951,62.068070907060054,87.252419043641,NaN,NaN,9.760240907462597,22.225499402124072
2005-01-11T09:30:00-05:00,34.25,34.37,34.2,34.24001,184000,386805,43.30185947830087,58.09669078144094,NaN,NaN,-128.96424027501058,-97.1607156929163,-0.14005906596671544,0.06819083814775695,0.2082499041144724,27297971,27483691,59.9330965838346,85.06179696348931,NaN,NaN,6.150060661355027,19.92900815344278
2005-01-12T09:30:00-05:00,34.2,34.47,34.02,34.44,249300,370285,48.06746890077674,56.86079066877267,NaN,NaN,-108.58097754096976,-110.50144289052949,-0.1272638378901532,0.049170106751780907,0.1764339446419341,27547271,27452351,59.29135282883203,82.76199365569025,NaN,NaN,4.493858265360906,17.723986740859655
2005-01-13T09:30:00-05:00,34.44,34.45,34.14999,34.19,387600,361450,43.181367928153165,55.394075151602976,NaN,NaN,-104.37651002998645,-111.31794299009917,-0.13013558669024852,0.013764461279123452,0.14390004796937197,27159671,27369331,57.5338862903815,80.27842248103505,NaN,NaN,1.509439340285381,15.407622826491902
2005-01-14T09:30:00-05:00,34.25,34.53,34.21001,34.50999,114100,359145,50.16422962920367,54.40279734622432,NaN,NaN,-64.95487839838577,-100.79983128544828,-0.10600451573418257,0.011394403301643763,0.11739891903582633,27273771,27352131,57.15589037993025,77.69151276837657,NaN,NaN,1.1887371582599247,13.376353445315905
2005-01-18T09:30:00-05:00,34.39999,34.8,34.33,34.8,193400,332175,55.5018301464031,53.366863080611594,NaN,NaN,-19.08689931850561,-85.19270111257164,-0.06788523892811726,0.03254237037567975,0.10042760930379702,27467171,27349171,57.08638093039098,75.0270267675971,NaN,NaN,2.728892228993832,11.855287557269895
2005-01-19T09:30:00-05:00,34.85001,34.85001,34.45,34.45,175400,331490,48.7199312397342,51.81885348265852,NaN,NaN,-31.959262633768834,-65.79170558432328,-0.06368591999979892,0.020820209304048376,0.0845061293038473,27291771,27347931,57.05507750869164,72.32495042525078,NaN,NaN,1.7101289964788324,10.4059791914426
2005-01-20T09:30:00-05:00,34.21001,34.21001,33.82001,33.83,385700,291865,39.50994878287245,49.51940636406972,NaN,NaN,-142.27856045861384,-72.53122216785209,-0.09805272490448858,-0.038059776826763425,0.05999294807772515,26906071,27219691,53.77113880255211,69.37150668123773,NaN,NaN,-2.7108870869580497,8.53214115167108
2005-01-21T09:30:00-05:00,33.83,33.95,33.64999,33.71001,334500,248565,38.01228555537973,47.41180457470887,NaN,NaN,-153.68334782446675,-82.39258972674816,-0.12265751229662465,-0.09332894229305566,0.029328570003568987,26571571,27102071,50.87860598134745,66.1950151357815,NaN,NaN,-6.615636990721363,6.3681728456150175
2005-01-24T09:30:00-05:00,33.72,33.8,33.38,33.38,340900,260355,34.17532699578716,45.51257715678273,NaN,NaN,-170.3976751603059,-103.48114907913218,-0.15297725709440732,-0.16189300136444018,-0.00891574427003285,26230671,26893451,46.137867207780715,62.67332230029722,NaN,NaN,-11.210148945852476,3.8569840182625184
2005-01-25T09:30:00-05:00,33.60001,33.66,33.44,33.47,269900,272420,36.07056639024777,44.44799661428474,NaN,NaN,-148.31744854742618,-129.3272589249163,-0.15813689226053596,-0.20658685959570278,-0.048449967335166835,26500571,26700131,42.21268908638903,59.2354999142682,NaN,NaN,-14.135567510050617,1.2866195142177848
2005-01-26T09:30:00-05:00,33.62,33.69,33.43201,33.64999,269900,273025,39.80339389873198,43.83989006622495,NaN,NaN,-127.17268656759944,-148.36994371168242,-0.14115280400834498,-0.22489097234559807,-0.08373816833725309,26770471,26595871,40.22510871681876,56.10791572128446,NaN,NaN,-15.29017966656429,-1.0814946544653687
2005-01-27T09:30:00-05:00,33.64999,33.75,33.50999,33.58,47900,269540,38.85336246563347,43.41290616282598,NaN,NaN,-112.99778624772058,-142.5137888695038,-0.12681121669234782,-0.24225218920268787,-0.11544097251034005,26722571,26559171,39.519719908793725,53.56331834703944,NaN,NaN,-16.504286860270113,-3.2847506838660463
2005-01-28T09:30:00-05:00,33.5,33.55,33.23,33.42,256300,259270,36.697021849101326,42.84566021340585,NaN,NaN,-129.33035229302274,-137.643189763215,-0.1203329069809756,-0.26585710623655956,-0.14552419925558396,26466271,26538111,39.09603688797644,51.56892300148424,NaN,NaN,-18.171224173038976,-5.411389753747893
2005-01-31T09:30:00-05:00,33.42,33.85001,33.42,33.78,384700,273230,44.200860035124904,42.58996094967505,NaN,NaN,-75.31737761510749,-118.62713025417528,-0.0856633028141108,-0.2526033277732225,-0.16694002495911167,26850971,26662171,42.97445595012627,50.205093361703256,NaN,NaN,-17.24255328287752,-7.101555972194983
2005-02-01T09:30:00-05:00,33.82001,33.89999,33.7,33.81,364600,270000,44.788206836044495,42.69612861808532,NaN,NaN,-48.77489643066657,-98.71861983082337,-0.05600596444272046,-0.23694748051251224,-0.18094151606979178,27215571,26805171,47.15205028959745,49.29216148354345,NaN,NaN,-16.32524529909853,-8.419225876038347
2005-02-02T09:30:00-05:00,33.81,33.99001,33.78,33.91,299800,242735,46.79847775440685,42.60548639334461,NaN,NaN,-27.98013174116746,-78.88010886553698,-0.026450018463016728,-0.2140040391485627,-0.18755402068554597,27515371,26954151,51.165861786262866,48.711769266217075,NaN,NaN,-14.97157858251041,-9.355276262677213
2005-02-03T09:30:00-05:00,33.85001,33.85001,33.7,33.84,477500,260095,45.54828356316946,42.774551795845774,NaN,NaN,-39.94308335541963,-64.26916828707678,-0.009295712703908665,-0.19917366156543181,-0.18987794886152315,27037871,27017211,52.79997353149052,48.373632640582,NaN,NaN,-14.197544297488825,-10.047028839078871
2005-02-04T09:30:00-05:00,33.89999,34.14999,33.85001,34.14999,156500,261460,51.70164489067653,42.88436717166526,NaN,NaN,11.365740348132228,-36.12994975884579,0.02345748905424999,-0.16055608754371065,-0.18401357659796064,27194371,27162831,56.426049532907726,48.32150115150896,NaN,NaN,-11.65134725335032,-10.276217183974792
2005-02-07T09:30:00-05:00,34.17999,34.31,34.09399,34.24001,202800,260850,53.35028494414207,42.73068537150376,NaN,NaN,46.17825193963391,-11.830823847897497,0.05017936379302762,-0.1212893718566761,-0.17146873564970372,27397171,27272071,58.97238864753713,48.45621598844797,NaN,NaN,-9.052997700452375,-10.10147154347159
2005-02-08T09:30:00-05:00,34.25,34.25999,34.08,34.16,56000,257540,51.662342830987654,42.94085762802187,NaN,NaN,40.81908041845474,6.087971521926765,0.060754828473420674,-0.09552520005792786,-0.15628002853134854,27341171,27297191,59.557647967218216,48.634971021199874,NaN,NaN,-7.34919269169324,-9.708288850360397
2005-02-09T09:30:00-05:00,34.25,34.25,33.75999,33.78,138300,255255,44.46655571915101,43.29490098061319,NaN,NaN,-5.841945031899812,10.515608863780301,0.041372519291303395,-0.1045643794172193,-0.1459368987085227,27202871,27234691,57.36502305885467,48.891677039507194,NaN,NaN,-7.942462528759727,-9.456027947274587
2005-02-10T09:30:00-05:00,33.95,33.97,33.72,33.92,759200,280750,47.37477593833688,43.96365029368156,NaN,NaN,-15.208165712212713,15.462592392421678,0.03732019935067338,-0.09928664952018096,-0.13660684887085434,27962071,27419531,61.839492742714796,49.67459752246201,NaN,NaN,-7.567858168365535,-9.186289407430436
2005-02-11T09:30:00-05:00,33.75,34.22,33.73,34.09,463100,284525,50.74768692487172,45.14739028861618,NaN,NaN,22.816628169244918,17.752769956644208,0.04491831861391185,-0.08045895060346453,-0.12537726921737638,28425171,27665691,66.83182339087531,51.15273724982591,NaN,NaN,-6.238259571159584,-8.765142287963172
2005-02-14T09:30:00-05:00,34.2,34.2,33.99001,34.03999,162300,286935,49.73776043242659,46.12361843448609,NaN,NaN,46.05305532335179,17.727730633387786,0.045277499345856606,-0.06878039503505562,-0.11405789438091223,28262871,27838831,69.8222971357425,53.12485211049402,NaN,NaN,-5.43517531038357,-8.289432719737515
2005-02-15T09:30:00-05:00,34.2,34.34,34.12,34.31,102100,282370,54.950555273379365,47.20555853267519,NaN,NaN,108.37334571108043,31.238583691912925,0.061400356995664346,-0.0373074481363318,-0.09870780513199615,28364971,28043591,72.9306390893118,55.46096142281494,NaN,NaN,-3.155685741728732,-7.55604029430769
2005-02-16T09:30:00-05:00,34.14999,34.31,34.13,34.25,156400,281420,53.61976449119624,48.260301534501096,NaN,NaN,114.49131069214283,55.30523483672145,0.06535798403458155,-0.017010325088769207,-0.08236830912335076,28208571,28244731,75.5903927322114,58.03743805305906,NaN,NaN,-1.6578250504140186,-6.713438116608594
2005-02-17T09:30:00-05:00,34.36,34.36,34.08,34.08,310600,277665,49.93013471172293,49.20552388183121,NaN,NaN,88.57839208899776,76.06254639696354,0.054314307771105824,-0.014475424409468474,-0.0687897321805743,27897971,28231911,75.08400276848872,60.60800704452423,NaN,NaN,-1.4263370729062212,-5.958137967508255
2005-02-18T09:30:00-05:00,34.05,34.06,33.96001,34.00999,194700,270675,48.45149980859154,49.5091410085074,NaN,NaN,35.86680947172105,78.67258265745878,0.04070436789083207,-0.01790927231703421,-0.05861364020786628,27703271,28087531,69.44186652186215,62.498536371076796,NaN,NaN,-1.649475223466488,-5.342614718359431
2005-02-22T09:30:00-05:00,33.73,33.82001,33.33,33.34,505800,278920,37.121764708577416,48.96153799940261,NaN,NaN,-117.51725246243777,45.958521100300864,-0.012182696195168513,-0.07384201045182692,-0.06165931425665841,27197471,27874451,62.03319048435305,63.561474956416475,NaN,NaN,-5.6875704147378965,-5.391894103556354
2005-02-23T09:30:00-05:00,33.42999,33.62,33.37,33.55,361600,283505,41.721732793211444,48.59891335931722,NaN,NaN,-112.10743702102276,1.8623645538802236,-0.03072880070601529,-0.10007031513917752,-0.06934151443316224,27559071,27713271,57.07295048316311,63.98340986333792,NaN,NaN,-7.503909569435148,-5.693610598681897
2005-02-24T09:30:00-05:00,33.60001,33.61,33.34,33.58,369500,288485,42.37034798214237,48.37191796067243,NaN,NaN,-109.72013090069744,-42.97992376468783,-0.03819558194023229,-0.11708599185845259,-0.0788904099182203,27928571,27657271,55.41501514954958,64.17019855034214,NaN,NaN,-8.732246274421668,-6.127701409501864
2005-02-25T09:30:00-05:00,33.56,33.78,33.50999,33.74001,271900,299685,45.83312719210241,47.95273812505999,NaN,NaN,-62.851416360179726,-73.26588545452333,-0.02994264704589919,-0.1163187187255943,-0.0863760716796951,28200471,27717771,56.872628324657214,64.2020970354671,NaN,NaN,-8.698839424444925,-6.495006840208015
2005-02-28T09:30:00-05:00,33.74001,33.78,33.44,33.60001,461100,309925,43.37725124329854,47.24037857499974,NaN,NaN,-91.11859775520107,-98.66296689990776,-0.03134722308073454,-0.12556010053061328,-0.09421287744987875,27739371,27724991,57.05307638900806,64.06500330271503,NaN,NaN,-9.412118080458859,-6.911737017386707
2005-03-01T09:30:00-05:00,33.60001,34.03,33.60001,33.98,359800,308680,51.044769990823085,47.1962662292737,NaN,NaN,-12.370507529693649,-77.63361791335893,-0.0054753160013532726,-0.10105702245157033,-0.09558170645021706,28099171,27905331,61.39769829882574,64.19643546925842,NaN,NaN,-7.587469852839744,-7.008270279594283
2005-03-02T09:30:00-05:00,33.84,34.17999,33.83,34,331100,307005,51.417663485886465,47.69277392689765,NaN,NaN,28.086884523191564,-49.59475360451607,0.01317547269530793,-0.07911236558108214,-0.09228783827639007,28430271,28079571,65.07398554911819,64.7470756471344,NaN,NaN,-6.027520340825229,-6.868163145484418
2005-03-03T09:30:00-05:00,34.2,34.2,33.85001,33.96001,103800,297205,50.587929820783366,47.92228491850098,NaN,NaN,26.032331374227127,-22.44426114953115,0.022464047903729592,-0.06420777839672809,-0.08667182630045768,28326471,28159151,66.63679062835672,65.0897397818231,NaN,NaN,-4.994121717566586,-6.600442941496157
2005-03-04T09:30:00-05:00,34,34.28,34,34.25,186300,282645,56.11798241775583,48.30587745370698,NaN,NaN,75.59929804904922,5.2458817323146345,0.046404999210242714,-0.028665577287654287,-0.075070576497897,28512771,28221611,67.8526509309602,65.16265603468631,NaN,NaN,-2.386422690387351,-5.998440048480613
2005-03-07T09:30:00-05:00,34.25,34.39999,34.23,34.28,152400,282440,56.658393360872225,48.80020837716739,NaN,NaN,107.13179024270619,44.89595933189608,0.06157703096738794,0.0019007122113379182,-0.05967631875605002,28665171,28406771,71.20302019366977,65.26127911025254,NaN,NaN,-0.11087486195690448,-5.157359307548655
2005-03-08T09:30:00-05:00,34.3,34.31,34.06,34.10001,706200,307610,52.482371135884556,48.62390951020347,NaN,NaN,63.58935993040032,60.087932823914876,0.05691611312348886,0.011468822648311061,-0.0454472904751778,27958971,28378731,70.0130339847741,65.0528787456427,NaN,NaN,0.655802263862368,-4.326907654489937
2005-03-09T09:30:00-05:00,34.05,34.05,33.67,33.72,516500,330635,44.94958608896293,48.00461105290109,NaN,NaN,-38.03414903167008,46.863726112942544,0.02717408726135514,-0.011479681398483876,-0.038653768659839015,27442471,28181171,62.13391074123089,64.09170146057266,NaN,NaN,-1.0076064454079179,-3.8527217674782204
2005-03-10T09:30:00-05:00,33.7,33.89,33.62,33.78,478900,347665,46.26109677537765,47.74253691459071,NaN,NaN,-48.99850868608984,31.857558100879153,0.01128930995204562,-0.024542131219781993,-0.03583144117182761,27921371,28100151,59.191932738363974,62.95655360127804,NaN,NaN,-1.9624433351982205,-3.5826819914382204
2005-03-11T09:30:00-05:00,33.89999,33.96001,33.64,33.74001,173000,318355,45.4833318514028,47.53052491764866,NaN,NaN,-41.695799706162795,8.398538549836747,-0.0014841649750638383,-0.03768664739065741,-0.036202482415593575,27748371,27947271,53.996524727846456,61.853314901705495,NaN,NaN,-2.9673293018927485,-3.494774464360296
2005-03-14T09:30:00-05:00,33.73,33.83,33.63,33.78999,378700,314135,46.689681593568764,48.213947552290904,NaN,NaN,-45.843676209466736,-22.19655474059784,-0.0058928712562387325,-0.043568571485891994,-0.03767570022965326,28127071,27839651,50.62774423723819,61.03864016976872,NaN,NaN,-3.4699783995356537,-3.491232169385347
2005-03-15T09:30:00-05:00,34,34.14,33.83,33.83,1067800,359410,47.68762373204887,48.640082619350714,NaN,NaN,9.55201143485317,-33.004024439707266,-0.005450421997007571,-0.044488727725912725,-0.039038305728905154,29194871,28086831,57.2281411535086,61.04972521765054,NaN,NaN,-3.6236690051787557,-3.5101517173558343
2005-03-16T09:30:00-05:00,33.75,33.75,33.48,33.63,269800,367795,43.32197800250943,48.70805619223408,NaN,NaN,-76.8286452363201,-40.76292368063727,-0.01729501122746613,-0.060657069763237814,-0.043362058535771686,28925071,28383351,63.52727259015617,61.629172177693874,NaN,NaN,-4.984033443631927,-3.7207062496809904
2005-03-17T09:30:00-05:00,33.66,33.78,33.62,33.66,980300,408990,44.147936027351946,48.587685394751894,NaN,NaN,-50.64830431442343,-41.09288280630399,-0.021502483696984778,-0.07024016315700266,-0.04873767946001788,29905371,28780151,69.91292008253136,62.5606215889706,NaN,NaN,-5.897768932467444,-4.03171520436477
2005-03-18T09:30:00-05:00,33.64999,33.64999,33.27,33.42,895400,438230,39.22342135920916,48.29098326017408,NaN,NaN,-118.82844395002638,-56.519411655076695,-0.03788435739783168,-0.09609312620730748,-0.0582087688094758,29009971,29032471,73.13401924444514,63.70926036435896,NaN,NaN,-8.146924611125865,-4.619602262473498
2005-03-21T09:30:00-05:00,33.45,33.45,33.03999,33.25999,640800,460535,36.31498561044084,47.23885580443249,NaN,NaN,-162.28210671282574,-79.80709775574849,-0.055847024001465226,-0.12801754881130734,-0.07217052480984211,28369171,29080891,73.7155605502138,64.58910766802953,NaN,NaN,-10.95822438197779,-5.525119708116968
2005-03-22T09:30:00-05:00,33.45,33.45,32.96001,32.98,267500,448620,31.862757227364227,45.84207678596662,NaN,NaN,-179.067176861291,-117.53093541497734,-0.08138842494670903,-0.1739060559932284,-0.09251763104651936,28101671,28862251,66.69516274873675,64.70490603943085,NaN,NaN,-14.886352454234695,-6.862438671848071
2005-03-23T09:30:00-05:00,32.89999,33.02,32.82001,32.87,326500,446865,30.291500354909147,44.39233182411846,NaN,NaN,-205.822544483841,-143.3297152644815,-0.09930724195407918,-0.21665168348911834,-0.11734444153503916,27775171,28632271,60.20061908536561,64.24517950064578,NaN,NaN,-18.644361299704133,-8.545570475827509
2005-03-24T09:30:00-05:00,32.85001,33.13,32.85001,32.92,321300,444455,31.93455691691277,42.66494428834395,NaN,NaN,-164.39936742275557,-166.0799278861479,-0.10107186952317851,-0.2436842784390123,-0.1426124089158338,28096471,28270491,51.675875652977844,63.08969555221847,NaN,NaN,-21.259993158448044,-10.361916573344727
2005-03-28T09:30:00-05:00,32.97,33.25,32.95,33.14999,505300,456125,39.05091218745385,41.40726706167121,NaN,NaN,-111.51925377977678,-164.61808985209802,-0.0809019548720219,-0.24373985250586117,-0.16283789763383927,28601771,28188851,49.956711576694666,61.5721020795774,NaN,NaN,-21.449185389186738,-11.945812118465014
2005-03-29T09:30:00-05:00,33,33.13,32.71001,32.73,269600,446550,32.39098119347061,39.97216778007021,NaN,NaN,-137.88817350366443,-159.73930321026577,-0.0893370475633927,-0.27450920708808013,-0.18517215952468744,28332171,28181451,49.795004633637085,60.12795712592475,NaN,NaN,-23.82781666280856,-13.64324133908552
2005-03-30T09:30:00-05:00,32.75,33.25999,32.75,33.25999,702800,463700,45.11217755840848,39.98378145645918,NaN,NaN,-84.18034261645218,-140.761936361298,-0.054429901712844425,-0.253209536665743,-0.19877963495289855,29034971,28368111,53.85275072612093,59.536445696274036,NaN,NaN,-21.336013943229087,-14.742208853963172
2005-03-31T09:30:00-05:00,33.10001,33.35001,33.10001,33.16,1051800,499735,43.45107139634266,39.78306535795668,NaN,NaN,-57.878513234397694,-111.17313011140936,-0.034266365785538766,-0.241612592184822,-0.20734622639928324,27983171,28409711,54.73089643588865,59.217800246097234,NaN,NaN,-19.97780777665329,-15.490151557204618
2005-04-01T09:30:00-05:00,33.3,33.47,32.82001,32.89999,722300,530660,39.389430982539366,39.347786724466445,NaN,NaN,-73.25792210951518,-92.94484104876125,-0.03453484738399579,-0.250514785629278,-0.2159799382452822,27260871,28242591,50.567816533919604,58.97289251795961,NaN,NaN,-20.24813305636692,-16.16986319994209
2005-04-04T09:30:00-04:00,32.85001,33.08,32.69,32.99001,350300,538860,41.43072004122946,38.97214661358505,NaN,NaN,-89.02220322917981,-88.44543093864186,-0.02517883871564741,-0.24745348663984146,-0.22227464792419405,27611171,28044471,46.09181176863822,58.648897341631034,NaN,NaN,-19.78841382015722,-16.686799002829964
2005-04-05T09:30:00-04:00,33.05,33.25999,33.05,33.19,268300,544655,45.798133833098085,38.83718304937429,NaN,NaN,-40.53377110318425,-68.9745504585458,-0.0032054272832801323,-0.2262814320282942,-0.22307600474501407,27879471,27953931,44.16775229875563,57.71601242343439,NaN,NaN,-17.975628936835452,-16.870917564830748
2005-04-06T09:30:00-04:00,33.39999,33.39999,33.00999,33.05,571500,537920,43.360581265122924,38.83994042527525,NaN,NaN,-37.556069085385474,-59.64969575233248,0.0038343835210441213,-0.21828302534370891,-0.22211740886475304,27307971,27608531,37.70191657677535,55.87134413676433,NaN,NaN,-17.260600312866266,-16.926586528835823
2005-04-07T09:30:00-04:00,33,33.24001,32.92,33.2,206900,522440,46.637674965435885,39.01777892085267,NaN,NaN,-40.34769983188054,-56.14353307182904,0.019643447419990745,-0.1975630995897646,-0.21720654700975534,27514871,27514871,36.1562382723873,53.4601525788969,NaN,NaN,-15.63997413373609,-16.74278475810729
2005-04-08T09:30:00-04:00,33.17999,33.27,32.89999,32.94,464700,521730,42.09164076276128,39.222651735392105,NaN,NaN,-55.918526276045654,-52.67565390513514,0.013910158461791555,-0.1998188489325159,-0.21372900739430745,27050171,27472731,35.45199704050924,50.76857956433005,NaN,NaN,-15.683403584032774,-16.59144459038236
2005-04-11T09:30:00-04:00,33.03999,33.03999,32.75,32.75999,215900,523875,39.239767630155285,39.43156473680028,NaN,NaN,-100.56036466968148,-54.98328619323547,0.000048159422369492555,-0.2136688081163456,-0.21371696753871508,26834271,27317351,32.90686679944014,47.85367286784622,NaN,NaN,-16.62087710922925,-16.595649235931916
2005-04-12T09:30:00-04:00,32.85001,33.14,32.52,33.07001,1381400,574010,46.022780195866694,40.44299494883618,NaN,NaN,-82.39876148689645,-63.35628426997791,0.013090371314330718,-0.19735400339580167,-0.2104443747101324,28215671,27384591,35.078928979734684,45.59537045577464,NaN,NaN,-15.222704729676648,-16.399514306466877
2005-04-13T09:30:00-04:00,32.89999,33.00999,32.5,32.57001,294800,535360,38.54840947123112,41.0327741714306,NaN,NaN,-153.87011558157278,-86.61909356921538,-0.009411492551427397,-0.22220874039941663,-0.21279724784798923,27920871,27507171,38.95860302976057,44.078083594659994,NaN,NaN,-16.58588345962113,-16.4261384712032
2005-04-14T09:30:00-04:00,32.5,32.57001,32.10001,32.12,294700,536605,33.30568537452332,41.13071191840278,NaN,NaN,-263.01521932227854,-131.15259746729498,-0.04980041390301021,-0.275047765226752,-0.2252473513237418,27626171,27529431,39.663747529635025,43.22007444299265,NaN,NaN,-19.673776659385496,-16.89008678380067
2005-04-15T09:30:00-04:00,32,32,31.42999,31.47,1753900,575285,27.489997220788723,40.30493227792671,NaN,NaN,-350.99300946504593,-190.16749410509505,-0.11193273173006679,-0.3651632659863253,-0.2532305342562585,25872271,27293851,35.0491945027959,42.15525179485702,NaN,NaN,-24.656588227523198,-17.999586990046744
2005-04-18T09:30:00-04:00,31.39999,31.58,31.32001,31.533,1661200,613575,28.787918322449585,40.04757064428235,NaN,NaN,-275.83088889743885,-225.22159895064652,-0.13867919881980884,-0.42657953278101957,-0.28790033396121073,27533471,27433691,39.54536894096462,41.423134959666136,NaN,NaN,-27.88757636791641,-19.41215690117098
2005-04-19T09:30:00-04:00,31.55,31.84,31.45,31.57001,615900,612330,29.585319374546557,38.93850934543507,NaN,NaN,-184.8902459213103,-245.7198958375293,-0.1431869493405603,-0.46688402063691115,-0.32369707129635084,28149371,27420431,39.26778660565006,40.38135180820393,NaN,NaN,-30.090807823058768,-20.937678461440665
2005-04-20T09:30:00-04:00,31.47,31.53999,31.00999,31.05,182600,608085,25.29883757985337,37.64192121568584,NaN,NaN,-190.51471942241017,-253.04881660569677,-0.16874096249882226,-0.5346232744198787,-0.3658823119210564,27966771,27429611,39.583965046528576,39.29942813753535,NaN,NaN,-33.53763399374898,-22.737672108913284
2005-04-21T09:30:00-04:00,31.53999,31.84,31.35001,31.82001,283800,605950,39.31883634761738,37.636878741762835,NaN,NaN,-108.09669096124586,-222.06511093349022,-0.12343612428426715,-0.5201774672763904,-0.3967413429921232,28250571,27554491,43.865302160906964,38.820677110891594,NaN,NaN,-31.280014686857104,-23.958006762905256
2005-04-22T09:30:00-04:00,31.89999,31.89999,31.12,31.34,348600,607315,34.919139514613505,37.17176584700456,NaN,NaN,-112.38382522677445,-174.34327408583593,-0.11558530550475932,-0.5412229748730724,-0.42563766936831304,27901971,27960431,55.022932791217855,39.45861432679014,NaN,NaN,-31.119736059013675,-24.981110948063602
2005-04-25T09:30:00-04:00,31.56,31.66,31.41,31.62,502900,607195,39.19343917283713,36.700001942700204,NaN,NaN,-87.99157930226075,-136.77541216680032,-0.0828559884256782,-0.5292076549004108,-0.44635166647473257,28404871,28134711,58.808401206479516,40.50437496305614,NaN,NaN,-29.42719935587596,-25.616266434893937
2005-04-26T09:30:00-04:00,31.45,31.73,31.39999,31.39999,466500,617040,37.129936845169055,36.2549559127035,NaN,NaN,-82.51719273197764,-116.30080152893375,-0.06796966000075078,-0.531313741475671,-0.46334408147492023,27938371,28092511,57.54544289972427,41.921769700409634,NaN,NaN,-28.81868504111627,-26.073754807211415
2005-04-27T09:30:00-04:00,31.45,31.58,31.14999,31.44,1098500,636825,37.771576507392474,35.621663165700404,NaN,NaN,-84.16177211461765,-95.03021206737523,-0.04829855157278057,-0.5237172709408959,-0.47541871936811536,29036871,28306531,62.002344393088585,43.76792013760258,NaN,NaN,-28.14198450984572,-26.36921619330203
2005-04-28T09:30:00-04:00,31.2,31.39999,30.97,30.98,319500,600210,33.534094627629926,35.01040987033387,NaN,NaN,-98.46059503324814,-93.10299288177569,-0.05845901566090056,-0.5484924889442411,-0.4900334732833405,28717371,28399891,63.78821433890267,45.79193565891639,NaN,NaN,-28.964957675769664,-26.74003640508312
2005-04-29T09:30:00-04:00,31.10001,31.21001,30.62,31.05,792700,603730,34.73402070813036,34.68857080447495,NaN,NaN,-102.14629456316862,-91.05548674905451,-0.05282810140653815,-0.5560686000415132,-0.503240498634975,29510071,28721511,69.16480120765056,48.3817881166457,NaN,NaN,-29.236986527925346,-27.096743565489152
2005-05-02T09:30:00-04:00,31.92,31.92,31.03999,31.21001,260600,599245,37.51112409960675,34.08059536902781,NaN,NaN,-57.92935769511669,-85.0430424276257,-0.03173000511744273,-0.5429030050317785,-0.5111729999143357,29770671,28994671,72.85167674971026,51.079841528786815,NaN,NaN,-28.61438256419786,-27.313549136733254
2005-05-03T09:30:00-04:00,31.16,31.49001,31.10001,31.33,567100,614185,39.587077714263316,34.154785957815825,NaN,NaN,-61.39231537682064,-80.81806695659431,-0.0045250396545162275,-0.516829299482481,-0.5123042598279648,30337771,29474551,77.85997384729355,53.85851087289632,NaN,NaN,-27.4894999897428,-27.338684972877473
2005-05-04T09:30:00-04:00,31.60001,32.00999,31.48,32,1203000,645760,49.64622951065841,35.32196768182548,NaN,NaN,-2.276444988652047,-64.44100153140117,0.060192130610261796,-0.43706409656513756,-0.49725622717539936,31540771,29975331,81.6618763678719,56.85837721848467,NaN,NaN,-23.16152346047722,-26.741947613963152
2005-05-05T09:30:00-04:00,31.95,32.14999,31.73,31.81,389200,654875,47.243857020299366,36.732957667504806,NaN,NaN,14.530999043116548,-41.84268271612824,0.09000826218286362,-0.3847458994468198,-0.4747541616296834,31151571,30462171,84.45634891883034,60.38745967677284,NaN,NaN,-20.377667836620837,-25.832764788628534
2005-05-06T09:30:00-04:00,32.14999,32.14999,31.75,31.81,277600,645520,47.243857020299366,38.051239003065504,NaN,NaN,27.06254240594818,-16.00091532230487,0.10830629705187433,-0.3393712903148405,-0.4476775873667148,31151571,30790471,86.00510783790374,63.70601245512564,NaN,NaN,-18.17168070557478,-24.73832420533514
2005-05-09T09:30:00-04:00,31.88,31.99001,31.77,31.99001,197400,644595,49.90728550222509,39.50280801218539,NaN,NaN,42.66295831612157,4.117547879942781,0.1296667645305084,-0.2855941317035793,-0.4152608962340877,31348971,31106131,87.31395895131367,67.13788190838731,NaN,NaN,-15.531719723051834,-23.42309499358038
2005-05-10T09:30:00-04:00,31.75,31.84,31.55,31.60001,212800,586165,44.648044161021744,40.88489419655457,NaN,NaN,9.416280351035088,18.279267025513924,0.11515471109998987,-0.2713175073591003,-0.3864722184590902,31136171,31265811,87.92896697748326,70.59109633202694,NaN,NaN,-14.763524989190389,-22.18601356438181
2005-05-11T09:30:00-04:00,31.60001,31.71001,31.3,31.59,633600,603105,44.51837026396801,41.256289476293894,NaN,NaN,-9.093737969654354,16.915808429313465,0.10290681554476172,-0.25783869902813805,-0.3607455145728998,30502571,31058171,82.33904584020966,73.33922088054855,NaN,NaN,-14.1818224687864,-21.042557693582467
2005-05-12T09:30:00-04:00,31.60001,31.81,31.42,31.42999,409700,608855,42.39855083807894,41.79053314225571,NaN,NaN,8.14466128338892,15.638540877367936,0.08291291018424707,-0.2571043768425909,-0.340017287026838,30092871,30846431,76.9656686365219,74.90655915521313,NaN,NaN,-14.284950549165812,-20.077185244380086
2005-05-13T09:30:00-04:00,31.39999,31.67,31.23,31.41,603100,551315,42.12866032948098,42.0001917963017,NaN,NaN,-28.27079705684203,4.571872984809895,0.06785884349416921,-0.2551937326591265,-0.3230525761532957,29489771,30514071,69.31880904390212,75.6573025721719,NaN,NaN,-14.443039746701805,-19.27230731614033
2005-05-16T09:30:00-04:00,31.41,31.8,31.41,31.8,255400,481025,48.95553252383172,42.84487720192046,NaN,NaN,46.963790376891495,5.43203939696388,0.08270007099155047,-0.21967748741385762,-0.3023775584054081,29745171,30193311,62.830754636503734,76.03482483908472,NaN,NaN,-12.635839919896014,-18.324240545248287
2005-05-17T09:30:00-04:00,31.85001,32.12,31.82001,32.07001,421900,471325,53.082167913442696,43.9384908737812,NaN,NaN,138.72091032103842,31.292965390964547,0.10765511637638459,-0.16780866293492736,-0.27546377931131194,30167071,29999491,59.22362739464315,75.83634505348148,NaN,NaN,-9.844913554897579,-17.11290811805533
2005-05-18T09:30:00-04:00,32.33,32.77,32.23,32.7,183600,471375,61.003701946706286,45.90060568228665,NaN,NaN,246.43212632132287,82.39813824915998,0.1603688369949987,-0.07500273306756355,-0.23537157006256226,30350671,29969111,58.65520703870717,75.46970167489607,NaN,NaN,-4.6382870633495346,-15.330819395954503
2005-05-19T09:30:00-04:00,32.74001,33,32.69,32.96001,997600,507065,63.725837972101715,47.971449772570324,NaN,NaN,246.72690899542587,130.11458779156737,0.20374104485707462,0.01930473600878102,-0.1844363088482936,31348271,30220191,61.90911120814001,74.95143810350247,NaN,NaN,0.580737480194255,-13.057739842218966
2005-05-20T09:30:00-04:00,32.13,32.92999,32.13,32.87,178800,498575,62.10950836789478,49.72847722030518,NaN,NaN,161.21216723519228,168.01118064997425,0.21618270494995726,0.08579207233915298,-0.13039063261080427,31169471,30556131,65.78871684495182,74.4469409674483,NaN,NaN,4.292208554793466,-10.579175785502905
2005-05-23T09:30:00-04:00,32.8,33.17999,32.8,33.08,306100,488735,64.37951643086251,51.49936570006226,NaN,NaN,184.3750476045373,195.4934320955034,0.22723869775254524,0.15365773957987727,-0.07358095817266797,31475571,30902211,69.26200976575721,73.83280067591,NaN,NaN,8.107463695551573,-7.909655859637979
2005-05-24T09:30:00-04:00,33.07001,33.07001,32.89999,33.02,512700,491045,63.21424064009436,52.46850935216484,NaN,NaN,152.19070677581442,198.18739138645861,0.21909791554192984,0.20029143625474433,-0.018806479287185505,30962871,31061371,70.73358892233463,73.05220871551447,NaN,NaN,10.88359955691453,-5.224905085844764
2005-05-25T09:30:00-04:00,32.91,33.00999,32.77,32.92,687500,470495,61.22519555391769,53.46717639028043,NaN,NaN,118.37220322029437,172.5754067662529,0.1962996448906835,0.22656807682616886,0.030268431935485375,30275371,31046311,70.39019228670236,72.04748324179104,NaN,NaN,12.646217064559695,-2.671887635786984
2005-05-26T09:30:00-04:00,33,33.14,32.94,33.09,337400,471390,63.33717290983391,54.61669895381861,NaN,NaN,117.57345163097482,146.7447152933627,0.1822928301002127,0.25813446956075126,0.07584163946053855,30612771,30899211,66.97020602842247,70.68784739825666,NaN,NaN,14.752880079265534,-0.18263510506519554
2005-05-27T09:30:00-04:00,33.14999,33.14999,33.03,33.09,493900,456450,63.33717290983391,55.575976625790666,NaN,NaN,105.5926979241208,135.62082143114839,0.16326610481810047,0.27992427048316415,0.11665816566506368,30612771,30787871,64.41897805622412,69.05249162003598,NaN,NaN,16.486774905955315,2.198709182223449
2005-05-31T09:30:00-04:00,33.03999,33.06,32.88,32.97,1084800,497660,60.63350106508528,56.717794976080924,NaN,NaN,81.58704927826162,115.06322176589326,0.13406017313477706,0.284233382083535,0.15017320894875794,29527971,30398351,56.333631988974446,66.79568197799964,NaN,NaN,17.266501830980264,4.351250989188708
2005-06-01T09:30:00-04:00,33.10001,33.25,32.89,33.11031,669300,502770,62.641558437385484,58.012308417039314,NaN,NaN,85.01471983920122,101.62802437857061,0.11631196109874475,0.2955631603221889,0.17925119922344412,30197271,30245231,53.49142444617564,64.7351375927115,NaN,NaN,18.476692581594328,6.369171216675225
2005-06-02T09:30:00-04:00,32.98,33.35001,32.98,33.28,178100,451525,64.9688762925113,59.62447452092734,NaN,NaN,89.03455911870554,95.76049555825287,0.10828548084330664,0.31460805027757743,0.2063225694342708,30375371,30265231,53.81916679229484,63.08181603240956,NaN,NaN,20.165663780950226,8.340098725857368
2005-06-03T09:30:00-04:00,33.19,33.37,32.98,33.03999,236600,443895,59.338217423140016,60.853728599045844,NaN,NaN,74.19806988590858,87.0854192092396,0.08038025370398122,0.30679788656424734,0.22641763286026612,30138771,30170431,51.95041523258043,61.841216474458015,NaN,NaN,20.103067594234474,10.02052284991124
2005-06-06T09:30:00-04:00,33.09,33.14999,32.99001,33.09,371400,448585,60.11390630646881,61.65075529780564,NaN,NaN,63.32422704516486,78.63172503344842,0.05980344725395734,0.3011719419277128,0.24136849467375546,30510171,30149911,51.5332998050879,61.034255415071165,NaN,NaN,20.25750044993943,11.482948221343838
2005-06-07T09:30:00-04:00,33.03,33.47,33.03,33.14,201500,448790,60.916675114836494,62.21036295504805,NaN,NaN,73.96853709082416,77.10802259596093,0.044761680782632374,0.29732059565204594,0.25255891486941356,30711671,30386651,55.92965387036025,60.798971591908106,NaN,NaN,20.59702201872978,12.784958763827543
2005-06-08T09:30:00-04:00,33.25,33.27,32.98,33,399400,458120,57.43121813179175,61.95518553969701,NaN,NaN,55.00791739540687,71.10666210720207,0.021750307341969977,0.27974679904687605,0.2579964917049061,30312271,30409651,56.34397234708367,60.63388339964928,NaN,NaN,19.962979129631066,13.810390244656617
2005-06-09T09:30:00-04:00,32.95,33.21001,32.8324,33.13,426000,447740,59.735049591855145,61.67012922682226,NaN,NaN,48.044301442422714,62.908610571945495,0.012131228750822065,0.2731605276434337,0.2610292988926116,30738271,30482231,57.69557021089933,60.332916185560656,NaN,NaN,20.014833575622703,14.696739291937487
2005-06-10T09:30:00-04:00,33.12,33.2,32.96001,33.13,451100,449810,59.735049591855145,61.500525028533715,NaN,NaN,51.47336431134082,58.36366945703194,0.0030864832934846542,0.26488740300946745,0.2618009197159828,30738271,30602131,59.904036803684164,59.912581896898686,NaN,NaN,20.058215433880623,15.46266445507222
2005-06-13T09:30:00-04:00,33.14999,33.36,32.99001,33.17999,355300,437420,60.683988142725944,61.23655872223825,NaN,NaN,68.94314056436048,59.48745216087101,-0.0019409304851608633,0.2593747566095317,0.26131568709469255,31093571,30718811,61.983898640027085,59.39271681648939,NaN,NaN,20.332248557589143,16.15831932686035
2005-06-14T09:30:00-04:00,33.12,33.61,33.12,33.53,314100,440355,66.61633962615994,61.4795657926715,NaN,NaN,150.40291376612603,74.77432749593137,0.014964186013191771,0.28002091961118225,0.2650567335979905,31407671,30858011,64.359149031686,58.93739968144306,NaN,NaN,22.246239939081956,17.02802227146344
2005-06-15T09:30:00-04:00,33.61,33.71001,33.33,33.53,264200,432470,66.61633962615994,61.86464751211737,NaN,NaN,214.453719653032,106.6634879474564,0.022359066524532734,0.2930055667536564,0.2706465002291237,31407671,31077091,67.77204286858395,58.75038900872032,NaN,NaN,23.826790103832575,17.999274818944745
2005-06-16T09:30:00-04:00,33.50999,33.69,33.50999,33.60001,118500,429215,67.74535203479321,62.179517449614465,NaN,NaN,218.96357197303678,140.8473420535792,0.027822377315728952,0.30542447187378485,0.2776020945580559,31526171,31234671,69.99748078964956,58.96662292023654,NaN,NaN,25.484596037766615,19.068606421633582
2005-06-17T09:30:00-04:00,33.64999,33.83,33.61,33.69,153800,387025,69.18781958282038,62.597420783399215,NaN,NaN,208.91864163812164,172.3363975189354,0.03300028594498455,0.3188524519892866,0.285852166044302,31679971,31423011,72.4464660353498,59.54001491874551,NaN,NaN,27.309289564172268,20.24584687056768
2005-06-20T09:30:00-04:00,33.5,33.75999,33.47,33.71001,203400,388255,69.51429278549648,63.23176304914286,NaN,NaN,155.96320310866471,189.74041002779626,0.03318670106095711,0.32733554237049844,0.29414884130954133,31883371,31580971,74.33838152257836,60.82606845686008,NaN,NaN,28.940291339746736,21.487910366164687
2005-06-21T09:30:00-04:00,33.85001,33.85001,33.58,33.73,386000,392250,69.85788961853473,63.74721527636781,NaN,NaN,146.5663080846939,188.9730888915098,0.030157856997716448,0.33184616255668686,0.3016883055589704,32269371,31753311,76.25412047916325,62.4519753163592,NaN,NaN,30.421843080337922,22.764186468189436
2005-06-22T09:30:00-04:00,33.75,33.88,33.56,33.72,477600,390495,69.43627932195174,64.06631549275642,NaN,NaN,122.75358268242708,170.63306149738884,0.023289900187289547,0.33080068079308234,0.3075107806057928,31791771,31830131,77.07564824859053,64.11315256323746,NaN,NaN,31.592014288823556,24.025304728280023
2005-06-23T09:30:00-04:00,33.64999,33.73,33.13,33.13,214400,366840,50.18990860008174,63.412864862537965,NaN,NaN,10.004733472004938,128.84129379718246,-0.022691635880173533,0.27914623575557584,0.3018378716357494,31577371,31840371,77.18893779400268,65.91590417476763,NaN,NaN,26.884874500432215,24.433814695730337
2005-06-24T09:30:00-04:00,33.10001,33.10001,32.82001,32.84,624600,381200,43.76818495562555,62.24531333747773,NaN,NaN,-104.03491963301782,66.25058154295456,-0.07158135959492862,0.2123611721420886,0.2839425317370172,30952771,31694931,71.76431079161533,67.36097638809102,NaN,NaN,20.533656288296946,23.876649208954138
2005-06-27T09:30:00-04:00,32.75,32.88,32.67999,32.69,666500,389830,40.85631268719802,60.81243030693212,NaN,NaN,-139.2113119467335,7.21567853187492,-0.11063337755008329,0.14565080979941314,0.25628418734949643,30286271,31375511,61.53593766923944,67.7614252308681,NaN,NaN,14.297075236618708,22.508138641477647
2005-06-28T09:30:00-04:00,32.75999,33.17999,32.75999,33.14999,172200,344200,51.510157603409155,60.38949741204765,NaN,NaN,-65.90968137677896,-35.279519360419656,-0.10229184821313,0.12841937708308393,0.23071122529621393,30458471,31013331,52.41390535150125,67.48070615975506,NaN,NaN,12.28624664135846,21.047868355746335
2005-06-29T09:30:00-04:00,33.14999,33.14999,32.92999,32.95,456500,333560,47.503619745634474,59.51582385160332,NaN,NaN,-69.48406325159345,-73.72704854722376,-0.10656747630343583,0.09750187991691917,0.204069356220355,30001971,30655371,45.2709617207023,66.59323412474099,NaN,NaN,9.244919128060488,19.361732751791212
2005-06-30T09:30:00-04:00,33.05,33.14999,32.78,32.78,308200,340065,44.346024978189526,58.416607807770056,NaN,NaN,-89.60222481239246,-93.64844020410325,-0.11637037817178278,0.058606383505626525,0.1749767616774093,29693771,30278651,39.21417058148412,65.11538653744098,NaN,NaN,5.6995295077229935,17.40998943121004
2005-07-01T09:30:00-04:00,32.95,32.96001,32.75999,32.86,669500,361710,46.159713890098914,57.379159646868125,NaN,NaN,-93.34070054052363,-91.50959638560441,-0.11290413626307097,0.0338465913485706,0.14675072761164157,30363271,30160751,37.52220680466584,63.36812283491519,NaN,NaN,3.473710226479266,15.419092401962786
2005-07-05T09:30:00-04:00,32.95,33.2,32.77,33.17,257700,356025,52.605174099293855,56.378362109234835,NaN,NaN,-47.20014329697908,-73.10736265565353,-0.08636736418672125,0.03879152237824002,0.12515888656496127,30620971,30227691,39.12811734111818,61.56590628558892,NaN,NaN,3.7070039084511377,13.745936902889694
2005-07-06T09:30:00-04:00,33.05,33.14999,32.83,32.87,217100,356805,46.76994781579116,54.96076269420849,NaN,NaN,-64.99881959199818,-72.92519029869737,-0.08549345842938609,0.018292063528228653,0.10378552195761474,30403871,30216771,38.952223943326146,59.507347790927646,NaN,NaN,1.9017799155389234,12.053914476125298
2005-07-07T09:30:00-04:00,32.59,33,32.45,32.97,410800,357375,48.80835866849628,53.608120310901576,NaN,NaN,-91.74343000038739,-77.37706364845617,-0.07502842927995314,0.009999985357673324,0.08502841463762646,30814671,30379311,43.05553467568464,57.582923068501586,NaN,NaN,1.1384627134118057,10.494564224309086
2005-07-08T09:30:00-04:00,33.05,33.49001,32.97,33.48,1017900,386970,57.704198410846814,52.787861655760594,NaN,NaN,19.63079287267546,-55.530460111442586,-0.03276421678768858,0.044073143653015734,0.07683736044070431,31832571,30807071,52.16750316488046,56.13442572061091,NaN,NaN,3.6395414211435604,9.515275252428296
2005-07-11T09:30:00-04:00,33.48,33.72,33.48,33.66,319200,380375,60.324760566266185,52.13146649724415,NaN,NaN,79.60224945605394,-20.941870112127052,0.006230395131923597,0.0846253543556088,0.07839495922368521,32151771,31164771,58.19203339067967,54.98111513976101,NaN,NaN,6.550422924703516,9.091724919896185
2005-07-12T09:30:00-04:00,33.74001,33.96001,33.60001,33.88,556900,390455,63.316366651336935,51.66421485673002,NaN,NaN,107.27892106532956,9.95394276033468,0.04367002898483287,0.1329824954547263,0.08931246646989342,32708671,31582311,63.90669612202014,54.099156257107936,NaN,NaN,9.958088616597962,9.215491162282154
2005-07-13T09:30:00-04:00,34.03,34.03,33.72,33.78999,175200,383510,61.280451963477475,51.08165575969615,NaN,NaN,103.65433732382377,43.68457414349907,0.05828873844812252,0.16217338953004656,0.10388465108192405,32533471,32008231,68.61880830039296,53.495096260808104,NaN,NaN,12.001024726854721,9.613424528649663
2005-07-14T09:30:00-04:00,34.05,34.17999,33.89,33.97,244000,382500,63.788201932286185,52.05296242628217,NaN,NaN,122.5189882744942,86.53705779847539,0.07493659147096084,0.1975553904206251,0.12261879894966425,32777471,32400791,72.21880865242609,53.14008703640978,NaN,NaN,14.500306088870696,10.311550465824096
2005-07-15T09:30:00-04:00,33.98,34.19,33.91,34.11,195600,386355,65.65148162215851,53.616055045320245,NaN,NaN,120.11390455829603,106.6336801355995,0.08925942402172679,0.23419307897682273,0.14493365495509594,32973071,32628891,74.07952427113894,53.305459427804315,NaN,NaN,17.14408277540267,11.287626510049607
2005-07-18T09:30:00-04:00,34,34.23,33.89999,34.14,326800,395005,66.05455798472451,55.41592970942928,NaN,NaN,114.27145022650019,113.56752028968876,0.09415076893145088,0.26262211611940955,0.16847134718795867,33299871,32858511,75.83420962812531,54.32676456772474,NaN,NaN,19.388334800729254,12.44487055157527
2005-07-19T09:30:00-04:00,34.25,34.37,34.16,34.35001,1103200,439995,68.81353963092785,56.65188556853776,NaN,NaN,130.43510192546654,118.19875646171613,0.10414745673999304,0.29865566811294997,0.19450821137295693,34403071,33197391,78.18167209642215,56.167319335219084,NaN,NaN,22.16645565113876,13.833668422941484
2005-07-20T09:30:00-04:00,34.27,34.50999,34.07001,34.48,768800,459135,70.416320619956,58.28850705956073,NaN,NaN,125.00276384770109,122.46844176649161,0.11147596909745969,0.33385317274478155,0.22237720364732186,35171871,33725071,81.2379165950259,58.736387540527915,NaN,NaN,24.98092819254547,15.426134104313482
2005-07-21T09:30:00-04:00,34.5,34.60001,34.28,34.39999,235900,447050,68.09651294832643,59.98497048599908,NaN,NaN,120.59554052781074,122.08375221715491,0.10309216236121094,0.35124240659883554,0.2481502442376246,34935971,34156771,83.29904071526995,61.885306835798325,NaN,NaN,26.659476177889186,17.03089725768144
2005-07-22T09:30:00-04:00,34.39999,34.62,34.35001,34.57001,148600,443760,70.33312604157575,61.71164278253314,NaN,NaN,114.33344968438082,120.92766124237187,0.10102103401083873,0.374426536751173,0.27340550274033426,35084571,34579071,85.03136430092606,65.2788180855312,NaN,NaN,28.762606489225362,18.70685571933057
2005-07-25T09:30:00-04:00,34.55,34.73,34.3,34.3,297900,427425,62.80307162973789,62.4400640347077,NaN,NaN,96.07003717153657,117.28737863137914,0.07470320816567899,0.366784512947433,0.292081304781754,34786671,34876431,86.12288724284377,68.63558736422588,NaN,NaN,28.366244552258635,20.086768409748863
2005-07-26T09:30:00-04:00,34.49001,34.60001,34.38,34.58,231600,405680,66.77552809451844,63.8690340546168,NaN,NaN,95.9258214876497,110.38552254381577,0.06949773554036309,0.3789534742072078,0.3094557386668447,35018271,34999471,86.5596150205896,72.03611529831615,NaN,NaN,29.250729468515395,21.395905703858368
2005-07-27T09:30:00-04:00,34.64999,34.67,34.39,34.67,252100,409675,67.95997099724278,65.23700636381297,NaN,NaN,94.30142681052736,104.24525513638102,0.06551420085305332,0.3913484897331614,0.32583428888010807,35270371,35019171,86.63215504303231,75.14873103884098,NaN,NaN,30.331963835360558,22.67248543693011
2005-07-28T09:30:00-04:00,34.74001,35.03,34.74001,35.02,437500,408725,72.12218989779723,66.26686289859515,NaN,NaN,124.7906323062463,105.08427349206815,0.0789486491398873,0.42452010030496723,0.3455714511650799,35707871,35173551,87.21451650386098,77.65208913448244,NaN,NaN,32.6337317747055,24.09552062804088
2005-07-29T09:30:00-04:00,35,35.02,34.64,34.64,466100,416620,62.611987838184525,66.43023627516075,NaN,NaN,98.44484363888756,101.9065522829695,0.055829261205995906,0.4153580276725748,0.3595287664665789,35241771,35204991,87.33551913203617,79.73376668743649,NaN,NaN,31.464502071128926,25.148232262767745
2005-08-01T09:30:00-04:00,34.7,34.78999,34.60001,34.64999,264800,396385,62.75104759876016,66.38985634283384,NaN,NaN,83.18886981893657,99.33031881244949,0.03577159794576468,0.40424326389878473,0.36847166595302006,35506571,35348971,87.90027091296253,81.44759345821808,NaN,NaN,30.59814945892257,25.926791862218433
2005-08-02T09:30:00-04:00,34.71001,34.82001,34.64999,34.82001,211400,394070,65.12822894525249,66.66469755581775,NaN,NaN,87.88571402810472,97.72229732054049,0.02881563028051648,0.40449120380366566,0.3756755735231492,35717971,35488911,88.43985351475979,82.86338240210144,NaN,NaN,30.60228640200518,26.59471965361654
2005-08-03T09:30:00-04:00,34.8,34.8,34.61,34.67,671600,416795,61.40469989531211,66.49444741031961,NaN,NaN,73.37501565773091,93.5370150899812,0.009946951309601826,0.38810926266015144,0.3781623113505496,35046371,35444111,87.10071700933858,83.9263758561666,NaN,NaN,29.464629661474913,27.004706797596306
2005-08-04T09:30:00-04:00,34.53,34.7,34.23,34.37,696300,431070,54.672732758327065,65.71025106290308,NaN,NaN,24.546098172640367,73.48810826326002,-0.024993939499568685,0.3469198869760888,0.37191382647565746,34350071,35172551,79.26578767674985,84.29682324228168,NaN,NaN,26.319303755259536,26.90679207726248
2005-08-05T09:30:00-04:00,34.25999,34.32001,34.00999,34.11,1922100,476280,49.59770171540219,64.53476132938006,NaN,NaN,-46.602454969477634,44.478648541586985,-0.06556724928859309,0.2899547648649161,0.3555220141535092,32427971,34609791,66.01356702683928,83.59534877076125,NaN,NaN,21.97938260621078,26.20287643854081
2005-08-08T09:30:00-04:00,34.06,34.25999,33.98,34.03,982000,509420,48.117660707174146,63.05648426339765,NaN,NaN,-71.45786647405816,13.549301282988036,-0.09590730972154948,0.23563787700157235,0.33154518672312183,31445971,33797671,52.39890764574072,81.75372273856972,NaN,NaN,18.015111108302026,25.033195677078126
2005-08-09T09:30:00-04:00,34.2,34.49001,34.10001,34.41,493900,506270,54.988557437774055,61.954501178956086,NaN,NaN,-18.628071535011316,-7.7534558296351666,-0.088668174091597,0.22070996910862561,0.3093781432002226,31939871,33042051,43.425004567124965,79.0528004508625,NaN,NaN,16.682591776162052,23.840252262661544
2005-08-10T09:30:00-04:00,34.56,34.8,34.31,34.39,447200,519870,54.57887295268492,60.9889554649817,NaN,NaN,21.955327289488263,-18.0373935032837,-0.08357958667383703,0.20490365985792636,0.2884832465317634,31492671,32331311,37.00529968380503,75.74610466290072,NaN,NaN,15.505840856574329,22.64962206179194
2005-08-11T09:30:00-04:00,34.45,34.60001,34.27,34.53999,311400,523240,57.156830580374546,60.04779150346733,NaN,NaN,5.475878189606763,-21.851437499890423,-0.06906681391656244,0.20214972913606033,0.27121654305262277,31804071,31822111,33.21658037341892,72.04504866807878,NaN,NaN,15.293427343745627,21.598737102071038
2005-08-12T09:30:00-04:00,34.39999,34.53999,34.05,34.45,1877600,607340,55.13492313241705,59.50006661080155,NaN,NaN,-46.99589715501711,-21.930125936998316,-0.06456547361770398,0.1905097010304928,0.2550751746481968,29926471,31321811,29.969892881913182,68.03412049944087,NaN,NaN,14.526313133436156,20.588390820837482
2005-08-15T09:30:00-04:00,34.39999,34.72,34.31,34.7,504600,616230,59.42872704963806,58.975295107595805,NaN,NaN,35.11297870267591,-0.6159569016514965,-0.044730547630699974,0.19916199010982183,0.2438925377405218,30431071,31118831,28.742408015156016,63.90431999905276,NaN,NaN,15.1458330415002,19.81088256664644
2005-08-16T09:30:00-04:00,34.67999,34.67999,33.97,33.98,1032200,612680,45.82607414854703,57.39430247554611,NaN,NaN,-113.74248090572053,-19.63883877579334,-0.07812579072820586,0.14623529933026447,0.22436109005847032,29398871,30610631,25.883974975696816,59.565164279957365,NaN,NaN,10.967027714051058,18.547474730561387
2005-08-17T09:30:00-04:00,33.99001,34.3,33.95,34.17999,561900,602335,49.29756834901157,55.763972364918565,NaN,NaN,-128.4123006003889,-49.71236435376877,-0.08424436172603955,0.11905563790092089,0.20329999962696044,29960771,30304251,24.314071344119796,55.07227533997586,NaN,NaN,8.797597319127618,17.15463510035656
2005-08-18T09:30:00-04:00,34.05,34.16,33.92,34.03999,1817000,681390,47.02578641911453,54.65067226355642,NaN,NaN,-143.71943181715937,-79.551426355122,-0.09445105506669355,0.08523618079359352,0.17968723586028706,28143771,29572191,21.03170236881249,50.33628842831701,NaN,NaN,6.313571510107197,15.605911730320937
2005-08-19T09:30:00-04:00,34.2,34.2,33.87,33.87,655900,706755,44.35311661563838,53.33653433619058,NaN,NaN,-139.08480218320668,-97.96920736075991,-0.10838367123897244,0.04420764681157152,0.15259131805054396,27487871,29084471,19.17448790449734,45.427303927712366,NaN,NaN,3.4192895648222326,13.864965706678266
2005-08-22T09:30:00-04:00,34,34.09,33.61,33.85001,661800,724950,44.03616509863486,51.829958347146466,NaN,NaN,-148.37064329244816,-134.66593175978474,-0.1141015750135215,0.009964349283642093,0.1240659242971636,26826071,28363471,16.81110889277062,40.31096502614171,NaN,NaN,1.03078957964533,12.031511974244989
2005-08-23T09:30:00-04:00,33.75,33.87,33.62,33.74001,433500,735045,42.24708408873375,50.461557218105156,NaN,NaN,-150.20078668185988,-141.9575929150126,-0.11985508158874192,-0.025752927688763805,0.09410215389997811,26392571,27762211,15.13568948832588,35.170605917497944,NaN,NaN,-1.4830295793375625,10.100863180876052
2005-08-24T09:30:00-04:00,33.73,33.89999,33.47,33.5,367700,740825,38.56545285899743,49.31103722529589,NaN,NaN,-153.04195361211703,-146.88352351735824,-0.13335305548559662,-0.07258916545701766,0.06076389002857896,26024871,26975031,13.27092196290289,30.45668693793745,NaN,NaN,-4.784906158175446,7.974324703868696
2005-08-25T09:30:00-04:00,33.45,33.64999,33.45,33.59,581200,748010,40.6539469111352,48.67219759641968,NaN,NaN,-147.8043885770693,-147.70051486934022,-0.12963311954389703,-0.10127750940129232,0.028355610142604702,26606071,26667491,12.616907075404782,26.642639798549272,NaN,NaN,-6.912546054518637,5.847628881241935
2005-08-26T09:30:00-04:00,33.5,33.53999,33.36,33.45,184500,733930,38.46346726546114,47.98261235058304,NaN,NaN,-153.02341239224077,-150.48823691114703,-0.129698939047245,-0.13376806366645155,-0.0040691246192065544,26421571,26454231,12.169053726849128,23.76907880434273,NaN,NaN,-9.355086383743084,3.675812414815504
2005-08-29T09:30:00-04:00,33.12,33.58,33.12,33.55,638600,752620,40.91246848251011,46.977177425207046,NaN,NaN,-141.33246104433678,-149.08060046152474,-0.11652229692042533,-0.14972199576973821,-0.033199698849312884,27060171,26501051,12.900037234365882,21.588723994859926,NaN,NaN,-10.718669030546824,1.6194579226208856
2005-08-30T09:30:00-04:00,33.39999,33.41,33.00999,33.21001,1660800,825090,35.709088204775284,45.62933565749921,NaN,NaN,-158.63303898068472,-150.7670509212897,-0.12354983376499963,-0.18763699105556242,-0.06408715729056279,25399371,26302411,12.42747092841168,19.83316479804612,NaN,NaN,-13.534368060548733,-0.5453743606890598
2005-08-31T09:30:00-04:00,33.22,33.5,33.07001,33.5,1443700,863695,42.434151206221486,44.57771570220256,NaN,NaN,-114.99010365126834,-143.15668092912,-0.10238711656044384,-0.1920710529911176,-0.08968393643067375,26843071,26466051,15.183965862310203,18.545120904395496,NaN,NaN,-13.903832663210098,-2.4537255467634935
2005-09-01T09:30:00-04:00,33.55,33.55,33.06,33.17,2020400,929900,37.61251197196148,43.32611490502717,NaN,NaN,-116.03315187392965,-136.80243358849208,-0.10399763130035396,-0.2196809755561162,-0.11568334425576225,24822671,26109371,14.13926912623161,17.41436206470396,NaN,NaN,-15.77980459505274,-4.357451125090528
2005-09-02T09:30:00-04:00,33.2,33.3,32.96001,33.05,1629600,915275,36.01016595484822,41.65336054111361,NaN,NaN,-124.8968910932236,-131.17712932868864,-0.10615879974831308,-0.2483818439411536,-0.14222304419284051,23193071,25463671,12.467008424467892,16.25183352251195,NaN,NaN,-17.80667531640719,-6.278768866707194
2005-09-06T09:30:00-04:00,32.95,33.62,32.95,33.62,1354100,933880,47.45985140910564,41.7700589168678,NaN,NaN,-69.17534127649377,-116.74570537512002,-0.06427566983881439,-0.2225676314913585,-0.1582919616525441,24547171,24961071,11.342501227776054,15.213156826231897,NaN,NaN,-15.715511651530283,-7.6268749788247785
2005-09-07T09:30:00-04:00,33.7,33.89999,33.55,33.86,2205500,1019460,51.40274771878379,41.92042887185152,NaN,NaN,-5.197920649973768,-86.05868170897784,-0.017895341683794447,-0.18066113875728718,-0.16276579707349273,26752671,25231731,15.749652558755457,14.601412627277297,NaN,NaN,-12.650780012181356,-8.344575697875719
2005-09-08T09:30:00-04:00,33.55,33.64999,33.49001,33.53999,3836400,1188920,46.402386606230316,41.87590031378836,NaN,NaN,-35.7824997636517,-70.2171609314545,-0.0068253330464053685,-0.17129746338149943,-0.16447213033509406,22916271,24446371,13.632098154614297,14.072869469120288,NaN,NaN,-11.78318869941541,-8.835806126667103
2005-09-09T09:30:00-04:00,33.55,33.86,33.55,33.82001,1828700,1264785,50.903080375488706,42.34375486806339,NaN,NaN,5.398796630560956,-45.930771230556374,0.01984061238193982,-0.1396713648576693,-0.1595119772396091,24744971,24430831,13.593153242131748,13.674202707522742,NaN,NaN,-9.524693483037694,-8.934218606148617
2005-09-12T09:30:00-04:00,33.75,33.95,33.71001,33.91,1316800,1236745,52.28963391962619,42.93328835527706,NaN,NaN,36.607920452466544,-13.629808921418341,0.0427114245003897,-0.10612269661412199,-0.1488341211145117,26061771,25004571,22.406888353988776,14.073901240466894,NaN,NaN,-7.291034848258046,-8.699478069307107
2005-09-13T09:30:00-04:00,33.8,33.8,33.42,33.42,932700,1258150,44.86057580830811,43.11996633524665,NaN,NaN,-24.55012176167749,-4.704765018455098,0.024893640006991208,-0.11771707110577267,-0.14261071111276388,25129071,25120951,24.09815497382091,14.71407734657368,NaN,NaN,-7.829401983640547,-8.575181485640455
2005-09-14T09:30:00-04:00,33.45,33.5,33.07001,33.11,1830500,1298065,40.90138472497919,43.286818611388206,NaN,NaN,-100.55876685934852,-23.776934260330048,-0.0060624890218284044,-0.15018882239004938,-0.14412633336822098,23298571,24430131,21.15107103413689,15.276945137376112,NaN,NaN,-9.62579969294043,-8.725269800969022
2005-09-15T09:30:00-04:00,33.14999,33.28,33.05,33.17,964500,1318195,41.96890618803891,43.38074427402419,NaN,NaN,-109.04380906703665,-38.42919612100704,-0.020004353185816393,-0.16913177485049147,-0.14912742166467507,24263071,24699491,25.002386056169215,16.161622207430714,NaN,NaN,-10.689971207769732,-9.00594143051198
2005-09-16T09:30:00-04:00,33.14999,33.27,33.05,33.14,971600,1275925,41.56463022599797,43.60225591406253,NaN,NaN,-102.44650721004913,-59.99825688912906,-0.028249145972510548,-0.18443885413031325,-0.1561897081578027,23291471,24408791,23.6592768584009,16.982352431112982,NaN,NaN,-11.65736627975367,-9.384716408975079
2005-09-19T09:30:00-04:00,33.10001,33.21001,32.60001,32.74001,1313100,1308785,36.51423835440835,43.28809661919813,NaN,NaN,-172.9422461769317,-101.90829021500869,-0.056038431046796205,-0.22623774696629795,-0.17019931591950174,21978371,23592111,20.351620167806445,17.514608354930164,NaN,NaN,-14.118912118913327,-10.0610300818234
2005-09-20T09:30:00-04:00,32.7,32.8,32.12,32.17,3519500,1451670,30.775412310710422,42.93569119819349,NaN,NaN,-255.44691017505127,-148.08764789768344,-0.10534362128650704,-0.3018788425276355,-0.1965352212411285,18458871,22258071,16.33441390142707,17.79367571014555,NaN,NaN,-18.319633040771805,-11.240830504530315
2005-09-21T09:30:00-04:00,32,32.03999,31.64999,31.66,4278398,1643914.9,26.727820204977178,41.81381041239033,NaN,NaN,-299.1302442476142,-187.80194337533658,-0.16148010707880114,-0.3983853550896299,-0.23690524801082877,14180473,20434451.4,12.656583394450934,17.613148391012746,NaN,NaN,-23.38739308989748,-12.976053731011339
2005-09-22T09:30:00-04:00,31.62,32.25,31.60001,32.17,3846900,1817874.9,35.81833582339016,41.68565497320666,NaN,NaN,-202.2662627774662,-206.44643411742248,-0.15349348631076448,-0.4287721058992844,-0.2752786195885199,18027373,19187311.8,10.856319141220666,17.378651963511963,NaN,NaN,-24.37105333668256,-14.603910817535798
2005-09-23T09:30:00-04:00,32.2,32.42999,32.05,32.28999,444000,1811014.9,37.774377990350494,41.81167011859968,NaN,NaN,-131.99998944617997,-212.35713056464866,-0.13027410084133584,-0.4381212456401897,-0.3078471447988539,18471373,18223292.2,9.706953524491212,17.1815051849422,NaN,NaN,-24.461762092091455,-16.012175285329462
2005-09-26T09:30:00-04:00,32.53999,32.67999,32.11,32.25,697300,1836654.9,37.36565331907681,41.090655969311904,NaN,NaN,-100.16687920805565,-197.80205717087344,-0.10863694094928367,-0.44364332098545844,-0.3350063800361748,17774073,17382432.6,8.828930317534898,17.00196440563926,NaN,NaN,-24.661417918398946,-17.24778137576796
2005-09-27T09:30:00-04:00,32.25,32.34,32.07001,32.24001,753700,1842409.9,37.257200083552824,40.080259709652545,NaN,NaN,-100.81387453822367,-166.8754500435079,-0.08696360959362587,-0.4437108920282071,-0.35674728243458126,17020373,17094733,8.544161172576494,16.487286449483623,NaN,NaN,-24.851610251989182,-18.334042643799563
2005-09-28T09:30:00-04:00,32.22,32.32001,31.91,31.95,2100200,1864379.9,34.15770609237428,39.20563967294855,NaN,NaN,-103.75645205107683,-127.80069160420044,-0.08407577307352321,-0.46184199877648524,-0.37776622570296203,14920173,17242673,10.149026769608113,16.238495636268894,NaN,NaN,-25.947168975157712,-19.42163211970787
2005-09-29T09:30:00-04:00,32,32.28999,31.75999,32.27,1994900,1891939.9,40.08104402919512,38.432637076784715,NaN,NaN,-86.77392471342168,-104.70222399139155,-0.05399266714410472,-0.4452570596330929,-0.3912643924889882,16915073,17020213,9.868591015793825,15.972455477244756,NaN,NaN,-25.071331230834282,-20.22873199272593
2005-09-30T09:30:00-04:00,32.3,32.53,32.24001,32.49001,1743900,1878114.9,43.822988315382084,37.82787667648156,NaN,NaN,-46.93729477938028,-87.68968505803161,-0.014699167326759466,-0.40963835164743756,-0.3949391843206781,18658973,17057733,10.318688427930852,15.109012625383475,NaN,NaN,-23.186782141642592,-20.65131058542831
2005-10-03T09:30:00-04:00,32.60001,32.64999,32.37,32.39999,468900,1820079.9,42.64936975747796,37.66993338713655,NaN,NaN,-37.24756358859337,-75.10582193413916,0.008555510816990908,-0.3842447957994395,-0.3928003066164304,18190073,17140933,11.375576409201486,14.200257013624945,NaN,NaN,-21.98476968969516,-20.841804743180717
2005-10-04T09:30:00-04:00,32.46001,32.55,32.13,32.17999,592400,1781994.9,39.84118557840348,37.59420487666686,NaN,NaN,-52.23947082046881,-65.39094119058817,0.012223797921729673,-0.3775205592142683,-0.389744357135998,17597673,17256393,12.909454794756286,13.611570139383472,NaN,NaN,-21.773813637636046,-20.97494887096005
2005-10-05T09:30:00-04:00,32.2,32.2,31.63,31.64,1396700,1741554.9,33.93498314690889,37.020353230871855,NaN,NaN,-96.35901578147707,-63.9114539366682,-0.01702545785001741,-0.4110261794485197,-0.3940007215985023,16200973,17512553,16.36785451310061,12.994817886307144,NaN,NaN,-23.451792129028853,-21.328783622112734
2005-10-06T09:30:00-04:00,31.7,32.03,31.41,31.67,1298900,1614679.9,34.51579153222926,36.51686475274552,NaN,NaN,-103.91580891167935,-67.33983077631974,-0.028959262796535934,-0.43019980009417225,-0.4012405372976363,17499873,17629513,17.96958634942341,12.588411421380181,NaN,NaN,-24.613823381207776,-21.79807501626917
2005-10-07T09:30:00-04:00,31.8,31.89,31.61,31.7,1956300,1621059.9,35.129963728326985,36.41798799373971,NaN,NaN,-98.27874305524062,-77.60812043149181,-0.029348484829087973,-0.43792614333399627,-0.4085776585049083,19456173,17788953,20.212919393928942,12.578504223246073,NaN,NaN,-25.383377822181764,-22.31026113139954
2005-10-10T09:30:00-04:00,31.8,31.8,31.41,31.46001,1247700,1617604.9,32.503674211460336,36.5414352723647,NaN,NaN,-121.69230406062451,-94.49706852589804,-0.03964462220541398,-0.4581334362616758,-0.4184888140562618,18208473,17792633,20.26711842571136,12.85941168926638,NaN,NaN,-26.811928284191815,-22.95335643894129
2005-10-11T09:30:00-04:00,31.39999,31.66,31.27,31.34,1840700,1663004.9,31.245721182390938,36.864142485037114,NaN,NaN,-135.21943496765633,-111.09306135533555,-0.047863280237415484,-0.47831791435303117,-0.4304546341156157,16367773,17546653,19.322287385060505,13.335533402881351,NaN,NaN,-28.371632695341898,-23.72739590414138
2005-10-12T09:30:00-04:00,31.3,31.42,30.85001,30.99001,2037300,1673344.9,27.85941067929012,36.295647831887116,NaN,NaN,-170.36934680135155,-125.89512755931044,-0.0689166750565054,-0.5166004779362474,-0.447683802879742,14330473,17172553,17.951601498877096,13.842339285571096,NaN,NaN,-30.782207099497537,-24.735226074906542
2005-10-13T09:30:00-04:00,30.75,31.14999,30.75,31.08,1818000,1716019.9,29.9612424730106,35.737566723505694,NaN,NaN,-165.70359915751786,-138.25268560847815,-0.06867540972871694,-0.5335280650406382,-0.46485265531192127,16148473,16902273,17.012610870807748,14.364171953165135,NaN,NaN,-32.17864616792282,-25.798571802480296
2005-10-14T09:30:00-04:00,31.14999,31.41,31.03999,31.39,2673400,1801109.9,36.79304444438954,35.696666089599454,NaN,NaN,-108.04426647721928,-140.20579029287387,-0.040902662127235645,-0.5159809829709658,-0.4750783208437302,18821873,16775413,16.57439193161713,14.917419211313867,NaN,NaN,-31.388745417338697,-26.597168033174352
2005-10-17T09:30:00-04:00,31.50999,31.55,31.22,31.45,1722000,1821554.9,38.052534146550165,35.75347566552784,NaN,NaN,-79.11641384814466,-131.6906122503779,-0.01319079864527306,-0.4915668191503215,-0.47837602050504846,20543873,17242493,24.305403139424072,16.04322220894584,NaN,NaN,-30.37809787419833,-27.13730086760635
2005-10-18T09:30:00-04:00,31.5,31.5,31.03999,31.12,1995200,1745339.9,34.03546911691926,35.74474445299534,NaN,NaN,-100.58375302319277,-124.7634758614852,-0.011828622215870666,-0.4931617982748868,-0.48133317605901615,18548673,17678673,30.758423419139888,17.515321969626676,NaN,NaN,-30.657652925699836,-27.640208304476847
2005-10-19T09:30:00-04:00,30.95,31.71001,30.83,31.71001,2003800,1631610,45.178563418540215,36.10885298080571,NaN,NaN,-61.01273707743965,-102.89215391670282,0.03168652201954003,-0.4417250235345911,-0.4734115455541311,20552473,18923073,45.13020019141229,20.03400833931371,NaN,NaN,-27.249640281284197,-27.584412872592182
2005-10-20T09:30:00-04:00,31.8,31.86,31.17,31.32001,1541900,1516360,40.32899944334794,35.85928234708898,NaN,NaN,-50.60998072866044,-79.87343023093133,0.03672702535972039,-0.4275027638544806,-0.464229789214201,19010573,19495493,50.24597282510653,22.885957224826257,NaN,NaN,-25.943798200261643,-27.350039347973535
2005-10-21T09:30:00-04:00,31.64,31.64,31.16,31.28,1652300,1576775,39.85633141752046,35.65977960852059,NaN,NaN,-59.647373604241565,-70.1940516563358,0.039639973489940306,-0.4146798223517756,-0.4543197958417159,17358273,19202773,47.7920774168339,25.48713586822857,NaN,NaN,-25.06867838981937,-27.0241306396658
2005-10-24T09:30:00-04:00,31.39999,31.83,31.32001,31.82001,1449800,1614400,48.610778990522746,36.286179137957674,NaN,NaN,-4.903137194984339,-55.35139632570374,0.07799188352733771,-0.35682994143254376,-0.4348218249598815,18808073,18855613,44.98603353680272,27.77832006408903,NaN,NaN,-21.331239355949666,-26.21086045627778
2005-10-25T09:30:00-04:00,31.89,31.89,31.42,31.59,1060700,1629750,45.56827590523088,37.11712862069496,NaN,NaN,-4.183860237731358,-36.071417768611454,0.08722714105211532,-0.32578789864473734,-0.41301503969685266,17747373,18695353,43.710178674141375,29.731343218449087,NaN,NaN,-19.270076888820565,-25.219319946641033
2005-10-26T09:30:00-04:00,31.45,31.7,31.39999,31.39999,1308900,1590185,43.16478516305462,37.73491388003963,NaN,NaN,-26.37069123354921,-29.143008599833372,0.08008241565930024,-0.31291202012272734,-0.3929944357820276,16438473,17872553,37.78505455801942,31.146733804777373,NaN,NaN,-18.352840150665966,-24.23839426150174
2005-10-27T09:30:00-04:00,31.49001,31.49001,30.74001,30.77,2105000,1595690,36.32387469478259,37.82019323478646,NaN,NaN,-120.47269101133779,-43.11555065636885,0.03478455286713883,-0.34951374469810403,-0.38429829756524286,14333473,16937133,32.40672865860897,32.01772018082595,NaN,NaN,-19.881174375874952,-23.61593427784077
2005-10-28T09:30:00-04:00,31,31.36,30.92999,31.31,938600,1555425,44.45048413693149,38.67353680089154,NaN,NaN,-74.23894570238636,-46.0338650759978,0.04253437897875895,-0.3311303238417942,-0.37366470282055314,15272073,16519893,30.332756559395065,32.736694333231924,NaN,NaN,-18.30120373943989,-22.856687058069216
2005-10-31T09:30:00-05:00,31.69,31.98,31.67,31.83,1918200,1627890,50.943197952975176,40.080499427361836,NaN,NaN,96.11723692902419,-25.82979025119611,0.08175391237013624,-0.27147231235788283,-0.35322622472801907,17190273,16196333,28.79382047562217,33.41323241112919,NaN,NaN,-14.621110126943998,-21.68017606790847
2005-11-01T09:30:00-05:00,31.88,31.95,31.75999,31.85001,1258000,1661170,51.17966745893244,41.74623205447915,NaN,NaN,121.39267534826253,-0.714483133997328,0.10654756843173663,-0.2200417641883483,-0.32658933262008494,18448273,16336513,30.440396225233954,34.30528917729753,NaN,NaN,-11.757371826131225,-20.262632604797435
2005-11-02T09:30:00-05:00,31.89,32.45,31.89,32.41,1208700,1651770,57.37242907273272,43.7041739544593,NaN,NaN,213.17700891102956,47.19505689491843,0.1552170582858426,-0.1325680097627817,-0.2877850680486243,19656973,16980213,37.57846327442432,35.77427863469872,NaN,NaN,-7.127309722725285,-18.386157907358555
2005-11-03T09:30:00-05:00,32.64999,32.73,32.27,32.42,3260400,1749845,57.47616292028215,45.1815395598802,NaN,NaN,223.5188190602159,115.99335890922916,0.18084727513256688,-0.061725974132915695,-0.24257324926548257,22917373,18696993,51.788368249321046,38.289562657391855,NaN,NaN,-3.535463240013318,-16.264630097737808
2005-11-04T09:30:00-05:00,32.60001,32.60001,32.34,32.53999,896800,1696870,58.772583041835034,46.661543052400546,NaN,NaN,189.11442377001603,168.66403280370963,0.19730046100575538,0.004052326991711652,-0.19324813401404373,23814173,20405413,61.24347143667063,40.92799610719518,NaN,NaN,-0.23217973932773886,-13.97428004653637
2005-11-07T09:30:00-05:00,32.64999,32.84,32.53999,32.8,3046100,1786790,61.510882569205876,48.62407258470673,NaN,NaN,185.07687955533015,186.45596132897086,0.21562522008963098,0.07628339109799498,-0.139341828991636,26860273,22339413,68.72177440874661,43.63966403502423,NaN,NaN,3.3987498300850914,-11.492418635590447
2005-11-08T09:30:00-05:00,32.78999,32.78999,32.36,32.42999,1376700,1763590,55.828162615594124,49.384758241639155,NaN,NaN,127.93138019271693,187.7637022978617,0.19346457280067555,0.10248888700920844,-0.09097568579146711,25483573,23746473,72.82946075343206,45.61818264659707,NaN,NaN,4.782020753889601,-9.167498722807583
2005-11-09T09:30:00-05:00,32.39999,32.53999,32.33,32.42,1242500,1723850,55.67859784956749,50.48115812779769,NaN,NaN,98.57702969536506,164.84370645472882,0.1696248453118732,0.12105537084837437,-0.04856947446349882,24241073,24663293,75.122048314245,47.39504518153554,NaN,NaN,5.8420654349736045,-7.023275271695985
2005-11-10T09:30:00-05:00,32.35001,32.97,32.35001,32.91,836000,1674750,61.17305129802189,52.00378097640493,NaN,NaN,124.73828000447452,145.08759864358052,0.17750400518938855,0.17331053202323687,-0.004193473166151672,25077073,25095233,76.14336604023275,49.42013722606403,NaN,NaN,8.490652949933365,-4.806999811463221
2005-11-11T09:30:00-05:00,32.91,33.07001,32.89999,33.00999,841200,1583140,62.20276434848902,52.974637073402526,NaN,NaN,134.6733578343555,134.19938545644843,0.1795568159919506,0.2202525468237866,0.04069573083183598,25918273,25516053,77.12850704333701,51.71602819081648,NaN,NaN,10.955874135891342,-2.5551606761268553
2005-11-14T09:30:00-05:00,33.2,33.2,32.97,33.03,1163400,1555210,62.41756867829098,54.17815798576397,NaN,NaN,123.97499382117758,121.9790083096179,0.17233678927870483,0.256116717430217,0.0837799281515122,27081673,25560333,77.23503220261294,54.1106605857073,NaN,NaN,13.019116596770571,-0.3302639228557944
2005-11-15T09:30:00-05:00,33.09,33.14999,32.50999,32.53999,1431200,1527010,54.282106613028596,54.97225237504782,NaN,NaN,77.02591390863981,111.79791505280248,0.1267421380828997,0.2422076007551368,0.11546546267223712,25650473,25593713,77.32078515798162,56.93464134284746,NaN,NaN,12.463128160520004,1.4973635176264624
2005-11-16T09:30:00-05:00,32.53999,32.64,32.39,32.52,1042500,1478945,53.9730451666906,56.23290740875554,NaN,NaN,46.89840663988785,101.46219044170704,0.08919187003631049,0.22695530021762522,0.13776343018131473,24607973,25667093,77.52124636547791,60.1571068933381,NaN,NaN,11.924662434006821,2.986977648537942
2005-11-17T09:30:00-05:00,32.60001,33,32.59,32.95,941000,1448900,59.336375758344595,57.29618538171361,NaN,NaN,79.38555873272037,92.3916461873562,0.08716613682976332,0.24672110121851887,0.15955496438875555,25548973,25761473,77.7931260165996,63.54713328313842,NaN,NaN,13.034721624425726,4.422369645093339
2005-11-18T09:30:00-05:00,33.87,33.87,32.95,33.17,837000,1408135,61.78962956453516,58.07093049682504,NaN,NaN,128.39545465712436,91.13606555190998,0.09391230745895734,0.27694534871245224,0.1830330412534949,26385973,25855013,78.0761500870475,67.06729968395453,NaN,NaN,14.704670062649832,5.891269704744267
2005-11-21T09:30:00-05:00,33.10001,33.36,32.34,33.28999,781900,1374740,63.097309570807404,58.922190647673254,NaN,NaN,81.4497623885226,82.63101926537898,0.0992064423568706,0.30704109419958314,0.20783465184271255,27167873,25872253,78.1314698255013,70.47380494111647,NaN,NaN,16.46987587020918,7.40249915695354
2005-11-22T09:30:00-05:00,33.25,33.48,33.14,33.44,588500,1351130,64.72276338799762,59.44721452733503,NaN,NaN,120.39086498456525,91.30400948056408,0.10500263680780558,0.33908794785246954,0.23408531104466396,27756373,26293433,79.4928627761922,73.46769061981419,NaN,NaN,18.424553012293924,8.977078279145022
2005-11-23T09:30:00-05:00,33.5,33.78999,33.5,33.67999,808000,1326085,67.21105707935425,60.142564110125896,NaN,NaN,149.2851883538965,111.7813658233658,0.11631265751036762,0.3794761329326235,0.2631634754222559,28564373,27084713,81.78687394778956,75.61044102684765,NaN,NaN,20.839206922271,10.671668085305877
2005-11-25T09:30:00-05:00,33.78,33.78,33.57001,33.67999,81800,1224925,67.21105707935425,60.74531225566299,NaN,NaN,144.01894852254895,124.70804378133153,0.1149050464990331,0.40679478354604726,0.29188973704701415,28564373,27687793,83.31850732150582,77.18722930433589,NaN,NaN,22.81089313143914,12.405843091896342
2005-11-28T09:30:00-05:00,34.27,34.27,33.33,33.37,491300,1202560,60.7879055770642,60.69367104193857,NaN,NaN,131.3738936219012,125.3037315742869,0.08555533015536465,0.39883389974121997,0.3132785695858553,28073073,28025213,84.1229951596647,78.28731650083003,NaN,NaN,22.754899667986034,13.884279745623441
2005-11-29T09:30:00-05:00,33.35001,33.60001,33.25,33.32001,810700,1147185,59.795484531953775,60.977051178821405,NaN,NaN,81.03811119601649,125.22140133578566,0.05662819883587461,0.38406381813069856,0.32743561929482395,27262373,28044113,84.16904914739571,79.09728710039886,NaN,NaN,22.434447418966055,15.105732270386671
2005-11-30T09:30:00-05:00,33.25,33.41,33.08,33.10001,1703800,1169475,55.50106628592632,60.964370352847034,NaN,NaN,42.910215038382326,109.72527134654908,0.018503635500804305,0.35056516367082935,0.33206152817002504,25558573,27604553,78.46827527434694,79.33630331183471,NaN,NaN,20.944821764719975,15.939887912434285
2005-12-01T09:30:00-05:00,33.25,33.50999,33.23,33.48,1147700,1166425,60.745084239854,60.93380127726362,NaN,NaN,72.58003914209382,94.38424150418855,0.01486063915586261,0.3506373271148533,0.3357766879589907,26706273,27232933,73.9104977909133,79.1768127225976,NaN,NaN,21.11475524533018,16.679154674276557
2005-12-02T09:30:00-05:00,33.42,33.64999,33.42,33.59,1015200,1054165,62.136140349131736,60.929042420166674,NaN,NaN,89.4987668690264,83.48020517348404,0.015756991412774535,0.3554729272249588,0.3397159358121843,27721473,27064353,71.87108624260404,78.8012826654024,NaN,NaN,21.654729475186656,17.38995107440657
2005-12-05T09:30:00-05:00,33.45,33.5,33.25999,33.39,4490602,1233855.1,58.10449498740778,60.62096572796072,NaN,NaN,52.04826184642458,67.61507881838871,-0.0003678579891450151,0.339256113325753,0.339623971314898,23230871,26095912.6,61.39120343724988,77.66958061073362,NaN,NaN,20.949539608890603,17.898463722190005
2005-12-06T09:30:00-05:00,33.53,33.72,33.47,33.49001,689700,1116035.1,59.51894620645459,60.99502569891973,NaN,NaN,77.84447276618744,66.97635113242289,-0.007169199839937135,0.33066247151497663,0.33783167135491377,23920571,25427552.2,55.38853206239274,76.10299110390585,NaN,NaN,20.753476818789053,18.30632273598987
2005-12-07T09:30:00-05:00,33.53999,33.59,33.32001,33.46001,1012600,1097830.1,58.876809753177696,61.34529459795453,NaN,NaN,53.15435170501593,69.02517846574962,-0.016050804621864756,0.3177681655775828,0.33381897019944756,22907971,24897431.8,51.11909997262024,74.21712350441601,NaN,NaN,20.415826156961536,18.60768036755725
2005-12-08T09:30:00-05:00,33.39999,33.50999,33.17,33.32001,523800,1061895.1,55.848666848763145,61.096172532984426,NaN,NaN,21.272515662919787,58.7636737699148,-0.032754049498278925,0.2928764083265989,0.3256304578248778,22384171,24033011.4,45.024634456044645,71.87651696437636,NaN,NaN,19.296449321249554,18.706075932370435
2005-12-09T09:30:00-05:00,33.32001,33.42,33.13,33.37,712400,1055715.1,56.7049359406875,60.73298013128101,NaN,NaN,9.431633234322092,42.750247042973946,-0.04128476410535237,0.27402450269318734,0.3153092667985397,23096571,23108031,39.586039835669524,69.12722337499223,NaN,NaN,18.573169403562353,18.687089285397853
2005-12-12T09:30:00-05:00,33.44,33.57001,33.38,33.41,521700,1039740.1,57.41658917683951,60.327214388854735,NaN,NaN,44.25437978956433,41.191470631601895,-0.04478934304487148,0.25932258799245034,0.3041119310373218,23618271,23185511,40.23723169806989,66.42049208017569,NaN,NaN,18.13911311155412,18.608806974848747
2005-12-13T09:30:00-05:00,33.34,33.67,33.24001,33.56,809900,1022065.1,60.06737049933542,59.99468632537887,NaN,NaN,50.94357392130167,35.811290862624745,-0.037837894708658226,0.25681456265149905,0.29465245736015727,24428171,23287031,41.13258269739894,63.6804720745476,NaN,NaN,18.441319622926404,18.58488021028841
2005-12-14T09:30:00-05:00,33.56,33.84,33.56,33.73,1051500,1003080.1,62.88705924871376,59.68582933747597,NaN,NaN,113.77547467085425,47.93551545579241,-0.02333462395921465,0.26548417741113894,0.2888188013703536,25479671,23801371,45.580915033752504,61.09433215211639,NaN,NaN,19.464599263149935,18.7105543606972
2005-12-15T09:30:00-05:00,33.71001,33.87,33.53999,33.66,469300,974420.1,60.97774069039711,59.24059245255046,NaN,NaN,106.21543695557342,64.92409971432315,-0.020121357630608405,0.26366710433209306,0.28378846196270147,25010371,24326611,49.75629564908126,58.69703131837178,NaN,NaN,19.839280929109506,18.871801013327527
2005-12-16T09:30:00-05:00,33.59,33.59,33.33,33.41,642300,959485.1,54.601715198743534,58.798721711241846,NaN,NaN,-4.262238525661578,62.185325362326395,-0.03559421092287007,0.2392956983091139,0.274889909231984,24368071,24580911,51.68899439137649,56.38031697777975,NaN,NaN,18.40497048209583,18.805110937437284
2005-12-19T09:30:00-05:00,33.33,33.45,32.98,33.05,395500,937410.1,46.9832279885878,57.88356052957284,NaN,NaN,-128.9393231750225,27.546584769409037,-0.06890686605921992,0.18875632665795905,0.25766319271717897,23972571,24651771,52.24028891044501,54.09969124656899,NaN,NaN,14.748458538832965,18.225589166208096
2005-12-20T09:30:00-05:00,33.05,33.05,32.77,32.98,946900,945660.1,45.64946586420977,57.17987478516452,NaN,NaN,-225.2324248323539,-27.688614981322075,-0.09299068375495159,0.14142483802348949,0.23441552177844108,23025671,24371271,49.81685966069692,52.0531615598797,NaN,NaN,11.334051248467372,17.241083749387993
2005-12-21T09:30:00-05:00,33.89,33.89,32.88,33.00999,2486700,1040570.1,46.352135324295006,56.15180700548173,NaN,NaN,-75.50688714669762,-65.54508734483245,-0.10343445863148013,0.10512244848909091,0.20855690712057104,25512371,24377811,49.875245375422374,50.33635781591607,NaN,NaN,8.713507194558929,16.022858527269555
2005-12-22T09:30:00-05:00,32.92,33.02,32.87,33.02,734700,1036905.1,46.60029340848635,55.04210365257849,NaN,NaN,-171.2132528030355,-121.03082529655424,-0.10582076785313796,0.07628094730414858,0.18210171515728654,26247071,24625151,52.14299734224999,48.92720860874791,NaN,NaN,6.605198628611289,14.677478541746947
2005-12-23T09:30:00-05:00,33.10001,33.13,33,33.08,1131700,1089400.1,48.14853550081986,54.33096368925078,NaN,NaN,-115.43368112863841,-143.2651138171496,-0.09960028747926725,0.05760135580820247,0.15720164328746972,27378771,25227291,57.21753940600507,48.62908974937328,NaN,NaN,5.202420251432244,13.323898785987703
2005-12-27T09:30:00-05:00,33.24001,33.24001,32.8,32.8,631900,1096430.1,42.02503758206897,53.081398787508945,NaN,NaN,-140.6097129566338,-145.59919177347186,-0.10978232248396408,0.019973740182514632,0.1297560626664787,26746871,25782151,61.29074895574994,49.05067667032737,NaN,NaN,2.1431724060342794,11.726652160280072
2005-12-28T09:30:00-05:00,32.89999,32.96001,32.84,32.86,640300,1087910.1,43.67803506703727,51.9957720242132,NaN,NaN,-136.86314517001944,-127.92533584100497,-0.10776315544083422,-0.004947881634564055,0.10281527380627016,27387171,26654451,66.6641543740214,50.16103769899886,NaN,NaN,0.02184522540983473,10.054536883870037
2005-12-29T09:30:00-05:00,32.91,33.00999,32.85001,32.85001,525200,1028980.1,43.45586831269407,51.11057212877971,NaN,NaN,-116.98886277858819,-136.22173096738305,-0.1024233436647069,-0.025213905774613465,0.07720943789009344,26861971,26924371,68.13803163489838,51.81199464034556,NaN,NaN,-1.8034752970958128,8.360535143732058
2005-12-30T09:30:00-05:00,32.67,32.88,32.63,32.64999,821900,1012690.1,39.16088844932447,49.85742587939664,NaN,NaN,-144.19907622261854,-130.81889565129967,-0.10717596499539153,-0.05676051835414597,0.05041544664124555,26040071,26882971,67.64402899636207,53.816136723252164,NaN,NaN,-4.666887022411555,6.499474834282971
2006-01-03T09:30:00-05:00,32.5,33.03999,32.25,33,1695300,1046695.1,48.71322849225704,49.23575725906932,NaN,NaN,-115.62145138958842,-130.85644970348966,-0.08265928227769426,-0.05290865620587226,0.029750626071821988,27735371,26954291,68.07345397104433,55.80443831417892,NaN,NaN,-4.453062501136613,4.934826643508744
2006-01-04T09:30:00-05:00,33,33.05,32.82001,33.03,3353400,989835,49.445899129346806,48.47708073264156,NaN,NaN,-58.07984019825086,-114.35047515181309,-0.06131626521680439,-0.046894705449183505,0.014421559767620887,31088771,27822671,72.80594680746778,58.06682146489812,NaN,NaN,-4.063306007247033,3.6493791219722045
2006-01-05T09:30:00-05:00,33.10001,33.17,32.95,33.06,636300,987165,50.21187290058006,47.57171027920344,NaN,NaN,-30.277527348885428,-93.03335158758628,-0.04294152435603685,-0.03925534567742517,0.0036861786786116756,31725071,28690251,76.54645734930384,60.278645916008934,NaN,NaN,-3.524723937172088,2.624507256380163
2006-01-06T09:30:00-05:00,33.21001,33.37,33.06,33.33,322100,952640,56.587200335182835,47.258100253830996,NaN,NaN,23.802972775508685,-64.87498447676691,-0.011976364054759011,-0.011284276389837089,0.0006920876649219223,32047171,29727291,80.07452071430278,62.444233420667615,NaN,NaN,-1.0943220458861702,2.0932459274849724
2006-01-09T09:30:00-05:00,33.36,33.67,33.35001,33.67,652200,959060,63.010459912472484,47.8587248762402,NaN,NaN,99.98998163889608,-16.03717290446399,0.029751515387864542,0.0378814818997526,0.008129966511888059,32699371,31059151,83.50613267297457,64.71688615506748,NaN,NaN,3.254276063390437,2.2591073754714674
2006-01-10T09:30:00-05:00,33.57001,33.74989,33.53,33.67999,527500,949815,63.182828986399095,49.01583923322672,NaN,NaN,110.61350957703486,29.20981928886066,0.054909537329183127,0.07676688817336697,0.02185735084418384,33226871,32157451,85.69414736601034,67.10644747332215,NaN,NaN,6.74570338924135,2.9000496631528794
2006-01-11T09:30:00-05:00,33.99001,34.13,33.66,33.85001,905400,969000,66.07988529235604,50.47515490666574,NaN,NaN,147.62735235828478,70.3512578001678,0.07845065931645284,0.1199206749897499,0.041470015673297056,34132271,32766151,86.74372875349874,69.74408097995085,NaN,NaN,10.649616902476378,4.0071306973419505
2006-01-12T09:30:00-05:00,33.78,33.78,33.52,33.55,318700,944440,57.48428765725442,51.27030864473427,NaN,NaN,85.66618762626007,93.5400007951969,0.06956925377691667,0.1284315828944429,0.05886232911752623,33813571,33183851,87.42550040902006,72.42624205377925,NaN,NaN,11.376919538946744,5.059957674714064
2006-01-13T09:30:00-05:00,33.61,33.64,33.45,33.56,420800,912905,57.68188543664033,52.061850932459556,NaN,NaN,75.06952660376602,103.79331156084837,0.06045716562486898,0.13443378614861246,0.07397662052374347,34234371,33621291,88.11488211494593,74.9956623946861,NaN,NaN,12.011709049775469,6.05306501400855
2006-01-17T09:30:00-05:00,33.44,33.5,33.3,33.38,243900,901635,52.9146589087435,52.40228831873982,NaN,NaN,45.844421768324494,92.96419958673405,0.03941501056326123,0.12324538372782001,0.08383037316455878,33990471,33879511,88.51514972522216,77.2312059889159,NaN,NaN,11.089607331463352,6.772571059359236
2006-01-18T09:30:00-05:00,33.16,33.48,33.13,33.27,1213100,930175,50.1850193656183,52.98514416042192,NaN,NaN,24.670858740223643,75.7756694193718,0.016375786910715007,0.10430010680295254,0.08792431989223753,32777371,33789611,87.41140270928645,79.09696697131135,NaN,NaN,9.488766416922413,7.160598967582547
2006-01-19T09:30:00-05:00,33.39999,33.66,33.36,33.52,652700,943035,55.76950418406421,53.84882052592384,NaN,NaN,70.296186363872,60.30943622048924,0.016229628772902543,0.10821135585836572,0.09198172708546318,33430071,33649171,85.61534876413218,80.45062371346214,NaN,NaN,9.823041790373924,7.540947942267029
2006-01-20T09:30:00-05:00,33.52,33.52,32.91,32.95,965800,943980,43.731878990640354,53.86853557434858,NaN,NaN,-22.248665408026245,38.72646561363198,-0.0219274124989359,0.0645724614617933,0.0864998739607292,32464271,33379311,82.12353323751304,81.4495881136489,NaN,NaN,5.787414806077955,7.2904432085257325
2006-01-23T09:30:00-05:00,33,33.07001,32.86,32.92999,790400,859165,43.37790647862643,54.16975114787015,NaN,NaN,-58.08019879974309,12.09652053293016,-0.04675962983938271,0.028050336661500808,0.07480996650088352,31673871,32867211,75.80523927726288,82.03253170514179,NaN,NaN,2.5973014625206603,6.619994387667865
2006-01-24T09:30:00-05:00,33.10001,33.27,33.03999,33.25999,713500,858105,50.49456053268254,54.29698915075768,NaN,NaN,-6.03604883593156,1.7204264120789474,-0.039494964650376524,0.02544126068791286,0.06493622533828938,32387371,32546591,72.0668194228519,82.31777209455663,NaN,NaN,2.2884126405355256,6.001196995220388
2006-01-25T09:30:00-05:00,33.25999,33.34,33.00999,33.14,1260100,864525,48.1259947635238,54.20271026748461,NaN,NaN,-13.756612661636806,-5.965067868293145,-0.04112071459320223,0.01353533209678659,0.05465604668998882,31127271,32216571,68.33136630766528,81.99815920171359,NaN,NaN,1.2547163196514355,5.3231283272819665
2006-01-26T09:30:00-05:00,33.28,33.35001,33.14999,33.28,342000,850030,51.013262349991386,54.25995237101399,NaN,NaN,6.2306737732837485,-18.778170386410796,-0.03154790316390043,0.015221167735113283,0.046769070899013714,31469271,31824411,64.08082954362119,81.10775721559341,NaN,NaN,1.3470185648266502,4.755112646931207
2006-01-27T09:30:00-05:00,33.28999,33.60001,33.27,33.42999,291300,832580,53.96926050469123,54.072956668836014,NaN,NaN,44.9076443011141,-5.346908444582732,-0.014748430497851656,0.028333532776699144,0.0430819632745508,31760571,31683671,62.57639550211092,79.85789112900827,NaN,NaN,2.3662358633061755,4.413844534984774
2006-01-30T09:30:00-05:00,33.03,33.55,33.03,33.35001,577500,835195,52.16174701470749,53.29804860470995,NaN,NaN,7.533734036484589,7.775878122662803,-0.008942616181001097,0.03190369304829943,0.04084630922930053,31183071,31585511,61.49205490125461,78.28545700245684,NaN,NaN,2.6437664629556714,4.160976238980616
2006-01-31T09:30:00-05:00,33.25,33.35001,33.13,33.23,921400,840170,49.483701360283966,52.31953948855887,NaN,NaN,-22.613295165213017,4.460428856806511,-0.012866003366461938,0.024763805021223106,0.037629808387685044,30261671,31160371,56.89371010005427,76.22828291203142,NaN,NaN,2.071827814941437,3.8625264641178765
2006-02-01T09:30:00-05:00,33.17,33.39,33.16,33.34,838900,797350,51.920318863131705,51.30814188647141,NaN,NaN,-13.555349320071539,4.500681525119565,-0.00797377004936975,0.027662595825972858,0.03563636587534261,31100571,31155031,56.83621885989136,74.09203220534516,NaN,NaN,2.312318453733665,3.641068176920132
2006-02-02T09:30:00-05:00,33.28,33.42999,33.14999,33.3,753000,667330,50.9577798845246,50.84196275984785,NaN,NaN,-21.884256579209755,-1.1223045453791243,-0.0073670112805145765,0.026427601774699383,0.03379461305521396,30347571,30930691,54.351380500063335,71.72959506899112,NaN,NaN,2.2376828084013907,3.440584552846026
2006-02-03T09:30:00-05:00,33.12,33.23,33.03,33.14,617100,666370,47.18927603009275,50.092490659380175,NaN,NaN,-84.312927636312,-26.966418932864343,-0.017119440981559764,0.012395311828264255,0.02951475280982402,29730471,30524671,50.0836740424577,69.01308020667052,NaN,NaN,1.0889537934163012,3.1046373014989226
2006-02-06T09:30:00-05:00,33.12,33.17,33.00999,33.13,797100,690120,46.95554838522383,49.6668399077002,NaN,NaN,-89.78229136185276,-46.42962401253182,-0.023241902603103836,0.0004623745559442227,0.02370427715904806,28933371,30074731,45.792553788824925,65.96146621121359,NaN,NaN,0.0821037326510515,2.6728467916635124
2006-02-07T09:30:00-05:00,33.03999,33.17999,32.85049,32.92999,1879100,751465,42.42901138858431,49.11283933791206,NaN,NaN,-122.8404021492407,-66.47504540933735,-0.038841242306096965,-0.024847275723573148,0.013993966582523816,27054271,29433251,40.4689075803515,62.60843084486108,NaN,NaN,-2.1183501904754736,1.9883900799293714
2006-02-08T09:30:00-05:00,32.88,33.2,32.88,33.16,589800,754580,48.56920526495438,48.59853227226136,NaN,NaN,-83.93754307959053,-80.55148416124115,-0.03203136358612707,-0.02604523790013502,0.005986125685992048,27644071,28741951,35.657878887039246,59.04004013935445,NaN,NaN,-2.2683444224541502,1.3802851510174399
2006-02-09T09:30:00-05:00,33.16,33.34,33.14,33.14999,479000,733260,48.3276336125281,48.92680045953905,NaN,NaN,-22.655218282854552,-80.7056765019701,-0.02677731570525927,-0.027485518945582044,-0.0007082032403227714,27165071,28105451,31.897824981530505,55.45248954964141,NaN,NaN,-2.4582519969742953,0.8319227013043349
2006-02-10T09:30:00-05:00,33.12,33.33,33.02,33.27,453700,740010,51.44566865784434,49.503069186626036,NaN,NaN,-16.488264056212113,-67.14074378595014,-0.01441525475615247,-0.018727271685513358,-0.004312016929360889,27618771,27683111,29.66271951004626,52.1565952805545,NaN,NaN,-1.7366212205577936,0.46498785532403086
2006-02-13T09:30:00-05:00,33.25999,33.25999,33.05,33.19,299400,733940,49.309618161016694,49.418430445792765,NaN,NaN,-31.606163585780536,-55.50551823073569,-0.010977384241937754,-0.01803374723178308,-0.007056362989845327,27319371,27360311,28.04519310344081,49.01219340059657,NaN,NaN,-1.7171942273803067,0.15324755779483978
2006-02-14T09:30:00-05:00,33.21001,33.57001,33.11,33.56,434900,743490,57.99617987567613,50.123443668089365,NaN,NaN,119.88333870201662,-6.960770060484222,0.015429726141959033,0.012230794687603463,-0.003198931454355569,27754271,27500311,29.832325351544185,46.26226190373079,NaN,NaN,1.0215031071731495,0.277284064848884
2006-02-15T09:30:00-05:00,33.52,33.73,33.39999,33.71001,601500,712910,60.92018429174858,50.83108094964346,NaN,NaN,200.52628314708355,49.931995184850585,0.04077479139580111,0.04776955779039582,0.0069947663945947106,28355771,27642651,31.689979677562093,43.94862977044084,NaN,NaN,4.252971765212189,0.8452394506150704
2006-02-16T09:30:00-05:00,33.67999,33.83,33.66,33.82001,713500,715950,62.95655908490035,51.47303084822982,NaN,NaN,246.89788949565974,103.84261674055344,0.061479278409191734,0.08384386440608438,0.022364585996892644,29069271,28023491,36.531547362853495,42.088283474779594,NaN,NaN,7.572595388968979,1.8062902989513432
2006-02-17T09:30:00-05:00,33.74001,33.75,33.61,33.62,738300,704575,57.127552673135334,51.82773125240323,NaN,NaN,161.03707857181297,139.34768526615846,0.05826553979103204,0.0951965107356827,0.03693097094465066,28330971,28165931,38.29315437926022,40.43121915177999,NaN,NaN,8.64452721029578,2.783181286286263
2006-02-21T09:30:00-05:00,33.72,33.78999,33.36099,33.44,310200,680565,52.42337212637178,52.03770773569523,NaN,NaN,94.17058846032833,164.50303567538023,0.04137298271076743,0.08864719933310994,0.04727421662234251,28020771,28306211,40.05770042796208,39.22864703234484,NaN,NaN,8.080549352038876,3.5399481528223506
2006-02-22T09:30:00-05:00,33.48,33.73,33.48,33.69,291800,659480,57.64060580987888,52.44629966046289,NaN,NaN,115.56912337820853,163.6401926106186,0.044139641022080796,0.1024487678999435,0.05830912687786271,28312571,28417871,41.49187616735482,38.13262255430652,NaN,NaN,9.277812032375236,4.359642992758477
2006-02-23T09:30:00-05:00,33.53999,33.77,33.50999,33.50999,525700,622760,53.123362383498254,52.60098412467529,NaN,NaN,88.79267331293346,141.2934706437886,0.03154044508952697,0.09773468323977141,0.06619423815024444,27786871,28304091,40.430352958476625,37.138263444193186,NaN,NaN,8.818489387381154,4.996621049133145
2006-02-24T09:30:00-05:00,33.48,33.49001,33.25,33.45,396900,625505,51.67007675776275,52.921041319508866,NaN,NaN,15.420782777591443,94.99804930017494,0.017558209030017702,0.08814199943776657,0.07058379040774887,27389971,27968231,37.38951492061649,36.2315377926331,NaN,NaN,7.998351066942167,5.425439623105862
2006-02-27T09:30:00-05:00,33.58,33.84,33.58,33.75,733000,647590,57.876195581518076,53.7010875478156,NaN,NaN,116.9869055049638,86.1880146868051,0.026375784219337284,0.10355352068192047,0.07717773646258319,28122971,27926631,37.01813364311885,35.60479349651123,NaN,NaN,9.282814483227513,5.976493174551812
2006-02-28T09:30:00-05:00,33.7,33.714,33.42,33.47,698500,653640,51.260057911558675,54.33187658517091,NaN,NaN,49.832512462685024,77.32039948727645,0.01194724677014633,0.09211179492526611,0.08016454815511978,27424471,27807371,35.91671372530985,35.27963679257969,NaN,NaN,8.171899194644402,6.29012260599361
2006-03-01T09:30:00-05:00,33.52,33.73,33.36,33.72,1903300,702735,56.086922274378466,54.868856371558344,NaN,NaN,65.23995439127508,67.25456568988976,0.01750099567757786,0.1020407927520921,0.08453979707451424,29327771,28010411,39.231737946403264,35.534912439677115,NaN,NaN,8.869315179341081,6.658578687900392
2006-03-02T09:30:00-05:00,33.53,33.56,33.36,33.5,972800,709430,51.27465045607922,55.07935757466913,NaN,NaN,21.435138588573032,53.78305874501766,0.005253927553734231,0.09110720651668203,0.0858532789629478,28354971,28124031,41.06888718336646,36.18998831123683,NaN,NaN,7.818233723891995,6.82424369304205
2006-03-03T09:30:00-05:00,33.41,33.67999,33.3101,33.48,879700,715765,50.8475299717408,55.036633382804595,NaN,NaN,23.996436651558078,55.49818951981099,-0.004756778277934429,0.07990730611552976,0.08466408439346419,27475271,28141091,41.35557108576995,37.0251919952171,NaN,NaN,6.864277764023381,6.829962846039383
2006-03-06T09:30:00-05:00,33.41,33.5,33.23,33.27,407000,705260,46.47032039137744,54.83382639925893,NaN,NaN,-31.94120479124215,25.712567460569794,-0.024955512274264458,0.05346969405063362,0.07842520632489808,27068271,27930151,38.83964153224393,37.796224025845895,NaN,NaN,4.652821109492815,6.518942597961302
2006-03-07T09:30:00-05:00,33.10001,33.24001,33.03999,33.12,2716200,801215,43.584207707841024,53.80439981584214,NaN,NaN,-102.07126220865939,-4.668187473699069,-0.046595115446874266,0.020181312016305242,0.06677642746317951,24352071,27315671,32.61498814826233,37.994985654182905,NaN,NaN,1.9009919557566368,5.859235363360636
2006-03-08T09:30:00-05:00,33.03,33.27,33.03,33.17999,518500,733185,45.0539671021021,52.671098588010246,NaN,NaN,-100.8231231323123,-37.88080297841655,-0.054496172830446485,-0.0013437885748786016,0.05315238425556788,24870571,26424231,26.08394822768399,37.59455483633447,NaN,NaN,0.10840640819978092,5.037688369766228
2006-03-09T09:30:00-05:00,33.19,33.31,33.00999,33.05,506900,729040,42.47192531264498,51.207910461420575,NaN,NaN,-116.50641155937669,-65.46911300800649,-0.06537186136014785,-0.02856244244461692,0.036809418915530925,24363671,25625971,21.862170829844885,36.54674222683385,NaN,NaN,-2.1776977061768723,4.006918930345785
2006-03-10T09:30:00-05:00,33.11,33.38,33.08,33.36,793900,744785,49.85288177341061,50.68829111144024,NaN,NaN,-63.46656692951404,-82.96171372422091,-0.04931373990156046,-0.02483275596141965,0.02448098394014081,25157571,25162431,19.8527529126429,35.229570693504044,NaN,NaN,-1.9183779660942333,3.160447945140068
2006-03-13T09:30:00-05:00,33.39,33.5,33.28,33.35001,440500,744125,49.63188696635826,50.48889931429642,NaN,NaN,-29.275617358816305,-82.42859623773575,-0.03752443965521217,-0.022424565628874404,0.015099874026337766,24717071,24692191,18.041168083007705,33.65696124029302,NaN,NaN,-1.777310523102856,2.4550538782482216
2006-03-14T09:30:00-05:00,33.31,33.72,33.25,33.71001,371800,747745,57.025029569159315,50.44492958281645,NaN,NaN,38.76286873568626,-54.261770048866616,-0.005331345219404007,0.008435692502082759,0.013767037721486765,25088871,24839551,20.489701574793997,32.156805912252956,NaN,NaN,0.7253424201789385,2.2079522413811814
2006-03-15T09:30:00-05:00,33.73,33.91,33.61,33.89999,1717300,811865,60.33392256850658,50.959969596031335,NaN,NaN,128.37144111039566,-8.422857200325023,0.02712470893218264,0.04767292388671507,0.020548214954532427,26806171,25226671,26.686204670709756,31.175081034555326,NaN,NaN,3.898207986774744,2.449417347865976
2006-03-16T09:30:00-05:00,33.92,34.07001,33.89999,33.97,787200,821150,61.51004206964286,51.662824261165625,NaN,NaN,173.76132756020064,49.63069062359044,0.05032615332290059,0.08345590660815816,0.03312975328525757,27593371,25872611,35.69195400535254,31.053826683465044,NaN,NaN,6.828249764600085,3.0749648359708486
2006-03-17T09:30:00-05:00,33.92,34.09,33.92,34.02,1653700,868160,62.368228163079245,51.98368373127714,NaN,NaN,170.23602812415217,96.37120963432368,0.06511903461720961,0.11452854655676958,0.049409511939559975,29247071,26690511,44.91838120920612,31.618130081042704,NaN,NaN,9.472088901262463,3.988839702441079
2006-03-20T09:30:00-05:00,33.99001,34.09,33.88,33.94,321100,847300,60.06079168124051,52.6123075719687,NaN,NaN,140.3303271909263,130.2923985442722,0.06542140843369418,0.1311862724816777,0.06576486404798351,28925971,27532291,52.47568964507762,32.80091407531183,NaN,NaN,11.028154925473862,4.994456162874334
2006-03-21T09:30:00-05:00,33.77,34,33.69,33.75,516200,857600,54.86873315911712,52.52529406373575,NaN,NaN,79.89329003950915,138.51848280503677,0.049456510312593266,0.1275855019387251,0.07812899162613182,28409771,28196471,57.437697427685436,34.101339752546274,NaN,NaN,10.877143174218192,5.834840021637742
2006-03-22T09:30:00-05:00,33.71001,33.88,33.67999,33.86,377900,861905,57.17681527725748,52.94687726524848,NaN,NaN,72.39725248944612,127.32364508084689,0.04316508538496325,0.13208534835733587,0.08892026297237263,28787671,28592771,60.113710419591754,35.46168426941951,NaN,NaN,11.416581013622453,6.632231591921272
2006-03-23T09:30:00-05:00,33.73,33.87,33.7,33.84,304500,850845,56.60993883229642,53.35847789814532,NaN,NaN,65.22487661100881,105.61635489100851,0.03487193468218949,0.1325101813251095,0.09763824664292,28483171,28770731,61.29067057056737,36.88561994690504,NaN,NaN,11.702654057618533,7.356577658449452
2006-03-24T09:30:00-05:00,33.81,33.87,33.64999,33.78999,265100,844255,55.13786386102845,53.97758814597753,NaN,NaN,50.465499598335576,81.66224918584518,0.023764233422874675,0.12734353842151336,0.10357930499863868,28218071,28564931,59.118136897317775,38.33408390155317,NaN,NaN,11.546072173852137,7.95507687493555
2006-03-27T09:30:00-05:00,33.67,33.87,33.67,33.78,887800,851995,54.83113278478398,54.78093993718774,NaN,NaN,50.1778621063524,63.631756168930416,0.013974529867244428,0.12104746733269423,0.1070729374654498,27330271,28245791,55.814159365223475,39.99116755990754,NaN,NaN,11.335251575005337,8.43795897494552
2006-03-28T09:30:00-05:00,33.67999,33.92,33.58,33.60001,1988200,916480,49.48933957079656,55.097752256380204,NaN,NaN,27.658135727919255,53.18472530661243,-0.005356739453796444,0.10037701314820424,0.10573375260200069,25342071,27632251,50.02578533545995,41.70129878189154,NaN,NaN,9.681647942976802,8.615628827521418
2006-03-29T09:30:00-05:00,33.78999,33.92,33.60001,33.89999,638600,853245,57.00705166886315,56.135975567538644,NaN,NaN,51.89219909920249,49.08371462856371,0.0009876729308063992,0.10696834376550868,0.10598067083470228,25980671,27070851,45.387449534782625,43.381675832244234,NaN,NaN,10.348036551861316,8.86311564528426
2006-03-30T09:30:00-05:00,33.88,34.00999,33.64999,33.75999,588500,834030,53.0395009250669,56.363591221228376,NaN,NaN,47.560734554524316,45.55088621726681,-0.00498822622584931,0.09974538805239064,0.10473361427823995,25392171,26452651,40.89130262527301,44.88442938314638,NaN,NaN,9.72893387111548,8.986803963260149
2006-03-31T09:30:00-05:00,33.77,33.81,33.60001,33.66,367200,808405,50.34449859230793,56.41449205165335,NaN,NaN,14.808015273011378,38.41938935220197,-0.015808277558040845,0.08497326733068888,0.10078154488872973,25024971,25814031,36.83219544729251,46.22664562345244,NaN,NaN,8.408303896536165,8.904161096585295
2006-04-03T09:30:00-04:00,33.81,33.82001,33.50999,33.53999,715000,823805,47.24185285817774,55.715693715154664,NaN,NaN,-7.552243645284635,26.873368201874563,-0.030338944024302733,0.06285786485835132,0.09319680888265405,24309971,25209971,33.449863913288326,47.15237150477346,NaN,NaN,6.361291194507665,8.540893967717063
2006-04-04T09:30:00-04:00,33.50999,33.74001,33.44,33.73,1072100,741600,52.25856669743791,55.1388825815069,NaN,NaN,-12.813711164937423,18.778998823303233,-0.026579729895969725,0.05997214651269189,0.08655187640866162,25382071,25217971,33.536912889936175,47.641707806146776,NaN,NaN,6.075565983836324,8.1887042557341
2006-04-05T09:30:00-04:00,33.73,33.98,33.73,33.95,581700,744760,57.31907897668852,54.8395280748673,NaN,NaN,68.82018898798542,22.164596801059815,-0.009579364842373955,0.07457767035569418,0.08415703519806814,25963771,25214591,33.51696528271263,47.48635146881536,NaN,NaN,7.414416675600332,8.07809174428642
2006-04-06T09:30:00-04:00,33.83,34.07001,33.83,34.02,330200,735925,58.81496502399316,54.58572356493259,NaN,NaN,103.77646481772312,33.40774285369958,0.005278293597103564,0.0907549021944476,0.08547660859734403,26293971,25394951,35.71427111027501,46.82891503317742,NaN,NaN,8.965735271232395,8.204897962421558
2006-04-07T09:30:00-04:00,34.10001,34.28,33.81,33.87,474200,719940,54.4139496883372,54.182377708296634,NaN,NaN,111.48818998005098,52.743777795107505,0.0039621656967788466,0.09042931571831758,0.08646715002153874,25819771,25553911,37.66956542702088,45.77133473188765,NaN,NaN,8.95529799791846,8.312097967492544
2006-04-10T09:30:00-04:00,33.8,33.94,33.74001,33.82001,378300,716830,52.99082714443934,54.048241564391084,NaN,NaN,14.955896441614811,57.24540581248739,-0.0010490105623700147,0.08515588681857622,0.08620489738094624,25441471,25780211,40.446625802124025,44.55768675863327,NaN,NaN,8.528700857870328,8.343041237546513
2006-04-11T09:30:00-04:00,33.98,33.98,33.50999,33.55,878000,742140,45.99381151112946,53.24945558109622,NaN,NaN,-100.4073089919379,39.72668624708729,-0.022152248893662352,0.058514586263868296,0.08066683515753065,24563471,25616491,39.08972032513155,43.055973180457535,NaN,NaN,5.9450142316320695,8.000465950987307
2006-04-12T09:30:00-04:00,33.55,33.58,33.42999,33.52,604000,686475,45.27844316279998,52.440063033275045,NaN,NaN,-187.70152628270662,-11.577656807051119,-0.03686804640290764,0.0345817771538961,0.07144982355680374,23959471,25215631,35.91289468116361,41.24327490264297,NaN,NaN,3.647947643676144,7.378677621371427
2006-04-13T09:30:00-04:00,34.37,34.37,33.4424,33.60001,322200,663225,47.61844606816281,51.90296176235607,NaN,NaN,6.822692443134388,-30.968411281968866,-0.039704282396075465,0.02181947056170941,0.06152375295778487,24281671,24813171,33.012089794159834,39.37855725241741,NaN,NaN,2.4002784048416483,6.667477733295744
2006-04-17T09:30:00-04:00,33.64999,33.64999,33.28999,33.42999,527100,606895,43.373939177835496,51.08459079043117,NaN,NaN,-193.23258045387482,-91.91256536875403,-0.050811795592297385,-0.001990991532586861,0.048820804059710524,23754571,24400131,30.306522814007536,37.55658321304484,NaN,NaN,0.03384926525243071,5.719816523575271
2006-04-18T09:30:00-04:00,33.49001,33.94,33.48,33.92,373700,609525,55.64504677508186,51.52428416216584,NaN,NaN,15.267260168696707,-91.85029262333765,-0.024283927892186398,0.018465894194477528,0.042749822086663926,24128271,24137491,28.696023891674827,36.03302882420304,NaN,NaN,1.9433749381883327,5.180324868519994
2006-04-19T09:30:00-04:00,33.89999,33.92999,33.69,33.8,1404400,653935,52.636771048448814,51.21212126070768,NaN,NaN,33.295688431255314,-65.10969313869901,-0.014431632346419337,0.024710281653639754,0.03914191400005909,22723871,23769571,26.56625774417391,34.68865798201671,NaN,NaN,2.475405861931252,4.793907867578746
2006-04-20T09:30:00-04:00,33.83,34.03,33.72,33.92999,594800,664780,55.44663333721615,51.384059290146915,NaN,NaN,85.57403676568015,-10.454580529021666,0.0004389344069718054,0.039690582008773845,0.03925164760180204,23318671,23641411,25.84664610933858,33.61403965944996,NaN,NaN,3.8302528591312486,4.656242866371961
2006-04-21T09:30:00-04:00,34,34,33.57001,33.67,1262600,712685,49.164248682480824,51.299755725159265,NaN,NaN,-7.522650007423766,-13.323649019133299,-0.007213296304331908,0.030235027221387156,0.037448323525719064,22056071,23196291,23.468878412790772,32.659517014128404,NaN,NaN,2.8940831123825683,4.40450575865919
2006-04-24T09:30:00-04:00,33.67,33.7,33.478,33.66,232900,711075,48.93458449099165,51.42066512750311,NaN,NaN,-83.66152044765418,8.590562982110844,-0.012611019209660082,0.021684549513643958,0.03429556872330404,21823171,22810011,21.610871581215648,31.813874704694644,NaN,NaN,2.092875246658276,4.074272828373346
2006-04-25T09:30:00-04:00,33.60001,33.72,33.5,33.61,569400,695155,47.733909208088704,51.09747530683531,NaN,NaN,-75.94619831599267,-9.652128714827029,-0.018836666234240927,0.01074973593050288,0.029586402164743807,21253771,22235111,19.177433867278936,30.788197631647698,NaN,NaN,1.082923218409694,3.6469371698071096
2006-04-26T09:30:00-04:00,33.67,33.92,33.66,33.84,817900,636640,53.398308512689944,50.817420273692555,NaN,NaN,33.95460297014279,-9.520345807049537,-0.007343002911236924,0.020407648525697653,0.027750651436934577,22071671,22104671,18.663917922936463,29.72726567737797,NaN,NaN,1.948760650877117,3.404340524245682
2006-04-27T09:30:00-04:00,33.78999,34.24001,33.69,34.11,2167000,713060,59.01384930370846,50.83162629367222,NaN,NaN,135.7692718669696,0.5187012132083509,0.01722370677545458,0.0492802849062528,0.03205657813079822,24238671,22288671,21.843149796015368,28.736471297787997,NaN,NaN,4.5456647161755495,3.5673868373785202
2006-04-28T09:30:00-04:00,34.09,34.24001,34,34.09,741800,720725,58.451973923946746,51.120056596215754,NaN,NaN,161.50451887865364,34.324134990423836,0.030150142320719185,0.0697442560316972,0.03959411371097802,23496871,22576831,26.676859543000077,27.951278020357943,NaN,NaN,6.430302811569649,3.9763748336915388
2006-05-01T09:30:00-04:00,34.08,34.3,33.89999,33.89999,616500,733190,53.263420882271966,51.13952757748951,NaN,NaN,111.36696093083467,73.3298312661216,0.02418469513377032,0.06982498262819092,0.0456402874944206,22880371,22788271,30.093274524105937,27.211752929070933,NaN,NaN,6.4546254423329605,4.330410634926028
2006-05-02T09:30:00-04:00,33.94,34.09,33.86,33.92999,1830000,788940,53.95832939601863,51.70842171212445,NaN,NaN,71.47679851229165,102.81443063177846,0.0206763028500868,0.0714856660570291,0.05080936320694231,24710371,23479591,39.94583963879152,27.272904308618074,NaN,NaN,6.679015793920599,4.665925657639538
2006-05-03T09:30:00-04:00,33.96001,34.02,33.86,34.02,631100,766890,56.068886527803095,52.47916766676752,NaN,NaN,67.13546276808536,109.45060259136699,0.022674433228680332,0.07915240474279273,0.05647797151411239,25341471,24133551,47.48572094142928,28.099534755779903,NaN,NaN,7.479898547652857,5.067921784784298
2006-05-04T09:30:00-04:00,34.05,34.22,34.05,34.21001,1129900,794300,60.21495329173283,53.37891818273681,NaN,NaN,137.77536034421266,109.85182028681561,0.03434928679858479,0.09941458001234338,0.06506529321375859,26471371,24580091,51.924271300093466,29.450404863346595,NaN,NaN,9.428303735033097,5.690833491962698
2006-05-05T09:30:00-04:00,34.44,34.66,34.34,34.61,1650600,860320,67.22690473363511,55.08270143672247,NaN,NaN,239.0841402571156,125.36774456250801,0.0647994519552904,0.1460646081578716,0.08126515620258119,28121971,25505111,59.551128154599105,31.539305244817424,NaN,NaN,13.606113282411794,6.82158774774114
2006-05-08T09:30:00-04:00,34.61,34.75999,34.61,34.66,975200,885370,67.98645812516685,55.96423081887141,NaN,NaN,229.35980534541278,148.96631344542362,0.08293813548420029,0.18493782555783156,0.10199969007363127,29097171,26748471,67.10514781863955,34.28281409674347,NaN,NaN,17.16614802081392,8.299382072465823
2006-05-09T09:30:00-04:00,34.67,34.75999,34.64999,34.75999,611200,897015,69.50838078027363,57.169345799716034,NaN,NaN,193.70936684046782,173.41282711105885,0.09541057330532826,0.22126290670529158,0.12585233339996332,29708371,27748071,71.68364621796115,37.50548470201399,NaN,NaN,20.57710126745316,10.053341957464013
2006-05-10T09:30:00-04:00,34.73,34.82001,34.67999,34.78,307300,868480,69.81761504767229,58.195844493320045,NaN,NaN,167.76973285069323,193.53968112758042,0.09835609554165106,0.24879745282702714,0.15044135728537608,30015671,28682911,75.16504819576798,41.028227708187515,NaN,NaN,23.421624351013506,11.963096585113941
2006-05-11T09:30:00-04:00,34.67999,34.7,34.37,34.42999,777000,877130,58.6190159615319,58.871185013252266,NaN,NaN,96.25136157662615,185.23488137406312,0.07133793711063074,0.2396137786736645,0.16827584156303377,29238671,29236371,76.97030373989533,44.849758088694976,NaN,NaN,22.51991479841047,13.471213472727731
2006-05-12T09:30:00-04:00,34.25,34.35001,34,34.09,905800,906310,50.196489108013466,58.96132105732526,NaN,NaN,17.607223735727985,140.93949806978557,0.02743232004321791,0.20256624161705616,0.17513392157383825,28332871,29278551,77.10688317447153,48.813758916784685,NaN,NaN,18.835438445394605,14.237531325965856
2006-05-15T09:30:00-04:00,34.05,34.2,33.89,34.17999,1208300,940370,52.155984709154836,59.27718359311569,NaN,NaN,-1.5575212542643209,94.75603274985016,0.002621371346180068,0.17841063575656335,0.17578926441038328,29541171,29367351,77.41061657414346,52.97327196727501,NaN,NaN,16.523444862816675,14.56409040265883
2006-05-16T09:30:00-04:00,34.09,34.09,33.88,33.94,640000,953685,46.86083839253672,58.81022144167617,NaN,NaN,-32.831436347313726,49.447872112293865,-0.029985305554771413,0.13830763246691902,0.16829293802169043,28901171,29205911,75.45071679849748,57.02947188695794,NaN,NaN,12.780056632938694,14.309228435555953
2006-05-17T09:30:00-04:00,33.82001,33.82001,33.44,33.47,687900,917860,38.59645229526726,57.351835941073226,NaN,NaN,-120.89508646645243,-8.285091751135269,-0.0803792562603837,0.06781886769621082,0.1481981239565945,28213271,28845431,71.12075181393868,60.54930060252389,NaN,NaN,6.359658735922827,13.17357562132265
2006-05-18T09:30:00-04:00,33.55,33.75,33.44,33.45,710900,923665,38.28701767357579,55.911481923189584,NaN,NaN,-117.61934714847416,-51.059233496155336,-0.11037904211994302,0.010224321306665729,0.12060336342660875,27502371,28498171,67.12443485127679,63.438413124543665,NaN,NaN,1.3758307726721344,11.488183500086862
2006-05-19T09:30:00-04:00,33.53,33.77,33.39999,33.67999,998500,910460,43.86081603207252,55.23986729103249,NaN,NaN,-98.74307447265733,-74.32929313783241,-0.10981816826541568,-0.016669346905160864,0.09314882136025482,28500871,28531771,67.31580341674373,66.0971651883035,NaN,NaN,-0.9541393588866003,9.710708805947796
2006-05-22T09:30:00-04:00,33.47,33.69,33.14999,33.44,1628400,980235,39.81935990025354,54.229940898477835,NaN,NaN,-134.36380744530092,-100.89055037603973,-0.11987459471633537,-0.056694422035164393,0.06318017268117097,26872471,27998031,61.21955443957374,67.61671624550223,NaN,NaN,-4.269841628701132,7.713487315283664
2006-05-23T09:30:00-04:00,33.52,33.57001,33.19,33.19,612200,982375,36.0888690408708,52.80279679226838,NaN,NaN,-148.32411879936015,-123.98908686644901,-0.13642416118072398,-0.10735002879473399,0.02907413238598998,26260271,27469851,55.83116205351012,68.21281918207943,NaN,NaN,-8.315598264125903,5.423617946796583
2006-05-24T09:30:00-04:00,33.00999,33.37,32.96001,33.24001,1233600,1003160,37.353232402592525,51.169816728758356,NaN,NaN,-153.95992098145902,-130.60205376945035,-0.13671907081057116,-0.14182470612722398,-0.005105635316652819,27493871,27325971,54.425835304336836,68.39150232523967,NaN,NaN,-11.095364678991375,3.0637632859697317
2006-05-25T09:30:00-04:00,33.36,33.56,33.3,33.56,1118900,950755,44.86872834930751,49.57280412987782,NaN,NaN,-89.37035536617347,-124.95225541299018,-0.10926931349615088,-0.1416922771868414,-0.03242296369069054,28612771,27548051,56.25609169143964,68.15614257787114,NaN,NaN,-11.044601042466867,1.0482826676216463
2006-05-26T09:30:00-04:00,33.67999,33.73,33.63,33.67,539200,940625,47.21309812161522,48.088992701052696,NaN,NaN,-49.391063302065255,-115.08185317887178,-0.0790207224382824,-0.13119886673854353,-0.05217814430026114,29151971,27678271,57.33799245532715,67.45848862334883,NaN,NaN,-10.253357866677536,-0.566237408706808
2006-05-30T09:30:00-04:00,33.42,33.47,33.16,33.16,812900,950445,38.94442893011381,45.905853283184136,NaN,NaN,-103.8344247790834,-108.97597664562825,-0.08799040509538471,-0.16216615066949203,-0.07417574557410732,28339071,27971591,59.752651351944955,66.60627470434767,NaN,NaN,-12.393665173886884,-2.2558699465896757
2006-05-31T09:30:00-04:00,33.23,33.53999,33.23,33.52,535500,885720,46.11797708201463,44.21302199992288,NaN,NaN,-69.87229271049722,-93.28561142785566,-0.06534922089301914,-0.15586227169038125,-0.0905130507973621,28874571,28494451,63.69708312201069,65.78713434193644,NaN,NaN,-11.639669574070444,-3.5964127505154995
2006-06-01T09:30:00-04:00,33.60001,34.08,33.46001,34.03999,1197300,914030,54.44390074961113,43.91479948478568,NaN,NaN,-5.493191857840809,-63.59226560313201,-0.013722713908686263,-0.10766644318321994,-0.09394372927453368,30071871,29010051,67.11924912401034,65.08348758365894,NaN,NaN,-7.844095808870702,-4.203224615994814
2006-06-02T09:30:00-04:00,34.14999,34.14999,33.67,33.97,451200,880095,53.25116743150435,44.13299079360645,NaN,NaN,6.797964913576401,-44.35860154718205,0.015745016593170763,-0.07426245853307023,-0.090007475126241,29620671,29211631,68.37446006348407,64.45974307573127,NaN,NaN,-5.386826332434431,-4.372310575486188
2006-06-05T09:30:00-04:00,33.8,33.86,33.41,33.42999,768400,835985,45.050579472923985,43.6254618481614,NaN,NaN,-43.70481332044909,-43.2213515508588,-0.0002521562686535195,-0.09032267046205789,-0.09007051419340437,28852271,29151691,67.54871485782829,63.75532152456589,NaN,NaN,-6.239734077249802,-4.639085361452419
2006-06-06T09:30:00-04:00,33.42,33.42,33.05,33.25999,2899700,932210,42.81522749706421,43.33648964134193,NaN,NaN,-90.21831300866582,-40.49812919677528,-0.020293503017486197,-0.11543739296526212,-0.09514388994777592,25952571,28674391,61.2095675848665,62.7380965807351,NaN,NaN,-7.686842845457526,-5.074479287738862
2006-06-07T09:30:00-04:00,33.23,33.55,33.23,33.27,908200,947060,42.99458991442613,43.6506423284247,NaN,NaN,-68.37597734279294,-40.198866123234424,-0.03028498843454644,-0.13300012549095896,-0.10271513705641253,26860771,28271631,56.39973055958668,61.68659506256711,NaN,NaN,-8.73600586035306,-5.597554512398033
2006-06-08T09:30:00-04:00,33.07001,33.3,32.71001,33.22,1974100,1030400,42.28121292209874,43.93594198903348,NaN,NaN,-123.60582018027833,-63.82139178772193,-0.03721431768234551,-0.1492330341593444,-0.1120187164769989,24886671,27234591,46.30923461696617,60.19979504583063,NaN,NaN,-9.78882706819893,-6.196307734655304
2006-06-09T09:30:00-04:00,33.33,33.34,33.13,33.14,551000,1019100,41.106003648118,43.739169675893876,NaN,NaN,-91.66350657975617,-83.51368608638843,-0.0436908108345766,-0.16663223002021965,-0.12294141918564305,24335671,26177591,38.70776240605365,58.15636354506706,NaN,NaN,-10.995974492689157,-6.881974414374426
2006-06-12T09:30:00-04:00,33.08,33.12,32.67999,32.7,833400,1015480,35.29526212881966,43.41601983507717,NaN,NaN,-173.30249523398732,-109.43322246909607,-0.07241874540079074,-0.21346485093663148,-0.14104610553584074,23502271,25107591,32.83249693095148,56.128716580165474,NaN,NaN,-13.936680624649686,-7.889789587270892
2006-06-13T09:30:00-04:00,32.66,32.85001,32.41,32.44,3526300,1131380,32.382272252995875,43.15126292165753,NaN,NaN,-214.41512132735195,-134.2725841328333,-0.10193525010585774,-0.2684651681681629,-0.16652991806230516,19975971,23912271,27.762841585878164,54.12383654676319,NaN,NaN,-17.361381764127795,-9.242874183964735
2006-06-14T09:30:00-04:00,32.46001,32.63,32.41,32.59,1424200,1170590,35.680407366109776,43.03177541905162,NaN,NaN,-190.15082407605493,-158.6275534794857,-0.1040011381268448,-0.2965313407208612,-0.19253020259401638,21400171,22820151,24.101139868604733,51.95778687278232,NaN,NaN,-19.1641075266143,-10.660193232914672
2006-06-15T09:30:00-04:00,32.73,33.39,32.73,33.3,1141900,1193290,48.48801299380904,43.290295750801725,NaN,NaN,-41.79783751645631,-142.2659569467213,-0.05277828278434912,-0.2585030560744528,-0.20572477329010366,22542071,22351231,22.715788480995258,49.56205092917916,NaN,NaN,-16.40908847076746,-11.481463981179356
2006-06-16T09:30:00-04:00,33.19,33.31,33.06,33.14999,335100,1174500,46.38635773036285,43.23124286571227,NaN,NaN,-29.721620482187483,-129.87757972720755,-0.025603798872353672,-0.23772952188054575,-0.21212572300819207,22206971,21925491,21.50704673192891,47.002697663222136,NaN,NaN,-14.923103348799152,-11.973126747982183
2006-06-19T09:30:00-04:00,33.34,33.34,32.91,32.97,550500,1152100,43.926196652753944,43.587083417329424,NaN,NaN,-49.07746673770857,-105.03257402795182,-0.016781796953501016,-0.23310296920006834,-0.21632117224656733,21656471,21556331,20.488969584320614,44.198148965534685,NaN,NaN,-14.508412270231627,-12.335310394017819
2006-06-20T09:30:00-04:00,32.99001,33.05,32.83,32.85001,352600,1088310,42.31499848375291,43.31544208888215,NaN,NaN,-81.72787471230261,-78.49512470494199,-0.016057930180624153,-0.23639358497234753,-0.22033565479172337,21303871,21821911,23.301843391641654,41.312774699079746,NaN,NaN,-14.672248687009839,-12.669158721588108
2006-06-21T09:30:00-04:00,32.95,33.31,32.82001,33.17,298800,1072640,47.81252896922114,42.841772675997156,NaN,NaN,-31.881445340095613,-46.841248957750125,0.007667331074900058,-0.2107514909480983,-0.21841882202299837,21602671,21862411,23.744876554165828,38.214605229805144,NaN,NaN,-13.067877254721658,-12.726118512035757
2006-06-22T09:30:00-04:00,33.06,33.14,32.86,32.91,568800,1039400,44.13223676015559,42.19042048518653,NaN,NaN,-58.88738459978193,-50.259158374415264,0.00753462114587472,-0.20900054559065495,-0.21653516673652967,21033871,21560771,22.69346969946548,34.95167734666096,NaN,NaN,-12.875314092445848,-12.747432166380056
2006-06-23T09:30:00-04:00,32.85001,33.08,32.75,32.88,191300,993020,43.714122536290894,42.09495927542702,NaN,NaN,-68.23416234375298,-57.96166674672834,0.007116043710222758,-0.20764011209875122,-0.21475615580897398,20842571,21287891,21.754985129845025,31.680696651805015,NaN,NaN,-12.846437924803878,-12.761575846154887
2006-06-26T09:30:00-04:00,32.87,33.05,32.87,33.05,297600,980940,46.7905060901027,42.37890774635836,NaN,NaN,-42.43752263534847,-56.63367792625631,0.019287546440929643,-0.19064672275781192,-0.20993426919874156,21140171,21184631,21.39442969510722,28.836758231107922,NaN,NaN,-11.913141619670267,-12.640370956657085
2006-06-27T09:30:00-04:00,33.05,33.07001,32.59,32.63,392100,959900,40.85006319731567,42.22572726656475,NaN,NaN,-90.37292632222635,-58.36268824824106,0.0010158353516953045,-0.20866447500912244,-0.20968031036081775,20748071,21073471,20.991109698923594,26.30757102677484,NaN,NaN,-12.921414104142592,-12.680519977726442
2006-06-28T09:30:00-04:00,32.58,32.73,32.5,32.66,378900,952070,41.42213594858429,42.16436462559943,NaN,NaN,-112.0561122601538,-74.3976216322527,-0.006663625665253525,-0.21800984244238464,-0.2113462167771311,21126971,20978331,20.632598878646277,24.47352561689485,NaN,NaN,-13.56033804029134,-12.806208272378571
2006-06-29T09:30:00-04:00,32.66,33.38,32.66,33.37,633500,923880,53.00616509044593,43.01437615719429,NaN,NaN,22.767016598960723,-58.06674139250416,0.03610969964015634,-0.1662090922269357,-0.20231879186709203,21760471,21123651,22.801416953739235,23.337358084586675,NaN,NaN,-10.289633612500147,-12.446697606681653
2006-06-30T09:30:00-04:00,33.48,33.5,33.34,33.39,584300,930535,53.28640227198768,44.299457595992,NaN,NaN,117.95093481575749,-20.82972196060208,0.06414711624353739,-0.12213489656267029,-0.18628201280620768,22344771,21424091,27.228900430258633,22.93710119168005,NaN,NaN,-7.652542840616232,-11.761818354386593
2006-07-03T09:30:00-04:00,33.50999,33.50999,33.28999,33.44,287200,906475,54.02453705775792,45.845333653475,NaN,NaN,125.37490454065478,12.732763474598569,0.08324690870747256,-0.08222337692186699,-0.16547028562933955,22631971,21722451,31.43443500317356,23.199357864344005,NaN,NaN,-5.308870891019865,-10.839968716762774
2006-07-05T09:30:00-04:00,33.05,33.19,32.98,33.13,596500,791315,48.86869644101781,46.787354301682726,NaN,NaN,28.28684801817158,36.464718342678154,0.07257943331106828,-0.07474599399050419,-0.14732542730157247,22035471,21979931,34.92933765413828,23.97280056331069,NaN,NaN,-4.819121976981075,-9.979847753936816
2006-07-06T09:30:00-04:00,33.12,33.28,33.05,33.14999,306000,761205,49.20533380983762,46.83859150282762,NaN,NaN,53.50017010085392,69.57597481487969,0.06470738546842528,-0.06644119546604088,-0.13114858093446616,22341471,22222831,38.133070431516586,25.074034988347933,NaN,NaN,-4.327483720076124,-9.172367177671003
2006-07-07T09:30:00-04:00,32.92999,33.3,32.83,32.89999,317800,678390,45.197567258139564,46.75367789766881,NaN,NaN,2.9759366609034594,65.61775882726823,0.04162251094133593,-0.07912044225779624,-0.12074295319913217,22023671,22275471,38.835885075501785,26.311809155745994,NaN,NaN,-5.074971541401772,-8.587024943918255
2006-07-10T09:30:00-04:00,32.96001,33.13,32.84,32.94,278500,664765,45.956230587141526,46.898680321553634,NaN,NaN,-7.270866255190166,40.57339861307871,0.02862557320047346,-0.08496098669854035,-0.11358655989901381,22302171,22266951,38.759137486551396,27.616821148762472,NaN,NaN,-5.476184911923718,-8.142619225061893
2006-07-11T09:30:00-04:00,32.94,32.94,32.58,32.91,430500,644620,45.44818441925304,47.1224793169465,NaN,NaN,-65.04099816427467,2.4902180720928215,0.018099761638639064,-0.09096185785071498,-0.10906161948935404,21871671,22114891,37.340813701815144,28.61960474234629,NaN,NaN,-5.946602666987646,-7.828902573908429
2006-07-12T09:30:00-04:00,32.96001,32.96001,32.35001,32.39,684600,502535,37.6738153008374,46.39828548349052,NaN,NaN,-153.62082480883603,-33.8913164933087,-0.02163732376132442,-0.13610827419100957,-0.11447095042968515,21187071,21945211,35.76793406171208,29.478394564313877,NaN,NaN,-8.76381794984313,-7.9624619133276715
2006-07-13T09:30:00-04:00,32.25,32.25999,31.78,31.8,591200,460885,31.160694937576167,45.4717467818777,NaN,NaN,-309.27355088699386,-106.44606069087827,-0.082018306637132,-0.21699383372610015,-0.13497552708896815,20595871,21596091,32.71455008638702,30.194186020522558,NaN,NaN,-13.601899218909697,-8.768095814125104
2006-07-14T09:30:00-04:00,31.71001,31.71001,31.27,31.39,1525400,480060,27.59098277972909,44.32009394212328,NaN,NaN,-307.459080345395,-168.53306409213795,-0.14049909781625208,-0.31059939935928327,-0.17010030154303118,19070471,21005451,28.311240026667704,30.66248994172418,NaN,NaN,-18.988491472866347,-10.228152336802424
2006-07-17T09:30:00-04:00,31.39,31.66,31.39,31.61,546700,490640,32.0867526115573,43.269825836512894,NaN,NaN,-215.03751785828314,-210.08639441275653,-0.1541978718750776,-0.3628476413868782,-0.2086497695118006,19617171,20468451,25.014623712894974,30.921075228709018,NaN,NaN,-21.857428033290613,-11.889477436300737
2006-07-18T09:30:00-04:00,31.56,31.57001,31.13,31.42,1493200,537775,30.335006692893202,42.51875037191129,NaN,NaN,-188.3934246690887,-234.75687971371934,-0.16492382682665774,-0.41480455304512276,-0.24988072621846502,18123971,19718911,21.288481631935255,30.94231608106699,NaN,NaN,-24.760577385903133,-13.728206000529651
2006-07-19T09:30:00-04:00,31.48,32.09,31.48,32.05,1378700,589080,41.70035808178427,42.53862338142558,NaN,NaN,-100.49078118056302,-224.13087098806471,-0.1205178249800376,-0.400528007443512,-0.2800101824634744,19502671,19382031,19.85682047106394,30.886903337668254,NaN,NaN,-23.39919126067612,-15.109775323407717
2006-07-20T09:30:00-04:00,31.94,32.03999,31.60001,31.63,818800,615080,37.328174006248084,41.41876687541145,NaN,NaN,-99.1491385153987,-182.1059885137457,-0.11061787919721555,-0.41828253145999383,-0.3076646522627783,18683871,18999631,18.348404248298323,30.568831001565336,NaN,NaN,-23.801805434152488,-16.35149391065697
2006-07-21T09:30:00-04:00,31.60001,31.60001,31.28,31.34,1718900,672585,34.62841696246396,40.086053639016896,NaN,NaN,-118.53457549842605,-144.3210875443519,-0.11431621555991683,-0.45055992171267434,-0.3362437061527575,16964971,18578531,16.832050427181372,29.826198858488386,NaN,NaN,-25.05824934124262,-17.59531611502635
2006-07-24T09:30:00-04:00,31.49001,32.07001,31.49001,32.02,1366400,731340,44.72377863789626,39.42171375188392,NaN,NaN,-61.96526407985836,-113.70663678866694,-0.06418013514340237,-0.41646887508201047,-0.3522887399386081,18331371,18321371,15.964375508542929,28.72119460887191,NaN,NaN,-22.453629075577165,-18.289360823676468
2006-07-25T09:30:00-04:00,31.99001,32.39,31.89999,32.31,1590600,795990,48.38465832070625,39.387139600433095,NaN,NaN,-23.073363834096384,-80.64262462166849,-0.007672510795606324,-0.361879378433116,-0.3542068676375097,19921971,18680971,22.017998199672732,27.798956076410086,NaN,NaN,-19.08591302047553,-18.403153994647763
2006-07-26T09:30:00-04:00,32.16,32.2,31.92,31.94,2204000,886585,44.348957753585886,39.040255596415115,NaN,NaN,-37.89627032776549,-68.12372245110897,0.007764279892695791,-0.34450151777163995,-0.35226579766433574,17717971,18324031,20.44375170689584,26.535433310365743,NaN,NaN,-17.743704217236605,-18.308946883589027
2006-07-27T09:30:00-04:00,32.16,32.28999,31.81,31.87,764700,905875,43.60789098300799,38.92670729104857,NaN,NaN,-37.44890193012346,-55.78367513405393,0.01577704842240324,-0.33254448713633167,-0.3483215355587349,16953271,17977911,19.02338994524466,25.12025508677595,NaN,NaN,-16.94574460112332,-18.11420370037964
2006-07-28T09:30:00-04:00,32,32.31,32,32.25999,2662400,1007320,48.74641385887211,39.12600609617219,NaN,NaN,-12.565033317102277,-34.58976669778917,0.04803606921827519,-0.2882764490358909,-0.3363125182541661,19615671,18508051,27.34921442240315,24.30526058219393,NaN,NaN,-14.578433636693825,-17.609093691281668
2006-07-31T09:30:00-04:00,32.12,32.34,32.12,32.28,422500,999230,49.00318211745834,39.37993450318686,NaN,NaN,0.18815604815274045,-22.15908267218695,0.07008035685328046,-0.24871207218756552,-0.318792429040846,20038171,18849411,32.18430501280807,23.936938532979138,NaN,NaN,-12.643555941333934,-16.899731155574848
2006-08-01T09:30:00-04:00,32.23,32.25999,31.82001,31.98,1261800,1047960,45.336104298972195,39.927240860196484,NaN,NaN,-22.18028575760992,-21.98046705688966,0.06398463174369218,-0.23881163936123073,-0.3027962711049229,18776371,18620291,30.70710848488605,23.575450991777277,NaN,NaN,-12.120097981680287,-16.216926416447052
2006-08-02T09:30:00-04:00,32.07001,32.3,32.03999,32.24001,623400,1049305,48.90495292042048,41.19468785897108,NaN,NaN,10.0860841570448,-12.383996159927598,0.07616353578740032,-0.2075918513706725,-0.2837553871580728,19399771,18956651,35.39508803305378,23.76691798796776,NaN,NaN,-10.587531085004997,-15.412727083383901
2006-08-03T09:30:00-04:00,32.03999,32.53999,31.91,32.44,521900,1060100,51.526369308754795,42.904358325330065,NaN,NaN,37.773827474291004,2.66054972095527,0.0951542567846494,-0.16481256617726103,-0.2599668229619104,19921671,19550331,42.756422487702906,24.798716735184563,NaN,NaN,-8.518572770859702,-14.427847895880443
2006-08-04T09:30:00-04:00,32.82001,33,32.31,32.45,2312800,1159850,51.65991841580545,44.30244159706207,NaN,NaN,100.13630402208801,25.20081718879333,0.10507737395853659,-0.1286201055137397,-0.2336974794722763,22234471,20074091,48.348097544474975,26.465393437440273,NaN,NaN,-6.811046406470006,-13.339733397393239
2006-08-07T09:30:00-04:00,32.46001,32.49001,32.23,32.38,770500,1184450,50.608817647885736,45.75057095099011,NaN,NaN,70.37382977711935,39.237951934586654,0.10345200082956005,-0.10438247843532622,-0.20783447926488627,21463971,20359251,51.146144284870076,28.598083626935622,NaN,NaN,-5.6746597643746375,-12.244722878390581
2006-08-08T09:30:00-04:00,32.49001,32.49001,31.97,32.05,1530300,1239440,45.87049482745218,46.048437861394966,NaN,NaN,39.374183038252895,51.54884569375922,0.07784508182673783,-0.11052812698146397,-0.1883732088082018,19933671,20590711,53.35489519802869,30.99080325029025,NaN,NaN,-6.000981996274408,-11.352759895231127
2006-08-09T09:30:00-04:00,32.2,32.2,31.58,31.61,2488000,1329610,40.434556084704894,46.270322295570445,NaN,NaN,-42.1806088322851,41.09550709589324,0.03135198376962234,-0.14918322909617387,-0.1805352128657962,17445671,20199891,49.301719085782196,33.20175431011052,NaN,NaN,-7.937773848439868,-10.864904745689518
2006-08-10T09:30:00-04:00,31.64999,32.07001,31.56,32.03999,2579800,1429040,47.03969517728144,47.1568421680574,NaN,NaN,-17.89784980059147,29.96117164091674,0.02965435017202739,-0.14346727515076196,-0.17312162532278935,20025471,20220651,49.521083652448034,35.53668525477242,NaN,NaN,-7.598558560263574,-10.39828386205724
2006-08-11T09:30:00-04:00,31.99001,32.08,31.89999,32.03,1382400,1421890,46.909546238051355,47.312968425211345,NaN,NaN,3.783781438583817,10.690667124215901,0.02797655463469667,-0.13815093202941853,-0.1661274866641152,18643071,19502371,42.64566368746958,37.44249155326719,NaN,NaN,-7.366470027467995,-9.965167599973062
2006-08-14T09:30:00-04:00,32.34,32.42999,32.08,32.12,1936900,1491400,48.29742027518873,47.306737136245815,NaN,NaN,55.370164745165496,7.689934117825127,0.032716510001744276,-0.12523184916193486,-0.15794835916367914,20579971,19325571,41.13189008395084,38.80776954500134,NaN,NaN,-6.7804369548985495,-9.510206079248132
2006-08-15T09:30:00-04:00,32.42999,32.61,32.31,32.57001,2431400,1538310,54.677315911377605,48.0444770046595,NaN,NaN,128.41904007020975,25.4989055242165,0.06413094061724939,-0.07778468339211742,-0.1419156240093668,23011371,19941111,48.04638588887094,40.77938627228527,NaN,NaN,-4.32097543563717,-8.768887415875136
2006-08-16T09:30:00-04:00,32.58,32.94,32.55,32.89999,2513100,1595030,58.70156701371424,49.122596721138514,NaN,NaN,188.1749263874755,71.57001256816861,0.1028114176112204,-0.013401351995341315,-0.11621276960656171,25524471,21556871,60.9968507065951,43.777490612381726,NaN,NaN,-0.9443158714724244,-7.6510914809604635
2006-08-17T09:30:00-04:00,32.92999,33.21001,32.89,33.10001,2093100,1658745,60.964145378924684,49.99529182971371,NaN,NaN,228.51118764310579,120.85182005690808,0.13549034558093292,0.05315016236960446,-0.08234018321132847,27617571,23075291,68.85409553233461,46.74212497737683,NaN,NaN,2.5722792233361864,-6.190609951775228
2006-08-18T09:30:00-04:00,33.21001,33.21001,32.86,33.09,3504800,1748040,60.78466811322587,50.8368265436971,NaN,NaN,188.9320740521192,157.88147857961513,0.1489821016519381,0.10388744385359416,-0.045094657798343936,24112771,24169231,73.06414875193768,49.66211381588609,NaN,NaN,5.3551500704752595,-4.541215662882301
2006-08-21T09:30:00-04:00,32.64999,32.78,32.63,32.73,553000,1707370,54.563264112441644,51.49590938751634,NaN,NaN,92.36439028572379,165.28032368772682,0.12706534544162157,0.11373702400368302,-0.013328321437938544,23559771,24765191,75.04331310944814,52.82898557478338,NaN,NaN,5.995682968268583,-3.0359444298607468
2006-08-22T09:30:00-04:00,32.63,32.81,32.59,32.7,415700,1648625,54.066640713015865,51.86460137270173,NaN,NaN,78.42675493492607,155.28186666067006,0.10487435372141331,0.1177646207138281,0.012890266992414787,23144071,24791731,75.13094836765839,55.66726131296942,NaN,NaN,6.376698075579834,-1.691281214797807
2006-08-23T09:30:00-04:00,32.59,32.71001,32.31,32.41,1410800,1608965,49.38711420214498,51.71179743651531,NaN,NaN,25.32268181731584,122.71141774663813,0.06684314249265501,0.09644419510823354,0.02960105261557854,21733271,24033491,67.80530046185422,57.45646688255166,NaN,NaN,5.348706425456602,-0.6855686947614628
2006-08-24T09:30:00-04:00,32.33,32.42999,32.16,32.24001,280600,1584760,46.82856689241789,51.366700899130485,NaN,NaN,-23.42236745848718,72.32470672631953,0.028383656280223955,0.06508062296585848,0.036696966685634526,21452671,22800511,57.916113163478414,58.13989656962334,NaN,NaN,3.73166828796831,-0.05453484008578091
2006-08-25T09:30:00-04:00,32.11,32.28,32.08,32.24001,638200,1483550,46.82856689241788,51.09668298802564,NaN,NaN,-41.40424202894303,26.257443510107088,0.0024555180019243117,0.039766364188039915,0.037310846186115604,21452671,22268491,54.24012384881442,58.36089510990507,NaN,NaN,2.409953092574799,0.2975348645800162
2006-08-28T09:30:00-04:00,32.22,32.67999,32.22,32.56,2509700,1587910,52.23121181159939,51.55101991546472,NaN,NaN,22.479685552541262,12.280502563470575,0.006156399311732466,0.04500634532578118,0.03884994601404872,23962371,22349011,54.70866788826399,58.4575931592076,NaN,NaN,2.7450221596022466,0.6471759067260492
2006-08-29T09:30:00-04:00,32.63,32.8,32.48,32.8,1194800,1584560,55.85427749089421,52.65242858733539,NaN,NaN,63.45075077318659,9.285301731122676,0.023115363168072334,0.06774414997413913,0.0446287868060668,25157171,22751631,57.07539479482971,59.01285570985385,NaN,NaN,4.0870308168007625,1.1385837510224368
2006-08-30T09:30:00-04:00,32.72,32.86,32.67,32.82001,775100,1592145,56.1528800911569,53.30337036689792,NaN,NaN,76.73433100327865,19.56763156831524,0.033403286952470565,0.08638289549665501,0.052979608544184445,25932271,23591431,61.584633664911365,59.87453785360123,NaN,NaN,5.270304464477168,1.7288295672302554
2006-08-31T09:30:00-04:00,32.86,32.96001,32.75,32.92,447000,1588400,57.692852240483525,54.0736065099288,NaN,NaN,89.16811239078731,42.08572753817013,0.04399862599891552,0.10797789104282884,0.06397926504391332,26379271,24576751,66.08616197163332,61.548859159612924,NaN,NaN,6.697303574435744,2.438611568259611
2006-09-01T09:30:00-04:00,32.99001,33.25,32.99001,33.19,1149400,1530230,61.613371923503465,55.024745913379846,NaN,NaN,130.44990593993242,76.45655713194522,0.06498058105217867,0.14520499135913667,0.080224410306958,27528671,25791951,70.65353012439921,63.65754773393066,NaN,NaN,9.090472381941082,3.388877398785535
2006-09-05T09:30:00-04:00,33.19,33.31,33.17,33.28999,851800,1534295,62.98149830001258,55.61790179828235,NaN,NaN,132.29609190378093,98.41983840219316,0.0803750121273222,0.18069317546611074,0.10031816333878854,28380471,26675571,73.45318186991773,65.47231887543401,NaN,NaN,11.49866333907552,4.54741824739839
2006-09-06T09:30:00-04:00,33.14999,33.17999,32.88,32.88,1289400,1522250,54.417335692444915,55.31188527533454,NaN,NaN,72.95038829967709,100.31976590749125,0.05873136680169952,0.17373237184091295,0.11500100503921343,27091071,27062351,74.59563815243708,66.4436608358513,NaN,NaN,11.179706762780421,5.494888035310109
2006-09-07T09:30:00-04:00,32.72,33.17,32.72,32.99001,1154800,1455590,56.14070039136162,54.96735349050861,NaN,NaN,64.2183939415751,97.81657849515054,0.04805889290735582,0.17507462117340822,0.1270157282660524,28245871,27525071,75.93019952802922,66.94909683554377,NaN,NaN,11.413703564885076,6.340433110963676
2006-09-08T09:30:00-04:00,32.92,33.28999,32.89999,33.28999,353000,1344250,60.523584774165315,54.94870468057571,NaN,NaN,101.56309570651402,100.29557515829588,0.056836311093394126,0.19806111713279506,0.14122480603940094,28598871,27968991,77.16933813271204,67.24232464845622,NaN,NaN,12.94025263345937,7.283264471320203
2006-09-11T09:30:00-04:00,33.28999,33.63,33.16,33.55,825600,1316410,63.89170608367792,55.61502196423544,NaN,NaN,153.78930892964303,104.96345575623805,0.07466408459049692,0.23455491177752208,0.15989082718702516,29424471,28348151,78.2015650894011,67.46791407559571,NaN,NaN,15.295601336497464,8.427884023488383
2006-09-12T09:30:00-04:00,33.55,34.38,33.55,34.33,2274100,1333270,71.6939358843682,56.87411447647491,NaN,NaN,250.10411055312412,128.5250594861067,0.13024425657311717,0.3226961479034216,0.19245189133030444,31698571,29011771,79.91333782561398,67.80951332259255,NaN,NaN,20.353588165385695,10.131556043759428
2006-09-13T09:30:00-04:00,34.37,34.53,34.25999,34.47,2223600,1322880,72.82878705781815,58.548519680451555,NaN,NaN,252.58138908796997,164.45125964376524,0.16543313823400713,0.39924331412281333,0.2338101758888062,33922171,30377991,82.89191026814146,68.88712830875593,NaN,NaN,24.720772924140856,12.215729883813918
2006-09-14T09:30:00-04:00,34.47,34.47,34.11,34.38,1107300,1252590,70.86193546304513,60.265188864067795,NaN,NaN,189.08853720570823,189.42528829659187,0.17094137657886643,0.4474868966123893,0.27654552003352284,32814871,31291791,84.54289737065031,70.78904146641106,NaN,NaN,27.557526144704937,14.407415063941206
2006-09-15T09:30:00-04:00,34.47,34.56,34.28,34.46001,2980500,1296960,71.59632996760566,62.03431479800978,NaN,NaN,165.40479527123424,202.19362820953592,0.1680176427974172,0.48656757353029434,0.31854993073287713,35795371,32731091,86.71718562447019,73.10883159324361,NaN,NaN,30.069816486695583,16.644900981477544
2006-09-18T09:30:00-04:00,34.37,34.42,34.14999,34.28,1936200,1218530,67.47579349312994,63.123213489547666,NaN,NaN,123.02240930293027,196.04024828419338,0.14298536405742746,0.49728163580466145,0.354296271747234,33859171,33618031,87.85127511525944,75.47616068088614,NaN,NaN,30.9402733074358,18.68709702804301
2006-09-19T09:30:00-04:00,34.3,34.35001,34.11,34.35001,1718700,1276815,68.24134296346969,64.00800388044591,NaN,NaN,104.58258860464166,166.9359438944969,0.12103791080658388,0.5055936602554638,0.38455574944887994,35577871,34393891,88.75568255137222,77.73903837778202,NaN,NaN,31.874750804125274,20.571047567483333
2006-09-20T09:30:00-04:00,34.45,34.69,34.45,34.60001,1603900,1336225,70.87743621884037,65.05975788956617,NaN,NaN,116.7304993273217,139.7657659423672,0.11338515960355738,0.5262871989533267,0.41290203934976927,37181771,35045811,89.46534124204346,79.73051749043432,NaN,NaN,33.46378730523274,22.412867530018964
2006-09-21T09:30:00-04:00,34.73,34.77,34.3,34.41,2827100,1407040,66.36842530287345,65.67944167973688,NaN,NaN,95.55649466925313,121.05935743507621,0.08675438260272395,0.5213450176031742,0.43459063500045025,34354671,35353771,89.7930566212624,81.42386710826497,NaN,NaN,33.48550568934886,23.99467298135181
2006-09-22T09:30:00-04:00,34.41,34.41,34.13,34.38,2897100,1537865,65.65820712040053,65.96835847951523,NaN,NaN,69.5924010479718,101.89687859042373,0.05963830963385436,0.5091385220427682,0.44950021240891386,31457571,34486211,82.04947224730572,82.23786297418688,NaN,NaN,33.301880501200756,25.324274055615945
2006-09-25T09:30:00-04:00,34.46001,35.03,34.37,34.91,2221000,1617005,71.46734580068215,66.57449044384877,NaN,NaN,101.81039096130662,97.65447492209898,0.06924149587281947,0.5360520822499382,0.4668105863771187,33678571,34450091,81.73343959212642,82.82930995434465,NaN,NaN,34.92532016539403,26.69585207129853
2006-09-26T09:30:00-04:00,34.83,35.22,34.78,35.21001,1947500,1588895,74.13453383712545,67.98286173989739,NaN,NaN,118.51869573576546,100.44169634832375,0.08652094764520041,0.5749617709336192,0.4884408232884188,35626071,34459731,81.75363936089673,83.34059575494891,NaN,NaN,37.16886513150249,28.19199679418481
2006-09-27T09:30:00-04:00,35.10001,35.41,35.08,35.14999,3028000,1680555,72.67095119653465,69.16359394026689,NaN,NaN,122.15557696381713,101.52671187562281,0.08453244427975815,0.5941063786381164,0.5095739343583583,32598071,33542991,73.43681922438104,83.16249716183118,NaN,NaN,38.526634959164305,29.668373674896166
2006-09-28T09:30:00-04:00,35.17,35.3,34.87,35.14,1443600,1713980,72.41469311897835,70.01295882203924,NaN,NaN,105.72468468979022,103.56034987973024,0.07357153172964037,0.6015383490204087,0.5279668172907683,31154471,32902951,68.21886435575922,82.52317760633454,NaN,NaN,39.54795830542865,31.079742907829377
2006-09-29T09:30:00-04:00,35.22,35.24001,34.92999,34.95,1228200,1753040,67.53682394402057,70.2733243834923,NaN,NaN,94.89125177539536,108.62012002521494,0.045905974008325634,0.5853492848011754,0.5394433107928498,29926271,32596691,65.80928369319408,81.63801464946262,NaN,NaN,39.020130224421884,32.21408395305688
2006-10-02T09:30:00-04:00,34.92999,35.27,34.91,35.03,1821600,1786650,68.49898778625115,70.04511380505537,NaN,NaN,94.54878529762875,107.16779889247937,0.026346682797553256,0.5723766642897914,0.5460299814922381,31747871,32210551,62.797534686765175,80.41545728240199,NaN,NaN,38.84424217238418,33.16124941296078
2006-10-03T09:30:00-04:00,35.07001,35.42999,34.97,35.33,2335600,1860840,71.86642078818892,69.9763733572247,NaN,NaN,107.76323482312809,105.01670670995188,0.026873409376987456,0.5796217432134725,0.552748333836485,34083471,31902031,60.41837355673599,78.81020466015873,NaN,NaN,39.66339345527101,34.090127133290814
2006-10-04T09:30:00-04:00,35.35001,35.87,35.27,35.84,2983200,1945530,76.471191362857,70.37703449292555,NaN,NaN,146.86482201657654,109.95855572050377,0.05330251036462941,0.6193764717922718,0.5660739614276424,37066671,32795751,64.60208549980784,77.38586095509858,NaN,NaN,41.9098894907108,35.20723604149367
2006-10-05T09:30:00-04:00,35.77,36.00999,35.50999,35.94,1600300,1967805,77.25722472038737,70.78138411812425,NaN,NaN,150.3479991196863,118.88321860648298,0.06829453130480823,0.6514421255586527,0.5831475942538444,38666971,34298251,70.28797129383933,76.2123456457678,NaN,NaN,43.9705721645865,36.4591412019355
2006-10-06T09:30:00-04:00,35.89999,36.00999,35.74001,35.87,1597300,2030020,75.35937828018842,71.34449731719985,NaN,NaN,143.0792036211438,128.5208089756327,0.06432744563306314,0.6635569012951734,0.5992294556621103,37069671,35726931,74.48482786009717,75.25759941325622,NaN,NaN,45.08303303957633,37.6911257501699
2006-10-09T09:30:00-04:00,35.91,36.21001,35.7605,36.12,1105500,2044015,77.4864968362348,72.00486545096878,NaN,NaN,147.74427070107618,139.15990605632217,0.06896015758305918,0.6854296526409343,0.6164694950578751,38175171,37012391,77.55659849975515,74.4576648381407,NaN,NaN,46.690549612187674,38.976757730458154
2006-10-10T09:30:00-04:00,36.24001,36.34,36.13,36.34,2904000,2075510,79.18904497723214,72.59855179085392,NaN,NaN,159.70959311492257,149.54917771468106,0.07666849759811711,0.7123051170555215,0.6356366194574044,41079171,38411531,80.33206693753162,73.80528810210414,NaN,NaN,48.58395756808329,40.34921485011889
2006-10-11T09:30:00-04:00,36.2,36.34,36.05,36.25,457100,1987185,76.63579974837037,73.33193567981799,NaN,NaN,134.60753343366196,147.09771999809814,0.06594227898058025,0.7180644681831296,0.6521221892025494,40622071,39122611,81.5788914991807,73.21856202195545,NaN,NaN,49.38933568941048,41.640660684303406
2006-10-12T09:30:00-04:00,36.49001,36.78,36.42999,36.73,1898400,2026740,80.28648862632195,74.37681293024093,NaN,NaN,158.55278251020448,148.73867667620178,0.08044969483656927,0.752684307748261,0.6722346129116917,42520471,39893311,82.84803869441062,73.27560248246293,NaN,NaN,51.300367991854,43.020618871096346
2006-10-13T09:30:00-04:00,36.55,36.63,36.48,36.63,1192500,1937340,77.5672595409264,74.81252105454409,NaN,NaN,128.95042076973186,145.91292010591937,0.07281495507020486,0.7632533067494478,0.690438351679243,41327971,40744971,84.14776611007147,73.44805437660186,NaN,NaN,52.00600627498818,44.3042456430809
2006-10-16T09:30:00-04:00,36.50999,36.67,36.48,36.60001,631400,1872100,76.72795780578002,74.9977656237337,NaN,NaN,113.57727816649918,139.07952159900398,0.056004081431272446,0.7604434534683335,0.7044393720370611,40696571,41249251,84.87844269213741,73.67125461454762,NaN,NaN,52.32784328740292,45.450473877984045
2006-10-17T09:30:00-04:00,36.39,36.48,36.22,36.47,2191600,1895745,73.03838721711982,75.02401105377551,NaN,NaN,85.21609522168795,124.18082202035707,0.027812351261983115,0.73920481111454,0.7113924598525568,38504971,40734411,80.7844441913904,74.19608496933401,NaN,NaN,51.528639369523496,46.31878323391825
2006-10-18T09:30:00-04:00,36.74001,36.75999,36.39,36.5,2577200,1944410,73.35676178758995,75.09130167296203,NaN,NaN,92.58186020787737,115.77568737520014,0.004113252196479178,0.7165340250981558,0.7124207729016766,41082171,40826431,80.96120434881874,75.1062521116954,NaN,NaN,50.956426630264716,46.981303719110606
2006-10-19T09:30:00-04:00,36.50999,36.66,36.32001,36.48,1942400,1900175,72.74008199807729,75.46296296253753,NaN,NaN,79.1634303690005,99.89781694695934,-0.018727864920643267,0.6890109417508725,0.7077388066715158,39139771,40150291,75.4679104154605,75.7961540204287,NaN,NaN,50.31494613887823,47.45753835050598
2006-10-20T09:30:00-04:00,36.59,36.59,36.31,36.42999,2928800,1901760,71.12986977344264,75.65088310447977,NaN,NaN,69.23817580671422,87.95536795435581,-0.041706329970720546,0.6556058942081151,0.6973122241788356,36210971,39126891,67.9524675681336,76.16436351195502,NaN,NaN,49.347421674810555,47.72752168254949
2006-10-23T09:30:00-04:00,36.36,36.91,36.35001,36.91,1537000,1867560,76.50574444584477,75.9822633657409,NaN,NaN,94.34089940928808,84.10809220291358,-0.029646617597295255,0.6602539521822166,0.6899005697795119,37747971,38537171,63.99752177307143,76.42001695597898,NaN,NaN,49.96096273982158,48.046584690731216
2006-10-24T09:30:00-04:00,36.81,37.05,36.75,37.05,1233700,1831870,77.8039360440174,76.07745941439522,NaN,NaN,112.89552204131697,89.64397756683938,-0.01788891770370471,0.667539422649881,0.6854283403535857,38981671,38632511,64.35868456544503,76.40263117495307,NaN,NaN,50.86189018551769,48.448771189986424
2006-10-25T09:30:00-04:00,37.11,37.12,36.78999,36.92,725300,1716735,73.72993659343805,75.82551026247027,NaN,NaN,103.98583571411704,91.92477266808733,-0.024126868207386964,0.655269755094352,0.679396623301739,38256371,38067351,60.4852096460528,75.70243391439689,NaN,NaN,50.43276242197889,48.732198508842494
2006-10-26T09:30:00-04:00,37.09,37.45,37.03999,37.42999,1453200,1717215,78.48865453747914,76.04902999513389,NaN,NaN,142.6572810182746,104.62354279794215,-0.00041948339360065034,0.6788722690597382,0.6792917524533388,39709571,38181311,60.99498605580411,74.7388737855188,NaN,NaN,51.565564567567215,49.13696508866031
2006-10-27T09:30:00-04:00,37.33,37.33,37,37.06,2369200,1774265,68.75754788554707,75.42553364151334,NaN,NaN,114.03648426955246,113.5832044905098,-0.015343034545669099,0.6601129592712525,0.6754559938169216,37340371,38407191,62.04031429296562,73.63056777074813,NaN,NaN,49.231890245428076,49.15052582534142
2006-10-30T09:30:00-05:00,37.05,37.34,36.96001,37.28999,1460600,1756215,71.15183990477078,74.85144756490897,NaN,NaN,120.36128414230265,118.78728143711271,-0.015373098927514706,0.6562396201575282,0.6716127190850429,38800971,38617791,63.03500523852323,72.3950633636761,NaN,NaN,48.10677196459574,49.001418130949176
2006-10-31T09:30:00-05:00,37.41,37.47,37.08,37.21001,877500,1683310,69.16672190107354,74.31794200438776,NaN,NaN,123.3337336939219,120.87492376763369,-0.02581316116344623,0.6393462676307351,0.6651594287941813,37923471,38406151,61.296697347859904,70.94633521001033,NaN,NaN,46.57687657844117,48.65505505201946
2006-11-01T09:30:00-05:00,37.27,37.28,36.88,36.92,2158800,1642090,62.371514173702145,73.03830097205777,NaN,NaN,75.38132814278765,115.15402225336781,-0.05557551358121893,0.5956900368176576,0.6512655503988766,35764671,37907811,57.290432231878384,69.12079189125802,NaN,NaN,43.041155563064954,47.85306941074025
2006-11-02T09:30:00-05:00,36.7,36.92,36.59,36.88,1951400,1659645,61.47443292884766,71.8888133569093,NaN,NaN,25.658104945941485,91.7541870389012,-0.07980678948803288,0.5515070635388355,0.6313138530268684,33813271,36728551,49.11056840414509,66.61813491226329,NaN,NaN,39.95559651214554,46.724858996655286
2006-11-03T09:30:00-05:00,36.92999,37,36.42999,36.60001,4193102,1789435.1,55.461275732914636,70.3697646374189,NaN,NaN,-7.527528704069393,67.44138444417682,-0.11443475559232263,0.4882704085364651,0.6027051641287877,29620169,35184510.6,40.88033429633873,63.47541288399194,NaN,NaN,35.36794177035652,45.10244225004118
2006-11-06T09:30:00-05:00,36.82001,37.13,36.63,37.05,1779800,1823150.1,61.90987576003771,69.57487096191304,NaN,NaN,44.1043863452924,52.19000488477476,-0.10691747230245774,0.46905832375071554,0.5759757960531733,31399969,33704310.2,34.85064907734635,60.19442751870309,NaN,NaN,33.38594048600155,43.4286562837498
2006-11-07T09:30:00-05:00,37.05,37.27,36.96001,37.14999,2116400,1783770.1,63.1853926943229,68.84834459810824,NaN,NaN,81.51474412973434,43.826206971937246,-0.09547092738289531,0.4566371368245541,0.5521080642074494,33516369,32822889.8,31.83911074647905,56.685706547107394,NaN,NaN,32.213053801192046,41.82642735767012
2006-11-08T09:30:00-05:00,37.10001,37.38,36.97,37.33,846100,1803220.1,65.42979420049235,68.32618118399503,NaN,NaN,96.5519325908037,48.06032786154045,-0.07683735718152085,0.4560613677305483,0.5328987249120691,34362469,32542449.4,30.923505223716646,53.503963319125695,NaN,NaN,31.948176764704574,40.415248701532185
2006-11-09T09:30:00-05:00,37.39,37.39,37.14,37.21001,1099800,1763290.1,62.68640848891261,67.7230768065286,NaN,NaN,91.6115985539776,61.25102658314768,-0.07364607257546518,0.4408411341927376,0.5144872067682028,33262669,32432329,30.551971195999727,50.8324992925447,NaN,NaN,30.892853624978333,39.05490654773878
2006-11-10T09:30:00-05:00,37.19,37.33,37.07001,37.33,786100,1742970.1,64.29847433540561,66.85112894149724,NaN,NaN,83.5652677999685,79.46958588395526,-0.06481818856674504,0.4334644710597715,0.4982826596265165,34048769,33318049,37.098133471111694,48.911114413833296,NaN,NaN,30.49838497514699,37.83254632308281
2006-11-13T09:30:00-05:00,37.25,37.58,37.25,37.38,1867500,1804775.1,64.97747900796115,65.93495343892178,NaN,NaN,114.12271802062416,93.4732522190216,-0.05723903004610936,0.4267338720688798,0.48397290211498917,35916269,34221309,42.998932740281354,47.385417854893035,NaN,NaN,30.36980175941755,36.76643995684491
2006-11-14T09:30:00-05:00,37.49001,37.81,37.21001,37.78999,1602300,1775310.1,70.0136208983415,65.66950231784345,NaN,NaN,150.3811795340514,107.24653929988509,-0.027735680357730996,0.4493033016678254,0.4770389820255564,37518569,35021749,47.68268033245821,46.47095147535056,NaN,NaN,31.818854828304755,36.05964208133918
2006-11-15T09:30:00-05:00,37.88,38.05,37.78999,37.92999,837800,1688340.1,71.51965647671214,65.1717167420744,NaN,NaN,203.46148018503888,128.62844881873212,-0.0032042025584602674,0.47303372882748107,0.47623793138594134,38356369,35820529,51.92777879110152,45.82329381358609,NaN,NaN,33.4867049729444,35.69207963728278
2006-11-16T09:30:00-05:00,38.03,38.23,37.94,38.17999,982700,1640355.1,74.02813821560328,65.54818747993555,NaN,NaN,220.34629307107403,154.3753877221514,0.02395226770501374,0.5061782660172085,0.48222599831219476,39339069,37035809,57.56884259029281,45.50390297768089,NaN,NaN,35.71381528760737,35.69518473018629
2006-11-17T09:30:00-05:00,38.06,38.11,37.89,38.11,4632898,1725560,72.11317255282056,65.61685409765339,NaN,NaN,179.6907485766218,173.60048387748208,0.03085483903718722,0.5207945471086788,0.48993970807149156,34706171,37167289.4,58.14114232380764,45.154341340915494,NaN,NaN,36.965598725221135,35.8766724437627
2006-11-20T09:30:00-05:00,38.08,38.14999,37.95,37.96001,5225898,1910004.9,68.05054714503704,65.53712732936506,NaN,NaN,145.82307988849252,179.94055625105574,0.019525077182388828,0.5143460545494776,0.49482097736708874,29480273,35880090.2,50.902644638460224,44.4119090045298,NaN,NaN,36.83555381991013,36.01365549749805
2006-11-21T09:30:00-05:00,37.95,38.09,37.92999,38.07001,961300,1896384.9,69.41156702923318,66.03998824761729,NaN,NaN,123.73616930121712,174.61155420448887,0.013909019758496732,0.5122072520652097,0.49829823230671294,30441573,34464691,44.362350290535765,43.488474580148186,NaN,NaN,37.11892328315514,36.171550895449066
2006-11-22T09:30:00-05:00,38.05,38.21001,37.96001,38.14999,1849700,1952604.9,70.39894103851081,66.67745311259321,NaN,NaN,117.4934182408692,157.41794181565496,0.010221096851958378,0.5110746033716609,0.5008535065197025,32291273,33251671.8,39.659340834277394,42.813386896586216,NaN,NaN,37.634758615803904,36.38058056978547
2006-11-24T09:30:00-05:00,38.09,38.10001,37.85001,37.95,395000,1899694.9,64.76900749706559,67.34229109574686,NaN,NaN,81.93774806488271,129.73623281441667,-0.00995530896678265,0.4884093703112242,0.4983646792780069,31896273,31763112.6,34.785782173149855,42.378061744929866,NaN,NaN,36.47273103168359,36.3937449214852
2006-11-27T09:30:00-05:00,37.91,37.95,37.37,37.39999,1460600,1854264.9,52.36584932086271,66.66057492152008,NaN,NaN,15.918287904715402,96.98174068003537,-0.06172346443351706,0.4212103487361105,0.4829338131696276,30435673,30909013,32.33082151440546,42.198074061862656,NaN,NaN,31.285278613453343,35.663964020337794
2006-11-28T09:30:00-05:00,37.25,37.41,37.14,37.38,1801100,1871289.9,51.9762689800197,65.85992322764127,NaN,NaN,-28.202375569067872,62.1766495885233,-0.09661362585587546,0.36216678084978327,0.4587804067056587,28634573,30739873,31.851425815763918,42.19895370966872,NaN,NaN,27.07037923805079,34.43630905143965
2006-11-29T09:30:00-05:00,37.63,37.74001,37.5,37.64,991600,1876994.9,56.508372095197394,65.22267879154879,NaN,NaN,21.113015214050133,41.6520187710899,-0.10100747798871501,0.33252105921976494,0.43352853720847995,29626173,30576793,31.368467383433128,42.230736721077044,NaN,NaN,24.81659097657222,33.06206361217288
2006-11-30T09:30:00-05:00,37.62,37.81,37.36,37.67999,1402400,1839174.9,57.17775718405525,64.82920369834468,NaN,NaN,15.331803397964322,21.219695802508927,-0.09986680902376194,0.3086950259287775,0.40856183495253945,31028573,30324253,30.594820220414306,42.233797365678086,NaN,NaN,23.198356035948066,31.65296252985505
2006-12-01T09:30:00-05:00,37.64,37.92999,37.35001,37.63,1443400,1813774.9,56.017090982944865,64.23767631602607,NaN,NaN,12.807933567953443,7.393732903123066,-0.10083170193977631,0.2825222075278191,0.3833539094675954,29585173,29862033,29.176463324452072,41.66796378377383,NaN,NaN,21.53548964674701,30.207609260839615
2006-12-04T09:30:00-05:00,37.73,38.14999,37.61,38.03,1794500,1693844.8,62.565217655236474,64.06537193368858,NaN,NaN,64.47331497130084,17.104738316440173,-0.07411861258401115,0.29070564373758145,0.3648242563215926,31379673,30050833,30.591884894400536,40.78174608049663,NaN,NaN,22.01883679168601,29.0377846223891
2006-12-05T09:30:00-05:00,37.99001,38.39,37.99001,38.35001,1917000,1700704.8,66.82104557898518,63.83733083944885,NaN,NaN,117.77576844456273,46.300367119166296,-0.036393688055280426,0.31933214625249207,0.3557258343077725,33296673,30983253,37.26060930086842,40.03731243538307,NaN,NaN,23.827979543983517,28.293526754045445
2006-12-06T09:30:00-05:00,38.3,38.42,38.28,38.32001,993300,1644549.8,66.06280306258722,63.4475555955828,NaN,NaN,124.19754236391333,66.91727254913894,-0.01599823339216455,0.33572804256756683,0.3517262759597314,32303373,31518693,40.77936789620914,39.24099737146219,NaN,NaN,25.03708763008334,27.828321164908
2006-12-07T09:30:00-05:00,38.34,38.45,38.11,38.14,598500,1632169.8,61.54964563184163,62.55623469674267,NaN,NaN,92.97710458073571,82.44633278569322,-0.017070542687807666,0.3303880975999718,0.34745864028777945,31704873,31653953,41.669366093511265,38.10532047883493,NaN,NaN,24.701755104592475,27.38166887057721
2006-12-08T09:30:00-05:00,38.2,38.36,38.0435,38.22,333900,1593874.8,62.76703402845298,61.888653373573554,NaN,NaN,81.63174406203292,96.21109488450911,-0.014910080318881358,0.32882103988917777,0.3437311202080591,32038773,32144673,44.90442270727351,37.15984050622536,NaN,NaN,24.78351473251281,27.01050399371087
2006-12-11T09:30:00-05:00,38.21001,38.39999,38.13,38.36,624500,1585794.8,64.8636012447678,61.661014380697175,NaN,NaN,98.59202644768271,103.0348371797855,-0.0069735913890643375,0.3350141309717287,0.34198772236079306,32663273,32401393,46.573783605798084,36.85063614674949,NaN,NaN,25.467199945489433,26.790031986822093
2006-12-12T09:30:00-05:00,38.28,38.28999,38.06,38.14999,1017200,1543279.8,59.45521461091437,60.94984635081726,NaN,NaN,61.06505919970085,91.69269533081311,-0.018153771062669966,0.3192955085324556,0.33744927959512555,31646073,32071273,44.69826664274769,36.874630171907484,NaN,NaN,24.461088688634582,26.457325801366736
2006-12-13T09:30:00-05:00,38.3,38.42,38.2,38.35001,1724200,1549374.8,62.64955088560629,60.396318482752655,NaN,NaN,98.06858160068226,86.4669031781669,-0.014521291961084482,0.31929766464376996,0.33381895660485444,33370273,32284653,46.206186857486934,37.34226203070817,NaN,NaN,24.552469378780696,26.185203455283016
2006-12-14T09:30:00-05:00,38.39999,38.77,38.3,38.75,658900,1540429.8,68.06754288326164,60.631928153195226,NaN,NaN,158.14104368360879,99.49969099874151,0.010999769330354403,0.3475686682677974,0.336568898937443,34029173,32749513,49.44059431805576,38.38903432677288,NaN,NaN,26.397158833556745,26.215482795036404
2006-12-15T09:30:00-05:00,38.62,38.78,38.42,38.45,968200,1539704.8,60.92879676694984,61.24356725648716,NaN,NaN,127.36652084980466,108.64664635629586,0.004205516486593119,0.3418257945456844,0.3376202780590913,33060973,32953953,50.840498303062446,39.71115409739123,NaN,NaN,25.62643356075562,26.131332904424863
2006-12-18T09:30:00-05:00,38.45,38.57001,38.35001,38.42,1652800,1390699.9,60.24832281059142,61.834428244385144,NaN,NaN,90.27429338459405,106.98309974367812,-0.005265999236399699,0.33103777901359166,0.33630377824999136,31408173,32702933,49.04486772095503,40.939257090619165,NaN,NaN,24.808061976491143,25.942294200434333
2006-12-19T09:30:00-05:00,38.24001,38.49001,38.12,38.44,1068300,1182820,60.56452827517176,62.12415368581189,NaN,NaN,61.781481893774384,107.12638428249284,-0.012716173491412353,0.32040856138572593,0.3331247348771383,32476473,32869013,50.29568811868539,42.29120142885147,NaN,NaN,24.243802128289527,25.699652475842218
2006-12-20T09:30:00-05:00,38.38,38.60001,38.38,38.42999,1780700,1223790,60.30596730589638,62.3475972659434,NaN,NaN,81.11632452120908,103.7359328665982,-0.020395044988469946,0.30763092864155084,0.3280259736300208,30695773,32334113,46.34938079738007,43.41652718434903,NaN,NaN,23.711817313247128,25.41567602404292
2006-12-21T09:30:00-05:00,38.50999,38.58,38.24001,38.25999,2812500,1271930,55.93826390421007,62.34196676031949,NaN,NaN,52.68308036757552,82.64434020339154,-0.03797842395479267,0.28055294368652994,0.3185313676413226,27883273,31104933,38.812969519410046,44.10484905541745,NaN,NaN,22.0101479949581,24.929172019887947
2006-12-22T09:30:00-05:00,38.22,38.36,38.13,38.23,598000,1282080,55.17902388347371,61.814381490907856,NaN,NaN,24.710616856236427,62.11315940467789,-0.051826334918543715,0.25374844899314297,0.3055747839116867,27285273,29949793,33.32843909998101,44.300317212958916,NaN,NaN,20.38909600331796,24.28058973180652
2006-12-26T09:30:00-05:00,38.2,38.37,38.10001,38.35001,495000,1233800,57.65581585822295,61.15972222513913,NaN,NaN,27.77544311907754,49.61338935157459,-0.05291622425769377,0.2394295035895695,0.29234572784726326,27780273,29224213,30.42062844294702,43.81174715167881,NaN,NaN,19.651702476315688,23.619320123879255
2006-12-27T09:30:00-05:00,38.45,38.61,38.39999,38.60001,306300,1159060,62.32622203078187,60.892823580010166,NaN,NaN,97.26162602620875,56.709418178061455,-0.03753623410778517,0.2454254352125318,0.28296166932031697,28086573,28346233,27.315084358241464,42.85001261325255,NaN,NaN,20.32614063066728,23.14886591056326
2006-12-28T09:30:00-05:00,38.61,38.66,38.5,38.56,195500,1119255,61.16352486444587,60.86524352519619,NaN,NaN,107.20316855239041,61.92678698429772,-0.031061695080042473,0.2441345504702639,0.27519624555030636,27891073,27785293,25.522385847919324,41.69665688142455,NaN,NaN,20.564349804572004,22.77964932399308
2006-12-29T09:30:00-05:00,38.50999,38.67999,38.34,38.36,664300,1082350,55.58172850902775,60.35200741666581,NaN,NaN,62.26402811447822,63.84297653367827,-0.04064771847088322,0.2243865974617023,0.26503431593258553,27226773,27653993,25.10701802977711,40.28255654731767,NaN,NaN,19.17747695664167,22.265053271514308
2007-01-03T09:30:00-05:00,38.57001,38.83,38.24001,38.52,2004600,1110410,58.81951087132578,59.920286675705675,NaN,NaN,87.34319772060348,76.36949270655168,-0.03673067270765146,0.2191209750480212,0.25585164775567265,29231373,28043213,28.805901713712288,39.01342212645441,NaN,NaN,18.91144778565905,21.785966773534984
2007-01-04T09:30:00-05:00,38.46001,38.63,38.3,38.50999,1336600,1087515,58.53205014875581,59.854346356980066,NaN,NaN,53.38908414859199,81.49222091245457,-0.03532142720077025,0.21169986375470984,0.2470212909554801,27894773,28066113,29.02799816743361,37.89411723536055,NaN,NaN,18.614260879601265,21.332865931544454
2007-01-05T09:30:00-05:00,38.56,38.56,38.2,38.25,1014900,1042410,51.49302153749124,59.057451403543276,NaN,NaN,-30.324616934100497,55.97497232039272,-0.05143053221231053,0.18273312569009192,0.23416365790240246,26879873,27824773,28.035379189593428,36.59620240193958,NaN,NaN,16.27172248820808,20.60984543963926
2007-01-08T09:30:00-05:00,38.28,38.36,38.03,38.31,3120100,1148750,52.900729177800315,57.9741075674389,NaN,NaN,-83.5644349960294,17.821451610708756,-0.05713709920695109,0.1627422838937136,0.21987938310066468,29999973,28246553,32.386868258981465,35.3780791120057,NaN,NaN,14.723283947151241,19.768908083569542
2007-01-09T09:30:00-05:00,38.50999,38.56,38.28999,38.52,1143300,1175990,57.54473281224641,57.73238871353151,NaN,NaN,35.467789374558386,12.462203862724792,-0.04632153265235103,0.16197746728522588,0.20829899993757692,31143273,29029853,39.68139277108891,34.581000145436164,NaN,NaN,14.71800508954245,19.047350512994242
2007-01-10T09:30:00-05:00,38.42,38.74001,38.31,38.72,1016500,1210120,61.44385917115221,57.81778416785728,NaN,NaN,102.38688260234817,15.470940839073728,-0.02624978324205471,0.17548677088500853,0.20173655412706323,32159773,29615533,44.50259718752262,34.256552250190985,NaN,NaN,15.904422920557145,18.5983608569318
2007-01-11T09:30:00-05:00,38.7,39.17,38.67,39.14999,718700,1214830,68.2048410885295,58.36352079738283,NaN,NaN,278.4985083787815,60.49282568511163,0.013308621056270564,0.21837233044740145,0.2050637093911309,32878473,30612273,51.59367896953398,34.349265882394455,NaN,NaN,19.31356841487066,18.70053336520878
2007-01-12T09:30:00-05:00,39.08,39.27,39.02,39.25999,863600,1207150,69.67007372675137,59.032385541729624,NaN,NaN,290.6028530118082,124.67831967429338,0.04255581891423704,0.2582584830339272,0.21570266411969014,33742073,31984713,59.304227798291144,35.27461209674525,NaN,NaN,22.54560388746062,19.2498291541019
2007-01-16T09:30:00-05:00,39.19,39.42999,39.19,39.39999,889300,1165405,71.47199971214812,60.141938099439486,NaN,NaN,264.9649684931724,194.38420037213373,0.06562450249129417,0.29773329223380784,0.23210878974251367,34631373,32910993,63.52691852964849,37.03989416890514,NaN,NaN,25.796933421102462,20.18512976367341
2007-01-17T09:30:00-05:00,39.46001,39.53,39.36,39.39999,838200,1174370,71.47199971214812,61.30572208720194,NaN,NaN,216.35743226079748,230.56212894938153,0.07452727005236687,0.32526787730797224,0.2507406072556054,34631373,33608613,66.35818483806852,39.399161721625674,NaN,NaN,28.370328317961256,21.354443842857386
2007-01-18T09:30:00-05:00,39.49001,39.67999,39.45,39.62,1012300,1176575,74.25921857554202,62.491679424153304,NaN,NaN,188.95914143446922,247.87658071580577,0.08795507960009769,0.36068445675572747,0.2727293771556298,35643673,34305393,68.9507011555067,42.151309772522794,NaN,NaN,31.494843362540447,22.80307234566925
2007-01-19T09:30:00-05:00,39.53999,39.72,39.495,39.61,981500,1143010,73.9057747665741,63.318790333852746,NaN,NaN,153.73277773124306,222.92343458629807,0.08863602156294914,0.3835244041093162,0.29488838254636707,34662173,34662133,70.21620348579765,45.215675424491096,NaN,NaN,33.90678910757844,24.389317597370564
2007-01-22T09:30:00-05:00,39.67999,39.69,39.31,39.36,2154000,1197295,65.51100211778692,63.629324423377106,NaN,NaN,108.0544413275978,186.413752249456,0.06577351902996131,0.3771052813338187,0.3113317623038574,32508173,34415353,68.147011432516,48.260291537676565,NaN,NaN,33.529723219526915,25.695089829107186
2007-01-23T09:30:00-05:00,39.46001,39.67999,39.38,39.5,1502200,1183370,67.7221027553388,64.49649401239932,NaN,NaN,102.09725129690916,153.84020881020336,0.05409190949496934,0.37894664917256904,0.3248547396775997,34010373,34291153,67.07567753741216,51.25805293107907,NaN,NaN,33.874472949192125,26.863573131976462
2007-01-24T09:30:00-05:00,39.58,39.64999,39.46001,39.64999,975300,1091510,69.94521081429906,65.29118686546884,NaN,NaN,98.09867569355119,130.1884574967541,0.05054488841413274,0.38803585019526565,0.3374909617811329,34985673,34362013,67.39065849230322,54.0141069866927,NaN,NaN,34.838739267077415,28.002882579848027
2007-01-25T09:30:00-05:00,39.57001,39.57001,38.97,39.02,924900,1107855,53.33066797870316,64.91965956760794,NaN,NaN,38.04708466112374,100.006046142085,0.002390707040054618,0.3404793455812012,0.33808863854114657,34060773,34045433,64.42521054408192,56.54247929931044,NaN,NaN,29.84816698164322,28.26649463724734
2007-01-26T09:30:00-05:00,39.06,39.12,38.72,38.83,1115800,1138895,49.51090916136185,64.77808011217012,NaN,NaN,-8.899647818428003,67.4795610321508,-0.04312437146469572,0.28418317421027695,0.32730754567497267,32944973,33701993,61.2750936271674,58.91674461628001,NaN,NaN,24.48421044870266,27.726168324598103
2007-01-29T09:30:00-05:00,38.85001,39.10001,38.81,38.92999,1907300,1218945,51.480442780503,64.67663108379175,NaN,NaN,-3.5880125235673397,45.151070261917766,-0.0659945622973308,0.24481434280330916,0.31080890510063997,34852273,34170813,63.8719910351776,61.16568195743688,NaN,NaN,20.89448332843818,26.750213325146685
2007-01-30T09:30:00-05:00,38.98,39.08,38.895,39.03999,1269200,1272630,53.623739857600235,64.39656015845988,NaN,NaN,2.364259443066895,25.20447189114931,-0.07268325327519598,0.219954838506645,0.29263809178184097,36121473,34593033,66.07826684925291,63.051172963020015,NaN,NaN,18.677763778346225,25.597006247032333
2007-01-31T09:30:00-05:00,38.95,39.53,38.95,39.46001,1149100,1296870,60.752854338310954,64.3472026703998,NaN,NaN,48.20640738697337,15.226018229833736,-0.048928649424966886,0.2314772800006324,0.2804059294255993,37270573,35050013,68.33237304009745,64.75329980963251,NaN,NaN,19.126557835697177,24.672656473984453
2007-02-01T09:30:00-05:00,39.47,39.63,39.42,39.60001,1188300,1256055,62.805264196255415,63.961518606665926,NaN,NaN,81.12308819628144,23.84121893686528,-0.025096737680497694,0.2490350073249772,0.2741317450054749,38458873,35929633,72.16634679505815,66.22277608288422,NaN,NaN,20.171463839662575,24.029628954795612
2007-02-02T09:30:00-05:00,39.64,39.74001,39.58,39.71001,607700,1219610,64.38136023623947,63.58375335734365,NaN,NaN,95.92584463734924,44.806317428020726,-0.004323008412443208,0.26872798448992086,0.27305099290236406,39066573,37153953,76.44161747619637,67.44687534559175,NaN,NaN,21.520808826010754,23.671226079254918
2007-02-05T09:30:00-05:00,39.64999,39.66,39.46001,39.58,764800,1207105,61.08665691066647,62.84194315723782,NaN,NaN,71.5059567544806,59.825111283630314,-0.0018621063712101482,0.2707233599383514,0.27258546630956154,38301773,37843853,78.45029668523108,68.51283092813335,NaN,NaN,21.60707371228296,23.376347169687495
2007-02-06T09:30:00-05:00,39.58,39.72,39.5,39.72,1373900,1119795,63.26663837605584,62.25584591894551,NaN,NaN,83.45549156683401,76.04335770838374,0.006227317315713354,0.28036961295420326,0.2741422956384899,39675673,38554693,80.3128878050802,69.50959542577705,NaN,NaN,22.349236719741867,23.22961710540955
2007-02-07T09:30:00-05:00,39.75999,39.96001,39.67999,39.91,923000,1108780,66.0466531072496,61.66923409978177,NaN,NaN,126.09221626965268,91.6205194849196,0.020597218245831883,0.29988881844577975,0.27929160019994786,40598673,39220313,81.89124071889331,70.43391968030467,NaN,NaN,23.84177537612476,23.317068286940295
2007-02-08T09:30:00-05:00,39.85001,39.86,39.6899,39.83,962500,1106080,63.85533864592168,60.95134580544944,NaN,NaN,107.98661118628539,96.99322408292039,0.020872592229488396,0.30538234048680835,0.28450974825731995,39636173,39455773,82.42792707818909,71.30618565118976,NaN,NaN,24.417030591073203,23.474205758959283
2007-02-09T09:30:00-05:00,39.87,39.9875,39.27,39.46001,1127200,1126505,54.79974170466664,60.18625577594086,NaN,NaN,41.89706006284675,86.18746716801988,-0.0062547029700616985,0.2766913695447428,0.2829460725148045,38508973,39344253,81.20045776520189,72.23857467495306,NaN,NaN,22.05064910438061,23.270840522590902
2007-02-12T09:30:00-05:00,39.5,39.53999,39.19,39.27,869772,1126813.6,50.81429563483308,58.978555267333306,NaN,NaN,-34.762534988685616,64.93376881938664,-0.03763524382846467,0.2359020177292237,0.27353726155768837,37639201,39211738.6,79.6820385234796,73.13902903110072,NaN,NaN,18.792116385825306,22.631022788767247
2007-02-13T09:30:00-05:00,39.36,39.62,39.31,39.62,937069,1129202.05,57.01563140429255,58.05501388090426,NaN,NaN,21.152781989087757,52.47322690383739,-0.035488661889402695,0.22917643419593503,0.2646650960853377,38576270,38991858,77.10555476299467,73.83295019329297,NaN,NaN,17.973554250684316,21.965670140469687
2007-02-14T09:30:00-05:00,39.64999,39.87,39.58,39.82001,991535,1136868.8,60.110705535118555,58.53930227779108,NaN,NaN,89.73363077892124,45.20150980569111,-0.021931581838447234,0.2372506187872787,0.25918220062572594,39567805,38785684.4,74.66757637007467,74.56454775229246,NaN,NaN,18.314979698771225,21.444142934512765
2007-02-15T09:30:00-05:00,39.81,39.95,39.67,39.95,1417200,1157113.8,62.0245487806217,59.43313367916678,NaN,NaN,111.57639769850647,45.91946710813532,-0.0063518334765171325,0.25124240878007953,0.25759424225659666,40985005,39055450.8,75.74808849921409,75.59833310029579,NaN,NaN,19.204036102453923,21.124127672790074
2007-02-16T09:30:00-05:00,39.74001,39.89999,39.67,39.89999,831100,1149593.8,60.81563084978521,60.09993282697265,NaN,NaN,95.26777088430833,56.593609272427635,-0.0017937343301657194,0.2553520743438895,0.25714580867405523,40153905,39384437.2,77.03456638758433,76.53851705403913,NaN,NaN,19.55315239298458,20.89970263281786
2007-02-20T09:30:00-05:00,39.83,40.21001,39.75,40.19,920100,1087898.8,65.06770759604221,60.91735909400422,NaN,NaN,142.8087959460341,92.10787545937157,0.01732063585819643,0.2787966034968008,0.26147596763860437,41074005,40071398,79.48209642223422,77.49593345210921,NaN,NaN,21.198686578062162,20.942414624995617
2007-02-21T09:30:00-05:00,40,40.12,39.97,40.03,2066600,1116118.8,61.1266692539901,60.94406015940988,NaN,NaN,124.01522219424031,112.68036350040208,0.01579852373627544,0.28122412230894867,0.2654255985726732,39007405,40157625,79.77348362522045,78.31315563676087,NaN,NaN,21.35676782717728,21.001607939592997
2007-02-22T09:30:00-05:00,40.08,40.12,39.77,39.94,1168400,1125773.8,58.96328321868607,60.66963294672636,NaN,NaN,90.3447874194532,112.80259482850848,0.005852884365898703,0.2727417040300466,0.2668888196641479,37839005,39811865,75.16388745396333,78.52726568382552,NaN,NaN,20.839108532587765,20.97839373859225
2007-02-23T09:30:00-05:00,39.99001,40.02,39.7,39.85001,796200,1119338.8,56.79868163895555,60.12801304692035,NaN,NaN,63.525267061553755,103.19236870111793,-0.008863793573534895,0.25580907769722927,0.26467287127076417,37042805,39023425,65.82351911823875,77.76883008682854,NaN,NaN,19.777572875403333,20.806847900993834
2007-02-26T09:30:00-05:00,39.85001,39.88,39.38,39.50999,909531,1109025.35,49.41681849707784,59.294453160235456,NaN,NaN,-12.778567727698293,81.5831009787166,-0.041735521587744406,0.21250346928608366,0.25423899087382806,36133274,38219298.8,57.918349494878576,76.3022624303748,NaN,NaN,16.515362765443882,20.19377859591527
2007-02-27T09:30:00-05:00,39.08,39.09,37.67999,38.14999,3531200,1190220.35,31.68114377799003,57.03834640323076,NaN,NaN,-323.86368441274954,-11.75139509304012,-0.1492609100114107,0.06766285335956468,0.21692376337097538,32602074,36524912.6,45.51458392826019,73.81666929631623,NaN,NaN,5.334043205948359,18.070959254491424
2007-02-28T09:30:00-05:00,39.28999,39.28999,37.88,38.23,5438801,1398700.4,33.20007788758208,54.69216245896879,NaN,NaN,-248.23364603011711,-86.2011687379116,-0.20570283807917675,-0.04020478422799556,0.1654980538511812,38040875,36331606.6,44.34770411839182,71.13498811056613,NaN,NaN,-2.1610620168391366,15.180670501444201
2007-03-01T09:30:00-05:00,38.24001,38.27,37.34,38.06,2660314,1474261.1,31.59285342160429,52.3876992286604,NaN,NaN,-267.6760307143161,-157.80533236466545,-0.24265407946543324,-0.13781954548061037,0.10483453398482287,35380561,35839917.8,41.43765459826566,68.2071115048573,NaN,NaN,-8.50320542711086,11.797259654507764
2007-03-02T09:30:00-05:00,37.92,38.13,37.75,37.78,1919300,1510811.1,29.094562251998738,50.551614982041265,NaN,NaN,-195.88529269902207,-209.6874443167806,-0.2719187761935316,-0.23506393625709165,0.036854839936439954,33461261,35123609,37.56985946328879,65.0906401975778,NaN,NaN,-14.504251939913463,8.039900855304731
2007-03-05T09:30:00-05:00,37.32001,37.75,37.23,37.28,3006100,1630731.1,25.254105742874103,48.725887132615625,NaN,NaN,-191.56475076351234,-245.44468092394345,-0.3082517200283416,-0.3484598100989871,-0.040208090070645464,30455161,33987986.4,32.40561299192579,61.71375265960967,NaN,NaN,-21.018104398214067,3.8887572476591883
2007-03-06T09:30:00-05:00,37.61,38.00999,37.44,37.92,1311200,1658051.1,36.760832967630186,47.27911581571117,NaN,NaN,-126.10883950924229,-205.89371194324198,-0.27365556648677825,-0.3822775481791183,-0.10862198169234004,31766361,33820843.8,31.714633904521108,58.47154402686156,NaN,NaN,-22.210210461093826,0.16033328926590062
2007-03-07T09:30:00-05:00,37.7,38.06,37.7,37.88,1303900,1654551.1,36.38383616755404,45.584339432313705,NaN,NaN,-100.76041013654155,-176.39906476452686,-0.23918831137590157,-0.407607370912217,-0.16841905953631542,30462461,32305161,26.24876314497608,55.013057367925946,NaN,NaN,-23.226944801589042,-3.180706437999091
2007-03-08T09:30:00-05:00,37.94,38.44,37.92,38.17999,835100,1650156.1,41.25005106460268,44.10044673831235,NaN,NaN,-67.5642386913168,-136.37670635992703,-0.1843661517057428,-0.3988767491684939,-0.2145105974627511,31297561,31488561,23.862584912682422,51.30694996888797,NaN,NaN,-22.37523911462338,-5.922782534659703
2007-03-09T09:30:00-05:00,38.42,38.47,38.05,38.25999,1256800,1664871.1,42.5129304387206,42.79311099466487,NaN,NaN,-54.74000498205339,-108.14764881653328,-0.13327884050716315,-0.38110914809670504,-0.2478303075895419,32554361,31307181,23.354736942659528,47.47267643710762,NaN,NaN,-21.29894914605532,-8.119377764859077
2007-03-12T09:30:00-04:00,38.19,38.32001,38.11,38.21001,409200,1628971.1,41.90684989662013,41.13876401613472,NaN,NaN,-52.625621669172816,-80.35982299766539,-0.09520179175130744,-0.3668325472786762,-0.27163075552736876,32145161,31645181,26.49416153510556,43.68782394516985,NaN,NaN,-20.62583015521886,-9.90601382062476
2007-03-13T09:30:00-04:00,37.99001,38.07001,37.42,37.50999,858900,1628427.5,34.49025462838377,39.23616297144855,NaN,NaN,-84.87604029953084,-72.1132631557231,-0.10854243530629326,-0.40730879966023537,-0.2987663643539421,31286261,31549161,26.16626549996778,39.85873693622324,NaN,NaN,-22.46755196613237,-11.70051926998299
2007-03-14T09:30:00-04:00,37.37,37.57001,36.86,37.44,2657800,1714464.05,33.8453014629586,37.44202141746802,NaN,NaN,-102.22190174188094,-72.40556147679098,-0.11295692079497932,-0.4399625153476663,-0.32700559455268696,28628461,31182361,24.89857624830718,36.26835756439065,NaN,NaN,-24.118194793560484,-13.474472916208347
2007-03-15T09:30:00-04:00,37.49001,37.7,37.4599,37.52,962200,1712997.3,35.333797935648064,35.90881543866034,NaN,NaN,-77.18109321061189,-74.32893238065,-0.10171578564487682,-0.45415032660878296,-0.35243454096390614,29590661,30840981,23.745530923588888,33.26278697905852,NaN,NaN,-24.998034117795388,-15.120695945006496
2007-03-16T09:30:00-04:00,37.58,37.64999,37.32001,37.32001,962600,1690267.3,33.31571403615651,34.758736548594534,NaN,NaN,-82.71079083450174,-79.92308955113967,-0.09888776649966013,-0.4760442490884813,-0.3771564825888212,28628061,30055721,21.301825902635628,30.64732100818402,NaN,NaN,-26.337782911432218,-16.72313694021017
2007-03-19T09:30:00-04:00,37.67,37.87,37.60001,37.87,1184000,1707912.3,42.96360070567058,35.564626329143145,NaN,NaN,-51.53696205678451,-79.70535762866203,-0.05339381818106581,-0.44389875531515344,-0.3905049371340876,29812061,29589101,19.985633519437798,28.82382455041099,NaN,NaN,-24.460328947074792,-17.828450084047976
2007-03-20T09:30:00-04:00,37.81,38.14999,37.78,38.14999,1322775,1728046.05,47.15523218185718,36.56142306444851,NaN,NaN,-25.117733208360775,-67.753696210428,-0.0006516338977249347,-0.3913194795062438,-0.39066784560851886,31134836,29558816,19.899693028282982,27.07753804397464,NaN,NaN,-21.539781406909924,-18.358640273028254
2007-03-21T09:30:00-04:00,38.14,38.8,38.02,38.75,1954167,1722424.4,54.81817240399247,38.22037442033338,NaN,NaN,38.89704419503661,-39.529907023044494,0.07429318579458483,-0.29780136336528784,-0.37209454915987267,33089003,30450924.4,29.51477003847272,26.22590343256086,NaN,NaN,-16.298698230770388,-18.06436283841999
2007-03-22T09:30:00-04:00,38.81,38.81,38.47,38.64,2292200,1778614.4,53.292441508060506,39.94879436719493,NaN,NaN,69.84099398893643,-10.125489583134831,0.11374494725041928,-0.22991336509684857,-0.34365831234726785,30796803,30692152.8,31.89539273823165,25.820584380771056,NaN,NaN,-12.64592537586017,-17.290300343768585
2007-03-23T09:30:00-04:00,38.49001,38.77,38.49001,38.66,1074128,1792510.8,53.545605645442315,41.96961578880695,NaN,NaN,90.7644945039846,24.569567484562437,0.1369192694452538,-0.17250922554070058,-0.30942849498595437,31870931,31340726.8,37.962256264857494,26.21748747169475,NaN,NaN,-9.681917765584881,-16.2033885468852
2007-03-26T09:30:00-04:00,38.57001,38.6615,38.24001,38.47,1208900,1807479.25,50.732355598367384,42.96758169100246,NaN,NaN,82.73060709545679,51.4230813150107,0.13496259568179553,-0.14072525038370998,-0.2756878460655055,30662031,31510720.8,39.483915120731304,26.77243612999548,NaN,NaN,-8.020685942199679,-15.034431031930126
2007-03-27T09:30:00-04:00,38.32001,38.35001,38.14,38.23,1662900,1714064.25,47.348345635253324,43.75076093869527,NaN,NaN,43.09312757679834,65.06525347204253,0.11385838234533902,-0.13336486813383175,-0.24722325047917076,28999131,31083579.8,37.026405605306394,27.542267734304794,NaN,NaN,-7.602224432988939,-13.972687232081384
2007-03-28T09:30:00-04:00,37.94,38.03999,37.71001,37.8,1661100,1525179.2,41.94934160879029,43.800710263280095,NaN,NaN,-26.109207978435155,52.06400303734817,0.0694743174802604,-0.16038035362884528,-0.22985467110910568,27338031,29933385.4,31.365213209767674,28.07816975552517,NaN,NaN,-8.905331560173328,-13.248779278951663
2007-03-29T09:30:00-04:00,38.12,38.12,37.67999,37.92999,3316300,1557978.5,44.0271820082236,43.908871089673156,NaN,NaN,-14.407129992954369,35.21437824097001,0.04840448624264301,-0.1693490633058019,-0.21775354954844492,30654331,29904891,31.23778968681772,28.641244951536468,NaN,NaN,-9.35301566545353,-12.6922416198805
2007-03-30T09:30:00-04:00,37.98,38.19,37.7,38.03,1368900,1530458.5,45.639341166626394,44.175477608959326,NaN,NaN,-2.6632340523940594,16.528832529694277,0.04102850316405468,-0.16646792059337656,-0.20749642375743124,32023231,29935351,31.557885393376097,29.00293951284151,NaN,NaN,-9.255769815880813,-12.201317076451973
2007-04-02T09:30:00-04:00,38.09,38.19,37.91,38.16,1342400,1447273.5,47.7461897043187,45.12233011438325,NaN,NaN,14.514718339855433,2.8856547785740374,0.04444259951879806,-0.15194317435893367,-0.19638577387773173,33365631,30476071,37.1510223753956,29.78756500394349,NaN,NaN,-8.576228409245063,-11.683447266850987
2007-04-03T09:30:00-04:00,38.39999,38.75999,38.36011,38.64999,1344600,1448943.5,54.84920221730709,46.62260873969385,NaN,NaN,109.36033040889126,16.139095344992626,0.07731316317494558,-0.09974431990904975,-0.17705748308399533,34710231,31618291,47.003419243115424,31.36648236071551,NaN,NaN,-5.777950752013033,-10.839804907588421
2007-04-04T09:30:00-04:00,38.60001,38.66,38.5,38.53999,1506396,1459068.3,53.10401460452212,47.891909930327714,NaN,NaN,93.50449475188795,40.06183589105724,0.0884571681544371,-0.06648602289094896,-0.15494319104538606,33203835,32791451.8,54.83482680698415,33.5871463523866,NaN,NaN,-3.987601829791123,-9.860918753617378
2007-04-05T09:30:00-04:00,38.50999,38.85001,38.50999,38.85001,777200,1456173.3,57.234031501382255,49.600361177843844,NaN,NaN,112.35754865319662,65.41477162028744,0.1120022832905953,-0.014940336932141918,-0.12694262022273722,33981035,33456792.6,58.573689592156136,36.24942233020949,NaN,NaN,-1.1761174086150694,-8.620232847188477
2007-04-09T09:30:00-04:00,38.92999,38.92999,38.73,38.82001,712655,1428966.05,56.7135334654358,50.58249923211279,NaN,NaN,114.71715768902972,88.8908499685722,0.12013134227099331,0.023221557616004418,-0.0969097846549889,33268380,33705822.4,59.9113596949866,39.10125991417726,NaN,NaN,0.95582649519328,-7.252224369705369
2007-04-10T09:30:00-04:00,38.8,38.92999,38.78,38.89999,1364281,1476720.1,57.81499093409975,51.34391057155868,NaN,NaN,107.51559615122866,107.49102553084683,0.12491664024477611,0.059236015650981244,-0.06568062459379487,34632661,33959228.4,61.28142841063911,42.057098155774135,NaN,NaN,3.043812707645366,-5.781361930083836
2007-04-11T09:30:00-04:00,38.85001,38.92999,38.56,38.60001,906729,1479111.55,52.42655750179411,51.17308093568737,NaN,NaN,73.23186238623335,100.26533192631526,0.10282241053659433,0.06284738857694805,-0.03997502195964628,33725932,33762368.6,59.57796992728365,44.20446957640348,NaN,NaN,3.365597489884976,-4.474653441516863
2007-04-12T09:30:00-04:00,38.58,38.89,38.33,38.87,1123851,1402414.1,56.36810027731237,51.39277084777679,NaN,NaN,67.14375451748627,94.99318387943492,0.10117863042433839,0.08649826607077671,-0.014680364353561681,34849783,34091558.2,61.50496727493999,46.31943918616837,NaN,NaN,4.800028189129422,-3.1496989228531085
2007-04-13T09:30:00-04:00,38.91,38.94,38.66,38.89999,1310925,1419850.35,56.79628993995249,51.62496258309894,NaN,NaN,84.79834203240547,89.4813425552767,0.09689211971614986,0.10643478529162564,0.009542665575475784,36160708,34527492.8,63.95550746188893,48.17609998595633,NaN,NaN,6.094334274606054,-1.8291227517875137
2007-04-16T09:30:00-04:00,39,39.32001,39,39.28999,1631353,1453288,62.016625562370315,52.430981866242014,NaN,NaN,149.11824269419978,96.36155955631071,0.11392806305398544,0.15195274439295758,0.03802468133897215,37792061,35432229,68.44512106102583,50.244757553120216,NaN,NaN,8.828894036536932,-0.30654892488402163
2007-04-17T09:30:00-04:00,39.24001,39.45,39.24001,39.45,651485,1426662.25,63.941709697076185,53.61622215637222,NaN,NaN,173.8280524765796,109.62405082138089,0.12849836560055422,0.19864763833966492,0.0701492727391107,38443546,36194406,71.64887332857856,52.71779096192537,NaN,NaN,11.702989711033378,1.4090994516756068
2007-04-18T09:30:00-04:00,39.28,39.44,39.14,39.42,825300,1401788.5,63.29400424198637,55.140840915886216,NaN,NaN,150.94111077173312,125.16590049848082,0.12834058486103958,0.23057500381541018,0.1022344189543706,37618246,36972868.8,74.49694741853008,55.79862911969412,NaN,NaN,13.876971680547564,3.190224055800172
2007-04-19T09:30:00-04:00,39.08,39.25,39.02,39.11,1929182,1400539.25,56.8820067689307,56.05904268450816,NaN,NaN,97.13867894056204,131.164885383096,0.10079833795280446,0.22823234139537618,0.12743400344257172,35689064,37140725,75.07830421933224,58.93009444344516,NaN,NaN,13.959018034635976,4.728623195633858
2007-04-20T09:30:00-04:00,39.46001,39.64,39.3,39.57001,680095,1319934,62.88979226942387,57.291217763279406,NaN,NaN,146.28255458162116,143.46172789293914,0.10644634778426071,0.2604919381728976,0.1540455903886369,36369159,37182415.2,75.22933640489754,62.04948380141097,NaN,NaN,15.906072413144068,6.325401655278174
2007-04-23T09:30:00-04:00,39.56,39.601,39.38,39.49001,790447,1305749.95,61.29039734713053,58.25866116633739,NaN,NaN,124.93910219701459,138.6258997935021,0.09789650013310952,0.2764162155550238,0.1785197154219143,35578712,36739745.4,70.35392942530954,64.42112001926196,NaN,NaN,17.005794301185293,7.8511720332649055
2007-04-24T09:30:00-04:00,39.42999,39.42999,39.07001,39.35001,1752312,1332920.55,58.487166481493915,58.518515756636454,NaN,NaN,82.08013846091117,120.27631699036843,0.07684372185660701,0.2745743677426731,0.19773064588606606,33826400,35816316.2,61.4128259978813,65.4503633588881,NaN,NaN,17.09827605163186,9.172186893031613
2007-04-25T09:30:00-04:00,39.55,39.78,39.41,39.75,3418108,1420680.95,63.60838740942121,59.268828099843525,NaN,NaN,124.6017121095226,115.00843725792632,0.08334372821037331,0.3019103061490327,0.21856657793865938,37244508,35741568.6,60.73991860703398,65.87215563032024,NaN,NaN,18.76534193980844,10.54263761399973
2007-04-26T09:30:00-04:00,39.83,39.84,39.55,39.69,1882521,1431752,62.36552650553647,59.63536345728311,NaN,NaN,117.90920534527999,119.16254253886991,0.07722710071565778,0.3151004538332316,0.23787335311757382,35361987,35676153.2,60.11908387989155,65.98254093658704,NaN,NaN,19.745848359275637,11.857382006182002
2007-04-27T09:30:00-04:00,39.63,39.63,39.36,39.42999,2833518,1407612.9,57.15385367878671,59.66681490109389,NaN,NaN,76.34934495230996,105.17590061300768,0.050583068145906684,0.30110218829995716,0.2505191201540505,32528469,34908015.2,53.237851153845675,65.50586175507698,NaN,NaN,19.01803919600291,12.880333033299275
2007-04-30T09:30:00-04:00,39.49001,39.49001,38.92999,38.92999,1638281,1421081.95,48.72201268654734,59.01731645484015,NaN,NaN,10.874223371821866,82.36292484796913,-0.0029613102122806045,0.24681748238869972,0.24977879260098032,30890188,33970310.4,46.274654660203886,64.4339493443316,NaN,NaN,15.586528191670478,13.266932341638018
2007-05-01T09:30:00-04:00,38.88,39.10001,37.83,39.03999,2850679,1496495.9,50.45380019716842,58.876405218795455,NaN,NaN,-86.71065071042236,48.60476701370243,-0.03162389501916524,0.21024892382702376,0.241872818846189,33740867,33953203.8,46.15605074657339,63.475240831423726,NaN,NaN,13.35097592116237,13.278938567284355
2007-05-02T09:30:00-04:00,39.21001,39.5708,39.2,39.49001,3489543,1603743.05,56.871145002982196,58.912336984914724,NaN,NaN,61.91412353339159,36.06724929847623,-0.021417154305407193,0.21510137596443002,0.2365185302698372,37230410,33950384.2,46.1350615689501,62.37739042385302,NaN,NaN,13.454342939847955,13.30399633479344
2007-05-03T09:30:00-04:00,39.45,39.55,39.3,39.41,2296343,1643240.4,55.49490160328335,58.81938067515265,NaN,NaN,55.973285184509,23.680065266322025,-0.02115938991969704,0.21006929287021592,0.23122868278991296,34934067,33864800.2,45.45932177549692,61.056234303396444,NaN,NaN,13.106251794229106,13.275747114712821
2007-05-04T09:30:00-04:00,39.50999,39.67,39.3,39.5,1154974,1662129.1,56.76240102145022,58.44407892222978,NaN,NaN,66.0594950127961,21.622095278419245,-0.016253096032376152,0.21091231274944278,0.22716540878181893,36089041,34576914.6,51.787129190099336,59.866377741187414,NaN,NaN,13.201291002120488,13.265110527199631
2007-05-07T09:30:00-04:00,39.45,39.57001,39.42,39.5,999446,1676468.65,56.762401021450216,57.93127115968507,NaN,NaN,62.253795115567904,31.89800962716845,-0.014396935593331162,0.20916923929015496,0.22356617488348612,36089041,35616685.2,59.22573157947967,58.97901047339464,NaN,NaN,13.277973236219834,13.266948057059661
2007-05-08T09:30:00-04:00,39.3,39.42,39.23,39.33,1067993,1661654.25,53.42897642267906,57.22662631544883,NaN,NaN,16.4786116312223,52.535862095497386,-0.025366032026720692,0.19185863485008525,0.21722466687680594,35021048,35872721.4,60.828415980637814,58.00268679925948,NaN,NaN,12.399343231656339,13.143004510573473
2007-05-09T09:30:00-04:00,39.2,39.60001,39.2,39.57001,2310700,1731852.8,57.24637833737495,57.252652856051995,NaN,NaN,46.762780240234804,49.50559343686602,-0.017575038180737468,0.1952558691508841,0.21283090733162158,37331748,35892989,60.9592334680363,56.99418174559548,NaN,NaN,12.724939609547112,13.083280953283992
2007-05-10T09:30:00-04:00,39.32001,39.52,39.00999,39.14,1779140,1764617.25,49.42889588643303,56.29116025726694,NaN,NaN,-37.77449070486277,30.75603825899167,-0.04115305400643471,0.1613895898235782,0.20254264383001291,35552608,36016697.2,61.7978498150862,56.03478984632324,NaN,NaN,10.593210950070858,12.727556667110688
2007-05-11T09:30:00-04:00,39.24001,39.3,39.09,39.3,1345400,1766341,52.05257259268476,55.631315631949384,NaN,NaN,-48.27803084340676,7.888533087751098,-0.04540970286168311,0.14578051525290903,0.19119021811459214,36898008,36178490.6,62.91970090303933,55.50377352330394,NaN,NaN,9.612967171739466,12.282615310629085
2007-05-14T09:30:00-04:00,39.33,39.49001,39.14,39.3,906900,1730118.35,52.05257259268476,55.17170178274872,NaN,NaN,-18.52888799424583,-8.26800353421165,-0.04744028096272376,0.13188986691118743,0.1793301478739112,36898008,36340284,64.05642066950298,55.692601714134064,NaN,NaN,8.826011779961455,11.788814806247995
2007-05-15T09:30:00-04:00,39.2,39.52,39.03999,39.16,3273100,1861199.1,49.44915304656586,54.16032789968762,NaN,NaN,-43.92473107231197,-20.34867207491851,-0.056795501719732466,0.1083357707242456,0.16513127244397807,33624908,36061056,60.603468882890134,55.68285530526664,NaN,NaN,7.412833139472442,11.163674568137202
2007-05-16T09:30:00-04:00,39.27,39.35001,39.03,39.3,984700,1869169.1,52.032787838100845,53.42227513772793,NaN,NaN,-45.70734077143814,-38.8426962772531,-0.052252856154836186,0.09981520225043283,0.15206805840526902,34609608,35516628,54.44144137983601,55.277309412405536,NaN,NaN,6.929718922351151,10.558823761596337
2007-05-17T09:30:00-04:00,39.22,39.4485,39.22,39.36,1168048,1831112.4,53.138213213198824,53.13544367590022,NaN,NaN,-4.043594392782395,-32.096517014837026,-0.044223748489223946,0.09678837279373909,0.14101212128296303,35777656,35561637.6,54.850166831710645,55.39247481796732,NaN,NaN,6.8274733703893835,10.025773705709629
2007-05-18T09:30:00-04:00,39.53,40.05,39.32001,39.72,1895400,1891877.65,59.211923962071,53.884723052723345,NaN,NaN,134.08892472633605,4.376874099111545,-0.015184199000527254,0.12203187253230396,0.13721607153283122,37673056,35716647.2,56.30408729127632,56.10886286304392,NaN,NaN,8.52371141412701,9.811193378340683
2007-05-21T09:30:00-04:00,39.82001,40,39.73,39.87,3262533,2015481.95,61.45369598912611,54.67042989500603,NaN,NaN,174.8846177612712,43.05957525021495,0.012134885672454132,0.15238467862339888,0.14024979295094475,40935589,36524163.4,62.990263561610995,57.3113066355466,NaN,NaN,10.62506697878531,9.927461035547058
2007-05-22T09:30:00-04:00,39.94,39.96001,39.75,39.83,1135081,1984620.4,60.49879495135439,54.92954774846119,NaN,NaN,145.30727914168668,80.90597729301467,0.02479049078425105,0.17123790643125858,0.14644741564700753,39800508,37759283.4,70.44059082232552,59.04741586793056,NaN,NaN,12.09098139931846,10.236535373228687
2007-05-23T09:30:00-04:00,40.08,40.23,39.83,39.85001,2767417,1952085.85,60.82671811564127,55.31039178505819,NaN,NaN,167.88190439068327,123.62382632543896,0.03136507871614297,0.18565376404218625,0.15428868532604328,42567925,39350946.8,76.89541350987582,61.29285099181477,NaN,NaN,13.396384522855257,10.687942394603912
2007-05-24T09:30:00-04:00,39.89999,40.12,39.5,39.53,2539257,1984922.65,53.217847479496065,55.057209389204324,NaN,NaN,88.93519268338615,142.21958374067268,0.012012782714987902,0.16930466371977815,0.15729188100479025,40028668,40201149.2,79.47382577529305,63.27047217647146,NaN,NaN,12.418705383875057,10.935194250214076
2007-05-25T09:30:00-04:00,39.57001,39.7278,39.55,39.67,1674300,1926961.75,55.8215165734023,54.990003357200905,NaN,NaN,62.80313803557764,127.96242640252099,0.00675388145736916,0.16573423282650168,0.15898035136913252,41702968,41007131.6,81.57320926365276,64.86672058248382,NaN,NaN,12.326590639797908,11.133965163011766
2007-05-29T09:30:00-04:00,39.64999,39.81,39.49001,39.64,1458700,1917982.7,55.113664066294426,55.11033818888772,NaN,NaN,55.45311173904325,104.0761251980754,-0.00026026902660442053,0.15865501508587698,0.1589152841124814,40244268,40868867.4,80.0604471207067,66.24043709248875,NaN,NaN,12.054904931952375,11.265527987146138
2007-05-30T09:30:00-04:00,39.46001,40,39.38,40,1574000,1854148.75,61.43364373934039,55.409428574742385,NaN,NaN,89.9040954370743,92.99548845715292,0.016882599732531423,0.1800185337781457,0.16313593404561427,41818268,41272419.4,81.15871446957844,67.68325716402747,NaN,NaN,13.690281378465723,11.611921328763222
2007-05-31T09:30:00-04:00,40.10001,40.14999,39.94,40.10001,1329267,1746134.95,62.99253724103226,56.3782601000709,NaN,NaN,149.01667983366147,89.22244354574858,0.03163752937066877,0.20268284575895024,0.17104531638828147,43147535,41388341.4,81.47437234744316,69.08872305919583,NaN,NaN,15.515124971748293,12.16952184918966
2007-06-01T09:30:00-04:00,40.25999,40.39,40.17,40.33,1755430,1719089.3,66.3600791733929,57.40022485583576,NaN,NaN,179.950854116336,107.42557583233852,0.05234517885080461,0.23647678995178723,0.1841316111009826,44902965,42363200.8,83.91493383952957,70.58838255465942,NaN,NaN,18.13634403984874,13.021925019283815
2007-06-04T09:30:00-04:00,40.22,40.42999,40.13,40.41,1364073,1729544.25,67.46896615305064,58.501395824433324,NaN,NaN,159.51660172797415,126.76826857081785,0.06600703195408458,0.2666404010435883,0.20063336908950374,46267038,43276014.8,85.80116351619606,72.14157847228036,NaN,NaN,20.6361014325516,14.109664506893498
2007-06-05T09:30:00-04:00,40.22,40.27,39.96001,40.17,1950700,1777106.95,60.975269654170575,59.32468986783366,NaN,NaN,102.48954416409333,136.17555505582786,0.05396444367396919,0.26808892368196524,0.21412448000799605,44316338,44090428.8,87.23898379287075,74.04411525156468,NaN,NaN,20.895448920929766,15.079062280327252
2007-06-06T09:30:00-04:00,39.91,39.94,39.66,39.66,2859321,1866673.35,49.969164929587066,59.17728823151125,NaN,NaN,14.839108001143106,121.16255756864162,0.009088336775818051,0.22548490097776863,0.21639656420195058,41457017,44018178.6,86.40307374624595,76.32708899202252,NaN,NaN,17.433408548151416,15.41539746144499
2007-06-07T09:30:00-04:00,39.64999,39.67,38.92,38.92,3534800,1927878.35,38.9759869455197,58.16570064096273,NaN,NaN,-110.88978057971013,69.18126548596729,-0.06871348065926672,0.13050471337786718,0.1992181940371339,37922217,42973115,75.1816232846412,77.77933588151758,NaN,NaN,9.913835896381155,14.629460095007298
2007-06-08T09:30:00-04:00,38.92,39.42,38.88,39.42,1939800,1935911.35,47.39683800899973,57.32176593002907,NaN,NaN,-95.99002151816642,13.993090359066812,-0.08378348069489677,0.09448884316851291,0.1782723238634097,39862017,41964925.4,66.24348351572462,78.48929275469246,NaN,NaN,6.938331217776083,13.530727398259982
2007-06-11T09:30:00-04:00,39.22,39.42999,39.16,39.28999,1250000,1931141.35,45.63352005413666,56.19175336324411,NaN,NaN,-85.9298234804326,-35.096194682614545,-0.09875920547955777,0.05482331701396248,0.15358252249352025,38612017,40433921.2,55.46051798750225,77.95145378511326,NaN,NaN,4.049859479106132,12.176317695523718
2007-06-12T09:30:00-04:00,39.02,39.33,38.87,38.97,1632000,1967396.35,41.5374667617979,54.837372778275785,NaN,NaN,-129.79917571714728,-81.55393865886266,-0.1247897756897584,-0.0024046971186777455,0.12238507857108065,36980017,38966657,47.483282527278554,76.31164604975277,NaN,NaN,0.22735172498987308,10.469322556876026
2007-06-13T09:30:00-04:00,39.12,39.42,38.98,39.42,1397098,1873596.25,48.53371540894307,53.959301156368774,NaN,NaN,-84.5156244369469,-101.42488514648066,-0.10696135923671116,-0.011316620474808303,0.09564473876190285,38377115,38350676.6,44.58399851416588,74.00368783577349,NaN,NaN,-0.4076544839305233,8.915468693903662
2007-06-14T09:30:00-04:00,39.37,39.72,39.37,39.7,949400,1871831.25,52.3543952808706,53.89762599932409,NaN,NaN,-20.57208697877764,-83.36134642629418,-0.07318279095868371,0.004166250063548205,0.07734904102223192,39326515,38631536.2,46.1971039064197,71.62677913085396,NaN,NaN,0.4529715791015388,7.706540534646216
2007-06-15T09:30:00-04:00,39.92999,40,39.75999,39.83,2640138,1945435.75,54.05962303318036,53.77177646073681,NaN,NaN,36.054880352294674,-56.95236605220195,-0.04058355607682047,0.02661959592620633,0.0672031520030268,41966653,39052463.4,48.61143298391484,69.2723665394441,NaN,NaN,1.7028586803531258,6.848871698318631
2007-06-18T09:30:00-04:00,39.83,39.86,39.64,39.66,787558,1890043.65,51.46563972789789,53.51120329370849,NaN,NaN,1.5258709381480888,-39.46122716848582,-0.029485211292167843,0.030346637887816996,0.05983184917998484,41179095,39565879,51.4718621120579,67.23032475311206,NaN,NaN,1.8683180850504233,6.137364039280316
2007-06-19T09:30:00-04:00,39.61,39.81,39.46001,39.78999,3112530,1882543.5,53.31048207605046,52.930977460616354,NaN,NaN,-4.38813988956622,-14.379020002969611,-0.013233137722294584,0.04329042702711661,0.05652356474941119,44291625,41028200.6,58.549007758290315,65.61534570230576,NaN,NaN,2.5809945035293524,5.62931124845875
2007-06-20T09:30:00-04:00,40,40.13,39.63,39.72,2659501,1958764.5,52.16083324203077,52.15728431783054,NaN,NaN,30.155290220790015,8.555162928577783,-0.0073348627585794815,0.04735498630118684,0.05468984905976632,41632124,41679202.4,61.25778289602982,64.17130359863339,NaN,NaN,2.815201334150185,5.227295546414669
2007-06-21T09:30:00-04:00,39.59,39.75999,39.25,39.64999,2915630,1966175.15,50.97661338039689,51.058465332616535,NaN,NaN,-32.376552556670156,6.194269812999275,-0.008219904212185776,0.044414968794534104,0.05263487300671988,38716494,41557198.2,60.46036484457266,62.495977241850746,NaN,NaN,2.6687438031721,4.861788154522873
2007-06-22T09:30:00-04:00,39.50999,39.57001,39.24001,39.39,2286200,1953522.3,46.733385877762174,49.57735245581022,NaN,NaN,-63.78046692389769,-13.772799642239198,-0.025415546593696985,0.020865439764598648,0.04628098635829563,36430294,40449926.4,53.63623593519071,60.198482414636075,NaN,NaN,1.2988726504844748,4.352800225374531
2007-06-25T09:30:00-04:00,39.38,39.58,39.08,39.23,1821700,1960892.3,44.29006941930749,48.38555243903428,NaN,NaN,-79.25086142322085,-29.92814611451298,-0.045493878283029546,-0.010586361495491303,0.03490751678753824,34608594,39135826.2,46.874311874421764,57.31529156331829,NaN,NaN,-0.5724618943544287,3.649191351127537
2007-06-26T09:30:00-04:00,39.35001,39.39,38.96001,38.96001,9750063,2375460.45,40.44721868312328,47.705413421429725,NaN,NaN,-106.80942192970554,-50.412402522540845,-0.07324209955074014,-0.05664510765088693,0.016596991899853208,24858531,35249207.4,33.44461199000193,53.53254429501514,NaN,NaN,-3.35651268129525,2.648376489352853
2007-06-27T09:30:00-04:00,38.92,39.42999,38.78999,39.36,1871690,2390344.95,47.68872038310504,48.32775152411439,NaN,NaN,-79.56893787085129,-72.35724814086912,-0.06141955944031602,-0.06017745740054181,0.0012421020397742032,26730221,32268826.8,27.045605205907364,50.094257289391294,NaN,NaN,-3.601938603405583,1.7554743332445053
2007-06-28T09:30:00-04:00,39.38,39.60001,39.28,39.28,3162708,2482017,46.47158302972232,48.26166188273743,NaN,NaN,-36.04472819366987,-73.09088326826905,-0.05590644265550879,-0.06864095127961178,-0.012734508624102995,23567513,29239030.6,22.361615280475476,46.95983812973065,NaN,NaN,-4.1644950888622905,0.9097644158006774
2007-06-29T09:30:00-04:00,39.39999,39.67,39.10001,39.33,1946200,2491555.5,47.375598355537235,48.38609604712319,NaN,NaN,-33.95441192571385,-67.12567226863229,-0.046213238481394005,-0.0705010567258455,-0.024287818244451496,25513713,27055714.4,19.71224188022866,44.406389836353966,NaN,NaN,-4.365584238109567,0.15614317952778534
2007-07-02T09:30:00-04:00,39.39999,39.81,39.00999,39.53999,1241367,2485420.2,51.11002953777687,49.06985053112168,NaN,NaN,-4.191720246828645,-52.113844033353836,-0.024092652940801058,-0.05440363442045282,-0.03031098147965176,26755080,25485011.6,18.054952265390156,42.30436624621908,NaN,NaN,-3.4578814169715715,-0.36014604854355126
2007-07-03T09:30:00-04:00,39.61,39.69,39.45,39.60001,1820743,2478922.35,52.15512220472623,49.328522445106195,NaN,NaN,44.93314945624683,-21.76532975616336,-0.004858246177911654,-0.03638378920204133,-0.031525543024129674,28575823,26228470,21.422456683918,40.64997040120137,NaN,NaN,-2.4111952726827144,-0.6531530805634317
2007-07-05T09:30:00-04:00,39.7,39.88,39.39999,39.81,3346256,2503269.1,55.721407924765636,49.56902334824155,NaN,NaN,84.74487896997641,11.097433612002174,0.02114066822432984,-0.005099707743717374,-0.026240375968047215,31922079,27266841.6,25.996681134303543,39.20708306033593,NaN,NaN,-0.47379753973361444,-0.6275308604448864
2007-07-06T09:30:00-04:00,39.75,40.7,39.02,40.17,2147616,2433909.9,61.07773794997955,50.07031727087006,NaN,NaN,147.95129164263244,47.89663757926263,0.05954164280057895,0.04818667753267647,-0.01135496526790248,34069695,29367278,34.32505410077785,38.186627425826146,NaN,NaN,2.9165526164088895,-0.12123322089434707
2007-07-09T09:30:00-04:00,40.16,40.19,39.92999,40.02,1458506,2409845.2,57.9330788241512,50.53227720631673,NaN,NaN,149.70478802959664,84.62847757032473,0.07102022988918621,0.0774203220935803,0.006400092204394074,32611189,30786773.2,39.29701909862803,37.31699578200973,NaN,NaN,4.841791807412031,0.5877703545779926
2007-07-10T09:30:00-04:00,39.75,39.78,39.17999,39.31,4505320,2572611.2,45.88949624754708,50.00220678999506,NaN,NaN,-29.404134173217518,79.58599478504696,0.029122898363482724,0.04280371515874748,0.013680816795264755,28105869,31056931,40.224531223515314,36.008104600954375,NaN,NaN,2.6291281938936057,0.8793929030516516
2007-07-11T09:30:00-04:00,39.12,39.55,37.53,39.53999,2505908,2616306.6,49.54830834158436,49.815597868534596,NaN,NaN,-179.66068484446137,34.66722792490532,0.01588849129998977,0.03354143092025197,0.0176529396202622,30611777,31464121.8,41.67116307667429,34.60906032814326,NaN,NaN,2.039980531154353,1.0451911356377517
2007-07-12T09:30:00-04:00,39.62,39.95,39.53999,39.85001,1922960,2642599.7,54.0578772615046,50.03568814575657,NaN,NaN,67.43190639933229,31.204633410776495,0.026384334033116602,0.050633357161657955,0.024249023128541353,32534737,31586653.4,42.125063296137476,33.29939593182646,NaN,NaN,3.056586936829833,1.3325333929509062
2007-07-13T09:30:00-04:00,39.88,40.13,39.84,40.05,1994260,2694842.7,56.74390130078456,50.75072496168674,NaN,NaN,116.05920138889064,24.826215360028137,0.04412163540367733,0.07940106738313801,0.035279431979460686,34528997,31678513.8,42.486400381288,32.5029791065477,NaN,NaN,4.764991217341076,1.8228845107209304
2007-07-16T09:30:00-04:00,40.03999,40.09,39.8,39.89,1037360,2614703.8,54.02263534012623,51.44590824174522,NaN,NaN,93.24765707546243,13.534789169201298,0.04239364118076915,0.08827148345542213,0.045877842274652976,33491637,31854603.4,43.2182483167513,32.24183170957124,NaN,NaN,5.297188329310891,2.319213627662353
2007-07-17T09:30:00-04:00,39.95,39.98,39.85001,39.92999,1772800,2663965.9,54.608560115375774,52.457432629763254,NaN,NaN,85.65538555910005,36.54669311566481,0.04122203200115821,0.09740538227610074,0.05618335027494253,35264437,33286317,48.910558815162005,33.34654219708267,NaN,NaN,5.898511969390634,2.830541962194965
2007-07-18T09:30:00-04:00,39.82001,39.96001,39.55,39.88,1659038,2591291.3,53.68750123407306,52.885916976260965,NaN,NaN,52.670728959472264,83.01297587645155,0.034624305137299194,0.09946373169656653,0.06483942655926733,33605399,33885041.4,51.11748996177459,35.065962536787474,NaN,NaN,6.126611892328237,3.3014090950711465
2007-07-19T09:30:00-04:00,39.92999,40.08,39.88,39.97,1326700,2524651.25,55.1540416445987,53.50609259160928,NaN,NaN,91.792936836106,87.88518196380628,0.033826375537398506,0.10712239598101547,0.07329602044361697,34932099,34364513.8,52.87317711969047,37.24535981101712,NaN,NaN,6.72738283522379,3.7908339150929526
2007-07-20T09:30:00-04:00,39.86,39.98,39.42,39.46001,3505479,2554143.7,46.22204052082314,53.42369560341542,NaN,NaN,6.9541977730520035,66.06418124063855,-0.0016615819762388628,0.07121904297331838,0.07288062494955724,31426620,33744038.4,50.352814536054424,39.4339721435761,NaN,NaN,4.538818619886898,3.8976888729206594
2007-07-23T09:30:00-04:00,39.88,39.88,39.46001,39.52,1673500,2523508.7,47.30312144006149,53.15177359643575,NaN,NaN,4.507231178901704,48.316096061326405,-0.02065366045053077,0.04706354938639379,0.06771720983692456,33100120,33665735,50.02870811157375,41.71781184687493,NaN,NaN,3.0789586067993917,3.780727406331907
2007-07-24T09:30:00-04:00,39.31,39.60001,38.73,38.89999,4702508,2667549.1,38.6543117121281,52.1874299898216,NaN,NaN,-119.86533714507512,7.21195152049137,-0.07165978291073698,-0.021857518801496667,0.04980226410924031,28397612,32292370,44.605655103312984,43.37375459111742,NaN,NaN,-1.1859319226442497,3.071204645049599
2007-07-25T09:30:00-04:00,39.25,39.25,38.56,38.77,4609578,2410524.85,37.1218416816833,50.858889543887145,NaN,NaN,-159.9845078503026,-35.31909584146361,-0.10862260393876214,-0.08597599081421237,0.02264661312454977,23788034,30328897,38.22587590087232,44.247268503015185,NaN,NaN,-5.1169284856446655,1.901471340664704
2007-07-26T09:30:00-04:00,38.23,38.31,37.22,37.63,6843098,2659095.25,27.00884865520399,48.42539745140317,NaN,NaN,-306.85412622513593,-115.04850845371197,-0.1990546092826147,-0.22617164847871862,-0.027117039196103913,16944936,26731464.4,29.812556727549747,43.92494726207032,NaN,NaN,-13.061909963649127,-0.23615455995155754
2007-07-27T09:30:00-04:00,37.56,37.78999,37.03999,37.03999,5860500,2793984.85,23.448415054521647,45.96220718214391,NaN,NaN,-269.8523038940841,-170.4098087871392,-0.28270670569121625,-0.3805004213101242,-0.09779371561890796,11084436,22663027.6,23.510396228713816,42.797331342790734,NaN,NaN,-21.001134740226526,-3.2025802999908386
2007-07-30T09:30:00-04:00,37.14,37.64999,36.94,37.57001,3503352,2871842.45,32.106866777715666,44.97773364858453,NaN,NaN,-193.3986780348414,-209.99099062988785,-0.2856020616319352,-0.45479629265882693,-0.16919423102689174,14587788,18960561.2,19.475540648642195,41.31526058744265,NaN,NaN,-23.99478756064364,-6.172895622941239
2007-07-31T09:30:00-04:00,37.86,38.09,36.98,37,3344171,2976982.65,28.38811258837569,43.46629109478391,NaN,NaN,-157.03325510909238,-217.42457422269126,-0.307279277682205,-0.5532933281296479,-0.24601405044744298,11243617,15529762.2,16.627849063421365,39.52645244363887,NaN,NaN,-27.85099776808878,-9.269767357962316
2007-08-01T09:30:00-04:00,37.00999,37.11,36.42,37.05,5022188,3137054.9,29.16316471029144,41.68809734112583,NaN,NaN,-161.64564525642385,-217.75680170391553,-0.2993243029251569,-0.6201694291038891,-0.3208451261787322,16265805,14025316.4,15.553842163375094,37.628508077012995,NaN,NaN,-30.420169528857404,-12.2912533823759
2007-08-02T09:30:00-04:00,37.25,37.52,37.02,37.52,5359125,3237698.35,36.157815909905665,40.21766267034877,NaN,NaN,-107.66038964742135,-177.9180543883726,-0.24572781852588116,-0.6280048993360836,-0.38227708081020245,21624930,14961315.2,19.05679912484166,35.954965130123966,NaN,NaN,-30.04682124249176,-14.827763076678165
2007-08-03T09:30:00-04:00,37.36,37.42,36.32001,36.37,4768668,3368750.95,28.692339344543925,38.40835581352146,NaN,NaN,-128.31140217874557,-149.6098740453049,-0.269158288362606,-0.71872494126346,-0.44956665290085396,16856262,16115680.4,23.283451954563418,34.5310511042534,NaN,NaN,-32.621559732409864,-17.36973402749698
2007-08-06T09:30:00-04:00,36.49001,36.96001,36.14999,36.95,4904320,3541041.65,35.882621624015144,37.07078877842427,NaN,NaN,-111.23624025596885,-133.1773864895304,-0.22862147231965813,-0.7353434933004266,-0.5067220209807685,21760582,17550239.2,28.29449909169213,33.05847540971984,NaN,NaN,-31.868784612109803,-19.441026968155953
2007-08-07T09:30:00-04:00,36.77,37.38,36.58,37.16,5932301,3612390.7,38.30818853050882,35.9722664424554,NaN,NaN,-80.45335966620803,-117.86140740095352,-0.17320766865222947,-0.7232316067960554,-0.5500239381438259,27692883,20840092.4,38.25505725883942,32.13973021665304,NaN,NaN,-30.41952885394499,-21.00938438041153
2007-08-08T09:30:00-04:00,37.35001,37.71001,37.03999,37.58,6075078,3790849.2,42.95613506725445,35.10098740121652,NaN,NaN,-52.6920566536049,-96.07068968038973,-0.0975776557972532,-0.6719960078903924,-0.5744183520931392,33767961,24340523.6,46.73348285711466,31.70118062646906,NaN,NaN,-27.609597049135342,-21.95227190451493
2007-08-09T09:30:00-04:00,36.91,37.23,36.52,36.52,3978800,3893641.2,35.654931380722076,34.3461938912093,NaN,NaN,-81.53730928875478,-90.84607360865644,-0.10746890815775667,-0.7087544872903351,-0.6012855791325784,29789161,25973369.8,50.17070041030407,31.688172474629745,NaN,NaN,-27.864793175458892,-22.796917800364067
2007-08-10T09:30:00-04:00,36.13,36.71001,35.78,36.36,5509195,4069387.95,34.69630088348292,33.445706708596546,NaN,NaN,-98.9881747831144,-84.9814281295302,-0.11276387612352379,-0.7422404242869831,-0.6294765481634593,24279966,27458110.6,53.132236285794086,31.909853058502627,NaN,NaN,-28.39276959869274,-23.596325200125307
2007-08-13T09:30:00-04:00,36.7,37.2,36.56,36.56,4938898,4264464.85,36.9772909813794,33.32591951354307,NaN,NaN,-67.49508294510925,-76.23319666735829,-0.09166904044738022,-0.7440628487226846,-0.6523938082753044,29218864,28949767,55.96391363189035,32.7211572391153,NaN,NaN,-28.048462309178408,-24.23234478713289
2007-08-14T09:30:00-04:00,36.5,36.5,35.60001,35.63,4751516,4413400.65,31.472352602328655,32.922384579303454,NaN,NaN,-114.23572630289443,-82.98966999469556,-0.12704444107568102,-0.8111993596199056,-0.6841549185442246,24467348,28304660,54.43221548190382,33.87875292347469,NaN,NaN,-29.67318606039917,-25.00960782617093
2007-08-15T09:30:00-04:00,35.47,35.98,35.07001,35.25,4617461,4561321.8,29.537380616094694,33.10299400508136,NaN,NaN,-140.69276306753466,-100.58981127748152,-0.16057057977395073,-0.884868143261663,-0.7242975634877122,19849887,25521045.2,48.29051023218503,35.19860674523435,NaN,NaN,-31.633149690918845,-25.95582809256349
2007-08-16T09:30:00-04:00,34.75999,35.35001,34.24001,35.3,7222281,4856100.85,30.14594729869644,33.581389165379555,NaN,NaN,-166.95156238900788,-117.67266189753214,-0.1633725730577661,-0.9285132798099198,-0.7651407067521537,27072168,24977646.6,47.17156883692367,36.888690502963634,NaN,NaN,-32.959765154751366,-26.9563905300189
2007-08-17T09:30:00-04:00,36.12,36.81,35.25,35.55,5922191,4976936.45,33.25017935476966,33.66305434945484,NaN,NaN,-94.25776413843971,-116.72657976859719,-0.13363449019899076,-0.9321838195008922,-0.7985493293019015,32994359,26720525.2,51.08636196909095,39.146606311567105,NaN,NaN,-33.091660488870275,-27.83285766699767
2007-08-20T09:30:00-04:00,35.87,36.0199,35.56,35.74001,5927125,5189617.7,35.592884097468286,34.177680885818596,NaN,NaN,-96.38843816857828,-122.50525081329098,-0.0885836790811576,-0.9092789281533484,-0.8206952490721908,38921484,28661049.2,55.07787845146519,41.893036982141666,NaN,NaN,-32.501915622864054,-28.49986594640715
2007-08-21T09:30:00-04:00,35.74001,36.14999,35.64999,35.98,2839594,5096472,38.527489899078304,34.84656125644623,NaN,NaN,-76.32066348249224,-114.92223824921057,-0.032905277548261,-0.8618268460075171,-0.8289215684592561,41761078,32119795.2,61.16140983932152,45.150720387566416,NaN,NaN,-31.14909629478349,-28.87832742474663
2007-08-22T09:30:00-04:00,36.38,36.58,36.2,36.46001,4135500,5072768.1,44.02137956903358,35.408244374955366,NaN,NaN,-19.75377348396795,-90.73444033249721,0.04190805140670917,-0.7765365042008696,-0.8184445556075788,45896578,37329133.4,68.15612418406026,48.65781503465346,NaN,NaN,-28.315749648635236,-28.79795917101643
2007-08-23T09:30:00-04:00,36.71001,36.8,36.28,36.32001,1897600,4825493.2,42.819386775472,36.41731919145023,NaN,NaN,-7.836287908512869,-58.91138543639821,0.08512983716783096,-0.7120322591477901,-0.7971620963156211,43998978,40714495.4,71.72051464710245,52.11760522697767,NaN,NaN,-26.323034589614164,-28.44439851653039
2007-08-24T09:30:00-04:00,36.46001,37.05,36.42999,37.05,2763200,4670628.2,50.421057186187426,37.45577887446253,NaN,NaN,39.64013094635269,-32.13180641943973,0.1616115994805658,-0.5951475969649138,-0.7567591964454796,46762178,43468059.2,74.24564997066298,55.399830289761304,NaN,NaN,-22.144936713660446,-27.544475401834685
2007-08-27T09:30:00-04:00,36.86,36.92999,36.52,36.53999,1829800,4586950.6,45.836300915068165,37.99350118764534,NaN,NaN,23.814837512107566,-8.091151283302567,0.17542852172268264,-0.5374735442921263,-0.712902066014809,44932378,44670238,75.28332601250858,58.0447066293091,NaN,NaN,-19.966485557631817,-26.46190542409142
2007-08-28T09:30:00-04:00,36.42999,36.49001,35.66,35.66,2629900,4551237.05,39.211126005141125,37.726000540351535,NaN,NaN,-60.70359768148801,-4.967738123101728,0.12523293398711788,-0.5563608985309116,-0.6815938325180295,42302478,44778518,75.3795472849095,60.090854088437304,NaN,NaN,-20.213341413777425,-25.56925342261799
2007-08-29T09:30:00-04:00,35.89999,36.8,35.82001,36.78,1873000,4393777.65,49.26281656263662,38.697992339059724,NaN,NaN,10.875404258788405,1.1580974254495433,0.16489613904942968,-0.4754736587062425,-0.6403697977556722,44175478,44434298,74.38812829271406,61.8206703657523,NaN,NaN,-16.819203468345513,-24.31924628629335
2007-08-30T09:30:00-04:00,36.37,36.78,36.3,36.63,1729500,4212296.4,48.11530731242992,39.65649279827022,NaN,NaN,31.93514868062322,9.112384743276756,0.1773776191292521,-0.418647773844107,-0.5960253929733591,42445978,44123698,73.44939554179226,63.27189602689503,NaN,NaN,-14.591900691343715,-22.92962548701483
2007-08-31T09:30:00-04:00,36.94,37.34,36.77,37.23,3226700,4135198,52.846746820390976,40.790025358199614,NaN,NaN,102.917430218961,21.76784459779842,0.2196267891665623,-0.32149190651515624,-0.5411186956817186,45672678,43905798,72.75573651492755,64.47131194711197,NaN,NaN,-11.131108473641293,-21.2441230565329
2007-09-04T09:30:00-04:00,37.03,37.3,36.91,37.28,3019300,4040947,53.229509341576914,42.34410798243164,NaN,NaN,102.48410415132146,37.501697925641196,0.2427187102882848,-0.23772030782136255,-0.48043901810964734,48691978,44657718,73.67947996432301,65.84611655299906,NaN,NaN,-8.315110173989066,-19.397121216169495
2007-09-05T09:30:00-04:00,36.78,36.89,36.53,36.69,4362898,3962476.85,48.252128081067696,43.68087565850114,NaN,NaN,44.91985641125017,58.62638874418883,0.21119621238351394,-0.21644375263025495,-0.4276399650137689,44329080,45063038.4,74.18754249057262,67.69590457145532,NaN,NaN,-7.484231149219221,-17.695279778033743
2007-09-06T09:30:00-04:00,36.82001,36.92999,36.53999,36.78,1725600,3745002.95,49.03500876965888,45.03009433499845,NaN,NaN,59.366437522633646,68.32459539695787,0.19000956862607365,-0.19012800423117682,-0.38013757285725047,46054680,45438878.8,74.6756888127559,69.66048456972905,NaN,NaN,-6.585029486248145,-16.108101164921514
2007-09-07T09:30:00-04:00,36.22,36.24001,35.87,35.89999,8882531,3990189.5,42.29685465447488,45.67628542783454,NaN,NaN,-43.075807297209835,53.32240420139127,0.11407503456279039,-0.2375437796537625,-0.3516188142165529,37172149,44384113,70.6383211716697,71.05705308419896,NaN,NaN,-7.944245963234306,-14.941836136109057
2007-09-10T09:30:00-04:00,36.09,36.16,35.53999,35.71001,5972500,4013354.75,40.9874013192887,46.061608086536,NaN,NaN,-64.80693040517993,19.777532076563084,0.05158229973548234,-0.2871409395472,-0.33872323928268233,31199649,41489507.2,60.90637140054528,71.47337400913325,NaN,NaN,-9.44746920460688,-14.156926574465889
2007-09-11T09:30:00-04:00,35.86,36.24001,35.85001,36.11,3243000,3928559.85,44.85810207363493,46.5137946704329,NaN,NaN,-24.693738478584788,-5.658036449418164,0.03832353730973914,-0.29081881764550843,-0.3291423549552476,34442649,38639641.4,53.14339212787118,70.90065845831536,NaN,NaN,-9.536612442406991,-13.496881698457475
2007-09-12T09:30:00-04:00,36.07001,36.31,36.05,36.13,1174900,3749729.05,45.0521731985914,46.58742278682989,NaN,NaN,-13.217375909743401,-17.285482913616878,0.03228130003251062,-0.2887907299146093,-0.3210720299471199,35617549,36897335.2,49.02901913207498,69.53443666888784,NaN,NaN,-9.552319449516812,-12.933372805751667
2007-09-13T09:30:00-04:00,36.45,36.8399,36.27,36.63,2811100,3659411,49.80812380427977,47.086618288887585,NaN,NaN,41.532873955651326,-20.852195627013337,0.06163788799331832,-0.244024669955472,-0.3056625579487903,38428649,35372129,45.693971372404135,67.67539786355225,NaN,NaN,-8.16589877968904,-12.25230508774272
2007-09-14T09:30:00-04:00,36.44,36.87,36.24001,36.87,3993240,3497958.95,51.95762269458535,47.196372968058874,NaN,NaN,48.31523224457663,-2.5739877186560407,0.09490977516635807,-0.18702533899084273,-0.2819351141572008,42421889,36422077,48.30105204612636,65.82221229751391,NaN,NaN,-6.3802309287446235,-11.413437350742992
2007-09-17T09:30:00-04:00,36.50999,36.63,36.38,36.42,1545300,3279114.4,47.822205300547594,47.3382232813074,NaN,NaN,9.908566131379692,12.369111588655883,0.08464102211880864,-0.17613383650868997,-0.2607748586274986,40876589,38357465,52.79926606139939,64.21620801529183,NaN,NaN,-6.037368121671804,-10.645427460875679
2007-09-18T09:30:00-04:00,36.7,37.84,36.59,37.84,4447398,3205128.05,58.93055264444289,48.74675375554324,NaN,NaN,180.56847014120765,53.42155331261438,0.1667662616349383,-0.052317031583825724,-0.21908329321876402,45323987,40533732.6,57.29842409079696,62.92469921571236,NaN,NaN,-1.9307491983891603,-9.400473423377605
2007-09-19T09:30:00-04:00,38.02,39.09,37.69099,37.91,5476367,3336966.7,59.38953508600994,49.47009079292705,NaN,NaN,272.5765671179186,110.58034191814677,0.2159631847624707,0.05087068773432435,-0.16509249702814635,50800354,43570293.6,62.64833832788611,62.08614278965323,NaN,NaN,1.415972867026352,-7.855266810462754
2007-09-20T09:30:00-04:00,37.81,37.81,37.1595,37.16,2970200,3278701.7,52.605940164482945,49.79085028235941,NaN,NaN,111.15131310418515,124.50402974785354,0.18911958498731435,0.07130698420599657,-0.11781260078131776,47830154,45450594.6,65.52835484242465,61.52035416826982,NaN,NaN,2.1114589365549272,-6.431448846603085
2007-09-21T09:30:00-04:00,37.5,37.5,37.06,37.10001,2361000,3301871.7,52.09339174627388,49.73703920563675,NaN,NaN,76.56616540053808,130.15421637904583,0.15962622888531322,0.08172018532532377,-0.07790604355998945,45469154,46060047.6,66.43181789981558,61.06864569576182,NaN,NaN,2.501261020052119,-5.155347437080913
2007-09-24T09:30:00-04:00,37.17999,37.25999,36.78999,36.78999,2835800,3305501.7,49.41394475488379,49.464498878015824,NaN,NaN,34.21970367148558,135.01644388706703,0.1136979963652646,0.06421645189659131,-0.0494815444686733,42633354,46411400.6,66.96928817630987,60.58934628233232,NaN,NaN,2.0138148693584257,-4.131181393303865
2007-09-25T09:30:00-04:00,36.5,36.5,36.09,36.31,8385086,3633266,45.51088685156926,49.26869593305165,NaN,NaN,-57.04161697124373,87.49442646457673,0.04877010649280779,0.011481088647336435,-0.03728901784547135,34248268,44196256.8,60.40288897866392,59.60472817433884,NaN,NaN,0.39786157493130514,-3.484175254984555
2007-09-26T09:30:00-04:00,36.57001,37.69,36.31,36.83,6648801,3834211.05,50.10855274641951,49.34537764567741,NaN,NaN,29.363019130933786,38.851716867179775,0.03904309545490402,0.011514851473158672,-0.027528243981745346,40897069,42215599.8,55.19191292182789,58.21302989641542,NaN,NaN,0.4175400395828486,-2.92678735576064
2007-09-27T09:30:00-04:00,36.86,36.86,36.64999,36.64999,3110300,3896076.05,48.580400133690205,49.794202322764214,NaN,NaN,-6.261091700072134,15.369235906328319,0.019662841882350866,-0.002949691628806761,-0.022612533511157627,37786769,40206922.8,50.43946511103405,56.77025446351286,NaN,NaN,-0.02244885440251951,-2.5118818555666227
2007-09-28T09:30:00-04:00,36.71001,36.83,36.57001,36.83,2483500,3933776.05,50.21546142988521,50.45334947352111,NaN,NaN,-4.0672889879224785,-0.7574549713637845,0.01817888755368819,0.00011107593095260881,-0.01806781162273558,40270269,39167145.8,48.12918215244893,55.85759808864884,NaN,NaN,0.08245592261758788,-2.1412621729688786
2007-10-01T09:30:00-04:00,36.85001,37.31,36.85001,37.31,3125131,3928697.6,54.381081170379225,51.1335622661457,NaN,NaN,59.88088404877114,4.37478110409333,0.04709300582690053,0.04079844566089008,-0.006294560166010448,43395400,39319555,48.50152646014359,55.526036255239724,NaN,NaN,1.398377132113376,-1.635599415099985
2007-10-02T09:30:00-04:00,37.28,37.44,37.24001,37.3,4551766,4005320.9,54.27918405419681,51.79263447011751,NaN,NaN,83.14074309610143,32.41125311756237,0.06216633148338137,0.07141335418821626,0.009247022704834894,38843634,40238628.2,50.795306435255725,55.652199634038354,NaN,NaN,2.438689880052554,-1.053558087221051
2007-10-03T09:30:00-04:00,37.23,37.67999,37.2,37.50999,7523602,4163356.1,56.13779221706095,52.24475364245903,NaN,NaN,91.04421030451053,44.74749135227771,0.08167190604884153,0.1113369052658868,0.029664999217045275,46367236,41332661.6,53.45305414664441,56.20641983219837,NaN,NaN,3.8371448955067478,-0.3548862325456512
2007-10-04T09:30:00-04:00,37.57001,37.57001,37.28,37.32001,4014600,4277806.1,53.99907132460409,52.39057140174607,NaN,NaN,72.33237741672058,60.46618517563625,0.07722171612179679,0.12619214436929127,0.04897042824749448,42352636,42245835,55.60839245763398,56.72837271873463,NaN,NaN,4.453000036793011,0.33195466307415755
2007-10-05T09:30:00-04:00,37.57001,38.14999,37.55,38.14999,5871500,4127254.55,60.991150702760116,53.33121035904697,NaN,NaN,133.36416395156667,87.95247576353408,0.12290526389677336,0.20260200811846119,0.07969674422168782,48224136,43836608.4,59.15642622943773,57.18245558788022,NaN,NaN,7.121908125960272,1.3019480149150309
2007-10-08T09:30:00-04:00,37.96001,37.96001,37.72,37.89999,2750900,3966174.55,58.12524679129534,53.27368851239357,NaN,NaN,110.26108905758569,98.02851676529698,0.12841493362123318,0.24021541124822932,0.11180047762699613,45473236,44252175.6,60.0546220552568,57.37932687105592,NaN,NaN,8.525160072557334,2.3338354517210744
2007-10-09T09:30:00-04:00,37.87,37.97,37.61,37.96001,3549300,3981489.55,58.62787092180875,53.21928392923635,NaN,NaN,100.05516839672177,101.41140182542105,0.12794763741708565,0.2717350243983532,0.14378738698126753,49022536,46287956,64.2071959541249,57.490673844358696,NaN,NaN,9.817345924173322,3.40290837635711
2007-10-10T09:30:00-04:00,37.89999,37.98,37.73,37.8,2151781,4030333.6,56.67480489535459,53.50991712429861,NaN,NaN,91.42487824363472,101.4875354132459,0.10942517208452968,0.2805688520869296,0.17114368000239993,46870755,46388659.8,64.40432367357162,57.41038590372634,NaN,NaN,10.374844202402574,4.398899208649319
2007-10-11T09:30:00-04:00,37.91,38.25,37.53999,37.63,5417012,4160629.2,54.593940754361725,53.68852776773345,NaN,NaN,79.43379334889306,102.9078185996804,0.07967011420553977,0.27073132275932466,0.1910612085537849,41453743,46208881.2,63.72953229561673,57.21736550342642,NaN,NaN,10.286326742508908,5.239960284914975
2007-10-12T09:30:00-04:00,37.75,37.98,37.64999,37.82001,3147181,4118326.25,56.51569752747527,54.19579582291856,NaN,NaN,74.65371055493227,91.16572792035352,0.06722790707695939,0.2750960923999841,0.20786818532302473,44600924,45484238.8,60.95717156120225,56.787928602347314,NaN,NaN,10.723087232241017,6.023264134532981
2007-10-15T09:30:00-04:00,37,37.89999,37,37.22,2946500,4188386.25,49.404856563278095,54.473936516612056,NaN,NaN,-2.3373178446260225,68.64604653991117,0.015718843682263034,0.22751673992585353,0.2117978962435905,41654424,44720476.4,58.08889301722692,56.62264317653038,NaN,NaN,9.069538638221035,6.458446206488418
2007-10-16T09:30:00-04:00,37.2,37.33,37.02,37.10001,3350100,4133521.35,48.10144594909497,54.330571745374584,NaN,NaN,-38.597613443668095,40.915490171833184,-0.02697844959000284,0.17807483425608694,0.20505328384608978,38304324,42576834,50.855920950536635,56.31292946429529,NaN,NaN,7.320045853917652,6.58153187040688
2007-10-17T09:30:00-04:00,37.33,37.41,36.69,37.14,4909801,4105193.05,48.588262045958636,54.33113331053661,NaN,NaN,-43.84749572878129,13.86101537734998,-0.05164339419327932,0.14049904110449063,0.19214243529776995,43214125,41845508,48.63116822045399,56.18376540068243,NaN,NaN,5.995535406146101,6.497818089798197
2007-10-18T09:30:00-04:00,36.78,37,36.50999,36.8,4985102,4205938.15,44.74527394722042,53.94040563320341,NaN,NaN,-89.87830133798496,-20.001403560025626,-0.0878454031748121,0.08233568132925484,0.17018108450406694,38229023,41200564,46.69130154773511,56.08105964320288,NaN,NaN,3.7433544037641235,6.104323277507615
2007-10-19T09:30:00-04:00,36.75999,37.09,35.98,35.98,7572699,4466523.1,37.11985711131289,52.70746105755581,NaN,NaN,-139.67862396711251,-62.867870464434574,-0.15981311265610548,-0.02958530631606493,0.13022780634004055,30656324,38411644,39.37663528454891,55.42928170208897,NaN,NaN,-0.8078510653182809,5.116869799961059
2007-10-22T09:30:00-04:00,35.81,36.44,35.22,36.3,3132500,4481358.1,41.322376656495216,51.78197481486284,NaN,NaN,-169.91676868480465,-96.38376063247031,-0.17730902089912415,-0.09140846978386463,0.08590055111525952,33788824,36838524,35.95503890443567,54.369262592744676,NaN,NaN,-3.373968268786572,3.9038929329971115
2007-10-23T09:30:00-04:00,36.67,36.67,36.13,36.47,5237609,4323984.25,43.48338282966181,50.878088430048614,NaN,NaN,-110.74658398472077,-110.81355474068084,-0.16891442144752827,-0.1252424756941508,0.04367194575337745,39026433,36982945.8,36.50056511201677,53.15837051884271,NaN,NaN,-4.849519865665629,2.653405390331006
2007-10-24T09:30:00-04:00,36.3,36.49001,35.82001,36.35001,6174801,4300284.25,42.29925914275421,50.042387559916484,NaN,NaN,-124.92442611346914,-127.02894081761842,-0.16285370632623125,-0.15989518715441164,0.0029585191718196208,32851632,34910447.2,32.25466852789134,51.49024738100395,NaN,NaN,-6.412383463473727,1.35829269693033
2007-10-25T09:30:00-04:00,36.37,36.58,35.8,36.13,4512699,4370404.2,40.14080948929752,48.553077473240585,NaN,NaN,-120.49414799143204,-133.15211014830783,-0.1645854035862327,-0.20277323531097124,-0.03818783172473855,28338933,32932429.2,28.810096904194907,49.322652429200886,NaN,NaN,-8.364481446841983,-0.03067503789428616
2007-10-26T09:30:00-04:00,36.32001,36.55,36.02,36.55,3558789,4424168.65,45.82418282860578,47.674430047334184,NaN,NaN,-89.1218604468441,-123.04075744425413,-0.1298913890839423,-0.2005520680796664,-0.07066067899572412,31897722,33180708.8,29.823149493473466,47.163261531930644,NaN,NaN,-8.419266578634046,-1.2290452579999662
2007-10-29T09:30:00-04:00,36.5,36.67999,36.44,36.64999,2178400,4376832.1,47.111624422001945,46.85184101163369,NaN,NaN,-56.991385174513,-100.45568074219582,-0.09431140354993606,-0.1885499334331442,-0.09423852988320813,34076122,33238168.4,30.071163459037024,44.72497349656722,NaN,NaN,-8.095734060436124,-2.2100008012051315
2007-10-30T09:30:00-04:00,36.52,36.69,36.49001,36.53999,1960700,4247278.8,45.821556135457605,46.07660895735534,NaN,NaN,-53.0691792286146,-88.92019979097458,-0.07322738663134354,-0.18577276317238756,-0.11254537654104402,32115422,31855966.2,27.54895457631399,42.092447132477396,NaN,NaN,-8.180737152833697,-3.062963137152069
2007-10-31T09:30:00-04:00,36.64,36.86,36.32001,36.64999,3704848,4056341.1,47.37349230376513,45.56086263945558,NaN,NaN,-44.155364886057505,-72.76638754549226,-0.048127634947472936,-0.1727049202253852,-0.12457728527791226,35820270,32449693.8,30.255054926987498,39.701413034718165,NaN,NaN,-7.830231457278278,-3.7440014685986704
2007-11-01T09:30:00-04:00,36.45,36.50999,35.72,35.72,3747000,4042961.1,37.57397388002668,44.207882378923536,NaN,NaN,-101.50313008529609,-68.96818396426508,-0.0880867085475498,-0.2346856709623495,-0.1465989624147997,32073270,33196561.2,33.614101515181645,37.748336602859546,NaN,NaN,-10.5648320578597,-4.718405838493103
2007-11-02T09:30:00-04:00,36.37,36.37,35.41,35.7,4368703,3967821.25,37.39482371076845,43.35002288945856,NaN,NaN,-109.7050595167305,-73.08482377824235,-0.10845446944502418,-0.28216704922107994,-0.17371257977605575,27704567,32357930.2,31.764181095574813,35.86800003702725,NaN,NaN,-12.798368462560589,-5.872686213359887
2007-11-05T09:30:00-05:00,35.48,35.62,35.11,35.22,3868125,4023682.5,33.292142574030635,42.2922155055254,NaN,NaN,-153.28994184181465,-92.34453511170267,-0.1445839990871114,-0.354442578634945,-0.2098585795478336,23836442,30309994.2,27.748160846584938,34.21744574388784,NaN,NaN,-16.060527579793863,-7.328092122850455
2007-11-06T09:30:00-05:00,35.09,35.56,35.08,35.53,2390506,3965742.8,38.02150341991855,41.53744703223681,NaN,NaN,-137.23141245173252,-109.17698175632624,-0.13795323978085375,-0.3823001292739008,-0.24434688949304703,26226948,29132299.4,25.733258194622934,32.58188074204277,NaN,NaN,-17.365289362778718,-8.761977442840207
2007-11-07T09:30:00-05:00,35.08,35.45,34.75,34.8,5204480,4118377.75,32.22728311531813,40.64330482995808,NaN,NaN,-165.41810704186426,-133.42953018748761,-0.17092470215771227,-0.4580027671901874,-0.2870780650324751,21022468,26172739,21.506814496744624,30.78298880982916,NaN,NaN,-20.486895685117247,-10.436965763165498
2007-11-08T09:30:00-05:00,35,35.2,34.16,34.7,5712785,4133166.4,31.518691959793586,40.243221604849566,NaN,NaN,-178.1161384041844,-148.75213185126526,-0.18639495114660998,-0.5200717539657376,-0.3336768028191276,15309683,22820021.6,17.91680703791843,29.250143935069843,NaN,NaN,-23.185856705881715,-12.258235897839242
2007-11-09T09:30:00-05:00,33.82001,34.42,33.82001,33.91,4742336,4212924.15,26.551866839499283,39.18818518934985,NaN,NaN,-208.9200871281704,-168.59513737355323,-0.23369415886011186,-0.6257945013942674,-0.39210034253415554,10567347,19392577.6,15.135363652880642,27.763024274244486,NaN,NaN,-27.338315246948753,-14.412532947712029
2007-11-12T09:30:00-05:00,33.91,34.53,33.64999,33.96001,3513603,4241279.3,27.332532639777313,38.03455303292953,NaN,NaN,-174.55726374939576,-172.84860175506947,-0.24432352660322842,-0.6975047507881911,-0.45318122418496265,14080950,17441479.2,13.820095953060417,26.14299076289046,NaN,NaN,-30.3246899859121,-16.685698238883468
2007-11-13T09:30:00-05:00,34.61,34.95,34.17,34.89999,3385990,4243073.8,40.19851137370978,37.88449962085493,NaN,NaN,-100.96897932153897,-165.59611512903075,-0.17405907103796797,-0.6707550629824226,-0.49669599194445463,17466940,15689477.6,12.748751876901409,24.749711002105467,NaN,NaN,-28.56984812893501,-18.38343393746226
2007-11-14T09:30:00-05:00,34.95,35.07001,34.17999,34.35001,3927878,4193977.65,36.16398923310038,37.60044103112656,NaN,NaN,-98.74389979476442,-152.26127367961078,-0.1514643636143843,-0.686026446462435,-0.5345620828480507,13539062,14192796.4,11.900066369173231,23.541851678175345,NaN,NaN,-28.5146697855027,-19.83075334432518
2007-11-15T09:30:00-05:00,34.05,34.41,33.88,34.02,2902808,4089862.95,33.96140432297497,36.75309970929579,NaN,NaN,-118.56606583812946,-140.35125916639979,-0.1455493932759031,-0.7164988244429296,-0.5709494311670265,10636254,13258110.6,11.390115574369744,22.22520639823936,NaN,NaN,-29.21631007060796,-21.171547162365577
2007-11-16T09:30:00-05:00,34.5,34.5,33.69,34.00999,5589223,3990689.15,33.89397163825575,35.80898165331392,NaN,NaN,-107.71686073284522,-120.11061388733476,-0.12964564259079037,-0.7330064844055144,-0.603360841814724,5047031,12154047.4,10.801314653976604,20.848788626449334,NaN,NaN,-29.7797966884392,-22.40129709466181
2007-11-19T09:30:00-05:00,33.69,33.92999,33.17,33.25999,5275762,4097852.25,29.213586816696576,34.62269813054528,NaN,NaN,-135.21335619498754,-112.24183237645312,-0.15524376319420052,-0.7974155458074748,-0.6421717826132742,-228731,9292111.2,9.439165549246212,19.555232267373068,NaN,NaN,-31.84013763226035,-23.749702885747315
2007-11-20T09:30:00-05:00,33.58,33.67999,32.73,33.28999,3546019,4013272.75,29.632166318214686,33.35546056014881,NaN,NaN,-132.70887466698414,-118.58981144554214,-0.15538094719879658,-0.83639796661177,-0.6810170194129734,3317288,6462180.8,8.321640035068626,17.988559775093147,NaN,NaN,-33.31759932002687,-25.116545233501537
2007-11-21T09:30:00-05:00,32.84,33.3,32.7,32.97,3501671,3879616.25,27.747429797381898,32.65356455424562,NaN,NaN,-132.92205374416923,-125.42544223542313,-0.1615339175419107,-0.8829344163403618,-0.7214004987984511,-184383,3717491.8,7.405840780475202,16.116541151185547,NaN,NaN,-35.13744487867319,-26.548102325668918
2007-11-23T09:30:00-05:00,33.47,33.55,33.12,33.55,1623543,3735158.45,35.72720570567735,32.5344489824534,NaN,NaN,-95.38324129566813,-120.78887732693086,-0.11333148961187578,-0.8630648608132958,-0.74973337120142,1439160,1878073,6.8609054606886986,14.33773574869368,NaN,NaN,-34.1756134352089,-27.637746769888917
2007-11-26T09:30:00-05:00,33.85001,33.85001,32.67999,32.67999,8446773,3979557.65,30.318154519928285,32.32202126430323,NaN,NaN,-108.92211123778182,-121.02992742791817,-0.12586494732894005,-0.9070645553625951,-0.7811996080336551,-7007613,-532855.8,6.21536203220036,12.799678690523356,NaN,NaN,-35.14515514308201,-28.710233680345073
2007-11-27T09:30:00-05:00,32.63,33.33,32.63,33.2,3635542,4052414.75,36.505836450113854,32.21375933788861,NaN,NaN,-101.11561986358379,-114.2103801616374,-0.0868147562212338,-0.8897180533101974,-0.8029032970889636,-3372071,-1161523.8,6.05536712410192,11.394115042628997,NaN,NaN,-33.82706875946296,-29.441210120219058
2007-11-28T09:30:00-05:00,33.5,34.49001,33.5,34.49001,3969408,4152850.15,48.68049660647943,33.38898887297155,NaN,NaN,-17.30871145044152,-91.13034751832888,0.03185746061310213,-0.763081471322586,-0.7949389319356881,597337,-1705514,5.913513725762826,10.280307844701724,NaN,NaN,-28.012494950457995,-29.237107953110336
2007-11-29T09:30:00-05:00,34.08,34.60001,33.92,34.14999,3003485,4117782,46.16769993040843,34.435346585158335,NaN,NaN,-3.6512389210050493,-65.27618455369605,0.09011691078537054,-0.6822927934539749,-0.7724097042393454,-2406148,-2149867,5.794112734899457,9.414401108771798,NaN,NaN,-24.400772618386636,-28.546202905292663
2007-11-30T09:30:00-05:00,34.84,35.14,34.60001,34.64999,3491600,4105012,50.235609266514665,36.12704247280228,NaN,NaN,59.76873368573212,-34.24578955741602,0.16085947184809135,-0.5713353644292312,-0.7321948362773225,1085452,-2220608.6,5.7741242493007405,8.745741151373235,NaN,NaN,-20.055829839744824,-27.333292467357257
2007-12-03T09:30:00-05:00,34.87,34.91,34.47,34.47,2419839,4007568.8,48.80584889426158,37.66085077669402,NaN,NaN,52.91207612025019,-1.8789520858096125,0.19195575853721025,-0.49225013810580975,-0.68420589664302,-1334387,-1085963.4,11.073146716975586,8.549530491652892,NaN,NaN,-17.129497938038508,-25.875607534597435
2007-12-04T09:30:00-05:00,34.55,34.58,34.23,34.36,2987975,3963561.3,47.908435469458794,38.21155964067609,NaN,NaN,35.46591408004368,25.43735470291589,0.2006015020807398,-0.43345401904209524,-0.634055521122835,-4322362,-1276021.6,10.9619417251958,8.42190119510249,NaN,NaN,-15.090616674786842,-24.334894554624494
2007-12-05T09:30:00-05:00,34.55,34.59,34.13,34.31,3764770,4032274.5,47.48106633092056,39.01992229052039,NaN,NaN,39.30989585133825,36.76107616327183,0.198094304385253,-0.38643764064126884,-0.5845319450265218,-8087132,-3012915.4,9.97593851626641,8.284463491323432,NaN,NaN,-13.581632768833614,-22.798714299511513
2007-12-06T09:30:00-05:00,34.50999,34.81,34.10001,34.61,2617356,3902918.3,50.34329919706836,40.19005763866993,NaN,NaN,65.99772294875721,50.69086853722429,0.21061277598179995,-0.3212659750492719,-0.5318787510310719,-5469776,-3625641,9.646306534013249,8.159905702726542,NaN,NaN,-11.46721523371794,-21.17992871868386
2007-12-07T09:30:00-05:00,34.75999,35,34.75,34.89999,4098848,3822221.45,53.009225376455916,41.55543290568421,NaN,NaN,114.38715215326837,61.61455223073153,0.23077396309426418,-0.2434112971632416,-0.4741852602575058,-1370928,-4116917,9.378720539014395,8.058291837372098,NaN,NaN,-8.897664995917788,-19.425319615431565
2007-12-10T09:30:00-05:00,34.74001,35.00999,34.67999,34.92,1758616,3673035.45,53.19595036399705,43.26845887334854,NaN,NaN,101.49803180497516,71.33174336767652,0.2369131000647252,-0.1780438851765993,-0.4149569852413245,387688,-3772502,11.237689389319044,8.18675782594873,NaN,NaN,-6.744312453720926,-17.613747163758617
2007-12-11T09:30:00-05:00,34.92,35.11,33.8,33.8,4420750,3718392.8,42.91650277105095,44.21734004855113,NaN,NaN,19.680196956973923,68.17459994306259,0.16064891614758448,-0.2141458400568439,-0.37479475620442837,-4033062,-3714642,11.565892561954058,8.41849014929769,NaN,NaN,-7.847101294784816,-16.218512039619505
2007-12-12T09:30:00-05:00,34.36,34.73,33.52,33.91,3582450,3728215.8,44.05983976683904,45.38251218922664,NaN,NaN,0.5021488938596514,60.413050551566855,0.11486339677712032,-0.231215510233028,-0.3460789070101483,-450612,-2187338,19.97713262212949,9.31643956655871,NaN,NaN,-8.396776629486169,-15.101121266743315
2007-12-13T09:30:00-05:00,33.47,33.97,33.42,33.69,3463042,3704974,42.23771231567248,45.84754837565486,NaN,NaN,-40.64888594634492,39.083728772546436,0.06925984048148387,-0.25950410640829347,-0.32876394688977734,-3913654,-1876113.6,21.61325466743898,10.3701787956123,NaN,NaN,-9.391214160170962,-14.285420251518692
2007-12-14T09:30:00-05:00,34.19,34.19,33.25,33.25,1906080,3655137.6,38.783145870445466,46.45219061497752,NaN,NaN,-51.68690307730403,5.868917726431955,0.011963205667090693,-0.313809939805914,-0.3257731454730047,-5819734,-2765874.8,20.333301730421,11.378603059770919,NaN,NaN,-11.29131256707887,-13.857690582313003
2007-12-17T09:30:00-05:00,33.28999,33.36,32.94,32.94,2971622,3524257.55,36.51702902146442,46.452990084359705,NaN,NaN,-97.21206026525459,-33.873100687614,-0.041389810224441326,-0.3775104082535563,-0.336120598029115,-8791356,-4601683.6,17.968838796580158,12.229565322090792,NaN,NaN,-13.579566755427527,-13.81795860704365
2007-12-18T09:30:00-05:00,33.02,33.39,32.84,33.25,3889703,3454954.6,40.27521725241569,45.85261298764086,NaN,NaN,-84.07644204043783,-54.62442848709634,-0.049812901604250004,-0.3983867250344275,-0.3485738234301775,-4901653,-4775401.8,17.75839751642124,13.075628449994964,NaN,NaN,-14.429722226638692,-13.905353409842942
2007-12-19T09:30:00-05:00,33.07001,33.28999,32.84,32.95,3131665,3434236.9,37.93474905349649,45.264545067861434,NaN,NaN,-95.92915467942535,-73.91068920175334,-0.06844847561867617,-0.4341344179535227,-0.3656859423348465,-8033318,-6291943,15.997052377064051,13.804409853006721,NaN,NaN,-15.840600758385948,-14.181817316777657
2007-12-20T09:30:00-05:00,32.95,33.17999,32.74001,33.11,2352319,3376769.3,39.93939627976125,44.52910128309333,NaN,NaN,-98.0321571455149,-85.38734344158733,-0.0629959950383886,-0.44443093613283224,-0.38143494109444365,-5680999,-6645412,15.60847023871409,14.506863137964817,NaN,NaN,-16.450566498875297,-14.505924342791605
2007-12-21T09:30:00-05:00,33.09,33.28999,32.94,32.94,5048750,3548029.65,38.51594179343444,43.79410791874854,NaN,NaN,-88.23707487712048,-92.69737780155063,-0.06364766498747099,-0.46099452232878235,-0.39734685734131137,-10729749,-7627415,14.550968853606847,14.755279004867049,NaN,NaN,-17.36296403701641,-14.914072870538005
2007-12-24T09:30:00-05:00,33.33,33.60001,33.33,33.55,1202233,3185802.65,45.958693434990494,43.65484063057223,NaN,NaN,-45.92287900036641,-82.43954154857299,-0.018168292934865438,-0.42005722350989316,-0.4018889305750277,-9527516,-7774647,14.393512039453768,15.00039117017119,NaN,NaN,-15.997847557827038,-15.06889782586501
2007-12-26T09:30:00-05:00,33.23,33.45,33.19,33.44,1829309,3095491,44.90310432261839,43.47070048712208,NaN,NaN,-64.0586455280987,-78.43598224610517,0.007933709969445257,-0.39197179311322117,-0.3999055030826664,-11356825,-9065681.4,13.059063393988623,15.220614375722777,NaN,NaN,-15.170978727411036,-15.083480811800156
2007-12-27T09:30:00-05:00,33.14,33.32001,32.96001,32.97,2663302,3030185.7,40.61108492095984,42.775542324542904,NaN,NaN,-84.88367975193708,-76.22688726060751,-0.002470398334325219,-0.40299350100057296,-0.40052310266624774,-14020127,-10263043.2,11.952290539214943,15.38532751895147,NaN,NaN,-15.699768691894109,-15.171521937527864
2007-12-28T09:30:00-05:00,33.28999,33.28999,32.82001,32.82001,659632,2912993.05,39.31944396260056,41.7977007949818,NaN,NaN,-86.71497056708598,-73.96344994492173,-0.014782508217366042,-0.4190012379379553,-0.40421872972058925,-14679759,-12062795.2,10.510384319846409,15.466160646153755,NaN,NaN,-16.51110057254331,-15.362890313958642
2007-12-31T09:30:00-05:00,32.48,33.02,32.48,32.7,3205487,2898687.4,38.270620170977125,40.731605781194666,NaN,NaN,-103.91770273025446,-77.09957551554854,-0.025698149493616096,-0.4363414165876094,-0.4106432670939933,-17885246,-13493894.6,9.526259675646486,15.343915666605714,NaN,NaN,-17.482682173790735,-15.665717722506084
2008-01-02T09:30:00-05:00,32.99001,32.99001,32.11,32.2,3901000,2972745.45,34.17987114325291,40.10756066492337,NaN,NaN,-125.29125902956693,-92.97325152138862,-0.05935779814145847,-0.48484051477081636,-0.4254827166293579,-21786246,-15945640.6,8.122999234613047,15.097994714652787,NaN,NaN,-19.561292603805526,-16.222228419834575
2008-01-03T09:30:00-05:00,32.10001,32.22,31.67999,31.84,9586926,3302693,31.56383199515956,39.214988681231986,NaN,NaN,-163.09190800751153,-112.7799040172712,-0.09643869421982698,-0.5460310844041416,-0.4495923901843146,-31373172,-19948910,6.451822740780159,14.131901151699264,NaN,NaN,-22.145245658815018,-17.068373739688923
2008-01-04T09:30:00-05:00,31.58,31.58,30.73,30.84,5985035,3413706.25,25.683407888668555,38.03253836501742,NaN,NaN,-218.99118009185142,-139.60140408525407,-0.17434362161300748,-0.667521917200574,-0.4931782955875665,-37358207,-24616526,5.127299509998281,12.954332926167783,NaN,NaN,-26.58974358158423,-18.42856943138825
2008-01-07T09:30:00-05:00,31.14,31.17999,30.67999,30.95,6121805,3588928.7,27.288136405841954,37.21146626040288,NaN,NaN,-204.9324521480601,-163.2449004014489,-0.20251738469830993,-0.746325026460454,-0.543807641762144,-31236402,-27927854.6,4.432142769728472,11.81853585754689,NaN,NaN,-29.61217929998658,-20.026227984045153
2008-01-08T09:30:00-05:00,31.03,31.31,30.28999,30.35001,4300109,3598991.75,24.216541657034696,36.33286002008648,NaN,NaN,-193.99780340988679,-181.26092053737534,-0.24289202728143588,-0.8474226758639389,-0.604530648582503,-35536511,-31458107.6,3.8351552717108035,10.808987034341936,NaN,NaN,-33.260711307055864,-21.91686845876097
2008-01-09T09:30:00-05:00,30.22,30.63,29.67,30.57001,6711012,3846611.55,27.44162497753352,35.416174857594896,NaN,NaN,-180.45080153406914,-192.29282903827578,-0.23591399306732286,-0.8994231399166566,-0.6635091468493337,-28825499,-32865958.2,3.6254319738861938,9.79948949558943,NaN,NaN,-35.21315086493706,-23.816337373928985
2008-01-10T09:30:00-05:00,30.39,31.28,30.28999,31,6124379,3931793,33.40671895484286,35.09274413626249,NaN,NaN,-116.58684464979929,-182.99181636673336,-0.18568325155888366,-0.8956132112979382,-0.7099299597390546,-22701120,-31131547.8,10.144540039813748,9.381452900071553,NaN,NaN,-34.982556154154295,-25.41151148538974
2008-01-11T09:30:00-05:00,30.59,30.67999,30.11,30.25999,3961027,3950721.85,28.989628363295253,34.31061785651492,NaN,NaN,-128.48115838717348,-164.88981202579777,-0.185219186511289,-0.9414539428781659,-0.7562347563668769,-26662147,-28992335.8,17.552362918094346,9.520302377170141,NaN,NaN,-36.23894122901362,-26.958287163050297
2008-01-14T09:30:00-05:00,30.28,30.58,30.14,30.55,3004298,3927784.65,32.74282380801469,33.89825228612779,NaN,NaN,-106.88733252048385,-145.2807881002825,-0.14981661510772348,-0.9435055252515312,-0.7936889101438077,-23657849,-27476625.2,22.43187668308005,10.083224364989658,NaN,NaN,-36.0412060718659,-28.25584700716681
2008-01-15T09:30:00-05:00,30.05,30.21001,29.74001,29.99001,6500176,4157489.45,29.50047061690175,32.72266494197859,NaN,NaN,-116.8214824836524,-129.84552391503564,-0.14827467795892857,-0.9790322575924684,-0.8307575796335398,-30158025,-26400928,25.788687606143228,10.897165476896046,NaN,NaN,-36.932433205659486,-29.495359321237192
2008-01-16T09:30:00-05:00,29.64,30.59,29.64,30.16,6617012,4339758.95,31.711130344505364,31.780381086399085,NaN,NaN,-95.75900086962166,-112.90716378214616,-0.12111319504722773,-0.9821490734425744,-0.8610358783953467,-23541013,-25344030.8,29.038038404875778,12.038520834816556,NaN,NaN,-36.949713811654064,-30.560267105582458
2008-01-17T09:30:00-05:00,30.09,30.39999,29.62,29.66,6892121,4489879.85,28.84595072761236,30.940014358302843,NaN,NaN,-97.2548171125392,-109.04075827469413,-0.12179888211187961,-1.0132844810351962,-0.8914855989233166,-30433134,-26890433.6,27.163934255269382,13.12506681453473,NaN,NaN,-37.87206992739175,-31.60481036584093
2008-01-18T09:30:00-05:00,30.07001,30.35001,29.42999,29.52,6384785,4652535.85,28.080893765962372,30.137260772828686,NaN,NaN,-94.3358431859267,-102.21169523444478,-0.11665072771532503,-1.037299008567473,-0.9206482808521479,-36817919,-28921588,24.891542278561076,14.15229238301435,NaN,NaN,-38.849082602747714,-32.639706399684755
2008-01-22T09:30:00-05:00,28.36,30.42,27.91,30.10001,28397808,5954810.3,35.69071922167622,29.952982133592908,NaN,NaN,-101.06677616126646,-101.0475839626013,-0.06190068254173353,-0.9980241340293148,-0.9361234514875812,-8420111,-25874040.4,33.835103007899434,15.88863833531813,NaN,NaN,-37.3050568129754,-33.30618503015485
2008-01-23T09:30:00-05:00,29.39999,31.2999,29.39999,31.2,12414813,6323113.45,47.11872109305458,30.877185701435884,NaN,NaN,-34.268950572013495,-84.53707758027352,0.05439377199307627,-0.8681312364962359,-0.9225250084893122,3994702,-19043495,48.60644211045484,18.780312826449688,NaN,NaN,-31.87923884058921,-33.10233557450262
2008-01-24T09:30:00-05:00,31.49001,31.50999,31.02,31.50999,7203703,6623186.95,49.824734594497215,32.18153588710286,NaN,NaN,15.426377545127776,-62.30000189732364,0.15262679370290722,-0.7317415163606782,-0.8843683100635854,11198405,-12095611.4,58.705227451824356,22.51269887723856,NaN,NaN,-26.626720059831086,-32.17724764383526
2008-01-25T09:30:00-05:00,31.78999,31.78999,30.66,30.86,6656973,6864570.15,44.66381066683901,33.53727894268646,NaN,NaN,7.879981269091185,-41.27304222099756,0.1727781736579883,-0.6683955929911001,-0.8411737666490884,4541432,-5100698.2,65.957806511438,26.85773509162711,NaN,NaN,-23.908386140030107,-30.995981714720237
2008-01-28T09:30:00-05:00,30.69,31.42,30.35001,31.37,7473773,7105093.7,49.11730358126751,35.09650516950258,NaN,NaN,13.179481841990825,-19.769977215414034,0.21656718006279885,-0.5704647915705898,-0.7870319716333887,12015205,4665926.6,73.06970257273045,31.760417934698676,NaN,NaN,-20.156277474478564,-29.447452537542855
2008-01-29T09:30:00-05:00,31.5,31.58,31.02,31.47,4764398,7310332,49.96757499334846,36.935864693524984,NaN,NaN,54.42917377580399,11.329212772000057,0.24621745814009088,-0.47926014895827507,-0.725477607098366,16779603,9705869.4,75.87107948348529,36.90584109268257,NaN,NaN,-16.939433472036463,-27.660592671041943
2008-01-30T09:30:00-05:00,31.37,32.06,31.17999,31.27,12923387,7796227,48.2316372599712,38.42086557084196,NaN,NaN,83.24951206120026,34.832905298642814,0.24574506010573605,-0.41829628196619595,-0.664041342071932,3856216,9678172.2,75.8243991107551,42.06291017388749,NaN,NaN,-14.845604976242106,-25.829880143213394
2008-01-31T09:30:00-05:00,30.87,32.6485,30.66,32.58,7917918,7997072.9,58.420978715628245,40.20759841089806,NaN,NaN,142.74761295986016,60.297152381589285,0.322221685806951,-0.26126423481324323,-0.5834859206201942,11774134,9793318,75.89080973981046,46.75907229531583,NaN,NaN,-9.329913354931627,-23.472742030601715
2008-02-01T09:30:00-05:00,32.58,32.89999,32.24001,32.87,8206879,7928070.55,60.28457684575257,42.442951873930724,NaN,NaN,206.83771018792632,100.08869816535632,0.3770910122496981,-0.11212215530807157,-0.48921316755776967,19981013,12881234.2,77.66291268093394,51.052682992661516,NaN,NaN,-4.31321097703589,-20.7356661658066
2008-02-04T09:30:00-05:00,32.89,32.89,32.10001,32.39999,6477254,7952681.5,55.91069844625631,44.09780006237656,NaN,NaN,158.34170155358035,129.12114210767422,0.36617943198814223,-0.03148887757259189,-0.3976683095607341,13503759,13178945,77.83209104397568,55.009841161296926,NaN,NaN,-1.5799484666051231,-17.999135065920676
2008-02-05T09:30:00-05:00,31.77,32.05,31.32001,31.49001,7004176,7996800.05,48.56411524310648,45.459488964248315,NaN,NaN,68.99565760455069,132.03443887342354,0.2856972023142691,-0.04054680666789778,-0.3262440089821669,6499583,11122941,73.68167335132564,58.430768714524234,NaN,NaN,-1.6991385690372407,-15.670564137794472
2008-02-06T09:30:00-05:00,31.69,31.95,31.02,31.14999,4939020,8028745.6,46.12525687174923,46.48906943048002,NaN,NaN,41.96982848937555,123.77850215905862,0.20155080282112997,-0.07430550545575443,-0.2758563082768844,1560563,10663810.4,72.74872954187828,61.552960938595845,NaN,NaN,-2.60413425926574,-13.803931298004652
2008-02-07T09:30:00-05:00,31.08,31.96001,31.05,31.75,6434117,8014900.85,50.818880080551324,48.05856438426138,NaN,NaN,55.78489475445782,106.38595851797815,0.17905000944815747,-0.05204379646668755,-0.23109380591484502,7994680,9907919.6,71.15142720421136,64.69492472066312,NaN,NaN,-1.8224918486849835,-12.092297090958986
2008-02-08T09:30:00-05:00,31.67,31.78999,31.2,31.57001,5486973,7983030.55,49.42774787564573,49.583339677810194,NaN,NaN,45.738149746656354,74.16604642972416,0.14618114751946182,-0.04836737151551773,-0.19454851903497955,2507707,6413258.4,64.13978253635952,67.49837045336302,NaN,NaN,-1.637915360665354,-10.598813986631324
2008-02-11T09:30:00-05:00,31.5,32.06,31.21001,31.89999,5200859,8045022.15,52.02085095176911,50.749777658531116,NaN,NaN,58.99263281593182,54.29623268219444,0.14074873875091637,-0.018612595596334103,-0.15936133434725047,7708566,5254219.8,61.95897173412509,69.50721821952199,NaN,NaN,-0.6917710355484178,-9.183522136476624
2008-02-12T09:30:00-05:00,32,32.42,31.78,31.96001,4424879,8116051.2,52.49795472524172,51.13400863225876,NaN,NaN,82.05915341662974,56.90893184461025,0.1352487317646347,0.009699580358542903,-0.1255491514060918,12133445,6380992.2,63.26657185329699,70.55437034401072,NaN,NaN,0.20893373990065334,-7.8417427255655845
2008-02-13T09:30:00-05:00,32.28999,32.5,31.99001,32.37,7036246,8142854.7,55.73593057340079,51.55623691646616,NaN,NaN,97.94214560407828,68.1033952675508,0.15202068356818846,0.06447670305414377,-0.08754398051404469,19169691,9902817.8,67.07593584301529,71.15227808623864,NaN,NaN,1.928512550103633,-6.445991971898554
2008-02-14T09:30:00-05:00,32.59,32.59,31.75999,32.06,4969453,8060476.75,52.80497490577979,52.13774864781908,NaN,NaN,79.3620842166403,72.81883315998729,0.1355784885732358,0.08192913020250003,-0.05364935837073574,14200238,11143929.4,68.3226517549585,71.32119560363296,NaN,NaN,2.5388560834364933,-5.1624422497078335
2008-02-15T09:30:00-05:00,31.71001,32.25,31.58,32.23,4196887,7925715.05,54.226517443048756,52.502692495089164,NaN,NaN,62.25159708441555,76.12152262753914,0.12950370469331882,0.10823027249591277,-0.021273432197406038,18397125,14321813,71.31755044565219,71.19604188027023,NaN,NaN,3.4470524681420702,-3.932514432872133
2008-02-19T09:30:00-05:00,32.39,32.39,31.75999,31.86,4075248,7810238.2,50.65061357382547,52.55148096512324,NaN,NaN,54.575306092836115,75.23805728292,0.09548875985882599,0.09808751762612644,0.0025987577673004594,14321877,15644475.2,72.48360917866873,70.95407971564048,NaN,NaN,3.219421361519465,-2.910809319387619
2008-02-20T09:30:00-05:00,31.62,32.3,31.53,32.3,10776109,6929153.25,54.49370923157383,52.998771820237714,NaN,NaN,51.68597877990967,69.16342235557599,0.0972192525373301,0.12412282343896308,0.026903570901632985,25097986,18237383.4,74.6586011316843,70.87080843142114,NaN,NaN,4.122794041920349,-1.9060088392007666
2008-02-21T09:30:00-05:00,32.32001,32.39999,31.50999,31.53,6012805,6609052.85,47.51951317437822,52.22009571014843,NaN,NaN,5.808926282249935,50.736778491210316,0.043822622097725264,0.08168184852378957,0.037859226426064305,19085181,18220481.4,74.61719727875987,70.77983611277467,NaN,NaN,2.7969291692229183,-1.2341605522830974
2008-02-22T09:30:00-05:00,31.72,32.22,31.28,32.22,4398996,6468817.5,53.2886785027208,51.720388685646164,NaN,NaN,18.730165793133025,38.610394806508864,0.051746427032555,0.10254226021675805,0.050795833184203054,23484177,20077269.2,76.18002487859074,70.67391555546445,NaN,NaN,3.4571883355475874,-0.563967854021571
2008-02-25T09:30:00-05:00,32.07001,32.64999,31.75,32.64999,6688879,6470412.8,56.49803493924605,51.76234129228828,NaN,NaN,96.43971132700064,45.44801765502588,0.08097814259402036,0.1520185114267285,0.07104036883270815,30173056,22432455.4,78.0279710553565,70.68790698484878,NaN,NaN,5.02186259732099,0.23400792474165188
2008-02-26T09:30:00-05:00,32.32001,33.14,32.32001,32.97,6773121,6435380.2,58.76849994283547,52.491225913697505,NaN,NaN,174.97986890026692,69.52893021651204,0.11482963666674965,0.21457741466614522,0.09974777799939556,36946177,26957315.4,81.06698308489099,71.21542910867488,NaN,NaN,7.018857492793619,1.2032721487490756
2008-02-27T09:30:00-05:00,32.67,33.05,32.66,32.89999,4445922,6419456.4,58.05462202219991,53.34332342444397,NaN,NaN,165.46148287136594,92.28403103480329,0.12465028194234393,0.25556063042732546,0.13091034848498154,32500255,28437769.2,81.94679717712364,71.87243393976384,NaN,NaN,8.419802161568908,2.2342050077233373
2008-02-28T09:30:00-05:00,32.57001,32.64,32.02,32.12,6614406,6104007.35,50.6697682112122,53.33267257663404,NaN,NaN,38.139061355430364,98.75005804943937,0.07330067412963776,0.22253619114702872,0.14923551701739096,25885849,29797902.8,82.74034760392064,72.7002139683145,NaN,NaN,7.388675869092844,2.970557987918981
2008-02-29T09:30:00-05:00,31.77,31.8,31,31.32001,9130027,6164612.8,44.42756606168028,52.97551673277936,NaN,NaN,-127.68597372729317,69.46683014535412,-0.015140852301234492,0.13030945164084784,0.14545030394208233,16755822,28452231.8,79.03864306771258,73.76441829198257,NaN,NaN,4.426845752528418,3.1785990971489007
2008-03-03T09:30:00-05:00,31.19,31.34,30.83,31.25,4894188,5998978.25,43.91766216875599,52.396717533992714,NaN,NaN,-151.0755855248689,19.96377077498023,-0.07557449647520531,0.050982183348075694,0.126556679823281,11861634,24789947.4,69.8761951999038,74.32993425382391,NaN,NaN,1.9240536210615393,2.999378314850706
2008-03-04T09:30:00-05:00,31.03999,31.34,30.78999,31.2,7484203,6049325.7,43.533377744868126,51.75639060682317,NaN,NaN,-137.15340576220962,-42.46288415751508,-0.1138360701463312,-0.015738407859632986,0.09809766228669821,4377431,18276198.2,57.179850480199356,73.89516844145979,NaN,NaN,-0.2070605336877586,2.541315622202354
2008-03-05T09:30:00-05:00,31.17999,31.7,30.97,31.21001,5022000,5950216.9,43.63970279573353,50.892374336989796,NaN,NaN,-97.90690295001025,-95.13656132179031,-0.13210573121833186,-0.06703450173621661,0.06507122948211524,9399431,13656033.4,50.21102398432663,72.6905318801249,NaN,NaN,-1.9174217515086855,1.904353140243634
2008-03-06T09:30:00-05:00,30.89,31.31,30.35001,30.45,6471004,6026816.1,37.81727706646222,49.82182449132426,NaN,NaN,-174.23086277596357,-137.6105461480691,-0.18572690476752354,-0.16708740147728918,0.01863950329023436,2928427,9064549,44.41740243177203,70.98301407132585,NaN,NaN,-5.24668363096475,0.8827764586424365
2008-03-07T09:30:00-05:00,30.03,30.66,29.92999,30.16,7841402,6097180.35,35.85167758045074,48.509335929710105,NaN,NaN,-198.3620114681506,-151.74575369624057,-0.22827656158697754,-0.26670619869348755,-0.03842963710651002,-4912975,4730789.6,39.75471737316843,68.72852599471987,NaN,NaN,-8.643077226306541,-0.47805978206456023
2008-03-10T09:30:00-04:00,30.35001,30.42,29.64999,29.81,6987727,6172218.05,33.58296959060492,47.29021850233721,NaN,NaN,-190.51821128997747,-159.63427884926233,-0.2649650542603045,-0.3696359549318906,-0.10467090067158613,-11900702,-21677.6,35.36986171497216,66.07754403302725,NaN,NaN,-12.224799231298265,-2.156165417669375
2008-03-11T09:30:00-04:00,30.63,30.63,29.84,30.62,7477773,6286063.75,42.63089210864843,46.44287442212825,NaN,NaN,-122.99674814706717,-156.80294732623383,-0.2214242124015951,-0.38145116617358,-0.1600269537719849,-4422929,-1781749.6,33.87947394217049,63.16474923377627,NaN,NaN,-12.673580014647293,-3.6586532172376494
2008-03-12T09:30:00-04:00,30.88,31.03999,30.39999,30.45,4108563,6270247.95,41.357471187232015,46.002728565903524,NaN,NaN,-85.82244265997917,-154.3860552682276,-0.1919163008085017,-0.399922329782612,-0.2080060289741103,-8531492,-5367934.2,31.012102120293406,60.050099579600094,NaN,NaN,-13.42215079293329,-5.053438585194169
2008-03-13T09:30:00-04:00,29.97,30.7,29.67999,30.48,9014227,6369147,41.688494689601846,45.1741440078236,NaN,NaN,-104.12735504643585,-140.36535372232206,-0.15954986269433183,-0.4074433573420251,-0.24789349464769325,482735,-5857072.6,30.63130240209182,56.796619402707314,NaN,NaN,-13.933190372606886,-6.321974554824557
2008-03-14T09:30:00-04:00,30.75,30.75,29.56,30.0401,8921551,6566751.9,38.2765908688666,43.87261228851078,NaN,NaN,-106.72961472454597,-122.03887437360113,-0.15671273152178006,-0.44378440904991834,-0.2870716775281383,-8438816,-6562240.8,30.058275362461657,53.37021256750054,NaN,NaN,-15.373625618585926,-7.615067563933324
2008-03-17T09:30:00-04:00,29.31,29.84,29.11,29.64,8907055,6802260.3,35.435904048326194,42.20599829604584,NaN,NaN,-137.12783507468617,-111.36079913054289,-0.16963560193188792,-0.4991161799429982,-0.32948057801111025,-17345871,-7651274.6,29.151289036634225,49.66194870691077,NaN,NaN,-17.45915495770909,-9.021365763044148
2008-03-18T09:30:00-04:00,30.19,30.92999,29.92999,30.81,5602055,6878600.65,47.66705383502429,41.464029139819004,NaN,NaN,-49.69929789286271,-96.70130907970199,-0.09117234998044033,-0.4434460154866606,-0.3522736655062203,-11743816,-9115452,27.931006785480093,45.80367796465051,NaN,NaN,-15.396324556409185,-9.932074162096296
2008-03-19T09:30:00-04:00,31.28,31.28,30.39999,30.39999,7762770,6727933.7,44.48653438608975,41.02236958088169,NaN,NaN,-34.30914997805755,-86.39865054331764,-0.06016796707850808,-0.4274836243543554,-0.3673156572758473,-19506586,-11310470.8,26.162865106330045,41.76242921482261,NaN,NaN,-14.729916099727609,-10.617480153186483
2008-03-20T09:30:00-04:00,30.25999,31.41,30.25999,31.25,6350676,6744827.25,51.68407772514532,41.54069184255776,NaN,NaN,-7.516284281455174,-67.0764363903215,0.020013482881470923,-0.34229880367400867,-0.3623122865554796,-13155910,-14038199.8,24.119498008763827,37.83963313918342,NaN,NaN,-11.674596286538245,-10.768496743665306
2008-03-24T09:30:00-04:00,31.64999,32.38,31.48,32.28999,10340391,7041897,58.73377546508512,42.59898564943841,NaN,NaN,85.60966563495992,-28.60858031842033,0.13889338665113982,-0.18869555324155485,-0.32758893989269466,-2815519,-12913540.4,26.66275453622636,34.752958806063596,NaN,NaN,-6.443884329796822,-10.150694970255522
2008-03-25T09:30:00-04:00,32.56,32.56,31.85001,32.03,7481020,7081504.05,56.513806283610045,43.52615911649141,NaN,NaN,96.31045449094812,18.07907759470654,0.1925185978266447,-0.08694069260938875,-0.27945929043603346,-10296539,-11503674,29.837484214159517,32.79993264420361,NaN,NaN,-3.116442516986732,-9.145801762645695
2008-03-26T09:30:00-04:00,31.89,31.94,31.36,31.42999,7751824,7130439.2,51.66084261304471,44.099097674870784,NaN,NaN,56.505099958012394,39.319957164881565,0.18029423881808943,-0.05409149191342166,-0.2343857307315111,-18048363,-12764583.4,28.643235356016973,31.259376313610066,NaN,NaN,-1.9982310014592597,-8.124720225333347
2008-03-27T09:30:00-04:00,31.84,31.84,31.11,31.13,4744156,7145350.9,49.37778405712201,44.924848174203625,NaN,NaN,48.25954386148005,55.83369593278909,0.14617311449388856,-0.05166933761415038,-0.19784245210803894,-22792519,-13421770,28.013880758938996,30.087696194121992,NaN,NaN,-1.8467082355476214,-7.227861369649672
2008-03-28T09:30:00-04:00,31.10001,31.10001,30.33,30.53,4229797,7026120.45,45.08610317721482,45.58445000254392,NaN,NaN,-22.512590674733737,52.834434654133375,0.08063711218258998,-0.09704606187980147,-0.17768317406239145,-27022316,-16195051.2,25.47055687909115,29.06739901597361,NaN,NaN,-3.1272811390537956,-6.642064193850261
2008-03-31T09:30:00-04:00,30.42,31.00999,30.34,30.72,5190836,6829160.9,46.66691284217867,46.519017377656326,NaN,NaN,-14.590433981386775,32.794414730864034,0.049078544616645764,-0.11633499329158425,-0.16541353790823002,-21831480,-19998243.4,22.459203069280264,28.1452091127099,NaN,NaN,-3.6613236077857736,-6.2162441101267625
2008-04-01T09:30:00-04:00,31.14,32.2,31.14,32.10001,9956426,7082272.8,56.468829028412806,47.507441443353784,NaN,NaN,115.70442137321848,36.673208107318075,0.11630252534557217,-0.020035381226264803,-0.13633790657183698,-11875054,-20313946.4,22.224311848403417,27.31269753458368,NaN,NaN,-0.7684063719792871,-5.437981576105694
2008-04-02T09:30:00-04:00,32.2,32.60001,32.10001,32.10001,7505168,7083321.05,56.468829028412806,48.58682414629527,NaN,NaN,144.74329000741062,54.32084611719772,0.1535834102317108,0.05564135621780153,-0.09794205401390926,-11875054,-19079284.6,25.505641144382267,26.919378893447167,NaN,NaN,1.4493354866041073,-4.454079138575723
2008-04-03T09:30:00-04:00,32.11,32.25,31.75,32.2,6364902,7150466.15,57.130896670525956,49.689852859218426,NaN,NaN,111.3623567999554,66.9414087048928,0.17617329769476534,0.1222745681045474,-0.05389872959021793,-5510152,-15622811.2,33.9118373508438,27.15370281835802,NaN,NaN,3.421705404989744,-3.328967060923513
2008-04-04T09:30:00-04:00,32.21001,32.25999,31.8,32.05,3237387,6988785.3,55.760802549241795,50.93872512210236,NaN,NaN,94.46888928091356,90.33770469602226,0.17201564099669195,0.161120821655647,-0.010894819341044935,-8747539,-11967855.8,41.437262669396304,27.966487625996205,NaN,NaN,4.6416512968702435,-2.1903072955244047
2008-04-07T09:30:00-04:00,32.17999,32.25999,31.87,31.92999,3153304,6754380.4,54.631950746826426,52.30987131485238,NaN,NaN,82.36823440327446,109.72943837295449,0.15283292633565515,0.18014633857852402,0.02731341224286886,-11900843,-9981728.4,45.095919683281934,29.10538981504248,NaN,NaN,5.335912221176706,-1.1151330788528175
2008-04-08T09:30:00-04:00,31.8,31.91,31.69,31.86,4584773,6634232.7,53.9460351362127,52.75836997922297,NaN,NaN,57.96771598138178,98.18209729458717,0.12808220841775989,0.18741617276506872,0.05933396434730883,-16485616,-10903840.8,43.729950937944324,30.233885825932777,NaN,NaN,5.728948548477009,-0.13740713209141386
2008-04-09T09:30:00-04:00,31.84,31.87,31.08,31.16,6715887,6596138.4,47.51994728002608,52.97504232878986,NaN,NaN,13.128170319265543,71.85907335695815,0.06064135581737376,0.13513565911902603,0.07449430330165227,-23201503,-13169130.6,40.48559405609652,31.256937893773234,NaN,NaN,4.24443522037745,0.4885703468327095
2008-04-10T09:30:00-04:00,31.14999,31.67999,31.11,31.49001,6425570,6711988.75,50.51285463765201,52.89138353682605,NaN,NaN,15.36614625095619,52.65983124715831,0.03557313276982621,0.11896071926393503,0.08338758649410882,-16775933,-15422286.8,37.50507512500251,32.21305054493314,NaN,NaN,3.8215614739941235,0.9647119364271972
2008-04-11T09:30:00-04:00,31.24001,31.28999,30.75999,30.91,3883192,6455437,45.591589031242606,51.95265593440873,NaN,NaN,-34.17881966312231,26.930289458351133,-0.01977905808546465,0.05866376388727801,0.07844282197274266,-20659125,-17804604,34.60429788127445,32.780303641008,NaN,NaN,1.9819409648069473,1.1100303690528759
2008-04-14T09:30:00-04:00,30.89,30.89,30.64999,30.69,3300036,6174361.25,43.84663865525569,51.047858246669136,NaN,NaN,-67.4747448202076,-3.0383063863452775,-0.06819092232963406,-0.006795830939299918,0.06139509139033414,-23959161,-20216267.6,31.913388431332734,32.92858251366324,NaN,NaN,-0.06395457263541128,0.9423182345259777
2008-04-15T09:30:00-04:00,30.81,30.84,30.49001,30.64999,2877587,5872887.85,43.52041016575354,50.46639878614833,NaN,NaN,-93.0714084452396,-33.246131271669555,-0.09807293217379794,-0.06119607382691328,0.03687685834688466,-26836748,-22286494,29.773069694481066,33.00928496641067,NaN,NaN,-1.8341020202459615,0.5456867695585579
2008-04-16T09:30:00-04:00,30.97,31.33,30.83,31.33,6371020,5911336.1,50.28997830383609,50.531555518056486,NaN,NaN,-35.24652182640904,-42.921069700804466,-0.0686008015767286,-0.04887414362402609,0.01972665795270251,-20465728,-21739339,31.08851964160938,33.22890202945855,NaN,NaN,-1.4829940886498187,0.25587521838593263
2008-04-17T09:30:00-04:00,31.22,31.49001,31.11,31.47,4230617,5734728.45,51.57680565971035,50.99517712394902,NaN,NaN,-14.621619104677372,-48.91862277193118,-0.037777444953027886,-0.027495148238582345,0.010282296714445537,-16235111,-21631174.6,31.36223077271177,33.64973587900288,NaN,NaN,-0.8260292216116896,0.10131744124341521
2008-04-18T09:30:00-04:00,32.13,32.22,31.75,32.07001,4859617,5660175.5,56.744882522869496,51.71503210114122,NaN,NaN,71.2533757351775,-27.832183692271222,0.021719888650572408,0.03743215752766105,0.01571226887708864,-11375494,-19774448.4,36.05728039863671,34.621027116814055,NaN,NaN,1.3024840005872198,0.27291266400681585
2008-04-21T09:30:00-04:00,31.92,32.08,31.73,32.07001,3426031,5314457.5,56.744882522869496,51.73475020788812,NaN,NaN,64.94842174169486,-1.3475503798907311,0.05772982648879267,0.08787455198807947,0.030144725499286807,-11375494,-17257715,41.862363357341884,36.023745081738234,NaN,NaN,3.0260129602540724,0.6662127063278525
2008-04-22T09:30:00-04:00,31.95,31.95,31.33,31.61,4154777,5148145.35,51.826673167379965,51.403167646385775,NaN,NaN,22.643382395679048,21.795407788292998,0.04764227775778558,0.08969757269651879,0.04205529493873321,-15530271,-14996419.6,46.5571087268036,37.52742133762547,NaN,NaN,3.141289675217946,1.0197951304550086
2008-04-23T09:30:00-04:00,31.62,31.87,31.36,31.60001,2589475,4890027.9,51.72183073266581,51.01680579368148,NaN,NaN,19.285404438911172,32.70179304135704,0.03780116215844572,0.08930674763679036,0.05150558547834464,-18119746,-14527223.2,47.50434877663829,38.49831501089651,NaN,NaN,3.2069119525648553,1.3322403907564153
2008-04-24T09:30:00-04:00,31.67999,32.31,31.52,32.03999,5207766,4913208.4,55.9484851859276,51.03021169630189,NaN,NaN,64.9918783272259,48.6244925277377,0.057260271306305524,0.12308092461122655,0.06582065330492103,-12911980,-13862597,48.886368724844985,39.03039401485712,NaN,NaN,4.459445168948224,1.7789839304981023
2008-04-25T09:30:00-04:00,32.23,32.41,31.82001,32.36,5679684,4985702.75,58.77543031942688,51.32617452291621,NaN,NaN,93.76793360276649,53.12740410125549,0.08627740216077254,0.1736674060058867,0.08739000384511417,-7232296,-13033957.4,50.63144459487825,39.42578865139972,NaN,NaN,6.35282515373984,2.432389819532636
2008-04-28T09:30:00-04:00,32.42,32.59,32.16,32.32001,3782645,4915293.2,58.272172789182704,51.635184355271214,NaN,NaN,111.02118630650634,62.34195701421779,0.0965931872773534,0.20813148794180591,0.11153830066445251,-11014941,-12961846.8,50.78890042835151,39.929999329285955,NaN,NaN,7.781021909180607,3.196480118053775
2008-04-29T09:30:00-04:00,32.37,32.62,32.27,32.58,3086353,4571789.55,60.63224369668446,52.5717769564611,NaN,NaN,118.39349354818017,81.49197924471801,0.11357042806828896,0.2535013357498137,0.13993090768152475,-7928588,-11441510.2,54.111924625880164,40.903308655699064,NaN,NaN,9.67348443209637,4.121766448631289
2008-04-30T09:30:00-04:00,32.69,32.88,31.45,31.45,6212344,4507148.35,47.94079971437267,52.38805874765542,NaN,NaN,37.12546178347792,85.05999071363136,0.04486820069782843,0.19601615855381027,0.15114795785598184,-14140932,-10645747.4,55.794502908409164,42.209696354513824,NaN,NaN,7.5250759032368135,4.607953513574935
2008-05-01T09:30:00-04:00,32.23,33.55,32.12,33.25999,6858293,4531817.9,61.75123179308804,53.5423189449301,NaN,NaN,177.31718357844562,107.52505176387531,0.11358625659674515,0.2931307786019133,0.17954452200516813,-7282639,-9519879.2,58.13350516755273,43.89035401781941,NaN,NaN,10.64152914268797,5.469892889162511
2008-05-02T09:30:00-04:00,33.64,33.64,32.98,33.19,4576613,4598779.2,61.0765042369255,54.77302362933509,NaN,NaN,188.04505205821383,126.3804754549648,0.14459955205533231,0.3602939620743335,0.2156944100190012,-11859252,-10445270.4,55.53259800677293,45.577440416065144,NaN,NaN,12.721240128555744,6.505799637647259
2008-05-05T09:30:00-04:00,32.99001,33.07001,32.7,32.82001,6094367,4745832.35,57.49976275943681,55.77154881459818,NaN,NaN,121.49476999490545,128.47519219264458,0.1308795951636283,0.3792939039735366,0.24841430880990828,-17953619,-11833006,51.79050534701461,47.15011439124611,NaN,NaN,13.167240149106082,7.457433996427091
2008-05-06T09:30:00-04:00,32.63,32.97,32.38,32.96001,3857736,4709480.5,58.49033318906938,56.3572884492577,NaN,NaN,97.69144498956321,124.33478248092119,0.12208899443605603,0.40102555185497835,0.2789365574189223,-14095883,-13066465,48.65235949509768,48.40467438078099,NaN,NaN,13.835832571320623,8.368633792840452
2008-05-07T09:30:00-04:00,33.03999,33.24001,32.34,32.34,4551461,4601259.2,52.63897394798878,56.43315761270617,NaN,NaN,76.11236854133331,132.13216383249227,0.0680685082781346,0.36402219276659054,0.29595368448845594,-18647344,-13967747.4,46.4381498415454,49.48152574284053,NaN,NaN,12.48763882094408,8.957063082569542
2008-05-08T09:30:00-04:00,32.63,32.64999,32.16,32.39,3711545,4465557.95,53.04691069890711,56.16901676813743,NaN,NaN,44.672637542189875,105.60325462524115,0.03113398036524878,0.3348711599450169,0.30373717957976815,-14935799,-15498379.4,42.8698497143625,49.96813783682095,NaN,NaN,11.549078651796707,9.327351021030566
2008-05-09T09:30:00-04:00,32.2,32.45,31.92999,32.2,3412536,4442025.15,51.240753616579894,55.775864703402455,NaN,NaN,16.10245951238355,71.21473611607509,-0.008542430900307596,0.2930591409543837,0.3016015718546913,-18348335,-16796196,40.059144152969736,49.83933646508008,NaN,NaN,10.237487515600835,9.45737052025489
2008-05-12T09:30:00-04:00,32.34,32.89999,32.24001,32.86,1877157,4370881.2,56.74959894014284,56.127502258599804,NaN,NaN,66.64484098129954,60.244750313353904,0.00640698568147835,0.3096103039565392,0.30320331827506086,-16471178,-16499707.8,41.01065930021253,49.44316150603787,NaN,NaN,10.76942703558989,9.644807165302748
2008-05-13T09:30:00-04:00,32.94,33.08,32.73,32.98,2492373,4351620.5,57.68567893672233,56.55349141603241,NaN,NaN,94.264196651229,59.55930064568706,0.020334998481978395,0.3286220663775339,0.3082870678955555,-13978805,-16476292.2,41.09019514737245,48.98500767537602,NaN,NaN,11.478761886750442,9.906800696938133
2008-05-14T09:30:00-04:00,33.14,33.55,33.06,33.35001,3688218,4217480.4,60.52284996773157,56.88023175758983,NaN,NaN,137.8625533951378,71.90933761644796,0.04880139229045455,0.36928880825862365,0.3204874159681691,-10290587,-14804940.8,46.622369076481796,48.82329341477864,NaN,NaN,12.92884871464151,10.33852184232433
2008-05-15T09:30:00-04:00,33.17,33.72,33.02,33.67,5420547,4276976.9,62.8431525706571,57.170783346963425,NaN,NaN,143.91817631596814,91.7584453712036,0.08158451846886489,0.4224680640542502,0.3408835455853853,-4870040,-12791789,52.41851928982498,48.950941607274835,NaN,NaN,14.847471052587801,10.98265744379054
2008-05-16T09:30:00-04:00,33.75999,33.75999,33.13,33.44,3569003,4212446.2,60.108447721949204,57.30194584216103,NaN,NaN,123.20231461706695,113.17841639214029,0.08006971867840729,0.4409706939333944,0.3609009752549871,-8439043,-10809930.6,57.330723348973855,49.418214673033575,NaN,NaN,15.66919649303694,11.652163022254312
2008-05-19T09:30:00-04:00,33.35001,33.69991,33.2,33.45,3690090,4225649.15,60.18956367625496,57.27032584070178,NaN,NaN,112.01587792509551,122.25262378089948,0.07227079589094804,0.45123947011867216,0.3789686742277241,-4748953,-8465485.6,62.29029018777423,50.00238364174029,NaN,NaN,16.362762703673962,12.32510583388569
2008-05-20T09:30:00-04:00,33.13,33.14999,32.67,32.92999,5388520,4287336.3,54.0362770652404,57.705717080049475,NaN,NaN,33.33266468300401,110.06631738725449,0.026953219209568613,0.4126601982396849,0.3857069790301163,-10137473,-7697219.2,63.7761556251168,50.57250169293369,NaN,NaN,15.21768025150163,12.738330750687966
2008-05-21T09:30:00-04:00,32.91,32.91,32.03,32.23,5555871,4435656.1,47.06169291216661,56.65646430284081,NaN,NaN,-55.54647406493105,71.3845118952407,-0.05105203559457855,0.32189193453689313,0.3729439701314717,-15693344,-8777770.6,60.18423048988279,50.71898207310012,NaN,NaN,12.017290693771333,12.635325028271305
2008-05-22T09:30:00-04:00,31.97,32.39999,31.89999,32.09,3132967,4331916.15,45.78873961178245,55.56448111533059,NaN,NaN,-101.4143022919434,22.318016173658403,-0.10960251794897313,0.2359408226952553,0.3455433406442284,-18826311,-11569024.8,52.03197319702399,50.46893744383234,NaN,NaN,9.016417747114568,12.118338273820342
2008-05-23T09:30:00-04:00,32.13,32.14999,31.60001,31.7,3667505,4231307.2,42.35204775292386,54.48250147200823,NaN,NaN,-143.5450812760185,-31.031463004958688,-0.16859442244404044,0.1348003125891779,0.30339473503321834,-22493816,-14379979.4,45.367321866337065,50.01013862378395,NaN,NaN,5.38964633969559,11.157096568945377
2008-05-27T09:30:00-04:00,31.59,32.16,31.59,31.94,5156301,4299990,45.08363457671361,53.52488014255426,NaN,NaN,-120.5918949904828,-77.55301758807435,-0.18418115967495163,0.0731682854395288,0.25734944511448044,-17337515,-16897691.8,40.378537898162506,49.419151366860014,NaN,NaN,3.1345062882642134,10.011012243133782
2008-05-28T09:30:00-04:00,32.09,32.64,31.92999,31.94,3306508,4310997.75,45.08363457671361,52.985213044606034,NaN,NaN,-74.36486510203018,-99.09252354508118,-0.18664174963833666,0.024047258066559607,0.21068900770489626,-17337515,-18337700.2,37.81710256157239,48.803362275433365,NaN,NaN,1.3012308095811083,8.766757752626258
2008-05-29T09:30:00-04:00,32.09,32.62,32.09,32.56,3740556,4187408.35,51.910635706504515,52.904050545148706,NaN,NaN,-43.53142072569481,-96.68951287723392,-0.14075379073022673,0.034746769292112845,0.17550056002233957,-13596959,-17918423.2,39.02985110095679,48.52907666019011,NaN,NaN,1.630425065780638,7.747281654505455
2008-05-30T09:30:00-04:00,32.64999,32.71001,32.17,32.31,2896852,3989336.3,49.25184765453201,52.76198583357386,NaN,NaN,-43.26070850110411,-85.05879411906606,-0.12216798184946104,0.022790582710513263,0.1449585645599743,-16493811,-17451923.2,40.4221106700232,48.555002839979636,NaN,NaN,1.1336656326926557,6.8024793656750555
2008-06-02T09:30:00-04:00,32.23,32.33,31.66,31.99001,4211625,3971086.9,46.003941342402605,51.9944388623067,NaN,NaN,-95.56006501421307,-75.46179086670499,-0.12585708323634007,-0.012362789485450776,0.11349429375088929,-20705436,-17094247.2,41.52466128866853,48.59171726772649,NaN,NaN,-0.24534920940226418,5.795646712092581
2008-06-03T09:30:00-04:00,32.14999,32.17999,31.685,32.03,4276035,3880170.3,46.47895406192121,51.19395851410661,NaN,NaN,-89.79518969497575,-69.30244980760358,-0.12005434167954807,-0.0365736333485458,0.08348070833100227,-16429401,-16912624.4,42.110500543067445,48.66459622456184,NaN,NaN,-1.2417434350949397,4.790305262494364
2008-06-04T09:30:00-04:00,31.98,32.49001,31.88,32.22,6594410,4017004,48.784285102366866,50.355489595151994,NaN,NaN,-50.77484765086316,-64.58444631737017,-0.09875957027573443,-0.03996875451366577,0.058790815762068654,-9834991,-15412119.6,46.84827910294342,48.68073265502339,NaN,NaN,-1.4558919120740632,3.8979913804131603
2008-06-05T09:30:00-04:00,32.28999,32.64,32.21001,32.64,3748602,3976861.05,53.54748005552729,49.69151298692844,NaN,NaN,-5.46276767526125,-56.97071570728345,-0.053967846083505557,-0.00866899184231329,0.04529885424119227,-6086389,-13910005.6,51.157721387382765,48.5906756619918,NaN,NaN,-0.2775692917901279,3.3014827129555475
2008-06-06T09:30:00-04:00,32.34,32.34,31.25999,31.25999,5663059,4074436.75,40.28887383260948,48.27582913768988,NaN,NaN,-122.97890545354534,-72.91435509777172,-0.11154617270272238,-0.09413386163721071,0.017412311065511672,-11749448,-12961133,53.71084970543334,48.33211325888177,NaN,NaN,-3.6281598618871924,2.311533773692299
2008-06-09T09:30:00-04:00,31.35001,31.7,31.02,31.24001,5514348,4179527.35,40.13393207443591,46.84328402327424,NaN,NaN,-148.11762754596094,-83.4258676041213,-0.14322153929504566,-0.1616146130532954,-0.018393073758249737,-17263796,-12272805,55.52697420871874,47.84901926037781,NaN,NaN,-6.2621318420811924,1.0867244000103717
2008-06-10T09:30:00-04:00,31.09,31.64,30.92999,31.36,4969277,4334133.35,41.58680805236062,45.954036236639965,NaN,NaN,-132.21418201743313,-91.90966606861276,-0.14774196804506595,-0.20307053381458218,-0.05532856576951623,-12294519,-11445828.6,57.675500175156664,47.41325815680922,NaN,NaN,-7.941297718648932,-0.20299304551238606
2008-06-11T09:30:00-04:00,31.3,31.33,30.7,30.7,6344383,4526733.85,36.35980324996888,45.18961554648298,NaN,NaN,-158.4670637754941,-113.44810929353896,-0.18444564526019866,-0.28588562234476456,-0.1014399770845659,-18638902,-13206610.8,51.923664499567465,46.823217728929556,NaN,NaN,-11.123960919574179,-1.7631313132354993
2008-06-12T09:30:00-04:00,31.03,31.28,30.705,30.95,6935891,4689117.5,39.46360941082666,44.737820532129,NaN,NaN,-138.59031295031454,-140.0736183485496,-0.18090262870143003,-0.32756826296135344,-0.1466656342599234,-11703011,-14329935.2,48.59413266097144,46.57765769064009,NaN,NaN,-12.765730929912825,-3.334931258475117
2008-06-13T09:30:00-04:00,31.14999,32.19,31.14,31.72,2829481,4559564.2,47.89297275020905,45.13360088907795,NaN,NaN,-49.68300491024009,-125.41443823988857,-0.11872199610693732,-0.29506812939359506,-0.17634613328665774,-8873530,-13754751.6,50.34973204339789,46.93354413185871,NaN,NaN,-11.427222844039528,-4.490972913555747
2008-06-16T09:30:00-04:00,31.53999,31.78999,31.34,31.62,4283266,4595277.35,46.978085607841116,45.26891881987277,NaN,NaN,-56.11840250014667,-107.0145932307257,-0.07829882936712457,-0.27421966999556346,-0.1959208406284389,-13156796,-12933351.6,52.827358399745506,47.8227455962575,NaN,NaN,-10.653226792427533,-5.371294896251716
2008-06-17T09:30:00-04:00,31.91,31.91,31.23,31.3,6054578,4713501.75,44.076486813630716,45.196979693938275,NaN,NaN,-63.30403458241557,-93.2325637437222,-0.06749329707901955,-0.2802874619772133,-0.21279416489819378,-19211374,-14316722.6,48.44292733001825,48.58173307971792,NaN,NaN,-10.90052564833008,-6.161185003691482
2008-06-18T09:30:00-04:00,31.08,31.10001,30.50999,30.61,6427270,4765439.25,38.54776157811961,44.24248868476793,NaN,NaN,-158.62041247227705,-93.26323348307878,-0.09927667287015371,-0.3368900059858859,-0.2376133331157322,-25638644,-15716671,44.42467965941608,48.96707797675073,NaN,NaN,-12.915959021936697,-7.126152720583656
2008-06-19T09:30:00-04:00,30.58,31.09,30.52,31,3948885,4685089.95,42.90691119310301,43.789278937523,NaN,NaN,-122.95121659115772,-90.13541421124742,-0.08693846554043583,-0.346286415041277,-0.25934794950084117,-21689759,-17714020.6,39.40286310273012,48.89427457908694,NaN,NaN,-13.185831045385003,-7.991821052698134
2008-06-20T09:30:00-04:00,30.56,30.60001,29.88,29.98,7441211,4900502.15,35.76187274847361,43.05770260938521,NaN,NaN,-190.75513365635186,-118.34983996046977,-0.13737724953791525,-0.43106951142323524,-0.29369226188532,-29130970,-21765508.6,31.59978692243287,48.185354981498676,NaN,NaN,-15.926941924124332,-9.125409748616162
2008-06-23T09:30:00-04:00,30.25999,30.25999,29.42,29.46001,4620656,4948159.7,32.76627248342545,42.07822535377837,NaN,NaN,-198.6251571674989,-146.8511908939402,-0.19229677047784344,-0.5340632249826243,-0.3417664545047808,-33751626,-25884474.6,25.969186101909244,47.032403949987376,NaN,NaN,-19.213214012139062,-10.566524643405147
2008-06-24T09:30:00-04:00,29.50999,29.7795,29.03,29.58,4220145,4901351.9,34.13727436622537,41.03201030119684,NaN,NaN,-184.5094311358341,-171.0922702046239,-0.2058654467615365,-0.5990982629567014,-0.3932328161951649,-29531481,-27948496,23.69111747342197,45.37832097645013,NaN,NaN,-21.329424933730902,-12.104081827737398
2008-06-25T09:30:00-04:00,29.78,30.27,29.47,29.8,6663398,5069196.4,36.68650687077199,39.82765507371431,NaN,NaN,-127.37373995517005,-164.84293570120252,-0.1859533087278501,-0.6256744521049775,-0.4397211433771274,-22868083,-27394383.8,25.57856422795851,43.55123832220553,NaN,NaN,-22.24424883025114,-13.55267711381079
2008-06-26T09:30:00-04:00,29.22,29.52,28.58,29.10001,4583254,5111331.3,32.39070723329334,39.2635003166203,NaN,NaN,-167.24961809102055,-173.70261600117507,-0.20438765942069786,-0.6952057176529998,-0.4908180582323019,-27451337,-28546699.4,24.236047157624995,41.44589528307637,NaN,NaN,-24.440620886628537,-15.108097652784753
2008-06-27T09:30:00-04:00,28.28,28.92999,28.28,28.61,9620148,5447496.1,29.763360391754077,38.52274519642874,NaN,NaN,-174.94173787875263,-170.53993684565523,-0.23202421336013523,-0.7808483249324709,-0.5488241115723357,-37071485,-30134802.4,22.48451136898072,39.08571936595222,NaN,NaN,-27.138192489863265,-16.826682629510255
2008-06-30T09:30:00-04:00,29.33,29.33,28.21001,28.48,4844762,5479152.95,29.089217272675924,37.63006014073698,NaN,NaN,-142.88701950818242,-159.39230931379194,-0.2404759489265682,-0.8494190477305459,-0.6089430988039777,-41916247,-31767726.6,20.8184973597004,36.45307630770534,NaN,NaN,-29.501547951583397,-18.637377675520703
2008-07-01T09:30:00-04:00,27.99001,28.75,27.67,28.12,8133672,5672034.8,27.248621139024152,36.97926141852664,NaN,NaN,-147.96959668234894,-152.0843424230949,-0.25058992741145025,-0.9221805080682905,-0.6715905806568403,-50049919,-35871414.2,17.34103018464198,33.982888142353524,NaN,NaN,-32.05327618826835,-20.553934605913224
2008-07-02T09:30:00-04:00,28.31,28.60001,27.74001,27.81,15300148,6107321.7,25.738362726987518,35.99888665539527,NaN,NaN,-135.15545345386153,-153.6406851228332,-0.2574535477653027,-0.9934075153634687,-0.735953967598166,-65350067,-44367811,12.635162836308837,31.414390297734762,NaN,NaN,-34.64769506594883,-22.56732895734688
2008-07-03T09:30:00-04:00,27.96001,28.60001,27.59,28.05,3366075,6088195.35,29.018457533987714,34.65070699709374,NaN,NaN,-119.42502626466009,-144.0757667575611,-0.22623360047940744,-1.0187459681974254,-0.7925123677180179,-61983992,-51274342,10.209731565416874,28.547247406450406,NaN,NaN,-35.841859580008766,-24.463690474870006
2008-07-07T09:30:00-04:00,27.97,28.25,27.12,27.73,5676445,6088864.65,27.287789947401095,33.24425730706231,NaN,NaN,-125.18963158460056,-134.1253454987307,-0.20800247162352448,-1.0525154572474236,-0.8445129856238991,-67660437,-57392132.4,8.629523553838212,25.39025920317132,NaN,NaN,-37.36320127326844,-26.306477731784067
2008-07-08T09:30:00-04:00,27.53999,28.45,27.53999,28.45,4820547,6054174.6,36.46885787036984,32.70085523968653,NaN,NaN,-90.19578606080445,-123.5870988092551,-0.13202373834670433,-1.0095426585572795,-0.8775189202105752,-62839890,-61576861,7.746334698546434,22.483359729494758,NaN,NaN,-35.869875234466285,-27.672677375024385
2008-07-09T09:30:00-04:00,28.42,28.42999,27.5,27.85001,6395891,6125505.3,32.75703963844819,32.28723224399572,NaN,NaN,-92.29990930640588,-112.45316133406648,-0.10777062538045457,-1.0122322019361434,-0.9044615765556888,-69235781,-65414033.4,7.0353189039359165,19.812691104103315,NaN,NaN,-35.74402536329767,-28.825727087634856
2008-07-10T09:30:00-04:00,27.63,27.88,26.91,27.36,4946695,6055620.9,30.065626257984462,31.369997605772966,NaN,NaN,-109.74685875117721,-107.3714423935296,-0.10994521966947635,-1.0418931011425343,-0.931947881473058,-74182476,-67180515.2,6.729106397452284,17.478851339440613,NaN,NaN,-36.493321379632384,-29.92109770077736
2008-07-11T09:30:00-04:00,26.75,27.25,26.31,26.78999,7846785,6101165.6,27.259800784846334,30.762706751228162,NaN,NaN,-127.45362060850933,-108.97716126229943,-0.13342501876050739,-1.0987291549236922,-0.9653041361631848,-82029261,-71189569,6.082097955929839,15.656159270404684,NaN,NaN,-38.03893535025607,-31.080788793560032
2008-07-14T09:30:00-04:00,26.91,27.17999,26.53,26.64999,4425715,6180977.3,26.60312161089945,30.322481688904876,NaN,NaN,-118.25548469131785,-107.5903318836429,-0.1412813213790618,-1.141905787887012,-1.0006244665079502,-86454976,-74948476.8,5.543865695720953,14.197207812819803,NaN,NaN,-39.47813067606911,-32.2804090624899
2008-07-15T09:30:00-04:00,26.28999,27.13499,25.92999,26.64999,6723852,6303006.6,26.60312161089945,29.784327920667312,NaN,NaN,-122.48437956578869,-114.04805058463975,-0.1296767970767294,-1.162720462853862,-1.0330436657771327,-86454976,-79671494,4.951005539995279,12.85862838900361,NaN,NaN,-40.627099494660406,-33.47279340994283
2008-07-16T09:30:00-04:00,26.62,27.94,26.53,27.72,7217055,6361130.45,39.5178910969184,29.986569651106347,NaN,NaN,-70.01804895766742,-109.59167851489205,-0.03790183370575706,-1.080420957909329,-1.0425191242035718,-79237921,-81671922,4.720735562926606,11.36878348435847,NaN,NaN,-37.53298622774198,-34.05282095534271
2008-07-17T09:30:00-04:00,28,28.69,27.49001,27.85001,10352422,6557388.05,40.87909672275967,30.592883186068224,NaN,NaN,-25.47933784192123,-92.73817433304086,0.03940919444025859,-0.9932576311532486,-1.0326668255935072,-68885499,-80612526.6,7.182760208837209,10.15069155944506,NaN,NaN,-34.632884971159264,-34.135687243316504
2008-07-18T09:30:00-04:00,28.59,28.84,28.17,28.71001,7046246,6712256.1,49.04801082619905,31.970358217100006,NaN,NaN,26.3094141736816,-61.985567376602695,0.15009817123889913,-0.8450441115448832,-0.9951422827837824,-61839253,-76574525,16.083654623487305,9.69348750619553,NaN,NaN,-29.321492711287476,-33.447945167312355
2008-07-21T09:30:00-04:00,28.7,28.73,28.05,28.2,5850672,6632729.15,45.07075921718978,33.11189692742242,NaN,NaN,15.53191860672132,-35.228086716994845,0.18813235884520396,-0.7599768342272775,-0.9481091930724814,-67689925,-72821514.8,23.4329369348891,9.880233190137579,NaN,NaN,-26.153657798744035,-32.40590411465974
2008-07-22T09:30:00-04:00,28.06,28.95,27.89999,28.95,6624828,6732937.75,51.32194159800353,34.83141981734953,NaN,NaN,51.21043184694241,-0.4891244344486296,0.2586162200659077,-0.6248389179900968,-0.8834551380560045,-61065097,-67743539,32.09808444644965,10.934308494552413,NaN,NaN,-21.30361807095852,-30.81986325127385
2008-07-23T09:30:00-04:00,28.81,29.85001,28.67,29.50999,9130320,6978446.5,55.40295781883713,36.95031946676736,NaN,NaN,130.5193783424805,39.61836102558095,0.3330285945990177,-0.4671693948072324,-0.8001979894062501,-51934777,-62282910.2,39.966132531395886,12.88652061563006,NaN,NaN,-15.89089946244348,-28.6871541385838
2008-07-24T09:30:00-04:00,29.5,29.5,28.52,28.88,8903262,7090439.7,50.294459162948165,38.470033868835955,NaN,NaN,102.28028297157893,65.17028518828099,0.32930168241315416,-0.3885708863898074,-0.7178725688029616,-60838039,-60673418.2,42.095866684182944,15.164101695541921,NaN,NaN,-13.061655937502204,-26.45494010985786
2008-07-25T09:30:00-04:00,28.78,29.00999,28.31,28.42999,9376801,7330117.05,46.96332330010464,39.87542910831478,NaN,NaN,64.00908385023031,72.71021912359073,0.2875293080053962,-0.35846093379621635,-0.6459902418016126,-70214840,-62348535.6,40.48605296940453,17.439568082368087,NaN,NaN,-11.844904607740412,-24.367792180983937
2008-07-28T09:30:00-04:00,28.46001,28.46001,27.71001,27.75999,5886453,7143432.3,42.454781174557915,40.30299505861393,NaN,NaN,-3.1823299793175246,68.96736940638297,0.2094059665146828,-0.3842327836582591,-0.5936387501729419,-76101293,-64030809.2,38.87808605820724,19.663264608058146,NaN,NaN,-12.323880718654808,-22.647233400651203
2008-07-29T09:30:00-04:00,27.85001,28.75,27.78,28.75,11027891,7452588.75,50.0807469305379,41.540402722334626,NaN,NaN,53.84070749551001,69.49342453609646,0.2180545793030767,-0.321070526044096,-0.5391251053471727,-65073402,-64832470.2,38.101494808335936,21.88227717265815,NaN,NaN,-10.093282542714359,-20.853811849517367
2008-07-30T09:30:00-04:00,28.89,29.17,28.33,28.72,7027867,7397298.5,49.865097342539414,42.954650656945695,NaN,NaN,85.39115062833515,60.46777899326738,0.21504515164319404,-0.2703186657931802,-0.48536381743637425,-72101269,-68865768.6,34.38053848722238,23.857379464784582,NaN,NaN,-8.450440006992103,-19.081901586299473
2008-07-31T09:30:00-04:00,28.39999,29.00999,28.39999,28.53,7152441,6989913.15,48.44237455335022,44.46769164041026,NaN,NaN,67.58966240926789,53.529654880805175,0.19418549164429788,-0.24263195288100192,-0.4368174445252998,-79253710,-72548902.8,31.36794522069208,25.663511412267603,NaN,NaN,-7.565305583873393,-17.43667358595289
2008-08-01T09:30:00-04:00,28.61,28.78999,27.97,28.25,8555367,7249377.75,46.34389259523456,45.87774671071991,NaN,NaN,30.51901029801217,46.83164017036155,0.1570449719191374,-0.24051122962637805,-0.39755620154551546,-87809077,-76067750.2,28.77380911564684,27.32279308511945,NaN,NaN,-7.462857541945287,-16.01184272252323
2008-08-04T09:30:00-04:00,28.44,28.67999,28.13,28.46001,6483785,7289744.75,48.157859535720355,47.41737084820712,NaN,NaN,36.552265611332444,54.77855928849154,0.1425602483353709,-0.21935589112630183,-0.3619161394616727,-81325292,-77112550,28.032522435557283,28.97147286337388,NaN,NaN,-6.852506576099671,-14.703366130177008
2008-08-05T09:30:00-04:00,29.12,29.75999,28.84,29.73,8630637,7480249.25,57.51231097102013,48.7026865535001,NaN,NaN,132.14522630725327,70.4394630508402,0.21035557565297114,-0.0989716698954588,-0.30932724554842994,-72694655,-78636800.6,26.942019203947325,30.558707409161077,NaN,NaN,-3.230059050561713,-13.064322261660537
2008-08-06T09:30:00-04:00,30,30,29.11,29.58,5039711,7412440.25,56.22193336506129,49.79860345652164,NaN,NaN,129.3336369496435,79.22796031510187,0.23506861440970306,-0.01549147753630109,-0.25056009194600415,-77734366,-79763420,26.132817934579265,31.912282960999793,NaN,NaN,-0.735389040580144,-11.303046087220482
2008-08-07T09:30:00-04:00,29.38,29.38,28.97,29,8089746,7569592.8,51.41804429239152,49.96789156124968,NaN,NaN,81.06114796617078,81.92225742648245,0.2035056466477907,0.0038219663637342194,-0.19968368028405648,-85824112,-81077500.4,25.182740928572954,32.56221769707734,NaN,NaN,-0.09707493742472781,-9.702193065821088
2008-08-08T09:30:00-04:00,29.14,30.61,29.03999,30.38,14209195,7887713.3,60.14406060306054,51.044555945954734,NaN,NaN,163.91071810645514,108.60059898817103,0.26294334172177647,0.12899549686816414,-0.13394784485361233,-71614917,-77838668.4,31.767156066569427,33.157519063625934,NaN,NaN,3.502824605118627,-7.815761969972558
2008-08-11T09:30:00-04:00,30.58,31.94,30.278,31.31,10754328,8204143.95,64.7403519084751,52.00301382527413,NaN,NaN,246.43516068617166,150.5771780031389,0.346985417311885,0.2997839267862439,-0.047201490525641085,-60860589,-73745727.8,39.065290511575974,33.65517663970639,NaN,NaN,8.173491428256815,-5.531582913082648
2008-08-12T09:30:00-04:00,31.23,31.28,30.71001,30.89999,7795293,8257716,61.379612620220506,52.429917739658656,NaN,NaN,189.91823170190756,162.13177908206973,0.35573625982176243,0.397468834251562,0.04173257442979954,-68655882,-72937973.2,40.4196992867763,33.6875742650907,NaN,NaN,10.746638271767003,-3.2061227438184123
2008-08-13T09:30:00-04:00,30.64999,30.75999,29.95,30.39999,9726746,8383200.55,57.46217519707102,52.94189745638172,NaN,NaN,117.06273883855177,159.6775994598514,0.31028353598494635,0.42958699441098247,0.11930345842603612,-78382628,-73067625.6,40.2649963770515,33.556797814581316,NaN,NaN,11.542864636334835,-1.099124546653663
2008-08-14T09:30:00-04:00,30.03999,31.28,30.00999,30.86,6495512,8190355.05,59.99208914978456,53.872523588501714,NaN,NaN,127.27655169239235,168.92068020509572,0.2937981702493737,0.48655117123775327,0.19275300098837955,-71887116,-70280226.4,45.12753607265556,33.88833232195638,NaN,NaN,13.008785132954515,0.9162911218617906
2008-08-15T09:30:00-04:00,30.96001,31.44,30.96001,31.22,6855734,8180829.45,61.90174650751991,55.26159254085614,NaN,NaN,142.93072652711422,164.72468188922753,0.2892811434756505,0.5543544303329426,0.26507328685729215,-65031382,-68963519.4,47.309469487909574,34.49057399550655,NaN,NaN,14.803675735761,2.9002032095616777
2008-08-18T09:30:00-04:00,31.49001,31.49001,30.55,30.69,7870770,8281834.35,57.54674422616313,55.79487806197223,NaN,NaN,104.96233240323637,136.43011623264047,0.23504537866620767,0.5588800101900517,0.32383463152384406,-72902152,-71371832,43.873144787452844,34.90283470830062,NaN,NaN,14.949116306889659,4.621476509179961
2008-08-19T09:30:00-04:00,30.55,30.55,29.89101,30.12,7651316,8333158.75,53.210936117997996,56.033866545933556,NaN,NaN,46.25128076094356,107.69672604444767,0.14940157796417886,0.5105866039790676,0.3611850260148888,-80553468,-73751349.2,40.725584105865686,35.35605225248942,NaN,NaN,13.708690875113403,5.919649990027596
2008-08-20T09:30:00-04:00,30.13,30.27,29.64,29.75,5454313,8149358.4,50.54855868248406,56.18430826944312,NaN,NaN,22.08077073650045,88.7003324240374,0.060984434738439564,0.43741556943793825,0.3764311346994987,-86007781,-75276379.8,38.804139804112054,35.88720900844799,NaN,NaN,11.86049890841768,6.76834269265475
2008-08-21T09:30:00-04:00,29.60001,30.07001,29.41,29.99001,5325191,7970454.85,52.21864709631542,56.60393359094889,NaN,NaN,14.674134747806441,66.17984903512023,0.014254404140467025,0.3942491398750825,0.37999473573461545,-80682590,-77035474.6,36.65582067583064,36.4502098341754,NaN,NaN,10.828705116986423,7.348394467559275
2008-08-22T09:30:00-04:00,30.14,30.69,30.05,30.69,3623372,7682783.4,56.80093181366829,57.2212958965166,NaN,NaN,57.282055538800925,49.050114837457556,0.02542507387810311,0.41177607808224437,0.38635100420414126,-77059218,-79441041.8,33.892464789211616,36.868777145150716,NaN,NaN,11.306980795739168,7.913906800156402
2008-08-25T09:30:00-04:00,30.44,30.53,29.8,29.83,9003285,7838625,50.40519968035548,56.71364509004055,NaN,NaN,19.382394047545603,31.934127166319392,-0.02731167036842297,0.3522114162436125,0.3795230866120355,-86062503,-82073112,31.12742300420507,37.16773455945484,NaN,NaN,9.700092622302881,8.169076203320184
2008-08-26T09:30:00-04:00,29.86,30.11,29.62,30.06,4056141,7490037.5,51.96304503648192,56.40943878085632,NaN,NaN,2.9079652658270994,23.2654640672961,-0.04771629394852245,0.3198777191763824,0.36759401312490486,-82006362,-82363690.8,30.8284026790667,37.50313346977537,NaN,NaN,8.865042409043584,8.268499946994956
2008-08-27T09:30:00-04:00,30,30.32001,29.60001,30.14999,3233891,7300338.7,52.59053153177826,56.49318786938395,NaN,NaN,6.174589553731372,20.084227830742286,-0.05561248261225038,0.2980784098595919,0.35369089247184227,-78772471,-80916628.8,34.21743894193908,38.14846904215867,NaN,NaN,8.368294273355003,8.282756279332105
2008-08-28T09:30:00-04:00,30.32001,30.86,30.16,30.85001,3596506,7122541.95,57.2667589686584,56.287666324069505,NaN,NaN,61.63482067924606,29.476365017030208,-0.01619725378565401,0.33344432523977474,0.34964157902542875,-75175965,-79815303.8,36.75708577559251,38.504892592803174,NaN,NaN,9.32104176832793,8.43108277776008
2008-08-29T09:30:00-04:00,30.64,30.84,30.45,30.5,2974984,6843522.8,54.37864953516797,55.54754472597614,NaN,NaN,51.33242034145565,28.286437977561157,-0.01616790119697825,0.32943170252920595,0.3455996037261842,-78150949,-80033650,36.45657967399354,38.31855610440443,NaN,NaN,9.27165554787803,8.551164602062645
2008-09-02T09:30:00-04:00,31.14999,31.78999,30.88,31.10001,9147688,6976717.95,58.264445128713106,55.32503276229704,NaN,NaN,122.17135447770433,48.844230063592896,0.019838515383106492,0.3703977479550673,0.3505592325719608,-69003261,-76621801.6,44.14135835154088,38.58438889474475,NaN,NaN,10.392542611856426,8.814218603461757
2008-09-03T09:30:00-04:00,31.12,31.39999,30.88,31.25999,7137930,6902082.6,59.26080481427054,55.45350630638272,NaN,NaN,102.08171538930446,68.67898008828837,0.048380240227376414,0.4110345328561813,0.3626542926288049,-61865331,-72593595.4,51.58591971157882,39.39302627578242,NaN,NaN,11.601685976161958,9.212428228133215
2008-09-04T09:30:00-04:00,31.06,31.06,30.21001,30.22,7527574,7026475.75,50.774748820372615,54.795124854281866,NaN,NaN,6.668028854000345,68.77766794834216,-0.0059425138776284525,0.3552261502817693,0.36116866415939775,-69392905,-70717682.2,54.61916122532382,40.07099950097301,NaN,NaN,10.07195294840414,9.335217473886203
2008-09-05T09:30:00-04:00,30.02,30.39999,29.60001,30.28,9137555,7078866.2,51.20884525106642,54.031346193106614,NaN,NaN,-65.34610141248409,43.38148352999614,-0.03914309328806159,0.31223979754932074,0.35138289083738233,-60255350,-67733559.2,59.01780859124537,40.907309436925566,NaN,NaN,8.97264867137146,9.283421930669812
2008-09-08T09:30:00-04:00,31.17,31.64999,30.86,31.64999,11719469,6954379.9,59.90355310206974,54.199689684242806,NaN,NaN,125.84542816836394,58.28408509537779,0.026325442881525385,0.38428969443928906,0.3579642515577637,-48535881,-61810545.6,66.05142756059796,42.491472492150216,NaN,NaN,10.773653859879,9.496312206271124
2008-09-09T09:30:00-04:00,31.75,31.95,30.75,31.05,10073398,6920333.4,55.25915503749907,54.34599103563574,NaN,NaN,103.39204679298011,54.528223558432956,0.024426377933673582,0.38849722397485564,0.36407084604118206,-58609279,-59731749.2,68.11948634763783,44.448179795133946,NaN,NaN,10.759869116745229,9.676820336338853
2008-09-10T09:30:00-04:00,30.97,31.10001,30.45,30.73,7933297,6927233.6,52.90329116113065,54.51418621268192,NaN,NaN,30.992364744900577,40.31035342955218,-0.00178520710860125,0.3618393371554305,0.36362454426403173,-66542576,-60667198.2,66.16618040906114,46.40261126691602,NaN,NaN,10.003819272376296,9.723534470058487
2008-09-11T09:30:00-04:00,30.5,31.24001,30.25,31.2,10967484,6989270.5,55.87857271081601,54.77560947086054,NaN,NaN,47.69616510009895,48.515980678771896,0.00855866913029435,0.37432288067689967,0.3657642115466053,-55575092,-57903635.6,68.9947568652437,48.71253528044552,NaN,NaN,10.297233470297943,9.805491470092695
2008-09-12T09:30:00-04:00,30.97,31.25999,30.64999,31.2,8688824,7098936.1,55.87857271081601,54.70972667779966,NaN,NaN,64.57764549978225,74.50073006122516,0.011258748285882247,0.37983764690395816,0.3685788986180759,-55575092,-56967584,69.91228884637835,51.28537985595743,NaN,NaN,10.53078725969294,9.909105154321301
2008-09-15T09:30:00-04:00,29.8,31.03,29.8,30.14999,11228359,7317567.35,48.01874137909878,54.53926537056704,NaN,NaN,-36.12866781865407,42.105910863821556,-0.05800854524633836,0.29606821706015296,0.3540767623064913,-66803451,-60621098,62.178030093435176,53.503280362331004,NaN,NaN,8.271447305233247,9.675154033023007
2008-09-16T09:30:00-04:00,29.41,30.75999,29.21001,30.35001,10370828,7442570.25,49.47663182006617,54.361664426537345,NaN,NaN,-63.84391074901525,8.658719355422486,-0.0888462802433086,0.2430189120023556,0.3318651922456642,-56432623,-60185766.8,62.70742679277349,55.78035351331006,NaN,NaN,6.873041172457209,9.274852195799323
2008-09-17T09:30:00-04:00,29.97,30.03,28.88,29.14999,9591313,7539570.1,41.88646158506861,53.59708800177237,NaN,NaN,-159.33473987683283,-29.406701568924195,-0.18312533083602234,0.10295852870063626,0.2860838595366586,-66023936,-60082038.8,62.84089052812859,57.824885769466455,NaN,NaN,3.0955617105642106,8.392096412194306
2008-09-18T09:30:00-04:00,29.42999,30.44,28.36,29.89999,17208672,8127288.05,47.32535410843244,52.88698765461337,NaN,NaN,-122.29525871429671,-63.40498633180332,-0.18736280489166734,0.05188035342207442,0.23924315831374177,-48815264,-58730073.2,64.6182472010766,59.814968728429605,NaN,NaN,1.679424056062722,7.433143218461223
2008-09-19T09:30:00-04:00,32.91,34.5,30.2,30.2,9551727,8338614.85,49.36675395933274,52.52899511348228,NaN,NaN,141.39981170681224,-48.040553090397324,-0.1632321005863652,0.035203032580785276,0.19843513316715047,-39263537,-55467762.2,68.52983204585775,62.105915326419904,NaN,NaN,1.185151754095619,6.5405730092661365
2008-09-22T09:30:00-04:00,29.87,31.49001,28.96001,28.96001,8107023,8562797.4,42.103777291694016,51.374661696552344,NaN,NaN,-87.7698956910164,-58.36879866486979,-0.2204929063646563,-0.07718099978866988,0.14331190657598641,-47370560,-51581184,72.4390850223516,64.1271815171921,NaN,NaN,-1.7190407070130975,5.360628192654818
2008-09-23T09:30:00-04:00,28.86,29.39999,28.42,28.55,6659387,8445602.5,40.00780401546597,49.99944735378059,NaN,NaN,-181.83852225847946,-81.96772096676264,-0.27229669523974703,-0.19705896247369736,0.07523773276604966,-54029947,-51100648.8,72.88752706818694,65.64872489980696,NaN,NaN,-4.747406200844152,3.916623279297822
2008-09-24T09:30:00-04:00,28.77,29.19,28.19031,28.45,4653965,8475493.7,39.49143775126363,49.193496563129955,NaN,NaN,-173.63137389981438,-84.82704777135895,-0.29755975821684155,-0.2967119650050023,0.0008477932118392539,-58683912,-49632644,74.26512267529985,67.05200786051954,NaN,NaN,-7.302958457390134,2.3138258883424
2008-09-25T09:30:00-04:00,28.78999,29.16499,28.3,28.96001,6353301,8631464.2,43.49686688054976,48.642640965235906,NaN,NaN,-135.1421480146932,-87.39642563143823,-0.2652556648893463,-0.33072178789984363,-0.06546612301049733,-52330611,-50335713.4,72.36859934719443,68.00563577165876,NaN,NaN,-8.237798426858998,0.806450986170772
2008-09-26T09:30:00-04:00,28.56,29.25,28.3,29.25,4583137,8680795.75,45.69795493932108,47.627955382182435,NaN,NaN,-107.454523626032,-137.1672926980071,-0.211999618280664,-0.3304656458613273,-0.11846602758066332,-47747474,-52032500.8,67.86428703999852,68.13512573447308,NaN,NaN,-8.354886739253685,-0.5023115460327217
2008-09-29T09:30:00-04:00,29.14999,29.14999,26.7905,27.3,10763379,9070215.5,35.643085196169054,46.226807536373144,NaN,NaN,-170.45093925278084,-153.70350141035996,-0.2908708019885519,-0.48205453006635324,-0.19118372807780132,-58510853,-54260559.4,62.37434002644706,67.72475814010231,NaN,NaN,-11.934561783653523,-2.1354901514071214
2008-09-30T09:30:00-04:00,27.89999,28.42,27.2,27.89999,5225242,8874093.2,40.01635827738845,45.30631233039156,NaN,NaN,-140.42858806204933,-145.42151457107394,-0.28502485819737583,-0.5474648008245211,-0.26243994262714526,-53285611,-54111692.2,62.592084661248585,67.46946558668714,NaN,NaN,-13.363778432724866,-3.739531334452513
2008-10-01T09:30:00-04:00,28.85001,28.85001,27.48,27.89999,9123527,8973373.05,40.01635827738845,44.17329701371816,NaN,NaN,-110.43907138378428,-132.7830540678679,-0.26402664497430633,-0.5924732488450282,-0.32844660387072183,-53285611,-53032032,64.20979327811855,67.12768247332106,NaN,NaN,-14.469564764861085,-5.272393253082309
2008-10-02T09:30:00-04:00,27.89999,27.89999,26.61,26.89,7379625,8965975.6,35.32940968611241,42.70549965481076,NaN,NaN,-147.0495924032155,-135.16454294557238,-0.2984854760028256,-0.7015534488742539,-0.40306797287142826,-60665236,-54698957,59.902583753284254,66.41270353810005,NaN,NaN,-16.96242440437804,-6.942397703267414
2008-10-03T09:30:00-04:00,27.25999,27.34,25.91,25.95,7869496,8902572.65,31.617666617048513,41.53399431466431,NaN,NaN,-160.74229973388051,-145.8220981671421,-0.3607504120559139,-0.8540059879413207,-0.49325557588540675,-68534732,-58856408.6,50.7574448974967,65.59694745267588,NaN,NaN,-20.33422554558016,-8.855515966454949
2008-10-06T09:30:00-04:00,25.37,25.73,23.74001,25.22,14042922,9018745.3,29.063932970946894,40.07594439687008,NaN,NaN,-203.73593805692067,-152.47909792797006,-0.42295571264570786,-1.0219502166925416,-0.5989945040468337,-82577654,-63669768.8,42.64080956177134,64.16361765046143,NaN,NaN,-23.988793461650353,-11.017412751482864
2008-10-07T09:30:00-04:00,25.64999,25.64999,23.27,23.60001,9430168,8986583.8,24.36148773677455,38.82416055056336,NaN,NaN,-202.09155890212818,-164.81169209598585,-0.5376958112329547,-1.2711142680880272,-0.7334184568550725,-92007822,-71414211,33.389342395567965,62.05993564099281,NaN,NaN,-28.94522731863573,-13.578529118218988
2008-10-08T09:30:00-04:00,22.92,24.3,22.5,23.14,8986789,9039258.4,23.21296498749456,37.10184704192494,NaN,NaN,-193.85162854747568,-181.4942035287241,-0.6040961066761787,-1.4885385902002959,-0.8844424835241171,-100994611,-80956011,25.92583759504221,59.29619209770465,NaN,NaN,-33.24599383946885,-16.388166935540397
2008-10-09T09:30:00-04:00,23.49001,23.59,21.52,21.67,8969906,8939379.5,19.972528010284094,35.002259474135755,NaN,NaN,-191.64797509196566,-190.41388006647415,-0.6997954818539296,-1.759186835841529,-1.0593913539875994,-109964517,-90815867.2,20.761461823103588,55.88416565322221,NaN,NaN,-38.14259976841219,-19.49594305452208
2008-10-10T09:30:00-04:00,20.60001,22.7,19.55,22.13,17007264,9355301.5,23.568138037511787,33.67828524169416,NaN,NaN,-177.0812706240657,-193.68167424451116,-0.6840791665839365,-1.91449031221752,-1.2304111456335836,-92957253,-95700371.4,18.767046681081112,52.05044862884574,NaN,NaN,-40.77454936185973,-22.535743955570315
2008-10-13T09:30:00-04:00,23.3,23.41,21.88,23,6573527,9122559.9,29.976180556942154,32.96174070894246,NaN,NaN,-118.4366564946844,-176.62181793206395,-0.5716291332774701,-1.9449475622304213,-1.3733184289529512,-86383726,-96461585.8,18.469278184870717,48.16343085146601,NaN,NaN,-40.784715306700555,-25.142739862874635
2008-10-14T09:30:00-04:00,24.85001,24.85001,22.17,23.14,11240602,9166048.6,30.979006630431584,32.35370991459731,NaN,NaN,-88.46631209174205,-153.8967685699867,-0.4497271322735412,-1.9354773442948776,-1.4857502120213364,-75143124,-93088646.2,24.207720676157052,44.58790213724153,NaN,NaN,-40.4737679297322,-27.33288672956857
2008-10-15T09:30:00-04:00,22.74001,22.74001,20.45,20.45,8172977,9095131.8,23.897304361776463,30.953741163256364,NaN,NaN,-125.40234760222283,-140.20691238093613,-0.5078700948571142,-2.1205878305927293,-1.612717735735615,-83316101,-89552944.2,29.786570916769975,41.546328677925494,NaN,NaN,-42.73479860555797,-29.533159854709915
2008-10-16T09:30:00-04:00,20.00999,21.89,19.63,21.8,12908457,8880121.05,32.2657478629029,29.994297800655062,NaN,NaN,-111.81244980799208,-124.23980732414141,-0.41683290189033895,-2.1337588630985387,-1.7169259612081997,-70407644,-81641569.6,40.364188185443666,39.58203590260015,NaN,NaN,-41.502311786513104,-31.243038702110372
2008-10-17T09:30:00-04:00,21.7,22.25999,20.5,22.24001,9712066,8888138,34.78295651918812,29.932860038013565,NaN,NaN,-89.50033144357525,-106.72361948804333,-0.2941881870090308,-2.084661194969488,-1.7904730079604574,-60695578,-75189234.6,47.3329596315948,38.50765158868213,NaN,NaN,-39.67412847397974,-32.44748009809171
2008-10-20T09:30:00-04:00,22.55,22.55,21.59,22.36,7031152,8834344.45,35.48704141160948,29.609337404743638,NaN,NaN,-70.87047808043306,-97.21038380519308,-0.1779141427345936,-2.0128656863786993,-1.8349515436441057,-53664426,-68645374.6,53.294017929722244,37.84350396500167,NaN,NaN,-38.033839198585675,-33.24553139816228
2008-10-21T09:30:00-04:00,22.23,22.57001,21.5,22.11,5372820,8770016.1,34.64773902668156,29.225864601121717,NaN,NaN,-67.35330165468456,-92.98778171778157,-0.09493478402703226,-1.953620023677896,-1.8586852396508637,-59037246,-65424199,55.937742941574804,37.25264322667713,NaN,NaN,-36.974129045103666,-33.778188204868194
2008-10-22T09:30:00-04:00,20.75,21.63,19.81,20.60001,7074309,8891033.3,30.028217800682953,28.847208037876754,NaN,NaN,-95.12072744942851,-86.9314576872227,-0.11736704696537026,-2.0053940483575765,-1.8880270013922062,-66111555,-61983289.8,58.631491935137625,37.16185095395236,NaN,NaN,-37.50959615990615,-34.311246484159334
2008-10-23T09:30:00-04:00,21.47,21.47,19.11,20.60001,9860465,9066391.5,30.028217800682953,28.733675979564932,NaN,NaN,-96.41856584835743,-83.85268089529578,-0.10806179846912323,-2.0231042494786102,-1.915042451009487,-66111555,-61124072,59.300595246813046,37.77207597890354,NaN,NaN,-37.92943456604434,-34.828130495857195
2008-10-24T09:30:00-04:00,18.56,19.89,18.56,19.42,7867191,9230594.2,26.79086662193211,28.571314097492444,NaN,NaN,-122.04845321593322,-90.36230524976736,-0.1544110759499291,-2.1080562959468985,-1.9536452199969694,-73978746,-63780705.6,56.27009682446004,38.74559649766701,NaN,NaN,-39.3086031714519,-35.468198020942154
2008-10-27T09:30:00-04:00,18.86,19.84,18.52,19.13,6460645,9015457.5,26.047632724212534,28.691753025166584,NaN,NaN,-118.41919373689689,-99.87204838106013,-0.17606353334112046,-2.17372463667337,-1.9976611033322496,-80439391,-69135698.6,50.65113454230327,39.97858165100524,NaN,NaN,-40.65163360328937,-36.20868881842033
2008-10-28T09:30:00-04:00,19.05,21.37,18.84,21,7392438,9123817.3,37.993190298544604,29.747483404527298,NaN,NaN,-75.72993733352928,-101.54737551682908,-0.04285400650899085,-2.0512286114684883,-2.0083746049594975,-73046953,-71937640,47.95290907317346,41.55194389944319,NaN,NaN,-37.977561174198236,-36.46138486924574
2008-10-29T09:30:00-04:00,21.49001,22.50999,20.808,21.42999,11380387,9236660.3,40.37804534543518,31.20502035703809,NaN,NaN,-28.628362172384797,-88.24890246142033,0.08863654721951231,-1.897578920935107,-1.9862154681546194,-61666566,-71048642.2,48.88332677064079,43.56064853855298,NaN,NaN,-35.0640227555419,-36.261761710145194
2008-10-30T09:30:00-04:00,22.58,22.58,21.45,22.08,6317578,9183557.95,43.89122038803987,32.65666909636153,NaN,NaN,0.79836944639236,-68.80551540247038,0.22599587157713819,-1.7037206286831967,-1.929716500260335,-55348988,-68896128.8,51.15993146802714,45.87442602333484,NaN,NaN,-31.541989036777434,-35.587508471092654
2008-10-31T09:30:00-04:00,21.78,23.13,21.07001,22.98,5957152,9087940.75,48.42288518602829,33.97429085558197,NaN,NaN,33.96187526396764,-37.60344970649021,0.37527171238195467,-1.4606268597828915,-1.8358985721648462,-49391836,-63978746.8,55.98294815229018,48.55397387815052,NaN,NaN,-27.112916316259884,-34.376852448973686
2008-11-03T09:30:00-05:00,22.67,23.52,22.09,22.32001,3328172,8552203.25,45.519504330041016,35.012897834125496,NaN,NaN,61.63759197861356,-1.592092563388121,0.42378107107186813,-1.306172233325011,-1.729953304396879,-52720008,-58434870.2,60.69543145037602,51.16023893345187,NaN,NaN,-24.29784499060047,-32.936994240634654
2008-11-04T09:30:00-05:00,22.89999,23.39999,22.44,23.2,6641531,8412771.4,49.8381901344582,36.86581824645991,NaN,NaN,95.13014817332684,32.5799245379831,0.5039010533457398,-1.1000769877147043,-1.603978041060444,-46078477,-53041175,64.65964720030692,53.65117295370452,NaN,NaN,-20.54995211467014,-31.167416794068295
2008-11-05T09:30:00-05:00,23.58,23.58,21.83,21.92,5958211,8261342.5,44.333199885938605,37.72777910524817,NaN,NaN,60.89257809307812,50.484112591075686,0.46063993212090426,-1.0281781259093137,-1.488818058030218,-52036688,-51115199.4,65.97914460931176,55.48081269826652,NaN,NaN,-19.024386509053276,-29.432698181923293
2008-11-06T09:30:00-05:00,22.89999,22.89999,20.56,20.75999,8243938,8225044.1,40.019029524422244,38.10178431990776,NaN,NaN,-11.684761669715598,47.9874863678541,0.3489213348707856,-1.052666389441736,-1.4015877243125217,-60280626,-52101527,64.64793210833088,56.717596446604816,NaN,NaN,-19.127150602933405,-27.96047709921045
2008-11-07T09:30:00-05:00,21.97,21.97,20.53,21.12,4601555,7604758.65,41.90840817502102,38.560453374437145,NaN,NaN,-25.236317828600246,36.14784774934053,0.29636025441822755,-1.0311374062897372,-1.3274976607079647,-55679071,-53358974,62.9053959710539,57.40412344955707,NaN,NaN,-18.622160010622036,-26.626431800840678
2008-11-10T09:30:00-05:00,21.82001,21.82001,20.25,20.63,4788313,7515497.95,40.058841060269756,38.94696066255059,NaN,NaN,-42.18705733885242,15.38291788584733,0.22871218072422916,-1.0416074348026783,-1.2703196155269074,-60467384,-54908449.2,60.7330360983358,57.74664438932571,NaN,NaN,-18.768139506618134,-25.503818615951744
2008-11-11T09:30:00-05:00,20.50999,20.52,19.56,19.91,9268297,7416882.7,37.4438482104026,39.47664854895913,NaN,NaN,-100.95237648617031,-23.833587046052102,0.1399547517546602,-1.0953761758335823,-1.2353309275882425,-69735681,-59639890,54.53937430142572,57.454350272632006,NaN,NaN,-19.685573795245475,-24.672640784422278
2008-11-12T09:30:00-05:00,19.82001,19.82001,18.69,18.7,6273906,7321929.15,33.48751710276254,39.723741356250535,NaN,NaN,-146.1972811777584,-65.25155890021941,0.011029558485974533,-1.2215439794807743,-1.2325735379667488,-76009587,-64434469.8,49.07744285532834,56.72412510181167,NaN,NaN,-21.737682257312724,-24.253360994835198
2008-11-13T09:30:00-05:00,19.08,20.16,17.81,20.16,13243422,7338677.4,41.51710385944808,40.77561544464453,NaN,NaN,-108.2693092616243,-84.56846841860116,0.03405448420175938,-1.1900054327145497,-1.224059916916309,-62766165,-64931577.6,48.53472590644394,56.17159860766766,NaN,NaN,-20.938117427058547,-23.779754770867104
2008-11-14T09:30:00-05:00,19.98,20.24001,19.09,19.17999,10408242,7373486.2,38.18481204244109,41.642556824518,NaN,NaN,-89.17358130533809,-97.35592111394871,-0.004681558868632418,-1.2299118655020997,-1.2252303066334673,-73174407,-68430644.8,44.78092760809233,55.75229811236688,NaN,NaN,-21.35376026819783,-23.433184127628635
2008-11-17T09:30:00-05:00,18.73,19.34,18.56,18.63,8913258,7467591.5,36.418191327176515,41.530056897991706,NaN,NaN,-114.77651878226847,-111.87381340263191,-0.05264403126486128,-1.291035345714544,-1.2383913144496828,-82087665,-72754701,40.60178484524661,55.22721781037211,NaN,NaN,-22.25132738255458,-23.264347449760912
2008-11-18T09:30:00-05:00,18.39,18.97,17.95,18.53999,8277695,7612835.25,36.12363742002667,41.22617061760538,NaN,NaN,-120.83156826139415,-115.8496517576767,-0.07440034336075274,-1.3313917436506237,-1.256991400289871,-90365360,-76880636.8,37.04886918558952,54.38189941143987,NaN,NaN,-23.055176612596235,-23.23446590159453
2008-11-19T09:30:00-05:00,18.21001,18.78,17.28999,17.35001,7774652,7647852.4,32.393399553344665,40.404897700841445,NaN,NaN,-136.50027724110979,-113.91025097034694,-0.14861858228477076,-1.4427646281458344,-1.2941460458610636,-98140012,-81306721.8,33.64735226972866,53.13100089727569,NaN,NaN,-24.916252024161214,-23.474721061961198
2008-11-20T09:30:00-05:00,17.25999,17.88,16.28999,16.33,16473512,7978504.75,29.574308511471386,39.05857079551595,NaN,NaN,-156.74151176787254,-123.60469147159661,-0.24064247773345793,-1.5949491430278862,-1.3543066652944282,-114613524,-91676193.6,27.31907810463521,51.08358160815749,NaN,NaN,-27.402709322315282,-24.03586224201178
2008-11-21T09:30:00-05:00,16.55,17.52,16.12,17.45,20129936,8591642,36.14547579768918,38.388997328919395,NaN,NaN,-132.70813920244834,-132.31160305101864,-0.20188365744705727,-1.6066612371032498,-1.4047775796561925,-94483588,-95938029.8,25.219662307660897,48.549598097963546,NaN,NaN,-27.465514671175384,-24.52581258903515
2008-11-24T09:30:00-05:00,17.94,19.24001,17.50999,18.82001,13785941,8957906.8,43.13498899094265,37.91019724723971,NaN,NaN,-67.63570117509236,-122.88343952958344,-0.06676937820222828,-1.488239302408978,-1.4214699242067497,-80697647,-95660026.2,25.621194131790844,45.76113716449811,NaN,NaN,-25.23291914335475,-24.62682781108081
2008-11-25T09:30:00-05:00,19.28999,19.39,18.5,19.06,10417602,9109165,44.28546575575282,37.90678766651215,NaN,NaN,-44.76185753362579,-107.66949738402975,0.04969266667026151,-1.3593540908689228,-1.4090467575391843,-70280045,-91642963.2,31.356722933280082,43.28810704478156,NaN,NaN,-23.09812937813661,-24.408442320660207
2008-11-26T09:30:00-05:00,19.06,20.39999,18.78999,20.17999,7079473,8894119.3,49.427692009135036,38.57883498684878,NaN,NaN,-9.389477127044266,-82.24733736121667,0.20440500407579032,-1.1535405024444465,-1.3579455065202368,-63200572,-84655075.2,40.02122885873216,41.52905681266737,NaN,NaN,-19.63011532763307,-23.725824178799186
2008-11-28T09:30:00-05:00,20.19,20.63,20.07001,20.49001,1486440,8652562.4,50.781846588968754,39.21265201641648,NaN,NaN,20.624954538875645,-46.77404409986702,0.3228253339193419,-0.9544138391210595,-1.2772391730404014,-61714132,-74075196.8,50.25849784641812,40.62570694662196,NaN,NaN,-16.40782704759653,-22.680396017198806
2008-12-01T09:30:00-05:00,19.98,20.14,18.7,18.7,6955867,8702498.15,43.53363548217682,39.46085161798127,NaN,NaN,-28.476308023247427,-25.92767786402685,0.2775359543614926,-0.9303192300885357,-1.2078551844500283,-68669999,-68912479,54.35282766931198,40.16997777312026,NaN,NaN,-15.804706388952617,-21.698154641735066
2008-12-02T09:30:00-05:00,19.08,19.67,18.73,19.57001,7690727,8920625.9,47.4589508615252,40.17621609306145,NaN,NaN,-15.292483744122363,-15.459034377832841,0.30113434617705304,-0.8314372517287119,-1.132571597905765,-60979272,-64968804,57.24770880909185,40.36343023795355,NaN,NaN,-14.046842549958432,-20.605110057195546
2008-12-03T09:30:00-05:00,19.23,20.44,19,20.27,10397996,9108449.15,50.44388177300089,41.387384998078474,NaN,NaN,28.78576210782684,-0.7495104495423138,0.3551365665276609,-0.6886508897461887,-1.0437874562738496,-50581276,-61029050.2,59.97834916788507,41.14206640313618,NaN,NaN,-11.655576414492105,-19.326605251095053
2008-12-04T09:30:00-05:00,19.87,21.13,19.86,20.49001,11895422,9405309.7,51.37884828020898,42.09179531384711,NaN,NaN,80.49896983026466,17.228178941919474,0.39392380160772034,-0.5513827042641992,-0.9453065058719196,-38685854,-56126106.6,63.13409828217131,42.18487871568813,NaN,NaN,-9.447704337392771,-17.91533369199473
2008-12-05T09:30:00-05:00,20.2,21.21001,19.57001,21.09,10934566,9539841.1,53.93148638436568,43.21655776684172,NaN,NaN,96.33113065900537,32.36941416594542,0.44449289159866556,-0.38969039137358763,-0.8341832829722532,-27751288,-49333537.8,67.01462540023857,43.772999986555725,NaN,NaN,-6.832665306460618,-16.332095351204142
2008-12-08T09:30:00-05:00,21.84,22.215,21.49001,21.88,12449461,9932236.4,57.12340669482387,44.69550172167367,NaN,NaN,178.73117159128753,73.81091008885241,0.5109086098268805,-0.19554752068865255,-0.706456130515533,-15301827,-38659903.4,72.00184250450411,46.015861247931255,NaN,NaN,-3.63936919766056,-14.518848757840773
2008-12-09T09:30:00-05:00,21.63,22.16,20.67999,21.44,10670285,10226335,54.84417428924273,46.032682926617674,NaN,NaN,141.96659318071858,105.2627254738206,0.5041148753740112,-0.07631253629801904,-0.5804274116720303,-25972112,-31658471.4,74.70364746362071,48.705488267790635,NaN,NaN,-1.625457420437049,-12.676935709640242
2008-12-10T09:30:00-05:00,21.52,21.95,21.28,21.94,7411727,10133506.5,56.946430694515634,47.78647086527275,NaN,NaN,142.5314966326071,128.01187237877667,0.510630637285229,0.05786088493450592,-0.45276975235072303,-18560385,-25254293.2,76.8995183167287,51.79492869971921,NaN,NaN,0.6809703433065686,-10.768663416362127
2008-12-11T09:30:00-05:00,21.45,21.75999,20.84,21.00999,8596875,10249654.95,52.08886085356297,49.39465317542214,NaN,NaN,96.35413832241264,131.18290607720624,0.4327232387152641,0.0881342960433571,-0.344588942671907,-27157260,-22948574.4,77.65169705823723,55.39011576783364,NaN,NaN,1.2906695200079887,-9.045901568309255
2008-12-12T09:30:00-05:00,20.57001,21.19,20.24001,20.94,7666594,9970813.55,51.73122719568257,50.507921132421664,NaN,NaN,64.91331341913713,124.89934262923259,0.3598832767175355,0.1052651532250124,-0.2546181234925231,-34823854,-24363087.6,76.0164147097843,59.018455225128164,NaN,NaN,1.6891820470049335,-7.512318194692942
2008-12-15T09:30:00-05:00,21.22,21.28,20.46001,20.87,6277723,9764287.6,51.35148117678356,51.094813431410294,NaN,NaN,63.0062852854001,101.7543653680551,0.29321699199979284,0.11190311650721796,-0.18131387549257488,-41101577,-29523037.6,70.20807467703133,62.20323240693106,NaN,NaN,1.9183491139918174,-6.165080007737977
2008-12-16T09:30:00-05:00,20.95,22.08,20.89999,21.98,12334820,9935365.7,56.77060670497663,51.986609213497715,NaN,NaN,95.30307761547485,92.42166225500637,0.30855154787123895,0.20437555934647378,-0.10417598852476515,-28766757,-30081966.6,69.58781480788126,64.93402468368829,NaN,NaN,3.651227778020764,-4.762750324058157
2008-12-17T09:30:00-05:00,21.81,22.3,21.49001,22.10001,7894340,9916197.95,57.32411139129152,52.550639169366036,NaN,NaN,101.29631445265852,84.17462581901665,0.31059667885176856,0.2840698600399456,-0.026526818811822978,-20872417,-30544373,69.04435594132863,67.00710518958803,NaN,NaN,5.2405686768049735,-3.3337047525062813
2008-12-18T09:30:00-05:00,22.19,22.21001,21.33,21.48,11799344,10117432.55,53.51205158774734,52.745653812135934,NaN,NaN,80.29258820033928,80.96231579460198,0.25627078638749956,0.29381166417255145,0.0375408777850519,-32671761,-31647273.2,67.6865646627016,68.25196710503685,NaN,NaN,5.5862788014657045,-2.0594213876531406
2008-12-19T09:30:00-05:00,21.98,21.98,21.14,21.23,11576289,9872571.4,52.01016680008127,53.3511203348434,NaN,NaN,64.45494914108501,80.87064293899155,0.19248956239723874,0.27815283078160036,0.0856632683843616,-44248050,-33532112.4,65.32233687027147,69.03550347653396,NaN,NaN,5.4725617647044995,-0.9834237944591921
2008-12-22T09:30:00-05:00,21.27,21.33,20.3,20.66,5459516,9139050.4,48.657038151407264,53.43669799840641,NaN,NaN,10.537694522662845,70.37692478644409,0.10526506187075638,0.21724459572280708,0.1119795338520507,-49707566,-35253310.2,63.153024173646145,69.45731171685927,NaN,NaN,4.450395254418766,-0.20716393033376956
2008-12-23T09:30:00-05:00,20.74001,20.91,20.34,20.44,3933958,8646451.25,47.38717962483559,53.21836213068031,NaN,NaN,-15.319565425268461,48.25239617829543,0.03001548419960305,0.1494988891015545,0.11948340490195146,-53641524,-40228263.6,57.23637913556195,69.26145671455048,NaN,NaN,3.240247054261976,0.2853233531799083
2008-12-24T09:30:00-05:00,20.47,20.71001,20.47,20.59,1046657,8177904,48.376440600637146,53.00390443928233,NaN,NaN,-22.720756378430853,23.44898201207756,-0.01023961236054921,0.10668388945126495,0.11692350181181416,-52594867,-46572753.6,50.71139707916113,68.37412091433546,NaN,NaN,2.466564766589674,0.5969292693813033
2008-12-26T09:30:00-05:00,20.78999,20.89,20.60001,20.82001,1146844,7881272.55,49.931073022212296,52.718160627699945,NaN,NaN,-9.994507484358241,5.391562875138051,-0.02132121800612405,0.09027197930415909,0.11159319731028314,-51448023,-50328006,47.27601437756292,66.96422012700148,NaN,NaN,2.193616970212816,0.8250275123572337
2008-12-29T09:30:00-05:00,20.56,20.71001,20.21001,20.42,1819907,7897945.9,47.26525444975785,52.01400689590952,NaN,NaN,-45.9199251306539,-16.683411979209723,-0.05369433784118652,0.0444752750088,0.09816961284998652,-53267930,-52131982,45.675252216888936,65.08374939217182,NaN,NaN,1.257108534430258,0.8867533726533801
2008-12-30T09:30:00-05:00,20.60001,21.19,20.53,21.19,2514670,7675886.05,52.52025349779454,51.848012553663224,NaN,NaN,2.1088578898899404,-18.369179305764305,-0.022925828748751292,0.0695123269140474,0.0924381556627987,-50753260,-52341120.8,45.4829769707349,62.99655864267998,NaN,NaN,1.8212360685450897,1.02025090063791
2008-12-31T09:30:00-05:00,21.23,21.63,21.125,21.57001,4189688,7500834.1,54.90839713185677,51.70243872775901,NaN,NaN,52.43121219197274,-4.819023782316063,0.020969695898516938,0.11865027553594487,0.09768057963742793,-46563572,-50925530.4,47.10604289820596,60.86845325564264,NaN,NaN,2.9612859978084725,1.2975416288051331
2009-01-02T09:30:00-05:00,21.62,22.64999,21.48,22.64999,8790594,7420464,60.9238603570568,52.33351012086571,NaN,NaN,147.72077222246682,29.269281937863475,0.11541455961084521,0.24194877915098445,0.12653421954013924,-37772978,-47961152.6,50.43393399568525,58.924327322603226,NaN,NaN,5.801466805682125,1.940959511216132
2009-01-05T09:30:00-05:00,22.32001,22.705,22.14999,22.55,6449961,7148190.95,60.124122431127,52.933002637683174,NaN,NaN,153.92781980794967,62.05374739632506,0.16102583202493087,0.3278165095713028,0.16679067754637195,-44222939,-46516135.8,52.0186785899566,57.2102033140441,NaN,NaN,7.910238900339599,2.7937137096623417
2009-01-06T09:30:00-05:00,22.73,23.10001,22.58,22.92999,7135297,6958227.5,62.15715501589115,53.704836483333715,NaN,NaN,178.84726862055336,107.00718614656651,0.20390232904399402,0.4216685888513645,0.21776625980737047,-37087642,-43280078.2,55.45359020370092,56.15631156594907,NaN,NaN,10.295204132809287,3.865355198683334
2009-01-07T09:30:00-05:00,22.47,22.53999,21.94,22.02,4843703,6577939.6,54.93403661734736,53.573652905645915,NaN,NaN,89.89995082167428,124.56540473292338,0.16002882037847066,0.4178022852804588,0.25777346490198816,-41931345,-41515695.2,57.250537443939265,55.275077468524636,NaN,NaN,10.323386341042209,4.787931076163173
2009-01-08T09:30:00-05:00,21.95,22.19,21.66,22.14999,5392910,6314070.85,55.72552587397569,53.45946822583765,NaN,NaN,63.984233908117574,126.87600907615236,0.13008636656346872,0.4203814231063241,0.29029505654285537,-36538435,-39510667.8,59.26165797123225,54.57631332780347,NaN,NaN,10.570828940842178,5.614059342545888
2009-01-09T09:30:00-05:00,22.24001,22.28,21.47,21.47,4107652,6148867.1,50.708415339825066,53.25920849384319,NaN,NaN,34.56680510376035,104.24521565241105,0.058457736463737475,0.3633672271225272,0.30490949065878975,-40646087,-40085289.6,58.413518498701514,53.91395288751776,NaN,NaN,9.308503642658815,6.141837099704877
2009-01-12T09:30:00-05:00,21.58,21.58,20.83,20.96001,5070316,5972539.15,47.27095506110612,52.92069336963068,NaN,NaN,-34.08863496135104,66.64192469855091,-0.02482832434247889,0.2738740852306911,0.29870240957317,-45716403,-40383982.4,57.94925061535864,53.38730386930969,NaN,NaN,7.197099743953254,6.292588906026074
2009-01-13T09:30:00-05:00,20.92,21.19,20.52,20.69,7976309,5988024.9,45.51187639100715,52.69603895817353,NaN,NaN,-70.30805082455095,16.81086080953005,-0.09568349220600925,0.17909804431565846,0.2747815365216677,-53692712,-43704996.4,52.913625086074624,52.65591822019745,NaN,NaN,4.914953633015591,6.0957838670245765
2009-01-14T09:30:00-05:00,20.19,20.50999,19.78999,19.88,6966965,6022487,40.627583181253684,52.21321064077483,NaN,NaN,-138.1590733214402,-28.800944019092846,-0.18927569046884596,0.038186923435610254,0.2274626139044562,-60659677,-47450662.8,47.86191155873266,51.98631339328107,NaN,NaN,1.3791848803980185,5.421984011792211
2009-01-15T09:30:00-05:00,19.99001,20.72,19.5,20.37,12496809,6030586.45,44.50737146484019,51.93684855964648,NaN,NaN,-108.52543255607885,-63.302877311932136,-0.2088184006616977,-0.03356038692266594,0.17525801373903177,-48162868,-49775549.4,44.99078627075896,51.57769833553806,NaN,NaN,-0.47658919488118473,4.579330696553154
2009-01-16T09:30:00-05:00,20.8,20.8,20.06,20.61,9021859,6086962.4,46.3563894908493,51.68151402169199,NaN,NaN,-72.77344059939347,-84.77092645256289,-0.1964023417278463,-0.0702449134207761,0.1261574283070702,-39141009,-49474533.8,45.44708783329353,51.4470607252331,NaN,NaN,-1.4785695023746595,3.7139163824206096
2009-01-20T09:30:00-05:00,20.61,20.67,19.33,19.39999,11222707,6058130.55,39.25472447230611,51.109333309016854,NaN,NaN,-124.7114964832698,-102.89549875694665,-0.25669462582283936,-0.19471085397147903,0.061983771851360336,-50363716,-50403996.4,44.22716265100781,51.34362575624159,NaN,NaN,-4.6814909447811655,2.5145724785346415
2009-01-21T09:30:00-05:00,19.47,20.05,19.21001,19.99001,11436707,6051151.45,43.77767500789802,50.484863416881396,NaN,NaN,-115.79789020225068,-111.99346663248659,-0.2439397011951549,-0.2429408546425833,0.0009988465525716042,-38927009,-47450855.8,48.918806742229194,51.58904216849118,NaN,NaN,-5.949086780990535,1.3054782986024736
2009-01-22T09:30:00-05:00,19.75,20.16,19.36,19.74001,8734484,6214899.85,42.33917559764748,49.58706187872359,NaN,NaN,-105.42017488074205,-105.44568694434697,-0.23912096156235124,-0.29790235540036747,-0.05878139383801621,-47661493,-44851219,52.69152604614239,51.988005250486644,NaN,NaN,-7.421924589940186,0.05870645738209368
2009-01-23T09:30:00-05:00,19.17999,19.95,19.09,19.67999,8079824,6422193.15,41.98250605865791,48.234108000266524,NaN,NaN,-110.7464162866578,-105.88988369046277,-0.22685999041635366,-0.3423563818584583,-0.11549639144210463,-55741317,-46366908.8,50.35629649598776,51.98245971479396,NaN,NaN,-8.715952782268129,-1.1948162911393667
2009-01-26T09:30:00-05:00,19.56,20.24001,19.53,19.82001,6112598,6675490.2,43.18495255773228,47.02416729502404,NaN,NaN,-81.5616192629575,-107.64751942317557,-0.19729396782833472,-0.36211385122752304,-0.16481988339918832,-49628719,-48464450.8,47.236329733465496,51.64086336790175,NaN,NaN,-9.454437958548182,-2.37476224362634
2009-01-27T09:30:00-05:00,19.89999,20.14,19.6391,19.75999,5022598,6869277.9,42.77569708707068,45.63977744296544,NaN,NaN,-75.70388432941427,-97.84599699240445,-0.17074778661955017,-0.37825461667362603,-0.20750683005407586,-54651317,-49321971,45.98202614034757,50.96432307766222,NaN,NaN,-10.178570423334552,-3.4895919835846563
2009-01-28T09:30:00-05:00,20.67,20.84,20.24001,20.60001,7701059,7163335.5,49.92784731519863,45.28219249281195,NaN,NaN,-24.035340149193015,-79.49348698179293,-0.08965835928078986,-0.3195797791550632,-0.22992141987427334,-46950258,-50926620.8,43.64643975313075,49.99260181403304,NaN,NaN,-8.785503708926203,-4.246150801490591
2009-01-29T09:30:00-05:00,20.24001,20.42999,19.75999,19.77,7172309,7396217.45,44.06714796669872,44.44945121372074,NaN,NaN,-60.53462458763328,-70.51637692317118,-0.08500618728964454,-0.336179153986329,-0.2511729666966845,-54122567,-52218835.6,41.804928227576156,48.74569254662903,NaN,NaN,-9.296638090669232,-4.967648985658968
2009-01-30T09:30:00-05:00,19.92999,20.03999,19.14,19.28,8765273,7624996.7,41.00687140380098,43.75648378971903,NaN,NaN,-87.83820411753004,-65.93473448934563,-0.10661489048733402,-0.38444157980585203,-0.277826689318518,-62887840,-53648140.2,39.80445798362726,47.416473938409446,NaN,NaN,-10.663278027762528,-5.781310277388048
2009-02-02T09:30:00-05:00,18.87,19.32001,18.82001,19.10001,5201863,7445560.15,39.91047006867336,43.23073486168811,NaN,NaN,-109.90479702243259,-71.60337004124065,-0.12352352670586836,-0.43223109770085344,-0.3087075709949851,-68089703,-57340337,35.128135560651174,45.786394291644626,NaN,NaN,-12.108416081147604,-6.685182535067985
2009-02-03T09:30:00-05:00,19.14999,19.78999,18.92999,19.64,6379922,7442058.2,44.68851532634807,43.1719233570696,NaN,NaN,-78.35086362255613,-72.13276589986901,-0.09037089664748066,-0.4216711918043359,-0.3313002951568552,-61709781,-58752029.8,33.507252823907265,44.40022484434696,NaN,NaN,-11.941759460216856,-7.436122095803538
2009-02-04T09:30:00-05:00,19.44,19.78999,19.11,19.21001,6847082,7427647.45,41.835809734927714,43.25822525376061,NaN,NaN,-83.15444446472372,-83.95658676297516,-0.08927463438063998,-0.4428935881326552,-0.35361895375201524,-68556863,-63073350.8,29.08338218540544,43.058901317680736,NaN,NaN,-12.644849296232117,-8.18022598157905
2009-02-05T09:30:00-05:00,19.13,19.72,18.99001,19.57001,6391988,7505061.7,45.00130894194516,43.29350650212525,NaN,NaN,-75.75055631259688,-86.9997731079679,-0.05770935910053926,-0.42575565262768933,-0.36804629352715007,-62164875,-64681812.4,27.621572458051517,41.81824318820163,NaN,NaN,-12.305949379217333,-8.769615038384519
2009-02-06T09:30:00-05:00,19.84,20.34,19.492,20.13,6818449,7576338.65,49.59655913655973,43.524947191104566,NaN,NaN,-4.127544193243831,-70.25764112311064,0.004193025253757754,-0.36280501195995285,-0.3669980372137106,-55346426,-63173529.6,31.11787678094707,40.794728113034026,NaN,NaN,-10.62486800193537,-9.03465117603464
2009-02-09T09:30:00-05:00,20.19,20.2,19.8,20.07001,3994087,7570660.4,49.123053193556494,44.22982781405102,NaN,NaN,15.92537857629679,-45.09160600336476,0.04228986460521089,-0.314135706457197,-0.3564255710624079,-59340513,-61423691.6,35.038506545787,40.13839553408968,NaN,NaN,-9.390731459444911,-9.085519787950393
2009-02-10T09:30:00-05:00,19.92,20.05,19.03,19.12,7616605,7697974.85,42.24475934542857,44.120333838160356,NaN,NaN,-88.35883545201759,-47.09320036925705,0.006573365961291766,-0.3482088636107932,-0.35478222957208494,-66957118,-62473159,33.7960780487644,39.058200627413626,NaN,NaN,-10.35697366448906,-9.267156056027344
2009-02-11T09:30:00-05:00,19.28999,19.42999,19,19.27,5047422,7551530.5,43.587881607817536,44.209527124601074,NaN,NaN,-113.183175636291,-53.0989466035705,-0.003350498713123151,-0.3589703529634889,-0.35561985425036574,-61909696,-61143725.6,36.85082885645261,37.926722256721504,NaN,NaN,-10.748673687060176,-9.478801431889178
2009-02-12T09:30:00-05:00,18.8,19.345,18.64999,19.3,9558328,7681098.65,43.869033717986824,44.34427910026742,NaN,NaN,-123.5494552031906,-62.658726381689235,-0.004238297910982902,-0.3609177266390944,-0.3566794287281115,-52351368,-59181024.2,41.16687720676645,37.27033516463426,NaN,NaN,-10.988952452425824,-9.694537291965842
2009-02-13T09:30:00-05:00,19.19,19.44,18.96001,18.99001,7272332,7419874.8,41.563898896584696,44.22848955304259,NaN,NaN,-104.88444621341745,-82.81010678572396,-0.021103634007956562,-0.3830589712380572,-0.36195533723010065,-59623700,-60036479,39.88725914950904,36.74540155149452,NaN,NaN,-11.839978727696273,-10.001028925641618
2009-02-17T09:30:00-05:00,18.2,18.52,18.03,18.27,4775258,7207544.75,36.735533374248455,43.797049287841,NaN,NaN,-237.56568414479287,-133.50831932994188,-0.0732176909779036,-0.45347745095248015,-0.38025975997457656,-64398958,-61048168,38.36832172416434,36.201565521767144,NaN,NaN,-14.047423950732066,-10.579085357797396
2009-02-18T09:30:00-05:00,18.27,18.37,17.92,18.14999,9847934,7138806.1,35.985171045493885,42.80114384000495,NaN,NaN,-215.02810729943238,-158.84217369942485,-0.1062355821103137,-0.5130542376124687,-0.406818655502155,-74246892,-62506122.8,36.22728930749198,35.67162620422152,NaN,NaN,-16.083238769853818,-11.365392988091171
2009-02-19T09:30:00-05:00,18.28,18.52,17.94,17.96001,9103727,7022157.1,34.77424528878154,42.13736507729657,NaN,NaN,-179.0117815190619,-172.00789487597905,-0.12977670359377252,-0.5690395349943707,-0.43926283140059813,-83350619,-66794307.4,30.785829818579074,34.884547746436006,NaN,NaN,-18.140634751317393,-12.33328466855206
2009-02-20T09:30:00-05:00,17.47,18.08,17.47,17.84,13448551,7257860.45,33.99600087317708,41.63658861082343,NaN,NaN,-183.07105333835514,-183.91221450301194,-0.14138279567284207,-0.6159913259916507,-0.4746085303188087,-96799170,-75683867.8,23.054865758128386,33.68814830175752,NaN,NaN,-20.084145229011103,-13.440550462903353
2009-02-23T09:30:00-05:00,17.94,18.2,17.33,17.44,6824781,7195108.3,31.468121441133007,41.03356370885626,NaN,NaN,-164.09208079288638,-195.75374141890572,-0.16244589971841106,-0.6776659049668226,-0.5152200052484115,-103623951,-84483918,18.186161618730466,32.47800730590604,NaN,NaN,-22.510516476540193,-14.7362598934229
2009-02-24T09:30:00-05:00,17.48,18.35001,17.48,18.2,9550266,7366991.7,40.518173994836694,40.735682185176884,NaN,NaN,-109.95856621078416,-170.232317832104,-0.11393357583924146,-0.6576369750474633,-0.5437033992082219,-94073685,-90418863.4,15.767718361490722,31.210897701447713,NaN,NaN,-22.067740741465894,-15.783614300286185
2009-02-25T09:30:00-05:00,18.13,18.39,17.7,18.03,12043305,7718027.05,39.26898499012278,40.55233756054796,NaN,NaN,-92.30759228756604,-145.68821482973073,-0.08344656750213131,-0.648011608585886,-0.5645650410837547,-106116990,-96792883,13.66581920132252,30.109643202584643,NaN,NaN,-22.058278187280823,-16.679994855571135
2009-02-26T09:30:00-05:00,18.28999,18.39,17.61,17.64999,6604441,7663196.15,36.55588164000787,39.949092753266726,NaN,NaN,-93.6589864283089,-128.61765581158014,-0.07906781306432031,-0.6633998074141552,-0.5843319943498348,-112721431,-102667045.4,12.069078575447762,28.998750782398663,NaN,NaN,-22.835902604072267,-17.559410248214153
2009-02-27T09:30:00-05:00,17.42999,17.91,17.255,17.53,6990984,7654129.9,35.716762817593235,38.9576787304834,NaN,NaN,-108.70904530151284,-113.74525420421166,-0.07450866742722173,-0.677467828633862,-0.6029591612066403,-119712415,-107249694.4,10.990229271357848,27.561061674570862,NaN,NaN,-23.717616787924353,-18.439154039601323
2009-03-02T09:30:00-05:00,17.41,17.47,16.81,16.87,10151637,7723448.1,31.441584878170147,37.694716707955806,NaN,NaN,-135.3905897242878,-108.00495599049195,-0.10436781034265508,-0.7334189241349591,-0.629051113792304,-129864052,-112497714.6,9.898942118043607,25.765378501160622,NaN,NaN,-25.79685938099223,-19.490254802657166
2009-03-03T09:30:00-05:00,17.00999,17.30499,16.61,16.74001,10516238,7989166.85,30.663102315191807,36.86745549151032,NaN,NaN,-130.9581758950448,-112.20487792734407,-0.12017252876702567,-0.7792667747510862,-0.6590942459840605,-140380290,-121759035.6,8.327467535311413,23.946192035913977,NaN,NaN,-27.73827783955779,-20.668543807928682
2009-03-04T09:30:00-05:00,17.14999,17.41,16.78999,17.11,8630324,8101686.95,35.55417349935618,36.293619198048795,NaN,NaN,-104.00960772087726,-114.54528101400633,-0.09415824368696857,-0.7767920505927712,-0.6826338069058027,-131749966,-126885630.8,7.6075175731970575,21.857384087110013,NaN,NaN,-27.998472923305133,-21.715676538696748
2009-03-05T09:30:00-05:00,16.73,17.02,16.23,16.31,10852289,8301947.3,30.53807636121455,35.34140795827935,NaN,NaN,-138.35839008878924,-123.4851617461024,-0.11774775199593746,-0.8298184969007245,-0.7120707449047871,-142602255,-132861795.6,6.8626803726835846,19.40708431324695,NaN,NaN,-29.80139170176515,-22.87077870484938
2009-03-06T09:30:00-05:00,16.67999,16.67999,15.85,16.32001,11070473,8535871.55,30.66987959901958,34.56326372273898,NaN,NaN,-144.54562563556684,-130.6524778129132,-0.11923003919694275,-0.8611082939009655,-0.7418782547040228,-131531782,-135225669,6.587920639701721,17.028560133975,NaN,NaN,-31.20040267095624,-24.060724985721787
2009-03-09T09:30:00-04:00,16.05,16.59,15.955,16.11,5134094,8451653.8,29.409065439962106,34.03994458457567,NaN,NaN,-137.45956656486473,-131.06627318102858,-0.12054765756715558,-0.8925628266629673,-0.7720151690958117,-136665876,-136586033.8,6.428413913527393,14.747138147500932,NaN,NaN,-32.7392474073934,-25.300513903103447
2009-03-10T09:30:00-04:00,16.2,17.22,16.2,17.10001,7966648,8650281.85,41.597657989625375,34.4408365091565,NaN,NaN,-79.44124308362613,-120.76288661874484,-0.04483576754181018,-0.8280598785230744,-0.7832241109812642,-128699228,-134249821.4,10.438852887725247,12.90510697466045,NaN,NaN,-30.27343923016876,-26.01093180696992
2009-03-11T09:30:00-04:00,17.39999,17.62,17.13,17.37,6067590,8572831.1,44.416330519125495,35.12955688275249,NaN,NaN,-27.028290858076886,-105.36662324618479,0.029339979134785477,-0.7465491370627824,-0.7758891161975678,-122631638,-132426155.8,13.553528048210921,11.67422827677701,NaN,NaN,-27.356194751678352,-26.203112227642553
2009-03-12T09:30:00-04:00,17.23,18.12,17.11,18.00999,7023227,8671621.35,50.513287815614795,36.30936309292661,NaN,NaN,16.38999362980703,-74.41694650246552,0.12221014957524934,-0.6231264292285061,-0.7453365788037555,-115608411,-127027387,22.18152591910774,11.611846859704103,NaN,NaN,-22.810726998253095,-25.718485766301203
2009-03-13T09:30:00-04:00,18.57001,18.66,17.83,18.22,4382285,8412819.2,52.35995884941516,37.8016371935182,NaN,NaN,75.77496788075413,-30.35282779920132,0.19421035412479193,-0.5025736361477655,-0.6967839902725574,-111226126,-122966255.8,28.002766382711613,12.313032914274187,NaN,NaN,-18.53710632584511,-24.69257441766462
2009-03-16T09:30:00-04:00,18.41,18.49001,17.78999,17.78999,4723715,8285388.35,48.37905590974973,38.36312875886912,NaN,NaN,63.053426132748314,9.749770740321292,0.20806807279680317,-0.4366988992765535,-0.6447669720733566,-115949841,-118823048.8,33.47066328704953,13.577528980385528,NaN,NaN,-16.13803842857269,-23.470497847794345
2009-03-17T09:30:00-04:00,17.85001,18.66,17.85001,18.64999,6938684,8393559.65,55.64266290110902,39.53267718108242,NaN,NaN,104.46705940094304,46.53143123723512,0.26660795849200336,-0.3115070239583524,-0.5781149824503558,-109011157,-114885434.6,38.26898271442096,15.334897802749703,NaN,NaN,-11.549573394296221,-21.767508640151757
2009-03-18T09:30:00-04:00,18.69,19.56,18.52499,19.24001,8035469,8302936.4,59.81991086619195,41.194393554381286,NaN,NaN,171.78929859991993,86.29494912883449,0.3322478569550588,-0.16280516125653222,-0.49505301821159103,-100975688,-110554244.6,43.1278430787036,17.55338098155369,NaN,NaN,-6.264876486185873,-19.552846903870915
2009-03-19T09:30:00-04:00,19.49001,19.49001,18.89999,19.03,9825363,8339018.2,57.73576718522981,42.767179580641034,NaN,NaN,158.59192142154927,114.73533468718293,0.3470836482718015,-0.061198457871839196,-0.4082821061436407,-110801051,-109592772.6,44.17822850617534,19.923952355469225,NaN,NaN,-2.7057579425575584,-17.146119909397576
2009-03-20T09:30:00-04:00,18.97,19.07001,18.28999,18.55,6566992,7994940.25,53.175605086983104,44.319609595556244,NaN,NaN,97.0331996042522,118.98698103188255,0.3112774878761935,-0.019185246298398795,-0.3304627341745923,-117368043,-110821156,43.083412681045964,22.294271681397962,NaN,NaN,-1.165226712440901,-14.863135166975194
2009-03-23T09:30:00-04:00,19.03999,19.88,18.74001,19.86,9381551,8122778.75,61.997506080045525,46.5577812930458,NaN,NaN,152.7928291585135,136.9348616370356,0.35913110521352415,0.11845114734231288,-0.24067995787121127,-107986492,-109228486.2,44.98700756018113,24.91281025460294,NaN,NaN,3.4088879463580515,-12.25284615078473
2009-03-24T09:30:00-04:00,19.67999,19.94,19.5,19.60001,10127016,8151616.25,59.597628885458896,48.275170963481706,NaN,NaN,146.24185157275312,145.28982007139763,0.3559008583288257,0.20419611503982082,-0.15170474328900485,-118113508,-111048956.4,43.20813943249963,27.455711815981697,NaN,NaN,6.18310830731688,-9.619138371055929
2009-03-25T09:30:00-04:00,19.64999,20.24001,19.1888,19.74001,6737832,7886342.6,60.48465549154808,50.4142123299341,NaN,NaN,130.00535079361816,136.93303051013726,0.34553682719105067,0.28021629069980847,-0.06532053649124218,-111375676,-113128954,41.203418872590404,29.908621708832182,NaN,NaN,8.652208671832538,-7.008945936357577
2009-03-26T09:30:00-04:00,20.11,20.67999,20.03999,20.64999,10584770,8085359.05,65.7484457025123,52.9198241944693,NaN,NaN,152.31223249128408,135.67709272408422,0.37959555438804937,0.4091739064938196,0.029578352105770173,-100790906,-111126925,43.901362112900856,32.573867528346405,NaN,NaN,12.603904308236501,-4.207110187129851
2009-03-27T09:30:00-04:00,20.33,20.405,20,20.10001,9272703,8199445,60.502699392239705,55.140798048203415,NaN,NaN,116.86333470806741,139.64311974484727,0.3456757796184228,0.46167307662879864,0.11599729701037587,-110063609,-109666038.2,45.853810309100794,35.38996727088737,NaN,NaN,14.130540013896976,-1.5874458726974479
2009-03-30T09:30:00-04:00,19.58,19.72501,19.23,19.5,6536469,8018686.6,55.31733460042022,56.12077494897447,NaN,NaN,69.97623071321702,123.07980005578797,0.2669458646761723,0.44967962785559124,0.18273376317941895,-116600078,-111388755.4,43.91291727600035,37.780971870049875,NaN,NaN,13.669186601878758,0.5920730522420099
2009-03-31T09:30:00-04:00,19.64999,19.96001,19.34,19.64999,4681871,7726968.25,56.325021840594864,56.97139575765085,NaN,NaN,72.270872105358,108.28560416230894,0.2115117984667379,0.44712351126284133,0.23561171279610343,-111918207,-110149695.2,45.69341635980054,40.076678178020565,NaN,NaN,13.618670834704528,2.4530155925937978
2009-04-01T09:30:00-04:00,20.02,20.31,19.11,20.00999,9455215,7768212.8,58.73070598738204,57.55835419849137,NaN,NaN,74.31410372035862,97.14735474765703,0.18650533368380312,0.46874337990085735,0.28223804621705423,-102462992,-108367158.4,48.239139506496166,41.93793629140544,NaN,NaN,14.315198505991017,4.1476131516505435
2009-04-02T09:30:00-04:00,20.39999,21.39999,20.3,21.11,10997188,7775457.75,65.06311435380604,58.46572244880501,NaN,NaN,129.1715014946369,92.51920854832761,0.22868180621963635,0.5680903039915997,0.3394084977719633,-91465804,-106502138,50.83592642101786,43.56887629414161,NaN,NaN,17.052619669321473,5.991185511317819
2009-04-03T09:30:00-04:00,21.27,21.42999,20.91,21.39,4953504,7469609.3,66.47330771044608,59.75816900599761,NaN,NaN,138.91019911060337,96.9285814288348,0.25790394733237715,0.6617884319374348,0.4038844846050576,-86512300,-101791876.2,56.73899195155718,45.23089977017787,NaN,NaN,19.703417481768778,7.950075792810813
2009-04-06T09:30:00-04:00,21.32001,21.41,20.9126,21.09,4641250,7444967.1,63.51516049970996,60.32049026304053,NaN,NaN,126.4051946816929,108.21437422252998,0.2398726312729767,0.7037252736962785,0.46385264242330176,-91153550,-96702570.6,62.04209585450643,46.928979280183974,NaN,NaN,20.95098345628063,9.807348316163644
2009-04-07T09:30:00-04:00,20.84,20.89,20.42999,20.47,4320039,7262636.65,57.791287597882715,60.17558860101844,NaN,NaN,85.18639837291511,110.79747947604139,0.1722006244232741,0.6791034229523945,0.5069027985291203,-95473589,-93413647,65.0258346354301,48.49312153423586,NaN,NaN,20.210677027026783,11.293538132001235
2009-04-08T09:30:00-04:00,20.78999,21.13,20.67,21.05,3347745,7126644.4,61.304423056810165,60.43049259184561,NaN,NaN,104.51191796059994,116.83704232408965,0.15315098923348525,0.698341535070977,0.5451905458374917,-92125844,-91346217.4,66.79289435137126,50.108454808892716,NaN,NaN,20.686383807585685,12.635373228513298
2009-04-09T09:30:00-04:00,21.75,22.03999,21.49001,21.91,8854156,7218190.85,65.84399590333017,61.33537765015611,NaN,NaN,152.87952165987332,121.57864635713695,0.18309541176815913,0.7740598105476906,0.5909643987795314,-83271688,-89707394.2,68.16593084199798,51.90006324896071,NaN,NaN,22.589079025623356,14.05733119952902
2009-04-13T09:30:00-04:00,21.7,22.0399,21.47,21.92,3482320,7173192.6,65.8940995591551,61.6137057558068,NaN,NaN,133.142263344359,120.42505920388808,0.18751629867699238,0.8253597721257719,0.6378434734487796,-79789368,-88362807.8,69.28795220216278,53.63584500910226,NaN,NaN,24.091879683443025,15.49083812580245
2009-04-14T09:30:00-04:00,21.75999,21.75999,21.28999,21.42999,4440840,7159048.85,61.159776654425194,61.7252877393044,NaN,NaN,99.4508627872781,115.0341928250051,0.14337092007086727,0.8170571235373636,0.6736862034664963,-84230208,-86978139.4,70.44328443982275,55.581212509625345,NaN,NaN,23.913620248556224,16.694092714767276
2009-04-15T09:30:00-04:00,21.32001,21.57001,21.14999,21.5,6334980,7128863.65,61.58445311205602,61.80384471219782,NaN,NaN,84.15019029054193,114.82695120853047,0.10651171758156774,0.806825850443456,0.7003141328618883,-77895228,-83462467.2,73.19993225953498,57.86667775154996,NaN,NaN,23.89216604365068,17.72238890460776
2009-04-16T09:30:00-04:00,21.56,22.42,21.56,22.25,7934516,7123816,65.88749830122173,61.81377704067707,NaN,NaN,123.20563935189558,118.56569548678958,0.11930418089694039,0.8494443589830638,0.7301401780861234,-69960712,-79029440.8,76.2125844726348,60.17462220581667,NaN,NaN,25.173008232498965,18.786763094306504
2009-04-17T09:30:00-04:00,22.64,22.67999,22.2,22.52,8623031,7063699.4,67.30723473365255,62.29981527934941,NaN,NaN,137.22883161955775,115.43555747872647,0.13164234736703173,0.8946931122949131,0.7630507649278814,-61337681,-74642639.4,78.75738331502617,62.52487742052563,NaN,NaN,26.65637679738652,19.910993623317935
2009-04-20T09:30:00-04:00,22.38,22.38,21.5,21.66,5790477,7024873.65,58.89871839998464,62.555628407889735,NaN,NaN,83.62721170017753,105.53254714989018,0.07063498264936174,0.8513444932395835,0.7807095105902218,-67128158,-72110397.4,80.08201036444244,65.10838406970005,NaN,NaN,25.350215848302277,20.68802536974427
2009-04-21T09:30:00-04:00,21.58,22.14,21.495,22.02,8673703,6989481.25,61.090044879345015,62.895987196371884,NaN,NaN,80.59876421286079,101.76212743500672,0.04455072523476156,0.8363979171336737,0.7918471918989122,-58454455,-66955246.8,82.47753984830702,67.73582146173624,NaN,NaN,24.93332119287479,21.29449620162006
2009-04-22T09:30:00-04:00,21.92999,22.77,21.77,22.24001,6866379,6826449.4,62.4090885731911,63.158728809643954,NaN,NaN,102.88531453948828,105.509152284796,0.032687599908244214,0.8327066917842174,0.8000190918759732,-51588076,-61693816.4,84.52341160542377,70.32755518308821,NaN,NaN,24.980120343428204,21.821013936164082
2009-04-23T09:30:00-04:00,22.41,22.56,21.88,22.24001,9905379,6984826.75,62.4090885731911,62.96915553960003,NaN,NaN,92.72092748947536,99.41220991231197,0.01624486342918563,0.8203251711624553,0.8040803077332697,-51588076,-58019289.2,85.77276724797183,72.82304381358492,NaN,NaN,25.01795260524261,22.277719460318156
2009-04-24T09:30:00-04:00,22.5,23.13,22.35001,22.78999,5778641,6744520.3,65.7729758606113,62.9191318360404,NaN,NaN,125.52853139295564,97.07214986699152,0.032855084234781784,0.8451491630267469,0.8122940787919651,-45809435,-54913640,86.74657784598715,74.96644280604421,NaN,NaN,26.019088917878104,22.81220081139815
2009-04-27T09:30:00-04:00,22.58,22.88,22.27,22.49001,12211586,6891464.45,62.48833694527854,62.84578729643816,NaN,NaN,99.32512046824043,100.21173162060411,0.01499417818115445,0.8310368015184082,0.8160426233372537,-58021021,-53092212.6,87.29579695232364,76.77027859874543,NaN,NaN,25.929086386237792,23.257470179232385
2009-04-28T09:30:00-04:00,22.25999,22.8401,22.16,22.49001,9045383,7016910.15,62.48833694527854,63.18129082125214,NaN,NaN,89.36321459196756,101.96462169642545,-0.0044264161351155185,0.8105096031683594,0.8149360193034749,-58021021,-53005525.8,87.3227227998204,78.36291346763046,NaN,NaN,25.855427750899914,23.62860697518489
2009-04-29T09:30:00-04:00,22.75,23.38,22.67999,22.89999,10159156,7290774.4,65.23979096019514,63.46238852863678,NaN,NaN,131.70310592577843,107.7281799736835,0.0023675213165537112,0.8178954209491671,0.8155278996326134,-47861865,-52260283.6,87.5666935405959,79.8467562668608,NaN,NaN,26.54824532968104,24.04569816868434
2009-04-30T09:30:00-04:00,23.58,23.87,23.24001,23.28999,9851973,7310612.3,67.66919150489201,63.592759643034064,NaN,NaN,171.7738130525883,123.53875708630608,0.02395559700976535,0.84547239589482,0.8215167988850547,-38009892,-49544646.8,88.439741745706,81.29488561712564,NaN,NaN,27.83684120519721,24.58729003104332
2009-05-01T09:30:00-04:00,23.41,23.44,22.97,23.17999,5897457,7055625.75,66.26250488757069,63.61907430934946,NaN,NaN,126.1538544940535,123.66382170652564,0.02172123778211854,0.8486683461127029,0.8269471083305844,-43907349,-49164229.6,88.560917552085,82.67152599926295,NaN,NaN,28.53320218459604,25.150991767265136
2009-05-04T09:30:00-04:00,23.45,23.98,23.28999,23.92999,7173383,7166619.7,70.7301630203963,64.30267333549025,NaN,NaN,160.12155694920847,135.82310900271926,0.05950625045467872,0.9013299213989328,0.841823670944254,-36733966,-44906818.6,89.84396492271276,84.05728889089794,NaN,NaN,30.49153357291905,25.91392631092998
2009-05-05T09:30:00-04:00,24.24001,24.24001,23.66,23.92,9424781,7405796.25,70.59606064386924,64.94635958776261,NaN,NaN,158.43583459443877,149.63763300321347,0.07175746422269969,0.9315205012226286,0.859763036999929,-46158747,-42534363.8,90.48446856196028,85.29189862678547,NaN,NaN,32.04801306088696,26.790224418066693
2009-05-06T09:30:00-04:00,24.33,24.35001,23.72,24.17,7759996,7577794.1,72.02546122410797,65.38478551082594,NaN,NaN,154.11730174751779,154.12047216756136,0.08379076327930224,0.9645014910990568,0.8807107278197546,-38398751,-40641741,90.97353292274971,86.34625208750796,NaN,NaN,33.78243808333406,27.78911208453346
2009-05-07T09:30:00-04:00,24.53,24.60001,23.53,23.64,11094418,7965127.75,64.83020334409599,65.20785469728618,NaN,NaN,122.0035960562145,144.1664287682866,0.04508791831944359,0.9370706257190591,0.8919827073996155,-49493169,-42938396.4,85.24778130310736,86.80985194379947,NaN,NaN,33.26659340557175,28.57160941611036
2009-05-08T09:30:00-04:00,24.07001,24.24001,23.5,23.99001,8184141,7931627,67.16318141054522,65.79817348375478,NaN,NaN,105.79648339380525,140.09495454823696,0.032670926148717694,0.9328213650855126,0.9001504389367949,-41309028,-42418732.2,85.47061270375622,87.19475211089332,NaN,NaN,33.49205068394554,29.27452959722967
2009-05-11T09:30:00-04:00,23.60001,23.78,23.3,23.57001,6551949,8085108.45,61.86036268104482,65.85319618387621,NaN,NaN,65.7832201074211,121.22728717987948,-0.011834386453259405,0.8853574558702206,0.89719184232348,-47860977,-44644134.4,79.90439590141212,87.01095611468655,NaN,NaN,32.117971301926254,29.680735555043466
2009-05-12T09:30:00-04:00,23.74001,23.74001,22.67,23.07001,12976383,8511885.6,56.174217423323356,65.40784824459993,NaN,NaN,25.206117100554597,94.58134368110265,-0.07919743476417151,0.7981950488682656,0.8773924836324372,-60837360,-47579857,73.13771245864925,86.19769188991692,NaN,NaN,29.1782901133567,29.6089576348025
2009-05-13T09:30:00-04:00,22.64999,22.64999,22.17,22.25999,8886285,8639450.85,48.410719417949394,64.40796473351125,NaN,NaN,-59.72379896533625,51.81312353853184,-0.17696023184782883,0.6561921938226511,0.83315242567048,-69723645,-53844835.8,61.22241434412053,84.44409525392756,NaN,NaN,23.97545776521979,28.804171939147828
2009-05-14T09:30:00-04:00,22.33,22.74001,22.12,22.28999,9451703,8715310.2,48.693534592054235,63.18800464290003,NaN,NaN,-60.32448764143434,15.347506799002065,-0.23464067302888314,0.5398515843843761,0.7744922574132592,-60271942,-56000590.4,57.7367900482277,82.37196755408759,NaN,NaN,19.94426416012722,27.538470827859168
2009-05-15T09:30:00-04:00,22.25999,22.795,22.13,22.13,7798555,8674086.4,47.207229333046506,62.09649695631203,NaN,NaN,-62.476596265634846,-18.307109132885945,-0.2757644904072991,0.4297866444041354,0.7055511348114345,-68070497,-61352884.2,50.10881046871472,79.71575423382981,NaN,NaN,16.17805130477979,25.915553753133544
2009-05-18T09:30:00-04:00,22.5,23.22,22.28999,23.22,6283707,8698747.9,56.86696195266416,61.6949701711253,NaN,NaN,-10.858656269464541,-33.63548440826308,-0.22395519362995753,0.4256071427739876,0.6495623364039451,-61786790,-64138046.8,46.654615890745276,76.81088945461015,NaN,NaN,15.730292906836576,24.460516489376836
2009-05-19T09:30:00-04:00,23.31,23.48,22.95,23.13,15801254,9055125.45,55.956541079921955,61.03188089396292,NaN,NaN,14.159113623614942,-35.84488510365101,-0.191407554378349,0.4103028934310089,0.6017104478093579,-77588044,-67488183.6,42.83008388192397,73.61541733613358,NaN,NaN,15.093221589627145,23.12233150369831
2009-05-20T09:30:00-04:00,23.25,23.7,22.8,22.88,13383504,9380981.7,53.399141237013154,60.01259158911443,NaN,NaN,1.6066739507508798,-23.578790520433582,-0.18241351961218133,0.37369354829413126,0.5561070679063126,-90971548,-71737764.2,38.5168531379721,70.04949672129544,NaN,NaN,13.791419702893288,21.789344103583307
2009-05-21T09:30:00-04:00,22.59,22.77,22.17,22.34,11743297,9472877.6,48.26766312611419,58.727245749010386,NaN,NaN,-94.89853670161501,-30.49360033246972,-0.2067452751901826,0.2976754739185843,0.5044207491087669,-102714845,-80226344.8,31.658526646773055,65.98504022805888,NaN,NaN,11.060517486371717,20.256654586838795
2009-05-22T09:30:00-04:00,22.53999,22.74001,22.14999,22.58,7362477,9552069.4,50.54246130866144,57.285267055315046,NaN,NaN,-82.0203193217311,-34.402344943688966,-0.20044048761414163,0.25387013959108984,0.45431062720523147,-95352368,-85682719,28.18451209849698,61.58079359775775,NaN,NaN,9.487662161431341,18.718227097494875
2009-05-26T09:30:00-04:00,22.39,23.41,22.11,23.34,11048590,9493919.6,56.99185025233745,56.3135377416342,NaN,NaN,-24.59919197257843,-37.150452084311745,-0.14162178609911974,0.2772833945813318,0.4189051806804515,-84303778,-90186116.6,25.679823196738752,56.95189035738478,NaN,NaN,10.14234766224275,17.493101463887427
2009-05-27T09:30:00-04:00,23.25,23.48,22.73,22.83,7775086,9430404.75,52.083583125409454,54.88911787744145,NaN,NaN,-21.007152637799056,-44.18370533659454,-0.13369740256820317,0.25178342747019755,0.3854808300384007,-92078864,-93084280.6,24.18996201269691,52.18163529238101,NaN,NaN,9.119018389492108,16.296803881830954
2009-05-28T09:30:00-04:00,23.09,23.14,22.35001,22.74001,5382070,9191550.45,51.24494381739372,53.91874219696272,NaN,NaN,-57.079326891780326,-55.92090550510078,-0.13097922043734,0.22175680449172575,0.35273602492906575,-97460934,-94382157.8,23.531547206906623,47.7733328569381,NaN,NaN,8.046894315335,15.118245372331533
2009-05-29T09:30:00-04:00,22.89999,23.17999,22.60001,23.12,4350984,8916501,54.57128941947259,53.01932134045752,NaN,NaN,-22.238358939308657,-41.38886995263951,-0.10137512230325613,0.22601712204999558,0.3273922443532517,-93109950,-92461178.8,26.711172009357128,43.576229950195305,NaN,NaN,8.152508709733972,14.123140134817595
2009-06-01T09:30:00-04:00,23.53999,24.25999,23.28,24.23,11532980,9198277.15,62.598615149756085,53.07205365965119,NaN,NaN,102.28542926287236,-4.52772023571882,-0.00965276145440136,0.31532629253525,0.3249790539896514,-81576970,-89706099.2,31.133948315521522,40.09262655120312,NaN,NaN,10.9770413719457,13.673697454407325
2009-06-02T09:30:00-04:00,24.11,24.52991,24.02,24.42999,7290035,9204109.75,63.838432496403684,53.61949759344264,NaN,NaN,142.10422626440715,28.8129634116783,0.05814317365882532,0.39765802106318304,0.3395148474043577,-74286935,-87702730.6,34.2415145537136,37.31432670085057,NaN,NaN,13.629141636938144,13.667332337626013
2009-06-03T09:30:00-04:00,24.25,24.265,23.88,24.11,8716402,9168690.8,60.38905242551111,54.47509280826848,NaN,NaN,109.17590586551793,54.8495751123417,0.0740720848209136,0.4321049534304997,0.3580328686095861,-83003337,-85887625.2,37.01470715501438,35.58520475877156,NaN,NaN,14.735665897672309,13.819951417632627
2009-06-04T09:30:00-04:00,24.2,24.2,23.71001,24.16,4963387,9028860.35,60.745964652117216,55.335980669701556,NaN,NaN,102.66605202970933,86.79865089663963,0.08009980252861737,0.4581576217703578,0.3780578192417404,-78039950,-82003428.4,42.59388784293677,34.50356888696508,NaN,NaN,15.727217362285614,14.092417981154481
2009-06-05T09:30:00-04:00,24.49001,24.49001,23.78,24.00999,6966754,8822477.15,59.02751972253282,56.18028712609343,NaN,NaN,108.04051516801829,112.85442571810502,0.06665892648188027,0.46138147734409074,0.3947225508622105,-85006704,-80382779.2,44.79129877508384,34.123746623134295,NaN,NaN,16.056617829464635,14.373017959484503
2009-06-08T09:30:00-04:00,23.75999,24.38,23.58,24.23,5533098,8689925,60.77992093158124,56.45978419601608,NaN,NaN,101.65320411627249,112.72798068878505,0.06518198876020614,0.47620003681246814,0.411018048052262,-79473606,-79962106.4,45.37579055350986,34.03240195618891,NaN,NaN,16.831710143573257,14.724259700068611
2009-06-09T09:30:00-04:00,24.34,24.48,24.09,24.37,4954336,8610044.35,61.896717267968924,56.884082495162296,NaN,NaN,116.50368850432754,107.60787313676913,0.06602662509717522,0.49355132942373103,0.4275247043265558,-74519270,-80008573.4,45.318717202832396,34.210161479110944,NaN,NaN,17.79220510101609,15.162537614489679
2009-06-10T09:30:00-04:00,24.52,24.72,23.77,24.00999,12544453,8588447.85,57.37252849127621,57.16789587046679,NaN,NaN,87.58453185108351,103.28959833388224,0.03622214372538113,0.4728023839832822,0.4365802402579011,-87063723,-80820650.6,44.270712943680046,34.62115146523294,NaN,NaN,17.372608782454574,15.478262067056093
2009-06-11T09:30:00-04:00,24.10001,24.32001,23.84,23.89,9527926,8620529.9,55.905815098299875,57.71347815419434,NaN,NaN,64.4159247100414,95.63957286994865,0.00400474738587403,0.4415861744902436,0.4375814271043696,-96591649,-84530990.4,39.74797430948207,35.19896915542644,NaN,NaN,16.618761880020198,15.641190611765252
2009-06-12T09:30:00-04:00,23.64999,23.92,23.42999,23.86,9665379,8631213.7,55.523624533928064,58.06927552742767,NaN,NaN,30.82486395470041,80.19644262728508,-0.022302304219042113,0.409703546830567,0.4320058510496091,-106257028,-88781055.2,35.29941820153775,35.70717673421507,NaN,NaN,15.888544667864926,15.676526905493777
2009-06-15T09:30:00-04:00,23.67999,23.67999,23.19,23.38,7384828,8610527.35,49.67244793225732,57.54646107599338,NaN,NaN,-9.543312098160522,57.95713938439849,-0.07219292438659253,0.34176469556636846,0.413957619952961,-113641856,-95614705.2,29.56904139106892,35.98497803381008,NaN,NaN,13.591553296664099,15.378673532803823
2009-06-16T09:30:00-04:00,23.46001,23.55,22.75,22.78999,9198605,8756272.25,43.59151542412697,56.93988481161607,NaN,NaN,-55.5900379768164,23.538394088169678,-0.14110595860880804,0.23757517169195097,0.378681130300759,-122840461,-105278943.4,23.707617585754463,35.95052486045705,NaN,NaN,9.670329622220809,14.563195831291964
2009-06-17T09:30:00-04:00,22.81,23.37,22.61,23.11,16528098,8792614.45,47.35589353537255,56.66209550575741,NaN,NaN,-53.93157117701506,-4.764826517450038,-0.15993237885794553,0.17876565672832712,0.33869803558627265,-106312363,-109128671.4,21.849573768818587,35.830383900593624,NaN,NaN,7.41266872941178,13.541691959594795
2009-06-18T09:30:00-04:00,23.14999,23.23,22.8,23.03999,5451008,8395989.65,46.62285154878542,56.09434994356547,NaN,NaN,-53.62535952721989,-28.373083364902293,-0.17090421474883055,0.1250677671502345,0.29597198189906504,-111763371,-112163015.8,20.486688457674845,35.385777932616314,NaN,NaN,5.35016425454575,12.37147371601636
2009-06-19T09:30:00-04:00,23.05,23.33,22.965,23.13,8922348,8254942.2,47.74284616437669,55.033223587466935,NaN,NaN,-47.0646975361479,-43.95099566307196,-0.16577615972516363,0.08875178224261049,0.2545279419677741,-102841023,-111479814.8,21.67137955241087,34.709880163822696,NaN,NaN,3.932560706898733,11.165914714713843
2009-06-22T09:30:00-04:00,22.86,22.89,22.44,22.44,10355023,8404569.5,40.69377966575096,53.38003409956317,NaN,NaN,-115.96977030474552,-65.23628730438895,-0.2002264046543599,0.004244936149824241,0.20447134080418414,-113196046,-111390652.8,21.835058672084656,33.823704743706344,NaN,NaN,0.4757782711016838,9.638752365626392
2009-06-23T09:30:00-04:00,22.45,22.605,22.21001,22.21001,10440859,8374182.95,38.64560066274899,51.82693040222302,NaN,NaN,-135.12781881351202,-81.14384347172808,-0.22786450245878975,-0.08035928726930308,0.14750521518948667,-123636905,-111549941.6,21.747625793552842,32.73319893217338,NaN,NaN,-3.0433000447122867,7.827030592720867
2009-06-24T09:30:00-04:00,22.5,22.78999,22.28999,22.34,8931750,8432016.15,40.469354203606265,50.37860108447224,NaN,NaN,-111.40226472716489,-92.63798218175805,-0.2262916117475074,-0.13535929949489756,0.09093231225260982,-114705155,-113228500,20.802328816678525,31.176659001726357,NaN,NaN,-5.445857552498389,5.930903714832402
2009-06-25T09:30:00-04:00,22.23,23.17,22.23,23.12,9044520,8615138.65,50.061676086987525,49.738183681933286,NaN,NaN,-71.7480661298929,-96.26252350229265,-0.16449440886024846,-0.11468569882270074,0.04980871003754771,-105660635,-112007952.8,23.409294380338935,29.649372973530294,NaN,NaN,-4.67460767973352,4.4158306584658416
2009-06-26T09:30:00-04:00,22.98,23.16,22.88,22.96001,4967230,8645950.95,48.34106666038374,48.849694091133465,NaN,NaN,-54.151549069533935,-97.67989380896987,-0.12780233511066275,-0.10994420885078071,0.01785812625988202,-110627865,-113565321.2,22.396269680801666,28.007978625479705,NaN,NaN,-4.5653072258969845,3.1328109606997234
2009-06-29T09:30:00-04:00,23.02,23.36,22.88,23.25,5258211,8332212.5,51.58892098395368,48.11342292798952,NaN,NaN,-32.05892436120548,-80.89772462026184,-0.07976116933597907,-0.08184333541009181,-0.002082166074112747,-105369654,-112000042.8,25.868583183706136,26.618683338399258,NaN,NaN,-3.481370372434141,2.1879279131091716
2009-06-30T09:30:00-04:00,23.21001,23.44501,22.92,23.08,6532809,8294351.2,49.61943233886938,47.55963034567475,NaN,NaN,-28.921285216120584,-59.65641790078355,-0.056298705183131105,-0.07245554755302663,-0.01615684236989553,-111902463,-109653154.4,30.86351062658052,25.661026030035007,NaN,NaN,-3.1577148909586588,1.4242646553851959
2009-07-01T09:30:00-04:00,23.25,23.53999,23.19,23.23,8897781,8303420.15,51.38307871817436,47.23657774709436,NaN,NaN,-3.5046581647743666,-38.076896588305445,-0.028921667620227014,-0.0523089268951793,-0.023387259274952284,-103004682,-107313059.8,35.52819608844413,25.35961329996087,NaN,NaN,-2.376946191330309,0.881234534425838
2009-07-02T09:30:00-04:00,22.99001,23.23,22.28999,22.28999,9373617,8523931.65,41.56361690004774,46.239434344674336,NaN,NaN,-91.05462394777823,-41.93820815188251,-0.07002217423637869,-0.11091497707042564,-0.040892802834046955,-112378299,-108656592.6,34.10541550763301,25.27432739325339,NaN,NaN,-4.805715099209622,0.06881315819220091
2009-07-06T09:30:00-04:00,22.12,22.5701,22.10001,22.39999,5033625,8427275.2,42.937850570140846,45.75839167595173,NaN,NaN,-117.71914463355036,-54.65172726468579,-0.08471974255699077,-0.14679248103028542,-0.06207273847329465,-107344674,-107999954.4,35.46566375064418,25.69551470465162,NaN,NaN,-6.322921819918771,-0.844291838680795
2009-07-07T09:30:00-04:00,22.45,22.45,21.78999,21.8,6464840,8473862.3,37.72639989563284,45.33945485248786,NaN,NaN,-153.9207160276535,-79.0240855979754,-0.12721479954949969,-0.22109123791016927,-0.09387643836066958,-113809514,-109687926.4,33.548474421448205,26.398433050058316,NaN,NaN,-9.357782696521198,-2.0605048183722814
2009-07-08T09:30:00-04:00,21.89999,22.08,21.7,21.981,10778910,8765091,40.08875888148347,44.8203738057815,NaN,NaN,-151.82717562500838,-103.60526367975294,-0.134774217281373,-0.26234420996238583,-0.12756999268101282,-103030604,-107913554.6,37.38051811679736,27.507786217771088,NaN,NaN,-11.081144224019347,-3.3491675906075766
2009-07-09T09:30:00-04:00,22.25999,22.25999,21.9501,22.14,5680012,8421868.95,42.16434525045457,44.501909070186436,NaN,NaN,-110.19941632890432,-124.94421531257895,-0.12113718687241531,-0.278991476271532,-0.15785428939911667,-97350592,-106782736.6,39.76454137298346,28.884775711721698,NaN,NaN,-11.86524276564401,-4.5657497584699245
2009-07-10T09:30:00-04:00,21.81,22.33,21.81,22.10001,5610715,8226008.4,41.77236827747024,44.07544636397883,NaN,NaN,-103.89430621034269,-127.51215176509183,-0.10735248985104556,-0.29204490171292363,-0.18469241186187807,-102961307,-104899338.2,43.61488637539035,30.45216905622024,NaN,NaN,-12.613429146423364,-5.715418242463273
2009-07-13T09:30:00-04:00,22.05,22.50999,21.8201,22.46001,7427328,8114105.85,46.5863377300411,44.49634336857098,NaN,NaN,-68.66301916196593,-117.70092667077495,-0.0684267494638163,-0.27022584869164845,-0.20179909922783215,-95533979,-102537199.2,48.09609718867925,32.32795752169128,NaN,NaN,-11.85499569345412,-6.592500735461965
2009-07-14T09:30:00-04:00,22.33,22.86,22.33,22.81,7158855,8102807.2,50.84145056728743,45.367475504609445,NaN,NaN,1.8519265307618953,-86.54639815909188,-0.016266498202121477,-0.222132221980484,-0.2058657237783625,-88375124,-97450321.2,56.17391646836834,34.7869782841781,NaN,NaN,-9.92006589694511,-7.067867187102414
2009-07-15T09:30:00-04:00,23.05,23.49001,22.96001,23.44,7938895,8039821.7,57.41742665520022,46.57805210829473,NaN,NaN,106.17437268639257,-34.9460884968117,0.05936122020409848,-0.1316641985232394,-0.1910254187273379,-80436229,-92931446.2,61.85345461629081,37.719201555578984,NaN,NaN,-6.054571361654304,-6.923110640609827
2009-07-16T09:30:00-04:00,23.46001,23.83,23.25999,23.73,5008023,7463817.95,60.065623169535186,47.292619757048136,NaN,NaN,142.30664752100245,15.555124273169659,0.12390006048198854,-0.03615034312485221,-0.16005040360684075,-75428206,-88546969,66.40286186254934,40.79017066145115,NaN,NaN,-1.9874350095846478,-6.218014121891944
2009-07-17T09:30:00-04:00,23.74001,23.7999,23.59,23.77,4727125,7427623.8,60.43114929203763,48.15619708788056,NaN,NaN,141.83011812655397,64.70000914054899,0.16186856486890971,0.042285302479296405,-0.11958326238961331,-70701081,-82094923.8,71.74338710285926,44.314964763026694,NaN,NaN,1.3834431789422488,-5.1320916503442024
2009-07-20T09:30:00-04:00,23.88,24.35001,23.88,24.27,6172105,7290111.65,64.77181617562718,49.09783245871437,NaN,NaN,177.13617288562418,113.85984755006697,0.21018011988652083,0.14314188746853773,-0.0670382324179831,-64528976,-75893923.2,75.73549427260927,47.87688698366264,NaN,NaN,5.73878173218837,-3.579109738553835
2009-07-21T09:30:00-04:00,24.39999,24.5,23.86909,24.27,7360102,7140365.6,64.77181617562718,50.18014558991136,NaN,NaN,153.69207130148783,144.2278765042122,0.23005405219905792,0.2205293328308393,-0.00952471936821861,-64528976,-71124693.6,78.27742932100817,51.26359546183603,NaN,NaN,9.222925852569407,-1.7502475112505145
2009-07-22T09:30:00-04:00,24.10001,24.59,24.07001,24.44,5414949,6889070.1,66.23248063807299,51.2408171556184,NaN,NaN,147.34872904912186,152.46274777675802,0.24138667228530683,0.29220862098841494,0.050821948703108105,-59114027,-66860253.2,80.26793757431341,54.45929128225527,NaN,NaN,12.585059375071697,0.29765347250980123
2009-07-23T09:30:00-04:00,24.44,25.21001,24.28,25.00999,7119672,6798466.2,70.62964239409186,53.31696183376441,NaN,NaN,166.8381726321654,157.36905279899062,0.27174794696643256,0.39050688241114884,0.11875893544471626,-51994355,-62173483,82.19858745640639,57.8945178500248,NaN,NaN,17.022262447426336,2.6868833260693057
2009-07-24T09:30:00-04:00,24.83,25.02,24.60001,24.99001,4536230,6573051.7,70.2841459457323,55.270268646306654,NaN,NaN,145.46362348224216,158.09575387012825,0.27417454985031553,0.46147712275761066,0.18730257290729513,-56530585,-59339383.8,83.26490209310232,61.30874916020038,NaN,NaN,20.50264366447253,5.2319919458411945
2009-07-27T09:30:00-04:00,25,25.10001,24.66,25.09,3530762,6501228.3,71.04743561390059,57.650342626182926,NaN,NaN,130.60222492375564,148.7889642777546,0.26599634097254965,0.5197979991229822,0.25380165815043254,-52999823,-57033553.2,84.0994295775665,64.91953167135169,NaN,NaN,23.624070143945566,7.859431688427533
2009-07-28T09:30:00-04:00,24.92,25.12,24.78,25.00999,4504770,6463556.25,69.50887776769174,59.75177968948351,NaN,NaN,114.03974672263324,140.85849936198366,0.23950651780136845,0.5531848054021431,0.31367828760077465,-57504593,-55628676.6,84.60320635053745,68.29258083090456,NaN,NaN,25.831303982565522,10.426842016161531
2009-07-29T09:30:00-04:00,24.94,25.17999,24.69051,24.88,9311750,6602503.3,66.97138361351438,61.52371100113064,NaN,NaN,97.07076329957361,130.802906212074,0.1991924792101244,0.5626688866134302,0.3634764074033058,-66816343,-57169139.8,81.552092747586,71.27740592909045,NaN,NaN,27.04699455257011,12.801149521362756
2009-07-30T09:30:00-04:00,25.27,25.52,25.14,25.27,12795066,6797367.55,70.45613235034298,63.57255129205013,NaN,NaN,108.4928441573762,119.13384051711617,0.18505756578781413,0.5947983646380735,0.4097407988502593,-54021277,-57574524.2,80.72702259195573,73.92827280170226,NaN,NaN,29.133502426223068,15.134342793485658
2009-07-31T09:30:00-04:00,25.21001,25.49001,25.11501,25.27,5109688,6584171.1,70.45613235034297,65.27753662207168,NaN,NaN,97.14550572801208,109.47021696627014,0.16276152385127507,0.6131927036643532,0.4504311798130781,-54021277,-57072662.6,80.98352264347301,76.27737461990182,NaN,NaN,30.851668295289574,17.379675008029075
2009-08-03T09:30:00-04:00,25.58,25.86,25.38,25.78999,5648957,6614937.7,74.600071208559,66.97458095359109,NaN,NaN,109.17782794053656,105.18533756962634,0.16933262060254756,0.6620969555662626,0.492764334963715,-48372320,-56147162,81.47320709273535,78.0844668073566,NaN,NaN,33.676716812855275,19.70782383728996
2009-08-04T09:30:00-04:00,25.72,25.99001,25.61,25.89999,5019355,6542663.45,75.38657429253163,68.25809149911477,NaN,NaN,110.30917463326728,104.43922315175314,0.16710206560057772,0.7016419169644372,0.5345398513638595,-43352965,-53316836.4,82.92157359745633,79.58933244886842,NaN,NaN,36.25970962833987,22.07237895029709
2009-08-05T09:30:00-04:00,25.99001,25.99001,25.39,25.67999,5765387,6291987.3,70.67314467979232,69.01577160699027,NaN,NaN,95.88720613475121,104.20251171878866,0.1380310467064223,0.7070786597468874,0.5690476130404651,-49118352,-49777238.2,84.54844310911061,80.88544539505138,NaN,NaN,37.145635645890806,24.225701335381906
2009-08-06T09:30:00-04:00,26.03,26.17,25.56,25.66,4776719,6246822.65,70.24338738160368,69.71664575624499,NaN,NaN,96.69374585838281,101.84269205898997,0.10611046614277109,0.701685695718929,0.5955752295761579,-53895071,-49751997,84.55973847323664,81.80089906436403,NaN,NaN,37.75818504526719,26.158913293936948
2009-08-07T09:30:00-04:00,26,26.64,25.89999,26.5,14941414,6713357.6,76.66481124915708,70.56614540435427,NaN,NaN,129.17304367349547,108.24819964808667,0.12871787059953976,0.7564725678255826,0.6277546972260428,-38953657,-46738473,85.88627435391908,82.52595478445758,NaN,NaN,40.40480491730396,28.194040668703664
2009-08-10T09:30:00-04:00,26.48,26.49001,26.02,26.25999,8552016,6769592,71.89108388199352,71.07466452623757,NaN,NaN,120.56771661412631,110.5261773828046,0.11510015302214549,0.7716298885037247,0.6565297354815792,-47505673,-46565143.6,85.96098512965922,83.07478019936124,NaN,NaN,41.09341779510432,30.036808829618042
2009-08-11T09:30:00-04:00,26,26.17,25.67999,25.98,4806164,6651957.45,66.67524654564315,71.10629066249258,NaN,NaN,88.10438870843075,106.08522019783729,0.07667732727805787,0.7523763945791515,0.6756990673010936,-52311837,-48356918,81.1772025515549,83.13972769773564,NaN,NaN,40.01866355913909,31.46278807669248
2009-08-12T09:30:00-04:00,26.03999,26.42,25.855,26.17,5547480,6532386.7,68.35318042213858,70.9436862359245,NaN,NaN,97.79803481006675,106.4673859329004,0.054540228984671146,0.7438743535319325,0.6893341245472614,-46764357,-47886119,81.46901607602646,83.08761545627992,NaN,NaN,39.6373773337963,32.630586541993026
2009-08-13T09:30:00-04:00,26.38,26.38,25.82001,26.24001,5293160,6546643.55,68.97310292640334,70.85004030597243,NaN,NaN,90.488391143639,105.22631498995165,0.03598938272707852,0.7343208529561096,0.6983314702290311,-41471197,-45401344.2,82.9696698347214,83.06652743782415,NaN,NaN,39.507380977846154,33.6129857471149
2009-08-14T09:30:00-04:00,26.19,26.3,25.64999,25.88,5377145,6579144.55,62.22318154375171,70.21973644381895,NaN,NaN,62.797606115036885,91.95122747825994,-0.0068661030950911695,0.6897488413601671,0.6966149444552583,-46848342,-46980281.2,78.61315023384816,82.67465034184427,NaN,NaN,37.326118782900515,34.1434333236557
2009-08-17T09:30:00-04:00,25.34,25.34,24.94,25.06,8796934,6710386,50.177934715807396,68.83895479725578,NaN,NaN,-38.6626516813392,60.10515381916683,-0.09204854869675716,0.5815542585843119,0.673602807281069,-55645276,-48608201.8,74.28243580319885,81.9374524456058,NaN,NaN,31.06765941174798,33.704037050526026
2009-08-18T09:30:00-04:00,25.27,25.42999,25.09,25.34,5755816,6630171.7,53.48885969260024,67.87591737433334,NaN,NaN,-26.704816662071345,37.14331274506642,-0.12888608066155716,0.5124952064541226,0.6413812871156798,-49889460,-48123726.4,74.72862233781832,81.45006170205095,NaN,NaN,27.064174393620142,32.75548524239662
2009-08-19T09:30:00-04:00,25.23,25.67999,25.02,25.60001,6253098,6672079.15,56.38725575831836,66.87099761776015,NaN,NaN,-15.80371167643627,14.42296344776581,-0.1344728307095765,0.4732902487287092,0.6077630794382857,-43636362,-47498127.4,75.32397035243808,81.06412939922826,NaN,NaN,24.732089125298025,31.609285797096817
2009-08-20T09:30:00-04:00,25.71001,25.8905,25.53,25.78999,5305371,6581364.1,58.42583140923907,66.0116904076813,NaN,NaN,25.014173832103477,1.32811998545871,-0.12434198962612875,0.4523355924056247,0.5766775820317535,-38330991,-46870086.2,75.9368445540396,80.70365239284017,NaN,NaN,23.479799256673846,30.44793057703639
2009-08-21T09:30:00-04:00,25.92,26.39,25.92,26.32001,3808738,6544989.5,63.545414958483775,65.2220721041045,NaN,NaN,95.0953094699352,7.787660656438374,-0.08290678340112323,0.47304410278034936,0.5559508861814726,-34522253,-44404868.4,78.22319149436996,80.47150842152836,NaN,NaN,24.07421256284025,29.53739943215123
2009-08-24T09:30:00-04:00,26.39,26.4722,26.03999,26.13,4654809,6601191.85,60.66143254505619,64.1702762649991,NaN,NaN,89.49063880107057,33.41831875292032,-0.06978438069941029,0.4687204103072098,0.5385047910066201,-39177062,-41111225.6,80.84222211500688,80.32298331563912,NaN,NaN,23.63131338091418,28.69367285340308
2009-08-25T09:30:00-04:00,26.17999,26.69,26.17,26.39999,5902871,6671096.9,63.21603229105986,63.63762538008964,NaN,NaN,116.90575734128291,62.14043355359117,-0.04558061469363983,0.4815290226395703,0.5271096373332101,-33274191,-37788171.8,83.05633274166348,80.2164040036786,NaN,NaN,24.070930952931604,28.033281153335725
2009-08-26T09:30:00-04:00,26.38,26.75,26.27,26.55,8205250,6615771.9,64.59186183405168,63.23394498383592,NaN,NaN,125.45849118081898,90.39287412504223,-0.02325302212336644,0.49804335967900215,0.5212963818023686,-25068941,-34074687.6,85.12520661775046,80.2567945854296,NaN,NaN,24.85168575389745,27.578767524844544
2009-08-27T09:30:00-04:00,26.53,26.72,26.12,26.60001,3896869,6170862.05,65.06103953655324,62.40510414722137,NaN,NaN,106.92591490681491,106.77522233998452,-0.009600596052817267,0.509295636736347,0.5188962327891643,-21172072,-30642903.8,86.73694052132721,80.31755645453018,NaN,NaN,25.62105394325256,27.29909415604569
2009-08-28T09:30:00-04:00,26.92,26.92,26.44,26.61,5134398,6172097.55,65.1603514513363,61.92433754503156,NaN,NaN,127.35228290492306,113.22661702698208,-0.004633380218152627,0.5131045075164735,0.5177378877346261,-16037674,-26945988,88.21797952425379,80.47877033985836,NaN,NaN,26.276663326021815,27.153032608899423
2009-08-31T09:30:00-04:00,26.35001,26.53,26.06,26.16,3363147,6057807.05,57.26434678876939,61.252130419540585,NaN,NaN,44.605917319258,104.24967273061957,-0.034715202329579475,0.4743438848226518,0.5090590871522312,-19400821,-22990739.8,89.56104906648773,81.0776165194964,NaN,NaN,24.560701821667724,26.782699639294894
2009-09-01T09:30:00-04:00,26.02,26.55,25.63,25.69,8901777,6251928.15,50.39547307302359,59.969437037460935,NaN,NaN,-14.087067927573113,78.05110767684836,-0.08638537389805973,0.4010773697796566,0.4874627436777163,-28302598,-21996421.2,89.8735647538482,81.67794142505511,NaN,NaN,20.878506270625113,25.93924344377064
2009-09-02T09:30:00-04:00,25.53,25.71001,25.39999,25.56,4316469,6179482.25,48.65696614801671,58.51828441043333,NaN,NaN,-90.45733465367495,34.86794250994958,-0.12698317345677784,0.328733776856744,0.45571695031352183,-32619067,-23506446.4,85.67857857764898,81.87143490669278,NaN,NaN,17.32887547388057,24.709190876643486
2009-09-03T09:30:00-04:00,25.74001,25.89999,25.48,25.83,4986688,6189980.7,52.334794556141496,57.81197105417545,NaN,NaN,-54.281006915558166,2.626558145474965,-0.13269633514429058,0.28984653138315863,0.4225428665274492,-27632379,-24798507.8,82.14540103892938,82.12373853562715,NaN,NaN,15.384785021581035,23.37713289734885
2009-09-04T09:30:00-04:00,25.91,26.3,25.81,26.3,4092510,5647535.5,57.977765965069445,58.36910185769417,NaN,NaN,25.633465087773647,-17.717205417954922,-0.10317901371262395,0.2935690993866693,0.39674811309929325,-23539869,-26298946.8,78.11677117978407,82.39761963395468,NaN,NaN,15.426890279171266,22.24138395189491
2009-09-08T09:30:00-04:00,26.53999,26.60001,26.34,26.53,4204176,5430143.5,60.445599431389,58.866011839036226,NaN,NaN,90.58773789344762,-8.520841303116992,-0.06820832822726369,0.31148770281521365,0.37969603104247734,-19335693,-26285921.2,78.12680001541774,82.64034661092606,NaN,NaN,16.231666057241842,21.38285282408733
2009-09-09T09:30:00-04:00,26.5,26.88499,26.36,26.81,4619453,5420807.95,63.27330047920811,59.357872176242644,NaN,NaN,113.71867162594144,17.040306607585915,-0.028306457153689235,0.3443129596003658,0.372619416754055,-14716240,-23568649.6,80.16859695591978,82.98639136831761,NaN,NaN,17.795717776074024,20.87040496008543
2009-09-10T09:30:00-04:00,26.86,27.22,26.71001,27.17,3438357,5315351.8,66.58124422014916,59.94040166273628,NaN,NaN,153.93197287442828,65.91816811320656,0.017764392744320345,0.39482490768445544,0.3770605149401351,-11277883,-19300412.8,82.87305510384297,83.48183497901786,NaN,NaN,20.193422666666475,20.773693203882722
2009-09-11T09:30:00-04:00,27.24001,27.24001,26.94,27.08,7071609,5404274.25,65.00491438452846,60.04465162173947,NaN,NaN,141.4364806173695,105.0616656197921,0.03652829161400323,0.42272087945763914,0.3861925878436359,-18349492,-17443835.4,83.90145647521089,83.8874253347922,NaN,NaN,21.661469983478092,20.900518458110632
2009-09-14T09:30:00-04:00,26.96001,27.25,26.77,27.17,3618461,5316340.05,65.87498152579525,60.41704797750655,NaN,NaN,122.72832524276292,124.48063765078996,0.04859701213973611,0.44693885301830605,0.39834184087856994,-14731031,-15682067.8,84.83219103332885,84.17242311467234,NaN,NaN,23.122379753123152,21.217927214540993
2009-09-15T09:30:00-04:00,27.12,27.41,27.03999,27.3,5547230,5153854.85,67.14562706452574,60.697733318468394,NaN,NaN,136.62262097662645,133.68761426742572,0.05827860644594318,0.47119009893599895,0.41291149249005576,-9183801,-13651689.4,85.84769032683627,84.37180579932752,NaN,NaN,24.71338439808847,21.71727824076206
2009-09-16T09:30:00-04:00,27.36,27.86,27.31,27.82001,4372230,5084675.55,71.68702945652387,61.204531005787835,NaN,NaN,177.31375261771694,146.4066304657808,0.09071316944534924,0.5263029542967423,0.4355897848513931,-4811571,-11670755.6,86.77780799846082,84.48984875509255,NaN,NaN,27.58394441405199,22.55537340837491
2009-09-17T09:30:00-04:00,27.81,28.09,27.5699,27.78999,6047199,5074380.6,71.07622132685542,61.63418684795228,NaN,NaN,173.67501618984892,150.35523912886495,0.10040019574321513,0.561090029530412,0.46068983378719686,-10858770,-11586933,86.81728927115039,84.49558795150848,NaN,NaN,29.725606834636103,23.579692469269364
2009-09-18T09:30:00-04:00,27.78999,27.94991,27.6599,27.8,8644922,5241358.15,71.16444813437595,62.06305089674082,NaN,NaN,147.82714909429708,151.63337282425044,0.09764748553163766,0.5827491907017439,0.48510170517010626,-2213848,-8359804.2,88.26954291379329,84.49927105076131,NaN,NaN,31.501710326962378,24.71140930608265
2009-09-21T09:30:00-04:00,27.74001,27.84,27.44,27.69,5620953,5331968.9,68.6850236908018,62.87881353260028,NaN,NaN,111.40287385975998,149.36828254764987,0.07936077488527593,0.5843026737767012,0.5049418988914253,-7834801,-6980558.2,88.83562856444242,84.44745530061523,NaN,NaN,32.34678855672263,25.80217777045979
2009-09-22T09:30:00-04:00,27.89999,27.96001,27.75,27.8,6928211,5445639,69.81749638000953,64.2661009116707,NaN,NaN,115.3092325772285,145.1056048677703,0.06615528008031402,0.5876359989918178,0.5214807189115038,-906590,-5325116,89.49113931428286,84.42013919778913,NaN,NaN,33.373896003240475,26.883851803714172
2009-09-23T09:30:00-04:00,27.92999,27.94,27.39999,27.39999,7491945,5525092.7,61.15626832282711,65.15890820987144,NaN,NaN,77.59929203431506,125.16271275108993,0.024128418795170026,0.5516412424054664,0.5275128236102964,-8398535,-6042508.8,87.10435547875687,84.52198040501112,NaN,NaN,31.84464754318126,27.59253690935233
2009-09-24T09:30:00-04:00,27.53999,27.60001,26.9826,27.14,8620820,5545871.2,56.27015233018838,65.44000519373193,NaN,NaN,37.110597390592005,97.84982899123855,-0.02487924338179981,0.4964137693830466,0.5212930127648464,-17019355,-7274625.8,83.00948302131592,84.58370054661016,NaN,NaN,29.067361930833123,27.8032261981353
2009-09-25T09:30:00-04:00,27.06,27.23,26.85001,26.98,7415566,5721806.05,53.44044894061598,65.11591112055669,NaN,NaN,10.55655261568668,70.39570969551647,-0.06925544065118983,0.4347237119508591,0.503979152602049,-24434921,-11718840.4,70.19167233577878,84.01762205775265,NaN,NaN,25.88398127751459,27.52904835233234
2009-09-28T09:30:00-04:00,27.11,27.58,26.98,27.49001,6924398,5811306.05,60.294628537931494,65.10512748530972,NaN,NaN,43.90342871938774,56.89582066744204,-0.06548613176119,0.4221214879005615,0.4876076196617515,-17510523,-13653984.8,65.45236852411225,83.1123055226594,NaN,NaN,25.05570279179684,27.175713272255837
2009-09-29T09:30:00-04:00,27.53,27.8,27.42,27.62,6260434,5956170.4,61.83671383091691,65.00251415328893,NaN,NaN,69.34277161532013,47.702528475060355,-0.055840478207661914,0.4178070219021741,0.47364750010983603,-11250089,-15722684.6,60.73160246609037,81.72394877338589,NaN,NaN,24.843041152837802,26.842474398053263
2009-09-30T09:30:00-04:00,27.75,27.75,27.11,27.47,7272398,5874701.45,58.989626574198404,64.46025575000672,NaN,NaN,44.30040990098416,41.04275204839417,-0.060758322707819556,0.3976995967250616,0.45845791943288117,-18522487,-17747475,56.44071703701438,79.83592462575525,NaN,NaN,23.816928216073865,26.41025351491335
2009-10-01T09:30:00-04:00,27.39999,27.39999,26.75,26.87,5784652,5948110.6,49.226329490339744,63.3332139718504,NaN,NaN,-26.060226910024777,28.408587188270822,-0.10312595232148292,0.3295504790310275,0.43267643135251044,-24307139,-19205031.8,53.50985068270149,77.66509564057601,NaN,NaN,19.650107364476558,25.444518350565236
2009-10-02T09:30:00-04:00,26.56,26.72,26.46001,26.53,5895141,5993533.25,44.71045090073523,61.82146178434611,NaN,NaN,-111.68018329320985,3.961240006491481,-0.1499177630696824,0.24527922751540743,0.39519699058508984,-30202280,-20358503.6,51.24209358466148,75.2658029656712,NaN,NaN,14.617714889210085,23.897832141800215
2009-10-05T09:30:00-04:00,26.62,27.06,26.545,26.94,5084156,6043115.55,50.59611567031625,60.63935382761686,NaN,NaN,-77.33376587638251,-20.28619891266257,-0.14882472003262848,0.20916609054430424,0.3579908105769327,-25118124,-21880023.8,48.332341071845256,72.58613516174327,NaN,NaN,12.291300350643908,22.23975617163503
2009-10-06T09:30:00-04:00,27.12,27.57001,27.03999,27.35001,4652980,6065555.75,55.67739455625502,59.49580847759766,NaN,NaN,5.442663679658869,-33.066220499794824,-0.11743583763118864,0.21119601353794692,0.32863185116913557,-20465144,-23723034.8,44.999091581761085,69.60194113197899,NaN,NaN,12.06407288239624,20.786087130315202
2009-10-07T09:30:00-04:00,27.3,27.50999,27.21001,27.37,4102902,6039728.2,55.915462680999205,58.41289714575078,NaN,NaN,8.215689342896923,-40.28316461141227,-0.09332607234061985,0.2119742607433608,0.30530033308398064,-16362242,-23290985.8,45.94031614335666,66.6821573371366,NaN,NaN,11.964042606947146,19.525795055548336
2009-10-08T09:30:00-04:00,27.52,28.02,27.49001,27.81,4390344,6087327.55,60.89442877713972,57.67932433451962,NaN,NaN,93.83743235020316,-16.303632759366682,-0.04802582439439779,0.2452680525909834,0.2932938769853812,-11971898,-20823937.6,51.087530908419865,64.02629933675277,NaN,NaN,13.520119966920118,18.66784147145859
2009-10-09T09:30:00-04:00,27.82001,27.83501,27.61,27.8,3047826,5886138.4,60.72656245070515,57.11086281736986,NaN,NaN,79.05628009270595,21.843659917816478,-0.020426994449463165,0.26776013392355225,0.2881871283730154,-15019724,-17787426.4,56.56881602018291,61.72152701216282,NaN,NaN,14.689228169769464,18.099468142645858
2009-10-12T09:30:00-04:00,27.98,28.13,27.77,27.94,2777693,5844100,62.29371921604883,56.573450162801244,NaN,NaN,111.5211907185461,59.6146512368022,0.004249360180059114,0.2934988285980893,0.2892494684180302,-12242031,-15212207.8,60.60126583715059,59.65796462093908,NaN,NaN,16.127411717001163,17.817745796125187
2009-10-13T09:30:00-04:00,27.84,28.09,27.7775,27.99001,3911615,5762319.25,62.863784599932444,56.69541561116591,NaN,NaN,100.92966695420654,78.71205189171174,0.020047751895854504,0.31430915828784833,0.29426140639199383,-8330416,-12785262.2,63.99416401154535,58.0072366589954,NaN,NaN,17.46795706634437,17.76777597758507
2009-10-14T09:30:00-04:00,28.32001,28.47,28.155,28.34,6239457,5855680.6,66.66242704452573,57.4377209479043,NaN,NaN,157.52223050966538,108.57336012506543,0.048551760562908886,0.35495110709562994,0.30639934653272105,-2090959,-9931005.6,67.53511622216345,56.90192474477023,NaN,NaN,19.80171982526192,18.05833938439605
2009-10-15T09:30:00-04:00,28.22,28.46001,28.16,28.38,3690582,5737849.75,67.0769229376959,58.41175480483857,NaN,NaN,144.9525739126684,118.79638843755848,0.06363167966117411,0.38593894610918866,0.32230726644801455,1599623,-7216701.4,70.5056604967493,56.92435247055384,NaN,NaN,21.829223410256596,18.597037102376127
2009-10-16T09:30:00-04:00,28.19,28.39,27.97,28.33,4216840,5516445.65,65.9727288998253,58.81733340211671,NaN,NaN,116.18827846168882,126.22278811135507,0.06361850599512853,0.4018303989419252,0.33821189294679666,-2617217,-4736200,72.94223522444804,57.45934294914925,NaN,NaN,23.217814262862817,19.2571481253028
2009-10-19T09:30:00-04:00,28.39999,28.77,28.265,28.64999,4002981,5435547.05,69.43992042402891,59.36041958733899,NaN,NaN,149.06334661747206,133.73121929114026,0.07761286276358853,0.43522797140128233,0.3576151086376938,1385764,-2010641,75.35174166732966,58.50363860638064,NaN,NaN,25.47203447657808,20.144989032627837
2009-10-20T09:30:00-04:00,28.64999,28.67,28.1884,28.36,4872043,5332738.65,63.15907939728049,59.658237646130566,NaN,NaN,112.50495376816296,136.04627665393156,0.06054886694185602,0.43330119231501385,0.37275232537315783,-3486279,-1041813.6,76.16427294402583,59.91246402831002,NaN,NaN,25.62569315561592,20.927946764483277
2009-10-21T09:30:00-04:00,28.32001,28.74249,27.92,27.99001,6993336,5307808.2,56.177371862914605,60.15474067274306,NaN,NaN,76.05199012733672,119.7522285774658,0.019669204053805456,0.3973388304404146,0.37766962638660917,-10479615,-2719544.8,71.75308961225215,61.215552523277935,NaN,NaN,23.614849656484243,21.31179003476913
2009-10-22T09:30:00-04:00,28,28.53999,27.85001,28.36,7622785,5257906.45,60.83925602774251,61.30679818181501,NaN,NaN,73.11160148308106,105.38403409154834,0.013184286690847202,0.39414998475016816,0.38096569805932096,-2856830,-3610835.4,69.45181197873387,62.516246694283105,NaN,NaN,23.32160273192334,21.598906134362586
2009-10-23T09:30:00-04:00,28.64,28.71001,28.105,28.25,5401059,5157181.1,58.83529899344038,61.89531127632387,NaN,NaN,80.30448226203123,98.2072748516168,-0.00206461054206436,0.3783849348817405,0.3804495454238049,-8257889,-4738969.8,66.54273472182516,63.816989097853096,NaN,NaN,22.47009613373106,21.72336184855808
2009-10-26T09:30:00-04:00,28.19,28.73,27.95,28.08,8439922,5232957.3,55.77752975465736,61.90246379049547,NaN,NaN,60.080577577040394,80.41072104353047,-0.025831582344409687,0.34816006749329276,0.37399164983770244,-16697811,-8355684.8,58.13553311509125,64.75530635023382,NaN,NaN,20.83569372811751,21.596552117066572
2009-10-27T09:30:00-04:00,28.06,28.11,27.46001,27.60001,11216711,5480771.15,48.16594966432073,61.348927146447004,NaN,NaN,-15.353933212105487,54.83894364747679,-0.0734155765348905,0.2822221791690893,0.3556377557039798,-27914522,-13241333.4,49.10928879559952,64.98166153967973,NaN,NaN,16.90141953295213,20.92581889076451
2009-10-28T09:30:00-04:00,27.47,27.58,26.77,26.82001,7987199,5516511.2,38.88064596180854,59.77651408820907,NaN,NaN,-102.81410726172254,19.06572416966493,-0.15241179571414332,0.16512301106130067,0.317534806775444,-35901721,-18325754.6,41.830452314841196,64.32044164013841,NaN,NaN,9.867629658780212,19.34607757190961
2009-10-29T09:30:00-04:00,27.17999,27.62,27.03,27.53999,9100742,5682315.7,48.70951036887274,58.91815322522104,NaN,NaN,-61.89397605524685,-7.935391338000659,-0.1508828799305995,0.12893120686219461,0.2798140867927941,-26800979,-23114584.4,36.36359548032863,62.87721160157739,NaN,NaN,7.445675016905786,17.64602006405192
2009-10-30T09:30:00-04:00,27.48,27.69,26.74001,26.82001,13307020,6052909.65,41.5190502468833,57.434248298852076,NaN,NaN,-117.22558044926114,-47.44140388025913,-0.19051350846232026,0.04167220121489379,0.23218570967721405,-40107999,-29484606.4,30.62931826703361,60.736358203711895,NaN,NaN,2.5897421550192155,15.495123219904393
2009-11-02T09:30:00-05:00,26.82001,27.34,26.62,27.08,11154438,6356423.75,44.6939945081276,56.13640614943744,NaN,NaN,-131.80048349671097,-85.81761609500941,-0.1908910241097259,-0.006428070459943314,0.18446295364978257,-28953561,-31935756.4,28.75055630395498,58.21895765316972,NaN,NaN,0.05991168394557327,13.290093000481704
2009-11-03T09:30:00-05:00,26.81,27.2,26.74001,27.10001,10347055,6641127.5,44.94174768831402,54.58492905256518,NaN,NaN,-124.55258929697449,-107.65734731198322,-0.18152554277209096,-0.04244397481533113,0.13908156795675983,-18606506,-30074153.2,32.15431356172931,55.69175746313872,NaN,NaN,-1.7527865651226942,11.141110205395362
2009-11-04T09:30:00-05:00,27.32001,27.56,27.03,27.11,9722164,6922090.6,45.07403789692127,53.013294406795566,NaN,NaN,-89.40626653463578,-104.97577916656587,-0.16677001324552376,-0.06938094860014488,0.09738906464537889,-8884342,-24670677.4,40.96937354876499,53.58202268113983,NaN,NaN,-3.1142781453431216,9.104626155289864
2009-11-05T09:30:00-05:00,27.24001,27.89999,27.21001,27.85001,8412547,7123200.75,53.908547680923256,52.15156717687398,NaN,NaN,-26.59662373118117,-97.91630870175273,-0.10244134164239709,-0.030662612407617473,0.07177872923477961,-471795,-19404840.6,48.05280938381964,51.804206549666375,NaN,NaN,-1.3391710319246686,7.612655128544931
2009-11-06T09:30:00-05:00,27.84,28.13,27.64,28.10001,3675979,7154608.4,56.45663260591931,51.224189475580445,NaN,NaN,15.731540621759262,-71.32488448754864,-0.041451209148505294,0.01996471779914799,0.061415926947653285,3204184,-10742404,57.1598091637363,50.50478279940971,NaN,NaN,0.9423812776802527,6.659758864135692
2009-11-09T09:30:00-05:00,28.31,28.71989,28.2,28.71001,8373547,7434401.1,61.97973566871269,51.139950637825606,NaN,NaN,91.51782696208656,-26.66122239578912,0.03731802284795248,0.10806345550759389,0.07074543265964141,11577731,-2636145.6,63.592204164769015,49.60677788660565,NaN,NaN,4.8406634601251355,6.399888092134184
2009-11-10T09:30:00-05:00,28.58,28.87,28.5,28.81,6486832,7563161.95,62.812401391340124,51.61388131842743,NaN,NaN,104.72020055292838,19.19333557419145,0.09046893462660578,0.18383160094289863,0.09336266631629285,18064563,4698068.2,68.23881044032032,49.355757945753375,NaN,NaN,8.164058206850871,6.651912394236567
2009-11-11T09:30:00-05:00,29,29.09,28.69,28.84,8246297,7663503.95,63.07370216343321,51.77348461383391,NaN,NaN,115.18369220773845,60.1113273226663,0.12010372568632512,0.24349232342419924,0.12338859773787413,26310860,11737108.6,71.94024396018355,49.533503087285496,NaN,NaN,10.870875544567738,7.254621415712449
2009-11-12T09:30:00-05:00,28.85001,29.03999,28.47501,28.52,6420188,7799984.25,58.36292044598612,51.73974328901575,NaN,NaN,86.58123756168133,82.74689958123881,0.11083564012435654,0.2619331478933198,0.15109750776896325,19890672,15809602,73.83977454656814,50.05472021762428,NaN,NaN,11.76127520912085,7.898429100485077
2009-11-13T09:30:00-05:00,28.59,29.03999,28.59,29.02,10507820,8114533.25,63.01146024620024,52.25645260984023,NaN,NaN,101.95984157608932,99.99255977210481,0.12974770101671682,0.3132821340398593,0.18353443302314246,30398492,21248463.6,76.1608315400247,51.34224153369096,NaN,NaN,14.019200365039325,8.772824995421399
2009-11-16T09:30:00-05:00,29.24001,29.55,29.10001,29.49001,9994301,8414099.25,66.7674293200835,53.585129728109,NaN,NaN,145.0240982094711,110.69381402158172,0.16312151729004404,0.3874363296356975,0.22431481234565348,40392793,27011476,78.35251577509031,53.43104346079743,NaN,NaN,17.189367415926274,9.975188198350667
2009-11-17T09:30:00-05:00,29.39999,29.39999,28.96001,29.25,6822992,8511646.7,63.236187786622914,55.32481128702432,NaN,NaN,115.00712409840806,112.75119873067766,0.1581265664709236,0.42197302043430795,0.26384645396338435,33569801,30112523.6,79.44746944986082,56.117973256155985,NaN,NaN,18.682383716753442,11.219073272408206
2009-11-18T09:30:00-05:00,29.23,29.25999,28.97,29.17,4812066,8402583.2,62.05802300068357,56.278276475010806,NaN,NaN,97.09150130923501,109.13276055097697,0.139195721297262,0.4378411055849618,0.2986453842876998,28757735,30601898.6,79.62263726784823,59.20790481240738,NaN,NaN,19.53103597003315,12.406496514926054
2009-11-19T09:30:00-05:00,29.03999,29.14999,28.53999,28.84,6826941,8362791,57.31437399456218,57.4065138855593,NaN,NaN,63.990721370558994,104.6146573127525,0.09625084255140959,0.4189589374769618,0.3227080949255522,21930794,31009923,79.77739598971573,62.71848179259896,NaN,NaN,18.827272838391576,13.323750275421128
2009-11-20T09:30:00-05:00,28.64,28.88,28.52,28.69,5446281,8365052.1,55.24715479209355,58.16031104869972,NaN,NaN,47.8555238357138,93.79379376467739,0.05177347864600684,0.38742494323306076,0.3356514645870539,16484513,28227127.2,75.56244023168428,66.06218778743677,NaN,NaN,17.636068599733587,13.939795750322908
2009-11-23T09:30:00-05:00,28.89999,29.235,28.82159,28.94,9790879,8432599.95,57.96819200821423,59.09077135726402,NaN,NaN,68.67832138584107,78.52463839995139,0.03407622293958473,0.37824674326153485,0.3441705203219501,26275392,25403647,71.43830949950573,68.86818749727794,NaN,NaN,17.410167121531316,14.435563089066966
2009-11-24T09:30:00-05:00,28.91,29,28.72,28.91,6416363,8192582.55,57.516262791123864,59.97950170684992,NaN,NaN,53.26454568181426,66.17612271663263,0.016145327148898714,0.3643521792580735,0.3482068521091748,19859029,22661492.6,67.58050913571068,70.76898289634549,NaN,NaN,17.0994776961997,14.816122318657357
2009-11-25T09:30:00-05:00,29.00999,29.19,28.91,29.19,5879957,8087220.45,60.60343252948471,60.45770776746145,NaN,NaN,67.82806529486692,60.32343551375901,0.018754634783542723,0.3716501455886032,0.3528955108050605,25738986,22057742.8,66.72612288581266,72.10279100363071,NaN,NaN,17.69741576517828,15.227735668160346
2009-11-27T09:30:00-05:00,28.57001,28.97,28.28999,28.62,6373891,7950877.9,52.275495040775,60.159055084236854,NaN,NaN,20.297678456016843,51.58482693085058,-0.02018640007392619,0.32766251071265273,0.3478489107865789,19365095,21544603,65.96282263247885,72.73157767996946,NaN,NaN,15.713168872666463,15.297083268804077
2009-11-30T09:30:00-05:00,28.72,28.78,28.37,28.62,8910813,7731067.55,52.275495040775,59.465895039384165,NaN,NaN,10.52626286317595,44.11897473634301,-0.04670695398218744,0.28946521830884464,0.3361721722910321,19365095,22120719.4,66.4271739022602,72.9340755183617,NaN,NaN,14.121356381992475,15.129122284973848
2009-12-01T09:30:00-05:00,28.87,29.2,28.86,29.07001,7038324,7525261.85,57.60919491197902,59.09423743371552,NaN,NaN,63.53804720589624,43.090919900354045,-0.03522729830662252,0.2921380494077539,0.3273653477143764,26403419,22146324.8,66.44908194188778,72.80623776847365,NaN,NaN,14.284485183230222,15.008459841867616
2009-12-02T09:30:00-05:00,29.03999,29.33,28.95,29.16,5429961,7279407.15,58.60548701934103,58.7750792091375,NaN,NaN,78.92613351427853,48.223237466846896,-0.023426975159102637,0.29808162876549815,0.3215086039246008,31833380,24541195,68.51831176625342,72.56181404033579,NaN,NaN,14.706725075986778,14.96535487531321
2009-12-03T09:30:00-05:00,29.28999,29.36,28.89999,28.96001,7478980,7167247.95,55.48454455417714,58.56948093115115,NaN,NaN,61.75437457911555,47.008499323696626,-0.030496707629690534,0.28338771938748764,0.31388442701717817,24354400,24264277.8,67.99610679312845,72.14440920080439,NaN,NaN,14.171868020458442,14.851999610333957
2009-12-04T09:30:00-05:00,29.24001,29.49001,28.73,29.14999,10204309,7256836.05,57.784421071096446,58.19612099007231,NaN,NaN,70.92116045755616,57.13319572400449,-0.02406673580518326,0.2838010072606991,0.3078677430658824,34558709,27303000.6,70.64040397071116,71.75009294585342,NaN,NaN,14.369321366096552,14.783045575442898
2009-12-07T09:30:00-05:00,29.17999,29.42,29.10001,29.24001,7979258,7472000,58.8687995538827,57.63193314962939,NaN,NaN,101.70831790470339,75.36960673230998,-0.015836841325422235,0.2880716914091046,0.30390853273452684,42537967,31937575,74.14867910184364,71.44981889776437,NaN,NaN,14.834785422967217,14.790436982232087
2009-12-08T09:30:00-05:00,29.09,29.14999,28.8,29.02,6186285,7362636.9,55.14085267483896,57.05369492735911,NaN,NaN,10.075464826923094,64.67709025651536,-0.02665950981207621,0.27058414546943155,0.29724365528150776,36351682,33927227.6,75.50207527413654,71.16800502806977,NaN,NaN,14.2022297140626,14.706407372493588
2009-12-09T09:30:00-05:00,29,29.11,28.81,29.02,5309770,7303783.8,55.14085267483896,56.55961133265591,NaN,NaN,2.111887737761276,49.31424110121189,-0.03475532685886451,0.2537994967079271,0.28855482356679163,36351682,34830888,76.11372572572684,70.91736848934683,NaN,NaN,13.68018488176693,14.559804159532638
2009-12-10T09:30:00-05:00,29.17,29.53,29.14,29.47,6281984,7205568.15,60.99946263869405,56.822831950093914,NaN,NaN,138.12611466897582,64.58858911918394,-0.01192044700559941,0.2736542648097924,0.2855747118153918,42633666,38486741.2,78.45712283884575,70.82306326428468,NaN,NaN,14.870318660788309,14.604163373997734
2009-12-11T09:30:00-05:00,29.64999,29.78,29.52,29.75999,5018945,7135506,64.24054217398182,57.46521676308593,NaN,NaN,214.93267316645918,93.39089166096456,0.018919857025205433,0.30922453309689857,0.29030467607169314,47652611,41105521.6,79.97281953462112,71.1380903573516,NaN,NaN,16.87065782853326,14.927948296074238
2009-12-14T09:30:00-05:00,29.96001,30.03,29.72,29.99001,6025848,6911407.4,66.6107836043651,58.08254473423956,NaN,NaN,234.8242458289261,120.01407724580909,0.04929083866077133,0.3519182243976573,0.30262738573688597,53678459,43333620,81.18569640672423,71.83433227929578,NaN,NaN,19.292156911334256,15.551406669682812
2009-12-15T09:30:00-05:00,29.89999,30.05,29.755,29.95,4647895,6644087.1,65.79387260306022,58.6738025779493,NaN,NaN,202.0475713699863,158.40849855442175,0.06043053351577987,0.3781655526316108,0.3177350191158309,49030564,45869396.4,82.4857178544962,72.89899004492331,NaN,NaN,21.05010539392826,16.336935058860732
2009-12-16T09:30:00-05:00,29.98,30.14999,29.89999,29.98,5371648,6571519.9,66.12929482179445,59.0685070274,NaN,NaN,178.12324762366296,193.61077053160207,0.06326261041105186,0.39681328212964573,0.33355067171859387,54402212,49479502.4,84.16342904828154,74.1445119136711,NaN,NaN,22.600762322633578,17.231767525113995
2009-12-17T09:30:00-05:00,29.83,29.83,29.5717,29.62,3822147,6522023.95,58.69173007498429,59.526809529843526,NaN,NaN,91.98574581783375,184.38269676137367,0.035706093989108845,0.3781832892049799,0.34247719521587106,50580065,51068782.2,84.85138840854329,75.49369518338997,NaN,NaN,21.90025969599965,17.89869497809766
2009-12-18T09:30:00-05:00,29.67,29.67,29.22,29.61,6401637,6500758.75,58.49492457291657,59.971054496425054,NaN,NaN,51.57462085486197,151.71108629905422,0.012801955052020475,0.35847963903089664,0.34567768397887616,44178428,50373945.6,83.1506624018069,76.68823007621474,NaN,NaN,21.27060677635271,18.380396663562667
2009-12-21T09:30:00-05:00,29.67999,30.069,29.66,29.99001,5937449,6525317.15,63.50326708879082,60.39205965191161,NaN,NaN,111.96403567783838,127.13904426883667,0.01887485782168119,0.3692712562559777,0.3503963984342965,50115877,49661429.2,81.3500100501779,77.75258208394975,NaN,NaN,22.137313357223352,18.917099048371337
2009-12-22T09:30:00-05:00,29.99001,30.13499,29.91,29.97,2465933,6159069.85,63.071684425067325,60.71107375232064,NaN,NaN,112.67637954761656,109.26480590436272,0.017220295857054146,0.3719217682556142,0.35470147239856004,47649944,49385305.2,80.62137786676078,78.61708680541457,NaN,NaN,22.72881728107048,19.461630224471214
2009-12-23T09:30:00-05:00,30.07001,30.16,29.82001,30.16,3022065,5989354.95,65.47128797816595,61.42441256831983,NaN,NaN,106.05041615988614,94.85023961160735,0.02417214261585038,0.384916650668373,0.3607445080525226,50672009,48639264.6,78.57365727639743,79.37262612564805,NaN,NaN,23.916921079029862,20.09810034655102
2009-12-24T09:30:00-05:00,30.25,30.3,30.09,30.17999,1154954,5753104.8,65.72364679571564,61.99150012007834,NaN,NaN,113.71118961960657,99.1953283719619,0.025249158105981828,0.39230595568499993,0.3670567975790181,51826963,48888644.2,78.76779003505354,79.9531537016725,NaN,NaN,24.97131574560164,20.794273974986822
2009-12-28T09:30:00-05:00,30.27,30.32001,30.02499,30.16,2523966,5560608.55,65.21038428042803,62.44447045768872,NaN,NaN,100.87116038057452,109.05463627710442,0.01997850610149471,0.3920299302058865,0.3720514241043918,49302997,49913558,79.58640806876541,80.3415629135955,NaN,NaN,25.72554774331431,21.498741656176463
2009-12-29T09:30:00-05:00,30.19,30.28999,30.16,30.25999,2045693,5217352.55,66.61481443926573,63.26403915514777,NaN,NaN,103.53980647544468,107.3697904366257,0.018616863621755686,0.3953225036315864,0.3767056400098307,51348690,50160120.6,79.78829748328148,80.64772164282013,NaN,NaN,26.74602041914461,22.248352908029055
2009-12-30T09:30:00-05:00,30.19,30.23,29.98,30.05,2278438,4979358.25,61.04163058646308,63.68552329169235,NaN,NaN,72.76054579061649,99.38662368522569,-0.00004793889737259027,0.37664571638811495,0.37669365528548754,49070252,50444182.2,80.03329993202507,80.92769122898429,NaN,NaN,26.17833765434494,22.809779300359896
2009-12-31T09:30:00-05:00,30.14,30.19,29.77,29.77,1620320,4788876.2,54.49479180243139,63.22090394624502,NaN,NaN,37.750066513620986,85.72655375597266,-0.0330473525025311,0.33538446465732363,0.36843181715985474,47449932,49799766.8,77.73131947491132,80.8758481315604,NaN,NaN,23.79429205304325,22.95042397931466
2010-01-04T09:30:00-05:00,29.89999,30.11,29.89999,30,5443828,4687118.6,58.438055879932115,62.80644063952719,NaN,NaN,49.769309264188536,72.93817768488904,-0.04067920869056191,0.31758280629665236,0.3582620149872143,52893760,50013126.2,77.95737997127088,80.73188816274968,NaN,NaN,22.817362791023434,22.9314152381302
2010-01-05T09:30:00-05:00,30.00999,30.14,29.82001,30.11,6162129,4485009.6,60.213785773774084,62.3495122230564,NaN,NaN,49.38283971515129,62.640513551804396,-0.0395765003413312,0.3087913895605503,0.3483678899018815,59055889,51963704.6,79.96027530886751,80.64435808433134,NaN,NaN,22.496879233031546,22.86933866597325
2010-01-06T09:30:00-05:00,30.09,30.215,30.02,30.14999,4246836,4298388.5,60.86835051654995,61.997689216877085,NaN,NaN,68.75805371955484,55.68416300062643,-0.03743461374467777,0.3015746227210343,0.33900923646571207,63302725,54354511.6,82.10641591242656,80.61726508846922,NaN,NaN,22.41041836760011,22.803778623348514
2010-01-07T09:30:00-05:00,30.34,30.41,30.13499,30.39999,5736621,4275905.3,64.77046648897436,61.90063005024708,NaN,NaN,119.10618079653293,64.95329000180972,-0.021266002954148377,0.31242673277302657,0.33369273572717495,69039346,58348330.4,84.99692992867084,80.67680086563989,NaN,NaN,23.45517692116381,22.896835523036412
2010-01-08T09:30:00-05:00,30.28999,30.41,30.12,30.39,6437977,4332315.65,64.49370890293983,62.31505710938677,NaN,NaN,119.56155718990507,81.31558813706654,-0.013696783370257481,0.3165717565143531,0.3302685398846106,62601369,61378617.8,86.74634743862097,80.81215508207401,NaN,NaN,24.237937032385375,23.088421452943408
2010-01-11T09:30:00-05:00,30.45,30.53999,30.17,30.33,4173441,4226888.5,62.75922401771562,62.619649926872405,NaN,NaN,131.631387315497,97.68800374732822,-0.015074590222571183,0.31142530210639663,0.3264998923289678,58427928,62485451.4,87.32758787176766,81.11050690135691,NaN,NaN,24.43747487543649,23.281143370442418
2010-01-12T09:30:00-05:00,30.14999,30.22,29.815,29.94,5473309,4249606.7,52.81620251123382,61.85628817133262,NaN,NaN,-18.58548404222247,84.09433899585346,-0.04301346401991257,0.2727330623040771,0.3157465263239897,52954619,61265197.4,83.00563145795967,81.22876557334133,NaN,NaN,21.65855138335232,23.049344515143833
2010-01-13T09:30:00-05:00,30.06,30.33,29.96001,30.28,4615801,4179104.35,58.92575495094483,61.56015035175244,NaN,NaN,61.63220345983085,82.66916894390866,-0.03945076710163714,0.2664330674469433,0.3058838345485804,57570420,60118736.4,79.04732143888252,81.11633297135003,NaN,NaN,21.060952169048893,22.765288465701698
2010-01-14T09:30:00-05:00,30.19,30.32001,30.13,30.28,5640293,4228724.25,58.92575495094482,61.0926122783795,NaN,NaN,76.07713143172218,74.06335907094652,-0.03793834782489919,0.25846089976745645,0.29639924759235564,57570420,57824951.2,71.68201844309385,80.6240730546855,NaN,NaN,20.58621004779878,22.453991548858422
2010-01-15T09:30:00-05:00,30.22,30.34,29.88,29.98,5889430,4254613.35,52.03139884292047,60.114594567465566,NaN,NaN,-0.11281315374750538,50.128485002215996,-0.056849116347505224,0.22533785215797408,0.2821869685054793,51680990,55640875.4,65.43052856888377,79.67141152138765,NaN,NaN,18.00823012248843,21.818882773662708
2010-01-19T09:30:00-05:00,30.13,30.38,29.86,30.38,4418457,4284428.85,58.93102881370548,59.66606917698538,NaN,NaN,54.01216659464225,34.604640858045066,-0.04276747427741273,0.2287276256587134,0.27149509993612614,56099447,55175179.2,64.1459455164521,78.56852133907957,NaN,NaN,17.96532664504259,21.268374755288406
2010-01-20T09:30:00-05:00,30.14,30.17999,29.81,29.97,5028102,4215752.1,50.85639451302815,58.5404677536827,NaN,NaN,-75.90328636459992,23.141080393569574,-0.060339843330604936,0.19607029577286994,0.2564101391034749,51071345,54798524.4,63.067464203806864,77.37417610483138,NaN,NaN,15.102177932167834,20.387489494842608
2010-01-21T09:30:00-05:00,29.98,30.25,29.53999,29.59,6786508,4258205.05,44.73797086451022,57.37592063068605,NaN,NaN,-175.83468068555155,-24.352296435506904,-0.09477910407006407,0.1379362590158948,0.23271536308595886,44284837,52141407.8,55.924225237489225,75.65209934093596,NaN,NaN,10.471528620603605,18.970923655665608
2010-01-22T09:30:00-05:00,29.47,29.7,29,29.02,10092023,4639509.55,37.45821243220816,56.159022104241544,NaN,NaN,-346.56220476988176,-108.88016367582767,-0.1498941781716784,0.04534764037136085,0.19524181854303926,34192814,47465886.6,46.04212470442634,73.38858542875846,NaN,NaN,3.6429814914786016,16.78121763221032
2010-01-25T09:30:00-05:00,29.21001,29.3,28.98,29.17,5311563,4753984.45,40.2151863192715,54.85738856419435,NaN,NaN,-274.52508918042895,-163.76261888116397,-0.16878887117262906,-0.015744270422747064,0.153044600749882,39504377,45030564,41.88999638793447,70.81234374423444,NaN,NaN,-0.6114111896181478,14.296556371949112
2010-01-26T09:30:00-05:00,29.02,29.41,28.96001,29.21001,5506859,4971579.7,40.962753848594545,53.48231485525296,NaN,NaN,-200.7649231968955,-214.71803683947155,-0.1706254408393894,-0.060237200299354754,0.11038824054003464,45011236,42812921.8,38.48636899252442,67.84992186449566,NaN,NaN,-3.6193589153918113,11.73713990232898
2010-01-27T09:30:00-05:00,29.22,29.35989,28.96001,29.25999,7041715,5197467.15,41.93943585012815,52.13024952193712,NaN,NaN,-158.37598653713434,-231.21257687397843,-0.16064888125241208,-0.09042286102548047,0.07022602022693161,52052951,43009243,38.95920687274443,64.76797836166122,NaN,NaN,-5.688578694301503,9.24775153138177
2010-01-28T09:30:00-05:00,29.39,29.53,28.92,29.09,6292574,5409811.2,39.54329806776332,50.32830892042204,NaN,NaN,-132.27997512565574,-222.50163576199924,-0.1574628890602373,-0.12660259109836502,0.030860297961872285,45760377,43304351,39.70942711038052,61.53315673178334,NaN,NaN,-8.150222507555897,6.762326668676389
2010-01-29T09:30:00-05:00,29.16,29.49001,28.89,28.91,7362922,5664035.4,37.12458356701219,48.3733713964272,NaN,NaN,-123.43872566098841,-177.87693994022058,-0.15898003297046986,-0.16786474325121503,-0.008884710280745181,38397455,44145279.2,41.90072751372613,58.32989816571943,NaN,NaN,-10.95733275255153,4.230946751358115
2010-02-01T09:30:00-05:00,28.97,29.28,28.94,29.28,8877043,6026871.55,44.62277936963354,47.077911064421336,NaN,NaN,-96.41394063836096,-142.254710231807,-0.12790341753085477,-0.16876398219431366,-0.04086056466345888,47274498,45699303.4,45.819744124152706,55.36505218374693,NaN,NaN,-11.051689593631673,2.0477129877881453
2010-02-02T09:30:00-05:00,29.35001,29.7,29.17999,29.69,5493691,6029364.7,51.52182449053812,46.98545549151449,NaN,NaN,-36.9879448537886,-109.4993145631856,-0.07518252839636448,-0.13483872515891449,-0.059656196762550004,52768189,47250694,49.48319479844578,52.970592422353086,NaN,NaN,-8.816297662471465,0.49571146632248686
2010-02-03T09:30:00-05:00,29.61,29.78,29.53,29.71001,4863367,5964426.6,51.837192430504906,46.479129597197364,NaN,NaN,-11.740084926653974,-80.17213424108954,-0.03637603847693051,-0.10512624485871314,-0.06875020638178263,57631556,48366415,51.99702855288486,51.03842864478183,NaN,NaN,-6.968747402813302,-0.5706398006969116
2010-02-04T09:30:00-05:00,29.47,29.53999,28.84,28.85001,10126156,6258392.6,39.84112467246594,45.11594172016316,NaN,NaN,-92.37979825055852,-72.1920988660701,-0.06440239873142542,-0.1492532047960644,-0.08485080606463899,47505400,48715419.6,52.78845241467612,49.68888821418056,NaN,NaN,-9.471533043370881,-1.8421959782217643
2010-02-05T09:30:00-05:00,28.84,28.97,28.21001,28.77,8303895,6386756.3,38.938296934234174,44.180720155257,NaN,NaN,-137.65293058735276,-75.03493985134295,-0.082925180896451,-0.18850728218520274,-0.10558210128875174,39201505,48876229.6,53.171556974616706,48.813247386018624,NaN,NaN,-11.697697742556052,-3.2501248016980915
2010-02-08T09:30:00-05:00,28.83,29.06,28.59,28.59,6376844,6383699.65,36.911775692739695,42.6079163609023,NaN,NaN,-112.48667656085144,-78.24948703584106,-0.10071243452518808,-0.23147264444523685,-0.13076020992004878,32824661,45986262.2,45.95447743571259,47.513856808822936,NaN,NaN,-14.157885621544237,-4.808376347390398
2010-02-09T09:30:00-05:00,28.84,29.21001,28.74001,29.03,6904883,6520271.75,44.51371981432496,42.15486816813779,NaN,NaN,-70.92710360170575,-85.03731878542449,-0.07730974031240914,-0.2273973853105602,-0.15008764499815105,39729544,43378533.2,40.59950707713028,45.90900272834603,NaN,NaN,-13.708556009767689,-6.079830584872868
2010-02-10T09:30:00-05:00,29.06,29.07001,28.66,28.91,5566219,6524917.25,42.992194318542204,42.03016984342578,NaN,NaN,-80.98788625047757,-98.88687905018921,-0.06487847987778317,-0.23118574484538001,-0.16630726496759685,34163325,38684887,33.118887691401454,44.28005004648263,NaN,NaN,-13.83991424622917,-7.188413965066625
2010-02-11T09:30:00-05:00,28.83,29.25,28.64999,29.25,5827508,6585502.6,48.37633652096084,42.810035849765256,NaN,NaN,-50.85555847147023,-90.58203109437154,-0.03047157226164296,-0.20439673029465055,-0.1739251580330076,39990833,37181973.6,31.140331798911532,43.21563626751729,NaN,NaN,-12.181778197704306,-7.901751712586294
2010-02-12T09:30:00-05:00,28.91,29.25,28.85001,29.25,6334367,6620206.3,48.37633652096084,43.39297514988592,NaN,NaN,-35.21383538456031,-70.09421205381305,-0.005722976504176885,-0.1810788786632287,-0.1753559021590518,39990833,37339839.2,31.602553890011023,42.48081894623704,NaN,NaN,-10.884155882511696,-8.327809451147065
2010-02-16T09:30:00-05:00,29.56,29.72,29.28,29.72,4520871,6551778.35,55.16504613033169,44.407424598581436,NaN,NaN,64.06568708308667,-34.783739325025444,0.04168196002353902,-0.12325345212962802,-0.16493541215316704,44511704,39677247.8,38.21552945594668,42.461473265052916,NaN,NaN,-7.515000006925689,-8.211693816258297
2010-02-17T09:30:00-05:00,29.85001,29.96001,29.675,29.96001,4630828,6562396.9,58.18880498800187,45.56809382271528,NaN,NaN,141.11126284599277,7.62393396451427,0.08602998079435092,-0.05739793616022837,-0.1434279169545793,49142532,41559845.4,42.99599252003168,42.749815097002,NaN,NaN,-3.737210467614944,-7.572481909309246
2010-02-18T09:30:00-05:00,29.89,30.16,29.8,30.14999,5917602,6606871.9,60.46185972482101,47.06227679821939,NaN,NaN,178.22434784312443,59.46638078323467,0.12274831201149286,0.010007473059786776,-0.11274083895170608,55060134,45739207.2,51.89459254768191,43.620184056809244,NaN,NaN,0.10099961528370088,-6.476270262938826
2010-02-19T09:30:00-05:00,30.17,30.32001,30.0099,30.22,5749922,6555042.6,61.29688592308917,48.78886982365346,NaN,NaN,189.58478056355645,107.55444859024001,0.1448236926707673,0.06828877688675306,-0.07653491578401425,60810056,49903051.8,58.79582626017258,44.826976824412554,NaN,NaN,3.458551252258421,-5.057010046482077
2010-02-22T09:30:00-05:00,30.31,30.35001,30.14999,30.21001,3557171,6228300,61.09859393215529,49.965713720976446,NaN,NaN,159.7472612904496,146.546667925242,0.1511284320736349,0.11237562430802939,-0.038752807765605524,57252885,53355462.2,63.47467985321644,46.08804366220283,NaN,NaN,6.122516397175256,-3.4599348402453147
2010-02-23T09:30:00-05:00,30.14999,30.32001,29.92999,30.03,5725301,6248986.9,57.48971162576793,50.39199137349287,NaN,NaN,114.514813304466,156.63649316951785,0.136023202738384,0.13127619565737447,-0.004747007081009523,51527584,54758638.2,65.20410083925005,47.21096552226028,NaN,NaN,7.410576380946293,-1.907004665789371
2010-02-24T09:30:00-05:00,30.17,30.45,30.03999,30.42,6335961,6290442,62.638639872990154,51.163523333670376,NaN,NaN,126.26254540029767,153.66674968037884,0.1443571430190601,0.1756994216928156,0.031342278673755504,57863545,56502840.8,67.27812737342765,48.30247258087048,NaN,NaN,10.12743834282869,-0.1877985217010767
2010-02-25T09:30:00-05:00,29.89999,30.48,29.89999,30.47,5719000,6224306.25,63.2531554854895,52.83581124888635,NaN,NaN,108.25848721984288,139.67357755572252,0.14491839697473602,0.21249027489217553,0.06757187791743952,63582545,58207323,69.20957171913517,49.47540967404613,NaN,NaN,12.525914446330377,1.6284461880177024
2010-02-26T09:30:00-05:00,30.48,30.60001,30.3,30.52,6311195,6225237.3,63.892727728135526,54.618270591307876,NaN,NaN,117.99226970999837,125.35507538501092,0.14024816152338934,0.2428820798216762,0.10263391829828686,69893740,60024059.8,71.16334074813851,50.76053708644054,NaN,NaN,14.693606741530138,3.4948976956623357
2010-03-01T09:30:00-05:00,30.67,31.02,30.575,31,8155207,6264851.55,69.39903662288776,56.93878922917564,NaN,NaN,145.41730075339143,122.48908327759928,0.1596656928342706,0.3022160343411251,0.1425503415068545,78048947,64183272.2,75.06438863073059,52.83981645751326,NaN,NaN,18.415134627895235,5.6263601145527495
2010-03-02T09:30:00-05:00,31.05,31.125,30.84,30.84,11935445,6417771.65,65.7970999662628,58.45903066859977,NaN,NaN,134.2140960581406,126.42893982833421,0.15195585536253325,0.33249516071002105,0.1805393053474878,66113502,67100455.8,77.37613644548512,55.46671855525289,NaN,NaN,20.469144869014414,7.746757936618701
2010-03-03T09:30:00-05:00,30.94,31.14,30.8007,30.92999,5255207,6405847.45,66.83956570758363,60.162414339245586,NaN,NaN,119.87182279155626,125.15079530658593,0.14325471074839088,0.3596076937829764,0.21635298303458553,71368709,69801488.6,79.29056621201589,58.76469559243963,NaN,NaN,22.47192346837158,9.850353012583398
2010-03-04T09:30:00-05:00,31.03999,31.25999,30.99001,31.21001,4601070,6392732.6,69.91257172931354,61.70071685412792,NaN,NaN,123.4558301945057,128.19026390151848,0.14618912659285593,0.39908939127565546,0.2529002646827995,75969779,72278935.4,80.88805125321244,62.3181041248897,NaN,NaN,25.152583583370024,12.036385951267201
2010-03-05T09:30:00-05:00,31.44,31.87,31.32001,31.78999,4801574,6126503.5,75.06646781613384,63.60715480378313,NaN,NaN,154.5845093400549,135.50871182752977,0.1750722112352755,0.47174052872689387,0.29666831749161837,80771353,74454458,82.18743932863643,65.93131022764865,NaN,NaN,29.36957015385045,14.512555123064807
2010-03-08T09:30:00-05:00,31.8,31.91,31.66,31.87,4498246,5936221.05,75.68524796303268,65.07288350611891,NaN,NaN,155.30128188033353,137.4855080529182,0.18639937738521783,0.5296675392231407,0.34326816183792286,85269599,75898588.4,83.0130527374556,69.13113331918501,NaN,NaN,32.92938313575969,17.14353055344979
2010-03-09T09:30:00-05:00,31.75999,31.97,31.71001,31.82001,5552309,5894994.3,74.4421790901645,66.23383879913054,NaN,NaN,141.18733436189817,138.8801557136697,0.17740790698982767,0.5650280455752075,0.3876201385853798,79717290,78619346,84.47321169481188,72.09379183166931,NaN,NaN,35.432236863091276,19.756202883398572
2010-03-10T09:30:00-05:00,31.85001,32,31.75,31.89,5215926,5810546.45,75.05979921544599,67.2765487627466,NaN,NaN,127.38101843937721,140.38199484323388,0.16340495137993677,0.5918763278103008,0.428471376430364,84933216,81332247.4,85.7852675685375,74.514554333159,NaN,NaN,37.67407768561482,22.31589928371518
2010-03-11T09:30:00-05:00,31.77,32.12,31.73,32.12,5052902,5784880.6,77.0246779404438,68.39996247827193,NaN,NaN,121.38745011628171,139.9683188275891,0.15683398344790356,0.6245138557402434,0.46767987229233987,89986118,84135515.2,87.00704961796782,76.52964171585866,NaN,NaN,40.203440414773226,24.871262302437756
2010-03-12T09:30:00-05:00,32.22,32.24001,31.995,32.21001,3636826,5675346.5,77.76302265026547,69.5902788152798,NaN,NaN,121.94683823035746,133.4407846056496,0.1459744112774617,0.650147886389167,0.5041734751117053,93622944,86705833.4,88.02351245364542,78.28312975874644,NaN,NaN,42.5262078296886,27.393397377759307
2010-03-15T09:30:00-04:00,32.11,32.3,31.94,32.17,4926035,5604929.9,76.58486613225685,70.95421842288614,NaN,NaN,111.06741871592983,124.59401197276887,0.12436582391176287,0.6596307550014089,0.535264931089646,88696909,87391295.4,88.28668745383834,79.93188594550274,NaN,NaN,44.13500926935739,29.785056219416177
2010-03-16T09:30:00-04:00,32.17,32.42999,32.17,32.41,5085500,5633161.35,78.67224977829369,72.09947627326497,NaN,NaN,114.79279576985942,119.31510425436113,0.1147388490971849,0.6786884924611272,0.5639496433639423,93782409,90204319.2,89.3235403257186,81.50655829923781,NaN,NaN,46.15776268383737,32.12401428576206
2010-03-17T09:30:00-04:00,32.58,32.64,32.42,32.57001,5350730,5669156.45,79.95525030832874,73.29248304632492,NaN,NaN,118.38261826570579,117.51542421962681,0.10776009085969518,0.6986497569385612,0.5908896660788661,99133139,93044303.8,90.26085515872099,83.01022140206537,NaN,NaN,48.26574205953909,34.429975396301636
2010-03-18T09:30:00-04:00,32.57001,32.7,32.53,32.56,6316176,5689085.15,79.63251694183553,74.41675370444635,NaN,NaN,110.04750840245632,115.24743587686173,0.09171113525992747,0.7055285851537754,0.6138174498938479,92816963,93610472.8,90.44102591217762,84.38719891378244,NaN,NaN,49.91630813362206,36.64230864449027
2010-03-19T09:30:00-04:00,32.63,32.73,32.22,32.39999,4925344,5647856.25,74.4587111063122,74.77815902469095,NaN,NaN,88.97220538743075,108.65250930827638,0.061036790643427485,0.6901134381981322,0.6290766475547047,87891619,92464207.8,86.93448287140747,85.23506278811651,NaN,NaN,49.94632889138694,38.542882965475506
2010-03-22T09:30:00-04:00,32.10001,32.81,32.08,32.74001,5077520,5723873.7,77.76472192180519,75.63298916437255,NaN,NaN,90.31016830789953,104.50105922667032,0.054575166610251635,0.6972956058175193,0.6427204392072676,92969139,93318653.8,87.32886170419908,85.9459717351675,NaN,NaN,50.92490748609683,40.31174361127855
2010-03-23T09:30:00-04:00,32.83,32.92999,32.55,32.87,6255180,5750367.65,78.88970484540347,76.49371338850254,NaN,NaN,107.06112597762842,102.95472526822411,0.050100323993751084,0.7053458441994565,0.6552455202057054,99224319,94407035.8,87.8326681947482,86.55612187679125,NaN,NaN,52.075489698833465,41.99227876664354
2010-03-24T09:30:00-04:00,32.69,32.84,32.59,32.74001,5829180,5725028.6,74.81339300743927,76.8437720512258,NaN,NaN,96.99773868118233,98.67774935131942,0.030399831111209363,0.693245309094717,0.6628454779835077,93395139,93259435.8,84.03846896716762,86.78115171350234,NaN,NaN,51.87307355354855,43.403820879058536
2010-03-25T09:30:00-04:00,32.98,33.28999,32.89,32.92999,5544859,5716321.55,76.7076665386369,76.9610005314046,NaN,NaN,123.24878189840432,101.31800405050903,0.022539378529579435,0.691019701145482,0.6684803226159025,98939998,94484042.8,84.79336651597006,86.96728936974046,NaN,NaN,52.238826449464604,44.665964531973685
2010-03-26T09:30:00-04:00,32.98,33.25999,32.88,33.06,6112773,5706400.45,77.93090494660507,77.12140460165976,NaN,NaN,119.05471727107482,107.33450642723786,0.018633574639909556,0.6917722909157895,0.67313871627588,105052771,97916273.2,86.69295479118536,87.23013951643543,NaN,NaN,52.898005748724785,45.84197042008098
2010-03-29T09:30:00-04:00,33.23,33.25,32.96001,33.11,5478367,5572558.45,78.40070770347265,77.4041566454675,NaN,NaN,115.10776576889467,112.29402591943688,0.012262695662175305,0.6884670858535991,0.6762043901914238,110531138,101428673,88.30324446648275,87.50371328584049,NaN,NaN,53.57492373333784,46.946678036260536
2010-03-30T09:30:00-04:00,33.13,33.24001,32.94,33.08,4150184,5183295.4,77.33692271691756,77.56680832414403,NaN,NaN,104.69721427740764,111.8212435793927,-0.0004526348902411659,0.6756385965786222,0.6760912314688634,106380954,102860000,88.89308604969685,87.72570032020901,NaN,NaN,53.85164177169553,47.933101427036966
2010-03-31T09:30:00-04:00,33,33.00999,32.78,32.84,8236105,5332340.3,69.2425767131154,77.01094395076343,NaN,NaN,71.67929894282719,106.75755563172167,-0.029878663893808444,0.6387429016016029,0.6686215654954113,98144849,103809942,89.27947863979051,87.88801667891063,NaN,NaN,51.793572442739524,48.484597286423046
2010-04-01T09:30:00-04:00,33.00999,33.2,32.84,33.07001,5910988,5397836.2,72.24116146410486,76.6165252946091,NaN,NaN,90.26740118522119,100.16127948908505,-0.03817303419216178,0.6209052727552091,0.6590783069473709,104055837,104833109.8,89.69529852548231,88.00742996975613,NaN,NaN,50.818371284579754,48.817993571874005
2010-04-05T09:30:00-04:00,33.2,33.5,33.07001,33.47,5628789,5439196.95,76.526885435893,76.6123838162974,NaN,NaN,130.23095564899293,102.39652716466867,-0.021852955043260125,0.6317621131432958,0.6536150681865559,109684626,105759480.8,90.07081227238265,88.13486745679502,NaN,NaN,51.26523623373625,49.16759966642576
2010-04-06T09:30:00-04:00,33.39999,33.58,33.28999,33.52,3415249,5385047.1,77.00481658586438,76.4932814454096,NaN,NaN,134.5310773209651,106.28118947508275,-0.013246278213178586,0.6370572204200826,0.6503034986332612,113099875,106273228.2,90.28230863210666,88.2033509072513,NaN,NaN,51.76862447964289,49.53917463974249
2010-04-07T09:30:00-04:00,33.44,33.53999,33.14999,33.39999,4768656,5345864.45,73.15474137938938,76.0075308076282,NaN,NaN,108.7317572034661,107.08809806029447,-0.02074483882254108,0.6243724501050849,0.645117288927626,108331219,106663281.2,90.44865464364443,88.21676515617442,NaN,NaN,51.03179699153766,49.752406404284656
2010-04-08T09:30:00-04:00,33.24001,33.77,33.21001,33.72,8560863,5513111.3,76.52516620991126,75.78557718391933,NaN,NaN,131.0393542022562,118.96010911218029,-0.00981643319375125,0.6328467474354369,0.6426631806291881,116892082,110412727.8,91.8864257139722,88.32000799915974,NaN,NaN,51.42308468876353,49.99107473063878
2010-04-09T09:30:00-04:00,33.78,34,33.5809,33.97,4365570,5478744.7,78.76786926816453,76.09337419548021,NaN,NaN,162.22077504855955,133.35078388484797,0.00764325179510239,0.6522172453730661,0.6445739935779637,121257652,113853090.8,92.93701981752231,88.74876063816794,NaN,NaN,52.47788152010491,50.34633284341965
2010-04-12T09:30:00-04:00,33.97,34.07001,33.925,33.97,3807428,5487274.8,78.76786926816453,76.16502757736302,NaN,NaN,166.9637559981031,140.69734395466998,0.012309514145721678,0.6599608862601158,0.6476513721143942,121257652,116167696,93.5428118062756,89.19261421688769,NaN,NaN,53.309347670530386,50.76962067586404
2010-04-13T09:30:00-04:00,33.92999,34.25,33.87,34.14999,5874109,5534678.5,80.33645680780594,76.26836700324891,NaN,NaN,164.83800240814122,146.75872897210522,0.02017097929127798,0.6728650962284917,0.6526941169372137,127131761,118974073.2,94.19313745951662,89.64693345008543,NaN,NaN,54.49501562340239,51.301819954083804
2010-04-14T09:30:00-04:00,34.28,34.72,34.17999,34.67999,5078609,5534333.95,84.06876014736295,76.92946465610059,NaN,NaN,192.8986816410794,163.5921138596279,0.05191387142478898,0.7175864562181999,0.665672584793411,132210370,123749903.4,95.09793959657189,90.43689563790001,NaN,NaN,56.88989706610429,52.100116684372445
2010-04-15T09:30:00-04:00,34.62,34.89,34.57001,34.83,6723234,5602959.15,84.94005958802227,77.51749273105669,NaN,NaN,188.1044811624848,175.0051392516736,0.07259276818779903,0.7564135450281597,0.6838207768403607,138933604,128158207.8,95.75538246324851,91.21989677699135,NaN,NaN,59.11431176958628,53.10214455368871
2010-04-16T09:30:00-04:00,34.72,34.82001,34.14999,34.37,12112000,5892750.35,71.94595026754973,77.08999596826702,NaN,NaN,127.34661622403104,168.0303074867679,0.04615807835109753,0.7415183747792327,0.6953602964281351,126821604,129270998.2,95.90469361180885,91.87787812132159,NaN,NaN,56.51412392727292,53.589570178486454
2010-04-19T09:30:00-04:00,34.3,34.52,33.92999,34.42999,9300211,6111493.7,72.53601973999288,76.67108968516132,NaN,NaN,95.68360887325878,153.77427806179904,0.024658598709202728,0.7261835448146385,0.7015249461054358,136121815,132243830.8,96.28106297503409,92.44772230050383,NaN,NaN,54.68806258307563,53.746497664856335
2010-04-20T09:30:00-04:00,34.67,34.88,34.575,34.85001,9344250,6324830.2,76.29539813852544,76.59669507241902,NaN,NaN,132.01824469331325,147.21032651883343,0.030299523025434594,0.7393993498872291,0.7090998268617945,145466065,135910691.6,96.68566904248489,93.00433537141727,NaN,NaN,54.37106756655723,53.83572193652789
2010-04-21T09:30:00-04:00,34.85001,35.07001,34.71001,35.00999,11293160,6576729.2,77.55560234035241,77.19048261722166,NaN,NaN,130.3075362216382,134.6920974349452,0.03599161613069035,0.7540893470251575,0.7180977308944672,156759225,140820462.6,97.13511032854719,93.56545192061417,NaN,NaN,54.53600515819454,53.93576239676598
2010-04-22T09:30:00-04:00,34.86,35.67,34.7,35.64,10561215,6813330.95,81.68496048800937,77.8650396903577,NaN,NaN,152.2566468323949,127.52253056892721,0.07133157626599007,0.8072622012269548,0.7359306249609647,167320440,146497829.8,97.54900509182104,94.12643096106694,NaN,NaN,56.1963662342986,54.258705802127785
2010-04-23T09:30:00-04:00,35.63,35.78999,35.455,35.67,6154094,6843792.7,81.85614429304715,78.2457010372973,NaN,NaN,157.9932415610486,133.6518556363307,0.08494785041584108,0.842115437980766,0.757167587564925,173474534,155828415.8,98.04810281325123,94.69623742827184,NaN,NaN,57.50938162879014,54.72308806307955
2010-04-26T09:30:00-04:00,35.83,36.13,35.71001,35.95,7600078,6918157.95,83.41429746349125,78.70352109998491,NaN,NaN,159.79730728898275,146.47459531947553,0.09999515407711546,0.8821615301613193,0.7821663760842038,181074612,164818975.2,98.38859707918928,95.27525803163488,NaN,NaN,59.12614087652022,55.35209560785679
2010-04-27T09:30:00-04:00,35.91,35.91,34.81,34.91,17206752,7504577.2,62.08680244157894,77.91295403299846,NaN,NaN,86.49502131838008,137.3699506444889,0.03068336936768934,0.8205205877938155,0.7898372184261262,163867860,168499334.2,98.503668834659,95.85061618813594,NaN,NaN,52.21785737948436,54.90434728951787
2010-04-28T09:30:00-04:00,35.02,35.11,34.55,34.78999,10607078,7827421.9,60.17482412678128,76.74507245563203,NaN,NaN,46.42444144189428,120.59333168854012,-0.02922794040838761,0.7533022929156417,0.7825302333240293,153260782,167799645.6,97.08424321705567,96.22188886692761,NaN,NaN,46.3724193699891,53.68550044387091
2010-04-29T09:30:00-04:00,34.95,35.63,34.95,35.56,8474402,7839336.75,67.1622959029944,75.91610292954847,NaN,NaN,90.60290251379145,108.26258282481942,-0.02324095121710834,0.7534790443026438,0.7767199955197521,161735184,166682594.4,94.73713325745499,96.35046839835137,NaN,NaN,43.99055168955221,52.30050776468252
2010-04-30T09:30:00-04:00,35.53,35.72,34.8,34.82001,10761266,8081850.65,56.84091926531366,74.34989221505911,NaN,NaN,58.9114155599016,88.44621762459003,-0.07257573429740505,0.6860003276479958,0.7585760619454008,150973918,162182471.2,85.74374875843948,95.79339246636309,NaN,NaN,37.82153645475631,50.23208329183592
2010-05-03T09:30:00-04:00,34.99001,35.69,34.89999,35.52,7932563,8197039.35,62.68302243380412,73.08893261691613,NaN,NaN,78.35484778781002,72.15772572435549,-0.061937347302588375,0.6811543778171654,0.7430917251197537,158906481,157748845,77.89776713843939,94.629437443429,NaN,NaN,35.22954153790858,48.08886304127487
2010-05-04T09:30:00-04:00,35.12,35.2,34.33,34.4825,15789750,8815764.4,51.545918512971,70.76587250017386,NaN,NaN,-3.8359946455743756,54.0915225315646,-0.12500800596685013,0.586831717661191,0.7118397236280412,143116731,153598619.2,71.31895999773457,92.93093890065491,NaN,NaN,28.301051905309514,45.262032878994106
2010-05-05T09:30:00-04:00,34.19,34.5,33.78,33.99001,26340896,9894376.4,47.25396877273127,68.0740088705102,NaN,NaN,-84.37002320607658,27.93262960197044,-0.19590561483282354,0.46695770508701173,0.6628633199198353,116775835,146301629.8,61.48657020996473,90.48316659684892,NaN,NaN,21.350288516382463,41.84606939862101
2010-05-06T09:30:00-04:00,33.74001,34.07001,31.03,32.78,30873696,11010018.05,38.72288385936002,65.70093269849666,NaN,NaN,-243.9108980074659,-38.97013050228103,-0.3133363762611274,0.27119284959342593,0.5845292258545534,85902139,131135020.8,46.98684354394528,86.98903444914437,NaN,NaN,11.873890194642515,37.56432951233837
2010-05-07T09:30:00-04:00,32.64,33.13,31.63,32.17999,29681872,12275833.15,35.31789998473455,63.042495573121066,NaN,NaN,-234.4222207805729,-97.63685777037593,-0.4141343697476151,0.06686126367003453,0.4809956334176496,56220267,112184290.6,35.66842754066916,82.65956048954686,NaN,NaN,3.342137751823641,32.67544497512198
2010-05-10T09:30:00-04:00,33.77,33.96001,33.49001,33.86,16425797,12906751.6,48.87381443754772,61.083811023051226,NaN,NaN,-83.290982353035,-129.96602379854494,-0.3527738232821041,0.0400283543150195,0.3928021775971236,72646064,94932207.2,28.854173713726055,77.81445368034981,NaN,NaN,1.9914224999477856,28.292013192954236
2010-05-11T09:30:00-04:00,33.52,34.35001,33.42,33.85001,12564207,13241256.5,48.80830908702326,59.03043293352771,NaN,NaN,-70.51911556543433,-143.30264798251693,-0.30003987569665846,0.017752332976300522,0.317792208672959,60081857,78325232.4,24.084344448196703,72.59654183175334,NaN,NaN,1.0325550292382706,24.397804883851954
2010-05-12T09:30:00-04:00,34.06,34.39,33.84,34.34,10334641,13504058.1,52.19285027067879,56.92385363228981,NaN,NaN,-36.7663179561108,-133.78190693252378,-0.22288590671129516,0.03918482528384004,0.2620707319951352,70416498,69053365,21.90694832950014,67.19353777730186,NaN,NaN,1.5572626646713228,21.134870281111866
2010-05-13T09:30:00-04:00,34.25999,34.33,33.53999,33.57001,10450352,13690414,46.940751141530114,54.429896978610024,NaN,NaN,-64.96372238809771,-97.99247180865014,-0.21437145794239215,-0.005893590432854978,0.20847786750953717,59966146,63866166.4,20.775327727689202,61.67405384261885,NaN,NaN,0.05531370282375884,18.123505055642138
2010-05-14T09:30:00-04:00,33.3,33.46001,32.75,33.00999,14208816,13795254.8,43.51128188586099,51.57968158020787,NaN,NaN,-114.15933196140396,-73.93989404481634,-0.23543688136328514,-0.08581823419456924,0.1496186471687159,45757330,61773579,20.319328890853484,56.09767754345201,NaN,NaN,-2.3580616385245623,15.197566956475466
2010-05-17T09:30:00-04:00,33.12,33.28999,32.38499,33.25999,13441254,14002306.95,45.42804117477829,50.38977006115067,NaN,NaN,-107.01240670437345,-78.68417891508403,-0.2217079189885003,-0.1275162515669095,0.09419166742159082,59198584,59084083,19.720228270493692,50.47028893172592,NaN,NaN,-3.5845900249644553,12.514401673412621
2010-05-18T09:30:00-04:00,33.49001,33.60001,32.49001,32.64,15789191,14324554,41.65332030350185,49.066805502345005,NaN,NaN,-98.92599920695217,-84.3655556433876,-0.2419056167204307,-0.20819035347894754,0.033715263241483155,43409393,55749590.2,18.973303391543254,44.890936087046455,NaN,NaN,-5.860242047363995,9.889452570444533
2010-05-19T09:30:00-04:00,32.42999,32.73,31.86,32.44,15400809,14529936.45,40.48467822954503,47.1612613828129,NaN,NaN,-122.77006007751996,-101.56630406766942,-0.2549549585886442,-0.28497843499432207,-0.030023476405677894,28008584,47268007.4,17.189823524080083,39.35184253466254,NaN,NaN,-8.032509139558998,7.329172326158314
2010-05-20T09:30:00-04:00,31.69,31.92999,31.12,31.17999,18538720,14928811.7,34.01063854295724,45.530527045501735,NaN,NaN,-160.64789461171307,-120.70313851239248,-0.329906049325049,-0.4424060380619892,-0.11249998873694017,9469864,37168751,15.340693583218709,34.32305287928963,NaN,NaN,-12.219716663829889,4.5364738990171425
2010-05-21T09:30:00-04:00,30.60001,31.89999,30.34,31.73,19606384,15601426.2,38.62446478641268,43.81205864211663,NaN,NaN,-146.311156009118,-127.13350332193531,-0.3234637265058686,-0.5168296468692759,-0.19336592036340733,29076248,33832534.6,14.775261199735738,29.814302455096506,NaN,NaN,-14.078267276972905,1.877225159589993
2010-05-24T09:30:00-04:00,31.7,31.96001,31.45,31.50999,14056762,15924260.4,37.495140133486494,42.80843161501059,NaN,NaN,-112.49776118657664,-128.23057421837592,-0.3147469443603125,-0.5867996008137979,-0.2720526564534854,15019486,24996715,13.369744233487822,25.6750727576503,NaN,NaN,-15.909170449906112,-0.6636884989094503
2010-05-25T09:30:00-04:00,30.77,31.83,30.48,31.83,14188578,15773351.7,40.23247192075606,42.3068961255838,NaN,NaN,-114.00956503268362,-131.24728738352223,-0.2698813365286784,-0.6094043271143335,-0.33952299058565505,29208064,22156449.2,12.943508585535312,22.207711213048196,NaN,NaN,-16.558673134315846,-2.9344005896817924
2010-05-26T09:30:00-04:00,32.03,32.39999,31.60001,31.73,13336340,15909814.8,39.64814265832711,42.37298603979572,NaN,NaN,-76.02768578977584,-121.89881252597343,-0.2308992171983063,-0.628147012083538,-0.39724779488523165,15871724,19729077.2,12.574547079916428,19.74969003704614,NaN,NaN,-17.25229422780094,-4.979813966555956
2010-05-27T09:30:00-04:00,32.45,32.87,32.155,32.87,10730402,16022614.8,48.780908530962456,43.33462950738343,NaN,NaN,-28.41486361276972,-95.45220632618475,-0.117988092432597,-0.5447329104259779,-0.42674481799338093,26602126,23155529.6,16.205636118900827,18.35949064977697,NaN,NaN,-14.980127838988988,-6.4084302340463895
2010-05-28T09:30:00-04:00,32.77,32.92,32.175,32.37,11275676,16048335.3,45.52682368807528,43.09555873956397,NaN,NaN,-32.16827075037212,-72.62362927443556,-0.06905073697164416,-0.5130582392079361,-0.444007502236292,15326450,20405570,15.644052331325653,17.415910551034088,NaN,NaN,-14.09816754300909,-7.5069641353267755
2010-06-01T09:30:00-04:00,32.14999,32.63,31.87,31.88,10932809,16198347.6,42.532423277456836,42.647281181737796,NaN,NaN,-51.91284835396525,-60.506646707913305,-0.061980720536192746,-0.521483402906533,-0.4595026823703402,4393641,18280401,15.205520020070622,16.781708806167945,NaN,NaN,-14.286768715813444,-8.475507646824871
2010-06-02T09:30:00-04:00,32,32.67999,31.91499,32.67999,7873813,15802550.75,48.48923266355083,42.38273706694294,NaN,NaN,-21.780915872304217,-42.060916875837414,0.0009424517066846105,-0.4583246177369844,-0.459267069443669,12267454,14892279,14.507304779684787,16.25316283832399,NaN,NaN,-12.53930830369137,-9.0560505978058
2010-06-03T09:30:00-04:00,32.89999,32.97,32.46001,32.78999,7889609,14879986.4,49.26792562579718,42.54896381581916,NaN,NaN,14.259363314966027,-24.00350705488905,0.051539065394007266,-0.3948432377011599,-0.4463823030951672,20157063,15749346.8,15.563535775637547,15.880891984606011,NaN,NaN,-10.908928102177622,-9.320747384144632
2010-06-04T09:30:00-04:00,32.17999,32.28,31.41,31.52,15224906,14097546.9,41.47278839037125,42.40335713756989,NaN,NaN,-77.87521797296,-33.89557792692712,0.0035720670403497357,-0.44191721929473005,-0.4454892863350798,4932157,11415353,14.582426280130335,15.471113226697216,NaN,NaN,-11.951431834696264,-9.69655944850915
2010-06-07T09:30:00-04:00,31.53999,31.81,30.92,30.92,11929813,13209943.95,38.38296510376695,41.90013741821193,NaN,NaN,-114.15234348331788,-50.29239247351627,-0.060909129412859364,-0.521625698101154,-0.46071656868829464,-6997656,6950531.8,13.629232745384996,15.036042117760877,NaN,NaN,-13.824239342871522,-10.286228004846633
2010-06-08T09:30:00-04:00,31.02,31.25999,30.53,31.17999,13775863,13077447.25,40.4531967111586,41.814414304473125,NaN,NaN,-121.40049530316979,-64.18992186335717,-0.07733951750033702,-0.5573909655637159,-0.4800514480633789,6778207,7427445,14.273824435542693,14.700365049475122,NaN,NaN,-14.68621741085859,-10.914797919991198
2010-06-09T09:30:00-04:00,31.42,31.9375,31.08,31.22,12343863,13066430.05,40.78292913234412,41.83571794038735,NaN,NaN,-76.08759468091023,-75.05125762507838,-0.07665361899161305,-0.5758684718028952,-0.4992148528112822,19122070,8798368.2,16.209668189222242,14.630353954128129,NaN,NaN,-15.277442541968428,-11.538032865987946
2010-06-10T09:30:00-04:00,31.57001,32.28,31.57001,32.28,10264988,13062947.4,48.86212077882227,42.896538100092,NaN,NaN,-9.223564080638344,-79.74784310419925,-0.000007431554683356989,-0.4992241422546364,-0.49921671069995305,29387058,10644367.2,18.866476422772834,14.882195585524853,NaN,NaN,-13.276887825352645,-11.78644071732576
2010-06-11T09:30:00-04:00,31.83,32.31,31.77,32.25,7718980,12926378.8,48.659776387782124,43.61334607161838,NaN,NaN,8.118665324765574,-62.54906644465414,0.05067003696659805,-0.4358791644917055,-0.48654920145830355,21668078,13991551.4,23.59700341906283,15.512320029762503,NaN,NaN,-11.743985195188577,-11.780375642734734
2010-06-14T09:30:00-04:00,32.64999,32.83,32.28999,32.34,6897277,12560801.85,49.33759054588404,44.45923538678964,NaN,NaN,61.43487475699927,-27.431622796590705,0.08995685132318915,-0.3741031373043171,-0.46405998862750625,28565355,21104153.6,32.59114515842694,16.88527723868673,NaN,NaN,-10.297577781482815,-11.568547376841602
2010-06-15T09:30:00-04:00,32.53999,33.12,32.46001,33.11,6946008,12236039.55,54.83195058928617,45.50205529168465,NaN,NaN,116.21932416169977,20.092341096383205,0.16323572613147974,-0.26001533096315654,-0.4232510570946363,35511363,26850784.8,38.85419008492374,18.73604020292876,NaN,NaN,-7.363678664508938,-10.967851846508363
2010-06-16T09:30:00-04:00,33.02,33.07001,32.66,32.88,7470352,11820097.6,52.98355812640657,46.45458496797604,NaN,NaN,113.38416043707068,57.98669211997939,0.18978905513350036,-0.18601473817776082,-0.3758037933112612,28041011,28634573,40.69609214517383,20.74472199330429,NaN,NaN,-5.447414809958291,-10.179217984144067
2010-06-17T09:30:00-04:00,32.92,32.97,32.38,32.67999,10401441,11570129.2,51.362077977110026,46.63895421412944,NaN,NaN,83.26034505636287,76.48347394737962,0.18714507195567032,-0.1418724533666733,-0.32901752532234363,17639570,26285075.4,39.028469606554616,22.37492438527956,NaN,NaN,-4.292657919234158,-9.33828083201408
2010-06-18T09:30:00-04:00,32.61,32.81,32.42999,32.47,7673602,11026873.3,49.64428293354904,46.93305844594899,NaN,NaN,63.55635791644788,87.5710124657161,0.16527593935717377,-0.12242260112587644,-0.2876985404830502,9965968,23944653.4,37.38505580126137,23.927853204560684,NaN,NaN,-3.783669910099258,-8.544764986026248
2010-06-21T09:30:00-04:00,32.91,32.92999,32.03,32.21001,8833859,10488247.05,47.52497823979035,47.2896695146871,NaN,NaN,35.09973877925055,82.30398527016635,0.12893569113410386,-0.12652892656542036,-0.2554646176995242,1132109,18458004.2,33.79265018509582,25.25550535920534,NaN,NaN,-3.920902197037337,-7.884213159027833
2010-06-22T09:30:00-04:00,32.21001,32.47,31.45,31.49001,9662176,10268517.75,42.15761785450818,46.8374113140412,NaN,NaN,-48.257112669942565,49.408697903837876,0.05577960979705443,-0.18574010545320618,-0.2415197152502606,-8530067,9649718.2,28.97838119895225,26.2891536748673,NaN,NaN,-5.591176714518183,-7.556636524097883
2010-06-23T09:30:00-04:00,31.5,31.73,31.17,31.47,12487262,10183451.95,42.01559813326034,46.31938792171713,NaN,NaN,-98.53246552101544,7.025372712220658,0.007927633655701177,-0.23161017318063415,-0.23953780683633533,-21017329,-161949.8,24.748791693384973,26.945243383277834,NaN,NaN,-6.999447310402853,-7.477038064998593
2010-06-24T09:30:00-04:00,31.33,31.33,30.62,30.72,11064305,10069850.2,36.986249455568355,45.998920854945496,NaN,NaN,-153.83683813883144,-40.39406392681819,-0.06816006500095823,-0.3247378880875331,-0.2565778230865749,-32081634,-10106190.6,21.347900484563368,27.428491540737333,NaN,NaN,-9.767188958885466,-7.804202478411003
2010-06-25T09:30:00-04:00,30.78,30.95,30.47,30.81,12418188,10154239.5,37.946170934905616,45.9677212714554,NaN,NaN,-145.36652568985002,-82.17864064807779,-0.10419453643847737,-0.3868209936346716,-0.2826264571961942,-19663446,-16032073.4,19.617859220037644,27.8562505746411,NaN,NaN,-11.783724621206114,-8.372705641667448
2010-06-28T09:30:00-04:00,30.8,30.92,30.55,30.58,7010215,9940966.45,36.41930115977185,45.67958587492778,NaN,NaN,-130.41411941304756,-115.2814122865374,-0.13341960647482554,-0.4494009652897262,-0.31598135881490064,-26673661,-21593227.4,18.132740141399978,28.13188741077376,NaN,NaN,-13.926663069833555,-9.166128131405463
2010-06-29T09:30:00-04:00,30.21001,30.21001,29.28999,29.49001,18822560,10335454,30.214488815665234,44.924697280879286,NaN,NaN,-193.7206847741205,-144.374126707373,-0.21142311160489102,-0.5802602483210144,-0.3688371367161234,-45496221,-28986458.2,16.359624648862265,28.14259858646233,NaN,NaN,-17.914466573427116,-10.415890765979984
2010-06-30T09:30:00-04:00,29.45,29.84,29.07001,29.13,11492520,10516389.35,28.488105063884717,43.46941044409804,NaN,NaN,-183.37234009545088,-161.3421016222601,-0.26884342795130783,-0.7048914216552582,-0.43604799370395037,-56988741,-36180740.6,14.839018750024294,27.854923038408863,NaN,NaN,-21.791270393175697,-12.040944998436515
2010-07-01T09:30:00-04:00,29.24001,29.47,28.64,29.37,15624742,10903146,31.30598416113625,42.229853856480474,NaN,NaN,-169.97300593948287,-164.56933518239038,-0.271448547444343,-0.7753586780093791,-0.5039101305650361,-41363999,-38037213.6,14.465374035703078,27.202663796740314,NaN,NaN,-24.177731651213676,-13.774771663118967
2010-07-02T09:30:00-04:00,29.44,29.50999,28.875,29.03999,6955078,10489654.6,29.57997756402915,40.818595786347984,NaN,NaN,-144.09884318976046,-164.31579868237245,-0.2753180192326137,-0.8480576546058032,-0.5727396353731895,-48319077,-43768339.8,13.347982669628763,25.828152190397585,NaN,NaN,-26.70974813389142,-15.622625444657888
2010-07-06T09:30:00-04:00,29.32001,29.67999,28.75999,29.03999,11804230,10483375.45,29.57997756402915,39.014883427401045,NaN,NaN,-122.41835982600674,-162.7166467649643,-0.2580891457464187,-0.8953510675562129,-0.6372619218097941,-48319077,-48097423,12.5588224102153,23.94991164220412,NaN,NaN,-28.767443142406556,-17.50045654433627
2010-07-07T09:30:00-04:00,29.08,29.89999,29.02499,29.86,12955539,10442359.25,39.23455342470691,38.03281166299393,NaN,NaN,-86.58313589660659,-141.2891369894615,-0.1756200443262239,-0.856786977217574,-0.6811669328913501,-35363538,-46070886.4,15.0895982003929,22.12087636043406,NaN,NaN,-27.783726041118804,-18.96949504387663
2010-07-08T09:30:00-04:00,30.16,30.1799,29.71001,30.12,7944074,10222369.8,41.952012966991205,37.360664162271156,NaN,NaN,-57.85644577301886,-116.18595812497509,-0.09192105482964974,-0.7960682514284123,-0.7041471965987626,-27419464,-40157031,22.168920138665726,20.91662282701342,NaN,NaN,-26.154153702292305,-19.99587485222173
2010-07-09T09:30:00-04:00,30.08,30.41,30.03999,30.41,5305688,9974404.8,44.91124282953074,37.02258986912699,NaN,NaN,-38.51367146715074,-89.89409123050866,-0.00971479805692066,-0.7162906941699134,-0.7065758961129928,-22113776,-36306986.4,26.467171234726152,20.136773929403763,NaN,NaN,-23.90482554462173,-20.55429637970744
2010-07-12T09:30:00-04:00,30.25,30.5374,30.14999,30.45,6895629,9933237.25,45.32526623254793,36.86546758289539,NaN,NaN,-29.824984737128364,-67.03931953998224,0.05131418097957563,-0.6424331698885233,-0.6937473508680989,-15218147,-29686800.4,33.28934882912144,20.10082383254845,NaN,NaN,-21.94404558449399,-20.752831980391235
2010-07-13T09:30:00-04:00,30.8,31.34,30.74001,31.21001,10565301,10116638.45,52.61260195771226,37.61225216169568,NaN,NaN,15.400124872974835,-39.475622600185936,0.14170281340345647,-0.5166188341137783,-0.6583216475172348,-4652846,-20953554.2,41.05817685520235,20.963666379423454,NaN,NaN,-17.92629396239444,-20.349040834963123
2010-07-14T09:30:00-04:00,30.97,31.16,30.78999,31.00999,8149363,10176806.2,50.69743394913625,38.2323832914011,NaN,NaN,16.048196369055873,-18.94935614705344,0.1841653451376014,-0.42811496609523303,-0.6122803112328344,-12802209,-16441288.4,44.645084341456815,22.384830140000016,NaN,NaN,-15.129498022480673,-19.603391861751344
2010-07-15T09:30:00-04:00,30.98,31.19,30.61,31.11,9929918,10299784.5,51.645221894212476,39.27945275130425,NaN,NaN,23.39496394968079,-2.699074202513497,0.21309023296360086,-0.3459175200283333,-0.5590077529919342,-2872291,-11531853.8,48.32943778323387,24.312082804190766,NaN,NaN,-12.54533976158935,-18.595098704585347
2010-07-16T09:30:00-04:00,30.92999,31,29.97,30.02,10392445,10299334.7,42.137469515349345,39.57883122133594,NaN,NaN,-16.362803550445634,1.7310993808275192,0.15558436357546213,-0.36452729852260646,-0.5201116620980686,-13264736,-9762045.8,49.630949886723144,26.455874994668303,NaN,NaN,-13.03034551640142,-17.800133963416215
2010-07-19T09:30:00-04:00,30.09,30.42999,29.89999,30.31,5211285,10176218.85,45.03666166991984,40.194356972060795,NaN,NaN,-18.450292863892955,4.006037755474601,0.13463369053709878,-0.3518195489266951,-0.4864532394637939,-8053451,-8329106.6,50.71342996603091,28.783067124999082,NaN,NaN,-12.534275580281406,-17.04786848011124
2010-07-20T09:30:00-04:00,29.91,30.81,29.89999,30.74001,10597340,10264392.9,49.10849604459066,41.54392891698404,NaN,NaN,17.305866308954275,4.387186042670492,0.14632162897573708,-0.30355120324412255,-0.44987283221985963,2543889,-6889759.6,51.833193781680045,31.31689349162892,NaN,NaN,-10.848118873267383,-16.162189964847833
2010-07-21T09:30:00-04:00,30.89999,30.89999,30.09,30.19,9884559,10275512.05,44.56122504734241,42.69200891580244,NaN,NaN,16.83804809343957,4.545156387547232,0.11497803224197822,-0.30615029191738685,-0.4211283241593651,-7340670,-5797451.8,52.711245149951026,34.02205252019512,NaN,NaN,-10.827062063779001,-15.400028836123715
2010-07-22T09:30:00-04:00,30.52,31.25999,30.52,31.10001,10438535,10173075.7,52.41261124290474,44.19962513592876,NaN,NaN,88.99911796843372,17.66598719129782,0.15121919338907297,-0.23210433242302386,-0.38332352581209683,3097865,-4603420.6,53.704736202098815,36.82486410350909,NaN,NaN,-8.169832695438476,-14.36714367316868
2010-07-23T09:30:00-04:00,31.14999,31.58,30.88,31.55,8268023,10033261.6,55.74986118220357,46.06890253722694,NaN,NaN,127.72203293869148,46.48295448912525,0.19821928904890596,-0.13554941450096436,-0.3337687035498703,11365888,322704.2,57.657134842005796,39.98980354439317,NaN,NaN,-4.873388086464106,-13.010892875068027
2010-07-26T09:30:00-04:00,31.64999,32.03,31.45,32.02,9000773,9862390.85,58.98518182307068,48.169274270015606,NaN,NaN,166.3603353406249,83.44508013002881,0.2503242633452646,-0.020863374368289556,-0.27118763771355414,20366661,6006726.6,61.718298274757025,43.50119467757472,NaN,NaN,-1.0734658047235903,-11.305546150733107
2010-07-27T09:30:00-04:00,32.17999,32.17999,31.50999,31.61,10768090,10050284.6,55.19407654612186,49.30924020725954,NaN,NaN,141.42894111935107,108.26969509210817,0.246167364029965,0.036521567323902104,-0.2096457967060629,9598571,7417663,62.67527888265317,46.900171869164744,NaN,NaN,0.8453477601911367,-9.569704163458216
2010-07-28T09:30:00-04:00,31.56,31.74001,31.25,31.39,5164242,9367368.7,53.21755590209667,50.11392184548135,NaN,NaN,98.23788197657505,124.54966186873528,0.21852881474774782,0.0635152217286219,-0.15501359301912593,4434329,9772662.8,64.28032502076093,49.90812936074297,NaN,NaN,1.787545989231457,-7.9472398559311195
2010-07-29T09:30:00-04:00,31.53,31.85001,30.85001,31.23,7490719,9167278.65,51.76566928588794,50.60352373522115,NaN,NaN,74.83381947531647,121.71660217011181,0.18095226906175294,0.07117674330806523,-0.1097755257536877,-3056390,8541811.8,62.76124110857311,52.50056292316061,NaN,NaN,2.12245242810864,-6.508712386782582
2010-07-30T09:30:00-04:00,30.85001,31.56,30.71001,31.44,7746988,8773390.95,53.55662776887797,51.1914781306733,NaN,NaN,60.60210304244801,108.29261619086313,0.16231671316647367,0.0931203657044044,-0.06919634746206926,4690598,7206753.8,61.07527641522914,54.48527203645402,NaN,NaN,2.9193013039262663,-5.1618532881098895
2010-08-02T09:30:00-04:00,31.88,32.14,31.69,32.11,9197059,8885490,58.81132045805447,51.634243737840606,NaN,NaN,126.8885504555886,100.39825921385587,0.18551608209141196,0.16269875515219567,-0.022817326939216273,13887657,5910953,59.40718921204132,55.795915776228235,NaN,NaN,5.230373547330049,-3.6772494544756125
2010-08-03T09:30:00-04:00,32.06,32.06,31.49001,31.62,6943367,8642446.85,53.999399681303366,51.8700984329954,NaN,NaN,95.05901143358929,91.12427327670352,0.15926930345668303,0.17626930238163752,0.01699999892495449,6944290,5380096.8,58.69987269060593,56.799829229738876,NaN,NaN,5.736386263586496,-2.3324443518953113
2010-08-04T09:30:00-04:00,31.87,32.19,31.85001,32.14999,7090445,8349192.15,58.002001685129066,52.32415413234658,NaN,NaN,126.24977072461407,96.72665102631133,0.16813690892732966,0.22717113508411657,0.05903422615678691,14034735,7300178,60.53035446321688,57.671323278309096,NaN,NaN,7.417010950981679,-0.9396650229128842
2010-08-05T09:30:00-04:00,31.98,32.25,31.89,32.25,6256789,8264827.9,58.73172077007211,53.50945779339821,NaN,NaN,122.0312732108745,106.16614177342294,0.17072513843039816,0.2724406491947846,0.10171551076438645,20291524,11969760.8,64.63546739878097,58.74307452917037,NaN,NaN,8.990588995591288,0.4789426940162831
2010-08-06T09:30:00-04:00,31.83,32.11,31.53999,32.03,6408539,8319970.45,56.409809173623344,54.32182547223418,NaN,NaN,84.84881529796675,111.01548422452667,0.1484304897384045,0.2872536229373921,0.1388231331989876,13882985,13808238.2,66.12913206358616,59.844196107567164,NaN,NaN,9.631245934245072,1.7864145854775386
2010-08-09T09:30:00-04:00,32.32001,32.41,32.175,32.34,6251523,8287765.15,58.87688584652721,55.01956760094394,NaN,NaN,124.84816130865417,110.60740639513979,0.14519351609264297,0.3203150283147913,0.17512151222214833,20134508,15057608.4,67.14469812082447,60.93787498893463,NaN,NaN,10.888093418917023,3.0866544188260363
2010-08-10T09:30:00-04:00,32.05,32.23,31.81,32.06,8057605,8162380.35,55.804712127431884,55.82267382095032,NaN,NaN,80.54082316851503,107.70376874212494,0.11608786441947228,0.3202313427464887,0.2041434783270164,12076903,16084131,67.99383470274442,62.02948852841987,NaN,NaN,11.077212220487704,4.228162676206274
2010-08-11T09:30:00-04:00,31.53,31.5419,31.155,31.22,7561422,8132983.3,47.75428023073094,55.48993589150933,NaN,NaN,-10.125532116179947,80.42870817396614,0.03629151341074746,0.24950787009045072,0.21321635667970326,4515481,14180280.2,64.65625449883825,62.81173983532983,NaN,NaN,8.739855753447634,4.8726902586693255
2010-08-12T09:30:00-04:00,30.71001,31.17,30.71001,31.10001,8202184,8046596.6,46.71751951088448,54.84476862927226,NaN,NaN,-49.46784173517184,46.12888518475686,-0.025227088897092353,0.18168249555833782,0.20690958445543017,-3686703,9384634.8,57.058560129554714,62.76898449872618,NaN,NaN,6.530329149998175,5.109495814573447
2010-08-13T09:30:00-04:00,30.92999,31.06,30.73,30.75,5865926,7820270.65,43.73479329198308,53.755455162766,NaN,NaN,-74.73977964540138,14.211166196083237,-0.086686487023234,0.09855147567638767,0.18523796269962167,-9552629,4697512,50.77809726256657,61.987541569284005,NaN,NaN,3.7499344631819627,4.915272764374663
2010-08-16T09:30:00-04:00,30.58,30.95,30.45,30.74001,5468273,7833120.05,43.649133116830264,52.93081634638803,NaN,NaN,-100.58875938401991,-30.876217942451582,-0.1229901158185708,0.03150031792640817,0.15449043374497898,-15020902,-2333570,43.112071875619804,60.59016964021019,NaN,NaN,1.4697256436024682,4.423051747121493
2010-08-17T09:30:00-04:00,31.05,31.52,30.91,31.24001,5902016,7598353.85,49.030038828691225,52.63170798400193,NaN,NaN,-37.76629820082645,-54.537642216319874,-0.10879680981257736,0.018494421479257284,0.12729123129183464,-9118886,-6572727.8,39.26329546676655,58.80323895778202,NaN,NaN,0.9848987072631987,3.9318870271417365
2010-08-18T09:30:00-04:00,31.17999,31.72,31.05,31.53,6261949,7417223.35,51.89888726526585,52.64122355395749,NaN,NaN,-15.763470848559244,-55.66522996279573,-0.07685141755691768,0.031226959345687533,0.10807837690260522,-2856937,-8047211.4,37.99280844831358,57.03406519633491,NaN,NaN,1.3993292302525167,3.570093056157562
2010-08-19T09:30:00-04:00,31.33,31.44,30.74001,30.92,7904422,7290517.7,46.029880072209814,52.103598718481194,NaN,NaN,-84.00909612454878,-62.57348084067111,-0.09271409113753266,-0.00781423701931061,0.08489985411822205,-10761359,-9462142.6,36.7634465108803,55.29750591745285,NaN,NaN,-0.010123378647293721,3.0586335654711543
2010-08-20T09:30:00-04:00,30.8,30.96001,30.55,30.89999,6498730,7202053.05,45.846725882171235,51.17755624877525,NaN,NaN,-111.54412969766646,-69.93435085112412,-0.09984728898363825,-0.03990925711132576,0.05993803187231249,-17260089,-11003634.6,35.41881576792437,53.584050671444494,NaN,NaN,-1.1998059847403146,2.4502850582980873
2010-08-23T09:30:00-04:00,31.06,31.245,30.62,30.62,6399848,7072006.8,43.25328570629099,50.4099766791315,NaN,NaN,-97.73319160877537,-69.36323729607521,-0.11749883060995135,-0.0869355063901267,0.030563324219824647,-23659937,-12731441.6,33.92121235681333,51.814146361887886,NaN,NaN,-2.9653829493728914,1.6766182000593761
2010-08-24T09:30:00-04:00,30.28,30.44,29.86,30.10001,12284469,7147825.75,38.85710529381609,49.04248407975201,NaN,NaN,-176.8585936139811,-97.18169637870618,-0.15586617907738504,-0.16426939962690668,-0.008403220549521626,-35944406,-18096545.6,29.71911376505892,49.6133434548766,NaN,NaN,-5.8580525698970645,0.6002366614941705
2010-08-25T09:30:00-04:00,29.87,30.57001,29.8,30.41,7462320,7262729.65,42.602412267555636,47.89039061528655,NaN,NaN,-138.57286414519857,-121.74357503803405,-0.1518838789692748,-0.1982580692611151,-0.046374190291840325,-28482086,-23221575.4,26.359873088434725,46.87937243270902,NaN,NaN,-7.216753212059003,-0.5164761775848541
2010-08-26T09:30:00-04:00,30.48,30.67,30.16499,30.2,6280168,7202202.1,40.78000679362219,46.77397615957218,NaN,NaN,-111.61451336676515,-127.26465848647733,-0.1544047712605752,-0.23938015436755933,-0.08497538310698413,-34762254,-28021754.4,23.662106387913,43.846013455875216,NaN,NaN,-8.888004035447238,-1.7124087287080518
2010-08-27T09:30:00-04:00,30.45,30.74001,29.91,30.69,10502805,7339992.95,46.527790523232206,45.89189792219397,NaN,NaN,-88.73128676269171,-122.70208989948237,-0.11584530484162932,-0.22978201415902078,-0.11393670931739146,-24259449,-29421626.4,22.92523704656358,40.68748052199943,NaN,NaN,-8.64318459823015,-2.7025195672112083
2010-08-30T09:30:00-04:00,30.63,30.72,30.14999,30.14999,7020113,7231145.65,41.721774221385324,44.885973786047785,NaN,NaN,-91.83802884063516,-121.52305734585434,-0.11902761341408011,-0.2627212260849916,-0.1436936126709115,-31279562,-30945551.4,22.117745667101204,37.41061701945348,NaN,NaN,-9.915105967058109,-3.732889052903623
2010-08-31T09:30:00-04:00,30.03,30.42999,29.89999,30.19,7439875,7255971.05,42.19816774395079,44.489108608420636,NaN,NaN,-101.34999461080844,-106.42133754521979,-0.11091922662938647,-0.2823426459576446,-0.1714234193282581,-23839687,-28524607.6,26.54419963531609,34.68832738634477,NaN,NaN,-10.797369093537636,-4.74210048727991
2010-09-01T09:30:00-04:00,30.61,31.28,30.61,31.23,8337270,7318312.3,52.96181694839299,44.93512985395696,NaN,NaN,3.262162443162989,-78.05433222754749,-0.03208927277051582,-0.21153501029140287,-0.17944573752088705,-15502417,-25928673.8,31.06827835098734,32.831878687875665,NaN,NaN,-8.081727139354221,-5.219190009004812
2010-09-02T09:30:00-04:00,31.3,31.82001,31.28999,31.81,9735879,7492266.8,57.69338946139454,45.93217243748635,NaN,NaN,86.58579749953842,-38.414270054286774,0.0576522053719207,-0.10738048080598617,-0.16503268617790687,-5766538,-20129530.6,39.9638131233513,32.059429820788864,NaN,NaN,-4.1696435408390355,-5.069254799266844
2010-09-03T09:30:00-04:00,32.14999,32.39999,31.89999,32.28,7918109,7567745.3,61.10748404532572,47.17919750380745,NaN,NaN,153.32151717586922,9.996290733425429,0.1423770749111308,0.012938657461006642,-0.12943841745012416,2151571,-14847326.6,46.70967334999109,32.31640135467252,NaN,NaN,0.23319725901156507,-4.3117616480842145
2010-09-07T09:30:00-04:00,32.09,32.14999,31.69611,31.75999,5087547,7509546.5,55.74718770324843,47.658993851990104,NaN,NaN,119.63398735172649,52.290693971897745,0.15601158219347117,0.06557606029171481,-0.09043552190175635,-2935976,-9178609.4,52.83461463702015,33.285781295404924,NaN,NaN,2.1384265353820724,-3.3903061933033163
2010-09-08T09:30:00-04:00,31.8,32.13,31.78999,31.99001,4385977,7325965.1,57.52217502502235,48.06065726340129,NaN,NaN,134.60392443588603,99.48147778123663,0.1718828647001399,0.12441805897341851,-0.047464805726721376,1450001,-4120671.8,57.525503522153045,34.68097380067917,NaN,NaN,4.2407822905113175,-2.3001506956155113
2010-09-09T09:30:00-04:00,32.25999,32.3,31.88,32.02,5051910,7200489.5,57.760063382449104,48.898527499846956,NaN,NaN,131.7023673257736,125.16951875775877,0.17516691261840184,0.1714938350462809,-0.003673077572120917,6501911,280193.8,61.146371299697705,36.4226112855947,NaN,NaN,5.97825695019104,-1.1175210319288613
2010-09-10T09:30:00-04:00,32.05,32.37,32.03999,32.28999,5401734,7060467,59.93540548126478,49.904861756925065,NaN,NaN,128.3654905636322,133.52545737057753,0.1853063690231584,0.22795988370682707,0.04265351468366869,11903645,3814230.4,63.81409865652091,38.450845777637305,NaN,NaN,8.085696274156994,0.19722429751197512
2010-09-13T09:30:00-04:00,32.63,32.72,32.44,32.67999,4158555,6975098.45,62.907052765367595,51.30870226114482,NaN,NaN,143.16642050684285,131.49443803677224,0.20644754273265487,0.30071294309948726,0.0942654003668324,16062200,6596356.2,65.80462370960231,40.72823230283651,NaN,NaN,10.792263461142792,1.7108013208878061
2010-09-14T09:30:00-04:00,32.63,32.87,32.47,32.71001,6494496,7026409.6,63.133724068785355,53.04274645935691,NaN,NaN,129.32469177452617,133.4325789213322,0.20993250611907452,0.35668103301567555,0.14674852689660103,22556696,11694890.6,69.15341872797383,43.54496837161616,NaN,NaN,13.053070115131554,3.3311254343511987
2010-09-15T09:30:00-04:00,32.53999,32.82001,32.47,32.77,5756703,7019143.95,63.61225846419333,54.54344975911675,NaN,NaN,112.35859541173,128.983513116501,0.20360234813147754,0.40125146206094797,0.19764911392947043,28313399,17067570.2,72.238677532107,46.82202583187846,NaN,NaN,15.059597379772422,5.00662142655423
2010-09-16T09:30:00-04:00,32.67999,32.81,32.52,32.77,6752551,7043674.05,63.61225846419333,56.17432487844325,NaN,NaN,100.24453814467194,122.69194728028064,0.1871596269706075,0.4315986476427298,0.2444390206721223,28313399,21429867.8,74.47133310311085,50.45125631153545,NaN,NaN,16.726840934744715,6.680938499152871
2010-09-17T09:30:00-04:00,32.81,32.8828,32.60001,32.75,6194406,6958173.25,63.29459227248136,57.371953574818185,NaN,NaN,92.75003144348844,115.56885545625191,0.16353757381447964,0.4488609879402219,0.28532341412574225,22118993,23472937.4,75.46649498567976,54.2042033071866,NaN,NaN,18.056565419475444,8.306028059198953
2010-09-20T09:30:00-04:00,32.85001,33.45,32.84,33.38,5130559,6889764.7,68.61188588206504,59.2926758362953,NaN,NaN,115.57418549991418,110.05040845486617,0.17776270778103892,0.5075267988520409,0.32976409107100196,27249552,25710407.8,76.54485206345109,58.09185376406874,NaN,NaN,20.812041002718065,10.09260133684454
2010-09-21T09:30:00-04:00,33.38,33.5,33.09,33.24001,13429566,7241250.6,66.31308697454588,61.0151700670521,NaN,NaN,108.66983386846091,105.91943687365313,0.16541990025409936,0.5365389663886262,0.37111906613452683,13819986,23963065.8,73.816128393695,61.468420103952944,NaN,NaN,22.52919640998414,11.869257775864483
2010-09-22T09:30:00-04:00,33.24001,33.4118,32.89999,33.02,7609637,7007509,62.75450771382428,61.71464797886862,NaN,NaN,91.7884095037401,101.80539969205516,0.13158813719930906,0.5356042376336632,0.4040161004343541,6210349,19542455.8,67.28139975978263,64.05507163315261,NaN,NaN,23.04921054366743,13.466393885550618
2010-09-23T09:30:00-04:00,32.72,33.27,32.66,32.85001,10307238,7149754.9,60.07215286221101,61.88455965035551,NaN,NaN,73.39594162689527,96.43568038849983,0.08895327361551641,0.5152076924537496,0.42625441883823323,-4096889,13060398.2,59.02938626102337,65.41689828584347,NaN,NaN,22.766638077848583,14.79500019873604
2010-09-24T09:30:00-04:00,33.25999,33.73,33.25999,33.7,6072012,7139347.1,67.54278961327472,62.344224333780446,NaN,NaN,117.83294735227285,101.45226357025672,0.10792578540115327,0.5611616505896748,0.45323586518852155,1975123,9031624.2,54.551087840684076,65.97699932089297,NaN,NaN,24.773786426767145,16.22054108845477
2010-09-27T09:30:00-04:00,33.74001,33.74001,33.47,33.48,10002480,7114330.85,64.19486578167114,62.94762991081063,NaN,NaN,110.25673437081552,100.388773344437,0.09598778931242258,0.5732206018290498,0.4772328125166272,-8027357,1976242.4,47.72292162863329,65.61187839172248,NaN,NaN,25.429336559036784,17.536083298537914
2010-09-28T09:30:00-04:00,33.52,33.82001,33.12,33.74001,7046211,7115635.75,66.3196978305783,63.57602439692177,NaN,NaN,105.5066410209824,99.75613477494129,0.09571583642659642,0.5968776080498728,0.5011617716232764,-981146,-983984,45.16831714997462,64.72922222228117,NaN,NaN,26.61836756186084,18.833552479012617
2010-09-29T09:30:00-04:00,33.69,33.71001,33.41,33.5,4928789,6990081.45,62.62522425031093,63.92353588748334,NaN,NaN,103.7025202293554,102.13895692006435,0.07064192561655658,0.589464178643972,0.5188222530274155,-5909935,-3408040.8,43.13220876659791,63.44249632705975,NaN,NaN,26.519328622231313,19.93152049947243
2010-09-30T09:30:00-04:00,33.69,33.89,33.2,33.41,8593480,7002891.95,61.24739467778512,64.0172494015205,NaN,NaN,91.6298812212337,105.78574483893203,0.04074932442213752,0.5697589085550874,0.5290095841329499,-14503415,-5489346,41.406325818981784,61.84194112437838,NaN,NaN,26.04042402424617,20.804221003011538
2010-10-01T09:30:00-04:00,33.58,33.75,33.28999,33.45,7622430,6897219.5,61.651225867842896,63.92754748026874,NaN,NaN,82.74539134360873,98.7682336371992,0.017606901341327252,0.5510182108096089,0.5334113094682816,-6880985,-7260567.6,39.941598132283154,59.99458215456987,NaN,NaN,25.754346417795404,21.51138177655209
2010-10-04T09:30:00-04:00,33.34,33.62,33.11,33.38,6968785,6849753.3,60.463771527860985,63.73683658448844,NaN,NaN,59.74748383157676,88.66638352935145,-0.007151549521231315,0.5244718725667425,0.5316234220879739,-13849770,-8425050.2,38.96567154835389,57.838314498882724,NaN,NaN,25.194720104359426,22.03757296623885
2010-10-05T09:30:00-04:00,33.74001,34.16,33.67,34.08,8745859,7032668.9,67.25573229085725,63.99708471496443,NaN,NaN,130.95449920408717,93.75595516597241,0.017530884583460193,0.5535370278172991,0.5360061432338389,-5103911,-9249603.2,38.25293870657946,55.41076172563076,NaN,NaN,26.668626817560938,22.69915208785629
2010-10-06T09:30:00-04:00,34.00999,34.0607,33.71001,33.85001,5572828,7092011.45,63.401858268146626,63.982056129532516,NaN,NaN,110.61107061816936,95.1376652437352,0.0125182679690643,0.5516539781951693,0.539135710226105,-10676739,-10202964,37.4011095716535,52.76288861624095,NaN,NaN,26.7678340204827,23.28039236394578
2010-10-07T09:30:00-04:00,34.03999,34.07001,33.67,34.00999,4956465,7087239.2,64.90817262454237,64.09731186896543,NaN,NaN,111.31831741659062,99.07535248280658,0.014014581192651976,0.5566539367169199,0.5426393555242679,-5720274,-8446335.8,40.05011753859093,50.233147370020326,NaN,NaN,27.28716772474604,23.852788844060104
2010-10-08T09:30:00-04:00,34.00999,34.48,33.94,34.36,6482797,7141292.35,68.0103427489402,64.05434450231367,NaN,NaN,155.35706854106306,113.59768792229745,0.03160745491791572,0.5821486741716626,0.5505412192537469,762523,-6917634.2,42.336987701491026,47.789728487023176,NaN,NaN,28.665675357554534,24.540344060273593
2010-10-11T09:30:00-04:00,34.41,34.50999,34.28,34.37,4334594,7150094.3,68.09711758078835,64.18177525990242,NaN,NaN,160.04157020416997,133.6565051968161,0.036596409753972936,0.596286731446213,0.5596903216922401,5097117,-3128256.8,47.66622500296849,45.92187824482843,NaN,NaN,29.807925757643073,25.292855731326377
2010-10-12T09:30:00-04:00,34.3,34.53751,34.035,34.45,4975434,7074141.2,68.82566211192177,64.6154291454808,NaN,NaN,141.12854797554087,135.69131495110682,0.03780776899911065,0.6069500329411284,0.5691422639420177,10072551,-92964.4,51.530381374387865,44.79680550301452,NaN,NaN,30.964948161224363,26.103154649883233
2010-10-13T09:30:00-04:00,34.61,34.77,34.44,34.5,5934543,7083033.2,69.29757684163218,65.27438800115375,NaN,NaN,156.48506746647473,144.8661143207679,0.03458720159094508,0.612376265930699,0.577789064339754,16007094,5243802.2,57.475664295085885,44.685825362590414,NaN,NaN,32.06264966219101,26.954511080212917
2010-10-14T09:30:00-04:00,34.5,34.64999,34.24001,34.46001,4666223,6978716.8,68.4056598969462,65.33602159284456,NaN,NaN,118.75460837112885,146.35337251167556,0.022935833086791146,0.6064588556982429,0.5835230226114517,11340871,8656031.2,60.78752331050811,45.131285039006414,NaN,NaN,32.76287455205532,27.78427729047612
2010-10-15T09:30:00-04:00,34.6599,34.73,34.28999,34.71001,7859500,7061971.5,70.92506714478674,65.81675026163853,NaN,NaN,122.19122479994618,139.72020376345216,0.025065194704831262,0.6148545159924907,0.5897893212876595,19200371,12343600.8,64.04636901933861,46.29724556691394,NaN,NaN,34.06307372205972,28.681248209273775
2010-10-18T09:30:00-04:00,34.69,34.75999,34.46001,34.75999,6641188,7137502.95,71.41581212918365,66.18075842582464,NaN,NaN,119.3654848653728,131.58498669569275,0.022898488566029385,0.6184124319951962,0.5955139434291669,25841559,16492489.2,67.3355728138447,47.88062097147609,NaN,NaN,35.294539563342624,29.626004116997898
2010-10-19T09:30:00-04:00,34.36,34.49001,33.94,34.13,10575617,6994805.5,58.10329952256516,65.85776380241421,NaN,NaN,44.71802855046007,112.30288281067658,-0.025293614451424196,0.5638969253648867,0.5891905398163109,15265942,17531167.4,68.12184895409837,49.66559527058325,NaN,NaN,32.5473599321599,30.04334066202104
2010-10-20T09:30:00-04:00,34.25999,34.71001,34.2,34.57001,7039777,6966312.5,63.255279590868795,66.00118415334876,NaN,NaN,82.80882590122474,97.56763449762653,-0.031464685349842925,0.5498596831290072,0.5813243684788502,22305719,18790892.4,69.0935411472277,51.643253508315105,NaN,NaN,31.668732383327864,30.275539479350588
2010-10-21T09:30:00-04:00,34.74001,35.17999,34.5,34.77,10737742,6987837.7,65.3413837489446,66.26476685914174,NaN,NaN,121.12693670055623,98.042100163512,-0.026220090951975306,0.5485492547888811,0.5747693457408564,33043461,23131410.4,72.23404091371756,53.94985656413184,NaN,NaN,31.576355261636024,30.461370305391366
2010-10-22T09:30:00-04:00,34.7,34.99001,34.67,34.96001,4421266,6905300.4,67.24413897037263,66.74907881932114,NaN,NaN,116.98718714200785,97.00129263192431,-0.014672448403037275,0.5564287852370597,0.571101233640097,37464727,26784281.6,74.5754646816257,56.49341321650841,NaN,NaN,32.07652595249171,30.692106826405702
2010-10-25T09:30:00-04:00,35.17999,35.49001,35.14,35.17999,6289898,6719671.3,69.34258886602413,66.89814000326164,NaN,NaN,159.95600846109804,105.1193973510694,0.002166532975123703,0.5738093998590017,0.571642866883878,43754625,30366894.8,76.65475892866229,59.236400375228605,NaN,NaN,33.13611004826777,31.04125014381457
2010-10-26T09:30:00-04:00,34.98,35.45,34.89,35.33,6217426,6678232.05,70.72011742548341,67.42087280021427,NaN,NaN,138.92688252967383,123.96116814691213,0.016969035888018347,0.5928541617439009,0.5758851258558826,49972051,37308116.6,80.0577296407958,62.28330180873877,NaN,NaN,34.430548866831614,31.525435675674146
2010-10-27T09:30:00-04:00,35.06,35.17999,34.78,35.11,6434988,6753542,66.03393224346736,67.50128420156605,NaN,NaN,101.18060930364173,127.63552482739553,0.0060672922349063185,0.5834692411495155,0.5774019489146092,43537063,41554385.4,81.80502952278538,65.26579552189551,NaN,NaN,34.14163828885117,31.899178906128007
2010-10-28T09:30:00-04:00,35.31,35.38,35.03999,35.27,7742137,6710974.85,67.70976129187751,67.47981409749015,NaN,NaN,122.63867744452475,127.93787297618924,0.003862995889230114,0.5822306937761468,0.5783676978869167,51279200,45201533.2,83.16908239921914,68.18237371459038,NaN,NaN,34.38673268625402,32.254543731860295
2010-10-29T09:30:00-04:00,35.27,35.36,35.1098,35.25999,6755469,6667626.8,67.4854282584415,67.4361220030368,NaN,NaN,114.34400191073033,127.40923592993374,-0.0036328016995172963,0.57382669576252,0.5774594974620373,44523731,46613334,83.67914957771603,70.75472546992948,NaN,NaN,34.52397990472731,32.57874889941272
2010-11-01T09:30:00-04:00,35.33,35.58,35.02,35.19,6587754,6648575.25,65.84280905206387,67.22306107018981,NaN,NaN,107.45241630613133,116.90851749894038,-0.017871771244057477,0.5551197834069654,0.5729915546510229,37935977,45449604.4,81.48699473758829,72.89448356730095,NaN,NaN,34.19283750998239,32.80933298663696
2010-11-02T09:30:00-04:00,35.49001,35.73,35.379,35.59,7291359,6575850.25,70.2931400944279,67.29417273110379,NaN,NaN,138.74856525372823,116.87285404375127,-0.005556402821807915,0.566046051123763,0.571602453945571,45227336,44500661.4,79.65452360259822,74.47868780355182,NaN,NaN,35.17675283363242,33.14753582192203
2010-11-03T09:30:00-04:00,35.72,35.78,35.21001,35.77,8126094,6703513.55,72.05744438854192,67.55501448050349,NaN,NaN,127.56300978293046,122.14933413960901,0.008729896358223077,0.5825148243933498,0.5737849280351267,53353430,46463934.8,80.62527862510284,75.8956703260229,NaN,NaN,36.53349894778303,33.63124483990217
2010-11-04T09:30:00-04:00,36.16,36.37,36.14999,36.33,9105051,6910942.85,76.69479449554018,67.96713786270016,NaN,NaN,204.83183200615974,138.587965051936,0.04773344039498195,0.6334517285288541,0.5857182881338722,62458481,48699791,81.6963706009218,77.15638472470741,NaN,NaN,39.30908445729657,34.44236478524423
2010-11-05T09:30:00-04:00,36.37,36.5999,36.32001,36.50999,6864598,6930032.9,77.9608248841781,68.43463877377118,NaN,NaN,197.01206289547514,155.12157724888496,0.07582449983313222,0.6804989129252874,0.6046744130921552,69323079,53659660.6,83.83170804859668,78.33468009861825,NaN,NaN,42.00107127930158,35.522179998681
2010-11-08T09:30:00-05:00,36.21001,36.485,36.14999,36.45,3194949,6873050.65,76.46976152718366,69.74652891695821,NaN,NaN,156.8609833150109,165.00329065066086,0.08011546324501073,0.7048187421484187,0.6247032789034079,66128130,59298091.2,85.85233741404657,79.60114356004313,NaN,NaN,43.7267626687879,36.6942632372677
2010-11-09T09:30:00-05:00,36.55,36.57001,35.96001,36.12,4769883,6862773.1,68.68731777007174,70.13453164404415,NaN,NaN,125.14605013074035,162.28278762606328,0.05185004140573368,0.6895158306605751,0.6376657892548414,61358247,62524273.4,86.86392495800534,80.87045668938437,NaN,NaN,42.82877999949508,37.570622774728754
2010-11-10T09:30:00-05:00,36.17999,36.44,35.96001,36.44,6937648,6912928.35,71.69548949855152,70.58839634044463,NaN,NaN,115.30077274388206,159.8303402182536,0.04602393288117079,0.6951957053563049,0.6491717724751341,68295895,65512766.4,87.73852507181518,81.97791984353421,NaN,NaN,42.993444749643636,38.34531162828802
2010-11-11T09:30:00-05:00,36.14,36.61,36.08,36.39,15392676,7449251,70.55493908765642,70.82488206310776,NaN,NaN,107.88751924239729,140.4414776655011,0.030850331991320923,0.6877346874642853,0.6568843554729644,52903219,63601714,83.89199216484366,82.64338609233549,NaN,NaN,42.78155992853166,38.979061385465684
2010-11-12T09:30:00-05:00,36.22,36.48,35.84,36.00999,9845254,7548538.7,62.42659627558518,70.33088259236213,NaN,NaN,70.94787553492634,115.22864019339139,-0.01051745217369826,0.6437375402558416,0.6542549924295399,43057965,58348691.2,74.25530063761157,82.47199621440329,NaN,NaN,40.02560141503104,39.12856710397502
2010-11-15T09:30:00-05:00,36.14,36.3,35.89999,35.94,5805398,7506749.2,61.03197066835913,69.63887210971039,NaN,NaN,57.278414726599046,95.312126475709,-0.04632595180926602,0.5963475526679574,0.6426735044772234,37252567,52573578.6,65.36550235062433,81.42255140796247,NaN,NaN,37.37161637972587,38.877574143368
2010-11-16T09:30:00-05:00,35.64999,36.08,35.32001,35.45,17551536,7855545.15,52.23393890530935,68.65315829984196,NaN,NaN,-0.0502498406705041,70.27286648142683,-0.10347132964647054,0.5133343424191352,0.6168056720656058,19701031,44242135.4,55.11433183244213,79.51607300150938,NaN,NaN,32.07945608332851,37.906414420505214
2010-11-17T09:30:00-05:00,35.50999,35.82961,35.5,35.75999,9342035,7970658.05,56.505608729784946,67.85286168826391,NaN,NaN,2.718156222537987,47.75634317715803,-0.11970526927410363,0.46717408547297623,0.5868793547470799,29043066,36391569.6,47.54744193568173,76.97167011125671,NaN,NaN,28.960974727253763,36.62849446432644
2010-11-18T09:30:00-05:00,36.10001,36.36,36.00999,36.07001,10058129,7936677.4,60.32682739151957,67.34153305491235,NaN,NaN,58.54884392024026,37.88860811272662,-0.10917095502518104,0.4504156609656036,0.5595866159907846,39101195,33631164.8,45.197671534133754,74.2229931081437,NaN,NaN,27.571472988502926,35.33463425349451
2010-11-19T09:30:00-05:00,35.92999,36.25999,35.83,36.24001,6686469,8049937.55,62.283610273763095,67.087304570748,NaN,NaN,46.80803848839308,33.06064070341997,-0.09109797059197411,0.44571415275081705,0.5368121233427912,45787664,34177104.6,45.768501213058535,71.67167214210586,NaN,NaN,27.060490118996555,34.15261366285194
2010-11-22T09:30:00-05:00,36.13,36.42999,35.9868,36.41,6799852,8075435.25,64.18582606692816,66.65106785449802,NaN,NaN,65.79786996901825,34.76453175190382,-0.06904031691818191,0.4505117271950638,0.5195520441132457,52587516,37244094.4,48.98342785054536,69.4808795883878,NaN,NaN,27.231363656206533,33.163863661902596
2010-11-23T09:30:00-05:00,36,36.07001,35.73,35.87,9937688,8261448.35,54.740935084274994,65.41417433276467,NaN,NaN,0.14326170076571132,34.80323406019106,-0.0907939947006115,0.40605955073748135,0.49685354543809285,42649828,41833853.8,53.43245517370934,67.5385350561454,NaN,NaN,24.242149916199732,31.889333126802185
2010-11-24T09:30:00-05:00,36.14999,36.61,36.14999,36.61,9349855,8407191.7,62.81585551777034,64.42282154863825,NaN,NaN,91.97663703414044,52.65493022251154,-0.05697385497139196,0.42563622672385293,0.4826100816952449,51999683,46425177.2,57.43165589984343,65.80534114892552,NaN,NaN,24.45287439183026,30.826981878949052
2010-11-26T09:30:00-05:00,36.35001,36.53,36.265,36.39999,2890663,8164618,59.56770262089327,63.10902710126077,NaN,NaN,77.23800948763949,56.39276333599139,-0.05059159454268308,0.419370588516891,0.4699621830595741,49109020,48426742.2,59.081438489967695,64.03746475188059,NaN,NaN,23.4896894986259,29.778797253188603
2010-11-29T09:30:00-05:00,36.21001,36.33,35.81,36.23,8178648,8235776.95,56.998498087767686,61.71822256987391,NaN,NaN,14.42507480583008,49.91617059947878,-0.05907214255376708,0.39612200486736526,0.45519414742113234,40930372,47455283.8,57.908377613772636,62.0414676232896,NaN,NaN,21.870808114312506,28.649084519063447
2010-11-30T09:30:00-05:00,35.87,36.39,35.77,36.14999,11391184,8475948.45,55.779046688747506,60.79620320692218,NaN,NaN,-0.575236707319298,36.64154926421127,-0.07054689586202056,0.36701052759360664,0.4375574234556272,29539188,42845618.2,52.574148849024944,59.59219790121957,NaN,NaN,20.204767795443583,27.442753558546322
2010-12-01T09:30:00-05:00,36.64,37.06,36.62,36.92,8645441,8543652.55,63.804845930096505,60.23258580917538,NaN,NaN,204.2652337108302,77.46594366622418,-0.028889752269462055,0.40144523311879965,0.4303349853882617,38184629,41952578.4,51.582811821411454,57.00964695476216,NaN,NaN,21.444665639702293,26.585883855854316
2010-12-02T09:30:00-05:00,36.97,37.42999,36.92999,37.39999,7198023,8497249,67.73582929126297,60.03122082371872,NaN,NaN,269.1574308531129,112.90210243001866,0.025443145391160882,0.4621389171272128,0.4366957717360519,45382652,40629172.2,50.075909987422975,54.59421251351781,NaN,NaN,23.880950896451846,26.199464861653965
2010-12-03T09:30:00-05:00,37.25999,37.5,37.12,37.42,6709074,8377450.15,67.89238123213246,60.421634034900656,NaN,NaN,226.12969257053004,142.68043904659677,0.055459900777438065,0.5060206477078495,0.4505607469304114,52091726,41225713.4,50.773992129032585,52.916976191476465,NaN,NaN,25.795603986761094,26.141770450954983
2010-12-06T09:30:00-05:00,37.39,37.53999,37.28999,37.46001,10153598,8541900.15,68.2243812533964,60.9353776481176,NaN,NaN,197.1078230414201,179.21698869371477,0.06981219029452934,0.5378259847985731,0.4680137945040438,62245324,45488703.8,55.556574811399265,52.21633851010325,NaN,NaN,27.411819055901628,26.32320596594736
2010-12-07T09:30:00-05:00,37.85001,37.88,37.41,37.48,7261035,8745204.45,68.40019118097727,62.09010995352246,NaN,NaN,175.97365315439967,214.52676666605856,0.07215717961056078,0.5582102690172448,0.486053089406684,69506359,53482138,62.84577404904727,52.768584382717904,NaN,NaN,28.763109308143875,26.671763586261147
2010-12-08T09:30:00-05:00,37.49001,37.53999,37.1899,37.38,5820535,8797737.05,66.42038508380423,62.79830826452384,NaN,NaN,119.15647535995531,197.5050149958836,0.0590313552760654,0.5598422835017658,0.5008109282257004,63685824,58582377,66.60886945773692,54.13011492000756,NaN,NaN,29.33873866646655,27.05276002629049
2010-12-09T09:30:00-05:00,37.63,37.71001,37.35001,37.42999,4318801,8666794.7,66.93560628477931,63.270363899756674,NaN,NaN,114.2999866238522,166.5335261500315,0.04633426906241589,0.5587287645537202,0.5123944954913043,68004625,63106771.6,69.55472560243285,55.86990449631464,NaN,NaN,29.957890531621167,27.46777866990916
2010-12-10T09:30:00-05:00,37.52,37.62,37.38,37.56,4328156,8113568.7,68.29794089613473,63.699958944211794,NaN,NaN,100.81264817483732,141.47011727089293,0.039572594124174354,0.5618602381465223,0.522287644022348,72332781,67154982.6,71.94008646161352,57.739303442639994,NaN,NaN,30.856476998399625,27.951878431122083
2010-12-13T09:30:00-05:00,37.78,37.78,37.36,37.38,4547582,7848685.1,64.34501593905455,63.71132964936368,NaN,NaN,87.68890336964846,119.58633333653862,0.01701127025189697,0.5435517318372192,0.5265404615853222,67785199,68262957.6,72.57345544925133,59.424305413976136,NaN,NaN,30.579080950638808,28.32719307676733
2010-12-14T09:30:00-05:00,37.42999,37.55499,37.27,37.37,4322785,7774554.45,64.1229730916268,64.38147522131737,NaN,NaN,68.77570340301283,98.14674338626122,-0.0034600348808982995,0.5222154179841993,0.5256754528650976,63462414,67054168.6,70.69852130504725,60.65759585192884,NaN,NaN,30.289871511706107,28.60757571033001
2010-12-15T09:30:00-05:00,37.32001,37.53,37.14999,37.25,3943351,7094145.2,61.385477411998174,64.27930535661936,NaN,NaN,53.899107379572584,85.09526979018467,-0.028560274016436127,0.48997511034455243,0.5185353843609886,59519063,66220816.4,69.36797496948832,61.51019007118919,NaN,NaN,29.329106558318173,28.710651545756892
2010-12-16T09:30:00-05:00,37.31,37.53999,37.16,37.52,4485359,6851311.4,65.00546605094024,64.66771703019415,NaN,NaN,58.96652644195741,74.0285777538057,-0.030292059765356205,0.48067030965429325,0.5109623694196495,64004422,65420775.8,68.04400640504883,62.150373493694985,NaN,NaN,29.425267963918404,28.81273960549425
2010-12-17T09:30:00-05:00,37.2,37.39,37.19,37.36,4896160,6593212.95,61.33592015014385,64.97753289179244,NaN,NaN,43.49353754475448,62.56475562778913,-0.044658722293057285,0.45513896655332786,0.49979768884638515,59108262,62775872,63.71448985314238,62.565095796507116,NaN,NaN,28.51089641533128,28.769619149756682
2010-12-20T09:30:00-05:00,37.48,37.655,37.28011,37.58,4302762,6474027.6,64.31850540933183,65.58749422897704,NaN,NaN,62.57146089977534,57.54126713381451,-0.04183905810561994,0.4474988662143602,0.48933792431998013,63411024,61901037,62.30242249549658,63.2599724855408,NaN,NaN,28.52685042846868,28.734937903858395
2010-12-21T09:30:00-05:00,37.72,37.8,37.57001,37.74001,4487160,6358393,66.35160507278117,65.76940559631166,NaN,NaN,84.61581823776886,60.70929010076571,-0.03212821071942118,0.44917766092070366,0.48130587164012484,67898184,62788191,63.19326723570758,64.08929072941909,NaN,NaN,29.108482800895498,28.78830146057798
2010-12-22T09:30:00-05:00,37.78,37.86,37.72,37.78999,3302084,6026612.8,66.98440807229437,65.71573265209962,NaN,NaN,98.67757522136573,69.66498366912435,-0.02555579273380354,0.4493611307228704,0.47491692345667397,71200268,65124432,65.50505192237826,65.1913722962016,NaN,NaN,29.767751151071664,28.928222844934222
2010-12-23T09:30:00-05:00,37.78999,37.81,37.52,37.63,2290478,5673643.95,62.906116064025646,65.35957085437771,NaN,NaN,75.44998680141147,72.96167574101516,-0.034636566556945636,0.4316212152604919,0.46625778181743754,68909790,66105505.6,66.4578047121692,66.31164462356851,NaN,NaN,29.234265061565324,28.971943161595807
2010-12-27T09:30:00-05:00,37.5,37.58,37.32001,37.52,3368253,5697523.45,60.192601013484115,64.78587226581254,NaN,NaN,38.20169292389288,71.90330681684284,-0.04978323982834171,0.4040287320320104,0.4538119718603521,65541537,67392160.6,67.71714158930794,67.18025653627627,NaN,NaN,28.037943180479846,28.838514592864954
2010-12-28T09:30:00-05:00,37.60001,37.60001,37.28999,37.44,3056898,5441435.95,58.22546533169472,64.05910613372093,NaN,NaN,22.495964902389748,63.88820761736572,-0.06590989172810702,0.3714246072002183,0.4373344989283253,62484639,67206883.6,67.32515439696971,67.50021227541359,NaN,NaN,26.487189618470712,28.502611025094346
2010-12-29T09:30:00-05:00,37.55,37.7,37.5,37.56,1867322,4965242.85,60.320234829978546,63.623381115590526,NaN,NaN,68.73209334947765,60.711462639707484,-0.06889163476719995,0.3512199554693254,0.42011159023652533,64351961,66497639,65.75599230920581,67.43929247908994,NaN,NaN,25.69012134180707,28.100826784624736
2010-12-30T09:30:00-05:00,37.50999,37.59,37.42,37.49001,2952174,4680579.5,58.47836360633275,63.019292352844346,NaN,NaN,12.765513084009578,43.52905021223626,-0.07544579567216553,0.32580434564631844,0.40125014131848397,61399787,64537542.8,61.49054278106463,66.8632794204208,NaN,NaN,24.52070513324774,27.589380834428024
2010-12-31T09:30:00-05:00,37.47,37.48,37.28999,37.41,2212571,4431306.9,56.35971943816913,62.16656224870395,NaN,NaN,-63.388861677424266,15.76128051646911,-0.08436299570333772,0.2957963966893118,0.3801593923926495,59187216,62593028,57.505290467692355,65.83222256371214,NaN,NaN,22.953482111163563,26.927109588247387
2011-01-03T09:30:00-05:00,37.71001,38.06,37.67,37.85001,4254574,4308581.9,64.06931019455823,62.146868981239926,NaN,NaN,207.6183761909275,49.64461716987604,-0.06091510664799715,0.30401550908265307,0.3649306157306502,63441790,62173078.6,56.651348915225434,64.69492923985314,NaN,NaN,23.68599572328999,26.4640933218249
2011-01-04T09:30:00-05:00,37.94,37.99001,37.44,37.64,3657399,3983771.95,58.73584884280444,61.76207439203832,NaN,NaN,91.78515523543705,63.5024552364855,-0.05975450384411862,0.2902374859255019,0.34999198976962054,59784391,61633029,55.50975660350822,63.6100174754575,NaN,NaN,22.71850510975977,25.929009291529884
2011-01-05T09:30:00-05:00,37.47,37.97,37.47,37.95,6155523,3928496.35,63.558263690241944,61.91727341191288,NaN,NaN,130.82457455417705,75.92095147742538,-0.039301965039777786,0.3008645334698983,0.34016649850967606,65939914,61950619.6,56.07038724339557,62.66018978073658,NaN,NaN,23.380698312611845,25.564964865970165
2011-01-06T09:30:00-05:00,37.88,37.88,37.6292,37.72,3691203,3822029.75,58.130207316140904,61.42618350228435,NaN,NaN,90.62978443499229,91.49380574762192,-0.04220173171084546,0.28741433387111925,0.3296160655819647,62248711,62120404.4,56.38679411755942,61.82753176020162,NaN,NaN,22.216984529769285,25.08668196079861
2011-01-07T09:30:00-05:00,37.78,37.89,37.38,37.7,5417320,3876955.7,57.66899431001957,61.164260227989764,NaN,NaN,44.297837553589275,113.03114559382463,-0.04608836479921358,0.2720056095829477,0.3180939743821613,56831391,61649239.4,55.19863187605038,61.21925619040933,NaN,NaN,21.15067555230884,24.524395331014357
2011-01-10T09:30:00-05:00,37.52,37.75999,37.34,37.67,4563992,3888747.5,56.9392223908312,60.63716858381115,NaN,NaN,11.352546499069415,73.77797965545301,-0.05092293484239818,0.25444030582916355,0.30536324067156173,52267399,59414361.2,49.83456107296027,60.328694660228166,NaN,NaN,20.071166646463144,23.8882198046499
2011-01-11T09:30:00-05:00,37.94,37.94,37.55,37.66,3151934,3818965.1,56.68173773389891,59.94646377389099,NaN,NaN,64.67125687272686,68.35519998291097,-0.05470580030835287,0.23698099028612063,0.2916867905944735,49115465,57280576,45.30748619805022,59.05113887182407,NaN,NaN,19.1124742797708,23.205970443952886
2011-01-12T09:30:00-05:00,37.86,37.89999,37.66,37.75,20994720,4652561.85,58.50063619396814,59.34048006829626,NaN,NaN,81.60586943903563,58.51145895988269,-0.0511247216950762,0.22778088847562827,0.2789056101707045,70110185,58114630.2,47.321885313193654,57.7523412568823,NaN,NaN,18.779514774033977,22.57361963396447
2011-01-13T09:30:00-05:00,37.75,37.82001,37.59,37.69,4640164,4687402.5,56.7886800779726,58.90352035500676,NaN,NaN,43.16505566231305,49.01851320534684,-0.05257191764503755,0.21319071311440752,0.26576263075944506,65470021,58758892.2,48.88789460205933,56.49734767758874,NaN,NaN,18.040958000980766,21.926096543538225
2011-01-14T09:30:00-05:00,37.62,37.95,37.57001,37.92,4588133,4692541.2,61.44625527404925,58.993067087904265,NaN,NaN,93.3550112531624,58.82994794526147,-0.038467929732654116,0.2176777185936274,0.2561456483262815,70058154,61404244.8,54.82612677277519,55.57656090497926,NaN,NaN,18.673917510718496,21.461499538849694
2011-01-18T09:30:00-05:00,38.02,38.0864,37.92,38.03,4013380,4648402.2,63.474003139320196,59.36796264559181,NaN,NaN,185.98904700225532,93.75724804589865,-0.022926558868948566,0.22748744974009583,0.2504140086090444,74071534,65765071.8,62.55029579290741,55.23549957611767,NaN,NaN,19.792311282556287,21.223044073664923
2011-01-19T09:30:00-05:00,37.96001,38.06,37.56,37.64999,6315961,4749062.15,53.0863532898772,58.85125682129886,NaN,NaN,42.563534209493255,89.33570351325194,-0.038518007741722565,0.2022664989318912,0.24078450667361376,67755573,69493093.4,67.64379520779858,55.370342640302866,NaN,NaN,17.64023399226052,20.711214062035722
2011-01-20T09:30:00-05:00,37.56,37.87,37.52,37.73,6701539,4859781.1,54.76489055256187,58.586008746029506,NaN,NaN,13.786646446617803,75.77185891476837,-0.04336038332838321,0.18658402751313474,0.22994441084151795,74457112,70362478.8,68.71249900199791,55.88619665608382,NaN,NaN,16.37387364816178,20.091594002910874
2011-01-21T09:30:00-05:00,38.03,38.08,37.74001,37.82001,4286992,4909026.5,56.64424925494211,58.60633230437043,NaN,NaN,107.16608300446829,88.57206438319943,-0.040474598970882264,0.17935116212791513,0.2198257610987974,78744104,73017295.4,71.77795521933514,56.90567270977259,NaN,NaN,15.869457203527126,19.48843160299891
2011-01-24T09:30:00-05:00,37.81,38.0175,37.64011,37.97,4844008,5036703,59.65245396190185,58.2908425734664,NaN,NaN,94.56239293036417,88.81354071863977,-0.028976197990255692,0.18360551361097777,0.21258171160123346,83588112,75723287,74.51843693421327,58.18189328255744,NaN,NaN,16.328448833003463,19.037005492999562
2011-01-25T09:30:00-05:00,37.85001,38.02,37.64999,37.99001,5713297,5153955.2,60.050688970862915,58.38475972547058,NaN,NaN,92.78265189408641,70.17226169700601,-0.020911318270499857,0.18644256376310864,0.2073538820336085,89301409,78769262,77.20204394639983,59.73134237847827,NaN,NaN,16.81709389488703,18.719875264697773
2011-01-26T09:30:00-05:00,38.11,38.27,37.92,38.05,4859410,5244080.8,61.2844311481213,58.222343115319106,NaN,NaN,179.32601933516804,97.52475872214094,-0.012822186156495441,0.1913261493379892,0.20414833549448463,94160819,84050311.2,80.94835545120483,61.5083401076075,NaN,NaN,17.572438730561828,18.55595575982121
2011-01-27T09:30:00-05:00,38.22,38.41,38.10001,38.35001,4361191,5368774.25,66.80549606262034,58.84200659721049,NaN,NaN,235.21080876941832,141.80959118670106,0.010204841241735346,0.21690438704665382,0.20669954580491848,98522010,88863290.8,83.59430258025772,63.45173356922881,NaN,NaN,19.952335623645887,18.755438597510448
2011-01-28T09:30:00-05:00,38.10001,38.14,37.03,37.10001,11102242,5776277.65,40.738125862576965,57.632658850964596,NaN,NaN,-164.35596409252994,87.50518176730141,-0.057553738809015736,0.1347573722936488,0.19231111110266455,87419768,90598423.6,84.43364469142301,65.53994877032686,NaN,NaN,11.739687372554116,17.753188422516686
2011-01-31T09:30:00-05:00,37.24001,37.37,37.05,37.17999,4939660,5912632.1,42.28977618250614,56.586269836084234,NaN,NaN,-247.49636127626977,19.093430925974634,-0.09365556893040686,0.07524164993965599,0.16889721887006284,92359428,92352686.8,85.25500849326744,68.06998072892023,NaN,NaN,6.418319567947188,16.133921443292472
2011-02-01T09:30:00-05:00,37.42,37.6801,37.28999,37.62,4844219,5942114.35,50.03988396177615,56.11185170950404,NaN,NaN,-93.99206364080017,-18.261512181002683,-0.08483331040838354,0.06285558085958343,0.14768889126796697,97203647,93933134.4,85.97310088461585,70.97466749224634,NaN,NaN,5.087505070966496,14.555861961531619
2011-02-02T09:30:00-05:00,37.5399,37.62,37.39999,37.50999,4006155,5959552.15,48.29366208843597,55.38278213053746,NaN,NaN,-93.34011515293041,-72.79473907862237,-0.08322361999726585,0.04365936627138467,0.12688298626865052,93197492,93740469,85.42691704971108,73.69645547342616,NaN,NaN,3.4511480608087406,12.969474261428351
2011-02-03T09:30:00-05:00,37.63,38.00999,37.58,37.95,5515316,5927541.8,55.05022354823696,55.258606664127775,NaN,NaN,37.86068511229737,-112.26476381004656,-0.0509283352612695,0.06322256719206365,0.11415090245333315,98712808,93778628.6,85.44663784189797,76.30779427627178,NaN,NaN,4.620909353505344,11.776822131725064
2011-02-04T09:30:00-05:00,37.98,38.24001,37.89,38.21001,4875984,5986780.85,58.50110963692048,55.048239118618575,NaN,NaN,122.0786530083602,-54.97784038986856,-0.012463990181846366,0.0985709147260252,0.11103490490787156,103588792,97012433.4,87.04640869977362,78.6092429853431,NaN,NaN,6.814292351463652,11.067889305973434
2011-02-07T09:30:00-05:00,38.28,38.59,38.19,38.412,4140184,5922924.05,61.00565671474042,54.87192865972002,NaN,NaN,184.22625385835266,31.36668263705592,0.024176344978016434,0.1412553361303921,0.11707899115237566,107728976,100086343,88.35660413239631,80.45255072387802,NaN,NaN,9.43338256622964,10.834388343152892
2011-02-08T09:30:00-05:00,38.44,38.89999,38.44,38.87,5742984,5981873.65,66.01419068573948,55.795345616567324,NaN,NaN,232.30861737677367,96.62681884057068,0.07403553647627054,0.20962341174771382,0.13558787527144328,113471960,103340005.6,89.56025836855841,82.018012378218,NaN,NaN,13.48933497884672,11.213666433966296
2011-02-09T09:30:00-05:00,38.87,39.24001,38.87,39.13,5755719,6112062.9,68.48858797266982,56.7756097180036,NaN,NaN,239.95808320840192,163.28645851283713,0.11676171042950378,0.281540013308323,0.16477830287881923,119227679,108546043,91.13873223839089,83.6198861808175,NaN,NaN,17.618541171368918,12.128648539309527
2011-02-10T09:30:00-05:00,38.99001,39.23,38.88,39.17999,4508363,5287745.05,68.95657723219121,57.65506171637855,NaN,NaN,191.48185778365533,194.01069304710873,0.1391087993998637,0.33866430212864884,0.19955550272878514,123736042,113550689.8,92.33805842120763,85.08846498095124,NaN,NaN,20.955913339253275,13.389686367872919
2011-02-11T09:30:00-05:00,39.09,39.62,38.96001,39.58,5155348,5313504.25,72.47873502563922,58.57122464950264,NaN,NaN,192.12722232274908,208.02040690998652,0.16953160297760506,0.41147000645079146,0.2419384034731864,128891390,118611209.4,93.32224669818771,86.43159424980657,NaN,NaN,25.02615200908525,15.052038602331823
2011-02-14T09:30:00-05:00,39.52,39.52,39.27,39.42,3527604,5260477.8,69.10150580762259,59.217711566414046,NaN,NaN,157.39981021825227,202.65511818196643,0.16729636765339695,0.4510588630399326,0.28376249538653564,125363786,122138171.4,93.90944719824,87.62498019636656,NaN,NaN,27.206605070648347,16.788405240662755
2011-02-15T09:30:00-05:00,39.27,39.509,39.185,39.47,3015765,5210597.05,69.57855641887619,59.81014908575368,NaN,NaN,130.0198325917714,182.19736122496596,0.15772928810529052,0.4809241055181488,0.32319481741285827,128379551,125119689.6,94.36087580162308,88.58301736425359,NaN,NaN,29.084533847164153,18.544995041591527
2011-02-16T09:30:00-05:00,39.69,39.82001,39.53999,39.78999,4626305,5126114.25,72.5043410808548,60.217209444199,NaN,NaN,140.61323476821565,162.32839153692873,0.16093890685901613,0.5243684509866284,0.3634295441276123,133005856,127875325,94.74831204727195,89.37973232618319,NaN,NaN,31.632109650377693,20.414582842846695
2011-02-17T09:30:00-05:00,39.64999,39.89999,39.53,39.8,3303362,4956205.4,72.59313928593566,62.49256754586748,NaN,NaN,123.07900759250623,148.6478214986989,0.15183944731031146,0.5532288532655016,0.4013894059551902,136309218,130389960.2,95.08047391526874,90.14022012788645,NaN,NaN,33.686207483408744,22.310529220069846
2011-02-18T09:30:00-05:00,39.8,40.02,39.73,40.00999,3688878,4926299.7,74.4567909149349,64.79021145532667,NaN,NaN,120.38278944618796,134.2989349233867,0.1479180882496871,0.5862870162672991,0.43836892801761196,139998096,132611301.4,95.35967931955311,90.861982329764,NaN,NaN,35.999038279442885,24.266030514265996
2011-02-22T09:30:00-05:00,39.56,39.67,38.94,39.05,7699648,5069081.7,55.78211105253184,65.2003705332378,NaN,NaN,53.76925660879536,113.5728242014953,0.0724453008229416,0.5289255540462889,0.45648025322334734,132298448,133998233.8,95.53025155454799,91.54463594904486,NaN,NaN,31.734660249684154,25.33297761932573
2011-02-23T09:30:00-05:00,39.08,39.21001,38.10001,38.48,8957906,5231312.15,48.0724094208637,65.18456677126835,NaN,NaN,-3.3629445123751185,86.896268780666,-0.019194994274897792,0.4324865103797251,0.45168150465462287,123340542,132990432,92.85915497031938,92.07551008623116,NaN,NaN,25.223288633152713,25.31730776415816
2011-02-24T09:30:00-05:00,38.53999,38.78999,38.2,38.71001,9453770,5461030.15,51.014568230994556,64.8963056771796,NaN,NaN,-8.5729834344578,57.059025140131304,-0.06506631576140204,0.37034860995287033,0.43541492571427237,132794312,132948123.2,92.74191788715606,92.59660151803531,NaN,NaN,21.14421740659909,24.72115199879258
2011-02-25T09:30:00-05:00,38.96001,39.2063,38.84,39.1125,4298695,5457905.35,55.74030390800943,64.69910526797166,NaN,NaN,33.55299028601263,39.1538216788326,-0.06869031085913896,0.34955203714034866,0.4182423479994876,137093007,133104881,92.77829791120992,93.00602217599506,NaN,NaN,19.432786571386774,23.965671223448894
2011-02-28T09:30:00-05:00,39.17999,39.41,39.10001,39.41,4889789,5147282.7,58.896728611376204,64.5484675463028,NaN,NaN,51.98941596427649,25.475146982450305,-0.05218818184288199,0.35300712069588513,0.4051953025387671,141982796,133501821,92.87567686470486,93.32881308544566,NaN,NaN,19.135419698309175,23.275635291286076
2011-03-01T09:30:00-05:00,39.47,39.58,38.61,38.66,10040758,5402337.6,49.34302519146727,63.35767001099764,NaN,NaN,8.371463659369955,16.395588392565223,-0.0906665124372884,0.29186216199215664,0.38252867442944505,131942038,133430539,92.63411066614218,93.54837396384451,NaN,NaN,15.360472561749672,22.144897758495162
2011-03-02T09:30:00-05:00,38.58,38.96001,38.55,38.81,7406656,5530459.45,51.0531203302432,62.11227946511002,NaN,NaN,-22.338196629932764,12.6005379690537,-0.10394588753728201,0.2525963150078425,0.35654220254512453,139348694,136632169.4,93.45724519552166,93.71398203221099,NaN,NaN,13.043497827943321,20.844697768416328
2011-03-03T09:30:00-05:00,39.24001,39.55,39.13,39.5,7595254,5709914.4,58.065909257673425,61.334374609787325,NaN,NaN,55.71600561672659,25.45833577929058,-0.06603646656707529,0.2739966193362804,0.3400330859033557,146943948,139462096.6,94.08630679174442,93.83885691582076,NaN,NaN,13.565594649660886,19.804825894308408
2011-03-04T09:30:00-05:00,39.44,39.53,38.88,39.21001,8208020,5844549.6,54.52985657701444,60.05231186345698,NaN,NaN,18.987431681049973,22.545224058298047,-0.06042033630101151,0.26450766552709126,0.3249280018281028,138735928,139790680.8,94.15655856961274,93.89845062092255,NaN,NaN,12.749673627538547,18.79694699905557
2011-03-07T09:30:00-05:00,39.23,39.44501,38.5975,38.82001,8321563,6016828.55,50.11018713565407,58.69578910117351,NaN,NaN,-39.151414269544944,4.317058011533762,-0.08158411624225215,0.2229478565252876,0.30453197276753974,130414365,137476994.6,86.37561698667906,93.36031989152535,NaN,NaN,10.562745097675117,17.620632441715507
2011-03-08T09:30:00-05:00,38.84,39.24001,38.64,39.13,5380777,6078858.2,53.346896701042475,57.53638483561396,NaN,NaN,-38.9088285057408,-5.139000421488389,-0.07356591157294295,0.21257458330136103,0.286140494874304,135795142,138247615.4,86.76784017891016,92.81796020418872,NaN,NaN,9.875879289157496,16.51423913420722
2011-03-09T09:30:00-05:00,39.05,39.32001,38.85001,39.22,6974059,6140411.95,54.27443205777843,56.23424847682279,NaN,NaN,-15.670576424764631,-3.8054763804547633,-0.06154890810686964,0.20920435974071694,0.2707532678475866,142769201,138931716.8,87.122261995032,92.27324234331444,NaN,NaN,9.628540706767216,15.53056793028722
2011-03-10T09:30:00-05:00,38.77,39.08,38.60001,38.77,9655133,6335382.65,49.02598357265013,54.55088021158811,NaN,NaN,-84.62702324622528,-31.874082153045133,-0.08197674225333867,0.16828234003091325,0.2502590822842519,133114068,136165740.8,78.02264731954818,91.05482615790582,NaN,NaN,7.731031278170739,14.416348408556294
2011-03-11T09:30:00-05:00,38.62,39.14999,38.50999,39.00999,10675371,6643733.05,51.708086151888736,52.92597272851338,NaN,NaN,-62.94478949145106,-48.26052638754534,-0.0774491197976998,0.15344768253712715,0.23089680233482696,143789439,137176443,78.89027984199556,89.87844048093743,NaN,NaN,7.012900857335399,13.358713044096167
2011-03-14T09:30:00-04:00,38.7,38.83,38.2,38.53,6663645,6719147.9,46.44446938265057,52.25899832352186,NaN,NaN,-128.50415444602527,-66.13107442284141,-0.10328816544714062,0.10178659552590119,0.2050747609730418,137125794,138518728.8,80.01850281732476,88.77045842827863,NaN,NaN,4.702646711062522,12.122132139377074
2011-03-15T09:30:00-04:00,37.66,38.46001,37.49001,38.21001,7517895,6918662.45,43.28135058679604,51.916779835374165,NaN,NaN,-192.6494303083182,-96.8791947833569,-0.13635968406184784,0.03462515589573201,0.17098483995757985,129607899,137281280.2,75.98654466497241,87.5652719778967,NaN,NaN,1.7714943824794465,10.643469602677413
2011-03-16T09:30:00-04:00,37.98,38.205,37.38,37.56,9540313,7244889.85,37.669122467701875,50.96353370942469,NaN,NaN,-214.06401977097107,-136.5578834525982,-0.19298102707142856,-0.07024144388170583,0.12273958318972271,120067586,132740957.2,63.36968172957769,85.46725510949825,NaN,NaN,-2.6940135312965765,8.738114869252557
2011-03-17T09:30:00-04:00,38.05,38.17999,37.685,37.73,6231383,7325143.75,39.865328209714896,49.829606873832226,NaN,NaN,-163.11552037282598,-152.25558287791833,-0.20862379410903265,-0.1380401594465681,0.07058363466246453,126298969,131377937.4,60.14128082691164,83.13603960347693,NaN,NaN,-5.566274304206967,6.694630701615482
2011-03-18T09:30:00-04:00,38,38.02,37.52499,37.58,17818896,8050920.45,38.57384221124819,48.377972130965944,NaN,NaN,-160.5585391173571,-171.77833280309954,-0.21770812051241437,-0.20155151597805343,0.016156604534360935,108480073,124316064.2,46.829697369061385,79.84704106807384,NaN,NaN,-8.289282382494076,4.554071689599832
2011-03-21T09:30:00-04:00,38.06,38.23,37.94,38.16,13364578,8534705.45,45.87532517536885,48.13027927267319,NaN,NaN,-88.16543810957229,-163.71058953580894,-0.17512243255180387,-0.2027464361553939,-0.027624003603590033,121844651,121259835.6,42.45053710422345,76.26250009936537,NaN,NaN,-8.369373041281682,2.7078652994739016
2011-03-22T09:30:00-04:00,38.14,38.19,37.83501,37.86,6743773,8486911.7,43.0264637570501,47.55694666030225,NaN,NaN,-97.48483513207336,-144.67767050055997,-0.1581437974469066,-0.22530375041222328,-0.06715995296531668,115100878,118358431.4,38.74623748101,72.35457097690023,NaN,NaN,-9.327510976520035,0.988525831474768
2011-03-23T09:30:00-04:00,37.77,38.28999,37.521,38.19,7460621,8412047.45,46.930505791730134,46.761560698449166,NaN,NaN,-81.60896177252909,-118.18665890087156,-0.117539645180269,-0.21408450944065294,-0.09654486426038393,122561499,118857214,39.720068074043446,68.47126821135016,NaN,NaN,-8.907843717975377,-0.4252412470181097
2011-03-24T09:30:00-04:00,38.37,38.86,38.35001,38.75,5019324,8190325.15,52.8366581937626,46.64061795678832,NaN,NaN,6.831634157905706,-84.19722799472522,-0.04931005391072457,-0.15818243164878965,-0.10887237773806507,127580823,119113584.8,40.24591602231508,64.62050802940033,NaN,NaN,-6.621156686867568,-1.3103720241394607
2011-03-25T09:30:00-04:00,38.88,39.075,38.74001,38.82001,3553160,8153048.4,53.53290301165987,46.88509766221731,NaN,NaN,39.244420818864604,-44.23663600748089,0.0015002899069929965,-0.10699701535432382,-0.10849730526131682,131133983,123644366.8,48.75408276564407,61.93325558504068,NaN,NaN,-4.58899305428572,-1.7787464570174978
2011-03-28T09:30:00-04:00,38.92999,38.92999,38.41,38.4175,9779590,8397538.45,49.049637231300835,46.57815055723576,NaN,NaN,4.028304295435719,-25.797887526479286,0.008570482734473,-0.09778420184322556,-0.10635468457769856,121354393,123546315.2,48.5928301398766,59.20646915368114,NaN,NaN,-4.215117409623788,-2.126799450246968
2011-03-29T09:30:00-04:00,38.41,38.77499,38.34,38.77,6116078,8201304.45,52.77932926108988,46.47135750032943,NaN,NaN,13.011897668818172,-3.6985409663009805,0.03601800561304705,-0.061332177561389756,-0.0973501831744368,127470471,126020233.8,52.83180164754862,56.75715055743233,NaN,NaN,-2.7424317789857535,-2.21474692578108
2011-03-30T09:30:00-04:00,39.02,39.25,38.89999,39.19,7027320,8182337.65,56.8338869854903,47.02906488696088,NaN,NaN,81.32753351277825,28.888758090760483,0.07902439967619072,0.0014303164208016028,-0.07759408325538912,134497791,128407492.2,56.554677353765065,55.223724131304955,NaN,NaN,-0.20462557210957247,-1.9275867323994362
2011-03-31T09:30:00-04:00,39.06,39.13,38.83,39.05,5560652,8080607.55,55.13447753794522,47.27380712882206,NaN,NaN,70.46264616610189,41.614960492399725,0.0936103222011677,0.03941881949607051,-0.05419150270509719,128937139,128678755.4,56.970275828311,53.65800955889891,NaN,NaN,1.355556970908036,-1.4585662033555118
2011-04-01T09:30:00-04:00,39.28999,39.58,39.14,39.3,6043234,7972368.25,57.57407750896031,48.068779137844174,NaN,NaN,119.18264702806029,57.602605734238864,0.11429375763037422,0.08867569433287059,-0.02561806329750363,134980373,129448033.4,58.19171101681205,52.09895300171944,NaN,NaN,3.397262909510115,-0.7648763300889938
2011-04-04T09:30:00-04:00,39.39999,39.50999,39.25999,39.39,2891843,7700882.25,58.44999688785859,49.152253873634365,NaN,NaN,118.3309612253704,80.4631371202258,0.12724341135281333,0.13343620089351305,0.006192789540699704,137872216,132751598,63.04325282943867,51.174432156324166,NaN,NaN,5.327330910249337,0.10543898995933909
2011-04-05T09:30:00-04:00,39.25,39.715,39.25,39.52,4034249,7633555.85,59.74288521015382,50.728951212380935,NaN,NaN,124.92499315481523,102.84575621742519,0.13692953136283437,0.17735470374424267,0.040425172381408296,141906465,135638796.8,66.68217370363199,51.41103872589947,NaN,NaN,7.30993430864892,1.1346526069149934
2011-04-06T09:30:00-04:00,39.67999,39.8,39.25999,39.45,7324453,7651075.55,58.683999642508375,52.073142029009034,NaN,NaN,119.33047014269687,110.44634354340891,0.13098674638707408,0.20415860536525088,0.07317185897817681,134582012,135655641,66.70277266527285,51.879716714353854,NaN,NaN,8.686796831979509,2.2135303533527813
2011-04-07T09:30:00-04:00,39.33,39.55,39.02499,39.28999,9909637,7663800.75,56.23059445147695,53.334338617596806,NaN,NaN,83.7324550231817,113.1003053148249,0.10951682394570604,0.21006788891030936,0.10055106496460332,124672375,134802688.2,64.527213621083,53.143825018069684,NaN,NaN,9.222553090927967,3.2148193158635223
2011-04-08T09:30:00-04:00,39.46001,39.48,38.87,39.06,8509586,7555511.5,52.81287880395776,53.82987816249601,NaN,NaN,61.262764666925314,101.51632884259789,0.07472471025456748,0.19395695278281266,0.11923224252824519,116162789,131039171.4,55.86860070508979,54.10225813241728,NaN,NaN,8.772173401886372,4.008727042438215
2011-04-11T09:30:00-04:00,39.09,39.3,38.92,39.07001,4787711,7461714.8,52.94692702398632,54.538482681562876,NaN,NaN,51.156938340447816,88.08152426561337,0.04855229185905302,0.17992260735206145,0.13137031549300843,120950500,127654828.2,49.443501287009354,54.86634840427439,NaN,NaN,8.430530470452997,4.6404132464403265
2011-04-12T09:30:00-04:00,38.86,39.14,38.78999,39.02,8993805,7535510.3,52.14985397271448,54.9112932659189,NaN,NaN,32.94066300398132,69.6846582354466,0.02521353622715289,0.16288723577694952,0.13767369954979664,111956695,121664874.2,40.55396422890752,54.92591241533611,NaN,NaN,7.937577798056869,5.111436753814118
2011-04-13T09:30:00-04:00,39.2,39.25,38.85001,39.14999,8083945,7462691.9,54.084726315061914,55.000440988868846,NaN,NaN,40.462123528859124,53.910988912679045,0.016304034391950883,0.15805374253973525,0.14174970814778437,120040640,118756599.8,37.06915366408177,54.69900081831944,NaN,NaN,7.989447705189619,5.52258117543919
2011-04-14T09:30:00-04:00,38.89999,39.11501,38.7,39.06,4116910,7356968.25,52.501971467588476,54.926803021435184,NaN,NaN,17.572738438887384,40.67904559582017,0.0028297902249167506,0.14528694592893032,0.14245715570401357,115923730,117006870.8,35.11414770550327,53.72471974259509,NaN,NaN,7.639474884570252,5.824994562457913
2011-04-15T09:30:00-04:00,39.12,39.37,39.00999,39.25,6455332,6788790.05,55.46531136788523,55.38506545976264,NaN,NaN,53.14293410551387,39.05507948353788,0.005062654170383457,0.14878547341699289,0.14372281924660943,122379062,118250125.4,37.63111383401261,52.94174000646195,NaN,NaN,8.077760271322099,6.146818235152797
2011-04-18T09:30:00-04:00,38.83,38.96001,38.46001,38.89999,9001461,6570634.2,49.35643666571141,55.14057313152132,NaN,NaN,-37.67232075080955,21.289227665286408,-0.017450336685224138,0.12190989839007926,0.1393602350753034,113377601,116735545.6,35.80875718888788,51.72580825941475,NaN,NaN,6.825702444960645,6.243801693696776
2011-04-19T09:30:00-04:00,38.89,39.03,38.741,38.99001,4473066,6457098.85,50.85562708902868,54.71355456748835,NaN,NaN,-20.63263794413826,10.57456747566249,-0.02617192228484716,0.10664533221924444,0.1328172545040916,117850667,117914340,38.31263487125092,50.42280522494946,NaN,NaN,6.155068306526426,6.231125495529583
2011-04-20T09:30:00-04:00,39.53999,39.84,39.5,39.69,8633230,6515729.3,60.618223890684654,55.10525073554117,NaN,NaN,164.87870161823608,35.45788309353789,0.013194389178714655,0.1493102409774849,0.13611585179877025,126483897,119202991.4,41.02105715410173,49.28357531964879,NaN,NaN,8.493101937297071,6.554264987210653
2011-04-21T09:30:00-04:00,39.85001,39.95,39.653,39.91,4332344,6481380.3,63.099308573855964,55.499910097319436,NaN,NaN,179.129501322842,67.76923567032881,0.04997570266971263,0.19858548013591104,0.1486097774661984,130816241,122181493.6,46.83165065333244,48.47214243654311,NaN,NaN,11.231609741377339,7.2224570949487505
2011-04-25T09:30:00-04:00,39.92999,39.95,39.74001,39.87,4212313,6514337.95,62.330411379959955,55.777082561040956,NaN,NaN,154.42417481852715,88.02548381293147,0.06650215495177472,0.2317374711559168,0.16523531620414209,126603928,123026466.8,48.385208330948245,47.42513925807952,NaN,NaN,13.227445547957192,8.080312588235671
2011-04-26T09:30:00-04:00,39.95,40.105,39.84,39.94,7022813,6376499.1,63.17607278637178,56.022310245056524,NaN,NaN,156.40076734764224,126.84010143262182,0.07633527984946006,0.26065441601596717,0.1843191361665071,133626741,127076294.8,55.14946609471816,46.60137442887138,NaN,NaN,15.124149297216139,9.08657497523288
2011-04-27T09:30:00-04:00,40.06,40.48,40.03999,40.42,6462176,6393804,68.41264167768874,56.717213247569404,NaN,NaN,198.04510001619443,170.57564902468837,0.10744894677974395,0.31863031964118704,0.2111813728614431,140088917,131523944.8,61.168284684328086,46.2060538588039,NaN,NaN,18.497616597387193,10.431009492683495
2011-04-28T09:30:00-04:00,40.34,40.655,40.34,40.58,6065789,6345727.45,69.94680231174976,57.69694238044603,NaN,NaN,192.93590893844865,176.1870904887309,0.1296032650440138,0.3731854541664603,0.24358218912244653,146154706,135458106.6,65.56968552824374,46.280516137886806,NaN,NaN,21.782189631665783,12.05260665539525
2011-04-29T09:30:00-04:00,40.61,40.72,40.5,40.55,10408152,6588102.45,69.26748465893563,58.87227137008731,NaN,NaN,169.9939875936397,174.3599877428904,0.1325599229817236,0.40928209284960104,0.27672216986787745,135746554,136444169.2,66.59178821651693,47.046458102988744,NaN,NaN,24.26459471038597,13.79717637753678
2011-05-02T09:30:00-04:00,40.71001,41.02,40.63,40.69,9342156,6753048.55,70.69768988271264,60.14018300285347,NaN,NaN,161.88668912021942,175.85249060322886,0.1338757384229069,0.4440668428965111,0.3101911044736042,145088710,140141125.6,70.1675383047966,48.52674646140212,NaN,NaN,26.7865220167786,15.652797183142756
2011-05-03T09:30:00-04:00,40.66,40.74001,40.28,40.46001,6641266,6940519.7,65.31981378965855,61.08089441834948,NaN,NaN,107.0275887139094,165.9778548764823,0.11017710103191575,0.4479124807634989,0.33773537973158313,138447444,141105266.2,71.03814310474482,50.70418780967621,NaN,NaN,27.454487302000967,17.338752914408214
2011-05-04T09:30:00-04:00,40.50999,40.66,40.05,40.37,10785426,7278078.55,63.29067484137332,61.738462170228864,NaN,NaN,80.76077107649968,142.52098908854336,0.08072429162979256,0.4386407442688238,0.35791645263903127,127662018,138619886.4,65.71425827244235,52.75026671027339,NaN,NaN,27.444381122284746,18.782414086962003
2011-05-05T09:30:00-04:00,40.07001,40.64,40.02,40.25999,8074313,7315571.55,60.80451655635995,62.331501105141115,NaN,NaN,67.17818493595783,117.3694442880452,0.047748503359423655,0.4176020818383108,0.36985357847888717,119587705,133306486.2,56.04414148658731,54.245266266065116,NaN,NaN,26.744553320113297,19.919862548840758
2011-05-06T09:30:00-04:00,40.81,40.81,40.17999,40.28999,5864309,7113305.15,61.251526740436404,62.744802203180484,NaN,NaN,73.10415337546243,97.99147744440975,0.02311950811034208,0.3987529636168148,0.3756334555064727,125452014,131247578.2,52.80172136070398,55.32888108940021,NaN,NaN,26.276478268100977,20.827950508735075
2011-05-09T09:30:00-04:00,40.3,40.5,40.17999,40.34,4283785,6902015.1,62.02894430246206,63.649981320091236,NaN,NaN,58.31077690266863,77.27629500089958,0.006237511068605817,0.38343034434223,0.3771928332736242,129735799,128176996,48.312537581444616,56.22200826029712,NaN,NaN,26.077361235787084,21.577866326885363
2011-05-10T09:30:00-04:00,40.45,40.92999,40.42999,40.86,5035328,6914395.95,68.99468196887702,64.94562809722326,NaN,NaN,94.74921709471553,74.82062067706083,0.025075611868266734,0.4085373481089576,0.38346173624069085,134771127,127441732.6,47.27604232151423,56.862251649601646,NaN,NaN,27.931820333343026,22.4855740420936
2011-05-11T09:30:00-04:00,40.83,40.83,40.25999,40.47,4930590,6711235.2,60.09099675210898,64.90796901589643,NaN,NaN,64.1379109247014,71.49604864670117,0.007183627143421689,0.392441270169968,0.3852576430265463,129840537,127877436.4,47.98814544956025,57.359900813562966,NaN,NaN,26.79495460475313,23.101199836759246
2011-05-12T09:30:00-04:00,40.38,40.88,40.27,40.87,7693328,6691704.35,65.06990391330307,65.04872582585695,NaN,NaN,76.59272518412354,73.37895669633431,0.01760744527279784,0.4072669496175436,0.3896595043447458,137533865,131466668.4,53.553384577007094,57.84002466525402,NaN,NaN,27.42237929745225,23.71851118828682
2011-05-13T09:30:00-04:00,40.89999,40.95,40.46001,40.56,5192551,6745486.4,58.93352778259992,64.80609128318837,NaN,NaN,70.62887603722693,72.88390122868722,-0.00011804594788905609,0.38951194690988444,0.3896299928577735,132341314,132844528.4,55.52093288989846,58.34971927660761,NaN,NaN,25.895130735106264,24.029456837832452
2011-05-16T09:30:00-04:00,40.39,40.46001,39.92999,40.02,8776848,6861562.2,50.074862001037324,63.87029051280734,NaN,NaN,-9.137612580918757,59.39422333196973,-0.04923557301414366,0.32808552659009393,0.3773210996042376,123564466,131610261.8,53.34110642785598,58.220550728974594,NaN,NaN,21.37228907235685,23.649861442764507
2011-05-17T09:30:00-04:00,39.89999,40.16,39.77,40.06,16365484,7229763.35,50.66642281835393,62.60270345142627,NaN,NaN,-50.66055880068113,30.312268152890397,-0.07832773520744324,0.27941143059493356,0.3577391658023768,139929950,132642026.4,54.933942426845235,57.77524056772581,NaN,NaN,18.089042631558964,22.85545875544943
2011-05-18T09:30:00-04:00,40.09,40.55,39.95,40.53,6410844,7326652.25,57.09880790530486,61.684989565251634,NaN,NaN,4.423131099301271,18.369312187810365,-0.06572320724526864,0.275585156745791,0.3413083639910596,146340794,135942077.8,59.675591378994866,57.354233842779465,NaN,NaN,17.420103702325846,22.078979462146062
2011-05-19T09:30:00-04:00,40.64999,40.69,40.41,40.66,4288996,7109440.55,58.70272175178864,60.93036364331257,NaN,NaN,62.997676182092626,15.650302387404187,-0.04919296109079485,0.27981716262756606,0.3290101237183609,150629790,138561262.8,63.002791630382866,57.09787694376989,NaN,NaN,17.415698631032054,21.412796486272633
2011-05-20T09:30:00-04:00,40.49001,40.62,40.08501,40.27,6412594,7213453.05,52.37637422330302,59.621698239069026,NaN,NaN,-23.48142771455443,-3.1717583629520796,-0.0641417581216947,0.24883292606624252,0.3129746841879372,144217196,140936439.2,65.76170133678328,56.78317430319753,NaN,NaN,15.284446626577719,20.537317934887646
2011-05-23T09:30:00-04:00,39.78,40.07001,39.71001,39.89,5363488,7271011.8,47.055215127012765,58.317084048880034,NaN,NaN,-168.64167339970268,-35.07257052670887,-0.09725300024921507,0.19140843387641837,0.28866143412563344,138853708,143994287.6,68.96986798239539,56.63544036588684,NaN,NaN,11.662542003966283,19.26949280189888
2011-05-24T09:30:00-04:00,40.03999,40.03999,39.64,39.69,4824543,7161098.3,44.49312275568494,56.97440175704515,NaN,NaN,-190.82576835780824,-63.10561243813429,-0.12830352632520098,0.1282820262191322,0.2565855525443332,134029165,142814130.6,66.38451383571153,56.683315763263224,NaN,NaN,7.8862096953131715,17.643309500958065
2011-05-25T09:30:00-04:00,39.56,39.87,39.42999,39.7,5650359,7120507.45,44.6553848509365,55.8208923495149,NaN,NaN,-190.18858125568445,-102.02795490913142,-0.14274057652598623,0.07815983188685038,0.22090040841283662,139679524,141481876.6,63.49113266007514,57.21524370422663,NaN,NaN,4.979701344662938,15.834222621487333
2011-05-26T09:30:00-04:00,39.67999,40.14,39.63,40.06,6693336,7151884.8,50.28926557371341,55.03787369474897,NaN,NaN,-99.80987048512311,-134.5894642425746,-0.12334629089354959,0.06671754479589964,0.19006383568944923,146372860,140630490.6,61.64211706786254,57.84670054045224,NaN,NaN,4.221801119636389,14.175305264080055
2011-05-27T09:30:00-04:00,40.11,40.3,40.03999,40.16,4265137,6844734.05,51.7583167054936,54.30425743782265,NaN,NaN,-36.567515676639246,-137.20668183499154,-0.10007532132839195,0.06496968402895931,0.16504500535735125,150637997,141914650.8,63.374669687062685,58.92256711942496,NaN,NaN,4.053174181798562,12.729286538039842
2011-05-31T09:30:00-04:00,40.53999,40.53999,40.235,40.44,5988723,6677062.4,55.705432880709004,53.35502536009637,NaN,NaN,32.02863054881253,-97.0726210452885,-0.06387915266846148,0.08519606452177442,0.1490752171902359,156626720,145469253.2,67.72087347239736,60.3829122016309,NaN,NaN,5.124147674947974,11.642838129026718
2011-06-01T09:30:00-04:00,40.28999,40.36,39.49001,39.52,12634293,6976713.75,43.19872816958252,52.148434747058765,NaN,NaN,-116.72473135838898,-82.25241364540464,-0.09791478566198075,0.026681735112759952,0.1245965207747407,143992427,147461905.6,69.87875062794379,61.94652685722973,NaN,NaN,1.7362740458939911,10.227614688579186
2011-06-02T09:30:00-04:00,39.53999,39.69,39.2061,39.42999,7908180,6832851.45,42.2004534392512,50.51490257034078,NaN,NaN,-167.6290943198422,-77.7405162582362,-0.1209949567983725,-0.026647175223224906,0.09434778157514759,136084247,146742850.2,68.10934606627602,62.986238392177505,NaN,NaN,-1.2177269396762427,8.592565884542696
2011-06-03T09:30:00-04:00,38.92,39.24001,38.84,38.92,7262133,6792242.45,36.98533415957995,48.94717445441078,NaN,NaN,-210.18203765759156,-99.81494969272988,-0.16252492644497557,-0.10880837648107189,0.05371654996390369,128822114,143232701,60.10801394731815,63.313887039136056,NaN,NaN,-5.575622347263862,6.568538994284616
2011-06-06T09:30:00-04:00,38.84,38.99001,38.5,38.50999,5193238,6758688.9,33.41056189102588,47.75686730369568,NaN,NaN,-215.0782585006371,-135.51709825752945,-0.20669088552060821,-0.2046470569368566,0.002043828583751635,123628876,137830876.8,50.31242806667799,63.09755287048048,NaN,NaN,-10.448541508367846,4.137527493905693
2011-06-07T09:30:00-04:00,38.77,38.97,38.55,38.55,5014180,6795208.65,34.08012878026605,46.57213201526083,NaN,NaN,-175.6276994513053,-177.04836425755303,-0.22100346373864016,-0.2742105010895486,-0.05320703735090841,128643056,132234144,42.57145823087472,62.21451828505401,NaN,NaN,-13.999088952467034,1.5465822872810175
2011-06-08T09:30:00-04:00,38.53999,38.57001,38.19,38.25,10020094,7044446.95,31.52081549802452,44.74513255759795,NaN,NaN,-186.01897626333397,-190.907213238542,-0.23704916446699273,-0.3495184929346493,-0.11246932846765659,118622962,127160251,37.01175965872753,60.59567316217778,NaN,NaN,-17.79530036829726,-1.2165438063730214
2011-06-09T09:30:00-04:00,38.35001,38.71001,38.22,38.57001,5665078,7081171.35,36.95921162044556,43.192024691073435,NaN,NaN,-140.08911196853515,-185.3992167682806,-0.21323213792269155,-0.37900950087102103,-0.16577736294832948,124288040,124801009.6,34.73992188257918,58.576896751620374,NaN,NaN,-19.2470014859611,-3.792323474885604
2011-06-10T09:30:00-04:00,38.37,38.42999,37.81,37.86,9624238,7177716.85,31.064503866020033,41.669748236981796,NaN,NaN,-158.67218723693327,-175.09724668414893,-0.23092592499118322,-0.4544347691873085,-0.2235088441961253,114663802,121969347.2,32.18626827294294,56.17865153277463,NaN,NaN,-22.589460801828274,-6.477628807305985
2011-06-13T09:30:00-04:00,37.91,38.13499,37.60001,37.81,9559152,7396046.9,30.693248569074825,40.50103633998623,NaN,NaN,-148.6968362810128,-161.82096224022408,-0.231063725087489,-0.5123385005554866,-0.28127477546799756,105104650,118264502,29.165509831035678,53.33548309339181,NaN,NaN,-25.296995341798173,-9.166109740804869
2011-06-14T09:30:00-04:00,38.16,38.56,38.16,38.48,9296871,7422048.05,40.8879345490647,40.243522896656216,NaN,NaN,-86.32785610390039,-143.96099357074309,-0.17371519003928138,-0.4984187630170993,-0.32470357297781793,114401521,115416195,27.06261953439838,50.52677635758373,NaN,NaN,-24.20854909441779,-11.315029648463858
2011-06-15T09:30:00-04:00,38.06,38.33,37.82001,37.89,19880000,7597773.85,35.8824887827372,39.61688746321341,NaN,NaN,-104.73210317678517,-127.70361895343333,-0.16335596314225398,-0.5288985269056354,-0.36554256376338146,94521521,110595906.8,23.919441564756397,47.700226993632384,NaN,NaN,-25.02830862620761,-13.27406950242725
2011-06-16T09:30:00-04:00,37.89999,38.08,37.52,37.8,8544691,7704466.2,35.175100094897786,38.53730421472658,NaN,NaN,-108.84601618510304,-121.45499979674692,-0.150710618859616,-0.5539308373379015,-0.4032202184782855,85976830,102933664.8,19.952437528676967,44.72239274083342,NaN,NaN,-25.893933699650695,-15.076907244887742
2011-06-17T09:30:00-04:00,37.99001,38.22,37.83,37.95,10872207,8033626.75,37.39048565571201,37.51103056831361,NaN,NaN,-85.20862452237056,-106.76228725383437,-0.12163553102962216,-0.5552646322653132,-0.43362910123569104,96849037,99370711.8,18.422417425269288,41.51151757927674,NaN,NaN,-25.886866177269525,-16.621187092370853
2011-06-20T09:30:00-04:00,37.8,38.395,37.75,38.25999,5102445,7968119.3,41.81589011483495,36.518920370751175,NaN,NaN,-67.9338652801818,-90.60969305366817,-0.07329934237577951,-0.5252532792054154,-0.4519539368296359,101951482,98740078.2,18.15701955419145,37.971242299404885,NaN,NaN,-24.48519749158557,-17.744617149401527
2011-06-21T09:30:00-04:00,38.45,39.09,38.34,39.03999,12653547,8332622.25,51.16870751655057,37.088204609820316,NaN,NaN,-4.539598695706679,-74.25204157202943,0.014737472443065003,-0.4335320962758047,-0.4482695687188697,114605029,98780779.8,18.238888022418493,34.28268068472451,NaN,NaN,-19.99908531862815,-18.066684030719617
2011-06-22T09:30:00-04:00,38.98,39.12,38.72,38.74001,7581238,8470457,47.97472223030381,37.50065238060979,NaN,NaN,3.3990693441181428,-52.625807067848754,0.054087445055869376,-0.38066026239903294,-0.4347477074549023,107023791,101281233.8,23.31397539718303,31.08301135121787,NaN,NaN,-17.402143133945067,-17.97174961689468
2011-06-23T09:30:00-04:00,38.24001,38.92,38.14999,38.88,12552367,8815557.4,49.55712732101415,38.398637606426526,NaN,NaN,-13.398691936039851,-33.53634221803612,0.08881323892950299,-0.3237311587930236,-0.4125443977225266,119576158,108001099.4,34.99246854177191,29.28904382225028,NaN,NaN,-14.826132950816895,-17.522375807454996
2011-06-24T09:30:00-04:00,38.88,38.99001,38.42,38.5,9967035,8979242.35,45.51056051579258,39.26292322248129,NaN,NaN,-8.841481521570488,-18.2629136178761,0.0854333333129994,-0.3057527310812773,-0.3911860643942767,109609123,110553116.6,38.804014924035826,28.467014312061558,NaN,NaN,-13.916888680430105,-17.00730621788001
2011-06-27T09:30:00-04:00,38.60001,39.14,38.35001,38.97,5413551,9036663.05,50.855629471651426,40.46117327186596,NaN,NaN,25.058637037010474,0.3355868455623529,0.11239698812061139,-0.25068982924351246,-0.36308681736412385,115022674,113167355,42.521821625499015,28.46346884024901,NaN,NaN,-11.402257501889213,-16.20658497273847
2011-06-28T09:30:00-04:00,39.23,39.71001,39.13,39.71001,14877582,9481106,57.86402264317594,42.34283092509106,NaN,NaN,141.87786848751074,29.619080282205836,0.17394115134517552,-0.14566037818265443,-0.31960152952782994,129900256,116226400.4,46.6092950957325,29.14900708574936,NaN,NaN,-6.752622181653625,-14.856018859726348
2011-06-29T09:30:00-04:00,39.94,40.05,39.64999,39.89,12873270,9493054.85,59.38130402775025,43.944408954184254,NaN,NaN,193.37612643045247,67.61449169947271,0.2177978454167998,-0.04735422275683021,-0.26515206817363,142773526,123376347.4,54.715270986921965,30.575817736059555,NaN,NaN,-2.5687269420720895,-13.100691442918597
2011-06-30T09:30:00-04:00,39.99001,40.3,39.94,40.21001,9225699,9558930.8,62.001192936731115,46.15417245923504,NaN,NaN,216.04222301559506,113.50267468979969,0.25670868005567166,0.05573378189595957,-0.2009748981597121,151999225,129860960.8,60.563260731507704,32.60274576881418,NaN,NaN,1.735446955877866,-10.981243100233389
2011-07-01T09:30:00-04:00,40.28999,41.08,40.19,41.02,9654629,9678555.6,67.68302499439115,48.79629934675763,NaN,NaN,237.55655460290006,162.78228191469378,0.3211640634791463,0.20048018118922073,-0.12068388228992552,161653854,140269907,67.76029060519656,35.359515824111384,NaN,NaN,7.556919554134771,-8.332934149609367
2011-07-05T09:30:00-04:00,40.95,41.355,40.89,41.2,11837766,10010782,68.79952112248523,50.78998410200195,NaN,NaN,212.70979047535215,200.31251260236212,0.35731492960015976,0.32595977971027423,-0.03135514988988555,173491620,151963696.2,73.5911764749664,38.6829841770091,NaN,NaN,12.530780026173286,-5.352403553068988
2011-07-06T09:30:00-04:00,41.11,41.1299,40.92,41.05,5560426,10038094.3,66.73054892994924,52.993416969659954,NaN,NaN,158.8167953083143,203.70029796652284,0.35195576242531007,0.40858955314175205,0.056633790716441965,167931194,159569883.8,76.56068631645081,42.44307308784442,NaN,NaN,15.882144748049495,-2.3188966529092045
2011-07-07T09:30:00-04:00,41.5,41.78,41.44,41.62,7871988,9930689,70.37622381319173,55.50778294953809,NaN,NaN,162.6745810944273,197.55998889931783,0.36600638653532463,0.5141417738855978,0.14813538735027315,175803182,166175815,78.79119356953028,46.64584137647679,NaN,NaN,19.983694404148924,0.8671877838133852
2011-07-08T09:30:00-04:00,41.05,41.37,40.97,41.37,6181203,9956495.25,66.91290840979157,57.61652743197235,NaN,NaN,117.36365523838857,177.82427534387654,0.3383214479382612,0.5710371972730997,0.23271574933483846,169621979,169700365.8,79.89072962152278,51.03643510478061,NaN,NaN,22.26368894942557,3.9238308074722688
2011-07-11T09:30:00-04:00,40.75,41.07001,40.41,40.57001,9967898,9973678.25,57.21066218810208,58.716154008634284,NaN,NaN,74.99425179697688,145.3118147826919,0.2500585774787495,0.5452889711832754,0.29523039370452586,159654081,169300411.2,79.38776386314314,55.41005969827716,NaN,NaN,21.069744603643578,6.37324706406817
2011-07-12T09:30:00-04:00,40.5,40.81,40.35001,40.37,9494816,9970461.45,55.061056703323175,58.99417895054661,NaN,NaN,58.13300284812107,114.39645725724566,0.16617290629198117,0.5029465265695023,0.33677362027752117,150159265,164633940.2,73.56814682243805,59.362149612564274,NaN,NaN,19.420751999482967,8.237176340555997
2011-07-13T09:30:00-04:00,40.63,41.02,40.50999,40.58,6115973,9811416.55,56.892473362985044,59.63116117430956,NaN,NaN,62.67750895114292,95.16859998581137,0.11521534298215508,0.480792799005215,0.3655774560230599,156275238,162302749,70.77684966846493,62.75235491765584,NaN,NaN,18.6360249305099,9.72272613912084
2011-07-14T09:30:00-04:00,40.69,40.88,40.12,40.27,6053859,9120109.5,53.43082262702541,59.9078536961675,NaN,NaN,40.895894979587894,70.81286276284351,0.05411997518070377,0.4332274249989396,0.37910744981823585,150221379,157186388.4,64.95209849378654,64.89232848565688,NaN,NaN,16.912726721238524,10.749869079423366
2011-07-15T09:30:00-04:00,40.47,40.47,40,40.28999,15673594,9476554.65,53.62676645852619,60.48758269207705,NaN,NaN,24.851355439977937,52.31040280316137,0.01080898857368845,0.3926186855353464,0.38180969696165795,165894973,156440987.2,64.12411597865324,66.70090713241527,NaN,NaN,15.584316479796795,11.440504422333856
2011-07-18T09:30:00-04:00,40.11,40.19,39.63,39.89999,6023898,9234139.2,49.27103394371053,60.37439729722412,NaN,NaN,-6.141069892698799,36.08333846522622,-0.0452738988154161,0.32521732344238785,0.37049122225780395,159871075,156484386,64.15276804326078,68.24597473368397,NaN,NaN,13.136188466794648,11.682745000113968
2011-07-19T09:30:00-04:00,40.2,40.75999,40.2,40.67,8481477,9403090.8,56.741790317002454,60.29423784535459,NaN,NaN,37.4027641519321,31.937290725988436,-0.0322896919738862,0.3301291072904462,0.3624187992643324,168352552,160123043.4,66.56387967540334,69.67130220366046,NaN,NaN,13.227394934104703,11.903409276398358
2011-07-20T09:30:00-04:00,40.75,40.75999,40.31,40.46001,4986887,9019757.8,54.38939802875135,59.93767313114038,NaN,NaN,29.81777655586692,25.36534424693324,-0.03916393790035466,0.3134638768888891,0.35262781478924377,163365665,161541128.8,67.4818598327634,70.58320140693485,NaN,NaN,12.577430859011725,11.999698073914553
2011-07-21T09:30:00-04:00,40.64999,41.16,40.63,40.92999,6942906,8987841.2,58.532971764989654,59.68994304744456,NaN,NaN,62.38125099397653,29.662415449810958,-0.014641358566399032,0.334326116581245,0.34896747514764404,170308571,165558567.2,69.99513807209128,71.25690693126225,NaN,NaN,13.307776424769157,12.186566409750926
2011-07-22T09:30:00-04:00,40.95,41.155,40.78999,41.09,4104559,8565450.8,59.86967314435953,59.131846486728016,NaN,NaN,69.74716218031058,38.64157679787749,0.008526437817131582,0.35962552241905854,0.35109908460192696,174413130,167262198.6,71.01808486644904,71.4896065213517,NaN,NaN,14.306377482704145,12.489396563029956
2011-07-25T09:30:00-04:00,40.64,40.9929,40.64,40.82001,3973955,8265796.8,56.55682346673675,58.25736808274598,NaN,NaN,41.82238944708627,48.234268665834506,0.0021695594063486645,0.3538110338598628,0.3516414744535141,170439175,169375818.6,72.28072402068985,71.39600277461766,NaN,NaN,14.161901052644755,12.72832577583207
2011-07-26T09:30:00-04:00,40.83,40.88,40.58,40.75,4969719,8243605.2,55.69619159569175,57.46919970172758,NaN,NaN,20.680465121090812,44.889808859666246,-0.009602263561463431,0.33963864500168484,0.34924090856314827,165469456,168799199.4,71.36724624740171,71.02504276968558,NaN,NaN,13.798341465764866,12.881185160108185
2011-07-27T09:30:00-04:00,40.71001,40.72,39.97,40.03999,9608496,7980150.9,47.75884566764043,55.85367269133106,NaN,NaN,-78.62512696446593,23.201228155599676,-0.06497238980302456,0.2680254213093676,0.33299781111239213,155860960,167298258.4,68.92542348019276,70.32034490616148,NaN,NaN,11.010066222592615,12.613882454748818
2011-07-28T09:30:00-04:00,40.09,40.38499,39.75999,39.84,6673043,7670139.55,45.779815804856504,54.344166076692844,NaN,NaN,-130.28130951077733,-15.331283945351094,-0.11207012426549456,0.19291015578052395,0.3049802800460185,149187917,163074127.6,62.449488161638506,69.07454194474117,NaN,NaN,8.10572272431534,11.969859636115464
2011-07-29T09:30:00-04:00,39.62,40.03999,39.28999,39.64999,9133938,7665551.5,43.91776462390372,53.39467339353582,NaN,NaN,-177.1218489799317,-64.70508617739955,-0.1506216119902956,0.11670326505814899,0.2673248770484446,140053979,156202297.4,53.622895831372794,67.23419422818615,NaN,NaN,5.134028433342751,10.993312321433647
2011-08-01T09:30:00-04:00,40.10001,40.10001,38.95,39.44,8141688,7589904.45,41.88992326359637,52.45387814784105,NaN,NaN,-171.66470974710498,-107.4025060162378,-0.1827273249401228,0.03891572087329109,0.2216430458134139,131912291,148496920.6,45.80510244129154,65.25111962953282,NaN,NaN,2.0358546473566155,9.713675510851214
2011-08-02T09:30:00-04:00,39.11,39.28,37.95,37.95,12166137,7606323,30.96465083142421,50.60189082415813,NaN,NaN,-266.77002113063656,-164.89260326658328,-0.2903806919391785,-0.14133281911055917,0.1490478728286193,119746154,139352260.2,38.610626594813205,62.95353226712914,NaN,NaN,-5.066042796877895,7.602287181175628
2011-08-03T09:30:00-04:00,38.03999,38.27,37.25,38.23,13997438,8028173.6,34.42573823555044,49.24438479619563,NaN,NaN,-247.54748901389655,-198.6770756764694,-0.32612339621599756,-0.25860637244137763,0.06751702377461992,133743592,134928786.6,35.69039561963805,60.86341063326139,NaN,NaN,-9.546411479227375,5.152473086832342
2011-08-04T09:30:00-04:00,37.63,37.7301,36.36,36.37,23055360,8787342.2,25.33804373930633,47.22376174482279,NaN,NaN,-265.529646967653,-225.72674316784452,-0.45074669800119394,-0.4959163487268725,-0.045169650725678565,110688232,127228849.6,31.258523420537742,58.515868307681714,NaN,NaN,-17.63690086979378,1.896848235885753
2011-08-05T09:30:00-04:00,36.82001,37.05,35.36,36.34,24836400,9720102.05,25.222392648647897,45.50600165231831,NaN,NaN,-231.3648276075193,-236.57533889336204,-0.5067320093037584,-0.6785846623553766,-0.17185265305161818,85851832,116388420.2,26.305921872544232,55.812522152630535,NaN,NaN,-23.544363255956682,-1.737610548663166
2011-08-08T09:30:00-04:00,35.42,35.8,33.91,34.06,26310640,10537239.15,18.36262170645672,42.76463246585076,NaN,NaN,-242.56254388973358,-250.75490572188772,-0.6591963142200181,-0.9958480458266408,-0.3366517316066227,59541192,101914200.4,21.42484195614334,52.588305172683384,NaN,NaN,-32.19870577838395,-6.089195581480421
2011-08-09T09:30:00-04:00,34.53,35.67,33.42,35.64,25260896,11325543.15,32.13677072021078,41.17515908666929,NaN,NaN,-175.14230747086827,-232.42936298993408,-0.6163007283476243,-1.1070276420411531,-0.49072691369352883,84802088,94925387.2,19.539584490949622,49.1638569339824,NaN,NaN,-33.11942190749026,-9.950656485196113
2011-08-10T09:30:00-04:00,34.78,35.23,34.02,34.12,23240336,12181761.3,27.355047959156863,38.9481645291098,NaN,NaN,-156.38764543940982,-214.19739427503674,-0.6496360889819751,-1.3027720249209978,-0.6531359359390226,61561752,80489019.2,16.34091968078721,45.331412763174974,NaN,NaN,-35.93656780991752,-13.662929531584885
2011-08-11T09:30:00-04:00,34.42,36.09,34.25,35.63,19358352,12846985.95,37.330972518527716,37.33825734155038,NaN,NaN,-108.09870353481925,-182.71120558847002,-0.5341558619371969,-1.3208307633605187,-0.7866749014233219,80920104,74535393.6,15.233383213377905,41.34679121652704,NaN,NaN,-33.72972339190501,-16.529614368773473
2011-08-12T09:30:00-04:00,35.97,36.28999,35.56,36.07001,10715598,12599086.15,39.92006436104995,36.149917405429896,NaN,NaN,-77.1294065201597,-151.86412137099808,-0.3985213847461775,-1.2848266323560438,-0.8863052476098663,91635702,75692167.6,16.418721282679044,37.35664816381198,NaN,NaN,-31.106310723538293,-18.611999562311304
2011-08-15T09:30:00-04:00,36.25,36.60001,35.97,36.60001,21470864,13371434.45,42.976039952659164,35.24133514521328,NaN,NaN,-57.334801323804136,-114.8185728578122,-0.25071353502051663,-1.199697166385512,-0.9489836313649954,113106566,86405242.4,26.648715913011415,34.162467425641246,NaN,NaN,-27.979253798848347,-19.950178738959455
2011-08-16T09:30:00-04:00,36.39999,36.75,36,36.39999,9129535,13403837.35,42.10559272882634,34.83753136386942,NaN,NaN,-51.63641043059738,-90.11739344975801,-0.1490407270307974,-1.1352845401534921,-0.9862438131226947,103977031,90240231,29.953822417581705,31.378781635454743,NaN,NaN,-25.92220234125135,-20.8033249678583
2011-08-17T09:30:00-04:00,36.74001,36.88,35.89,36.35001,9699566,13639471.3,41.87734696692276,34.5587835897313,NaN,NaN,-46.643679101604086,-68.16860018219688,-0.07169942977411359,-1.0758681003403368,-1.0041686705662232,94277465,96783373.6,35.309623150789136,29.440219848965505,NaN,NaN,-24.41571767824679,-21.31938106934237
2011-08-18T09:30:00-04:00,35.28999,35.33,34.2,34.55,17188576,14151754.8,34.602362950334836,33.89339775590494,NaN,NaN,-91.6423971794002,-64.87733891111307,-0.12518241937489138,-1.1606466947848375,-1.0354642754099461,77088889,96017130.6,34.972390122834256,28.108040869784183,NaN,NaN,-25.568854409314113,-21.926448689338333
2011-08-19T09:30:00-04:00,34.03999,35.19,33.99001,34.05,15118164,14702435.05,32.89299307235909,33.250759885102276,NaN,NaN,-94.0078617973976,-68.25302996656065,-0.1746109536038407,-1.253727967414747,-1.0791170138109063,61970725,90084135.2,32.392651570002215,27.150008664692084,NaN,NaN,-27.05740643470984,-22.659442652962834
2011-08-22T09:30:00-04:00,34.81,34.89999,34.07001,34.14999,10973828,15052428.7,33.5994299215982,33.438958391543274,NaN,NaN,-90.65610540832301,-74.91729078346444,-0.18021917451512914,-1.3043909819548176,-1.1241718074396885,72944553,82051732.6,29.247148916757325,26.48118883054524,NaN,NaN,-27.9971227142492,-23.421968376003743
2011-08-23T09:30:00-04:00,34.27,35.48,34.13,35.47,9892586,15298572.05,42.24338574509178,33.99736178508194,NaN,NaN,-63.15812285466055,-77.22163326827706,-0.07979809760800438,-1.223919429449694,-1.1441213318416896,82837139,77823754.2,27.721241420451534,25.91196353060334,NaN,NaN,-25.9780740873067,-23.787126334761307
2011-08-24T09:30:00-04:00,35.33,36.12,35.27,36.10001,10335934,15334943.95,45.86555956847307,35.46361291573672,NaN,NaN,-25.107447906563777,-72.914387029269,0.037963538225182836,-1.096666909060211,-1.1346304472853939,93173073,77602875.8,27.64010990151492,25.653505422101713,NaN,NaN,-23.14497393451383,-23.695390277583098
2011-08-25T09:30:00-04:00,36.27,36.42,35.25999,35.38,11603813,15581482.45,42.5790191153809,36.703371949074786,NaN,NaN,-24.8888099747349,-59.56366958833594,0.07417899181854581,-1.0419067075122115,-1.1160856993307573,81569260,78498950,28.553659912510028,25.814058139242125,NaN,NaN,-21.83002324864025,-23.428909273448404
2011-08-26T09:30:00-04:00,35.14,36.32001,34.75,36.12,10999313,15674751.2,46.79845511976487,38.73450290716823,NaN,NaN,-14.14080370664262,-43.59025797018494,0.15038976269870874,-0.9280984959573715,-1.0784882586560802,92568573,84618519.6,34.62401713082336,26.75685636600499,NaN,NaN,-19.38200645658576,-22.850780299610882
2011-08-29T09:30:00-04:00,36.58,37.2,36.52,37.17,9910113,15763172.45,52.16919090274306,40.16539006306339,NaN,NaN,83.91022644934955,-8.676991598650423,0.2671144361678788,-0.7445952134462317,-1.0117096496141105,102478686,90525346.2,39.92937225050311,28.213269777401667,NaN,NaN,-15.524721406493406,-21.804200457736957
2011-08-30T09:30:00-04:00,37.08,37.60001,36.75999,37.34,13722980,15841014.6,52.99653041568985,41.996924524244314,NaN,NaN,115.48509816805874,27.05165260589343,0.3463451866422238,-0.5787781663113307,-0.9251233529535545,116201666,97198251.6,45.32713158633619,30.28371348494088,NaN,NaN,-12.205185692571193,-20.43291263414185
2011-08-31T09:30:00-04:00,37.60001,37.99001,37.25,37.57001,8406902,15561487.8,54.15205293321877,43.19843026815082,NaN,NaN,148.60264158852573,61.79367050491133,0.4009623729658408,-0.42392038674625354,-0.8248827597120943,124608568,103485350.6,49.89537442655415,32.759570000167756,NaN,NaN,-9.158332626504615,-18.82225834733653
2011-09-01T09:30:00-04:00,37.55,37.89999,37.05499,37.11,9822188,14899829.2,51.428965875756674,44.02049466205845,NaN,NaN,122.58753824360855,91.28894014858002,0.3923397922242583,-0.33445801943177145,-0.7267978116560297,114786380,110128774.6,54.24582653614545,35.461506089701075,NaN,NaN,-7.3720292908523,-17.186511339267355
2011-09-02T09:30:00-04:00,36.36,36.53999,35.94,36.06,12263719,14271195.15,45.77119261696058,44.22014842379425,NaN,NaN,31.66490488801828,100.4500818675122,0.30598575535024886,-0.3443156174682187,-0.6503013728184676,102522661,112119592.2,55.49295031897724,37.521808547270055,NaN,NaN,-7.488100213613638,-15.801024035602538
2011-09-06T09:30:00-04:00,35.00999,36,34.99001,35.95,8780992,13394712.75,45.21006588823141,44.441896506608906,NaN,NaN,-15.007906483397166,80.66645528096286,0.23472916954481715,-0.35688991088744615,-0.5916190804322633,93741669,110372188.8,54.09910270125538,39.24647142467533,NaN,NaN,-7.744366379724276,-14.650072941905643
2011-09-07T09:30:00-04:00,36.44,36.89999,36.28,36.88,8546445,12558990.2,50.711652247425164,45.07291831235908,NaN,NaN,64.3696966432282,70.44337497599672,0.24250613666892784,-0.2884864095961035,-0.5309925462650313,102288114,107589478.4,51.86495931822906,40.42899543663532,NaN,NaN,-6.334931035646164,-13.462195526725719
2011-09-08T09:30:00-04:00,36.64,37,36.2426,36.38,7433965,11768671.65,47.92537447403537,46.0245619926234,NaN,NaN,46.23908024952278,49.97066270819613,0.20760014236877178,-0.27149236830406664,-0.4790925106728384,94854149,101638594.6,47.360568834826985,41.3138653446348,NaN,NaN,-5.967367301744234,-12.391505780299791
2011-09-09T09:30:00-04:00,35.92999,36.11,35.17,35.42,11123930,11356950.55,43.03619046274386,46.7490760919366,NaN,NaN,-42.026392235312706,17.04787661241188,0.11794183658111279,-0.3316652149464474,-0.4496070515275602,83730219,95427362.4,43.148383257711416,42.08213189375688,NaN,NaN,-7.139932215488318,-11.641280985326723
2011-09-12T09:30:00-04:00,34.84,35.85001,34.84,35.84,8871559,11264748.6,45.64861769609695,47.60973236154366,NaN,NaN,-43.67975224526643,1.9789451857549338,0.08646544198997708,-0.34152524904008885,-0.42799069103006593,92601778,93443185.8,41.86737033027764,42.98357628043691,NaN,NaN,-7.338610384117139,-11.026613756582497
2011-09-13T09:30:00-04:00,35.92,36.38,35.67,36.25999,8314547,10606932.75,48.206579824182064,48.03567479576439,NaN,NaN,9.68050124191439,6.916626730817245,0.09290867637354089,-0.3118548455631398,-0.4047635219366807,100916325,94878117,43.18113322291251,44.08785426632698,NaN,NaN,-6.756771317032889,-10.416636265218267
2011-09-14T09:30:00-04:00,36.44,37.32001,35.94749,36.86,10082266,10654569.3,51.70363273886714,48.45268002222111,NaN,NaN,60.9344888876312,6.229585179697845,0.13405813275333656,-0.23719085599501,-0.37124898874834655,110998591,96620212.4,44.81181300946584,45.31440448832347,NaN,NaN,-5.22868063369821,-9.675499746429688
2011-09-15T09:30:00-04:00,37.34,37.53999,36.87,37.48,7848586,10562020.3,55.07881118226212,49.345522312712625,NaN,NaN,102.01963726194747,17.38569658218278,0.19577382370743363,-0.12653170911405454,-0.32230553282148816,118847177,101418818,49.141600808620595,46.78497169518851,NaN,NaN,-2.9151378088071085,-8.709733755340748
2011-09-16T09:30:00-04:00,37.5,37.815,37.37,37.77,11630777,10284130.35,56.606374434561765,50.04608797805526,NaN,NaN,117.6946095914654,49.3298969475384,0.24563875635334387,-0.015257087379808354,-0.2608958437331522,130477954,110768365,56.33045035352666,48.335431211095894,NaN,NaN,-0.5480626109825395,-7.543780734718147
2011-09-19T09:30:00-04:00,37.13,37.91,37,37.7,6554004,9855922.35,56.110381026642166,50.32760155833376,NaN,NaN,98.4017890138242,77.74620519935652,0.26192764172412797,0.06651370842200777,-0.1954139333021202,123923950,117032799.4,60.37222737513287,49.795635148569446,NaN,NaN,1.263287579434454,-6.285628118410632
2011-09-20T09:30:00-04:00,37.86,38.23,37.47,37.5,13814637,9997962.8,54.63733369636431,50.444801792667654,NaN,NaN,107.2144099315214,97.25298693727794,0.2474245384774462,0.11386673979468753,-0.13355779868275866,110109313,118871397,61.498543502985754,50.9507359997587,NaN,NaN,2.402017535576289,-5.0445358821267865
2011-09-21T09:30:00-04:00,37.58,37.64,36.28999,36.28999,14209359,10213801.45,46.65679774032301,49.909426421746524,NaN,NaN,12.342510945132414,87.53459134877816,0.14936148073821293,0.05314405224000751,-0.09621742849820542,95899954,115851669.6,58.554871567996166,51.56927150986171,NaN,NaN,1.13445791663693,-4.161822482303398
2011-09-22T09:30:00-04:00,35.17999,35.91,34.67,35.2,28196000,11106804.75,40.86618063642133,49.15494176179401,NaN,NaN,-125.3499224697101,42.06067940244667,0.011384260860664824,-0.08198710242237439,-0.09337136328303922,67703954,105623025,49.85064150845807,51.25532972216975,NaN,NaN,-1.8261030041100974,-3.8281482711329264
2011-09-23T09:30:00-04:00,34.96001,35.94,34.94,35.73,16589563,11356092.25,44.47477672329373,49.062340626532084,NaN,NaN,-97.36212824003441,-0.9506681638532968,-0.041019358542161904,-0.1446455614607416,-0.10362620291857969,84293517,96386137.6,43.55427042662838,50.40256687271626,NaN,NaN,-3.209286190706844,-3.739739402500629
2011-09-26T09:30:00-04:00,36.07001,36.57001,35.39999,36.57001,14192742,11515763.7,49.71264319050013,49.383953290979846,NaN,NaN,-40.794882205740706,-28.79000240776628,-0.017162413305996632,-0.12507921955107548,-0.10791680624507885,98486259,91298599.4,40.518690434336385,49.43253742507919,NaN,NaN,-2.7706702536067946,-3.6013009526586526
2011-09-27T09:30:00-04:00,37.25,37.55,36.62,36.82001,12552566,11647886.35,51.18844153489015,49.41800966865592,NaN,NaN,37.97144812616841,-42.63859476883687,0.01562861272468566,-0.08838104033922178,-0.10400965306390744,111038825,91484501.8,40.681381596845746,48.63371044498037,NaN,NaN,-1.9688613369645582,-3.368095293273782
2011-09-28T09:30:00-04:00,36.91,37.25,36.14999,36.19,9743051,11448889.9,47.41227513597167,49.38135971593708,NaN,NaN,-3.839687308584602,-45.875034419580274,-0.0038954153595831265,-0.10887892226338636,-0.10498350690380323,101295774,92563665.8,41.67861858665217,48.22785685582503,NaN,NaN,-2.426669250970247,-3.2336058586589913
2011-09-29T09:30:00-04:00,36.83,36.87,35.14999,35.89,13368305,11696960.05,45.68404236188243,49.57049199444698,NaN,NaN,-53.59171151716487,-31.523392229071238,-0.03411667836195134,-0.1476293548562424,-0.11351267649429106,87927469,96608368.8,45.38462481267753,48.387588395465464,NaN,NaN,-3.31641745864525,-3.2454360872284567
2011-09-30T09:30:00-04:00,35.27,35.78999,34.86,34.86,13228031,11867252.2,40.25820797855392,49.1854627289082,NaN,NaN,-121.04294256574796,-36.25955509421395,-0.11596764820206201,-0.2584722367468686,-0.14250458854480658,74699438,94689553,43.957561418712636,48.536887758925104,NaN,NaN,-5.804514575544612,-3.6110187284164788
2011-10-03T09:30:00-04:00,34.61,35.21001,33.84,33.84,22001216,12354127.05,35.732254766928634,48.294439510532946,NaN,NaN,-174.4571144394362,-62.99200154095305,-0.22498586459682585,-0.4237369192908389,-0.19875105469401305,52698222,85531945.6,37.841931095876944,48.155516178422566,NaN,NaN,-9.457653682575721,-4.446252293296371
2011-10-04T09:30:00-04:00,33.39999,34.99001,33.07001,34.91,17657600,12797957.45,42.97479276421047,47.670950940914615,NaN,NaN,-152.96992590533756,-101.18027634725425,-0.2114253640932542,-0.4630327598105808,-0.2516073957173266,70355822,77395345,33.39613533799462,47.34011063046034,NaN,NaN,-10.237586179780486,-5.273585705651244
2011-10-05T09:30:00-04:00,35.07001,35.64999,34.67,35.55,14089203,13075095.35,46.8341200081322,47.08204442847676,NaN,NaN,-67.66696114956933,-113.9457311154512,-0.14870547669610995,-0.43748924158746405,-0.2887837648913541,84445025,74025195.2,31.733179576318236,46.09665197101017,NaN,NaN,-9.620291118950448,-5.894543621836844
2011-10-06T09:30:00-04:00,35.52,36.42,35.44,36.38,8903016,13148547.9,51.42542887476131,46.71197688849103,NaN,NaN,-3.5555391938925247,-103.93849665079672,-0.04599703211994932,-0.3462800550412908,-0.30028302292134146,93348041,75109309.6,32.89082870934783,44.422393282140256,NaN,NaN,-7.590612615800131,-6.136839192403028
2011-10-07T09:30:00-04:00,36.59,36.75999,36.06,36.35001,11919949,13188348.85,51.25319937497629,46.36503534194346,NaN,NaN,18.47384805541454,-76.03513852656423,0.02161360284047753,-0.2732660193707446,-0.2948796222112221,81428092,76455040.4,34.378413614583266,42.56569229924385,NaN,NaN,-6.050148053333211,-6.124454743964483
2011-10-10T09:30:00-04:00,36.75,37.61,36.75,37.58,6577215,13073631.65,57.53482858778197,46.57199926275901,NaN,NaN,84.53109351842856,-24.237496934991263,0.14404106776955466,-0.11482828749927876,-0.2588693552688334,88005307,83516457.4,41.683265792262446,41.150315319906476,NaN,NaN,-2.634205543417515,-5.625847715314916
2011-10-11T09:30:00-04:00,37.46001,37.8,37.36,37.74001,7979980,13056903.3,58.28786985643124,47.402790128195306,NaN,NaN,97.70510576950711,25.89750939997767,0.22579688706954762,0.023376753568101094,-0.20242013350144653,95985287,88642350.4,46.35181658836083,40.27866853564681,NaN,NaN,0.32431806342582326,-4.775824032637668
2011-10-12T09:30:00-04:00,37.92,38.59,37.89,38.08,9778535,13041716.75,59.91445711916605,48.76338130553422,NaN,NaN,124.1814879940414,64.26719922869981,0.2887459980414108,0.158512364050317,-0.13023363399109383,105763822,92906109.8,49.941642021148404,40.285168572267544,NaN,NaN,3.259029323027925,-3.627987838971155
2011-10-13T09:30:00-04:00,37.95,38.22501,37.75,38.05,8828313,13090703.1,59.693259683409615,49.85041580268535,NaN,NaN,105.34476840528653,86.04726074853563,0.3123375241913244,0.26018827124806165,-0.052149252943262725,96935509,93623603.4,50.54139197548535,40.784248682900184,NaN,NaN,5.57758778331091,-2.312905607216574
2011-10-14T09:30:00-04:00,38.53,38.72,38.2007,38.67,6166879,12817508.2,62.7537182342105,50.781921162950376,NaN,NaN,131.6455325433774,108.6815976461282,0.3507933729584948,0.3863424632548558,0.03554909029636098,103102388,97958462.6,54.118047867562304,41.75563135670204,NaN,NaN,8.489959383967829,-0.7696391799045166
2011-10-17T09:30:00-04:00,38.48,38.64,37.86501,37.88,5928297,12786222.85,56.83231969003503,51.1850553168893,NaN,NaN,100.98411272812719,111.97220148806791,0.3057675369966568,0.417758511542182,0.11199097454552519,97174091,99792219.4,55.5814088596261,42.8199190183292,NaN,NaN,9.327540283704858,0.6728150291825368
2011-10-18T09:30:00-04:00,37.89,38.96001,37.49001,38.64999,11289914,12659986.7,60.722513139500236,52.135786602855624,NaN,NaN,110.46355780085607,114.52389189433771,0.30963533839013346,0.499035147533192,0.18939980914305854,108464005,102287963,57.56510710486505,43.95466819820155,NaN,NaN,11.233269834310283,2.1814514299150716
2011-10-19T09:30:00-04:00,38.71001,38.74249,37.92999,38.07001,7405398,12319788.65,56.58600275492193,52.9144980595013,NaN,NaN,91.73276897539421,108.03414809060828,0.257088314717569,0.5107602025400197,0.25367188782245076,101058607,101346920,56.53978767206744,44.75146554530084,NaN,NaN,11.604748581932084,3.5276367373460733
2011-10-20T09:30:00-04:00,38.14999,38.42999,37.64999,38.25999,8995422,11359759.75,57.6047836367639,54.15353917794487,NaN,NaN,75.69575347221611,102.10434510399418,0.22048726560133086,0.5292809698241143,0.30879370422278346,110054029,103970624,58.74604186130476,45.80778557691456,NaN,NaN,12.203977355676274,4.767113968536102
2011-10-21T09:30:00-04:00,38.8,39.34,38.74001,39.32001,10418508,11051207,62.84404749369788,56.090095801285536,NaN,NaN,118.93750620809837,99.56273983693839,0.25082091703679577,0.6223198505187781,0.3714989334819824,120472537,107444653.8,61.53075672234913,47.49984455023401,NaN,NaN,14.353135063882986,6.136545553585657
2011-10-24T09:30:00-04:00,39.55,40.03999,39.37,39.89999,13107582,10996949,65.36601518442384,57.68946883130077,NaN,NaN,134.9884308797158,106.3636034672561,0.2903110989603973,0.734387807182479,0.4440767082220817,133580119,114725859.4,66.61697744670687,49.872761843713455,NaN,NaN,16.946805184705443,7.680868358031341
2011-10-25T09:30:00-04:00,39.69,39.69,38.91,39.03,11092063,10923923.85,58.9070315506626,58.55181965576723,NaN,NaN,95.24979930143287,103.32085176737147,0.24027490048749423,0.7444203338314495,0.5041454333439552,122488056,117530669.6,68.35278632757178,52.48844804023156,NaN,NaN,17.17229462103593,9.036786395603425
2011-10-26T09:30:00-04:00,39.08,39.185,38.22,38.88,16208004,11247171.5,57.84571473126854,59.01041150266061,NaN,NaN,67.71691437472312,98.51768084723724,0.1821487260723661,0.7318313409344128,0.5496826148620467,106280052,118574958.6,68.99911329193236,55.06761122470188,NaN,NaN,17.034955736385797,10.179382015715191
2011-10-27T09:30:00-04:00,39.92,40.17,39.22,39.94,12983871,11227949.8,62.92866050728962,59.844373012111554,NaN,NaN,107.50570291123175,104.87967073504038,0.1988032010050771,0.798186616118393,0.5993834151133159,119263923,120416937.4,70.15685067020469,57.62321387153198,NaN,NaN,18.50055132807875,11.368120488909986
2011-10-28T09:30:00-04:00,39.77,39.86,39.36,39.63,9072188,11020157.65,60.62628980769749,60.06519167067695,NaN,NaN,95.38545999166811,100.16926149175433,0.1735723709718625,0.8163488788281441,0.6427765078562816,110191735,118360777,67.14252179060723,59.441732157128044,NaN,NaN,18.99895710008088,12.458240004791541
2011-10-31T09:30:00-04:00,39.23,39.50999,38.99001,39.02,6499051,10245049.4,56.264040300642414,59.92063241669204,NaN,NaN,71.04292041103032,87.38015939801723,0.10387037935268595,0.772614482047139,0.6687441026944531,103692684,112383290,59.18175790478559,60.35815653687267,NaN,NaN,18.0900827275462,13.262788965185065
2011-11-01T09:30:00-04:00,38.05,38.5589,37.82001,38.17999,10708516,9897595.2,50.83919361379066,59.272399309165216,NaN,NaN,-0.732853757045561,68.18362878632153,-0.0049668236813025235,0.6625355730928248,0.6675023967741274,92984168,106482512.4,52.557095650409345,60.54497465324845,NaN,NaN,15.593177313661268,13.59570158639595
2011-11-02T09:30:00-04:00,38.82001,38.82001,38.24001,38.57001,5430758,9464672.95,53.10026387446423,58.80147103709769,NaN,NaN,16.891073332523266,58.018460577881584,-0.05411883160557118,0.5998538572671634,0.6539726888727346,98414926,104909487.2,50.92072538531575,60.57206989680776,NaN,NaN,14.21041013328392,13.683517093094231
2011-11-03T09:30:00-04:00,38.92999,39.16,38.12,39.07001,6738301,9356437.2,55.90051140387633,58.31195626350239,NaN,NaN,30.35732030119894,42.588784055875024,-0.05614267162320652,0.5837943493437265,0.6399370209669331,105153227,102087348,48.03135953483745,60.137306444470276,NaN,NaN,13.883598406825662,13.712100137913007
2011-11-04T09:30:00-04:00,38.83,39.02,38.48,38.92,4696641,8995271.8,54.84252913742989,58.169828366887735,NaN,NaN,23.2919354698375,28.170079151508894,-0.06987555513633215,0.5525925770465179,0.62246813218285,100456586,100140318.2,46.08833697897609,59.459229881566706,NaN,NaN,13.309818258680735,13.654631298022682
2011-11-07T09:30:00-05:00,39,39.17999,38.59,39.17,4544074,8893614.75,56.32603646359576,57.855794318608844,NaN,NaN,37.375410570813514,21.43657718346553,-0.06454057559605886,0.5417924126877764,0.6063329882838353,105000660,100401913.4,46.40205750653884,58.661869195971974,NaN,NaN,13.244788501182011,13.596082327045444
2011-11-08T09:30:00-05:00,39.36,39.61,38.77251,39.55,8445629,8916897.2,58.55479319255526,57.99642220701122,NaN,NaN,74.36064170091775,36.45527627505819,-0.03909050001965109,0.5574698632592714,0.5965603632789225,113446289,104494337.6,51.18754730609815,58.27956631268845,NaN,NaN,13.811975215192431,13.6269241682093
2011-11-09T09:30:00-05:00,38.75999,38.8,38,38.14,6888918,8772416.35,48.63677255045695,57.35584998656073,NaN,NaN,-67.5352865489059,19.570004298772353,-0.11651133003481162,0.450921200735408,0.5674325307702196,106557371,106122826.6,52.98638026108186,57.86816191267253,NaN,NaN,11.25501796960315,13.288080425551279
2011-11-10T09:30:00-05:00,38.53999,38.60001,37.99001,38.5,6754398,8668720.6,50.92244275099915,56.50430679065368,NaN,NaN,-65.1676475605155,0.4650107264294633,-0.14112830504666407,0.3910221494618895,0.5321504545085536,113311769,107754535,54.784385870032615,57.386278280364195,NaN,NaN,9.833340669657611,12.794546174709327
2011-11-11T09:30:00-05:00,38.88,39.56,38.88,39.47,6706480,8695700.65,56.53493222002853,55.87351515033972,NaN,NaN,65.45112199251807,8.896848030965577,-0.09210794933206368,0.417015517843474,0.5091234671755377,120018249,111666867.6,58.848202168539295,56.83136576049509,NaN,NaN,10.348461485615076,12.44510550483872
2011-11-14T09:30:00-05:00,39.28999,39.5228,39.02,39.17999,3483801,8573475.85,54.52717355188893,55.560668150427325,NaN,NaN,50.338232518220956,11.489412420447065,-0.07970383129798764,0.40949367805305315,0.4891975093510408,116534448,113973625.2,61.069885661201475,56.311158570040064,NaN,NaN,10.154809425838817,12.117920350695877
2011-11-15T09:30:00-05:00,39.00999,39.53,38.83,39.32001,3898055,8203882.9,55.35161938785535,55.38251848304067,NaN,NaN,43.286329134395196,5.274549907142554,-0.06327513490637421,0.410103590718073,0.4733787256244472,120432503,115370868,62.394234549906116,55.83938151703819,NaN,NaN,10.237848411245317,11.849338645060083
2011-11-16T09:30:00-05:00,38.97,39.3,38.50999,38.58,4901801,8078703.05,50.174097457904594,54.471478265227454,NaN,NaN,-28.497484007655103,13.08211041539271,-0.10120237203904392,0.3468757605756423,0.4480781326146862,115530702,117165534.2,64.08427781357871,55.40562631299348,NaN,NaN,8.754807620617363,11.40726278442541
2011-11-17T09:30:00-05:00,38.53,38.62,37.69,37.89999,6999691,7978916.5,45.923150512498815,53.42125402985612,NaN,NaN,-146.4175119988805,-3.167862472280291,-0.16715092630695105,0.2391394747309974,0.40629040103794845,108531011,116209382.6,62.4733866663456,55.07211666126051,NaN,NaN,6.167048468297097,10.658660739264223
2011-11-18T09:30:00-05:00,38.07001,38.13,37.64999,37.88,3869815,7651481.85,45.80030574265211,52.67384441857109,NaN,NaN,-149.39876554292158,-46.13783997936822,-0.20470366185741573,0.15041082371617875,0.3551144855735945,104661196,113137972,57.47542736228619,54.95023590822484,NaN,NaN,4.0506711479786315,9.714662226223425
2011-11-21T09:30:00-05:00,37.37,37.45,36.82001,37.28999,5852238,7288714.65,42.21121749611205,52.05756041016548,NaN,NaN,-216.20388328964836,-99.44626314094208,-0.2584006555803856,0.0321136660981125,0.2905143216784981,98808958,109592874,52.276875962890735,54.93022021625922,NaN,NaN,1.147236129608843,8.490744212421342
2011-11-22T09:30:00-05:00,37.23,37.46001,36.91,37.27,3933607,6930791.85,42.09086869907839,51.271175040495066,NaN,NaN,-172.61297546430862,-142.62612406068286,-0.2824353803260956,-0.06252990372912137,0.2199054765969742,94875351,104481443.6,45.83910980047813,54.56724767448511,NaN,NaN,-1.2535215874546277,7.09870624101049
2011-11-23T09:30:00-05:00,36.91,37.03999,36.49001,36.53,4668816,6353832.45,37.79499258663148,49.97792369640615,NaN,NaN,-187.4529811873022,-174.41722349661228,-0.33192405830663185,-0.19499959628631558,0.13692446202031625,90206535,99416610.2,40.51498041607465,54.03036345171633,NaN,NaN,-4.670526461705943,5.417387283479571
2011-11-25T09:30:00-05:00,36.39,36.78,36.33,36.33,2988641,5854070.95,36.70463797810522,48.682360042168675,NaN,NaN,-176.36767663870683,-180.40725642457753,-0.35955444224207334,-0.3125185907822754,0.04703585145979791,87217894,95153986.8,36.65614947343904,53.35663577274941,NaN,NaN,-7.8343307094961805,3.5242847130544637
2011-11-28T09:30:00-05:00,37.34,37.67,37.21001,37.44,5567160,5678819.55,46.01349533827953,47.94574996178894,NaN,NaN,-79.07413710626568,-166.34233073724636,-0.28761540364723853,-0.31248340309925027,-0.024867999452011735,92785054,92778758.4,34.674342079287115,52.51894181365999,NaN,NaN,-7.944917883489149,1.8858271992625193
2011-11-29T09:30:00-05:00,37.55,37.78,37.39,37.57001,4842363,5595985.15,46.99674874693791,47.12017535853057,NaN,NaN,-58.84551063665637,-134.87065620664794,-0.21892448194860886,-0.2985236018877728,-0.07959911993916396,97627417,92542450.2,34.474644639073986,51.3251630517297,NaN,NaN,-7.745206741515523,0.509965207722799
2011-11-30T09:30:00-05:00,38.63,38.77499,38.31,38.74001,8710129,5496065.8,54.948819147573786,47.5710358297532,NaN,NaN,33.161064506820594,-93.71584821242212,-0.08900160324388114,-0.19085112399401538,-0.10184952075013425,106337546,94834889.2,38.19344193923086,50.26852460016892,NaN,NaN,-5.0135392723856205,-0.27910686086411807
2011-12-01T09:30:00-05:00,38.69,39.53999,38.61,38.77,4375945,5443325.15,55.13462709045219,47.87190613971412,NaN,NaN,62.71027496784163,-43.68319698139335,-0.000060414408757453186,-0.10192503876108105,-0.1018646243523236,110713491,98936280.4,44.28569493637027,49.51861810490732,NaN,NaN,-2.7872588808168604,-0.6374142922859384
2011-12-02T09:30:00-05:00,39.21001,39.42999,39.03999,39.07001,5729352,5392877.7,57.04330608544473,47.90821855867243,NaN,NaN,77.56450939992625,7.103240226333267,0.07576398435697913,-0.007159643906099689,-0.08292362826307882,116442843,104781270.2,51.606628958030846,49.00136287558529,NaN,NaN,-0.3592561611132938,-0.597677416404132
2011-12-05T09:30:00-05:00,39.67,39.75,39.19,39.42999,4591602,5387625.75,59.28171005764088,48.24782830908328,NaN,NaN,95.42796156637105,42.0036599608606,0.1430466567978249,0.0958846927342023,-0.0471619640636226,121034445,110431148.4,57.429634048425946,48.741344903244176,NaN,NaN,2.3592566314603034,-0.17525826670921263
2011-12-06T09:30:00-05:00,39.39,39.53,39.19,39.3,6142070,5467525.55,58.104288294203165,48.44444751667955,NaN,NaN,82.4980247406597,70.27236703632381,0.16985369878331927,0.1651551594155265,-0.004698539367792777,114892375,113884140,60.55362330421445,48.609872671409065,NaN,NaN,4.2885099585137665,0.46242290832264143
2011-12-07T09:30:00-05:00,39.14999,39.7299,38.95,39.55,4717820,5281135.1,59.759631437244046,49.129128515203796,NaN,NaN,87.344371406413,81.1090284162423,0.19374907344193154,0.23748780243462164,0.04373872899269011,119610195,116538669.8,62.812908845541365,48.51906060226354,NaN,NaN,6.3928546076751305,1.3096274368015686
2011-12-08T09:30:00-05:00,39.34,39.45,38.64,38.71001,6413629,5257370.65,52.284629836972506,49.583519895523345,NaN,NaN,44.73843452527697,77.51466032772935,0.14456462768918885,0.22444451360417617,0.07987988591498732,113196566,117035284.8,63.23712807210765,48.573613559817964,NaN,NaN,6.1449931240824665,2.0003939635559824
2011-12-09T09:30:00-05:00,38.91,39.49001,38.89999,39.35001,6603039,5249802.7,56.72603701750021,50.36392927229821,NaN,NaN,63.44556191138065,74.69087083002023,0.14627350845837864,0.2627217714879606,0.11644826302958197,119799605,117706637.2,63.8377061919146,49.02806204764857,NaN,NaN,7.2689229645684295,2.7530409637006175
2011-12-12T09:30:00-05:00,39.06,39.265,38.67999,39.23,14243891,5626673.25,55.67944046345899,51.325945198537276,NaN,NaN,50.611236211827226,65.72752575911146,0.13095630837830205,0.28014364850245954,0.1491873401241575,105555714,114610891,59.04742993255948,49.51167304548205,NaN,NaN,7.8849845940862195,3.486175768041418
2011-12-13T09:30:00-05:00,39.42,39.48,38.3,38.46001,7897957,5847381.05,49.38388002122054,51.84687457869029,NaN,NaN,29.193699024114967,55.06666061580252,0.06399176256583716,0.22917704333145394,0.16518528076561678,97657757,111163967.4,54.17306864408466,50.106955820025384,NaN,NaN,6.524378093118751,3.920204671623894
2011-12-14T09:30:00-05:00,38.38,38.38,37.81,38.06,7996426,6052299.6,46.44584574575672,52.46479266148494,NaN,NaN,-19.046746329726297,33.78843706857466,-0.008368537743004806,0.15472460858686077,0.16309314632986557,89661331,105174194.6,46.92410257073658,50.564750259644086,NaN,NaN,4.484427509436309,4.000807934168525
2011-12-15T09:30:00-05:00,38.36,38.42999,38.06,38.12,7489395,6181679.3,46.955617923558364,53.19700551473159,NaN,NaN,-7.098203724117386,23.42110941869579,-0.05094170880206128,0.09941601032728897,0.15035771912935025,97150726,101965026.6,43.560876743853974,51.05794506467373,NaN,NaN,2.9721430530535997,3.853855808294964
2011-12-16T09:30:00-05:00,38.14999,38.36,37.84,37.89999,12432648,6453327.15,45.254552214958935,53.14279529163726,NaN,NaN,-20.9572670234985,6.540543631719959,-0.09036660593097628,0.03739946171562991,0.1277660676466062,84718078,94948721.2,37.27112789604787,51.24342976587093,NaN,NaN,1.2159948479771965,3.4770185282495687
2011-12-19T09:30:00-05:00,38,38.2,37.37,37.48,5161371,6517904.95,42.11779861117157,52.794298853368254,NaN,NaN,-48.3872982917558,-13.259163268996602,-0.13830780033467982,-0.04511868277174358,0.09318911756293624,79556707,89748919.8,33.419855670239116,51.168087696668444,NaN,NaN,-1.2142949858587877,2.8068308833769464
2011-12-20T09:30:00-05:00,38.05,38.59,38.00999,38.50999,5791633,6514874.7,51.0742220049591,52.51754191461006,NaN,NaN,2.943648655222688,-18.509173342775057,-0.09622412061632435,-0.027091033207469195,0.06913308740885515,85348340,87287036.4,31.747214745481372,50.70764289711491,NaN,NaN,-0.7219975954568624,2.302712529257831
2011-12-21T09:30:00-05:00,38.57001,38.74001,38.28,38.64,3355464,6485967.55,52.08211778030064,52.29950553531352,NaN,NaN,14.144797151808207,-11.870864646468156,-0.05713599674831826,-0.0022869085265426747,0.05484908822177559,88703804,87095531,31.614663157368994,49.80256919861482,NaN,NaN,-0.0217563649343375,1.9706455443732356
2011-12-22T09:30:00-05:00,38.8,38.84,38.62,38.75,3421680,6423610.75,52.964993759070204,52.008197512001054,NaN,NaN,24.92825943077862,-5.465572015488957,-0.023121260255950918,0.025947512901836944,0.04906877315778786,92125484,86090482.6,30.88582820360554,48.32251200187016,NaN,NaN,0.8068195213191324,1.804384683936935
2011-12-23T09:30:00-05:00,38.94,39.21001,38.86,39.17999,1991541,6373755.75,56.35055855044414,51.79882954720129,NaN,NaN,57.694796236395334,10.264840636489811,0.026404178897681728,0.08207399677989002,0.055669817882208296,94117025,87970272,33.95274712793314,46.64559150754924,NaN,NaN,2.5110368618453074,1.9053349950667025
2011-12-27T09:30:00-05:00,39.03,39.39,39,39.3,2113101,6201052.8,57.27490905562837,51.73958817301737,NaN,NaN,71.72862932036183,34.28802615891334,0.06321284073488573,0.13468586880081546,0.07147302806592973,96230126,91304955.8,39.11430281576512,45.114211472659996,NaN,NaN,4.187821087981578,2.2314044369116846
2011-12-28T09:30:00-05:00,39.41,39.41,38.75,38.87,2667908,6092330.05,52.94831785475793,51.25306577426836,NaN,NaN,34.178926216348394,40.535081671138485,0.05487687391109934,0.1400691204548039,0.08519224654370457,93562218,92947731.4,41.53815774311187,43.59458639391504,NaN,NaN,4.438964748598324,2.5467701957240614
2011-12-29T09:30:00-05:00,38.88,39.27,38.88,39.27,2319665,5772806.85,56.258496129039614,51.53691336655886,NaN,NaN,50.48179780989266,47.802481802755366,0.07152569906740579,0.1745993703779618,0.10307367131055602,95881883,94383347.2,43.649383522167454,42.19546178320502,NaN,NaN,5.6102093632236265,2.9844043625097134
2011-12-30T09:30:00-05:00,39.21001,39.25999,39.02,39.02,1987574,5653388.3,53.71496964061832,51.321837125353014,NaN,NaN,42.57299805285898,51.33142952717144,0.06131724585758727,0.1797202286325401,0.11840298277495284,93894309,94737112.2,44.18429255831515,40.79164652366221,NaN,NaN,5.884889841467567,3.3987594309322637
2012-01-03T09:30:00-05:00,39.67,39.81,39.35001,39.35001,12055441,5969692.75,56.51013787260138,51.381172654577476,NaN,NaN,100.52916891252077,59.89830406239653,0.07168544365011925,0.2080097873376019,0.13632434368748264,105949750,97103657.2,47.75697307413161,39.985185319488785,NaN,NaN,6.917911575569759,3.901495451594763
2012-01-04T09:30:00-05:00,39.28,39.75,39.28,39.66,3118257,5896025.5,59.013987995973544,52.06903750991698,NaN,NaN,107.83390058654506,67.11935831563316,0.09296615433785962,0.25253203660980716,0.15956588227194754,109068007,99671233.4,51.39224240067812,39.78655487353119,NaN,NaN,8.52217535291067,4.561592580354178
2012-01-05T09:30:00-05:00,39.44,39.99001,39.23,39.99001,4576289,5817736.45,61.551805278467505,53.14803461939632,NaN,NaN,126.52418506020554,85.58841008440461,0.12103678763762188,0.3108618668189749,0.189825079181353,113644296,103687649,56.49229255600635,40.46999701533617,NaN,NaN,10.637567335565183,5.429588973955751
2012-01-06T09:30:00-05:00,40.00999,40.2,39.8,40.05,3092504,5736470.65,62.01227849901584,54.223510374786144,NaN,NaN,154.78634550127495,106.44931962268106,0.13438379099954498,0.3578048179307842,0.22342102693123925,116736800,107858632.4,61.06142186656138,41.720035952672404,NaN,NaN,12.5171314220599,6.442095037970629
2012-01-09T09:30:00-05:00,40.16,40.16,39.83,39.99001,3071332,5569355.8,61.22264565909786,55.36408847793892,NaN,NaN,132.49376850602886,124.43347371331504,0.1298395052418544,0.38572040848355726,0.2558809032417029,113665468,111812864.2,64.83212014752394,43.68867825634926,NaN,NaN,13.886155282520388,7.505532215763452
2012-01-10T09:30:00-05:00,40.33,40.35001,40.11,40.25,3856405,5432024.1,63.39792807213276,56.88409772515043,NaN,NaN,146.14468666205147,133.5565772632212,0.13444397061645097,0.42393586651226656,0.2894918958958156,117521873,114127288.8,66.85524244408478,46.07692016876682,NaN,NaN,15.671424106274879,8.672088200122227
2012-01-11T09:30:00-05:00,40.17999,40.39,40.16,40.31,2610468,4850352.95,63.90120779689617,57.800310996003084,NaN,NaN,131.9570960785957,138.3812163616313,0.13147200268540377,0.4538318992525703,0.3223598965671665,120132341,116340155.6,68.70875572392578,48.7170302386557,NaN,NaN,17.313723589381038,9.906607541444913
2012-01-12T09:30:00-05:00,40.39,40.49001,40.08,40.42999,2100405,4560475.35,64.93945533370459,58.71869224981766,NaN,NaN,120.11385873956579,137.09915109750335,0.12743583897242083,0.48165469528269256,0.3542188563102717,122232746,118057845.6,70.10620515950012,51.46642609595078,NaN,NaN,18.999711931823253,11.205622454356105
2012-01-13T09:30:00-05:00,40.2,40.38,39.97,40.38,3423161,4331812.1,64.11213961548384,59.514916953847205,NaN,NaN,99.47996383635589,126.03787476451953,0.11180606178113256,0.4939764335366874,0.38217037175555485,118809585,118472402.6,70.4492148916126,54.292382287951284,NaN,NaN,20.23795272047838,12.495955349516429
2012-01-17T09:30:00-05:00,40.61,40.75,40.42999,40.49001,2358638,4075274.25,65.16392131015627,60.14444286525521,NaN,NaN,116.892193800675,122.91755982344878,0.09968496859459736,0.5067765824988015,0.4070916139042042,121168223,119972953.6,71.71436628180707,56.989640798942276,NaN,NaN,21.58053969447602,13.793753113082085
2012-01-18T09:30:00-05:00,40.57001,41.17999,40.41,41.14,4465000,3676891.85,70.63918820932423,61.099034233376344,NaN,NaN,138.18433633176778,121.32548975739205,0.1246315182023715,0.5628810116571685,0.438249493454797,125633223,121595223.6,73.05735027988156,59.4141441892363,NaN,NaN,24.41703602127245,15.31136495710928
2012-01-19T09:30:00-05:00,41.2,41.57001,41.14999,41.5,3951630,3616404.8,73.15575114847746,62.54242232578488,NaN,NaN,169.38842355458235,128.81175525258936,0.15271306407055424,0.6291408235429898,0.4764277594724356,129584853,123485726,74.5724730578117,61.7737381402863,NaN,NaN,27.666783449778116,17.076424741776258
2012-01-20T09:30:00-05:00,41.49001,41.49001,41.03999,41.16,6033973,3628521.8,67.28965547583182,63.33036227912718,NaN,NaN,136.36589027891637,132.0621615604595,0.13626705518676707,0.6467615784558944,0.5104945232691274,123550880,123749352.8,74.78541263924676,63.99774022007767,NaN,NaN,28.808555380083543,18.752443404391585
2012-01-23T09:30:00-05:00,41.17,41.42,40.85001,41.13,2931193,3607308.25,66.78081761186817,64.26363713421645,NaN,NaN,116.38914849406505,135.4439984920013,0.11224706018867026,0.6508033485049651,0.5385562883162949,120619687,124111373.2,75.09386407497006,66.2055667569816,NaN,NaN,29.603725075100222,20.302626500207104
2012-01-24T09:30:00-05:00,40.98,41.27,40.85001,41.25,2817418,3577095.15,67.82877445105063,65.07211117553426,NaN,NaN,105.12131046521523,133.08982182490936,0.09405582107281574,0.6561260646573146,0.5620702435844989,123437105,124565149.6,75.49846032374722,68.18710156052556,NaN,NaN,30.562698484688593,21.768351069418745
2012-01-25T09:30:00-05:00,41.22,41.63699,41.05,41.55,4075457,3681290.95,70.34728413649631,65.88163232842875,NaN,NaN,121.96801508874942,129.84655757630568,0.09174435528165203,0.6767506876865639,0.5850063324049118,127512562,124941017.4,75.84843663268023,69.93397257709715,NaN,NaN,32.11451362163708,23.246374291164223
2012-01-26T09:30:00-05:00,41.75,41.89999,41.32001,41.48,3739826,3762627.2,68.99014447399304,66.41294227096628,NaN,NaN,122.68983138145813,120.50683914168084,0.07568555506816543,0.6796132762401186,0.6039277211719531,123772736,123778594,72.40397323095861,71.07052119673659,NaN,NaN,33.047862044437686,24.646586827346145
2012-01-27T09:30:00-05:00,41.24001,41.53,41.14999,41.45,3381320,3798297.8,68.38127764204987,66.86787078118299,NaN,NaN,92.51719051220971,111.73709918833951,0.05423222467508404,0.6717180020158082,0.6174857773407242,120391416,123146701.2,70.52895230123654,71.74677337064196,NaN,NaN,33.67194360858677,25.93592351038052
2012-01-30T09:30:00-05:00,41.09,41.39999,40.83,41.33,4951508,3929889.95,65.87682626278578,67.20031225287498,NaN,NaN,66.29742780200445,101.7187550499274,0.024655130350323406,0.6483046902786285,0.6236495599283051,115439908,122110745.4,67.44521504900071,71.93342300646172,NaN,NaN,33.558847908054965,27.024912710048298
2012-01-31T09:30:00-05:00,41.59,41.62019,41.16,41.32001,3414115,4001217,65.66122401033142,67.3619762484606,NaN,NaN,77.06704654943945,96.10790226677224,-0.0014989144977179958,0.6217759168061576,0.6232748313038756,112025793,119828483,61.106431929264,71.52279368397453,NaN,NaN,33.40847471390888,27.936850139171238
2012-02-01T09:30:00-05:00,41.39999,41.61,41.31,41.46001,5627199,3679804.9,67.2774957849811,67.60313967618096,NaN,NaN,80.1757310039339,87.74944544980914,-0.014560992275450046,0.605073590959563,0.6196345832350131,117652992,117856569,56.19238507169762,70.62876720881538,NaN,NaN,33.67763115493233,28.756961712851393
2012-02-02T09:30:00-05:00,41.44,41.505,41.2142,41.41,3607074,3704245.75,66.08097696077729,67.68467693525758,NaN,NaN,65.5560867114179,76.3226965158011,-0.03082534988110508,0.5811028958836317,0.6119282457647368,114045918,115911205.4,51.769329401199,69.31899036893671,NaN,NaN,33.61112011655859,29.45041291338099
2012-02-03T09:30:00-05:00,41.71001,42.25999,41.71001,42.25999,5562129,3753537.75,74.41097792881422,68.42030824335261,NaN,NaN,144.23048032225725,86.66535447781061,0.009261924700439628,0.6235056516402864,0.6142437269398467,119608047,115754531.6,51.41830045345698,67.95963933763989,NaN,NaN,36.05642295587025,30.3941286337366
2012-02-06T09:30:00-05:00,41.99001,42.24001,41.98,42.17,2585795,3728202.3,72.38417980522826,68.9360409930006,NaN,NaN,143.24802935026466,102.05547478746266,0.02255943201452082,0.6424430169579978,0.619883584943477,117022252,116071000.4,52.12446072155216,66.56036036905024,NaN,NaN,37.468805738713144,31.404796791590393
2012-02-07T09:30:00-05:00,42.17,42.42999,42.0442,42.37,9408602,4045065.8,74.07432487595626,69.18140789776004,NaN,NaN,157.09829538043078,118.06172455366091,0.036823621724525024,0.6659131120991333,0.6290894903746083,126430854,118952012.6,58.09598366803727,65.49169132534709,NaN,NaN,39.17327426165773,32.5145792873143
2012-02-08T09:30:00-05:00,42.47,42.668,42.21001,42.47,4260902,4065290.65,74.90144657746973,69.30610042840235,NaN,NaN,165.2935079774801,135.08527994837013,0.04448026197316235,0.6846898178410612,0.6402095558678988,130691756,121559765.4,62.63854886283516,64.63926816856305,NaN,NaN,40.83361020254136,33.703012275203875
2012-02-09T09:30:00-05:00,42.45,42.58,42.16,42.53999,4129363,4141235.4,75.49081768317633,69.89189772892696,NaN,NaN,148.81475852815728,151.73701431171804,0.045577496889449565,0.6971814269797107,0.6516039300902612,134821119,125714805.6,68.49822981788577,64.19018368132298,NaN,NaN,42.385917747625236,34.943427342692644
2012-02-10T09:30:00-05:00,42.11,42.36,42.06,42.31,3183449,4195387.6,69.69888355605417,70.10033101065453,NaN,NaN,105.98717043876742,144.08835233502006,0.023258001625998226,0.680676432122759,0.6574184304967607,131637670,128120730.2,71.30465313060996,63.919525756725825,NaN,NaN,42.10351606334904,35.96629715992927
2012-02-13T09:30:00-05:00,42.61,42.71001,42.49001,42.64999,4839594,4266209.25,72.99711768772283,70.46949838470253,NaN,NaN,135.83870129101055,142.60648672316924,0.02375316069874389,0.6871098813701906,0.6633567206714467,136477264,132011732.6,75.15900513636574,63.89527895762715,NaN,NaN,42.81638946078644,36.94488177433744
2012-02-14T09:30:00-05:00,42.42999,42.63,42.28,42.60001,3854016,4340978.15,71.76053458352848,70.57044484520483,NaN,NaN,104.91511951438036,132.16985154995916,0.013581033442328083,0.6803330124743567,0.6667519790320287,132623248,133250211.4,76.25238640940537,63.924132513107516,NaN,NaN,43.04659887679511,37.81655564611711
2012-02-15T09:30:00-05:00,42.78999,42.87,42.31,42.41,4970313,4366243.8,67.1063249461451,70.4358863075014,NaN,NaN,96.02582614956239,118.31631518437561,-0.011711243892864487,0.652112924165948,0.6638241680588125,127652935,132642447.2,74.51897855280303,64.07520432181069,NaN,NaN,41.896509786035026,38.39940623753395
2012-02-16T09:30:00-05:00,42.34,42.64999,42.31,42.59,4967477,4417036.15,69.14772534460064,70.49063257196933,NaN,NaN,84.27971255536636,105.40930598981745,-0.021514809317087713,0.6369306564124528,0.6584454657295405,132620412,132202305.8,73.22083186810022,64.26748143372951,NaN,NaN,41.483408182085164,38.83997794389841
2012-02-17T09:30:00-05:00,42.7,43.02769,42.7,42.96001,3370649,4283869.95,72.87439479936967,70.99045889601103,NaN,NaN,118.79499547403162,107.97087099687027,-0.008921400178137029,0.6472937155068692,0.6562151156850062,135991061,133072984,74.17908157372696,64.74847189978139,NaN,NaN,42.23384056482623,39.32481546117381
2012-02-21T09:30:00-05:00,43.10001,43.21001,42.715,42.81,4118258,4343223.2,69.22366487340072,71.24491895765884,NaN,NaN,111.60299725599815,103.12373018986781,-0.016116296464024238,0.6360697451049759,0.6521860415690002,131872803,132152091.8,71.27406285355728,65.47473125151662,NaN,NaN,41.75980012742078,39.67267041349481
2012-02-22T09:30:00-05:00,42.81,42.88,42.55,42.7,4632152,4433959.9,66.58935587018999,71.19576610660233,NaN,NaN,81.20433151962864,98.38157259091747,-0.03274687384572772,0.6112524492618405,0.6439993231075682,127240651,131075572.4,67.92520884325072,66.31279009234184,NaN,NaN,40.586532456657544,39.803222133946626
2012-02-23T09:30:00-05:00,42.7,42.92999,42.5401,42.91,3536206,4406997.35,69.01369417692258,71.40524590775557,NaN,NaN,85.96065495560104,96.3685383521252,-0.03392346182053818,0.6015949958318956,0.6355184576524338,130776857,131700356.8,68.84027258934046,67.5321431772091,NaN,NaN,40.280057653464354,39.87134149387773
2012-02-24T09:30:00-05:00,42.91,43.037,42.8,42.86,2770061,4358509.1,67.7531067181749,70.92968367842418,NaN,NaN,94.03593788951994,98.31978341895592,-0.041867384103860594,0.583184227522608,0.6250516116264686,128006796,130777633.6,65.85224868219164,68.56313947926158,NaN,NaN,39.666931792569024,39.84214010797648
2012-02-27T09:30:00-05:00,42.71001,43.17,42.59,43.11,4435559,4411221.05,70.64071252346595,70.80515030115545,NaN,NaN,96.74975962816607,93.91073624978281,-0.034395783511337874,0.5820568822372962,0.6164526657486341,132442355,130067892.4,63.566730804556194,69.38044448519044,NaN,NaN,39.96193929084066,39.85925427695708
2012-02-28T09:30:00-05:00,43.11,43.36501,43.00999,43.35001,6125906,4469940.95,73.12851399996738,70.73759238144196,NaN,NaN,137.05295557722096,99.00072791402738,-0.018212848991199126,0.5936866045096352,0.6118994535008343,138568261,131406984,65.96673799570783,69.94264122288118,NaN,NaN,40.96140678102162,40.016704634680586
2012-02-29T09:30:00-05:00,43.38,43.505,43.17999,43.19,9505824,4774526.4,68.93468719952499,70.31139528301733,NaN,NaN,140.1279608325569,110.78545377661302,-0.02290498641380756,0.5832682204835749,0.6061732068973824,129062437,131771341.2,66.61122860321132,70.22640406147949,NaN,NaN,40.56132099535235,40.09450697191941
2012-03-01T09:30:00-05:00,43.31,43.61,43.28999,43.55,4733516,4729842.25,72.72464376376959,70.11381143163115,NaN,NaN,159.0280326053574,125.39892930656431,-0.00719721645663296,0.5971766863265913,0.6043739027832242,133795953,132375160.4,67.70277565620492,70.16958590707371,NaN,NaN,41.38111207636268,40.27830770112559
2012-03-02T09:30:00-05:00,43.42,43.67999,43.37,43.52,5799898,4839483.45,71.93702794486715,70.27367888797492,NaN,NaN,153.10899292197203,137.21354031305472,-0.0043990919994379984,0.5988750377839267,0.6032741297833647,127996055,132373012.2,67.69429661823618,69.911703299047,NaN,NaN,41.80609102703043,40.49656246196914
2012-03-05T09:30:00-05:00,43.39999,43.57001,43.27,43.48,3326004,4727677.2,70.83547079853004,70.11927553874686,NaN,NaN,122.87864863267643,142.4393181139568,-0.010467315765634533,0.5901899850763215,0.600657300841956,124670051,130818551.4,61.675085048251425,68.94856614989598,NaN,NaN,41.841439388056926,40.68868773712454
2012-03-06T09:30:00-05:00,43.08,43.10001,42.67,42.8,5486922,4872733.55,55.325429895077185,68.94533948957178,NaN,NaN,5.835236992133517,116.19577439693933,-0.0625941362248087,0.5224146305609452,0.5850087667857539,119183129,126941525,49.78489511224903,67.05803105724196,NaN,NaN,36.6925111564814,40.117805368461234
2012-03-07T09:30:00-05:00,42.96001,43.35001,42.94,43.28999,4815836,4643095.25,61.81374858849896,68.56729832116848,NaN,NaN,68.75085367848335,101.9203529661246,-0.06604832553591011,0.5024483598658662,0.5684966854017763,123998965,125928830.6,47.223919747404274,65.10838399971348,NaN,NaN,34.399686209928866,39.30093120295661
2012-03-08T09:30:00-05:00,43.34,43.82001,43.34,43.73,4378063,4648953.3,66.51660093480403,68.37936086332587,NaN,NaN,141.00252432971584,98.31525131099629,-0.04185344762099741,0.5161798758755296,0.558033323496527,128377028,124845045.6,44.580867602885085,63.06267226648383,NaN,NaN,34.14967475730248,38.56503742500602
2012-03-09T09:30:00-05:00,43.89999,44.07001,43.797,43.98,4735402,4679255.25,68.86295654674107,68.09282955956668,NaN,NaN,170.32792418922077,101.75903756444605,-0.013627607329496305,0.5409988143346567,0.554626421664153,133112430,125868320.6,47.564875148081185,61.161657521794844,NaN,NaN,34.77569914789086,38.02370338541814
2012-03-12T09:30:00-04:00,44,44.11,43.77,43.86,5385930,4789379.3,66.45569959141432,67.89511775371052,NaN,NaN,142.80497170052828,105.74430217801641,-0.007936358640983854,0.5447059733629231,0.552642332003907,127726500,126479610.4,49.32042289358615,59.593540381796906,NaN,NaN,34.46459222480577,37.51525893390208
2012-03-13T09:30:00-04:00,44.03,44.53999,43.95,44.53999,6801215,4887460.35,72.35341981493181,68.30683660690634,NaN,NaN,184.01312723636343,141.37988022686238,0.03440388138196693,0.5956471837313657,0.5612433023493988,134527715,129548527.6,57.08809431158335,58.8194607723921,NaN,NaN,36.32585942661881,37.3453447185759
2012-03-14T09:30:00-04:00,44.56,44.59,44.34,44.48,6978586,5043688.85,71.16466885673171,68.46047765546415,NaN,NaN,174.84936596490203,162.59958268414613,0.05019324554180371,0.6239848592766535,0.5737916137348498,127549129,130258560.4,58.66656767620011,58.09276756431064,NaN,NaN,37.34730086166976,37.34562416758931
2012-03-15T09:30:00-04:00,44.47,44.66,44.3,44.63,5270582,5058702.3,72.38633610738196,68.79142261183608,NaN,NaN,157.2814752959012,165.8553728773832,0.06180000119206697,0.6510416152249334,0.5892416140328665,132819711,131147097,60.61879355929773,57.71894934124679,NaN,NaN,38.56362108849653,37.51962372771891
2012-03-16T09:30:00-04:00,44.55,44.56,44.25999,44.35001,7723711,5196514,66.7053394700358,68.51032453659107,NaN,NaN,122.70702743510971,156.33119352656098,0.04259492158015399,0.6424852660080589,0.5998903444279049,125096000,129543811,55.52289192472092,57.14438942125856,NaN,NaN,37.74920749252783,37.5524214084059
2012-03-19T09:30:00-04:00,44.2,44.64,44.17999,44.58,7124879,5384225.5,68.86677908317712,68.20591489967748,NaN,NaN,115.45374857033441,150.8609489005222,0.037532992309883384,0.6468065848152591,0.6092735925053757,132220879,130442686.8,57.671324827037154,56.55185990921065,NaN,NaN,37.75975593672623,37.582040626737374
2012-03-20T09:30:00-04:00,44.37,44.74001,44.24001,44.655,4767664,5416695.8,69.56074716627658,68.25063346873117,NaN,NaN,109.61830858282337,135.9819851698142,0.03162442537547361,0.6488041242247178,0.6171796988492442,136988543,130934852.4,58.843571959784306,55.99702729182301,NaN,NaN,37.97866097213666,37.63870067608013
2012-03-21T09:30:00-04:00,44.74001,44.85001,44.64999,44.71001,3079395,5339057.95,70.08741221090337,68.06225978638358,NaN,NaN,116.40513327688228,124.29313863221023,0.024147145635314837,0.6473636308933877,0.6232164852580728,140067938,133438614.2,64.26533633107485,55.75149591145657,NaN,NaN,38.30955971167955,37.73453768116576
2012-03-22T09:30:00-04:00,44.49001,44.71001,44.41,44.60001,4559289,5390212.1,67.5697998467347,67.75031492223125,NaN,NaN,87.9039782269813,110.41763921842626,0.005493009523203973,0.6300827471620778,0.6245897376388738,135508649,133976401.8,65.32205357343474,55.58204997968505,NaN,NaN,37.87442110866214,37.75452102795096
2012-03-23T09:30:00-04:00,44.53,44.7,44.09,44.64999,3527128,5428065.45,68.12996948626447,67.557064828498,NaN,NaN,70.35030190889181,99.94629411318269,-0.00899165281393477,0.6133501716214553,0.6223418244353901,139035777,136764357.2,70.23589991861773,56.193536756139785,NaN,NaN,37.66454739937954,37.74166765244075
2012-03-26T09:30:00-04:00,45.02,45.39,44.96001,45.36,5721809,5492377.95,74.79144925769086,68.94749478297041,NaN,NaN,144.8345778515315,105.82245996942206,0.02203840661459089,0.6498898327036287,0.6278514260890378,144757586,139271698.6,73.82777467060984,57.9108852960227,NaN,NaN,39.57134793692344,38.003050550223996
2012-03-27T09:30:00-04:00,45.49001,45.5587,45.25999,45.28999,4500641,5411114.7,73.16744772192754,69.75847329250102,NaN,NaN,143.27477502898313,112.55375325865403,0.03014028077151898,0.6655267770534365,0.6353864962819176,140256945,139925379,74.68547368043777,59.87242486266795,NaN,NaN,40.61524794741839,38.376221606966055
2012-03-28T09:30:00-04:00,45.32001,45.32001,44.7,44.89999,6695953,5270621.15,64.73484204877765,69.631204800642,NaN,NaN,90.5988708401248,107.39250077130252,0.0029567889203120368,0.6390824824323076,0.6361256935119955,133560992,138623989.8,69.78241942302022,61.67253570696331,NaN,NaN,38.874101842654845,38.4473473549216
2012-03-29T09:30:00-04:00,44.60001,44.92999,44.392,44.89,3908803,5229385.5,64.5296837978149,69.32168531857585,NaN,NaN,58.28644585215895,101.46899429633804,-0.020673271884921962,0.6102841036558431,0.630957375540765,129652189,137452697.8,65.6076932933799,62.96130843162751,NaN,NaN,37.42937935466231,38.30192335488456
2012-03-30T09:30:00-04:00,45.08,45.21001,44.83,45.09,4183609,5148571.05,66.7982969573159,69.34615655899738,NaN,NaN,91.76561586381584,105.75205708732285,-0.02738919432423892,0.5967208826354664,0.6241100769597053,133835798,136412702,62.057690705105855,63.871113275307486,NaN,NaN,36.86422927471893,38.09653848628947
2012-04-02T09:30:00-04:00,45.02,45.358,44.89999,45.21001,10855531,5525047.4,68.11606632359177,69.0434884524731,NaN,NaN,102.32581095708578,97.2503037084337,-0.028193952179949466,0.5888676367347685,0.617061588914718,144691329,136399450.6,62.01164787241483,64.22279567250975,NaN,NaN,36.77219079734523,37.90734595929744
2012-04-03T09:30:00-04:00,45.14999,45.39999,44.95,45.12,5316266,5516514.6,66.00022794068514,68.67459981561264,NaN,NaN,99.96995654112789,88.58934001086266,-0.03859024589126714,0.5688237815506341,0.6074140274419012,139375063,136223074.2,61.35910532105149,64.41511978999912,NaN,NaN,36.09859649465307,37.64895317863396
2012-04-04T09:30:00-04:00,44.85001,44.88,44.42,44.7,7481918,5649818.7,57.0891592592856,67.58194432646289,NaN,NaN,9.174935980849833,72.30455303900766,-0.07542457346934528,0.5131333106052196,0.5885578840745649,131893145,135889504.8,60.071640213624256,64.37603740816532,NaN,NaN,32.76764434746695,36.9516233456101
2012-04-05T09:30:00-04:00,44.55,45.08,44.55,45.00999,5713602,5716595.65,61.24790715903024,67.19212773281963,NaN,NaN,41.98915731096159,69.04509533076819,-0.0801406678977774,0.4883820492023432,0.5685227171001206,137606747,137480416.4,63.95611714616082,64.97841063826816,NaN,NaN,31.144638988317112,36.122054151711104
2012-04-09T09:30:00-04:00,44.36,44.7,44.28,44.60001,6593906,5809520.85,53.81891080080548,66.11727999836451,NaN,NaN,-42.05324067253199,42.28132402349862,-0.11024259718454721,0.4307194706194366,0.5409620678039838,131012841,136915825,61.663395121900884,65.26355851647271,NaN,NaN,27.2859125769064,34.85974821245329
2012-04-10T09:30:00-04:00,44.44,44.59,43.42,43.50999,17268144,6403631.55,39.945974521115325,64.00193909513871,NaN,NaN,-196.72056922653118,-17.527952013224773,-0.1978251820046769,0.29368059029813764,0.49150577230281456,113744697,130726498.6,43.32676904988494,64.15521545147989,NaN,NaN,18.040082158807813,32.45693877621822
2012-04-11T09:30:00-04:00,43.94,44.23,43.89999,44.11,4521117,6289626.65,47.906245495818865,62.41757004406124,NaN,NaN,-133.8129713422135,-64.28453758989306,-0.20853965432066762,0.23083120440198002,0.43937085872264764,118265814,126504648.8,35.559156980684776,62.10477406930918,NaN,NaN,13.56996652382518,29.75879988301922
2012-04-12T09:30:00-04:00,44.21001,44.71001,44.02,44.67,7048109,6293102.8,54.03070531898593,61.45049186350776,NaN,NaN,-49.330706678232524,-75.98566612170951,-0.17259105323214546,0.2236320421824658,0.39622309541461126,125313923,125188804.4,33.54083024207678,59.83468668849789,NaN,NaN,12.385883742686165,27.276954720114496
2012-04-13T09:30:00-04:00,44.58,44.78999,44.34,44.55,6473789,6353263.15,52.60353769272083,60.34146102111178,NaN,NaN,-29.422152037696684,-90.26792799144117,-0.15228206829306068,0.20587051004828538,0.35815257834134606,118840134,121435481.8,28.56104951350204,56.857911659561054,NaN,NaN,10.988036975488718,24.94996647088224
2012-04-16T09:30:00-04:00,44.66,44.77,44.19,44.39,9921289,6463142.05,50.681306712143545,58.619307982144115,NaN,NaN,-54.675210611669264,-92.79232197926862,-0.14504594723181236,0.1768451443015806,0.32189109153339296,108918845,117016682.6,24.036453073553034,53.301388688342705,NaN,NaN,9.247621622443553,22.706774349676714
2012-04-17T09:30:00-04:00,44.61,44.99001,44.48,44.92999,4698125,6341804.35,56.463522860922396,57.42617049207232,NaN,NaN,19.45473421880868,-49.55726129020066,-0.10138065785963996,0.19516526920884303,0.296545927068483,113616970,116991137.2,24.01276983608672,49.68190984231763,NaN,NaN,9.800380714908256,20.863003830424077
2012-04-18T09:30:00-04:00,44.75999,45.12,44.7,44.92999,4314199,6319131.1,56.463522860922396,56.83536197865409,NaN,NaN,41.63841995980871,-14.46698302979621,-0.0714011114212415,0.20729453779193108,0.2786956492131726,113616970,116061368.4,23.119869451634344,46.348870558647214,NaN,NaN,10.222110827475225,19.34287625857424
2012-04-19T09:30:00-04:00,44.92999,45.14999,44.37,44.57001,5706797,6450501.2,51.77075291628519,55.92400977283054,NaN,NaN,-7.6028211231120055,-6.12140591877211,-0.07438144592518625,0.18571884180668974,0.260100287731876,107910173,112580618.4,20.10573118849321,43.09873040829816,NaN,NaN,9.068958791297774,17.87517376324903
2012-04-20T09:30:00-04:00,44.75,44.98,44.62,44.64,4598367,6452455.1,52.595691119864924,54.90953792729834,NaN,NaN,1.7368650924292115,0.11039750725306638,-0.07025494993255482,0.17228160031618245,0.24253655024873727,112508540,111314299.6,19.1286791792443,40.03237244216519,NaN,NaN,8.403029456138414,16.52201029080466
2012-04-23T09:30:00-04:00,44.25,44.3199,43.87,44.16,6162090,6584203.2,46.69658772620188,53.37957517034191,NaN,NaN,-130.57749144312646,-15.07005865903837,-0.0968292996865619,0.12149992564053491,0.2183292253270968,106346450,110799820.6,18.730430044953962,36.940856883060846,NaN,NaN,5.950396449399591,15.011779742032505
2012-04-24T09:30:00-04:00,44.21001,44.39,43.83,44.00999,8880609,6742143.2,44.99798217792652,51.879414758716294,NaN,NaN,-122.63979593785251,-43.4889646903706,-0.11997338901048277,0.06836248906399334,0.1883358780744761,97465841,107569594.8,16.419066630123808,33.73085411942315,NaN,NaN,3.432932468891461,13.357658703012357
2012-04-25T09:30:00-04:00,44.34,44.78,44.3201,44.75,7897328,6911977.55,53.90553199236175,51.652012811078876,NaN,NaN,-1.9881396787508794,-52.21427661808252,-0.08268176537318966,0.08498367135798901,0.16766543673117867,105363169,105918834.6,15.37490277519619,30.538230016678288,NaN,NaN,4.0799503503142605,12.032271795484057
2012-04-26T09:30:00-04:00,44.67999,45.395,44.67999,45.31,5782207,6866290.25,59.27985839011282,51.511437899013345,NaN,NaN,111.37616877593594,-28.418478638272926,-0.02076446541440896,0.14170985496316746,0.16247432037757642,111145376,106565875.2,17.587217916410538,27.22616578598184,NaN,NaN,6.490205512789409,11.240548040813392
2012-04-27T09:30:00-04:00,45.64,46.08,45.42999,45.87,8757762,7108738.2,63.822407003717395,52.22597334207848,NaN,NaN,213.4532325799391,13.924794859229053,0.053389250623621404,0.22921088365710318,0.17582163303348178,119903138,108044794.8,22.56981558402441,24.433767247562095,NaN,NaN,10.130092945229162,11.081911598587073
2012-04-30T09:30:00-04:00,45.84,45.84,45.5,45.61,6951547,7247135.1,60.45061312033547,53.69059038487992,NaN,NaN,164.61413426544155,72.96312000094265,0.07887308564124626,0.2744129900850396,0.19553990444379335,112951591,109365823,26.825535199724712,23.255107686836368,NaN,NaN,11.908209272032643,11.199954123365012
2012-05-01T09:30:00-04:00,45.72,46.27,45.57001,45.91,7755777,7092147.4,62.88700125794183,54.7606443678887,NaN,NaN,184.17531068724412,134.32614132596197,0.10807380140722492,0.3306321562028245,0.22255835479559957,120707368,114014128.4,39.43872599033041,23.532219758953914,NaN,NaN,14.162611110552358,11.623190835820347
2012-05-02T09:30:00-04:00,45.75,46.21001,45.66,46.16,9648375,7308752.85,64.83131475647743,55.53211647056667,NaN,NaN,171.35216837880262,168.9942029374727,0.13463623100060063,0.3908536435463503,0.2562174125457497,130355743,119012643.2,49.51613757621732,24.67331313996395,NaN,NaN,16.626712114647788,12.337979589938554
2012-05-03T09:30:00-04:00,46.14,46.17999,45.66,45.8,5027297,7186021.8,59.95997041434145,56.05757595068243,NaN,NaN,128.25877287343474,172.37072375697244,0.11891694934813746,0.4048635992309215,0.28594664988278407,125328446,121849257.2,54.17617373571482,26.502964870122007,NaN,NaN,17.152835485727554,13.025816146479839
2012-05-04T09:30:00-04:00,45.60001,45.60001,44.87,44.91,9999844,7400333.9,49.96460552681589,56.00638300887331,NaN,NaN,31.336279001293104,135.94733304124324,0.04342594333340133,0.3402290790495357,0.29680313571613437,115328602,120934350,52.49311022554758,28.535583238121614,NaN,NaN,14.17587143193318,13.19010975868746
2012-05-07T09:30:00-04:00,44.78,45.08,44.73,44.89,7754230,7458350.1,49.763846142953135,55.52783467187551,NaN,NaN,1.4295559908153581,103.310417386318,-0.010149067250263766,0.28411680165330466,0.29426586890356843,107574372,119858906.2,50.50684264807321,30.428017010406364,NaN,NaN,11.822027392433442,12.99466942065117
2012-05-08T09:30:00-04:00,44.55,44.56,43.62,44.35001,12210082,7205447,44.55812711150107,54.67744926120256,NaN,NaN,-93.81994556205318,47.71136613645852,-0.08034048112916387,0.19384026749211358,0.27418074862127745,95364290,114790290.6,42.36961784893827,31.802999038785213,NaN,NaN,8.082289026408123,12.292900792902165
2012-05-09T09:30:00-04:00,43.96001,44.42,43.69,44.17999,11145980,7536690.15,43.031774008394954,54.05323648206754,NaN,NaN,-104.36177089205057,-7.431421717712107,-0.13347345148861875,0.107338934260504,0.24081238574912275,84218310,105562804,32.19900191952419,32.666804091001715,NaN,NaN,4.593825160504824,11.19303284541683
2012-05-10T09:30:00-04:00,44.42999,44.60001,44.16,44.33,7807855,7574677.45,44.82756232297844,53.49837013943279,NaN,NaN,-68.76992161944177,-46.837160616287406,-0.15240142187632794,0.05031060840371282,0.20271203028004076,92026165,98902347.8,27.135649409659138,33.23873053603135,NaN,NaN,2.2922253511748343,9.921488917667974
2012-05-11T09:30:00-04:00,44.06,44.74001,44.05,44.24001,8099574,7655966.7,43.9328759878216,53.30096215811991,NaN,NaN,-68.67178309444826,-66.8387730354357,-0.16386701110615792,-0.0021217336026566613,0.16174527750350126,83926591,92621945.6,23.399156816218948,33.572211019693135,NaN,NaN,0.15270436267060797,8.525948266954064
2012-05-14T09:30:00-04:00,43.89,44.06,43.61,43.61501,11686781,7744241.3,38.22649676828459,52.817284628859774,NaN,NaN,-129.8134242793021,-93.08736908945919,-0.20382388151704336,-0.09303457439280294,0.11078930712424043,72239810,85555033.2,20.05310627990461,33.83178528039176,NaN,NaN,-3.558283357122153,6.799629463514604
2012-05-15T09:30:00-04:00,43.58,44.11,43.45,43.55,9828898,8000779.95,37.678286742267524,51.65819568242447,NaN,NaN,-119.71514203226236,-98.26640838350102,-0.22334212041527418,-0.1683883433948523,0.05495377702042188,62410912,78964357.6,17.53475199599498,33.98606022473454,NaN,NaN,-6.7187138214085795,4.868437565668435
2012-05-16T09:30:00-04:00,43.67,44,43.47,43.48,8177871,8193963.55,37.06195664574055,50.07120270068359,NaN,NaN,-111.33871616367821,-99.66179743782655,-0.22883605098061205,-0.23109128670534318,-0.0022552357247311305,54233041,72967303.8,15.613327459725625,33.845068049257044,NaN,NaN,-9.493223842577835,2.8167716502046822
2012-05-17T09:30:00-04:00,43.52,43.53999,42.3,42.33,15522398,8684743.6,28.74344645434789,47.56556266144291,NaN,NaN,-172.5674362568032,-120.42130036529883,-0.29365332913449227,-0.36932189714284647,-0.0756685680083542,38710643,62304199.4,12.905459021335943,33.15475686620787,NaN,NaN,-15.051710111433604,0.2641313985420699
2012-05-18T09:30:00-04:00,42.46001,42.7,41.95,42.00999,9487820,8929216.25,26.931958155136158,45.17137302107153,NaN,NaN,-181.79134013639515,-143.0452117736882,-0.33861818531726107,-0.4989412996549305,-0.16032311433766946,29222823,51363445.8,10.83002147509562,32.0122201715915,NaN,NaN,-20.21070576575674,-2.6608453392149025
2012-05-21T09:30:00-04:00,41.95,42.75999,41.73,42.75,8336625,9037943,36.84413619704456,43.31116837386458,NaN,NaN,-146.36516607318134,-146.35556013246406,-0.30036301661210885,-0.5357768851028055,-0.23541386849069668,37559448,44427373.4,9.7585678846836,29.89220887833101,NaN,NaN,-21.383129708576803,-5.3354573919808885
2012-05-22T09:30:00-04:00,42.91,43.25,42.64,42.92,9205945,9054209.8,38.89489752129577,41.458567142780176,NaN,NaN,-98.67575143085575,-142.14768201218274,-0.24764466618485048,-0.5449697012217598,-0.2973250350369093,46765393,41298269.6,9.311027046904911,27.02041526909441,NaN,NaN,-21.643203241677135,-7.665135370508924
2012-05-23T09:30:00-04:00,42.62,43.22,42.39999,43.14999,6635098,8991098.3,41.655149230612906,40.151079915371,NaN,NaN,-88.58939854912128,-137.59781848927133,-0.18423180275489404,-0.5276147884805269,-0.34338298572563286,53400491,41131759.6,9.286620333152968,23.81401859748285,NaN,NaN,-20.983267760888396,-9.567725711991706
2012-05-24T09:30:00-04:00,43.22,43.4201,42.97,43.35001,7894988,9096737.35,44.023395776627254,39.72670779035752,NaN,NaN,-61.421146420155445,-115.36856052194177,-0.11893274668765336,-0.49204891908519954,-0.3731161723975462,61295479,45648726.8,15.739134058024007,21.18873458551688,NaN,NaN,-19.715479177714872,-11.017404778523586
2012-05-25T09:30:00-04:00,43.39999,43.50999,43.14999,43.28,6096629,8963680.7,43.35998151165336,39.26928888812183,NaN,NaN,-51.395725112831094,-89.28943751722898,-0.07283615801095944,-0.46416136991124546,-0.391325211900286,55198850,50843932.2,22.561788459018615,19.192659286298692,NaN,NaN,-18.8762576437825,-12.140098044989145
2012-05-29T09:30:00-04:00,43.63,43.96001,43.42999,43.88,12327465,9232476.6,50.27581874561882,39.677695433415956,NaN,NaN,-15.932586231465795,-63.202921548885854,0.0017327180413290177,-0.3891593143486247,-0.39089203238995374,67526315,56837305.6,29.639748917042297,18.283382934020413,NaN,NaN,-15.980628016856654,-12.688745183827361
2012-05-30T09:30:00-04:00,43.45,43.50999,43.0675,43.19,7288336,9209104.55,43.67184364430566,39.72341469312386,NaN,NaN,-47.63445794464804,-52.99466285164433,0.007909712979196737,-0.3810048911659578,-0.38891460414515455,60237979,59531822.8,32.62148078892163,18.31355999612023,NaN,NaN,-15.502445268428119,-13.090702338770326
2012-05-31T09:30:00-04:00,43.14,43.38,42.69991,43.10001,9868016,9220086.6,42.88073104612072,39.58435531620545,NaN,NaN,-58.71030530167676,-47.01884420215542,0.009169402155206896,-0.37745285145114593,-0.38662225360635283,50369963,58925717.2,32.28999780299294,18.681727738501216,NaN,NaN,-15.362729278317147,-13.415277615848444
2012-06-01T09:30:00-04:00,42.37,42.467,41.66,41.74001,15054094,9721426.45,33.11697752589161,38.81179114035331,NaN,NaN,-148.5305623917744,-64.44072739647922,-0.07378898579178922,-0.47885848584608937,-0.40506950005430015,35315869,53729795.2,29.520620884571528,19.11897517195497,NaN,NaN,-18.70277180477802,-14.17063392855267
2012-06-04T09:30:00-04:00,41.74001,42.02,41.44,41.89,10940465,9768457.5,34.878100831444485,38.57262000200758,NaN,NaN,-151.79132320114334,-84.51984701414167,-0.10865260291314144,-0.5408852536957269,-0.4322326507825855,46256334,51941292,28.61100314833749,19.730253519700177,NaN,NaN,-20.698519163254254,-15.103188962081468
2012-06-05T09:30:00-04:00,41.74001,42.19,41.71001,42.11501,6782547,9719873.35,37.535350601022394,38.562410277632935,NaN,NaN,-118.43089472611425,-105.01950871307136,-0.10650849861283018,-0.5653682740486232,-0.45885977543579304,53038881,49043805.2,27.151376727132615,20.417155286210008,NaN,NaN,-21.44448820895211,-16.00908885449156
2012-06-06T09:30:00-04:00,42.47,43.07001,42.42999,43.03,9054094,9562073.95,47.005102268341915,39.2726349649616,NaN,NaN,-28.976067238439587,-101.28783057182967,-0.037005402880815,-0.5051165290368118,-0.4681111261559968,62092975,49414804.4,27.66026417613206,21.27765076595332,NaN,NaN,-18.84650472572573,-16.414433978953582
2012-06-07T09:30:00-04:00,43.7,43.7,42.92,43.03,8162484,9412899.15,47.00510226834191,40.57703895167547,NaN,NaN,16.222672711194164,-86.30123496925549,0.012765355175452409,-0.4521544321866813,-0.4649197873621337,62092975,51759406.8,30.94338303111033,22.56607390950864,NaN,NaN,-16.85006017525208,-16.47666629271051
2012-06-08T09:30:00-04:00,42.86,43.42,42.675,43.41,6243559,9334684.35,50.61144671246896,42.26843099148495,NaN,NaN,19.33401456031508,-52.72831957883759,0.07178081829998095,-0.37519376448715747,-0.4469745827871384,68336534,58363539.8,39.299985970883,24.59964280206488,NaN,NaN,-14.036684703071828,-16.1280974941907
2012-06-11T09:30:00-04:00,43.75,43.78,42.67999,42.75,11057527,9482582,44.89675133531591,42.84361778707576,NaN,NaN,16.799859280548322,-19.010083082499257,0.06696302199113396,-0.363270805298221,-0.43023382728935494,57279007,60568074.4,41.83048236591961,26.89049383643888,NaN,NaN,-13.428603540124461,-15.742455500752667
2012-06-12T09:30:00-04:00,42.89999,43.265,42.655,43.21001,12066277,9501556.8,49.20200664535512,43.57983986736571,NaN,NaN,19.285443470569984,8.533184556837593,0.09371213154880587,-0.3130936628533476,-0.4068057944021535,69345284,63829355,45.4532598792759,29.472081895893947,NaN,NaN,-11.519307222164764,-15.139148603811538
2012-06-13T09:30:00-04:00,43.05,43.23,42.44,42.58,11391602,9579692,44.11803917810745,43.75576057790103,NaN,NaN,-18.35585571419603,10.657226861686302,0.06906841480885662,-0.3204702758910827,-0.3895386906999393,57953682,63001496.4,44.69235198046606,32.00106272784488,NaN,NaN,-11.561392138001239,-14.628040537267209
2012-06-14T09:30:00-04:00,42.75999,43.35001,42.64,43.14999,12104559,9776026.4,49.22940192853045,44.127618160179836,NaN,NaN,34.9685104977811,14.406394419003693,0.08992831023611769,-0.2771283029047922,-0.36705661314090987,70058241,64594549.6,46.54673768336325,34.201605843940534,NaN,NaN,-9.893375501675983,-13.951659817897033
2012-06-15T09:30:00-04:00,43.2,43.46001,43.05,43.42,10328539,9516333.45,51.49283798191137,44.70853647948398,NaN,NaN,72.37494260338765,25.014580027618205,0.11886649042900183,-0.2184735001046576,-0.33733999053365943,80386780,67004598.8,49.31540741295101,36.11257862636428,NaN,NaN,-7.81934339357942,-13.075614614423088
2012-06-18T09:30:00-04:00,43.25999,43.82001,43.17,43.73,5495293,9316707.1,54.026949927801134,44.976474421068424,NaN,NaN,110.46478533664144,43.74756523883683,0.15363214338697362,-0.1452998112999424,-0.298931954686916,85882073,72725212,55.24156490555081,37.941279768400605,NaN,NaN,-5.316963318196826,-11.967235857819336
2012-06-19T09:30:00-04:00,43.94,44.33,43.87,44.13,10536836,9426717.65,57.13845646365887,45.93837533673651,NaN,NaN,185.10054332462755,76.91058520964835,0.19562130141385004,-0.05440532791960351,-0.25002662933345354,96418909,78139937,60.00795267153269,39.897456331444246,NaN,NaN,-2.241745423747306,-10.577880081523332
2012-06-20T09:30:00-04:00,44.2,44.28,43.72,44.08,7038031,9318321.95,56.622572894774706,46.919935468783216,NaN,NaN,149.6638312501592,110.5145226025194,0.21077306219380504,0.01343969840880277,-0.19733336378500227,89380878,84425376.2,64.70639983237747,42.212913619257414,NaN,NaN,0.07316830859167911,-9.05630174007833
2012-06-21T09:30:00-04:00,44.14,44.14,43.08,43.11501,7962383,9384686.2,47.67593426770919,47.95986095034162,NaN,NaN,53.22892171477773,114.16660484591871,0.1494364633087199,-0.010537784649102377,-0.15997424795782228,81418495,86697427,66.24995500196992,44.83643748478587,NaN,NaN,-0.6365358120174259,-7.85347803606963
2012-06-22T09:30:00-04:00,43.25999,43.39,43.08501,43.31,3887940,9184333.8,49.415194590256796,48.99822479025679,NaN,NaN,24.87186716102113,104.66598975744542,0.11706042602628694,-0.013648715424963598,-0.13070914145125054,85306435,87681358,66.92458064375825,47.57312159160164,NaN,NaN,-0.6772309190542293,-6.8282998764960015
2012-06-25T09:30:00-04:00,42.89,43.00999,42.47,42.64,7567625,9257883.6,44.00278762580456,49.46018457774123,NaN,NaN,-54.58062317872475,71.65690805437217,0.049065067654852856,-0.06937780688268447,-0.11844287453753732,77738810,86052705.4,64.62198704776156,50.249593757360856,NaN,NaN,-2.4445505623105808,-6.202049974469513
2012-06-26T09:30:00-04:00,42.82001,43.32001,42.69,43.17,7761738,9029597.25,48.78181853168884,49.587092882266006,NaN,NaN,4.071738518022541,35.45114709305117,0.038778005295746626,-0.06997036791785405,-0.10874837321360067,85500548,83869033.2,61.5635539260029,52.67125731092306,NaN,NaN,-2.416991798529427,-5.661327377906644
2012-06-27T09:30:00-04:00,43.14999,43.3853,42.97,43.11,4064747,8868417.8,48.27948047216551,49.67811989682484,NaN,NaN,20.25245247850184,9.568871338719694,0.0274598451186477,-0.07442356681529105,-0.10188341193393875,81435801,82280017.8,59.36188649041117,54.701150415158835,NaN,NaN,-2.5471059810555685,-5.216438606927919
2012-06-28T09:30:00-04:00,42.86,42.98,42.44501,42.87,6768477,8713440.85,46.22881177143031,49.365074543893506,NaN,NaN,-38.77600120607898,-8.832113245451648,0.004538963435014642,-0.09620970764017045,-0.10074867107518509,74667324,80929783.6,57.48076746683157,55.99977766486944,NaN,NaN,-3.261616270391542,-4.9371782731370075
2012-06-29T09:30:00-04:00,43.56,43.83,43.21001,43.78,10030379,8462255.1,54.17642489317672,50.027908369454984,NaN,NaN,87.06382362862958,3.6062780480700383,0.048927239360475785,-0.039589621874590364,-0.08851686123506615,84697703,80808037.2,57.30443652174644,57.10506010457136,NaN,NaN,-1.391405088389722,-4.430639246744538
2012-07-02T09:30:00-04:00,43.81,43.98,43.58,43.91,8392109,8334837.3,55.19524575106743,50.455996877005866,NaN,NaN,116.22289032437658,37.7669807486903,0.08328739165483687,0.015592378333479928,-0.06769501332135694,93089812,83878237.6,60.58789052489178,58.18610515068678,NaN,NaN,0.4227143661834707,-3.737303016326251
2012-07-03T09:30:00-04:00,43.87,43.97009,43.63651,43.87,2771985,8134309.2,54.791578061129464,51.21839251150744,NaN,NaN,105.0083182443431,57.95429669395442,0.0985220627116419,0.055457565068195436,-0.04306449764344646,90317827,84841693.4,61.58624485509872,59.392811784589114,NaN,NaN,1.7719709612479353,-2.9502638766727958
2012-07-05T09:30:00-04:00,43.66,44.2,43.63,43.98,5524707,7957839.85,55.74999184321827,51.684148933985135,NaN,NaN,109.96049938825523,75.8959060759051,0.11031872388275926,0.09483390721000262,-0.015484816672756644,95842534,87723040,64.48378889287133,60.6740297281254,NaN,NaN,3.1596916613558053,-2.077413085525853
2012-07-06T09:30:00-04:00,43.61,43.92,43.51891,43.77,5307641,7815097.7,53.42157011265738,51.82191551475271,NaN,NaN,65.037657667105,96.6586378505419,0.0986690154826333,0.10785145268053498,0.00918243719790168,90534893,90896553.8,67.40044067669984,61.96581781839318,NaN,NaN,3.708501339408939,-1.25085388196374
2012-07-09T09:30:00-04:00,43.74001,43.78999,43.39,43.53,5771652,7791502.35,50.809765660411024,51.59211663851056,NaN,NaN,31.867718835734028,85.61941689196279,0.07079485727197596,0.09767600878787164,0.026881151515895672,84763241,90909661.4,67.4123442827314,62.8351592024775,NaN,NaN,3.468076478986875,-0.5767209732565093
2012-07-10T09:30:00-04:00,43.75,43.91,43.11,43.27,6169262,7547089.1,48.068020789953245,50.94422837610301,NaN,NaN,3.888666130286325,63.15257205314473,0.03277502859676147,0.06784993726184751,0.035074908665086044,78593979,88010494.8,62.01822182208125,62.97874985608811,NaN,NaN,2.506652978092972,-0.13623898020658348
2012-07-11T09:30:00-04:00,43.25999,43.34,42.74989,43.02,8805828,7384066.65,45.52427210360522,50.151492605305194,NaN,NaN,-69.16081994225213,28.318744415825687,-0.009047371809098995,0.023765693903712304,0.0328130657128113,69788151,83904559.6,55.27269859263107,62.304914053249085,NaN,NaN,0.9726933980409179,0.022179930971630984
2012-07-12T09:30:00-04:00,42.78,43.10001,42.4509,42.92,6319715,7130472.3,44.50962145490362,49.92532740439051,NaN,NaN,-110.67951632602498,-15.80925872703035,-0.041467480807053744,-0.019021285296005885,0.02244619551104786,63468436,77429740,46.65494153581599,60.905270234238095,NaN,NaN,-0.5960647744604275,-0.06614074123294879
2012-07-13T09:30:00-04:00,42.98,43.71001,42.92,43.62,6060578,6828273.25,52.49185332084324,50.145088742289545,NaN,NaN,-2.845738146031562,-29.38593788965766,-0.015146256186923855,0.0035133752773930382,0.018659631464316893,69529014,73228564.2,42.07142629862212,59.13004492387123,NaN,NaN,0.22954156504353726,-0.02390041176487935
2012-07-16T09:30:00-04:00,43.38,43.58,43.17999,43.34,4051386,6514415.6,49.428953835842314,50.53267204300653,NaN,NaN,-13.494075303893784,-38.458296717583224,-0.015893692911765872,-0.0012074846753904467,0.014686208236375425,65477628,69371441.6,38.34660672481435,57.25323204366071,NaN,NaN,0.04631357429760227,-0.013869842327381976
2012-07-17T09:30:00-04:00,43.46001,43.89,43.21001,43.77,6339176,6556609.75,53.87965554193895,50.8968032580244,NaN,NaN,37.32894441227391,-31.770241061185708,0.0117787059593365,0.02940959068554605,0.01763088472620955,71816804,68016006.6,37.1034324094913,55.50608050676702,NaN,NaN,1.2088417060546943,0.16080323601291463
2012-07-18T09:30:00-04:00,43.60001,44.12,43.53999,44,7050371,6382286.5,56.10494354133686,51.45576490582234,NaN,NaN,95.14717509384774,1.0913579460342646,0.04302309550596393,0.07140975410866446,0.02838665860270053,78867175,69831811.4,39.91374960051183,54.116927871774216,NaN,NaN,2.841781215938839,0.5438000902880467
2012-07-19T09:30:00-04:00,44.10001,44.58,43.98,44.28999,4190809,6239925.4,58.803863712610415,52.35398290162092,NaN,NaN,167.86532958639228,56.80032712851771,0.07859882039319793,0.12663518409419794,0.048036363701000014,83057984,73749721,45.56537731261713,53.26582857504461,NaN,NaN,5.032416243348522,1.185030969296686
2012-07-20T09:30:00-04:00,43.99001,44.05,43.73,43.75,5770684,6130340.45,52.34922335844887,52.22346850628322,NaN,NaN,72.2557075229065,71.82061626230532,0.061877876849361024,0.1253837097627013,0.06350583291334028,77287300,75301378.2,47.664885974224546,52.57728925022162,NaN,NaN,5.02116689877731,1.733050387793918
2012-07-23T09:30:00-04:00,43.07001,43.25999,42.78999,43.11,3992876,6135587.25,45.916252785852926,51.56068329448219,NaN,NaN,-71.77365565475424,60.16470019213324,0.006731497422023086,0.07192020469086913,0.06518870726884604,73294424,76864737.4,49.76710674455427,51.804376123054645,NaN,NaN,2.938121430664462,1.9052033939182815
2012-07-24T09:30:00-04:00,43.14,43.2,42.53999,42.82001,4903684,6002390.2,43.318699513243885,50.74119196963322,NaN,NaN,-111.76958862189896,30.344993585298663,-0.04728685838948141,0.006080134281994276,0.05336699267147569,68390740,76179524.6,48.8410836541133,50.894007465841405,NaN,NaN,0.39129617349467843,1.6889309338577667
2012-07-25T09:30:00-04:00,42.89,43.00999,42.56,42.73,3215626,5775084.6,42.514747636092174,49.795817383409926,NaN,NaN,-120.23454895655343,-12.731351224781571,-0.08489642665362387,-0.05275354064555415,0.03214288600806972,65175114,73441112.4,45.21977257280899,49.51800630012267,NaN,NaN,-1.9053759618472392,1.175458520185623
2012-07-26T09:30:00-04:00,43.35001,43.56,42.99001,43.42,5171906,5830442.55,50.15212584588902,49.56228565006933,NaN,NaN,-22.865112521268276,-50.87743964631368,-0.060277816975311385,-0.04320438521106951,0.017073431764241875,70347020,70898919.6,42.09910336716149,47.71076792086992,NaN,NaN,-1.5615247403247774,0.7844609115412801
2012-07-27T09:30:00-04:00,43.64999,44.39,43.64999,44.28,9931063,5988571.85,57.69613117036852,50.054168900780574,NaN,NaN,110.36955196585932,-43.254670757723126,0.013040049064372408,0.033373493094707385,0.020333444030334977,80278083,71497076.2,43.09420390969151,45.97375789422422,NaN,NaN,1.3318126276263018,0.8626540138391403
2012-07-30T09:30:00-04:00,44.27,44.39999,43.99001,44.11,7800672,5877086.5,55.89532896277361,50.61326234169631,NaN,NaN,108.67489170154272,-7.164961286463731,0.04727630719841623,0.07942882802835527,0.03215252082993904,72477411,71333673.6,42.87741402936444,44.606557337601586,NaN,NaN,3.040117451038405,1.173720219153321
2012-07-31T09:30:00-04:00,43.92,43.92,43.53999,43.53999,5902219,5752592,50.23380166862656,50.949657310626414,NaN,NaN,23.2588196730155,19.84072037251916,0.029586793438824165,0.06913601262846925,0.03954921918964508,66575192,70970564,42.36736137463283,43.684747536316,NaN,NaN,2.633957796686293,1.3823255873723168
2012-08-01T09:30:00-04:00,43.83,43.87,43.31,43.36,7889672,6008476.35,48.561179303977326,51.23905429984596,NaN,NaN,-1.2580261973023898,43.636024924369366,0.005101256322615259,0.04592578959291416,0.0408245332702989,58685520,69672645.2,40.51226111543666,43.24598464914605,NaN,NaN,1.7782824381955185,1.4388908517756314
2012-08-02T09:30:00-04:00,43.09,43.69,43.00999,43.47,7207621,6092622.05,49.66426004380984,51.03708335148643,NaN,NaN,-19.767407772642347,44.25556587409456,-0.0038654667211710098,0.03599269986883513,0.03985816659000614,65893141,68781869.4,39.24228422539597,43.04390307248705,NaN,NaN,1.4192739830187888,1.4360884419532254
2012-08-03T09:30:00-04:00,43.95,44.41251,43.92,44.33,7646121,6209546.05,57.36260565001111,51.603772766784196,NaN,NaN,126.32963969880791,47.44758342068428,0.045236810728825315,0.09640418000103779,0.05116736927221247,73539262,67434105.2,37.33524957801681,42.97166327628721,NaN,NaN,3.598600808291858,1.7450187800016015
2012-08-06T09:30:00-04:00,44.39999,44.62,44.31,44.49001,5418336,6191880.25,58.63036265255824,51.9431089889713,NaN,NaN,144.24928892176698,54.56246286472913,0.08338675984540048,0.15540081907896308,0.0720140592335626,78957598,68730142.6,40.33781026987091,43.202690266314335,NaN,NaN,5.746316222320266,2.316632700332839
2012-08-07T09:30:00-04:00,44.71001,45.06,44.71001,44.91,6251398,6195987.05,61.83778018370853,52.352597320569274,NaN,NaN,173.90583667825032,84.6918662657761,0.129073379318172,0.2333557833812776,0.1042824040631056,85208996,72456903.4,48.04652152621934,43.783602546722015,NaN,NaN,8.579102973387984,3.2112713107692885
2012-08-08T09:30:00-04:00,44.48,44.73,44.34,44.69,4018442,5956617.75,59.246554166576956,52.38421806728117,NaN,NaN,115.46838273889311,108.0371480530152,0.13595201866733114,0.27422242739726954,0.1382704087299384,81190554,76957910.2,55.52128795808609,44.49473902139838,NaN,NaN,10.12721958482487,4.199263921348657
2012-08-09T09:30:00-04:00,44.63,44.795,44.53999,44.66,1718409,5726552.45,58.88419984965051,52.851002102367,NaN,NaN,112.94929912789715,134.5804894331231,0.12996147224396765,0.30072224903489797,0.17076077679093032,79472145,79673711,59.32400577365832,45.3275332927865,NaN,NaN,11.272777060906154,5.2097657984282995
2012-08-10T09:30:00-04:00,44.5,44.64999,44.41,44.62,4464207,5646733.9,58.37158024194198,53.740668349230496,NaN,NaN,89.10665262577587,127.13589201851669,0.11528441871644576,0.31486630018648754,0.19958188147004177,75007938,79967446.2,59.72507505630258,46.03881674362566,NaN,NaN,12.075192326575804,6.190541016735086
2012-08-13T09:30:00-04:00,44.56,44.67,44.37,44.64,2394737,5563901.45,58.56580742159352,54.82974748554119,NaN,NaN,80.30937069473053,114.3479083731094,0.09949852953940616,0.3239550433942995,0.22445651385489332,77402675,79656461.6,59.06110217096387,46.76881806625784,NaN,NaN,12.793739865951345,7.133855138051694
2012-08-14T09:30:00-04:00,44.95,44.96001,44.61501,44.75,3547672,5424326.25,59.68006919046784,56.05584188228231,NaN,NaN,96.13057323638867,98.79285568473708,0.08936197852285338,0.33615898700846003,0.24679700848560665,80950347,78804731.8,57.185974640401426,47.623546785371595,NaN,NaN,13.697428431857336,8.071508465738214
2012-08-15T09:30:00-04:00,44.67999,44.92999,44.67999,44.89,2309192,5187267.3,61.11340611190942,56.83879047271234,NaN,NaN,92.65615172056756,94.23040948107197,0.08500855386298067,0.3530577008143325,0.26804914695135185,83259539,79218528.8,57.885543773642155,48.75114967154878,NaN,NaN,14.84941601237855,9.039780972401118
2012-08-16T09:30:00-04:00,44.82001,45.39999,44.82001,45.25999,7023758,5328914.75,64.68628691681445,57.33808731174419,NaN,NaN,118.0148909501662,95.24352784552578,0.09899176729176995,0.3917888560660643,0.29279708877429433,90283297,81380759.2,61.431823563285114,50.06097964680547,NaN,NaN,16.861110840182242,10.157113810655565
2012-08-17T09:30:00-04:00,45.28,45.5,45.28,45.42999,4577395,5269250.3,66.22195294931657,58.07570331078298,NaN,NaN,128.39984094168219,103.10216550870703,0.11074649023218974,0.4312302015645315,0.32048371133234177,94860692,85351310,66.9375029915507,51.77955742981877,NaN,NaN,19.01401813214092,11.422385856582043
2012-08-20T09:30:00-04:00,45.35001,45.38,45.0701,45.24001,3519101,5245561.55,62.92855076283309,58.9824711032263,NaN,NaN,102.78195265992471,107.59668190174587,0.09726274023320369,0.4420621366238464,0.3447993963906427,91341591,88139093.2,70.15853391597302,53.76464118277164,NaN,NaN,20.01193393704976,12.649464153791717
2012-08-21T09:30:00-04:00,45.32001,45.53999,45.09,45.17999,3301772,5165465.95,61.88147944225959,59.93392111310361,NaN,NaN,101.25544346511953,108.62165594749203,0.07673890693258612,0.44072303005637536,0.36398412312378925,88039819,89556987.6,71.67025438381823,55.99021213051318,NaN,NaN,20.58536999824561,13.783164988713702
2012-08-22T09:30:00-04:00,45.09,45.39,45.08,45.31,3781585,5193763.9,63.30574843292087,60.90831314089725,NaN,NaN,97.77841345565591,109.64610829450972,0.06483074622691126,0.44502255590742834,0.3801918096805171,91821404,91269360.6,73.42140130469335,58.43157763617728,NaN,NaN,21.449758877316757,14.878392687085567
2012-08-23T09:30:00-04:00,45.16,45.21001,44.9095,45,3530288,5111683,57.76358020502158,60.93695418054085,NaN,NaN,64.77855503796184,98.99884111206883,0.03071879501095026,0.4185903034442049,0.38787150843325463,88291116,90870924.4,72.30151887157541,60.92916830000289,NaN,NaN,20.740535596658756,15.715841674167452
2012-08-24T09:30:00-04:00,44.92,45.42,44.89,45.37,2948334,4762546.55,62.03564026959221,61.18018829604328,NaN,NaN,83.17094154084383,89.95306123190116,0.02780413996052472,0.4226266833839105,0.3948225434233858,91239450,90146676,70.20531652324688,63.06256160381546,NaN,NaN,21.28922797957106,16.51203971779654
2012-08-27T09:30:00-04:00,45.5,45.50999,45.19,45.3,2789777,4512001.8,60.78303669930518,61.10484947572876,NaN,NaN,89.5659469998411,87.30986009988443,0.016452993449640074,0.4153887852354359,0.3989357917857958,88449673,89568292.4,68.49737568023055,64.52333690053055,NaN,NaN,21.404932628355873,17.211024419305016
2012-08-28T09:30:00-04:00,45.25999,45.52,45.19,45.39,3622200,4398000.85,61.84963342088645,61.29078370817944,NaN,NaN,88.71718330578751,84.80220806801802,0.010582389900969269,0.4121637791620074,0.40158138926103815,92071873,90374703.2,69.60755593124415,65.52949889861326,NaN,NaN,21.786954024023018,17.864728648550443
2012-08-29T09:30:00-04:00,45.42999,45.69,45.3672,45.61,4014206,4204227.55,64.39856753666224,61.684667114394564,NaN,NaN,112.41289226253552,87.72910382939395,0.016726808133104232,0.42248989942741844,0.4057630912943142,96086079,91227638.2,70.7804650083121,66.34781741537425,NaN,NaN,22.815499369307773,18.571981608658632
2012-08-30T09:30:00-04:00,45.42,45.62,45.30499,45.36,5625262,4125109.6,59.53107151180668,61.7674879193849,NaN,NaN,86.53000689962552,92.07939420172669,0.00004748291737294297,0.40582244494103037,0.4057749620236574,90460817,91661578.4,71.38550412364557,67.18070520589875,NaN,NaN,22.369385942244698,19.11446794202807
2012-08-31T09:30:00-04:00,45.62,45.75,45.3,45.55,3630760,3924341.55,61.888731014288304,62.004839604577384,NaN,NaN,101.21793181634372,95.68879225682667,-0.001983300876401861,0.4032958359281551,0.40527913680455696,94091577,92232003.8,72.20040042526244,68.11922650977722,NaN,NaN,22.63609325144601,19.617557271944918
2012-09-04T09:30:00-04:00,45.46001,45.64,45.14999,45.44,6218793,3964364.4,59.71953131104376,62.00765832747566,NaN,NaN,69.66834055635432,91.70927096812932,-0.013866984455544962,0.38794540623512574,0.4018123906906707,87872784,92116626,71.75527931812584,69.15989112961468,NaN,NaN,22.26448815860731,19.995690255753832
2012-09-05T09:30:00-04:00,45.5,45.69,45.37,45.50999,6203352,3961962.1,60.664251866001905,61.9755758813394,NaN,NaN,88.05192734465018,91.57621977590185,-0.019785165434579866,0.3770809338974459,0.39686609933202577,94076136,92517478.6,72.39210276717588,70.19607391486707,NaN,NaN,22.201067404857845,20.31074413419726
2012-09-06T09:30:00-04:00,45.78999,46.56,45.77,46.52499,5384387,4030259.35,71.2097840964781,62.4415399656011,NaN,NaN,240.18222266940666,117.13008585727607,0.03869938074988444,0.4452403252693813,0.40654094451949685,99460523,93192367.4,73.47639539960625,71.0564004746043,NaN,NaN,25.645911730803178,21.072910933712393
2012-09-07T09:30:00-04:00,46.67,46.83,46.60001,46.78,4765996,4182638.7,73.1568908309189,62.93689267142984,NaN,NaN,282.6745842335046,156.35900132405192,0.08589546203855469,0.5139102720676902,0.42801481002913555,104226519,95945507.8,77.37939276442616,71.8022497440954,NaN,NaN,29.130678453696124,22.224020579424355
2012-09-10T09:30:00-04:00,46.78,46.9847,46.67999,46.71001,2940840,4106470.35,71.72315969598208,63.56507902379762,NaN,NaN,237.23887553160674,183.5631900671045,0.10260554178187026,0.5562717372564734,0.45366619547460313,101285679,97384328.2,79.10951632011873,72.4416056301058,NaN,NaN,31.457605940535256,23.543104202440198
2012-09-11T09:30:00-04:00,46.72,46.84,46.62,46.69,3092149,4141340.95,71.29297496350054,64.23732870388626,NaN,NaN,179.07234731968128,205.44399141976987,0.10228736442923086,0.5815254010111417,0.47923803658191083,98193530,99448477.4,81.31718708773377,73.13067225181406,NaN,NaN,33.197363376499425,24.92228408444866
2012-09-12T09:30:00-04:00,46.87,47,46.7,46.92,4925082,4210211.45,73.27699605948713,64.94956067721242,NaN,NaN,158.23332640902706,219.4802712326453,0.10703480534051024,0.6130315432575486,0.5059967379170384,103118612,101256972.6,83.01117431058877,73.81565603794945,NaN,NaN,35.28115596097558,26.402122923952504
2012-09-13T09:30:00-04:00,46.89999,47.63,46.77,47.52,5856086,4387556.15,77.6219772973113,66.36801761237598,NaN,NaN,168.36261041231296,205.1163487812265,0.13807699058519263,0.6785929761485292,0.5405159855633366,108974698,103159807.6,84.5939772704067,74.69368878072312,NaN,NaN,38.63915333070793,28.150270124917565
2012-09-14T09:30:00-04:00,47.64,48.00999,47.58,47.71001,5233477,4298042.1,78.7976758679745,67.56530586940329,NaN,NaN,173.62234383811312,183.30590070214822,0.15749362013863377,0.7373830107366288,0.579889390597995,114208175,105156138.8,86.06122744998864,75.82625384691895,NaN,NaN,41.77113987889375,30.096108661199878
2012-09-17T09:30:00-04:00,47.67,47.67,47.39,47.53,2711179,4204731.3,74.78886050820552,68.56572185575331,NaN,NaN,127.80382262938473,161.4188901217038,0.14463295301980805,0.7606805818727551,0.6160476288529471,111496996,107198402.2,87.38486583812268,77.17536028676838,NaN,NaN,43.11789156481263,31.956363361715987
2012-09-18T09:30:00-04:00,47.38,47.44,47.21001,47.3,3267706,4192161.55,69.89591554271651,69.1404562930269,NaN,NaN,96.62049821750975,144.92852030126951,0.10869578631315413,0.7519173617443897,0.6432215754312356,108229290,109205554.2,88.53698373475308,78.5274622727333,NaN,NaN,42.739776059394885,33.49685088995583
2012-09-19T09:30:00-04:00,47.45,47.92999,47.37,47.78999,5974730,4325809.45,73.82478608112214,69.81375761763117,NaN,NaN,112.38590282698156,135.75903558486038,0.10587894248122753,0.77557025353277,0.6696913110515424,114204020,111422635.8,89.66029309088836,79.87602142148876,NaN,NaN,43.66163426393344,34.94896280052406
2012-09-20T09:30:00-04:00,47.55,47.74001,47.37,47.73,3534011,4313430.75,72.57593327927742,70.7455334581648,NaN,NaN,95.26711568207647,121.13993663881311,0.0886291807147257,0.7804777869449495,0.6918486062302238,110670009,111761698,89.82451755679415,81.19309380957078,NaN,NaN,44.00969016864448,36.243352424541264
2012-09-21T09:30:00-04:00,47.77,47.83501,47.47,47.53,4708875,4372360.1,68.42036647402395,71.21207884814592,NaN,NaN,86.95596996209493,103.80666186360948,0.05410029167279029,0.7594739708212117,0.7053736791484214,105961134,110112289.8,82.92456229735623,81.9591053718632,NaN,NaN,43.03148405898967,37.21308551517675
2012-09-24T09:30:00-04:00,47.37,47.50999,47.25,47.395,2688442,4359365.5,65.68634940580354,71.63828014062877,NaN,NaN,64.11427159596074,91.06875165692466,0.014576084466870975,0.7235937847320102,0.7090177002651392,103272692,108467429,76.60490343392448,82.30550709442025,NaN,NaN,41.40266841326606,37.81159735776094
2012-09-25T09:30:00-04:00,47.55,47.72,46.83,46.84,2955999,4367676.6,55.812409195142386,71.29171994985307,NaN,NaN,39.316363076390616,79.60792462870086,-0.05284380778481634,0.6429629405341188,0.6958067483189352,100316693,106884909.6,70.99874107456576,82.20598125923381,NaN,NaN,36.69733156773526,37.65241653061441
2012-09-26T09:30:00-04:00,46.81,46.91,46.35001,46.52,3516892,4362411.2,51.04773185508324,69.851573361182,NaN,NaN,-14.232013962216968,54.28434127086116,-0.11909632011174143,0.5469363481792584,0.6660326682909998,96799801,103404065.8,60.50931937602597,81.27976154326379,NaN,NaN,31.147358143732262,36.723122475345534
2012-09-27T09:30:00-04:00,46.7,47.17,46.61501,46.99001,2896751,4306538.45,56.871556787565055,68.68833521522818,NaN,NaN,12.390846567628072,37.70908744797148,-0.13045603794763916,0.5029626208564508,0.63341865880409,99696552,101209374.4,54.992624615230085,79.68070667546408,NaN,NaN,28.23891322581627,35.51109258255564
2012-09-28T09:30:00-04:00,46.69,46.99001,46.44,46.78999,3643073,4207429,53.931029518150545,67.41746877395448,NaN,NaN,-16.15692296921408,17.08650886170968,-0.14927693405542808,0.4468224912348049,0.596099425290233,96053479,99227843.4,50.514607372763535,77.63821317922442,NaN,NaN,24.91916528125761,33.997960110941634
2012-10-01T09:30:00-04:00,46.91,47.3,46.67419,46.75999,2687529,4160267.45,53.48435684118779,66.14542462236071,NaN,NaN,-4.348488109605783,3.3939569205963807,-0.16059721815235473,0.3953529025997895,0.5559501207521442,93365950,97246495,46.44230738221039,75.1471503431156,NaN,NaN,22.156648216655135,32.30634412604356
2012-10-02T09:30:00-04:00,46.92,47.00999,46.49001,46.67,4156828,4057169.2,52.09066030816289,64.63211492583756,NaN,NaN,-44.49528957369598,-13.368373609420946,-0.17008522406040982,0.343343590676632,0.5134288147370418,89209122,95024980.8,42.32258547647181,72.2408225692501,NaN,NaN,19.48118764178956,30.474178914007275
2012-10-03T09:30:00-04:00,46.85001,47.2,46.67999,47.03999,3950288,3944516,57.046532406492084,63.16244029077904,NaN,NaN,-19.86080677397668,-14.494132171772886,-0.14818490891573377,0.3281976785923746,0.47638258750810836,93159410,94296902.6,41.0377392385979,69.12966270983519,NaN,NaN,18.609534151090894,28.779229662162077
2012-10-04T09:30:00-04:00,47.28,47.57001,47.21001,47.47,5413480,3945970.65,61.970285049636345,61.96048380375488,NaN,NaN,54.625517973926186,-6.047197890513262,-0.10359097337199852,0.3468938707931102,0.4504848441651087,98572890,94072170.2,40.62774848050127,65.88441421201466,NaN,NaN,19.40368555769302,27.4398662186665
2012-10-05T09:30:00-04:00,47.78999,47.96581,47.48,47.61,5026133,3958977.5,63.43969172974484,61.149828891007694,NaN,NaN,95.90308303848848,16.36480331102725,-0.06538245990094954,0.36875676928892176,0.4341392291898713,103599023,95581279,44.62828431526537,62.830372674667714,NaN,NaN,20.506813872025827,26.449430169146403
2012-10-08T09:30:00-04:00,47.39999,47.655,47.373,47.52,2736613,3948766.15,61.786913447660865,60.57061445564658,NaN,NaN,57.607199580994575,28.755940849147322,-0.047708201518040505,0.37450397729232066,0.42221217881036116,100862410,97080571,48.351696075575205,59.959994984726436,NaN,NaN,20.924016360688423,25.66008533936669
2012-10-09T09:30:00-04:00,47.48,47.48,46.74001,46.75999,5788910,4083604.2,49.95193810725295,58.86541102894164,NaN,NaN,-49.5691469875778,27.741169366370958,-0.08648066653234349,0.3141113456449318,0.4005920121772753,95073500,98253446.6,51.12072958837458,57.20716902026117,NaN,NaN,17.388194560219166,24.47838665663133
2012-10-10T09:30:00-04:00,46.81,46.91,46.39,46.47,5427492,4108724.7,46.30718872136275,56.98907213194773,NaN,NaN,-123.36083959720219,7.041162801725855,-0.12840764225290796,0.24008245936114037,0.3684901016140483,89646008,97550766.2,49.41153668916784,54.320527529716436,NaN,NaN,13.256129161756206,22.875207014506312
2012-10-11T09:30:00-04:00,46.81,46.81,46.14,46.25999,5810852,4106463,43.8139200721822,55.23146881753046,NaN,NaN,-136.3745156738095,-31.158843927821284,-0.16471711907979486,0.16259370276430474,0.3273108218440996,83835156,94603219.4,42.92786677169001,51.463620706454556,NaN,NaN,9.07572186879187,20.903851993689962
2012-10-12T09:30:00-04:00,46.28,46.52,46.14,46.25,5718488,4130713.55,43.69340351064865,53.66054411073368,NaN,NaN,-137.64789513362402,-77.86903956224378,-0.18246202090528985,0.09923329571248729,0.28169531661777714,78116668,89506748.4,34.49863525013427,48.45603012189811,NaN,NaN,5.735126709553404,18.73689123881331
2012-10-15T09:30:00-04:00,46.44,46.77,46.17,46.71001,3462098,4168259.5,50.451872631675,53.27764864191458,NaN,NaN,-86.43650170041246,-106.67777981852518,-0.1572306198515255,0.08515704180337025,0.24238766165489575,81578766,85650019.6,29.739608470093458,45.50894922157867,NaN,NaN,4.87723681084259,16.756940606246065
2012-10-16T09:30:00-04:00,46.89,47.17999,46.89,47.13,3833187,4196533.55,55.682143323680904,53.6086780325287,NaN,NaN,4.495636849293439,-95.86482305115094,-0.1085807989973891,0.10666166290815937,0.21524246190554847,85411953,83717710.2,27.67938240018121,43.163953723304054,NaN,NaN,5.836121148421429,15.196823540842546
2012-10-17T09:30:00-04:00,47.25999,47.53999,47.14999,47.39999,4981172,4146855.65,58.70027052963602,53.73930044267662,NaN,NaN,63.311975633307746,-58.530260005048966,-0.05712824226985877,0.143832159068225,0.20096040133808377,90393125,83867133.6,28.09421235632459,41.242638561953655,NaN,NaN,7.609482341933731,14.112917655284145
2012-10-18T09:30:00-04:00,47.38,47.67,47.21001,47.42999,4474535,4193881.85,59.03411134391427,54.103806287374034,NaN,NaN,80.8814472164585,-15.079067426995369,-0.0218016073594845,0.17370839213872813,0.19550999949821263,94867660,86073634.4,34.10499010860869,40.07052304308545,NaN,NaN,9.119339915460694,13.399549406737938
2012-10-19T09:30:00-04:00,47.25,47.28,46.41,46.58,7448160,4330846.1,47.35444966466614,53.665955774765344,NaN,NaN,-44.61023911767559,3.528463776194312,-0.05454348411930643,0.1273306443490796,0.18187412846838602,87419500,87934200.8,38.75409800513906,39.521365230437496,NaN,NaN,6.606139669243563,12.429062301381599
2012-10-22T09:30:00-04:00,46.55,46.63,46.11,46.42999,3277091,4360278.55,45.638328143851886,53.205074905885986,NaN,NaN,-108.66244181404498,-0.916724246532192,-0.08343759805225606,0.07757713090306595,0.161014728955322,84142409,88446929.4,40.01019053591071,39.35619416325456,NaN,NaN,4.0498895216177875,11.232037618558197
2012-10-23T09:30:00-04:00,45.95,46.2,45.67,46.06,4677109,4446334.05,41.63096937181787,52.10396326055211,NaN,NaN,-163.2558829213737,-34.46702820066562,-0.1222537701142069,0.00819751631256338,0.13045128642677029,79465300,87257598.8,38.06027306250072,39.143518007819054,NaN,NaN,0.5771782456402327,9.709914850998487
2012-10-24T09:30:00-04:00,46.32001,46.32001,45.8,45.88,2740734,4407526.15,39.80000929459701,50.520372135192154,NaN,NaN,-141.92543073587407,-75.51450947450198,-0.15285072908882932,-0.060612124934266376,0.09223860415456295,76724566,84523887,33.96307100244708,38.667469616529466,NaN,NaN,-2.8224207061548103,7.919581199976587
2012-10-25T09:30:00-04:00,46.13,46.31,45.57001,45.77,2995374,4412457.3,38.68042085481109,48.75185278698261,NaN,NaN,-139.40693974016116,-119.57218686582591,-0.1718764871870548,-0.12260700482925557,0.04926948235779924,73729192,80296193.4,28.7996437898085,37.53685243613969,NaN,NaN,-5.918167362622691,5.942759976748119
2012-10-26T09:30:00-04:00,45.91,46.015,45.42999,45.92,3788589,4419733.1,41.11305884658042,47.27514888690543,NaN,NaN,-132.90634161556426,-137.23140736540364,-0.16566794519535397,-0.15781544913639323,0.00785249605896074,77517781,78315849.6,26.74825344236922,35.9937493909107,NaN,NaN,-7.77110821954679,3.9836359487059894
2012-10-31T09:30:00-04:00,46.33,46.42,45.71001,46.0717,9157895,4743251.4,43.55202455842675,46.81801220484642,NaN,NaN,-83.76747750112342,-132.25241450281933,-0.143482414020481,-0.17150052146664052,-0.028018107446159513,86675676,78822503,28.15817069685798,34.35356661294522,NaN,NaN,-8.618814622497366,2.1832858671055098
2012-11-01T09:30:00-04:00,46.25,46.69,46.17,46.60001,5129320,4791876,51.14154541556032,47.163323397289105,NaN,NaN,-25.74531927282606,-104.7503017731098,-0.0880844219399239,-0.13812363487106438,-0.050039212931140484,91804996,81290442.2,34.746669925667135,33.30607612983803,NaN,NaN,-7.03541619686938,0.8663284293948113
2012-11-02T09:30:00-04:00,47.11,47.25,46.53999,46.57111,6086855,4898704.35,50.739655418281785,47.65801877915336,NaN,NaN,15.309908427466695,-73.30323394044166,-0.0501326353222671,-0.11270500708397435,-0.06257237176170725,85718141,83089157.2,39.12831338945542,33.03467945967842,NaN,NaN,-5.8798205605856335,-0.09740714060239508
2012-11-05T09:30:00-05:00,46.52,46.75999,46.32001,46.69,6315078,4943784.25,52.39695216173146,48.27970082565927,NaN,NaN,-6.10699460205715,-46.64324491282085,-0.015559412714142531,-0.08202163765438542,-0.06646222494024288,92033219,86749962.6,46.93773877288909,33.9231868541609,NaN,NaN,-4.437825551941999,-0.7174669136509099
2012-11-06T09:30:00-05:00,46.82001,47.05,46.67999,46.94,4751938,4930074.5,55.76694611017945,48.65934893126673,NaN,NaN,48.77255310906836,-10.307465967894315,0.02348640291986398,-0.03710422129041291,-0.06059062421027689,96785157,90603437.8,53.67495116278158,35.63285418935292,NaN,NaN,-2.2038601843836383,-0.9298088094698711
2012-11-07T09:30:00-05:00,46.60001,46.75999,46.03,46.39,6984570,5142472.35,47.7568551850216,48.09325692136249,NaN,NaN,-25.9095513577012,1.2641192607901324,0.012181045721086428,-0.04536431705891886,-0.057545362780005285,89800587,91228420,54.67999317309177,37.56146924456082,NaN,NaN,-2.606779300239729,-1.1693760224369936
2012-11-08T09:30:00-05:00,46.39999,46.55,45.63,45.64,6467523,5176403,39.43807657183086,46.71738592437641,NaN,NaN,-98.24002903690428,-13.234822692025512,-0.042882101470092276,-0.11114798961762062,-0.06826588814752835,83333064,89534033.6,51.422729283148726,39.22779188219111,NaN,NaN,-5.827145478456437,-1.8347716590111998
2012-11-09T09:30:00-05:00,45.27,45.82001,45.19,45.42,7380578,5274057.3,37.38113286763444,45.17074460464214,NaN,NaN,-155.36371971348518,-47.36954832021589,-0.08856418372917066,-0.17897111780899166,-0.090406934079821,75952486,87580902.6,47.88194190796863,40.21185986785968,NaN,NaN,-9.100814845080649,-2.8727778284496925
2012-11-12T09:30:00-05:00,45.60001,45.67999,45.36,45.46001,3519653,5159497.35,38.0143149822159,44.50359212732426,NaN,NaN,-130.56287710890413,-72.26072482158528,-0.10917657953351798,-0.22687765849671848,-0.1177010789632005,79472139,85068686.6,43.7126513579044,40.566042250200056,NaN,NaN,-11.47937700711726,-4.102291996830774
2012-11-13T09:30:00-05:00,45.34,45.99001,45.2901,45.59,3302588,5038702.35,40.13239043013412,44.110310862058704,NaN,NaN,-99.05277602813715,-101.82579064902639,-0.10700409680091541,-0.25145619996434476,-0.14445210316342935,82774727,82266600.6,39.57356275384574,40.53485455148113,NaN,NaN,-12.796178546510225,-5.344275789642124
2012-11-14T09:30:00-05:00,45.78999,45.811,44.78999,44.91,11105645,5420879.7,33.65395939777437,43.54052443534131,NaN,NaN,-137.7483176366515,-124.19354390481644,-0.14211216428686396,-0.3220923085220093,-0.17998014423514536,71669082,78640299.6,34.96000339043742,40.31340671776233,NaN,NaN,-16.13749940514055,-6.8861648775704705
2012-11-15T09:30:00-05:00,44.87,45.16,44.685,44.88,6701883,5564314.5,33.39781205620649,43.08322463259913,NaN,NaN,-151.68937847608208,-134.88341379265202,-0.15694115164434935,-0.37615658379058203,-0.21921543214623268,64967199,74967126.6,31.015664115897252,40.102877654437336,NaN,NaN,-18.84823281271919,-8.595031725448859
2012-11-16T09:30:00-05:00,44.88,45.25,44.66,45.1813,10998211,5865166.45,38.463614293804795,43.06773844967011,NaN,NaN,-128.7283514422954,-129.55634013841407,-0.1367817517740456,-0.39019262186378967,-0.25341087008974406,75965410,74969711.4,31.02156186644234,40.26158608848261,NaN,NaN,-19.599602786264864,-10.167113305565431
2012-11-19T09:30:00-05:00,45.71001,46.14999,45.69,46.14999,7312637,6007071.55,51.29102719212944,43.79473618863789,NaN,NaN,2.046599561873028,-103.03444480425863,-0.052846073744428346,-0.3194684622702795,-0.26662238852585113,83278047,75730893,32.842423507845396,40.69688395030233,NaN,NaN,-15.789900151882094,-10.970368569324954
2012-11-20T09:30:00-05:00,46.13,46.53999,46.00999,46.38,5137098,5891518.45,53.755983480401,44.52359039735034,NaN,NaN,53.90948940620944,-72.4419917173893,0.01964290792707124,-0.24206875361701208,-0.2617116615440833,88415145,76858976.6,35.5574495409723,41.225403867739075,NaN,NaN,-11.91824924755257,-11.105780094786041
2012-11-21T09:30:00-05:00,46.37,46.62,46.31,46.53999,5954750,6025401.4,55.444976040189424,44.83097829910957,NaN,NaN,80.0641803031498,-28.879492129429046,0.07664404689804752,-0.16590660292152393,-0.24255064981957145,94369895,81399139.2,45.165733431205744,41.96962268956326,NaN,NaN,-8.279175572101686,-10.701979448688276
2012-11-23T09:30:00-05:00,46.74001,47.16,46.74001,47.16,1889674,5886029.65,61.33810405892065,45.58801034486948,NaN,NaN,137.0550307497043,28.869389715728214,0.15013232664196138,-0.05488524151711971,-0.2050175681590811,96259569,87657613.2,55.103097751594674,43.11067871543035,NaN,NaN,-3.0538733069740154,-9.60939285701481
2012-11-26T09:30:00-05:00,46.98,47.03999,46.71001,46.94,7466227,6122304.3,58.38706790427838,46.01587575505141,NaN,NaN,104.80363672263063,75.57578734871342,0.1761523920310159,0.015172921879688772,-0.16097947015132713,88793342,90223199.6,58.42902155518053,43.931484628451166,NaN,NaN,0.1930007948345955,-8.20905090675061
2012-11-27T09:30:00-05:00,46.92999,47.12,46.72,46.75,4272582,6186164.7,55.88634543309417,46.02440427811674,NaN,NaN,89.30895822607157,93.02825908155314,0.1725693284318895,0.05473219038853472,-0.11783713804335476,84520760,90471742.2,58.74783857851432,44.293833729574935,NaN,NaN,2.0423762934778313,-6.7445613067179755
2012-11-28T09:30:00-05:00,46.67,47.39,46.42999,47.36,11788406,6586155.55,61.57630150551595,47.01150758672349,NaN,NaN,100.64772080838517,102.37590536198829,0.2012802378529262,0.13376315927280302,-0.0675170785801232,96309166,92050546.4,60.80421556947587,44.73127818645951,NaN,NaN,5.57006417414751,-4.985329095165763
2012-11-29T09:30:00-05:00,47.46001,47.63499,47.242,47.49001,3905659,6323543.75,62.68113271932552,48.671725882973114,NaN,NaN,127.97886182899633,111.9588416671576,0.21763671177767976,0.20452881114197652,-0.013107900635703253,100214825,93219532.4,62.30263283058522,45.50841415413355,NaN,NaN,8.734888697708406,-3.0252979818980252
2012-11-30T09:30:00-05:00,47.35001,47.61,47.22,47.53,5473273,6340741.4,63.033233961947815,50.50401881828121,NaN,NaN,115.54466257941544,107.65676803309982,0.21915132730124515,0.2608312584908532,0.04167993118960805,105688098,95105238.2,64.65025905668047,46.70615109332725,NaN,NaN,11.36846066943567,-0.9690467459932117
2012-12-03T09:30:00-05:00,47.83,47.83,47.24001,47.28,9836383,6528217.8,59.26848340086198,52.02217370532736,NaN,NaN,107.40424241013177,108.17688917060005,0.19227798032983778,0.2820274066019053,0.0897494262720675,95851715,96516912.8,66.34021216480872,48.322405436677556,NaN,NaN,12.495734807694861,0.9544934759622272
2012-12-04T09:30:00-05:00,47.21001,47.27,46.85001,47.08,5679758,6496451.8,56.367977584300476,53.18185850205354,NaN,NaN,66.45756618559717,103.60661076250517,0.15177299646701686,0.2794656718558386,0.12769267538882173,90171957,97647152.2,67.67274456924596,50.329489852063276,NaN,NaN,12.600758145570573,2.6182455716205624
2012-12-05T09:30:00-05:00,47.24001,47.24001,46.60001,46.94,6548551,6586282.45,54.36243649998376,54.66103543792563,NaN,NaN,53.18819523601429,94.11470564803099,0.10833044334434033,0.26310572956924716,0.15477528622490683,83623406,95110000.2,61.76192185629649,52.24391259962464,NaN,NaN,12.116685067129241,3.9751654995503736
2012-12-06T09:30:00-05:00,46.96001,47.31,46.88,47.24001,3803140,6427210.95,57.82535981730977,56.40586027800443,NaN,NaN,66.63804321490719,81.84654192521317,0.09315751240290876,0.27122217672854276,0.178064664325634,87426546,92552344.4,56.412691964836654,54.05798601740603,NaN,NaN,12.686508352288579,5.219643049941546
2012-12-07T09:30:00-05:00,47.55,47.55,47.17,47.42,7161406,6461905.1,59.79634470556378,57.92962673598722,NaN,NaN,79.84279876346098,74.70616916202228,0.08862710225712189,0.28884854214703637,0.20022143988991448,94587952,90332315.2,52.187573975035086,55.569844025162645,NaN,NaN,13.729650193115203,6.4353583561092105
2012-12-10T09:30:00-05:00,47.3,47.44,47.11501,47.14999,7840801,6484916.25,55.59863687274032,58.23731314174514,NaN,NaN,62.1149281455777,65.64830630911146,0.06208476174073302,0.27782739206583074,0.21574263032509772,86747151,88511402.4,48.94922965315113,56.72033017839876,NaN,NaN,13.42675178381985,7.434128845782158
2012-12-11T09:30:00-05:00,47.42,47.49001,47.13,47.3,5448496,6581358.4,57.38837983615109,58.496770024298726,NaN,NaN,64.04955341314576,65.16670375462118,0.049800354485254994,0.27799307343166646,0.22819271894641147,92195647,88916140.4,49.696408256581535,57.73025580094228,NaN,NaN,13.673839781855246,8.325516122364029
2012-12-12T09:30:00-05:00,47.50999,47.6599,47.27,47.36,4894246,6660941.3,58.11559418897367,58.6875284634976,NaN,NaN,72.13582385858653,68.95622947913563,0.04123877950131477,0.2797411933230549,0.23850241382174014,97089893,91609437.8,54.471686718239575,58.39496675001613,NaN,NaN,14.07716645923699,9.147180456203023
2012-12-13T09:30:00-05:00,47.34,47.6001,46.935,47.05,3635560,6287437.05,53.07565937026554,58.09735384287938,NaN,NaN,44.79831425216151,64.5882836865865,0.011752888437156495,0.25319352436818576,0.24144063593102927,93454333,92814995.2,56.46390729019355,58.49216743134462,NaN,NaN,13.015617784600991,9.699814360259875
2012-12-14T09:30:00-05:00,46.91,47.06,46.78999,46.85001,5065305,6205608.15,50.05952797421569,57.50252956216061,NaN,NaN,-5.040810129263611,47.61156190804157,-0.022308465455547655,0.2135550541115947,0.23586351956714235,88389028,91575210.4,53.854046755981756,58.16538351711613,NaN,NaN,11.244989727025278,9.920553698369218
2012-12-17T09:30:00-05:00,46.92,47.72,46.89999,47.69,5464684,5928931.8,60.27146127184981,57.81575212207173,NaN,NaN,85.66715729696945,52.322007738319925,0.008967861169444535,0.24707334602894804,0.2381054848595035,93853712,92996522.6,56.34523142296563,57.99376872029122,NaN,NaN,12.788256354329185,10.3302255063635
2012-12-18T09:30:00-05:00,47.84,48.39,47.75999,48.25,11834570,6155028.45,65.3573313429355,58.08582568188741,NaN,NaN,224.34068575465486,84.38023420662175,0.06166827615642145,0.31519083005503035,0.2535225538986089,105688282,95695049.6,60.68487380289978,57.98524430839293,NaN,NaN,15.872081880179792,11.12191927405154
2012-12-19T09:30:00-05:00,48.37,48.39999,47.89,47.91,4581109,6127229,60.309294765506664,57.91640868518606,NaN,NaN,188.57367695973062,107.66780482685056,0.06745779992674283,0.3378448038070374,0.2703870038802946,101107173,96498505.6,61.899311092149865,57.95643561279041,NaN,NaN,16.72106765954533,11.921797614836368
2012-12-20T09:30:00-05:00,47.87,48.03011,47.66,48.00999,4190328,6039007.9,61.25702233211794,57.7895364259125,NaN,NaN,136.0500111525088,125.91814420692,0.07146637342646056,0.35971997066337025,0.2882535972369097,105297501,98867139.2,65.30212906276608,58.00299775608223,NaN,NaN,17.693732928386442,12.74635980248638
2012-12-21T09:30:00-05:00,47.00999,47.3399,46.9501,47.28,8737754,6381411.9,51.57475823992748,57.23998462870289,NaN,NaN,-32.1779595384507,120.4907143250826,0.021018274816015148,0.3145264407569286,0.29350816594091345,96559747,100501283,67.46128195497704,58.083074169665686,NaN,NaN,15.248843148168465,13.103857423298106
2012-12-24T09:30:00-05:00,47.14999,47.37,46.91,47.32001,2563547,6136277.9,52.02236455597354,56.92958369810811,NaN,NaN,-35.13545497972302,96.3301918697441,-0.011825941941606188,0.2787257385139057,0.2905516804555119,99123294,101555199.4,68.80933142050804,58.16425894475584,NaN,NaN,13.493811691644916,13.159565175919079
2012-12-26T09:30:00-05:00,47.41,47.41,46.66,46.83,4459063,6145601.95,46.369391907519386,56.35865194150352,NaN,NaN,-96.85704386540682,32.09064594573177,-0.06571232294561802,0.20841127677348936,0.2741235997191074,94664231,99350389.2,62.93513717933752,58.24806003925876,NaN,NaN,10.105653255900169,12.723292044487806
2012-12-27T09:30:00-05:00,46.91,47.03999,46.24001,46.89,5091512,5810757.25,47.127012270174426,55.594484259565284,NaN,NaN,-146.35668394641579,-34.8954262354975,-0.09471258675697225,0.15573286627289207,0.2504454530298643,99755743,99080103.2,62.23374019752533,58.66384919873652,NaN,NaN,7.657965046626742,11.999673901936225
2012-12-28T09:30:00-05:00,46.66,46.92999,46.451,46.50999,15385641,6384756.35,42.98523551574336,54.39369074600669,NaN,NaN,-147.0092828784594,-91.50728504169115,-0.1344590137993201,0.08237168578071419,0.2168306995800343,84370102,94894623.4,52.4800050190516,58.68473713045199,NaN,NaN,4.2470483255704075,10.892155962455394
2012-12-31T09:30:00-05:00,46.3707,47.47,46.3,47.4391,12471988,6734692.1,53.69943768306813,54.2580336610301,NaN,NaN,-44.500753026662224,-93.97184373933345,-0.09500591503597036,0.09807330578507134,0.1930792208210417,96842090,94951092,52.58796929291779,58.94464710472105,NaN,NaN,4.7713910620091395,10.017760976677359
2013-01-02T09:30:00-05:00,48.33,48.49001,48.07001,48.42999,9938223,6739784.1,61.918613162185565,54.581621755746845,NaN,NaN,194.21444173469953,-48.10186439644893,-0.0038210915089914588,0.18830285643480238,0.19212394794379384,106780313,96482495.8,55.538213550190434,59.36191891140739,NaN,NaN,8.355301351906888,9.78026674456729
2013-01-03T09:30:00-05:00,48.56,48.84,48.42999,48.55,5612426,6736417.5,62.78038158612672,54.914820855543496,NaN,NaN,194.10743024684186,10.091030426000804,0.05943929773967324,0.2664230701183854,0.20698377237871216,112392739,100028197.4,61.510121478494064,59.864664251425566,NaN,NaN,11.365197406832637,10.006685410605197
2013-01-04T09:30:00-05:00,48.64,48.78999,48.50999,48.7287,4987598,6658369.85,64.08373092993241,55.701111681233975,NaN,NaN,164.74329349513457,72.31102591431087,0.10549096293820603,0.3388474760514697,0.23335651311326366,117380337,103553116.2,66.34910780865596,60.57075000274431,NaN,NaN,14.16584701946463,10.600851354727974
2013-01-07T09:30:00-05:00,48.61,48.66499,48.36,48.61,3563809,6646403.3,62.51769145904814,56.59098050157916,NaN,NaN,122.52027413848784,126.21693731770033,0.11912262044148808,0.3822597886651238,0.2631371682236357,113816528,109442401.4,72.55692337721149,61.90666976140358,NaN,NaN,15.899835246764956,11.3578490535904
2013-01-08T09:30:00-05:00,48.46001,48.5658,48.14,48.4698,3875371,6482101.55,60.63297605973264,56.616802986427935,NaN,NaN,90.21310819347006,153.15970956172677,0.11007586686964765,0.40073200181069524,0.2906561349410476,109941157,112062214.8,74.78529948275661,63.223817479960076,NaN,NaN,16.741843773698616,12.126991156463001
2013-01-09T09:30:00-05:00,48.53,48.8,48.49001,48.55,3665163,6273319.65,61.35076179370687,56.330619447197314,NaN,NaN,100.7247650395417,134.4617742226952,0.1011034982997937,0.4170355078157897,0.315932009515996,113606320,113427416.2,75.88422429645173,64.30948537235665,NaN,NaN,17.63599625251828,12.913991884470898
2013-01-10T09:30:00-05:00,48.82001,48.88,48.5175,48.83,5135348,6257662.25,63.83032504109155,56.5821216097391,NaN,NaN,101.03939389827599,115.84816695298204,0.10516843310168805,0.44739255089310603,0.342224117791418,118741668,114697202,76.89295891727507,65.38046021700845,NaN,NaN,19.12257176170954,13.800931866933562
2013-01-11T09:30:00-05:00,48.82001,48.95,48.7,48.87,3370433,6181471.6,64.18383364970346,56.79117956099527,NaN,NaN,98.8763615825723,102.67478057046958,0.1016358670344909,0.46926895158453164,0.36763308455004073,122112101,115643554.8,77.64352060649807,66.26198818441787,NaN,NaN,20.44170282266459,14.749613432037995
2013-01-14T09:30:00-05:00,49.00999,49.14,48.8,48.99001,5376875,6268537.35,65.28024657875568,57.77014301376871,NaN,NaN,101.9725295568576,98.56523165414353,0.09840092014337831,0.4906342347292636,0.3922333145858853,127488976,118378044.4,79.69579717863485,67.13588212896487,NaN,NaN,21.856688080911162,15.764909810448447
2013-01-15T09:30:00-05:00,48.84,49.39,48.77,49.35001,8628297,6446686.95,68.40478659541972,58.940316016586294,NaN,NaN,110.9588986040817,102.71438973626587,0.1106134219856657,0.5305000920679674,0.41988667008230174,136117273,123613267.6,82.92713578706854,68.14429672657631,NaN,NaN,24.004387255190736,16.941978016840203
2013-01-16T09:30:00-05:00,49.25999,49.32001,49.10001,49.24001,3741183,6360511.9,66.43736811506417,60.373742888553785,NaN,NaN,105.94425443163055,103.75828761468365,0.1016214735426536,0.5469135120106188,0.44529203846796517,132376090,127367221.6,84.79567454909073,69.7057636815587,NaN,NaN,25.278498380190722,18.13290949731885
2013-01-17T09:30:00-05:00,49.49001,49.89,49.48,49.75999,4635789,6000572.85,70.723866039255,62.05923244348811,NaN,NaN,132.93164290056438,110.13673741514133,0.11978259521290219,0.5950202824840929,0.4752376872711907,137011879,131021263.8,86.3604921450175,71.42910310637956,NaN,NaN,27.716061255258502,19.501931177024513
2013-01-18T09:30:00-05:00,49.86,49.88,49.53999,49.82001,5263934,6034714.1,71.18138982317524,64.07324346544753,NaN,NaN,121.30280890482176,114.62202687959123,0.12438411776637848,0.6307178344791637,0.5063337167127853,142275813,135054006.2,87.84707459733367,73.95532236197111,NaN,NaN,29.85065623328508,20.98032047077602
2013-01-22T09:30:00-05:00,49.78,49.985,49.69,49.95,4556660,6053030.7,72.19488859141156,65.39434710175779,NaN,NaN,119.8810052722698,118.20372202267367,0.12442735224325041,0.6618679070168483,0.5374405547735979,146832473,138922705.6,89.07700675067336,76.56168218038225,NaN,NaN,31.939215913394964,22.545876962578728
2013-01-23T09:30:00-05:00,49.86,50.03999,49.72,49.99001,2617149,5747000.45,72.51528287237794,66.15125208105724,NaN,NaN,115.78881444219701,119.16970519029674,0.11558536514456108,0.6819222612042992,0.5663368960597381,149449622,141589175.4,89.84021197809199,79.01182492523235,NaN,NaN,33.769882031118435,24.1493062580844
2013-01-24T09:30:00-05:00,50.14999,50.64999,50.14999,50.37,4254828,5831564.5,75.412987876757,67.05358110181655,NaN,NaN,143.75959749084925,126.73277380214047,0.1230710917891088,0.7201757607961241,0.5971046690070153,153704450,145854847.4,90.93179432832595,81.11337298593462,NaN,NaN,36.25831334917696,25.879164413954765
2013-01-25T09:30:00-05:00,50.46001,50.92,50.45,50.89999,5682680,5892745.35,78.77427507821383,68.10290568383665,NaN,NaN,156.38446824612868,131.42333887125332,0.14969044458699843,0.7842177247407633,0.6345272801537649,159387130,150329897.6,91.9133917306715,82.9393932660786,NaN,NaN,39.58567068358042,27.837236738187002
2013-01-28T09:30:00-05:00,50.97,50.98,50.59,50.66,5244094,5900374.45,73.85086928867568,68.9124183859529,NaN,NaN,139.56266949160852,135.07531098861068,0.13742745352899743,0.8063115970650117,0.6688841435360142,154143036,152703342.2,92.38425039505073,84.35563091020997,NaN,NaN,40.92635214596913,29.707110367870165
2013-01-29T09:30:00-05:00,50.59,50.61,50.17999,50.46001,6276168,5444900.8,69.9286131616274,69.57639246465966,NaN,NaN,102.67950311489224,131.6350105571352,0.10367609046059933,0.7984792566117633,0.694803166151164,147866868,152910221.2,92.42564955685667,85.61565591550281,NaN,NaN,40.88671924671971,31.304197350562955
2013-01-30T09:30:00-05:00,50.64999,50.67,50.31,50.37,4091848,5025893.8,68.17366558050641,70.06374273514534,NaN,NaN,94.67771581890474,127.41279083247673,0.06500790222354191,0.7760630439305913,0.7110551417070494,143775020,151775300.8,89.54972925720124,86.59176341269922,NaN,NaN,40.347777244664336,32.596137335434584
2013-01-31T09:30:00-05:00,50.25999,50.41,50.035,50.13,5825152,4820240.25,63.59107986511671,70.0466537940043,NaN,NaN,64.07678381665875,111.47622809763861,0.015564815994116743,0.7305111616996953,0.7149463457055786,137949868,148624384.4,81.92768959883082,86.95138703281033,NaN,NaN,38.54833456767549,33.446451225754714
2013-02-01T09:30:00-05:00,50.47,50.61,50.32021,50.42,5154293,4797333.6,66.51964845534401,70.21349770869291,NaN,NaN,80.1512162682568,96.22957770206423,-0.004251992812215666,0.709631354690309,0.7138833475025247,143104161,145367790.6,74.83780207333771,86.75097856615604,NaN,NaN,37.82244993867512,34.07159389902906
2013-02-04T09:30:00-05:00,50.13,50.30499,49.78,49.8,4108566,4753382,56.12555483626533,69.55959115565788,NaN,NaN,30.27751462504207,74.37254672875096,-0.06252517794514545,0.6357268750710929,0.6982520530162384,138995595,142338302.4,68.86728484830988,85.97751339970425,NaN,NaN,33.787141884716014,34.03095789698434
2013-02-05T09:30:00-05:00,50.03,50.50999,49.98,50.33,5863938,4868388.45,61.64313494020232,69.07661603742807,NaN,NaN,56.51461101140034,65.13956830805257,-0.06831447716082673,0.612858956565205,0.6811734337260317,144859533,141736835.4,67.71227533416707,84.89073765306843,NaN,NaN,32.067224491437635,33.75042455333481
2013-02-06T09:30:00-05:00,50.38,50.59,50.2,50.44,5066367,4927938.25,62.69181410733256,68.80907646544723,NaN,NaN,66.0884861700819,59.421722378287974,-0.0675521251255371,0.5967332773191103,0.6642854024446474,149925900,142967011.4,68.86253523155276,83.7526562732443,NaN,NaN,31.032351825124387,33.36212844930475
2013-02-07T09:30:00-05:00,50.46001,50.50999,49.83,50.33,5165352,5002947.7,60.89876291220141,68.10728338494341,NaN,NaN,39.14375414047164,54.43511644305056,-0.0766092098484702,0.5685238901340597,0.6451330999825299,144760548,144329147.4,70.13138870617003,82.59343459904089,NaN,NaN,29.645185141705632,32.83113654821916
2013-02-08T09:30:00-05:00,50.45,50.75,50.37399,50.72,2926004,4892480.5,64.74838003427232,67.64778268573606,NaN,NaN,84.1790221946052,55.240677628320235,-0.05926270015552837,0.5710547247881195,0.6303174249436478,147686552,145245625.6,70.98801618570275,81.38921614106728,NaN,NaN,29.63427899910457,32.37444261263136
2013-02-11T09:30:00-05:00,50.75999,50.75999,50.4545,50.55,2386568,4843287.25,61.88813378952836,66.91158591417297,NaN,NaN,75.78402682611723,64.34198006853526,-0.06187908176381696,0.5529685727388767,0.6148476545026936,145299984,146506503.4,72.17055932114035,80.18161275324347,NaN,NaN,28.75233256883322,31.8569983206602
2013-02-12T09:30:00-05:00,50.56,50.845,50.55,50.75,4567047,4802795.85,63.90812605488397,66.2967889986377,NaN,NaN,93.42877703021553,71.72481327229829,-0.05311709129025288,0.5484512903898775,0.6015683816801304,149867031,147508003,73.10816967088913,78.98646687415756,NaN,NaN,28.61729675224304,31.394183810886318
2013-02-13T09:30:00-05:00,51.06,51.19,50.7,50.86,5832328,4662997.4,65.00668153115927,65.55348140252356,NaN,NaN,125.57955306373813,83.62302665102955,-0.043305200798663845,0.5474368806818006,0.5907420814804645,155699359,148662694.8,74.18796189865253,77.7904788434666,NaN,NaN,28.824675385077136,31.027111178627862
2013-02-14T09:30:00-05:00,50.67999,50.98,50.66,50.87801,4687547,4710315.6,65.19348238068582,64.58342478127156,NaN,NaN,107.45843751292963,97.28596332552114,-0.039121494410892965,0.5418402134668483,0.5809617078777413,160386906,151787966.4,76.89242228293179,76.71755245434233,NaN,NaN,29.046089407079766,30.744108068406707
2013-02-15T09:30:00-05:00,50.92,51.17,50.66991,50.94,12289078,5092980.05,65.8688454430463,64.01328022086946,NaN,NaN,120.65798317910381,104.58175552242085,-0.03578887493151839,0.5362256142133432,0.5720144891448616,172675984,156785852.8,80.42466699688956,75.86329649733081,NaN,NaN,29.41335609031469,30.55400064296499
2013-02-19T09:30:00-05:00,50.97,51.17,50.89,51.13,7060176,5182792.15,67.92324007382769,63.870039286026625,NaN,NaN,137.98556953369845,117.02206406393711,-0.024913532427421226,0.540872573610585,0.5657861060380063,179736160,163673088,84.04423819063449,75.26462425688636,NaN,NaN,30.292801483543798,30.51668647733339
2013-02-20T09:30:00-05:00,51.12,51.23,50.34,50.35001,6987910,5304354.65,53.647399638722064,62.83244886161346,NaN,NaN,30.113193986953895,104.35894745528478,-0.07172637342956867,0.47612813925104547,0.5478545126806141,172748250,168249331.8,85.9086789804222,75.00454923711644,NaN,NaN,26.66232084639551,29.966062815770837
2013-02-21T09:30:00-05:00,50.23,50.28,49.755,49.92999,8753496,5611172,47.818999078199184,61.70587166254792,NaN,NaN,-142.5072212593777,50.74159259066162,-0.12910712040947392,0.38647061216877177,0.5155777325782457,163994754,169908410.8,86.52350278396449,75.33282160748313,NaN,NaN,21.586492653201766,28.768981363975254
2013-02-22T09:30:00-05:00,50.14,50.23,49.82001,50.21001,5340324,5665446.8,51.5946984634989,60.63980380598756,NaN,NaN,-106.15286338846556,8.019332410382574,-0.14513445392598368,0.3341596651707661,0.4792941190967498,169335078,171698045.2,87.17361050585032,76.21395078123403,NaN,NaN,18.56814406964198,27.311718893356215
2013-02-25T09:30:00-05:00,50.5,50.55,49.39999,49.42999,5324199,5647522.75,42.39278190035382,59.65889145342244,NaN,NaN,-156.1677288070384,-47.34580998684587,-0.20172057530064091,0.22714339997094868,0.4288639752715896,164010879,169965024.2,82.998181852903,77.2233005672764,NaN,NaN,12.505902195399777,25.196602222219582
2013-02-26T09:30:00-05:00,49.64,50.00999,49.48,49.92,7872434,5778939.75,48.59519663632255,58.726895860288174,NaN,NaN,-135.25417701757326,-101.99375929710021,-0.19925171159055716,0.17979933578339313,0.3790510473739503,171883313,168394454.8,79.29153795556499,78.0503907545191,NaN,NaN,9.676201487019616,22.979402117191015
2013-02-27T09:30:00-05:00,50.02,50.845,49.89999,50.67999,5101359,5720199.3,56.43047366348898,58.279657257156494,NaN,NaN,11.893444303157683,-105.63770923385945,-0.14221412139714407,0.20128339562752018,0.34349751702466425,176984672,169241739.2,79.81524983624138,78.83272751199686,NaN,NaN,10.190978136620156,21.15248440568089
2013-02-28T09:30:00-05:00,50.62,51.08,50.57001,50.92999,5825492,5806881.5,58.66256027664783,58.1199284974741,NaN,NaN,86.27304821147717,-59.88165533968847,-0.0861861509647256,0.23576482831875722,0.3219509792834828,182810164,173004821.2,81.99334467744278,79.68001008137348,NaN,NaN,11.393560980185375,19.75835248775296
2013-03-01T09:30:00-05:00,50.44,51.05,50.34,51.05,4531754,5742211.6,59.72911104090222,57.76140928366194,NaN,NaN,69.80292180160306,-24.69049830167475,-0.041827291878755724,0.2696668644350382,0.3114941563137939,187341918,176606189.2,83.79551989316667,80.59483177476376,NaN,NaN,12.684374853334655,18.74778425426463
2013-03-04T09:30:00-05:00,50.83,51.5,50.83,51.5,7059035,5837448.7,63.52895628860711,57.878610890739004,NaN,NaN,141.1042889964541,34.76390525902375,0.014046753332864426,0.3290525979798744,0.31500584464701,194400953,182684204,86.2895155707361,81.60332864973489,NaN,NaN,15.061367160902,18.221153240927112
2013-03-05T09:30:00-05:00,51.73,52.09,51.67,52.02,6244309,5944235.85,67.36144693783515,58.12527666809264,NaN,NaN,226.89282430538734,107.19330552361586,0.07864450541936308,0.4133114764212138,0.3346669710018507,200645262,188436593.8,88.14860878818904,82.67764572954204,NaN,NaN,18.398594447431197,18.24650198471341
2013-03-06T09:30:00-05:00,52.13,52.315,51.92,51.98,3526304,5827354.15,66.78011868603653,58.25195075058387,NaN,NaN,207.90405071218552,146.39542680542144,0.10940664858775984,0.4714252817365505,0.3620186331487907,197118958,192463451,89.2477427283566,83.75334436023518,NaN,NaN,20.80070477851296,18.61138809811335
2013-03-07T09:30:00-05:00,52.00999,52.10001,51.918,52.07001,3343162,5741193.9,67.46062887378528,58.41388978580527,NaN,NaN,169.7003147596822,163.08088011506243,0.12539625980416141,0.5187639579039924,0.393367698099831,200462120,195993842.2,90.11344316756804,84.69770299485205,NaN,NaN,22.93715834378055,19.229355276065807
2013-03-08T09:30:00-05:00,52.36,52.7,52.14999,52.62,4042909,5685071.75,71.32586159025759,58.80367665346321,NaN,NaN,192.0455637017113,187.52940849508408,0.16035757790470967,0.5938146704807181,0.43345709257600845,204505029,199426464.4,90.88212967859448,85.44466461497383,NaN,NaN,26.072453829441915,20.206940783690964
2013-03-11T09:30:00-04:00,52.57001,52.78999,52.505,52.75,3207494,5699146.25,72.1674368075929,59.10683356301787,NaN,NaN,171.3802403296427,193.5845987617218,0.1782089962877062,0.6562183379356412,0.478009341647935,207712523,202088778.4,91.43814891290626,85.9728010951361,NaN,NaN,28.871299971934665,21.444706382011493
2013-03-12T09:30:00-04:00,52.7,52.795,52.4301,52.60001,3724904,5766063.05,69.6282667885462,60.248324073719594,NaN,NaN,136.18716806841013,175.44346751432636,0.16612597810904928,0.6856668142842466,0.5195408361751973,203987619,202757249.8,91.57703842810227,86.37768391282755,NaN,NaN,30.437216651483183,22.729350706221734
2013-03-13T09:30:00-04:00,52.62,52.91499,52.535,52.89,3836986,5729560,71.70137172405771,61.95420783413806,NaN,NaN,127.60524928112204,159.38370722811368,0.1636139078176757,0.7240582209472919,0.5604443131296162,207824605,204898379.2,92.02337817374959,86.77053215495505,NaN,NaN,32.3951134388923,24.110173953746102
2013-03-14T09:30:00-04:00,52.98,53.00999,52.7545,52.95,3709362,5623411.7,72.12532157498963,63.420680913530255,NaN,NaN,117.75512919930014,148.99467011603724,0.15218207542462125,0.7506719074103927,0.5984898319857714,211533967,207112748.6,92.46791504837422,87.14869676513533,NaN,NaN,34.12012470864021,25.540166918730975
2013-03-15T09:30:00-04:00,52.7,52.78,52.48,52.591,6048957,5691482.2,65.77577173690975,65.09089447328425,NaN,NaN,85.23141607276827,127.63184059024866,0.10867232962223328,0.7343302440135631,0.6256579143913298,205485010,207308744.8,92.50771525502122,87.82794915100092,NaN,NaN,33.80246726620694,26.72049553979897
2013-03-18T09:30:00-04:00,52.12,52.41,51.92999,52.19,5213109,5337683.75,59.47722339170012,65.86818209866837,NaN,NaN,49.42670834402059,103.24113419312421,0.044409593817024584,0.6811699066626105,0.6367603128455859,200271901,205820620.4,88.6763445923237,88.49829248219797,NaN,NaN,31.627101931777553,27.421439310081627
2013-03-19T09:30:00-04:00,52.38,52.38,51.4675,51.82001,6250422,5297196.05,54.309702559193205,65.71669844836153,NaN,NaN,26.983341855995235,81.40036895064125,-0.02761418796213011,0.6022425778929232,0.6298567658550533,194021479,203827392.4,83.67730774142484,88.77415376113966,NaN,NaN,28.150654335825188,27.52561288518785
2013-03-20T09:30:00-04:00,52.14999,52.53999,52.14999,52.42,4117637,5153682.4,60.32897115635617,65.83572779691212,NaN,NaN,54.94284632148561,66.86788835871397,-0.038762041476793074,0.5814042140090621,0.6201662554858551,198139116,201890294.6,79.01534043695725,88.56143917253353,NaN,NaN,26.952850584441236,27.443789699366906
2013-03-21T09:30:00-04:00,52.14,52.298,51.815,51.98,5189367,4975475.95,54.64367627293587,65.47248245634309,NaN,NaN,26.62930007836337,48.64272253452661,-0.07745103927625174,0.5233524563905405,0.6008034956667923,192949749,198173451,70.85784419772104,87.63731948000171,NaN,NaN,24.06583298285895,26.961224454151484
2013-03-22T09:30:00-04:00,52.25999,52.64,52.23,52.62,6911961,5054057.8,60.477853070730845,65.25454651220907,NaN,NaN,59.088423286238395,43.41412397722063,-0.062274548049274125,0.5229603106051997,0.5852348586544738,199861710,197048791,68.55165436886196,86.37032939415356,NaN,NaN,23.5248629168413,26.470315663107172
2013-03-25T09:30:00-04:00,52.74001,52.95,52.28,52.53,4548836,5015289.65,59.322255518144374,64.68031855365973,NaN,NaN,65.2048885036909,46.5697600091547,-0.06057674689158732,0.5095139250399896,0.5700906719315769,195312874,196056985.6,66.49626423579,84.82373335469649,NaN,NaN,22.730216873436156,25.93601583601131
2013-03-26T09:30:00-04:00,52.61,52.81,52.53,52.78999,3302035,4786769.7,61.604635058713704,64.3106411517081,NaN,NaN,76.08573962988424,56.390239563932504,-0.044942518266756326,0.5139125240981315,0.5588550423648878,198614909,196975671.6,67.46922657243111,83.26812505784467,NaN,NaN,22.790977272594553,25.48672461266606
2013-03-27T09:30:00-04:00,52.56,52.86,52.38,52.81,3373600,4700381.75,61.7823688048717,63.9050511467857,NaN,NaN,68.14715858247065,59.0311020161295,-0.036605308870740205,0.5130984062764625,0.5497037151472027,201988509,197745550.2,68.3000359633268,81.71002454325601,NaN,NaN,22.891951098830702,25.116042682118152
2013-03-28T09:30:00-04:00,52.83,53.05,52.74001,53,3800552,4599134.75,63.50963965072291,63.346749579676086,NaN,NaN,99.07415638441266,73.52007327733936,-0.022346984477934373,0.5217699845497847,0.5441169690277191,205789061,200313412.6,70.96371696248707,80.28728077781975,NaN,NaN,23.478733934725046,24.882141432490567
2013-04-01T09:30:00-04:00,52.99001,53.13,52.535,52.60001,5974781,4671286.1,57.606927484547256,62.30671319945854,NaN,NaN,68.76244727196938,75.45487807448555,-0.04272571501946332,0.4907098252533899,0.5334355402728532,199814280,200303926.6,70.9400026412226,78.8231274726995,NaN,NaN,22.23702297592311,24.504267367266646
2013-04-02T09:30:00-04:00,52.77,53.16,52.77,53.03999,4598863,4548277.5,61.81142321610393,61.74836722999838,NaN,NaN,115.35903213915593,85.48570680157856,-0.030043690209349605,0.4958809275111662,0.5259246177205158,204413143,202123980.4,72.81697516302228,77.48312295376522,NaN,NaN,22.436152337215702,24.208822362973653
2013-04-03T09:30:00-04:00,53.14999,53.17,52.375,52.55,6844793,4578301.7,55.24064609701139,60.572601113780784,NaN,NaN,43.685942289153104,79.00574733343232,-0.056584674308006844,0.45519377483550727,0.5117784491435141,197568350,201914668.6,72.23910684830406,76.06996071623338,NaN,NaN,20.524981172444598,23.682559335755215
2013-04-04T09:30:00-04:00,52.5,52.9357,52.49001,52.85001,4436355,4623804.25,58.172504876513024,59.57597134960388,NaN,NaN,54.60643610945587,76.29760283882938,-0.055773635936771704,0.44206140422254947,0.4978350401593212,202004705,201917907.8,72.2427779885987,74.62530806910657,NaN,NaN,19.846712679493454,23.134581242003534
2013-04-05T09:30:00-04:00,52.23,52.67,51.95,52.59,4086571,4660974.7,54.820961164255095,58.79348488012855,NaN,NaN,-53.19494224867838,45.84378311221117,-0.07347344444276421,0.4059932346058659,0.4794666790486301,197918134,200343722.4,67.566485408294,72.84379165148319,NaN,NaN,18.244717554816688,22.436029286691127
2013-04-08T09:30:00-04:00,52.55,53.19,52.53999,53.19,4471793,4682418.9,60.479398967628356,58.86506884983771,NaN,NaN,109.38801960621592,53.96889757906049,-0.04679635004540256,0.4209712414918769,0.4677675915372795,202389927,200858851.8,68.289839298129,71.38761270189785,NaN,NaN,18.656004600901028,21.896025760149683
2013-04-09T09:30:00-04:00,53.25,53.27,52.8,53.05,5316320,4787860.2,58.6340812464804,59.17395304178679,NaN,NaN,116.53070765249234,54.203232681727776,-0.04082154287920442,0.41674066293827394,0.45756220581747836,197073607,199390944.6,63.91533521239579,69.97604323553864,NaN,NaN,18.414987254818254,21.398734545102336
2013-04-10T09:30:00-04:00,53.23,53.745,53.12,53.67,5008563,4852043.15,63.88884718485935,59.42822990096558,NaN,NaN,205.05622242239733,86.47728870837662,0.0004587275108999811,0.45813561520610335,0.45767688769520337,202082170,200293708.6,65.38395863964878,69.00237310715946,NaN,NaN,19.919672781899425,21.18744000750192
2013-04-11T09:30:00-04:00,53.72,54.36501,53.72,54.12,6266465,4973517.1,67.15054947560138,60.32157798687026,NaN,NaN,265.2493594160464,128.60587336969473,0.05085374990120245,0.5212440750717064,0.470390325170504,208348635,201562494.6,67.39260163636982,68.75485578134865,NaN,NaN,22.271631479590575,21.342324503514586
2013-04-12T09:30:00-04:00,54.00999,54.41,53.96001,54.41,7789738,5177535.9,69.08829227385104,60.9366093585217,NaN,NaN,232.64029962309158,185.77292174404872,0.09399319972211084,0.5878818248231426,0.4938886251010317,216138373,205206542.4,72.35432863841373,69.02647537203093,NaN,NaN,24.830317472474718,21.840609213366033
2013-04-15T09:30:00-04:00,54.12,54.255,52.98,52.98,9073961,5328786.1,52.60864646886174,60.45706585500151,NaN,NaN,84.4794471234907,180.79120724750368,0.020342944694730192,0.5193173059694445,0.4989743612747143,207064412,206141439.4,73.46970929706431,69.52457859069337,NaN,NaN,21.149706820476492,21.74190887152467
2013-04-16T09:30:00-04:00,53.38,53.74001,53.21001,53.74001,6701301,5403195.7,58.30152064827631,60.22112911139884,NaN,NaN,95.53087775196391,176.59124126739798,0.01706698958223385,0.5203080982525066,0.5032411086702727,213765713,209479860.6,77.03307834998749,70.20771086051883,NaN,NaN,20.27819867421325,21.532807414765898
2013-04-17T09:30:00-04:00,53.45,53.48,52.89999,53.19,8970402,5539194.7,53.31058591224127,59.61600176192523,NaN,NaN,34.23103522812164,142.42620382854284,-0.025569301816079026,0.47127948140017395,0.496848783216253,204795311,210022488.8,77.56064232283806,70.86918274334106,NaN,NaN,17.73285887614164,20.98995762353386
2013-04-18T09:30:00-04:00,53.28,53.31,52.3291,52.61,8752984,5770962.05,48.587075678824846,58.55010433536109,NaN,NaN,-39.04278836206043,81.56777427292148,-0.09249643874059238,0.3812282347905125,0.47372467353110487,196042327,207561227.2,69.73591933964249,70.78148291313786,NaN,NaN,13.959742282409707,19.98564114623041
2013-04-19T09:30:00-04:00,52.59,53.28,52.57001,53.24001,6410082,5831997.8,53.41541485074183,58.25071057580356,NaN,NaN,-1.8022998833291877,34.67925437163732,-0.09370934644960827,0.3565879904690945,0.4502973369187028,202452409,204824034.4,62.2183358287636,70.15850671224793,NaN,NaN,12.634903895918056,18.935535824757217
2013-04-22T09:30:00-04:00,53.27,53.56,52.87,53.47,4561340,5714466.75,55.074116525338034,57.76947438360599,NaN,NaN,39.19827937311622,25.62302082156243,-0.07898502508052807,0.35156605556804266,0.4305510806485707,207013749,204813901.8,62.1916086133618,69.39955195870075,NaN,NaN,12.172847976414488,17.969437560708254
2013-04-23T09:30:00-04:00,53.87,54.095,53.45,54.00999,5339680,5754008.95,58.78472945211622,58.022623194684904,NaN,NaN,117.97355222770042,30.111555716709734,-0.0350799319050174,0.38670116576729896,0.42178109767231636,212353429,204531445,61.39980382095676,68.62531602817594,NaN,NaN,13.049480648173764,17.266586573203327
2013-04-24T09:30:00-04:00,54.23,54.42,53.91,54.05,2919056,5734860,59.05457911757821,58.08562849761813,NaN,NaN,139.12547916649166,51.09044450438374,-0.007014075115518437,0.41301350377791834,0.4200275788934368,215272485,206626879.8,64.9635981737818,68.10537461283188,NaN,NaN,13.815541647439844,16.773580155237116
2013-04-25T09:30:00-04:00,54.14999,54.69,54.14999,54.50999,6805160,5906438,62.12488870698348,58.60733760781301,NaN,NaN,158.85343107119394,90.66968839103463,0.036470925520821595,0.46561623579446376,0.42914531027364217,222077645,211833943.4,71.90510750053669,68.41527619084921,NaN,NaN,15.430855585004554,16.58176235948961
2013-04-26T09:30:00-04:00,54.45,54.49001,54.12,54.27,2473066,5840063.7,59.61329494957934,58.54547303509522,NaN,NaN,118.44647446871424,114.7194432614433,0.04258657827733525,0.4823785331203112,0.43979195484297595,219604579,215264377.4,75.3675522527673,68.92082711618052,NaN,NaN,15.993267976614717,16.497691733364626
2013-04-29T09:30:00-04:00,54.50999,54.67,54.28,54.46001,3157722,5699210.75,60.9590683487298,58.71154354239875,NaN,NaN,123.16408952864242,131.51260529254856,0.05230378713953732,0.5051716887673976,0.4528679016278603,222762301,218414087.8,78.04321002800805,69.9299610315814,NaN,NaN,16.853668220878937,16.548545517295242
2013-04-30T09:30:00-04:00,54.49001,54.63,54.36,54.61,3848165,5661675.85,62.03452494113011,58.579091953560955,NaN,NaN,114.64415784810595,130.84672641662965,0.0610957956327251,0.5292376461687667,0.46814185053604157,226610466,221265495.2,80.14577430163935,70.9843764360093,NaN,NaN,17.873730100771056,16.73785760064893
2013-05-01T09:30:00-04:00,54.52,54.75,54.25999,54.32001,4271371,5533004.75,58.66948378364348,57.97330154699252,NaN,NaN,92.80069366229513,121.58176931579035,0.040629269442246985,0.5189284373388503,0.4782991678966033,222339095,222678817.2,81.1112686864301,71.96428122529932,NaN,NaN,17.796518446553897,16.88909486434964
2013-05-02T09:30:00-04:00,54.35001,54.88,54.35001,54.85001,3028656,5462619.8,62.65651217786758,57.5138886829937,NaN,NaN,108.17813435946448,111.44670997344444,0.055134193496625794,0.5472169097673856,0.4920827162707598,225367751,223336838.4,81.56086302940128,72.62189082465558,NaN,NaN,18.897414326829313,17.17599764470388
2013-05-03T09:30:00-04:00,55.3,55.7,55.25,55.53999,6508930,5583737.75,67.1053726542539,58.54936912480743,NaN,NaN,177.21082209907397,123.1995794995164,0.10088206084580387,0.6181852923280147,0.5173032314822108,231876681,225791258.8,83.17000981246298,73.31476943289833,NaN,NaN,21.266361699149737,17.760335366767574
2013-05-06T09:30:00-04:00,55.56,55.82001,55.45,55.72,3195457,5519920.95,68.17075396047022,59.25431436139271,NaN,NaN,171.95886744302308,132.95853508239253,0.13103919633444894,0.681102226900272,0.5500630305658231,235072138,228253226.2,84.61989130162326,73.85668464372945,NaN,NaN,23.527958229521175,18.58428149001809
2013-05-07T09:30:00-04:00,55.88,56.19,55.61,56.19,4618406,5485025.25,70.8274417880248,60.505518352520106,NaN,NaN,181.861930623268,146.40208963742492,0.16805129575648747,0.7601271502614324,0.5920758545049449,239690544,230869241.8,86.00001764505514,74.45949716674497,NaN,NaN,26.29706099520756,19.686107133616584
2013-05-08T09:30:00-04:00,56.16,56.25,55.955,56.23,3396709,5404432.55,71.0489173440173,62.10993561431957,NaN,NaN,169.26020211652252,161.69399132827039,0.17959510002005707,0.8165697295300163,0.6369746295099592,243087253,235018873.4,87.86082906907346,75.75413357599004,NaN,NaN,28.600152779956662,20.95954222595088
2013-05-09T09:30:00-04:00,56.32001,56.58,56.13699,56.33,6649262,5423572.4,71.62881774779223,63.41089296410888,NaN,NaN,157.73042842095057,171.60445014056762,0.17799045125420176,0.8594626935777114,0.6814722423235097,249736515,239892626.2,89.60792167450336,77.71053256497144,NaN,NaN,30.6754620349792,22.347530770097784
2013-05-10T09:30:00-04:00,56.38,56.7701,56.38,56.77,2966393,5182405.15,74.08818712147743,64.76904086383313,NaN,NaN,151.01422962633913,166.36513164602064,0.1895210546530609,0.9183735606398358,0.7288525059867749,252702908,244057871.6,90.82345748746523,79.75566462740741,NaN,NaN,33.22535991332168,23.90150636198691
2013-05-13T09:30:00-04:00,56.71001,56.81,56.49001,56.78,2257136,4841563.9,74.14304710565648,65.86606355337172,NaN,NaN,131.257698453814,158.22489784817884,0.18080657409173362,0.9548607236014419,0.7740541495097083,254960044,248035452.8,91.80877731961257,81.92773416302569,NaN,NaN,35.33326074428512,25.534614130886656
2013-05-14T09:30:00-04:00,56.81,57.41,56.8,57.36,3509372,4681967.45,77.16305797212085,67.15952632869619,NaN,NaN,137.738854603894,149.400282644304,0.19582366820794228,1.0188337347696361,0.8230100665616938,258469416,251791227.2,92.61509834742351,83.90284131828581,NaN,NaN,38.14493050195908,27.336087898182715
2013-05-15T09:30:00-04:00,57.28999,57.705,57.28999,57.67,4756313,4471263,78.6016257360464,68.3364361164864,NaN,NaN,137.56392704402106,143.06102762980373,0.20725094170521685,1.0820737436932149,0.874822801987998,263225729,255818922.4,93.36894602260962,85.43597264129103,NaN,NaN,40.983527279550295,29.285722095520942
2013-05-16T09:30:00-04:00,57.52,57.7,56.91,57,5974680,4332347.8,68.5507807987519,68.97482796285587,NaN,NaN,106.54740024837189,132.824421995288,0.15281547126551076,1.0658421410698864,0.9130266698043756,257251049,257321829.2,93.63023577454442,86.74045003570367,NaN,NaN,40.484146073789034,30.88549694955924
2013-05-17T09:30:00-04:00,57.14999,57.59,57.1257,57.55,5710617,4297374.55,71.74482958445597,69.74523947969347,NaN,NaN,108.9749005476249,124.41655617954518,0.13746135869743503,1.0848533681761694,0.9473920094787344,262961666,259373580.8,93.9790409358647,87.87872367197915,NaN,NaN,41.04660611677931,32.33708397344782
2013-05-20T09:30:00-04:00,57.4201,57.61,57.25999,57.38,4833625,4310988.8,69.39868990347404,70.27125126271802,NaN,NaN,99.45928573420943,118.05687363562427,0.10114555187309882,1.0738239493201078,0.972678397447009,258128041,260007180.2,94.08672764066145,88.87450605333787,NaN,NaN,40.788780162099,33.54446914325513
2013-05-21T09:30:00-04:00,57.57001,57.86,57.37,57.64,3839755,4235992.55,70.96266256743209,71.14933546156007,NaN,NaN,102.17982261680956,110.94506723820737,0.08080616005643415,1.0736860975175517,0.9928799374611176,261967796,260706856.2,94.20988226149338,89.81012130869954,NaN,NaN,41.036094250233845,34.614701301394945
2013-05-22T09:30:00-04:00,57.69,58.09,56.83099,57.09,9568512,4568465.35,63.56215089411455,71.21402394129198,NaN,NaN,78.37050262600856,99.10638235460488,0.019670218903781733,1.0174677110908448,0.997797492187063,252399284,258541567.2,88.09513738488519,90.27685519123409,NaN,NaN,38.953606910228146,35.234544959799685
2013-05-23T09:30:00-04:00,56.46001,57.069,56.38341,56.97,5479422,4502178.45,62.041883231544475,70.85234612538417,NaN,NaN,40.37942130837414,85.87278656660534,-0.03643459892075085,0.9522542435361245,0.9886888424568754,246919862,256475329.8,82.58655007486655,90.2351794956915,NaN,NaN,36.80376914828988,35.458719843869716
2013-05-24T09:30:00-04:00,56.64,56.83,56.28,56.8,5170871,4637068.7,59.8576767665696,70.25855489724843,NaN,NaN,23.549051800923504,68.78761681726505,-0.08955274022308246,0.8767479171780224,0.9663006574011048,241748991,252232794.8,72.55464486759485,89.37337617897518,NaN,NaN,34.3765878876477,35.30412956440943
2013-05-28T09:30:00-04:00,57.47,57.74001,57.10001,57.35001,6500926,4804228.9,64.24367039009363,69.7882855116819,NaN,NaN,74.38354878208408,63.77246942683996,-0.09186088486721233,0.8514745513170894,0.9433354361843017,248249917,250257170,68.3886218414922,88.11541933586354,NaN,NaN,33.510912388047885,35.047955682072065
2013-05-29T09:30:00-04:00,57.08,57.08,56.53,56.75999,4506871,4837164.2,57.04335700349722,68.78788834450191,NaN,NaN,19.81051631518737,47.29860816651552,-0.1347459929468211,0.7749029450007754,0.9096489379475965,243743046,246612220,61.38546598662555,86.22432197283153,NaN,NaN,30.471277997025396,34.394144584208256
2013-05-30T09:30:00-04:00,56.96001,57.23,56.71001,56.75999,3712693,4809230.3,57.04335700349722,67.7460697199094,NaN,NaN,22.598423702504615,36.14419238181473,-0.16285503599161955,0.7060801429580721,0.8689351789496916,243743046,244880972.4,58.33015539493406,83.99019581000518,NaN,NaN,28.056705687153283,33.48879617034326
2013-05-31T09:30:00-04:00,56.64999,57.11,56.08,56.12,8268844,5071239.7,49.99449424740343,66.02509165747556,NaN,NaN,-46.37049394887561,18.794209330364787,-0.22070069234561107,0.5930593135176778,0.8137600058632889,235474202,242591840.4,54.46967851262337,81.39349731180218,NaN,NaN,23.67035516107256,32.086161740447444
2013-06-03T09:30:00-04:00,56.27,56.41,55.63,56.37,7899512,5140768.8,52.46550355077865,64.47669568926999,NaN,NaN,-96.66769465561295,-5.2491399609425,-0.23685221279427693,0.5176947398704428,0.7545469526647197,243373714,242916785,54.92571525809751,78.7589928788368,NaN,NaN,20.77520373753329,30.470310597173995
2013-06-04T09:30:00-04:00,56.42999,56.769,55.77,56.17,8061895,5384090.7,50.32311261444478,62.559556735150274,NaN,NaN,-91.6111188800283,-38.44807349336497,-0.25420208183079596,0.4367943503762248,0.6909964322070208,235311819,240329165.4,50.5809907490468,75.75655662180989,NaN,NaN,17.732791774027387,28.650665051010193
2013-06-05T09:30:00-04:00,55.92,56.08,55.13,55.24001,12105617,5758451.25,41.77983426926076,59.929428773237014,NaN,NaN,-191.02433921801838,-80.61504460000613,-0.3174004221880852,0.29424590447191434,0.6116463266599995,223206202,236221796.6,44.55619204679103,72.26993133782285,NaN,NaN,12.058152776148475,26.280306154601377
2013-06-06T09:30:00-04:00,55.28,55.82001,54.9214,55.82001,7424980,5959864.8,47.73879936745214,58.44285867100131,NaN,NaN,-170.2628953145412,-119.1873084034153,-0.3089352807512047,0.2254772257209936,0.5344125064721983,230631182,233599423.8,41.18337661777554,68.52372711233936,NaN,NaN,9.19551490077871,23.83962168976957
2013-06-07T09:30:00-04:00,56.14999,56.86,56.03,56.84,4755828,5865193.1,56.22439226326701,57.3342560052021,NaN,NaN,-30.70559246204414,-116.054328106049,-0.2272133540810538,0.25039581387088106,0.47760916795193487,235387010,233581985.4,41.16106310330513,64.75101441001368,NaN,NaN,9.68252486463851,21.817179286179417
2013-06-10T09:30:00-04:00,57.07001,57.07001,56.58,56.67,5974504,6015598.65,54.63222251198303,56.27950833438131,NaN,NaN,-4.655269982311065,-97.65184317138862,-0.1792840086534757,0.2535041571350902,0.43278816578856594,229412506,230789743.8,37.64405426723593,60.719394883340435,NaN,NaN,9.525692766685355,20.061252640537408
2013-06-11T09:30:00-04:00,56.06,56.62,55.92999,56.11,5789273,6192205.5,49.64494617826755,54.75681430658385,NaN,NaN,-74.66597483230976,-94.26281436184492,-0.17952799833220218,0.2083781678733132,0.3879061662055154,223623233,228452026.6,34.95143154067992,56.48664840328233,NaN,NaN,7.71463400087933,18.297449977729112
2013-06-12T09:30:00-04:00,56.49001,56.548,55.41,55.49001,5306688,6282071.3,44.77189086388666,53.41465287585328,NaN,NaN,-111.60103702883444,-78.37815392400812,-0.21337255187027976,0.12119047636766567,0.3345630282379454,218316545,227474095.2,33.8603148226927,52.61273250598286,NaN,NaN,4.532108134963204,16.330972571619697
2013-06-13T09:30:00-04:00,55.48,56.62,55.39999,56.53,6316563,6360083.8,53.089939445381205,52.77522831969876,NaN,NaN,-59.155993736411425,-56.15677360838216,-0.160080735671773,0.13446210864822916,0.29454284432000216,224633108,226274480.4,32.51920522027143,49.036493587797494,NaN,NaN,4.740685418568347,14.675217264040933
2013-06-14T09:30:00-04:00,56.45,56.71001,56.19,56.35001,6738160,6398257.8,51.640319695293435,52.18827424317903,NaN,NaN,-25.111707708851554,-55.037996657743655,-0.13245859322673537,0.12896960278658298,0.26142819601331835,217894948,222776068,28.921629742948184,45.91984965032274,NaN,NaN,4.4136222403684044,13.209275117802001
2013-06-17T09:30:00-04:00,56.66,57.00999,56.33,56.66,4676703,6346562.1,53.97138154966183,51.45453932600533,NaN,NaN,13.988731692813582,-51.30919632271872,-0.09080242449158957,0.14792516539883138,0.23872758989042095,222571651,221407897,27.63406570606503,43.008809926363654,NaN,NaN,4.914218967062166,12.024267096267739
2013-06-18T09:30:00-04:00,56.7,57.33,56.7,57.24001,4659766,6337869.15,58.04625042824337,51.526174570630054,NaN,NaN,79.26618807904283,-20.522763740448198,-0.025094682483817438,0.20735923678564916,0.2324539192694666,227231417,222129533.8,29.418898280788866,40.72548366166104,NaN,NaN,6.681694083820114,11.261042380203792
2013-06-19T09:30:00-04:00,57.28,57.379,56.58,56.59,8763875,6584075.15,52.44297163463841,51.197575615711564,NaN,NaN,53.66772645034838,12.530988955388366,-0.026196195709598608,0.19970867463246833,0.22590487034206694,218467542,222159733.2,29.49726534880395,38.66599151550889,NaN,NaN,6.331251508946352,10.556786541452729
2013-06-20T09:30:00-04:00,56.00999,56.09,54.95,55.11,12942816,6752790.35,42.405644304870755,50.65551490553066,NaN,NaN,-158.31698801805967,-7.301209900941285,-0.1220230290250102,0.0733760840608042,0.1953991130858144,205524726,218338056.8,25.6204726241034,36.605333952043175,NaN,NaN,2.3274114043451277,9.381161521865929
2013-06-21T09:30:00-04:00,55.35001,55.42,54.47,55.045,11942699,7075954.2,42.025212309278146,49.90977981685205,NaN,NaN,-180.83021275309596,-38.44491090979017,-0.18161834742160876,-0.031623821191196555,0.1499945262304122,193582027,213475472.6,21.710615631309565,34.23282683584403,NaN,NaN,-0.8236936779243902,7.923325064753026
2013-06-24T09:30:00-04:00,54.48,54.94,53.96001,54.53999,7004762,7167648.75,39.09093765915449,49.10748160575988,NaN,NaN,-201.28090820119215,-81.49883888859131,-0.24304683442625546,-0.15381401680240714,0.08923281762384833,186577265,206276595.4,17.461979610487447,31.867183183089793,NaN,NaN,-4.382414232602693,6.165362307987923
2013-06-25T09:30:00-04:00,55.03999,55.22,54.72,55.03,4402320,7062718.45,43.23264273907175,49.21125363931781,NaN,NaN,-122.45820478737696,-121.84371746187529,-0.23835032845467743,-0.20870509294449846,0.029645235510178967,190979585,199026229,14.404547161682132,29.713494262724875,NaN,NaN,-5.96048645450416,4.433098199060483
2013-06-26T09:30:00-04:00,55.47,55.85001,55.4599,55.72,6192734,7147011.6,48.53908664701825,49.26841701642967,NaN,NaN,-40.4687988105876,-140.67102251406249,-0.17914801334447797,-0.1942897811704185,-0.015141767825940532,197172319,194767184.4,12.96813869205829,27.69812012517364,NaN,NaN,-5.541491312075942,3.0081568403267083
2013-06-27T09:30:00-04:00,56.00999,56.42999,56,56.2,3948489,7158801.4,51.907019497680395,48.9600332474592,NaN,NaN,23.745493872368943,-104.25852613597674,-0.1018793910458306,-0.14249100663322878,-0.04061161558739818,201120808,193886400.8,12.686392404112155,25.664215075231287,NaN,NaN,-4.097839371846978,1.993014524301896
2013-06-28T09:30:00-04:00,56.10001,56.73,56.05,56.39999,7999043,7145311.35,53.27900567941184,48.863374902275545,NaN,NaN,45.49762379572903,-58.99295882621175,-0.03497508657053738,-0.0843304738005699,-0.04935538723003253,209119851,196993965.6,19.34449139299838,24.357103441357175,NaN,NaN,-2.5107976275523027,1.349612788322725
2013-07-01T09:30:00-04:00,56.75999,57.19,56.64999,56.78999,9685758,7234623.65,55.91990345961922,49.31158613665781,NaN,NaN,92.84383349616297,-0.16801048674072377,0.03413153968757233,-0.00669096262056712,-0.04082250230813945,218805609,203439634.4,31.083328707653934,24.080810381855322,NaN,NaN,-0.3735824309646273,1.103442042710246
2013-07-02T09:30:00-04:00,56.72,57.27499,56.66,56.89,3030841,6983070.95,56.59741794519951,50.15626664246587,NaN,NaN,91.82993160246332,42.68961679122733,0.08241157801782678,0.06219197021414402,-0.020219607803682753,221836450,209611007.4,40.07602915487657,24.524789977011316,NaN,NaN,1.558624968842136,1.1684681750148018
2013-07-03T09:30:00-04:00,56.59,57.5,56.5,57.14999,2620440,6508812.1,58.38799332088794,50.534699062144924,NaN,NaN,95.69342782313001,69.92206211797085,0.12512871232580153,0.13619128260356916,0.011062570277767636,224456890,215067921.6,46.698977764827674,25.537630873051047,NaN,NaN,3.699801576393387,1.5300872323545998
2013-07-05T09:30:00-04:00,57.63,57.81,57.14999,57.77,6366246,6455875.4,62.374446534959844,51.30142240783538,NaN,NaN,137.8620636694987,92.7453760773968,0.18481026507813952,0.24207540162544205,0.057265136547302524,230823136,221008387.2,52.81305231856902,27.244161057023963,NaN,NaN,6.786311564148462,2.2809764226108658
2013-07-08T09:30:00-04:00,58.14999,58.41,58.06,58.31,13217297,6878948.85,65.47658716959532,52.12322280925923,NaN,NaN,179.1988057807457,119.48561247440014,0.24646890978220734,0.3653512737750617,0.11888236399285437,244040433,227992503.6,58.79714328528698,29.470095169825527,NaN,NaN,10.407019004111143,3.4418396485394767
2013-07-09T09:30:00-04:00,58.63,58.72,58.35989,58.53999,6347008,6897574.05,66.734561320543,52.743816444423494,NaN,NaN,176.23620232971876,136.1640862411113,0.2857886429164625,0.4761181676384325,0.19032952472197,250387441,234308870,63.326803225752776,31.89208838018009,NaN,NaN,13.786500702371852,4.91964837051553
2013-07-10T09:30:00-04:00,58.47,58.7,58.23,58.60001,9804438,7098332.3,67.07176950736049,53.78873057818936,NaN,NaN,146.95501554833123,147.18910303028488,0.29754711522632893,0.5622634187548812,0.26471630352855224,260191879,241979955.8,67.93697375907718,34.637781838056746,NaN,NaN,16.653347789811487,6.5958911447006665
2013-07-11T09:30:00-04:00,59.23,59.49001,59.10001,59.44,7161957,7191095.75,71.43581701471824,55.86231434317846,NaN,NaN,177.8618303221503,163.62278353008892,0.34051201783805085,0.6903563258261158,0.349844307988065,267353836,250559345,72.15323223833022,37.96155038193009,NaN,NaN,20.622957526640274,8.599757770692039
2013-07-12T09:30:00-04:00,59.38,59.75999,59.341,59.72,4475504,7099042.8,72.73307353545209,58.055733002190884,NaN,NaN,166.19745738561917,169.28986227331302,0.3642708658745103,0.8051828903312028,0.44091202445669253,271829340,258760585.8,75.4734532905744,41.80175307187757,NaN,NaN,24.334303237546,10.847549980242604
2013-07-15T09:30:00-04:00,59.89999,59.89999,59.55,59.57001,3608323,6942550.95,70.87615370454633,60.32610557686172,NaN,NaN,143.5386622587961,162.1578335689231,0.3464750486598924,0.8740058352815581,0.5275307866216656,268221017,263596702.6,77.19981752431939,46.068741494294144,NaN,NaN,26.887944202220915,13.139034869096648
2013-07-16T09:30:00-04:00,59.59,59.66,59.03,59.25,4794395,6948435.55,66.94888607866517,62.020122958261254,NaN,NaN,106.36440957279854,148.18347501753905,0.2919264925352554,0.8924389022907349,0.6005124097554795,263426622,266204538.8,78.09518997552439,50.6180731238543,NaN,NaN,27.973866556224998,15.258296538686412
2013-07-17T09:30:00-04:00,59.39,59.42,59.17999,59.28,5422496,6986572.05,67.13274982927545,63.34824175699391,NaN,NaN,92.14510064205606,137.22149203628402,0.23887301811563622,0.8991036824000247,0.6602306642843885,268849118,267935986.6,78.69345312329446,55.31273844037118,NaN,NaN,28.91937795607197,17.20987959831292
2013-07-18T09:30:00-04:00,59.38,59.81,59.38,59.62,3148005,6705778.55,69.22246093515417,64.58505900252774,NaN,NaN,94.04888089698042,120.45890215125004,0.20877681859610908,0.9212016875295248,0.7124248689334157,271997123,268864644,79.02435474414898,60.05116432180238,NaN,NaN,30.31720956483555,19.082355307816155
2013-07-19T09:30:00-04:00,59.59,59.75999,59.41,59.57001,5574703,6337372.9,68.53252539174579,65.67459612483732,NaN,NaN,84.45749394033422,104.11090946219306,0.1692833914250248,0.9240291082146967,0.754745716789672,266422420,267783260,77.51469536914544,64.20617889152717,NaN,NaN,31.30541460144008,20.828506635476714
2013-07-22T09:30:00-04:00,59.62,59.71001,59.3,59.53,4161621,5948319,67.94879361903509,66.5338025647956,NaN,NaN,74.71247485366155,90.34567198116613,0.12622134392192863,0.9125223966920828,0.7863010527701542,262260799,266591216.4,75.79575900025739,67.39992391242741,NaN,NaN,31.99181106150349,22.423264410623396
2013-07-23T09:30:00-04:00,59.62,59.74001,59.37,59.45,3842967,5790229.25,66.7249913828074,67.25720066748188,NaN,NaN,70.13341550008664,83.09947316662375,0.0803401856663486,0.8867262848530899,0.8063860991867413,258417832,265589458.4,74.30452303643375,69.84481633253866,NaN,NaN,32.276315337057476,23.830843114399695
2013-07-24T09:30:00-04:00,59.73,59.78999,59.11501,59.25,3852233,5762724.9,63.63911641810289,67.63228088871152,NaN,NaN,59.041552337235444,76.47876350565961,0.02725599834474013,0.8404560971176664,0.8132000987729263,254565599,262732754.6,70.07077084595716,71.5142301240479,NaN,NaN,31.75053474813012,24.962227633504043
2013-07-25T09:30:00-04:00,59.2,59.34,58.96001,59.33,3720859,5639131.15,64.3493511589437,67.77334550471036,NaN,NaN,44.47898603510193,66.56478453328393,-0.009753323297345018,0.8010084446512451,0.8107617679485901,258286458,259990621.6,66.17314670357652,72.46852258011985,NaN,NaN,31.46825764591079,25.89166049241929
2013-07-26T09:30:00-04:00,59.14,59.56,58.94,59.52,3026484,5593030.9,66.04568287282129,67.81399519779794,NaN,NaN,47.747356741106096,59.22275709343829,-0.027704967941285963,0.7761305580219826,0.8038355259632686,261312942,258968726,64.72817572048291,72.89216775406241,NaN,NaN,31.63392183003561,26.711983540650195
2013-07-29T09:30:00-04:00,59.42,59.55,59.09,59.21001,4285254,5407341.45,60.9500711660374,67.40081732961896,NaN,NaN,38.56464596871008,51.993191316448005,-0.06461562348154337,0.7230659966113393,0.7876816200928827,257027688,257922103.8,63.20586668070186,72.88352942941593,NaN,NaN,30.463298435486514,27.247885668483956
2013-07-30T09:30:00-04:00,59.45,59.45,58.99001,59.06,3302393,5088173.2,58.594136406055306,66.79527210809717,NaN,NaN,22.881618321046673,42.54283188064001,-0.10111768026528678,0.6612845197612742,0.762402200026561,253725295,256983596.4,61.802257372007475,72.44533540176809,NaN,NaN,28.830051556475546,27.47390936676847
2013-07-31T09:30:00-04:00,59.27,59.7973,59.27,59.37,5249121,5199087.2,61.873865584966595,66.11227557740061,NaN,NaN,51.68233655909429,41.07098872501178,-0.10586290595083248,0.6300735675880205,0.7359364735388529,258974416,257865359.8,62.64166972596827,71.76593807945652,NaN,NaN,28.212194906570538,27.579378729597337
2013-08-01T09:30:00-04:00,59.86,60.395,59.78,60.28999,4130277,5274579.05,69.57582241769234,65.88675764041777,NaN,NaN,154.58331320013875,63.09185415801918,-0.05128539283586786,0.6718297324940181,0.723115125329886,263104693,258829006.8,63.58352918235893,70.91665778601256,NaN,NaN,29.957142719014147,27.919059299514025
2013-08-02T09:30:00-04:00,60.19,60.75,60.14999,60.72,3738826,5143208.05,72.38396856154515,65.99445870163198,NaN,NaN,230.36536533592033,99.61545587698203,0.006460931131122338,0.7311912892437888,0.7247303581126665,266843519,259935122.2,64.68414443173295,70.0226811365421,NaN,NaN,32.35550802398288,28.552837688723862
2013-08-05T09:30:00-04:00,60.61,60.67999,60.45441,60.59,1827321,4573709.25,70.2722586819595,66.23184245901015,NaN,NaN,212.30935275946837,134.36439723513368,0.027412990942996762,0.7589965967914125,0.7315836058484158,265016198,261532824.2,66.269896783057,69.17801733708015,NaN,NaN,33.668837428636635,29.28369479442569
2013-08-06T09:30:00-04:00,60.47,60.61,59.98,60.34,3169260,4414821.85,66.26839177749022,66.17010259816834,NaN,NaN,141.62789363805084,158.11365229853453,0.01648417779924627,0.7521888280974736,0.7357046502982273,261846938,263157152.8,67.85042989162741,68.40351567767536,NaN,NaN,33.57375691531098,29.896560811695014
2013-08-07T09:30:00-04:00,60.02,60.17,59.64999,59.81,3559318,4102565.85,58.64035381305258,65.4142378037325,NaN,NaN,48.14534863713671,157.40625471414302,-0.031760559078483186,0.6960039514501233,0.7277645105286065,258287620,263019793.6,67.56212119093647,67.58478470958876,NaN,NaN,31.080281605367166,30.06566378221961
2013-08-08T09:30:00-04:00,60.10001,60.38,59.81,60.21001,3020685,3895502.25,62.178865460682914,64.96040495151372,NaN,NaN,86.19924844891149,143.72944176389757,-0.04144167092962181,0.6759624218665792,0.717404092796201,261308305,262660516,66.76302652291608,66.8168083634295,NaN,NaN,30.05907663825606,30.06472276165339
2013-08-09T09:30:00-04:00,60.25999,60.44,59.89,60.08,3123078,3827880.95,60.3710134599796,64.41913494015263,NaN,NaN,75.92432284274474,112.84123326526242,-0.06017453406094542,0.6421859252200193,0.7023604592809647,258185227,260928857.6,62.90138520657226,65.89578166388057,NaN,NaN,28.676195333750083,29.866361700524344
2013-08-12T09:30:00-04:00,59.75999,60.19,59.7,60,3498976,3822413.6,59.229822239005586,63.88376571559535,NaN,NaN,41.377287879452,78.65482028925916,-0.08027018059048374,0.6020227335428601,0.6822929141333438,254686251,258862868.2,58.55013212152253,64.7704680271012,NaN,NaN,27.212638442754304,29.487258377985768
2013-08-13T09:30:00-04:00,60,60.11,59.532,60,3771854,3771286.55,59.229822239005586,63.56881613137411,NaN,NaN,23.133775523785108,54.95599666640601,-0.09487818127099834,0.5636951875445959,0.6585733688155943,254686251,257430730.8,55.675013632056455,63.74219965467972,NaN,NaN,26.019225527758742,28.99182511366762
2013-08-14T09:30:00-04:00,59.75,59.88,59.31,59.34,6380266,3819175.05,50.15801856954802,62.555149517845855,NaN,NaN,-44.12464465845114,36.50199800728844,-0.14718426786511618,0.47459303398419905,0.6217773018493152,248305985,255434403.8,51.85266228045221,62.71930791017083,NaN,NaN,22.120725849807695,28.010239504544774
2013-08-15T09:30:00-04:00,58.9101,58.97,58.1001,58.3,15395805,4431565.05,39.810713344026716,60.681223122931954,NaN,NaN,-194.50655198565633,-19.63916207962511,-0.24429206241755574,0.31641222382737055,0.5607042862449263,232910180,249754778.8,42.841040635039874,61.155941118353475,NaN,NaN,14.717772503824749,26.111315647299058
2013-08-16T09:30:00-04:00,58.11,58.56,58.09,58.09,6454500,4475554.9,38.10148747272726,59.04918143055266,NaN,NaN,-190.1630793826062,-72.8566425246953,-0.3108646965173751,0.17212341559820743,0.4829881121155825,226455680,243408869.4,35.431654741611524,59.17206883698987,NaN,NaN,8.252047792172165,23.559991667995217
2013-08-19T09:30:00-04:00,58.0601,58.36,57.84,57.84,3335000,4434223.85,36.11366992571425,57.44343382481401,NaN,NaN,-186.04584077791264,-118.34126825616822,-0.3566528191521607,0.037172088175381646,0.39382490732754233,223120680,237095755.2,29.892764656351943,56.8928193573002,NaN,NaN,2.3369072758776968,20.528122469121286
2013-08-20T09:30:00-04:00,58.05,58.60001,58.05,58.42999,3474201,4415785.55,43.59291206995234,56.137651430884425,NaN,NaN,-125.32634795895386,-148.03329295271604,-0.33259424026526924,-0.02191789300404423,0.310676347261225,226594881,231477481.2,25.997734929154774,54.27539544324209,NaN,NaN,-0.3207992595722714,17.54970507930792
2013-08-21T09:30:00-04:00,58.27,58.42999,57.74001,57.92999,5249590,4485653.4,39.384790921235954,53.98114918113754,NaN,NaN,-137.44586194845132,-166.69753641071605,-0.3348208583143872,-0.10784972563175899,0.2269711326826282,221345291,226085342.4,22.912050668483587,51.370289835108146,NaN,NaN,-3.9809282545196245,14.473900317332557
2013-08-22T09:30:00-04:00,58.00999,58.72,57.86,58.50999,5790707,4589145.8,45.9078226196771,52.089995899575534,NaN,NaN,-94.42132816335568,-146.68049164625592,-0.2837196041901847,-0.12767837255510273,0.156041231635082,227135998,224930506,22.301537735896858,48.342960785405566,NaN,NaN,-4.841003659600812,11.71462832062779
2013-08-23T09:30:00-04:00,58.61,58.69,58.24001,58.52,2802050,4577924.1,46.01579814695988,50.35739157564699,NaN,NaN,-74.61728863555085,-123.57133349684486,-0.23760106093323197,-0.14096009453145797,0.096640966401774,229938048,225626979.6,23.623321918643143,45.29677686651887,NaN,NaN,-5.469716314472372,9.25972194418491
2013-08-26T09:30:00-04:00,58.60001,58.92,58.37,58.39999,4175777,4572450.25,44.85964661303365,48.82819549247152,NaN,NaN,-61.46166730601129,-98.65449880246459,-0.2047792263314779,-0.1593330665125734,0.045446159818904514,225762271,226155297.8,24.670186758550955,42.212473785584834,NaN,NaN,-6.326093590540689,7.0331768677955395
2013-08-27T09:30:00-04:00,57.78999,58.09,57.41,57.45,6975434,4756102.3,36.946227284905724,47.278615026175316,NaN,NaN,-118.06418454042684,-97.20206611875919,-0.23451273725608215,-0.2476947617511982,-0.013182024495116039,218786837,224593689,23.63881119018457,39.075094499816835,NaN,NaN,-9.775526545999655,4.631933522967655
2013-08-28T09:30:00-04:00,57.41,57.94,57.31,57.75999,3552642,4671278.35,40.62677381918964,45.7391799089258,NaN,NaN,-102.28648656795409,-90.17019104265974,-0.22095256506096891,-0.2893727308213272,-0.06842016576035828,222339479,224792526.6,24.074067907808725,36.02588317016631,NaN,NaN,-11.374957164937992,2.3452348532668488
2013-08-29T09:30:00-04:00,57.64999,58.34,57.58,58.03999,5096902,4719609.6,43.816859017014686,44.55674030585688,NaN,NaN,-73.08122968076877,-85.90217134614235,-0.1823778938060398,-0.296392533017908,-0.11401463921186823,227436381,224852603.2,24.21462401745174,33.26254308522913,NaN,NaN,-11.660040327375777,0.34448125603218793
2013-08-30T09:30:00-04:00,58.13,58.13,57.48,57.67999,5866941,4826015.35,40.78284030095785,43.239098738853464,NaN,NaN,-82.3208566333437,-87.44288494570094,-0.17057439589267331,-0.32723263407770986,-0.15665823818503655,221569440,223178881.6,22.94046294664713,30.71899528702374,NaN,NaN,-12.852369716729903,-1.5407831686481106
2013-09-03T09:30:00-04:00,58.33,58.61,57.86,58.09,8020625,5135680.55,45.418377656527504,42.25256698296217,NaN,NaN,-47.29257157450909,-84.6090657994005,-0.12664029678281974,-0.3149586091635612,-0.18831831238074148,229590065,223944440.4,24.88734538840356,28.51987612676282,NaN,NaN,-12.382445323742079,-3.089592047947249
2013-09-04T09:30:00-04:00,58.00999,58.8,58.00999,58.7,5420828,5248258.95,51.501180609824715,42.34850712869622,NaN,NaN,-16.806257259243903,-64.35748034316391,-0.05181892394922655,-0.2530919673172747,-0.20127304336804813,235010893,227189251.6,32.653786896286334,27.148527885036685,NaN,NaN,-9.964658085001092,-4.071744338954941
2013-09-05T09:30:00-04:00,58.78,59.03,58.66,58.72,5030895,5321837.8,51.69127431404838,43.19711862655492,NaN,NaN,16.92743665050877,-40.514695699471346,0.0009054178252262124,-0.20014127108651536,-0.20104668891174157,240041788,230729713.4,39.949694866651626,26.942003187294667,NaN,NaN,-8.007259426661012,-4.6339607800558085
2013-09-06T09:30:00-04:00,59.02,59.08501,58.07001,58.64999,5952262,5468416.65,50.93861495830157,44.11405630409593,NaN,NaN,5.153762906386577,-24.867697182040278,0.03126957995318366,-0.161959713970262,-0.19322929392344565,234089526,232060342.4,42.47216454975591,27.444896745019264,NaN,NaN,-6.637147157149181,-4.920130262497719
2013-09-09T09:30:00-04:00,58.86,59.27,58.75,59.17,4366152,5530570.35,56.05672846690987,45.53856048560991,NaN,NaN,76.7331642213866,6.9431069889057895,0.0836095034220374,-0.08871741464589888,-0.1723269180679363,238455678,235437590,48.39699993713869,28.76662783650403,NaN,NaN,-3.8567782489208025,-4.768222831986731
2013-09-10T09:30:00-04:00,59.41,59.75999,59.41,59.745,4429566,5577099.85,60.912406425596494,46.775667225298776,NaN,NaN,164.68932762259854,49.339486828327324,0.1502984334448328,0.015546123738104711,-0.13475230970672808,242885244,238096625.8,52.541377815868806,30.662602328412174,NaN,NaN,0.14490301292700597,-4.066347711284768
2013-09-11T09:30:00-04:00,59.67999,60.17999,59.67999,60.17999,5099230,5643468.65,64.14057988698826,48.543937865709665,NaN,NaN,213.8088377948188,95.46250583913987,0.21320742723597275,0.13175697433823785,-0.08145045289773489,247984474,240691342,56.23507231957806,33.04281816063321,NaN,NaN,4.586372592311363,-2.8302448107710356
2013-09-12T09:30:00-04:00,60.10001,60.28,59.79491,60.03999,4258676,5537389.15,62.355625929754495,49.718780959286626,NaN,NaN,199.46341166064448,131.96970084116703,0.2332689754473117,0.21013576641140475,-0.02313320903590696,243725798,241428144,57.25249687791422,35.53931524220588,NaN,NaN,7.649087447374936,-1.3331973453216113
2013-09-13T09:30:00-04:00,60.10001,60.25,59.84,60.21001,5629215,5049059.65,63.67760703573052,50.98033873705595,NaN,NaN,165.32802281822927,164.00455282353556,0.2446760003110701,0.2827117913529307,0.03803579104186058,249355013,244481241.4,61.27035053358809,38.22838871470196,NaN,NaN,10.574480388946235,0.3678994738595096
2013-09-16T09:30:00-04:00,60.92999,61.00999,60.38,60.48,6550125,5053840.9,65.7354067339239,52.471464459976694,NaN,NaN,175.48777738105684,183.7554754554696,0.25588274826825147,0.3578892263771749,0.10200647810892344,255905138,247971133.4,65.28673133352103,41.129570470056954,NaN,NaN,13.668632321907392,2.2680041664377786
2013-09-17T09:30:00-04:00,60.39999,60.89,60.39999,60.83,4240477,5099114.75,68.24683466557589,54.70722213002456,NaN,NaN,150.69542382775035,180.95669469649994,0.2708993330331928,0.44063064440041444,0.16973131136722164,260145615,251423207.6,68.74001961780094,44.35108535774384,NaN,NaN,17.090758426659235,4.385540489326559
2013-09-18T09:30:00-04:00,60.74001,61.74001,60.53999,61.53,9662242,5408516.8,72.5761415910955,56.98931982801785,NaN,NaN,160.28605034376713,170.25213720628963,0.30923540347222966,0.5562755657075087,0.24704016223527905,269807857,255787884.2,72.46919544626945,47.80788018191961,NaN,NaN,21.5899030896058,6.843306575080736
2013-09-19T09:30:00-04:00,61.73,61.75,61.39,61.50999,6338750,5462974.8,72.27279443308078,59.02188664345113,NaN,NaN,150.42119838745182,160.44369455165108,0.3135238694367506,0.6389449990312173,0.3254211295944667,263469107,259736546,75.33583523084121,51.459395268590285,NaN,NaN,25.081814686822746,9.448807733901024
2013-09-20T09:30:00-04:00,61.34,61.5099,60.89999,60.96001,7688328,5557855.85,64.31581356678555,60.702813305295976,NaN,NaN,107.41722087112159,148.86153416222956,0.26171111644488326,0.6525600251505708,0.3908489087056875,255780779,261021699.2,76.20428099159372,55.26395370037218,NaN,NaN,25.734253876203645,11.775300039944256
2013-09-23T09:30:00-04:00,60.83,60.89999,60.22,60.49001,7157184,5775612.55,58.398670481800984,61.62997707852979,NaN,NaN,65.30314504969859,126.8246076959579,0.18195896057977534,0.6182976094304067,0.43633864885063134,248623595,259565390.6,73.0647319079343,58.70519559462438,NaN,NaN,24.428163969091816,13.582852029822478
2013-09-24T09:30:00-04:00,60.53999,60.99001,60.3277,60.64999,3862563,5759951.85,59.75588713492849,62.219598973180055,NaN,NaN,65.66513816020947,109.81855056244972,0.1286647986387079,0.5971696471490162,0.4685048485103083,252486158,258033499.2,69.80677934692582,61.358980769670055,NaN,NaN,23.769421825744296,15.038076286382736
2013-09-25T09:30:00-04:00,60.67999,60.71001,60.19,60.28,5720730,5697216.65,55.26529664581919,62.47488628259225,NaN,NaN,45.453477085776896,86.85203591085168,0.060633062350329836,0.5442961764482206,0.48366311409789076,246765428,253425013.4,60.9953094989071,62.862238957688305,NaN,NaN,21.828961522378755,16.00820274866788
2013-09-26T09:30:00-04:00,60.28,60.87,60.28,60.85001,3516786,5695423.85,60.22453712440365,63.138166437313835,NaN,NaN,57.35777227486194,68.2393506883337,0.04678084498337637,0.5421391703271112,0.49535832534373486,250282214,250787634.8,56.59270081246904,63.870848690739244,NaN,NaN,21.670286311728162,16.817071829105064
2013-09-27T09:30:00-04:00,60.64,60.92999,60.59,60.86,4953309,5688244.2,60.307588301183486,63.441799282619094,NaN,NaN,61.66418593001436,59.088743700112275,0.0317676654690634,0.5350679071800641,0.5033002417110007,255235523,250678583.6,56.41139025044426,64.44330514168963,NaN,NaN,21.568808204534495,17.49589131130927
2013-09-30T09:30:00-04:00,60.23,60.78,60.17,60.63,5381594,5663976.85,57.33914477895601,63.18656630785905,NaN,NaN,37.01770125420884,53.431654941014315,0.0014258269754592323,0.5050825254303248,0.5036566984548656,249853929,250924650.4,56.74811495422519,64.74378636585796,NaN,NaN,20.612967120800057,17.941187855522237
2013-10-01T09:30:00-04:00,60.60001,61.16,60.60001,61.12,6199848,5572938,61.66798365379667,63.00995229120252,NaN,NaN,69.03425788331435,54.10547888563529,0.009012319511074396,0.5149220978437086,0.5059097783326342,256053777,251638174.2,57.76692860283918,64.85320467180517,NaN,NaN,21.067391957112374,18.387788441463684
2013-10-02T09:30:00-04:00,60.89,61.11,60.55,61.10001,5518285,5577810.85,61.394285912467936,62.94128514711061,NaN,NaN,61.5131290149716,57.31740927147423,0.0074069473975971745,0.5151684625796307,0.5077615151820335,250535492,252392187,58.86950474588163,64.96870523380285,NaN,NaN,21.3557619383773,18.811784655308486
2013-10-03T09:30:00-04:00,60.92,61.14999,60.151,60.41,5199152,5586223.7,52.6997347361038,62.157151411422994,NaN,NaN,16.97438713490477,49.2407322434828,-0.04265154418549255,0.45444708495016783,0.4970986291356604,245336340,251403012.2,56.775415183430916,64.64763842307732,NaN,NaN,18.928935908499394,18.828520548621473
2013-10-04T09:30:00-04:00,60.57001,61.07001,60.38,60.98,3969242,5487072.7,57.992149038338376,61.60406157602403,NaN,NaN,42.87995120297846,45.483885298075606,-0.0399472574290855,0.4471645573493035,0.487111814778389,249305582,250217024,54.282229884380065,63.861602605281554,NaN,NaN,18.48040163325907,18.77878927499827
2013-10-07T09:30:00-04:00,60.56,60.71001,60.12,60.12,5309176,5534223.9,49.070953927777744,60.23435580903845,NaN,NaN,-58.29042752727418,26.422259541779,-0.09548225795383136,0.36775899233609977,0.46324125028993113,243996406,249045519.4,51.85968183232314,62.65586419203313,NaN,NaN,14.996072197572657,18.238401121080326
2013-10-08T09:30:00-04:00,60.2,60.2,59.12,59.17,7899516,5707721.4,41.479910398201014,58.01319643811741,NaN,NaN,-214.51010474087906,-30.286612983059683,-0.19013524533281023,0.22557219362391834,0.41570743895672857,236096890,245054142,44.562607154470626,60.66253645690464,NaN,NaN,9.14004527607819,16.938636000365737
2013-10-09T09:30:00-04:00,59.19,59.23,58.45,58.89999,11607887,6033154.25,39.60463967063322,55.67975681222831,NaN,NaN,-274.20767866107036,-97.43077451826807,-0.26051603312173943,0.09006239755455425,0.3505784306762937,224489003,239844844.2,37.20465019163235,57.938880382675435,NaN,NaN,3.9142521191603885,15.078009731622116
2013-10-10T09:30:00-04:00,59.55,60.34,59.55,60.27,6104434,6125442.15,51.56875012177339,54.76925228044172,NaN,NaN,-80.41293000658554,-116.90823794656615,-0.2067379854929302,0.0921559488101309,0.2988939343030611,230593437,236896263.6,33.80249649213398,54.91018148985688,NaN,NaN,3.7118658001383102,13.454274884267287
2013-10-11T09:30:00-04:00,60.2,60.78999,60.14999,60.78999,8827941,6285378.45,55.196557034802275,54.54052989137038,NaN,NaN,1.0814118246650672,-125.26794582222882,-0.13173381221190672,0.1342266690381777,0.2659604812500844,239421378,234919422.8,31.708953024644245,51.95619728390759,NaN,NaN,4.901321700848029,12.232424429493108
2013-10-14T09:30:00-04:00,60.42999,61.05251,60.32001,61.03999,6048848,6260314.6,56.8693203256592,54.33434654785115,NaN,NaN,38.54691802119139,-105.90047671253572,-0.0642872403414696,0.18560143082324743,0.24988867116471702,245470226,235214186.8,32.38144410178866,49.28295905211207,NaN,NaN,6.403075587920959,11.399660309268516
2013-10-15T09:30:00-04:00,60.92,60.95,60.36,60.46001,13368078,6716694.65,52.017238818319456,54.102342417315455,NaN,NaN,2.836106205123591,-62.431234523335185,-0.057934148358417314,0.1774709857166954,0.2354051340751127,232102148,234415238.4,31.47666929357341,47.17448475173109,NaN,NaN,5.965812500681401,10.623396336613213
2013-10-16T09:30:00-04:00,60.86,61.25,60.71001,61.21001,5537988,6510481.95,57.11299560337367,53.88008945152759,NaN,NaN,87.57874908119697,9.926051025118293,-0.005198045403930124,0.22890757732020006,0.23410562272413019,237640136,237045465,37.65285020906404,45.82163828005931,NaN,NaN,7.383230867995112,10.160515555382055
2013-10-17T09:30:00-04:00,60.95,61.7,60.95,61.66,4936203,6440354.6,59.86692127882538,53.84861323564487,NaN,NaN,157.6624830518926,57.541133636813925,0.05471142665505749,0.30249490604295204,0.24778347938789455,242576339,239442045.4,42.718974603296815,44.843608590977354,NaN,NaN,9.465028987789271,10.06116033144023
2013-10-18T09:30:00-04:00,61.87,62.14999,61.67,62.03999,5243258,6318101.1,62.08121343752821,54.187332425542884,NaN,NaN,221.96051826234785,101.71695492435049,0.11138453910087681,0.3870141532639906,0.27562961416311377,247819597,241121689.2,46.02898747033115,44.07795662784207,NaN,NaN,11.879481869206506,10.320920551121127
2013-10-21T09:30:00-04:00,62.14,62.2,61.89999,62.2,3158021,6118142.95,63.00679364916716,54.282961710926486,NaN,NaN,200.09547228709178,134.02666577753058,0.14876578825558356,0.4615868494825932,0.31282106122700964,250977618,242223167.6,48.14516281655643,43.39068764310758,NaN,NaN,14.091800988828357,10.859617756507873
2013-10-22T09:30:00-04:00,62.44,62.83,62.24001,62.62,6774648,6263747.2,65.39455499296216,54.568695216676076,NaN,NaN,210.44226162115527,175.5478968607369,0.18834857148694018,0.5482567755856849,0.3599082040987447,257752266,247353191.2,56.66707658503477,43.23337134590423,NaN,NaN,16.68985952174551,11.692509437256108
2013-10-23T09:30:00-04:00,62.37,62.59,62.00999,62.22,5246930,6240057.2,61.33417346449276,55.185440840132436,NaN,NaN,148.12520058404726,187.65718716130695,0.17447646989839943,0.578003791471744,0.40352732157334453,252505336,250326231.2,60.698202355642,43.5135704296336,NaN,NaN,17.63087783452629,12.540847779723277
2013-10-24T09:30:00-04:00,62.50999,62.89,62.34,62.84,5124246,6320430.2,64.9652898178401,55.683522324382544,NaN,NaN,157.29151335079032,187.5829932210865,0.1925234305119473,0.6441816097132786,0.45165817920133133,257629582,253336879.8,64.3181305660915,44.23042047832728,NaN,NaN,19.582026457810635,13.54673044802147
2013-10-25T09:30:00-04:00,63.17,63.39,62.97,63.31,3882466,6266888.05,67.46000623128147,56.997026060347096,NaN,NaN,165.12928850943504,176.21674727050396,0.21961914002794736,0.7261821042362655,0.5065629642083181,261512048,256075370,67.27107384642443,45.331234193620226,NaN,NaN,22.00725339734945,14.755376583639753
2013-10-28T09:30:00-04:00,63.27,63.3,62.94,63.19,4898718,6242744.25,66.16456946863048,58.76021599394921,NaN,NaN,133.23660946474845,162.8449747060353,0.21281305008932005,0.7725792768199682,0.5597662267306481,256613330,257202512.4,68.42917299744236,47.03598889668964,NaN,NaN,23.583137530623237,16.016485290351678
2013-10-29T09:30:00-04:00,63.39,63.56,63.03,63.56,7715931,6318548.4,68.19272591930431,60.802222154568575,NaN,NaN,127.27866023211483,146.2122544282272,0.2159003668024838,0.8296416852337529,0.6137413184312691,264329261,258517911.4,69.77338244017844,49.36232691444293,NaN,NaN,25.521309952034848,17.374317384877845
2013-10-30T09:30:00-04:00,63.76,63.795,62.88,63.25,5721127,6328690.5,64.69378231808184,61.73972445430489,NaN,NaN,107.17768192014812,138.02275069544737,0.1811387448900894,0.8401647495438809,0.6590260046537915,258608134,259738471,71.00694486438414,52.01978751246081,NaN,NaN,26.14050272754957,18.626629576688092
2013-10-31T09:30:00-04:00,63.26,63.81,63.11,63.41,7640513,6450758.55,65.6727774426177,62.488025912005995,NaN,NaN,101.8353336577086,126.93151475683105,0.154057853318589,0.8515983213020277,0.6975404679834387,266248647,261462284,72.70139164326571,54.94781884236233,NaN,NaN,26.931074854634872,19.812978902109062
2013-11-01T09:30:00-04:00,63.71,63.74,63.21,63.56,4412755,6472934.2,66.60760784136207,63.18361787741334,NaN,NaN,94.42401597480749,112.79046024990552,0.13222141416092514,0.8628172356845951,0.73059582152367,270661402,263292154.8,74.41102063515774,57.9499314518887,NaN,NaN,27.851010142668958,20.961269079331906
2013-11-04T09:30:00-05:00,63.65,63.83,63.46,63.78,4990581,6457004.45,67.98471470229364,64.32415186912579,NaN,NaN,95.94782836670251,105.33270403029636,0.11898267551669739,0.8793241659195417,0.7603414904028443,275651983,267099885.4,77.5602853457087,61.24161831275551,NaN,NaN,29.0124785495399,22.11144186079019
2013-11-05T09:30:00-05:00,63.6,63.91,63.2001,63.78,4016469,6262852.1,67.98471470229364,65.10070323333436,NaN,NaN,87.14880759098381,97.30673350207014,0.09751573391975499,0.882236157802538,0.784720423882783,275651983,269364429.8,79.19982701482243,64.20925951316683,NaN,NaN,29.97746153672206,23.235158957351885
2013-11-06T09:30:00-05:00,64.05,64.205,63.51,63.62,4533561,5909135.8,65.69938897383926,65.51730806869249,NaN,NaN,90.94901311077193,94.0609997401949,0.06158376237595342,0.8617001268527247,0.8001163644767713,271118422,271866487.4,80.8635028916896,66.93386867662346,NaN,NaN,30.22544462837381,24.233771196069302
2013-11-07T09:30:00-05:00,63.81,63.89,62.245,62.3,9667663,6087297.25,50.5901811182845,64.69652004588937,NaN,NaN,22.750062167858793,78.24394544222494,-0.05569984826131513,0.7304915541501273,0.7861914024114425,261450759,270906909.8,78.27763144799394,69.2373432464565,NaN,NaN,25.794409715496762,24.45671955598751
2013-11-08T09:30:00-05:00,62.45,63.32,62.33,63.29,8287187,6060259.55,58.33028579159597,64.36248377034856,NaN,NaN,29.53761163369745,65.26666457400293,-0.07027913492771276,0.6983424837518015,0.7686216186795143,269737946,270722218.6,77.76219670931977,71.35284566736819,NaN,NaN,24.295518332502027,24.4336908097753
2013-11-11T09:30:00-05:00,63.34,63.53,63.12,63.39,5229911,6019312.7,59.02846244621273,63.907762874152176,NaN,NaN,54.933677505161384,57.06383440169468,-0.076358611177605,0.673173354707508,0.7495319658851131,274967857,270585393.4,77.35581556367214,72.83061273727085,NaN,NaN,23.33351868978132,24.276523364061873
2013-11-12T09:30:00-05:00,63.14,63.45,62.98,63.28,4446436,5573230.6,57.879652765443346,63.66101139564865,NaN,NaN,39.0156935918341,47.437211601864746,-0.09001954741731999,0.6370075316134631,0.7270270790307831,270521421,269559281,74.22312296569633,73.79667849513187,NaN,NaN,22.212183293076297,23.981617639635363
2013-11-13T09:30:00-05:00,63.05,64.28,63.004,64.28,6655211,5629091.75,64.62070625103144,63.63639828373375,NaN,NaN,104.68272177707259,50.183953335124876,-0.03667348745480559,0.6811852197122761,0.7178587071670817,277176632,270770923,75.48556312068592,74.59435224903147,NaN,NaN,23.370808855283133,23.89435924187076
2013-11-14T09:30:00-05:00,64.38,64.8,64.28,64.73,5938129,5679188.05,67.16719093503612,63.61548290543051,NaN,NaN,194.55519849253568,84.54498060006024,0.020858642169088393,0.7439320098784421,0.7230733677093537,283114761,275103723.4,79.375503176679,75.45895434404966,NaN,NaN,25.16291715002201,24.07558180017808
2013-11-15T09:30:00-05:00,64.87,64.98,64.62,64.95,5138515,5673950.9,68.36597566970634,63.772726205507354,NaN,NaN,209.07655769435024,120.45276981219081,0.06327298611403209,0.8021646003518939,0.7388916142378618,288253276,278806789.4,82.00382556609102,76.42857238466742,NaN,NaN,26.98936101396096,24.491835973575636
2013-11-18T09:30:00-05:00,65.05,65.09,64.28,64.44,4892979,5760698.8,62.65487025306151,63.37716508649002,NaN,NaN,156.00500287747627,140.66703488665377,0.04725725835855554,0.7979631871860562,0.7507059288275006,283360297,280485277.4,83.05774624626906,77.3774555136739,NaN,NaN,26.754874949923675,24.81512725591107
2013-11-19T09:30:00-05:00,64.48,64.67,64.08,64.16,6360923,5740012.55,59.705902869645094,63.02088798303025,NaN,NaN,101.70834536738329,153.20556524176362,0.010028618380635734,0.7632417018032953,0.7532130834226596,276999374,281780868,83.84422977417422,78.29440443580175,NaN,NaN,25.65467908214921,24.935063231087945
2013-11-20T09:30:00-05:00,64.35,64.5,63.66,63.83,4551735,5705252.8,56.34021215866865,62.354276177033874,NaN,NaN,53.132843362942424,142.8955895589376,-0.04175801763160647,0.7010155613831515,0.7427735790147579,272447639,280835069.4,80.89206933365752,78.8794528422583,NaN,NaN,23.708913160653346,24.759898935311572
2013-11-21T09:30:00-05:00,64.03,64.56,63.94,64.49,3325351,5615308.05,61.06722685241956,61.9585346778237,NaN,NaN,88.99879451249686,121.78430876292983,-0.03667992034134948,0.696923678588071,0.7336035989294205,275772990,279366715.2,76.3948144352442,79.02115239940734,NaN,NaN,23.4683240286361,24.575388234357934
2013-11-22T09:30:00-05:00,64.41,64.87,64.35,64.85,4415233,5641946.4,63.39524360331944,61.630715313611255,NaN,NaN,121.10265089008507,104.18952740207678,-0.015288010308410316,0.7144935860439077,0.729781596352318,280188223,277753704.6,71.68034606440678,78.60115673645721,NaN,NaN,23.987861812368806,24.491455888359486
2013-11-25T09:30:00-05:00,65.02,65.14,64.81,64.91,3329204,5563470.7,63.78393546714665,61.3306596539579,NaN,NaN,134.1001431531739,99.80855545721631,-0.003902772449163372,0.7249031307908638,0.7288059032400271,283517427,277785130.6,71.71696716497652,78.0666667471825,NaN,NaN,24.520198283097763,24.49556194475067
2013-11-26T09:30:00-05:00,64.85,65.47,64.85,65.29,3531630,5354255.65,66.22972748806775,61.36854097640279,NaN,NaN,140.2261182196013,107.5121100276599,0.021044191800776657,0.755111142990998,0.7340669511902214,287049057,279795067.2,74.03005642324709,77.57856342800802,NaN,NaN,25.698434439436213,24.66740087256289
2013-11-27T09:30:00-05:00,65.66,65.695,65.22,65.54,3108804,5223639.5,67.77176820920121,62.595797197182556,NaN,NaN,147.03851731804428,126.2932448186803,0.0448393620630162,0.7901161537689916,0.7452767917059754,290157861,283337111.6,77.51930891690012,77.5243975329299,NaN,NaN,27.139228845563267,25.020519154420086
2013-11-29T09:30:00-05:00,65.69,65.859,65.49,65.6,3499037,5016565.7,68.14769054340171,63.29704039374011,NaN,NaN,142.03726311244466,136.90093853866983,0.05443767392134802,0.8133238841076604,0.7588862101863124,293656898,286913893.2,80.38525009127312,77.71175848878372,NaN,NaN,28.43026684281009,25.50762596704723
2013-12-02T09:30:00-05:00,65.52,65.745,65.16,65.29,4157939,5003824.9,63.99434220756888,63.65174609097984,NaN,NaN,105.93198564221534,133.8668054890959,0.03089790051987429,0.7975085858361552,0.766610685316281,289498959,288776040.4,81.69372068703363,78.0216088547381,NaN,NaN,28.398135812844338,25.920555945018243
2013-12-03T09:30:00-05:00,65.05,65.05,64.41,64.67,4116105,4960101.1,56.56863846229779,63.55810221218373,NaN,NaN,37.34959535633491,114.5166959297281,-0.03203208726047313,0.7265705762406895,0.7586026635011627,285382854,289149125.8,81.95346965904658,78.5737764756917,NaN,NaN,26.17472740132472,25.956866153062027
2013-12-04T09:30:00-05:00,64.39,64.92,64.05,64.52,5417795,5030167.4,54.908590678449016,62.864379671284986,NaN,NaN,13.31803525087127,89.13507933598208,-0.08628489475132528,0.650746545062006,0.7370314398133313,279965059,287732326.2,77.45868658709921,78.71471386614978,NaN,NaN,23.84898159318437,25.655739787365217
2013-12-05T09:30:00-05:00,64.34,64.755,64.32,64.59,4089558,5007967.25,55.56393853964956,62.03557592875738,NaN,NaN,15.936623677773063,62.91470060792784,-0.1180184451557883,0.5895083833685959,0.7075268285243842,284054617,286511677.4,73.70789949403985,78.30988503167555,NaN,NaN,22.099466130352177,25.147700693506213
2013-12-06T09:30:00-05:00,65.24,65.24,64.71,65.13,3923052,4720736.7,60.35121357704662,61.46309292213882,NaN,NaN,61.46614589573869,46.800477164586646,-0.10371054643610855,0.5778886454792485,0.681599191915357,287977669,285375831.6,70.296749178749,77.47366528972256,NaN,NaN,21.885166390332063,24.681624364481333
2013-12-09T09:30:00-05:00,65.16,65.4,64.99,65.08,5286427,4570698.7,59.70976899784531,61.25272854676624,NaN,NaN,72.70500170126489,40.15508037639657,-0.09871084740869107,0.5582106326544931,0.6569214800631842,282691242,284014288.2,66.3338000631189,76.27909770521183,NaN,NaN,21.53126516630214,24.231573050455733
2013-12-10T09:30:00-05:00,65.03,65.275,64.98,65.12,3267290,4472567.65,60.07535442152628,61.27911794332918,NaN,NaN,62.027070766156925,45.09057545836097,-0.09383886837121747,0.5396228945991624,0.6334617629703798,285958532,284129423.8,66.50575563831428,75.04063526693612,NaN,NaN,21.333305417186278,23.817534817131524
2013-12-11T09:30:00-05:00,65.16,65.26,64.41,64.52,5712539,4535872.8,52.39540656705045,60.99734611535645,NaN,NaN,-9.90225826254556,40.446516755677614,-0.1299317660214534,0.47104705544356307,0.6009788214650165,280245993,284185610.6,66.59542363862207,74.01944628871931,NaN,NaN,18.9470361161731,23.121749288423178
2013-12-12T09:30:00-05:00,64.5,64.57,64.22,64.32,3568008,4381512.65,50.09644218934768,60.213718639422744,NaN,NaN,-83.1658815649241,20.62601570713817,-0.1639853991181639,0.39599707256731165,0.5599824716854755,276677985,282710284.2,61.90881899759131,72.98473232888696,NaN,NaN,16.26637488980192,22.142410088620142
2013-12-13T09:30:00-05:00,64.45,64.71,64.41,64.48,3312360,4250224.2,51.91417791501957,59.39364251882991,NaN,NaN,-51.30549297459711,-1.9283120669289915,-0.17162759811217487,0.34544797404525696,0.5170755721574318,279990345,281112819.4,57.213747661358646,71.95140387152638,NaN,NaN,14.49547901443908,21.049991363737135
2013-12-16T09:30:00-05:00,64.72,65.1,64.71,64.9,3486185,4167607.7,56.40335084496372,58.8664579029597,NaN,NaN,17.090062873305854,-13.051299832520797,-0.14533123858031516,0.3354115239320379,0.48074276251235304,283476530,281269877,57.55457381807675,70.93980434674782,NaN,NaN,14.199194635134097,20.071306116793842
2013-12-17T09:30:00-05:00,64.98,65.005,64.49,64.73,3692515,4107584.5,54.19780884020389,58.00703514239799,NaN,NaN,-14.35561372287422,-28.32783673032703,-0.13646252904514145,0.31016460120592626,0.4466271302510677,279784015,280034973.6,53.91777447433627,69.50321277896849,NaN,NaN,13.327019066542986,19.107836538186575
2013-12-18T09:30:00-05:00,64.72,65.74,64.1201,65.69,9749804,4277028.55,62.99718997133245,57.66599383969308,NaN,NaN,61.83773281845025,-13.979838514127863,-0.06655705948570134,0.36343080589394106,0.4299878653796424,289533819,281892538.8,58.19679921073415,68.12303351424234,NaN,NaN,15.315259473344382,18.56603981463769
2013-12-19T09:30:00-05:00,65.64,65.76,65.37,65.65,6007693,4349826.45,62.458755763171,57.25964135539089,NaN,NaN,129.38743023185685,28.530823845228326,-0.02572545826518402,0.3978310425481624,0.4235565008133464,283526126,283262167,61.06737085995845,66.74318499771987,NaN,NaN,16.732736818211276,18.304139386576775
2013-12-20T09:30:00-05:00,65.55,65.835,65.46,65.66,7393491,4553233.45,62.54494372527425,57.15611289236984,NaN,NaN,126.43628502651019,64.0791794454498,-0.0020077377580935973,0.4210468286157294,0.423054566373823,290919617,285448021.4,65.17721693530177,65.5634347297391,NaN,NaN,17.901170727750713,18.246572435315908
2013-12-23T09:30:00-05:00,65.97,65.97,65.64,65.95,3689412,4516942.4,65.05080921631105,57.76198223194222,NaN,NaN,144.208934128861,89.50295369656081,0.027613533677559587,0.4575714834707725,0.4299579497932129,294609029,287674521.2,68.79111717717103,64.62326669531943,NaN,NaN,19.641223946416154,18.445808365473088
2013-12-24T09:30:00-05:00,65.9,66.135,65.9,66.09,1992017,4450083.05,66.22557159617864,58.57033801178005,NaN,NaN,152.89633216592742,122.95334287432115,0.049746654067399754,0.49214126737746255,0.4423946133100628,296601046,291037927.4,73.29907934209669,64.32615189210496,NaN,NaN,21.438190553133087,18.8732915351388
2013-12-26T09:30:00-05:00,66.32,66.59,66.2,66.58,5031382,4525070.65,70.02349832534948,59.60316371075862,NaN,NaN,181.9913017208385,146.9840566547988,0.08824889135609737,0.5527057275051845,0.46445683614908717,301632428,293457649.2,75.98645910936997,64.48890615034283,NaN,NaN,24.20442783707456,19.63488243541534
2013-12-27T09:30:00-05:00,66.69,66.72,66.235,66.27,3142741,4526767.5,65.04047867097134,59.93811121746752,NaN,NaN,150.61266181953994,151.2291029723354,0.08373735496546353,0.5691285298559166,0.485391174890453,298489687,296450361.4,78.82508801554361,65.09807321011387,NaN,NaN,25.10502526349436,20.4163314108552
2013-12-30T09:30:00-05:00,66.42,66.6,66.2901,66.57,2116130,4457622.15,67.45420446806739,60.49128517962624,NaN,NaN,141.6466927134086,154.2711845097151,0.09124004129891938,0.5994412265141023,0.5082011852151829,300605817,298387601.4,80.43717044962466,66.10545680915,NaN,NaN,26.60048092285276,21.299781341140566
2013-12-31T09:30:00-05:00,66.73,66.85,66.545,66.83,3675751,4433512.75,69.42450607940265,61.1590817266174,NaN,NaN,143.33693187254394,154.09678405845168,0.10311904540368633,0.6370999919697908,0.5339809465661045,304281568,300322109.2,81.91761795807625,67.20630411770442,NaN,NaN,28.460506209140895,22.322742036569185
2014-01-02T09:30:00-05:00,66.7,66.83,66.28,66.52,4331892,4444302.1,64.41710848178278,62.01777472052686,NaN,NaN,107.4606083828107,145.00963930182834,0.08050722614046801,0.6346149792416895,0.5541077531012215,299949676,300991835.2,82.41380407341558,68.33618843447539,NaN,NaN,28.561402059679896,23.213979182727858
2014-01-03T09:30:00-05:00,66.56,66.7312,66.31,66.34,3772711,4362047.9,61.63715604990859,62.84211142485265,NaN,NaN,89.35105096615312,126.48158915089127,0.045575379961496076,0.6110769780530916,0.5655015980915955,296176965,299900742.6,78.62835597422531,69.53044107566353,NaN,NaN,27.82789343183566,23.873109789743257
2014-01-06T09:30:00-05:00,66.42,66.5699,65.779,65.93,4078760,4361508,55.73684932856465,63.115159382963,NaN,NaN,48.65009475716364,106.08907573841603,-0.010029173498783739,0.5529651312181159,0.5629943047168996,292098205,298622446.2,74.32125541779278,70.75240591540883,NaN,NaN,25.388104759202516,24.08953764252315
2014-01-07T09:30:00-05:00,66.5199,66.5199,66,66.33,3085657,4319638.25,59.781818738466754,63.35647851821323,NaN,NaN,61.331672479659204,90.02607169166613,-0.02396093060412252,0.5330431414617465,0.557004072065869,295183862,297538055.2,70.7792377802295,71.69702476984831,NaN,NaN,24.504892342760755,24.14887402827138
2014-01-08T09:30:00-05:00,66.29,66.37,65.969,66.15,5789485,4344791.15,57.24657553421221,63.57424756778524,NaN,NaN,44.71935383560089,70.30255608427751,-0.04800229376843679,0.49700120485532295,0.5450034986237597,289394377,294560617,62.03686960481439,72.27696013631103,NaN,NaN,23.007541483927724,23.98582652193657
2014-01-09T09:30:00-05:00,66.32,66.36,65.75,66.14,5081807,4435517,57.101694453139494,63.15314074505717,NaN,NaN,32.93576765748741,55.39758793921284,-0.06616146438497261,0.46230166814254403,0.5284631325275166,284312570,291433195.8,54.43178437264542,72.00803050501898,NaN,NaN,21.755902310443588,23.667265920294714
2014-01-10T09:30:00-05:00,66.23,66.4,65.94,66.34,4630461,4381413.1,59.319207817549724,62.928887320369945,NaN,NaN,43.51809600198744,46.230996946379705,-0.06612935217711724,0.44580144230612007,0.5119307944832373,288943031,289986409,51.29875898075861,71.31027251364756,NaN,NaN,21.30789442167493,23.330212849063315
2014-01-13T09:30:00-05:00,66.3,66.3,64.91,65.01,6980672,4552046.3,43.29247892235694,61.553711263018705,NaN,NaN,-61.42839630521747,24.21529873390348,-0.15218728316446245,0.32169669052765926,0.4738839736921217,281962359,287959239.8,47.19938250311387,70.02614148277699,NaN,NaN,15.204046093157816,22.169331883933957
2014-01-14T09:30:00-05:00,65.33,65.61,64.99,65.57,6090580,4690957.3,49.48148860710969,60.44161693379004,NaN,NaN,-76.39121284719167,-3.3292783314666936,-0.16673123622087782,0.26546992841602446,0.4322011646369023,288052939,286533055.2,44.50481906509377,68.2914059033429,NaN,NaN,12.271265731665368,20.755322433609873
2014-01-15T09:30:00-05:00,65.66,65.92,65.615,65.73,5854961,4809396.1,51.1228456082232,59.36285079179322,NaN,NaN,-35.0028521578282,-19.273719530152512,-0.16083624662769147,0.23115585635228797,0.39199210297997944,293907900,287435759.8,46.583473682810556,66.38314835625104,NaN,NaN,10.530681550283198,19.29465945027749
2014-01-16T09:30:00-05:00,65.7,65.7,65.24,65.38,6331984,4941369.55,47.48813089916957,57.75318168992323,NaN,NaN,-99.72001760982116,-45.80487658361422,-0.17461997905242804,0.17371712916444437,0.3483371082168724,287575916,288088429,48.097208923550916,64.39105905726396,NaN,NaN,7.893129631186975,17.665869476121703
2014-01-17T09:30:00-05:00,65.34,65.4775,64.97,65.09,5586903,4733224.5,44.655163176030186,56.29708772599885,NaN,NaN,-144.97577341607203,-83.50365046722611,-0.19578833308425325,0.10360169186155588,0.29939002494580913,281989013,286697625.4,45.16031276363604,61.98643225355628,NaN,NaN,4.811697246882112,15.829559157658904
2014-01-21T09:30:00-05:00,65.31,65.48,64.624,65.03,10439316,4954805.65,44.069387278294506,54.62674364101508,NaN,NaN,-150.65731210673405,-101.34943362752942,-0.20535124088504614,0.042700973839501444,0.24805221472454758,271549697,284615093,41.11222141562337,59.17750732255619,NaN,NaN,2.183227030907432,13.880083139551552
2014-01-22T09:30:00-05:00,65.14,65.25,64.9,65.2,4635912,4816926.7,46.22190905209889,52.969415281921954,NaN,NaN,-125.1897524037644,-111.10914153884396,-0.1919926766998818,0.008061368849695327,0.20005404554957712,276185609,282241627,37.037389803382254,55.97177674007804,NaN,NaN,0.6453021196571285,11.989400136709492
2014-01-23T09:30:00-05:00,65.02,65.08,64.4301,64.74,7973002,5031106.2,41.560933127734,51.33683132806133,NaN,NaN,-149.43674610864733,-133.9959203290078,-0.2047351940040009,-0.05586494695542399,0.1488702470485769,268212607,277102568.4,30.08448162183298,52.23396799353643,NaN,NaN,-2.1364819199552776,9.971416985757381
2014-01-24T09:30:00-05:00,64.35,64.45,63.48,63.5,8622240,5362617.35,32.1495673869765,49.23057499499475,NaN,NaN,-211.90901518174164,-156.43371984339188,-0.28248052456750594,-0.20423040866080555,0.07825011590670042,259590367,271505458.6,24.65563825553201,48.378773870772626,NaN,NaN,-8.234181849403994,7.3706171521628985
2014-01-27T09:30:00-05:00,63.62,63.77,62.72,63.25,7217942,5471945.35,30.642956726476,47.43815409484556,NaN,NaN,-217.81663958147482,-171.00189307647244,-0.33306950303709937,-0.33808676288967376,-0.005017259852574424,252372425,265582141,20.449903189648907,44.530820140190926,NaN,NaN,-13.558148723608312,4.380793455624154
2014-01-28T09:30:00-05:00,63.5,63.89,63.46,63.69,4731711,5551393.85,36.300875606929935,45.760943871164365,NaN,NaN,-153.4325918881268,-171.556949032751,-0.31919212746985665,-0.40400741918989524,-0.0848152917200386,257104136,262693028.8,18.7682603825251,40.81575032606918,NaN,NaN,-16.042063556739624,1.4632424538579003
2014-01-29T09:30:00-05:00,63.14,63.37,62.57,62.67,17415039,6316339.3,30.158832622024732,43.826105091722404,NaN,NaN,-184.82437408249177,-183.48387336849646,-0.35808225082101514,-0.5324181052463075,-0.17433585442529237,239689097,255393726.4,15.336800683948937,37.48003111743593,NaN,NaN,-20.500169728757534,-1.6743878579443048
2014-01-30T09:30:00-05:00,63.11,63.91,63.11,63.72,12737061,6769404.8,41.18998431431927,42.689554367520955,NaN,NaN,-114.82480661495018,-176.56148546975706,-0.2950886297041749,-0.543196641555511,-0.24810801185133607,252426158,252236436.6,14.133121503162968,34.60155519818718,NaN,NaN,-20.09095505715631,-4.305326029260305
2014-01-31T09:30:00-05:00,62.71,63.31,62.43,62.82,6825696,6894095,35.94877655595202,41.0202378488354,NaN,NaN,-141.06047408614492,-162.3917772506377,-0.2953103588489455,-0.617245960412518,-0.3219356015635725,245600462,249438455.6,13.148293554668143,31.876521953466433,NaN,NaN,-21.775330281410245,-6.8010409224245825
2014-02-03T09:30:00-05:00,62.82,62.96,61.0301,61.17,32477653,8329342.1,28.730824990355913,39.98011971083533,NaN,NaN,-176.56790685675895,-154.1420307056945,-0.38233279726496905,-0.7998515981447838,-0.41751880087981474,213122809,241588532.4,10.861541541626579,29.28096188478877,NaN,NaN,-26.265372401559624,-9.58165970515816
2014-02-04T09:30:00-05:00,61.63,62.04,61.4233,61.92,9495172,8600162.7,35.108731051003076,38.953494171113434,NaN,NaN,-144.16014955501385,-152.28754223907194,-0.3651645716781762,-0.8739745154775349,-0.5088099437993587,222617981,234691301.4,9.326675152499888,26.76823731960349,NaN,NaN,-27.09696894026021,-12.083846738744167
2014-02-05T09:30:00-05:00,61.76,62.15,61.1101,62,7747759,8833267.8,35.769020471432384,37.85679237562838,NaN,NaN,-127.01593922422778,-140.72585526741915,-0.3255171939911955,-0.9157064362883531,-0.5901892422971576,230365740,232826630,8.958115338731972,24.08071172359788,NaN,NaN,-27.457650657111866,-14.280104441368124
2014-02-06T09:30:00-05:00,62.2,63.355,62.2,63.31,8293726,8958479.85,45.54102247020396,37.71771320213083,NaN,NaN,-60.09849284096024,-129.78059251262113,-0.19462105428769927,-0.8334655601567817,-0.6388445058690825,238659466,230073291.6,8.428485277543984,21.247231463168813,NaN,NaN,-24.0122043518524,-15.670404428580163
2014-02-07T09:30:00-05:00,63.75,64.17,63.45,64.09,6270495,9017914.25,50.381524525914976,38.12673901283689,NaN,NaN,-6.637305836799624,-102.89595886275208,-0.04677353134626816,-0.6973114200519177,-0.6505378887056495,244929961,229939191.4,8.402428822100262,18.621668324487683,NaN,NaN,-19.456038138887486,-16.211209244338352
2014-02-10T09:30:00-05:00,64.18,64.18,63.76,64.05,4670525,9019917.45,50.135422224779234,38.56002722330008,NaN,NaN,5.177912338005472,-66.54679502379919,0.05172450075556312,-0.5858822627611957,-0.6376067635167588,240259436,235366516.8,19.279032002072498,17.062154794948338,NaN,NaN,-16.13995712691712,-16.201030370421034
2014-02-11T09:30:00-05:00,64.24,64.725,64.1,64.52,5647364,8953252.05,53.038186559943796,39.046904188146144,NaN,NaN,37.50605434433275,-30.213554243929885,0.14655691640159163,-0.45441061801476934,-0.600967534416361,245906800,240024280.6,27.261711419225023,16.363892053222823,NaN,NaN,-12.493317982723545,-15.671357172178535
2014-02-12T09:30:00-05:00,64.65,64.83,64.4,64.58,4223261,8859886.1,53.41104218868191,39.893340549642424,NaN,NaN,51.95536724012777,5.580707048941238,0.20762124771346624,-0.34144097477452817,-0.5490622224879944,250130061,243977144.8,33.29099749344557,16.59292890119515,NaN,NaN,-9.522622964173097,-14.792966571034901
2014-02-13T09:30:00-05:00,64.21,64.92,64.2,64.78,6584447,8896360.4,54.70207587259827,41.50423401290113,NaN,NaN,60.86937692887436,29.774281002908168,0.25278056692328976,-0.23308651383388224,-0.485867080757172,256714508,247588153.2,38.32071324946264,17.56900568647591,NaN,NaN,-6.716643040483042,-13.63920606667035
2014-02-14T09:30:00-05:00,64.75,65.41,64.68,65.17,4828485,8821185.45,57.19315266943642,43.40067658025544,NaN,NaN,95.64196188437931,50.23013454714395,0.2971528246246959,-0.11442604997630212,-0.411578874600998,261542993,250910759.6,42.608577862033485,19.151768163074813,NaN,NaN,-3.608920165569412,-12.206308080798788
2014-02-18T09:30:00-05:00,65.5,65.5,64.97,65.25,3578177,8720749.15,57.70694537375357,44.92968156359999,NaN,NaN,106.09378990758145,70.41331006105915,0.3182449531715347,-0.013772683136579644,-0.3320176363081143,265121170,255883106.4,48.390815247824676,21.26766493916764,NaN,NaN,-0.9220099239930009,-10.59426548696939
2014-02-19T09:30:00-05:00,65.17,65.37,64.61,64.72,6304394,8514003.05,53.15507398925992,46.57227023268822,NaN,NaN,82.90917772539744,79.4939347372721,0.28398574399242743,0.022964543682419958,-0.2610212003100075,258816776,258465101.6,51.14346104650868,23.825283536493338,NaN,NaN,0.1448581399475961,-9.060104968838392
2014-02-20T09:30:00-05:00,64.92,65.17,64.65,65.07,4698682,8517141.55,55.64334425280754,47.604653085437384,NaN,NaN,88.67485451974264,86.83783219319506,0.2723415962207094,0.0794057949658793,-0.19293580125483012,263515458,261142181,53.88954162802029,26.665027831126,NaN,NaN,1.7628869506766902,-7.5139632660505224
2014-02-21T09:30:00-05:00,65.31,65.41,65.08,65.2,4375154,8337249.15,56.56617709027384,49.07732455217465,NaN,NaN,103.8193777727462,95.42783236196942,0.260821928653124,0.13309160956157484,-0.12773031909154914,267890612,263377401.8,56.107846971021466,29.733567360865525,NaN,NaN,3.3645889611028186,-5.959884376457188
2014-02-24T09:30:00-05:00,65.26,65.9,65.25,65.47,3215402,8066907.25,58.4974520080944,51.20351219629883,NaN,NaN,110.5058560807992,98.4006112012534,0.2583241698753638,0.19517489325265558,-0.0631492766227082,271106014,265290006,57.97104836853019,33.09853213421578,NaN,NaN,5.266446563284015,-4.3561228136370165
2014-02-25T09:30:00-05:00,65.58,66.01,65.47,65.93,4538261,7932923.2,61.627925787524724,53.09774039176466,NaN,NaN,113.85120448476486,99.95209411669009,0.27314868847473567,0.2782865839707114,0.005137895495975722,275644275,267394627,59.98402969619189,36.716914601622356,NaN,NaN,7.820800119863653,-2.6165623945654923
2014-02-26T09:30:00-05:00,66.09,66.69,65.97,66.3,5488426,7970758.95,63.98130472845316,55.112903552980434,NaN,NaN,127.45186371555367,108.86063131472133,0.2916871983275554,0.36974689340542,0.07805969507786459,281132701,271857812,63.929502010235595,40.64344222101547,NaN,NaN,10.69968159453412,-0.7142418246941193
2014-02-27T09:30:00-05:00,66.27,66.61,66.06,66.57,4386738,7319343.9,65.6374873503332,56.548365330132526,NaN,NaN,120.7625694860534,115.2781743079835,0.3045351661171286,0.4587286527242753,0.15419348660714674,285519439,276258608.2,67.3480795101937,44.851984666204736,NaN,NaN,13.624728343707709,1.33418248507757
2014-02-28T09:30:00-05:00,66.57,67.068,66.32,66.84,6994029,7032192.3,67.25877421593171,57.75388316513372,NaN,NaN,126.18502838530515,119.7513044304953,0.3124488034390951,0.5447544909060156,0.2323056874669205,292513468,281183179.4,70.69507933067642,49.3014597025316,NaN,NaN,16.586283002627624,3.513053987584721
2014-03-03T09:30:00-05:00,66.16,66.42,65.71,66.21,8668776,7124346.3,60.12981268366922,58.46776819791158,NaN,NaN,85.8481303103503,114.8197592764055,0.2587068206119159,0.5556892132318154,0.2969823926198995,283844692,283730915,72.27828615460015,53.08712071342644,NaN,NaN,17.217280214209776,5.4708005913883
2014-03-04T09:30:00-05:00,66.89,67.14,66.8201,67.04,4391050,5720016.15,65.34182298093944,59.34659937083984,NaN,NaN,130.29207433803325,118.10793324705915,0.2617216770859241,0.6241344889773046,0.3624128118913805,288235742,286249208.4,73.78582972949246,56.41027202130268,NaN,NaN,19.39040864443719,7.459316027538141
2014-03-05T09:30:00-05:00,67.18,67.32,67.05,67.32,7568065,5623660.8,66.91318611494182,60.311038222715545,NaN,NaN,136.4240561513662,119.90237173422165,0.2644563453703947,0.6929832436043739,0.4285268982339792,295803807,289183429.6,75.46034624481493,59.422368360686214,NaN,NaN,21.66634212574294,9.48889118442454
2014-03-06T09:30:00-05:00,67.43,67.63,67.23,67.49,5255272,5499036.45,67.86579361476356,61.25130377572736,NaN,NaN,138.14236174291293,123.37833018559357,0.2592493487704503,0.7525885841970421,0.4933392354265918,301059079,292291357.6,77.1269779872835,62.1942444133877,NaN,NaN,23.82036486401678,11.53624456722343
2014-03-07T09:30:00-05:00,67.85,67.85,67.24,67.39,4339868,5301343.55,66.65017840293942,61.92680561383471,NaN,NaN,126.75140869351671,123.49160624723586,0.23151597890512,0.7827342090579918,0.5512182301528719,296719211,293132506.2,77.57096299620594,64.69155763725716,NaN,NaN,25.260699095726093,13.496880928438097
2014-03-10T09:30:00-04:00,67.36,67.37,66.86,67.21,3274540,5151545.8,64.41362076622198,62.40585385615389,NaN,NaN,92.77221760805887,124.87642370677759,0.18548425890878484,0.7830735537888529,0.5975892948800681,293444671,295052502,78.59243005539257,66.84881583779773,NaN,NaN,25.866882143309827,15.264023959134057
2014-03-11T09:30:00-04:00,67.47,67.47,66.63,66.82,4390168,5137527.95,59.73633267467227,62.87594376225477,NaN,NaN,72.81918494020648,113.38184582721223,0.1165720808269256,0.7433043959137251,0.6267323150867995,289054503,295216254.2,78.68160437492968,68.81582607554209,NaN,NaN,25.08913710345245,16.667611551179544
2014-03-12T09:30:00-04:00,66.46,66.78,66.15,66.72,4786430,5094481.25,58.56210274172391,63.084426511463086,NaN,NaN,36.89074769960688,93.47518413686036,0.05517279628703475,0.6956983104455929,0.6405255141585582,284268073,292909107.4,74.00423391625372,70.2525898104159,NaN,NaN,24.11667922875777,17.73176407654786
2014-03-13T09:30:00-04:00,67.08,67.08,65.61,65.91,11268229,5446729.65,49.99033593620168,62.6147235718865,NaN,NaN,4.11989795828335,66.67069137993444,-0.04373519145018778,0.5858565248458234,0.6295917162960112,272999844,287297260.4,64.03302417977125,70.81867389675517,NaN,NaN,20.633295187894078,18.146268521025892
2014-03-14T09:30:00-04:00,65.84,66.23,65.68,65.85,4786069,5356810.75,49.41337144351919,61.965860674416845,NaN,NaN,-27.536862618233894,35.81303711758434,-0.11300505832099839,0.4883353933947632,0.6013404517157616,268213775,281596173.2,55.806562129189395,70.66406773680225,NaN,NaN,17.6173137044151,18.07070354722435
2014-03-17T09:30:00-04:00,66.14,66.475,66.12,66.29,3231458,5276959.4,53.63909467660792,61.39522988077994,NaN,NaN,1.904072042830468,17.63940800453866,-0.12790069103882995,0.4414645879172241,0.569365278956054,271445233,277196285.6,50.42258984580835,69.98110774748915,NaN,NaN,16.163002367477908,17.798174807260573
2014-03-18T09:30:00-04:00,66.44,66.6999,66.31,66.58,3222886,5259194.85,56.23406011231169,60.84185526534126,NaN,NaN,20.608172487958395,7.197205514089039,-0.11721589153873846,0.422845414532631,0.5400613060713695,274668119,274319008.8,47.21469945328941,68.78719327913585,NaN,NaN,15.661520522561245,17.492938480874955
2014-03-19T09:30:00-04:00,66.61,66.65,65.76,66.14,6058045,5246877.4,51.52199083016109,59.833605513900395,NaN,NaN,-26.950095794175116,-5.5709631846673595,-0.13737762340511261,0.3683392768149787,0.5057169002200913,268610074,271187409,43.938229276941115,67.11506111961782,NaN,NaN,13.828665413081072,16.969470899761543
2014-03-20T09:30:00-04:00,66.09,66.44,65.7725,66.31,3761794,5200033,53.15524627564799,58.826210661022984,NaN,NaN,-39.40842820119113,-14.276628416562255,-0.13657456591408657,0.33499869282748307,0.47157325874156963,272371868,271061813.8,43.80692971588613,65.19447900427565,NaN,NaN,12.763520616216143,16.368620859255056
2014-03-21T09:30:00-04:00,66.52,66.54,65.62,65.68,6231071,5292828.85,46.855203755356904,57.87802430900068,NaN,NaN,-80.29400072269203,-24.828056037453884,-0.17341613220220176,0.25480309348881747,0.4282192256910192,266140797,270647218.2,43.34644991112548,63.12791927259889,NaN,NaN,9.880628490872269,15.441764806628944
2014-03-24T09:30:00-04:00,65.75,65.93,64.71,65.02,12355521,5749834.8,41.328849386523586,56.162811909399544,NaN,NaN,-177.62966628702804,-60.734803703425584,-0.23344060306567027,0.1364184718589314,0.3698590749246017,253785276,267115226.8,39.533887783651096,60.68135199075308,NaN,NaN,5.545600811384532,14.0280270930226
2014-03-25T09:30:00-04:00,65.18,65.42,64.299,64.63,5861185,5815981,38.44343347360066,54.12925814930376,NaN,NaN,-211.37956397877483,-107.13235099677222,-0.2870862598557296,0.011001250104939686,0.2980875099606693,247924091,261766421.2,34.574369217602325,57.76092506023789,NaN,NaN,0.9838416711991276,12.164572032762104
2014-03-26T09:30:00-04:00,64.92,64.98,64.09,64.11,6956676,5889393.5,34.94067773920922,51.77746415819273,NaN,NaN,-210.78546942535885,-143.89942572300896,-0.3415635742270775,-0.12886695782317759,0.21269661640389992,240967415,256237889.4,30.33799298200833,54.418854702718235,NaN,NaN,-4.059676175951509,9.84682228866016
2014-03-27T09:30:00-04:00,64,64.17,63.53,63.8,6352873,5987700.25,33.00972088516454,49.37457433549452,NaN,NaN,-216.29810045183626,-179.277360173138,-0.37952616274106693,-0.26171108702243373,0.11781507571863319,234614542,248686424.2,25.70497902782047,50.71414156211927,NaN,NaN,-8.842204597335403,7.176961304946508
2014-03-28T09:30:00-04:00,64.01,64.66,63.95,64.28,5683705,5922184.05,38.66213684973285,47.535182627173874,NaN,NaN,-145.28879964744922,-192.27631995808946,-0.3538666080998793,-0.32451818440621594,0.029348423693663347,240298247,243517914.2,23.10429117165937,46.750703070424045,NaN,NaN,-11.141264321431759,4.560071929749613
2014-03-31T09:30:00-04:00,64.66,64.92,64.6301,64.72,5679002,5772695.35,43.378425640841066,46.36676069618593,NaN,NaN,-93.48182856730519,-175.44675241414487,-0.2914212159224472,-0.3349280962093957,-0.04350688028694846,245977249,241956308.8,22.367935720016064,42.72829816650164,NaN,NaN,-11.58766283843809,2.25325267715137
2014-04-01T09:30:00-04:00,64.91,65.67,64.77,65.62,5074895,5806887.6,51.57957726199923,45.86800887620559,NaN,NaN,-43.50661866656439,-141.8721633517028,-0.17917233082578685,-0.267472293819182,-0.08829996299339518,251052144,242581919.4,23.420921420903824,39.115204416833784,NaN,NaN,-9.20043761616596,0.6170112066774658
2014-04-02T09:30:00-04:00,65.67,66.17,65.6501,66.06,5043445,5680656.6,55.010411765870415,46.226585721181934,NaN,NaN,6.8513545566173475,-98.34479855530753,-0.07053960863194761,-0.1764744737833297,-0.10593486515138209,256095589,245607554.2,28.473851305394575,36.57526349723545,NaN,NaN,-6.084389539943983,-0.34033175712559827
2014-04-03T09:30:00-04:00,66.23,66.25,65.42,65.74,5369703,5686378.15,52.11812114910676,46.4197821287239,NaN,NaN,1.073984051749023,-54.87038165459048,-0.018208784557999264,-0.12869584584888116,-0.1104870612908819,250725886,248829823,33.505914600634085,34.982360102338646,NaN,NaN,-4.475787422422271,-0.9311111378822657
2014-04-04T09:30:00-04:00,66.15,66.15,64.53,64.65,7400075,5839388.5,43.69147199220825,45.70923765126679,NaN,NaN,-49.086782942242735,-35.62997831354919,-0.05300826738343914,-0.17674739552018082,-0.12373912813674168,243325811,249435335.8,34.43932135620726,33.84069806736714,NaN,NaN,-5.943218158144301,-1.6471264264911278
2014-04-07T09:30:00-04:00,64.4,64.48,63,63.39,7595407,6055431.85,36.370844940755795,44.29043656758422,NaN,NaN,-154.30200613791735,-47.794013827671634,-0.15132327847092528,-0.3128932262253983,-0.161569947754473,235730404,247385966.8,32.76301533213838,32.80843491585635,NaN,NaN,-9.980021377162183,-2.837539990872707
2014-04-08T09:30:00-04:00,63.34,64.09,63.21,64.03,4750510,6073448.95,41.71301049548503,43.58979511510735,NaN,NaN,-126.32991961353407,-64.35867401706555,-0.1626962992189755,-0.36494032177819236,-0.20224402255921686,240480914,245271720.8,31.082161414266224,31.89014435423672,NaN,NaN,-11.250363433674377,-4.039371911272946
2014-04-09T09:30:00-04:00,64.17,64.74,63.9301,64.72,3845808,6026417.85,46.89015210452209,43.14228838859837,NaN,NaN,-63.5441345960834,-78.4377718476057,-0.11541787126099917,-0.34651636163546584,-0.23109849037446667,244326722,242917947.4,29.281104735843584,30.852585427090826,NaN,NaN,-10.40498430045624,-4.948745109727702
2014-04-10T09:30:00-04:00,64.63,64.72,63.06,63.11,10075515,5966782.15,38.334233053504136,42.53364762418031,NaN,NaN,-117.33342788348976,-102.11925423465345,-0.1803738309443339,-0.45656577905488405,-0.27619194811055015,234251207,239623011.6,26.928767241412473,29.679893807825614,NaN,NaN,-12.976997312776328,-6.095638281591792
2014-04-11T09:30:00-04:00,62.54,63.09,62.12,62.24,8446219,6149789.65,34.65445091182772,42.056904875987755,NaN,NaN,-176.04889917511966,-127.51167748122884,-0.264634852046891,-0.6069855131691639,-0.3423506611222729,225804988,236118847,24.659820469621707,28.617460428252087,NaN,NaN,-16.42187093722457,-7.570814375253617
2014-04-14T09:30:00-04:00,62.72,63.0099,62.22,62.73,4701379,6223285.7,38.24975418502348,42.043070641089386,NaN,NaN,-145.74256562632502,-125.79978937891038,-0.2691836305349527,-0.6788301992909638,-0.4096465687560111,230506367,235074039.6,24.010228636567078,27.86287895817814,NaN,NaN,-17.773452763920687,-9.028334145063198
2014-04-15T09:30:00-04:00,62.94,63.15,61.84,62.81,9694505,6546866.65,38.841391698408906,42.321693066746505,NaN,NaN,-133.2290310637606,-127.17961166895569,-0.24908358337116748,-0.7210010479699704,-0.47191746459880296,240200872,235018031.2,23.973770991894497,27.40829167317001,NaN,NaN,-18.600144837084866,-10.395735672494865
2014-04-16T09:30:00-04:00,63.61,63.7,63.083,63.69,4754310,6481679.9,45.07532145881867,43.183521679150374,NaN,NaN,-65.75103174504316,-127.62099109874764,-0.16296596457693258,-0.6756249203199687,-0.5126589557430361,244955182,235143723.2,24.251744942191735,27.304489238482244,NaN,NaN,-17.18052790315482,-11.364991705446288
2014-04-17T09:30:00-04:00,63.5,63.9801,63.5,63.77,4953543,6541267.35,45.61801093127795,43.680369827832166,NaN,NaN,-41.26572840236017,-112.40745120252173,-0.09066693739366571,-0.6259926274851182,-0.5353256900914525,249908725,238275226.8,31.01882336270893,27.869812966414354,NaN,NaN,-15.903419350596565,-12.013338511896327
2014-04-21T09:30:00-04:00,63.75,64,63.57,63.94,10586605,6759044.05,46.82047455808676,43.92623046477829,NaN,NaN,-28.68852293044497,-82.93537595358677,-0.02486893216103725,-0.5664118552927491,-0.5415429231317118,260495330,245213295.2,43.13910273031447,29.353467752864244,NaN,NaN,-14.510819755777908,-12.370121546736552
2014-04-22T09:30:00-04:00,64.11,64.75,64.11,64.49,4675803,6375058.15,50.62436504427697,43.858001020655266,NaN,NaN,25.289016624785745,-48.72905950336464,0.05771251187589188,-0.46940228328684697,-0.5271147951627388,265171133,252146248.4,52.18077813596944,31.407743232511788,NaN,NaN,-12.16762604494432,-12.34119361790909
2014-04-23T09:30:00-04:00,64.42,64.67,64.12,64.19,2827017,6223349.75,48.58304307197351,43.3989032568055,NaN,NaN,17.249906834721983,-18.63327192366811,0.09210788171671458,-0.4119799430168456,-0.5040878247335602,262344116,256574897.2,56.89588550891398,33.437888532763175,NaN,NaN,-10.816665779499736,-12.123403926707754
2014-04-24T09:30:00-04:00,64.45,64.77,64,64.54,3683664,6059699.15,51.06232941086344,43.32348956121668,NaN,NaN,26.61107875027578,-0.16084982460432967,0.13576964063563562,-0.33437577393901563,-0.47014541457465125,266027780,260789416.8,60.8519282724185,35.39117522360492,NaN,NaN,-8.955911547409997,-11.670905015379503
2014-04-25T09:30:00-04:00,64.11,64.11,63.352,63.44,4735534,5978832.2,43.89801659475676,43.338242747113,NaN,NaN,-42.01588016013682,-0.31088017615966523,0.09010551214875495,-0.35751352438870754,-0.4476190365374625,261292246,263066121,62.83621923136766,37.41952507183066,NaN,NaN,-9.465678642645925,-11.355872676417563
2014-04-28T09:30:00-04:00,63.71,63.85,62.49,63.28,9346712,6161982.55,42.95397898110835,43.808466607138186,NaN,NaN,-71.22773990873111,-8.818723571816893,0.05063067233756591,-0.3843306961155051,-0.434961368453071,251945534,261356161.8,60.36153891142475,39.39084818463683,NaN,NaN,-10.159419933752277,-11.184950856036808
2014-04-29T09:30:00-04:00,63.48,63.645,63.02,63.57,4410227,6098543.8,45.25210847657594,44.06125932007325,NaN,NaN,-49.62747271347913,-23.802021439469865,0.04570704626797584,-0.3778275606181012,-0.423534606886077,256355761,259593087.4,57.83252740469471,41.30158861252458,NaN,NaN,-10.071742343547376,-11.025921068538318
2014-04-30T09:30:00-04:00,63.36,63.93,63.28,63.84,7794580,6234528.05,47.377651101177364,44.096080676977195,NaN,NaN,-21.78789298824436,-31.609581404063135,0.06131702733748445,-0.34688832271422143,-0.4082053500517059,264150341,259954332.4,58.21879418543846,43.36856643035278,NaN,NaN,-9.39312224407451,-10.792664093614917
2014-05-01T09:30:00-04:00,63.92,64.38,63.875,64.09,4175258,6191118.7,49.33892282922712,44.8821299466717,NaN,NaN,32.58951472822958,-30.413894208472374,0.08756266737295021,-0.29875201583551814,-0.38631468320846835,268325599,260413896.2,58.736643011887125,45.64055755681526,NaN,NaN,-8.27161676843216,-10.432514475731667
2014-05-02T09:30:00-04:00,64.17,64.625,64.09,64.25,4111540,6128210.55,50.60771734574787,46.021648977666,NaN,NaN,74.92330935627771,-7.026056305189461,0.11315552980715915,-0.2448702709495194,-0.35802580075667856,272437139,262642874.8,61.24557069281525,48.253825429900516,NaN,NaN,-6.9826671662091,-9.939679145799872
2014-05-05T09:30:00-04:00,63.94,64.36,63.69,64.31,3347950,5925604.3,51.10228012998983,46.93968654516359,NaN,NaN,60.904444274998674,19.400380531556497,0.1303579530250888,-0.1950783594753176,-0.3254363125004064,275785089,267410785.8,66.00683328867083,51.253582905050784,NaN,NaN,-5.772853091472477,-9.344418280895958
2014-05-06T09:30:00-04:00,64.1,64.23,63.39,63.39,4197695,5755718.7,43.85173906261766,47.297568499749936,NaN,NaN,-4.8177088085395585,28.36233331254441,0.07856120935638744,-0.2272348008049221,-0.30579601016130953,271587394,270457112.4,68.65644394675489,54.44520240182653,NaN,NaN,-6.691326525922222,-8.965405173042567
2014-05-07T09:30:00-04:00,63.67,63.7,62.83,63.31,4394929,5737939.65,43.276734272979034,47.16909798647568,NaN,NaN,-56.21801863493386,21.47630818320651,0.03966017623172924,-0.256220789871648,-0.2958809661033772,267192465,271065537.2,69.17325668888876,57.65388181230488,NaN,NaN,-7.609690594449749,-8.771731661815021
2014-05-08T09:30:00-04:00,63.19,64.1,63.14,63.49,5760407,5833669.6,45.023477655867076,47.12663132394632,NaN,NaN,-8.717354397305936,13.214934358099404,0.02738338011048569,-0.2616517409652701,-0.2890351210757558,272952872,271990991.8,69.98397688189151,60.43710706367507,NaN,NaN,-7.921457993518651,-8.650263994915539
2014-05-09T09:30:00-04:00,63.46,63.88,63.12,63.84,5060786,5582933.15,48.35380147195336,47.236154674936806,NaN,NaN,-2.992698323322535,-2.3682671778206457,0.04322430047155307,-0.23500474548631445,-0.2782290459578675,278013658,273106295.6,70.97467906828524,62.42536251638727,NaN,NaN,-7.290565561093071,-8.45602136151233
2014-05-12T09:30:00-04:00,64.1,64.67,64.03,64.64,5719500,5446597.2,55.055600594486684,47.55267149995178,NaN,NaN,112.9564434902081,8.042132665221242,0.10447788536563618,-0.14763168925082226,-0.25210957461645844,283733158,274695909.4,72.37422625846443,63.86775166799406,NaN,NaN,-4.737759786752301,-7.924841136546611
2014-05-13T09:30:00-04:00,64.74,64.93,64.33,64.46,4959886,5459522.55,53.37727339501504,47.895116523026175,NaN,NaN,118.94435519834762,32.79454546659868,0.12820479768683707,-0.09185357750791212,-0.2200583751947492,278773272,276133085,73.61303115909467,65.06183350014982,NaN,NaN,-3.0830551966031488,-7.233157430840402
2014-05-14T09:30:00-04:00,64.34,64.43,63.62,63.74,4285535,5189074.05,47.181550170687814,47.61791800587077,NaN,NaN,6.587220538331441,45.35559330125174,0.09241317157245371,-0.10454191072918206,-0.19695508230163578,274487737,277592139.4,74.84624292400495,66.06142740383457,NaN,NaN,-3.437524942355578,-6.690924218199712
2014-05-15T09:30:00-04:00,63.5,63.62,62.63,63.28,5712004,5236958.75,43.69216279890041,47.6032141633096,NaN,NaN,-122.43846846504312,22.6113704877043,0.037574699097428554,-0.14998670842985007,-0.18756140752727862,268775733,276756711.6,72.74971067479602,66.76953393550802,NaN,NaN,-4.799650264595543,-6.420742224827688
2014-05-16T09:30:00-04:00,63.28,63.79,63.06,63.75,3011380,5139850.6,47.929503707994385,47.95860878665861,NaN,NaN,-56.82458208664628,11.844993735039552,0.032937542676315296,-0.1463894791818845,-0.1793270218581998,271787113,275511402.6,69.61921194025946,67.4307962947105,NaN,NaN,-4.684448899937939,-6.17270032127201
2014-05-19T09:30:00-04:00,63.57,64.08,63.39,64.04,2738595,4747450.1,50.409265280382726,48.326977129787664,NaN,NaN,-5.1839272717929825,-11.783080417360665,0.04844643518929981,-0.11876897787157503,-0.16721541306087484,274525708,273669912.6,65.15440228712639,67.95378735774133,NaN,NaN,-3.8485789688416823,-5.840682985210535
2014-05-20T09:30:00-04:00,63.7,63.96,63.2699,63.46,4849038,4756111.85,45.71966401894988,48.20854948105712,NaN,NaN,-46.73284468995576,-44.91852039502133,0.02013769236071558,-0.14204329760998036,-0.16218098997069594,269676670,271850592.2,60.9926533243458,68.15192015337757,NaN,NaN,-4.550928296759245,-5.656432315431779
2014-05-21T09:30:00-04:00,63.64,64.275,63.64,64.23,3889031,4809212.55,52.091771304996485,48.405181515040645,NaN,NaN,44.988975930226,-37.23816931664242,0.05195684394527908,-0.09723493503909708,-0.14919177898437616,273565701,271666185,60.57032965725421,68.28289777090379,NaN,NaN,-3.141148101651813,-5.297105999177498
2014-05-22T09:30:00-04:00,64.22,64.68,64.11,64.57,5257523,4887905.5,54.62475508937972,48.69211278244292,NaN,NaN,120.60831179563996,11.371186735494188,0.09223496677365295,-0.033898070517309975,-0.12613303729096292,278823224,273675683.2,63.53349866675304,68.44632119761363,NaN,NaN,-1.1832317909329804,-4.709409683713996
2014-05-23T09:30:00-04:00,64.64,65.11,64.53,65.08,1990495,4750653.55,58.19521553776786,49.198751025855636,NaN,NaN,169.88593137140487,56.713289427104414,0.14634234384755612,0.05679489251848224,-0.08954745132907388,280813719,275481004.4,66.00520700027721,68.44620503415695,NaN,NaN,1.6071687962460908,-3.807041329433983
2014-05-27T09:30:00-04:00,65.33,65.5,65.245,65.42,3402658,4453450.85,60.43062877308644,50.38295743374626,NaN,NaN,206.83185488760702,99.1164458589844,0.1950986847983065,0.15432590466880924,-0.040772780129497255,284216377,277419138.2,68.4755887208312,68.43328680373382,NaN,NaN,4.61821480194562,-2.6034333106654683
2014-05-28T09:30:00-04:00,65.45,65.52,65.03,65.35,10111702,4738524.6,59.72256224075825,51.55765943144478,NaN,NaN,165.28693143845598,141.52040108466676,0.21133530048290067,0.22339634547412857,0.012061044991227912,274104675,278304739.2,69.5639642674067,68.46119448791369,NaN,NaN,6.843951687774245,-1.253806882316938
2014-05-29T09:30:00-04:00,65.55,65.63,65.2967,65.62,2948002,4496195.7,61.59190987989804,52.741118876018426,NaN,NaN,161.5831217272096,164.8392302440635,0.22755436195798195,0.29650399743870537,0.06894963548072341,277052677,279002134.4,70.42975368245246,68.49303568795376,NaN,NaN,9.265483924274475,0.24894894719612104
2014-05-30T09:30:00-04:00,65.52,65.7,65.395,65.68,3058103,4440337.95,62.01382584888977,53.71683490294246,NaN,NaN,142.4141026256713,169.20038841006976,0.22899183896924785,0.3551894341922832,0.12619759522303536,280110780,279259645.6,70.76050072522405,68.47773723487795,NaN,NaN,11.379241775556919,1.838990779819092
2014-06-02T09:30:00-04:00,65.8,65.9499,65.51,65.9,3048680,4387194.95,63.59304960031104,54.326652689072766,NaN,NaN,137.69636101059317,162.7624743379074,0.2307780577747375,0.41467016744145724,0.18389210966671973,283159460,279728793.8,71.38838840786455,68.4073202455494,NaN,NaN,13.622529546116851,3.522353460718772
2014-06-03T09:30:00-04:00,65.66,65.9,65.62,65.78,2243279,4331961.4,62.07707267901069,54.94806692364388,NaN,NaN,117.74264883506325,144.94463312739865,0.21046522906596768,0.4469736459991793,0.23650841693321165,280916181,279068754.6,69.13892459631141,68.08774120535058,NaN,NaN,15.120619552664403,5.179248616711005
2014-06-04T09:30:00-04:00,65.58,66.17,65.49,66.1,2170080,4230580.65,64.50692552822595,56.18559373489661,NaN,NaN,115.22834738461889,134.93291631663124,0.2049660568012147,0.49271598793473004,0.2877499311335153,283086261,280865071.8,71.7480659004016,67.86644284652178,NaN,NaN,17.098058508266227,6.881935744076037
2014-06-05T09:30:00-04:00,66.2,66.62,65.89,66.53,2703443,4146006.35,67.51865072362544,57.887485729519824,NaN,NaN,131.24185453032155,128.86466287725364,0.21559285702053588,0.5572410024091852,0.3416481453886493,285789704,282612477.2,74.04672243706955,67.95908654382704,NaN,NaN,19.708194057046306,8.714258360214647
2014-06-06T09:30:00-04:00,66.65,66.925,66.6,66.92,3203933,4018182.65,70.00467903487791,59.46428396715436,NaN,NaN,146.046038146314,129.59104998138216,0.232725943669627,0.632555574975683,0.39982963130605603,288993637,284389048.6,76.16962675546174,68.42697331634149,NaN,NaN,22.71535608779765,10.71441517844079
2014-06-09T09:30:00-04:00,66.97,67.26,66.85,66.94,2568708,3893578.75,70.13093262691775,60.87297449190687,NaN,NaN,141.97462562225746,130.44670290371502,0.22889593477817044,0.6859495497787691,0.45705361500059866,291562345,286069625.6,78.00265402968598,69.34470558366716,NaN,NaN,25.227995309099633,12.78778376853491
2014-06-10T09:30:00-04:00,66.79,66.93,66.71,66.81,5461647,3880686.1,68.12375032853706,62.47326637116309,NaN,NaN,113.41518289015134,129.58120971473264,0.2020330894105239,0.7095949767637535,0.5075618873532296,286100698,287106529,79.07226272152538,70.63610625489427,NaN,NaN,26.836437431360178,14.794734291795661
2014-06-11T09:30:00-04:00,66.62,66.755,66.37,66.61,3027907,3784087.15,65.03966201046973,63.398115707268325,NaN,NaN,88.54834538275324,124.2452093143595,0.15721419235764267,0.704079627800283,0.5468654354426403,283072791,287103835,79.06150640189098,71.9569045937969,NaN,NaN,27.41376685639898,16.597453229596134
2014-06-12T09:30:00-04:00,66.61,66.61,65.61,65.76,4549638,3797292.3,53.87620151663538,63.344647594929434,NaN,NaN,46.32489649648101,107.2618177075914,0.061650466191167874,0.6239285181816001,0.5622780519904322,278523153,285650524.8,73.27099358846655,72.65243994534788,NaN,NaN,24.611168909030965,17.74226975522968
2014-06-13T09:30:00-04:00,65.78,65.95,65.395,65.79,4962813,3759832.75,54.17515839423854,63.057500656105915,NaN,NaN,20.89597172426642,82.23180442318187,-0.004690497059288923,0.5564149306663211,0.56110542772561,283485966,284548990.6,69.1377452367991,72.876192676528,NaN,NaN,22.415484713930613,18.409871892186956
2014-06-16T09:30:00-04:00,65.56,66.01,65.56,65.94,3553048,3786916.15,55.72055632509674,62.72106690982094,NaN,NaN,24.743979042007226,58.78567510713183,-0.04156868548644965,0.5091445708675479,0.5507132563539976,287039014,283644324.4,65.85221930951522,72.68880914714829,NaN,NaN,20.982617148890842,18.77740692885894
2014-06-17T09:30:00-04:00,65.97,66.27,65.79,66.2,4017679,3850870.35,58.34293153246768,62.622521859228755,NaN,NaN,41.813337367830535,44.46530600266767,-0.05093227540484979,0.4870479120979354,0.5379801875027852,291056693,284635523.4,67.66529432361193,72.55318986544867,NaN,NaN,20.460800208752996,19.01789168312952
2014-06-18T09:30:00-04:00,66.14,66.75,66.04,66.7,5848116,3900824.25,62.89404466792907,62.71553148694527,NaN,NaN,79.02335530725823,42.56030798756866,-0.027127068893755713,0.5040713513855906,0.5311984202793463,296904809,287401927,72.11528294698157,72.67358481291504,NaN,NaN,21.31440016503311,19.34596432340146
2014-06-19T09:30:00-04:00,66.73,66.91,66.36,66.54,2980192,3855382.3,60.61200980894714,62.6154017698065,NaN,NaN,83.64949925007838,50.025228538288125,-0.025838041670983358,0.4989008681906171,0.5247389098616004,293924617,290482219.8,76.06514503088476,73.05248797760508,NaN,NaN,21.37323446553542,19.635574343706313
2014-06-20T09:30:00-04:00,66.51,66.59,66,66.08,5017653,3843388.8,54.49053136230144,61.965221895662964,NaN,NaN,26.89273088894119,51.22458037122308,-0.05781570137411618,0.4524692831439552,0.5102849845180714,288906964,291566419.4,77.2847925121374,73.47365969933887,NaN,NaN,19.590351657619635,19.629113959979644
2014-06-23T09:30:00-04:00,66,66.205,65.8801,66.16,4289163,3958322.2,55.33537849907146,61.48367231138159,NaN,NaN,-1.9419603858282934,45.88739248565598,-0.07437464205749389,0.41731668194620397,0.49169132400369786,293196127,292797842,78.61752809609507,74.15070280646626,NaN,NaN,18.364352430258364,19.44843374144803
2014-06-24T09:30:00-04:00,66,66.57,65.91,66,3908711,3983624.85,53.2078906274719,60.676598389899155,NaN,NaN,4.766777032949532,38.4780804186798,-0.09554810579908368,0.37225619175484326,0.46780429755392694,289287416,292443986.6,77.21556833481702,74.54123869463878,NaN,NaN,16.724081579576637,19.059240575466404
2014-06-25T09:30:00-04:00,65.83,66.64,65.83,66.56,3945651,3675322.3,59.130537767469654,60.07744746445945,NaN,NaN,29.578863698911398,28.58918209701044,-0.07233742382933422,0.3773825177672592,0.4497199415965934,293233067,291709638.2,74.25612875919697,74.55619628907645,NaN,NaN,16.98203327440488,18.762496675314758
2014-06-26T09:30:00-04:00,66.56,66.61,66.07,66.61,3079483,3681896.35,59.62196036839554,59.335824702567855,NaN,NaN,39.46361099449756,19.752004445894276,-0.054906498419935335,0.38108681857167426,0.4359933169916096,296312550,292187224.8,74.92911914674565,74.4675886027396,NaN,NaN,17.333107275773475,18.558298189666004
2014-06-27T09:30:00-04:00,66.49,66.84,66.451,66.77,5204887,3789235.55,61.22854271149487,58.69993970860908,NaN,NaN,81.61683840075801,30.69682594825764,-0.0348668843270018,0.3924097115828573,0.4272765959098591,301517437,294709319.4,78.17402813399096,74.47982961018995,NaN,NaN,18.082764651731605,18.490364827103946
2014-06-30T09:30:00-04:00,66.72,66.89,66.61,66.74,2527541,3763178.6,60.74053985666295,58.17256753204664,NaN,NaN,85.71783319060918,48.22878466354514,-0.026288591833701858,0.3944158561177318,0.42070444795143364,298989896,295868073.2,79.48762856376804,74.50949859892157,NaN,NaN,18.57304126613659,18.50217574696575
2014-07-01T09:30:00-04:00,66.91,67.6,66.83,67.45,3830557,3842542.5,67.36910086508226,58.33895602166183,NaN,NaN,173.83334398510732,82.0420980539767,0.0219412662997025,0.44813103082606176,0.42618976452635926,302820453,298574680.6,82.18474939637692,74.732587384242,NaN,NaN,21.053966240893057,18.866717246098222
2014-07-02T09:30:00-04:00,67.5,67.68,67.45,67.55,1748932,3821485.1,68.1838957065012,59.36093417808082,NaN,NaN,192.541443515054,114.63461401720522,0.053516885225471544,0.4930858710581987,0.43956898583272713,304569385,300841944.2,84.07385653526903,75.50422045187075,NaN,NaN,23.33420952643272,19.50493042900315
2014-07-03T09:30:00-04:00,67.75,68.13,67.69,68.07,1747361,3773681,72.08702851483187,60.64035347240891,NaN,NaN,212.78783266860168,149.29945835202605,0.0996801465384648,0.5641691690058082,0.46448902246734336,306316746,302842783.4,85.5319016459714,76.67523162395449,NaN,NaN,26.611655063982408,20.520176805428758
2014-07-07T09:30:00-04:00,67.85,67.97,67.58,67.65,3090406,3768004.65,65.13644870937505,61.31291721414307,NaN,NaN,152.5983770007002,163.49576607201448,0.09235090984516647,0.5799276597738015,0.487576749928635,303226340,303184564,85.7715301296839,78.09803953968083,NaN,NaN,27.266753065225696,21.483973413971178
2014-07-08T09:30:00-04:00,67.54,67.56,66.84,66.99,5100294,3894583.95,55.999026077920824,61.145495395961156,NaN,NaN,68.3147825273358,160.0151559393598,0.03635109670144665,0.5330156208054433,0.49666452410399664,298126046,303011794,85.00509123856372,79.33659646217737,NaN,NaN,24.77423336491452,21.954010549820225
2014-07-09T09:30:00-04:00,67.18,67.86,67.1,67.8,18565051,4549754.15,62.881115601724396,61.14457189123225,NaN,NaN,114.07705686257067,148.0638985148525,0.04651022619414813,0.5548023068466819,0.5082920806525337,316691097,305785922.8,87.01196797257623,80.40064539257699,NaN,NaN,25.002976179957674,22.38957706841129
2014-07-10T09:30:00-04:00,66.82,67.46,66.81,67.17,4842264,4640472,55.59740378665931,60.786385746783125,NaN,NaN,53.95096259801599,120.34580233144486,0.005600498753509542,0.5152927040944206,0.5096922053409111,311848833,307241812.4,87.9253215826626,81.24780086056113,NaN,NaN,22.532514704288317,22.409996730679435
2014-07-11T09:30:00-04:00,67.28,67.43,67.14,67.39,7046793,4765329.75,57.45089184574957,60.997840067029415,NaN,NaN,66.11040523201358,91.01031684412723,-0.0109413937567292,0.49601546314499956,0.5069568569017288,318895626,309757588.4,89.32261812298056,82.10764554704993,NaN,NaN,21.242897382707437,22.24326825239772
2014-07-14T09:30:00-04:00,67.74,67.785,67.5,67.58,3430382,4688708.2,59.04106947783023,61.262532279797895,NaN,NaN,90.23852968111824,78.53834738021087,-0.01323243834138299,0.490416308975,0.503648747316383,322326008,313577522,91.02157283420459,82.99364874262918,NaN,NaN,20.742008573316053,22.028802583957482
2014-07-15T09:30:00-04:00,67.4,67.63,67.03,67.35,4172839,4719697.75,56.29817913311276,61.48326717305797,NaN,NaN,50.358422387629865,74.94707535226969,-0.03324448658798351,0.4620931390814036,0.4953376256693871,318153169,317582946.6,92.3890853467348,84.07747138633759,NaN,NaN,19.459661667341866,21.661782453012393
2014-07-16T09:30:00-04:00,67.87,68.03,67.43,67.52,23478667,5692747.15,57.85661665950445,61.39227280820331,NaN,NaN,82.49565718529131,68.63079541681383,-0.0377118155428956,0.4481978562407676,0.4859096717836632,341631836,322571094.4,93.68006424646177,85.46489534971364,NaN,NaN,18.891686063098927,21.26605439731047
2014-07-17T09:30:00-04:00,67.36,67.66,66.77,66.88,5637421,5682212.4,50.548376473230405,60.74415967283437,NaN,NaN,8.878869181693654,59.61637673354936,-0.08380818566768394,0.38114943969905823,0.4649576253667422,335994415,327400210.8,94.62976842655814,86.87208458398597,NaN,NaN,16.01914078458912,20.516495309778847
2014-07-18T09:30:00-04:00,67.1,67.52,67.01,67.4999,3454990,5705952.3,56.30558609736888,60.39251991468252,NaN,NaN,37.140415182437025,53.82237872363404,-0.07298549396495468,0.37372575791054885,0.44671125187550353,339449405,331510966.6,95.27998462863808,88.09393861931791,NaN,NaN,15.436915751764472,19.790841087205365
2014-07-21T09:30:00-04:00,67.28,67.41,66.99,67.19,3715995,5640869.4,52.98460925254499,59.83852487153123,NaN,NaN,11.539082218220049,38.0824892310544,-0.0862256955103855,0.33892913248752166,0.42515482799790716,335733410,334192447,95.64997793351759,89.2483921457286,NaN,NaN,13.8778715937027,18.94613115956213
2014-07-22T09:30:00-04:00,67.34,67.61,67.26,67.47,4410062,5646914.35,55.536372586199626,58.99332999446818,NaN,NaN,45.2337996144517,37.05756467641875,-0.07601141343687312,0.3301405612018158,0.4061519746386889,340143472,338590507.6,96.1790267159819,90.24798338284324,NaN,NaN,13.40969283353625,18.15521139870129
2014-07-23T09:30:00-04:00,67.48,67.49,67.21,67.42,5389292,5720943.4,54.96269874343299,58.048958782820456,NaN,NaN,25.26727687652,25.61188861466448,-0.07251834863752693,0.31550403884178024,0.3880223874793072,334754180,337214976.4,92.39422605423809,90.84229549134103,NaN,NaN,12.864347690763008,17.399373726138677
2014-07-24T09:30:00-04:00,67.54,67.78,67.49,67.57,3976824,5722502.05,56.417182187443494,56.92968404514985,NaN,NaN,71.55877815784555,38.14787040989486,-0.06049230809379402,0.31240700236206465,0.37289931045585867,338731004,337762294.2,92.52035004868904,91.34147037724942,NaN,NaN,12.83564278899891,16.74741216369014
2014-07-25T09:30:00-04:00,67.07,67.2,66.71,66.82,3852733,5761164.55,48.05975398103985,55.709920135983054,NaN,NaN,-113.58186640518986,8.003414092369479,-0.10104641181148538,0.24659129569150195,0.34763770750298734,334878271,336848067.4,89.84040994760814,91.63210464995832,NaN,NaN,10.17713522268717,15.808801172118287
2014-07-28T09:30:00-04:00,66.83,67.02,66.521,66.95,2803834,5641111.9,49.457363745705614,55.24265854082483,NaN,NaN,-140.45712980290966,-22.395828311856462,-0.11604096880456949,0.20258649649727545,0.31862746530184494,337682105,337237806.4,89.97374101025423,91.98700820507906,NaN,NaN,8.441387529074214,14.756313508826276
2014-07-29T09:30:00-04:00,67.06,67.41,66.75,66.76,3584693,5693969.5,47.44783928968387,54.14028166139336,NaN,NaN,-109.12730713479336,-53.26804966170547,-0.13438642920752997,0.15064442879243245,0.2850308579999624,334097412,336028594.4,86.19413828262017,91.92859179865363,NaN,NaN,6.404096684331597,13.563139676755608
2014-07-30T09:30:00-04:00,67.01,67.1861,66.715,67.13,23867466,6695814.95,51.57424161976875,53.85291293518689,NaN,NaN,-89.68861801772543,-76.25922864055455,-0.11782628600762368,0.1377480004904328,0.25557428649805647,357964878,340670734,88.23703981412308,91.9508573866151,NaN,NaN,5.8672737827628705,12.463730263328074
2014-07-31T09:30:00-04:00,66.65,66.76,65.84,65.89,6449640,6930850.35,40.18592348961346,52.619700909748595,NaN,NaN,-247.1113684144056,-139.9932579550048,-0.1827339855810549,0.027156804521737854,0.20989079010279274,351515238,343227580.8,89.18618780248327,91.94111236372244,NaN,NaN,1.3910420500280334,10.88191766142807
2014-08-01T09:30:00-04:00,65.7,66.11,65.35,65.65,6088844,7147924.5,38.41771874063591,51.14660442852043,NaN,NaN,-279.8532968976838,-173.24754405350356,-0.23106743030980614,-0.07894349778446497,0.15212393252534118,345426394,345337205.4,89.90963888548782,91.86168851024266,NaN,NaN,-2.758271675954462,8.933319184659137
2014-08-04T09:30:00-04:00,65.82,66.4999,65.77,66.29,16942563,7840532.35,45.326322745110545,50.36290040080599,NaN,NaN,-157.13058543518102,-176.58223517995785,-0.20979254058532834,-0.11011674320631926,0.09967579737900908,362368957,350274575.8,91.36556542493484,91.7885799443998,NaN,NaN,-3.9650322373564904,7.090697552942618
2014-08-05T09:30:00-04:00,66,66.32,65.6,65.83,9897119,8080373.6,41.704862194860276,49.209203653331414,NaN,NaN,-164.39409035975217,-187.63559182494959,-0.21572503080029903,-0.1699804911213647,0.04574453967893432,352471838,353949461,92.26066093442863,91.68719399354029,NaN,NaN,-6.179572924654255,5.194944627571637
2014-08-06T09:30:00-04:00,65.37,66.11,65.33,65.69,10970482,7700645.15,40.64060087166044,48.50150539607642,NaN,NaN,-159.95279551246676,-201.68842732389788,-0.21748625532321658,-0.22611327947508642,-0.008627024151869833,341501356,350656756.6,83.87106079981183,90.91871487734413,NaN,NaN,-8.269856126470899,3.271401662708418
2014-08-07T09:30:00-04:00,66.11,66.23,65.16,65.35,6364549,7776759.4,38.097883976959245,47.20095524461858,NaN,NaN,-144.49280346311366,-181.1647143336395,-0.2288085226161177,-0.29463767742201696,-0.06582915480589926,335136807,347381070.4,76.42550304225392,89.5719661926024,NaN,NaN,-10.807505400067162,1.2601292251690492
2014-08-08T09:30:00-04:00,65.35,66.41,65.35,66.36,5580481,7703443.8,48.42153749943217,46.87502154796766,NaN,NaN,-80.18787765914887,-141.2316304859325,-0.15885458726831797,-0.2643973888912967,-0.10554280162297876,340717288,346439249.2,74.38095323431486,88.05275014265933,NaN,NaN,-9.590054254463428,-0.28989698620701887
2014-08-11T09:30:00-04:00,66.63,66.845,66.52,66.66,5032547,7783552.05,51.03375475128816,46.55340598833113,NaN,NaN,-7.147005987014694,-111.23491459629925,-0.08657388314453177,-0.21376015555364347,-0.1271862724091117,345749835,343115424.8,67.51624673582745,86.00540871550545,NaN,NaN,-7.74230776942566,-1.354527098095396
2014-08-12T09:30:00-04:00,66.57,66.85,66.32,66.49,3127073,7731263.75,49.503754884968146,46.16348142701221,NaN,NaN,-16.891707352600108,-81.73443799486884,-0.046420861979851596,-0.1852123498839262,-0.1387914879040746,342622762,341145609.6,63.76060007924808,83.96014971729187,NaN,NaN,-6.744661452648787,-2.124546291603023
2014-08-13T09:30:00-04:00,66.69,66.9,66.53,66.73,3394595,6727060.15,51.70507096782095,45.82690205418203,NaN,NaN,8.3921056107933,-48.065457770216824,-0.0022386930968062435,-0.14158985427508242,-0.13935116117827617,346017357,342048809.8,64.72939655059093,81.97508161028486,NaN,NaN,-5.246607185094685,-2.5705549906732603
2014-08-14T09:30:00-04:00,66.85,67.25,66.73,67.25,5599619,6725170.05,56.16400432945519,46.40577707906884,NaN,NaN,52.97259908490859,-8.572377260612386,0.06002681352148942,-0.0643176442764144,-0.12434445779790382,351616976,345344843.6,68.08268012530655,80.42095805154905,NaN,NaN,-2.547669999601897,-2.567285706234494
2014-08-15T09:30:00-04:00,67.47,67.54,66.65,67.12,6432625,6874051.8,54.80177946724515,46.78752105917881,NaN,NaN,58.84018108571381,19.233234488360136,0.08874425042229213,-0.01341414477003866,-0.10215839519233079,345184351,346238256.2,68.94454732978798,78.9188727886586,NaN,NaN,-0.7616869816733832,-2.3093430312971925
2014-08-18T09:30:00-04:00,67.58,67.85,67.5,67.74,4756157,6926059.9,59.808547395478065,47.67042878102125,NaN,NaN,126.0829481833322,45.879225322429555,0.1425899734280486,0.07607907159272997,-0.06651090183531863,349940508,347076390.8,69.76927188715536,77.7456680461254,NaN,NaN,2.3907938761070007,-1.6378949016680222
2014-08-19T09:30:00-04:00,68.11,68.35,68,68.25,3746900,6892901.8,63.40007711925876,48.51513131669911,NaN,NaN,172.57329896956702,83.77222658686297,0.20201800316042703,0.18601160211521517,-0.016006401045211872,353687408,349289320,71.89175037619674,76.57814737198781,NaN,NaN,6.242638547615447,-0.5121044089132409
2014-08-20T09:30:00-04:00,68.06,68.68,68.05,68.57,5003987,6873636.55,65.48422204024533,50.32215264174424,NaN,NaN,177.63749695744727,117.62130485619377,0.249243803064469,0.2955483527853744,0.046304549720905384,358691395,351824127.6,74.13211058378013,75.50285614208043,NaN,NaN,10.09700120390358,1.0034821072034479
2014-08-21T09:30:00-04:00,68.66,68.68,68.46,68.51,1999257,6774758.2,64.73982401224357,52.202303018287644,NaN,NaN,172.22397341686468,141.47157972258498,0.26152703794593535,0.37321334715332455,0.11168630920738923,356692138,352839160,74.99169377632667,74.4372886342832,NaN,NaN,12.981245058682935,2.714591100271946
2014-08-22T09:30:00-04:00,68.57,68.735,68.36,68.64,3290660,6746654.55,65.65091244296929,53.654059425277545,NaN,NaN,147.43450209401703,159.1904439242456,0.26279432565606553,0.44017921627747114,0.1773848906214056,359982798,355798849.4,77.35465589320603,73.43650938201687,NaN,NaN,15.632118987938052,4.559952227081389
2014-08-25T09:30:00-04:00,68.97,68.99,68.73,68.84,3967557,6804840.7,67.06103646941955,55.465214730603215,NaN,NaN,144.29762955893045,162.83338019936528,0.26095887281893965,0.5035834816450802,0.2426246088261405,363950355,358600818.8,79.3444626964885,72.51392379359257,NaN,NaN,18.277382132661582,6.519585070735703
2014-08-26T09:30:00-04:00,68.89,69.03,68.75,68.85,2026450,6726928.55,67.13368850084908,57.35757813268812,NaN,NaN,124.14628468164317,153.14797734178052,0.2445547656044541,0.5483180658317082,0.30376330022725406,365976805,361058698.2,80.92760207398257,72.30367674174762,NaN,NaN,20.48085733562972,8.514052537149134
2014-08-27T09:30:00-04:00,68.87,69.03,68.785,68.92,1804348,5623772.65,67.67122724782756,59.46995979489299,NaN,NaN,108.22986977292305,139.26645190487565,0.22315090852458086,0.5827019358829801,0.3595510273583993,367781153,362876649.8,82.02498535172971,72.70363976385303,NaN,NaN,22.486837593022,10.510164687988114
2014-08-28T09:30:00-04:00,68.63,68.91,68.47,68.83,2313243,5416952.8,66.17269267347027,60.73789945018143,NaN,NaN,86.05138221781391,122.03193366506551,0.1890158983765165,0.5958209003290449,0.4068050019525284,365467910,364631804.2,83.03961255422088,73.32211542956063,NaN,NaN,23.82892368435977,12.412844544612636
2014-08-29T09:30:00-04:00,68.91,69,68.58,68.82,2309226,5227971.9,65.99781496812466,61.80676089424118,NaN,NaN,80.94121413180135,108.73327607262237,0.1533652694051446,0.5985115887089592,0.44514631930381454,363158684,365266981.4,83.40469153937433,74.45700434409967,NaN,NaN,24.926142373821403,14.200458520213887
2014-09-02T09:30:00-04:00,68.85,69.17,68.63,68.95,9520168,4856852.15,67.21095906292396,63.0715611926666,NaN,NaN,80.06792355567698,95.88733487197167,0.1272184672611859,0.6041694033802969,0.476950936119111,372678852,367012680.8,84.39865915748749,75.93115142111678,NaN,NaN,26.188809512323246,15.913080090515225
2014-09-03T09:30:00-04:00,69.24,69.25,68.71,68.77,2606647,4492328.55,63.81589285304272,63.93661989875387,NaN,NaN,73.48132715683852,85.75434336701076,0.08832570582285271,0.5873580683976769,0.4990323625748242,370072205,367831760.8,84.85695064137727,77.36883385617296,NaN,NaN,26.472669552083623,17.421592870739282
2014-09-04T09:30:00-04:00,68.87,69.33,68.87,69.03,3739068,4130757.85,66.4519845670246,64.67147563000883,NaN,NaN,78.50123265002877,79.8086159424319,0.0713613067806469,0.5882339960506329,0.516872689269986,373811273,369037784.8,85.53091249701183,78.61513616843762,NaN,NaN,27.399048342575778,18.84694365243021
2014-09-05T09:30:00-04:00,68.87,69.29,68.65,69.26,2670541,3946057.45,68.62922820487972,65.65915053983987,NaN,NaN,74.45475454040646,77.4892904069504,0.06695330552789913,0.6005643211798599,0.5336110156519608,376481814,371240565.6,86.69561941398082,79.88306988873708,NaN,NaN,28.793185574012416,20.26783535551338
2014-09-08T09:30:00-04:00,69.09,69.17,68.68,68.97,2500814,3792074.1,63.07113661789821,65.8921926271556,NaN,NaN,61.86018503311994,73.67308458721412,0.03730870054954161,0.5802468913388878,0.5429381907893462,373981000,373405028.8,87.7399352923089,81.16668870339092,NaN,NaN,28.54285654023016,21.449981239044348
2014-09-09T09:30:00-04:00,68.88,68.95,68.2301,68.28,2558377,3668365.6,52.23211728403269,65.09448121035373,NaN,NaN,16.410425898887542,60.94158505585623,-0.03221179915380201,0.5026734418470937,0.5348852410008957,371422623,373153783,86.88737094863146,82.23780445856482,NaN,NaN,24.97683056977633,21.953816857720344
2014-09-10T09:30:00-04:00,68.44,68.55,68.07,68.52,2872167,3655620.3,55.12112142309782,64.35425973770035,NaN,NaN,-4.471949129153183,45.35092979865789,-0.06365751311822332,0.45531334960311654,0.5189708627213399,374294790,373998300,87.3329250691076,83.18071977894536,NaN,NaN,22.818556345185534,22.07735107021537
2014-09-11T09:30:00-04:00,68.22,68.61,68.22,68.55,2439625,3607871.8,55.48355410474843,63.693097601450695,NaN,NaN,-6.797600328399383,28.291163202972246,-0.08284687377777739,0.4154122704991181,0.4982591442768955,376734415,374582928.4,87.64587782236127,84.08459006794783,NaN,NaN,21.169013187074494,21.94758851548096
2014-09-12T09:30:00-04:00,68.48,68.59,68.1,68.35,2913379,3473559.8,52.44291018575303,62.7496688687924,NaN,NaN,-42.55374146165427,4.889464002560101,-0.10783748953070516,0.3634622823635141,0.47129977189421923,373821036,374050772.8,85.5734244868797,84.67164496749595,NaN,NaN,18.878182702473662,21.50910197076563
2014-09-15T09:30:00-04:00,68.33,68.42,67.92,68.07,2920145,3297935.8,48.44049121087014,61.41962992175315,NaN,NaN,-110.2339265020661,-29.529358304477103,-0.1400137998678555,0.29628252205939987,0.43629632192725537,370900891,373434751,83.12313548678952,84.94155016680317,NaN,NaN,15.700349300981701,20.679280160796498
2014-09-16T09:30:00-04:00,67.89,68.6,67.78,68.42,2846775,3202466.7,53.24409249499962,60.427515921335335,NaN,NaN,-96.42431592158813,-52.09630666857224,-0.1344829810267557,0.2681925956438107,0.4026755766705664,373747666,373899759.6,83.50704291403547,85.12579594109266,NaN,NaN,14.31727095212091,19.77042170241427
2014-09-17T09:30:00-04:00,68.45,68.7199,68.12,68.39,6408878,3335565.6,52.790100118174614,59.36457826921726,NaN,NaN,-65.3086419753147,-64.26364523780454,-0.12955219712194338,0.2407353302681372,0.3702875273900806,367338788,372508559.2,77.80469211162139,84.82434642394207,NaN,NaN,13.060979250744559,18.811929923604314
2014-09-18T09:30:00-04:00,68.6,68.77,68.46,68.69,2812582,3225995.35,56.7605689023641,58.69228371413826,NaN,NaN,-7.49425287357283,-64.40297574683923,-0.10390087860782082,0.24041142913030455,0.3443123077381254,370151370,371191950.2,72.74214869925498,84.0888132914445,NaN,NaN,13.107627720545025,17.997029608881558
2014-09-19T09:30:00-04:00,68.74,68.8851,68.33,68.49,5923648,3422214.9,53.52845372243708,57.801615053732,NaN,NaN,-27.613436806995477,-61.414914815907466,-0.0982790357168627,0.22146351309204704,0.31974254880890973,364227722,369273287.4,66.0023223381423,82.84578691992793,NaN,NaN,12.209844052392294,17.17028881509738
2014-09-22T09:30:00-04:00,68.27,68.38,67.359,67.53,5424512,3528907.5,41.355428213825085,55.95479142165351,NaN,NaN,-204.99197813800401,-80.36652514309503,-0.15378341310428612,0.1275132824285521,0.2812966955328382,358803210,366853751.2,58.625530621086845,81.00484916732788,NaN,NaN,7.13610163026767,15.73683350297885
2014-09-23T09:30:00-04:00,67.3,67.54,66.95,66.95,5492525,3605155.9,36.02503027474866,53.96972980891822,NaN,NaN,-266.8399072458408,-114.44964340794556,-0.22008967421488174,0.006184602764236047,0.22627427697911778,353310685,362766355,48.71929609503723,78.42358812830359,NaN,NaN,0.853154294916934,13.610593616112862
2014-09-24T09:30:00-04:00,67.07,67.74,66.84,67.71,6343060,3820986.4,45.87040345709291,52.49961687249453,NaN,NaN,-178.07684229449217,-137.00328347178106,-0.2036731645998137,-0.02831717877064932,0.17535598582916437,359653745,361229346.4,45.59902976309793,75.57131079016688,NaN,NaN,-0.9377254800862717,11.532262316655842
2014-09-25T09:30:00-04:00,67.54,67.6146,66.68,66.72,4639618,3962749.9,37.725847924604075,50.29223256676055,NaN,NaN,-201.48891944252946,-175.8022167855724,-0.24748490480124635,-0.13400014517239356,0.1134847596288528,355014127,358201897.8,40.145112960194105,72.24627461489641,NaN,NaN,-5.744424189519233,9.064164244345118
2014-09-26T09:30:00-04:00,67.03,67.56,66.94,67.41,2593399,3976757.7,45.04916301120637,49.00494873771113,NaN,NaN,-131.3154051274407,-196.54261044966142,-0.2189721179829625,-0.16023038784985033,0.058741730133112166,357607526,356877858.6,38.00422688725752,68.69372401453559,NaN,NaN,-6.6713168024687715,6.816238380514562
2014-09-29T09:30:00-04:00,66.84,67.35,66.77,67.06,6848666,4203729.7,42.32990258004453,48.29764768742626,NaN,NaN,-135.85552712766975,-182.71532024759458,-0.21249369480779418,-0.20687538837663055,0.005618306431163615,350758860,355268988.6,35.52508815334484,65.02498952915796,NaN,NaN,-8.399666808960433,4.642537639160992
2014-09-30T09:30:00-04:00,67.23,67.23,66.59,66.69,4428332,3949137.9,39.60804236478304,47.18957061183236,NaN,NaN,-136.15132922042346,-156.57760464251112,-0.22095763069834534,-0.27057873194176807,-0.04962110124342273,346330528,353872957.2,33.48398486673666,61.17863665756004,NaN,NaN,-10.734311928417885,2.445844843792581
2014-10-01T09:30:00-04:00,66.54,66.66,65.7,65.8,6556951,4146653.1,33.95262265083042,45.651646936552496,NaN,NaN,-178.40295334673866,-156.6428268529604,-0.2710250323139874,-0.38840239163590695,-0.11737735932191957,339773577,349896923.6,28.467311612151192,56.951596213973616,NaN,NaN,-14.845205144811901,-0.024305154579487898
2014-10-02T09:30:00-04:00,65.83,66.21,65.04,66.1,7484608,4333930.1,37.2072901039137,44.56338835927826,NaN,NaN,-171.37718660048958,-150.62048028455246,-0.26798332351351173,-0.45235651371380925,-0.18437319020029752,347258185,348345735.2,26.781486410819824,52.752172065683624,NaN,NaN,-16.862103082930908,-2.4297048586296905
2014-10-03T09:30:00-04:00,66.52,67.16,66.39,66.95,4965952,4448700.65,45.41474889376362,44.34726390805637,NaN,NaN,-73.61248640981208,-139.0798965410267,-0.19610280129871258,-0.42950169182368825,-0.23339889052497567,352224137,347269057.4,25.64622612085637,48.64667853954554,NaN,NaN,-15.550649820241125,-4.304125567431324
2014-10-06T09:30:00-04:00,67.14,67.28,66.45,66.59,3899119,4518615.9,42.85960197474995,43.60551458518138,NaN,NaN,-70.97085855434933,-126.10296282636264,-0.1616159554843805,-0.4354188348804513,-0.2738028793960708,348325018,346782289,25.127624926700292,44.47672011187875,NaN,NaN,-15.412453178391031,-5.891029511854139
2014-10-07T09:30:00-04:00,66.29,66.42,65.6,65.6,6450131,4713203.6,36.73815998997516,42.45894743316713,NaN,NaN,-133.54759874940717,-125.58221673215937,-0.19221137179738557,-0.5140670941428027,-0.32185572234541715,341874887,345891160.8,24.16427022193743,40.645261405472745,NaN,NaN,-17.52671970965229,-7.553270968682447
2014-10-08T09:30:00-04:00,65.65,66.75,65.27,66.63,7153111,4927250.8,45.46518398543492,41.652134224815065,NaN,NaN,-95.09714226475711,-108.92105451576306,-0.13264545737084843,-0.4876625440589777,-0.35501708668812926,349027998,347742045,30.15390899600962,37.60324428381237,NaN,NaN,-16.002940197032302,-8.760366572732426
2014-10-09T09:30:00-04:00,66.59,66.59,65.11,65.12,22700793,5940309.2,37.33400781507018,40.495388088574565,NaN,NaN,-132.35466315079907,-101.11654982582496,-0.1814852514823368,-0.5818736510410503,-0.40038839955871347,326327205,343555849,25.288918355192337,34.695143999315945,NaN,NaN,-17.943513931188548,-10.072244766797587
2014-10-10T09:30:00-04:00,65.01,65.57,64.55,64.55,11009143,6345097.4,34.80365074193337,40.02740398343944,NaN,NaN,-169.33138633752523,-120.2603298113676,-0.23530913523922636,-0.6945248186077464,-0.45921568336852003,315318062,336174634,19.358314545858335,31.890342851085332,NaN,NaN,-20.3887023223336,-11.546024417588445
2014-10-13T09:30:00-04:00,64.52,64.67,63.19,63.24,21316499,7264915.1,29.804066955715285,39.583049460651345,NaN,NaN,-216.6100218958312,-149.38816247966395,-0.33612416700940984,-0.8793708921302823,-0.5432467251208725,294001563,325309943,14.112201597655414,29.418407529843766,NaN,NaN,-24.38797680971228,-13.380589045034707
2014-10-14T09:30:00-04:00,63.62,64.19,63.38,63.7,11244976,7684825.15,33.42081885360588,38.69379341754512,NaN,NaN,-174.78198723389337,-157.63504017656118,-0.34738408950536914,-0.9774768370025839,-0.6300927474972148,305246539,317984273.4,11.79179252353859,27.00360486987524,NaN,NaN,-26.083262650852905,-15.195256703008734
2014-10-15T09:30:00-04:00,62.8,63.49,61.68,63.17,15093245,8119043.5,31.41258986278308,38.242846413129335,NaN,NaN,-194.84763921271073,-177.58513956615192,-0.36431006930656684,-1.0854803341304233,-0.7211702648238565,290153294,306209332.6,9.179204568368107,24.7917542704591,NaN,NaN,-28.122400706301036,-17.04199156062192
2014-10-16T09:30:00-04:00,61.76,63.66,61.76,63.24,12684022,8612615.5,31.99382432003135,37.310322220902556,NaN,NaN,-162.48396198205856,-183.61099933240382,-0.3447792015959845,-1.152144266818837,-0.8073650652228526,302837316,301511354.8,8.381319397512826,22.675832306905907,NaN,NaN,-29.48809871695425,-18.820006868669395
2014-10-17T09:30:00-04:00,63.75,64.48,63.68,63.94,8512128,8742039.5,37.68118556688521,36.97827100567689,NaN,NaN,-90.91902441183542,-167.92852694726585,-0.2624307787629172,-1.1354035386764991,-0.8729727599135819,311349444,300717631.2,8.250829770889993,20.72767099387342,NaN,NaN,-28.764971472304406,-20.24071609776011
2014-10-20T09:30:00-04:00,63.78,64.89,63.78,64.83,6192206,8780424.2,44.08405678073457,37.297986321101995,NaN,NaN,-58.35617206866006,-136.27775698183163,-0.13230288080213604,-1.038351360916252,-0.906048480114116,317541650,305425648.6,16.55015147099752,19.518111465606335,NaN,NaN,-26.004971123492265,-21.064181101436134
2014-10-21T09:30:00-04:00,65.12,66.1572,65.055,66.09,5534453,8782520.6,51.656844766120294,38.56257361505128,NaN,NaN,11.509939542458978,-99.01937162656115,0.044864827729196755,-0.84996744545262,-0.8948322731818168,323076103,308991561.4,22.284270758794648,19.076465690366582,NaN,NaN,-20.93818704736622,-21.046181950854717
2014-10-22T09:30:00-04:00,66.28,66.44,65.465,65.52,7764591,8853597.15,48.45950968733235,39.36630358529546,NaN,NaN,18.978131551759784,-56.25421747366706,0.12534017337265835,-0.7381570564659938,-0.8634972298386522,315311512,314023205,29.631801927470207,19.280059655841608,NaN,NaN,-17.938734905017423,-20.602260944306533
2014-10-23T09:30:00-04:00,66.25,66.855,66.1,66.41,5183770,8880804.75,53.31808333356497,39.930827473852695,NaN,NaN,58.124134046130386,-12.132598268029286,0.23388008216750955,-0.5711471271292652,-0.8050272092967747,320495282,317554798.2,34.32509270835929,19.899978697806098,NaN,NaN,-13.771994151293605,-19.626508545304684
2014-10-24T09:30:00-04:00,66.21,66.4,65.87,66.35,4507076,8976488.6,52.95565800584187,40.65197433321641,NaN,NaN,48.59022923128495,15.769252460594789,0.29316063342885756,-0.43857641751070275,-0.7317370509395603,315988206,318482550.6,35.541357913254544,20.64381676827426,NaN,NaN,-10.65625775332341,-18.345044146450217
2014-10-27T09:30:00-04:00,66.26,66.63,66.06,66.48,3726255,8820368.05,53.690161827619,41.862831607333824,NaN,NaN,62.82431861082609,40.00535059649201,0.32991597298843334,-0.3193420847040187,-0.649258057692452,319714461,318917112.8,36.137948264574206,21.499079485605453,NaN,NaN,-7.939712393139151,-16.858568181691492
2014-10-28T09:30:00-04:00,66.76,67.22,66.53,67.2,7694493,8983676.1,57.63531999373605,42.73212703649819,NaN,NaN,98.02253650844287,57.30786998968879,0.3875266470190146,-0.16484974891868376,-0.5523763959376984,327408954,319783683,37.38254026392622,22.015410290456636,NaN,NaN,-4.384674634234898,-15.076583389197694
2014-10-29T09:30:00-04:00,67.29,67.43,66.65,67,4893621,8900509.6,56.20302321294054,44.07991385063179,NaN,NaN,94.76660830148518,72.46556533963386,0.3955934916018684,-0.057884531435362874,-0.4534780230372313,322515333,321224447.2,39.49387606519886,23.030050126885676,NaN,NaN,-1.8923560487720477,-13.19312234056546
2014-10-30T09:30:00-04:00,66.86,67.64,65,67.44,5101896,8781374,58.63830912169163,45.78238944918595,NaN,NaN,70.53170158927702,74.94707884826319,0.4121260136431005,0.0616794940166443,-0.3504465196264562,327617229,322648836.6,41.59071123616239,24.618078461907395,NaN,NaN,0.9345319751199647,-11.174886009753255
2014-10-31T09:30:00-04:00,68.34,68.405,67.91,68.1,4739419,8770047.35,62.04728994193058,48.08547680534418,NaN,NaN,143.74733182256531,93.97849936651926,0.44619856367398597,0.2073016849660263,-0.23889687870795967,332356648,325922525,46.2049549116412,26.91041798433495,NaN,NaN,4.410722306567569,-8.948370535993137
2014-11-03T09:30:00-05:00,68.26,68.26,67.975,68.1,15926148,9371398.8,62.04728994193058,50.13022474022451,NaN,NaN,133.44515252085984,108.10266614852601,0.44634208916419127,0.31903073274727944,-0.12731135641691183,332356648,328450962.4,49.5217772733633,29.605416895036715,NaN,NaN,7.224753714172194,-6.637924214540947
2014-11-04T09:30:00-05:00,67.74,67.85,66.93,67.28,4944639,9296124.2,55.46083180664045,51.8479563076429,NaN,NaN,85.46437807177197,105.59103446119184,0.37186424730595113,0.3375189527155271,-0.03434529459042403,327412009,328451573.4,49.522587209380184,32.487087083680436,NaN,NaN,7.84868146148373,-4.568409117965993
2014-11-05T09:30:00-05:00,67.85,67.87,67.17,67.55,10753432,9476140.25,57.07652389713118,53.639577706007174,NaN,NaN,87.58965241250948,104.1556432833967,0.32323312931007486,0.36969611704716954,0.04646298773709469,338165441,331581595,53.627448240101856,35.71895342957965,NaN,NaN,8.828679210942166,-2.654539356693399
2014-11-06T09:30:00-05:00,67.64,68.16,67.5447,68.12,11249976,8903599.4,60.346842375181545,55.25855319231406,NaN,NaN,96.23292336502989,109.29588763854727,0.31176014612158776,0.43616317038907937,0.12440302426749163,349415417,335941232.6,58.66900820229733,39.32025188896589,NaN,NaN,10.626037533394316,-0.7573140866808683
2014-11-07T09:30:00-05:00,67.9,68.08,67.72,68.0067,3771021,8541693.3,59.37842280315168,56.35100790820099,NaN,NaN,87.38884183622153,98.02418964127851,0.2798614205724238,0.4742297999830214,0.1943683794105976,345644396,338598782.2,61.42232192651395,42.52540692150278,NaN,NaN,11.841717133889855,1.0425475162578062
2014-11-10T09:30:00-05:00,68.13,68.15,67.56,67.97,2650410,7608388.85,59.047875118910774,56.87893864768603,NaN,NaN,80.53973350068404,87.44310583724334,0.24108299158819502,0.4957221188958414,0.2546391273076464,342993986,340726249.8,63.517544631741806,45.47064076957043,NaN,NaN,12.761745088532564,2.716718598011343
2014-11-11T09:30:00-05:00,68.05,68.27,67.86,68.26,3230380,7207659.05,60.9001163329186,57.76755340808504,NaN,NaN,86.91332501196676,87.7328952252823,0.22032508096387593,0.5300454785124913,0.30972039754861536,346224366,344488721.2,66.93753064504646,48.13533567796868,NaN,NaN,14.048635156505702,4.335563820653395
2014-11-12T09:30:00-05:00,68.04,68.69,68.04,68.58,5266637,6716328.65,62.89444485263183,58.45157923087554,NaN,NaN,98.67257235970182,89.94947921472078,0.21336261059566475,0.5764236607931963,0.36306105019753154,351491003,347153833.6,69.14404268289103,50.62240353329238,NaN,NaN,15.700508517814912,5.959127348819326
2014-11-13T09:30:00-05:00,68.35,69.185,68.35,69.01,10800149,6622135,65.4450031415651,59.34367531199862,NaN,NaN,119.68177956685389,94.63925045508557,0.22194548559110527,0.6404929071864132,0.4185474215953079,362291152,349728980.6,71.14769648684069,53.16571343140567,NaN,NaN,17.853630505420522,7.658342085476639
2014-11-14T09:30:00-05:00,69.08,69.31,68.93,69.28,9557989,6674428.05,66.97981725434971,60.29293641390796,NaN,NaN,132.93454619084866,103.74839132601103,0.22910526853987562,0.7049290072701524,0.4758237387302768,371849141,354969929.6,74.74243808959207,55.92317699033553,NaN,NaN,20.126003074768423,9.439436512518323
2014-11-17T09:30:00-05:00,69.05,69.41,69.01,69.2,4031103,6566372.9,66.04379143274105,60.893541516694036,NaN,NaN,128.75349171897616,113.39114296966946,0.2121393977240873,0.7409979858853859,0.5288585881612986,367818038,359934740,77.59077548268398,58.795193791675366,NaN,NaN,21.7990791831945,11.20509975118635
2014-11-18T09:30:00-05:00,69.05,69.5,69.0241,69.33,4482073,6513753.9,66.85439383363814,61.65435370388672,NaN,NaN,123.88965590774224,120.78640914882456,0.19385961430609788,0.7711831060439209,0.577323491737823,372300111,365149889,80.12609112394077,61.69749486729978,NaN,NaN,23.441685848713316,12.953183479404487
2014-11-19T09:30:00-05:00,69.45,69.67,69.25,69.62,5017599,6376404.3,68.65216955597946,62.369629449192985,NaN,NaN,133.19307276874068,127.69050923063233,0.18548353331249712,0.8091779083784445,0.6236943750659474,377317710,370315230.4,82.2661478483988,64.60288319674524,NaN,NaN,25.358854871383723,14.725422249687234
2014-11-20T09:30:00-05:00,69.3,70.1,69.28,69.92,5353105,6384871.05,70.43843077620234,62.968996651640964,NaN,NaN,139.16923666021563,131.58800064930466,0.18396941128471922,0.8536561391718465,0.6696867278871272,382670815,374391163,83.7528746414016,67.28487746315669,NaN,NaN,27.52157069828601,16.553443456629918
2014-11-21T09:30:00-05:00,70.59,70.655,69.91,70.09,7782249,6548629.7,71.43184864805093,63.63932227350671,NaN,NaN,153.90908141518344,135.78290769417163,0.17812000517933324,0.8923367343612938,0.7142167291819606,390453064,378111947.6,84.98996654204007,69.81831955377646,NaN,NaN,29.648935151775806,18.4242279845079
2014-11-24T09:30:00-05:00,70.46,70.77,70.32,70.74,3342568,6529445.35,74.90441763053016,65.02814983235596,NaN,NaN,158.93442793028706,141.8190949364338,0.20008646964694987,0.9643248162406479,0.764238346593698,393795632,383307466.4,86.53204402340147,72.46185218334941,NaN,NaN,32.6061797839985,20.450221098720842
2014-11-25T09:30:00-05:00,70.98,71.1751,70.7,70.96,4250911,6357266.25,75.96912987252279,66.37762168774108,NaN,NaN,156.53942694461534,148.3490491438084,0.21043823156226327,1.027286136046527,0.8168479044842638,398046543,388456752.8,87.86293097524421,74.90724380728815,NaN,NaN,35.431258741502994,22.590369333404006
2014-11-26T09:30:00-05:00,70.94,71.01,70.822,70.95,2337361,6229453.25,75.81168333597074,67.48225318494032,NaN,NaN,137.36438989251718,149.18331256856374,0.19780977249181342,1.0641101200990306,0.8663003476072172,395709182,392135047.2,88.72039790652659,77.05377164330453,NaN,NaN,37.73712403420165,24.754191433517953
2014-11-28T09:30:00-05:00,71.25,71.95,71.25,71.81,3357172,6142217.05,79.70686892373178,68.93428505069603,NaN,NaN,164.3624840847252,154.22196205346563,0.22651027983742256,1.1494381974039953,0.9229279175665728,399066354,395414155,89.43685577947845,79.05480977565914,NaN,NaN,41.10536444767608,27.0900732926834
2014-12-01T09:30:00-05:00,71.6,71.61,70.92,71.02,11885509,6499521.55,68.75387138948288,69.62757049859404,NaN,NaN,118.00337860469986,147.04082149136892,0.17379504659187062,1.140171725806411,0.9663766792145404,387180845,394759711.2,88.23230297872152,80.82014965758627,NaN,NaN,40.72278122139482,29.03760299678503
2014-12-02T09:30:00-05:00,71.12,71.43,71.08,71.29,5166875,5961557.9,70.25814438031594,70.29600107340814,NaN,NaN,107.98597282587669,136.85113047048682,0.14006403364373377,1.1414567212692077,1.001392687625474,392347720,394470128.8,87.66964683574193,82.30101509977878,NaN,NaN,40.86101312824009,30.726661586992893
2014-12-03T09:30:00-05:00,71.4,71.48,71.09,71.41,5663162,5997484.05,70.92803967051456,70.86982927468547,NaN,NaN,99.78124776413253,125.49949463439027,0.11010831379176844,1.1390280798651844,1.028919766073416,398010882,394462996.6,87.65482072332027,83.62321353123802,NaN,NaN,41.16820945457041,32.21831128236111
2014-12-04T09:30:00-05:00,71.35,71.5099,71.02,71.37,6095058,5764565.35,70.35915672054945,71.22084024461293,NaN,NaN,88.66140374524727,115.75889740493626,0.07362741751645574,1.1209540379689855,1.0473266204525298,391915824,393704325,85.98897115021889,84.68330457862217,NaN,NaN,41.25820464350561,33.509724619667466
2014-12-05T09:30:00-05:00,71.39,71.65,71.37,71.53,4480500,5426091.55,71.3490506312564,71.5329283429634,NaN,NaN,91.27021064637913,101.14044271726706,0.04756477692295147,1.106782591606219,1.0592178146832676,396396324,393170319,84.76782398978011,85.39940357149274,NaN,NaN,41.602459072129946,34.66582954144782
2014-12-08T09:30:00-05:00,71.38,71.5258,70.71,70.95,4202936,5447687.3,63.11986509886652,71.32407646197238,NaN,NaN,58.66696701988532,89.27316040030415,-0.017935137131009693,1.0367988932695056,1.0547340304005153,392193388,394172827.6,85.19295263655656,85.94241622534079,NaN,NaN,39.49591560405503,35.355841836105995
2014-12-09T09:30:00-05:00,70.55,70.88,69.97,70.82,4438030,5537068.3,61.41020703601225,70.93520597642767,NaN,NaN,21.394126282490042,71.95479109162683,-0.07596112991147197,0.9597826180111753,1.0357437479226472,387755358,393254355.2,82.90984078269847,86.14125548668062,NaN,NaN,37.2501192194975,35.62645289087621
2014-12-10T09:30:00-05:00,70.7,70.81,69.81,69.88,5465178,5648808.2,50.713787511646956,69.65389297326107,NaN,NaN,-14.25327972111855,49.147885594576614,-0.17777997211854513,0.8135187827744659,0.991298754893011,382290180,390110214.8,75.45509883051636,85.65475198540331,NaN,NaN,31.660862034759855,35.059939911431016
2014-12-11T09:30:00-05:00,70.19,71.08,70.14,70.45,17569802,6263966.45,55.74728100884292,68.60452513273539,NaN,NaN,9.088217853953374,33.23324841631784,-0.204939943099261,0.7351238260189348,0.9400637691181958,399859982,391699046.4,76.60008800098544,85.143838653945,NaN,NaN,28.43255250660209,34.11317028216974
2014-12-12T09:30:00-05:00,70.14,70.75,69.86,70,12176063,6332762.15,51.293501101708266,67.16607173656806,NaN,NaN,-32.02350787088419,8.574504712865187,-0.2485083269280598,0.629428360458121,0.8779366873861808,387683919,389956565.4,72.60015685010192,84.25885224737799,NaN,NaN,24.257194699477534,32.705173770356566
2014-12-15T09:30:00-05:00,70.39,70.55,69.225,69.577,8882481,6298986.75,47.45550771034744,65.20543531369786,NaN,NaN,-81.63142220519599,-19.485173132151075,-0.29778778170440234,0.5057019602556778,0.8034897419600802,378801438,387278175.4,66.82391204147066,82.85112853438294,NaN,NaN,19.507940989247665,30.81985480162672
2014-12-16T09:30:00-05:00,69.35,69.86,68.45,68.51,9114825,6553172.85,39.439133544279024,62.59614986168045,NaN,NaN,-165.56558555817523,-56.87711550028414,-0.38848337156680535,0.3178855275015735,0.7063688990683789,369686613,383664426.4,59.89925446801382,80.85372306958075,NaN,NaN,12.322032458163221,28.177308752560506
2014-12-17T09:30:00-05:00,68.82,69.94,68.64,69.82,9713907,6814764.55,50.495815677860406,60.78787360038685,NaN,NaN,-113.9359500434755,-76.81364956475552,-0.3478033607688634,0.27161469810729955,0.619418058876163,379400520,383086494.4,58.84896579609262,78.7200493474069,NaN,NaN,10.086560231528898,25.592916106698848
2014-12-18T09:30:00-05:00,70.81,70.97,70.07,70.97,18848499,7506309.55,57.78259342393565,59.22185392183,NaN,NaN,7.257828706282382,-77.17972739428971,-0.2363302940301415,0.32400519133848604,0.5603354853686275,398249019,382764301.8,58.23590772213489,76.49141020045381,NaN,NaN,11.097165690229655,23.52209461863182
2014-12-19T09:30:00-05:00,70.88,71.07,70.46,70.87,9830143,7730161.45,56.9969382333488,58.38207298210613,NaN,NaN,17.39181022766096,-67.2966637745807,-0.1655625489033712,0.35338229923941356,0.5189448481427847,388418876,382911293.2,58.448579423699336,74.36400137509507,NaN,NaN,11.559706188242867,21.813181985719112
2014-12-22T09:30:00-05:00,71,71.56,71,71.56,4951201,7588609.05,60.94303078910248,57.71670772559089,NaN,NaN,79.75969239720708,-35.01844085410008,-0.07322456795278998,0.4274141382017973,0.5006387061545873,393370077,385825021,62.52255456235226,72.56778049842438,NaN,NaN,13.354132217449132,20.604746304537684
2014-12-23T09:30:00-05:00,71.8,72.19,71.71,71.96,7337251,7788343.2,63.05928931060452,57.15465412845445,NaN,NaN,131.6741999963991,24.429516256814786,0.009452480479582692,0.5124543067540657,0.503001826274483,400707328,392029164,69.4018656693494,71.26399799456934,NaN,NaN,15.507939359638426,19.876631026694934
2014-12-24T09:30:00-05:00,72.15,72.15,71.82,71.84,1687799,7660187.6,61.97439258720657,56.55574240464425,NaN,NaN,115.81714510981571,70.38013528747304,0.048533446776504174,0.5636686347451132,0.515135187968609,399019529,395952965.8,72.80217961855381,70.32208431373611,NaN,NaN,16.841096654248247,19.44298325920255
2014-12-26T09:30:00-05:00,72.04,72.38,71.94,72.23,14102317,8248435.4,64.13407272216551,56.040386839709086,NaN,NaN,124.07338212123067,93.7432459704627,0.09067693556036249,0.6284813574190622,0.5378044218586997,413121846,398927531.2,75.06444835539875,69.62898605413746,NaN,NaN,18.62536238271316,19.326180276846923
2014-12-29T09:30:00-05:00,72.19,72.91,72.03,72.78,23013595,9231256.55,66.98210810557799,56.31626134018848,NaN,NaN,148.57324717379788,119.97953335969007,0.1425348779198734,0.7159730192585414,0.573438141338668,436135441,408470844.2,80.63091416344764,69.3031261632011,NaN,NaN,21.043323645917177,19.571486472428386
2014-12-30T09:30:00-05:00,72.58,72.76,72.29,72.44,6051237,8939542.95,63.618924694463324,56.4740268872207,NaN,NaN,125.492948958602,129.12618467196904,0.14064058593436513,0.7492388737566245,0.6085982878222593,430084204,415813669.6,83.65441298767574,69.35630989212805,NaN,NaN,22.00604599332994,19.919280689700038
2014-12-31T09:30:00-05:00,72.67,72.975,72.12,72.15,6663959,9014397.15,60.81413663337298,57.19548039591542,NaN,NaN,106.77987871267274,124.14732041522379,0.10802507157814156,0.7436296272949363,0.6356045557167948,423420245,420356253,85.19418811109149,70.05195912645485,NaN,NaN,21.960555734307246,20.21089141035821
2015-01-02T09:30:00-05:00,72.53,72.6545,71.14,71.63,6185492,9040513.65,56.04296683052562,57.2166008117499,NaN,NaN,55.33329747148512,112.05055088755766,0.04293957569864326,0.6892790253400989,0.6463394496414556,417234753,423999297.8,86.3081378140377,70.7453912559586,NaN,NaN,20.4715280436564,20.248125215115095
2015-01-05T09:30:00-05:00,71.36,71.53,70.11,70.26,8582863,9164903.9,45.83922424852245,56.827009607950906,NaN,NaN,-32.03561920289907,80.82875062273172,-0.09342846853268993,0.5295538639755932,0.6229823325082832,408651890,423105306.6,84.62550997946657,71.60434505091321,NaN,NaN,15.602313189802747,19.584437782927616
2015-01-06T09:30:00-05:00,70.55,70.574,69.09,69.56,7172952,9299526.5,41.66503370927232,56.41340432215983,NaN,NaN,-89.64616681272845,33.18486782542645,-0.22435561774611634,0.3425378103256378,0.5668934280717541,401478938,416174006,72.77857408555451,72.02967805406205,NaN,NaN,10.10862177142972,18.23074978128506
2015-01-07T09:30:00-05:00,70.73,70.73,70.01,70.66,7410982,9459928.8,49.4543311239594,57.128775577851286,NaN,NaN,-33.84529819971286,1.3172183937634743,-0.22962595515425888,0.27986098412893057,0.5094869392831894,408889920,411935149.2,66.63493865453856,72.51079835309953,NaN,NaN,8.08303599679568,16.781076383500864
2015-01-08T09:30:00-05:00,71.25,71.82,70.92,71.72,6399125,9557983.55,55.60598165911276,57.49378743365503,NaN,NaN,35.80798619531212,-12.877160109708655,-0.15789010005641774,0.3121243142126673,0.470014414269085,415289045,410308909.2,64.38921855720169,72.90653069317875,NaN,NaN,8.596903162770072,15.611908780539322
2015-01-09T09:30:00-05:00,71.71,71.77,70.81,70.89,5629153,9566182.3,50.43042306245775,56.96863240783518,NaN,NaN,9.153813373556515,-22.11305692929438,-0.1619042885552725,0.26763405357499437,0.42953834213026687,409659892,408793937,62.28335452745558,73.19563403641595,NaN,NaN,7.165638374696962,14.405298722561842
2015-01-12T09:30:00-05:00,71.03,71.12,70.22,70.51,6028349,8989109.65,48.217674017554955,56.341542106707045,NaN,NaN,-30.901781292580097,-21.88628934723055,-0.1840997451226447,0.19941366072696098,0.3835134058496057,403631543,407789867.6,60.862624371855624,73.36806581842711,NaN,NaN,5.289025180080672,13.102973930778818
2015-01-13T09:30:00-05:00,71.29,71.69,69.96,70.51,7551630,8757888,48.21767401755496,55.432588051596504,NaN,NaN,-25.922020512917136,-9.141460087268289,-0.1918570329667606,0.14369211464115494,0.33554914760791554,403631543,408220388.6,61.27056416017275,73.27863793255713,NaN,NaN,3.842740973135327,11.780083508258318
2015-01-14T09:30:00-05:00,69.56,69.93,68.86,69.66,10175032,8822515.55,43.290103272214594,54.02050333456865,NaN,NaN,-116.76177489702873,-25.724755426731463,-0.24396583978004427,0.03059184788286018,0.27455768766290445,393456511,405133706.8,56.706814424075006,72.37184855789468,NaN,NaN,1.0037955163533676,10.24061379512904
2015-01-15T09:30:00-05:00,69.82,70.1,68.74,68.76,8051225,8769335.55,38.77202861162255,52.36319162202694,NaN,NaN,-140.956551133687,-61.07766289253129,-0.3237765253854252,-0.13016296906887703,0.19361355631654814,385405286,399156955,49.08320105262984,70.67763580318584,NaN,NaN,-2.927549860860718,8.359447558559074
2015-01-16T09:30:00-05:00,68.8,69.745,68.5,69.67,9552095,8761244.95,45.02018152060495,50.99791367905833,NaN,NaN,-131.17645401526718,-89.14371637029603,-0.30051848021821476,-0.18203454395622032,0.11848393626199444,394957381,396216452.8,45.81945399824055,68.58870763481738,NaN,NaN,-4.181374610807475,6.567901534363853
2015-01-20T09:30:00-05:00,69.75,69.9,68.65,69.27,13937262,8515683.1,42.945630845631825,49.28102244620503,NaN,NaN,-118.94782969560094,-106.75292605090019,-0.29679437373171064,-0.25250903090264387,0.04428534282906678,381020119,391694168,41.27396236656516,65.77749679218293,NaN,NaN,-5.859648880472374,4.792537189387249
2015-01-21T09:30:00-05:00,69.23,69.94,69.03,69.72,9372030,8492777.45,45.96245253583854,48.019845863446115,NaN,NaN,-88.71206483427328,-119.31093491517143,-0.2505875167327275,-0.2689490530868426,-0.018361536354115096,390392149,389046289.2,38.8441041175608,62.57676044431757,NaN,NaN,-6.285618892224583,3.209943463442702
2015-01-22T09:30:00-05:00,69.95,71.15,69.7,71.03,15175069,9003970.85,53.64644979989915,47.5078682324837,NaN,NaN,-16.89878572210348,-99.33833708018638,-0.12472120401479739,-0.17426304137261184,-0.04954183735781445,405567218,391468430.6,42.19642474863087,59.505491632713245,NaN,NaN,-4.082537437674547,2.1681604775688097
2015-01-23T09:30:00-05:00,71.11,71.2799,70.75,70.93,4981682,8886192.4,53.0265826818893,47.29241222186682,NaN,NaN,10.690939651093757,-69.00883892323023,-0.04522264893968801,-0.10607014853242447,-0.060847499592736456,400585536,394504480.6,46.17890692788417,56.63911799798799,NaN,NaN,-2.5505338898877894,1.494061282217867
2015-01-26T09:30:00-05:00,70.9,71.34,70.68,71.3,3453401,8974472.5,55.09409212074932,47.95347421274016,NaN,NaN,23.08315371098634,-38.156917377979525,0.031143421874296404,-0.02191822224986595,-0.05306164412416235,404038937,396320791.8,48.46637911825674,54.056322936473,NaN,NaN,-0.6549933228444496,1.187053481494679
2015-01-27T09:30:00-05:00,70.49,71.19,70.26,70.73,5886188,8563666.05,51.34479720841716,48.64488589125051,NaN,NaN,0.592349357351974,-14.248881567388935,0.041483290471972266,-0.001207531034197018,-0.042690821506169284,398152749,399747317.8,52.56250687246531,52.612318135538054,NaN,NaN,-0.17970307596886909,0.9918025447141721
2015-01-28T09:30:00-05:00,71.1,71.14,69.73,69.81,5197512,7672861.9,45.913734187050494,48.39198611004273,NaN,NaN,-33.1128203951775,-3.1290326795697765,-0.012533549483510535,-0.058357758360557455,-0.04582420887704692,392955237,400259935.4,53.16230146638253,51.649986907812625,NaN,NaN,-1.463817114658299,0.6409997362323905
2015-01-29T09:30:00-05:00,70.04,70.895,69.64,70.76,8535017,7797050.9,51.606178361873475,48.10628587452563,NaN,NaN,-6.576913715313734,-1.0646582782118303,0.015311322279157533,-0.026685056028100007,-0.04199637830725754,401490254,399444542.6,52.035268399362735,50.76756189653842,NaN,NaN,-0.741005864241836,0.4435703647360724
2015-01-30T09:30:00-05:00,70.53,70.92,69.9,69.99,8027676,7865236.75,47.26412453251298,47.8801216938153,NaN,NaN,-13.344054861410749,-5.871657180712736,-0.0167954245344185,-0.06299065897528067,-0.04619523444086217,393462578,398019951,50.03930601322096,49.89298700266452,NaN,NaN,-1.5335307763311792,0.1611273445836079
2015-02-02T09:30:00-05:00,70.17,70.67,69.06,70.62,20849371,8598430.7,50.9039032236826,48.0719952085387,NaN,NaN,-22.717951887233838,-15.03187830035677,0.004587413820732342,-0.04046096716494674,-0.04504838098567908,414311949,400074553.4,52.84844159127991,49.320545375480535,NaN,NaN,-1.0259922087486586,-0.008461163035287322
2015-02-03T09:30:00-05:00,71.03,72.13,70.86,72.12,5614407,8450007.9,58.286091179961595,48.79116786299632,NaN,NaN,147.6421598685812,14.378083801889073,0.11388647605146154,0.09730971407864786,-0.016576761972813686,419926356,404429274.8,58.211563052827444,49.10204529638444,NaN,NaN,1.9668669448196854,0.2737285666582802
2015-02-04T09:30:00-05:00,72.11,72.965,72.04,72.6,9165977,8549659.15,60.34109895562051,50.00909612609674,NaN,NaN,203.56868051022943,61.71438398297046,0.20720649932703686,0.24243136218598238,0.03522486285894552,429092333,411656694,65.27169370070683,49.71382238757242,NaN,NaN,5.048529863772211,0.9558430376745559
2015-02-05T09:30:00-05:00,72.65,73.09,72.56,73.05,5077541,8432987.1,62.220192013366834,51.68396494050705,NaN,NaN,196.46494153629277,102.32275503329177,0.2832323852867553,0.3892653444673897,0.10603295918063435,434169874,418192618,70.1784574344728,51.220626414846926,NaN,NaN,8.152252615465802,1.983901548787591
2015-02-06T09:30:00-05:00,73.15,73.3,72.71,72.94,4648325,8345447.1,61.45367756652918,52.8577860866445,NaN,NaN,178.32372442029006,140.65631088963192,0.30804980281518796,0.4910952126996193,0.18304540988443135,429521549,425404412.2,74.46551792560047,53.266773838229774,NaN,NaN,10.396032614504906,3.185634558175779
2015-02-09T09:30:00-05:00,72.53,72.93,72.46,72.66,4367548,8282366.85,59.44614444369521,54.03639420079188,NaN,NaN,134.23548871717603,172.0469990105139,0.2879186637064413,0.542943739517483,0.25502507581104167,425154001,427572822.6,75.60126007866697,55.71872367480847,NaN,NaN,11.666728862448478,4.397219458786164
2015-02-10T09:30:00-05:00,73.25,73.69,72.86,73.55,5562004,8259049.6,63.52490264896515,55.290854923158065,NaN,NaN,149.1125293697131,172.34107291074025,0.31468038946507526,0.6483755626423857,0.33369517317731046,430716005,429730752.4,76.71139723572747,58.423530326106096,NaN,NaN,14.024575090611824,5.772555977618401
2015-02-11T09:30:00-05:00,73.65,73.76,73.24,73.57,5313725,8147154.35,63.61346745063204,56.002784755353275,NaN,NaN,132.97566654047395,158.22247011678917,0.3131921727886442,0.7251853891631157,0.4119932163744715,436029730,431118231.8,77.42270105340809,60.93969291930447,NaN,NaN,15.94945873627844,7.226399228855549
2015-02-12T09:30:00-05:00,73.89,74.468,73.68,74.44,4130750,7844940.25,67.32961452474679,57.024429886985956,NaN,NaN,142.62309625760997,147.4541010610526,0.3476066401945541,0.8465015166176642,0.49889487642311003,440160480,432316353,78.04626223470628,63.21593258407747,NaN,NaN,18.773381557819786,8.875968132993297
2015-02-13T09:30:00-05:00,74.53,74.89,74.44,74.89,5332412,7708999.6,69.08816544085259,58.02400655270761,NaN,NaN,145.4365618246238,140.87666854191937,0.3751244665340764,0.9678004595907055,0.5926759930566291,445492892,435510621.6,79.65924428553993,65.44399438174057,NaN,NaN,21.681021803808136,10.705261514538273
2015-02-17T09:30:00-05:00,74.78,75.07,74.41,74.72,4121976,7437493.65,67.60763439216106,59.18563778011789,NaN,NaN,127.56139652372424,139.54185010322902,0.356455145829467,1.038244925343463,0.6817897795139959,441370916,438754004.6,81.17189662536762,67.48752222123359,NaN,NaN,23.666723134545826,12.556898888825067
2015-02-18T09:30:00-05:00,74.56,74.77,74.43,74.68,4143943,6947827.7,67.24249939572864,60.709121009309186,NaN,NaN,110.24874774488653,131.76909377826368,0.31729915570775435,1.0784137241486889,0.7611145684409345,437226973,440056198.2,81.75843461655167,69.53010316053138,NaN,NaN,25.206763555416345,14.364022412623822
2015-02-19T09:30:00-05:00,74.76,75.075,74.76,74.91,3272456,6642849,68.30256883707912,61.90172032896674,NaN,NaN,112.11504598026725,127.59696966622235,0.28386272006442526,1.1159429685214661,0.8320802484570409,440499429,440950138,82.169092736744,71.68251918463005,NaN,NaN,26.80465899674201,16.141256210354992
2015-02-20T09:30:00-05:00,74.66,75.46,74.46,75.44,3930846,6080637.85,70.65888161412181,63.57277440622452,NaN,NaN,110.41938270718406,121.15622695613717,0.27426230215620984,1.1749081261523031,0.9006458239960933,444430275,441804097,82.57270261124904,74.00633322734633,NaN,NaN,28.867372019747258,17.959272754553886
2015-02-23T09:30:00-05:00,75.39,75.61,75.14,75.37,3121192,5987613.35,69.91959199163809,64.9310378896499,NaN,NaN,109.90695622208275,114.05030583562896,0.2411894105999013,1.2021325872459698,0.9609431766460685,441309083,440967335.2,80.6464072661026,75.99190220411938,NaN,NaN,30.403589396808634,19.737032274875993
2015-02-24T09:30:00-05:00,75.63,75.8,75.49,75.73,3518588,5990872.7,71.56720979292221,65.87968921914708,NaN,NaN,110.69879636349748,110.6777858035836,0.22203003891130502,1.2384807252852,1.016450686373895,444827671,441658686.2,81.03996366174202,77.6225022476133,NaN,NaN,32.18823528228983,21.5157755616494
2015-02-25T09:30:00-05:00,75.79,76.52,75.7,76.31,6842105,6038668.55,74.03480811066981,66.85781130165061,NaN,NaN,119.37886035411876,112.50380832543006,0.22612959251855957,1.2991126770220944,1.0729830845035349,451669776,444547246.8,82.62934846440653,78.8623347307347,NaN,NaN,34.473121188358334,23.366824936893533
2015-02-26T09:30:00-05:00,76.24,76.36,75.895,76.07,3504697,5954027.8,71.27817182416027,67.50480985956442,NaN,NaN,106.99141055275122,111.47908123992684,0.19174660511355257,1.3126663408954755,1.120919735781923,448165079,446080376.8,83.42360737825243,79.8084168695761,NaN,NaN,35.683757921882965,25.126386791892024
2015-02-27T09:30:00-05:00,76.03,76.2162,75.9,75.97,3869124,5720733.15,70.10684688539308,68.12289338234042,NaN,NaN,95.64894039237988,108.524992776966,0.14354336318280203,1.3003489397604255,1.1568055765776235,444295955,446053512.8,83.35168951479241,80.44314341166125,NaN,NaN,36.398369473766415,26.736670032159793
2015-03-02T09:30:00-05:00,76.02,76.91,76,76.88,24004370,6519567.85,74.25323197066405,69.18054249140961,NaN,NaN,115.22936699200662,109.58947493095077,0.1533334231475476,1.3484723555120581,1.1951389323645105,468300325,451451761.2,85.9692441135077,81.18371369986416,NaN,NaN,38.25084660659868,28.381552399936776
2015-03-03T09:30:00-05:00,76.73,76.75,76.1412,76.67,6025539,5778376.25,71.77890371908695,69.77011399641832,NaN,NaN,108.05112358597377,109.05994037544603,0.12713408873944765,1.35405654328882,1.2269224545493724,462274786,454941184.2,87.35339942246253,81.94385671320238,NaN,NaN,39.11727866018416,29.915227579972118
2015-03-04T09:30:00-05:00,76.62,76.62,75.95,76.27,4666313,5730971.55,67.18640804954413,70.02532403919774,NaN,NaN,90.40994711251805,103.26615772712589,0.06733559114074561,1.3110919434753043,1.2437563523345587,457608473,456128923.6,87.79476859767831,82.68471868065025,NaN,NaN,38.570069007244854,31.151633498153938
2015-03-05T09:30:00-05:00,76.51,76.52,76.1801,76.32,7784685,5661906.95,67.46661306801465,70.03510964943118,NaN,NaN,86.35952327551064,99.13978027167776,0.018177002319747615,1.2664776052342432,1.2483006029144956,465393158,459574539.4,88.99471004998753,83.46675066745605,NaN,NaN,38.190887136315574,32.157241160748455
2015-03-06T09:30:00-05:00,76.06,76.17,75.255,75.41,7852495,5800654.65,57.79367287021002,69.22836018009956,NaN,NaN,35.62991318213258,87.1359748296283,-0.08304210968204728,1.1444979658119365,1.2275400754939838,457540663,462223481,89.82307343874623,84.19273846411365,NaN,NaN,34.95340296075051,32.55669284646304
2015-03-09T09:30:00-04:00,75.47,75.93,75.41,75.84,4224972,5779487,60.66363130458991,68.73235995955876,NaN,NaN,37.549112875427454,71.59992400631248,-0.12588073664451827,1.070189154688336,1.1960698913328542,461765635,460916543,86.3689004568397,84.56395302350451,NaN,NaN,33.006989493219756,32.62102093885685
2015-03-10T09:30:00-04:00,75.24,75.31,74.64,74.66,7146321,5918425.65,50.5128756355087,67.53738683382876,NaN,NaN,-38.77451818619666,42.23479565187838,-0.2323414660740013,0.9056430587403526,1.1379845248143539,454619314,459385448.6,82.37249047984544,84.60781415659692,NaN,NaN,27.828184344392653,31.936329996790537
2015-03-11T09:30:00-04:00,74.79,74.86,74.23,74.25,4592445,5869947.7,47.53652602132821,66.05409806127513,NaN,NaN,-85.74774133556504,7.003257962261756,-0.3234292950715234,0.7336979059749495,1.057127201046473,450026869,457869127.8,78.49859129255626,84.34563548201209,NaN,NaN,22.593184835036748,30.601594973682854
2015-03-12T09:30:00-04:00,74.54,75.81,74.54,75.76,6921541,5950338.5,57.474707708004495,65.11237135369532,NaN,NaN,-10.803772244795896,-12.429401141799554,-0.27683963807292267,0.7110776534553196,0.9879172915282423,456948410,456180178.2,74.3067515164023,83.75521040380875,NaN,NaN,21.21457956106919,29.2605927718809
2015-03-13T09:30:00-04:00,75.65,75.74,74.77,75.16,5582834,6022942.7,53.16512047459682,63.91562338819238,NaN,NaN,-34.4330733080432,-26.441998439834663,-0.28042300403490783,0.6373885364846075,0.9178115405195153,451365576,454945160.8,71.30812154775946,83.08818999535568,NaN,NaN,18.59096208743481,27.736359816960032
2015-03-16T09:30:00-04:00,75.44,76.08,75.44,76.04,5450696,6028856.9,58.12457832002895,62.95543542584285,NaN,NaN,32.93289302451983,-27.365242410016187,-0.22017671961055463,0.642590641006322,0.8627673606168766,456816272,453955288.2,68.90788293093776,82.22161280029822,NaN,NaN,18.14367705272663,26.36597656492669
2015-03-17T09:30:00-04:00,75.54,75.8375,75.363,75.62,4927311,6069123.65,55.124315454541424,61.604685950405106,NaN,NaN,-2.1760568009949104,-20.04555013297584,-0.20554259237347172,0.605839120150037,0.8113817125235088,451888961,453409217.6,67.55693217788048,81.14501163697493,NaN,NaN,16.769975042493456,24.995119204579087
2015-03-18T09:30:00-04:00,75.48,76.53,74.92,76.29,7718509,6247851.95,58.77960540231355,60.71193120598748,NaN,NaN,32.2286503345041,3.549728201037989,-0.15023470003229367,0.6235883374831417,0.7738230375154354,459607470,455325337.8,69.7946874166746,80.17151735400509,NaN,NaN,16.865726083358773,23.83377733011904
2015-03-19T09:30:00-04:00,76.32,76.91,75.9043,76.18,4555471,6312002.7,57.94509834131239,59.8432348814103,NaN,NaN,83.6914244393118,22.448767537859528,-0.12176797332117029,0.6216130708639724,0.7433810441851427,455051999,454946055.6,68.78334469389947,79.13092129536986,NaN,NaN,16.67749532741262,22.81145132973241
2015-03-20T09:30:00-04:00,76.43,76.93,76.27,76.77,6243345,6427627.65,61.1324808194114,58.90603837060653,NaN,NaN,118.60253791914403,53.05588978329697,-0.06666714356571268,0.6600471147280018,0.7267142582937145,461295344,456932009.2,71.1413426697201,78.07178547795647,NaN,NaN,17.528010410395385,22.056674055541407
2015-03-23T09:30:00-04:00,76.72,77.129,76.63,76.64,3730691,6458102.6,60.05247891189242,58.06843659866406,NaN,NaN,124.58640228967738,71.38659163632849,-0.04355782059913316,0.672266982544798,0.7158248031439312,457564653,457081685.4,71.31719455183311,76.92634227291151,NaN,NaN,17.88896018694068,21.461286360027017
2015-03-24T09:30:00-04:00,76.61,76.75,76.22,76.24,5275561,6545951.25,56.731413503404866,57.32165127393983,NaN,NaN,63.031036085199716,84.4280102135674,-0.05884307535237654,0.6422709589534605,0.7011140343058371,452289092,457161711.6,71.41747945365397,75.7565359054812,NaN,NaN,17.210103011898077,20.853974453151455
2015-03-25T09:30:00-04:00,76.12,76.31,75,75,5925751,6500133.55,47.88972500580197,55.92330212663892,NaN,NaN,-62.471345059972364,65.48801113467212,-0.1508647516173527,0.5125330947841462,0.6633978464014989,446363341,454512885.8,63.50313450583853,73.93570908089912,NaN,NaN,13.720546848113898,19.83491336671752
2015-03-26T09:30:00-04:00,74.57,74.98,74.231,74.53,5054070,6577602.2,45.025351960510875,55.011279204517564,NaN,NaN,-148.85287129897966,18.979151987013825,-0.2366759495006171,0.3675529095257275,0.6042288590263446,441309271,451764340.2,56.505727156716446,71.55589863218272,NaN,NaN,9.921718214623462,18.41874263070408
2015-03-27T09:30:00-04:00,74.42,75.06,74.42,74.91,3361860,6552239,47.74662431175881,54.08863584788677,NaN,NaN,-107.71280453608436,-26.283916504031858,-0.2593117284532883,0.28008919845973423,0.5394009269130225,444671131,448439497.6,49.41267452058128,68.91616820816427,NaN,NaN,7.628653712194769,16.87730135663132
2015-03-30T09:30:00-04:00,75.16,75.9,75.16,75.68,4593003,5581670.65,52.84073514723949,54.2549115272961,NaN,NaN,-16.202814863309545,-54.44175993462924,-0.21568386102357318,0.2697961006335561,0.48547996165712926,449264134,446779393.8,46.28831553520773,66.33872714069012,NaN,NaN,7.2540779517262814,15.502555155930601
2015-03-31T09:30:00-04:00,75.57,76.15,75.13,75.35,8129812,5686884.3,50.56555036405121,54.471270408919175,NaN,NaN,-15.779807607750566,-70.20392867321928,-0.2025181117356244,0.2323323219875988,0.4348504337232232,441134322,444548439.8,42.40764496170299,63.760802402772036,NaN,NaN,6.249307694966012,14.180662661507089
2015-04-01T09:30:00-04:00,75.18,75.38,74.53,75.02,7350680,5821102.65,48.324755146610144,53.81770236881958,NaN,NaN,-80.19284724821253,-73.74822911086733,-0.20867401854084988,0.1740079105471608,0.3826819290880107,433783642,442032500,38.488750841696366,61.202373783150186,NaN,NaN,4.744454671036675,12.832632948582745
2015-04-02T09:30:00-04:00,74.95,75.81,74.87,75.69,4464777,5655107.25,52.889444255517674,53.79801121031392,NaN,NaN,-13.969928467095052,-46.77164054449041,-0.16232438813936118,0.1797764439138092,0.3421008320531704,438248419,441420329.6,37.57879771730603,58.793136366689225,NaN,NaN,4.8346787746683555,11.690068066594975
2015-04-06T09:30:00-04:00,75.25,76.365,75.16,76.05,4989338,5511949.4,55.18036145159796,53.587710005426,NaN,NaN,38.13328547340428,-17.602422542592677,-0.10490853410083834,0.21096516442712243,0.31587369852796077,443237757,441133654.8,37.136023345607484,56.52371782487991,NaN,NaN,5.600481009504911,10.820127058439251
2015-04-07T09:30:00-04:00,76.05,76.19,75.63,75.63,3148778,5458139.7,52.00310746347772,53.364766577492865,NaN,NaN,31.711125312112088,-8.019634507508352,-0.09310508942664492,0.1994923367446546,0.2925974261712995,440088979,439298623.8,34.346317901084305,54.15153109082304,NaN,NaN,5.308856903107249,10.03280275053468
2015-04-08T09:30:00-04:00,75.82,76.35,75.76,76.34,4248503,5313248.8,56.556982581110525,53.206007804549806,NaN,NaN,67.6918148963994,8.674689993321635,-0.038183209910904514,0.24486841378266888,0.2830516236935734,444337482,439939255.8,36.14965173310288,51.74831425628221,NaN,NaN,6.448431340934702,9.520749692020397
2015-04-09T09:30:00-04:00,76.33,76.64,75.86,76.41,5251568,5346204.95,56.9902532167146,53.13780458136425,NaN,NaN,79.93937440740834,40.7011343244458,0.0001290959580559914,0.2832129936411434,0.2830838976830874,449589050,443100337.4,44.282136519312786,49.99822795809745,NaN,NaN,7.496001383687482,9.231499933687124
2015-04-10T09:30:00-04:00,76.51,76.75,76.4,76.67,3972134,5198734.6,58.64022834444165,52.95978654743784,NaN,NaN,109.3282511164497,65.36077024115475,0.038147510353937986,0.33076828562550986,0.2926207752715719,453561184,446162890.4,50.81794410274333,48.546556631884826,NaN,NaN,8.848887010592914,9.176840944673666
2015-04-13T09:30:00-04:00,76.6,76.83,76.2325,76.25,3146786,5076932.2,54.971554084613416,52.59686334548933,NaN,NaN,79.09540421591201,73.55319398965631,0.03050577387449549,0.33075299261469127,0.3002472187401958,450414398,447598218.6,53.56700157843299,47.278685705213384,NaN,NaN,8.979940776772638,9.148712349259233
2015-04-14T09:30:00-04:00,76,76.45,75.74,76.21,2920343,4950414.55,54.621069369644744,52.44612447879218,NaN,NaN,34.90482975363916,74.19193487796171,0.018826915285490464,0.32378086284705887,0.3049539475615684,447494055,449079233.8,56.282358047390204,46.197605604765975,NaN,NaN,8.992874645232364,9.126449820112537
2015-04-15T09:30:00-04:00,76.4,76.64,76.17,76.21,5759310,4992014.5,54.621069369644744,52.92693479049524,NaN,NaN,56.6288745016124,71.97934679900432,0.007739688040399317,0.31462855761206754,0.3068888695716682,447494055,449710548.4,57.42529627109234,45.76347430228411,NaN,NaN,9.003627907980889,9.108903832665158
2015-04-16T09:30:00-04:00,76.38,76.525,76.18,76.36,6859851,4949081.6,55.84542452914167,53.69979711682601,NaN,NaN,53.61867212290891,66.71520634210444,0.007159503890838859,0.31583824943521677,0.3086787455443779,454353906,450663519.6,59.160939265284775,45.95313231003899,NaN,NaN,9.326372708123204,9.13997081487345
2015-04-17T09:30:00-04:00,75.95,75.98,74.99,75.23,8591523,5150884.2,45.81664071355862,53.561941145526,NaN,NaN,-59.78078138658873,32.893399841496745,-0.06850758263404455,0.22304426725182225,0.2915518498858668,445762383,449103759.4,55.194785419792424,46.366140231411215,NaN,NaN,6.724786366470657,8.794944465101622
2015-04-20T09:30:00-04:00,75.55,76.185,75.55,76.06,4099946,5043714.25,52.55610452369942,53.54161038670171,NaN,NaN,11.469355574924371,19.368190113299214,-0.06203232746209164,0.21401144055825227,0.2760437680203439,449862329,448993345.6,54.91413297309753,46.982270048403336,NaN,NaN,6.443120063408221,8.458969550573993
2015-04-21T09:30:00-04:00,76.36,76.42,75.89,76.14,3917476,5053053.5,53.16083951541341,53.72698818322758,NaN,NaN,47.50382726137347,21.887989614846077,-0.052133151093244234,0.21087732915378865,0.2630104802470329,453779805,450250495.6,57.56015238258182,48.06459200703754,NaN,NaN,6.393578859868339,8.163913737616042
2015-04-22T09:30:00-04:00,76.34,76.35,75.77,76.21,3463336,4962442.25,53.71674554428919,54.11213035449037,NaN,NaN,45.05191027900938,19.572596770325468,-0.041126213074801465,0.21160271390353103,0.2527289269783325,457243141,452200312.8,61.34898153821431,49.697465628217394,NaN,NaN,6.509305464106148,7.927541127114629
2015-04-23T09:30:00-04:00,76.1,76.99,76.06,76.59,4135761,4872942.75,56.71972611269988,54.385721915717674,NaN,NaN,98.74682967142793,28.598228280029282,-0.010124742652280971,0.24007299866298126,0.25019774131526223,461378902,453605312,63.853176883191864,51.57420699720924,NaN,NaN,7.4622239339392795,7.861067242375293
2015-04-24T09:30:00-04:00,77.25,77.69,77.12,77.63,4827756,4861627.05,63.66767008878461,54.99195824694529,NaN,NaN,213.4104067061071,83.23646589856844,0.07392649947178093,0.3426058656549884,0.2686793661832075,466206658,457694167,69.95418457977713,53.918361371078504,NaN,NaN,10.546950410433446,8.244764837812172
2015-04-27T09:30:00-04:00,77.82,77.8895,76.87,76.95,6925297,5039798.9,57.20167580254641,55.363284556878774,NaN,NaN,168.60509771480577,114.66361432654472,0.0768873305407961,0.3647885293592026,0.2879011988184065,459281361,459577973.4,72.27589581400035,56.62761693628679,NaN,NaN,11.165714701439954,8.662043389758997
2015-04-28T09:30:00-04:00,76.83,76.88,76.13,76.68,5566235,5088460.5,54.820986394791355,55.23928482928454,NaN,NaN,60.43991906533838,117.25083268733769,0.05485705167189703,0.3564725134082778,0.30161546173638076,453715126,459565037.6,72.23461851235524,59.20511456337624,NaN,NaN,10.933356570530318,8.986516701297758
2015-04-29T09:30:00-04:00,76.32,76.62,75.85,76.16,7243530,5044146.4,50.4647967461855,54.77318079567532,NaN,NaN,1.133665472614762,108.46718372605878,0.0022382466021624303,0.3044132699890838,0.30217502338692137,446471596,457410728.6,65.52322830963102,60.72233540554184,NaN,NaN,9.373100199437264,9.041742915317688
2015-04-30T09:30:00-04:00,75.8,76.29,74.97,75.31,10702743,5211749.55,44.271968549078046,53.74687652457793,NaN,NaN,-124.22063824585553,63.87369014260209,-0.08785941985840856,0.19235074856391066,0.2802101684223192,435768853,452288718.8,52.931194207957134,60.87328184162853,NaN,NaN,5.959855825397085,8.601473331043316
2015-05-01T09:30:00-04:00,75.69,76.38,75.5901,76.35,6110220,5294021.7,52.028735859858905,53.53667522280974,NaN,NaN,-29.74153061449128,15.243302678482413,-0.07590940799197282,0.18532340843235318,0.261232816424326,441879073,447423201.8,44.23482130521394,60.20669753639861,NaN,NaN,5.60573987765312,8.17351140913043
2015-05-04T09:30:00-04:00,76.95,76.95,76.395,76.51,3920894,5240599.5,53.110065272799645,53.42874635874938,NaN,NaN,60.839255791073896,-6.309865706263953,-0.05661085897455745,0.1904692427061292,0.24708010168068664,445799967,444726923,40.28489341944203,59.06402149154517,NaN,NaN,5.679749907675272,7.8172597660654075
2015-05-05T09:30:00-04:00,76.75,76.75,75.69,75.71,7856800,5476000.6,47.36152924457133,52.910207778387,NaN,NaN,-51.94548741894772,-28.786947003121178,-0.09485398073073209,0.12851262576727152,0.2233666064980036,437943167,441572531.2,36.21107363857853,57.548719874937035,NaN,NaN,3.832009257354723,7.247938264821024
2015-05-06T09:30:00-04:00,75.91,76.01,75.03,75.4,8298192,5678485.05,45.314725665295796,52.15801500239801,NaN,NaN,-144.13526387066238,-57.84073287177661,-0.13567149264442785,0.05377724069246881,0.18944873333689666,429644975,438207207,32.441778026877444,55.640208357907945,NaN,NaN,1.6831518247969925,6.45296877338902
2015-05-07T09:30:00-04:00,75.4,75.93,75.21,75.79,5892410,5710527.15,48.33952416941118,52.338220963530325,NaN,NaN,-101.25050338860775,-53.24670590032705,-0.13098127356475478,0.02572214138095319,0.15670341494570797,435537385,438160913.4,32.391828314843806,54.011425707554466,NaN,NaN,0.8564453357069349,5.653465425148722
2015-05-08T09:30:00-04:00,76.56,76.92,76.53,76.6,5673635,5795602.2,54.02716817616069,52.44329693870613,NaN,NaN,72.03036350639789,-32.892327076149215,-0.07091160774340158,0.068063905266456,0.13897551300985758,441211020,438027302.8,32.2375534910807,52.391670030267555,NaN,NaN,1.9822017302143755,5.128999183015244
2015-05-11T09:30:00-04:00,76.54,76.925,76.25,76.26,6947200,5985622.9,51.46580391037009,52.32222296691732,NaN,NaN,37.40946789767551,-37.57828465482889,-0.05250882021763667,0.07333948773781174,0.1258483079554484,434263820,435720073.4,29.614547711441617,50.39555541090039,NaN,NaN,2.098915236271462,4.6961300477661325
2015-05-12T09:30:00-04:00,75.84,76.4,75.54,76.12,7510392,6215125.35,50.40612030514465,52.08574973554986,NaN,NaN,-36.94019538075935,-34.57722624719121,-0.04830351833098605,0.06546891004171584,0.11377242837270189,426753428,433482125.6,27.294700592868324,47.96310677194712,NaN,NaN,1.8760340451563078,4.293259190250443
2015-05-13T09:30:00-04:00,76.16,76.42,75.575,75.64,7921603,6323240,46.84475661731029,51.38039477159345,NaN,NaN,-55.068150648297014,-16.763803602718138,-0.0748052864746826,0.020265820279348645,0.09507110675403124,418831825,431319495.6,25.237320829200158,45.20483133951914,NaN,NaN,0.6154715197995191,3.7678609516145967
2015-05-14T09:30:00-04:00,75.93,76.08,75.52,75.98,6830306,6321762.75,49.56309695432235,50.372925261989,NaN,NaN,-53.36629443534194,-7.186961812064979,-0.06666340403050763,0.0117418517158967,0.07840525574640433,425662131,429344444.8,23.495507200227777,41.88635438383704,NaN,NaN,0.3606396557037968,3.281115052198768
2015-05-15T09:30:00-04:00,76.07,76.59,75.99,76.59,7189908,6251682,54.098540967528784,50.151272773773464,NaN,NaN,23.593732779741167,-16.874287957396326,-0.01985165487525417,0.053590687152336614,0.07344234202759078,432852039,427672648.6,22.10480280496384,38.30270488319157,NaN,NaN,1.5154256824620569,3.0288737136649524
2015-05-18T09:30:00-04:00,76.46,77.015,76.44,76.88,3961471,6244758.25,56.11878080188903,50.24397237428044,NaN,NaN,78.17061892770978,-8.722057751389467,0.028367261846608052,0.10890141933585085,0.0805341574892428,436813510,428182586.6,23.59045229254299,34.828121581776415,NaN,NaN,3.0801311373690936,3.036196202765544
2015-05-19T09:30:00-04:00,77.09,77.25,76.78,76.86,4645381,6281153.5,55.935935407297606,50.63476799293131,NaN,NaN,95.19823556422043,17.705628437606485,0.05509231813397003,0.14939955515670533,0.0943072370227353,432168129,429265526.8,26.784070807548176,32.061038903056215,NaN,NaN,4.299264732566558,3.216634564165689
2015-05-20T09:30:00-04:00,76.87,77.1053,76.5,76.77,7407751,6478374.25,55.066454379782286,51.405802695124464,NaN,NaN,63.01605252654483,41.32246907257486,0.06235166449033405,0.17224681763565286,0.10989515314531881,424760378,430451237.4,30.222874566634033,30.439016071533135,NaN,NaN,5.081709368935401,3.4830738219899335
2015-05-21T09:30:00-04:00,76.6,77.24,76.6,77.07,2930361,6418104.25,57.4412254400712,51.79240909371106,NaN,NaN,82.72183707375376,68.54009537439399,0.08177651087697602,0.21211579174153883,0.1303392808645628,427690739,430856959,31.41000031750869,29.52295742955419,NaN,NaN,6.4082418512929955,3.900954969033228
2015-05-22T09:30:00-04:00,77.06,77.23,76.81,76.94,2963763,6324904.6,56.058613846244526,52.00301970609998,NaN,NaN,93.845116704153,82.59037215927637,0.08018019380051422,0.2305645231152056,0.15038432931469137,424726976,429231946.4,29.262614574651025,28.735651797783408,NaN,NaN,7.169797011736705,4.3679324037051535
2015-05-26T09:30:00-04:00,76.88,77.11,76.265,76.39,5336010,6245440.25,50.5183588746377,52.228507536819,NaN,NaN,41.14374612197585,75.18499759812957,0.038505734608030556,0.19851649757472956,0.160010762966699,419390966,425747437.6,25.27270249502652,27.954339573243974,NaN,NaN,6.329030073541844,4.648089213681824
2015-05-27T09:30:00-04:00,76.54,77.06,76.38,76.96,3627679,6148512.45,55.43407884122054,52.95131847795649,NaN,NaN,71.10412461592308,70.36617540847011,0.045283737512221756,0.2166154348569762,0.17133169734475445,423018645,423917540.8,23.46340125145076,27.313026946427783,NaN,NaN,6.990878294497968,4.98277336808413
2015-05-28T09:30:00-04:00,76.83,76.99,76.63,76.83,3254159,5949043.9,54.1136854788956,53.36375857149109,NaN,NaN,67.2446265197636,71.21189020711385,0.03729991539596561,0.21795659158971148,0.18065667619374587,419764486,422918362.4,22.51554436250032,26.607578092688964,NaN,NaN,7.172661621311501,5.295614547116612
2015-05-29T09:30:00-04:00,76.61,76.89,76.19,76.3,6166504,5722231.95,48.99033456234358,53.00398474193273,NaN,NaN,7.057253442591731,56.07897348088146,-0.005129887090308621,0.1742443173308601,0.17937420442116872,413597982,420099811,20.0544404149572,25.737355730108714,NaN,NaN,5.84713468426094,5.374403138137231
2015-06-01T09:30:00-04:00,76.37,76.79,76.14,76.52,5547524,5694097.15,51.06156565016011,52.975110580489165,NaN,NaN,8.199406280626672,38.949831396176194,-0.01905058247112071,0.15556097633226784,0.17461155880338855,419145506,418983517,19.16112304236306,24.990682539460245,NaN,NaN,5.316745090829512,5.366166274236128
2015-06-02T09:30:00-04:00,76.35,77.06,76.25,76.69,7130786,5854591.75,52.66114131331984,53.13618350964453,NaN,NaN,40.2687819260618,38.77483855699337,-0.017520039036591967,0.1527115100076486,0.17023154904424057,426276292,420360582.2,23.677679016281658,24.73232385541834,NaN,NaN,5.314555639569972,5.358793326426677
2015-06-03T09:30:00-04:00,76.9,77.4,76.7,77.29,4398015,5681652.5,57.89235737130374,53.92529784921549,NaN,NaN,113.0962988112164,47.17327339605204,0.02109633508570566,0.19660196790137263,0.17550563281566697,430674307,421891714.6,28.463513328731935,24.962766176813467,NaN,NaN,6.848413855520488,5.571596259154364
2015-06-04T09:30:00-04:00,77.11,77.27,76.605,76.74,5660486,5549767.2,52.198116559602155,54.113513535306915,NaN,NaN,62.413884311794966,46.20712495445831,0.007494659063823961,0.18487395664544692,0.17737929758162296,425013821,422941581.6,31.629304820842194,25.54375172114307,NaN,NaN,6.483524802797742,5.701871765389132
2015-06-05T09:30:00-04:00,76.52,76.7,76.16,76.52,3512996,5430796.5,50.07637654745807,53.826216076730425,NaN,NaN,-34.092666961081875,37.97714087372359,-0.017080509608114886,0.15602866057147935,0.17310917017959424,421500825,424522150.2,36.206455228203986,26.55101260851736,NaN,NaN,5.551137204116582,5.680338256635911
2015-06-08T09:30:00-04:00,76.43,76.46,75.96,75.98,3696421,5331935.8,45.21786591291787,53.04757929894678,NaN,NaN,-97.65016342451852,16.80722693269455,-0.06762810241611497,0.08857404215945053,0.1562021445755655,417804404,424253929.8,35.76883924627607,27.420897390926864,NaN,NaN,3.2438943543321614,5.332274842021089
2015-06-09T09:30:00-04:00,76,76.13,75.44,75.9,4686139,5218882.75,44.52859466836724,52.23276924616603,NaN,NaN,-141.83574232624917,-19.613677917767642,-0.102294655680924,0.028333824974410504,0.1306284806553345,413118265,421622324.4,31.71815219409531,27.77333177568023,NaN,NaN,1.1653173999187452,4.73699520743504
2015-06-10T09:30:00-04:00,76.22,76.86,76.13,76.68,4663727,5076549.5,52.18209253307427,52.0267433999726,NaN,NaN,-3.0377894466555415,-42.84049556934203,-0.07007366192545036,0.04303640324852154,0.1131100651739719,417781992,419043861.4,28.332561144319044,27.638309388372022,NaN,NaN,1.6374098957576224,4.294197305766837
2015-06-11T09:30:00-04:00,76.88,77.19,76.81,76.94,4393276,4900133.15,54.43867183933938,51.81227528563461,NaN,NaN,82.05181075457438,-38.91291028078615,-0.030643400395310105,0.07480581467983427,0.10544921507514438,422175268,418476150.8,27.633188876094877,27.36853714255675,NaN,NaN,2.7195190973726238,4.069243275996235
2015-06-12T09:30:00-04:00,76.5,76.78,76.45,76.59,4067712,4762003.45,50.95282965612772,51.447576414911985,NaN,NaN,-15.270311263831148,-35.148439141336,-0.027620441376328755,0.07092366335473343,0.09854410473106219,418107556,417797497,26.782103321550636,27.191357767335294,NaN,NaN,2.5811151780765424,3.856653547721993
2015-06-15T09:30:00-04:00,76.11,76.37,75.82,76.23,4671420,4636079.05,47.578191084691234,51.237564429915814,NaN,NaN,-130.72132163764863,-41.76267078396203,-0.048150566816901164,0.038355896209935736,0.0865064630268369,413436136,416923843.4,25.685363532681833,27.220833555739244,NaN,NaN,1.4411921474335867,3.511587633395078
2015-06-16T09:30:00-04:00,76.15,76.71,76.09,76.69,4106788,4643344.9,51.95675142135407,50.989183899925344,NaN,NaN,-35.63680201376101,-20.522882721464395,-0.02992685698550343,0.049097891794957604,0.07902474878046103,417542924,417808775.2,28.863038297362095,27.606521916161483,NaN,NaN,1.8006653050733754,3.267170157920549
2015-06-17T09:30:00-04:00,76.83,77.22,76.49,77.04,4288608,4625506.25,55.03423814295543,51.054937661643905,NaN,NaN,72.57468000402442,-5.400388831328405,0.004679955365902197,0.08487469298783878,0.08019473762193659,421831532,418618683.2,31.739859276336574,28.265401552864073,NaN,NaN,3.0468520738344353,3.235696145908247
2015-06-18T09:30:00-04:00,77.05,78.19,77.05,77.97,5791712,4544704.3,61.99970700010055,51.98417855005511,NaN,NaN,228.2798781257275,23.845224642902217,0.08474481114421971,0.18612575155221123,0.10138094040799152,427623244,419708278.4,35.51793483240397,29.369936868395985,NaN,NaN,6.509013208819815,3.703312869181328
2015-06-19T09:30:00-04:00,77.86,77.93,77.45,77.45,5983307,4697351.6,56.70998320416418,52.38763694676969,NaN,NaN,174.0692199407762,61.713130883823695,0.09637599273073699,0.22185093132141276,0.12547493859067577,421639937,420414754.6,37.91727204243091,30.70966179697226,NaN,NaN,7.667755765215308,4.26966185432904
2015-06-22T09:30:00-04:00,77.85,78.16,77.835,77.88,3905998,4744463.35,59.766854421355035,52.89518788305792,NaN,NaN,201.2290401014567,128.10320323164473,0.12491166760052735,0.28161452309133495,0.1567028554908076,425545935,422836714.4,45.41575997858731,32.26238186570838,NaN,NaN,9.62959169493098,5.035366117272174
2015-06-23T09:30:00-04:00,78.07,78.25,77.99,78.19,3511642,4653244.95,61.85793839394793,53.17844367038965,NaN,NaN,187.70995297053048,172.77255422850305,0.15460404552056742,0.34995791239151686,0.19535386687094944,429057577,425139645,51.423704337865786,33.90239550921794,NaN,NaN,11.903089751488858,6.016469493588843
2015-06-24T09:30:00-04:00,77.95,78.31,77.64,77.65,5986683,4771195.15,56.362590636573856,53.47590610445906,NaN,NaN,124.87444166612735,183.23250656092364,0.12886751085061096,0.35643825543421315,0.22757074458360219,423070894,425387517.4,52.03564490990163,35.35999122986504,NaN,NaN,12.073958226546722,6.88182502686854
2015-06-25T09:30:00-04:00,77.79,78.025,77.54,77.59,4429652,4829969.8,55.769746426451356,53.882575381529996,NaN,NaN,92.24783293931822,156.0260975236418,0.1000771227887638,0.3526671480695569,0.2525900252807931,418641242,423591117,47.37746430653969,36.15792044974616,NaN,NaN,12.029676504773803,7.617232380855007
2015-06-26T09:30:00-04:00,77.91,78.14,77.64,77.9,8308634,4937076.3,58.215219514545296,54.81095778164625,NaN,NaN,98.52285395763163,140.91682432701288,0.09426631790609219,0.37042292266340837,0.2761566047573162,426949876,424653104.8,50.21483698592177,37.18977743114942,NaN,NaN,12.722715738424034,8.34658714622201
2015-06-29T09:30:00-04:00,77.21,77.555,76.085,76.14,8979817,5108690.95,43.507553001991674,54.73802623404799,NaN,NaN,-47.36635220126253,91.19774586646902,-0.029154133543714267,0.23971393782767336,0.26886807137138763,417970059,423137929.6,46.37300915280831,38.236552928200354,NaN,NaN,8.122760593173732,8.31461192435797
2015-06-30T09:30:00-04:00,76.91,76.9199,76.16,76.48,7237296,5114016.45,46.32854303626711,54.31991555570462,NaN,NaN,-54.24606113717217,42.806543044928496,-0.08573658679198481,0.1616973378814066,0.24743392467339143,425207355,422367885.2,44.50923383122973,39.392029548693976,NaN,NaN,5.464350367900381,7.907431702006886
2015-07-01T09:30:00-04:00,77.13,77.37,76.96,77.35,6022567,5195244.05,52.82068246534619,54.20434488613368,NaN,NaN,23.580188170083606,22.547692345719746,-0.06344135908999834,0.1681322258108935,0.23157358490089183,431229922,423999690.8,49.171262472219894,40.93046337698861,NaN,NaN,5.488089414857104,7.561811375271203
2015-07-02T09:30:00-04:00,77.58,77.82,76.97,77.2,6258889,5225164.2,51.660412597243614,54.254886524784816,NaN,NaN,31.85257550590096,10.468640859036308,-0.0578253031640476,0.15929195594583234,0.21711725910987995,424971033,425265649,52.50504543601196,42.76781638516443,NaN,NaN,5.122232081607121,7.213300047604906
2015-07-06T09:30:00-04:00,76.67,77.57,76.5,77.05,4049663,5251997.55,50.46657964900688,54.4611999936645,NaN,NaN,-2.7668375163932644,-9.789297435768683,-0.0628260363470273,0.13858471367609582,0.20141075002312311,420921370,424059947.8,49.1955711050212,44.44711692604581,NaN,NaN,4.4570308071823925,6.819547298973118
2015-07-07T09:30:00-04:00,77.13,77.73,76.2,77.72,6961719,5415262.45,55.42193835767944,54.708713346259174,NaN,NaN,11.85022616819408,2.0540182381226417,-0.021745342989602068,0.17422907128612053,0.1959744142757226,427883089,426042553.8,54.29691816557478,46.26382263091814,NaN,NaN,5.471115733018015,6.62691421812239
2015-07-08T09:30:00-04:00,77.1,77.29,76.14,76.24,6825260,5522218.5,44.76788329973904,53.97540228602943,NaN,NaN,-77.5470286689523,-2.6061752682333834,-0.09109363722333078,0.08210736774655913,0.1732010049698899,421057829,425212648.6,51.94561337329226,47.707090780700696,NaN,NaN,2.6148497282628993,6.053762148142463
2015-07-09T09:30:00-04:00,77,77.35,76.49,76.56,5927672,5585415.75,47.13424230603519,52.913583379310474,NaN,NaN,-48.75583607794185,-17.073380117838475,-0.11094191364047098,0.03452361291930117,0.14546552655977216,426985501,424363764.4,49.580513852199665,48.71156071068611,NaN,NaN,1.176377785500877,5.356992953479379
2015-07-10T09:30:00-04:00,77.32,77.825,77.13,77.67,4658306,5598667.25,54.42790426017258,52.750577740453934,NaN,NaN,45.326359677826694,-14.378623283453328,-0.04805524493898242,0.08539647038604414,0.13345171532502656,431643807,425698319.2,53.18896962539267,49.802396252326226,NaN,NaN,2.519462541116006,4.951631465998897
2015-07-13T09:30:00-04:00,78.22,78.84,78.22,78.79,6064712,5698517.25,60.36923052052842,52.7936046046806,NaN,NaN,161.4155495323122,18.457854126287774,0.06413916569397046,0.21362567244248964,0.14948650674851918,437708519,429055749,60.791503635161334,50.90066365636723,NaN,NaN,5.843456352407112,5.07903502120007
2015-07-14T09:30:00-04:00,78.97,79.03,78.72,78.89,3751024,5652497.45,60.85988208846631,52.72231486857477,NaN,NaN,171.2071058311661,50.329230058882175,0.13611709409534353,0.3196328743676986,0.18351578027235507,441459543,431771039.8,65.6502854172088,51.91684801917745,NaN,NaN,8.529158533078819,5.57190980861132
2015-07-15T09:30:00-04:00,78.93,79.01,78.63,78.81,2714320,5582874.05,60.217580993972696,52.99767132267469,NaN,NaN,146.98725326205417,95.23608644508347,0.16731749073374258,0.3926626436895333,0.22534515295579072,438745223,435308518.6,70.73790673228223,53.25272386363321,NaN,NaN,10.421617197224728,6.264725149841807
2015-07-16T09:30:00-04:00,79.36,79.38,78.9,79.29,3277435,5532315.4,62.757294409698744,53.49678189290664,NaN,NaN,164.419061358105,137.87106593229285,0.2066802854388402,0.48369550975434095,0.27701522431550074,442022658,438315950,74.23217309251481,55.17091734834571,NaN,NaN,12.797268175510323,7.197945582080166
2015-07-17T09:30:00-04:00,79.41,79.42,78.89,79.15,3244752,5404967.4,61.52360236545364,53.73309495368581,NaN,NaN,136.85477931238407,156.17674985920434,0.2090576326332475,0.5383372651070601,0.32927963247381264,438777906,439742769.8,75.71389456364734,56.99227860389754,NaN,NaN,14.351320592894034,8.219856297910718
2015-07-20T09:30:00-04:00,79.56,79.56,79.07,79.19,2554701,5233537.1,61.754933777262664,55.03647929477659,NaN,NaN,127.36533530366746,149.36670701347538,0.19913928824122484,0.5782037427753437,0.37906445453411886,441332607,440467587.4,76.45458942849359,59.14096290930363,NaN,NaN,15.678148090114263,9.285326553939797
2015-07-21T09:30:00-04:00,79.57,79.57,78.72,78.94,2676886,5172081.5,59.35307149010472,55.966802755764995,NaN,NaN,98.01363247801135,134.72801234284444,0.16307317734552773,0.5829059262160285,0.4198327488705008,438655721,439906823,74.55996326307135,61.287443583006606,NaN,NaN,16.139415453814472,10.26448211106475
2015-07-22T09:30:00-04:00,78.93,79.45,78.83,79.32,3209736,5156986.2,61.785988759467855,56.607181776773686,NaN,NaN,96.52376069307891,124.63531382904937,0.15234224954895437,0.6102605608066938,0.4579183112577394,441865457,440530869.8,75.29371448170173,63.15333301225531,NaN,NaN,17.21489171360971,11.257397768571172
2015-07-23T09:30:00-04:00,79.48,79.63,78.6701,78.85,3760993,5045701.7,57.22378057882109,57.00456520402922,NaN,NaN,75.60054546120902,106.87161064967015,0.10346122361455878,0.5872448407759379,0.4837836171613791,438104464,439747231,72.46716979792635,64.57919903810634,NaN,NaN,16.869093371483267,12.059068568987186
2015-07-24T09:30:00-04:00,80.4,80.4,78.71,78.85,5169588,5082698.5,57.22378057882109,57.48722241330166,NaN,NaN,84.28003598812762,96.35666198481889,0.06298937234677143,0.5625203325948434,0.4995309602480719,438104464,439612542.6,71.9671006223488,66.20573686077259,NaN,NaN,16.58522064763858,12.705661723080242
2015-07-27T09:30:00-04:00,78.55,78.9,78.05,78.26,5552323,4944882.95,51.66932605738805,57.21917867756656,NaN,NaN,20.898798527679904,75.06335462962139,-0.007886157006185113,0.4896732639903405,0.4975594209965256,432552141,437856449.4,65.60997614118793,67.01381243045924,NaN,NaN,14.764219706684678,12.999741435023733
2015-07-28T09:30:00-04:00,78.03,79.03,78.03,78.87,5448454,4768314.8,56.38323144864065,58.0488464024881,NaN,NaN,32.26391608875337,61.91341135176977,-0.01750353967263585,0.4756799964057308,0.4931835360783666,438000595,437725424.2,65.14757709332949,67.95680983903334,NaN,NaN,14.49800253713303,13.21377873532506
2015-07-29T09:30:00-04:00,79.08,79.81,79,79.68,5812230,4697061.5,61.722064973480045,59.09083373587702,NaN,NaN,88.72179305715781,60.35301782458553,0.024582083198887328,0.5239111400769758,0.4993290568780885,443812825,438114897.8,65.9165282489709,69.12366801023128,NaN,NaN,15.898769728326462,13.597348877182403
2015-07-30T09:30:00-04:00,79.34,80.06,79.2,79.97,3303234,4561094.85,63.447154905532884,59.735065924831325,NaN,NaN,101.4612466370312,65.52515805974997,0.06362673766860272,0.5788624789638419,0.5152357412952392,447116059,439917216.8,69.29284847423408,70.27394507086282,NaN,NaN,17.581645217308388,14.166534068628973
2015-07-31T09:30:00-04:00,80.15,80.53,79.94,80.22,3665190,4431409.9,64.91510118363202,60.05977097219587,NaN,NaN,132.86893842598832,75.24293854732211,0.09602086199363657,0.6352618187872849,0.5392409567936484,450781249,442452573.8,73.29973881545766,71.16739044088398,NaN,NaN,19.415688741109243,14.916413307554725
2015-08-03T09:30:00-04:00,80.06,80.5048,79.515,79.95,5757089,4516781.2,62.018309027959184,60.14251575358822,NaN,NaN,108.73948139849402,92.81107512148495,0.08914437318761648,0.650671423278169,0.5615270500905525,445024160,444946977.6,76.54280837043481,71.94542779468584,NaN,NaN,20.12653898987602,15.660716976457767
2015-08-04T09:30:00-04:00,80.05,80.47,79.93,80.29,5703658,4453878.15,64.1856559576701,60.42594967956661,NaN,NaN,125.18818132709633,111.39592816915354,0.09673989864555321,0.6824519233974939,0.5857120247519407,450727818,447492422.2,79.30519052205945,72.55737663681279,NaN,NaN,21.35781645280235,16.47458833022128
2015-08-05T09:30:00-04:00,80.4,80.61,79.28,79.42,5941265,4409678.4,55.464149343329034,59.90501074625448,NaN,NaN,80.06385232154493,109.66434002203096,0.035568169262252036,0.6301722363297557,0.5946040670675037,444786553,447687167.8,79.50405824905314,72.9339398622798,NaN,NaN,19.795670378838786,16.949028622880924
2015-08-06T09:30:00-04:00,79.7,79.7,77.49,78.34,7744717,4500530.65,46.937761383334,58.86316496181737,NaN,NaN,-88.430007258097,71.68608924300531,-0.07898159653081771,0.4958770714039815,0.5748586679347992,437041836,445672323.2,71.81494440814585,72.65544342260112,NaN,NaN,15.50482891773447,16.74271437928857
2015-08-07T09:30:00-04:00,78.43,78.495,77.73,78.28,6452885,4590259.6,46.50999055700893,57.77424044608496,NaN,NaN,-149.0059556208275,15.311110433642142,-0.1557087613048973,0.38022271630367754,0.5359314776085748,430588951,441633863.6,59.41211248912919,71.43812364121796,NaN,NaN,12.005577764685514,16.06598057720242
2015-08-10T09:30:00-04:00,78.87,79.16,78.75,78.91,3837136,4478880.8,51.50733020309087,57.2138303541554,NaN,NaN,-39.862954045812195,-14.409376655219102,-0.16031820794487733,0.3355337176774782,0.4958519256223555,434426087,439514249,54.12820175722188,69.97871210508585,NaN,NaN,10.5662969423233,15.280311486505404
2015-08-11T09:30:00-04:00,78.4,78.59,77.8329,78.2,5674738,4575066.5,46.26178036200604,56.10495832576527,NaN,NaN,-135.5293002789,-66.55287297641836,-0.20463430309188896,0.24005904675749434,0.4446933498493833,428751349,435118955.2,45.15922930084204,67.82624887788158,NaN,NaN,7.615051589833632,14.185274358409437
2015-08-12T09:30:00-04:00,77.96,77.98,76.58,77.86,7136936,4796197.3,43.953337709969276,55.157069549418715,NaN,NaN,-199.09364654902956,-122.38437275053325,-0.24743569475847027,0.13539873140129544,0.3828344261597657,421614413,430484527.2,38.0079124526801,65.36487335322114,NaN,NaN,4.466653322484264,12.79689992470584
2015-08-13T09:30:00-04:00,77.81,78.79,77.79,78.31,4424313,4853541.2,47.67489841816087,54.47500653794298,NaN,NaN,-87.05326419757566,-122.10902413842898,-0.2360640695356932,0.08775433924014919,0.3238184087758424,426038726,428283905.2,35.160632488698155,62.73583991510325,NaN,NaN,2.990804901909387,11.39602920716349
2015-08-14T09:30:00-04:00,78.22,78.47,78.07,78.36,4739584,4928282.8,48.08736672733233,54.21915230008186,NaN,NaN,-76.97173360792216,-107.70217973584792,-0.21632299397904808,0.05341466630203229,0.26973766028108037,430778310,428321777,35.25052997601553,60.56730804616235,NaN,NaN,1.9317372563820285,10.043987499908996
2015-08-17T09:30:00-04:00,78.08,79.16,78.01,79.11,4420502,5021572.85,53.95111798907801,54.0454299101131,NaN,NaN,-24.773012289948344,-104.68419138467513,-0.14720556036428417,0.08573070982572517,0.23293627019000934,435198812,428476322,35.64266042021531,58.45981399808277,NaN,NaN,2.800088960948753,9.009144851486104
2015-08-18T09:30:00-04:00,79.2,79.5,79.03,79.18,5849675,5180212.3,54.468057960730846,53.527286552059586,NaN,NaN,25.278927447022006,-72.52254583949075,-0.0938237323262682,0.1156566047821741,0.2094803371084423,441048487,430935749.6,41.694250378199015,56.729651293027636,NaN,NaN,3.65235126768,8.24388862522809
2015-08-19T09:30:00-04:00,78.95,79.63,78.66,79.04,5740905,5306770.75,53.1821739701143,52.79407362810112,NaN,NaN,12.403042773407767,-30.223207975003277,-0.06629090678661431,0.1266167036251744,0.19290761041178872,435307582,433674383.4,47.60259470128453,55.18034745210267,NaN,NaN,3.9969888647588223,7.637188659446766
2015-08-20T09:30:00-04:00,78.28,78.45,76.8,76.82,9412255,5589333.85,37.901916024606415,50.86456040245643,NaN,NaN,-148.42809082124742,-42.49817329973763,-0.18899270180006206,-0.043333266838288864,0.1456594349617732,425895327,433645703.6,47.548255176471514,53.34095576360367,NaN,NaN,-1.07409860769272,6.392719049855411
2015-08-21T09:30:00-04:00,76.05,76.29,74.29,74.36,18601289,6260918.9,28.224528857307803,48.450718961695614,NaN,NaN,-288.3229550754481,-84.76841759324282,-0.4143119023177758,-0.3722304429354466,0.04208145938232921,407294038,428948849.2,39.57979489338955,50.70074051524329,NaN,NaN,-9.98241716858552,4.053413875792421
2015-08-24T09:30:00-04:00,70.06,73.8601,66,71.39,23817067,7174156.1,21.19001315675328,45.379601618772995,NaN,NaN,-399.14838353519997,-159.64349184229314,-0.7237408076775282,-0.8625945502145811,-0.13885374253705285,383476971,418604481,28.32214893844622,47.05909468784234,NaN,NaN,-21.189872201502872,0.4472301504645215
2015-08-25T09:30:00-04:00,73.18,73.76,71.06,71.1,12093806,7506423.7,20.648848321814853,42.89279440295054,NaN,NaN,-226.78235371558878,-210.0557480748153,-0.8969863813007795,-1.2600867191630272,-0.3631003378622477,371383165,404671416.6,20.050034572947695,42.81237871097767,NaN,NaN,-29.116402556150035,-3.7761459504804145
2015-08-26T09:30:00-04:00,72.73,73.89,71.34,73.8,18895053,8160564.85,36.825558439451086,42.17049419267319,NaN,NaN,-149.6751574053006,-242.47138811055697,-0.7829338334375862,-1.3417676296592305,-0.5588337962216443,390278218,395665543.8,16.662431278137518,38.87291348740565,NaN,NaN,-28.6378217018235,-7.327813914957998
2015-08-27T09:30:00-04:00,74.95,75.73,74.01,75.53,16115557,8801181,44.6164125931005,42.035238623822586,NaN,NaN,-71.41173380042396,-227.06811670639226,-0.554905881263611,-1.252466147801158,-0.6975602665375471,406393775,391765233.4,15.445314569738883,35.73242792173491,NaN,NaN,-24.864446914625482,-9.833047200624781
2015-08-28T09:30:00-04:00,75.28,76,75.1,75.56,7644485,9000145.75,44.74367072062126,41.55212008936047,NaN,NaN,-48.97417690488862,-179.1983610722804,-0.374619241530152,-1.165834318450237,-0.7912150769200851,414038260,393114077.8,17.684664538938407,33.12931812042895,NaN,NaN,-22.185281935152133,-11.597652162700117
2015-08-31T09:30:00-04:00,75.22,75.65,74.755,74.98,10108895,9217736.05,42.70084042251435,41.29776723653964,NaN,NaN,-53.66311618117323,-110.10130760147506,-0.2717817969955012,-1.1309423231644615,-0.8591605261689603,403929365,397204556.6,24.237587534264705,31.63491513710199,NaN,NaN,-20.880065947064068,-12.92371127475211
2015-09-01T09:30:00-04:00,73.34,74.21,72.67,73.08,13939912,9629548.75,36.77718890537397,40.78518517906855,NaN,NaN,-93.80615514321988,-83.50606788700127,-0.3064987868927146,-1.2422840097848535,-0.935785222892139,389989453,400925814.2,29.719000387259356,31.04284998957194,NaN,NaN,-21.97962223675544,-14.217412840752585
2015-09-02T09:30:00-04:00,73.81,74.64,73.42,74.62,7694615,9717216.25,43.6058973753058,40.49454224743604,NaN,NaN,-60.108107064837846,-65.59265781890873,-0.20538097317563353,-1.192511439361681,-0.9871304661860474,397684068,402406984.2,31.83303707325389,30.805164602754495,NaN,NaN,-20.31626329793381,-15.088677191778475
2015-09-03T09:30:00-04:00,74.77,75.61,74.4,74.65,6600759,9660018.35,43.73339459144518,40.18354423772981,NaN,NaN,-36.380426650015536,-58.586396388827026,-0.12032186657738553,-1.1375327994077793,-1.0172109328303938,404284827,401985194.6,31.54207227123112,30.540274766698467,NaN,NaN,-19.03504293720875,-15.652443726839943
2015-09-04T09:30:00-04:00,73.57,74.28,73.23,73.85,7155582,9695153.2,41.06706349789551,39.26325463121678,NaN,NaN,-62.53614257834775,-61.29878952351887,-0.10248140850988041,-1.1453126934677442,-1.0428312849578638,397129245,398603391.6,29.234796148651697,30.08257017587249,NaN,NaN,-18.87669975923753,-16.11305173146817
2015-09-08T09:30:00-04:00,75.24,75.63,74.7,75.56,5255219,9766057.35,48.320004760287055,38.82410797404223,NaN,NaN,-13.468569894029262,-53.25988026609008,0.032708388650514175,-1.0019457991447211,-1.0346541877952353,402384464,398294411.4,29.025884889778453,29.17768692669959,NaN,NaN,-16.24807000121785,-16.132340055718124
2015-09-09T09:30:00-04:00,76.27,76.37,74.58,74.75,7682071,9866424,45.46561830281678,38.272925426378116,NaN,NaN,-11.551451250230144,-36.808939487492125,0.07346854370767497,-0.9428185081606415,-1.0162870518683165,394702393,399236999.4,30.65390485745985,27.967066223569255,NaN,NaN,-15.072523263702422,-15.980937656858739
2015-09-10T09:30:00-04:00,74.49,75.43,74.44,74.96,6206093,9819881.85,46.35047039380196,38.87639359560637,NaN,NaN,-18.090499593785562,-28.40541799328168,0.11783188124138522,-0.8689972003165849,-0.9868290815579701,400908486,399881883,31.806421827828316,26.842649555809025,NaN,NaN,-13.870503966553741,-15.67944712967231
2015-09-11T09:30:00-04:00,74.76,75.53,74.6,75.52,4609646,9829148.5,48.73905333273279,40.341716772422444,NaN,NaN,-2.9999769727605923,-21.72932805783069,0.18419564392959187,-0.7565845266459803,-0.9407801705755722,405518132,400128544,32.27009251267671,26.320527957186677,NaN,NaN,-12.153183778481896,-15.175695222359394
2015-09-14T09:30:00-04:00,75.47,75.55,74.85,75.12,3592263,9771782.45,47.125127426907085,42.19422493457629,NaN,NaN,1.7395259672853558,-8.874194348704064,0.19918517238811018,-0.6917987050904344,-0.8909838774785446,401925869,401087868.8,34.14552451455005,26.73648335547981,NaN,NaN,-11.212134753257601,-14.609472298201995
2015-09-15T09:30:00-04:00,75.14,76.11,74.7701,75.91,5570389,9829276.8,50.60408641194465,44.33388479815699,NaN,NaN,31.19073146377174,0.05766592285613825,0.2566775869090956,-0.5701368938421751,-0.8268144807512707,407496258,402110227.6,36.17386897619105,27.88818581285434,NaN,NaN,-9.38229230060383,-13.862732298545113
2015-09-16T09:30:00-04:00,76.04,76.87,75.83,76.77,6615888,9867587.45,54.14142456109776,45.570732378274606,NaN,NaN,89.43940117248931,20.25583640740003,0.34167835595152685,-0.3997165358118622,-0.741394891763389,414112146,405992178.2,43.31337792329303,29.791824858936874,NaN,NaN,-6.758498688006901,-12.84784178275394
2015-09-17T09:30:00-04:00,76.8,78.13,76.68,76.97,10995155,10130299.95,54.94940768298224,46.30880345612331,NaN,NaN,142.60851208955955,52.395638744069046,0.39656653570500355,-0.2456867221321346,-0.6422532578371382,425107301,410831941.2,50.715243769829804,32.31110551608622,NaN,NaN,-4.376642534422382,-11.637670461563719
2015-09-18T09:30:00-04:00,75.77,76.4899,75.34,75.46,9861451,10152759.75,48.06394986266621,46.54596625198366,NaN,NaN,64.83492421322681,65.96261898126653,0.3196713383086245,-0.2426640849513575,-0.562335423259982,415245850,412777484.8,53.35214501710092,34.85878269309784,NaN,NaN,-4.267950508907426,-10.584853325469963
2015-09-21T09:30:00-04:00,75.82,76.48,75.485,76.12,7018088,9573599.7,50.956638615967584,47.1356661229446,NaN,NaN,75.31033180995536,80.67678014980052,0.3019635813352702,-0.18488094659089427,-0.48684452792616445,422263938,416845098.6,58.367453554888186,37.29663026599951,NaN,NaN,-3.3164778656425384,-9.546513974066045
2015-09-22T09:30:00-04:00,75.17,75.319,74.57,75.11,7645217,8765007.2,46.67256811252279,47.84247892345523,NaN,NaN,3.9905592080058563,75.23674569864735,0.21501790059069054,-0.2180721521878013,-0.43309005277849183,414618721,418269591.2,59.989793778242806,39.458829793926895,NaN,NaN,-3.788206808481445,-8.723898664696817
2015-09-23T09:30:00-04:00,75.1,75.31,74.66,74.91,5385582,8429596,45.850527118371886,48.00280961938852,NaN,NaN,-13.828102126771965,54.5832450387951,0.14043530524657732,-0.2575459212202702,-0.3979812264668475,409233139,417293789.8,58.313448000368616,41.35028771729224,NaN,NaN,-4.410901304402435,-8.107756184654763
2015-09-24T09:30:00-04:00,74.47,74.82,73.68,74.71,6978707,7833778.7,44.99703337278861,48.09306953234162,NaN,NaN,-85.8945909759166,8.882624425699893,0.0771913147407367,-0.3014920830409267,-0.3786833977816634,402254432,412723216,51.10933613198164,42.74794942163156,NaN,NaN,-5.164358172579281,-7.6872707543582655
2015-09-25T09:30:00-04:00,75.53,75.7,74.34,74.7,5854032,7320702.45,44.951976661271935,48.37056332972565,NaN,NaN,-27.19548310315846,-9.523457037577163,0.03631891807518112,-0.333284750187687,-0.3696036682628681,396400400,408954126,46.056312228028844,43.94948628444421,NaN,NaN,-5.798138439177132,-7.417394709332389
2015-09-28T09:30:00-04:00,74.19,74.46,72.37,72.55,12015407,7539248.55,36.49156900529272,47.52567506151177,NaN,NaN,-187.0716167821043,-61.9998467559891,-0.12504137714009905,-0.5259053896879919,-0.4008640125478929,384384993,401378337,37.937448107475284,44.5860265142797,NaN,NaN,-9.003955900382374,-7.644046308053816
2015-09-29T09:30:00-04:00,72.58,73.1,71.86,72.31,6177144,7342661,35.68419299556612,46.82700182527958,NaN,NaN,-202.94933088830118,-103.38782477525051,-0.2312856471339209,-0.689971071465294,-0.4586854243313731,378207849,394096162.6,32.08285166625254,44.68809414347918,NaN,NaN,-11.862951811774659,-8.24674709429965
2015-09-30T09:30:00-04:00,73.38,74.34,73.04,74.26,10798607,7185595.75,46.11583177546405,46.810241923969734,NaN,NaN,-89.81769675411867,-118.58574370071986,-0.15712692956558783,-0.6550940862883579,-0.49796715672277003,389006456,390050826,29.37122908306766,44.514151804567696,NaN,NaN,-11.22568631148296,-8.672309839611552
2015-10-01T09:30:00-04:00,74.3,74.82,73.67,74.81,8362690,7218999.5,48.6458470801194,46.80358433449735,NaN,NaN,-44.08800222438949,-110.22442595041443,-0.06276924218509161,-0.5764287094541345,-0.5136594672690429,397369146,389073768.8,28.73942224633278,44.26196107125742,NaN,NaN,-9.913986634762447,-8.849692238918824
2015-10-02T09:30:00-04:00,73.65,75.88,73.55,75.88,8201806,7299051.85,53.24517304902981,47.240730450363266,NaN,NaN,13.135649454432256,-102.15819943889628,0.0726306312484491,-0.4228711782084815,-0.4955018094569306,405570952,390907879.2,31.709138522148905,44.08793350037162,NaN,NaN,-7.329637093515387,-8.632541503861189
2015-10-05T09:30:00-04:00,76.43,77.137,76.17,77,7018012,7292173.35,57.53256850893879,47.73562202871999,NaN,NaN,142.16921714540592,-36.31003265339423,0.2296824099683063,-0.20839879699654773,-0.43808120696485403,412588964,396548673.4,39.991896753418985,44.360649770173616,NaN,NaN,-3.734630184821544,-7.932839886855525
2015-10-06T09:30:00-04:00,76.75,77.26,76.07,76.43,9086048,7483714.8,54.77944174565843,47.78119468476003,NaN,NaN,111.94324677284547,26.668482878835107,0.28369692517411627,-0.08346005049720873,-0.367156975671325,403502916,401607686.8,46.28439525680036,44.57286529399557,NaN,NaN,-1.6371170914906066,-7.033450916089109
2015-10-07T09:30:00-04:00,76.6,76.88,75.95,76.69,7794334,7489327.95,55.818023668798745,47.843238683746925,NaN,NaN,92.89969077460917,63.21196038458068,0.32262020792118473,0.03611828423015595,-0.2865019236910288,411297250,406065845.6,51.14608236496298,44.60363947936223,NaN,NaN,0.3749141090924433,-5.975113055348887
2015-10-08T09:30:00-04:00,76.36,77.74,76.33,77.63,6341600,7496103.3,59.44456853682504,48.65614001761542,NaN,NaN,124.21209786115162,96.87198040168889,0.39270487041240604,0.20437916432447878,-0.18832570608792726,417638850,410119786.4,55.123591448761516,44.73017136733798,NaN,NaN,3.2159274138727123,-4.6621072740315155
2015-10-09T09:30:00-04:00,77.65,77.7899,77.28,77.72,8352650,7683253.5,59.78492666031262,49.286732020782914,NaN,NaN,126.95972362881207,119.63679523656485,0.4235068601330942,0.3410578690784405,-0.0824489910546537,425991500,414203896,58.7658710242153,44.758629758004204,NaN,NaN,5.614803844489371,-3.1939771142428177
2015-10-12T09:30:00-04:00,77.77,78.3,77.76,78.09,5488967,7778088.7,61.22563377328082,50.326236710837065,NaN,NaN,133.30033304832807,117.86301841714928,0.44497622846209234,0.47377129452296174,0.0287950660608694,431480467,417982196.6,61.85066365690905,44.891549035051796,NaN,NaN,8.041051749163476,-1.5889729908990615
2015-10-13T09:30:00-04:00,77.83,78.5,77.57,77.67,7581497,7878644.1,58.656791788212814,51.240969901539984,NaN,NaN,110.21250656349929,117.51687037528004,0.4080404854913893,0.5388456729251061,0.13080518743371677,423898970,422061407.4,64.90345964872154,45.36226415279129,NaN,NaN,9.400354325711834,-0.01906908852607625
2015-10-14T09:30:00-04:00,77.67,77.935,76.71,76.88,7015941,7898646.75,54.0620696465389,51.888472492522155,NaN,NaN,69.73373464296897,112.883679148952,0.31189124051592665,0.5206692380786251,0.20877799756269844,416883029,423178563.2,65.71267967058161,46.40536011983414,NaN,NaN,9.299867489275124,1.3122075654455236
2015-10-15T09:30:00-04:00,77.31,77.885,76.725,77.88,5703160,7634047,58.49415208679239,52.855770737202185,NaN,NaN,84.27115834633196,104.89549124598807,0.2971911769481325,0.5802669687478641,0.2830757917997316,422586189,424168031,66.45051720686504,47.86208904689387,NaN,NaN,10.50146815960937,2.6249590788975015
2015-10-16T09:30:00-04:00,77.85,78.32,77.8,78.29,5319156,7406932.25,60.190038282443254,54.548518542712934,NaN,NaN,101.77406354062443,99.85835922835054,0.29598270351646094,0.6530541711953077,0.3570714676788468,427905345,424550800,66.74861360841008,49.92002943981779,NaN,NaN,11.997695979304828,3.963921493241405
2015-10-19T09:30:00-04:00,78.07,78.705,78,78.66,4928655,7302460.6,61.710480371316805,56.40753906955227,NaN,NaN,103.0498817760042,93.80826897388576,0.3000665365755846,0.7321546383983275,0.43208810182274293,432834000,424821506.6,66.97212430682319,52.412120342715696,NaN,NaN,13.688308567228468,5.353119646668128
2015-10-20T09:30:00-04:00,78.55,78.91,78.31,78.56,5013842,7170891.85,61.03202874319451,57.472981710104435,NaN,NaN,98.63515603195563,91.49279886757704,0.2765751892085969,0.7778070883334891,0.5012318991248922,427820158,425605744.2,67.65052960767217,55.14635609447316,NaN,NaN,14.908241249870139,6.718137018554129
2015-10-21T09:30:00-04:00,78.76,78.94,78.108,78.21,5012405,7152233,58.60353760704778,58.18424531917075,NaN,NaN,84.49686166739505,94.44542427246225,0.22044692146108413,0.7767905509512474,0.5563436294901632,422807753,426790689,68.69677327040884,58.00045259619288,NaN,NaN,15.30646092724846,7.945040434081891
2015-10-22T09:30:00-04:00,78.7,79.39,78.55,79.24,8227518,7214673.55,63.239254355836245,58.89810826965692,NaN,NaN,104.23109571716223,98.4374117466283,0.23437073378671147,0.8493070467235526,0.6149363129368411,431035271,428480505.4,70.1780226649035,60.74823003496106,NaN,NaN,16.981425266835632,9.235952553046712
2015-10-23T09:30:00-04:00,80.34,80.41,79.2075,79.63,7895090,7316726.45,64.84456188578366,59.42039351086013,NaN,NaN,122.52620932078085,102.58784090265958,0.2500944403638242,0.9275543633916215,0.6774599230277972,438930361,430685508.6,72.03741398289453,63.03719555135217,NaN,NaN,18.857054383674846,10.610395671707874
2015-10-26T09:30:00-04:00,79.66,80.33,79.6,80.19,6025021,7017207.15,67.06836017186859,60.29817339844657,NaN,NaN,130.80605843209753,108.13907623387824,0.276401010137556,1.0229611856997423,0.7465601755621862,444955382,433109785,73.95978216189259,65.01400890171591,NaN,NaN,21.114559262880693,12.110990470446847
2015-10-27T09:30:00-04:00,80,80.1,79.465,79.81,4471166,6931908.25,64.10506134097449,60.89010466074483,NaN,NaN,117.13766801372626,111.83957863023235,0.24734310188083097,1.055739052913225,0.8083959510323939,440484216,435642596.6,75.82939704448935,66.77710280739636,NaN,NaN,22.213576921552367,13.554217106319063
2015-10-28T09:30:00-04:00,80.12,80.57,79.52,80.57,11357916,6959873.7,67.22414137354488,61.445788434796256,NaN,NaN,131.87913141992718,121.3160325807388,0.25729546674012993,1.1300152844575564,0.8727198177174265,451842132,441449472.4,79.46891437562722,68.51605444502962,NaN,NaN,24.081839486099145,15.058163160573361
2015-10-29T09:30:00-04:00,80.46,80.94,79.69,80.8,4724772,6777977.8,68.12678860253845,62.041635716383816,NaN,NaN,136.31785877092852,127.73338519149206,0.25676720538494757,1.193678824448611,0.9369116190636634,456566904,446555799,82.03119265309945,70.17786313280706,NaN,NaN,25.897464266954817,16.606634747199283
2015-10-30T09:30:00-04:00,80.96,81.505,80.746,80.97,7771070,6756441,68.81050822231582,62.58341246274345,NaN,NaN,154.2225827516584,134.07265987766758,0.24528329866634624,1.2435157423965961,0.9982324437302499,464337974,451637321.6,84.15095612572651,71.77074116629403,NaN,NaN,27.60788300483555,18.17824164114732
2015-11-02T09:30:00-05:00,81.26,81.455,80.75,81.34,7734965,6792288.65,70.30362293300188,63.415328973085536,NaN,NaN,137.51088766320396,135.41362572388886,0.23973909355668943,1.2979063106761117,1.0581672171194223,472072939,457060833,86.04338524453507,73.2807358517093,NaN,NaN,29.492508748793956,19.794565513668267
2015-11-03T09:30:00-05:00,81.25,81.86,81.185,81.65,7283512,6702161.85,71.53323372153007,64.66326926415633,NaN,NaN,137.66958848300015,139.52000981774364,0.23383294102008834,1.3504583933945327,1.1166254523744443,479356451,464835280,88.21557847623282,74.88808576639865,NaN,NaN,31.447132383424588,21.459217923633457
2015-11-04T09:30:00-05:00,81.79,81.87,80.71,81.12,6265877,6625739,66.46609039160924,65.2326934287861,NaN,NaN,107.52658990805703,134.6495015153696,0.17386974694481294,1.3339626360554604,1.1600928891106475,473090574,469084968.4,89.20464928626137,76.51338091492697,NaN,NaN,31.789224855068394,22.934933199552734
2015-11-05T09:30:00-05:00,81.24,81.6477,80.81,81.41,6964685,6656893.25,67.80974177332308,65.77695796384896,NaN,NaN,99.17497372795675,127.22092450677526,0.13510221621689555,1.328970659381767,1.1938684431648714,480055259,473782639.4,90.1852835575479,78.18742876843682,NaN,NaN,32.44253892103976,24.293162588336596
2015-11-06T09:30:00-05:00,81.2,81.61,80.9,81.42,6593217,6568921.6,67.85756818859139,66.21603566508284,NaN,NaN,91.39652582596202,114.65571312163597,0.09347510351984933,1.310712322564683,1.2172372190448337,486648476,478244739.8,91.0197346786166,79.90511522356492,NaN,NaN,33.0001419430755,25.537016781870726
2015-11-09T09:30:00-05:00,81.04,81.3,79.74,80.3,7009554,6644950.95,57.54526505653972,65.96698111603608,NaN,NaN,41.818017569086486,95.51713910281248,-0.020089186505948264,1.1921257359123985,1.2122149224183467,479638922,479757936.4,91.29017610740544,81.59366140211729,NaN,NaN,30.548913901886237,26.253002084730085
2015-11-10T09:30:00-05:00,80.19,81.06,80.08,81.06,7331430,6632447.6,61.78880462440503,66.19450018870445,NaN,NaN,52.70216615652249,78.52365463751696,-0.052766082590579355,1.1462573191801226,1.199023401770702,486970352,481280716.6,91.5654546001479,83.2271386399558,NaN,NaN,29.609469120916316,26.732497375613832
2015-11-11T09:30:00-05:00,81.23,81.25,80.41,80.58,7086711,6635986.1,57.85548711712602,65.80994538593943,NaN,NaN,48.24420955844445,66.66717856759445,-0.11204498887154801,1.058967165681267,1.171012154552815,479883641,482639330,91.81404014671722,84.77256846008535,NaN,NaN,27.623812025589483,26.85982803989607
2015-11-12T09:30:00-05:00,80.08,80.59,79.77,79.83,6075739,6654615.05,52.257841635444336,64.91089393948663,NaN,NaN,-4.9618736814059545,45.8398090857219,-0.2018654175927641,0.9186803825618597,1.1205458001546238,473807902,481389858.6,89.21002815664895,85.99918375821066,NaN,NaN,24.140680101081863,26.471378334351183
2015-11-13T09:30:00-05:00,79.32,79.43,77.64,77.73,11377220,6957518.25,40.455227737672395,63.00995590847261,NaN,NaN,-141.8681798705825,-0.8131320535870088,-0.3918138996310918,0.6307784256157589,1.0225923252468507,462430682,476546299.8,79.76566240994131,86.41388949021415,NaN,NaN,16.435692178676124,25.03770888354046
2015-11-16T09:30:00-05:00,77.42,78.67,77.255,78.67,7383208,7080245.9,46.30153753244888,61.73827563643507,NaN,NaN,-143.77005993749967,-37.93074755490424,-0.4396645712436591,0.47301161119227686,0.912676182435936,469813890,474581293.4,76.23933760931428,86.4431709591302,NaN,NaN,12.15514300136167,23.197342328943492
2015-11-17T09:30:00-05:00,79.06,79.51,78.556,78.82,7452316,7202169.6,47.192545340570135,60.30744734836545,NaN,NaN,-90.14753654972033,-66.5006880961528,-0.4453565468210783,0.35598049890958805,0.8013370457306663,477266206,472640464.2,72.81531141524027,85.96791360481686,NaN,NaN,9.156901556154105,21.191565075687866
2015-11-18T09:30:00-05:00,79.04,80.27,78.86,80.17,7137626,7308430.65,54.50858857634968,59.33471877506626,NaN,NaN,-36.92641240513542,-83.53481248886877,-0.34672963147027414,0.36792500639282366,0.7146546378630978,484403832,473544502.4,73.41426178284085,85.35241854265553,NaN,NaN,9.08271710437691,19.46172965121487
2015-11-19T09:30:00-05:00,80.23,80.57,80.05,80.27,5685216,7181315.55,55.005853653628115,58.34867202015999,NaN,NaN,2.3613945874058593,-82.07015883510641,-0.2668696549600945,0.3810675691629797,0.6479372241230742,490089048,476800731.6,75.50747248289854,84.7350268538821,NaN,NaN,9.187912013059387,17.99404141719266
2015-11-20T09:30:00-05:00,80.88,81.24,80.68,81.23,5564915,7064806.8,59.57433293626809,57.58229416325043,NaN,NaN,64.233223786219,-40.84987810374611,-0.14746738326120234,0.4636029950465712,0.6110703783077736,495653963,483445387.8,79.12018284863368,84.24051239703202,NaN,NaN,10.799316258403561,16.966223537365643
2015-11-23T09:30:00-05:00,81.36,81.85,81.205,81.53,4172024,6972156.95,60.910052941598735,56.82349553611248,NaN,NaN,96.64225128485789,7.23258414072541,-0.051323581508553096,0.5469159014220821,0.5982394829306352,499825987,489447807.2,81.74035789821782,83.77799664145951,NaN,NaN,12.516842049348927,16.33059761050611
2015-11-24T09:30:00-05:00,80.89,81.6,80.52,81.36,4545537,6975875.5,59.706154951630886,56.340643004685454,NaN,NaN,59.72004726457376,37.20610090358423,-0.00467508025511576,0.5923956326117406,0.5970707128668563,495280450,493050656,83.11038088563683,83.34269175570061,NaN,NaN,13.538425023706418,15.931715812391868
2015-11-25T09:30:00-05:00,81.51,81.9,81.48,81.77,3703169,6593138.15,61.6736678585705,55.90235201077456,NaN,NaN,97.57432977954528,64.10624934052036,0.0455302344778683,0.6539835059641916,0.6084532714863233,498983619,495966613.4,84.14710678754643,82.91139341498622,NaN,NaN,14.980842890091386,15.795876823491799
2015-11-27T09:30:00-05:00,81.79,81.79,81.13,81.47,2282568,6471027.95,59.38857494396111,55.297423921872394,NaN,NaN,69.82922462833605,77.5998153487064,0.04991873150951476,0.6708516858732168,0.620932954363702,496701051,497289014,84.60852102697916,82.4534495827264,NaN,NaN,15.527360144540081,15.757517297927269
2015-11-30T09:30:00-05:00,81.75,81.75,80.695,80.78,8647024,6514825.65,54.396431922905926,55.07250726946999,NaN,NaN,38.31788418727328,72.41674742891726,0.0003574187836595799,0.6213797278432764,0.6210223090596169,488054027,495769026.8,81.66622401402728,81.7660244331994,NaN,NaN,14.534759284468285,15.582837581718842
2015-12-01T09:30:00-05:00,81.22,81.64,80.985,81.61,8187446,6537449.7,58.87467016099722,54.864354807797994,NaN,NaN,64.06814147922998,65.90192546779168,0.016581530765718444,0.6417492225167649,0.6251676917510465,496241473,495052124,80.2487480532566,80.9576882512786,NaN,NaN,15.019824092083006,15.502407083199436
2015-12-02T09:30:00-05:00,81.73,81.75,80.74,80.9,6263477,6486447.95,53.99050130646086,54.58828439275048,NaN,NaN,43.99513161079131,62.756942337035184,-0.02512881722186755,0.593756670223712,0.6188854874455796,489977996,493991633.2,78.08952591214512,79.97736580595202,NaN,NaN,13.93319176160761,15.278233465829176
2015-12-03T09:30:00-05:00,81.24,81.24,79.33,79.68,9828903,6664599.25,46.80523630118064,54.19881258316021,NaN,NaN,-36.732518576609905,35.89557266580415,-0.13345457186634202,0.452067272612652,0.585521844478994,480149093,490224728,70.8021986699254,78.66252084261463,NaN,NaN,10.60640433164349,14.61082930380265
2015-12-04T09:30:00-05:00,79.97,81.32,79.78,81.22,7032182,6667974.1,54.95456426784048,55.23447947817222,NaN,NaN,22.049394872475307,26.33960671463201,-0.10141403568906404,0.4587542998676639,0.560168335556728,487181275,488320772.8,67.37956508634126,77.77779960521461,NaN,NaN,10.459634901600756,14.017801532059522
2015-12-07T09:30:00-05:00,81.1,81.2499,80.32,80.88,6535419,6665084.2,53.02321058227367,55.71459898173113,NaN,NaN,28.423234266048507,24.360676730387052,-0.10282031049847817,0.4316429474336303,0.5344632579321085,480645856,486839138.6,64.75616959902743,76.95757331876555,NaN,NaN,9.704421175415993,13.401604338253303
2015-12-08T09:30:00-05:00,80.2,81.04,79.99,80.64,6083455,6618779.25,51.64349156993254,56.03252371239988,NaN,NaN,5.709320025414679,12.688912439623989,-0.11850056454485858,0.3863375522510353,0.5048381167958939,474562401,482503324.2,57.67888307649237,75.87639986599785,NaN,NaN,8.668615076618071,12.725463015162555
2015-12-09T09:30:00-05:00,80.48,81.07,79.23,79.61,9735757,6738995.6,46.09939803495806,55.43186724515761,NaN,NaN,-40.111384201397755,-4.132390722813834,-0.192451355075706,0.2642739229512614,0.4567252780269674,464826644,477473053.8,50.74910474405784,74.25746007751334,NaN,NaN,5.969749759069945,11.76036112143504
2015-12-10T09:30:00-05:00,79.83,80.38,79.54,79.88,4730117,6621165.9,47.68485198760888,54.908938554727676,NaN,NaN,-39.035232940701626,-4.592933595632178,-0.2156467678195228,0.18716681825256387,0.40281358607208667,469556761,475354587.4,48.12667826770846,72.30168906214263,NaN,NaN,4.286674133345469,10.692691551707957
2015-12-11T09:30:00-05:00,78.83,79.13,77.9,78.06,10104244,6822591.15,39.29443773124161,53.4603746115115,NaN,NaN,-143.8784503029418,-37.77850263071559,-0.33870116597106636,-0.020562871391746285,0.3181382945793201,459452517,469808835.8,42.007104195552785,69.65075487263685,NaN,NaN,-0.15281404125578427,9.143333609855995
2015-12-14T09:30:00-05:00,78.11,78.6325,77.26,78.46,14958021,7001631.2,41.72151983905018,52.0897651041866,NaN,NaN,-159.90974137825003,-75.4450977595753,-0.3754473445526115,-0.15117088611144425,0.22427645844116723,474410538,468561772.2,40.752231761677876,66.72303157716972,NaN,NaN,-2.8994508088603252,7.422935835753664
2015-12-15T09:30:00-05:00,79.26,79.64,78.8331,78.89,7978838,7031412.7,44.29966256643836,50.98930136238713,NaN,NaN,-95.64548962007515,-95.71605968867327,-0.3534006574163867,-0.21747436332931613,0.13592629408707055,482389376,470127167.2,43.05195552760893,63.861715480167724,NaN,NaN,-4.317224542438783,5.745770067440458
2015-12-16T09:30:00-05:00,79.44,80.365,78.8,80.21,12074735,7262533.65,51.406367198824086,50.255922743833814,NaN,NaN,-49.88897739130235,-97.67157832665418,-0.23805627244387312,-0.16164404646777086,0.07641222597610225,494464111,476054660.6,50.83410312615194,61.482215218639546,NaN,NaN,-3.2116864799749854,4.46613341780968
2015-12-17T09:30:00-05:00,80.22,80.4989,78.89,78.89,9224610,7366882.85,45.19627855252974,49.242187287303004,NaN,NaN,-76.42387017767884,-105.14930577404964,-0.23821729528205188,-0.22135939312646258,0.016857902155589286,485239501,479191208.6,54.386182114372936,59.32347672488196,NaN,NaN,-4.370863351818439,3.2037053078628066
2015-12-18T09:30:00-05:00,78.43,78.45,77.28,77.33,15052988,7835271.45,39.173359165395574,48.15482494748083,NaN,NaN,-174.339557502854,-111.24152721403206,-0.32553972285502086,-0.3900667514131868,-0.06452702855816594,470186513,481338007.8,56.69243327481252,57.53963452922375,NaN,NaN,-7.513034955263269,1.6727424131305102
2015-12-21T09:30:00-05:00,77.85,78.11,77.195,77.72,7089038,7911477.6,41.28011526643435,46.898071026440626,NaN,NaN,-150.0217423715373,-109.26392741268953,-0.33772922904912095,-0.48668856486956713,-0.14895933582044618,477275551,481911010.4,57.31281295699054,55.90135345091903,NaN,NaN,-9.256681503171713,0.11139613937304982
2015-12-22T09:30:00-05:00,78.12,78.44,77.68,78.29,6732917,8039522.25,44.31573820432859,46.20701651914546,NaN,NaN,-107.66416198334144,-111.6676618853428,-0.28993094891685905,-0.51137302196652,-0.22144207304966096,484008468,482234828.8,57.68174901753749,54.44365510130421,NaN,NaN,-9.675867469071317,-1.2867843761190025
2015-12-23T09:30:00-05:00,78.5,78.78,78.36,78.69,6024849,8113487.85,46.40946746782776,46.17874731676312,NaN,NaN,-70.3608952103061,-115.76204544914353,-0.2172273428686347,-0.49297625163545433,-0.2757489087668196,490033317,481348670,56.24902261255717,53.4041425257779,NaN,NaN,-9.356661514074553,-2.4396239672555096
2015-12-24T09:30:00-05:00,78.56,78.74,78.42,78.48,1911828,8023920.8,45.443410013259445,45.49937915572162,NaN,NaN,-65.76524177526714,-113.63031976866121,-0.17115847407248636,-0.48969700135742755,-0.3185385272849412,488121489,481925067.6,56.99722081611738,52.6625465064762,NaN,NaN,-9.38543759162122,-3.431883056450611
2015-12-28T09:30:00-05:00,78.28,78.73,78.06,78.68,4055859,8112585.35,46.58382917896329,45.03942334119945,NaN,NaN,-62.13142730565845,-91.18869372922208,-0.11764340186338279,-0.46559277961416967,-0.3479493777507869,492177348,486323234.6,62.29572980858101,52.486800807158595,NaN,NaN,-9.081154660798454,-4.238921857071731
2015-12-29T09:30:00-05:00,79.16,79.71,79,79.59,5740199,7967244.1,51.546738973900496,45.03251244148287,NaN,NaN,2.001250022615542,-60.78409525039152,-0.016687867706428994,-0.36880921238382314,-0.35212134467739414,497917547,490451633.8,66.4717508624667,53.114862791871055,NaN,NaN,-7.339966795560201,-4.681928276855799
2015-12-30T09:30:00-05:00,79.53,79.56,78.93,78.95,3218888,7718816.2,48.15787446992468,45.17954647255192,NaN,NaN,-10.634960564676199,-41.378254966658474,0.00983082911208838,-0.3398328082872837,-0.34966363739937206,494698659,492589672,68.42236005970241,54.377238171559945,NaN,NaN,-6.843162446349997,-4.99067601535497
2015-12-31T09:30:00-05:00,78.58,79.01,78.15,78.1608,6580203,7734652.5,44.290998301521654,44.93712835211712,NaN,NaN,-56.92447278259855,-38.690970481116956,-0.021240197428973262,-0.37621388418558865,-0.3549736867566154,488118456,492206699.8,67.6630010998316,55.77268980242589,NaN,NaN,-7.566081661655602,-5.358591107683632
2016-01-04T09:30:00-05:00,76.78,76.93,75.98,76.82,13400415,7913228.1,38.61763909285721,44.88878559223252,NaN,NaN,-174.89859690861843,-60.51764150778721,-0.12193196497518666,-0.5073886429755987,-0.38545667800041206,474718041,489526010.2,62.4393805613853,57.23213811427107,NaN,NaN,-10.014841564528169,-6.023769744375709
2016-01-05T09:30:00-05:00,76.89,77.145,76.17,76.72,7424949,7932866.45,38.22437357224172,44.63898943031763,NaN,NaN,-151.7768231792602,-78.44672068250756,-0.18151937048806754,-0.6123558911104965,-0.43083652062242894,467293092,484549159,54.090401371091495,58.18486451494346,NaN,NaN,-12.087180019110422,-6.889971212194954
2016-01-06T09:30:00-05:00,75.6,76.37,75.36,75.97,10115409,8111865.95,35.319293504819726,43.99753449734487,NaN,NaN,-189.84511050516662,-116.81599278806398,-0.25328745006032066,-0.7474458331978298,-0.4941583831375091,457177683,476401186.2,43.771262375256526,58.23624357548972,NaN,NaN,-14.747515758276112,-8.012477575920833
2016-01-07T09:30:00-05:00,74.46,75.7099,74.235,74.41,12645191,8439952.75,30.181197494132945,42.48145094700978,NaN,NaN,-222.0894315316234,-159.10688698145344,-0.3800429531906565,-0.9692120746258297,-0.5891691214351732,444532492,466367952.8,34.93351517065278,57.10048729295407,NaN,NaN,-18.849432661172994,-9.560614016671142
2016-01-08T09:30:00-05:00,75.01,75.34,73.44,73.61,10797663,8493048.05,27.93671789731242,41.24862518592284,NaN,NaN,-208.46701081682866,-189.41539458829945,-0.48525115592961177,-1.195733066347188,-0.7104819104175761,433734829,455491227.4,28.269790741623538,55.2350307663291,NaN,NaN,-23.006364809856947,-11.481435558554828
2016-01-11T09:30:00-05:00,74.05,74.49,73.11,74.19,13232713,8918177.85,31.891333382864488,40.728480487170614,NaN,NaN,-178.43853805190585,-190.12338281695693,-0.48226437877897976,-1.3133123838913008,-0.831048005112321,446967542,449941127.6,25.587589121766285,53.013256183968664,NaN,NaN,-25.18622625987715,-13.439262801600874
2016-01-12T09:30:00-05:00,74.71,75.455,74.14,75.01,8737070,8849819.15,37.14319270871554,40.43298601876213,NaN,NaN,-112.43263810980771,-182.25454580306643,-0.3952042387247511,-1.32505330351826,-0.9298490647935088,455704612,447623431.6,24.540479308773058,50.67237520909599,NaN,NaN,-25.37078749581295,-15.143766329345457
2016-01-13T09:30:00-05:00,75.32,75.32,72.33,72.48,14930536,8848444.9,29.567578952393845,39.37954607219537,NaN,NaN,-145.78890865487028,-173.44330543300717,-0.4729008033634894,-1.5209750689978705,-1.048074265634381,440774076,444342710.2,23.099483573265672,48.202213391647994,NaN,NaN,-28.230747397301233,-17.01333505333914
2016-01-14T09:30:00-05:00,72.63,73.645,71.25,73,15919363,9245471.15,32.60988094504495,38.39386132056802,NaN,NaN,-147.5787239039547,-158.54116390747345,-0.4540689850974009,-1.6156604970061323,-1.1615915119087314,456693439,446774899.6,26.543177284605832,46.08036729679433,NaN,NaN,-29.44222233323883,-18.788890379039096
2016-01-15T09:30:00-05:00,71.1,71.98,70.67,71.5,14551514,9369310.1,28.751831273866685,37.20160569632568,NaN,NaN,-162.69677629043503,-149.3871170021947,-0.5035990073696499,-1.7910902711207939,-1.287491263751144,442141925,448456318.8,28.913173656315166,44.07436392823703,NaN,NaN,-31.815478666934148,-20.649831563024104
2016-01-19T09:30:00-05:00,72.29,72.615,71.04,71.77,11622643,9489211.75,30.349188212207068,36.04198848441452,NaN,NaN,-129.27730153841458,-139.55486969949646,-0.4792753923277522,-1.8865855041608341,-1.407310111833082,453764568,449815724,30.855537366153868,41.82863589663509,NaN,NaN,-33.13976295066511,-22.43410747554425
2016-01-20T09:30:00-05:00,70.74,71.76,68.94,71.14,21443240,9808724.35,28.730606853611334,34.412264761536726,NaN,NaN,-141.16974564693248,-145.3022912069214,-0.46628036416274354,-1.9901605670365115,-1.523880202873768,432321328,445139067.2,28.019137544590393,39.08202065964393,NaN,NaN,-34.735552987212074,-24.19145683435394
2016-01-21T09:30:00-05:00,71.36,72.91,71,72.05,15944217,10251483.3,34.19023798896805,33.41457644146839,NaN,NaN,-92.16394347496839,-134.577298170941,-0.3617251460827118,-1.9760366354771577,-1.614311489394446,448265545,446637361,30.23191285354895,36.354131573490115,NaN,NaN,-34.33693803692556,-25.64081129186417
2016-01-22T09:30:00-05:00,73.22,73.59,72.855,73.31,7185111,10274093,40.93691897677718,33.17499934684379,NaN,NaN,-53.253952829421415,-115.71234395603435,-0.18210210496706036,-1.8419391206032714,-1.659837015636211,455450656,446388804.4,30.066785027309905,33.66868756830999,NaN,NaN,-31.78451772000971,-26.518483638742104
2016-01-25T09:30:00-05:00,73.3,73.495,72.3899,72.47,7148402,10330270.65,38.130420119506084,33.14019799160443,NaN,NaN,-60.54779075899593,-95.28254684974654,-0.09844618979078845,-1.7828947528746966,-1.6844485630839081,448302254,447620870.2,32.04808229567868,31.497880549330947,NaN,NaN,-30.55829148882017,-27.095599045896115
2016-01-26T09:30:00-05:00,72.74,73.68,72.38,73.53,7950062,10632182.35,43.40334676266919,33.51012464806353,NaN,NaN,-44.0967456139411,-78.24643566485186,0.042151948764197256,-1.6317586271286615,-1.6739105758928587,456252316,448118419.8,32.875141674827915,29.98250485674069,NaN,NaN,-27.80733586966609,-27.197275735006112
2016-01-27T09:30:00-05:00,73.4,73.88,72.0433,72.38,10642669,10961522.85,39.472831379675384,33.80680592483894,NaN,NaN,-51.935859310927825,-60.399658397650924,0.06993687317356945,-1.586489484425897,-1.6564263575994664,445609647,450776083.6,37.26729347163531,29.517935649339172,NaN,NaN,-26.744305711809773,-27.13256573169235
2016-01-28T09:30:00-05:00,73.29,73.51,72.01,73.31,10402172,11194621.5,43.897476744848575,34.78654015703292,NaN,NaN,-41.25334142158471,-50.21753798697417,0.15813746932168038,-1.458754520947366,-1.6168919902690464,456011819,452325338.4,39.74250612976469,29.861435003561446,NaN,NaN,-24.422411066835384,-26.745400779569927
2016-01-29T09:30:00-05:00,72.94,74.18,72.67,74.11,11526278,11609991,47.45579398495894,36.1807598775791,NaN,NaN,-5.855683782280676,-40.73788417754603,0.27092509349811866,-1.278235623396398,-1.5491607168945167,467538097,454742826.6,43.489426009769645,30.948551808429034,NaN,NaN,-21.360013494605514,-25.976059738860727
2016-02-01T09:30:00-05:00,73.68,74.86,73.325,74.56,8299429,11695952.3,49.399903930096734,37.431372059524264,NaN,NaN,35.620601392724,-21.504205747202047,0.37025720145398755,-1.0863392150770323,-1.45659641653102,475837526,460249881,50.96895392609434,32.76150643730961,NaN,NaN,-18.26578702331155,-24.874592208067988
2016-02-02T09:30:00-05:00,74.05,74.28,72.85,73.11,9048911,11478377.1,43.779047778418004,37.90536170736015,NaN,NaN,-0.2591220482265175,-12.736681034059131,0.3338510469708973,-1.0392826078173982,-1.3731336547882955,466788615,462357140.8,53.50487253499428,34.83039166775398,NaN,NaN,-17.32157436581869,-23.79558965917523
2016-02-03T09:30:00-05:00,73.8,73.84,71.52,72.92,13351759,11774717.6,43.0872245042581,38.87105067535045,NaN,NaN,-32.9493930412553,-8.93938778012464,0.2939245923976199,-1.0057279142912705,-1.2996525066888904,453436856,463922582.6,55.35229744437498,37.134164087118926,NaN,NaN,-16.77547470861127,-22.792716094808952
2016-02-04T09:30:00-05:00,72.69,72.87,71.87,72.5,9937842,11765839.25,41.525085190983795,39.5078509786318,NaN,NaN,-50.43332531186149,-10.775384558179994,0.23853671637246276,-1.001481611223312,-1.2400183275957748,443499014,461420021.6,51.80831738536096,38.938816951458584,NaN,NaN,-16.781352739082777,-21.933949901133783
2016-02-05T09:30:00-05:00,72.18,72.24,69.96,70.16,12823351,11774747.25,34.105958992211384,39.89028867279928,NaN,NaN,-160.90952392107485,-41.78615258593883,0.053287856946586,-1.1734085064125424,-1.2266963633591284,430675663,454047534.8,43.061353901636544,39.94940125469583,NaN,NaN,-19.22108223947196,-21.546397378039238
2016-02-08T09:30:00-05:00,69.39,69.39,67.61,68.8,13175976,11893662.9,30.675575456368307,39.91360204738222,NaN,NaN,-254.4329473266295,-99.79686232980953,-0.1412244429929017,-1.4032269171002554,-1.2620024741073537,417499687,442379967,33.4393304366081,40.133957902585415,NaN,NaN,-22.45081789473416,-21.675600308995655
2016-02-09T09:30:00-05:00,67.92,69.49,67.795,68.69,14473732,11955713.85,30.40916250524097,40.03349887964149,NaN,NaN,-197.54397067728414,-139.25383205562105,-0.25125227296005725,-1.5760678153074252,-1.324815542347368,403025955,429627435,26.475811211076604,40.02372030733443,NaN,NaN,-25.0649116635215,-22.15978764535649
2016-02-10T09:30:00-05:00,68.75,69.755,68.54,68.57,13287159,12183218.3,30.102025896937192,39.74148373021071,NaN,NaN,-153.19843719353898,-163.3036408860778,-0.3026245551104907,-1.7030962362354813,-1.4004716811249907,389738796,416887823,21.629948060368335,39.40929425067868,NaN,NaN,-27.254597609791674,-22.887617640275803
2016-02-11T09:30:00-05:00,67.59,68.96,67.59,68.53,13565278,12114955.4,29.993279591972637,38.95979520272467,NaN,NaN,-151.46027025857592,-183.50902987542068,-0.30874450063601566,-1.7864023069200101,-1.4776578062839945,376173518,403422723.8,17.900638523303783,38.540283786106805,NaN,NaN,-29.06590392573029,-23.7702299667693
2016-02-12T09:30:00-05:00,69.28,69.82,68.63,69.79,10927225,11865348.5,37.63600018850796,38.92447949336766,NaN,NaN,-90.9410277866976,-169.51533064854522,-0.2025136864588195,-1.7307999143575188,-1.5282862278986993,387100743,394707739.8,15.98021390852854,37.392578901310365,NaN,NaN,-28.472432815630142,-24.441973230892277
2016-02-16T09:30:00-05:00,70.82,71.5,70.4,71.48,10470402,11661292.9,46.130740361506966,39.119293321856084,NaN,NaN,-18.965746419583517,-122.42189046713602,-0.003529222415799449,-1.5326977559184485,-1.529168533502649,397571145,390722031.4,15.178216270935167,36.12851280103232,NaN,NaN,-25.256933109107173,-24.55839607063726
2016-02-17T09:30:00-05:00,72.23,73.21,72.14,73.02,9774726,11568897.05,52.482427314625696,40.048550174352535,NaN,NaN,46.407659270055895,-73.63156447766802,0.23359573225406538,-1.2371738681850672,-1.4707696004391326,407345871,391586014.6,16.16047024270567,34.620882570394485,NaN,NaN,-20.340979076933653,-23.955907928679604
2016-02-18T09:30:00-05:00,73.06,73.08,72.29,72.54,6974156,10845442.85,50.48435991976414,40.519041829703646,NaN,NaN,36.87171810120189,-35.61753341871986,0.35275183275349975,-1.029829809497258,-1.3825816422507577,400371715,393712598.4,18.65734424152909,33.11479957837766,NaN,NaN,-16.98646848358148,-22.960273722237016
2016-02-19T09:30:00-05:00,72.08,72.76,71.65,72.74,7591642,10427814.1,51.31603860442223,40.79477358823673,NaN,NaN,25.455216311208083,-0.23443610476306986,0.434312999825899,-0.8396903924683841,-1.274003392294283,407963357,400070566.2,25.774723726007878,31.849463700966105,NaN,NaN,-14.035779861620249,-21.685346027863194
2016-02-22T09:30:00-05:00,73.39,74.255,73.33,74.15,5644952,10350806.15,56.82218366170283,41.324936426208595,NaN,NaN,85.04341401887643,34.96245225635174,0.564264305850037,-0.5686730099817368,-1.1329373158317737,413608309,405372079.4,31.18190151354206,30.436102814355227,NaN,NaN,-9.687044053396123,-19.97130288865361
2016-02-23T09:30:00-05:00,73.94,74.46,73.535,73.74,6456665,10316219.3,54.87855266885058,42.11775820409663,NaN,NaN,80.86768115024105,54.92913777031665,0.6002991306601008,-0.3825634025066478,-0.9828625331667485,407151644,407288179.2,33.07940074960986,28.977140543970627,NaN,NaN,-6.704725361025364,-18.07607752756386
2016-02-24T09:30:00-05:00,73.13,74.29,72.31,74.17,10821583,10459795.35,56.55691541896119,43.07987898371829,NaN,NaN,66.96050990661683,59.03970789762883,0.6278185539085339,-0.1980893407810811,-0.825907894689615,417973227,409413650.4,35.21336027925932,27.538645032176653,NaN,NaN,-3.7345257752313112,-16.02728442008778
2016-02-25T09:30:00-05:00,74.25,74.93,73.83,74.91,5548163,10205070.05,59.35860107324134,44.35370154673668,NaN,NaN,97.47863468075681,71.16109121353982,0.6669106250929937,0.007730386676627177,-0.6591802384163665,423521390,414043585.4,39.722425128581996,26.675367013835295,NaN,NaN,-0.3640026109643678,-13.789672733070152
2016-02-26T09:30:00-05:00,75.33,75.39,74.68,74.83,6966311,10033277,58.91624017917283,46.125864488662494,NaN,NaN,104.87745175333798,87.04553830196579,0.6573564282890159,0.1625152969449033,-0.49484113134411256,416555079,415761929.8,41.35382608131882,26.553400740955457,NaN,NaN,2.2687536396803742,-11.495611822677219
2016-02-29T09:30:00-05:00,74.85,75.43,74.44,74.44,8742790,9894102.6,56.697943248771224,47.984605045262704,NaN,NaN,93.79517655900011,88.79589080999052,0.5965308158756522,0.2508223885004526,-0.3457084273751995,407812289,414602725.8,40.5563851532327,27.06176179214293,NaN,NaN,3.901986163649717,-9.295954967487656
2016-03-01T09:30:00-05:00,75.09,76.475,74.84,76.41,9345777,9946420,64.05929469434554,50.38818591591303,NaN,NaN,127.13318980092336,98.04899254012699,0.6560079247774973,0.47430147859667215,-0.18170644618082515,417158066,416604010.2,42.61380935397419,28.214475945207045,NaN,NaN,7.727125849662735,-6.864086279323315
2016-03-02T09:30:00-05:00,76.28,76.42,75.8,76.34,7637770,9875862.95,63.64526487327815,52.78413155708024,NaN,NaN,125.65113456758414,109.78711747232043,0.6560873514734449,0.6384027431609809,-0.017684608312463934,409520296,414913424,41.3129857508503,29.620407208812896,NaN,NaN,10.687106908409985,-4.356772966789986
2016-03-03T09:30:00-05:00,76.21,76.8,76.01,76.79,9519500,9684250,65.20230259644322,55.29906177168529,NaN,NaN,121.47486259142222,114.58636305445353,0.6506231274067769,0.7955943009460071,0.1449711735392303,419039796,414017105.2,40.6052676604579,31.242166432895328,NaN,NaN,13.631458608325818,-1.7870255989163
2016-03-04T09:30:00-05:00,76.83,77.05,76.38,76.72,7746724,9574694.1,64.73782320271431,57.23490627270003,NaN,NaN,111.80781692210628,115.97243608820717,0.6073026071951536,0.9040994325331724,0.29679682533801877,411293072,412964703.8,39.74436728703777,32.939605959931704,NaN,NaN,15.932786430639679,0.7443761195916969
2016-03-07T09:30:00-05:00,76.32,76.78,75.94,76.39,7435489,9305301,62.478217146410955,58.40258318590746,NaN,NaN,92.24060553746304,115.66152188389977,0.524548669132402,0.9524826617535211,0.42793399262111925,403857583,412173762.6,39.07385878984555,34.646437568425306,NaN,NaN,17.29402838867557,3.1086121580322503
2016-03-08T09:30:00-05:00,75.94,76.5,75.72,75.79,6340033,8963503.85,58.48139902966519,58.83108116555314,NaN,NaN,76.56939078171948,105.54876208005899,0.40299040513744,0.9316719990429192,0.5286815939054792,397517550,408245659.4,35.840006684036396,36.052118742806066,NaN,NaN,17.40096491209734,5.150376837184406
2016-03-09T09:30:00-05:00,76.08,76.14,75.44,75.94,6744650,8577049.75,59.184369303911495,59.45251040727795,NaN,NaN,67.36818393911584,93.89217195436534,0.3104273776903902,0.916715816018467,0.6062884383280768,404262200,407194040.2,35.00474779620343,37.2197904252828,NaN,NaN,17.674046636506453,6.939472522801841
2016-03-10T09:30:00-05:00,76.3,76.62,75.1353,76.13,8064863,8315934.95,60.10577586108879,60.08034878275413,NaN,NaN,66.31488792960755,82.8601770220024,0.24273548939834366,0.9097078000760064,0.6669723106776627,412327063,405851493.6,33.91797566349241,37.801451277960275,NaN,NaN,18.142313856313343,8.539878427589198
2016-03-11T09:30:00-05:00,76.77,77.3,76.585,77.3,5693561,7922349.1,65.30052557470874,60.68594463368312,NaN,NaN,102.26125249918626,80.95086413741839,0.25616893719507194,0.9871834821715026,0.7310145449764307,418020624,407197004,36.06048752243292,38.14992170716677,NaN,NaN,20.023710342488137,10.18042584400333
2016-03-14T09:30:00-04:00,77.08,77.81,77.08,77.59,5500344,7651005.05,66.46608827452283,61.513625748374,NaN,NaN,115.61565617391099,85.62587426470797,0.2630025654770304,1.0597677518227187,0.7967651863456883,423520968,411129681,41.981454458478105,38.78578268637164,NaN,NaN,21.938040412908187,11.860085068132596
2016-03-15T09:30:00-04:00,77.1,77.6,77.1,77.57,4499599,7352464.9,66.30068373209544,62.20960919931216,NaN,NaN,105.41281132300666,91.3945583729654,0.24495841283015207,1.1029632023833784,0.8580047895532263,419021369,415430444.8,47.686736584247754,39.67673813672796,NaN,NaN,23.48663135164309,13.521020251491239
2016-03-16T09:30:00-04:00,77.48,78.37,77.26,78.2,7254347,7226445.95,68.92409474885503,62.89285874757028,NaN,NaN,121.67829523606818,102.25658063235588,0.2531904250667433,1.1744928208866554,0.9213023958199121,426275716,419833148,52.8033219110148,40.61108790690173,NaN,NaN,25.58117586677589,15.243899625103332
2016-03-17T09:30:00-04:00,78.03,78.595,77.79,78.31,6160847,7185780.5,69.37242157707206,63.63972884742022,NaN,NaN,131.08314408674244,115.21023186378287,0.24369803533512213,1.2259249399888148,0.9822269046536927,432436563,423855048,56.94597623878513,41.724812918149325,NaN,NaN,27.46525178684524,16.989807076780746
2016-03-18T09:30:00-04:00,78.13,78.47,77.95,78.09,9706532,7291525,67.28176362136344,64.3957160168911,NaN,NaN,122.85361597071531,119.32870455808866,0.20197867440629724,1.2347002476615643,1.032721573255267,422730031,424796929.4,57.87841770188692,42.96210095733891,NaN,NaN,28.547605302515038,18.6409211090285
2016-03-21T09:30:00-04:00,78.07,78.22,77.64,78.13,4049374,7211746.1,67.47369801916193,64.6396019686637,NaN,NaN,102.789803006033,116.76353392451308,0.15837931244665726,1.2306957138135886,1.0723164013669313,426779405,425448616.8,58.547358718887274,44.10021162626128,NaN,NaN,29.513842940392728,20.194195656366247
2016-03-22T09:30:00-04:00,77.57,78.22,77.54,78,4492322,7113528.95,66.11620106209706,64.81609741072218,NaN,NaN,89.85065284376306,113.65110222866436,0.10467717152211131,1.2031628657695705,1.0984856942474592,422287083,426101759.6,59.24592511579592,45.381135866614535,NaN,NaN,30.014937412525477,21.597158764388993
2016-03-23T09:30:00-04:00,77.63,77.83,77.37,77.45,8521961,6998547.85,60.56449490135718,64.48482543250175,NaN,NaN,59.75152427942057,101.26574803733482,0.0204159601802405,1.12400564447276,1.1035896842925195,413765122,423599640.8,55.39462323792178,46.43751840786195,NaN,NaN,29.03403051363982,22.659569014281967
2016-03-24T09:30:00-04:00,76.82,77.56,76.6,77.55,6958072,7069043.3,61.20238462722449,64.23229410568105,NaN,NaN,31.7011725821024,81.38935373640682,-0.03714702315955121,1.0571559053430803,1.0943029285026316,420723194,421256967,51.98714109130895,47.312002251024175,NaN,NaN,28.34952366257634,23.47241967832402
2016-03-28T09:30:00-04:00,77.66,78.24,77.6,77.9,5132622,6977358.85,63.43191379965381,64.30041529519839,NaN,NaN,75.87211038301007,71.99305261886578,-0.05891944617899547,1.0206536207788872,1.0795730669578827,425855816,421882124,52.821158677182694,48.29395224297683,NaN,NaN,28.297478782723573,24.161713836095384
2016-03-29T09:30:00-04:00,77.79,78.76,77.79,78.69,5489585,6814698.6,67.91388437039812,64.97416424810788,NaN,NaN,109.76663978684817,73.38841997502881,-0.028903631560335485,1.0434435275074634,1.0723471590677989,431345401,422795323.2,54.076083380662816,49.59652914987872,NaN,NaN,29.46928270883713,24.919937960772778
2016-03-30T09:30:00-04:00,79.01,79.37,78.86,79.19,5274240,6611121.75,70.3876956704714,65.77440184571931,NaN,NaN,156.07157067462882,86.63260354120196,0.013557323219723694,1.0892938130924534,1.0757364898727297,436619641,425661834.8,57.86476957733171,51.229387848530735,NaN,NaN,31.20116235048629,25.81725573073185
2016-03-31T09:30:00-04:00,79.07,79.39,78.97,79.1,5070440,6482755.25,69.35121622259254,66.43479044296957,NaN,NaN,142.79620533562604,103.24153975244306,0.023909455803125645,1.1056233096266368,1.0817138538235112,431549201,429218650.6,62.048563539847095,53.23871555398465,NaN,NaN,32.363190626292315,26.75238928724049
2016-04-01T09:30:00-04:00,78.6,79.6,78.54,79.43,8141837,6413872.1,71.0353930978126,66.844423837477,NaN,NaN,130.25388180521702,122.95208159706598,0.04034264910607499,1.1321421652061048,1.0917995161000298,439691038,433012219.4,65.93381947658368,55.372524979281124,NaN,NaN,33.833955419298675,27.76404159182023
2016-04-04T09:30:00-04:00,79.52,79.6,78.712,78.81,9471831,6500127.45,63.9277397659519,66.66311322972193,NaN,NaN,106.4031170770676,129.0582829358775,-0.0009928513737502698,1.090558451882842,1.0915513032565922,430219207,433884897.6,66.7764331757915,57.143594887660655,NaN,NaN,33.12000083781302,28.529178626962057
2016-04-05T09:30:00-04:00,78.41,78.55,77.96,78.14,8548041,6555755.05,57.260110726974105,66.0173580150704,NaN,NaN,36.09213266908058,114.32338151232398,-0.07955839499401085,0.9921033095140785,1.0716617045080894,421671166,431950050.6,63.05264016092769,58.24115942885208,NaN,NaN,30.463040661654706,28.80544463191815
2016-04-06T09:30:00-04:00,78.24,78.95,78.04,78.88,6777084,6577607.6,61.97713892828234,65.5211468850295,NaN,NaN,67.05404545455139,96.51987646830852,-0.08717623711078315,0.9626914081196105,1.0498676452303937,428448250,430315772.4,60.00867021174043,58.755827164618196,NaN,NaN,29.546192564649704,28.911265765165513
2016-04-07T09:30:00-04:00,78.56,78.81,77.65,77.99,5173359,6499043.05,54.225686137976695,64.4392372108084,NaN,NaN,12.235006354495697,70.40763667208248,-0.15375019428340786,0.8576799023761339,1.0114300966595418,423274891,428660910.4,57.00750700804896,58.76022221956561,NaN,NaN,26.16900547228,28.519514294753296
2016-04-08T09:30:00-04:00,78.31,78.39,77.58,77.87,5159432,6353771.5,53.25848606159837,63.43757452796804,NaN,NaN,-26.281096212015235,39.10064106863602,-0.204296756427212,0.7560591511255268,0.9603559075527388,418115459,424345794.6,49.98728971205986,58.196570220292244,NaN,NaN,23.174136355669305,27.755888874884153
2016-04-11T09:30:00-04:00,78.11,78.46,77.54,77.58,5870999,6362643.4,50.89585912532773,62.25344317840845,NaN,NaN,-46.832016281772255,8.453614396868053,-0.2525312927734946,0.6446917915858705,0.8972230843593652,412244460,420750845.2,45.01392406604105,57.22989631651752,NaN,NaN,19.965612973765765,26.642992317581527
2016-04-12T09:30:00-04:00,77.6,78.29,77.25,78.17,5751270,6375189.7,55.24575869775379,61.4769830095268,NaN,NaN,-45.11800326257206,-7.788412789462465,-0.24005304798460902,0.5971567743786039,0.837209822363213,417995730,420015758,44.04885980424343,56.14439165140663,NaN,NaN,18.508710792711767,25.48095209974299
2016-04-13T09:30:00-04:00,78.63,79.3,78.5,79.27,5040500,6402234.75,62.003876540151765,61.579795983726406,NaN,NaN,107.19052415837147,0.23888295130155085,-0.15708120039226348,0.6408583218728836,0.7979395222651471,423036230,418933354,42.60055546317722,55.2305296674963,NaN,NaN,19.42160935938358,24.615331708263074
2016-04-14T09:30:00-04:00,79.32,79.51,79,79.27,3462258,6212630.3,62.003876540151765,61.63704540607836,NaN,NaN,120.09707205429996,21.8112960912624,-0.10411625997549623,0.6677941972957768,0.771910457271273,423036230,418885621.8,42.534139945316454,54.55531529992542,NaN,NaN,20.13417337059035,23.975166231452686
2016-04-15T09:30:00-04:00,79.28,79.54,79.05,79.49,4299693,6119572.6,63.28969288318578,61.62688676918778,NaN,NaN,114.42229677872413,49.95197468941027,-0.05845838928613434,0.6988374706636051,0.7572958599497395,427335923,420729714.6,46.034604388194424,54.070561422140536,NaN,NaN,21.106060144362516,23.565293933296946
2016-04-18T09:30:00-04:00,79.49,80.24,79.27,80.24,4463022,5857397.1,67.34656893289159,61.58636423793731,NaN,NaN,151.1110169147308,89.54058132871089,0.014182690949448018,0.7750242236365494,0.7608415326871014,431798945,424640611.6,52.6254234641503,53.96694285667536,NaN,NaN,23.239023087241893,23.518683812431938
2016-04-19T09:30:00-04:00,80.34,80.46,79.5,79.8,4272786,5868567.7,62.95130882378632,61.05519374888838,NaN,NaN,131.4986519366099,124.86391236854726,0.023953013552745483,0.7907827996280332,0.7668297860752877,427526159,426546697.4,55.47930975299656,53.79655286922285,NaN,NaN,23.67745964427738,23.541366074124145
2016-04-20T09:30:00-04:00,80,80.17,79.52,79.9,4785727,5883237.95,63.53380299957109,60.63966423295828,NaN,NaN,111.88273801053339,125.80235513897965,0.028211931524006806,0.8020947004802963,0.7738827689562895,432311886,428401828.6,58.12341907193901,53.51618540722942,NaN,NaN,24.204168932552598,23.636052196756783
2016-04-21T09:30:00-04:00,80.11,80.26,79.59,79.62,4142744,5664277.1,60.65806077818405,59.89842621012766,NaN,NaN,98.86623063860512,121.55618685584068,0.004478135378651715,0.7794804381796041,0.7750023028009524,428169142,429428411,59.55490551788344,53.060548695893694,NaN,NaN,23.81387342558409,23.6614552294464
2016-04-22T09:30:00-04:00,79.66,79.91,78.97,79.46,4730011,5552874.05,59.01426176617317,59.547463495857755,NaN,NaN,57.53832563971151,110.17939262803816,-0.027908873772090725,0.740116210585839,0.7680250843579297,423439131,428649052.6,57.93574208144051,52.429070760582896,NaN,NaN,23.024230458282386,23.57042311928011
2016-04-25T09:30:00-04:00,79.31,79.56,78.985,79.55,3897217,5491103.8,59.676217077902415,59.720042520924075,NaN,NaN,44.5302094772329,88.86323114053859,-0.048003742734203714,0.7080204059401751,0.7560241486743788,427336348,427756533.2,56.05615864468587,51.92932208085134,NaN,NaN,22.54371349211516,23.423750315399403
2016-04-26T09:30:00-04:00,79.69,79.995,79.3139,79.74,3898533,5411551.2,61.104426404344515,59.65770591207137,NaN,NaN,76.17029886856302,77.79756052692922,-0.05284955350660514,0.6899622067911224,0.7428117602977276,431234881,428498277.6,57.29610755857976,51.73556760562558,NaN,NaN,22.512876888597265,23.293625540141953
2016-04-27T09:30:00-04:00,79.7,79.865,79.27,79.66,5711629,5433420.65,60.138587074203016,60.08005597894468,NaN,NaN,61.332635888247445,67.68754010247204,-0.06499383902900102,0.6615694615114762,0.7265633005404772,425523252,427140550.8,54.27709336698117,51.540538059835015,NaN,NaN,22.23522853401941,23.142425967838733
2016-04-28T09:30:00-04:00,79.27,79.97,78.63,78.8,7300781,5544937.7,50.83612693408716,59.90703032697958,NaN,NaN,7.764832215183095,49.46726041778764,-0.13070568728690035,0.5631811914318519,0.6938868787187522,418222471,425151216.6,50.11078612820676,51.54935923241694,NaN,NaN,19.27125294189472,22.58940124984673
2016-04-29T09:30:00-04:00,79.45,79.58,78.595,79.2,8399548,5557823.25,54.37143777571174,60.155285944864154,NaN,NaN,7.20955228411658,39.401505746668654,-0.14583976131128384,0.5115871770796474,0.6574269383909312,426622019,425787794.2,51.39646023569247,52.00525467310632,NaN,NaN,17.721588561850297,21.893999437275813
2016-05-02T09:30:00-04:00,79.42,80.37,79.32,80.31,6648020,5416632.7,62.44242607866708,60.66933361492939,NaN,NaN,97.9248060566217,50.08042506254642,-0.08283637350525974,0.5538814715093565,0.6367178450146163,433270039,426974532.4,53.78742229083031,52.700866279291105,NaN,NaN,18.872164477606397,21.462308728751612
2016-05-03T09:30:00-04:00,79.71,80.04,79.405,79.57,5779349,5278198.1,55.40617213645519,60.19806901466536,NaN,NaN,57.03627433106038,46.25362015504589,-0.09203455730647703,0.52167464838152,0.613709205687997,427490690,426225694.2,52.04752885117611,53.37565009271959,NaN,NaN,17.50585053696494,20.89710041563923
2016-05-04T09:30:00-04:00,78.92,79.55,78.85,79.21,6438236,5261255.7,52.317551213452866,59.50618863418686,NaN,NaN,-1.1594069412532635,33.755211589145745,-0.12154462579659409,0.4617784234422544,0.5833230492388485,421052454,425331534.6,49.96900801163986,53.906712097456975,NaN,NaN,15.381120949944865,20.109103349111464
2016-05-05T09:30:00-04:00,79.18,79.27,78.64,78.7,6294753,5317325.4,48.21685410131397,58.42955729262459,NaN,NaN,-51.26373943761702,21.949497258585676,-0.17153444833428955,0.36890498882098655,0.5404394371552761,414757701,424638580.6,48.35728565638447,54.0726179023277,NaN,NaN,12.25886451889713,18.987640659080846
2016-05-06T09:30:00-04:00,78.54,79.28,78.28,79.28,5391700,5328938.8,52.75242831698282,57.38711867720253,NaN,NaN,-53.7848542162169,9.750615958518981,-0.1617878195816882,0.33820466267816585,0.49999248225985404,420149401,423344057,45.41057972146467,53.557271920707294,NaN,NaN,11.103859972768614,17.861386275321955
2016-05-09T09:30:00-04:00,79.25,79.73,79.223,79.5,5216513,5296214.5,54.384487037856125,56.77520283535038,NaN,NaN,19.299614968362523,-5.974422259132856,-0.13771608663968066,0.3278473739602532,0.46556346059993386,425365914,421763232,42.041497816599914,52.59742821096467,NaN,NaN,10.686974081636992,16.836470247652674
2016-05-10T09:30:00-04:00,79.73,80.535,79.72,80.52,4832283,5250265.15,61.094580438477074,56.60097265241509,NaN,NaN,155.7525306787649,13.76882901040805,-0.05455952205994319,0.39736405802500485,0.45192358008494804,430198197,422304733.4,43.58549248317324,51.55900488319569,NaN,NaN,12.576844069419757,16.22795222219083
2016-05-11T09:30:00-04:00,79.74,79.74,78.85,78.9,6116767,5304078.5,48.81307295127748,55.75490209335034,NaN,NaN,-71.2540258268766,-0.2500947667166173,-0.10708321448964575,0.3180695619728908,0.4251527764625366,424081430,422910528.6,45.33981981180396,50.54364161847572,NaN,NaN,9.735031745884909,15.300392154147126
2016-05-12T09:30:00-04:00,79.2,79.35,78.49,79.05,5603270,5411129.1,49.818960817217636,55.098094882710654,NaN,NaN,-105.50283514507262,-11.097913908207738,-0.1286939554372316,0.26428533216599703,0.39297928760322864,429684700,425895928.4,53.08287835460244,50.19700849513015,NaN,NaN,7.935599604732263,14.248278932802146
2016-05-13T09:30:00-04:00,78.66,79.01,78.07,78.11,7602049,5576246.9,43.985558853884974,53.977333580995115,NaN,NaN,-182.9454595695982,-36.930034978883995,-0.1990641205334014,0.1441491369364769,0.3432132574698783,422082651,426282578.4,53.99190360469562,50.049561706559416,NaN,NaN,4.339440897769882,12.83273064208325
2016-05-16T09:30:00-04:00,78.05,78.85,77.94,78.6,4605726,5583382.1,47.440430732168785,53.00133389012543,NaN,NaN,-148.72418082760385,-70.53479413807727,-0.20459386106686672,0.0874709311362949,0.2920647922031616,426688377,426547071,54.63935034254059,49.85979333398519,NaN,NaN,2.6492631451620223,11.377949571094504
2016-05-17T09:30:00-04:00,78.48,78.65,77.485,77.71,6543245,5696905.05,42.333135265455105,51.7295159037863,NaN,NaN,-196.27890633795306,-140.94108154142086,-0.25679506678988984,-0.028929041284200707,0.22786602550568913,420145132,424536458,48.99491578848888,49.48249493552145,NaN,NaN,-0.5551926294913385,9.673214971010813
2016-05-18T09:30:00-04:00,77.18,77.759,76.73,77.26,11329345,6024085.95,39.98896213817211,50.95471841836379,NaN,NaN,-244.15005291489896,-175.52028695902533,-0.3068475092735173,-0.15569336108620746,0.15115414818730982,408815787,421483329.4,41.91419681733123,48.89702427045892,NaN,NaN,-3.9114509180802637,7.732548415426374
2016-05-19T09:30:00-04:00,76.92,77.3099,76.645,77.19,7833646,6208631.05,39.62141802349448,49.9011455789197,NaN,NaN,-212.66517892635775,-196.95275571528236,-0.32797923705119864,-0.2588198981266885,0.06915933892451015,400982141,415742817.6,32.42555656287949,47.54195972240085,NaN,NaN,-6.6465735457748725,5.678388135254767
2016-05-20T09:30:00-04:00,77.28,77.95,77.22,77.7,3908089,6167534.95,43.68274222836463,48.56116816104095,NaN,NaN,-126.70361117553665,-185.70438603647005,-0.29211448501103193,-0.2959837673392798,-0.0038692823282478334,404890230,412304333.4,28.29379593900036,45.72098641155585,NaN,NaN,-7.674919168535106,3.7707728061419283
2016-05-23T09:30:00-04:00,77.59,77.94,77.35,77.43,4252544,6185301.3,42.06938984500624,47.60854085450889,NaN,NaN,-111.75024617354971,-178.30959910565923,-0.2715175229697522,-0.343266186040438,-0.07174866307068586,400637686,407094195.2,23.423397465312277,43.67640559827986,NaN,NaN,-9.002856578085437,1.945968608395162
2016-05-24T09:30:00-04:00,77.73,78.58,77.7,78.36,3991464,6189947.85,49.04963263408868,47.37511809884001,NaN,NaN,-47.6817752301302,-148.59017288409467,-0.1843698027601988,-0.30221091652093435,-0.11784111376073556,404629150,403990998.8,21.094322042358527,41.613928029045475,NaN,NaN,-7.970652324487502,0.52930847512621
2016-05-25T09:30:00-04:00,78.42,78.96,78.42,78.79,4353909,6122061.85,51.93349895732931,47.64059273141254,NaN,NaN,1.9121221131783948,-99.37773787847918,-0.09156639996554986,-0.23229911371767287,-0.140732713752123,408983059,404024453.2,21.185306983592454,39.67307240956033,NaN,NaN,-6.210458857291748,-0.4335154295049267
2016-05-26T09:30:00-04:00,79.01,79.29,78.83,78.95,3503953,5932220.45,52.999521276865295,47.658242228547,NaN,NaN,30.75857981128941,-50.692986130949755,-0.01710510350345021,-0.16211409313143577,-0.14500898962798556,412487012,406325427.4,27.38711269200438,38.385681907456025,NaN,NaN,-4.463240403469957,-1.0091904257856452
2016-05-27T09:30:00-04:00,79.07,79.435,79.07,79.32,3212112,5672848.65,55.45957488497642,47.73503421762702,NaN,NaN,53.35099684009922,-14.682064527822575,0.0553970272456496,-0.07576270557092357,-0.13115973281657317,415699124,408487206.2,32.74187173585324,37.7214229016884,NaN,NaN,-2.259503363537362,-1.1878065597501761
2016-05-31T09:30:00-04:00,79.44,79.49,78.93,79.24,4162968,5548596.05,54.79179890216413,47.28483553646181,NaN,NaN,54.22878170514074,18.513741047915516,0.09402629963452909,-0.013626858273411813,-0.1076531579079409,411536156,410666900.2,37.728261008321624,37.30304922491327,NaN,NaN,-0.638691057441781,-1.1093614879918339
2016-06-01T09:30:00-04:00,78.87,79.24,78.69,79.19,3767765,5448016.85,54.35131603193237,47.68042432793716,NaN,NaN,41.23174285647777,36.29644466523712,0.11109993529715392,0.03122176121350151,-0.07987817408365241,407768391,411294748.4,39.128175563878735,36.85936035006148,NaN,NaN,0.5870546462115658,-0.8670163259627768
2016-06-02T09:30:00-04:00,78.97,79.65,78.95,79.63,4057889,5328999.5,57.58294389444621,48.2349945477392,NaN,NaN,76.82263042068087,51.27854632673761,0.14478532331248115,0.10110348005694902,-0.04368184325553213,411826280,411863392.6,40.434279029004124,35.9558889696616,NaN,NaN,2.561718890402,-0.3771970093392373
2016-06-03T09:30:00-04:00,79.34,79.42,78.57,79.11,5655451,5297034.4,52.823506084781755,48.86627649280326,NaN,NaN,37.82017701250053,52.69086576697983,0.1255218398732763,0.11322045658606328,-0.012301383287213044,406170829,410600156,38.46003986573134,34.84647013116415,NaN,NaN,2.9886824114465953,0.1036429079158816
2016-06-06T09:30:00-04:00,79.2,79.46,78.91,79.31,4099973,5232448.05,54.3851408398438,49.36232721478005,NaN,NaN,54.73264547828406,52.9671954946168,0.11974348151494821,0.13737796860647222,0.017634487091524008,410270802,409514491.6,36.79716342237585,33.57202820829524,NaN,NaN,3.7804706114602147,0.6289040084222149
2016-06-07T09:30:00-04:00,79.31,79.75,79.3,79.41,4325668,5187905.8,55.183948249938375,50.28024242795743,NaN,NaN,80.13085901031873,58.14761095565241,0.11606556340268787,0.16271644134488383,0.046650877942195974,414596470,410126554.4,38.413822957458926,32.81623586322167,NaN,NaN,4.659359970014877,1.2046834315068808
2016-06-08T09:30:00-04:00,79.44,79.63,79.19,79.5,3951598,5143871.55,55.931923172315074,51.41902535896764,NaN,NaN,83.58055231235932,66.61737284682872,0.11299424955448312,0.18789368988529986,0.07489944033081675,418548068,412282489.8,43.86099567525804,32.95529292450216,NaN,NaN,5.598776569336014,1.8324110226253283
2016-06-09T09:30:00-04:00,79.09,79.41,79.01,79.32,6581099,5167088.15,53.99108131922854,52.44542988009149,NaN,NaN,62.976524085316775,63.84815157975589,0.09297584087223125,0.1911192414211058,0.09814340054887456,411966969,412310627.6,43.930698779779675,33.777088797137885,NaN,NaN,5.916560079255279,2.4158608878581784
2016-06-10T09:30:00-04:00,78.69,78.81,78.27,78.49,4813543,5127601.8,46.05513491693977,52.614886500704,NaN,NaN,-8.796225664740508,54.52487104430769,0.021691327299870833,0.1252575596737131,0.10356623237384227,407153426,412507147,44.449469671486185,34.93106549231545,NaN,NaN,3.9704185050713576,2.6379405474600612
2016-06-13T09:30:00-04:00,78.35,78.92,78,78.06,6033405,5049169.6,42.56453822122475,52.65025424186246,NaN,NaN,-28.638660724327156,37.85060980378544,-0.05251130903013075,0.037927096086178835,0.09043840511630959,401120021,410676990.8,40.67508359352107,36.163328787187496,NaN,NaN,1.2515829438613144,2.439889461231669
2016-06-14T09:30:00-04:00,77.87,78.155,77.365,77.86,8097665,5223766.55,41.00773535013407,52.07583300729427,NaN,NaN,-75.8024633011162,6.663945341498456,-0.10985539678744691,-0.04688084086799904,0.06297455591944787,393022356,406362168,33.46104134641077,37.04666588033409,NaN,NaN,-1.4831267912158186,1.879458568024885
2016-06-15T09:30:00-04:00,77.92,78.72,77.92,78.08,5635881,5178398.35,43.457574122044335,51.470409804773915,NaN,NaN,-34.50712851127162,-16.953590823227735,-0.1265729995927543,-0.09524169357149503,0.03133130602125928,398658237,402384201.8,28.451105345793863,37.565651477634184,NaN,NaN,-3.1334409643417396,1.1633300634010815
2016-06-16T09:30:00-04:00,77.71,78.43,77.24,78.33,6382312,4931046.7,46.19215064144978,50.98416904510139,NaN,NaN,-66.29405408988416,-42.80770645826792,-0.11474732894868223,-0.1121028551645935,0.002644473784088726,405040549,400998917.8,26.938490380997663,37.533607026847996,NaN,NaN,-3.7970675744955975,0.4547018294158417
2016-06-17T09:30:00-04:00,78.15,78.21,77.785,77.93,8559745,4967351.65,42.63889654000658,50.06840630617497,NaN,NaN,-80.41985027397698,-57.132431380115214,-0.12687115778559335,-0.15594447344790296,-0.029073315662309612,396480804,398864393.4,24.754593921030676,36.9630871829321,NaN,NaN,-5.388038330855845,-0.37997533633725633
2016-06-20T09:30:00-04:00,78.53,79.35,78.53,78.63,3972196,4970557,49.90169287944135,49.71911301883763,NaN,NaN,13.62025532642069,-48.68064816996565,-0.08288192254555568,-0.13267571884425422,-0.04979379629869854,400453000,398730989.2,24.62025421755078,36.02680098359132,NaN,NaN,-4.655117477569037,-0.9907099279417964
2016-06-21T09:30:00-04:00,78.86,78.86,78.295,78.45,2899280,4902893.8,48.21127478704178,49.280538644202586,NaN,NaN,-34.7062562749814,-40.4614067647387,-0.06199873372560398,-0.12729221345570352,-0.06529347973009954,397553720,399637262,27.498766587659333,35.196128913861365,NaN,NaN,-4.540844979508683,-1.4978720781656372
2016-06-22T09:30:00-04:00,78.51,78.95,78.28,78.34,4103718,4908506.5,47.1599022870546,48.536035672246044,NaN,NaN,-40.03970676185782,-41.567922414855936,-0.05208415430658006,-0.1303986726133246,-0.07831451830674455,393450002,398595615,26.25764178131257,34.18351196759768,NaN,NaN,-4.742514079531355,-1.9613923640750253
2016-06-23T09:30:00-04:00,79.06,79.12,78.75,79.11,4441205,4912871.3,54.62015780998668,48.66436793833212,NaN,NaN,27.284512278648375,-22.852209141149427,0.006714029083756151,-0.06992198195204935,-0.0766360110358055,397891207,397165746.6,24.615285758528188,33.19460095994032,NaN,NaN,-2.6395571234680224,-2.0582730439883106
2016-06-24T09:30:00-04:00,76.33,77.52,75.98,76.15,15348156,5505081.45,34.47179804859961,47.2419863103861,NaN,NaN,-250.1282145212039,-56.79388199059481,-0.1449859781924575,-0.2578684837763774,-0.11288250558391988,382543051,394378196,21.758068280739295,32.12037987839485,NaN,NaN,-8.642883224625104,-2.9989316412221383
2016-06-27T09:30:00-04:00,75.46,75.585,74.18,74.77,10861093,5887530.5,29.085029522588556,45.37777782986111,NaN,NaN,-321.28701328980435,-123.77533571383984,-0.3195074470931947,-0.5122668144504132,-0.19275936735721855,371681958,388623987.6,17.29522086017124,30.611908300017156,NaN,NaN,-15.830101265948576,-4.831955873325915
2016-06-28T09:30:00-04:00,75.64,76.26,75.42,76.26,7860635,6072413.85,39.98905182746728,44.23900130522913,NaN,NaN,-177.4213590005771,-152.31835625895897,-0.3152993449738407,-0.5868835485745194,-0.2715842036006787,379542593,385021762.2,15.194161073169425,28.564277257010826,NaN,NaN,-16.824091367269812,-6.545118086746472
2016-06-29T09:30:00-04:00,77.17,77.62,76.74,77.49,7053766,6236713.9,47.205756049761284,43.7543352145529,NaN,NaN,-68.36333311871584,-157.98308153033057,-0.21516156757982374,-0.5405361630754584,-0.32537459549563463,386596359,383651033.6,14.47362632794787,26.460200653308558,NaN,NaN,-14.496385006279306,-7.681013360965448
2016-06-30T09:30:00-04:00,77.73,78.09,77.23,78.06,6711840,6369411.45,50.19483397425331,44.05002800436102,NaN,NaN,-25.530228696502114,-168.54602972536065,-0.10177557733555637,-0.4525940671650801,-0.35081848982952374,393308199,382734432,13.995672660574726,24.28492943824345,NaN,NaN,-11.588877258061538,-8.239279631979175
2016-07-01T09:30:00-04:00,78.14,79.05,77.99,78.87,7130128,6443145.3,54.16612811745516,44.8787129969489,NaN,NaN,40.3440678400359,-110.4515732531127,0.02951846153671539,-0.3139204129086295,-0.3434388744453449,400438327,386313487.2,24.482169200169338,23.128292695861184,NaN,NaN,-7.807953722559883,-8.177661644919276
2016-07-05T09:30:00-04:00,78.38,78.54,77.74,78.23,7317558,6604024.55,50.724565785736324,45.572772313777634,NaN,NaN,8.974980474540008,-44.39917450024384,0.07255137680124724,-0.25274965344378586,-0.3253010302450331,393120769,390601249.4,34.747118055712164,23.220155317954145,NaN,NaN,-6.128579687131144,-7.884935650949543
2016-07-06T09:30:00-04:00,77.91,78.9,77.74,78.9,7780623,6776772.3,54.01832711712363,46.32711181342615,NaN,NaN,42.65948726646089,-0.38300524683623394,0.14144385350164468,-0.14849621336797725,-0.2899400668696219,400901392,394873009.2,43.05221884154245,24.2630919962219,NaN,NaN,-3.628725831710406,-7.2769056767725235
2016-07-07T09:30:00-04:00,78.78,79.24,78.71,79.24,9242827,7041333.75,55.63884313338452,47.00187556285007,NaN,NaN,92.5672053166981,31.80310244024655,0.20155093664591525,-0.038001396062227855,-0.2395523327081431,410144219,399582581.2,50.52811062648762,25.948064870899753,NaN,NaN,-1.1299071599643127,-6.398763031514208
2016-07-08T09:30:00-04:00,79.75,80.68,79.75,80.62,7411381,7082847.85,61.56035709341648,48.3534084595222,NaN,NaN,188.35691116744573,74.58053041303613,0.31891158770608824,0.1590871519244672,-0.15982443578162103,417555600,404432061.4,56.81476922883453,28.238077392885742,NaN,NaN,3.1203700789875213,-5.038886872871104
2016-07-11T09:30:00-04:00,81.06,81.29,80.83,81.09,4431021,7063721.75,63.35448806037051,49.314322401017144,NaN,NaN,210.42720604040755,108.59715805311046,0.40720448860052305,0.3491811749690328,-0.05802331363149027,421986621,408741720.2,61.49734139452344,30.872155048383785,NaN,NaN,7.09511617126163,-3.305457866566428
2016-07-12T09:30:00-04:00,81.35,81.62,81.28,81.41,4886042,7006353.6,64.56709044275283,50.48259494785365,NaN,NaN,194.24865202782192,145.65189236376685,0.4621490760938139,0.5196630314857771,0.057513955391963204,426872663,415492099,67.45068590541499,33.725863571080616,NaN,NaN,10.650908713513918,-1.311691212269236
2016-07-13T09:30:00-04:00,81.52,81.59,80.83,81.01,3655401,6784240.4,61.81364379661284,51.52929076996495,NaN,NaN,151.62778927666977,167.4455527658086,0.44630925156716744,0.6154005198509225,0.16909126828375504,423217262,419955273,70.67882356026252,36.8988051267199,NaN,NaN,12.708917387548729,0.6912528734190448
2016-07-14T09:30:00-04:00,81.61,81.81,81.24,81.34,3406049,6672748.8,63.207640420815835,52.14268238502417,NaN,NaN,142.84804969956625,177.50172164238225,0.43250314420760894,0.7097201985432662,0.27721705433565724,426623311,423251091.4,72.82233810579568,40.34216600866758,NaN,NaN,14.816467764375735,2.7091407149842865
2016-07-15T09:30:00-04:00,81.73,81.748,80.92,80.98,3483683,6527817.35,60.608324739142894,54.00957714863441,NaN,NaN,112.51916202260493,162.3341718134141,0.37567552014379035,0.7468114545153952,0.37113593437160486,423139628,424367897,73.52852899676672,44.0400560598124,NaN,NaN,15.816617765120666,4.581637436432341
2016-07-18T09:30:00-04:00,81.17,81.52,80.95,81.29,2775041,6238582.15,62.055374917957735,56.36460181973221,NaN,NaN,99.95216336065738,140.23916327746406,0.33676343508774653,0.792090228231288,0.4553267931435415,425914669,425153506.6,74.03954696299624,48.09322221001418,NaN,NaN,17.064576103169923,6.364914388823424
2016-07-19T09:30:00-04:00,80.85,81.165,80.68,81.14,2636780,6171811.35,60.889805943283726,57.85751282800481,NaN,NaN,78.35621811937638,117.06067649577497,0.28099662125297287,0.8065725697097577,0.5255759484567848,423277889,424434551.8,72.65720256894531,52.19772517399817,NaN,NaN,17.781579567409217,7.995866557192823
2016-07-20T09:30:00-04:00,81.36,81.52,80.98,81.48,2451007,6149397.7,62.604362659075136,58.95741330009865,NaN,NaN,81.34138068622563,103.00339477768611,0.24821918561261092,0.8358499304725484,0.5876307448599375,425728896,424936878.6,73.03599934743137,56.380751818247,NaN,NaN,18.86125286317697,9.548064600904844
2016-07-21T09:30:00-04:00,81.47,81.62,81.01,81.26,2434747,6065949.15,60.748582693017966,59.711252494296126,NaN,NaN,71.95058226336327,88.82390129044555,0.19526566071316342,0.8317128207513917,0.6364471600382283,423294149,424271046.2,71.61968710266528,60.496752849824894,NaN,NaN,19.28449045180254,10.938982579604515
2016-07-22T09:30:00-04:00,81.34,81.6976,81.1639,81.6,2529634,5970370.6,62.59403840245884,60.31324608608211,NaN,NaN,71.42148066243679,80.6043650184119,0.16773490701765614,0.8461157938102986,0.6783808867926424,425823783,424807877.2,72.0896298757084,63.897285755220544,NaN,NaN,20.14009884409856,12.25342776024652
2016-07-25T09:30:00-04:00,81.83,81.8301,81.48,81.73,3130219,5359473.75,63.30445122103462,61.21180933146055,NaN,NaN,72.62146580558877,75.13822550739819,0.14379785020890612,0.8581281995537751,0.7143303493448689,428954002,425415743.8,72.64204655124081,66.60406636204402,NaN,NaN,21.049680440564728,13.510035286006264
2016-07-26T09:30:00-04:00,81.66,82.025,81.34,81.63,4987724,5065805.3,62.32390970522879,61.80506523061092,NaN,NaN,69.03660891391061,73.27430366630503,0.10836226599331622,0.8497831818365142,0.741420915843198,423966278,425553421.6,72.77348835359682,68.72701418433361,NaN,NaN,21.577873048623534,14.66258353780873
2016-07-27T09:30:00-04:00,81.87,81.9,81.07,81.38,4295122,4887529.65,59.828926423231664,62.10435689417143,NaN,NaN,56.78267106764671,68.36256174258925,0.057757590345439036,0.8136179037749969,0.7558603134295578,419671156,424341873.6,69.60430482265805,70.08959948406007,NaN,NaN,21.41061611770492,15.626588192079614
2016-07-28T09:30:00-04:00,81.16,81.63,80.86,81.53,3158914,4692787.05,60.84183719958346,62.053034044611934,NaN,NaN,47.342393578079154,63.44092400553243,0.025693427075174413,0.7879770972735258,0.7622836701983514,422830070,424249057.8,69.35512165300048,70.98533894292908,NaN,NaN,21.51529187186947,16.467831574906736
2016-07-29T09:30:00-04:00,81.42,81.74,81.28,81.62,3996267,4557008.4,61.46960231489959,61.91839934850687,NaN,NaN,58.35477536857117,60.82758294675931,0.0030433338493186524,0.7660878375099998,0.7630445036606811,426826337,424449568.6,69.60824888519406,71.56468947797698,NaN,NaN,21.757573507151402,17.22350899379883
2016-08-01T09:30:00-04:00,81.62,81.96,81.31,81.75,2750209,4338012.45,62.40709162278061,61.76411371850885,NaN,NaN,67.83594878622301,59.87047954288615,-0.009973077159885047,0.7505781572108248,0.7605512343707098,429576546,424574077.4,69.77520078076546,71.73072625478771,NaN,NaN,22.19417687731982,17.9336044057304
2016-08-02T09:30:00-04:00,81.81,81.81,80.37,80.53,4246682,4184468.65,50.089843996669636,60.926699447084346,NaN,NaN,-17.34580147795957,42.59399746451211,-0.10240005651109019,0.632551163731847,0.7349512202429372,425329864,424846794.6,70.16183905862422,71.69379879038499,NaN,NaN,19.143038638123674,18.106380724643724
2016-08-03T09:30:00-04:00,80.26,80.76,80.09,80.76,3872012,3989038.1,52.012750958134035,60.127064485464224,NaN,NaN,-102.58797809781761,10.719867631419243,-0.1469858636969461,0.5512188906217546,0.6982047543187007,429201876,426752938.6,72.78253676477843,71.69095583745518,NaN,NaN,17.080545029889723,17.959832768250294
2016-08-04T09:30:00-04:00,80.61,80.89,80.4,80.72,2240348,3638914.15,51.640124691494925,59.486478767775075,NaN,NaN,-126.88153365847097,-24.124917815890782,-0.17614424803507966,0.47802444427485113,0.6541686923099308,426961528,427579230.2,73.85455750481182,71.71424358802983,NaN,NaN,15.2649284611328,17.57484643866208
2016-08-05T09:30:00-04:00,81.2,81.69,80.88,81.57,3518591,3444274.65,58.45187457257963,59.22908588596236,NaN,NaN,28.402438421080845,-30.11538520538885,-0.13690530275284252,0.4830370638688777,0.6199423666217202,430480119,428309986.6,74.79988447304483,71.76855341017615,NaN,NaN,15.51787620872206,17.28099354867065
2016-08-08T09:30:00-04:00,81.63,81.77,81.23,81.3,3148390,3380143.1,55.76489756010727,58.86302100144976,NaN,NaN,39.35765339274931,-35.811044284083586,-0.12801695528972246,0.4599211725095671,0.5879381277992896,427331729,427861023.2,73.05228128649273,71.7967733185724,NaN,NaN,14.958842824673013,16.949257730956703
2016-08-09T09:30:00-04:00,81.14,81.461,80.9,81.06,7364076,3504044.8,53.41441960690141,58.20659649772306,NaN,NaN,-39.090953191224216,-40.16007462673652,-0.13641140996135082,0.417423865347601,0.5538352753089518,419967653,426788581,68.91060992789,71.50210264574801,NaN,NaN,13.81731264063529,16.50183700376793
2016-08-10T09:30:00-04:00,81.09,81.47,81.06,81.23,3389445,3490747,54.86561265097318,57.78638435186273,NaN,NaN,-9.261817860818924,-21.494842579336776,-0.12872218764071863,0.3929325407580535,0.5216547283987721,423357098,425619625.4,64.61073950641361,71.00146353173004,NaN,NaN,13.253618813660454,16.037805833752575
2016-08-11T09:30:00-04:00,81.67,82.14,81.63,82.04,3694771,3505183.1,61.085788878015954,57.678652242973946,NaN,NaN,166.13955680409703,37.1093755131768,-0.07021842116706689,0.4338817019399386,0.5041001231070055,427051869,425637693.6,64.64745855932702,70.46987986627423,NaN,NaN,14.589054461787038,15.830841352043212
2016-08-12T09:30:00-04:00,81.87,82.2,81.42,82,2456627,3453830.3,60.64133820345418,57.48842988457534,NaN,NaN,130.93539363918612,57.61596655679786,-0.03701691923050471,0.4578289740688746,0.4948458932993793,424595242,424460718.2,60.26119331272942,69.58553320638056,NaN,NaN,15.54909423407328,15.790591763761793
2016-08-15T09:30:00-04:00,82.22,82.38,82.11,82.16,3070450,3468600.75,61.8374330968568,57.453681555405915,NaN,NaN,180.05003467571157,85.7544428133903,-0.008566962303639625,0.4841371904198297,0.49270415272346935,427665692,424527510.8,60.42529263729847,68.70351922664496,NaN,NaN,16.691196250755194,15.919249547617992
2016-08-16T09:30:00-04:00,81.96,82.06,81.63,81.69,2307926,3452158.05,56.4139945535049,57.209757850425426,NaN,NaN,80.06830959472957,109.58629537058104,-0.02477217785469188,0.4617389304051045,0.4865111082597964,425357766,425605533.4,63.07556228134382,68.23718047369394,NaN,NaN,16.157496688404546,15.953284853444643
2016-08-17T09:30:00-04:00,81.4,81.555,81.01,81.5,3424270,3500821.2,54.33919154596066,56.745283160880945,NaN,NaN,-16.96125236869404,108.04640846900604,-0.05019147955023762,0.42377175882199936,0.473963238372237,421933496,425320813,61.896561010722515,67.70442614210266,NaN,NaN,15.121563333229776,15.834467493413948
2016-08-18T09:30:00-04:00,81.55,81.64,81.3,81.45,4733027,3615735.2,53.778658695890655,56.195930045237446,NaN,NaN,5.306535967681926,75.87980430172301,-0.0710046006672897,0.38520748753812484,0.45621208820541453,417200469,423350533,54.32864867801922,66.61302612730445,NaN,NaN,14.107792735947102,15.587799670918685
2016-08-19T09:30:00-04:00,81.35,81.67,81.19,81.5,3723871,3675447.05,54.286487317585255,55.615886880580625,NaN,NaN,3.4447622388350077,50.3816780216528,-0.08129599860384018,0.3545920899506143,0.4358880885544545,420924340,422616352.6,51.787700985694656,65.32820471337082,NaN,NaN,13.385816097808046,15.273230589045736
2016-08-22T09:30:00-04:00,81.42,81.54,81.18,81.42,2888580,3663365.1,53.27787061638843,55.843603067703405,NaN,NaN,-10.10142359505927,12.35138636749863,-0.09256409847593383,0.32018296545953717,0.412747063935471,418035760,420690366.2,45.74359307219681,63.58404428576887,NaN,NaN,12.510023882943196,14.87848677388823
2016-08-23T09:30:00-04:00,81.8,81.93,81.685,81.83,5350824,3681520.1,57.623367197141945,56.244361370489685,NaN,NaN,87.81922014217776,13.901568476988274,-0.07237205620954323,0.32228199367354193,0.39465404988308517,423386584,420296129.8,44.596253066631846,61.570738307329826,NaN,NaN,12.8652675500392,14.590884027624083
2016-08-24T09:30:00-04:00,81.75,81.945,81.28,81.44,3233111,3628419.55,52.61083249332517,56.313697642048986,NaN,NaN,26.7505429491602,22.643927540559115,-0.08440908705502881,0.28914269106429913,0.37355177811932794,420153473,419940125.2,43.534367604722306,59.405010457323435,NaN,NaN,11.796369751663752,14.191667702486892
2016-08-25T09:30:00-04:00,81.14,81.44,81.02,81.17,3030748,3622011.25,49.4065754138416,55.66760484499627,NaN,NaN,-48.181043032111496,11.946411740600427,-0.10816517045723789,0.23834531504778056,0.34651048550501845,417122725,419924576.4,43.48566509164111,57.16828050150888,NaN,NaN,9.966176874303338,13.588026155603528
2016-08-26T09:30:00-04:00,81.29,81.61,80.58,80.94,6289208,3736658.3,46.79216323934383,55.02669525065602,NaN,NaN,-75.89010372861523,-3.9205614528896207,-0.1352219589634705,0.17748303680068034,0.31270499576415084,410833517,417906411.8,37.60520294859876,54.63634633451646,NaN,NaN,7.65112135304914,12.739896898095758
2016-08-29T09:30:00-04:00,80.94,81.33,80.94,81.22,3996282,3798961.95,50.24399549218874,54.80023638531941,NaN,NaN,-45.83346630214587,-11.066969994306941,-0.13007399717683976,0.1501124992931011,0.28018649646994087,414829799,417265219.6,35.94222448881864,52.281461660297076,NaN,NaN,6.598062929846378,11.862492045488704
2016-08-30T09:30:00-04:00,81.14,81.24,80.64,80.77,2452905,3709273.1,45.1719610846424,54.107832702010064,NaN,NaN,-104.82278073996393,-49.59537017073528,-0.15130101611584026,0.09106022632514055,0.2423612424409808,412376894,415063281.6,30.890244995516355,49.8728549095187,NaN,NaN,4.159279118271833,10.762033055886294
2016-08-31T09:30:00-04:00,80.71,80.84,80.26,80.56,3500937,3690719.35,42.990908625009276,52.81534125536673,NaN,NaN,-175.47291502766495,-90.04006176610031,-0.17228552165960515,0.027004340366474366,0.1992898620260795,408875957,412807778.4,26.743577819428765,47.165434856668824,NaN,NaN,1.4565608058379889,9.432679877307965
2016-09-01T09:30:00-04:00,80.65,80.895,80.28,80.72,5416837,3849543.8,45.1633759234469,51.709772521080495,NaN,NaN,-157.3516237303338,-111.87417790574477,-0.16801277288345937,-0.010726104078244703,0.15728666880521466,414292794,412241792.2,25.80737751284113,44.704448013819665,NaN,NaN,-0.20630857026048074,8.05568152765533
2016-09-02T09:30:00-04:00,81.11,81.185,80.695,80.88,3352425,3841235.5,47.32508695775106,50.67317636828722,NaN,NaN,-85.42580764829417,-113.78131868968057,-0.14775031587027018,-0.02740122603262307,0.12034908983764711,417645219,413604132.6,31.97974798234712,42.67262339560885,NaN,NaN,-1.0128892216452,6.760171420612398
2016-09-06T09:30:00-04:00,80.88,81.03,80.48,81.03,6177982,3992715.1,49.34130227639387,50.1679840627793,NaN,NaN,-88.50494850771935,-122.31561513079525,-0.11882943476646338,-0.028187703620432103,0.09064173114603127,423823201,415402813,39.17470992407064,40.96541965580362,NaN,NaN,-1.1420856432366704,5.631277554348245
2016-09-07T09:30:00-04:00,80.87,81.085,80.72,81.07,5364303,3892726.45,49.89210070717302,49.850334717151604,NaN,NaN,-64.49815525938726,-114.25069003467993,-0.09274680826256002,-0.02529177918216874,0.06745502908039128,429187504,418764935,49.85254707982421,40.10513294645375,NaN,NaN,-1.1028490571189642,4.669259466995787
2016-09-08T09:30:00-04:00,80.65,80.81,80.27,80.37,4459104,3946209.4,41.407353961751944,48.966670093284556,NaN,NaN,-129.82886752573194,-105.12188053429331,-0.11682412162484683,-0.07857512295066726,0.038248998674179566,424728400,421935423.6,57.44003151360229,40.32737457756683,NaN,NaN,-3.591310918390226,3.489177983369214
2016-09-09T09:30:00-04:00,79.8,79.96,78.43,78.43,9562492,4239595.45,27.46629961648837,47.050942400349065,NaN,NaN,-298.62142341019285,-133.37584047026513,-0.24994617831306587,-0.27418372421715276,-0.024237545904086902,415165908,422110046.4,57.81858695490125,40.758152146795865,NaN,NaN,-11.929883477069804,1.2864549175922115
2016-09-12T09:30:00-04:00,78.12,79.73,78.01,79.53,10876558,4660592,39.83532202858108,46.09076035836283,NaN,NaN,-226.60716151468867,-161.612111243544,-0.24986151347989016,-0.3365644377539496,-0.08670292427405946,426042466,423789495.8,61.376763690962704,41.87480719099343,NaN,NaN,-13.808278449995079,-0.869935563491687
2016-09-13T09:30:00-04:00,78.95,79.18,78.15,78.4,9237180,4968928.5,33.51296720532905,44.36858893037619,NaN,NaN,-226.5501266187206,-189.2211468657443,-0.30803379989298874,-0.4717451741402954,-0.16371137424730664,416805286,422385912.8,57.04578717997507,42.76405962766081,NaN,NaN,-18.0300306517764,-3.3213777189609317
2016-09-14T09:30:00-04:00,78.42,78.87,78.18,78.41,7355708,5221317.6,33.61338191069399,43.01162817447397,NaN,NaN,-185.95866386055425,-213.5132485859777,-0.3262167192526871,-0.5714822733131655,-0.2452655540604784,424160994,421380610.8,54.1011520622629,43.518829946056556,NaN,NaN,-20.967220965226556,-5.84221246842745
2016-09-15T09:30:00-04:00,78.17,79.03,78.05,78.98,5772560,5338732.1,39.245815758324554,42.28585962765133,NaN,NaN,-138.2391656541078,-215.19530821165284,-0.2819004937595102,-0.5976411712598662,-0.31574067750035595,429933554,422421641.6,56.59950781690325,44.455532997861,NaN,NaN,-21.198375871044473,-8.035950097372739
2016-09-16T09:30:00-04:00,78.41,78.575,78.17,78.51,5351536,5369657.55,36.49620659427459,41.550434153003515,NaN,NaN,-130.00229379611832,-181.47148228883796,-0.2664620069740993,-0.64881818621798,-0.38235617924388077,424582018,424304863.6,60.76051458495168,46.10948382902906,NaN,NaN,-22.3618861127625,-10.082512385285561
2016-09-19T09:30:00-04:00,78.64,78.99,78.27,78.45,3127433,5339835.65,36.14802941012781,40.54357943285631,NaN,NaN,-102.16212990422886,-156.58247596674602,-0.24316027536528184,-0.686306523450483,-0.4431462480852012,421454585,423387287.4,57.850238273545585,47.674341956509565,NaN,NaN,-23.363494246408198,-11.97979550830308
2016-09-20T09:30:00-04:00,78.77,78.88,78.31,78.51,3342216,5362517.45,36.79736980030817,39.94539434111816,NaN,NaN,-89.28518397529025,-129.12948743805993,-0.2079391984008095,-0.703070246086213,-0.49513104768540356,424796801,424985590.4,61.32514486097943,49.84826337547121,NaN,NaN,-23.94717434416053,-13.689421056282717
2016-09-21T09:30:00-04:00,78.63,79.31,78.4,79.27,6015908,5395771.65,44.496871221619905,40.052963098018914,NaN,NaN,-56.53678214755014,-103.24511109545911,-0.12194735357075026,-0.6475652396488414,-0.5256178860780911,430812709,426315933.4,63.98649832651947,52.50847198312054,NaN,NaN,-21.948048441620067,-14.869224968473766
2016-09-22T09:30:00-04:00,79.73,80,79.6,79.85,4821435,5475187.85,49.54817425616366,40.366162978927264,NaN,NaN,-1.6384134966330157,-75.92496066396413,-0.019850446437513547,-0.5504309441249831,-0.5305804976874695,435634144,427456051.4,66.13714138846943,55.38916940280827,NaN,NaN,-18.58308599076512,-15.399776543086817
2016-09-23T09:30:00-04:00,79.63,79.93,79.63,79.67,3891172,5518209.05,48.08555990660603,40.420482475274035,NaN,NaN,-1.7508884458678244,-50.27467959391403,0.03853253184272698,-0.48241483288406073,-0.5209473647267877,431742972,428888242.2,68.66831804495997,58.00978155013776,NaN,NaN,-16.339256040993384,-15.533987899930613
2016-09-26T09:30:00-04:00,79.45,79.45,78.69,78.79,5928319,5500164.6,41.61751316572753,39.868783253083585,NaN,NaN,-49.1099818727512,-39.66424998761848,0.021695746095912738,-0.49382768210689676,-0.5155234282028095,425814653,429760255.8,70.1322098920727,60.22103154785219,NaN,NaN,-16.456264913397103,-15.665741758997255
2016-09-27T09:30:00-04:00,78.89,79.59,78.76,79.59,5137461,5557223.55,48.411205155283874,39.76300499937723,NaN,NaN,-19.920076531997648,-25.791228498959953,0.06575950785599882,-0.43332404338281094,-0.49908355123880976,430952114,430991318.4,72.11312853909831,61.811073080657486,NaN,NaN,-14.237995976110298,-15.46177807572769
2016-09-28T09:30:00-04:00,79.64,79.85,79.34,79.81,4130322,5641094.4,50.12983154218695,40.38603911226544,NaN,NaN,12.87531330275886,-11.908809408898152,0.10852053351591018,-0.36343288434392207,-0.47195341785983225,435082436,431845263.8,73.42955622298057,62.95318198847023,NaN,NaN,-11.91947634082143,-14.955734970741082
2016-09-29T09:30:00-04:00,79.72,80.175,79.1734,79.4,6361080,5784101.55,46.98816262441458,41.78045789854588,NaN,NaN,10.644087165458538,-9.452309276479841,0.10777095734964287,-0.3372397211727787,-0.44501067852242154,428721356,430462706.2,67.84542526515965,63.66938472491726,NaN,NaN,-10.995771627707244,-14.390025921736248
2016-09-30T09:30:00-04:00,79.75,80.28,79.6,80.04,4789737,5752746.55,52.04078705959869,42.65227682933287,NaN,NaN,50.85191905434455,1.0682522235626195,0.1465519881173345,-0.2618206933757534,-0.4083726814930879,433511093,430816330.4,68.5051572843353,64.17855569587245,NaN,NaN,-8.565657176027596,-13.55797324377787
2016-10-03T09:30:00-04:00,79.73,80.17,79.65,79.99,7726052,5971427.9,51.62679308201526,43.94612153481045,NaN,NaN,56.30136069732174,22.150520737577207,0.16370886210112034,-0.20373660386668746,-0.3674454659678078,425785041,430810408,68.47981604683487,64.99527204350528,NaN,NaN,-6.769301383955898,-12.588162978089017
2016-10-04T09:30:00-04:00,80.06,80.32,79.5501,79.71,8939143,6109485.95,49.263341321651865,45.0639757784503,NaN,NaN,58.348422966444886,37.804220637265715,0.15136155356799702,-0.17824352400781152,-0.32960507757580854,416845898,427989164.8,57.55709399517224,65.2421250387131,NaN,NaN,-5.971121942182383,-11.642871401530925
2016-10-05T09:30:00-04:00,80.01,80.36,79.91,80.04,7135269,6198034.25,52.049496840692825,45.9785244271909,NaN,NaN,97.13882301470306,54.656922579654555,0.1597526526714224,-0.12991426173653053,-0.28966691440795295,423981167,425768911,50.70301837980173,64.82094722177727,NaN,NaN,-4.475840627758123,-10.619009862420524
2016-10-06T09:30:00-04:00,79.93,80.255,79.61,80.1,7262545,6338206.3,52.55959513599241,47.125909323027884,NaN,NaN,90.37356097611787,70.60281734178642,0.1631074307902456,-0.08578262592014596,-0.24889005671039155,431243712,426273382.2,52.09879184838766,64.20225274059412,NaN,NaN,-3.1093729608225558,-9.546204590763672
2016-10-07T09:30:00-04:00,80.33,80.41,79.54,79.74,8692053,6294684.35,49.17912258889807,48.056701692940045,NaN,NaN,71.53659896382537,74.73975332368259,0.13595450384172897,-0.07894692690823035,-0.21490143074995932,422551659,424081495.4,46.004027836426395,63.356094852228466,NaN,NaN,-2.8744118887473293,-8.593091347618481
2016-10-10T09:30:00-04:00,80.12,80.219,79.815,79.87,2970513,5899382.1,50.41924365401872,49.029692682490804,NaN,NaN,72.60491070876951,78.00046332597215,0.12206412714383377,-0.06232127182016711,-0.18438539896400089,425522172,424028921.6,45.8654318480335,62.25182963701804,NaN,NaN,-2.3382581386806267,-7.699543746341645
2016-10-11T09:30:00-04:00,79.93,79.93,78.741,78.9,8425902,5858818.2,42.15371165287744,48.86232414186634,NaN,NaN,-24.817853871691064,61.367207958344956,0.04673697746777966,-0.12596417712927632,-0.17270115459705598,417096270,424078996,46.03220285947248,60.9693799608004,NaN,NaN,-4.344286841135141,-7.220221331312144
2016-10-12T09:30:00-04:00,78.98,79.564,78.88,79.27,3798210,5680943.3,45.80344267104845,48.59484331435811,NaN,NaN,-25.54158140915143,36.83112707357405,0.022260368865413882,-0.14487569351528862,-0.1671360623807025,420894480,423461658.6,44.223406814275734,59.404113205500856,NaN,NaN,-4.941635641462151,-6.894709089905002
2016-10-13T09:30:00-04:00,78.71,79.19,78.19,78.98,4027979,5593714.25,43.487485039920884,48.26640939530916,NaN,NaN,-89.05784112524096,0.9448466533022838,-0.011231395465145566,-0.18117530671213444,-0.16994391124698888,416866501,420586216.4,36.94200439160302,57.13794794454679,NaN,NaN,-6.134195167428823,-6.786064243836977
2016-10-14T09:30:00-04:00,79.23,79.49,78.85,78.89,3474562,5499865.55,42.7648015316852,48.34835856430614,NaN,NaN,-57.7878075654134,-24.92003465254547,-0.035828859739149316,-0.21472998592092551,-0.1789011261817762,413391939,418754272.4,33.19233577374919,54.499385507523684,NaN,NaN,-7.318174191976483,-6.862079950714049
2016-10-17T09:30:00-04:00,78.86,78.87,78.22,78.24,3628640,5524925.9,37.87000398995445,47.59541562392547,NaN,NaN,-149.38766729666793,-69.31855025363295,-0.08921833984541766,-0.2904240509885483,-0.20120571114313063,409763299,415602497.8,27.938228472079288,51.34403550273661,NaN,NaN,-9.86421492710121,-7.290956375912216
2016-10-18T09:30:00-04:00,79.05,79.2,78.65,78.76,3950181,5555324.15,43.4467458569971,47.118052360697625,NaN,NaN,-92.08540348391088,-82.7720601760769,-0.08298531960200628,-0.3049373606456385,-0.2219520410436322,413713480,414925939.8,26.95197995420061,48.024208626395186,NaN,NaN,-10.377906808643813,-7.731949294873872
2016-10-19T09:30:00-04:00,78.89,79.2,78.69,79.11,3256058,5417331.65,46.901453000949495,47.11185881616441,NaN,NaN,-72.28561665053626,-92.12086722435387,-0.05036867895936742,-0.28491288974284146,-0.23454421078347404,416969538,414140951.4,25.81336970394952,45.0219189434516,NaN,NaN,-9.761187822798279,-8.021840513148787
2016-10-20T09:30:00-04:00,78.93,79.15,78.64,78.96,4909466,5421733.2,45.61535922736487,46.652899685290556,NaN,NaN,-76.3214519599558,-89.57358939129685,-0.03471914588603356,-0.277943143141016,-0.24322399725498242,412060072,413179665.6,24.45111875094463,41.87520190535228,NaN,NaN,-9.629855647650091,-8.251556960934687
2016-10-21T09:30:00-04:00,78.58,79.71,78.58,79.59,4797682,5467058.7,51.61630059457034,46.65215022190164,NaN,NaN,-17.008011112494035,-81.41763010071297,0.019332268221236404,-0.21905866197843693,-0.23839093019967333,416857754,413872828.6,27.42528530293454,38.942735423645104,NaN,NaN,-7.674738834168117,-8.169154371396607
2016-10-24T09:30:00-04:00,79.99,80.21,79.82,80.16,3568315,5349058.5,56.3132105884767,47.15571231238913,NaN,NaN,90.5202780635323,-33.436041028672925,0.09074665097042689,-0.12495761648663972,-0.2157042674570666,420426069,416005382.6,35.79917445997684,37.38859831398828,NaN,NaN,-4.492400148052042,-7.643903768061669
2016-10-25T09:30:00-04:00,79.8,79.8,79.18,79.22,4633803,5323875.6,48.032200213527524,46.868762553305885,NaN,NaN,-9.475241602919105,-16.914008652474575,0.07272864379900437,-0.12479346270831115,-0.19752210650731553,415792266,416421139.8,37.31766285437544,36.432501490743554,NaN,NaN,-4.381661599024466,-7.177869172484926
2016-10-26T09:30:00-04:00,78.87,79.21,78.72,78.88,4326491,5333684.05,45.42993870480576,46.35950137964969,NaN,NaN,-71.9391863138575,-16.84472258513883,0.0377255159278046,-0.15036521159755978,-0.18809072752536438,411465775,415320387.2,34.96002435235641,35.208303812455604,NaN,NaN,-5.1408952441218,-6.88687289700448
2016-10-27T09:30:00-04:00,79.08,79.2,78.08,78.22,5335234,5282391.75,40.80810240404386,45.76157136644582,NaN,NaN,-120.09268353868619,-25.598968900884902,-0.02659627124214614,-0.22133606657804705,-0.1947397953359009,406130541,414134481,32.5724417911602,34.24890480922231,NaN,NaN,-7.329135984806087,-6.9500533381189955
2016-10-28T09:30:00-04:00,77.8,78.57,77.75,78.04,5006087,5293209.25,39.624119884870694,44.99049109722096,NaN,NaN,-154.73899732325498,-53.14516614303709,-0.07522947477906819,-0.28877663880973614,-0.21354716403066795,401124454,410987821,27.253829124024918,32.919504614650265,NaN,NaN,-9.451543364084344,-7.307409056114046
2016-10-31T09:30:00-04:00,78.15,78.295,77.94,78.1,5898954,5201854.35,40.246457393604274,44.85425865013003,NaN,NaN,-140.17142429302865,-99.28350661434928,-0.0959922426345915,-0.3335374673239073,-0.23754522468931583,407023408,408307288.8,23.703160114629483,31.324572990018623,NaN,NaN,-10.963263076683042,-7.829673916195331
2016-11-01T09:30:00-04:00,78.3,78.44,76.93,77.55,11945883,5352191.35,36.529385264299854,44.19182597821941,NaN,NaN,-175.89552626989172,-132.5675635477438,-0.13690793193583,-0.4086801396091033,-0.2717722076732733,395077525,404164340.6,19.479143034570157,29.55712557718251,NaN,NaN,-13.422979120276896,-8.628717516778412
2016-11-02T09:30:00-04:00,77.35,77.6868,76.88,77.08,9695150,5480185.4,33.66779253196732,43.49041937050845,NaN,NaN,-197.68400544682595,-157.7165273743375,-0.1828927599532046,-0.5003881576147791,-0.3174953976615745,385382375,398947660.6,15.68809699605859,28.038989334643617,NaN,NaN,-16.414610360398438,-9.740987923009843
2016-11-03T09:30:00-04:00,77.22,77.59,76.7,76.88,8900837,5562100,32.50103795720723,42.75729340090288,NaN,NaN,-179.7085546985508,-169.63970160631044,-0.21199660641522045,-0.5824911556806001,-0.3704945492653796,376481538,393017860,12.669645221114237,26.573082866598266,NaN,NaN,-19.226307111372005,-11.096033521347294
2016-11-04T09:30:00-04:00,76.81,77.39,76.61,76.73,8912152,5573104.95,31.616087532219296,42.310585082493226,NaN,NaN,-162.20218806103196,-171.1323397538658,-0.22532004261451644,-0.6521446025335251,-0.4268245599190087,367569386,386306846.4,10.262959849253832,25.31056367925359,NaN,NaN,-21.806633087463958,-12.626119173649675
2016-11-07T09:30:00-05:00,77.83,78.51,77.59,78.5,7143701,5781764.35,49.19508582607422,42.72118079457016,NaN,NaN,-34.47192177649534,-149.99243925055916,-0.10501072235240666,-0.558087962859517,-0.45307724050711035,374713087,379844782.2,8.574042720233507,23.99785387682737,NaN,NaN,-18.336299446774657,-13.441859212667529
2016-11-08T09:30:00-05:00,78.5,79.15,78.3,78.82,5325195,5626729,51.61665810853795,43.057981159397904,NaN,NaN,23.422704751697935,-110.12879304624123,0.00045393553526529296,-0.45250982108802873,-0.452963756623294,380038282,376836933.6,7.920661633932596,22.719803300397587,NaN,NaN,-14.757391728004135,-13.629792429144187
2016-11-09T09:30:00-05:00,77.17,79.12,76.98,78.98,11425598,6008098.4,52.82735827090506,43.573123948222204,NaN,NaN,-13.025180165637055,-73.19702799000345,0.08087375417525478,-0.3518715639042256,-0.43274531807948036,391463880,378053234.6,10.87822803096212,21.750311106113116,NaN,NaN,-11.53421753538354,-13.33042458717838
2016-11-10T09:30:00-05:00,79.29,80.15,78.67,79.27,16685235,6640961.2,55.0241207361086,43.8165396726178,NaN,NaN,86.55239992343826,-19.944837065605633,0.1494921816448458,-0.24588009102342312,-0.3953722726682689,408149115,384386750,24.480723351462956,21.539985252436576,NaN,NaN,-8.199858336856483,-12.59748655141811
2016-11-11T09:30:00-05:00,78.97,79.83,78.92,79.72,6039266,6769196.4,58.271443536812754,43.9564134546418,NaN,NaN,94.35262318690735,31.366125183982227,0.21698673769493587,-0.12413885054959906,-0.3411255882445349,414188381,393710549,39.194124433191206,21.782481679094747,NaN,NaN,-4.360164664478535,-11.420726281855313
2016-11-14T09:30:00-05:00,80.09,80.3264,79.63,79.73,6329677,6904248.25,58.34342183289211,44.69292928459641,NaN,NaN,117.35847415098442,61.732204369478175,0.25166436800779846,-0.02654512823478683,-0.2782094962425853,420518058,402871543.2,49.586929690724006,22.658857881691073,NaN,NaN,-1.2690863138449449,-9.970492000710975
2016-11-15T09:30:00-05:00,80.01,80.15,79.62,80.04,6010155,7007246.95,60.611628402534144,45.777335691577,NaN,NaN,109.11079350705135,78.86982212054886,0.2825268314991519,0.07494904313135464,-0.20757778836779728,426528213,412169529.4,57.52248491504139,24.27046220759714,NaN,NaN,2.0238793815991354,-8.257010374666674
2016-11-16T09:30:00-05:00,79.87,80.48,79.76,80.48,3993203,7044104.2,63.63800120692451,47.40804274892562,NaN,NaN,121.06054806498989,105.68696776667426,0.3170325215028334,0.18871286351074446,-0.12831965799208894,430521416,419981036.6,62.81788612475275,26.43085108856804,NaN,NaN,5.783301877647004,-6.251251481479006
2016-11-17T09:30:00-05:00,80.55,81.45,80.39,81.45,5701050,7083683.4,69.24765849000089,49.52400979214921,NaN,NaN,160.42305655887563,120.46109909376173,0.3851136505932305,0.35307240524944916,-0.03204124534378132,436222466,425595706.8,66.09009101224132,29.204869794869214,NaN,NaN,11.08296657662087,-3.7749346160361665
2016-11-18T09:30:00-05:00,81.4,81.58,81.1,81.2,4293571,7058477.85,66.40426155798576,51.39242437531931,NaN,NaN,151.2142078145549,131.83341601929123,0.39193498738544935,0.45787748888803037,0.06594250150258103,431928895,429143809.6,68.00623603378736,32.36937521766621,NaN,NaN,14.540470540618871,-1.1584481650854466
2016-11-21T09:30:00-05:00,81.35,81.73,81.24,81.73,4763423,7118233.25,69.28378513457105,53.73202436605296,NaN,NaN,151.94323064906075,138.7503673189065,0.40888676607944097,0.5770509591018822,0.16816419302244126,436692318,432378661.6,69.68797873963885,35.95572062517111,NaN,NaN,18.411074257466755,1.6371978952791535
2016-11-22T09:30:00-05:00,81.98,82.77,81.9,82.7,5750061,7174046.15,73.72288291643119,56.59310225065753,NaN,NaN,170.2053425041858,150.96927711833342,0.45844730567814074,0.7412233251201172,0.2827760194419765,442442379,435561494.8,71.287218676976,39.92708645952236,NaN,NaN,23.38609499235349,4.744183194861201
2016-11-23T09:30:00-05:00,82.56,82.825,82.5,82.78,4437205,7179581.85,74.05590154992889,59.56130679299479,NaN,NaN,153.40549303543182,157.4382661124218,0.46800572455285205,0.8677831751330416,0.39977745058018954,446879584,438833128.4,72.87159538001399,44.22722575658663,NaN,NaN,27.399609055281477,7.980672603492669
2016-11-25T09:30:00-05:00,82.91,83.07,82.78,82.98,4271318,7126386.05,74.91191963951881,62.653866229230466,NaN,NaN,140.46631057818135,153.44691691628293,0.4585819609597016,0.9730049017798166,0.514422940820115,451150902,441818815.6,74.26711514242459,48.79895113467025,NaN,NaN,30.936372559295826,11.260058311464547
2016-11-28T09:30:00-05:00,82.78,82.79,82.15,82.32,5146847,7133424.05,67.04978670644311,63.92920200639968,NaN,NaN,105.13416437777381,144.2309082289267,0.3818261504674608,0.991705628904441,0.6098794784369802,446004055,444633847.6,75.54447269829365,53.58255327596026,NaN,NaN,31.591645587997863,14.164570779540735
2016-11-29T09:30:00-05:00,82.41,82.67,82.32,82.54,4367618,7056857.25,68.24611335058471,65.11702023797444,NaN,NaN,97.15862221112378,133.2739865413393,0.3221808689635053,1.0126055646413619,0.6904246956778566,450371673,447369718.6,76.75228973764462,58.49909814051112,NaN,NaN,32.485148795308824,16.781796210364746
2016-11-30T09:30:00-05:00,82.5,82.54,81.83,81.85,5066564,6712891.3,60.791188460107,65.68586525148888,NaN,NaN,72.26174820569888,113.68526768164193,0.21757845031402656,0.9623977585703898,0.7448193082563632,445305109,447942264.6,77.00820515406957,63.2226679350188,NaN,NaN,30.923716051821575,18.802070473430007
2016-12-01T09:30:00-05:00,81.78,82.31,81.63,81.89,9366082,6696437.9,61.05676697401619,66.11676855419655,NaN,NaN,60.277037515864954,95.05957657772856,0.13637218998615386,0.9152845457390555,0.7789123557529016,454671191,449500586,77.72687392427339,67.02596440450525,NaN,NaN,29.752781359039247,20.366457742802755
2016-12-02T09:30:00-05:00,81.9,82.12,81.34,81.44,7657527,6634272.4,56.426268014076435,65.98497030257253,NaN,NaN,41.79781859150755,75.3258781803938,0.04250567971181973,0.8320444553926762,0.7895387756808565,447013664,448673138.4,76.36197281576258,69.68081071754607,NaN,NaN,27.347121394581336,21.36369540734255
2016-12-05T09:30:00-05:00,81.78,82.465,81.43,82.33,8105186,6593924.1,62.48595340101551,66.28086541458136,NaN,NaN,56.33294153080323,65.56563361099967,0.031043398090079832,0.8283430232934563,0.7972996252033765,455118850,450496097.4,77.30741513355525,71.660845392034,NaN,NaN,27.060225650077985,22.17748544201904
2016-12-06T09:30:00-05:00,82.39,82.53,82.147,82.52,7033303,6588404.2,63.64820319687909,66.49776361417742,NaN,NaN,68.26022336996647,59.78595384276822,0.027088243439689075,0.8311599295029879,0.8040716860632988,462152153,452852193.4,78.50410106497145,73.15953225988616,NaN,NaN,27.18074764312212,22.892237185033768
2016-12-07T09:30:00-05:00,82.56,84.16,82.46,84.12,7972115,6720750.2,71.6216166015924,67.06802185665364,NaN,NaN,126.26928679108215,70.58746155984487,0.11796691267678361,0.9515303269092783,0.8335634142324947,470124268,457816025.2,80.8011969738175,74.44405446339078,NaN,NaN,30.102945778543926,23.922338412678076
2016-12-08T09:30:00-05:00,84.15,84.34,83.93,84.12,5605852,6429762.9,71.6216166015924,67.2375902931959,NaN,NaN,152.60051110279045,89.05215627722997,0.16114444291428542,1.0349939678753515,0.873849524961066,470124268,460906640.6,82.08487456733545,75.58653900304036,NaN,NaN,32.32706187239348,25.12301319263742
2016-12-09T09:30:00-05:00,84.32,84.32,83.875,84.31,4801567,5835579.5,72.45373310577902,67.66969540375257,NaN,NaN,145.4666954047628,109.78593163988103,0.1839184612127216,1.103747601476968,0.9198291402642464,474925835,466489074.8,84.14675430188882,76.7394331650476,NaN,NaN,34.37257636391358,26.444379359962586
2016-12-12T09:30:00-05:00,84.14,84.28,83.43,83.61,5942154,5830723.9,64.90298040045866,67.35678077988739,NaN,NaN,112.54702316897323,121.02874796751503,0.13549319366428136,1.0891956323445982,0.9537024386803168,468983681,469262041,85.06618677591437,77.83787659621014,NaN,NaN,33.737348114909835,27.486232039240765
2016-12-13T09:30:00-05:00,83.92,84.6833,83.65,84.36,4824205,5755450.3,68.67030896661959,66.99588264061514,NaN,NaN,133.24220500896607,134.02514429531493,0.13720692179004457,1.1252110909178725,0.988004169127828,473807886,471593187.6,85.81118863546735,78.87530302181666,NaN,NaN,34.41254915104754,28.47570591235602
2016-12-14T09:30:00-05:00,84.34,84.51,83.64,83.79,8457288,5877806.95,63.124563602219794,66.21507278720735,NaN,NaN,104.87608063201951,129.74650306350242,0.0857049260222924,1.0951353266556936,1.0094304006334012,465350598,470638453.6,83.9637253059795,79.66759801652849,NaN,NaN,33.155172788856916,29.144201180427576
2016-12-15T09:30:00-05:00,83.93,84.17,83.54,83.59,6109437,5983618.65,61.25528384287905,65.23959880173308,NaN,NaN,79.11258745969843,115.04891833488401,0.026965361948968036,1.0431371030696113,1.0161717411206432,459241161,468461832.2,79.74832642366025,80.05911310804534,NaN,NaN,31.559481469300664,29.48924122169516
2016-12-16T09:30:00-05:00,83.34,83.38,82.57,82.69,9868723,6192002.3,53.56791290232424,64.27660781572459,NaN,NaN,4.469547388163028,86.84948873156405,-0.0779651688988332,0.9187152799971017,0.9966804488959349,449372438,463351152.8,70.76483969321173,79.71771075053948,NaN,NaN,27.610616548262097,29.220866268347578
2016-12-19T09:30:00-05:00,82.88,83.345,82.69,82.91,3786132,6166630.35,55.052827618618544,63.33423026344129,NaN,NaN,6.432115003448776,65.62650709845916,-0.13469318917018835,0.8283139624331994,0.9630071516033878,453158570,460186130.6,65.81987482088792,78.93682397077114,NaN,NaN,24.898700215999195,28.60341397515495
2016-12-20T09:30:00-05:00,83.03,83.68,83.02,83.57,4034205,6130169.45,59.26193179687705,63.22499764463915,NaN,NaN,39.84291045567522,46.946648187800996,-0.12984826798528604,0.8006968166217803,0.9305450846070663,457192775,456863108.4,61.00019619177457,77.79339475917865,NaN,NaN,23.89656547360156,27.931007046361607
2016-12-21T09:30:00-05:00,83.56,83.62,83.34,83.53,2702817,5977807.25,58.90191937535234,63.07107995902031,NaN,NaN,41.71807607039812,34.31504727547673,-0.1310410129400833,0.7667438184319622,0.8977848313720455,454489958,454690980.4,58.0099930267373,76.38504612364035,NaN,NaN,22.992973818600156,27.22557372810997
2016-12-22T09:30:00-05:00,83.38,83.41,82.495,82.63,4461019,5978997.95,51.34405570811799,62.70806479430899,NaN,NaN,-20.773998168712588,14.337730149794528,-0.19054004630860022,0.6596097734862951,0.8501498197948953,450028939,452848536,55.52375911006625,74.89660228751919,NaN,NaN,19.779088799118377,26.161790166825458
2016-12-23T09:30:00-05:00,82.61,82.765,82.351,82.45,2836955,5907279.8,49.963242597618304,61.813585451209185,NaN,NaN,-48.27928872357833,3.787962927446253,-0.2370822967710995,0.553796948831021,0.7908792456021205,447191984,452412445.2,54.92373807203787,73.2977682116965,NaN,NaN,16.75688853777607,24.818232791246974
2016-12-27T09:30:00-05:00,82.51,83.1,82.51,82.77,6101058,5954990.35,52.41338700808916,61.01109858058134,NaN,NaN,-25.397343398201496,-2.5779287528837953,-0.240614474626051,0.4901111523195567,0.7307256269456077,453293042,452439339.6,54.956067166287994,71.61576579036198,NaN,NaN,14.952901247446762,23.40889971356123
2016-12-28T09:30:00-05:00,82.95,83.03,82.18,82.2,3857667,5929492.8,47.91285234278485,59.31761541923794,NaN,NaN,-55.82658539804144,-21.711827923627126,-0.2732529213531121,0.38915947525421757,0.6624123966073296,449435375,450887859.6,52.611848036741264,69.60224086628511,NaN,NaN,12.018643238530627,21.781720217128285
2016-12-29T09:30:00-05:00,82.26,82.48,81.9,82.09,2566291,5804479.15,47.072822645627795,57.56413013666904,NaN,NaN,-86.41843091131015,-47.339129319968784,-0.2924447281798903,0.29685648638246676,0.5893012145623571,446869084,449363684.8,50.34005119410423,67.33475348248288,NaN,NaN,9.382518380202992,20.0104056689961
2016-12-30T09:30:00-05:00,82.35,82.35,81.15,81.4,4809130,5576631.55,42.088079223351556,55.39515485935279,NaN,NaN,-132.23023376166088,-69.63037643855844,-0.33855007971829065,0.16611361491449372,0.5046636946327844,442059954,447769887.8,48.005723279776454,64.75325126661771,NaN,NaN,5.520965884214555,17.940485699741593
2017-01-03T09:30:00-05:00,82.05,82.34,81.38,81.88,14050515,5896280.95,46.34467334847389,54.06956149849674,NaN,NaN,-113.16247162978688,-82.60701301980015,-0.32366911018682626,0.10007730689925154,0.4237464170860778,456110469,449553584.8,50.757787288091606,62.302651303201806,NaN,NaN,3.499345065533511,15.877465609140438
2017-01-04T09:30:00-05:00,82.24,83.06,82.16,82.97,5493835,5765713.4,54.519673821270196,53.0588018452575,NaN,NaN,-35.81013803831193,-84.68957194782224,-0.23167669882020525,0.13415054356082123,0.3658272423810265,461604304,451215837.2,53.24162365630835,59.976253804690444,NaN,NaN,4.326006071309357,14.227257103735997
2017-01-05T09:30:00-05:00,82.46,82.94,82.44,82.91,4396660,5633881.25,54.03165936800881,52.409308685671,NaN,NaN,-35.16919322029526,-80.558093512273,-0.169036999152601,0.1545309934402752,0.3235679925928762,457207644,452770291,55.5020529674907,57.94327720908411,NaN,NaN,4.828710654531715,12.884607610992528
2017-01-06T09:30:00-05:00,82.89,83.57,82.58,83.32,6538097,5562180.35,56.87252539608278,52.09625451089983,NaN,NaN,7.188705674048714,-61.836666195201225,-0.09769911557715871,0.20144409812142783,0.29914321369858654,463745741,456145622.4,60.02146247635625,56.534215498562396,NaN,NaN,6.123018366417051,11.918666290338889
2017-01-09T09:30:00-05:00,83.29,83.47,83.1,83.25,3855613,5474668.4,56.233546859808555,52.286656936434426,NaN,NaN,25.914599602026797,-30.20769952246369,-0.05505883116296795,0.23031967474487658,0.2853785059078445,459890128,459711657.2,64.16270600821865,56.06263452106289,NaN,NaN,6.9874263960344045,11.214203448295391
2017-01-10T09:30:00-05:00,83.23,83.856,83.1,83.55,5174829,5493331.5,58.391177404708145,52.52511049258368,NaN,NaN,59.44078966333384,4.31295273616045,-0.008902894280869156,0.2742498880567581,0.28315278233762725,465064957,461502554.8,66.06393824696613,56.080067622925625,NaN,NaN,8.34334273069876,10.80408048863873
2017-01-11T09:30:00-05:00,83.49,83.73,83.22,83.73,5388656,5465656.6,59.675690689538015,52.55466469920231,NaN,NaN,69.25428455943067,25.325837255708972,0.029399186816996603,0.319901765858873,0.2905025790418764,470453613,463272416.6,67.87761951294817,56.5713121458666,NaN,NaN,9.842786125205114,10.666752722433928
2017-01-12T09:30:00-05:00,83.54,83.75,82.975,83.65,4282285,5438560.6,58.806765018186375,52.54786795940475,NaN,NaN,66.46095365868116,45.651866631504255,0.04411116559524075,0.3456415360359273,0.30153037044068653,466171328,465065153.4,69.64716083004757,57.40253841753162,NaN,NaN,10.862460440351185,10.69471096785068
2017-01-13T09:30:00-05:00,83.7,84.0399,83.7,83.96,2808352,5156113.8,61.16642249085681,53.249465586743234,NaN,NaN,127.27256333355731,69.66863816340597,0.06805444963755541,0.3865984324876308,0.3185439828500754,468979680,466111941.2,70.66338560890125,58.483940310305556,NaN,NaN,12.397070813540445,10.937905231520647
2017-01-17T09:30:00-05:00,83.72,84.3799,83.71,84.1,4325927,5066938.3,62.21898456534348,54.124875727295034,NaN,NaN,143.0529660460667,93.09631145221395,0.08552447775964372,0.42544958004963007,0.33992510228998635,473305607,468795037,73.14522769210802,59.78547528316771,NaN,NaN,13.984613622366235,11.37314928735573
2017-01-18T09:30:00-05:00,84.13,84.13,83.66,83.95,2910097,4719007,60.332136512342224,54.69050069188454,NaN,NaN,107.77023883218457,102.7622012859841,0.07931933664499052,0.4390742730962245,0.35975493645123396,470395510,469861147.6,74.08342154296581,61.15171488150184,NaN,NaN,14.85853319579807,11.871061274276064
2017-01-19T09:30:00-05:00,84.07,84.36,83.5,83.69,4162977,4737849.25,57.09980845009852,55.34671184240694,NaN,NaN,89.17945471529302,106.74723531715658,0.05139961403491894,0.4240044539948826,0.3726048399599637,466232533,469016931.6,71.94014401071506,62.53230745107139,NaN,NaN,14.780011656060157,12.286625614530935
2017-01-20T09:30:00-05:00,83.99,84.15,83.66,83.93,5491896,4810733.8,59.26907812182449,56.217872947849564,NaN,NaN,90.20666332596976,111.4963772506143,0.04312489221061788,0.426510955223236,0.38338606301261813,471724429,470127551.8,73.04496997486304,64.15408736398274,NaN,NaN,15.283252487631932,12.714715167831077
2017-01-23T09:30:00-05:00,83.55,84.02,83.47,83.99,8552873,5103236.6,59.81613279852753,57.48416248893356,NaN,NaN,76.97088889617221,101.43604236313726,0.03601158104349117,0.4284005393169821,0.3923889582734909,480277302,472387076.2,75.18563063224559,66.09550931773053,NaN,NaN,15.850685852463561,13.162710979921432
2017-01-24T09:30:00-05:00,84.12,84.77,83.97,84.68,4797237,5120047.5,65.54695155817234,58.855753789626306,NaN,NaN,128.92369616838843,98.61018838760162,0.07012216162912233,0.4800416603098938,0.4099194986807715,485074539,474740862.6,77.21556058645027,67.9853502676133,NaN,NaN,18.013823553356772,13.855727061840765
2017-01-25T09:30:00-05:00,85.01,85.2899,84.95,85.2,3669079,5161653.7,69.12104922068109,59.898709175298514,NaN,NaN,172.26722083148786,111.50958478746229,0.1172741204869171,0.5565121492894178,0.43923802880250074,488743618,478410484.2,79.96701539762876,69.89430682056475,NaN,NaN,21.022254234036968,14.879516657868795
2017-01-26T09:30:00-05:00,85.27,85.635,85.07,85.33,3904985,5051850.05,69.96005055248864,61.03645140276136,NaN,NaN,167.30368863531686,127.13443157146705,0.14497219866238326,0.6204532771304798,0.47548107846809656,492648603,483693698.2,83.12634418888872,71.86747047923603,NaN,NaN,23.764221630355927,16.148760225366956
2017-01-27T09:30:00-05:00,85.39,85.5,84.75,85.06,4510839,5084508.65,65.95200008902641,61.68498530940019,NaN,NaN,131.442771671958,135.38165324066472,0.13316749579091414,0.6419404482067392,0.5087729524158251,488137764,486976365.2,84.73699878794444,73.63286593006376,NaN,NaN,24.98549073300711,17.41115029788698
2017-01-30T09:30:00-05:00,84.93,85.03,84.19,84.96,3789634,5145675.8,64.47860367192592,62.273917938837144,NaN,NaN,90.96948388900137,138.18137223923054,0.10776752427523184,0.643482357759865,0.5357148334846331,484348130,487790530.8,85.11646228601192,75.129562807049,NaN,NaN,25.599484784343552,18.580912367380776
2017-01-31T09:30:00-05:00,84.58,84.83,84.215,84.83,4745017,5142470.15,62.52309326923321,62.56905478630322,NaN,NaN,77.15453241472824,127.8275394884985,0.0730176563342978,0.6269869039025053,0.5539692475682075,479603113,486696245.6,82.15986453683149,76.27927182775366,NaN,NaN,25.590827403818217,19.582328801157555
2017-02-01T09:30:00-05:00,84.97,85.12,84.36,84.67,5206771,4700282.95,60.10690812921531,62.599856031994456,NaN,NaN,77.04272615627748,108.78264055345642,0.03214814802724719,0.5941544326022665,0.5620062845750193,474396342,483826790.4,74.82058570881907,76.77519798460159,NaN,NaN,24.933363613094357,20.346762345719956
2017-02-02T09:30:00-05:00,84.54,84.97,84.44,84.6,4081031,4629642.75,59.03207621874396,62.615949689177135,NaN,NaN,63.28088527037623,87.9780798804683,-0.0047442675337034945,0.55607595015789,0.5608202176915935,470315311,479360132,65.07562689446985,76.44865984634603,NaN,NaN,24.093358382024434,20.88199035090631
2017-02-03T09:30:00-05:00,84.34,84.63,84.18,84.49,3652143,4592416.9,57.29812877169277,62.339642994951134,NaN,NaN,29.850094107654282,67.65954436760754,-0.03975185043228269,0.5111304046512402,0.5508822550835228,466663168,475065212.8,57.341914228004676,75.497126176282,NaN,NaN,22.918877992055407,21.172974299641897
2017-02-06T09:30:00-05:00,84.25,84.45,84.1,84.24,3939267,4462475.4,53.45513805845992,61.71365395874517,NaN,NaN,3.2744206631552,50.120531722438315,-0.08058677181690044,0.4501487903123973,0.5307355621292977,462723901,470740367,50.7956102585797,73.90072493102998,NaN,NaN,20.84830617675026,21.126593139228806
2017-02-07T09:30:00-05:00,84.28,84.41,84.07,84.16,5725555,4555972.5,52.247520979250254,61.13618142066717,NaN,NaN,-10.248867963347472,32.639851646823146,-0.1119008456117655,0.3908595051145909,0.5027603507263564,456998346,466219413.6,45.010850986660955,71.82411274843676,NaN,NaN,18.759344072443255,20.788414701116583
2017-02-08T09:30:00-05:00,84.16,84.775,84.16,84.68,4129895,4503725.8,58.767905757761234,61.25533122835737,NaN,NaN,30.448026031414845,23.32091162185062,-0.09706025814150054,0.3814350280494807,0.47849528619098125,461128241,463565793.4,41.98825337331734,69.68469198862265,NaN,NaN,18.590615454324745,20.47444338014632
2017-02-09T09:30:00-05:00,84.71,85.42,84.71,85.21,3529175,4410751.75,64.14216461556738,61.60340883505328,NaN,NaN,107.56187682329389,32.177109932434156,-0.05320939467299335,0.4119835428497396,0.46519293752273294,464657416,462434214.4,40.7321335532317,67.3766322442204,NaN,NaN,20.060319345820325,20.415282803814033
2017-02-10T09:30:00-05:00,85.33,85.76,85.29,85.73,3826000,4387937.5,68.4827092160207,62.22245000773136,NaN,NaN,163.7452851685461,58.95614814461252,0.006008911381101989,0.4727040767491104,0.4666951653680084,468483416,462798264,41.340135094159855,64.95909684864286,NaN,NaN,22.764115582249886,20.750830343590582
2017-02-13T09:30:00-05:00,85.93,86.045,85.71,85.83,4408807,4467960.25,69.2535011527003,62.48720355019764,NaN,NaN,175.94475920680526,93.49021585334253,0.04493779694607858,0.5228674115506067,0.4779296146045281,472892223,464831928.4,44.74988099213496,62.640119734763175,NaN,NaN,25.189129639043877,21.38487310008391
2017-02-14T09:30:00-05:00,85.79,86.32,85.76,86.32,3168130,4410070.4,72.76789378593234,62.747692447715586,NaN,NaN,179.45545026893603,131.4310794997992,0.09389541687129865,0.5952988856936514,0.5014034688223528,476060353,468644329.8,50.5525628678531,60.53908741120778,NaN,NaN,28.46465346425865,22.396270294966016
2017-02-15T09:30:00-05:00,86.18,86.795,86.03,86.77,4754897,4502310.4,75.53371302548251,63.14581119578658,NaN,NaN,186.51072891874773,162.6436200772658,0.14380570066869647,0.6811605946582233,0.5373548939895268,480815250,472581731.6,55.72451684252517,58.58181402932467,NaN,NaN,32.20383753753275,23.797351329618404
2017-02-16T09:30:00-05:00,86.68,86.7713,86.17,86.33,3082517,4448287.4,68.23608825019028,63.308960350155424,NaN,NaN,149.91886816628144,171.11501834586332,0.1345712330970653,0.7055689353608585,0.5709977022637932,477732733,475196795,58.8062786043697,56.7296197304979,NaN,NaN,32.99085979365602,25.110709681623778
2017-02-17T09:30:00-05:00,86.12,86.61,86.11,86.61,3878574,4367621.3,70.2086087216971,63.71824642513908,NaN,NaN,134.564035741073,165.2787684603687,0.13439207012843535,0.7389877899243373,0.604595719795902,481611307,477822373.2,61.68951852140879,55.05626660445483,NaN,NaN,34.27520745540533,26.419923649306856
2017-02-21T09:30:00-05:00,86.99,87.3,86.78,87.11,3591388,4119547.05,73.38680824362108,64.49422606616679,NaN,NaN,165.32111654373935,163.15403992775552,0.15363156800078226,0.7966351797968798,0.6430036117960976,485202695,480284467.6,64.21864725605387,53.774751084399206,NaN,NaN,36.434112271328075,27.850522023881314
2017-02-22T09:30:00-05:00,87.02,87.21,86.93,87.11,2245593,3991964.85,73.38680824362108,65.44279036005291,NaN,NaN,141.53316822921573,155.56958351981146,0.15177475068725743,0.8327220501551693,0.6809472994679119,485202695,482112936,66.01310116047804,53.14564504523198,NaN,NaN,38.11925355775704,29.317483671577847
2017-02-23T09:30:00-05:00,87.22,87.32,86.45,86.52,3468703,3981946.05,64.03756317712892,65.80032514279469,NaN,NaN,99.81016075921636,138.22946988790517,0.09879416214047698,0.8044400021435081,0.7056458400030311,481733992,482296684.4,66.19656781412576,53.22571225377884,NaN,NaN,36.577764609808874,30.354666662753708
2017-02-24T09:30:00-05:00,86.37,86.92,86.18,86.92,4846313,4029012.45,67.09793608642822,66.50031137956151,NaN,NaN,82.54078343085946,124.75385294082079,0.07950182951459372,0.8050231268962733,0.7255212973816796,486580305,484066198.8,67.98867690966907,53.98619530246914,NaN,NaN,36.26431799436483,31.19890256726958
2017-02-27T09:30:00-05:00,86.95,87.075,86.66,87.02,3452412,3976091.1,67.83488110913433,67.52743588318111,NaN,NaN,89.73709923289553,115.78846563918532,0.06300947910893573,0.8042831462678492,0.7412736671589135,490032717,485750480.8,69.63862568649857,55.33212497589192,NaN,NaN,36.24044679385573,31.919123171067604
2017-02-28T09:30:00-05:00,86.79,86.81,86.3,86.37,4089516,3991085.2,58.64077174161722,67.9840966519216,NaN,NaN,54.39191147420403,93.60262462527827,0.0011298003631914355,0.7426859176129028,0.7415561172497114,485943201,485898582,69.78609516596273,57.10178527441347,NaN,NaN,33.18454586719008,32.099897841942244
2017-03-01T09:30:00-05:00,87.3,87.58,87.02,87.34,8634802,4185574.45,66.0383342240136,68.50341297093964,NaN,NaN,103.39809794298957,85.97561056803299,0.017428098864766595,0.7633412408306697,0.7459131419659031,494578003,487773643.6,71.66273243869679,59.221390921940575,NaN,NaN,33.02398751170736,32.23191065190869
2017-03-02T09:30:00-05:00,87.3,87.43,87.06,87.13,3935376,4122004.7,63.39469973766475,68.45002262251802,NaN,NaN,88.33854926216917,83.68128826862356,0.006527889739252224,0.7540730041399684,0.7475451144007161,490642627,489555370.6,73.35621125034484,61.551682186020095,NaN,NaN,31.99342779952647,32.197841672996944
2017-03-03T09:30:00-05:00,87.04,87.22,86.68,87,3281538,4082030.05,61.746808461691934,67.96888685435168,NaN,NaN,66.34050246617002,80.44123207568569,-0.01575787534592976,0.7278477702183039,0.7436056455642337,487361089,489711527.4,73.50565556484071,63.849219362497294,NaN,NaN,30.647680165283393,31.976390029037866
2017-03-06T09:30:00-05:00,86.72,86.81,86.39,86.72,2602736,4029559.7,58.23554732770133,67.18189015256603,NaN,NaN,36.7522921092414,69.84427065095485,-0.053548363887753636,0.6766701907045416,0.7302185545922952,484758353,488656654.6,70.62388821531769,65.69736273558178,NaN,NaN,28.423198412357593,31.468791226654968
2017-03-07T09:30:00-05:00,86.72,86.73,86.34,86.44,3073900,3986291.35,54.87501593210599,65.90382744872129,NaN,NaN,18.4369755121628,62.65328345854662,-0.09895382530757835,0.6065262729578222,0.7054800982654006,481684453,487804905,68.29564835070127,66.96472598435665,NaN,NaN,25.52351491574749,30.61946603938247
2017-03-08T09:30:00-05:00,86.57,86.96,86.54,86.8,2609528,3830490,58.21375368758909,64.66668749601462,NaN,NaN,41.57406127901952,50.28847612575258,-0.10568313425673337,0.5733761804444839,0.6790593147012173,484293981,485748100.6,62.90287314437741,67.47746572020324,NaN,NaN,24.096347750524753,29.68759199811708
2017-03-09T09:30:00-05:00,86.72,86.97,86.47,86.72,2746929,3761341.7,57.20091474694927,63.87846081721168,NaN,NaN,26.913386072735225,38.003443487865795,-0.1156571174633858,0.534487917871985,0.6501450353353708,481547052,483928985.6,58.502914136350874,67.45579682963047,NaN,NaN,22.642422979301465,28.681139281143423
2017-03-10T09:30:00-05:00,87.1,87.18,86.67,86.85,3506602,3760213.05,58.46553873851167,63.039670104127005,NaN,NaN,51.68146372658997,35.07163573994978,-0.1134766315864798,0.508299245852271,0.6217758774387508,485053654,483467498.6,57.40588400348073,67.14982293549274,NaN,NaN,21.797784546654555,27.697802890502157
2017-03-13T09:30:00-04:00,86.9,87.11,86.795,87.08,2491102,3693468.15,60.679235114997965,62.131986309225354,NaN,NaN,66.02636060037763,40.92644943817703,-0.09715186205285165,0.5003360498726863,0.597487911925538,487544756,484024779.2,58.41985650544467,66.7356235961635,NaN,NaN,21.70621945271386,26.841862399389544
2017-03-14T09:30:00-04:00,86.99,87.2,86.77,87.06,3892828,3667669.2,60.37788303231473,61.202777365560614,NaN,NaN,63.03197358147791,49.84544905204005,-0.08855048814684574,0.4867998017419808,0.5753502898888265,483651928,484418274.2,59.15915741179517,66.24605618554331,NaN,NaN,21.54912763798398,26.085757433474463
2017-03-15T09:30:00-04:00,87.23,87.69,86.95,87.52,3736900,3696107.7,64.7179855887172,61.251378966388344,NaN,NaN,149.194173940148,71.36947158426575,-0.05440658411955224,0.5073420597393863,0.5617486438589385,487388828,485037243.6,60.353302019070654,65.82868005732509,NaN,NaN,22.653104805065325,25.59537848655887
2017-03-16T09:30:00-04:00,87.58,87.745,87.41,87.51,6264710,3771598.35,64.55244600031901,61.06955824595197,NaN,NaN,170.55771516724965,100.09833740316863,-0.03591329530628773,0.5168570247260789,0.5527703200323666,481124118,484952656.8,60.09470913769845,65.26482521647004,NaN,NaN,23.51334063043276,25.297944507112284
2017-03-17T09:30:00-04:00,87.35,87.53,87.1,87.36,4714252,3853185.1,61.991021182844975,60.65213967978845,NaN,NaN,103.0898569712968,110.38001605211,-0.037051576934641894,0.5064558488640643,0.5435074257987061,476409866,483223899.2,54.915900877390534,64.21320201581946,NaN,NaN,23.563324558297413,25.05014165728159
2017-03-20T09:30:00-04:00,87.43,87.45,86.9827,87.154,2639009,3791206.85,58.554718193872425,60.64599299780667,NaN,NaN,61.57037531493456,109.48881899502138,-0.05392421712037787,0.4761021543982338,0.5300263715186116,473770857,480469119.4,47.84084453173782,62.64568411337483,NaN,NaN,22.67656647909167,24.711059488968743
2017-03-21T09:30:00-04:00,87.36,87.49,85.9911,86.05,4645729,3843923.9,44.36213039103472,59.09769272402247,NaN,NaN,-112.84943663246719,74.31253695223236,-0.13695971465516188,0.35882672819965933,0.4957864428548212,469125128,477563759.4,41.73396706476675,60.507915158094114,NaN,NaN,17.086359796500126,23.62181667575894
2017-03-22T09:30:00-04:00,85.98,86.27,85.65,86.15,6101146,4036701.55,45.64723056404438,57.83001635447816,NaN,NaN,-196.77711372359227,5.11827941948431,-0.1799633252680672,0.2708322862697372,0.4507956115378044,475226274,475131248.6,37.42634767087663,57.941496330989246,NaN,NaN,13.020304182559835,22.10731489101621
2017-03-23T09:30:00-04:00,86.3,86.8,86.1,86.35,3636969,4045114.85,48.223062525631335,56.864034501902395,NaN,NaN,-97.60290095779621,-48.513843805524864,-0.1888294651735618,0.21475878007085214,0.40358824524441395,478863243,474679073.6,36.66867892662825,55.310283713974066,NaN,NaN,10.428432292054815,20.43890309116458
2017-03-24T09:30:00-04:00,86.44,86.84,86.19,86.56,3311136,3968356,50.85657427271068,56.33696499797448,NaN,NaN,-70.24573645657999,-83.18096249110022,-0.17476556490233275,0.185131289116498,0.35989685401883076,482174379,475831976.2,40.00368955723257,53.12312666696799,NaN,NaN,9.043773054721461,18.811027371672704
2017-03-27T09:30:00-04:00,86.04,86.675,85.71,86.53,4904103,4040940.55,50.461710300341196,56.021728881419854,NaN,NaN,-102.3241537413726,-115.95986830236166,-0.16198472581112566,0.15741594675492365,0.3194006725660493,477270276,476531860,42.000429291204405,51.244896734146785,NaN,NaN,7.806231691116194,17.238913703021773
2017-03-28T09:30:00-04:00,86.52,87.38,86.37,87.19,4155009,4044215.2,58.1585807864482,56.017787959909796,NaN,NaN,23.347227807004785,-88.72053541446726,-0.1062746933245779,0.18655730591032693,0.2928319992349048,481425285,478991891.4,48.48962697161164,50.21537915037781,NaN,NaN,9.048563119056597,16.068863619598176
2017-03-29T09:30:00-04:00,87.19,87.77,87.1,87.71,4553458,3840148,63.03209365322075,56.43430073892919,NaN,NaN,126.42023281046103,-24.0810661076566,-0.035270137465146456,0.24874432740347174,0.2840144648686182,485978743,481142385.2,53.39815795187024,49.85075370862918,NaN,NaN,11.739797645757081,15.450425623335162
2017-03-30T09:30:00-04:00,87.55,87.95,87.47,87.94,4682572,3877507.8,64.97530165193291,56.89928380417356,NaN,NaN,158.96859710150997,27.233233504204634,0.02317181846322075,0.31297923794764415,0.2898074194844234,490661315,483501999.6,58.114527111770016,49.901371073506986,NaN,NaN,14.572949134114577,15.325071839160794
2017-03-31T09:30:00-04:00,87.8,88.17,87.77,87.95,2379291,3832395.45,65.06129366225676,57.21228798612061,NaN,NaN,160.23707835788963,73.32979646709857,0.05658345693091921,0.3605367406480724,0.3039532837171532,493040606,485675245,61.93552634665303,50.15249034787902,NaN,NaN,16.8498800801331,15.542901587871123
2017-04-03T09:30:00-04:00,87.96,88.01,87.1,87.6,6155978,4010057.55,59.550410706966765,57.15318282002433,NaN,NaN,87.8467384875056,111.36397491287421,0.04945175991517459,0.3657679836111214,0.3163162236959468,486884628,487598115.4,64.97963483694554,50.568238735389755,NaN,NaN,17.175099385111615,15.776072701762622
2017-04-04T09:30:00-04:00,87.35,87.59,87.27,87.46,4324377,4072581.4,57.454060224414654,56.63433100828843,NaN,NaN,60.53639493941253,118.80180833935576,0.03057113985326143,0.3545301485125236,0.3239590086592622,482560251,487825108.6,65.33209931758265,50.9238671138549,NaN,NaN,16.830612989610152,15.92672131431227
2017-04-05T09:30:00-04:00,87.79,88.26,87.13,87.25,4350940,4159652,54.362656370359495,55.90648889186275,NaN,NaN,69.15220758232789,107.34820329372913,0.0007793614640007052,0.32493321048926305,0.32415384902526234,478209311,486271222.2,60.81948199487936,50.975636603653534,NaN,NaN,15.6386028445438,15.885561532916773
2017-04-06T09:30:00-04:00,87.3,87.8,87.27,87.52,2913884,4167999.75,57.52695571977759,55.58762707307223,NaN,NaN,60.5983517344129,87.67415422030972,-0.0036588830187816446,0.3195802452517853,0.32323912827056694,481123195,484363598.2,55.73026255848677,51.033805295160406,NaN,NaN,15.533514613378491,15.835269115839875
2017-04-07T09:30:00-04:00,87.3,87.56,87.1365,87.26,3908262,4188082.75,53.66802414640336,55.23857749825301,NaN,NaN,26.203286382846724,60.86739582530114,-0.02578838600776001,0.2910036457608669,0.3167920317686269,477214933,481198463.6,48.48143141476844,51.07956150109117,NaN,NaN,14.309639720711683,15.61732205939299
2017-04-10T09:30:00-04:00,87.29,87.88,87.26,87.58,2398145,4183434.9,57.45110229529778,56.17350406284323,NaN,NaN,59.70347932099023,55.23874399199807,-0.02077334001543152,0.2908253567493375,0.31159869676476903,479613078,479744153.6,45.549777853148065,51.352119414546976,NaN,NaN,14.373340166123585,15.439610360354504
2017-04-11T09:30:00-04:00,87.55,87.69,86.88,87.51,5469075,4262247.25,56.36687289791866,56.939192800977104,NaN,NaN,25.456456540845856,48.222756312284744,-0.023849055841793976,0.28178737696252654,0.3056364328043205,474144003,478060904,42.35720564868954,51.70432355581933,NaN,NaN,14.115369750016898,15.250433130306273
2017-04-12T09:30:00-04:00,87.44,87.5499,87.09,87.16,2461603,4198482.4,51.167274681250376,57.1494936692356,NaN,NaN,12.287160889374217,36.84974697369402,-0.049649259372506804,0.243574858588687,0.2932241179611938,471682400,476755521.8,40.01486695810316,51.94333698663896,NaN,NaN,12.351934075701456,14.8363618367913
2017-04-13T09:30:00-04:00,87.03,87.325,86.55,86.55,4688801,4119686.95,43.615734926474076,56.63229085879014,NaN,NaN,-50.82068235370104,14.56594015607123,-0.10481967413541515,0.16219952529192483,0.26701919942734,466993599,473929602.6,35.44518127055055,51.61772925187596,NaN,NaN,8.304190336513155,13.903194479608707
2017-04-17T09:30:00-04:00,86.77,87.44,86.77,87.44,3477605,4057854.6,54.22958467814904,56.901424742919275,NaN,NaN,11.025025388058182,11.53028795711352,-0.07954124302975893,0.1675926456401413,0.24713388866990024,470471204,472580856.8,33.479987888761855,51.009126294558634,NaN,NaN,8.279889631222805,13.099865215553578
2017-04-18T09:30:00-04:00,87.23,87.59,87.01,87.45,2554196,4053613.95,54.33360218586284,56.6282119857346,NaN,NaN,29.56694003542688,5.502980100000849,-0.061142424593157385,0.1707058579284535,0.23184828252161088,473025400,471263321.2,31.634842048940172,49.80521308579638,NaN,NaN,8.295508968048463,12.413528608767132
2017-04-19T09:30:00-04:00,87.74,88.09,87.46,87.53,3736547,4008154.85,55.21054651525337,56.06953004730837,NaN,NaN,76.70711683758663,15.753112159349005,-0.04341351814159683,0.17758138484461483,0.22099490298621166,476761947,471786910,33.21016092141592,48.36321329790679,NaN,NaN,8.580224704282793,11.865913765269369
2017-04-20T09:30:00-04:00,87.9,88.62,87.87,88.45,4386207,3922407.9,63.816009693513514,55.98672347884985,NaN,NaN,175.46076733025058,48.38783344752428,0.02667190768060662,0.2543347875869699,0.2276628799063633,481148154,473680060.8,38.709451951720524,46.9771365007604,NaN,NaN,11.851215049918402,11.863813948790659
2017-04-21T09:30:00-04:00,88.33,88.42,88.03,88.25,3852436,3933181.25,61.069085008521476,55.701565717868746,NaN,NaN,151.2211149103716,88.79619290033881,0.054362817549154896,0.2956164018428069,0.241253584293652,477295718,475740484.6,44.10375082197055,45.70343824899736,NaN,NaN,13.542368160252897,12.103607407570978
2017-04-24T09:30:00-04:00,89.18,89.209,88.72,88.82,4243034,3979776.15,65.61217517412575,56.134548894094394,NaN,NaN,243.50457911859004,135.29210364644518,0.1030457601657816,0.370060784500879,0.2670150243350974,481538752,477953994.2,49.26935818342223,44.581275630888555,NaN,NaN,16.559816476820796,12.740208703178094
2017-04-25T09:30:00-04:00,89.12,89.645,89.12,89.52,5354433,4002292.65,70.20984129381591,57.045676113337336,NaN,NaN,257.5389769015856,180.88651101967693,0.17039549609380406,0.48000939445235247,0.3096138983585484,486893185,480727551.2,54.89421348990158,43.83571235748276,NaN,NaN,20.817367298728016,13.894088502542369
2017-04-26T09:30:00-04:00,89.75,90.3175,89.63,89.94,4082207,3998652.55,72.57878806863218,58.34682837749967,NaN,NaN,244.95963960449993,214.5370155730596,0.22765732031400654,0.5941855487510566,0.36652822843705,490975392,483570240.2,59.81245056777165,43.76378154126078,NaN,NaN,25.10775895370252,15.496041424136676
2017-04-27T09:30:00-04:00,90.4,90.545,90.17,90.42,3663998,3954179.55,75.02331031913161,59.59656799173924,NaN,NaN,217.71524570654248,222.98791124831797,0.2789046602105013,0.7151590537001766,0.4362543934896753,494639390,486268487.4,63.84251912493315,44.3432284388641,NaN,NaN,29.497382904504043,17.496233064189155
2017-04-28T09:30:00-04:00,90.61,90.78,89.95,90.06,5059755,3973038.7,69.98420614483763,60.76200956305598,NaN,NaN,164.33743719418112,225.61117570507986,0.2694532498691623,0.7730709558261282,0.5036177059569659,489579635,488725270.8,67.0796154767049,45.67167015757384,NaN,NaN,31.3413650836262,19.474109066965877
2017-05-01T09:30:00-04:00,90.26,90.52,90.0741,90.18,5913870,4149767.65,70.69088682801026,61.70770845824973,NaN,NaN,136.01444290844074,204.11314846305,0.2524708375279858,0.8192062528669481,0.5667354153389623,495493505,491516221.4,70.32939452163004,47.44164277675113,NaN,NaN,33.01894648481735,21.40908584094466
2017-05-02T09:30:00-04:00,90.23,90.28,89.75,90.28,3960601,4039998.8,71.29734232223373,62.77417055998652,NaN,NaN,107.61482317093885,174.12831771692066,0.2298065997654295,0.8539936650457491,0.6241870652803196,499454106,494028405.6,72.9206551765968,49.62474631445879,NaN,NaN,34.547885192747444,23.286057176916486
2017-05-03T09:30:00-04:00,90.21,90.45,89.49,89.75,2816743,3964617.1,63.766409496020245,63.67410876104151,NaN,NaN,83.08906229057456,141.75420225413558,0.16404029676729492,0.8292374362394384,0.6651971394721434,496637363,495160799.8,74.0219949626264,52.05382688621045,NaN,NaN,33.51919401874105,24.74793386860571
2017-05-04T09:30:00-04:00,89.82,89.82,89.27,89.61,5339638,4014052,61.90626415669407,64.98057513462865,NaN,NaN,57.040957333961885,109.61934457961945,0.09922104045271973,0.7892234400380431,0.6900023995853234,491297725,494492466.8,72.15673234541185,54.67608053441483,NaN,NaN,32.11924363002509,25.80097812023705
2017-05-05T09:30:00-04:00,89.97,90.17,89.53,90.17,3219275,4029321.55,66.15877704487832,65.83266030368074,NaN,NaN,71.39318803810117,91.03049474840346,0.08283952702761421,0.7935518083698412,0.710712281342227,494517000,495479939.8,73.23008681972132,57.51537331519764,NaN,NaN,32.202553945729036,26.71548895245019
2017-05-08T09:30:00-04:00,90.49,90.51,90.015,90.34,2506161,3959216.5,67.35033820155996,66.76242716194483,NaN,NaN,82.0093541277388,80.22947699226306,0.0725989015258377,0.8014609082495241,0.7288620067236864,497023161,495785871,73.57002731813088,60.51074369156841,NaN,NaN,32.6298236694265,27.560393912018235
2017-05-09T09:30:00-04:00,90.54,90.93,90.37,90.86,10257768,4352197.65,70.74369039484233,67.87193743905831,NaN,NaN,96.95912058421975,78.09833647491925,0.08891481087062059,0.8400055203119621,0.7510907094413415,507280929,497351235.6,75.29847460274551,63.517051811663386,NaN,NaN,34.06239758666161,28.48925157982443
2017-05-10T09:30:00-04:00,90.49,90.58,90.215,90.55,3518774,4254682.6,66.3185380425794,68.05068946399159,NaN,NaN,75.53062317661359,76.58664865212704,0.06784921903478192,0.8359022332348189,0.768053014200037,503762155,498776194,76.78669664371198,66.23685500394849,NaN,NaN,33.89324997709681,29.26125135086334
2017-05-11T09:30:00-04:00,90.38,90.38,89.46,90.01,4351558,4349180.35,59.353785531716106,67.92816807279121,NaN,NaN,42.1305121099623,73.60455960732712,0.009625214819503292,0.7800845327244161,0.7704593179049128,499410597,500398768.4,78.38372262256331,68.68542441827654,NaN,NaN,31.51979183848132,29.583899991951622
2017-05-12T09:30:00-04:00,90.1,90.1,89.77,89.88,3230814,4276281,57.780574876986876,67.368768051567,NaN,NaN,35.28272650604489,66.38246730091586,-0.04269345953188475,0.7170924934900569,0.7597859530219416,496179783,500731325,78.70706028449483,70.78811742549603,NaN,NaN,29.121621489317235,29.517860205860995
2017-05-15T09:30:00-04:00,89.9,90.28,89.795,89.9,3952248,4300013.15,57.96516951554605,66.49414863883344,NaN,NaN,36.09451755004051,57.1994999853762,-0.0788981995649084,0.6611632035658062,0.7400614031307146,500132031,501353099,79.3296123525173,72.53350305853999,NaN,NaN,27.243787156633807,29.192992627399967
2017-05-16T09:30:00-04:00,89.95,90.02,89.53,89.59,4198330,4382219.85,54.022436946506886,65.16869498725308,NaN,NaN,1.4777517891380012,38.10322622635986,-0.12398512955148044,0.585079991191364,0.7090651207428444,495933701,499083653.4,71.15246356989279,73.34350398726293,NaN,NaN,24.47319176372366,28.518735361160495
2017-05-17T09:30:00-04:00,89.04,89.27,88.13,88.14,8289390,4609862,40.23637917664732,62.68391419136134,NaN,NaN,-148.74996920210864,-6.752892249384587,-0.24474526231409366,0.4031335428502274,0.6478788051643211,487644311,495860084.6,61.46141110073332,73.17342484267724,NaN,NaN,16.73713003152699,26.835648885498564
2017-05-18T09:30:00-04:00,88.14,89.06,88.14,88.65,6521757,4716639.5,45.50403207978958,60.93533032957219,NaN,NaN,-143.19838263595526,-43.8186711985681,-0.2809650017947857,0.29667255292083894,0.5776375547156246,494166068,494811178.8,58.66165905106977,72.57214224084615,NaN,NaN,12.202345037788263,24.745176907254237
2017-05-19T09:30:00-04:00,88.8,89.54,88.7,89.25,3694974,4708766.4,50.97839440487366,59.527295156491,NaN,NaN,-90.67221920419223,-69.00966034061553,-0.2559137961760277,0.25774530949558994,0.5136591056716177,497861042,495147430.6,59.30169763048161,71.78444960576412,NaN,NaN,10.340460009174974,22.687360207528627
2017-05-22T09:30:00-04:00,89.42,89.8,89.37,89.7,2946716,4643950.5,54.6573301509381,58.33872285854131,NaN,NaN,-33.7389097934951,-82.97634580932264,-0.20276174504321876,0.2602069243675942,0.46296866941081294,500807758,495282576,59.57262320655594,70.8310187507612,NaN,NaN,10.095757327802096,20.888559796139123
2017-05-23T09:30:00-04:00,89.77,89.96,89.22,89.36,2089011,4480679.4,51.511809342004135,57.4633942761116,NaN,NaN,-52.38267418282321,-93.74843100371488,-0.18473676608055023,0.23204771181012518,0.4167844778906754,498718747,495839585.2,60.73286553299675,69.88179522007337,NaN,NaN,8.852155699503033,19.16907349661968
2017-05-24T09:30:00-04:00,89.33,89.71,89.005,89.68,3871101,4470124.1,54.1842885103709,56.91182458708851,NaN,NaN,-53.82751849158513,-74.76394086161018,-0.14713294403376487,0.2328682978484693,0.38000124188223416,502589848,498828692.6,66.31911660576773,69.46482266724165,NaN,NaN,8.709472392303722,17.674844767431686
2017-05-25T09:30:00-04:00,89.97,90.75,89.97,90.47,3301914,4452019.9,60.03983483218488,56.474757286181834,NaN,NaN,88.22505104489537,-28.479254125440058,-0.06889908920046028,0.2938773803816588,0.36277646958211907,505891762,501173831.4,69.93314054273343,69.22932650459965,NaN,NaN,10.576695445086662,16.66082343566811
2017-05-26T09:30:00-04:00,90.59,90.79,90.49,90.74,2324013,4315232.8,61.835138951680186,56.080814482619,NaN,NaN,122.69318899042362,14.193827513483111,-0.0023284151208285975,0.3598659506810833,0.3621943658019119,508215775,503244778,72.71721754531674,69.16841152082722,NaN,NaN,12.663390847522493,16.089761637361594
2017-05-30T09:30:00-04:00,90.74,91.03,90.73,90.81,2638884,4151483.5,62.30794124180293,55.4782609716876,NaN,NaN,137.95992459680312,48.53359439154276,0.04068403264320758,0.4130494066059214,0.3723653739627138,510854659,505254158.2,75.12407472348154,69.15595438659408,NaN,NaN,14.46124392630797,15.85711625006822
2017-05-31T09:30:00-04:00,90.97,91.09,90.33,91.05,5103647,4208635.8,63.956631758616886,55.30955337997599,NaN,NaN,120.7897793263658,83.16808509338055,0.07743213267389826,0.4691555398050866,0.39172340713118836,515958306,508702070,78.61091862564096,69.28625595673186,NaN,NaN,16.44904830574134,15.941677972307238
2017-06-01T09:30:00-04:00,91.28,91.91,91.01,91.91,5147498,4325173.55,69.16195815411739,56.01013713871898,NaN,NaN,183.15805345094208,130.565199481886,0.14771793285262313,0.5763708231969673,0.4286528903443442,521105804,512405261.2,81.5949000395658,69.51562577223204,NaN,NaN,19.953885835104156,16.51485052413537
2017-06-02T09:30:00-04:00,91.96,92.3452,91.83,92.24,3134363,4214909.8,70.89869959015047,56.947146046802104,NaN,NaN,195.5499952552401,152.03018832395495,0.2011799750911744,0.6801278592083122,0.4789478841171378,524240167,516074942.2,83.97998455275636,69.89226321996502,NaN,NaN,23.398737567318264,17.49826295887578
2017-06-05T09:30:00-04:00,92.34,92.42,91.82,91.99,5499327,4328912.4,67.78420465197225,57.64850569940397,NaN,NaN,158.62415551634243,159.2163816291387,0.20382186831518156,0.7337252195111148,0.5299033511959332,518740840,518179955.2,85.16737806465181,70.30924648511748,NaN,NaN,25.28370801353963,18.61046939525633
2017-06-06T09:30:00-04:00,91.67,91.855,91.13,91.2,3563744,4381791.55,58.96877945438331,58.001815878538004,NaN,NaN,89.15263093353003,149.4549228964841,0.13954609455010458,0.704335969383564,0.5647898748334594,515177096,519044442.6,85.63817113026667,71.34393988228705,NaN,NaN,24.128313719354853,19.39873287012755
2017-06-07T09:30:00-04:00,91.34,91.515,91.15,91.36,4671512,4102478.75,60.10055217090212,59.42068537812763,NaN,NaN,79.43916947120728,141.18480092545238,0.09700579264837672,0.6860471156439303,0.5890413229955536,519848608,519822503,86.06682002173311,73.10146909092988,NaN,NaN,23.54660118129633,19.991285486008803
2017-06-08T09:30:00-04:00,91.37,91.47,90.65,90.77,5198798,4186479.95,54.16722762001815,60.039485059572534,NaN,NaN,46.88773587495691,113.93073741025535,0.02223455265777985,0.6168345138177784,0.5945999611599986,514649810,518531304.2,81.70845651873373,74.74766891004874,NaN,NaN,21.16270317982161,20.158630870839204
2017-06-09T09:30:00-04:00,90.86,90.99,89.56,90.37,10989006,4518352.35,50.52537903093293,60.00712681857676,NaN,NaN,-3.6866124727481946,74.08341586465768,-0.05674410387368756,0.5236698313178891,0.5804139351915767,503660804,514415431.6,69.60803357827993,75.48383576346292,NaN,NaN,18.0180953474639,19.85284008178559
2017-06-12T09:30:00-04:00,90.08,90.555,89.95,90.32,6436554,4678639.35,50.072192925537976,59.679617016762464,NaN,NaN,-7.631535498430312,40.832277661703145,-0.11175418227327683,0.44072120734998066,0.5524753896232575,497224250,510112113.6,59.65988710987985,75.49006889941462,NaN,NaN,15.366838024101137,19.211982644973524
2017-06-13T09:30:00-04:00,90.53,91.01,90.5001,90.88,4164849,4689269.4,54.946351743175015,59.92494147398896,NaN,NaN,29.931487120268873,28.988048899050902,-0.10967401572308122,0.415382869969406,0.5250568856924872,501389099,507354514.2,54.304049042593256,75.03086772152867,NaN,NaN,14.510101656713854,18.54028536093643
2017-06-14T09:30:00-04:00,91.21,91.35,90.36,90.83,4809407,4719823.25,54.43537041860002,59.942875896005326,NaN,NaN,30.076676926653786,19.115550390140196,-0.11059864109021877,0.38680858432971377,0.49740722541993254,496579692,502700731,46.68679067888,73.62855872675095,NaN,NaN,13.670281016538993,17.84457045459394
2017-06-15T09:30:00-04:00,90.16,90.52,89.715,90.45,3585054,4484606.45,50.585134423441154,59.26754015252363,NaN,NaN,-29.430335315536823,3.851936152041449,-0.13416589381402994,0.3296998581523951,0.46386575196642504,492994638,498369696.6,40.932347628174945,71.5570735185682,NaN,NaN,11.822271825224096,16.984242078969675
2017-06-16T09:30:00-04:00,90.5,90.5,89.64,90.15,7711618,4544099.5,47.71574048412467,58.259011690555376,NaN,NaN,-53.84480194115623,-6.179701741640157,-0.1652784680571825,0.25726766689494696,0.42254613495212945,485283020,494694139.8,36.78821041993931,68.99071586675554,NaN,NaN,9.412598696117403,15.902578738562209
2017-06-19T09:30:00-04:00,90.53,90.98,90.3,90.84,3419785,4530340.05,54.15676619868559,57.67678490176128,NaN,NaN,-0.0005765300372007384,-4.653509947961536,-0.13593314085801567,0.2526297088796099,0.38856284973762556,488702805,492989850.8,35.017849826825696,66.12598551699439,NaN,NaN,9.196650911786431,14.944589049022811
2017-06-20T09:30:00-04:00,90.68,90.7,89.68,89.7,3352527,4550630.6,44.420214637569806,56.281326535972205,NaN,NaN,-83.65177930504143,-27.37016323302358,-0.186708808503466,0.15517683910829305,0.34188564761175905,485350278,489782086.6,31.905669109584878,62.78989626584753,NaN,NaN,5.687207595613662,13.622105984250076
2017-06-21T09:30:00-04:00,89.93,89.98,89.52,89.84,3126222,4602491.15,45.7110526115265,54.60626185435857,NaN,NaN,-117.52299295497544,-56.89009720934943,-0.2029288622866472,0.08822456975345006,0.29115343204009725,488476500,488161448.2,30.434024028987324,59.13554797937764,NaN,NaN,3.338439100744605,12.153010715177867
2017-06-22T09:30:00-04:00,89.83,89.965,89.61,89.63,3658877,4591879.95,44.058114044477726,52.6890771725248,NaN,NaN,-127.85215911574488,-76.57446196939104,-0.21851351114349296,0.018011543110731054,0.23652505425422402,484817623,486526045.2,28.981321287545825,55.20707203186261,NaN,NaN,0.9199000383583132,10.54828061848936
2017-06-23T09:30:00-04:00,89.63,89.63,89.23,89.52,3922640,4622916.25,43.17736993111627,50.93144612103509,NaN,NaN,-143.80940572409253,-94.56738272597829,-0.2260031245824574,-0.045978851473847726,0.18002427310860966,480894983,485648437.8,28.203324417465282,51.13821105706357,NaN,NaN,-1.303040194068848,8.855234788123902
2017-06-26T09:30:00-04:00,89.96,90.11,89.56,89.84,4708660,4742148.6,46.5262998498317,50.04269757785283,NaN,NaN,-88.49704698532523,-112.26667681703591,-0.20006960645767627,-0.0700627349634857,0.13000687149419057,485603643,485028605.4,27.638984931512184,46.995412042866825,NaN,NaN,-2.2135716373124352,7.273976727347282
2017-06-27T09:30:00-04:00,89.65,89.9866,89.13,89.13,4014898,4810949.3,40.78305262417608,48.66287618165811,NaN,NaN,-115.96234768070666,-118.72879049216894,-0.2198227894847734,-0.14477161536177618,0.07505117412299722,481588745,484276298.8,26.934527463954282,42.771676860168334,NaN,NaN,-4.811160946035409,5.547528488292612
2017-06-28T09:30:00-04:00,89.39,90.1275,89.33,90.03,5030799,4807306.9,49.322723066100515,48.316840142092566,NaN,NaN,-68.14385592903565,-108.85296308698098,-0.1639285578512557,-0.1298595231910724,0.034069034660183295,486619544,483904907.6,26.574431632991875,38.83353222547249,NaN,NaN,-4.326053713418454,4.137016745191032
2017-06-29T09:30:00-04:00,89.86,89.95,88.46,89.16,4901666,4795015.3,42.884617899973016,47.77107148988114,NaN,NaN,-119.27862105147848,-107.1382554741277,-0.17613369884007177,-0.18609808888990642,-0.009964390049834654,481717878,483284958.6,25.950743366700962,35.71515435321685,NaN,NaN,-6.118130590539032,2.671995697229594
2017-06-30T09:30:00-04:00,89.6,90.02,89.44,89.63,4656803,4871137.3,46.915861851677775,47.5456192703197,NaN,NaN,-66.6968015404877,-91.71573463740674,-0.14446527978230647,-0.19054598977771775,-0.04608070999541127,486374681,484380898.2,29.117802004278857,33.53357684567393,NaN,NaN,-6.206453139339965,1.4036458634339428
2017-07-03T09:30:00-04:00,89.88,90.32,89.5,89.54,2807322,4736537.05,46.24279316349214,46.92393651462806,NaN,NaN,-51.25905788955051,-84.2681368182518,-0.12236650025897439,-0.19903883531912925,-0.07667233506015486,483567359,483973641.4,28.627808954716826,31.699559696539897,NaN,NaN,-6.488267976857707,0.2762296005351357
2017-07-05T09:30:00-04:00,89.53,89.55,88.895,89.32,3985053,4757602.5,44.55992910784769,46.21854784957433,NaN,NaN,-113.1278502750844,-83.70123733712735,-0.11544163823022954,-0.2209743828479418,-0.10553274461771225,479582306,483572353.6,28.12557617531961,30.373758660571298,NaN,NaN,-7.230943793772726,-0.7962237415088445
2017-07-06T09:30:00-04:00,88.77,89.04,88.35,88.41,3797421,4713897.95,38.34400327584328,45.344181339031614,NaN,NaN,-187.40008004073275,-107.55248215946676,-0.16216157961900374,-0.30823471914146694,-0.1460731395224632,475784885,481405421.8,25.521807800158413,29.273005815712974,NaN,NaN,-9.925212465777893,-2.100364987832994
2017-07-07T09:30:00-04:00,88.6,89.2661,88.6,89.2,2579747,4582945.4,45.45726265418237,45.18286149403574,NaN,NaN,-121.11218933714247,-107.91919581659957,-0.13119628045680617,-0.3100684900934709,-0.17887220963666475,478364632,480734772.6,24.757885272820573,28.413696876633065,NaN,NaN,-9.85958498121547,-3.2088249868876333
2017-07-10T09:30:00-04:00,89.27,89.53,89.01,89.39,2700116,4168500.9,47.039800580894685,44.67450680705067,NaN,NaN,-71.95530206501451,-108.97089592150493,-0.09115420510944491,-0.2928149660234709,-0.201660760914026,481064748,479672786,23.55551350837915,27.594958568172594,NaN,NaN,-9.299563776163312,-4.07893052821273
2017-07-11T09:30:00-04:00,89.29,89.35,88.72,89.21,3212276,4007287,45.687364070258546,44.76501748081415,NaN,NaN,-93.52127237448647,-117.42333881849213,-0.07092683079218706,-0.2903192994042598,-0.21939246861207276,477852472,478529808.6,22.300240858603217,26.908856550245332,NaN,NaN,-9.258231471644486,-4.818830662988695
2017-07-12T09:30:00-04:00,89.71,90.02,89.65,89.89,3033865,3950737.8,51.3750038792314,45.16958542850737,NaN,NaN,26.419146699054487,-89.51393942366435,-0.009134432114318247,-0.23081050875497056,-0.2216760766406523,480886337,478790614.8,23.30457882059001,26.399610463931232,NaN,NaN,-7.42074360960466,-5.1905325125052615
2017-07-13T09:30:00-04:00,90.15,90.25,89.83,89.9,3311710,3875852.95,51.45551333450461,45.69797109208071,NaN,NaN,60.657674527376884,-39.90238851004243,0.032733843399311124,-0.1807587723915134,-0.2134926157908245,484198047,480473247.2,29.62484794341964,26.44557665363651,NaN,NaN,-5.938320166316507,-5.297359320192582
2017-07-14T09:30:00-04:00,90.18,90.3,89.785,90.19,4139975,3903599,53.84230285886359,46.45975201549123,NaN,NaN,80.15783227311344,0.3516158120087539,0.07771359913999548,-0.11635061686583015,-0.19406421600582563,488338022,482467925.2,36.32386471640885,27.025615246418194,NaN,NaN,-3.9881078741397404,-5.11032339932789
2017-07-17T09:30:00-04:00,90.19,90.56,90.19,90.41,3177182,3676877.2,55.624780498984705,47.109643490430734,NaN,NaN,125.940009973339,39.93067821967945,0.11764129580665067,-0.047012596247512306,-0.16465389205416298,491515204,484558016.4,42.50025537168691,28.087134563573528,NaN,NaN,-1.8381640347671524,-4.642872061533499
2017-07-18T09:30:00-04:00,90.33,90.83,90.26,90.82,3489985,3680387.2,58.81666610043158,48.397758738734694,NaN,NaN,170.71180474459584,92.77729364349592,0.16416661169951224,0.040554372570227315,-0.12361223912928491,495005189,487988559.8,50.91579858883548,29.80008250106504,NaN,NaN,0.9604546880544013,-3.84239681159237
2017-07-19T09:30:00-04:00,90.99,91.359,90.92,91.26,2656159,3645568.8,61.97749530045008,49.301671041188236,NaN,NaN,226.8832293391727,132.87011017151957,0.2139286145666674,0.14379852907904933,-0.07013008548761807,497661348,491343562,57.471391626427625,32.00700821488188,NaN,NaN,4.331128102996247,-2.674750395222568
2017-07-20T09:30:00-04:00,91.35,91.42,90.76,91.07,4599489,3719232.15,59.841655214667526,50.51288799223784,NaN,NaN,176.51846763730282,156.04226879350475,0.22241798891511624,0.20789240065627723,-0.014525588258839005,493061859,493116324.4,60.47526504647842,34.473045477723126,NaN,NaN,6.544861203431098,-1.35766302398633
2017-07-21T09:30:00-04:00,90.64,91.13,90.64,91.13,3324429,3702509.75,60.30684764157824,51.469386977230734,NaN,NaN,136.7786490922102,167.3664321573241,0.22004093262751578,0.2605255775255557,0.04048464489803994,496386288,494725977.6,63.028737659618336,36.89525516739023,NaN,NaN,8.50372230644352,0.05110630893221968
2017-07-24T09:30:00-04:00,91.16,91.16,90.72,90.82,2040899,3608422.7,56.65517731972361,52.21312870267583,NaN,NaN,110.64049632787278,164.30652942823085,0.18686356394577225,0.27406409983025526,0.08720053588448301,494345389,495292014.6,63.911667589540414,39.41553078416335,NaN,NaN,9.211272745549017,1.3597015141631907
2017-07-25T09:30:00-04:00,91.16,91.6952,91.01,91.46,5048411,3625410.25,61.79812991328472,53.44442876020706,NaN,NaN,138.28026903328131,157.82022228596796,0.19632124941181933,0.3326020976492572,0.13628084823743786,499393800,496169736.8,65.2956875396375,42.070538738757485,NaN,NaN,11.363622114836197,2.7888330285450484
2017-07-26T09:30:00-04:00,91.61,91.63,91.32,91.42,2864393,3567885,61.30850812096228,55.084750534858415,NaN,NaN,124.90354178029057,137.42428477419153,0.1881625061041141,0.3714839808675805,0.18332147476346639,496529407,495943348.6,64.60744817236935,44.8623701939154,NaN,NaN,12.989088546191383,4.24601238820881
2017-07-27T09:30:00-04:00,91.81,92.55,91.32,92.09,6637638,3648226.95,66.1467275146663,56.562569453464405,NaN,NaN,145.0475208259507,131.1300954119211,0.21427150223159455,0.45116085255295957,0.23688935032136502,503167045,497964385.8,67.86395942243732,47.9413754903166,NaN,NaN,15.925314135854274,5.914484066443876
2017-07-28T09:30:00-04:00,91.19,91.5,91.04,91.39,3916736,3598980.45,57.98810368206106,57.34459110354772,NaN,NaN,81.17317990575705,120.00900157463047,0.17257160931409132,0.45260386196397917,0.28003225264988785,499250309,498537190,68.74181098954368,51.16896816754264,NaN,NaN,16.008624913325292,7.3565041874269355
2017-07-31T09:30:00-04:00,91.72,91.85,91.0563,91.36,3130649,3522672.75,57.65986477028582,58.199769724978246,NaN,NaN,81.54553901846188,114.1900101127483,0.13292090486477343,0.44618338373085464,0.3132624788660812,496119660,498892044.2,69.30128176280874,54.52618537498589,NaN,NaN,15.977737718583606,8.588108977592174
2017-08-01T09:30:00-04:00,91.63,91.7,91.23,91.52,4375438,3601078.55,58.99305459015189,58.74391620432971,NaN,NaN,78.17873562175522,102.16970343044306,0.10845554999088852,0.4488319163546919,0.34037636636380336,500495098,499112303.8,69.66422463395153,57.83758864736886,NaN,NaN,16.332488311259937,9.694448882401854
2017-08-02T09:30:00-04:00,91.48,91.52,90.73,91.27,2888005,3546226.15,56.024646657337165,59.070282870246324,NaN,NaN,49.400072929063555,87.06900966019765,0.06837815806937536,0.4258490639505226,0.3574709058811472,497607093,499327841,70.03753295545265,60.724209005371215,NaN,NaN,15.787749784492869,10.564920439843428
2017-08-03T09:30:00-04:00,91.18,91.495,90.985,91.02,3595719,3536141.05,53.14480757132344,59.02046177827917,NaN,NaN,43.81001762101849,66.82150901921122,0.020460519237391783,0.383046554927887,0.3625860356904952,494011374,497496706.8,62.950061091908076,62.62608017504973,NaN,NaN,14.502344144905056,11.127409540566518
2017-08-04T09:30:00-04:00,91.22,91.22,90.66,91.03,2449353,3529621.35,53.248329154932314,58.850715253703996,NaN,NaN,19.12817603061347,54.412508244182504,-0.013313353729038302,0.34594434352919734,0.35925769725823564,496460727,496938790.4,60.92702280558497,63.94227784889959,NaN,NaN,13.471267528034664,11.46224639591911
2017-08-07T09:30:00-04:00,91.19,91.37,91.07,91.24,3469717,3568101.4,55.47316994016355,58.61189409939914,NaN,NaN,42.74330533204255,46.65206150689865,-0.02365782944194106,0.32968541045580935,0.3533432398977504,499930444,497700947.2,62.69095529538939,64.7833604707963,NaN,NaN,13.170165613403759,11.706234855559774
2017-08-08T09:30:00-04:00,91.24,91.77,91.02,91.29,3025108,3558743,56.00994423025606,58.18564045152813,NaN,NaN,56.651538153374645,42.34662201322253,-0.028931843580912275,0.31717843542161006,0.34611027900252234,502955552,498193038,63.82644258350357,65.23729268201602,NaN,NaN,13.055277766533251,11.898955271413127
2017-08-09T09:30:00-04:00,90.21,90.82,90.04,90.76,4898141,3651956.8,49.23460650454264,57.42799411509065,NaN,NaN,-86.94820293512254,15.076966840385314,-0.06769962159086623,0.26148575201393953,0.32918537360480576,498057411,498283101.6,64.0421428543456,65.49206966829225,NaN,NaN,11.048921528594725,11.777521879581927
2017-08-10T09:30:00-04:00,90.38,90.53,89.38,89.4,4904886,3731615.6,36.899689287055736,55.756054232624756,NaN,NaN,-212.46148376391884,-36.177333436602154,-0.1782427307659341,0.1063819601473881,0.2846246909133222,493152525,498111331.8,63.26728708182086,65.50910891273527,NaN,NaN,4.73270257476974,10.771119121751616
2017-08-11T09:30:00-04:00,89.18,90.05,89.18,89.86,4919590,3770596.35,42.176524879183596,54.72186477258617,NaN,NaN,-208.9567929821125,-81.79432723914735,-0.21142397516294134,0.02034472195964554,0.23176869712258688,498072115,498433609.4,64.14385704056556,65.52569387352278,NaN,NaN,1.2596937170714062,9.412344063940157
2017-08-14T09:30:00-04:00,90.36,90.8,90.34,90.5,3754082,3799441.35,48.615029381552425,53.7802147346053,NaN,NaN,-76.25052440027429,-105.59309318561073,-0.18240782831147506,0.0037589117332430533,0.18616674004471812,501826197,498812760,65.19612768507054,65.51858245533943,NaN,NaN,0.5209732534824351,8.142148233874769
2017-08-15T09:30:00-04:00,90.46,90.54,89.66,89.67,3095655,3779724.85,42.07228808512201,52.40619901775956,NaN,NaN,-151.9306300550228,-147.3095268272902,-0.20932485742795787,-0.0754893317402292,0.13383552568772866,498730542,497967758,60.906143803941255,65.25420357188027,NaN,NaN,-2.467842680566321,6.62643524609747
2017-08-16T09:30:00-04:00,90,90.3,89.75,90.13,2452677,3769550.75,46.37939202541986,50.99424648281339,NaN,NaN,-115.26877556345752,-152.9736413529572,-0.18708680247398157,-0.1000229774047483,0.08706382506923327,501183219,498592919.6,62.853609085604674,64.89632140496366,NaN,NaN,-3.3615244217864193,5.199583864971201
2017-08-17T09:30:00-04:00,89.9,90,88.69,88.69,4895731,3784362.85,37.083877063760696,49.50108743864909,NaN,NaN,-186.23427038380206,-147.72819867693383,-0.25603220129114296,-0.23297642654469541,0.02305577474644753,496287488,499219912.2,64.75019589301326,64.61120604092578,NaN,NaN,-7.783389590136397,3.344873371384401
2017-08-18T09:30:00-04:00,88.5,88.74,88.15,88.25,6787836,3957533.2,34.78946696585713,47.86748759547561,NaN,NaN,-206.1015546439085,-147.15715100929305,-0.3141141776877545,-0.3695869473632456,-0.0554727696754911,489499652,497505419.6,56.28720848899462,63.68162937851047,NaN,NaN,-12.046574299510558,1.1460951326851214
2017-08-21T09:30:00-04:00,88.22,88.53,87.89,88.41,10550695,4383023,36.332085436256904,46.24884694162596,NaN,NaN,-174.72997425023,-166.8530409792842,-0.3233358901516782,-0.45964263236508884,-0.13630674221341066,500050347,497150249.6,54.69244854657452,62.61221680084069,NaN,NaN,-14.764496809273151,-1.1268465733089177
2017-08-22T09:30:00-04:00,88.67,89.46,88.62,89.36,4385556,4349880.25,44.69727211021848,45.43974875968892,NaN,NaN,-94.55443537586356,-155.37780204345233,-0.25029661604395087,-0.44917751226834923,-0.19888089622439836,504435903,498291321.8,58.73731871177646,61.8050586405781,NaN,NaN,-14.110288053021094,-2.9816239275535144
2017-08-23T09:30:00-04:00,88.76,88.92,88.45,88.6,4840795,4448700.35,40.152216447895015,44.511706536586885,NaN,NaN,-113.29668869347012,-154.98338466945484,-0.23808431716410916,-0.4964862926795348,-0.25840197551542565,499595108,497973699.6,57.20636948228705,61.3947949541766,NaN,NaN,-15.187151907726765,-4.725270781863979
2017-08-24T09:30:00-04:00,89.04,89.25,88.27,88.41,2765860,4255111.45,39.082268515616384,43.49984506235004,NaN,NaN,-102.7962198542619,-138.29577456354681,-0.22771866613551328,-0.5430503081848173,-0.315331642049304,496829248,498082051.6,57.61224962545965,61.15802544131051,NaN,NaN,-16.378144283994388,-6.389966996454037
2017-08-25T09:30:00-04:00,88.67,89.01,88.47,88.63,3244564,4221502.85,41.0413583558799,42.469001377758346,NaN,NaN,-89.28349238269956,-114.93216211130502,-0.19236958369180923,-0.5557936216640655,-0.3634240379722563,500073812,500196883.6,64.65808341817717,61.2985345929382,NaN,NaN,-16.69887914295729,-7.862668731668787
2017-08-28T09:30:00-04:00,88.92,88.98,88.56,88.68,2184210,4174180.9,41.50181109162096,41.43270615357012,NaN,NaN,-78.66046297891683,-95.7182598570424,-0.15362498141528985,-0.5554552647413686,-0.4018302833260788,502258022,500638418.6,65.93135439620755,61.448885436702774,NaN,NaN,-16.814799804095117,-9.141544599158262
2017-08-29T09:30:00-04:00,88.11,88.7,87.97,88.6,2755578,4093187.9,40.95074453314704,40.84100172704187,NaN,NaN,-91.67984074008936,-95.14334092988756,-0.12272934305200256,-0.555241962141082,-0.43251261908907945,499502444,499651726.8,60.67102275033592,61.20809114355922,NaN,NaN,-17.065819358516656,-10.273583850495175
2017-08-30T09:30:00-04:00,88.65,89.35,88.56,89.24,2256426,4061608.95,47.01233335260869,41.563333446009935,NaN,NaN,-42.027920646582565,-80.88958732051005,-0.05214444067829771,-0.49769316993695156,-0.44554872925865385,501758870,500084479.2,62.099295216097794,61.12466315315043,NaN,NaN,-15.481083139347243,-11.017512320331186
2017-08-31T09:30:00-04:00,89.49,89.74,89.36,89.66,3994053,4081525.65,50.59646591598708,42.16475780578161,NaN,NaN,3.5144198524480315,-59.62745937916806,0.025695707938001466,-0.41342909433615205,-0.4391248022741535,505752923,501869214.2,67.36337634121149,61.354628817482286,NaN,NaN,-13.050920568816368,-11.307999212971925
2017-09-01T09:30:00-04:00,89.89,90.23,89.84,90.07,2431911,4080653.55,53.87630551652706,42.540563243994086,NaN,NaN,46.864123872434625,-32.39793612814122,0.10330605277219085,-0.3099922363089149,-0.4132982890811058,508184834,503491418.6,71.26941291913488,61.788434905629735,NaN,NaN,-9.990370054165863,-11.119766475999631
2017-09-05T09:30:00-04:00,89.82,90.2,89.18,89.7,4955544,4154944.9,50.61087120459977,43.1504620382425,NaN,NaN,25.81305614615343,-11.503232303127174,0.1266906653578707,-0.25493495738376737,-0.3816256227416381,503229290,503685672.2,71.7061017203209,62.55986047108542,NaN,NaN,-8.348207647172892,-10.723829500452954
2017-09-06T09:30:00-04:00,89.84,90.365,89.65,90.26,3004657,4153922.35,55.051359148712685,43.76988826133485,NaN,NaN,76.30542937486314,22.093821719863325,0.17392345316141067,-0.16422130628987475,-0.3381447594512854,506233947,505031972.8,74.5888666860842,63.39809315683396,NaN,NaN,-5.562051087260731,-9.986432584282637
2017-09-07T09:30:00-04:00,90.45,90.57,89.27,89.48,5354006,4176715.6,48.50928499803342,44.58598882806861,NaN,NaN,50.232344145387295,40.545874678257306,0.147715718143891,-0.15350011177142164,-0.30121582991531265,500879941,504856187,73.5353556758755,64.02560456989555,NaN,NaN,-5.1459489626361545,-9.294934924047425
2017-09-08T09:30:00-04:00,89.3,89.38,89.015,89.17,2589950,4060968.8,46.16139309550199,45.39826926590039,NaN,NaN,-11.514564213646402,37.54007786503841,0.10650836697017652,-0.168080371202592,-0.2745887381727685,498289991,503363600.6,65.12433422626873,64.6568278368437,NaN,NaN,-5.528947706065391,-8.756936750049992
2017-09-11T09:30:00-04:00,89.49,89.73,89.42,89.64,3351563,3982567.45,50.10447391055196,46.3820112997786,NaN,NaN,35.9458318947356,35.356419469498604,0.10759472808608858,-0.1400953280651578,-0.24769005615124637,501641554,502054944.6,58.77648164043601,64.94854448640524,NaN,NaN,-4.635492600528568,-8.168159014404074
2017-09-12T09:30:00-04:00,89.86,90.17,89.7432,90.04,2720090,3930867.85,53.243064853476916,46.9924250671542,NaN,NaN,88.53112352023744,47.90003294431541,0.1304205532382217,-0.08466436460346927,-0.21508491784169095,504361644,502281415.4,59.51197960669376,65.00387740747075,NaN,NaN,-2.9200600000249786,-7.4184305837784885
2017-09-13T09:30:00-04:00,89.99,90.69,89.99,90.69,3291562,3940663.2,57.879697043453845,48.25867368112269,NaN,NaN,136.08439660724957,59.8558263907927,0.1813328469447223,0.011581140839211912,-0.16975170610551038,507653206,502565267.2,60.46410065253035,65.23657249105956,NaN,NaN,0.037570226079020295,-6.353287610941702
2017-09-14T09:30:00-04:00,90.47,90.7,90.17,90.2,3516900,3993874.35,53.56725373888803,49.293315482784955,NaN,NaN,119.40643536229457,73.69064463417416,0.1740148574609141,0.04776686572063227,-0.12624799174028184,504136306,503216540.2,62.635222166909,65.59535624402024,NaN,NaN,1.1855593327059692,-5.276309476134892
2017-09-15T09:30:00-04:00,89.71,89.97,89.58,89.63,3911134,3944644.5,48.994209880839335,49.86137630599634,NaN,NaN,44.12867313630903,84.81929210416524,0.12508084751746912,0.030103067656554572,-0.09497777986091455,500225172,503603576.4,63.90382841905954,65.5414808869404,NaN,NaN,0.7141079585028598,-4.420535556900927
2017-09-18T09:30:00-04:00,89.91,89.98,89.1234,89.32,6569557,3933730.55,46.6611138851051,50.22989793410236,NaN,NaN,11.156247599871806,79.86137524519248,0.06893543188691846,-0.008808490002266467,-0.07774392188918493,493655615,502006388.6,55.52569072985297,64.7982191964865,NaN,NaN,-0.39730901462496787,-3.8457889080043617
2017-09-19T09:30:00-04:00,89.33,89.48,88.91,89.24,6400542,3726222.9,46.05165270626267,50.59424851789633,NaN,NaN,-28.505999072275976,56.4539507266898,0.025734227227671297,-0.0455761378545958,-0.0713103650822671,487255073,498585074.4,42.63198327609319,63.50971637689774,NaN,NaN,-1.4736640641805068,-3.5069139303152395
2017-09-20T09:30:00-04:00,89.37,89.61,89.06,89.54,3709887,3692439.45,48.754743111851106,50.718706357842215,NaN,NaN,-4.981413524964086,28.24078870024706,0.017102940510402245,-0.04993168944426429,-0.06703462995466654,490964960,495247425.2,34.27122166594984,61.52199683760146,NaN,NaN,-1.605170706706514,-3.2352363269425646
2017-09-21T09:30:00-04:00,89.51,89.61,89.24,89.39,4207581,3660778.75,47.47391123513702,50.4956667377815,NaN,NaN,-9.52955397489437,2.4535908328092746,0.001834945161866719,-0.06474094850233314,-0.06657589366419986,486757379,491771639.8,28.0925115375247,58.716935065909546,NaN,NaN,-2.07456438810569,-3.0694260499658683
2017-09-22T09:30:00-04:00,89.16,89.59,89.142,89.54,3116275,3678299.5,48.91908026743074,50.1415792199889,NaN,NaN,-14.994218133328593,-9.370987421118247,0.002348679897107117,-0.06364004379281596,-0.06598872368992308,489873654,489701336.2,25.180468391812056,55.424867599672204,NaN,NaN,-2.075735389593768,-2.9274702413412825
2017-09-25T09:30:00-04:00,89.51,89.71,89.06,89.35,7167628,3874452.7,47.149510079141685,49.89433913959903,NaN,NaN,-31.055530742889783,-17.81334308967056,-0.008976192332366364,-0.07720896410538103,-0.06823277177301466,482706026,487511418.4,22.5211175611055,51.91165444544253,NaN,NaN,-2.5536741779519962,-2.8740708037142415
2017-09-26T09:30:00-04:00,89.61,89.79,89.165,89.36,3073229,3918903.65,47.25764851437302,49.33764552286049,NaN,NaN,-28.390895475375473,-17.790322370290465,-0.014343614218100792,-0.08616228954564065,-0.07181867532753985,485779255,487216254.8,22.181089797699627,48.168241810557916,NaN,NaN,-2.9248216359875228,-2.8813209226104246
2017-09-27T09:30:00-04:00,89.59,90.02,89.2,89.85,5229087,4042579.1,52.397404060815084,49.615368313059186,NaN,NaN,9.19809772718051,-14.954420119861547,0.014969518111801805,-0.0531067776877876,-0.0680762957995894,491008342,487224931.2,22.218265870765634,44.502735395907216,NaN,NaN,-1.8734011663852235,-2.7373323860068246
2017-09-28T09:30:00-04:00,89.72,89.82,89.58,89.74,3599766,4109746.1,51.19136608546393,49.97465209805647,NaN,NaN,7.687265457286148,-11.511056233425444,0.0261583902653034,-0.035378307967960154,-0.061536698233263555,487408576,487355170.6,22.81434302643504,41.48059316734766,NaN,NaN,-1.2998406252101802,-2.5319764201787325
2017-09-29T09:30:00-04:00,89.75,90.175,89.71,90.08,3472016,4083644.25,54.66478976803146,50.300388945019286,NaN,NaN,67.69457844933864,5.026703083108007,0.054059116553726555,0.006037197458894639,-0.048021919094831916,490880592,487556558.2,23.786931961679855,38.981339618865086,NaN,NaN,0.15125247622555613,-2.1486580064066914
2017-10-02T09:30:00-04:00,90.19,90.45,90.063,90.25,2929666,4108532,56.337884643376206,50.52144750144067,NaN,NaN,123.16615101800804,35.87103943528757,0.07999969256503284,0.05197769661145912,-0.028021995953573707,493810258,489777404.6,33.70732229522693,37.138149810903165,NaN,NaN,1.846815789684443,-1.5778760355365293
2017-10-03T09:30:00-04:00,90.4,90.645,90.33,90.63,4915550,4106532.3,59.90030650021035,50.665776748351846,NaN,NaN,152.8593926288144,72.12109705612554,0.1165712104178688,0.11769201706876231,0.0011208066508935008,498725808,492366715.2,43.01995387530389,35.892139326815574,NaN,NaN,4.352337830862453,-0.7307026260509605
2017-10-04T09:30:00-04:00,90.7,91.1562,90.6024,91.1,4931739,4202886.4,63.831055836557546,51.39890546961396,NaN,NaN,195.2379624457775,109.32906999984493,0.16336675763909228,0.20532925369975885,0.04196249606066657,503657547,494896556.2,50.357550365085764,35.01516276954248,NaN,NaN,7.747758710548451,0.4805061363203841
2017-10-05T09:30:00-04:00,91.24,91.635,91.12,91.61,7220520,4296212.1,67.5483588448419,52.72420182418557,NaN,NaN,212.77744867588842,150.34710664356538,0.21629778915110728,0.3123347324995507,0.0960369433484434,510878067,499590454.4,60.5169277020607,34.77324128975685,NaN,NaN,11.9041430785567,2.112454270925572
2017-10-06T09:30:00-04:00,91.46,91.85,91.46,91.72,3133244,4323376.8,68.30500020569339,54.27019370422759,NaN,NaN,197.31794317240087,176.27177958817782,0.24427963927516402,0.40138649244239843,0.1571068531672344,514011311,504216598.2,67.56270168121654,35.63302778628282,NaN,NaN,15.55013601884841,4.032123092057406
2017-10-09T09:30:00-04:00,91.88,91.89,91.34,91.43,4270062,4369301.75,64.06409921921069,55.55679702658102,NaN,NaN,150.77147458170595,181.79284430091744,0.22907314279225444,0.44344828165755246,0.21437513886529802,509741249,507402796.4,71.35424779275264,37.684618108901354,NaN,NaN,17.47148596441482,5.952032073822751
2017-10-10T09:30:00-04:00,91.49,91.77,91.12,91.34,2756674,4371130.95,62.761742886000356,56.55729701044883,NaN,NaN,116.3786772358371,174.49670122232197,0.1998356057609459,0.46416964606648037,0.2643340403055345,506984575,509054549.8,73.10907558520361,40.4587505317052,NaN,NaN,18.70568418005625,7.773982374713251
2017-10-11T09:30:00-04:00,91.39,91.49,91.16,91.39,3842849,4398695.3,63.209215365645754,57.68124730548516,NaN,NaN,99.33979652480471,155.3170680381274,0.17181537151062137,0.4791032546938112,0.30728788318318984,510827424,510488525.2,74.56578772567254,43.77827025943004,NaN,NaN,19.855314937078365,9.499887026479696
2017-10-12T09:30:00-04:00,91.05,91.07,90.58,90.78,4583954,4452048,54.590568005780135,58.08635357251012,NaN,NaN,48.4351697961846,122.44861226218663,0.10351572593496272,0.43668254060189327,0.33316681466693054,506243470,509561605.8,71.85611587336027,47.11224507954063,NaN,NaN,18.414958722683547,10.77346869736596
2017-10-13T09:30:00-04:00,90.95,91.3,90.84,91.22,2730147,4392998.65,58.939571116961424,58.92850078949724,NaN,NaN,66.90143517953184,96.36531066361285,0.08032271969341959,0.433570214283705,0.3532474945902854,508973617,508554067,68.92418827793183,50.42675013074251,NaN,NaN,18.432807130697228,11.867659902127569
2017-10-16T09:30:00-04:00,91.26,91.38,91.06,91.34,4327757,4280908.65,60.062966675254366,59.843166372417336,NaN,NaN,70.61839277097927,80.33469430146751,0.06601277269003797,0.4357634604528329,0.3697506877627949,513301374,509266092,69.86013045245548,53.8323958917965,NaN,NaN,18.771366317901364,12.853903675809539
2017-10-17T09:30:00-04:00,91.32,91.54,91.16,91.39,2773244,4099543.75,60.547316570826155,60.42530298027527,NaN,NaN,72.24414881366818,71.50778861703371,0.053403013262454446,0.43650445434086294,0.3831014410784085,516074618,511084100.6,72.16527834018568,57.40003963961221,NaN,NaN,19.18433276539229,13.758250688607076
2017-10-18T09:30:00-04:00,91.47,91.51,91.12,91.14,4525582,4140328.5,56.83573043944445,60.82847186270244,NaN,NaN,57.56039341519174,63.1519079951111,0.023252907480264817,0.4121675754287395,0.3889146679484747,511549036,511228423,72.34609414844968,60.93802186261326,NaN,NaN,18.500048771317203,14.435650414708523
2017-10-19T09:30:00-04:00,90.76,91.15,90.54,91.14,4501085,4155003.7,56.83573043944445,60.98353905351767,NaN,NaN,25.21530596845656,58.5079352295655,-0.0004092113435417155,0.38840315376904755,0.38881236511258926,511549036,512289536.2,73.69890181233748,64.50316256623167,NaN,NaN,17.93504838294469,14.935564410170832
2017-10-20T09:30:00-04:00,91.5,91.59,91.25,91.36,4801413,4239260.6,59.377208944860996,61.20063364648086,NaN,NaN,64.42476802298954,58.01260179825704,-0.0047235595511584405,0.38290791567364124,0.3876314752247997,516350449,513764902.6,75.49394858879484,67.4879215872008,NaN,NaN,18.116523582277026,15.389987149043145
2017-10-23T09:30:00-04:00,91.46,91.54,90.67,90.74,2910557,4026407.05,50.37532168564572,60.520277588297674,NaN,NaN,15.048590336002292,46.89864131126164,-0.05028100636214311,0.3247802172721208,0.3750612236342639,513439892,513792606.2,75.52772373650639,69.80990514871526,NaN,NaN,15.604050602667924,15.420567642418114
2017-10-24T09:30:00-04:00,90.84,91.11,90.84,90.96,3701956,4057843.4,53.09281707694794,59.75326053403984,NaN,NaN,5.186048964744146,33.48702134147685,-0.06557919353303016,0.29308723171797624,0.3586664252510064,517141848,514006052.2,75.80441568848468,71.6275383861009,NaN,NaN,14.263262658118581,15.255238358946752
2017-10-25T09:30:00-04:00,90.78,90.92,90.12,90.61,4683616,4030569.85,48.53884276495743,58.39543795690524,NaN,NaN,-69.84416661146619,8.006109336145258,-0.09733610685891925,0.23699629167735736,0.3343323985362766,512458232,514187891.4,76.05282089697486,72.73724504288049,NaN,NaN,11.712611429083568,14.749148797537725
2017-10-26T09:30:00-04:00,90.61,91.26,90.53,90.93,3566536,4028908.35,52.54649237652216,57.26983025482158,NaN,NaN,-24.969054952636547,-2.030762848073362,-0.09476459757348782,0.21587665156941682,0.31064124914290464,516024768,515083037.8,77.28892086309295,73.43197498444309,NaN,NaN,10.72155266254295,14.173777921109899
2017-10-27T09:30:00-04:00,91.61,92.45,91.18,92.4,5945603,4152587.7,65.74415277376298,57.38983408014674,NaN,NaN,173.4014633370527,19.764576214739268,0.0027948002638135683,0.3141347494726716,0.31133994920885805,521970371,516207022.2,78.77070742574817,73.96172210108561,NaN,NaN,14.630840413020513,14.239072562811415
2017-10-30T09:30:00-04:00,92.03,92.19,91.775,91.98,4335414,4222875.1,60.56161236192445,57.232681899855606,NaN,NaN,155.52352441143637,47.859563029826084,0.034154787049805735,0.35403343302111523,0.3198786459713095,517634957,517046035.2,79.82868203871398,74.44169399062207,NaN,NaN,15.849233206719088,14.469095511941083
2017-10-31T09:30:00-04:00,92.08,92.18,91.91,91.99,3187590,4136477.1,60.64116657328605,57.04924984325849,NaN,NaN,149.98540376617555,76.81943399011236,0.04974207293042093,0.3820562371343357,0.33231416420391474,520822547,517782175,80.73580644035607,74.88240961309948,NaN,NaN,16.794597895594023,14.801310138177216
2017-11-01T09:30:00-04:00,92.29,92.59,91.98,92.02,4417221,4110751.2,60.89600860000475,57.499638457131674,NaN,NaN,160.85980109079802,122.9602275305652,0.05578920519926095,0.40205067070299094,0.34626146550373,525239768,520338482.2,83.50920122478519,75.71477285248696,NaN,NaN,17.613194260812836,15.203007869982304
2017-11-02T09:30:00-04:00,91.77,91.88,91,91.33,4591765,3979313.45,52.47951554733658,57.03820591644419,NaN,NaN,8.711111111113663,129.69626074331524,0.00946388050941771,0.35809131614050216,0.34862743563108445,520648003,521263129.2,84.3848971243444,76.81910919865929,NaN,NaN,15.551384867323007,15.252776012459547
2017-11-03T09:30:00-04:00,91.28,91.74,91.06,91.7,3694007,4007351.6,55.99197662668335,56.747420912974825,NaN,NaN,29.941113046369804,101.00419068517867,0.0003661180388825902,0.34908508317968767,0.3487189651408051,524342010,521737457,84.82992443657615,77.88838019752505,NaN,NaN,14.989057028482497,15.215101871891397
2017-11-06T09:30:00-05:00,91.52,92.41,91.52,92.37,3847861,3986241.55,61.53619879014383,56.818055357211804,NaN,NaN,132.5754971390248,96.41458523069636,0.03422325477995353,0.391498033615747,0.35727477883579345,528189871,523848439.8,86.65304286224308,78.92322052052916,NaN,NaN,16.391468084831047,15.383154188025634
2017-11-07T09:30:00-05:00,92.26,92.55,91.69,91.82,2432920,3970053.85,55.36951024745255,56.713325343498106,NaN,NaN,102.53084224254292,86.92367292596983,0.015293291540098897,0.3763913932609171,0.3610981017208182,525756951,524835320.6,87.41452783636811,79.99953721252334,NaN,NaN,15.440123401429414,15.391292647083317
2017-11-08T09:30:00-05:00,91.68,91.97,91.59,91.92,2725780,3914200.4,56.22839678669827,56.669944368301955,NaN,NaN,62.58411843876507,67.26853639556325,0.00571636161812028,0.3682435537434685,0.36252719212534823,528482731,525483913.2,87.90300962849676,81.01411634224898,NaN,NaN,14.974785191980121,15.331791582068574
2017-11-09T09:30:00-05:00,91.4,92.19,91.18,92.06,3441318,3857068.6,57.462603124045586,56.53318680967227,NaN,NaN,52.9258192898072,76.11147803130194,0.005043448081341051,0.36883150222702454,0.3637880541456835,531924049,527739122.4,89.43805833463823,82.0101241812378,NaN,NaN,14.981075758365133,15.281689321539512
2017-11-10T09:30:00-05:00,92.03,92.49,91.95,92.37,2510606,3846091.55,60.142532565308436,57.23084472964818,NaN,NaN,110.98671018590757,92.3205974592095,0.020824182565516103,0.38981828235257865,0.36899409978706255,534434655,529757651.4,90.58914199152663,83.08593977088209,NaN,NaN,15.806876102316883,15.356716004507707
2017-11-13T09:30:00-05:00,92.08,92.87,91.9,92.68,5714667,3915437.05,62.67496221717788,57.915283668236036,NaN,NaN,124.64279414359225,90.73405686012299,0.0460430301666494,0.4265478874953743,0.3805048573287249,540149322,532149541.6,91.73816928516155,84.22406502778759,NaN,NaN,17.276019214705514,15.630902177393107
2017-11-14T09:30:00-05:00,92.39,92.78,92.13,92.76,4189459,3986247.8,63.32261030296694,58.97126706380815,NaN,NaN,119.00773445231516,94.02943530207743,0.061072486502057655,0.456845465456297,0.39577297895423935,544338781,535865907.6,93.13970947039383,85.4445570687461,NaN,NaN,18.660600373501254,16.063716205408557
2017-11-15T09:30:00-05:00,92.31,92.67,91.83,92.36,3365293,3928233.35,57.911819673330285,59.354504727865866,NaN,NaN,76.21412803532334,96.75543722138909,0.038155885674417855,0.4434678360472617,0.40531195037284384,540973488,538364059,93.8900399574891,86.63035128977438,NaN,NaN,18.268977393430422,16.37875351798311
2017-11-16T09:30:00-05:00,92.51,93.21,92.44,93.13,4093326,3907845.4,64.24539972930586,59.24745093897606,NaN,NaN,150.03360215053783,116.17699379353522,0.06723645912260628,0.4893575242761017,0.4221210651534954,545066814,540992612,94.56377643257653,87.75842764740499,NaN,NaN,19.938623421431963,16.887306361332946
2017-11-17T09:30:00-05:00,93.34,93.695,93.27,93.54,4686446,3902097.05,67.0856235273443,59.713451736506045,NaN,NaN,196.77045858661134,133.33374347367595,0.10425579787547173,0.552440812497835,0.4481850146223633,549753260,544056333,95.22472442496723,88.8581449607088,NaN,NaN,22.26099749016321,17.654976522594414
2017-11-20T09:30:00-05:00,93.69,93.92,93.51,93.72,2447596,3878949,68.27705076100986,60.258872035629174,NaN,NaN,199.26375961452186,148.2579365678619,0.1293947032826886,0.609928393725724,0.48053369044303545,552200856,546466639.8,95.67068545996696,89.92492203353814,NaN,NaN,24.51630647537224,18.63516651584839
2017-11-21T09:30:00-05:00,93.96,94.36,93.83,94.3,5015078,3944605.1,71.81708869935115,61.038949185582496,NaN,NaN,209.48956041007264,166.35430175941337,0.17100150909398337,0.6942855768105147,0.5232840677165314,557215934,549042070.4,96.0907832835144,90.82360646630453,NaN,NaN,27.636358995232875,19.92105115576046
2017-11-22T09:30:00-05:00,94.34,94.58,94.28,94.39,3197307,3870289.65,72.3330240105622,62.45705693295575,NaN,NaN,193.53907584249797,189.81929132084832,0.18908857602978058,0.7596447877537571,0.5705562117239765,560413241,552930021,96.62345475232387,91.69778915401733,NaN,NaN,30.291212008285978,21.402502706121247
2017-11-24T09:30:00-05:00,94.61,94.67,94.48,94.63,1736248,3778775.25,73.71491020879506,63.722980760249435,NaN,NaN,171.6786611834603,194.14830312743283,0.20062745081442468,0.8213405252420074,0.6207130744275827,562149489,556346556,97.00912628490902,92.56773214318396,NaN,NaN,32.926617042228976,23.048804754136636
2017-11-27T09:30:00-05:00,94.88,95.09,94.5288,94.7,3924108,3677700.5,74.12091483997685,64.62188904952323,NaN,NaN,151.54076962042257,185.10236533419507,0.19615088534282132,0.8659016811061093,0.669750795763288,566073597,559610623.4,97.3236451058081,93.32991801772432,NaN,NaN,35.19743074491242,24.78432275281889
2017-11-28T09:30:00-05:00,94.85,95.75,94.73,95.75,5804730,3751166.3,79.2887035608118,66.33040285762031,NaN,NaN,162.3820690148769,177.72602721426605,0.24396506414480312,0.9747071259442919,0.7307420617994888,571878327,563546117.6,97.64518196047099,94.0606790265888,NaN,NaN,39.11480078611298,26.831533900432333
2017-11-29T09:30:00-05:00,95.83,96.42,95.68,96.16,6346727,3909123.15,80.89314639221742,68.09217068658596,NaN,NaN,167.98445519838018,169.42500617192758,0.28064821958188346,1.081552336276843,0.8009041166949596,578225054,567747941.6,97.93098911530973,94.77696327564686,NaN,NaN,42.913437905445065,29.128948758291294
2017-11-30T09:30:00-05:00,96.32,97.05,96.09,96.65,7481718,4062348,82.6254624209998,69.88951777922556,NaN,NaN,163.41114725443953,163.39942045431587,0.3128974326372307,1.192025907491498,0.8791284748542674,585706772,572806647.8,98.21230566912132,95.40369522810995,NaN,NaN,46.699475844842446,31.63902405637003
2017-12-01T09:30:00-05:00,96.55,96.92,95.25,96.61,11780071,4421763.3,81.97210231085614,71.44877276105038,NaN,NaN,128.96283325186846,154.8562548679975,0.30614046110480486,1.2618040512352735,0.9556635901304686,573926701,575162090.2,98.3264093042871,95.95635717902141,NaN,NaN,49.47845358393606,34.18751398887946
2017-12-04T09:30:00-05:00,97.59,98.37,97.55,97.73,6772924,4575709.15,85.44307419577754,73.0750664738075,NaN,NaN,175.1028752980855,159.5686760035301,0.348620114353015,1.3914387330717375,1.0428186187187225,580699625,578087295.8,98.45803741411181,96.43634775966072,NaN,NaN,53.308420381700536,36.91907204499675
2017-12-05T09:30:00-05:00,97.7,97.93,97.14,97.17,7481896,4757410.9,77.41710270223383,74.08181593089799,NaN,NaN,135.14752844730612,154.12176789001597,0.31172522555133675,1.4324751506578934,1.1207499251065567,573217729,578355176.2,98.46990566789742,96.81707605948239,NaN,NaN,53.70938257041183,39.31768783434176
2017-12-06T09:30:00-05:00,97.04,97.23,96.48,96.54,5718046,4921667.2,69.50692845569618,74.91003798678128,NaN,NaN,96.55548497913756,139.8359738461674,0.22183628125830657,1.39804527667944,1.1762089954211334,567499683,576210102,92.34085854381205,96.70642024421974,NaN,NaN,51.27034480458422,41.02521025866211
2017-12-07T09:30:00-05:00,96.47,96.97,96.33,96.79,3951414,4982948.9,70.78270125990619,75.37698809610986,NaN,NaN,85.04846477742512,124.16343735076455,0.15909775104472712,1.3750811842270423,1.2159834331823152,571451097,573358967,84.78684020969044,96.00806765687074,NaN,NaN,49.757356735665816,42.27265975537693
2017-12-08T09:30:00-05:00,97.06,97.44,96.8204,97.25,5793388,5100552.4,73.01948933649098,75.80083565390605,NaN,NaN,93.58838580870655,117.08854786213217,0.12970452525442022,1.3781140897503406,1.2484095644959203,577244485,574022523.8,85.09249699282068,95.28433712600312,NaN,NaN,49.23039268128146,43.266621601934716
2017-12-11T09:30:00-05:00,97.33,97.49,97.125,97.46,3346422,5142343.2,73.99815660279872,76.2094860711767,NaN,NaN,91.33278687167272,100.33453017684961,0.10650229293267621,1.3815374306617656,1.2750351377290894,580590907,574000780.2,85.03220826796918,94.52444589800328,NaN,NaN,49.11292246089436,44.10180743892895
2017-12-12T09:30:00-05:00,97.73,97.81,97.465,97.5,2759040,4994561.85,74.19019804084861,76.37899388128366,NaN,NaN,92.54531211015203,91.8140869094188,0.07730501161791059,1.3716664022514777,1.2943613906335671,583349947,576027223.8,86.02591015764054,93.80552638901229,NaN,NaN,49.07592982201112,44.81239635079783
2017-12-13T09:30:00-05:00,97.7,97.81,97.435,97.58,3452882,4957733,74.5943418589076,76.54051658473689,NaN,NaN,85.70899381746848,89.64478867708499,0.048257232264508065,1.3546829309642021,1.306425698699694,586802829,579887853,87.70113013669868,93.16821748789621,NaN,NaN,49.15949352409553,45.433410232697504
2017-12-14T09:30:00-05:00,97.69,98.17,97.61,97.88,4247329,5001834.8,76.10535356100668,76.7112625384663,NaN,NaN,92.55914821123304,91.14692536384658,0.03475578848315619,1.3498704343036394,1.3151146458204832,591050158,583807665.2,89.1264476310536,92.60516901262083,NaN,NaN,49.65746930050583,46.03684724238441
2017-12-15T09:30:00-05:00,98,98.23,97.74,97.97,6732140,5133775.5,76.55583620457062,76.88518549308014,NaN,NaN,92.49485300130348,90.92821880236596,0.01822532977486402,1.3378963080390633,1.3196709782641993,597782298,587915227.8,90.38404711445955,92.10948344181023,NaN,NaN,50.19463764355282,46.630817299694186
2017-12-18T09:30:00-05:00,98.59,99.0137,98.47,98.85,6008340,5199870.2,80.43905702256566,76.96735359749114,NaN,NaN,126.49839583771586,97.96134059557458,0.051037312355697084,1.3834676187088206,1.3324303063531235,603790638,592555174,91.57010647775424,91.67554947875904,NaN,NaN,51.88930052086849,47.38202918843337
2017-12-19T09:30:00-05:00,98.96,99.08,98.55,98.72,5984713,5376726.05,78.37380231421288,76.78740044906223,NaN,NaN,121.31965272543152,103.7162087186305,0.04848395805400485,1.3930352539206297,1.3445512958666248,597805925,595446369.6,92.21449815729511,91.26722869604369,NaN,NaN,52.669579969247536,48.137393585692536
2017-12-20T09:30:00-05:00,99.06,99.125,98.49,98.53,2464500,5249197.15,75.32964223064724,76.26627043546561,NaN,NaN,109.16329763601522,108.40706948233984,0.01995858220973168,1.3694995236287895,1.3495409414190578,595341425,597154088.8,92.57550737071551,90.86460024615756,NaN,NaN,52.44797234724749,48.75319055162896
2017-12-21T09:30:00-05:00,98.66,99.39,98.58,99.17,2359901,5207326.85,78.37638584524149,76.00943354506457,NaN,NaN,122.88737571867988,114.4727149838292,0.029572965084554204,1.3865071477747506,1.3569341826901964,597701326,598484322.4,92.85349256109842,90.4736776216441,NaN,NaN,53.165053437655594,49.3834566782042
2017-12-22T09:30:00-05:00,99.04,99.04,98.79,98.98,3221867,5281607.8,75.39933476419617,75.2920235856659,NaN,NaN,110.25980962729881,118.02570630902828,0.009552544259190388,1.3688748630141845,1.359322318754994,594479459,597823754.6,91.0307835943521,89.94315949166126,NaN,NaN,52.87576442334304,49.882357784652605
2017-12-26T09:30:00-05:00,98.86,99.31,98.86,99.2,1498337,5160319.25,76.51184427935074,75.22736226974568,NaN,NaN,116.39236381717232,116.00449990491957,-0.0018494238774704463,1.3570105389081561,1.3588599627856266,595977796,596261186.2,86.69545768895863,89.10212749316564,NaN,NaN,52.95298507706022,50.321018826425124
2017-12-27T09:30:00-05:00,99.38,99.39,98.905,99,1866942,4963429.85,73.26797696750754,75.49600859201792,NaN,NaN,104.60887229041123,112.66234381791551,-0.03405100641773262,1.3162962047634608,1.3503472111811934,594110854,595522172,84.64231361914761,88.55223142711817,NaN,NaN,52.08896248312516,50.5735822059537
2017-12-28T09:30:00-05:00,99.35,99.35,99.06,99.27,4195766,4855881.8,74.82003509772406,75.78438958043348,NaN,NaN,104.42335494908241,111.71435528052893,-0.04752941301759872,1.290935444909195,1.3384648579267937,598306620,596115211,84.95032402268015,88.56390884233171,NaN,NaN,51.78421718283847,50.74653005979438
2017-12-29T09:30:00-05:00,99.3,99.43,98.62,98.69,2630625,4613327.15,65.96053461319333,75.28017852876937,NaN,NaN,70.39225649253598,101.21533143530016,-0.10270262041877842,1.2100865824033207,1.312789202822099,595675995,595710144.8,83.71530992563953,88.46553833753308,NaN,NaN,48.826950044576456,50.47230434333468
2018-01-02T09:30:00-05:00,99.11,100.19,99.11,100.19,4900550,4269351.1,74.40240150773892,75.30905316483653,NaN,NaN,131.61530297921064,105.4864301056825,-0.048142229711035656,1.2526114156833046,1.3007536453943402,600576545,596929562,84.44829620478902,88.4238303330202,NaN,NaN,48.842560733452416,50.23948382763721
2018-01-03T09:30:00-05:00,100.29,100.73,100.27,100.65,5319074,4196658.6,76.34023910213236,75.46262752635678,NaN,NaN,163.08052405876816,114.82406215400167,0.006076264069949877,1.3083489754817776,1.3022727114118278,605895619,598913126.6,85.58490878408104,88.39233023490881,NaN,NaN,49.53772008974109,50.13923186508062
2018-01-04T09:30:00-05:00,101.04,101.11,100.46,100.98,3457382,3995432.9,77.64756477813253,75.68071487773,NaN,NaN,164.98450835127278,126.899189366174,0.04892809511385665,1.3634328303041485,1.3145047351902919,609353001,601961556,87.1404282941657,88.35228010329932,NaN,NaN,50.5369830763984,50.19605346669744
2018-01-05T09:30:00-05:00,101.43,101.83,101.1964,101.78,4294382,3924249.7,80.46553098473896,75.9921561222823,NaN,NaN,201.68448053192589,146.35141448274268,0.11229194333879366,1.454869664363784,1.3425777210249903,613647383,605029708.6,88.48700717777892,88.30660578520828,NaN,NaN,52.38915782851554,50.509354089814316
2018-01-08T09:30:00-05:00,101.83,102.07,101.7,101.9,2670023,3860180.15,80.8554127165512,76.29926873028091,NaN,NaN,193.50387269781956,170.97373772379942,0.14153874147205348,1.519501147865057,1.3779624063930036,616317406,609157990.8,90.00377292506194,88.27944334310844,NaN,NaN,53.95366027284565,51.00139783024736
2018-01-09T09:30:00-05:00,102.2,102.34,101.76,102.1,3160909,3728556.2,81.5175149785866,76.37630144142527,NaN,NaN,167.59328966111033,178.16933506017935,0.1526512857620157,1.5687765135955232,1.4161252278335075,619478315,612938344.8,91.153159809657,88.24966143824436,NaN,NaN,55.420332302050554,51.632674183362106
2018-01-10T09:30:00-05:00,101.73,102.17,101.491,102.03,2838881,3703179.15,80.46855720549222,76.52592679080237,NaN,NaN,131.5257300460139,171.85837625762852,0.13423640073836807,1.5839207287564676,1.4496843280180995,616639434,615087107.8,91.73488735894892,88.21540352407676,NaN,NaN,56.283449238857116,52.297070619861394
2018-01-11T09:30:00-05:00,102.28,103.7,102.18,103.69,3622686,3746361.45,85.29951688363231,77.23806069458702,NaN,NaN,167.63805571263407,172.38908572990076,0.2083782402584644,1.71015712834118,1.5017788880827156,620262120,617268931.6,92.28930949516332,88.19496081868017,NaN,NaN,58.878613143231505,53.23729098034284
2018-01-12T09:30:00-05:00,103.89,105.07,103.76,105.03,4037795,3775607.1,87.90104410207145,77.91839342721774,NaN,NaN,192.63713091077065,170.57961580566973,0.3157496152778514,1.8964659071800298,1.5807162919021784,624299915,619399438,92.79738672726577,88.19095325912069,NaN,NaN,62.17824034693539,54.51456946128464
2018-01-16T09:30:00-05:00,105.56,106.0195,104.01,104.28,9251550,4025818.15,79.4284922841351,78.20619039292764,NaN,NaN,167.74946687003964,165.42873464011376,0.3042214598620825,1.9609931167297816,1.6567716568676991,615048365,619145629.8,92.01948675112767,88.26157491317609,NaN,NaN,61.60962762871013,55.528149199488276
2018-01-17T09:30:00-05:00,104.77,104.99,104.12,104.78,6656143,4022018.3,80.75992832805126,78.50962496783482,NaN,NaN,140.24765619897227,159.95960794768615,0.29785240471988295,2.029087162767553,1.73123475804767,621704508,619590868.4,92.14390006386026,88.65074936852622,NaN,NaN,61.643862088289026,56.401822469316954
2018-01-18T09:30:00-05:00,104.74,104.9162,104.42,104.69,3292300,3886216.3,79.75925468189409,78.97328766171958,NaN,NaN,123.07665052533198,158.26979204354976,0.2567195625435885,2.0521342112271554,1.795414648683567,618412208,619945423.2,92.24754557487925,89.19398022250705,NaN,NaN,61.33393641619165,57.10641017601334
2018-01-19T09:30:00-05:00,105.19,105.61,104.87,105.6,3760384,3774999.85,82.16550556558947,79.49796412370996,NaN,NaN,129.02246443696814,150.5466737884166,0.25918625170206266,2.119397463311145,1.8602112116090825,622172592,620327517.6,92.36445659097012,89.72356112024204,NaN,NaN,61.891569681245315,57.79000439104648
2018-01-22T09:30:00-05:00,105.59,106.77,105.5,106.77,7752314,4039390.55,84.68623153337676,80.83551390372307,NaN,NaN,142.43984018543907,140.50721564335026,0.30485282921316736,2.2412772481255416,1.9364244189123743,629924906,621452515.8,92.71290346621352,90.36624637314017,NaN,NaN,63.280659946692,58.574383756138694
2018-01-23T09:30:00-05:00,107.34,107.8,107.13,107.67,4154888,4129139.9,86.29132935823486,81.68472303590136,NaN,NaN,152.44150940017514,137.44562414937735,0.3572767518752751,2.3830203587564682,2.025743606881193,634079794,625258801.6,93.75182768931197,91.03078433632038,NaN,NaN,65.0050795258785,59.49305458038724
2018-01-24T09:30:00-05:00,108.15,108.76,107.16,108.13,6463963,4291244.7,87.03907751068735,82.44892577936956,NaN,NaN,142.9162354419517,137.97933999797323,0.3822938208471891,2.5036108829401797,2.1213170620929906,640543757,629026651.4,94.57617774028836,91.67301783319233,NaN,NaN,66.62284935194504,60.51159669060978
2018-01-25T09:30:00-05:00,108.59,108.67,107.47,107.94,5070635,4469859.6,84.97729263598157,82.97247776921593,NaN,NaN,126.76581239501517,138.71717237190987,0.34646856236153756,2.5544027650449124,2.207934202683375,635473122,632438834.2,95.19450726872807,92.24830918851822,NaN,NaN,67.21335723349159,61.46899105387861
2018-01-26T09:30:00-05:00,108.18,109,107.91,109,3916294,4572327.2,86.84895037401566,83.4284362970214,NaN,NaN,126.87373691605058,138.28742686772634,0.35336893882056364,2.6496453762090795,2.296276437388516,639389416,635882199,95.724247031854,92.76525489238072,NaN,NaN,68.35789806351933,62.45312062668443
2018-01-29T09:30:00-05:00,108.89,109.3362,108.46,108.7,6355231,4680300.45,83.67166156682515,83.62959692918382,NaN,NaN,120.02893513478415,133.80524585759537,0.29908976431071155,2.670138642776905,2.3710488784661936,633034185,636504054.8,95.81399320004022,93.18027062630775,NaN,NaN,68.24106014645163,63.279969129508316
2018-01-30T09:30:00-05:00,107.89,108.5753,107.5401,108.16,5284063,4812972.35,78.1308681616417,83.38769358511634,NaN,NaN,95.07309794671244,122.33156356690283,0.1933119111295727,2.6126887673781596,2.419376856248587,627750122,635238120.4,91.59896883716863,93.21211412827287,NaN,NaN,66.37419434559288,63.722001303234684
2018-01-31T09:30:00-05:00,108.66,109.04,107.58,107.81,10502354,5093062.55,74.67902411715467,82.97415550737794,NaN,NaN,87.29400779420898,111.20711803735428,0.07248549288277939,2.509983722352061,2.4374982294692815,617247768,630578922.6,77.99881599237247,92.23096617351739,NaN,NaN,63.77575999485624,63.729681116323476
2018-02-01T09:30:00-05:00,107.14,107.97,106.515,106.61,9353417,5294779.7,64.20537982077406,81.4674314314595,NaN,NaN,50.0764576597684,95.86924709030492,-0.10584937725295518,2.3051865079030875,2.4110358851560427,607894351,625063168.4,65.58425819490247,90.32346250921306,NaN,NaN,57.971633229112975,62.907102846721976
2018-02-02T09:30:00-05:00,107.07,107.99,105.36,105.59,10690708,5656446,56.900413501746364,79.2531006742934,NaN,NaN,23.015583251520123,75.09761635739883,-0.29915239070283217,2.0370953967775023,2.3362477874803345,597203643,616626013.8,51.96061369742401,87.40655014993864,NaN,NaN,50.48987248700778,61.13321279533423
2018-02-05T09:30:00-05:00,104.71,106.23,101.1,102.03,23046519,6594052.85,39.856193627932235,76.42650791313606,NaN,NaN,-83.08709560534552,34.474410209372884,-0.653118920303907,1.5198491371004508,2.1729680574043577,574157124,604850601.6,39.597534909591424,83.66212501840032,NaN,NaN,35.63599847107018,57.49075360615365
2018-02-06T09:30:00-05:00,100,104.85,99.74,104.64,22332501,7577176.75,51.35976224698495,74.32649605020276,NaN,NaN,-89.03871584278346,-2.3479525485262913,-0.6939871429886324,1.3054841286685672,1.9994712716571996,596489625,598598502.2,34.855563682099785,79.57010099113174,NaN,NaN,28.271113991133817,53.316519375436535
2018-02-07T09:30:00-05:00,104.72,106.19,104.29,104.32,13137027,8075982.65,50.09465534659888,72.20759609768167,NaN,NaN,-33.747109064888676,-26.556175920345822,-0.721873050763429,1.0971299582029133,1.8190030089663423,583352598,591819468.2,30.579468892458095,75.1652383709588,NaN,NaN,22.579285521122795,48.92548596767743
2018-02-08T09:30:00-05:00,104.46,104.73,100.08,100.16,15741985,8721137.85,37.24920656136207,68.99928902595114,NaN,NaN,-151.36272429959791,-66.84401231221908,-0.9835746040543039,0.5895347538984623,1.5731093579527662,567610613,583762720.6,26.42953345875941,70.45560100437231,NaN,NaN,11.575730775873506,43.58980665456259
2018-02-09T09:30:00-05:00,101.14,101.6659,97.1001,100.83,21263172,9603162.15,39.92125835578197,65.80179094183724,NaN,NaN,-192.67827808403658,-109.98278457933043,-1.0676273646094099,0.23857515219100378,1.3062025168004137,588873785,582096749,25.654245278525565,65.66569684810888,NaN,NaN,4.9108805453996025,38.064245781825015
2018-02-12T09:30:00-05:00,101.79,102.765,100.7453,102.2,12559479,10029246.35,45.07178441752957,62.85753773178687,NaN,NaN,-113.0628192262416,-115.97792930350963,-0.9888214155127477,0.07017574740947907,1.0589971629222268,601433264,587551977,32.62387480066823,61.299414498920044,NaN,NaN,1.8502849874614622,32.89082281120165
2018-02-13T09:30:00-05:00,101.79,102.97,101.62,102.73,5150796,9824208.65,46.96598200341093,59.9951737669814,NaN,NaN,-88.03241178384786,-115.77666849172252,-0.8634230339590447,-0.02028162952657908,0.8431414044324657,606584060,589570864,35.050556104152236,57.047584382053174,NaN,NaN,0.2637967656550757,28.229819090409283
2018-02-14T09:30:00-05:00,102.24,104.57,102.161,104.37,6731343,9827968.65,52.432296728238505,57.67053120214263,NaN,NaN,-48.581238452716924,-118.74349436928817,-0.6425894861742167,0.03990454671469479,0.6824940328889115,613315403,595563425,41.756214730228386,53.23056348644606,NaN,NaN,0.9768061794429063,24.3365315316998
2018-02-15T09:30:00-05:00,105,105.3,103.87,105.3,5590781,9942892.7,55.24915578621585,55.41340301729979,NaN,NaN,-16.466142558334678,-91.76417802103552,-0.41736143445618856,0.16079223981867585,0.5781536742748644,618906184,605822539.2,51.06994743376443,50.040970658011084,NaN,NaN,2.5334710018732145,21.221808598867433
2018-02-16T09:30:00-05:00,104.97,105.63,104.56,104.79,4748646,9992305.8,53.382252829250675,53.249873821758754,NaN,NaN,-10.93127410837434,-55.41477722590307,-0.29213200421608476,0.21298866900475844,0.5051206732208432,614157538,610879289.8,54.89831232523567,47.11842202409648,NaN,NaN,3.137238872498542,18.638298637957593
2018-02-20T09:30:00-05:00,104.51,105.6,104.06,104.47,5875674,9898473.8,52.19059161924561,51.396996925873324,NaN,NaN,-16.885553969551225,-36.179324174565004,-0.22335332223292348,0.22592902042968888,0.44928234266261236,608281864,612249009.8,55.90472170609826,44.56883294330573,NaN,NaN,3.244133119195278,16.439132135277262
2018-02-21T09:30:00-05:00,104.94,106.01,104.32,104.32,4953059,9938382.35,51.60901433688614,49.749139084425565,NaN,NaN,-8.452599549138652,-20.26336172762317,-0.18220429753531497,0.2215269707434686,0.4037312682787836,603328805,611597958.8,55.27337809877655,42.94558737947746,NaN,NaN,3.15867356021919,14.541923767411824
2018-02-22T09:30:00-05:00,104.83,105.2499,104.14,104.45,4443802,9837374.3,52.10712166273456,48.88497778742275,NaN,NaN,-12.453625191636663,-13.037839075407126,-0.14224588029988527,0.22592391790392696,0.36816979820381224,607772607,610489399.6,54.151979022713384,42.12899601003538,NaN,NaN,3.2298815214438052,12.925917732273536
2018-02-23T09:30:00-05:00,105.05,105.91,104.56,105.91,2992964,9733490.75,57.40944217214999,48.921336978165854,NaN,NaN,21.33499184111528,-5.47761219551712,-0.019926699003420256,0.3432614244495369,0.36318812345295715,610765571,608861277,52.46831962332995,42.165260719028666,NaN,NaN,4.868574418972036,11.774868687516179
2018-02-26T09:30:00-05:00,106.31,106.8,106.05,106.8,3898404,9732596.25,60.29520001163407,50.38126600557313,NaN,NaN,67.42453315573285,10.193549257304316,0.1112717886086444,0.5022778592137627,0.39100607060511827,614663975,608962564.4,52.56712313353007,43.09165987788142,NaN,NaN,7.132563182708647,11.111682186829388
2018-02-27T09:30:00-05:00,106.9,106.9,104.52,104.54,6284648,9729067.1,50.869618520929514,50.346255739426326,NaN,NaN,30.19171209826869,19.609002470868298,0.03987875994288065,0.4408545205337191,0.40097576059083845,608379327,608982057,52.58754900731181,44.35823025825372,NaN,NaN,6.218151263608493,10.412606340654975
2018-02-28T09:30:00-05:00,105.1,105.54,104.05,104.07,6049365,9767332.2,49.1488866642065,50.27870083354115,NaN,NaN,6.582762582200785,22.616074897136187,-0.04060943926881416,0.35021396150482076,0.3908234007736349,602329962,608782288.4,52.33879673851262,45.91246796154332,NaN,NaN,4.94832155244469,9.631994228053506
2018-03-01T09:30:00-05:00,104.18,104.68,101.92,102.95,9536608,9719044.9,45.22315655411526,50.84826869016638,NaN,NaN,-45.35008652616654,16.036782630230213,-0.16396791512780245,0.18586350686388187,0.3498314219916843,592793354,605786437.8,48.62417992934853,47.49779985229969,NaN,NaN,2.6460988254681372,8.63400917054131
2018-03-02T09:30:00-05:00,101.81,103.225,101.29,103.05,7265415,9614644.8,45.64064809986517,51.256796529029465,NaN,NaN,-67.53787945041967,-1.7377916280767778,-0.2294987288058593,0.06295801098436016,0.29245673979021947,600058769,603645077.4,46.105366154688525,48.95859420059704,NaN,NaN,0.9254278411494659,7.532783266342475
2018-03-05T09:30:00-05:00,102.67,104.5,102.42,104.28,4994289,9329823.85,50.6254054294302,51.65348374416522,NaN,NaN,-3.5728277186668276,-15.937263802956712,-0.18271201645962493,0.0640667192156883,0.24677873567531322,605053058,601722894,43.90667582422703,49.76450855942267,NaN,NaN,0.9145714683410414,6.587324438056556
2018-03-06T09:30:00-05:00,104.76,105.05,104.0659,105,7575910,8556293.4,53.32363469773335,52.10760179375968,NaN,NaN,42.74643458003217,-13.426319306604018,-0.10011006242866052,0.12164115763948757,0.2217512200681481,612628968,602572822.2,45.15217684198433,50.48605289783926,NaN,NaN,1.7094106131681244,5.890479605929637
2018-03-07T09:30:00-05:00,103.96,104.535,103.44,104.29,5263656,7702851.15,50.39877000797034,51.9623498851691,NaN,NaN,8.37676141868825,-13.067519539306526,-0.09042102786660716,0.10872493523488913,0.1991459631014963,607365312,603579892.2,46.66337204868148,50.836564134871615,NaN,NaN,1.527067701540973,5.267135048159828
2018-03-08T09:30:00-05:00,104.69,104.8,104.295,104.62,4036814,7247840.5,51.72419701555226,51.710567115835985,NaN,NaN,35.63834714647698,3.130167195222181,-0.060363855688623375,0.12369114349071708,0.18405499917934046,611402126,607301646.6,51.934104207584795,50.89828961871593,NaN,NaN,1.753383535243445,4.76517054631463
2018-03-09T09:30:00-05:00,105.33,106.27,105.035,106.24,3624742,6641978.35,57.699918308176365,52.01897179290211,NaN,NaN,99.55279736349316,36.54830255800474,0.06334639168017969,0.26323798877956506,0.19989159709938537,615026868,610295266.4,55.724161719029496,50.95727886112978,NaN,NaN,3.770254080727828,4.623039622659373
2018-03-12T09:30:00-04:00,106.59,107.03,106.34,106.59,4256578,5791648.65,58.88407349554198,52.49707764120899,NaN,NaN,151.034878657363,67.46984383321072,0.1580786643397422,0.3974899275240631,0.2394112631843209,619283446,613141344,59.03160558071521,51.1806277093167,NaN,NaN,5.77735626707274,4.787942000432712
2018-03-13T09:30:00-04:00,107.18,107.4,105.67,105.84,5662857,5446817.55,55.310885011421234,52.76149697510435,NaN,NaN,123.6159612537783,83.64374916795994,0.15912235812625264,0.43831421084213673,0.2791918527158841,613620589,613339668.2,59.25998686505545,51.46538547833662,NaN,NaN,6.463640420110616,5.027327488958127
2018-03-14T09:30:00-04:00,106.39,106.53,105.44,105.71,5122689,5445412.2,54.691381537727835,52.9460869661753,NaN,NaN,84.3195382445999,98.83230453314226,0.14059343309722755,0.45493364408741854,0.314340210990191,608497900,613566185.8,59.53743125084555,51.85006063748892,NaN,NaN,6.856026169405211,5.2885701575934245
2018-03-15T09:30:00-04:00,105.92,106.15,105.42,105.6,3839782,5300834.15,54.138825933650004,52.71247152056816,NaN,NaN,62.82952614336601,104.27054033252007,0.11172399905010849,0.4539952098028266,0.3422712107527181,604658118,612217384.2,57.046209576053236,52.177052776969155,NaN,NaN,7.035608387551316,5.538147047587409
2018-03-16T09:30:00-04:00,105.32,105.87,105.17,105.18,3346756,5188632.9,51.97944138070513,52.11848876121609,NaN,NaN,33.83181751808147,91.12634436343774,0.05784860033986272,0.41458196117754653,0.3567333608376838,601311362,609474283,52.25718835926077,52.154914578807066,NaN,NaN,6.620479378526179,5.692765952007234
2018-03-19T09:30:00-04:00,104.79,104.83,103.11,103.87,5727448,5237573,45.83820956189985,51.759102406999695,NaN,NaN,-75.80213820672179,45.75894099062077,-0.06580538460939661,0.27447663007593803,0.34028201468533464,595583914,604734376.6,45.19663571552189,51.62699220082207,NaN,NaN,4.49903181168722,5.5222325033900885
2018-03-20T09:30:00-04:00,104.06,104.635,104.01,104.49,3706707,5129124.65,48.91449514672252,51.74236015575083,NaN,NaN,-40.24991234514655,12.985766270835796,-0.10339501440716298,0.21103824667638094,0.3144332610835439,599290621,601868383,41.54179814003485,50.85577801521652,NaN,NaN,3.535482588492285,5.238411086976116
2018-03-21T09:30:00-04:00,104.62,105.2,104.09,104.41,5269662,5144954.8,48.53145881913794,51.97866746039531,NaN,NaN,-24.582669701394913,-8.794675318363165,-0.12950736975156513,0.1525490488940875,0.2820564186456526,594020959,598972994.8,38.18254229571309,50.10994675567114,NaN,NaN,2.6346879595891903,4.866450640206556
2018-03-22T09:30:00-04:00,103.6,103.86,102.14,102.19,6906791,5268104.25,39.32798543655583,51.52776298444464,NaN,NaN,-139.80451412250622,-49.32148337153761,-0.2833317660820629,-0.072108288956926,0.2112234771251369,587114168,595464204.8,34.53764138685379,49.2836807008258,NaN,NaN,-1.1047368304980643,4.013423858677324
2018-03-23T09:30:00-04:00,102.48,102.92,100.15,100.18,8944632,5565687.65,33.1907444779939,50.282430059342055,NaN,NaN,-210.15846180057818,-98.11953923526953,-0.49509238666211586,-0.4076420062025079,0.08745038045960793,578169536,590835839.6,30.41342752438382,48.319877250836996,NaN,NaN,-6.600244363710727,2.497185541193317
2018-03-26T09:30:00-04:00,101.8,103.24,100.811,103.14,7280344,5734784.65,46.444914280836784,49.79109288670658,NaN,NaN,-116.29585674401527,-106.21828294272822,-0.41376326367209837,-0.4297536991305151,-0.01599043545841669,585449880,588809032.8,28.792027529508374,47.15129515708872,NaN,NaN,-6.768740500028554,1.1734818210187639
2018-03-27T09:30:00-04:00,103.56,103.78,100.47,101.12,6256719,5733388.2,40.53489031730674,49.08653005165918,NaN,NaN,-130.10104756474283,-124.1885099866475,-0.4698634901597328,-0.6033197981580827,-0.1334563079983499,579193161,584789540.8,25.848892181486434,45.664546595146206,NaN,NaN,-9.145857849809257,-0.3007095605280963
2018-03-28T09:30:00-04:00,100.54,101.21,99.183,99.89,12974378,6079638.85,37.4130371896277,48.064304349807436,NaN,NaN,-180.4868871283618,-155.36935347204087,-0.5576740355236846,-0.8305488524029556,-0.27287481687927106,566218783,579229105.6,22.432703149844684,43.55730366245049,NaN,NaN,-12.170152112563471,-1.996344210818864
2018-03-29T09:30:00-04:00,100,101.79,99.28,101.29,7648492,5985233.05,42.81183694274864,47.0008699665626,NaN,NaN,-130.12668441247584,-153.4337875300348,-0.4916453127670441,-0.8874314578380762,-0.3957861450710321,573867275,576579727,21.00806080709097,41.07758216874059,NaN,NaN,-12.648360045367419,-3.5180607586115147
2018-04-02T09:30:00-04:00,100.68,100.82,97.481,98.43,11888299,6216377.25,35.98317643936177,45.36509160540686,NaN,NaN,-176.96517186354313,-146.7951295426278,-0.6033971406143306,-1.1500325708389454,-0.5466354302246148,561978976,573341615,19.387454393257386,38.24585708392218,NaN,NaN,-15.661152580588197,-5.252788161751041
2018-04-03T09:30:00-04:00,99.01,100.22,98.26,99.68,7307933,6332059.45,40.45366854969578,44.303861858140756,NaN,NaN,-132.40400744786098,-150.0167596833969,-0.5570542954929099,-1.2429532995907522,-0.6858990040978423,569286909,570109020.8,17.902701548812118,35.291765275619085,NaN,NaN,-16.37031540112666,-6.8410063388047
2018-04-04T09:30:00-04:00,98.17,101.71,98.0683,101.51,7442794,6325403.65,46.35948457540669,43.7087263608321,NaN,NaN,-86.89057075873869,-141.3746643221961,-0.37576625624249593,-1.1556068244009623,-0.7798405681584664,576729703,569616329.2,17.68045477749625,32.30198124180842,NaN,NaN,-14.78148845526627,-7.975360926870638
2018-04-05T09:30:00-04:00,102.37,103.2,101.795,102.87,4231570,6273799.35,50.30421189440979,43.43482535802924,NaN,NaN,-17.153994592099714,-108.70808581494369,-0.14853845690329004,-0.9655136392875789,-0.8169751823842889,580961273,572564827.2,23.778683346847174,29.9257293682937,NaN,NaN,-12.103178644592628,-8.565049172259494
2018-04-06T09:30:00-04:00,101.88,102.79,100.03,100.68,8764948,6510206.05,44.61450360665329,42.90875837416839,NaN,NaN,-56.58500875780932,-93.99975068401037,-0.13064232002215692,-0.980278082411985,-0.8496357623898281,572196325,572230637.2,23.565596584515916,27.876329955811922,NaN,NaN,-11.904601293652258,-9.042128046744175
2018-04-09T09:30:00-04:00,101.39,101.981,100.34,100.44,4260137,6541975.8,44.02680503938408,42.77937233684583,NaN,NaN,-58.95571380503028,-70.3978590723078,-0.120147154090815,-0.9998197050033468,-0.8796725509125318,567936188,573422079.6,26.107920259430657,26.51285028037683,NaN,NaN,-11.948596354903982,-9.457337805052719
2018-04-10T09:30:00-04:00,101.73,101.93,100.75,101.66,6416710,6649982.4,47.791688089522445,42.699171832760115,NaN,NaN,-36.767961587292675,-51.270649900194144,-0.021393318469483114,-0.9064141989993857,-0.8850208805299026,574352898,574435277.4,28.29222915140123,25.56645249547443,NaN,NaN,-10.748714766159923,-9.641820228068033
2018-04-11T09:30:00-04:00,101.24,102.265,101,101.35,4790160,6606347.55,46.92793544973475,42.58463444923132,NaN,NaN,-27.80497396787886,-39.45353054202218,0.029910236271912805,-0.8476330851900116,-0.8775433214619244,569562738,573001884.4,27.072938390586245,24.772909359393942,NaN,NaN,-10.06320401678078,-9.702017912169854
2018-04-12T09:30:00-04:00,101.97,102.38,101.425,101.79,3057391,6503082.65,48.3546717942028,43.22939776049181,NaN,NaN,-8.455046822048947,-37.71374098801202,0.09657853349236478,-0.7568201545964683,-0.8533986880888331,572620129,571333655.6,25.68553197184221,24.140615829750256,NaN,NaN,-9.080300274439148,-9.613201106779753
2018-04-13T09:30:00-04:00,102.33,102.51,100.85,101.22,4434239,6532805.5,46.606705671886296,44.187680702912694,NaN,NaN,-16.395580991591924,-29.675855434768543,0.104706328860245,-0.7225157770135269,-0.8272221058737719,568185890,570531568.6,25.021584593357915,23.755484191819836,NaN,NaN,-8.764891655166359,-9.492014042263554
2018-04-16T09:30:00-04:00,101.85,102.37,101.39,101.98,4240664,6577500.9,49.24138494698698,44.38742860763771,NaN,NaN,14.312628758072577,-15.022186922147972,0.16035484529529564,-0.6267785492546523,-0.7871333945499479,572426554,571429641.8,27.28793225989611,23.648048815418953,NaN,NaN,-7.7438837928726345,-9.242281149493422
2018-04-17T09:30:00-04:00,102.97,104.08,102.97,103.88,4075532,6494905.1,55.19392869106599,45.43450277719194,NaN,NaN,120.57205005065397,16.44581540544136,0.3152578975028012,-0.3930610226714464,-0.7083189201742476,576502086,571859479.4,28.403407609825408,23.830514203157456,NaN,NaN,-5.0212651685809835,-8.639278866505931
2018-04-18T09:30:00-04:00,104.24,104.865,104.15,104.37,3298304,6474484.95,56.607238217667174,46.80551713633762,NaN,NaN,169.35313707054493,55.877437613126105,0.433550053389295,-0.16638135343762883,-0.5999314068269238,579800390,573907009.8,33.6268471217694,24.630095915437796,NaN,NaN,-2.358731653871297,-7.742057836129555
2018-04-19T09:30:00-04:00,104.39,104.63,103.5362,104.04,8064537,6614228.7,55.34118654799783,47.700470679569705,NaN,NaN,150.82571683301455,87.73359034413882,0.46937550585229093,-0.013212024511560116,-0.48258753036385105,571735853,573730154.6,33.40018173504693,25.51524741029179,NaN,NaN,-0.5077204511510429,-6.708581066846911
2018-04-20T09:30:00-04:00,104.13,104.2669,102.56,102.98,6255112,6581644.75,51.36706773283578,48.79932005767499,NaN,NaN,96.83441629538447,110.3795898015341,0.4039777005284747,0.022384595296742305,-0.3815931052317324,565480741,573189124.8,32.674581971330866,26.464327951582757,NaN,NaN,-0.018463520114603747,-5.7528499887422955
2018-04-23T09:30:00-04:00,103.16,103.87,102.58,103.2,7041006,6486463.45,52.1353290340026,49.633724377982624,NaN,NaN,83.56635532767552,124.23033511545468,0.3593292420549141,0.06756844733691025,-0.29176079471800387,572521747,573208163.4,32.72996395015515,27.523418123107263,NaN,NaN,0.5977370636816153,-4.8456232669674515
2018-04-24T09:30:00-04:00,103.78,103.99,101.03,101.57,6701998,6457546.15,46.299477930254525,49.629438189043185,NaN,NaN,25.33924500655051,105.18377410663399,0.21114495608654985,-0.02782959960981657,-0.23897455569636641,565819749,571071696,29.770447751373425,28.386989049812772,NaN,NaN,-0.5291680905402102,-4.228986813192131
2018-04-25T09:30:00-04:00,101.38,102.24,100.52,101.99,9397261,6614573.25,47.917232034515216,49.458939627622144,NaN,NaN,-9.80592464982357,69.3519617625603,0.13617945316117955,-0.06875023924489199,-0.20492969240607153,575217010,570155020,28.576491601462138,28.729689639428127,NaN,NaN,-1.0181194479071758,-3.7702914752942807
2018-04-26T09:30:00-04:00,102.6,103.84,102.39,103.64,6484653,6290087,53.80497143899503,50.11540161564655,NaN,NaN,80.07208721204336,55.20123583836606,0.1892212264772777,0.031596840690525596,-0.1576243857867521,581701663,572148182,34.708091323942796,29.525582120815763,NaN,NaN,0.2792230393183537,-3.1917894017781903
2018-04-27T09:30:00-04:00,105.01,105.25,103.86,104.11,4425648,6128944.8,55.353228878953324,50.92443188990149,NaN,NaN,125.0242836033046,60.839209299950085,0.2439788264683827,0.14734914729872628,-0.09662967916965644,586127311,576277496,45.20362322487008,30.889560904061433,NaN,NaN,1.805882499808793,-2.47783627298005
2018-04-30T09:30:00-04:00,104.59,105.125,103.69,103.7,5003100,5784684.85,53.66357322869238,51.34385225698505,NaN,NaN,101.33424423137198,64.39278708068937,0.24022576824720887,0.20365253113935466,-0.03657323710785422,581124211,577997988.8,48.89008615888072,32.36083640459568,NaN,NaN,2.611777412764567,-1.750748603587962
2018-05-01T09:30:00-04:00,103.36,103.89,102.55,103.84,5605364,5699556.4,54.17792338374772,51.86170853798598,NaN,NaN,52.663885553977444,69.85771519017477,0.23454829649318346,0.2566121335086251,0.022063837015441644,586729575,582179954,56.54304771963314,34.46584421381332,NaN,NaN,3.420108062905997,-1.012054794088825
2018-05-02T09:30:00-04:00,103.55,104.08,103.02,103.13,4776889,5566261.15,51.0811327100425,52.05645574626025,NaN,NaN,45.52340270727136,80.92358066159375,0.173182664812813,0.2385421680314579,0.0653595032186449,581952686,583527089.2,58.688931814774335,36.823229916879896,NaN,NaN,3.2873726333125872,-0.39785087588862333
2018-05-03T09:30:00-04:00,102.69,102.94,101.36,102.67,7007745,5705069.9,49.12206139531825,52.23612401221967,NaN,NaN,-23.552389571407012,60.19868530490368,0.09568935879419735,0.1849712017113916,0.08928184291719424,574944941,582175744.8,55.71676985320875,39.01574314972639,NaN,NaN,2.646634148299492,0.037075556138250254
2018-05-04T09:30:00-04:00,102.2,104.27,102.07,104.02,3989646,5466304.8,54.622427600994385,52.620484201791626,NaN,NaN,43.354170894588336,43.864662763160425,0.12744174220375243,0.2485840206718848,0.12114227846813236,578934587,580737200,52.65949166670106,40.827997393069595,NaN,NaN,3.610251809450704,0.5475293066114579
2018-05-07T09:30:00-04:00,104.56,104.67,103.99,104.37,3450033,5425799.6,55.95198591568457,52.67463114640724,NaN,NaN,96.56025545478647,42.909865007843315,0.16189456557257995,0.3235104854338573,0.16161591986127735,582384620,580989281.8,53.144680408186,42.59523116438107,NaN,NaN,4.789030873507589,1.1534581018823338
2018-05-08T09:30:00-04:00,104.1,104.335,103.365,103.93,6097429,5409835.55,53.817189517322085,52.475341953525444,NaN,NaN,59.248637968731636,44.22681549079415,0.14544895358127324,0.3434271118378689,0.19797815825659565,576287191,578900805,48.69212461702786,43.671322414042386,NaN,NaN,5.215724631127576,1.7337818917745111
2018-05-09T09:30:00-04:00,104.09,104.36,103.44,104.29,4024770,5371566.05,55.3192784336073,52.47377708821183,NaN,NaN,67.67713886231179,48.65756272180224,0.1486859179960623,0.3838355557516735,0.2351496377556112,580311961,578572660,48.011487619819114,44.71498712009754,NaN,NaN,5.981850053200474,2.34064877197822
2018-05-10T09:30:00-04:00,104.27,104.77,104.13,104.67,2930771,5365235.05,56.91234499159168,52.86986832098012,NaN,NaN,103.22044350774905,74.01212933763345,0.1650273209570518,0.441433788951926,0.27640646799487417,583242732,580232218.2,51.68947287041589,46.073193612889334,NaN,NaN,7.0628277029130455,3.0152457621117663
2018-05-11T09:30:00-04:00,104.68,105.02,104.54,104.89,4424146,5364730.4,57.84934973482216,53.27801265675294,NaN,NaN,121.12852088120299,89.56699933495638,0.17813873192066043,0.4990798828956997,0.3209411509750393,587666878,581978676.4,55.27538463095353,47.68358080437493,NaN,NaN,8.228527213125572,3.760000255113739
2018-05-14T09:30:00-04:00,105.05,105.425,104.94,105.09,3324860,5318940.2,58.72804041155379,54.165767119702885,NaN,NaN,139.48057231549956,98.151062707099,0.1868559571671929,0.5545110974340304,0.3676551402668375,590991738,583700100,58.54187735199545,49.738682918705074,NaN,NaN,9.452656743453367,4.573236896305114
2018-05-15T09:30:00-04:00,104.53,104.67,103.99,104.48,4558014,5343064.3,54.96448410250811,54.66914226741666,NaN,NaN,60.18824490303124,98.33898409395893,0.1402438303680667,0.5429599282269209,0.40271609785885415,586433724,585729406.6,62.05974817578611,52.13034410258536,NaN,NaN,9.57465962742664,5.2877258578939035
2018-05-16T09:30:00-04:00,104.61,105.57,104.61,105.35,3239196,5340108.9,59.00009985228967,55.040222868366286,NaN,NaN,124.11386776879331,109.62632987525521,0.15552632071641248,0.5971239987543697,0.44159767803795724,589672920,587601598.4,65.00963956740064,54.29474040568949,NaN,NaN,10.772539608818564,6.071270679454569
2018-05-17T09:30:00-04:00,105.12,105.75,104.74,105,6364479,5255106,56.79514669850738,55.14321699833443,NaN,NaN,111.0050151373076,111.18324420116691,0.13058999879543254,0.6048351765322479,0.4742451777368154,583308441,587614740.2,65.03019318388712,55.71092397419071,NaN,NaN,11.213305981175685,6.805847151129014
2018-05-18T09:30:00-04:00,104.84,105.17,104.64,104.87,4108918,5147796.3,55.95863176446956,55.30714975088994,NaN,NaN,80.95911631979288,103.14936328888491,0.09549475272931707,0.5936136186484617,0.49811886591914467,579199523,585921269.2,60.1286912587719,56.5136814813258,NaN,NaN,11.368878474346602,7.457708768731527
2018-05-21T09:30:00-04:00,105.37,105.72,105.1,105.45,8747329,5233112.45,58.86933249798304,55.64225040190676,NaN,NaN,112.05718490486547,97.6646858067581,0.1009647300634764,0.6243247784984902,0.5233600484350138,587946852,585312292,58.42336052167415,56.64798953861443,NaN,NaN,12.275932731431572,8.146026477688675
2018-05-22T09:30:00-04:00,105.83,106.0698,104.91,104.98,2995215,5047773.3,55.65916294714414,55.969252561699726,NaN,NaN,98.38871405390896,105.30477963693366,0.0643347922439792,0.6037785387399879,0.5394437464960087,584951637,585015874.6,57.56752215957179,56.56788884895712,NaN,NaN,12.213921817258479,8.727154383341505
2018-05-23T09:30:00-04:00,104.6,105.75,104.47,105.74,4627171,4809268.8,59.50459404630474,56.710862036770195,NaN,NaN,95.87095845884465,99.65619777494392,0.08158673957626361,0.6414271709663382,0.5598404313900746,589578808,584997052.2,57.509911360122075,56.695970385165204,NaN,NaN,13.217630535979396,9.36865097657549
2018-05-24T09:30:00-04:00,105.63,106.15,105.11,105.97,5483535,4759212.9,60.61771157680477,57.139096606470936,NaN,NaN,124.0628449445405,102.26776373639049,0.09769711856331231,0.6819618295942149,0.5842647110309026,595062343,587347832.6,62.550631740837716,57.40248039046069,NaN,NaN,14.370109497641337,10.083145051013467
2018-05-25T09:30:00-04:00,105.92,106.54,105.81,106.13,3840941,4729977.55,61.412333623890426,57.52912144277135,NaN,NaN,140.4838716737635,114.17271480718462,0.10755754397722095,0.7187116410024288,0.6111540970252078,598903284,591288584.8,69.15638054733151,58.54617325754251,NaN,NaN,15.55776854013394,10.86523412088782
2018-05-29T09:30:00-04:00,105.61,106.07,104.895,105.31,5904282,4775036.65,55.2586076524256,57.63207988099303,NaN,NaN,69.01620106579558,105.56451803937064,0.050197263838753114,0.6739006768236493,0.6237034129848962,592999002,592299014.8,70.58890027530309,60.11022866170503,NaN,NaN,14.934600170274276,11.446572127943028
2018-05-30T09:30:00-04:00,105.8,106.3951,105.56,106.27,4921622,4740849.55,60.27702097437468,57.986204348190704,NaN,NaN,115.23450526519593,108.93367628162805,0.06719230028706902,0.7076937883437324,0.6405014880566634,597920624,594892812.2,73.93546861721391,61.96194159009037,NaN,NaN,15.82710880100805,12.07236308123803
2018-05-31T09:30:00-04:00,106.31,106.34,105.4,105.76,6433519,4823681.05,56.64221851076088,57.96690959955993,NaN,NaN,88.73082768550587,107.50565012696029,0.035935790120590116,0.685421225707401,0.6494854355868109,591487105,595274471.6,74.39710716802095,63.58391546849074,NaN,NaN,15.52432306894039,12.565500222338368
2018-06-01T09:30:00-04:00,106.22,106.65,106.11,106.54,5218729,4734230.25,60.5594653341963,58.16048928522951,NaN,NaN,143.5189986292725,111.39688086390667,0.058317544625652196,0.7223823663688762,0.664064821743224,596705834,595603169.8,74.81088864006227,64.9793086119985,NaN,NaN,16.42975502450611,13.117536622648046
2018-06-04T09:30:00-04:00,106.86,107.77,106.81,107.73,4707410,4770118.45,65.65729608222065,58.65543611884857,NaN,NaN,224.78074681773606,128.25625589270118,0.13917776041033703,0.8380370222561453,0.6988592618458083,601413244,596105161.8,75.46309632757604,66.18796711025426,NaN,NaN,18.872227093575976,13.939635261352036
2018-06-05T09:30:00-04:00,107.79,108.46,107.58,108.36,4580959,4826664.75,68.01438312813445,59.58757176353617,NaN,NaN,235.39884272173504,161.53278422388908,0.2163972106757821,0.969355775190536,0.7529585645147538,605994203,598704202,78.55857363241113,67.36645464287034,NaN,NaN,21.670817501550328,15.044089867094648
2018-06-06T09:30:00-04:00,108.67,109.45,108.17,109.37,5460404,4794813.5,71.40303243585257,60.473495519504944,NaN,NaN,241.57425759858904,186.8007346905677,0.31104422770004214,1.1417638491398066,0.8307196214397644,611454607,601410998.6,81.21633245263945,68.52407556324454,NaN,NaN,25.20987392797701,16.496344732934986
2018-06-07T09:30:00-04:00,109.64,110.08,109.33,109.69,5349890,4861069.5,72.40069422968713,61.588177486017784,NaN,NaN,226.0140487826534,214.25737890999716,0.36690983216457584,1.2893569116454842,0.9224470794809083,616804497,606474477,84.96960645012501,69.94831936797581,NaN,NaN,28.386918843005983,18.194998177230843
2018-06-08T09:30:00-04:00,109.3,110.2816,109.2,109.92,3843944,4906728.15,73.12638563566954,62.81444561967492,NaN,NaN,182.7025181303029,222.09408281020328,0.3889595797885894,1.408646554216645,1.0196869744280557,620648441,611262998.4,87.51111073475079,71.90420647340288,NaN,NaN,31.192492696659357,20.051783108577773
2018-06-11T09:30:00-04:00,109.93,110.6,109.93,110.36,3184554,4844748.55,74.50733750437064,63.93144597727404,NaN,NaN,165.66278243093822,210.2704899328437,0.4011735111019896,1.5211538633055426,1.119980352203553,623832995,615746948.6,89.33043903316202,74.11185493850915,NaN,NaN,33.96631714580545,22.039573685324584
2018-06-12T09:30:00-04:00,110.56,111.09,110.49,110.89,3488238,4852917.45,76.10046244086809,65.39153879825432,NaN,NaN,153.12487977179083,193.8156973428549,0.41141150300403706,1.6342447309585992,1.2228332279545622,627321233,620012354.6,90.7159473382811,76.47959959413126,NaN,NaN,36.80705130507724,24.149213345289247
2018-06-13T09:30:00-04:00,110.98,111.635,110.86,111.06,5052535,4877643.5,76.60548003960382,66.61303065491853,NaN,NaN,140.7129516138437,173.6434361459058,0.39596227290068464,1.717786069080418,1.3218237961797334,632373768,624196186.8,91.83583151571307,78.93145103381632,NaN,NaN,39.29630686710432,26.313083848405686
2018-06-14T09:30:00-04:00,111.42,112.235,111.37,112.22,4191786,4925273,79.74988366685058,67.97961437563609,NaN,NaN,141.9513014542358,156.83088668022228,0.427499672923803,1.8561983873344872,1.4286987144106842,636565554,628148398.2,92.72817036475179,81.08698950695303,NaN,NaN,42.54836692612665,28.632410002365823
2018-06-15T09:30:00-04:00,111.42,112.21,111.35,112.11,9130006,5063549.35,78.67005958480621,69.21230908713008,NaN,NaN,121.6115697669391,144.6126970075495,0.4048113485282798,1.934712900071034,1.529901551542754,627435548,629505819.6,93.01072921665295,82.79087155476171,NaN,NaN,44.87313937206719,30.95251419803745
2018-06-18T09:30:00-04:00,111.37,112.15,111.16,111.92,4024162,5059311.55,76.73731203074647,70.74650225701014,NaN,NaN,104.43531680406268,132.3672038821744,0.3432966899958809,1.9590224140376051,1.6157257240417242,623411386,629421497.8,92.76958287047115,84.37520602584515,NaN,NaN,46.26090630558034,33.13942735625786
2018-06-19T09:30:00-04:00,110.93,111.79,110.7359,111.78,6169750,4930432.6,75.26991976921306,71.8174235994986,NaN,NaN,85.65248354591479,118.8727246369992,0.2630795780586024,1.9445751966149771,1.6814956185563747,617241636,627405578.4,86.96451007510016,85.30585184426559,NaN,NaN,47.01980239041494,35.12233807542316
2018-06-20T09:30:00-04:00,112.36,112.6,111.91,112.31,3943049,4977824.3,77.05844476875014,73.27572547506927,NaN,NaN,100.04212710173897,110.73855973457826,0.21750346739803006,1.9533749528039124,1.7358714854058823,621184685,625167761.8,80.91179912344907,85.77118698393903,NaN,NaN,48.17776823294291,36.987399526497406
2018-06-21T09:30:00-04:00,112.47,112.62,111.32,111.51,6850371,5088984.3,68.9522550379796,73.87521045391092,NaN,NaN,79.94730981874578,98.33776140748026,0.11065561298564552,1.8741910016379393,1.7635353886522938,614334314,620721513.8,70.42404028591316,85.45784067292837,NaN,NaN,46.84725159065,38.39594982137635
2018-06-22T09:30:00-04:00,112,112.16,111.24,111.32,5568005,5093207.8,67.14565207589143,73.98152159631597,NaN,NaN,67.1451856154408,87.44448457718059,0.00968152611001738,1.7756372962898155,1.765955770179798,608766309,616987666,63.034814683321514,84.57010626976735,NaN,NaN,45.22224976838085,39.37113552809128
2018-06-25T09:30:00-04:00,110.86,110.86,108.27,108.9,12066759,5504498.7,49.39411689478076,72.65150257964787,NaN,NaN,-9.189508684793097,64.71951947940944,-0.22465322505134755,1.4851392388656137,1.7097924639169613,596699550,611645298.8,54.26205845775027,82.8346409001487,NaN,NaN,37.252606369505884,39.06848850543622
2018-06-26T09:30:00-04:00,109.31,110.03,109,109.68,4632899,5440929.55,53.64768482253598,71.38326346441097,NaN,NaN,-9.707646820351416,45.647493406156194,-0.32556308772681697,1.3028386042584401,1.628401691985257,601332449,608463461.4,49.8152650150875,80.59170751175215,NaN,NaN,32.13595332384185,38.07812633663703
2018-06-27T09:30:00-04:00,110.12,110.52,108.24,108.26,6850627,5537379.8,46.057818096126844,69.50162945487094,NaN,NaN,-41.44141407456812,17.350785170894778,-0.47721178968916744,1.031886954873798,1.5090987445629653,594481822,603122888.8,43.38814642856626,77.62160322449795,NaN,NaN,24.91279759650039,36.19736508804608
2018-06-28T09:30:00-04:00,108.37,109.355,107.8,109.11,5973916,5514399.65,50.566216442262935,67.89018879819903,NaN,NaN,-64.87086372063395,-11.61284953698117,-0.5067591785325729,0.8756497713972493,1.3824089499298222,600455738,600347173.6,40.46591255594419,74.26123192601176,NaN,NaN,20.654155099498052,33.9769065182535
2018-06-29T09:30:00-04:00,109.9,110.35,109.28,109.3,5741368,5540531.6,51.54117468076218,66.24974859651272,NaN,NaN,-33.87806607002406,-31.817499874074134,-0.49919155830558326,0.7584195020478433,1.2576110603534265,606197106,599833333,39.92977170859272,70.73261283139966,NaN,NaN,17.688784540442153,31.650031949994737
2018-07-02T09:30:00-04:00,108.51,109.48,108.22,109.45,6898739,5650098.05,52.3403378538318,64.55259684029585,NaN,NaN,-75.02250819645035,-44.984099776405586,-0.47017262460293563,0.669895279599757,1.1400679042026927,613095845,603112592,44.943175690741114,67.46312914228966,NaN,NaN,15.59680954215357,29.356714463160284
2018-07-03T09:30:00-04:00,109.96,109.96,108.72,108.9,2909264,5566513.3,49.14029044009584,62.590797583188134,NaN,NaN,-72.81407770634074,-57.605385953603445,-0.4728303898057087,0.5490299169455568,1.0218603067512655,610186581,604883418.4,47.49168628146616,64.29569019698631,NaN,NaN,12.85438908092558,26.999239408555326
2018-07-05T09:30:00-04:00,109.53,109.63,108.56,109.44,3788631,5482924.65,52.22848504045103,60.624983395588174,NaN,NaN,-73.08667561605608,-63.934438261901036,-0.424564242095699,0.4911550041316417,0.9157192462273407,613975212,608782096.4,52.68452196131121,61.43542959674057,NaN,NaN,11.495232849205008,24.784381328648138
2018-07-06T09:30:00-04:00,109.48,110.46,109.22,110.3,5185027,5474681.5,56.734211113618265,59.05813707621761,NaN,NaN,-26.69074036622766,-56.29841359101978,-0.32552084334119,0.5088181920508532,0.8343390353920432,619160239,612522996.6,57.07150183678007,58.86834192674966,NaN,NaN,11.72913920916825,22.91934674015101
2018-07-09T09:30:00-04:00,110.99,111.64,110.745,111.62,3730730,5469020.8,62.5697232026955,58.04616644564254,NaN,NaN,50.47032430033268,-39.42873551694843,-0.16974521277076793,0.6221575194285833,0.7919027321993513,622890969,615861769.2,60.58410586228188,56.56937928330756,NaN,NaN,13.883937972146821,21.628574059007555
2018-07-10T09:30:00-04:00,111.84,111.97,111.34,111.86,3179634,5468774.8,63.53279533154867,57.2078004143808,NaN,NaN,67.06563868016072,-11.011106141626211,-0.05511312759288456,0.7230113227082455,0.7781244503011301,626070603,618456720.8,63.11056679290363,54.8655261917221,NaN,NaN,15.906776157714104,20.811174358822775
2018-07-11T09:30:00-04:00,111.16,111.84,111.07,111.6,4432410,5515983.4,61.681244277879415,56.10942895074718,NaN,NaN,50.86413832243434,13.724537064128807,-0.0040614408524862755,0.7730476492355223,0.7771090900880085,621638193,620747043.2,65.22898000596413,53.745324826187456,NaN,NaN,16.996251881809947,20.266185433535227
2018-07-12T09:30:00-04:00,112.02,112.43,111.53,112.34,2914209,5409067.1,64.82344608535868,55.814514025559966,NaN,NaN,79.41571411475029,44.22501501029008,0.06828999078936338,0.8624715785747128,0.7941815877853494,624552402,622862481.2,67.1078196734352,53.50845192529617,NaN,NaN,18.902667184014643,20.071397112175145
2018-07-13T09:30:00-04:00,112.41,112.77,112.23,112.59,5523716,5475663.6,65.84251039780293,55.72143247712507,NaN,NaN,99.26505077609748,69.41617323875512,0.11877260631577813,0.9426473456800721,0.823874739364294,630076118,625045657,68.97123584045136,53.932482007948295,NaN,NaN,20.770546751119902,20.171275632024397
2018-07-16T09:30:00-04:00,112.87,113.05,112.435,112.87,3096416,5173984.1,66.9957534075717,56.97869222803871,NaN,NaN,107.09365875457112,80.7408401296028,0.15454571256544103,1.0170568800710953,0.8625111675056543,633172534,627101970,70.65740415584943,55.103578129241086,NaN,NaN,22.661855482429914,20.5270727535109
2018-07-17T09:30:00-04:00,111.7,113.23,111.47,112.98,4071940,5176373,67.46055157829616,57.96532556773587,NaN,NaN,90.64269628327524,85.45625165022571,0.1680226542398181,1.0725394853054269,0.9045168310656088,637244474,629336744.2,72.41203296327194,56.71763298268284,NaN,NaN,24.35610334403201,21.074077123585344
2018-07-18T09:30:00-04:00,112.91,113.31,112.55,112.91,6406110,5188191,66.81569502828704,59.448031062890166,NaN,NaN,100.17849577653587,95.319123141046,0.15494817125105387,1.098202045129426,0.9432538738783722,630838364,631176778.4,73.80117139560896,58.889991908900164,NaN,NaN,25.600316212147284,21.72068270766562
2018-07-19T09:30:00-04:00,112.66,113.3,112.57,112.65,3609662,5171521.65,64.35501243248382,60.432945062191656,NaN,NaN,93.08185028123063,98.05235037434208,0.11343864132238968,1.0850521755313594,0.9716135342089697,627228702,631712038.4,74.20802116126903,61.30014252356623,NaN,NaN,26.03140844526022,22.336500670179134
2018-07-20T09:30:00-04:00,112.66,112.83,112.105,112.15,3334241,4995715.15,59.79444105305861,61.02246408878427,NaN,NaN,67.97659186916094,91.79465859295479,0.04070778407422071,1.0224982643017455,0.9817904802275248,623894461,630475707,71.44809389714779,63.55145125132015,NaN,NaN,25.19238585906801,22.74448426859183
2018-07-23T09:30:00-04:00,112.13,112.25,111.42,112.03,3369156,4885772.7,58.71893958395723,61.47807849807894,NaN,NaN,45.282266108117526,79.43238006366406,-0.023621393584728367,0.9522637382466144,0.9758851318313427,620525305,627946261.2,66.03672115920187,65.05813307049593,NaN,NaN,24.199701790562536,22.952372486016216
2018-07-24T09:30:00-04:00,112.71,112.89,111.44,111.7,4825617,4523715.6,55.74927890243535,61.95014910253177,NaN,NaN,45.8097804914869,70.46579690530639,-0.0926601909205449,0.8600598931806616,0.9527200841012065,615699688,623637304,57.98051849721741,65.80733537162101,NaN,NaN,22.54611856433594,22.89433621149046
2018-07-25T09:30:00-04:00,111.39,112.56,111.06,112.52,6269782,4605559.75,61.024117529910235,62.578408566064574,NaN,NaN,43.56195251339605,59.14248825267843,-0.08743025408312322,0.8434322664973024,0.9308625205804256,621969470,621863525.2,55.005673572655404,65.97313191528845,NaN,NaN,22.47631853896132,22.834619401129157
2018-07-26T09:30:00-04:00,112.4,112.79,111.691,111.93,5802016,4553129.2,55.86417289911563,62.51626297931438,NaN,NaN,44.3332884680693,49.39277589004617,-0.12570791016999538,0.7737276328679314,0.8994355430379268,616167454,619651275.6,51.459445316800526,65.5722707352899,NaN,NaN,20.92515922185991,22.561839375519263
2018-07-27T09:30:00-04:00,113.41,113.57,111.14,111.64,6548826,4581874.7,53.470902772928916,61.86634723433105,NaN,NaN,39.03761764717961,43.60498104564989,-0.16981689173610648,0.6871644283677938,0.8569813201039003,609618628,616796109,47.227534692323346,64.61822993743573,NaN,NaN,18.928052474943495,22.042726961151295
2018-07-30T09:30:00-04:00,111.65,111.83,110.44,110.75,6566161,4623114.35,46.83893977106896,60.67392898001107,NaN,NaN,-38.57102486163444,26.834322851699504,-0.25317212068463435,0.5405161692481073,0.7936882899327417,603052467,613301541.4,42.60885422890346,63.15382189715,NaN,NaN,15.086651458746282,21.049001889379152
2018-07-31T09:30:00-04:00,111.07,111.725,110.48,111.27,6154738,4585914.3,50.68734654620028,59.88865057060542,NaN,NaN,-41.22407434547584,9.427551884306956,-0.2661965818694365,0.460942562595946,0.7271391444653825,609207205,612003044.8,41.00419440382085,61.423480068425484,NaN,NaN,12.958151712204488,19.893166149782772
2018-08-01T09:30:00-04:00,111.38,111.48,110.24,110.72,5218625,4701382.35,46.826167174972184,58.603130648434956,NaN,NaN,-86.0431246107078,-16.493463540513815,-0.3021345010049,0.3494710182092575,0.6516055192141575,603988580,608406866.8,36.8635723643935,59.263176689208215,NaN,NaN,9.948569971397468,18.472509552870587
2018-08-02T09:30:00-04:00,110.2,111.56,110.03,111.48,4361522,4730026.9,52.240173368945065,57.63153514637368,NaN,NaN,-88.31437843737416,-43.022996921602505,-0.26626044132625537,0.3187799675563383,0.5850404088825937,608350102,606843396.4,35.19937282331922,56.85090075941307,NaN,NaN,9.016081536227723,17.12159126477875
2018-08-03T09:30:00-04:00,111.7,112.01,111.49,111.86,3285887,4635069.9,54.72249448853846,56.754873795014156,NaN,NaN,-18.95547374113347,-54.621615199265115,-0.21090045288956594,0.32141484277063626,0.5323152956602022,611635989,607246868.6,36.00230880686876,54.37553680591444,NaN,NaN,9.010922475487265,15.962924294879967
2018-08-06T09:30:00-04:00,111.93,112.73,111.61,112.61,3625307,4629798.75,59.226842297613125,56.166751703536804,NaN,NaN,45.13425157724387,-37.88055991148948,-0.12213590347894687,0.3796454163115186,0.5017813197904655,615261296,609688634.4,40.784349730602614,52.116416575009495,NaN,NaN,10.441335199924136,15.174125852743419
2018-08-07T09:30:00-04:00,112.84,113.295,112.62,113.13,3220519,4631843,62.04608684273437,55.826065404568745,NaN,NaN,124.81966899659588,-4.671811243075135,-0.031486897008811354,0.4624226985294513,0.49390959553826264,618481815,611543556.4,44.19567528767484,50.00173828158563,NaN,NaN,12.53907877035928,14.79769055525997
2018-08-08T09:30:00-04:00,113.08,113.43,112.86,113.25,2729031,4546674.05,62.687264059958366,55.706940520816936,NaN,NaN,130.93582025929086,38.7239777309246,0.030135979409061542,0.5315795697995895,0.501443590390528,621210846,614988009.6,49.96041477399308,48.269766396780206,NaN,NaN,14.42317190524261,14.744187890971777
2018-08-09T09:30:00-04:00,113.21,114.07,113.0001,113.67,5537465,4677836.85,64.92094982274803,56.07311971865189,NaN,NaN,151.65921977115696,86.71869737263083,0.08941207998329448,0.6132086903696461,0.5237966103863516,626748311,618667651.4,55.27568627336048,47.114594423652534,NaN,NaN,16.694289731853097,15.022773868240536
2018-08-10T09:30:00-04:00,113.04,113.25,112.43,112.72,4946200,4648961.05,56.658828460834734,55.92596892414314,NaN,NaN,62.76579012880783,103.0629501466191,0.05647592813543589,0.5943915205556465,0.5379155924202106,621802111,620700875.8,57.934582615674444,46.53587024197201,NaN,NaN,16.154808700161126,15.184493129943478
2018-08-13T09:30:00-04:00,113.04,113.14,112.12,112.15,5984741,4793377.3,52.3536642422586,55.68342501984481,NaN,NaN,29.62936320634414,99.96197247243914,-0.00840851739152837,0.5274049456808001,0.5358134630723285,615817370,620812090.6,58.081382808069506,46.543074835604294,NaN,NaN,14.338803379881401,15.063680308506038
2018-08-14T09:30:00-04:00,112.81,113.4,112.425,113.24,4190463,4799303.45,58.800548734437804,55.52459867731106,NaN,NaN,84.87440412905421,91.9729194989308,0.016040302045054244,0.5558638406286462,0.539823538583592,620007833,621117294.2,58.50930409560092,46.79333415867183,NaN,NaN,14.86376407747796,15.035120846930598
2018-08-15T09:30:00-04:00,112.65,112.65,111.2,111.86,6237617,4790878.8,49.64235137533353,55.08018285418376,NaN,NaN,-30.033717308571923,59.77901198535825,-0.06246635494939157,0.4617405948968525,0.524206949846244,613770216,619629168.2,55.532573834135555,47.08427190991005,NaN,NaN,12.070980730600075,14.611672258883381
2018-08-16T09:30:00-04:00,112.61,112.96,112.29,112.41,3840119,4802401.65,52.79778660324042,55.03210312777744,NaN,NaN,44.75946970073312,38.39906197127349,-0.07807759667934866,0.42660995399705826,0.5046875506764069,617610335,617801573,52.031465149763626,47.42740979972721,NaN,NaN,10.92385226329885,14.084840830942733
2018-08-17T09:30:00-04:00,112.29,112.71,111.75,112.51,3011276,4786253.4,53.36990006487599,55.498600291620804,NaN,NaN,18.87137422165201,29.62017878984232,-0.08198883760202208,0.4022015036738793,0.4841903412759014,620621611,617565473,51.57905552355737,48.06813846363106,NaN,NaN,10.217712463554603,13.532393921315858
2018-08-20T09:30:00-04:00,112.89,113.365,112.58,113.31,6569293,4946260.25,57.7787522339743,56.00512926931895,NaN,NaN,93.72610550440383,42.43952724945425,-0.033502477155272214,0.4423122448318111,0.4758147219870833,627190904,619840179.8,55.58588547967114,49.109687826191795,NaN,NaN,11.055757127255863,13.178588665021573
2018-08-21T09:30:00-04:00,113.64,114.59,113.59,114.21,4171631,4913560.95,62.118133106439274,57.097412550138024,NaN,NaN,173.92853759032008,60.25035394170742,0.05174207488912108,0.5404923155984847,0.48875024070936357,631362535,622111120.2,59.21448163428052,50.70618134546943,NaN,NaN,13.222871826037498,13.184914830880992
2018-08-22T09:30:00-04:00,114.22,114.89,114.2,114.33,2757427,4737943.2,62.66905384835826,57.84233258438183,NaN,NaN,172.0319729088148,100.66349198518476,0.10566158059150543,0.6208272164487454,0.51516563585724,634119962,626181069.4,64.76970850554721,52.81834817991429,NaN,NaN,15.103728358712178,13.45903104914259
2018-08-23T09:30:00-04:00,114.42,114.84,114.01,114.22,3994524,4647568.6,61.78206875966139,58.34658788946204,NaN,NaN,138.95490410257185,119.50257886555251,0.12220171773366562,0.6679177830243219,0.5457160652906563,630125438,628684090,67.68486520248392,55.081387922458234,NaN,NaN,16.35534048440695,13.872789539894642
2018-08-24T09:30:00-04:00,114.44,115.03,114.26,114.89,5259253,4583089.95,65.02876016575419,58.761010594329264,NaN,NaN,143.0921988799667,144.34674379721542,0.1639453848449014,0.750647796346783,0.5867024115018816,635384691,631636706,70.75862986861999,57.222407932316614,NaN,NaN,18.427428959109083,14.523452314068134
2018-08-27T09:30:00-04:00,115.46,115.805,115.35,115.63,3016038,4405583.8,68.23814164301261,59.20330022292056,NaN,NaN,178.49349905320693,161.30022250697607,0.22339143603156275,0.8659417065413351,0.6425502705097723,638400729,633878671,72.86890241257325,59.270495584095066,NaN,NaN,21.225621516459412,15.480905057266888
2018-08-28T09:30:00-04:00,115.93,116.01,115.45,115.86,3810009,4288347.35,69.184721395136,59.667404318290394,NaN,NaN,164.53157532245552,159.42083005340314,0.2577605755542326,0.964750989952563,0.7069904143983304,642210738,636048311.6,74.76673513686671,61.042375610014616,NaN,NaN,23.80070181786906,16.66944745163863
2018-08-29T09:30:00-04:00,116.17,117.24,115.9399,117.16,8311844,4443008.3,73.91643503583381,60.30993897636795,NaN,NaN,187.5186236752562,162.51816020669145,0.3423077173739242,1.1348750611157357,0.7925673437418115,650522582,639328835.6,77.34695790432384,62.61889501222628,NaN,NaN,27.720837774022478,18.248217497693464
2018-08-30T09:30:00-04:00,116.97,117.16,116.09,116.49,4421818,4446023.1,68.11160383230592,61.12799436004446,NaN,NaN,150.7720637701163,164.88159214020033,0.3273723717918049,1.2017828084815676,0.8744104366897627,646100764,642523900.8,79.54120255521089,64.16222500790745,NaN,NaN,29.150268347617576,19.805653333396908
2018-08-31T09:30:00-04:00,116.41,117.18,116.41,116.95,4104416,4486949.55,69.86159767703228,62.37856103395687,NaN,NaN,141.973904558459,164.65793327589878,0.32223407815522054,1.2772030343837883,0.9549689562285678,650205180,645487998.6,81.34637708385563,65.82401031332076,NaN,NaN,30.87895700555948,21.387553857991563
2018-09-04T09:30:00-04:00,116.83,117.44,116.36,117.17,4453724,4528370.4,70.69005173328708,63.227811248160386,NaN,NaN,130.196750426445,154.99858355054639,0.3074550687591011,1.3392877921774442,1.031832723418343,654658904,648739633.6,83.10726975254182,67.58100786024511,NaN,NaN,32.53151186297757,22.97954785870385
2018-09-05T09:30:00-04:00,117.08,117.1,115.825,115.91,7114947,4723091.8,60.442438465758336,63.99924604033358,NaN,NaN,86.48521107427949,139.38931070091118,0.1922572908467064,1.272154336976726,1.0798970461300197,647543957,649806277.4,83.65243124499052,69.5895691038776,NaN,NaN,30.711237558214187,24.0840749586339
2018-09-06T09:30:00-04:00,116.22,116.58,115.08,115.59,5592536,4866267.05,58.137369508187135,64.38064481925835,NaN,NaN,56.22141109365697,113.12986818459134,0.07970824286972666,1.179532349717178,1.0998241068474512,641951421,648092045.2,79.22721369503255,71.53212257139681,NaN,NaN,28.511239827829282,24.716527082804667
2018-09-07T09:30:00-04:00,115.05,116.295,114.8,115.58,4460798,4812433.7,58.06284913983177,64.71585546746948,NaN,NaN,42.94499965839493,91.56445536224709,-0.005678820850074429,1.0927255807848582,1.0984044016349326,637490623,646370017,74.93860000322366,73.20066146280155,NaN,NaN,26.737027310941457,25.005169972538493
2018-09-10T09:30:00-04:00,116.37,116.45,115.7,116.01,4054886,4767868,60.4126404313867,64.90399033871321,NaN,NaN,59.02359530997045,74.97439351254937,-0.04147243281573387,1.0465638606152652,1.088036293430999,641545509,644638082.8,70.78829684495207,74.28654798889305,NaN,NaN,25.9048654172161,25.133697893206723
2018-09-11T09:30:00-04:00,115.76,117.02,115.555,116.94,4888002,4713031.05,64.98261008718768,65.10859583733811,NaN,NaN,72.83127391213536,63.50129820968745,-0.012302113749111943,1.072658651244609,1.084960764993721,646433511,642993004.2,66.99301761282925,74.84215770164653,NaN,NaN,26.54714002165229,25.335618197270374
2018-09-12T09:30:00-04:00,116.96,117.23,116.18,117.16,4572807,4732148.25,65.983017682946,65.34530753980866,NaN,NaN,82.78790480807862,62.76183695644727,0.010774680096076406,1.0984291151138166,1.0876544350177402,651006318,643685476.4,67.77619381206188,75.05690665211185,NaN,NaN,27.368806039046934,25.626073603238453
2018-09-13T09:30:00-04:00,117.6,117.74,117.11,117.36,4714434,4655989.1,66.90856952184177,65.71148616567869,NaN,NaN,106.31775033285611,72.78110480428708,0.027521535765913097,1.1220563547251317,1.0945348189592186,655720752,646439342.6,70.74870770481697,75.27575254513566,NaN,NaN,28.3142605274369,26.010100306695374
2018-09-14T09:30:00-04:00,117.36,117.58,116.44,116.92,3103169,4619141.6,62.85662591218098,65.55633371899489,NaN,NaN,80.6924112257974,80.33058711776759,-0.0014830210186804749,1.092681042685868,1.0941640637045484,652617583,649464734.6,73.62697130493112,75.48063407630073,NaN,NaN,27.973657772013528,26.290608516026538
2018-09-17T09:30:00-04:00,116.75,116.77,115.37,115.47,5179235,4727539.55,51.73715337293456,64.3776916997036,NaN,NaN,2.9880072495308823,69.12346950567968,-0.1220956703341316,0.941544475786884,1.0636401461210157,647438348,650643302.4,74.67249878799582,75.60946238883092,NaN,NaN,24.083634651637258,25.975326535399496
2018-09-18T09:30:00-04:00,115.56,117.065,115.55,116.94,3668182,4582484,59.54964364718857,63.689471860564495,NaN,NaN,44.32086546049966,63.42138781535253,-0.1071779238464945,0.9296677413128975,1.036845665159392,651106530,651577906.2,75.50190154768146,75.66197427531769,NaN,NaN,23.223504247423644,25.58220906568866
2018-09-19T09:30:00-04:00,117.09,117.27,116.5,116.99,3173661,4532585.5,59.788077952575534,62.68030349747462,NaN,NaN,73.0655581291101,61.47691847955883,-0.0984711663036264,0.9137567072798589,1.0122278735834853,654280191,652232680.8,76.09258488310958,75.5723762023738,NaN,NaN,22.636175174335992,25.161347081209705
2018-09-20T09:30:00-04:00,117.53,117.965,117.3,117.79,4834779,4636453.1,63.49569708465996,62.350595872642764,NaN,NaN,136.65215623987467,67.54379966096255,-0.04602607535220038,0.9546952793932348,1.0007213547454352,659114970,652911524.4,76.71931516881916,75.37081281763155,NaN,NaN,23.338302735536434,24.90091217468495
2018-09-21T09:30:00-04:00,118,118.08,116.88,116.92,8053639,4839408.85,57.30747996684234,61.453873179057766,NaN,NaN,94.21662311641573,70.2486420390862,-0.07538649854135282,0.9064882315687441,0.981874730110097,651061331,652600274,75.73894032793172,74.97028162077983,NaN,NaN,21.898892999941097,24.472052292578685
2018-09-24T09:30:00-04:00,116.53,116.53,115.73,116.16,4841672,4818529.8,52.49449979793945,60.1541908979615,NaN,NaN,-49.071618323463916,59.836716924487256,-0.14729014715902955,0.79776204616131,0.9450521933203395,646219659,652356536.2,74.9314281103587,74.38629293205247,NaN,NaN,19.101627605542102,23.704848765859172
2018-09-25T09:30:00-04:00,116.44,116.73,116.18,116.65,4095068,4872481.3,55.11207667721991,59.773450770208754,NaN,NaN,-6.4162002592639675,49.68930378053453,-0.16198197338918852,0.7425747265838538,0.9045566999730423,650314727,652198175.6,74.37657885137703,73.72373204679435,NaN,NaN,17.652606067338468,22.8402426660705
2018-09-26T09:30:00-04:00,116.62,117.775,116.49,116.92,6730107,5018486.2,56.53330716824732,59.65887488878449,NaN,NaN,63.71838205571318,47.819868565855145,-0.15371506427292148,0.7124128696318905,0.866127933904812,657044834,652751104.2,75.07068819271935,73.4268373680577,NaN,NaN,16.917965261722088,21.994203036877867
2018-09-27T09:30:00-04:00,116.94,117.62,116.75,117.32,5309562,4868372.1,58.62342353880027,59.698915917282235,NaN,NaN,81.17977528089725,36.72539237405966,-0.12284478564128443,0.7125719518532065,0.835416737494491,662354396,653398989.4,75.89466985532412,73.49512807177916,NaN,NaN,16.93733378450996,21.27179314368245
2018-09-28T09:30:00-04:00,117.1,117.73,117.09,117.22,3503939,4822478.15,57.874179310194656,59.51759726576852,NaN,NaN,87.16824933040506,35.315717616857526,-0.1110542677074422,0.6965989028601882,0.8076531705676304,658850457,654956814.6,77.79513836336697,73.99561675166593,NaN,NaN,16.738441787818324,20.624171521416148
2018-10-01T09:30:00-04:00,117.91,118.13,116.86,116.86,7849543,5009734.5,55.14192370066097,58.81469109530233,NaN,NaN,72.99954202213108,59.729949685976536,-0.12818013002811102,0.6474280080324917,0.7756081380606027,651000914,655913065.6,78.89507885102665,74.84576398296575,NaN,NaN,15.795415198018157,19.93434918950215
2018-10-02T09:30:00-04:00,116.88,116.9,115.25,115.28,9177045,5245900.55,45.08229849274155,57.3217825817163,NaN,NaN,-101.67822329414432,40.67754507900047,-0.24009785469996647,0.47548581968564463,0.7155836743856111,641823869,654214894,72.06766939819983,75.15229795340417,NaN,NaN,11.666463582184857,18.75322267417111
2018-10-03T09:30:00-04:00,115.85,115.95,114.84,114.89,9161634,5348234.9,42.997173937578474,55.613825754268916,NaN,NaN,-151.2915806377603,-2.324447459694227,-0.32907211868676867,0.3042435260271503,0.633315644713919,632662235,649338374.2,56.8527235536481,74.1597276568921,NaN,NaN,7.626961498637838,17.16375679195207
2018-10-04T09:30:00-04:00,114.67,114.795,112.7073,113.09,12959856,5716600.9,34.96020176830969,53.62122402970668,NaN,NaN,-272.5202287568994,-73.06444826725355,-0.48823457212363464,0.023022429559375723,0.5112570016830104,619702379,640807970.8,40.67541719369026,71.8060452203749,NaN,NaN,1.0237367718289283,14.858039646220194
2018-10-05T09:30:00-04:00,113.15,113.59,111.335,112.24,7429341,5865028.05,31.92546588273248,52.20610349469224,NaN,NaN,-282.6750998177604,-147.03311809688665,-0.6213064981476383,-0.2653761210015375,0.35593037714610076,612273038,631492487,30.476737734844434,68.64920514514979,NaN,NaN,-5.478362464995666,11.952839344617928
2018-10-08T09:30:00-04:00,111.82,112.97,111.27,112.53,7256707,6025119.1,34.02953626103263,50.38323868139539,NaN,NaN,-220.0934066917276,-205.65170783965837,-0.6568813168548494,-0.46517126892246097,0.1917100479323884,619529745,625198253.2,25.77431931314085,65.09723498553976,NaN,NaN,-9.918999649118328,8.82829091694132
2018-10-09T09:30:00-04:00,112.39,113.645,112.11,112.2,5894282,6075433.1,32.78763711187011,48.454635764202145,NaN,NaN,-158.05625071985293,-216.9273133248001,-0.6675517329199118,-0.6427296182175013,0.02482211470241044,613635463,619560572,22.43524600068193,61.26456792250921,NaN,NaN,-13.894048535807979,5.5822424236914205
2018-10-10T09:30:00-04:00,112.15,112.15,108.26,108.42,13716641,6532624.8,22.609249452116984,45.534175219020504,NaN,NaN,-223.1586642168695,-231.30073004062197,-0.8807026457849765,-1.0760561925288101,-0.19535354674383368,599918822,613011889.4,19.306437365081948,57.16364807938512,NaN,NaN,-22.191054691526187,1.6146285500889053
2018-10-11T09:30:00-04:00,107.73,109.23,105.57,106.51,28602890,7727047.6,19.34190858375105,42.82234869165684,NaN,NaN,-232.09588457126168,-223.2158612034944,-1.0882443574610174,-1.5556589935701055,-0.46741463610908807,571315932,603334600,15.799843811629657,52.8822840425064,NaN,NaN,-30.319025522073602,-2.947322031648596
2018-10-12T09:30:00-04:00,108.95,109.22,107.14,108.48,15178226,8330800.45,30.49824524606143,41.251187652236986,NaN,NaN,-159.10657882075682,-198.5021570040937,-1.0312977863951878,-1.7565368691030727,-0.725239082707885,586494158,598178824,14.30873441349992,48.55209163558792,NaN,NaN,-32.27935375669701,-7.1376122780840845
2018-10-15T09:30:00-04:00,108.46,109.14,107.72,108.23,7807307,8462204.05,29.932430682670855,39.452641509769194,NaN,NaN,-131.48101454803614,-180.7796785753554,-0.950884994461241,-1.9138453257844361,-0.9629603313231951,578686851,590010245.2,12.324223761707032,44.119780557754346,NaN,NaN,-33.90984378750277,-10.96221677942961
2018-10-16T09:30:00-04:00,108.91,110.63,108.34,110.4,7431609,8650375.4,40.287823523944546,38.292249820890426,NaN,NaN,-87.93126332220122,-166.75468109582508,-0.7033733956470258,-1.8421770758819775,-1.1388036802349517,586118460,584506844.6,11.197440746767484,39.557405740186354,NaN,NaN,-31.253240129265393,-13.860934400834722
2018-10-17T09:30:00-04:00,110.4,110.4,108.39,109.49,10038660,8993625.35,37.76707664287314,36.80251075689563,NaN,NaN,-85.63797168770385,-139.25054258999194,-0.5590577432373767,-1.8376258592816725,-1.2785681160442959,576079800,579739040.2,10.317362300591,34.873312343419705,NaN,NaN,-30.12334831208821,-16.18413638815665
2018-10-18T09:30:00-04:00,109.26,109.37,107.06,107.39,12486331,9376202.95,32.68474380347206,35.0032653635583,NaN,NaN,-104.06687479547278,-113.64474063483415,-0.5616573900264612,-1.9806398535773724,-1.4189824635509112,563593469,578194547.6,10.042018246099275,30.033803763614873,NaN,NaN,-31.08248406234096,-18.312471770182977
2018-10-19T09:30:00-04:00,107.58,107.99,105.98,106.34,8585876,9402814.8,30.476393364345057,33.24144176810716,NaN,NaN,-114.97423203283087,-104.81827127724895,-0.5879157445385714,-2.1538771442241256,-1.5659613996855541,555007593,571897234.6,8.988703404139173,25.040491231694336,NaN,NaN,-32.63060840918842,-20.35791986146947
2018-10-22T09:30:00-04:00,106.84,107.32,106.19,106.77,6918839,9506673.15,32.488110925076185,32.34185694184536,NaN,NaN,-102.37031974287918,-98.99613231621757,-0.5318362910176642,-2.2307567634576344,-1.6989204724399702,561926432,568545150.8,8.478879791143228,20.498434831190288,NaN,NaN,-33.13344478338647,-22.182994850314756
2018-10-23T09:30:00-04:00,105.13,107.19,104.49,106.79,10511970,9827518.25,32.58581939152121,31.598188759984122,NaN,NaN,-101.86419389870687,-101.78271843151869,-0.4520419518691332,-2.2639729122763868,-1.8119309604072535,572438402,565809139.2,8.076237200027379,17.01440009164595,NaN,NaN,-33.49010836529021,-23.798296781025535
2018-10-24T09:30:00-04:00,106.76,107.37,103.44,103.6,11795682,10080797,26.09793081170909,30.96516940594123,NaN,NaN,-115.8376236632017,-107.82264882661825,-0.5653909387626634,-2.5186696338605827,-1.9532786950979193,560642720,562721723.2,7.635595065648317,14.65441279678581,NaN,NaN,-36.10962608795053,-25.557058110586247
2018-10-25T09:30:00-04:00,104.63,107.31,104.4,106.73,10432801,10336958.95,38.943295396887365,31.46644294266658,NaN,NaN,-84.44949681342588,-103.89917323020886,-0.38924020377413804,-2.439828949815592,-2.050588746041454,571075521,564218133.6,10.193159734584043,13.205585796767208,NaN,NaN,-33.52911830221604,-26.695923852247645
2018-10-26T09:30:00-04:00,104.04,105,102.305,103.41,18281779,11075850.95,32.4920274805317,31.35662088691651,NaN,NaN,-130.01653686863688,-106.90763419737009,-0.45160753871929415,-2.6150981694405715,-2.1634906307212773,552793742,563775363.4,10.104008362139808,12.086277871695705,NaN,NaN,-33.88955545891942,-27.723585510343614
2018-10-29T09:30:00-04:00,104.5,105.53,100.99,102.5,14306263,11398686.95,30.977268648351114,31.227308853808008,NaN,NaN,-133.29139446711625,-113.09184914221751,-0.5053741055488956,-2.795208262657397,-2.2898341571085012,538487479,559087572.8,9.187778919806448,11.140030223061745,NaN,NaN,-34.72340098261797,-28.72355914923995
2018-10-30T09:30:00-04:00,102.21,104.15,101.89,104.04,14443500,11662009.7,36.38241975638599,32.211106732684364,NaN,NaN,-118.85172494419649,-116.48935535131541,-0.39342621910350317,-2.78161693098788,-2.388190711884377,552930979,555186088.2,8.497171401932249,10.36793979712248,NaN,NaN,-33.418024074521554,-29.39419699570875
2018-10-31T09:30:00-04:00,105.48,106.48,105.12,105.38,9104308,11659143.4,40.73160239052061,33.738942004596474,NaN,NaN,-58.12252956230002,-104.94633653113507,-0.19534705178862177,-2.632374526620154,-2.4370274748315324,562035287,555464601.6,9.022890532427567,9.8838717057509,NaN,NaN,-30.844225270128835,-29.601343892054476
2018-11-01T09:30:00-04:00,105.8,107.65,105.3,107.53,6905762,11356438.7,46.993139082561264,34.917148707203616,NaN,NaN,-20.94922922762073,-92.24628301397405,0.09847143961207605,-2.313938175316437,-2.4124096149285132,568941049,555037707.2,8.938123948713624,9.50025667255188,NaN,NaN,-26.473122998720694,-29.154455193006793
2018-11-02T09:30:00-04:00,108.5,109.29,106.83,107.97,7912622,11380602.75,48.19926477280316,36.221922570784486,NaN,NaN,22.997888504321548,-61.64339793938236,0.3275423922817762,-2.002981624576293,-2.330524016858069,576853671,559849693,18.259978113475057,9.9242391262496,NaN,NaN,-22.693886340601487,-28.23151678552032
2018-11-05T09:30:00-05:00,108.05,108.32,106.91,108.12,4697849,11252659.85,48.62841241942358,36.81767892046156,NaN,NaN,25.293116782676215,-29.92649568942387,0.4847689063082541,-1.7245628839727516,-2.2093317902810057,581551520,568462501.2,31.730840233138053,11.390910518133207,NaN,NaN,-19.603052077067954,-26.998878970027125
2018-11-06T09:30:00-05:00,107.97,108.85,107.86,108.6,4779419,11196916.7,50.05435838767809,37.695341902233345,NaN,NaN,64.99833517340358,6.843516334096115,0.6086775870451504,-1.4484848064745677,-2.057162393519718,586330939,575142493.2,39.99107411795093,13.510461362230345,NaN,NaN,-16.66081474157436,-25.52201265167673
2018-11-07T09:30:00-05:00,109.7,111.59,109.24,111.54,6408767,10831523,57.78382822824734,39.48813364686015,NaN,NaN,155.699731359926,49.60796851854133,0.860811951203982,-0.9811474545147405,-1.8419594057187225,592739706,581283377,46.41038018815455,16.108201500948578,NaN,NaN,-11.433403270670437,-23.50935416867583
2018-11-08T09:30:00-05:00,111.08,112.15,110.76,111.57,4377330,9620245,57.85550057388174,41.44378416182706,NaN,NaN,154.66917080296247,84.73164852465796,0.9924270233153469,-0.6014256265745388,-1.5938526498898857,597117036,586918574.4,51.53395144581246,19.147147789639526,NaN,NaN,-7.3026376349949444,-21.194108949578563
2018-11-09T09:30:00-05:00,111.1,111.26,109.49,110.02,5257890,9124228.2,52.861932945231935,42.899057163266754,NaN,NaN,101.51032598694871,100.43413602118339,0.9385096076889821,-0.42071564027865804,-1.35922524796764,591859146,589919669.4,54.053374054279956,22.402468808435007,NaN,NaN,-5.250524838652053,-18.916454076589062
2018-11-12T09:30:00-05:00,109.78,110.12,107.59,107.81,6023350,9035030.35,46.676000471407384,43.9054986689729,NaN,NaN,41.664198575558075,103.70835237975976,0.7268717517750676,-0.4506355582488055,-1.177507310023873,585835796,590776524.6,54.77621491529234,25.738181502382506,NaN,NaN,-5.4085659064419795,-16.98675576656805
2018-11-13T09:30:00-05:00,107.98,108.82,107.3,107.76,7912985,9059099.15,46.543297179783075,45.365881980978195,NaN,NaN,27.536939255445667,96.21607319616818,0.5636616516564257,-0.47293024545334106,-1.0365918971097667,577922811,589094899,53.01349990204982,28.979460419268328,NaN,NaN,-5.573245617395535,-15.356254316686261
2018-11-14T09:30:00-05:00,108.79,109.47,106.65,106.95,8291637,8971748,44.343813244459966,45.751633255804805,NaN,NaN,22.05474141273074,69.48707520672913,0.38957475038625466,-0.5496234591269484,-0.9391982095132031,569631174,584473192.6,48.40327067896252,31.7087540581525,NaN,NaN,-6.358599537694835,-14.07087506254463
2018-11-15T09:30:00-05:00,106.06,107.05,104.19,106.79,10848591,8889861,43.90247425889123,46.56666516854477,NaN,NaN,-36.82661203531207,31.187918639074223,0.25838996572499195,-0.6162107523569631,-0.874600718081955,558782583,576806302,41.894556033946515,33.97950746328156,NaN,NaN,-7.124625769766562,-13.078553735004906
2018-11-16T09:30:00-05:00,105.77,106.67,105.22,106.37,5730915,8747112.95,42.70106236522491,47.404079005464325,NaN,NaN,-32.15635766297882,4.454581909088719,0.14379080419521784,-0.6948622128379327,-0.8386530170331505,553051668,569044806.4,36.538102460055036,35.933102001870736,NaN,NaN,-8.098233773519334,-12.367079454792682
2018-11-19T09:30:00-05:00,106.12,106.43,103.47,103.77,6680119,8735176.95,36.11277500911786,47.38481866637375,NaN,NaN,-79.7028938108179,-19.818836568186477,-0.09385556811030416,-0.9559724771710307,-0.8621169090607266,546371549,561151957,32.0503797347946,37.61547402564662,NaN,NaN,-11.01186430900056,-12.173477291108092
2018-11-20T09:30:00-05:00,100.56,103.7969,100.31,101.42,11993080,8809232.45,31.397489684668642,46.718096330241465,NaN,NaN,-149.7351158180829,-55.27324758289219,-0.37999940100201357,-1.3371161603132435,-0.95711675931123,534378469,552443088.6,27.968486942713568,38.96873091209562,NaN,NaN,-15.157925942053996,-12.59982709838608
2018-11-21T09:30:00-05:00,102.41,103.34,102.22,102.48,8737286,8656312.65,35.48917652337667,45.89638471887114,NaN,NaN,-114.58836988136231,-82.6018698417108,-0.4630560409676747,-1.5359368105208233,-1.0728807695531486,543115755,547140004.8,25.81266583779663,40.1740553327444,NaN,NaN,-17.330397172017914,-13.275622823190627
2018-11-23T09:30:00-05:00,101.94,102.65,101.94,102.02,2728006,8271072.9,34.5267777120869,44.91977850024854,NaN,NaN,-112.96542091422236,-97.82963161749286,-0.5104150471672961,-1.7108995785122687,-1.2004845313449726,540387749,543461038,24.407128164394422,40.61313747923865,NaN,NaN,-19.385997338277672,-14.148533468203063
2018-11-26T09:30:00-05:00,103.31,104.48,103.14,104.31,5853975,7649682.7,42.8373986541192,44.50613465986966,NaN,NaN,-65.60760912317767,-104.51988190953264,-0.3562549161010198,-1.6458031764712473,-1.2895482603702275,546241724,542099049.2,23.88852949370552,40.05297242642204,NaN,NaN,-18.608116305639598,-14.785616730693997
2018-11-27T09:30:00-05:00,103.94,104.73,103.63,104.62,6033247,7236031.9,43.87595395266479,44.064820057368706,NaN,NaN,-59.40284576997431,-100.4598723013639,-0.20941482002117273,-1.5513167853966934,-1.3419019653755206,552274971,543279733.6,25.368930444546294,39.00853359260742,NaN,NaN,-17.670090803804584,-15.197684455424081
2018-11-28T09:30:00-05:00,105.21,107.73,104.6709,107.71,6341494,6830931.6,53.03540934156842,43.725647279748785,NaN,NaN,3.4179135741411546,-69.8292664229191,0.10303002361175162,-1.213114435860831,-1.3161444594725826,558616465,548127332.8,31.279046169019523,37.92772401981206,NaN,NaN,-13.772938174684729,-14.994149272461316
2018-11-29T09:30:00-05:00,107.58,107.88,106.58,107.21,4975250,6624478.7,51.56883458778856,43.27659970931355,NaN,NaN,17.049205005869556,-43.50175144547272,0.2735536003499308,-0.974202459035169,-1.2477560593850998,553641215,550232424.8,33.733197796962074,36.656241616322745,NaN,NaN,-11.11556933123323,-14.440066423714446
2018-11-30T09:30:00-05:00,107.17,108.1,106.88,107.99,5671468,6562764,53.71889792283065,43.33781149342774,NaN,NaN,28.655095727078535,-15.17764811721255,0.42724767449805334,-0.7136964662625331,-1.1409441407605865,559312683,554017411.6,38.01915359231676,35.510940154753946,NaN,NaN,-8.266828629299761,-13.558175310226634
2018-12-03T09:30:00-05:00,110.21,110.595,109.3,110.01,5994885,6466877.15,58.817806848151996,44.20508337748093,NaN,NaN,92.08951747973758,16.3617772033705,0.6404965643905299,-0.34032343527242404,-0.980819999662954,565307568,557830580.4,42.083234266085675,34.60429867981061,NaN,NaN,-4.136273596347266,-12.21218935110101
2018-12-04T09:30:00-05:00,109.68,110.05,105.77,106.05,9708721,6717420.75,47.718645386492554,44.28903682081732,NaN,NaN,14.919691038359822,31.226284565037332,0.4968049489787961,-0.35981381343945884,-0.856618762418255,555598847,558495355.6,42.78755229897214,33.873873851019354,NaN,NaN,-4.160156579773914,-11.06189895519714
2018-12-06T09:30:00-05:00,104.13,106.56,103.52,106.56,11161940,7036546.8,49.05206728294879,44.625340680709385,NaN,NaN,-32.323424924627496,24.078016865283605,0.42105513014103413,-0.33029984974196225,-0.7513549798829964,566760787,560124220,44.566374716158144,33.599809853676184,NaN,NaN,-3.7387397429789684,-10.015733353451687
2018-12-07T09:30:00-05:00,106.08,107.17,103.11,103.37,9345689,7183392.9,41.86040384021404,44.47947850794672,NaN,NaN,-55.120433794381384,9.644089105233414,0.15477581788098238,-0.5578852075317684,-0.7126610254127508,557415098,560878996.6,45.413303814729645,33.85114898087498,NaN,NaN,-5.8933059723080685,-9.426815156145455
2018-12-10T09:30:00-05:00,103.26,103.97,101.35,103.45,9898207,7459436.75,42.08970792030555,44.43581033330963,NaN,NaN,-96.849980339442,-15.456926108070693,-0.008633892845232749,-0.7234533914692918,-0.714819498624059,567313305,562479121,47.25318597795695,34.61651208929654,NaN,NaN,-7.46921546427424,-9.14715805730671
2018-12-11T09:30:00-05:00,104.99,105.27,102.74,103.49,7964979,7594791.2,42.21243174416307,44.87150010009857,NaN,NaN,-60.1326216488891,-45.90135393379603,-0.1015337513518324,-0.8417366878138495,-0.7402029364620171,575278284,564473264.2,49.53600813193083,35.865485546234844,NaN,NaN,-8.672321439120307,-9.079324254708652
2018-12-12T09:30:00-05:00,104.6,105.8268,104.39,104.58,7186679,7652957.65,45.5958547992486,45.88566903685428,NaN,NaN,-17.10152431206299,-52.305597003880585,-0.07812947343131371,-0.8378647782511592,-0.7597353048198455,582464963,569846487.4,55.166446751740274,37.80819696116532,NaN,NaN,-8.679368355877907,-9.022187697732832
2018-12-13T09:30:00-05:00,105,105.28,103.51,104.06,6108298,7562723.3,44.26436556920202,46.512468254413236,NaN,NaN,-35.97844086809028,-53.03660019257315,-0.08562327277869275,-0.8667643957932114,-0.7811411230145187,576356665,571765663,57.01137180704299,40.03667595896862,NaN,NaN,-9.07046440444069,-9.02908437011967
2018-12-14T09:30:00-05:00,102.98,104.11,102,102.33,6138633,7455073.1,40.07181112960407,46.90854206995018,NaN,NaN,-85.99070138782791,-59.210653711262445,-0.18911477147854805,-1.0175345873627037,-0.8284198158841557,570218032,574326249.8,59.41125792271313,42.53697094170569,NaN,NaN,-10.668201942622026,-9.263244023334291
2018-12-17T09:30:00-05:00,101.6,102.05,98.99,99.73,11928807,7509083.9,34.74541036513175,46.33054290645107,NaN,NaN,-164.41630945875667,-72.72391953512538,-0.4024409096777769,-1.3314709529813769,-0.9290300433036,558289225,572521433.8,56.9960212213033,44.90179177939124,NaN,NaN,-13.814676322558933,-9.91344863750924
2018-12-18T09:30:00-05:00,100.33,101.53,99.8,100.51,8688885,7656982.4,37.432306934967315,45.87028240518697,NaN,NaN,-134.98108459690852,-87.69361212472927,-0.45680541545325326,-1.5000368126201664,-1.0432313971669132,566978110,570861399,54.78974846768226,47.00327878104381,NaN,NaN,-15.568900228232582,-10.721370293326862
2018-12-19T09:30:00-05:00,100.55,102.33,97.97,98.52,14030915,8024522.2,33.62793285001845,44.48403408436197,NaN,NaN,-145.52650062275757,-113.37860738686818,-0.584419749229113,-1.7737560837033044,-1.1893363344741914,552947195,564957845.4,47.7158570015462,48.177336697652855,NaN,NaN,-18.30457354515099,-11.804685043587451
2018-12-20T09:30:00-05:00,97.93,98.39,95.03,96.31,17687637,8309250.05,29.983403655242725,42.942217589180125,NaN,NaN,-207.0229740647454,-147.58751402619922,-0.7639637770768559,-2.1442910558202612,-1.3803272787434053,535259558,556738424,39.97692709448668,48.62331736176176,NaN,NaN,-21.874779548636702,-13.243269972880201
2018-12-21T09:30:00-05:00,96.34,97.78,93.54,93.76,13373543,8541062.9,26.424757099955755,40.99263610183192,NaN,NaN,-201.36563231549238,-170.66250021173212,-0.9866011142173443,-2.6135786715150857,-1.6269775572977414,521886015,547072020.6,33.16452442339205,48.276558135409985,NaN,NaN,-26.181002045879353,-15.09151741188008
2018-12-24T09:30:00-05:00,92.9,94.15,91.73,91.98,8439016,8826613.4,24.26022855378379,38.52423765223419,NaN,NaN,-205.12135577875944,-178.80350947573265,-1.1731892210149404,-3.093464083566417,-1.9202748625514765,513446999,538103575.4,28.33930540555326,47.29484893108624,NaN,NaN,-30.485098470773327,-17.2906004202934
2018-12-26T09:30:00-05:00,92.77,97.46,92.59,97.43,11744914,9121160.35,40.36675645091917,37.99910272826465,NaN,NaN,-119.72937579216956,-175.75316771478487,-0.8633254667945067,-2.99943169604461,-2.136106229250103,525191913,529746336,24.72873712528282,46.00493356153701,NaN,NaN,-28.443220845970487,-18.88383190967584
2018-12-27T09:30:00-05:00,96.12,97.95,94.06,97.95,10760072,9357501.6,41.64193312814675,37.469807431493074,NaN,NaN,-91.41157671944535,-164.93018293412243,-0.5711922632300799,-2.850096558287703,-2.278904295057623,535951985,526347294,23.421713617838193,44.494600625942724,NaN,NaN,-26.455346610165126,-19.965476866888597
2018-12-28T09:30:00-05:00,98.4,99.48,97.1,97.96,8328286,9456841.2,41.6677659517469,37.456047582316856,NaN,NaN,-59.15495911245843,-135.35657994366503,-0.33673147641585954,-2.6998186405774476,-2.363087164161588,544280271,528151436.6,25.66745367074016,43.0841827585149,NaN,NaN,-24.928079508937916,-20.67442010146707
2018-12-31T09:30:00-05:00,98.78,99.41,98.05,99.01,6215323,9518844.85,44.44838597115246,37.62452458594878,NaN,NaN,-43.13644708198769,-103.71074289696408,-0.08357161547428094,-2.467551683504439,-2.383980068030158,550495594,533873352.4,32.434995315543944,42.02574056834254,NaN,NaN,-22.804447176136446,-20.978709683562695
2019-01-02T09:30:00-05:00,97.32,100.32,96.79,99.76,6852757,9577909.3,46.41331371631083,37.92458758395934,NaN,NaN,-35.72043653849461,-69.8305590489111,0.14908258210286052,-2.1976268404015826,-2.346709422504443,557348351,542653622.8,41.270994813452134,41.435382474165486,NaN,NaN,-20.470750342023784,-20.90614406334285
2019-01-03T09:30:00-05:00,99,99.24,97.43,97.6,6346211,9595475.6,41.824905556608556,37.6552340666279,NaN,NaN,-45.43699414416637,-54.97208271931047,0.17063891859371294,-2.133410774262302,-2.304049692856015,551002140,547815668.2,45.76192927078108,40.76363122552555,NaN,NaN,-19.843362489583253,-20.754318124234338
2019-01-04T09:30:00-05:00,98.92,101.57,98.72,100.83,7269178,9473498.45,49.81460223939484,38.05167954307024,NaN,NaN,7.787162589256346,-35.13233485757014,0.40234147398688513,-1.8011228503724084,-2.2034643243592935,558271318,552279534.8,49.367604594585096,40.21764785320712,NaN,NaN,-16.643620905104335,-20.167075664358624
2019-01-07T09:30:00-05:00,101.31,103.77,101.26,103.11,6270230,9228912.95,54.558772410582776,39.08646249171158,NaN,NaN,66.2944504815078,-10.042452938776904,0.6920695791238858,-1.3383773504544365,-2.0304469295783223,564541548,556331790.2,52.457439252583214,39.720946519626416,NaN,NaN,-12.351059030036112,-19.05050185945541
2019-01-08T09:30:00-05:00,104.18,104.81,102.77,104.25,9390977,9231177.35,56.75979895497817,40.65891881955775,NaN,NaN,96.84295911233572,17.95342830008778,0.9286494453601031,-0.8696351228781936,-1.7982845682382966,573932525,561019176.4,55.81626736205165,39.63667838682272,NaN,NaN,-8.162262231325377,-17.495039055436834
2019-01-09T09:30:00-05:00,104.5,105.24,103.85,104.78,5162747,8994404.35,57.78359206916247,42.11258204342884,NaN,NaN,107.67783721514482,46.633083050815664,1.078469762726782,-0.450197364829819,-1.528667127556601,579095272,565368560.6,58.729822644887165,39.91811225662308,NaN,NaN,-4.485426852503627,-15.636523026446376
2019-01-10T09:30:00-05:00,103.48,104.61,103.06,104.48,4759997,8834155.25,56.96147102604632,43.779263341716536,NaN,NaN,93.90400709374106,74.50128329839715,1.1106303353611897,-0.14037920835511386,-1.2510095437163036,574335275,570035187.6,61.6517312244793,40.91353184397544,NaN,NaN,-1.746518007974381,-13.652236595236092
2019-01-11T09:30:00-05:00,104.14,104.92,103.95,104.58,3032579,8626450.25,57.18016641807977,45.721889253347754,NaN,NaN,105.14861383473662,93.9735735474932,1.0903538634204977,0.1119327855593184,-0.9784210778611792,577367854,573854494.8,63.90417249673194,42.62262080127867,NaN,NaN,0.551032316337899,-11.623198179296951
2019-01-14T09:30:00-05:00,103.75,104.71,103.24,103.94,2948145,8468442.6,55.245337792386806,47.78050215994998,NaN,NaN,94.04168116614478,99.5230196844206,0.988563585743186,0.2572834043178034,-0.7312801814253826,574419709,575830127,65.04780975879774,44.89999832523626,NaN,NaN,1.9790590228626714,-9.680018578988435
2019-01-15T09:30:00-05:00,103.96,105.08,103.8,104.88,3766806,8349851.25,57.51899225028151,50.15612813827124,NaN,NaN,103.25944263155895,100.80631638826524,0.9395968208254597,0.44321584460644203,-0.49638097621901767,578186515,576680925,65.55395563057277,47.558187627023365,NaN,NaN,3.832115002949632,-7.749713781568711
2019-01-16T09:30:00-05:00,104.92,105.49,104.58,104.64,4493973,7978109.55,56.72659858656824,51.324688290817605,NaN,NaN,97.50973845297698,98.77269663583168,0.8488593545542719,0.5646932169738221,-0.28416613758044973,573692542,575600379,64.28079262788842,50.38333444863805,NaN,NaN,5.18245350220043,-5.902261312458833
2019-01-17T09:30:00-05:00,104.11,105.66,103.94,105.35,4395957,7763463.15,58.545997717709625,52.532121475786376,NaN,NaN,88.36593664482278,97.66508254604803,0.7953894882773459,0.7100707227662326,-0.08531876551111325,578088499,576351023.8,64.79235429735597,53.33838021146075,NaN,NaN,6.830045780199979,-4.0833602992218605
2019-01-18T09:30:00-05:00,106.4,107.26,106.04,106.81,5798123,7351823.55,62.07693177917561,53.98991903488843,NaN,NaN,106.5438564806453,97.94413107522976,0.8141316047571494,0.9323457404353235,0.1182141356781741,583886622,577654777.4,65.71089427972142,56.19862596924513,NaN,NaN,9.273467367412588,-2.1752420611312253
2019-01-22T09:30:00-05:00,106.33,106.58,104.34,105.21,9243681,6929625.75,56.406642679416244,54.84408022833584,NaN,NaN,75.18176911835151,94.17214866567112,0.6800146784433412,0.9682324837323506,0.2882178052890094,574642941,577699423.8,65.74385336859103,58.577830115891345,NaN,NaN,9.878156043662578,-0.4533280461606821
2019-01-23T09:30:00-05:00,105.67,106.05,104.22,105.42,6104331,6566165.15,56.96230122227614,55.5975793359048,NaN,NaN,67.14639878940095,86.94953989723952,0.571079376878321,1.0020670263869107,0.4309876495085897,580747272,578211575.2,66.14585470265396,60.354605822262904,NaN,NaN,10.530488801161141,1.1157886463138638
2019-01-24T09:30:00-05:00,105.49,105.97,105.2,105.86,3965227,6342475.7,58.16550792883265,56.76476521963509,NaN,NaN,72.79109201479743,82.0058106096036,0.4970144556324765,1.0522557190491852,0.5552412634167088,584712499,580415566.6,67.8920689289279,61.9353300835591,NaN,NaN,11.403201366380243,2.585419034894775
2019-01-25T09:30:00-05:00,106.94,107.42,106.77,107.03,4392949,5974877.45,61.26646798479618,57.582755630020905,NaN,NaN,101.35085076432959,84.60279343350496,0.49414231688416144,1.1729191595219106,0.6787768426377492,589105448,582618956.4,69.58131245290488,63.37916635915337,NaN,NaN,13.0188578319085,4.075910291611021
2019-01-28T09:30:00-05:00,105.98,106.42,105.37,106.41,5901025,5731925.1,58.78000608197529,57.88427232083465,NaN,NaN,74.50479837375362,78.19498181212663,0.4206831287025776,1.2046307535159713,0.7839476248133936,583204423,582482516.6,69.33804391261947,64.58492383487025,NaN,NaN,13.739244318560262,5.456386581175198
2019-01-29T09:30:00-05:00,106.12,106.31,105.07,105.72,2882308,5459626.2,56.053516077151635,57.83382354384704,NaN,NaN,62.4151068411465,75.64164935668563,0.3014061390516416,1.1607052986279456,0.859299159576304,580322115,583618351.4,70.26989924312672,65.6173261120899,NaN,NaN,13.629021492668492,6.623905854245669
2019-01-30T09:30:00-05:00,106.56,108.11,106.4799,107.8,5900590,5443889.55,61.804997871417925,58.12106681543671,NaN,NaN,121.4743206191124,86.5072337226279,0.33575209918725923,1.278989283560378,0.9432371843731188,586222705,584713438,71.17933212922931,66.5065767895429,NaN,NaN,15.17757139875911,7.845858074890446
2019-01-31T09:30:00-05:00,107.96,109.15,107.47,108.78,5599090,5381206.2,64.18341084447374,58.63691965961009,NaN,NaN,159.09942356503004,103.76890003267445,0.3936207989445042,1.435263183053749,1.0416423841092448,591821795,586135297.2,72.36150627046598,67.2715607213991,NaN,NaN,17.197758708291428,9.181843879662015
2019-02-01T09:30:00-05:00,107.85,108.25,106.9601,107.19,5636382,5345714.75,57.88537262501225,58.687291531533845,NaN,NaN,114.00334168755266,106.29939821731905,0.29829098588713276,1.4145061164681607,1.116215130581028,586185413,585551290.2,71.07200397502432,67.78354868413427,NaN,NaN,17.09450800665483,10.312224469232417
2019-02-04T09:30:00-05:00,107.04,107.94,106.89,107.89,3604799,5162495.8,59.75757273300074,59.00959402729198,NaN,NaN,110.26543361431557,113.45152526543143,0.2573992439190287,1.4379641854798138,1.180564941560785,589790212,586868448,72.2721528202268,68.29957318852206,NaN,NaN,17.55458937635907,11.346848027393367
2019-02-05T09:30:00-05:00,108.22,109.08,108.22,108.9,4162383,5057103.45,62.357749654865735,59.35521955619085,NaN,NaN,150.94339622641647,131.15718314248542,0.2719686537934338,1.5205257588025773,1.2485571050091435,593952595,589594544,74.61914197659043,68.94708649895189,NaN,NaN,18.710584854698066,12.398810431294038
2019-02-06T09:30:00-05:00,108.93,109.21,108.02,108.45,2915949,4733352.05,60.4826457610887,59.62350864008517,NaN,NaN,123.48295926849497,131.55891087236193,0.22674262589183414,1.5319853873739362,1.305242761482102,591036646,590557332.2,75.41075763414707,69.74208399939893,NaN,NaN,19.13472393137274,13.361083788448138
2019-02-07T09:30:00-05:00,107.68,107.94,106.665,107.56,4521237,4701276.55,56.84209450376921,59.50180126766086,NaN,NaN,57.89095844272497,111.31721784790093,0.11781223474795577,1.4525080549170468,1.334695820169091,586515409,589496055,72.718385645818,70.30822909571765,NaN,NaN,18.45172792189425,14.088318664654725
2019-02-08T09:30:00-05:00,106.89,107.14,106.36,107.13,3323286,4629441,55.11595135122885,59.00458837995037,NaN,NaN,26.993838124685645,93.91531713532751,0.003751101427278636,1.3393846969531893,1.3356335955259107,583192123,588897397,71.17468894178465,70.69850014300788,NaN,NaN,17.39181108674123,14.560246153524226
2019-02-11T09:30:00-05:00,107.49,107.75,107.16,107.32,3057904,4630707.25,55.75530010053587,58.95806391003034,NaN,NaN,49.56545885571374,81.77532218360714,-0.06798820655703097,1.250648337329622,1.318636543886653,586250027,588189360,69.30090925352971,70.95257556336064,NaN,NaN,16.676525700563296,14.862571803101236
2019-02-12T09:30:00-05:00,108.01,109.09,107.82,108.97,3876944,4677147.2,60.95656361266887,59.24336836648697,NaN,NaN,109.53997668743513,73.49463827581087,-0.016111573213264396,1.2984970773700724,1.3146086505833368,590126971,587424235.2,67.24081575390665,71.03078706702155,NaN,NaN,17.49645860984901,15.238841346922348
2019-02-13T09:30:00-05:00,109.42,109.95,109.16,109.71,3480557,4662834.75,63.054268234227045,59.592565531158,NaN,NaN,152.35082143282412,79.2682107086767,0.05248832593455388,1.3802190580015292,1.3277307320669753,593607528,587938411.6,67.93074011448435,71.0335492945613,NaN,NaN,18.796739673712963,15.747112536463865
2019-02-14T09:30:00-05:00,108.84,109.9,108.31,109.31,4167348,4646503.5,61.14199963687669,59.58367493487804,NaN,NaN,117.17599250852582,91.12521752183686,0.055102155771333816,1.3966084267811425,1.3415062710098087,589440180,588523365.8,68.73739536893308,70.97326950284904,NaN,NaN,19.356981189416082,16.26280805831418
2019-02-15T09:30:00-05:00,109.99,110.29,109.69,110.06,3610515,4607231.4,63.384270384435176,59.91255095648232,NaN,NaN,153.5251834598147,116.43148658886267,0.08948489887864963,1.4533623946081207,1.363877495729471,593050695,590495080.2,71.3530712393794,71.11720002618902,NaN,NaN,20.467126046260955,16.863424913735148
2019-02-19T09:30:00-05:00,109.72,110.84,109.72,110.51,4919423,4563296.4,64.70044282914145,60.530188581624444,NaN,NaN,145.93860875174798,135.7061165680695,0.12262812781857324,1.5171626555026876,1.3945345276841143,597970118,592839098.4,74.12476200774061,71.39254736651858,NaN,NaN,21.77273198801902,17.564754495775702
2019-02-20T09:30:00-05:00,110.58,110.99,109.61,110.73,6601747,4431199.7,65.3560850547743,60.78383766614991,NaN,NaN,131.45206881060372,140.08853499270322,0.13829947347762817,1.5674088695311497,1.4291093960535215,604571865,595728077.2,77.06950980183238,71.81327434313309,NaN,NaN,23.04797203737097,18.34807128743217
2019-02-21T09:30:00-05:00,110.47,110.8367,110.09,110.51,2993430,4275654.65,64.07444175019597,60.77605415941578,NaN,NaN,120.1269994061463,133.64377058736767,0.11380327879282781,1.5713634945445563,1.4575602157517284,601578435,597322258.6,78.52207031679868,72.25331463215686,NaN,NaN,23.799544490786417,19.126853173625634
2019-02-22T09:30:00-05:00,110.78,111.16,110.61,111.11,7108279,4432807.25,66.0309334491048,61.35787993256525,NaN,NaN,132.41793598313916,136.69215928229033,0.11748608263655891,1.604417819047427,1.486931736410868,608686714,601171565.4,81.55960104964606,73.00242870891555,NaN,NaN,24.974249412998034,19.962195493535976
2019-02-25T09:30:00-05:00,111.77,111.91,110.68,110.74,3991446,4412732.1,63.72616436041258,61.64135076309467,NaN,NaN,124.9529787653739,130.9777183434022,0.07646696972657208,1.582515448569083,1.506048478842511,604695268,603500480,83.11546982486081,73.7769513521037,NaN,NaN,25.390642214965514,20.737687882311626
2019-02-26T09:30:00-05:00,110.3,111.05,110.22,110.89,7175152,4476438.45,64.27064121696262,61.77798587467301,NaN,NaN,94.44527570276404,120.6790517336054,0.04259075258850453,1.5592869195781418,1.5166961669896373,611870420,606280540.4,84.76764144505901,74.50184417128003,NaN,NaN,25.883447743630057,21.472796433928544
2019-02-27T09:30:00-05:00,110.77,111.13,110.069,110.81,3102228,4487434.45,63.72128520521629,62.00931726353927,NaN,NaN,83.56779932185897,111.10219783585644,0.00019227580111946807,1.5169365117410365,1.516744235939917,608768192,607119805.8,85.23727851994556,75.20373852026562,NaN,NaN,26.169209146011674,22.143712535654704
2019-02-28T09:30:00-05:00,110.41,110.52,109.71,110.21,4053410,4395075.45,59.60620178028253,62.20675349757594,NaN,NaN,49.94611866367087,97.06602168736137,-0.07851081343812294,1.4186057191422634,1.4971165325803863,604714782,607747075.2,85.59476131530684,76.12347963951483,NaN,NaN,25.38009190535172,22.60605244561142
2019-03-01T09:30:00-05:00,111.11,111.55,110.365,111.1,4855991,4357920.5,63.3836033866509,62.79730007153465,NaN,NaN,87.52206981122251,88.08684845297805,-0.08057592332309671,1.3963966284265155,1.4769725517496122,609570773,607923887,85.69987767165092,77.16099312021957,NaN,NaN,25.646482358240213,23.040399575986964
2019-03-04T09:30:00-05:00,111.58,111.77,109.94,110.75,5658849,4359043.85,60.96897616641081,63.169705504811425,NaN,NaN,71.90379997585346,77.47701269507397,-0.11344783030642769,1.3351627638665775,1.4486105941730052,603911924,607767218.2,85.10726297351268,78.29001838593264,NaN,NaN,25.236203312010485,23.354085823990324
2019-03-05T09:30:00-05:00,111.14,111.5,110.86,111.03,5149252,4436266.5,62.20929359738661,63.25918621800555,NaN,NaN,83.57005902138009,75.30196935879717,-0.12344194244332174,1.294308166118853,1.4177501085621746,609061176,607205369.4,82.89348411965261,79.40806612634306,NaN,NaN,25.202720110769512,23.61817643638735
2019-03-06T09:30:00-05:00,111.14,111.61,110.46,110.51,3769555,4416625.1,58.49181886174963,62.93329697711431,NaN,NaN,62.69480811299171,71.12737111702373,-0.16934557001186512,1.2060681460473432,1.3754137160592084,605291621,606510055.2,80.11611367638469,80.27844995219309,NaN,NaN,24.182964136566852,23.69886039355585
2019-03-07T09:30:00-05:00,110.27,110.405,108.82,109.17,7076275,4624641.4,50.17156557943185,62.14969454443968,NaN,NaN,-25.28403070691479,56.08134124290659,-0.28729475368209734,1.0162952739565867,1.303590027638684,598215346,605210168,75.0532943750636,80.72958559548813,NaN,NaN,20.776167762532445,23.28133287483822
2019-03-08T09:30:00-05:00,108.47,108.47,107.66,108.41,5878601,4692509.6,46.160961898568424,60.91945822402062,NaN,NaN,-115.07174720214864,15.562577840232356,-0.4065485571810712,0.7954043311623451,1.2019528883434163,592336745,601763362.4,63.57998330542681,80.17436502877722,NaN,NaN,16.591384806902624,22.325626007990277
2019-03-11T09:30:00-04:00,108.78,110,108.74,109.9,4562262,4754458.4,53.935518680510704,60.150535070547,NaN,NaN,-39.467989824178915,-6.711780119774124,-0.37585223968917725,0.7321375887319448,1.107989828421122,596899007,600360779,59.588123279719106,79.1360336910614,NaN,NaN,15.191030947717014,21.306398142236954
2019-03-12T09:30:00-04:00,110.07,110.365,109.62,110.21,8634046,5033265.5,55.379214399866534,59.437901452339304,NaN,NaN,-10.338588911291446,-25.493509706308437,-0.32722744308647145,0.6989555245630328,1.0261829676495042,605533053,599655154.4,57.62784828168702,77.7473435824796,NaN,NaN,14.494056226154465,20.333206439939456
2019-03-13T09:30:00-04:00,110.53,111.25,110.4,110.6,4852050,5082020.8,57.196713465760865,58.94663514630822,NaN,NaN,52.74635745067174,-27.48319983877243,-0.26406318465652723,0.6961039868288452,0.9601671714853725,610385103,600673850.8,59.68957189671174,76.40216512390194,NaN,NaN,14.45908379969455,19.494046062761612
2019-03-14T09:30:00-04:00,110.45,110.51,110.0199,110.27,4901695,5153077.7,55.14972974486983,58.16940631029144,NaN,NaN,-4.919252216592433,-23.410244140707952,-0.24044391256674558,0.6596122807769405,0.900056193343686,605483408,602127463.2,62.493969337315946,75.04033428730693,NaN,NaN,13.833302149680488,18.68536836089288
2019-03-15T09:30:00-04:00,110.44,110.69,109.83,110.6,5427955,5216108.05,56.81417390198056,57.67569270611772,NaN,NaN,0.7236555617054613,-0.25116358793713306,-0.20018115464002828,0.6498297500436507,0.850010904683679,610911363,605842386.8,68.52129852625636,73.99789348026377,NaN,NaN,13.781642221604502,17.984836055280255
2019-03-18T09:30:00-04:00,110.65,111.755,110.65,111.67,5485631,5309863.85,61.76845389529494,57.49696504028431,NaN,NaN,121.08785890034413,31.86000615696749,-0.10391589796119605,0.720116032232184,0.8240319301933801,616396994,609741984.2,73.36078989194348,73.18311836932695,NaN,NaN,15.229929394829645,17.591277960930167
2019-03-19T09:30:00-04:00,112.06,113.165,111.78,112.23,7016654,5414725.4,64.09033311547587,57.52332560530285,NaN,NaN,210.72447153377055,76.0726182459799,-0.00990590703466565,0.8116495464000479,0.8215554534347136,623413648,613318103.2,76.8722881087264,72.58561905423986,NaN,NaN,17.16162304755772,17.529898687591245
2019-03-20T09:30:00-04:00,112.17,112.94,111.32,112.39,9949399,5582108,64.74905957728848,57.89067259080328,NaN,NaN,163.60097153469223,98.24354106278399,0.05225787998037834,0.8868778034101865,0.8346199234298082,633363047,617913692,80.44044514288099,72.21745361335229,NaN,NaN,18.939509268075646,17.731271627660444
2019-03-21T09:30:00-04:00,112.24,114.02,112.24,113.93,5731484,5719010.7,70.38090732646887,58.39048001507599,NaN,NaN,232.32992817227108,145.6933771405567,0.17915162470031087,1.0585594543051968,0.879407829604886,639094531,624635916.6,84.2646718840724,72.11493891423954,NaN,NaN,22.410493283000065,18.399731864137532
2019-03-22T09:30:00-04:00,113.22,113.64,111.64,111.67,8758893,5801541.4,56.192570267129064,58.04930816512729,NaN,NaN,119.65928274037023,169.48050257628967,0.09704942780333625,1.0007196143590562,0.90367018655572,630335638,628520771.6,85.97168428730198,72.17668329379592,NaN,NaN,20.654785210143395,18.721882342138368
2019-03-25T09:30:00-04:00,111.43,112.84,111.32,112.33,7461877,5975062.95,58.804415759178305,57.80610260525527,NaN,NaN,95.85276122344372,164.43348304090958,0.07438293952444197,0.9966488609612725,0.9222659214368305,637797515,632800875.8,87.57141463881904,72.51082118802208,NaN,NaN,20.151456003500137,18.926107150904336
2019-03-26T09:30:00-04:00,112.98,113.57,112.21,112.81,5440650,5888337.85,60.64227271472202,57.95970645189616,NaN,NaN,126.18410310294799,147.52540935474505,0.07850110346403327,1.020392300766872,0.9418911973028388,643238165,636765779.2,88.84091490102972,73.13402127549674,NaN,NaN,20.357638371904354,19.130611611047197
2019-03-27T09:30:00-04:00,112.9,113.415,111.91,112.58,4427768,5954614.85,59.27761712286782,58.61013870499873,NaN,NaN,96.7513247706703,134.15548000194067,0.05370202634608057,1.0090187302354394,0.9553167038893589,638810397,637855249.2,89.16831182368925,74.14223680754142,NaN,NaN,20.09270615725055,19.268053689076247
2019-03-28T09:30:00-04:00,112.9936,113.73,112.6715,113.26,6928435,6098366.1,62.00027927855368,59.74151851785482,NaN,NaN,116.16850571180396,110.92319550984726,0.07002986764761676,1.0428540384488798,0.972824170801263,645738832,639184109.4,89.5702583289219,75.99868502350536,NaN,NaN,20.71765031099276,19.475138920778605
2019-03-29T09:30:00-04:00,113.83,114.06,113.545,113.85,4599934,6085563.25,64.23462870252789,60.477169233713184,NaN,NaN,129.45914297205744,112.8831675561847,0.10537613025461279,1.104544333619529,0.9991682033649163,650338766,643184735,90.69031591217374,78.22027021153782,NaN,NaN,21.929391321371728,19.825746406577622
2019-04-01T09:30:00-04:00,114.77,115.14,114.41,115.1,4977726,6051507.1,68.46523808872212,61.41188521148859,NaN,NaN,157.08812443569946,125.13024019863585,0.19266934599845675,1.2400048858629873,1.0473355398645305,655316492,646688530.4,91.54655677673063,80.64303510404093,NaN,NaN,24.367387054052926,20.474552213359807
2019-04-02T09:30:00-04:00,115.08,115.18,114.7,115.08,3632051,5975647.05,68.32597670529239,62.206832585740834,NaN,NaN,140.06147045256594,127.90571366855943,0.2264582855132884,1.330408396756141,1.1039501112428527,651684441,648377785.6,91.93183713831831,82.94605404986999,NaN,NaN,26.25213142041743,21.299920671510897
2019-04-03T09:30:00-04:00,115.75,116.3172,115.4,115.89,4211309,5997734.75,70.90698292353254,63.33235066993103,NaN,NaN,156.66261932600457,139.88797257962628,0.277393025923095,1.4506913936467214,1.1732983677236264,655895750,651794856.2,92.66054036072582,85.10080912297067,NaN,NaN,28.66945901271412,22.352711863111356
2019-04-04T09:30:00-04:00,115.98,116.85,115.98,116.83,3073869,5797614.45,73.59594100273637,64.53104831998502,NaN,NaN,166.17473867906773,149.88921917307906,0.3440684003859291,1.6033838682060377,1.2593154678201086,658969619,654441013.6,93.17464077359324,86.8617621406376,NaN,NaN,31.609534690180812,23.675115124121277
2019-04-05T09:30:00-04:00,117.12,117.62,116.8169,117.52,2946748,5651021.8,75.39376185433397,65.50428460277352,NaN,NaN,172.594925760997,158.51637573086697,0.4003758485845028,1.759785278550737,1.3594094299662343,661916367,656756533.8,93.59727649182138,88.3072254692003,NaN,NaN,34.651548407354774,25.243177021726062
2019-04-08T09:30:00-04:00,117.29,117.98,117.15,117.94,3231419,5584479.65,76.44509871242181,66.38676785969822,NaN,NaN,160.08545048680875,159.11584094108883,0.42908984520512394,1.8957717364726392,1.4666818912675152,665147786,658722792.6,93.94040819230213,89.52637690374142,NaN,NaN,37.48700829657081,26.992295775275313
2019-04-09T09:30:00-04:00,117.54,117.54,116.68,116.88,4456471,5375600.9,68.49132069136996,66.65407222498976,NaN,NaN,118.34639729756532,154.7728263100887,0.34357544079688074,1.8961511922636163,1.5525757514667355,660691315,660524167.4,94.24471456619432,90.51239614826382,NaN,NaN,37.50156761867253,28.49362032433206
2019-04-10T09:30:00-04:00,117.16,117.44,116.61,117.44,3406876,5303342.2,70.25226097421668,66.6448831998289,NaN,NaN,107.42678871359252,144.9256601876063,0.2935492314374284,1.919512290763521,1.6259630593260925,664098191,662164655.6,94.51486680353061,91.2445529282251,NaN,NaN,38.049592165118526,29.858759158730127
2019-04-11T09:30:00-04:00,117.57,117.635,117.27,117.59,2165418,5166528.35,70.7242269759482,67.68285867903026,NaN,NaN,104.8837430998522,132.6674610717632,0.24155449153038577,1.9279061737390748,1.686351682208689,666263609,663623453.6,94.75082729645926,91.87163457173635,NaN,NaN,38.63129081118691,31.111977966223954
2019-04-12T09:30:00-04:00,118,118.53,117.79,118.32,4538867,5122073.95,72.97168700386072,68.69480662507901,NaN,NaN,115.40183115134553,121.22884214983291,0.22751525846264742,1.9707457552869982,1.7432304968243508,670802476,665400675.4,95.03126054135754,92.40448070763196,NaN,NaN,39.79717532340985,32.35272044582194
2019-04-15T09:30:00-04:00,118.37,118.62,117.835,118.56,2432718,4969428.3,73.68688924012241,69.62656494832189,NaN,NaN,108.05058451903065,110.82186895627729,0.20621255299127084,2.0009961880634393,1.7947836350721684,673235194,667018157,95.27849093689028,92.86430756733628,NaN,NaN,40.96636851001612,33.58324159784968
2019-04-16T09:30:00-04:00,118.92,119.245,118.83,119.08,3014556,4769323.4,75.21705879264805,70.76509649616334,NaN,NaN,116.51200801551967,110.45499109986815,0.1988729125041655,2.0433747757023752,1.8445018631982097,676249750,670129844,95.71972455701561,93.33226561971674,NaN,NaN,42.406931088305576,34.84376866791481
2019-04-17T09:30:00-04:00,119.42,119.76,119.23,119.31,2781367,4410921.8,75.88503826313959,71.75686499506233,NaN,NaN,116.60288472732357,112.29021030261438,0.18170941261963192,2.0716386289727495,1.8899292163531176,679031117,673116429.2,96.09675567212587,93.79844400137416,NaN,NaN,43.79849199548556,36.123014857567775
2019-04-18T09:30:00-04:00,119.56,119.585,118.91,119.27,3071288,4277912,75.50388782613392,72.5618120753199,NaN,NaN,101.01566304955978,111.51659429255588,0.14164332527167822,2.0669833729427154,1.9253400476710372,675959829,675055673.2,96.32322763736467,94.2007948388878,NaN,NaN,44.851800988765724,37.36998430488177
2019-04-22T09:30:00-04:00,118.85,119.22,118.44,118.82,2764755,3978205.1,71.17285140592297,72.75521302654855,NaN,NaN,81.69324535370194,104.77487713302716,0.06283459434833238,2.0038832906064528,1.9410486962581204,673195074,675534192.8,96.3790569604927,94.54597342344225,NaN,NaN,44.61230467254444,38.40460150026215
2019-04-23T09:30:00-04:00,119.19,120.4801,119.1,120.24,4099784,3810100.45,75.87548938611667,73.2944639323217,NaN,NaN,112.6043274610543,105.68562572143189,0.08306982749028391,2.0448859806209754,1.9618161531306915,677294858,676346125.6,96.47681141326167,94.87061444308107,NaN,NaN,45.76971455396696,39.45676050793427
2019-04-24T09:30:00-04:00,120.27,120.9,120.27,120.35,2181383,3647137.1,76.1993938271291,73.67249328257859,NaN,NaN,126.47833844166216,107.67889180666039,0.08053266160821382,2.0624819801409586,1.9819493185327448,679476241,676991423.8,96.55638241465934,95.1488888755049,NaN,NaN,46.80754077829554,40.50687197512874
2019-04-25T09:30:00-04:00,120.25,120.31,119.22,119.72,2820071,3566752.25,70.37179599312563,73.44219721046353,NaN,NaN,93.00673709747555,102.95966228069081,0.01644657816960704,2.0025075412447535,1.9860609630751465,676656170,676516434.4,94.85813230899434,95.2691382708907,NaN,NaN,46.01879276680888,41.29428923108304
2019-04-26T09:30:00-04:00,120.18,120.67,119.42,120.67,4236856,3432173.3,73.64497145582254,73.31728361056987,NaN,NaN,105.53451620945121,103.86343291266908,0.017936747751787552,2.008481897764881,1.9905451500130933,680893026,677503073.8,95.05277648612677,95.37310255619822,NaN,NaN,46.29269583529732,42.00834731739937
2019-04-29T09:30:00-04:00,120.72,120.73,120.05,120.25,3700251,3387189.15,69.96491372351734,72.85441325421955,NaN,NaN,102.37980063251239,108.00074396843118,-0.02702035575419104,1.9567697053203545,1.9837900610745456,677192775,678302614,95.21098619847834,95.46385812806794,NaN,NaN,45.4183867439195,42.49549580690225
2019-04-30T09:30:00-04:00,120.13,120.17,119.15,120.07,4339764,3355291.05,68.38767556865034,72.84701003116815,NaN,NaN,70.74320130186206,99.62851873659272,-0.08335516037207236,1.8795961106094552,1.9629512709815276,672853011,677414244.6,91.7019476571973,95.28223192028246,NaN,NaN,44.242119682041356,42.74501350335069
2019-05-01T09:30:00-04:00,120.27,120.2799,118.61,118.61,4561464,3401761.7,57.13654897430921,71.91017345974619,NaN,NaN,32.22071816091925,80.77699468044413,-0.22536475049237792,1.6812453328660553,1.9066100833584332,668291547,675177305.8,83.36983363358767,94.48615812242937,NaN,NaN,39.53078625364597,42.2858381819643
2019-05-02T09:30:00-04:00,118.67,119.175,117.85,118.7,10408526,3711622.55,57.59963544832902,70.97270263634483,NaN,NaN,-10.446225778591662,60.0864021052307,-0.3141982282250093,1.5138622980771714,1.8280605263021807,678700073,675586086.4,83.6619776451353,93.69409743304911,NaN,NaN,35.90124372952905,41.37375326018784
2019-05-03T09:30:00-04:00,119.82,120.33,119.46,120.1,3502942,3733076.2,64.09748997087046,70.33883141970266,NaN,NaN,74.24358933629136,53.82821673059872,-0.2807278902934054,1.477150663435424,1.7578785537288293,682203015,675848084.2,83.85770776011739,92.89598652010338,NaN,NaN,34.64363997844401,40.41230850565301
2019-05-06T09:30:00-04:00,118.02,119.57,117.9501,119.37,3814048,3776441.2,59.01860000021696,69.29109647399513,NaN,NaN,-1.9181427318773794,32.96862805772076,-0.3076462488278249,1.3733207426940481,1.680966991521873,678388967,676087322.6,84.04566317837333,92.0936416802093,NaN,NaN,31.932502699797567,39.20090767624509
2019-05-07T09:30:00-04:00,118.64,118.89,116.7,117.56,6578626,3943801.55,48.712220962977206,67.39789377187579,NaN,NaN,-98.93443356207607,-0.9668989150668992,-0.4392258564403866,1.1319346709713898,1.5711605274117764,671810341,675878788.6,83.13697571947912,91.19487390609956,NaN,NaN,25.768729384558863,37.28202506314705
2019-05-08T09:30:00-04:00,117.37,118.3,117.01,117.6,7152701,4078613.05,48.92449456045086,65.47214065025517,NaN,NaN,-111.82464515174567,-29.775971577599886,-0.5104437242579813,0.9331058720892997,1.443549596347281,678963042,678013087.6,84.93254512108264,90.39743029531076,NaN,NaN,21.133862037339085,34.97514463088877
2019-05-09T09:30:00-04:00,116.69,117.52,115.78,117.12,6383047,4227421.6,46.44053114637243,63.39618660170077,NaN,NaN,-173.37241104097833,-62.36120863007723,-0.5721164453458409,0.72840403966498,1.300520485010821,672579995,676789072,79.69175806470184,89.2094681829777,NaN,NaN,16.55232818607422,32.34331371020098
2019-05-10T09:30:00-04:00,116.83,117.795,115.11,117.29,6820805,4460190.95,47.45799239509649,61.70226810092745,NaN,NaN,-167.88169392570714,-110.78626528247692,-0.581788016847258,0.5732854639517484,1.1550734807990064,679400800,676228629,77.33861703308318,87.8494367595913,NaN,NaN,13.179063868103247,29.605563732758448
2019-05-13T09:30:00-04:00,114.92,115.18,113.43,113.8,7642191,4615357.15,33.421269020078384,58.66982378906757,NaN,NaN,-270.9300665650057,-164.58865004910257,-0.7906059124566033,0.16681609022825228,0.9574220026848556,671758609,674902557.4,71.92677229000162,86.09586253650129,NaN,NaN,4.230142336520494,25.980503533295884
2019-05-14T09:30:00-04:00,114.33,115.51,113.78,114.95,4595948,4723518.65,39.7454372596243,56.06596974853152,NaN,NaN,-186.40076528015885,-182.08191639271914,-0.8153823758567379,-0.0618059671360669,0.753576408720671,676354557,675811400.6,73.30549663458719,84.43508498078185,NaN,NaN,-0.5589409527095347,22.189154321009397
2019-05-15T09:30:00-04:00,114.24,115.96,114.02,115.73,4156782,4780629.95,43.65480254868418,54.157613073928566,NaN,NaN,-133.7561653724665,-186.4682204368633,-0.7452605261136303,-0.17799924892136687,0.5672612771922634,680511339,676121060,73.77802777887396,82.92936322863038,NaN,NaN,-2.9002974897106495,18.60494691947796
2019-05-16T09:30:00-04:00,116.21,117.49,116.011,116.8,3615889,4822356.05,48.583091182246854,52.36747876867315,NaN,NaN,-61.01387439853967,-163.99651310837558,-0.5991284334157436,-0.18164926457741615,0.4174791688383275,684127228,678430506.6,77.0420298093084,81.64288132314337,NaN,NaN,-3.0352936711960576,15.5134839779531
2019-05-17T09:30:00-04:00,115.81,117.3832,115.81,115.91,3674507,4852517,45.05324169613378,50.58807362386004,NaN,NaN,-68.96289443747341,-144.21275321072883,-0.5367321649596086,-0.25343603736118325,0.2832961275984253,680452721,678640890.8,77.31900259289283,80.36488249417299,NaN,NaN,-4.36349256129373,12.673915900917839
2019-05-20T09:30:00-04:00,115.49,115.49,114.72,115.09,3538433,4891200.9,42.02372000370222,48.70493394064946,NaN,NaN,-104.60368575013587,-110.94747704775486,-0.5244002467622004,-0.3722041808543253,0.15219606590787518,676914288,679672026.6,78.6768248115809,79.43451657662895,NaN,NaN,-6.461078897922371,9.940345215369238
2019-05-21T09:30:00-04:00,115.43,116.19,115.03,115.89,3660299,4869226.65,45.849428570135665,47.89871105463707,NaN,NaN,-74.85889961249501,-88.63910391422212,-0.4395143233065046,-0.39719683822525553,0.04231748508124904,680574587,680516032.6,79.74566576652799,79.17564744326754,NaN,NaN,-6.89391553395525,7.535450822608597
2019-05-22T09:30:00-04:00,114.97,115.8681,114.58,114.7,3945431,4957429.05,41.4661697382426,46.74632064677375,NaN,NaN,-89.76063359725711,-79.83999755918022,-0.43959822428418566,-0.507180295273983,-0.06758207098979736,676629156,679739596,75.97285678562572,78.62642452473115,NaN,NaN,-8.718891464514916,5.213401924448096
2019-05-23T09:30:00-04:00,113.79,113.86,112.73,113.28,4956488,5064249.9,36.929262589190124,44.805732976653736,NaN,NaN,-139.00259720104677,-95.43774211968164,-0.5066112962531204,-0.7008461913061979,-0.19423489505307745,671672668,677248684,65.29942338652893,77.30083278376055,NaN,NaN,-11.81735875824389,2.7804361126349555
2019-05-24T09:30:00-04:00,113.9,114.09,112.96,113.43,2632546,4984034.4,37.704633164293526,43.28330677408777,NaN,NaN,-122.03340799645619,-106.0518448314782,-0.5107129381845604,-0.832626067783778,-0.3219131295992176,674305214,676019182.6,60.76176892184299,75.63769747972266,NaN,NaN,-13.977909597057007,0.386386725536104
2019-05-28T09:30:00-04:00,113.75,114.3918,112.61,112.68,4117968,5004920.25,35.3636758443554,42.329839265614794,NaN,NaN,-119.14017450334978,-108.95914258212099,-0.5314397790609344,-0.9862128534253856,-0.4547730743644512,670187246,674673774.2,56.16260283706271,73.71095655955007,NaN,NaN,-16.505512340643072,-2.0267417124894926
2019-05-29T09:30:00-04:00,112.06,112.16,110.95,111.68,4768721,5026368.1,32.46905402335524,41.15445065582225,NaN,NaN,-158.6814352717922,-125.72364971398042,-0.5762435945028433,-1.1750775674930054,-0.5988339729901621,665418525,671642561.8,47.448577834891324,71.03353032482211,NaN,NaN,-19.564202194777472,-4.5320932099592035
2019-05-30T09:30:00-04:00,112.05,112.79,112.03,112.41,3897644,4993177.1,36.55187879125371,40.44811834474234,NaN,NaN,-117.866053619933,-131.34473371851558,-0.5220717669951583,-1.25142368173411,-0.7293519147389517,669316169,670179964.4,43.908496405217335,68.47758306343037,NaN,NaN,-20.83587277654285,-6.861204576614011
2019-05-31T09:30:00-04:00,111.02,111.48,110.62,110.94,4252246,4685363.1,32.315041522859374,39.3664789967254,NaN,NaN,-150.52257675872946,-133.64872963005212,-0.5479126539137759,-1.4142427321311715,-0.8663300782173956,665063923,668858215.4,40.936108510790284,65.87740388326658,NaN,NaN,-23.31439869489259,-9.211660879225235
2019-06-03T09:30:00-04:00,110.67,111.06,109.43,110.01,8065586,4913495.3,29.94979592231043,39.11851663259912,NaN,NaN,-161.23016981323104,-141.4880819934071,-0.5868389959074698,-1.599878823101733,-1.013039827194263,656998337,665396840,34.373645001054186,63.195037648341774,NaN,NaN,-26.140004200004096,-11.629995639336501
2019-06-04T09:30:00-04:00,111,113.03,110.0394,112.99,5739530,5009769.4,44.075020398706165,39.42777257110497,NaN,NaN,-86.5903254294633,-134.9781121786298,-0.38106187416071813,-1.4893671698951607,-1.1083052957344426,662737867,663906964.2,31.99602512796551,60.244361112154515,NaN,NaN,-23.682027003936646,-13.35171440570795
2019-06-05T09:30:00-04:00,113.64,113.78,112.43,113.55,5258624,4943769.3,46.267712875531934,39.61440902302267,NaN,NaN,-36.92906918685817,-110.62763896164299,-0.18626676813453025,-1.3411387559026053,-1.154871987768075,667996491,664422557.4,33.70501431227217,57.382003007397245,NaN,NaN,-21.011368109069608,-14.44595064904533
2019-06-06T09:30:00-04:00,113.55,114.41,113.08,114.13,3659817,4769125.1,48.519062723315336,39.60983556167041,NaN,NaN,-7.270612135525403,-88.50855066476149,-0.0068655652277131995,-1.1634539443027165,-1.1565883790750033,671656308,664890585.2,35.29463840739301,54.40004647868899,NaN,NaN,-18.139433505796614,-14.973591057152655
2019-06-07T09:30:00-04:00,114.63,116.13,114.45,115.78,4044915,4652218.5,54.37565436317042,40.27572218074446,NaN,NaN,63.39630851484652,-45.724773610046284,0.22178307822736065,-0.8793595312908025,-1.1011426095181631,675701223,667018045.2,42.09180929163579,51.88381838574206,NaN,NaN,-13.673249881085997,-14.787828032000276
2019-06-10T09:30:00-04:00,116.52,117.8001,116.44,116.76,3729915,4497674,57.470344546099014,41.37905250520138,NaN,NaN,128.3403380487054,12.189327962341014,0.42604960036750283,-0.5685806090587846,-0.9946302094262874,679431138,671504605.4,53.24611210826624,50.06733890693386,NaN,NaN,-8.979782756636725,-13.958107278376911
2019-06-11T09:30:00-04:00,117.69,118.22,116.72,117.21,5029539,4367041.4,58.850586732251536,42.307706659638214,NaN,NaN,124.79875785689248,54.46714461961218,0.5695314775590508,-0.28271586247747393,-0.8522473400365247,684460677,675849167.4,61.06672148545422,48.73312860114289,NaN,NaN,-4.783160239749046,-12.64740055857293
2019-06-12T09:30:00-04:00,117.17,117.63,116.92,117.18,2792922,4276890.1,58.7137833222375,43.539679058495,NaN,NaN,106.81486131102679,83.21593071918916,0.6354626037219285,-0.057919085384114055,-0.6933816891060426,681667755,678583420.2,65.03115796755247,47.951578685566226,NaN,NaN,-1.4937756048726876,-11.054025565187182
2019-06-13T09:30:00-04:00,117.61,118.4,117.54,118.23,3846360,4261369,62.03982058161409,45.33329034366814,NaN,NaN,121.77767052228009,109.02558725075025,0.716804932076612,0.20262447598972244,-0.5141804560868896,685514115,681354981.6,68.5292998091008,48.182284144321365,NaN,NaN,2.3599409591599962,-9.137744633137585
2019-06-14T09:30:00-04:00,118.21,118.73,117.97,118.49,2547213,4207935.2,62.83816070300599,47.128542310719034,NaN,NaN,125.3089828399234,121.40812211576562,0.7514929062854313,0.4251856767698996,-0.3263072295155317,688061328,683827002.6,71.28815902347773,48.93416915158099,NaN,NaN,5.75023669981429,-7.010890157001603
2019-06-17T09:30:00-04:00,118.71,118.94,118.4,118.54,2682356,4158327.65,62.99931829318438,49.10251677134968,NaN,NaN,122.40088951989983,120.22023241000451,0.7400059204869733,0.598700171093185,-0.14130574939378837,690743684,686089511.8,73.57173113766711,50.17767831590987,NaN,NaN,8.571875274984976,-4.784780809574949
2019-06-18T09:30:00-04:00,119.38,120.22,119.06,119.44,4398769,4201344.45,65.86854920483012,51.48819499859788,NaN,NaN,131.05148852592356,121.47077854381072,0.752737922154888,0.7996166532998217,0.046878731144933655,695142453,688225867,75.54922065116739,52.184867088501015,NaN,NaN,11.875785597860697,-2.4046998942269995
2019-06-19T09:30:00-04:00,119.56,119.89,118.75,119.66,3065283,4171593.65,66.55135802139674,53.6310149436081,NaN,NaN,113.23552910886,122.75491210337736,0.7348708300170719,0.9654672686662735,0.23059643864920162,698207736,691533863.2,78.2615935737584,54.63865974339681,NaN,NaN,14.827768842854328,0.05708135392747549
2019-06-20T09:30:00-04:00,120.64,120.79,119.55,120.49,4188593,4183751.75,69.06570221123496,56.256062135634934,NaN,NaN,116.45869685483638,121.69111736988864,0.736015296836694,1.1506155596950691,0.41460026285837515,702396329,694910306,80.62421956011863,57.473524818348835,NaN,NaN,18.142446747287693,2.6407049815503636
2019-06-21T09:30:00-04:00,119.94,120.26,119.51,119.52,5221439,4196999.3,63.0963299603138,58.62367170977803,NaN,NaN,93.4024384457593,115.3098084910558,0.6324665230400427,1.2051834166584285,0.5727168936183858,697174890,696733018.4,81.7757124638674,60.85938677997835,NaN,NaN,19.39395707765984,5.034026709566003
2019-06-24T09:30:00-04:00,119.57,119.72,118.84,118.88,2890305,4209887.25,59.445606663384105,59.721570728683595,NaN,NaN,72.12984953378816,105.25560049383348,0.4883445620178736,1.1831475961407278,0.6948030341228543,694284585,697441198.6,82.21788900041406,64.44666277086752,NaN,NaN,19.428069551634643,7.090318544147237
2019-06-25T09:30:00-04:00,119.12,119.29,117.56,117.74,3197210,4163849.35,53.50687175242096,60.23865350560424,NaN,NaN,46.59475628563374,88.36425404577552,0.29332535667544013,1.0614597299671544,0.7681343732917143,691087375,696630183,79.8291070048771,67.7412408203393,NaN,NaN,17.691542494775607,8.604779108522719
2019-06-26T09:30:00-04:00,118.17,118.585,117.99,118.12,2438103,4047318.45,55.116495476930034,60.70989870229101,NaN,NaN,43.12595250354824,74.34233872471317,0.17296227481590554,0.9843372168115962,0.8113749419956907,693525478,695693731.4,77.04555960830805,70.72344947754752,NaN,NaN,16.701383151130656,9.761436828895281
2019-06-27T09:30:00-04:00,118.53,118.99,118.3341,118.86,1954508,3950161.65,58.15468749441327,60.97982964023692,NaN,NaN,51.69246141555865,61.38909163685763,0.12828197943100883,0.9717274162844518,0.843445436853443,695479986,694310462.8,72.99657877085822,72.9309330117777,NaN,NaN,16.716995843762735,10.75508811673349
2019-06-28T09:30:00-04:00,119.04,119.45,119,119.2,6663696,4070734.15,59.510811525267215,61.125577281606084,NaN,NaN,62.63017578938755,55.23463910558328,0.1075609571969951,0.9778966333496868,0.8703356761526917,702143682,695304221.2,74.05161510417956,74.41704036862866,NaN,NaN,17.110658355829393,11.663026722318618
2019-07-01T09:30:00-04:00,120.71,121.26,119.74,120.25,4149736,3874941.65,63.45023157835201,61.45412334204183,NaN,NaN,101.34889190730705,61.07844758028705,0.14800876156282372,1.0553466281062214,0.9073378665433977,706293418,697705987.8,76.44677082664607,75.51561532157093,NaN,NaN,18.611294801940527,12.65563644797889
2019-07-02T09:30:00-04:00,120.1,120.57,119.63,120.51,9008528,4038391.55,64.37455145523293,61.85846392297008,NaN,NaN,96.31700045147608,71.02289641345551,0.17392236433999197,1.1247408219683876,0.9508184576283957,715301946,702548902,80.37950083930436,76.61192552669607,NaN,NaN,20.118584525656843,13.721771887647169
2019-07-03T09:30:00-04:00,120.87,121.56,120.64,121.56,1809553,3865938,67.90460301703928,62.277376954071876,NaN,NaN,141.06082253018948,90.60987041878374,0.23938732742463298,1.250052616909187,1.010665289484554,717111499,707266106.2,83.30381202441339,77.66724782778981,NaN,NaN,22.50402119934948,14.97637893217607
2019-07-05T09:30:00-04:00,120.98,121.81,120.65,121.7,3377531,3851823.7,68.35485048566629,62.67142622426189,NaN,NaN,141.71332139884967,108.61404241544196,0.2675908491558594,1.3451538509293783,1.077563001773519,720489030,712267915,85.73210236054999,78.69895806615213,NaN,NaN,24.590371025856243,16.34980637413038
2019-07-08T09:30:00-04:00,121.32,121.95,121.2,121.85,5074579,3903306.9,68.85891962593922,63.08996917660153,NaN,NaN,147.35797489426454,125.55960223641736,0.2709894290724555,1.4162997881140882,1.1453103590416327,725563609,716951900.4,87.55715760794496,79.6979170997434,NaN,NaN,26.467128215399207,17.795138065740215
2019-07-09T09:30:00-04:00,121.38,122.14,121.25,121.98,1933470,3813484.65,69.31510812508876,63.33615195661999,NaN,NaN,137.94891538570448,132.87960693209683,0.2567685998353777,1.4662711088358549,1.2095025090004772,727497079,721192632.6,88.9369137261983,80.65418089081705,NaN,NaN,28.167342559913855,19.276881564907878
2019-07-10T09:30:00-04:00,122.51,122.6,121.77,122.42,2385061,3681260.75,70.87049275321719,63.644661580321454,NaN,NaN,145.13229693712523,142.64266622922668,0.2514479938583767,1.523812501323448,1.2723645074650713,729882140,724108671.4,89.77641806331944,81.4766683543571,NaN,NaN,30.0665538754673,20.818263323559226
2019-07-11T09:30:00-04:00,122.83,123.06,122.4,122.67,1976179,3640423.6,71.74679307469175,63.83616807056837,NaN,NaN,148.78956161321477,144.18841404583173,0.23928633338593874,1.5714724241974949,1.3321860908115561,731858319,727058035.4,90.5569301075279,82.18614767917207,NaN,NaN,31.927757368919412,22.405333901467824
2019-07-12T09:30:00-04:00,123.01,124.109,123.01,124.08,2487718,3572491.5,76.11164796940272,64.76583364264614,NaN,NaN,175.45233024812362,150.93621581568652,0.2969574748992312,1.703382934435595,1.4064254595363639,734346037,729829436.8,91.23414507251326,82.86175000836104,NaN,NaN,34.9817342518883,24.201962522956464
2019-07-15T09:30:00-04:00,124.35,124.54,123.85,124.48,1996598,3544960.75,77.18832346079415,66.03317055674687,NaN,NaN,169.55299932173975,155.37522070118158,0.33024258066635737,1.8192286853693105,1.4889861047029531,736342635,731985242,91.73092607918761,83.54125265684488,NaN,NaN,37.88040220389154,26.156025334518617
2019-07-16T09:30:00-04:00,124.3,124.6,123.93,124.32,2051749,3513430.4,75.71823392150814,67.61969642596738,NaN,NaN,144.7282699437967,156.7310916128,0.31000755003803393,1.8764955422504954,1.5664879922124615,734290886,733344003.4,92.03723046788565,84.4132614756312,NaN,NaN,39.89237326980831,28.118360753845717
2019-07-17T09:30:00-04:00,124.17,124.3499,123.13,123.13,2299627,3408473.3,65.69643580387049,68.37540644932027,NaN,NaN,100.5479636899774,147.81422496337044,0.19084912486990535,1.8050493982998432,1.6142002734299379,731991259,733765827.2,92.13463691058547,85.49105271150816,NaN,NaN,38.77931783718098,29.641354622893612
2019-07-18T09:30:00-04:00,122.88,123.21,122.15,122.97,2323053,3371361.8,64.46105656529944,68.825861382955,NaN,NaN,63.733599304181105,130.80303250156368,0.08123112398794108,1.7157391784148643,1.6345080544269233,729668206,733327804.6,90.89127981221193,86.76924564303343,NaN,NaN,37.50707346367409,30.765028743005107
2019-07-19T09:30:00-04:00,123.35,123.52,122.09,122.16,2064128,3265138.55,58.46702274973464,68.75130504184553,NaN,NaN,51.35029354207754,105.98262516035447,-0.05832739068321713,1.5615988160729017,1.6199262067561189,727604078,731979412.8,86.99910788358811,87.69406655584831,NaN,NaN,34.593636640569954,31.311972728371515
2019-07-22T09:30:00-04:00,122.37,122.57,121.76,122.23,2017022,3104917.7,58.82336744698429,68.42081474674784,NaN,NaN,31.299767750500997,78.33197884610672,-0.1530436673234017,1.4286216226018666,1.5816652899252683,729621100,730635105.8,83.1750041097543,88.1746546474989,NaN,NaN,32.30649042423758,31.45404668492381
2019-07-23T09:30:00-04:00,122.94,123.06,122.04,123.06,2429207,3081862.8,62.88913924903246,68.31471387487638,NaN,NaN,48.59664608526552,59.10565407440047,-0.1658382721947642,1.374367449681813,1.5402057218765772,732050307,730186990,81.88293790718485,88.28204300949038,NaN,NaN,31.42284210218834,31.44958888739017
2019-07-24T09:30:00-04:00,122.54,123.69,122.52,123.68,2116785,3027841.55,65.61998118320057,68.15152660103071,NaN,NaN,68.8112583046862,52.75831299734223,-0.13963897639225897,1.3656570013862535,1.5052959777785124,734167092,730622156.6,82.17255948352167,88.20123925656954,NaN,NaN,31.455488226107537,31.45043165006408
2019-07-25T09:30:00-04:00,123.28,123.64,122.79,122.99,2399525,3025912.65,60.301746354490874,67.57630487737534,NaN,NaN,56.25582609599366,51.262758355704726,-0.17365534359090296,1.2882267982898838,1.4618821418807868,731767567,731042028.8,82.46384821562627,87.96779253193212,NaN,NaN,29.8830302542485,31.226517164947566
2019-07-26T09:30:00-04:00,123.17,123.65,122.76,123.55,2140166,3035195.55,62.92779883514564,67.15265339231864,NaN,NaN,61.3100563982547,53.25471092694016,-0.1634626521824838,1.257553826652682,1.4210164788351658,733907733,732302759.8,83.34388032087408,87.66684415428419,NaN,NaN,29.3206968538125,30.9542571204997
2019-07-29T09:30:00-04:00,123.24,123.45,122.51,122.95,2205413,2812281.4,58.46530026463602,66.37766711657203,NaN,NaN,32.62128335911634,53.51901404866324,-0.19975082261629118,1.1713279505648018,1.371078773181093,731702320,732719003.8,83.6358699197703,87.28819816811077,NaN,NaN,27.489122319002394,30.459237863142942
2019-07-30T09:30:00-04:00,122.11,122.48,121.92,122.12,2165182,2713053.7,52.8789298146446,65.09255547810254,NaN,NaN,-36.907393543208876,36.41820612296836,-0.27749280105923324,1.0242127718570515,1.3017055729162847,729537138,732216370,81.77170224007214,86.71643275216455,NaN,NaN,24.148142694770485,29.557652839089734
2019-07-31T09:30:00-04:00,122.08,122.1364,119.61,120.72,4301714,2477713,45.05831155510809,63.186235369560855,NaN,NaN,-158.34038392410534,-9.012122322789903,-0.4128854664475352,0.7855987398568658,1.198484206304401,725235424,730430036.4,75.34426074175731,85.62981351175236,NaN,NaN,18.487613012565504,27.976218578157702
2019-08-01T09:30:00-04:00,120.95,122.14,118.65,119.08,6631779,2718824.3,37.973345320038945,60.462070894606306,NaN,NaN,-208.26659449081384,-61.916606440151405,-0.5916901481084105,0.45887152116888785,1.0505616692772983,718603645,727797252,66.9870156990184,83.89787569935986,NaN,NaN,10.875096058564102,25.533201075358615
2019-08-02T09:30:00-04:00,118.67,119.0846,117.64,118.1,5550186,2827457.05,34.48397470002152,57.41176026883683,NaN,NaN,-269.498169202239,-128.07825156025015,-0.744863164011211,0.1194827142632846,0.8643458782744956,713053459,723626397.2,56.32769768958252,81.36907367153094,NaN,NaN,3.3729270057632004,22.367447636844986
2019-08-05T09:30:00-04:00,116.1,116.11,114.09,114.93,6890823,2918269.25,26.12223792398713,53.869189126156755,NaN,NaN,-322.33446618649884,-199.0694014693732,-1.012004155724279,-0.40065931638085317,0.6113448393434259,706162636,718518460.4,46.556938113474146,78.12048136050154,NaN,NaN,-7.181181559587209,18.14621489449753
2019-08-06T09:30:00-04:00,115.72,116.83,115.07,116.68,4447830,3043987.25,35.43052744428202,51.70733852904329,NaN,NaN,-199.53025414465972,-231.59397358966334,-1.0202846263722862,-0.6640109436219319,0.3562736827503543,710610466,714733126,40.89551712671244,74.46054423308203,NaN,NaN,-11.81145086665195,13.86654835719046
2019-08-07T09:30:00-04:00,115.46,117.3,114.85,117.15,5844916,3216980,37.70082579827987,49.795893474256175,NaN,NaN,-151.38671716097875,-230.20324023703802,-0.9452434360649125,-0.8252806123307863,0.11996282373412617,716455382,712977117.6,38.553389144426255,70.72212347109733,NaN,NaN,-14.37411162177492,9.832168360195407
2019-08-08T09:30:00-04:00,117.91,119.43,117.8,119.41,4669197,3351630.9,47.29677894418091,48.998018916716624,NaN,NaN,-68.90636882751387,-202.33119510437805,-0.7055236068476225,-0.7619416848254019,-0.05641807797777945,721124579,713481304.4,39.62258919156209,67.33808642166692,NaN,NaN,-12.76167661624949,6.604476220703279
2019-08-09T09:30:00-04:00,119.05,119.32,117.62,118.29,3976369,3426063.45,43.704070430801515,47.91806912984644,NaN,NaN,-72.22567728249479,-162.87669672042918,-0.5892485793737494,-0.7929788021949662,-0.2037302228212168,717148210,714300254.6,41.40605377242841,64.35458996900078,NaN,NaN,-12.853620180463956,3.8247481633936737
2019-08-12T09:30:00-04:00,117.48,117.55,116.08,116.57,3201285,3486297.8,38.82639803273483,46.19930190011088,NaN,NaN,-103.0762060591616,-119.02504469496174,-0.5933892727704609,-0.945466813784293,-0.35207754101383204,713946925,715857112.4,44.747380997261594,61.702050189720545,NaN,NaN,-14.758701673636262,1.1699696152465404
2019-08-13T09:30:00-04:00,116.4,119.5,116.01,118.49,4642874,3615854.05,46.06300451316735,44.802374995108515,NaN,NaN,-62.20413273221351,-91.55982041247249,-0.4391383946993943,-0.9010005343880749,-0.4618621396886806,718589799,717452979,48.01957049742335,59.26255097642781,NaN,NaN,-13.555110121538394,-0.9336132042941645
2019-08-14T09:30:00-04:00,116.46,116.65,114.72,114.78,6406512,3821198.3,36.96377556249893,43.1353770813948,NaN,NaN,-115.95084960439306,-84.47264690115537,-0.5519893961663197,-1.1518488848965802,-0.5998594887302605,712183287,716598560,46.43401724894216,56.68899162166467,NaN,NaN,-16.224218523590395,-3.1179853927650543
2019-08-15T09:30:00-04:00,115.48,115.65,113.63,114.59,5055419,3957816.6,36.56540513185696,41.25234895973133,NaN,NaN,-119.18187684755236,-94.52774850516306,-0.60044257300201,-1.350412704982773,-0.749970131980763,707127868,713799217.8,41.588845240387634,53.70648911591564,NaN,NaN,-18.292248728402676,-5.2857372978561425
2019-08-16T09:30:00-04:00,115.42,116.115,115.08,115.89,3980350,4053627.7,41.23225900035383,40.02141744085403,NaN,NaN,-84.75351466520074,-97.03331598170425,-0.5095355961879793,-1.3868896272157372,-0.8773540310277579,711108218,712591219.4,39.66539998303311,50.56574126329156,NaN,NaN,-18.243557752958925,-7.136854505727968
2019-08-19T09:30:00-04:00,117.48,117.7768,116.985,117.35,3122723,4108912.75,46.03413926603319,39.53250383023893,NaN,NaN,-40.09960608968207,-84.43799598780835,-0.3246737079593961,-1.283196165977003,-0.9585224580176069,714230941,712648022.6,39.806375789559304,47.568217945397784,NaN,NaN,-16.497512228303435,-8.47409132323875
2019-08-20T09:30:00-04:00,117.33,118.12,117.12,117.38,3267072,4150806,46.131539494640855,39.60916296877699,NaN,NaN,-31.461380774893534,-78.28944559634435,-0.18113272932008995,-1.1849383696677194,-1.0038056403476294,717498013,712429665.4,39.425020760142026,45.00255794671097,NaN,NaN,-15.138214237470986,-9.426108882414782
2019-08-21T09:30:00-04:00,119.34,119.64,119.06,119.64,4670547,4278494.1,53.011753875651884,40.68333500846363,NaN,NaN,27.388171774654037,-49.62164132053494,0.07171067686011301,-0.9141672942724881,-0.9858779711326011,722168560,714426720,44.6479886056271,43.406913154325885,NaN,NaN,-11.603024524439556,-9.737096831275464
2019-08-22T09:30:00-04:00,119.94,120.26,118.85,119.67,2952113,4306123.5,53.09739096681757,42.0128647418062,NaN,NaN,40.68884889735434,-17.6474961715536,0.23733142447562638,-0.6892136905380681,-0.9265451150136945,725120673,718025281,52.58197033042001,43.139361200099984,NaN,NaN,-8.845426883286722,-9.609715410134214
2019-08-23T09:30:00-04:00,118.75,119.35,116.0002,116.49,7691828,4583706.6,43.953053020231216,43.28649439153792,NaN,NaN,-27.944229036929997,-6.285639045899453,0.13420495904286933,-0.7587889162101078,-0.8929938752529771,717428845,719289406.4,55.02098121268318,43.74393570718636,NaN,NaN,-9.425372839719337,-9.583380757217803
2019-08-26T09:30:00-04:00,117.37,117.65,116.53,117.64,3452091,4646040.5,47.47589490670122,44.14687778171072,NaN,NaN,-20.4426441260003,-2.354246653163096,0.14406361077852292,-0.7129143617798235,-0.8569779725583464,720880936,720619405.4,57.49797919944466,44.92982585523866,NaN,NaN,-8.71420534656272,-9.459212841409935
2019-08-27T09:30:00-04:00,118.1,118.27,116.89,117.06,3353436,4705453.2,45.908602253205665,44.73314752849114,NaN,NaN,-5.594946953564708,2.8190401111026695,0.11348942974064402,-0.7151161853825414,-0.8286056151231854,717527500,720625302.8,57.50915310556094,46.28380899531971,NaN,NaN,-8.646506568905961,-9.343111945337938
2019-08-28T09:30:00-04:00,116.9,118.61,116.6,118.52,3891185,4684926.75,50.351746937051466,44.951359527981886,NaN,NaN,30.648903482521938,3.4711864526762555,0.1891048503470114,-0.5922245521894212,-0.7813294025364326,721418685,720475327.8,57.09804161084308,47.53205559669692,NaN,NaN,-7.166606521140241,-9.032182599023981
2019-08-29T09:30:00-04:00,119.88,120.54,119.51,120.3,2939487,4500312.15,55.184979380803476,45.77142445298203,NaN,NaN,154.92708410005383,26.318833493216157,0.3473046149485217,-0.3471986338507804,-0.6945032487993021,724358172,720322827.6,56.65454163147555,48.621233300914575,NaN,NaN,-4.3232713699455205,-8.359480994869916
2019-08-30T09:30:00-04:00,120.56,120.8148,119.32,119.58,3413757,4393490.7,52.93998776072376,46.77953800498124,NaN,NaN,128.80468407510298,57.668616115622754,0.3886378163543285,-0.2087059783563916,-0.5973437947107201,720944415,721025941.6,58.26415516842544,49.586717170283414,NaN,NaN,-2.7200974467053407,-7.553854773703548
2019-09-03T09:30:00-04:00,119.01,119.83,118.58,119.09,4322516,4265075.35,51.40725472287859,47.16127016281776,NaN,NaN,80.46805568121754,77.85075607706632,0.36834684379431004,-0.13691023996783258,-0.5052570837621426,716621899,720174134.2,55.571797183943936,50.12616193360632,NaN,NaN,-1.8769743237192489,-6.7428718522772195
2019-09-04T09:30:00-04:00,119.7,120.38,119.178,120.27,4172500,4251308.85,54.801020909115614,48.435359116147524,NaN,NaN,108.57133939695319,100.6840133471699,0.4162306807715682,0.015031267202317622,-0.4011994135692506,720794399,720827514,57.205337781213494,50.8955419716257,NaN,NaN,-0.13585841214055278,-5.799012789400553
2019-09-05T09:30:00-04:00,121.4,122.69,121.4,122.57,3671890,4142657.55,60.580075337862645,50.15069270229078,NaN,NaN,188.9610105074204,132.3464347521496,0.5748621273021105,0.31737824555838756,-0.25748388174372294,724466289,721437034.8,58.72979527658542,52.11989554563983,NaN,NaN,3.2712909908340353,-4.503255106509898
2019-09-06T09:30:00-04:00,122.72,123.18,122.46,122.87,3493456,4083870.5,61.27556605779472,51.58235749210799,NaN,NaN,180.9876276213904,137.5585434564169,0.6656467527036617,0.5745745591358542,-0.09107219356780749,727959745,722157349.4,60.51967877862524,53.60948688818212,NaN,NaN,6.212040648182078,-2.97249857012533
2019-09-09T09:30:00-04:00,123.29,123.66,122.88,123.34,3259252,4048014.65,62.394959846796596,52.75098753359108,NaN,NaN,163.08505255719837,144.414617152836,0.7184790842079649,0.8070266616921487,0.08854757748418374,731218997,724212265.8,65.16164905786177,55.420577835917996,NaN,NaN,8.960199012384098,-1.2678274869096975
2019-09-10T09:30:00-04:00,122.79,122.95,121.62,122.85,3650572,4070479,60.4335916635383,53.77256268851233,NaN,NaN,118.4672609497248,152.01445820653743,0.6818515786056036,0.9408620507411882,0.25901047213558465,727568425,726401571,69.3027681984797,57.55470265294212,NaN,NaN,10.700699695987414,0.4419621106470326
2019-09-11T09:30:00-04:00,122.82,123.33,122.28,123.08,3408853,4008777.95,61.052470975789674,54.34689962423646,NaN,NaN,116.68263150089713,153.63671662732622,0.6354670948742644,1.0533443407284153,0.4178772458541508,730977278,728438146.8,72.5692266679216,59.54907680024886,NaN,NaN,12.315379453468402,2.1381645881929425
2019-09-12T09:30:00-04:00,123.67,124.39,123.37,123.67,3343189,3855611.8,62.66570064693426,55.03035031567337,NaN,NaN,131.25770088125213,142.09605470209257,0.6069246784830677,1.1765330939579854,0.5696084154749177,734320467,730408982.4,75.3075039488767,61.1723292015672,NaN,NaN,14.136857988602177,3.8522636453942614
2019-09-13T09:30:00-04:00,123.98,124.15,123.32,123.42,2014872,3703584.45,61.50321712523635,56.283933466030874,NaN,NaN,113.62946691709267,128.62442256123305,0.5360714231563517,1.2396976944203573,0.7036262712640056,732305595,731278152.4,76.4252065972484,62.70120244332186,NaN,NaN,15.372340605852514,5.497988925459726
2019-09-16T09:30:00-04:00,122.61,122.705,121.71,121.84,3401308,3674632.35,54.60846529588159,56.79340277954375,NaN,NaN,56.98864252891234,107.4051405555758,0.356313490318764,1.1490181341624606,0.7927046438436965,728904287,730815210.4,74.4911355626856,63.9149993264105,NaN,NaN,14.593186518984307,6.797302867391809
2019-09-17T09:30:00-04:00,121.63,122.615,121.31,122.58,2256638,3631328.1,57.037690300567725,57.58833764006961,NaN,NaN,52.72568792671153,94.25682595097317,0.2649642928645297,1.1239100099243586,0.8589457170598289,731160925,731533710.4,75.52632506452022,65.20194018062188,NaN,NaN,14.590199974416063,7.910573882680988
2019-09-18T09:30:00-04:00,122.38,122.68,121.33,122.52,2980523,3617000.65,56.772392112508825,58.04695515260229,NaN,NaN,47.03419948811888,80.32713954841753,0.1821586155903644,1.0866439865477844,0.90448537095742,728180402,730974335.2,73.04114741545928,66.34073345238018,NaN,NaN,14.516930258028568,8.854339079159214
2019-09-19T09:30:00-04:00,122.78,122.93,122.14,122.19,2268844,3496915.5,55.250254189096665,58.051617638908944,NaN,NaN,50.217824808125314,64.11916433379216,0.09140271611958939,1.0187387661069067,0.9273360499873173,725911558,729292553.4,66.00862835934171,67.00888250437062,NaN,NaN,14.055756966726651,9.597398777383134
2019-09-20T09:30:00-04:00,122.02,122.33,120.38,120.39,3815158,3540067.75,47.73270755383525,57.67966905270263,NaN,NaN,1.090852150096046,41.61144138039283,-0.09359894547621894,0.8103373681420436,0.9039363136182625,722096400,727250714.4,58.6281267600079,67.03488047519794,NaN,NaN,11.470606223092924,9.864999841055962
2019-09-23T09:30:00-04:00,120.07,121.16,119.91,120.81,2237796,3267366.15,49.46066422780105,57.54062687448279,NaN,NaN,-21.109377746184233,25.991837325373506,-0.1860853875214976,0.6713295792163905,0.8574149667378881,724334196,726336696.2,55.6295920685893,67.03900868124404,NaN,NaN,9.764836465225837,9.850690787365943
2019-09-24T09:30:00-04:00,121.43,121.78,119.24,119.52,5363060,3362914.6,44.585172740164296,56.81092343384342,NaN,NaN,-48.666608346323926,5.71337807076641,-0.32444086904038993,0.45186388043740067,0.7763047494777906,718971136,723898738.4,48.503775646029226,66.41746852873088,NaN,NaN,6.809417404342753,9.416223161219774
2019-09-25T09:30:00-04:00,120,120.79,119.06,120.61,3256470,3358066.3,49.14659200155777,55.99424605267878,NaN,NaN,-61.694313719153364,-16.032324570688036,-0.3316678466533197,0.3617199411611409,0.6933877878144606,722227606,722708179.2,45.44251301828894,65.46837693885256,NaN,NaN,5.557795337940832,8.86501918646564
2019-09-26T09:30:00-04:00,120.6,120.89,119.5428,120.09,3020459,3314530,47.152521719490565,54.985457171371344,NaN,NaN,-72.51116209879437,-40.578121952071974,-0.358317668925203,0.24549070165795683,0.6038083705831598,719207147,721367297,42.21121364847474,64.16062942955608,NaN,NaN,3.929041852682685,8.159879567353789
2019-09-27T09:30:00-04:00,120.48,120.55,119.03,119.67,3557054,3345408.35,45.5451374969955,53.781898432099844,NaN,NaN,-92.21556968165248,-59.23940631842167,-0.3885458813965842,0.11812601883742957,0.5066719002340138,715650093,720078035.6,39.31638120760768,62.31453886882365,NaN,NaN,2.1049476748933,7.294889297002291
2019-09-30T09:30:00-04:00,119.92,120.86,119.87,120.7,2494186,3299429.8,50.04278689340266,53.039698091375854,NaN,NaN,-57.79328729558257,-66.57618822830133,-0.3260111594785168,0.09915795088586776,0.42516911036438454,718144279,718840052.2,36.71279722084695,59.986683798992736,NaN,NaN,1.7901912284857653,6.508503858642787
2019-10-01T09:30:00-04:00,120.98,121.43,119.65,119.69,3636896,3265148.8,46.02819240081624,51.96653533602061,NaN,NaN,-75.81338295146922,-72.0055431493304,-0.3380575896687829,0.0025971232784058884,0.3406547129471888,714507383,717947301.6,34.91708771687024,57.29724530248907,NaN,NaN,0.3344249378457197,5.6264925842432065
2019-10-02T09:30:00-04:00,119,119,116.95,117.54,5504988,3331773.2,38.8781647387246,50.26742562829135,NaN,NaN,-186.02972745524409,-96.87262589654856,-0.46820018247044903,-0.24459551514087252,0.2236046673295765,709002395,715302259.4,30.20339276236649,54.0755230748812,NaN,NaN,-3.322047482347407,4.348129717587405
2019-10-03T09:30:00-04:00,117.39,118.12,115.96,118.11,7231831,3509770.25,41.473866060155665,48.836757695071306,NaN,NaN,-173.248701021796,-117.02013368114888,-0.490889703821911,-0.39000746244781226,0.10088224137409875,716234226,714707675.2,29.247567181049263,50.70569168800983,NaN,NaN,-5.5078460809140655,2.9401331749443376
2019-10-04T09:30:00-04:00,118.39,119.3,118.245,119.22,3189184,3494556.65,46.26003999760816,48.2404416023375,NaN,NaN,-95.21975686605147,-117.62097111802868,-0.4094599241050935,-0.4109426637572682,-0.0014827396521746444,719423410,715462338.6,32.18114737124847,47.683549674335744,NaN,NaN,-5.876766450847672,1.6805760855454792
2019-10-07T09:30:00-04:00,118.89,119.46,118.38,118.7,2760797,3469633.9,44.42708619462632,47.33968416619882,NaN,NaN,-90.284699395016,-124.11925353791537,-0.3701284172443598,-0.4641432612076244,-0.0940148439632646,716662613,715166005.4,31.62662240201469,44.54785662701392,NaN,NaN,-6.735585557392872,0.4782672794114293
2019-10-08T09:30:00-04:00,117.8,118.74,117.43,117.45,2945797,3434395.15,40.293975937824406,46.16265443943565,NaN,NaN,-121.6378848174043,-133.28415391110238,-0.40498841186731666,-0.6002503587974104,-0.19526194693009374,713716816,715007892,31.31654757465128,41.56752806695622,NaN,NaN,-8.764660900859297,-0.8421510320558174
2019-10-09T09:30:00-04:00,118.28,118.87,117.93,118.45,3048708,3416387.9,44.72432443663101,45.410802314259534,NaN,NaN,-90.30584953159811,-114.13937832637319,-0.34000998966934765,-0.6202744340167783,-0.28026444434743064,716765524,716560517.8,37.768710179479086,39.550391054108886,NaN,NaN,-9.109023567465071,-2.023132822828568
2019-10-10T09:30:00-04:00,118.56,119.65,118.48,119.24,3274375,3412947.2,48.00663335276523,45.43036844275453,NaN,NaN,-52.87833961922899,-90.06530604585978,-0.22848781612127034,-0.5658742144990185,-0.3373863983777482,720039899,717321652.4,40.7092010714926,38.27046779064351,NaN,NaN,-8.385115036971522,-2.9319874248489897
2019-10-11T09:30:00-04:00,120.47,121.64,120.45,120.59,5315850,3577996.1,53.12868434855928,45.692369879951556,NaN,NaN,46.76608898092794,-61.668136876463905,-0.05738043585911107,-0.409111943201637,-0.35173150734252595,725355749,718508120.2,45.0665941291681,37.51596793782771,NaN,NaN,-6.130615652303726,-3.3889343144853807
2019-10-14T09:30:00-04:00,120.46,120.77,120.21,120.53,1575535,3486707.45,52.87934878837545,46.28481102625234,NaN,NaN,31.355003490403238,-37.34019629938006,0.052251941636556665,-0.28641658029683015,-0.3386685219333868,723780214,719931640.4,49.830584123619346,37.61073997194129,NaN,NaN,-4.406996775097678,-3.534371808858566
2019-10-15T09:30:00-04:00,120.92,121.87,120.84,121.59,2556820,3501716.55,56.74179915321799,46.8273258227995,NaN,NaN,89.5354986671885,4.8944803975384845,0.1889625587109786,-0.10246532354466353,-0.29142788225564215,726337034,722455684,56.95817683669952,38.433287387542045,NaN,NaN,-1.739636359733596,-3.2779810304121417
2019-10-16T09:30:00-04:00,121.62,122.2063,121.57,122.09,3072809,3506330.85,58.47102478583518,47.63579032753841,NaN,NaN,122.13140669118116,47.38193164209434,0.29931011967767823,0.08270976734145563,-0.2166003523362226,729409843,724984547.8,62.679135345216736,39.89528179445218,NaN,NaN,0.995409373717422,-2.667496686965061
2019-10-17T09:30:00-04:00,122.74,122.91,122.18,122.41,2307071,3508242.2,59.584538103929766,48.63860465660514,NaN,NaN,154.0172767888049,88.76105492370112,0.3751798585326075,0.2523744708295368,-0.12280538770307071,731716914,727319950.8,67.03657646346932,41.875295741299446,NaN,NaN,3.586519134345184,-1.7740658553493118
2019-10-18T09:30:00-04:00,122.1,122.57,121.67,122.17,2061372,3420552.9,58.321493223256375,49.229940823023256,NaN,NaN,124.15955877122529,104.2397488817606,0.3888693468281443,0.36328129583210966,-0.02558805099603463,729655542,728179909.4,68.49524408568558,44.14547051735935,NaN,NaN,5.405212338699453,-0.748454684770917
2019-10-21T09:30:00-04:00,122.79,123.15,122.26,122.6,2410230,3429174.6,59.959177187167874,50.22501116490552,NaN,NaN,139.11063682601292,125.79087554888254,0.4047393559636587,0.48033614395853874,0.07559678799488005,732065772,729837021,71.14498959364164,46.73317779427159,NaN,NaN,7.409595621899415,0.4169810733248447
2019-10-22T09:30:00-04:00,122.47,122.5,121.77,121.82,2747944,3298418.8,55.68486766849744,51.42548994560358,NaN,NaN,94.14488391425202,126.71275259829524,0.3430022851331749,0.5043496444113487,0.16134735927817379,729317828,730433179.8,72.05556976596368,49.722619008814256,NaN,NaN,8.001645585076307,1.500504575003625
2019-10-23T09:30:00-04:00,121.68,121.68,120.3553,121.26,1887637,3229977.15,52.77599417514325,52.232784810959835,NaN,NaN,43.350487497469125,110.95656875955282,0.24911707379741924,0.4727437015249478,0.2236266277275286,727430191,730037249.4,70.46514590539397,52.66673177483887,NaN,NaN,7.708656339110466,2.3873833984474593
2019-10-24T09:30:00-04:00,121.48,121.59,120.86,121.2,2203784,3189143.4,52.4597939828013,52.67562438133076,NaN,NaN,45.3037742444393,89.21386825067971,0.1713446924285772,0.4378074932632501,0.2664628008346729,725226407,728739148,65.37063514732213,55.03740947312985,NaN,NaN,7.380708568224679,3.100715565558491
2019-10-25T09:30:00-04:00,119.72,121.44,119.44,121.06,2737404,3148160.9,51.68171428050388,53.19381210175059,NaN,NaN,16.172866771919967,67.61652985081864,0.10225253515079735,0.3942784697731696,0.29202593462237225,722489003,727305840.2,60.1956537500897,57.07805456942092,NaN,NaN,6.901308782029905,3.6436574536258357
2019-10-28T09:30:00-04:00,121.37,121.75,121.19,121.44,2057940,3126348.6,53.689499373672724,54.150635204311186,NaN,NaN,51.5550425063007,50.10541098687622,0.07517503019729538,0.38599472236899146,0.3108196921716961,724546943,725802074.4,55.25355168285011,58.7878405771494,NaN,NaN,6.995477764747691,4.122488926643244
2019-10-29T09:30:00-04:00,121.46,121.53,120.71,120.75,2306907,3059849.15,49.65474895003144,54.50280838383979,NaN,NaN,27.792445699511596,36.83492334392813,0.007394703529628788,0.32006307158373204,0.31266836805410325,722240036,724386516,51.00815333043042,59.73351508793165,NaN,NaN,6.009014407071832,4.39199256670447
2019-10-30T09:30:00-04:00,120.68,121.51,120.18,121.5,2902071,2929703.3,53.72542563946408,54.91129354717542,NaN,NaN,26.195930640282366,33.40401197249078,0.009536375354117776,0.3245888372467505,0.3150524618926327,725142107,723928899.2,49.67925375397123,60.37423313668012,NaN,NaN,6.2296786671134745,4.654519152477185
2019-10-31T09:30:00-04:00,121.49,121.65,120.29,120.85,3126995,2724461.5,49.95553711097181,54.68464017306203,NaN,NaN,11.968294198164052,26.736915963235724,-0.03397493342988478,0.27258379510527675,0.30655872853516153,722015112,723286640.2,47.797133633771466,60.56927167272322,NaN,NaN,5.374244880166247,4.757337113575622
2019-11-01T09:30:00-04:00,121.47,121.6933,121.2,121.65,3214889,2725746.75,54.21390844810862,54.77996586304297,NaN,NaN,44.22993418740259,32.348329446332244,-0.011206663027266195,0.29255039975107877,0.30375706277834497,725230001,723834839.8,49.5538963297496,60.549508258875385,NaN,NaN,5.828031321572687,4.910293429003774
2019-11-04T09:30:00-05:00,122.01,122.17,121.5,121.71,4765942,2826004,54.52643895011411,54.621725848535554,NaN,NaN,59.68697000607678,33.97471494628746,0.004711284230245583,0.30964616806615197,0.3049348838359064,729995943,724924639.8,52.94409867462487,60.26278839015576,NaN,NaN,6.287973586792953,5.1071048801165135
2019-11-05T09:30:00-05:00,121.82,122.155,121.4,121.89,2154532,2786440.75,55.507622787986286,54.41005427726062,NaN,NaN,55.90429568133711,39.597084942652565,0.02314851824318581,0.33387053163988867,0.31072201339670286,732150475,726906727.6,58.41763435016683,59.95839546193791,NaN,NaN,6.938804232008958,5.368776216101148
2019-11-06T09:30:00-05:00,122.03,122.05,121.46,122.02,3611577,2814584.2,56.24197542545398,54.17129980022664,NaN,NaN,51.707801071694426,44.699459028934974,0.03895463876825411,0.35941531185702047,0.32046067308876636,735762052,729030716.6,63.33886600815602,59.694273286558385,NaN,NaN,7.6822531138271515,5.699272915776292
2019-11-07T09:30:00-05:00,122.29,122.429,121.15,121.29,3833565,2842543.7,51.137803337497935,53.658179094101044,NaN,NaN,16.163006354697327,45.53840146024163,-0.002688931008679174,0.3170995093279174,0.3197884403365966,731928487,731013391.6,67.23680320255005,59.6043846520487,NaN,NaN,6.9787902151670504,5.882061101403543
2019-11-08T09:30:00-05:00,121.5,121.54,120.86,121.34,2074719,2680487.15,51.462720015645836,53.05128929613518,NaN,NaN,-39.71376019970377,28.74966258282037,-0.028373922545553487,0.28432103715465473,0.3126949597002082,734003206,732768032.6,70.25132227436,59.54055127210001,NaN,NaN,6.472847691049909,5.966459185638738
2019-11-11T09:30:00-05:00,120.8,121.1255,120.65,121.09,1862828,2694851.8,49.683752196723425,52.62263819100848,NaN,NaN,-88.5930658738888,-0.9063445931727472,-0.06179056594815968,0.23545675226500862,0.2972473182131683,732140378,733196919.6,70.95479221676214,59.461924304299906,NaN,NaN,5.571975543656189,5.910104379641231
2019-11-12T09:30:00-05:00,121.18,121.63,120.76,121.01,2194507,2676736.15,49.09885254935312,52.35998521773775,NaN,NaN,-57.89180783071721,-23.66556529558361,-0.087311667239932,0.18810773416325333,0.2754194014031853,729945871,732755998.8,69.1445437767162,59.36759558082292,NaN,NaN,4.654771017232396,5.730771042154254
2019-11-13T09:30:00-05:00,120.7,120.92,120.32,120.63,2494867,2647839.05,46.31003335230059,51.92071660127341,NaN,NaN,-118.28629993252791,-57.664385496428075,-0.12549243559167395,0.11855385691359288,0.24404629250526683,727451004,731093789.2,62.65489302982172,59.17361400100147,NaN,NaN,3.118270519532037,5.357556681779652
2019-11-14T09:30:00-05:00,120.72,121.34,120.5535,121.15,1979897,2631480.35,50.45704586720085,51.83324028603749,NaN,NaN,-57.3513875712774,-72.36726428162302,-0.11188461894926696,0.10419051881868313,0.2160751377679501,729430901,730594272,60.80786903312375,59.21734366407532,NaN,NaN,2.817617139601997,4.994708175754273
2019-11-15T09:30:00-05:00,121.73,121.8374,121.1,121.37,2268382,2641830.85,52.14129815772642,51.722654484898456,NaN,NaN,13.434643761718641,-61.73758348933855,-0.08542035624516739,0.10929969246149085,0.19472004870665824,731699283,730133487.4,59.077758901085105,59.49050132252068,NaN,NaN,2.998496835116337,4.70953512709171
2019-11-18T09:30:00-05:00,121.4,121.795,121.05,121.79,2806173,2661628,55.267787280372545,52.12358579420853,NaN,NaN,48.664739350271994,-34.28602244450637,-0.039326999567243864,0.14556129924760342,0.18488829881484728,734505456,730606503,60.325675879942644,60.15603864748584,NaN,NaN,3.996046711739697,4.6076082106128515
2019-11-19T09:30:00-05:00,121.36,121.43,120.15,120.45,3164538,2682457.7,45.13651050558052,51.510091856074,NaN,NaN,-115.87696034412845,-45.883052947188624,-0.09557625112002469,0.06541798491481643,0.16099423603484112,731340918,730885512.4,61.079606804736024,60.97034957968332,NaN,NaN,1.9027835902970982,4.221204693424887
2019-11-20T09:30:00-05:00,120.78,120.97,119.6,120.17,4428263,2809489,43.34836545472698,51.03815102348508,NaN,NaN,-174.3350893665047,-57.09281083398398,-0.14515862683602096,-0.02045404751018509,0.12470457932583587,726912655,730777842.6,60.60101891889645,61.88491281433511,NaN,NaN,-0.3748617787132431,3.5646237688337252
2019-11-21T09:30:00-05:00,120.27,120.49,119.4401,119.49,2587194,2828659.5,39.27862591685962,49.97134512839587,NaN,NaN,-206.98208326429204,-87.01894997258691,-0.21315936352427742,-0.1417446250795109,0.0714147384447665,724325461,729756754.6,56.11081566678364,62.35326419555183,NaN,NaN,-3.628775375037694,2.536995319709237
2019-11-22T09:30:00-05:00,119.96,120.35,119.72,120.31,2385165,2811047.55,45.87738515488771,49.35355557159398,NaN,NaN,-143.55879591435996,-118.41763790780264,-0.19292733203024637,-0.16974442659304145,0.023182905437204915,726710626,728759023.2,52.05235268617772,62.289568053519886,NaN,NaN,-4.415477111446691,1.5437849724012473
2019-11-25T09:30:00-05:00,120.86,121.39,120.7709,121.37,3814210,2898861.05,52.98940751251647,49.173683051917564,NaN,NaN,15.139317895505009,-125.12272219875604,-0.1026973475839628,-0.10518877904274859,-0.0024914314587857894,730524836,727962899.2,49.00642367955249,61.61733871990458,NaN,NaN,-2.7313205040588584,0.9330556186212322
2019-11-26T09:30:00-05:00,121.33,122.28,121.2306,122.2,3774556,2972243.5,57.67892290081664,49.27632215730061,NaN,NaN,111.32901047952336,-79.68152803402566,0.012231998155055879,0.012798566235034059,0.0005665680799781803,734299392,728554594,51.287910134949364,60.75655615753267,NaN,NaN,0.29893741985846545,0.8424673045122655
2019-11-27T09:30:00-05:00,122.58,123.295,122.43,123.25,4213043,3037792.1,62.74234001948159,50.10521763458515,NaN,NaN,214.31268832684958,-1.951972495354812,0.15062964567264073,0.18885362517077908,0.03822397949813836,738512435,730874550,59.028153855229434,60.170224061295485,NaN,NaN,4.6858001329006695,1.3915148514248945
2019-11-29T09:30:00-05:00,123.33,123.39,122.32,122.45,1755092,2969196.95,57.13361593755995,50.51028162900759,NaN,NaN,154.4163224790008,70.32770865330376,0.1780757432199292,0.26081865852304986,0.08274291530312067,736757343,733360926.4,65.37773601415833,59.822110756995365,NaN,NaN,6.368691922916474,2.102540147352263
2019-12-02T09:30:00-05:00,122.54,122.6644,121.185,121.44,3594792,2988192.1,50.942109117995514,50.60016426624132,NaN,NaN,47.32762181678739,108.50499219953322,0.12073320890706989,0.23365942643695803,0.11292621752988814,733162551,734651311.4,68.13752709874143,59.62087753427961,NaN,NaN,5.59967390871617,2.602130684689964
2019-12-03T09:30:00-05:00,120.36,120.4217,119.55,120.22,4525809,2976185.45,44.64805682224741,50.28225028573377,NaN,NaN,-119.58771479920244,81.55958566059174,-0.00042409163086101764,0.11239610299131186,0.11282019462217288,728636742,734273692.6,66.4677792300271,59.42968006665895,NaN,NaN,2.66139633553192,2.6105972062388147
2019-12-04T09:30:00-05:00,120.69,121.32,120.63,120.89,2829149,3009916.3,48.417324215182454,50.4327710616539,NaN,NaN,-25.799726081214093,54.13383834844425,-0.03461163423805769,0.06955565182460077,0.10416728606265846,731465891,733706992.4,63.935615285949076,59.52116022781091,NaN,NaN,1.6343247006616404,2.4711297054420758
2019-12-05T09:30:00-05:00,121.34,121.34,120.51,120.77,2352313,2946953.1,47.78962893810223,50.242241281004006,NaN,NaN,-29.478093910714307,5.375681900931466,-0.06283311748308913,0.025625889208797048,0.08845900669188618,729113578,731827221,56.277035843190745,59.197529285672836,NaN,NaN,0.6359855730640963,2.2089662579595073
2019-12-06T09:30:00-05:00,121.66,122.04,121.65,121.74,2515613,2881055.5,53.08432699790326,50.30960048387378,NaN,NaN,70.46604394482804,-11.414373805903086,-0.016131310570365334,0.06829486847892952,0.08442617904929485,731629191,730801590.6,52.576476435735415,58.733151966719284,NaN,NaN,1.5451486900200029,2.1141351768252923
2019-12-09T09:30:00-05:00,121.65,122.325,121.5,121.89,2149393,2884789.2,53.86349889915415,50.2092941709296,NaN,NaN,72.78043287134946,-6.3238115949906675,0.022789059407802084,0.11291250330904745,0.09012344390124537,733778584,730924797.2,52.97649389269086,58.20821039620131,NaN,NaN,2.5076208142469145,2.170347410742667
2019-12-10T09:30:00-05:00,121.93,122.16,121.51,121.68,2179953,2900645.45,52.547722924408596,50.738666486560184,NaN,NaN,54.41864615157733,28.47746059516528,0.03176560550926083,0.1298304507878214,0.09806484527856058,731598631,731517175,54.944308890667536,57.7699748309107,NaN,NaN,2.8947439182145223,2.273832626095789
2019-12-11T09:30:00-05:00,121.59,122.06,121.36,121.99,2049670,2893403.6,54.321607216954945,51.52246946957647,NaN,NaN,51.282802646115755,43.89396634063125,0.05461616247808672,0.16633504837616897,0.11171888589808225,733648301,731953657,56.392360643948955,57.46935638270016,NaN,NaN,3.735107457461029,2.4825861734336803
2019-12-12T09:30:00-05:00,122.21,123.36,122.06,123.06,4613189,2999319.7,59.89448022869997,52.99503049185078,NaN,NaN,131.02420008488298,75.9944251397507,0.1333417599386873,0.2783960858214414,0.14505432588275408,738261490,733783239.4,61.91735513662585,57.88410920197462,NaN,NaN,6.217853293939386,3.0161957620773525
2019-12-13T09:30:00-05:00,123.05,123.38,122.54,123.17,3562464,3078448.05,60.42896985367747,54.034429398907186,NaN,NaN,131.62440342560907,88.22609703590692,0.18139295428522897,0.3717955187392903,0.1904025644540613,741823954,735822192,66.9438112101063,58.94778481082664,NaN,NaN,8.381673731515903,3.7826926148542883
2019-12-16T09:30:00-05:00,123.81,124,123.51,123.71,3646828,3147370.35,63.03349906515502,54.751864509809934,NaN,NaN,162.73747321376922,106.21750510439088,0.2347272682200921,0.48381164972917645,0.24908438150908435,745470782,738160631.6,71.57726068082084,60.55998745377438,NaN,NaN,11.008630499120166,4.814969455463699
2019-12-17T09:30:00-05:00,123.92,124.42,123.87,124.26,3409613,3177542.35,65.52258657745833,55.312126200998634,NaN,NaN,167.0795427041975,128.74968441491492,0.28868025200810715,0.6099346965192183,0.3212544445111111,748880395,741616984.4,76.76200063512042,62.37956534664374,NaN,NaN,14.00389347298712,6.127672886538473
2019-12-18T09:30:00-05:00,124.6,124.71,124.15,124.38,2639175,3151274.2,66.05955968211893,55.54907046261559,NaN,NaN,158.234252419928,150.13997436967736,0.31209314538126665,0.7113708762376945,0.3992777308564278,751519570,745191238.2,80.68567222119137,63.926530944212445,NaN,NaN,16.61791584405498,7.626279023326545
2019-12-19T09:30:00-05:00,124.29,124.87,124.115,124.77,3246544,3092188.25,67.81405481910696,56.311958954154655,NaN,NaN,142.63488701956092,152.46211175661296,0.3316562050061617,0.81384798711413,0.48219178210796826,754766114,748492163,83.46277238648571,65.21831925652155,NaN,NaN,19.356907954179004,9.302083156305468
2019-12-20T09:30:00-05:00,124.83,124.83,124.4,124.55,3336820,3129669.55,65.74929954465483,57.36961541320175,NaN,NaN,125.79238952774008,151.29570897703917,0.3080960490022162,0.8673118433607385,0.5592157943585223,751429294,750413231,84.82985127328996,66.41062812613215,NaN,NaN,21.104967557487324,10.988209499331447
2019-12-23T09:30:00-05:00,124.82,124.8399,124.26,124.26,3164156,3168619.1,63.025199215153975,58.68226844126651,NaN,NaN,106.34981180893789,140.01817669607289,0.2535727095023501,0.87618168123646,0.6226089717341099,748265138,750972102.2,85.2128256698558,67.74956001469135,NaN,NaN,21.865461876300106,12.542102696041255
2019-12-24T09:30:00-05:00,124.43,124.69,124.2601,124.54,1648079,3060312.55,64.55229004284735,59.83476600038542,NaN,NaN,98.41844826997273,126.28595780922792,0.21829857487452942,0.8954821903272716,0.6771836154527422,749913217,751178666.6,85.35993872868407,69.27986883202956,NaN,NaN,22.929004746213966,14.025945846065927
2019-12-26T09:30:00-05:00,124.91,126.06,124.775,126.06,2517945,2997482,71.44655256559938,61.52454625949237,NaN,NaN,140.5500360570635,122.74911453665501,0.27557495389088893,1.0216523078163533,0.7460773539254644,752431162,751360985,85.4970840733981,71.36701513418723,NaN,NaN,26.113529052017668,15.752743446916176
2019-12-27T09:30:00-05:00,126.47,126.73,125.89,126.05,2958904,2934775.05,71.3482366173119,62.82911123230726,NaN,NaN,144.06048666450448,123.03423446564375,0.28958856272121825,1.1080630573269872,0.8184744946057689,749472258,750302213.8,80.76535794126245,73.38050667029631,NaN,NaN,28.632256030879244,17.592673816053757
2019-12-30T09:30:00-05:00,126.16,126.2999,124.97,125.24,3338723,3013956.6,63.7017212767154,63.531841402133075,NaN,NaN,97.65820059650326,117.40739667939638,0.22403712684049215,1.098520903156384,0.8744837763158919,746133535,749243062,76.22088959424603,75.04082064897882,NaN,NaN,28.557177571041436,19.15903149533771
2019-12-31T09:30:00-05:00,125.03,125.48,124.85,125.42,1783733,2923403.65,64.60941683201906,64.3933909669624,NaN,NaN,78.76370198951881,111.89017471551256,0.17472103820278395,1.0928850740693719,0.9181640358665879,747917268,749173488,75.91869953872732,76.53899140955453,NaN,NaN,28.758062807972134,20.530321682856915
2020-01-02T09:30:00-05:00,126.21,126.91,125.72,126.91,6290687,3011647.55,71.06063369603228,65.58903571546792,NaN,NaN,125.05163554465226,117.21681217044848,0.22136909655604953,1.1948754065616498,0.9735063100056003,754207955,750032435.6,77.12451499665355,78.01985957760485,NaN,NaN,31.04706915515071,22.032714178898885
2020-01-03T09:30:00-05:00,125.3,126.2,125.22,125.83,5596424,3150011.3,62.20889509078512,65.75435106275971,NaN,NaN,84.98517421725862,106.10383980248749,0.16120431384684086,1.1750117023141513,1.0138073884673104,748611531,749268509.4,73.59497203049453,78.85397507002403,NaN,NaN,30.01745056033644,23.173390804818535
2020-01-06T09:30:00-05:00,124.91,126.21,124.75,126.18,6411570,3352974.15,63.78337267131172,65.9939512640193,NaN,NaN,79.50905560187601,93.1935535899618,0.12813709101520998,1.173978752236323,1.045841661221113,755023101,750378678,75.35976244230521,79.45511444375254,NaN,NaN,29.704108995849666,24.10635054639441
2020-01-07T09:30:00-05:00,126.1,126.27,125.45,125.98,9151127,3684749.85,62.18893822633464,65.93362548981784,NaN,NaN,85.09794011740037,90.68150149414122,0.07839576676009719,1.1438363696712344,1.0654406029111372,745871974,750326365.8,75.10503584749166,79.70709838422901,NaN,NaN,28.95524095349287,24.799049175979903
2020-01-08T09:30:00-05:00,125.87,127.05,125.75,126.36,4725972,3813578.8,64.0288290282677,65.8269285220185,NaN,NaN,104.77017052413208,95.88279520106387,0.057646526378824614,1.137498760884668,1.0798522345058434,750597946,750862501.4,76.00039088622103,79.65269768787905,NaN,NaN,28.88816165859841,25.38320810206826
2020-01-09T09:30:00-05:00,127.03,127.49,126.71,127.03,3821496,3895655.95,67.07128208770519,65.89919440813182,NaN,NaN,132.7634022148619,97.42514853510579,0.07453240637976788,1.1730177424805532,1.0984853361007854,754419442,750904798.8,76.07350254115899,79.32325699644818,NaN,NaN,29.762754490611982,26.008857586145933
2020-01-10T09:30:00-05:00,127.19,127.19,126.21,126.34,3703568,3978350.85,61.319203788089425,65.43527647734484,NaN,NaN,96.21041287716751,99.67019626708758,0.02716016776808572,1.1324355458108926,1.1052753780428068,750715874,751325667.4,76.82986260812751,78.84947772656544,NaN,NaN,28.71382254868736,26.39528115222328
2020-01-13T09:30:00-05:00,126.6,126.94,126.24,126.74,3224515,3908917.15,63.284951897368195,65.25925164539579,NaN,NaN,94.15083434331551,102.59855201537547,0.01149486636853525,1.1196439610034759,1.1081490946349406,753940389,751109125,75.50729021749257,78.1835805082942,NaN,NaN,28.439559623076978,26.687320933773808
2020-01-14T09:30:00-05:00,126.54,127.105,126.34,126.7,4340641,3947826,62.94048520772228,65.25320064486496,NaN,NaN,94.61351542081198,104.50166707605779,-0.011581911272243284,1.0936717055446366,1.1052536168168798,749599748,751854679.8,76.9768124318576,77.5952938484372,NaN,NaN,28.118851410946565,26.89182528765563
2020-01-15T09:30:00-05:00,126.35,126.85,126.1,126.41,3261867,3928577.95,60.374676448383084,64.9547996738318,NaN,NaN,68.68138804059836,97.28391057935104,-0.05402235425622037,1.0377256739966043,1.0917480282528247,746337881,751002666.8,71.68370059354129,76.61841969592699,NaN,NaN,27.117499627942117,26.92406447912513
2020-01-16T09:30:00-05:00,127.14,127.56,127.03,127.54,4349534,3975574,66.16298154184271,64.57740174356347,NaN,NaN,134.74765446565448,97.68076102950957,-0.015630558896022162,1.072209829632797,1.0878403885288193,750687415,750256261.4,67.31666271215892,75.3198181701242,NaN,NaN,27.956330121858354,27.071530999515588
2020-01-17T09:30:00-05:00,127.88,128.17,127.73,127.99,6736581,4180444.3,68.15778718005528,64.34951249804514,NaN,NaN,163.89416697297196,111.21751184867044,0.028052369934856713,1.1229058509473901,1.0948534810125334,757423996,751597885.8,70.76429523044843,74.60545654792318,NaN,NaN,29.268896384156168,27.385440340178526
2020-01-21T09:30:00-05:00,127.34,127.79,126.92,127.6,4001934,4218213.8,64.60312136783591,64.41389821883946,NaN,NaN,109.9746515991912,114.38227529984559,0.01909097277461025,1.1187171969807963,1.099626224206186,753422062,751494220.4,70.14855031278454,74.17171802781878,NaN,NaN,29.30225275103404,27.659270684586456
2020-01-22T09:30:00-05:00,128.07,128.53,127.4302,127.54,3965084,4249627,64.04968004022646,64.3739170194257,NaN,NaN,132.65981609910307,121.9915354355038,-0.0013807799084895045,1.097900249320574,1.0992810292290636,749456978,751465666.4,69.96795617491247,73.74666493040344,NaN,NaN,29.17126341317442,27.875269645813308
2020-01-23T09:30:00-05:00,126.89,127.89,126.24,127.73,3995908,4291214.6,65.07015368598347,63.9460255901365,NaN,NaN,80.12626730297251,124.28051128797865,-0.012036274305923467,1.0842356863466591,1.0962719606525826,753452886,752888667.4,73.61370168900362,73.49589255128559,NaN,NaN,29.343133941465783,28.084964545192232
2020-01-24T09:30:00-05:00,127.98,128.05,125.4,125.95,5690930,4493357.15,50.583735552994696,63.1156570517229,NaN,NaN,-7.476413629966305,95.83569766885448,-0.1416739141757115,0.9191795679329431,1.0608534821086546,747761956,752303575.6,69.85857434716831,73.22900700247658,NaN,NaN,24.76332227535438,27.610444220929683
2020-01-27T09:30:00-05:00,123.23,124.71,122.99,124.07,7877101,4761314.95,40.3629436533632,61.44276926472658,NaN,NaN,-242.4409496929095,14.568674335678192,-0.34515030133601354,0.6294156054386377,0.9745659067746513,739884855,748795747.4,52.55070686638046,71.59978874705338,NaN,NaN,16.67044214038205,26.04758678085145
2020-01-28T09:30:00-05:00,124.67,125.75,124.19,125.28,5907730,4908756.25,47.689127542662064,60.40706850160711,NaN,NaN,-115.12384181559767,-30.451024347279578,-0.38625756780997533,0.49174394701218205,0.8780015148221574,745792585,747269852,47.0857756073318,69.59841301561339,NaN,NaN,12.649456242277243,24.133568132483706
2020-01-29T09:30:00-05:00,125.69,126.18,125.12,125.21,2930064,4888323.3,47.32691195351727,59.21407442483922,NaN,NaN,-77.5862269650103,-72.50023296010224,-0.404246354772941,0.37269357135598113,0.7769399261289222,742862521,745950960.6,42.930140494955964,67.23625227338016,NaN,NaN,9.5098275039362,22.04446232840549
2020-01-30T09:30:00-05:00,124.23,125.13,123.98,125,5230465,5060659.9,46.19338083443661,57.72279576389146,NaN,NaN,-138.68384653974175,-116.2622557286451,-0.41481503844144396,0.25842112807711715,0.6732361665185611,737632056,742786794.6,34.958684293888496,64.29947954143226,NaN,NaN,6.676706895316248,19.84906869510703
2020-01-31T09:30:00-05:00,127.56,127.73,125.06,125.32,8422254,5167238.25,48.228236478687684,56.787726670362765,NaN,NaN,-24.967367030903787,-119.7604464088326,-0.3854101080500053,0.1914735314560545,0.5768836395060598,746054310,742445265.4,34.22008364338588,61.255923901093574,NaN,NaN,5.010049251229198,17.729208774553054
2020-02-03T09:30:00-05:00,126.02,127.77,126.01,126.21,8088595,5291846.8,53.49585456486613,56.088505432326905,NaN,NaN,23.494601199636158,-66.57333623032346,-0.29523744985110245,0.20783682719218177,0.5030742770432842,754142905,745296875.4,44.721702195865475,59.05695332812021,NaN,NaN,5.246500016498663,15.94596466625957
2020-02-04T09:30:00-05:00,128.06,128.94,127.77,128.51,8348620,5388699.3,63.75832825218476,56.14692279264565,NaN,NaN,152.45617609989853,-13.057332647224229,-0.08104794502352358,0.40176434576387976,0.48281229078740334,762491525,748636663.4,53.98695637977002,57.4148207529711,NaN,NaN,9.262007090394382,14.991113583993116
2020-02-05T09:30:00-05:00,129.36,129.5157,128.26,129.16,6677013,5264993.6,66.03923759378885,56.55153430303178,NaN,NaN,170.6780353966226,36.59551982510235,0.09453032825278218,0.6009752011033811,0.5064448728505989,769168538,753897866.8,64.17406772734446,56.87841840538561,NaN,NaN,13.251740307433945,14.742631687341806
2020-02-06T09:30:00-05:00,129.45,129.48,128.87,128.87,5519882,5304689.1,64.10088338901677,56.40424157782992,NaN,NaN,148.74461744439324,94.08121262192934,0.176499668673894,0.7270694586929665,0.5505697900190725,763648656,759101186.8,71.01000869303729,57.142228832591215,NaN,NaN,15.72000137580657,14.882255928551057
2020-02-07T09:30:00-05:00,128.29,128.9199,127.79,128.31,3633784,5295303.5,60.413327916433275,55.85106591614264,NaN,NaN,90.2294878196586,117.12058359204181,0.17786672753710153,0.7729031994404494,0.5950364719033479,760014872,761893299.2,73.88912538591224,57.36543098655291,NaN,NaN,16.54167413535562,15.11931567238028
2020-02-10T09:30:00-05:00,128.21,129.77,128.21,129.76,2933621,5256806.15,65.88570056137874,55.9426787156814,NaN,NaN,125.719073615859,137.5654780752864,0.2565102843836321,0.915674327382888,0.6591640429992559,762948493,763654416.8,75.53926549129493,57.750482070732225,NaN,NaN,19.145926167211286,15.694545743070423
2020-02-11T09:30:00-05:00,130.29,131.34,129.97,130.78,5507862,5370973.5,69.11959952017739,56.30481582139219,NaN,NaN,174.2870377819653,141.93165041169974,0.35144039360295265,1.0984645350029467,0.7470241413999941,768456355,764847382.8,76.61726627551585,58.2254327922039,NaN,NaN,22.434898989907733,16.657453349761468
2020-02-12T09:30:00-05:00,131.43,132.192,131.41,132.12,3905516,5349217.25,72.77138198335467,56.85490355691871,NaN,NaN,194.30680581817106,146.65740449600943,0.4712228538122727,1.3360527086653349,0.8648298548530622,772361871,765486049.4,77.1966666098001,58.481358857975074,NaN,NaN,26.525572171475392,18.067184610006315
2020-02-13T09:30:00-05:00,131.6,132.38,131.23,131.89,3553398,5363793.8,71.21470194379633,58.32854401340454,NaN,NaN,161.52849613222602,149.21418023357597,0.4990353472606509,1.4886240389288758,0.9895886916682249,768808473,766518012.8,78.13925729460489,59.072836211363395,NaN,NaN,29.18582781823992,19.655562211182545
2020-02-14T09:30:00-05:00,132.14,132.3,131.33,131.69,2479787,5270306.45,69.81614093287997,60.4323438190843,NaN,NaN,136.43637291058673,158.4555572517616,0.4685219978467041,1.5752411889766051,1.106719191129901,766328686,767780775.6,79.26852566256582,60.981251839662356,NaN,NaN,30.861061762601537,21.256347861385258
2020-02-18T09:30:00-05:00,131.5,132.11,130.95,131.68,3370054,5101980.1,69.74239072069349,62.007576903229406,NaN,NaN,112.17935033252812,155.7476125950954,0.41410820000322435,1.6243544411339315,1.2102462411307071,762958632,767782803.4,79.27037753755263,63.280151977535276,NaN,NaN,32.17381854381517,22.815986530303817
2020-02-19T09:30:00-05:00,132.15,132.73,132.08,132.27,2318071,5017786.95,71.64550983949431,63.74461960937062,NaN,NaN,120.40507499631806,144.97122003796596,0.3849132872475345,1.6913878501901252,1.3064745629425907,765276703,767146873,76.94895936753392,65.71006761129084,NaN,NaN,33.852354517710985,24.392610528504843
2020-02-20T09:30:00-05:00,132.16,132.68,130.69,132.32,5416369,5090351.2,71.80734393727822,65.57418840243074,NaN,NaN,93.9929947543529,124.90845782520232,0.33771669495972056,1.7286204316422413,1.3909037366825208,770693072,766813113.2,75.69603542003358,68.61987840601549,NaN,NaN,35.267739087717196,25.946200322678035
2020-02-21T09:30:00-05:00,131.74,131.88,129.96,130.3,6161330,5198622.3,57.523119462111936,66.23810861553247,NaN,NaN,54.951030061212656,103.59296461099966,0.14883883328462577,1.576952278288303,1.4281134450036772,764531742,765957767,72.44068966318778,71.3499216931442,NaN,NaN,32.110149835361966,26.826764538775738
2020-02-24T09:30:00-05:00,125.88,127.04,125.2,125.82,8753592,5351755.4,38.99567345325516,65.20238139327454,NaN,NaN,-75.58895697668464,61.18789863354542,-0.27627150040473447,1.0827740694977592,1.3590455699024937,755778150,763847659.8,65.01272803986151,72.79928068200105,NaN,NaN,21.05727079409282,26.00255114667818
2020-02-25T09:30:00-05:00,126.92,127.19,122.17,122.46,14609928,5688396.75,30.945333197184695,62.8585960322031,NaN,NaN,-133.54188756425114,12.04365105418957,-0.7550573227064679,0.41522391651940893,1.1702812392258768,741168222,759489577.8,52.93906835058365,72.72443153705917,NaN,NaN,7.984601975179567,23.428558407892663
2020-02-26T09:30:00-05:00,123.19,124.33,121.18,121.49,12360387,6011029.6,29.078978846546136,60.218577550257194,NaN,NaN,-164.12524509604617,-44.86241296428328,-1.0881420125472157,-0.18989627645814267,0.8982457360890729,728807835,752195804.2,39.66304156432643,70.97364395398645,NaN,NaN,-2.282368116375434,19.755568904425793
2020-02-27T09:30:00-05:00,119,121.48,116.52,116.58,17717160,6750384.4,21.88411761972762,57.20309428102227,NaN,NaN,-224.99183850981757,-108.65937961711737,-1.5614047051101176,-1.0535101452985742,0.5078945598115434,711090675,740275324.8,27.51730514478163,67.8670222719682,NaN,NaN,-14.766412350845137,14.823857296529948
2020-02-28T09:30:00-05:00,112.8,116,112.53,115.83,20617106,7519716.45,21.02824193200233,54.38987385356291,NaN,NaN,-238.5361470826615,-167.3568150458922,-1.8286788030622776,-1.7779539440163035,0.05072485904597407,690473569,725463690.2,19.51911256313612,63.98344992748418,NaN,NaN,-23.852481830159146,9.29866599271722
2020-03-02T09:30:00-05:00,116.18,119.82,114.55,119.81,9511225,7574165,35.45451124228822,52.21621747362787,NaN,NaN,-149.4954142209527,-182.1381064947458,-1.6468068119570853,-2.0077836559003828,-0.3609768439432973,699984794,714305019,15.794465924560697,59.715964244146015,NaN,NaN,-25.13319945832174,4.379828071140226
2020-03-03T09:30:00-05:00,120.16,121.74,115.8,116.91,14774264,7908448.45,31.009466536633767,49.49406511766046,NaN,NaN,-124.53615770985843,-180.33696052386728,-1.6282649051657083,-2.3963079754004326,-0.7680430702347244,685210530,703113480.6,13.095439798297832,55.178690924344735,NaN,NaN,-28.00892822928125,-0.24713711463427046
2020-03-04T09:30:00-05:00,118.74,121.05,117.45,120.95,7342410,7858137.95,41.9317071441999,47.29123120057799,NaN,NaN,-87.89159775010098,-165.09023105467824,-1.2664613964081588,-2.351119815744923,-1.084658419336764,692552940,695862501.6,11.700377623978127,50.50038456821459,NaN,NaN,-25.54032334450045,-3.8604494331865817
2020-03-05T09:30:00-05:00,118.06,118.83,115.54,116.44,7299838,7889279.2,35.22702668024384,44.72068296746709,NaN,NaN,-108.74274649126154,-141.84041265096704,-1.2512290073413492,-2.6486946785134506,-1.3974656711721014,685253102,690694987,10.81605241270249,45.69158421950728,NaN,NaN,-26.51778775223812,-7.097212050193944
2020-03-06T09:30:00-05:00,112.89,115.27,112.17,114.65,8327470,8029658.6,32.97350457896245,42.0890660850444,NaN,NaN,-123.48594503628424,-118.83037224169159,-1.2775833393142064,-2.9944448453148595,-1.7168615060006531,676925632,687985399.6,10.373325161913627,40.77049846946069,NaN,NaN,-28.148246714894785,-10.104502716579779
2020-03-09T09:30:00-04:00,106.08,110.7,103.5,107.43,8414870,8268712.9,25.80332082627332,38.950561092585815,NaN,NaN,-167.0913918833221,-122.34956777416546,-1.6722399284066354,-3.807161416508947,-2.1349214881023117,668510762,681690593.2,9.409701984116722,35.780450215643846,NaN,NaN,-32.74048454947006,-13.338214406992677
2020-03-10T09:30:00-04:00,111.21,113.37,107.37,113.37,10969642,8670513.95,37.78908427073547,36.532244980531615,NaN,NaN,-111.02525174186314,-119.6473865805664,-1.4334008576252324,-3.926672560133852,-2.4932717025086197,679480404,680544568,9.241386963409326,30.94419504392066,NaN,NaN,-30.941076637496018,-15.852909011350297
2020-03-11T09:30:00-04:00,110.27,110.82,106.14,107.17,7627558,8776498.75,31.981788915655585,33.68756247898714,NaN,NaN,-126.36982026490209,-127.34303108352663,-1.5814987470832325,-4.47014513636266,-2.888646389279428,671852846,676404549.2,8.64013000933231,26.15448751458485,NaN,NaN,-32.15122909755162,-18.1812404522362
2020-03-12T09:30:00-04:00,99.07,102.67,95.25,96.34,9980826,9080264.25,24.809637933528194,31.350885226945444,NaN,NaN,-187.36328453642903,-143.06713869256015,-2.2562289188460127,-5.708932537836944,-3.452703618990931,661872020,671728332.8,8.006490674276762,21.552044729662633,NaN,NaN,-36.60577275882559,-20.813316496034684
2020-03-13T09:30:00-04:00,101.6,102.37,95.97,102.3,8037076,9304448.15,33.6306196204137,30.96766709602819,NaN,NaN,-151.9279851474137,-148.75554671478602,-2.149030554459324,-6.138991812065086,-3.989961257605762,669909096,670325025.6,7.821123082079495,17.466930089821062,NaN,NaN,-35.77064430866193,-22.95007761212429
2020-03-16T09:30:00-04:00,91.05,95.85,88.64,89.34,8408900,9600903.8,26.382647104124416,30.641760946523892,NaN,NaN,-190.83917044361925,-153.50510242684544,-2.7598861715776657,-7.439818972077845,-4.679932800500179,661500196,668922912.4,7.63101997938449,14.23064092044969,NaN,NaN,-38.60085379275989,-25.185902780786517
2020-03-17T09:30:00-04:00,91.34,94.73,86.245,92.78,13567046,10110753.4,30.65470188309648,30.754312591991773,NaN,NaN,-162.4086644696568,-163.78178497240418,-2.7358820269833846,-8.09978533422941,-5.363903307246025,675067242,668040280,7.507315276499625,11.933803328462062,NaN,NaN,-38.66466361579267,-27.11144004293025
2020-03-18T09:30:00-04:00,86.82,89.12,81.7378,87.45,13828879,10686293.8,27.94845240412691,31.187479362306004,NaN,NaN,-165.812496529684,-171.6703202253606,-2.8686637030790463,-8.949732936094833,-6.0810692330157865,661238363,665917383.4,7.204792046059026,10.482909535696164,NaN,NaN,-39.838664458377174,-28.92961495942267
2020-03-19T09:30:00-04:00,87.08,93.06,84.19,90.5,7442125,10787581.6,31.666067809794484,31.947324067862585,NaN,NaN,-126.49903554908082,-159.49747042789096,-2.551424771622461,-9.270350197543863,-6.718925425921402,668680488,667279077,9.717898988316364,9.78282285178047,NaN,NaN,-39.25987088015804,-30.405365805242006
2020-03-20T09:30:00-04:00,91.56,94.47,87.66,87.81,12891718,11124101,30.186707325868355,31.571052359546886,NaN,NaN,-107.93764959961474,-150.69940331833115,-2.3292500078582155,-9.63048793574417,-7.301237927885955,655788770,664455011.8,9.16361508664842,9.309190649072454,NaN,NaN,-39.357902719197824,-31.684299650092836
2020-03-23T09:30:00-04:00,86.86,89.31,84.66,87.53,7654169,11069129.85,30.0294475495226,31.501051003324665,NaN,NaN,-108.93713489328152,-134.31899620826363,-2.0191969892201502,-9.825234164411143,-7.806037175190992,648134601,661781892.8,8.660101576616114,8.992380776095187,NaN,NaN,-39.48393915170987,-32.79853386460955
2020-03-24T09:30:00-04:00,92.34,95.895,91.95,95.74,10373690,10857317.95,39.91376550291163,31.35691231466122,NaN,NaN,-59.413224092360004,-113.71990813280426,-1.1239029502952587,-9.210915863060066,-8.087012912764807,658508291,658470102.6,8.068579980807144,8.732966658725832,NaN,NaN,-36.12528203362354,-33.27378360304012
2020-03-25T09:30:00-04:00,97.44,101.07,95.03,97.42,9998946,10739245.9,41.727792243432454,31.821252712031832,NaN,NaN,-34.85505254094499,-87.52841933505647,-0.3228917133443918,-8.490627554445297,-8.167735841100905,668507237,659923877.4,10.944182892978375,8.742118835888395,NaN,NaN,-32.906662109060896,-33.221337675328805
2020-03-26T09:30:00-04:00,98.48,102.1,98.01,101.45,6495561,10178165.95,45.94373926507592,32.74769804675422,NaN,NaN,-14.196776644709773,-65.06796755418226,0.5277420027417854,-7.508058337673674,-8.03580034041546,675002798,661188339.4,13.479188133596764,8.963966191008618,NaN,NaN,-28.868101037012316,-32.599446726997876
2020-03-27T09:30:00-04:00,98.36,100.64,96.89,98.05,5131145,9403867.9,43.1099365611287,33.98388488495818,NaN,NaN,-23.00596669159466,-48.08163097257819,0.8895184294592893,-6.923902303591348,-7.813420733050637,669871653,664004916,19.009517808069248,9.64966732129094,NaN,NaN,-26.44767845143054,-31.720622687631113
2020-03-30T09:30:00-04:00,98.64,100.49,96.925,100.1,6660260,9261319.65,45.300647537523254,34.52042511830016,NaN,NaN,-13.53649342106605,-29.00150267813509,1.2717025352187212,-6.223792564027235,-7.495495099245956,676531913,669684378.4,28.881080946777885,11.052502605817265,NaN,NaN,-23.80666338496986,-30.59005707296522
2020-03-31T09:30:00-04:00,99.23,100.69,97.82,98.08,5152333,8780223.1,43.52219748256347,35.34474001593644,NaN,NaN,-9.785529290318863,-19.075963717726857,1.3840066974313565,-5.765486727456761,-7.149493424888117,671379580,672258636.2,32.874709017886914,12.783543963571166,NaN,NaN,-22.162280162939922,-29.386088942961607
2020-04-01T09:30:00-04:00,94.35,95.95,92.87,93.7,6758401,8751022.65,39.86740551851482,36.420294843435485,NaN,NaN,-44.7660955336892,-21.05817231627571,1.1675040518863025,-5.690113360030239,-6.857617411916541,664621179,671481424.6,32.28524343299162,14.517740589193654,NaN,NaN,-21.845557855664875,-28.30887021620493
2020-04-02T09:30:00-04:00,93.15,95.48,91.98,94.05,5998824,8685971.95,40.29883840290682,36.89659618504214,NaN,NaN,-41.10516867745972,-26.43985072282569,1.055457667679791,-5.538295327316803,-6.593752994996594,670620003,670604865.6,31.597113406542235,16.216025612369563,NaN,NaN,-21.46701742575287,-27.33146267471178
2020-04-03T09:30:00-04:00,93.48,93.95,91.23,92.41,5180054,8528601.15,38.89081199532288,37.79003653441346,NaN,NaN,-48.195357976214574,-31.477728979749674,0.8853533485152543,-5.4870613093525265,-6.372414657867781,665439949,669718524.8,30.880386929961716,17.876694680267935,NaN,NaN,-21.543176522443137,-26.504564652959118
2020-04-06T09:30:00-04:00,95.79,100.63,95.79,100.1,5303916,8373053.45,48.05563153298938,39.03296008083438,NaN,NaN,36.31852115865332,-21.5067260638058,1.2811774940317733,-4.770942790328064,-6.052120284359837,670743865,668560915.2,29.92562449555355,19.47800248162893,NaN,NaN,-18.822691911810484,-25.407154261366458
2020-04-07T09:30:00-04:00,104.73,105.505,101.37,101.59,7009093,8175026,49.63185564859068,40.58177459829608,NaN,NaN,102.99084378904334,1.0485485520666402,1.6123753032437493,-4.036651155305151,-5.6490264585489,677752958,669835590.8,32.403937880163156,21.277941469779226,NaN,NaN,-16.126299885161995,-24.081317921908678
2020-04-08T09:30:00-04:00,102.83,105.21,102.09,104.79,4165482,8001922.2,52.934988630369425,42.10098322833715,NaN,NaN,128.7966346934536,35.7610945974952,1.9911579161050188,-3.1600790634176263,-5.151236979522645,681918440,673295043,38.73665431838135,23.35070970764101,NaN,NaN,-12.844574068891653,-22.476068800049102
2020-04-09T09:30:00-04:00,106.3,108.44,105.6517,106.68,5322906,7769026.2,54.819578677496,43.86047403916769,NaN,NaN,150.62026413493373,74.10618115997389,2.2917699602862696,-2.286524529164808,-4.5782944894510775,687241346,676619311.6,44.15113096592081,25.849817984731892,NaN,NaN,-9.553429813920133,-20.62997751631639
2020-04-13T09:30:00-04:00,106.26,107.05,104.65,106.65,3411719,7537758.35,54.782081257521845,45.62851930402478,NaN,NaN,127.84047839229589,109.313348433676,2.39987430449382,-1.5784516088338023,-3.9783259133276223,683829627,680297247.2,49.47197793887273,28.764952010607367,NaN,NaN,-6.8785266120808295,-18.665484529997023
2020-04-14T09:30:00-04:00,108.88,111.03,108.37,110.82,5744700,7404548.35,58.98198920913752,46.99053528304091,NaN,NaN,155.9948220661365,133.2486086151726,2.6442159325440335,-0.6730559976475803,-3.317271930191614,689574327,684063339.6,54.27577120564216,32.06546566952415,NaN,NaN,-3.286997027360576,-16.468557743906103
2020-04-15T09:30:00-04:00,108.07,109.14,107.08,108.39,3808761,6916634.1,55.733365750416226,47.990933390682606,NaN,NaN,120.97506367914045,136.84545259319202,2.5339163746774984,-0.14987646184474102,-2.6837928365222394,685765566,685665861.2,56.18463966910948,35.29692686781923,NaN,NaN,-1.115496050035496,-14.275263216210302
2020-04-16T09:30:00-04:00,108.84,111,107.8,109.69,4609191,6455649.7,57.094845520957875,48.78744098038846,NaN,NaN,125.35244213310415,136.15661408112211,2.4393812551680036,0.365433732437765,-2.0739475227302386,690374757,687357124.6,58.16943350226271,38.48908725129537,NaN,NaN,1.087673185571135,-12.08055801595581
2020-04-17T09:30:00-04:00,112.36,113.2,110.97,112.93,4383922,6302739.55,60.366611528125496,50.02006062088824,NaN,NaN,139.0560784580268,133.84377694574073,2.477929091878993,1.0234638421185025,-1.4544652497604904,694758679,688860591.2,59.90808689378036,41.410413614560454,NaN,NaN,3.949692771569212,-9.790522189166522
2020-04-20T09:30:00-04:00,111.7,113.19,110.7701,110.96,3413066,5828806.95,57.495736379922256,50.89113839534531,NaN,NaN,115.46066368598085,131.3678140044777,2.2597322758820626,1.3702000950920876,-0.8895321807899748,691345613,690363788.4,61.62547759210199,43.749299089226454,NaN,NaN,5.599753334550972,-7.591911400064022
2020-04-21T09:30:00-04:00,109.11,109.83,107.24,108.08,4327909,5662493.95,53.49069770246703,51.60317412533842,NaN,NaN,71.19528038309423,114.40790566786927,1.8288266621583522,1.3965011469079656,-0.43232551525038665,687017704,689852463.8,60.67339195537865,45.7349192990473,NaN,NaN,5.909888970346736,-5.663082775719628
2020-04-22T09:30:00-04:00,110.09,111.18,109.47,110.41,3385690,5313093.95,56.151854248309974,52.766349034609505,NaN,NaN,85.91405500478176,107.39570393299752,1.615509841776216,1.5870617869698833,-0.028448054806332612,690403394,690780029.4,61.82557337664843,47.844942866451355,NaN,NaN,6.92174564117035,-3.865250144735346
2020-04-23T09:30:00-04:00,110.96,112.02,109.98,110.38,4129555,5019624.4,56.107339871842235,53.89552771096203,NaN,NaN,82.75795634845743,98.87680677606821,1.3954641215557784,1.7158820971383903,0.320417975582612,686273839,689959845.8,60.147529536286804,49.884258304290256,NaN,NaN,7.742021300656994,-2.2070685096792975
2020-04-24T09:30:00-04:00,111.52,112.75,110.495,112.25,2914498,4840571.25,58.325105927833704,55.28369156328423,NaN,NaN,85.97895721129426,88.26138252672169,1.3008090337865859,1.9464292678158444,0.6456202340292585,689188337,688845777.4,57.85069764835319,51.81070906988965,NaN,NaN,9.04727989688227,-0.5993044515990738
2020-04-27T09:30:00-04:00,113.4,115.09,113.29,114.35,4119671,4789997.55,60.72505375579736,56.188650293484805,NaN,NaN,104.249059426473,86.01906167482011,1.3014215970920366,2.2723972303943043,0.9709756333022677,693308008,689238256.4,58.45262524385605,53.84835198048268,NaN,NaN,10.835833553497185,1.034286691986106
2020-04-28T09:30:00-04:00,116.49,116.9,114.22,114.8,4729440,4693456.55,61.24014871592262,57.01781408400852,NaN,NaN,107.9975208979245,93.37950977778618,1.2534486184998221,2.5377864064270454,1.2843377879272233,698037448,691442205.2,61.75550353819227,55.94489238462762,NaN,NaN,12.475620732589551,2.668762983500884
2020-04-29T09:30:00-04:00,117.03,118.21,116.38,117.33,4998795,4685779.65,64.09156648575691,57.81471250225048,NaN,NaN,122.18129615675277,100.63295800818037,1.3074218641065198,2.918615118060373,1.6111932539538532,703036243,693968775,65.17351210163227,57.83323936914554,NaN,NaN,14.704686952360172,4.388180693337925
2020-04-30T09:30:00-04:00,116.48,117.3,115.3988,116.6,5053528,4600536,62.65921139238884,58.37468626759998,NaN,NaN,108.30695083660981,105.74275690581085,1.211438198355123,3.125491001897757,1.9140528035426339,697982715,696310550.2,68.02585494416783,59.538576796163184,NaN,NaN,16.224884039700026,6.079138314246796
2020-05-01T09:30:00-04:00,113.02,113.94,111.37,112.24,6276608,4614425.2,54.78416423057952,58.37483505138981,NaN,NaN,52.84114991230553,99.11519544601312,0.7920768357158732,2.904148848187475,2.112072012471602,691706107,696814104.2,68.62099172302503,60.90636349503121,NaN,NaN,15.416904253111039,7.413104876941688
2020-05-04T09:30:00-04:00,110.76,112.9,110.12,112.85,4606904,4585767.7,55.62447470081021,58.13501258650928,NaN,NaN,37.573621554183696,85.78010787155526,0.5073806989702447,2.746297886184408,2.238917187214163,696313011,697415104.8,69.35415876730444,61.98339117800708,NaN,NaN,14.968285089248262,8.492416335842627
2020-05-05T09:30:00-04:00,114.35,114.69,113.02,113.26,4545941,4547868.95,56.21349223888949,58.16930733568595,NaN,NaN,64.97915909284548,77.17643551053945,0.30809440283298395,2.624035190755393,2.315940787922409,700858952,697979405.6,70.06147649568109,62.974593808476484,NaN,NaN,14.744894790240176,9.385627543613705
2020-05-06T09:30:00-04:00,114,114.48,113.075,113.24,3905014,4392665,56.174322255918995,58.10355567389745,NaN,NaN,57.742776963792856,64.28873167194747,0.14464445216723787,2.4967463531314564,2.3521019009642186,696953938,696762944.6,66.4983902414686,63.56951928984834,NaN,NaN,14.547219966091287,10.122997889681931
2020-05-07T09:30:00-04:00,114.65,115.59,114.5975,115.02,5333595,4451070.65,58.91803543836357,58.00008595320018,NaN,NaN,89.18274379543217,60.463890263711946,0.1267664659865515,2.5105599834474077,2.383793517460856,702287533,697623908.2,67.74855571981007,64.12955277742188,NaN,NaN,15.072422299622836,10.83005851967349
2020-05-08T09:30:00-04:00,116.49,117.37,115.85,117.26,3936588,4381754.75,62.13100456794141,58.331176538058685,NaN,NaN,124.27086728526395,74.74983373830364,0.23013455946295602,2.671461716789551,2.441327157326595,706224121,700527511,71.59792047158344,64.84187012595628,NaN,NaN,16.398616908796136,11.625566860976724
2020-05-11T09:30:00-04:00,116.24,117.96,116.08,117,4043612,4413349.4,61.5294865329032,58.90537574023269,NaN,NaN,116.65691229091725,90.56649188565034,0.24400993771721646,2.7463395794731156,2.502329641755899,702180509,701701010.6,73.00049553557581,65.72237752454178,NaN,NaN,17.36231744058283,12.44510265806331
2020-05-12T09:30:00-04:00,117.5,117.77,114.38,114.44,5972398,4424734.3,55.8010757958311,58.88032013648421,NaN,NaN,67.55542315235647,91.08174469755254,0.0537288707893655,2.569490730242606,2.5157618594532405,696208111,700770842.4,70.04770193033653,66.3096724212338,NaN,NaN,16.688479131064007,13.05129929706341
2020-05-13T09:30:00-04:00,114.27,114.92,111.35,112.47,6681084,4568350.45,51.80414769214682,58.572949266505965,NaN,NaN,-13.992302423938314,76.73472882000631,-0.21700869017046642,2.2445009967401575,2.461509686910624,689527027,699285460.2,65.4919838582197,66.69141915851472,NaN,NaN,14.977385828073523,13.32645451577914
2020-05-14T09:30:00-04:00,111.09,114.2,110.06,114.15,5718373,4623809.55,54.77891166847449,58.31964967655173,NaN,NaN,-24.477395565067887,54.00270094790629,-0.29055323293439983,2.098318145742624,2.388871378677024,695245400,697877033.6,61.413423066560334,66.94589954552951,NaN,NaN,14.300485925641897,13.465601860045249
2020-05-15T09:30:00-04:00,113.22,115.5,112.84,115.48,6278256,4718526.25,57.03958771157917,58.056402101964714,NaN,NaN,32.90846911132502,35.73022131311852,-0.2583196384439135,2.065971830622132,2.3242914690660457,701523656,696936940.6,58.78203619702235,66.9694288993271,NaN,NaN,14.3386520060308,13.590323309471756
2020-05-18T09:30:00-04:00,118.64,120.398,118.52,119.85,5117037,4803724.8,63.49677062054356,58.217589380866215,NaN,NaN,171.70706089141964,46.740251033218996,0.033118365642299086,2.3656894261189194,2.3325710604766203,706640693,697828977.4,60.511031538638754,66.88053804221614,NaN,NaN,16.32983747196177,13.981682475541758
2020-05-19T09:30:00-04:00,119.59,121.41,119.13,119.42,5256835,4850171.1,62.501284311521424,58.103997796992246,NaN,NaN,166.42589600841097,66.5143456044299,0.16534274050732467,2.5392494861107764,2.3739067456034517,701383858,698864126.8,62.478003526078,66.68800171539083,NaN,NaN,17.664833952606585,14.507846972265305
2020-05-20T09:30:00-04:00,121.39,121.4188,120.23,120.98,3854136,4873593.4,64.66560748141384,58.24731180335118,NaN,NaN,169.25685280901394,103.16417665102036,0.3174639782823738,2.770736718456419,2.4532727401740453,705237994,702006320.2,67.73219994129352,66.66702635804266,NaN,NaN,19.4355584316066,15.211805752171205
2020-05-21T09:30:00-04:00,121.28,122.07,119.94,121.41,4558596,4895045.45,65.26079542573744,58.99564260300531,NaN,NaN,152.9162590132584,138.6429075666856,0.40124421287371037,2.954828006266183,2.5535837933924728,709796590,704916558.2,71.68669639061889,66.8860052628708,NaN,NaN,21.069514577189622,16.04862129860241
2020-05-22T09:30:00-04:00,121.36,121.56,120.3,121.23,3821024,4940371.75,64.76896860214458,59.64882073881491,NaN,NaN,130.30089253921543,158.1213922522637,0.3979544406639124,3.0510268442223634,2.653072403558451,705975566,705806940.2,72.78558429975442,67.13110708661722,NaN,NaN,22.297898604770513,16.941375199483566
2020-05-26T09:30:00-04:00,124.44,124.75,122.97,123.15,4564260,4962601.2,67.57595583499766,60.460425281394066,NaN,NaN,166.94399893612177,157.16877986120411,0.473373405661746,3.2447891606356336,2.7714157549738876,710539826,706586766.8,73.7466518277156,67.39433389604827,NaN,NaN,24.168464168656172,17.97381648079394
2020-05-27T09:30:00-04:00,124.62,125.28,122.1,125.26,5765629,5014410.65,70.36987874319315,61.474393601913654,NaN,NaN,151.98260688416687,154.2801220363553,0.605218337910844,3.5279386773624424,2.9227203394515984,716305455,709571086.2,77.08214997020818,68.15031673381539,NaN,NaN,26.63216336066656,19.2107231779186
2020-05-28T09:30:00-04:00,125.63,126.08,123.405,123.74,3646981,4946819.95,65.96050392779281,61.97742706544432,NaN,NaN,130.8832472934315,146.60540093323883,0.5324809093951695,3.58832147619556,3.0558405668003905,712658474,711055182.2,78.54218374628326,68.92129016427775,NaN,NaN,27.506562464561057,20.39584307601038
2020-05-29T09:30:00-04:00,123.7,124.64,122.75,124.19,6507996,5019543.35,66.62721290303281,62.29858480366513,NaN,NaN,104.58218084745087,136.93858530007734,0.45983540278524027,3.6306348202819407,3.1707994174967005,719166470,712929158.2,80.25290393961245,69.53950326913697,NaN,NaN,28.41908165612712,21.542020016027056
2020-06-01T09:30:00-04:00,124.34,125.82,124.24,125.37,3331277,4872276.8,68.37633282793614,62.78764525331034,NaN,NaN,112.6641030701005,133.41122740625434,0.43659454523134,3.7165425990358756,3.2799480538045356,722497747,716233594.4,82.84941630391828,70.24299760973285,NaN,NaN,29.689208661624843,22.70590410825531
2020-06-02T09:30:00-04:00,125.93,126.44,125.28,126.44,4225247,4853193.95,69.91607518674704,63.79585949551862,NaN,NaN,116.35615481070285,123.29365858117053,0.43752285843279104,3.8268516268455244,3.3893287684127333,726722994,719470228,84.93841717474999,71.30662012719095,NaN,NaN,31.20764080823063,23.9204379225375
2020-06-03T09:30:00-04:00,127.06,129.23,127.06,128.83,5531065,4902450.15,73.07012775062795,65.31485807112442,NaN,NaN,140.4237639077547,120.9818899858881,0.5367933890602372,4.06032050473803,3.5235271156777928,732254059,722659948.8,86.66256974068024,72.81880483308099,NaN,NaN,33.49341005465492,25.288005369982844
2020-06-04T09:30:00-04:00,128.53,129.31,127.5,128.18,4985779,4956488.4,70.89322365580301,66.46588035593359,NaN,NaN,126.84648940412113,120.17453840802602,0.49726983239118105,4.145114406166769,3.647844573775588,727268280,725581910,88.01593687056062,74.71898439050959,NaN,NaN,34.7965840207068,26.646373748657695
2020-06-05T09:30:00-04:00,131.23,131.9887,130.58,131.25,5844661,4982041.7,74.72346906736557,67.72901473848977,NaN,NaN,153.88139013501072,130.03438026553798,0.6090930517094977,4.40921088841246,3.800117836702962,733112941,728371204.2,89.14796970249753,76.88797964090067,NaN,NaN,37.1492257415227,28.14678117620984
2020-06-08T09:30:00-04:00,132.01,133.3,132.01,133.25,3502454,4960335,76.85983321298248,68.68351920937826,NaN,NaN,153.59902190108423,138.2213640317347,0.7402423936500249,4.725420828765493,3.9851784351154684,736615395,731194733.8,90.16113993802395,79.00584452657104,NaN,NaN,39.84024513826282,29.817276027931694
2020-06-09T09:30:00-04:00,132.08,132.95,131.24,132.21,4344916,4975400.2,73.38638114140085,69.46102612579823,NaN,NaN,127.83999435611224,140.5181319408166,0.6809370494659364,4.836349746947889,4.155412697481952,732270479,732304230.8,90.53508401544056,81.00992170438265,NaN,NaN,41.0349613046409,31.41980249603301
2020-06-10T09:30:00-04:00,132.73,132.75,130.83,130.97,3892230,4871391.8,69.3614972061241,69.79644682042039,NaN,NaN,110.22286791676486,134.4779527426186,0.4910517558402585,4.769227392282275,4.2781756364420165,728378249,731529068.8,88.01807502139837,82.45891278153299,NaN,NaN,40.84102234335982,32.765691045651124
2020-06-11T09:30:00-04:00,126.77,128.66,123.81,124.11,6867784,4880726.8,52.27897283190412,68.86917377800373,NaN,NaN,18.433103421237504,112.79527554604189,-0.1304988964153626,4.115052015922814,4.245550912338176,721510465,730377505.8,84.26989680919675,83.35771281143141,NaN,NaN,34.502553642470716,33.01381427376821
2020-06-12T09:30:00-04:00,127.44,127.88,122.8,125.34,5994757,4894546,54.44534006438215,68.13177173959211,NaN,NaN,6.304479703231884,83.27989345968614,-0.4734439867905067,3.653745928850043,4.12718991564055,727505222,729255962,80.66695499117202,83.92066786081838,NaN,NaN,30.221156389243696,32.61486314740757
2020-06-15T09:30:00-04:00,122.59,126.93,121.92,126.53,4996497,4830458.05,56.502703844952656,67.34082516887462,NaN,NaN,-8.216608761524276,50.916767327164436,-0.6252603920772288,3.3456144255440137,3.9708748176212425,732501719,728433226.8,78.03133761782023,84.22671684582586,NaN,NaN,27.448189611057707,31.876766927929015
2020-06-16T09:30:00-04:00,130.38,130.54,126.59,129.19,5083444,4828778.4,60.76790164749198,66.65496966203882,NaN,NaN,59.187489034126614,37.18626626276731,-0.5540855127759232,3.2782679266513384,3.8323534394272616,737585163,729496163.6,78.98658400555354,84.36274784835052,NaN,NaN,26.491790317203733,31.10748455496826
2020-06-17T09:30:00-04:00,129.73,130.17,128.53,128.85,3175214,4724697.35,59.958600113405836,66.22626224672545,NaN,NaN,59.163301022432144,26.97435288390077,-0.5370652396272217,3.1610218898932345,3.6980871295204563,734409949,730702503.6,80.04697841784254,84.47023318203333,NaN,NaN,25.48402725000122,30.304133511401538
2020-06-18T09:30:00-04:00,128.35,129.07,127.8,128.38,2766752,4670328.15,58.79295844971332,65.66667264291694,NaN,NaN,36.16356206246376,30.52044461214603,-0.561952471287086,2.995646540411599,3.557599011698685,731643197,732729050,81.71618150942219,84.57475300844831,NaN,NaN,24.319962388724843,29.449251922447726
2020-06-19T09:30:00-04:00,129.99,130.24,126.97,127.38,6691951,4776995.9,56.28570347688804,64.80305626069921,NaN,NaN,25.04514019805803,34.26857671111126,-0.6443444437398513,2.7521684570238705,3.396512900763722,724951246,732218254.8,79.90178611541403,84.36420799498373,NaN,NaN,22.610250170282452,28.472251672138402
2020-06-22T09:30:00-04:00,126.87,128.5,126.3,128.39,2837884,4727838.9,58.223513321939464,63.96787327035581,NaN,NaN,6.223464137109618,37.15659129083804,-0.6287180547291404,2.610615332352296,3.2393333870814365,727789130,731275737,76.52536418720996,83.76327563873086,NaN,NaN,21.718897366126594,27.507486771279574
2020-06-23T09:30:00-04:00,129.77,130.21,129.01,129.4,3673804,4683316.1,60.12700593431517,63.04336456919061,NaN,NaN,50.90253817100841,35.4996011182144,-0.5510418411943467,2.550531085588503,3.1015729267828496,731462934,730051291.2,72.25371949526784,82.73407204977283,NaN,NaN,21.4995442720245,26.649209271385992
2020-06-24T09:30:00-04:00,128.63,129.09,124.98,126.55,5981477,4694108.5,52.81428713403828,61.75201196049312,NaN,NaN,-33.10390356162057,17.046160201403854,-0.6836261617358668,2.2470402246130163,2.930666386348883,725481457,728265592.8,66.42991681264218,81.19221347420724,NaN,NaN,19.097736840786233,25.570427495586028
2020-06-25T09:30:00-04:00,126.02,126.86,124.77,126.72,4884674,4755993.15,53.18007454770684,60.21319806623178,NaN,NaN,-62.15933857306997,-2.6184199257028924,-0.7467599554096926,1.997216442086767,2.7439763974964597,730366131,728010179.6,65.61526645531728,79.51130609940864,NaN,NaN,17.251895265637796,24.382065748450565
2020-06-26T09:30:00-04:00,126.68,126.95,123.54,123.75,5748505,4718018.6,46.41097173936775,58.038279389545025,NaN,NaN,-111.05379007028448,-29.838205979371395,-0.9617393739301798,1.5418021800837352,2.503541554013915,724617626,727943455.6,65.38966594316993,77.74191509977621,NaN,NaN,13.493610468032383,22.826572136962252
2020-06-29T09:30:00-04:00,124.3,126.2,122.93,126.1,3911330,4747021.25,51.6546166340273,56.4860104961612,NaN,NaN,-99.70549221948086,-51.02399725068949,-0.9189211419274281,1.35489012660463,2.273811268532058,728528956,728091420.8,65.6715378078159,75.9659475135173,NaN,NaN,11.843839536119578,21.25761033684187
2020-06-30T09:30:00-04:00,126,128.295,125.613,127.71,3364938,4704005.8,54.90984748314005,55.45374980166233,NaN,NaN,-31.443493438086616,-67.49320357250849,-0.7618956034865056,1.321441764173926,2.0833373676604316,731893894,728177612.8,65.84603127406689,74.38223010299362,NaN,NaN,11.466734914586898,19.858913847948305
2020-07-01T09:30:00-04:00,127.89,129.53,127.79,129,5586407,4706772.9,57.38573173421808,55.81851829468476,NaN,NaN,21.78296467852864,-56.51582992447866,-0.5602038143564738,1.3830825997148395,1.9432864140713133,737480301,730577381.6,70.36299192554148,73.3888797541611,NaN,NaN,11.91247175372265,18.7237078344875
2020-07-02T09:30:00-04:00,130.94,131.65,129.18,129.51,3664259,4640696.9,58.35922419921419,56.09808144717276,NaN,NaN,61.93238165313156,-31.69748587923835,-0.38959006145693453,1.456298837250145,1.8458888987070796,741144560,732733067.4,73.72465579537564,72.89300124017566,NaN,NaN,12.56418634758057,17.843776193500794
2020-07-06T09:30:00-04:00,131.44,132.64,131.11,132.58,3557949,4526361.3,63.73044136922159,56.614348413191976,NaN,NaN,123.52692181983276,15.2186564987851,-0.08313810050865889,1.741966273071256,1.8251043735799148,744702509,736750044,78.59659007888295,72.93337641596585,NaN,NaN,14.844326274212099,17.415283347888124
2020-07-07T09:30:00-04:00,131.96,132.38,130.28,130.5,3446631,4523570.15,58.248339605862355,56.43437969593271,NaN,NaN,96.55167782756426,54.47009050819413,-0.03608158067241596,1.7800023977393948,1.8160839784118108,741255878,739295428.4,81.00057738611189,73.07723308600573,NaN,NaN,15.076488120231279,17.081169743937146
2020-07-08T09:30:00-04:00,130.73,131.92,130.12,131.89,2739961,4443322.4,60.68235759625985,56.48607665899372,NaN,NaN,108.57741754851956,82.47427270551536,0.06745365214076182,1.9004010435877632,1.8329473914470014,743995839,741715817.4,82.96043362371347,73.28533702928223,NaN,NaN,16.029035306772172,16.930864824342148
2020-07-09T09:30:00-04:00,132.35,132.44,129.62,131.74,3112394,4404330.6,60.273999486556875,56.591865304482546,NaN,NaN,108.1468914694168,99.74705806369299,0.10252821728857286,1.9611076630577173,1.8585794457691445,740883445,742396446.2,83.4766038642024,73.4110814831951,NaN,NaN,16.67374935045444,16.89413404235819
2020-07-10T09:30:00-04:00,131.82,133.41,130.95,133.31,6456353,4383759.05,63.07487490112744,57.07680612049965,NaN,NaN,136.5497858672415,114.67053890651498,0.2023869948040844,2.11156318927425,1.9091761944701655,747339798,743635493.8,84.40288143743211,73.73258829191069,NaN,NaN,18.05994825336196,17.060678929644443
2020-07-13T09:30:00-04:00,134.51,136.5,131.25,131.62,6641270,4416084.7,58.309165983683755,57.082924167767096,NaN,NaN,138.6636364080414,117.69788182415671,0.1291096344813334,2.0705632375718324,1.941453603090499,740698528,742834697.6,81.23335119187794,74.0688730779584,NaN,NaN,17.840803250049518,17.172125261130883
2020-07-14T09:30:00-04:00,130.97,133.01,129.43,132.93,5737048,4453112.25,60.782701031507564,57.12975953185226,NaN,NaN,86.04898969948653,115.59734419854117,0.1423139419589763,2.1193460305392193,1.977032088580243,746435576,743870637.2,82.16633753001463,74.77691722329745,NaN,NaN,18.388193135826118,17.3458492432302
2020-07-15T09:30:00-04:00,134.8,135.23,132.92,134.83,3752862,4386583.15,64.108780971666,57.936509091682815,NaN,NaN,144.15356728969545,122.71257414677635,0.24635915116007379,2.2849810275303355,2.0386218763702617,750188438,745109157,83.23918247207166,75.97757905611385,NaN,NaN,19.87162453111323,17.70667428435635
2020-07-16T09:30:00-04:00,133.74,134.85,133.28,134.47,3024682,4379056.55,63.0182082310351,58.63923292620627,NaN,NaN,121.30258537709963,125.3437129283129,0.2570980333210593,2.3599944180215857,2.1028963847005264,747163756,746365219.2,84.27253391054845,77.31024101720179,NaN,NaN,20.76915133271771,18.14417100555083
2020-07-17T09:30:00-04:00,134.99,134.99,133.3596,133.84,3094657,4395451.8,61.06062124186393,59.685636462098856,NaN,NaN,104.69504928372362,118.97276561160933,0.1909746197349267,2.341614659369185,2.150640039634258,744069099,745711079.4,81.45596830167935,78.45783404280961,NaN,NaN,20.971752673992206,18.548111243899598
2020-07-20T09:30:00-04:00,133.94,136.33,133.61,135.98,2735803,4197644.4,65.03399107615174,60.64130606510774,NaN,NaN,121.58258533282181,115.55655539656541,0.2564813658349263,2.471241746927916,2.2147603810929897,746804902,746932354.2,82.62363842949551,79.66869837292958,NaN,NaN,22.319210964010765,19.08683977534405
2020-07-21T09:30:00-04:00,137.04,137.23,135.69,136.19,2657904,4188645.4,65.40702479696726,61.39110444466683,NaN,NaN,133.0771686850743,124.96219119368297,0.2773047099692323,2.56139126855453,2.284086558585298,749462806,747537800.2,83.18878590220908,80.90746656065402,NaN,NaN,23.529290552881548,19.72147560070655
2020-07-22T09:30:00-04:00,135.96,137.44,135.83,137.36,2660497,4137980.05,67.4881353735829,62.112704704621464,NaN,NaN,129.8082326060014,122.09312425694415,0.3296626930422941,2.6961649248881656,2.3665022318458715,752123303,747924773.2,83.55689513039594,81.84988821814362,NaN,NaN,25.16580501719497,20.499236945919183
2020-07-23T09:30:00-04:00,137.51,137.51,134.37,135.3,3433847,4010598.55,60.57797631780012,62.271186998806165,NaN,NaN,95.43429709999411,116.91946660152306,0.19215886279210936,2.606700810336008,2.4145419475438987,748689456,748229913.2,83.85706241358062,82.5736315480154,NaN,NaN,24.612469173892897,21.086841549915427
2020-07-24T09:30:00-04:00,134.54,136.13,133.87,135.54,3143802,3923554.95,61.07799305887897,62.08172640521026,NaN,NaN,76.51946205713978,111.28434915620628,0.08920416204408399,2.5260471500990036,2.4368429880549196,751833258,749782745,85.32518438658025,83.05424542713662,NaN,NaN,24.2975083788753,21.545508239766836
2020-07-27T09:30:00-04:00,136.12,136.69,135.4,136.38,2449656,3758612.5,62.853866349380404,62.410692601175846,NaN,NaN,93.92453104835593,105.75273829931311,0.05138852583910447,2.5010786453538003,2.449690119514696,754282914,751278347.4,86.59015317155217,83.45350084038236,NaN,NaN,24.51988356353612,21.970419000305306
2020-07-28T09:30:00-04:00,136.11,136.66,134.83,135.03,2559821,3691037.05,58.25364214185481,62.23721292586119,NaN,NaN,70.73016711751407,93.28333798580107,-0.08349465713239157,2.3453217980992065,2.428816455231598,751723093,751730404.8,86.95614814935186,83.7389090207851,NaN,NaN,23.41221416188978,22.176389737674516
2020-07-29T09:30:00-04:00,135.92,136.69,135.71,136.4,2247524,3635166.35,61.34549356230076,62.31374821698575,NaN,NaN,87.28716942464648,84.77912534953008,-0.0983727517740478,2.305850515514038,2.404223267288086,753970617,752099867.6,87.26213981945577,84.00930444616036,NaN,NaN,23.32606336404204,22.34062882715559
2020-07-30T09:30:00-04:00,135.42,136.95,134.63,136.29,3970354,3554363.7,60.955131951788175,62.162338006318656,NaN,NaN,72.31072932399148,80.15441179432955,-0.13147997867959926,2.2398732939385866,2.371353272618186,750000263,752362029,87.48645913767756,84.22955999617787,NaN,NaN,23.147975220096015,22.45596402614708
2020-07-31T09:30:00-04:00,137.97,138.21,135.49,137,3807170,3561509.25,62.609003670033104,62.46946926962933,NaN,NaN,100.40632698674031,84.93178478024966,-0.12164718319212886,2.2192942936280247,2.3409414768201535,753807433,752756864,87.8339562127411,84.70103178338239,NaN,NaN,23.443409295384534,22.597027636038145
2020-08-03T09:30:00-04:00,137.44,137.48,136.54,136.71,2794600,3523341.8,61.46380292616291,62.51811940496186,NaN,NaN,91.81793703528423,84.51046597763532,-0.14895627022302005,2.1547461390413787,2.3037024092643987,751012833,752102847.8,83.68830050486402,84.80974342444306,NaN,NaN,23.390689202709854,22.710407859848388
2020-08-04T09:30:00-04:00,136.44,137.85,136.42,137.81,2670092,3484514.85,64.14296263394841,62.52056095226775,NaN,NaN,102.81988994589597,90.92841054331168,-0.10906752801316433,2.1673679992479435,2.276435527261108,753682925,752494814.2,84.17051750982425,84.8762673557111,NaN,NaN,24.065279100512996,22.903960894229048
2020-08-05T09:30:00-04:00,138.35,139.56,138.13,139.49,3268368,3510935.2,67.82242480833044,62.86371927921741,NaN,NaN,164.55958298896107,106.38289325617461,0.008111309919530019,2.2865746646605203,2.2784633547409903,756951293,753090949.4,84.9015814766171,84.921199324716,NaN,NaN,25.72490285903733,23.306952603487375
2020-08-06T09:30:00-04:00,138.99,140.47,138.79,140.17,2156094,3463120.2,69.20009004583287,63.44510990807233,NaN,NaN,183.92430385437584,128.70560816225148,0.1037552230463139,2.4081573835488825,2.3044021605025686,759107387,754912374.2,86.8933207849702,85.30958164495107,NaN,NaN,27.52750761694146,23.909889033980814
2020-08-07T09:30:00-04:00,140.18,140.8,139.36,140.38,2976535,3289129.3,69.63249883063902,63.77357474767857,NaN,NaN,179.1593943656719,144.4562216380378,0.15065686940025147,2.492723247252883,2.3420663778526314,762083922,756567672,88.39199793948265,85.72160732423585,NaN,NaN,29.15101676889302,24.6586215675397
2020-08-10T09:30:00-04:00,140.88,142.22,140.66,142.06,2280328,3071082.2,72.90923180971957,64.30944667716088,NaN,NaN,203.75371135967183,166.8433765029153,0.2580177337642686,2.664588545057967,2.4065708112936983,764364250,759237955.4,90.31574339456941,86.23067571654732,NaN,NaN,31.575624705332906,25.64676487293873
2020-08-11T09:30:00-04:00,142.87,143.67,141.45,141.78,3546913,2961575.45,71.52401637437633,64.59772389150326,NaN,NaN,192.61976618637715,184.80335175101155,0.2719745350824545,2.7465389801467666,2.474564445064312,760817337,760664837.8,91.15890654904481,86.77367653216508,NaN,NaN,33.2183241506283,26.728416198322954
2020-08-12T09:30:00-04:00,143.18,143.96,142.63,143.66,3815599,2964712.3,74.96349770938988,65.62526113375968,NaN,NaN,183.3881003411277,188.5690552214449,0.3638821094991993,2.929417081938311,2.565534972439112,764632936,762201166.4,91.96961095780905,87.35314428532426,NaN,NaN,35.742755146805635,28.016178905249053
2020-08-13T09:30:00-04:00,143.53,144.46,143.3,143.6,2371377,2932047.05,74.65358244996548,66.59494609026585,NaN,NaN,158.2994884305659,183.44409213668288,0.3751941426761034,3.0345276507842414,2.659333508108138,762261559,762832000.8,92.28254069650066,87.85009830746144,NaN,NaN,37.71879698219559,29.402267201955702
2020-08-14T09:30:00-04:00,143.6,143.91,142.97,143.59,1687059,2861667.15,74.59822767866727,67.43382904235777,NaN,NaN,128.23878888861228,173.25997104127094,0.3377331963733545,3.0815000035748312,2.7437668072014767,760574500,762530116.4,90.46575193012926,88.12692679021696,NaN,NaN,39.339398250572415,30.82185735175809
2020-08-17T09:30:00-04:00,144.77,145.62,144.14,145.44,1608972,2805325.6,77.86776364218848,68.83483772095303,NaN,NaN,143.42459648511203,161.194148066359,0.38959714855877037,3.2307632428999398,2.8411660943411694,762183472,762093960.8,87.77699785813917,88.18555891227318,NaN,NaN,41.79541513386387,32.38950846348749
2020-08-18T09:30:00-04:00,146,146.66,144.91,146.34,2587680,2801814.4,79.26593988185635,70.1148696009213,NaN,NaN,140.56974285155988,150.78414339939553,0.4332146711952811,3.382684433335271,2.94946976213999,764771152,762884723.8,88.44740116419757,88.27022043689759,NaN,NaN,44.32136860471428,34.09405991223417
2020-08-19T09:30:00-04:00,146.91,146.95,145.44,145.65,2655410,2801560.05,75.3364770075326,71.14210853347446,NaN,NaN,123.48862271659183,138.8042478744884,0.36691951960323843,3.408119161644038,3.0411996420407994,762115742,762381285,85.24189666784517,88.10989454619528,NaN,NaN,45.35185966840698,35.70231702025886
2020-08-20T09:30:00-04:00,144.77,145.85,144.4,145.43,1663269,2713031.15,74.07557915386231,71.96114963946226,NaN,NaN,96.04837094812879,126.35402437800096,0.2643665527500123,3.3716578329783147,3.1072912802283024,760452473,762019467.8,82.9160705953389,87.75861700209511,NaN,NaN,45.860662717878,37.15350926277588
2020-08-21T09:30:00-04:00,145.28,146.26,145.25,146.18,1823841,2647033.1,75.57633062064282,72.96918733192511,NaN,NaN,98.01410181771311,120.30908696382112,0.20576447475844528,3.3644968736763587,3.1587323989179135,762276314,762359830.6,83.3755941993542,87.73628083741583,NaN,NaN,46.71392682374772,38.51928320005757
2020-08-24T09:30:00-04:00,147.18,148.46,147.17,148.4,2642051,2656652.85,79.38119809089528,74.05763272170704,NaN,NaN,125.17540684864674,116.65924903652805,0.2711249671509499,3.497638607856601,3.226513640705651,764918365,762906809.2,84.11506076913123,87.73231964165204,NaN,NaN,48.67328945409648,39.96985552206313
2020-08-25T09:30:00-04:00,148.75,148.9,147.68,148.89,2598977,2658610.65,80.11745336783865,74.9358490473862,NaN,NaN,122.99854789156312,113.14501004452873,0.2997339850441536,3.6011811220108427,3.301447136966689,767517342,763456047.2,84.84406503812801,87.7282113246171,NaN,NaN,50.51264761871208,41.47596867872726
2020-08-26T09:30:00-04:00,148.9,150.6,148.76,150.36,2792253,2685847.1,82.17394172160817,75.862552738513,NaN,NaN,136.7006494885035,115.78741539891107,0.3656663148828989,3.758530030570313,3.392863715687414,770309595,765094817.8,86.79180219119752,87.72095999649049,NaN,NaN,52.76980441611605,43.08937378406852
2020-08-27T09:30:00-04:00,150.92,151.02,148.99,149.55,3085432,2641601,77.42200110910375,76.41894575840332,NaN,NaN,126.76428958821245,121.93059912692779,0.30519819089565603,3.774361454306984,3.469163263411328,767224163,766449155.8,88.14746713913098,87.70349351075109,NaN,NaN,53.219820250898394,44.53658042218707
2020-08-28T09:30:00-04:00,150.32,150.8,149.74,150.53,2137875,2558136.25,79.00397633635882,76.85428465316328,NaN,NaN,124.0793389529015,127.14364655396548,0.28221256003357986,3.8219289634533027,3.539716403419723,769362038,767866300.6,89.3762077668673,87.63638382305808,NaN,NaN,54.07789535821943,45.89962541304884
2020-08-31T09:30:00-04:00,150.51,150.955,149.89,150.09,3512483,2594030.4,76.4151380817127,77.2036504894016,NaN,NaN,113.8916262953131,124.88689044329874,0.1926608723264125,3.7805424938277383,3.587881621501326,765849555,768052538.6,89.5298256299852,87.52002090026812,NaN,NaN,54.01942677245661,47.059597035821376
2020-09-01T09:30:00-04:00,150.23,151.75,150.02,151.66,4952274,2708139.5,79.05277020581842,77.49574138200363,NaN,NaN,121.49395300467238,124.58597146592061,0.19391570840849592,3.8302762570119455,3.6363605486034496,770801829,768709436,90.07496568665104,87.38468909518541,NaN,NaN,54.766915971549324,48.16064259806823
2020-09-02T09:30:00-04:00,152.71,154.14,151.84,153.76,4076837,2748562.95,81.95909144927022,78.01756345338254,NaN,NaN,148.20876618706617,126.88759480563313,0.28540192250479723,3.993112951734446,3.7077110292296487,774878666,769623250.2,90.79311069319658,87.27830123780656,NaN,NaN,56.384872496931216,49.335532583620086
2020-09-03T09:30:00-04:00,153.32,153.43,147.45,148.88,7570915,3019304,60.835804976039114,77.03453326033767,NaN,NaN,69.36948380535087,115.40863364906082,-0.017450224408121606,3.6858982487194965,3.703348473127618,767307751,769639967.8,90.80621684202185,87.30262016008462,NaN,NaN,49.69359230701783,49.386683972676906
2020-09-04T09:30:00-04:00,149.36,150.21,143.62,147.16,6669885,3203971.5,55.41475877170238,75.4307471981601,NaN,NaN,-1.338539431388545,90.32505797220281,-0.34988641616237093,3.2659904529246546,3.6158768690870255,760637866,767895133.4,78.2810434169097,86.62433769999679,NaN,NaN,42.32743454167051,48.37821976824742
2020-09-08T09:30:00-04:00,144.74,147.27,144.05,145.23,7606291,3470269.65,50.027742345639176,73.34230451700172,NaN,NaN,-44.29700833490509,58.68733104615917,-0.6960427070729742,2.7458234852458077,3.441866192318782,753031575,765331537.4,64.25712147839275,84.89646057958215,NaN,NaN,34.370975505115844,46.37718487351434
2020-09-09T09:30:00-04:00,146.59,149.07,145.735,147.97,3712940,3478571,56.49396033423665,71.99641046890915,NaN,NaN,2.280763376656025,34.8446931205559,-0.7330374934137449,2.5255693255516007,3.2586068189653457,756744515,762520074.6,53.03568400625053,82.59601681803967,NaN,NaN,30.234502040527094,44.07108732594473
2020-09-10T09:30:00-04:00,148.71,150.28,145.37,145.85,6277087,3601645.4,50.99570444796537,70.34784798991652,NaN,NaN,-16.133031724582633,1.9763335382261324,-0.8827996157409403,2.1551072992891704,3.037906915030111,750467428,757637827,39.979036192501006,79.52908578926554,NaN,NaN,24.842953950014625,41.324211129383286
2020-09-11T09:30:00-04:00,146.84,147.51,144.69,146.07,3798254,3672989.25,51.52297124481224,68.6297508916429,NaN,NaN,-54.913333173992946,-22.88022985764264,-0.9440459294459096,1.8578495032227238,2.8018954326686334,754265682,755029413.2,35.01876207966346,76.07502635214477,NaN,NaN,20.993301356785437,38.419795447583596
2020-09-14T09:30:00-04:00,147.69,148.76,147.04,147.62,2778139,3727543.25,55.18181791949829,66.90122373654313,NaN,NaN,-7.802675370099391,-24.173057045384805,-0.8595724516619412,1.7274298680912068,2.587002319753148,757043821,754310604.2,33.775129529488794,72.47931697788462,NaN,NaN,19.097302395871086,35.65943929733895
2020-09-15T09:30:00-04:00,148.55,149.34,148.06,148.83,2706225,3782405.9,57.85594992633361,65.31111634786419,NaN,NaN,19.58702936208593,-11.396249505986603,-0.7079317371324874,1.702087648337539,2.4100193854700263,759750046,755654298.4,38.19383170572879,69.1471574541418,NaN,NaN,18.45075509713739,33.2010558401673
2020-09-16T09:30:00-04:00,149.45,150.03,147.93,148,2608622,3783453,55.41352195655926,63.399657793217834,NaN,NaN,11.904530587133483,-9.471496063891113,-0.6507156712458402,1.5966247964127263,2.2473404676585664,757141424,755733680.2,38.45509050938356,65.6945351911551,NaN,NaN,17.15245530732202,30.908398621189402
2020-09-17T09:30:00-04:00,145.84,146.87,144.7,145.92,4424640,3871914.5,49.745899057167364,61.42279336093667,NaN,NaN,-96.93982734183416,-25.63285518734142,-0.7339714736689693,1.3298761255723548,2.063847599241324,752716784,756183551.4,40.00291320120447,62.2556384813032,NaN,NaN,14.189844963978636,28.520033813016436
2020-09-18T09:30:00-04:00,146.38,146.435,142.69,143.89,5423621,4059932.1,44.917349428595784,58.988034296096444,NaN,NaN,-149.04454598269336,-44.4590977490815,-0.8960441623731044,0.9437923962749437,1.839836558648048,747293163,754789047.6,36.904597030456216,58.507666285845254,NaN,NaN,10.073626487319764,25.88483276648834
2020-09-21T09:30:00-04:00,141.29,141.67,139.0323,141.51,4217906,4179635.35,40.013556007795,56.38792129081662,NaN,NaN,-240.02169551133483,-90.9029017773286,-1.1193155467461133,0.44069212521540635,1.5600076719615197,743075257,751995334.8,31.62072098594264,54.37130166841366,NaN,NaN,4.8916708974043415,22.885809642333484
2020-09-22T09:30:00-04:00,142.38,144.63,141.91,144.5,3819341,4238499.85,47.733596489079304,54.15083745390668,NaN,NaN,-122.98854417153647,-119.41801648405308,-1.0239888317951382,0.280021632217597,1.3040104640127352,746894598,749424245.2,27.691243939845123,49.9153215436418,NaN,NaN,3.1234477106410745,20.06261508066314
2020-09-23T09:30:00-04:00,146,146.27,141.84,142.13,3965354,4306818.7,43.00877530277931,51.36867201487162,NaN,NaN,-113.82405140474184,-144.56373288242813,-1.0736969847597844,-0.03811076693699533,1.035586217822789,742929244,746581809.2,24.122298977147764,45.153120706781166,NaN,NaN,0.0020127403663147943,17.196814746335022
2020-09-24T09:30:00-04:00,141.48,144.06,140.4,142.07,4498673,4392139.7,42.89302145217237,50.08704462030971,NaN,NaN,-129.047159266446,-150.9851992673505,-1.0618384235907623,-0.29171181166566384,0.7701266119250985,738430571,743724566.6,21.168812501524556,40.17902039674565,NaN,NaN,-2.4186422445431854,14.394606604780993
2020-09-25T09:30:00-04:00,142.03,144.41,141.04,143.92,2514322,4363584.2,47.57789614130483,49.527268718138465,NaN,NaN,-92.94648913851427,-139.76558789851467,-0.8877008016731267,-0.3394993901663099,0.5482014115068168,740944893,742454912.6,19.997137725871454,36.01588427595719,NaN,NaN,-2.9301185611779865,11.919645866786853
2020-09-28T09:30:00-04:00,145.81,147.27,145.22,146.93,2662675,4389824.2,54.16620651121513,49.822873301393884,NaN,NaN,-4.637942524712732,-92.68883730119026,-0.5449266505168623,-0.1329569016392611,0.4119697488776012,743607568,742561374.8,20.39501176350869,32.88287643917976,NaN,NaN,-1.1368170794247603,10.054436874470909
2020-09-29T09:30:00-04:00,146.86,146.959,145.69,145.79,3028471,4365623.6,51.525009926918166,49.467948272299715,NaN,NaN,-8.377460489030398,-69.76662056468905,-0.3780244840568048,-0.06056085619340479,0.3174636278634,740579097,741298274.6,19.176482204658967,30.46436202478037,NaN,NaN,-0.5470201119505523,8.539943019267843
2020-09-30T09:30:00-04:00,146.23,148.72,146.05,146.98,4474196,4341719.7,54.044081734939574,49.68568950708358,NaN,NaN,31.310491759271155,-40.73971193188645,-0.18054800679556954,0.09177861936893805,0.2723266261645076,745053293,741723084.4,20.888441580277302,29.10074812390725,NaN,NaN,0.7397399252310448,7.425628291548301
2020-10-01T09:30:00-04:00,148.43,149.03,147.49,148.9,3879579,4331856.8,57.84999912501241,50.13762006995502,NaN,NaN,85.50277889360316,2.170275700123375,0.07273821291604948,0.36324939230956943,0.29051117939351995,748932872,743823544.6,28.90684839188056,28.66418286049418,NaN,NaN,3.0535299488208376,6.801042814015806
2020-10-02T09:30:00-04:00,146.12,148.77,146.06,148.27,4089845,4157803.3,56.2051795985221,50.21071733274243,NaN,NaN,65.57430958107557,33.874435444041346,0.1848263879725885,0.5215441643592555,0.33671777638666706,744843027,744603171.4,31.674968764949696,28.514171377312817,NaN,NaN,4.425186898298139,6.461634826056139
2020-10-05T09:30:00-04:00,149.06,150.395,148.93,150.23,2320379,3940328,60.01426079754373,50.36488239497174,NaN,NaN,130.4512739503162,60.89227873904713,0.367405009309627,0.7959740380237008,0.4285690287140738,747163406,745314339,34.19209589087707,28.228333104823413,NaN,NaN,6.795288732212164,6.509299669792714
2020-10-06T09:30:00-04:00,150.37,151.05,147.21,147.45,3975598,3758793.35,52.976218913857586,50.19078932049304,NaN,NaN,78.59432179414182,78.28663519568157,0.28126148689074626,0.7801458873275067,0.4988844004367604,743187808,745836081.2,36.05337550888607,28.056782033359305,NaN,NaN,6.630146894284164,6.526563559005778
2020-10-07T09:30:00-04:00,149.24,151.18,149.24,150.82,2502953,3698294,59.2195851768763,50.86748118618654,NaN,NaN,126.845012560904,97.39353935600813,0.4230414972259532,1.027686271969202,0.6046447747432487,745690761,745963574.8,36.52581673321423,27.80841799993143,NaN,NaN,8.602119853531196,6.823071601080838
2020-10-08T09:30:00-04:00,151.8,151.91,150.695,151.81,2533327,3511106,60.863477898308496,52.00649036259459,NaN,NaN,139.92845728049207,108.27867503338594,0.5473969828259789,1.2888910032757224,0.7414940204497434,748224088,745821818,36.205525379066174,27.758484310546418,NaN,NaN,10.713510901802193,7.378848644041032
2020-10-09T09:30:00-04:00,152.6,153.75,152.41,153.39,3681174,3505252,63.39929463706415,53.676900264685244,NaN,NaN,159.85339048707132,127.1344912145851,0.6907169870498188,1.604890254262017,0.9141732672121982,751905262,747234265,41.69191909746752,28.477855604226768,NaN,NaN,13.277309583637722,8.221485921126273
2020-10-12T09:30:00-04:00,154.46,156.1415,154.24,155.43,3197227,3526206.4,66.42425096515365,55.01194701297627,NaN,NaN,180.19613278553203,137.08346298162826,0.8661923543217376,1.9969137101143701,1.1307213557926326,755102489,748822081.6,47.1902500529301,29.87064175516141,NaN,NaN,16.421782039408665,9.392956795166615
2020-10-13T09:30:00-04:00,155.11,156.1,154.5901,155.4,3412972,3561543.75,66.33742212189321,56.678278928627265,NaN,NaN,157.23509334484694,152.8116172917693,0.9185465797968715,2.278904580538722,1.3603580007418503,751689517,750522423.4,52.3699407638429,31.888330454211065,NaN,NaN,18.876116763710964,10.747693933530094
2020-10-14T09:30:00-04:00,155.73,155.89,152.99,153.68,3805374,3621381.35,61.38316541935412,57.99900349771167,NaN,NaN,117.26196142328023,150.89500706424454,0.78104095852589,2.3366591988992127,1.5556182403733227,747884143,750961099.8,53.63347492677671,34.20723491315765,NaN,NaN,19.494788018428178,11.99727880280125
2020-10-15T09:30:00-04:00,151.7,154.54,151.25,154.25,2379053,3519102,62.38571040881306,59.0567045168194,NaN,NaN,90.34637470981896,140.9785905501099,0.6761054352048612,2.4007500343793993,1.724644599174538,750263196,751368921.4,54.83307646561346,36.69551625171065,NaN,NaN,20.293609114797288,13.182468847372112
2020-10-16T09:30:00-04:00,154.94,155.68,152.38,152.85,2105617,3353201.8,58.37698141757172,59.357474152987734,NaN,NaN,85.71654495480902,126.15122144365746,0.4698233330517163,2.3119237654891833,1.842100432437467,748157579,750619384.8,52.161955049987746,38.964583629316294,NaN,NaN,19.815139836064777,14.129993274328207
2020-10-19T09:30:00-04:00,153.85,154.46,150.6,150.97,2577000,3271156.5,53.413492623990635,59.492365774207194,NaN,NaN,50.617289687921584,100.23545282413536,0.1791295063120022,2.0660123153274697,1.8868828090154675,745580579,748715002.8,46.02702235024745,40.882479354001184,NaN,NaN,17.919796697158244,14.671393763303927
2020-10-20T09:30:00-04:00,151.85,154.06,151.44,152.18,4260400,3293209.45,56.00617512937861,59.632515302381414,NaN,NaN,55.06106710438013,79.800647576042,0.04755500549225111,1.9463265658807813,1.8987715603885302,749840979,748345295.2,44.922414744365746,42.599191722864646,NaN,NaN,17.070738914959172,15.014157356397533
2020-10-21T09:30:00-04:00,152.01,153.07,150.9,151.35,2769908,3233437.15,53.79458251097572,59.342842687093075,NaN,NaN,34.29401141449392,63.20705757428474,-0.10768565340988934,1.7641644936261685,1.8718501470360578,747071071,748182680.8,44.41748101660194,43.707094053201885,NaN,NaN,15.72148492679939,15.115204152169227
2020-10-22T09:30:00-04:00,151.33,151.83,149.7,151.66,2068109,3111908.95,54.5169973042456,59.2222582375019,NaN,NaN,11.460896722076436,47.42996197673623,-0.1966242557068778,1.6260698274024605,1.8226940831093383,749139180,747957877.6,43.686432764983905,44.565055767490044,NaN,NaN,14.803592712024253,15.070688232148516
2020-10-23T09:30:00-04:00,152.28,153.01,151.11,152.99,1957539,3084069.8,57.58126087214618,59.048472528544934,NaN,NaN,37.179114362807645,37.72247585833596,-0.17380154136577497,1.6054421564021197,1.7792436977678947,751096719,748545705.6,46.18080782438748,45.421392334169354,NaN,NaN,14.85384925095629,15.039711234835341
2020-10-26T09:30:00-04:00,151.43,152.05,147.915,150.05,3150116,3108441.85,49.622649294163914,58.808931841423956,NaN,NaN,-37.84801151914785,20.029415616922083,-0.3542306989631687,1.3364553240639339,1.6906860230271026,747946603,749018910.4,48.171044516656146,46.28694012043865,NaN,NaN,12.496243902255195,14.676358758752462
2020-10-27T09:30:00-04:00,150.45,150.9,149.56,149.98,3120736,3113055.1,49.44740855843651,58.11091922582112,NaN,NaN,-44.14000196046635,0.18920180395278124,-0.4686317390890773,1.104896349165756,1.5735280882548333,744825867,748015888,44.42127361807954,46.850901326500455,NaN,NaN,10.543258237741403,14.085915827179454
2020-10-28T09:30:00-04:00,147.29,148.03,145.08,145.24,4586178,3118654.2,39.32119997893346,56.5721850887229,NaN,NaN,-174.94393711043082,-41.658387901032164,-0.8326109262995609,0.5327644303803822,1.3653753566799431,740239689,746649611.6,39.868639914126184,47.11255236471903,NaN,NaN,5.273394740377814,12.826984243350648
2020-10-29T09:30:00-04:00,145.66,147.84,144.62,146.16,3033928,3076371.65,41.81195639319095,55.03023235701767,NaN,NaN,-158.33052386673882,-75.61667201879523,-0.9708348046008912,0.15183185092882923,1.1226666555297204,743273617,745476499,36.417463115500276,46.73580550886423,NaN,NaN,1.7939802696271632,11.250840818533007
2020-10-30T09:30:00-04:00,145.03,145.55,141.74,142.97,4991626,3121460.7,36.25485872227315,52.87527576824049,NaN,NaN,-214.97598563722565,-126.04769201880188,-1.220391574171646,-0.4028228121848372,0.8175687619868088,738281991,742913553.4,30.255436346667494,45.5261759584169,NaN,NaN,-3.1609967967236225,9.192006873496346
2020-11-02T09:30:00-05:00,144.84,145.35,142.41,143.99,3990906,3204987.05,39.0445383937159,50.92578407337068,NaN,NaN,-167.41513091470037,-151.9611158979124,-1.255193580949881,-0.7514232142005426,0.5037703667493385,742272897,741778812.2,27.996712929203724,43.78523111308554,NaN,NaN,-6.262050889338464,6.984284335948516
2020-11-03T09:30:00-05:00,145.52,147.99,144.78,147.16,2837749,3148094.6,46.83208491208011,49.88642117999397,NaN,NaN,-94.26402649259363,-161.98592080433784,-1.013498266919489,-0.7631024669000226,0.25039580001946626,745110646,741835768,28.28610641593515,41.97470479088256,NaN,NaN,-6.368958806895361,5.076678172685105
2020-11-04T09:30:00-05:00,148.9,152.0759,148.6,150.29,4270617,3236477.8,53.1910531819016,49.22965994950029,NaN,NaN,-7.707376482447515,-128.53860867874118,-0.6114125955863225,-0.5138699444634369,0.09754265112288563,749381263,743664082.8,37.034649878631335,40.70338860609813,NaN,NaN,-4.244967395806096,3.7450145200435045
2020-11-05T09:30:00-05:00,152.93,154.15,152.2599,153.22,3240046,3271813.75,58.22761600441165,49.218990991417435,NaN,NaN,56.596657176764644,-85.55317247004048,-0.14124535066184157,-0.07901403720441635,0.062231313457425226,752621309,745533621.2,44.49157004141331,40.15550396262852,NaN,NaN,-0.6763170964257581,3.1133957176907527
2020-11-06T09:30:00-05:00,152.77,153.03,151.46,152.76,2423550,3208932.55,57.18726566751862,49.48854620881229,NaN,NaN,39.73299729346606,-34.61137588390214,0.13092720812019734,0.22589032360767192,0.09496311548747458,750197759,747916774.8,52.253992281785386,40.60028752916695,NaN,NaN,1.7480131017908986,2.918341058276488
2020-11-09T09:30:00-05:00,158.04,158.04,152.07,152.26,4891333,3293637.85,56.01572486413755,49.48922833272364,NaN,NaN,81.84655943228347,15.24096218549461,0.26188168200360384,0.42231521799197935,0.1604335359883755,745306426,748523480.6,54.0169695169376,41.24989858435066,NaN,NaN,3.3148572913244236,2.974986234426193
2020-11-10T09:30:00-05:00,152.11,152.47,150.11,151.72,8882419,3567110.2,54.712107987840746,49.554765866785424,NaN,NaN,24.58980556286335,39.011728596586,0.2943089583293153,0.5283197339000196,0.23401077557070432,736424007,746786152.8,48.49498966895004,41.54114920237553,NaN,NaN,4.202594669259542,3.1503588679738144
2020-11-11T09:30:00-05:00,152.69,153.77,152.11,153.05,3703465,3562014.75,57.345111220040984,49.756774003627946,NaN,NaN,65.69434647201639,53.69207318747878,0.3819496462967705,0.7114478334416674,0.3294981871448969,740127472,744935394.6,43.404579775912495,41.521016846013275,NaN,NaN,5.734851351974817,3.5195720799739574
2020-11-12T09:30:00-05:00,153.05,153.065,150.135,151,2964886,3591306.4,52.298017010730256,49.37939944209825,NaN,NaN,29.019077348353825,48.17655722179662,0.2830285171289994,0.6832838335561462,0.4002553164271468,737162586,741843650,36.51001966974229,40.830246263538626,NaN,NaN,5.559333873459705,3.8109666219004925
2020-11-13T09:30:00-05:00,151.87,153.705,151.65,153.45,2231761,3597613.6,57.15174123017941,49.917191723242205,NaN,NaN,70.6534170933082,54.36064118176505,0.3588940722724391,0.8488729067676957,0.4899788344952566,739394347,739682967.6,32.61138727702186,39.71884217499332,NaN,NaN,6.912635964529737,4.254062242276099
2020-11-16T09:30:00-05:00,155,155.51,153.83,155.46,3932297,3665378.45,60.68601649426659,50.71994943294436,NaN,NaN,114.46236207662375,60.88380171063311,0.5114377729315642,1.129276050659712,0.6178382777281477,743326644,739287011.2,31.938327699413307,38.827203180802876,NaN,NaN,9.179837412487956,4.957744409449221
2020-11-17T09:30:00-05:00,154.91,155.51,153.63,154.8,2919789,3598347.9,58.96612001855725,52.1231580072032,NaN,NaN,101.38894224271804,76.24362904660404,0.5324864243114626,1.283446308117476,0.7509598838060134,740406855,740083580.8,34.851394240398875,38.46882848982235,NaN,NaN,10.509327910460911,5.750827766736605
2020-11-18T09:30:00-05:00,154.72,155.96,153.7,153.74,2707605,3595232.75,56.210751570427576,53.15164337700582,NaN,NaN,90.12606827095455,81.12997340639167,0.4432724113999752,1.3050503980559824,0.8617779866560072,737699250,739597936.4,33.89879252612165,38.28892344772388,NaN,NaN,10.811769061615815,6.473819380290777
2020-11-19T09:30:00-05:00,153.71,154.65,153.38,154.5,2107214,3597188,57.73565954433008,54.68598629286702,NaN,NaN,76.28230723728167,90.58261938417725,0.40476248328719844,1.3677310907650053,0.9629686074778069,739806464,740126712,35.951549490665485,38.695788672295166,NaN,NaN,11.501506322731995,7.192060372068094
2020-11-20T09:30:00-05:00,154.65,154.76,153.64,153.69,2066734,3602647.75,55.51666800253252,55.86256697921107,NaN,NaN,69.5425983245896,90.36045563043352,0.29893537952303717,1.3366378318816032,1.037702452358566,737739730,739795788.6,35.21451035325951,39.21134563115629,NaN,NaN,11.45911733464707,7.801639938150805
2020-11-23T09:30:00-05:00,154.54,155.79,154.125,155.38,2306109,3560447.4,59.052752228966284,56.73547178756008,NaN,NaN,84.92452521288752,84.45288825768628,0.3153256312071051,1.4318594913674474,1.1165338601603423,740045839,739139627.6,33.737598024752046,39.60073788892892,NaN,NaN,12.435916035396959,8.463679380614542
2020-11-24T09:30:00-05:00,156.85,158.21,156.4,157.69,2732835,3541052.35,63.342202321465116,57.46055386895748,NaN,NaN,121.79354780750549,88.53380937064377,0.4463084101352388,1.6744193728293908,1.228110962694152,742778674,739613991.4,35.83282833342591,39.514893492842816,NaN,NaN,14.595583866934744,9.339665735803141
2020-11-25T09:30:00-05:00,157.57,158.14,157.13,157.88,2312351,3427361,63.679224375750344,57.84995446691023,NaN,NaN,120.60126438067931,94.62884859258872,0.5059385569645265,1.86053415889981,1.3545956019352836,745091025,741092346.4,41.98920634811989,39.33615322903614,NaN,NaN,16.448054894356524,10.355149901310767
2020-11-27T09:30:00-05:00,158.6,158.79,157.74,158.22,1108264,3331077.8,64.31153405704175,58.3588307804476,NaN,NaN,127.2710226649198,104.82659167811634,0.5261398587539958,2.0122704253777783,1.4861305666237825,746199289,742370911.4,46.74780076062539,38.942853834667574,NaN,NaN,18.163003858688562,11.470557609507594
2020-11-30T09:30:00-05:00,157.98,158.06,155.21,157.26,3288012,3245897.1,61.078289305853126,58.72044252628443,NaN,NaN,93.62827435088955,109.64372688337633,0.43640679658706416,2.0316390623576126,1.5952322657705484,742911277,743405220.8,50.29955191844262,38.67732400620365,NaN,NaN,18.762369154619655,12.512244973095031
2020-12-01T09:30:00-05:00,158.49,159.16,157.49,158.43,4369116,3264807.6,63.487582286664825,59.34726211905757,NaN,NaN,134.43815822885628,119.54645348657009,0.41740992483668116,2.1169946718164,1.6995847469797187,747280393,744852131.6,54.837494343398255,39.130360054378514,NaN,NaN,19.94961197503475,13.574725973372134
2020-12-02T09:30:00-05:00,157.81,157.81,156.77,157.44,2154615,3230650.9,60.097663461262606,59.54387299343055,NaN,NaN,95.08671151727975,114.20508622852495,0.30494745876140295,2.0807690704314723,1.7758216116700694,745125778,745321552.4,56.233682464106664,40.04672453210667,NaN,NaN,20.04150387412919,14.498551387766
2020-12-03T09:30:00-05:00,157.48,158.75,157.48,157.88,3005736,3167406.85,61.092018270498684,60.17201594055687,NaN,NaN,106.02972962433482,111.29077927725605,0.23036225951607214,2.0637744360651595,1.8334121765490874,748131514,745929650.2,58.04320502221198,41.58480920014022,NaN,NaN,20.385358496952836,15.339523831935548
2020-12-04T09:30:00-05:00,158.2,158.4299,157.72,158.03,2089284,3109868.75,61.44475427614653,60.478659729554515,NaN,NaN,93.41369083131643,104.51931291053538,0.16439551201173264,2.038906566563753,1.8745110545520205,750220798,746733952,60.37669014840127,43.56804511952446,NaN,NaN,20.76559241673539,16.114676486906955
2020-12-07T09:30:00-05:00,157.68,157.745,156.87,157.67,4215580,3199470.25,60.03795256508575,60.43236944889874,NaN,NaN,64.44744095640311,98.68314623163809,0.07436702982783694,1.9674698418368166,1.8931028120089797,746005218,747352740.2,62.122095649609264,45.724028544538456,NaN,NaN,20.7333491135642,16.774486862143704
2020-12-08T09:30:00-05:00,156.91,157.44,156.12,157.34,2478452,3078826.2,58.710975266418295,60.414144823745964,NaN,NaN,44.29487608550557,80.65448980296794,-0.02427840728815034,1.8627548028987917,1.887033210186942,743526766,746602014.8,58.741344219117224,47.430453543018345,NaN,NaN,20.372283282726507,17.288457779369818
2020-12-09T09:30:00-05:00,158.37,158.45,156.52,157.19,6030412,2936225.85,58.082561939543425,60.54784556439709,NaN,NaN,52.2621653534418,72.08958057020035,-0.1116111131115416,1.747519318797515,1.8591304319090567,737496354,745076130,52.488769962001044,48.758309074152585,NaN,NaN,19.90789326360441,17.662662848546187
2020-12-10T09:30:00-05:00,156.58,157.72,155.93,157.05,2902963,2896200.75,57.464337800553196,60.52846543984161,NaN,NaN,30.082407935486465,56.900116232430676,-0.18638253243350844,1.6261522663671713,1.8125347988006797,734593391,742368505.4,43.61679825988121,49.30582684338227,NaN,NaN,19.357692342660478,17.904809919133942
2020-12-11T09:30:00-05:00,156.47,157.03,155.23,156.3,2067158,2851314.35,54.139774923098074,60.430115934167716,NaN,NaN,-8.01045156087151,36.615287753993094,-0.2878651108101704,1.4527034102879668,1.7405685210981372,732526233,738829592.4,35.234112168337546,49.3072269730307,NaN,NaN,18.04222171345603,17.92444017546567
2020-12-14T09:30:00-05:00,157.72,158.62,156.48,156.53,3407484,2910100.5,54.99958769832901,60.140604181979334,NaN,NaN,34.01163615267829,30.528126793248124,-0.33757242839271595,1.3186029856072423,1.6561754139999583,735933717,736815292.2,31.520767992167023,49.1488819707032,NaN,NaN,17.100952410370812,17.806799066166406
2020-12-15T09:30:00-05:00,157.91,158.67,157.19,158.64,2326300,2829800.65,62.03227885499984,60.047038220088965,NaN,NaN,80.83476645706291,37.83610486755959,-0.2314756720124913,1.366830823984344,1.5983064959968354,738260017,735761942.4,29.754764747288576,48.71473457169339,NaN,NaN,18.065011254600797,17.843686521657034
2020-12-16T09:30:00-05:00,158.93,160.08,158.87,159.68,2221627,2794892.55,64.9406169350448,60.13713768861,NaN,NaN,152.96661550543237,57.97699489795771,-0.10104302819056388,1.4720027107586304,1.5730457389491943,740481644,736359000.4,32.077692623524115,48.00676930565084,NaN,NaN,19.734246625544174,18.113766536498055
2020-12-17T09:30:00-05:00,160.5,160.8,160.04,160.77,1988746,2758949.6,67.73058535865852,60.38135563872548,NaN,NaN,199.77109083822776,91.91473147850596,0.04122656438746297,1.624578944433523,1.58335238004606,742470390,737934400.2,37.911952924745925,47.37563731737374,NaN,NaN,22.01221835691459,18.670688225128988
2020-12-18T09:30:00-05:00,161.04,161.13,159.28,159.99,4946372,2900907.5,63.816920353700475,60.57697214214314,NaN,NaN,160.93877104640396,125.70457599996105,0.06402432497517774,1.663382786265032,1.5993584612898544,737524018,738933957.2,41.35397322576654,46.736667410754016,NaN,NaN,22.86517214619117,19.269900213852157
2020-12-21T09:30:00-05:00,157.4,158.81,156.27,157.89,3952165,2995179.05,54.65948735959488,59.946393933066716,NaN,NaN,-7.864562195448416,117.32933633033572,-0.07364088108286171,1.5073073599362772,1.580948241019139,733571853,738461584.4,40.21922089892308,45.69250502186293,NaN,NaN,20.822004061002254,19.4916293348736
2020-12-22T09:30:00-05:00,157.63,157.7,155.83,157.21,3726599,3066203.55,52.05470068117137,59.37189659163163,NaN,NaN,-75.88053459381442,85.98627612016026,-0.2138756032825957,1.3136037369158942,1.5274793401984899,729845254,736778631.8,36.388187413502216,44.274969661105466,NaN,NaN,18.323360312784644,19.324733760289465
2020-12-23T09:30:00-05:00,157.24,158.05,156.57,157.55,2172967,3038210.15,53.25421046596397,58.81205317702201,NaN,NaN,-37.15259346847944,47.962434325377885,-0.28278802969906036,1.1739943030746645,1.4567823327737248,732018221,735085947.2,32.98498750789754,42.485096981511575,NaN,NaN,16.613555634663218,18.937422599485714
2020-12-24T09:30:00-05:00,157.7,158.12,157.21,157.88,1048821,2975033.65,54.44547707767137,58.312104805702354,NaN,NaN,-9.318870130840622,6.144442131564216,-0.30337816511226756,1.0775596263833904,1.380937791495658,733067042,733205277.6,29.665301904535525,40.29142639266403,NaN,NaN,15.523608517812084,18.44973487353234
2020-12-28T09:30:00-05:00,159.42,160.32,158.6,159.68,2912501,3065245.5,60.37689142617005,58.336314724351226,NaN,NaN,119.25961875806328,-2.191388326103919,-0.19809802974366741,1.1333152543160736,1.331413284059741,735979543,732896382.6,29.146443028589886,37.93602263401978,NaN,NaN,16.311208703135154,18.14423113490417
2020-12-29T09:30:00-05:00,160.24,160.53,158.98,159.73,2431202,3022405,60.5306251654918,58.466289717142196,NaN,NaN,117.15490625733085,22.812505364451926,-0.13067321202462834,1.1680717690289555,1.2987449810535838,738410745,733864161,33.09474566237887,36.104122737109904,NaN,NaN,16.99252568752108,17.979701785278014
2020-12-30T09:30:00-05:00,160.3,160.925,160.13,160.69,2440695,2925983.95,63.46187487554112,58.85052635542774,NaN,NaN,145.48416127089789,67.0854445373944,-0.03213798963125458,1.2585724940145155,1.2907104836457701,740851440,736065398.2,41.130305839901865,35.292803871245674,NaN,NaN,18.442426639582486,18.04580533589294
2020-12-31T09:30:00-05:00,160.71,160.98,159.93,160.78,2929651,2964735.75,63.733800774106065,59.298345139252945,NaN,NaN,120.82534933262536,98.68103309761534,0.025283133981540917,1.3223144011226964,1.2970312671411555,743781091,738417972.2,48.279828123078055,35.62587743290259,NaN,NaN,19.709859400508254,18.283527345123698
2021-01-04T09:30:00-05:00,161.78,161.89,157.44,159.42,9060195,3267458.7,56.848761759845544,59.491844199020626,NaN,NaN,60.42565790242232,112.62993870426794,-0.038668611104791806,1.2486955032601657,1.2873641143649575,734720896,738748743,49.21372760866803,36.624421392926195,NaN,NaN,18.854833660847433,18.36514253308423
2021-01-05T09:30:00-05:00,158.5,161.06,158.45,160.61,3131211,3319555.05,60.83553489362482,59.90869757011318,NaN,NaN,74.6069096125757,103.69939687517042,-0.012518886434221166,1.271715506322181,1.2842343927564022,737852107,739123255.8,50.307816090124,37.96635339992313,NaN,NaN,19.29367542112896,18.497790088519192
2021-01-06T09:30:00-05:00,160.79,164.01,160.15,162.25,4415992,3329575.65,65.55828148782234,60.16055490102907,NaN,NaN,151.29477813098046,110.52737124990036,0.09748036393926962,1.4060848476804892,1.3086044837412196,742268099,739894726.6,52.5743235503812,39.59632188585831,NaN,NaN,21.180879435512256,18.88108856666106
2021-01-07T09:30:00-05:00,163.72,166.03,163.66,165.38,3362779,3373792,72.39913524104668,60.69330620860064,NaN,NaN,233.2832015512719,128.08717930597513,0.349134671739012,1.7450228234149847,1.3958881516759727,745630878,740850614.2,55.295119815418474,41.25470954242219,NaN,NaN,25.418412052467236,19.814991921776226
2021-01-08T09:30:00-05:00,167.34,168.96,166.29,168.79,4642159,3304379.35,77.61549672355747,61.39937130609343,NaN,NaN,282.629677204195,160.44804488028905,0.6934566878945274,2.262709011544132,1.5692523236496045,750273037,742149003.4,58.75629006683287,42.74359076685698,NaN,NaN,31.267794660640856,21.451106598756887
2021-01-11T09:30:00-05:00,166.82,167.5,165.19,165.64,3710548,3344758.6,65.3322431313924,61.50760864735714,NaN,NaN,181.03935193082083,184.57078368596876,0.657586696616115,2.3912356944197484,1.7336489978036334,746562489,744517322,64.20082686675605,44.375508884070506,NaN,NaN,31.224071734337016,22.847244475268333
2021-01-12T09:30:00-05:00,166.51,168.8,166.31,168.17,5697712,3526286.3,69.50639628490653,62.56810214202226,NaN,NaN,184.45132101008537,206.5396659654707,0.7462856422230577,2.6665060505824556,1.920220408359398,752260201,747398940.8,69.48003030555778,46.46556669883013,NaN,NaN,32.86308548365911,24.278078905038445
2021-01-13T09:30:00-05:00,168.35,168.805,167.32,168.16,2827322,3497278.2,69.47079144426158,63.81210862510013,NaN,NaN,154.08180909206808,207.09707215768822,0.7446144368380834,2.850988454407002,2.1063740175689185,749432879,748831896.8,71.71386018646628,48.98882903975613,NaN,NaN,34.03482750984398,25.67190013429638
2021-01-14T09:30:00-05:00,168.35,169.17,166.89,167.09,3014951,3531710.75,65.59868010634928,64.69385645655622,NaN,NaN,121.94549591372132,184.8295310301781,0.6170447283516802,2.8776799280085186,2.2606351996568383,746417928,748989306.8,71.95667747867472,51.772521180525935,NaN,NaN,33.610692207881314,26.806013287665657
2021-01-15T09:30:00-05:00,166.82,167.34,165.14,165.8,3635740,3602416.4,61.17189785052751,65.1743150831888,NaN,NaN,78.00030359109336,143.90365630755778,0.40180543630726273,2.762891995040917,2.3610865587336543,742782188,747491137,66.13743223351344,54.3776733468815,NaN,NaN,31.758060040450676,27.513448538063518
2021-01-19T09:30:00-05:00,167.21,167.48,166.09,166.74,3174329,3661695.55,63.12467097793387,65.37058505117193,NaN,NaN,80.09133836241477,123.71405359387654,0.28429734153297037,2.716458235649867,2.4321608941168966,745956517,747369942.6,65.67473163302434,56.98683681862682,NaN,NaN,30.901472651536167,27.997451982845323
2021-01-20T09:30:00-05:00,168.31,170.37,167.79,169.89,3434366,3586095.25,68.78935570863497,65.96049437568216,NaN,NaN,110.23706501152837,108.87120239416515,0.3745943022289291,2.9004037719030578,2.5258094696741287,749390883,746796079,63.41249322574747,59.15239021601029,NaN,NaN,32.10990625184505,28.584945449845282
2021-01-21T09:30:00-05:00,170.79,171.79,170.49,170.68,3343963,3555685.15,70.03269250066555,66.42983849176248,NaN,NaN,122.07442467765493,102.46972551128253,0.43894246715526686,3.074487553618212,2.6355450864629453,752734846,747456472.4,64.91044110533647,60.85097130639848,NaN,NaN,33.47749732982001,29.283881432698816
2021-01-22T09:30:00-05:00,169.78,170.4069,169.11,170.1,2225645,3480637.45,67.89421632318562,66.72701103098244,NaN,NaN,95.08586077673301,97.09779848388487,0.39522255436736087,3.1295732794221465,2.7343507250547856,750509201,748274727,66.7280980846036,62.16870487507888,NaN,NaN,33.88845769754412,29.94167804196243
2021-01-25T09:30:00-05:00,170.54,171.96,167.3373,170.73,5880274,3666002.8,69.00145720073704,67.59506070533185,NaN,NaN,90.75584957447533,99.64890768056128,0.3623781152395362,3.187323369104206,2.8249452538646698,756389475,750996184.4,71.93517635166799,63.791665499578876,NaN,NaN,34.559931970089664,30.601428603123463
2021-01-26T09:30:00-05:00,171.32,171.48,169.98,170.62,3729176,3800020.55,68.55688049578256,68.14658539120025,NaN,NaN,96.69075863407699,102.96879173489371,0.29002096782957043,3.187471463651633,2.8974504958220626,752660299,752336940.8,74.08681938704184,65.490165735073,NaN,NaN,34.97211136387767,31.225811854659778
2021-01-27T09:30:00-05:00,168.69,168.79,164.53,165.36,5620689,3935429.95,51.477159937557644,67.14079099475278,NaN,NaN,9.337956616947803,82.7889700559776,-0.13263088352337515,2.7316618914178434,2.8642927749412186,747039610,751866686.2,72.00175792409865,66.87783961890997,NaN,NaN,29.441038727498743,30.970844265065345
2021-01-28T09:30:00-05:00,164.58,167.52,163.61,165.88,3921702,4009954.95,52.730905134098116,65.73591741568501,NaN,NaN,-9.12006199926546,56.55007272059352,-0.38351617104653934,2.3848975611330445,2.768413732179584,750961312,751511979.4,70.39250076294228,67.95622397230453,NaN,NaN,25.52357283271772,30.192662631872828
2021-01-29T09:30:00-05:00,164.92,165.29,161.09,162.01,5416710,4158755.7,43.68438419961784,63.312266521117905,NaN,NaN,-81.72441658501727,21.18801724824346,-0.7928751159206415,1.7773198372787817,2.5701949531994233,745544602,750519059.6,65.94905131872423,68.46999263315391,NaN,NaN,18.714816713701214,28.552970357848313
2021-02-01T09:30:00-05:00,163.89,166.4,162.89,166.22,3251295,4174837.9,53.108964227012386,62.43917517080505,NaN,NaN,-32.68301584405347,-3.499755835462298,-0.7626491603354602,1.616883502780098,2.379532663115558,748795897,749000344,59.7376582989662,68.15119487831178,NaN,NaN,16.300366906409355,26.802598436214176
2021-02-02T09:30:00-05:00,167.51,170.87,167.49,169.75,2700719,3856864.1,59.2647173753841,61.70762667726773,NaN,NaN,72.00119476050754,-8.437668610176193,-0.5001421795464496,1.7543549386824964,2.254497118228946,751496616,748767607.4,58.82332830681948,67.3900018784019,NaN,NaN,16.686563259270855,25.3574505537937
2021-02-03T09:30:00-05:00,170.3,170.4666,168.68,168.8,2031420,3801874.55,57.092496480095484,60.82346275125587,NaN,NaN,64.4668057415518,2.5881012147446087,-0.3905702106037028,1.7662843549743172,2.15685456557802,749465196,749252724.6,60.19106348764922,66.56694497134355,NaN,NaN,16.19641190890843,24.04873074738152
2021-02-04T09:30:00-05:00,169.58,170.6,169.06,170.6,2571448,3709647.35,60.07823061990915,60.42914493079586,NaN,NaN,85.21056359843877,21.454226334285458,-0.20621012390097704,1.8990919107017987,2.1053020346027758,752036644,749467791,60.81251710849324,65.77093351633059,NaN,NaN,16.85332395443664,23.020815491246537
2021-02-05T09:30:00-05:00,171.2,172.81,170.86,172.23,2232093,3653113.05,62.61518635679853,60.532236966958074,NaN,NaN,137.58917713154443,65.31694507759781,0.004982237476949258,2.111529831448962,2.106547593972013,754268737,751212618,65.51591142396305,65.72653917279126,NaN,NaN,18.248186414767005,22.33901133746375
2021-02-08T09:30:00-05:00,173.35,173.46,172.15,173.21,2360041,3539007.15,64.09262652406646,60.60137664882468,NaN,NaN,145.08802346660138,100.87115293972877,0.18042865922297802,2.3320834180007353,2.1516547587777572,756628778,752779194.2,69.10168344533305,65.97132144509904,NaN,NaN,19.841789577399645,21.982265371740304
2021-02-09T09:30:00-05:00,172.66,173.08,172.04,172.25,1807698,3443864.65,61.5274716478289,60.08267064448139,NaN,NaN,116.38018250405364,109.74695048843799,0.2000555259646566,2.4017241662335778,2.201668640268921,754821080,753444087,70.50358632206591,66.47782809483606,NaN,NaN,20.331138048530764,21.746390039853228
2021-02-10T09:30:00-05:00,172.81,172.81,169.25,170.55,2441586,3281058.35,57.16438881199931,59.16350609529094,NaN,NaN,61.9142840840502,109.23644615693767,0.07330780333378417,2.293303394436151,2.219995591102367,752379494,754026946.6,71.71511723239809,66.96387638962617,NaN,NaN,19.384598500263262,21.408991248483233
2021-02-11T09:30:00-05:00,171,171.59,169.26,170.08,1955840,3237484.25,55.98241024401296,58.31266280392147,NaN,NaN,41.53940417059793,100.50221427136951,-0.060211707924491265,2.144730956196753,2.204942664121244,750423654,753704348.6,70.00134127814667,67.19767947487925,NaN,NaN,18.267910684065445,20.960265453566407
2021-02-12T09:30:00-05:00,169.34,170.4,168.86,170.32,1997177,3186595.55,56.47728813584681,57.418079299286454,NaN,NaN,25.38471166918229,78.06132117889709,-0.14552855571992884,2.023031969471333,2.168560525191262,752420831,753334767.4,67.99657721680228,66.91635096524598,NaN,NaN,17.497840731172193,20.465633350367234
2021-02-16T09:30:00-05:00,170.65,170.87,169.11,169.58,2258203,3117718.7,54.44477589416557,56.410071827742385,NaN,NaN,21.34465056785407,53.312646599147605,-0.25837007928221967,1.8455979260884874,2.103968005370707,750162628,752041537.4,61.373106838779236,66.00822864037008,NaN,NaN,16.283744269234333,19.868220624491105
2021-02-17T09:30:00-05:00,168.55,170.73,167.7,170.56,3220883,3120046.4,56.66879805398345,56.7809031217728,NaN,NaN,10.913307722258192,32.21927164278851,-0.2721929378067136,1.7637268331123153,2.035919770919029,753383511,751754023.6,59.97438310760631,65.14913043919205,NaN,NaN,15.851846252910901,19.294452857122504
2021-02-18T09:30:00-05:00,168.77,171.16,168.65,170.61,2580040,3077330.1,56.78472032019161,57.070461349350914,NaN,NaN,27.039442239765805,25.24430327393164,-0.2819582428969789,1.6834719672978053,1.9654302101947843,755963551,752470835,62.28234889052444,64.5698338768765,NaN,NaN,15.524545255321756,18.755894628293827
2021-02-19T09:30:00-05:00,171.38,171.38,169.39,169.62,2510630,3035663.45,53.7202593052441,57.78730957118136,NaN,NaN,28.671363319576404,22.670695103727333,-0.3543961691738464,1.5224349987274763,1.8768311679013228,753452921,753076688.4,64.1632554122817,64.44227702641635,NaN,NaN,14.427128547138187,18.13749947384302
2021-02-22T09:30:00-05:00,168,168.59,165.89,166.04,2846935,3066727.95,44.39094871372982,57.16459417737546,NaN,NaN,-81.77971170717679,1.2378104284555362,-0.6267987731778082,1.0933327014290626,1.7201314746068708,750605986,752713719.4,62.16319742641786,64.61552982123432,NaN,NaN,10.562540156092634,17.05536242845011
2021-02-23T09:30:00-05:00,163.1,165.79,159.06,164.95,5384205,3041924.5,41.999381968640314,55.931355934036624,NaN,NaN,-160.52525567888915,-35.136170820893106,-0.8499209844973032,0.6577302439852417,1.507651228482545,745221781,751725550,56.95777738185571,64.4822761837369,NaN,NaN,6.5880275239261294,15.56002887066097
2021-02-24T09:30:00-05:00,164.74,166.9,162.98,166.68,3986771,3054804.25,46.89005077795995,55.20260981245552,NaN,NaN,-83.17452989961565,-53.95373834526788,-0.8485558115818896,0.44695646400518285,1.2955122755870725,749208552,750890558.2,52.924874489913684,63.963262683898655,NaN,NaN,4.5932756168333615,13.993349834399883
2021-02-25T09:30:00-05:00,165.5,166.42,159.68,160.48,7320928,3139816.2,35.37707032568356,53.43824122001083,NaN,NaN,-151.02763059597322,-89.56715291241568,-1.2106979036257148,-0.21786010394507116,0.9928377996806437,741887624,748075372.8,42.10131980446798,62.626748590754,NaN,NaN,-1.5524645326281374,11.772519210538738
2021-02-26T09:30:00-05:00,162.54,163.28,159.01,161.15,6127726,3250117.4,37.17232412851663,51.6208939179907,NaN,NaN,-154.41091173860914,-126.18360792405278,-1.3405084443149011,-0.6827977557129827,0.6577106886019184,748015350,746987858.6,38.800232396000304,60.71848580304237,NaN,NaN,-5.709656258066595,9.275065572166547
2021-03-01T09:30:00-05:00,163.15,165.215,162.84,164.93,4350034,3196783.6,46.245435480674395,50.34609455774841,NaN,NaN,-89.3061767083173,-127.68890092428089,-1.1163649622059169,-0.7377455141554776,0.3786194480504392,752365384,747339738.2,40.4278355760712,58.67035381238081,NaN,NaN,-6.138251138848936,7.07316318487862
2021-03-02T09:30:00-05:00,165.16,165.52,162.95,163.03,3310110,3199724.35,42.892443471483205,49.01502111658086,NaN,NaN,-96.16522821200255,-114.81689543090356,-1.0420598364657245,-0.9239553475317166,0.11810448893400799,749055274,748106436.8,43.92702626069177,56.77202809371123,NaN,NaN,-7.64110674142283,4.9711246239784135
2021-03-03T09:30:00-05:00,162.71,163.36,159.2,159.2,5562842,3342830.5,37.05943861965922,47.578953245699424,NaN,NaN,-139.09010248686104,-126.00000994835264,-1.1863587131346203,-1.3648439024842673,-0.17848518934964708,743492432,746963212.8,40.14083954162706,54.51672254437044,NaN,NaN,-11.032211285200209,2.684933779810039
2021-03-04T09:30:00-05:00,159.26,160.3,152.84,155.83,9234823,3703000.65,32.82900331223385,45.92513846485806,NaN,NaN,-179.85824821907704,-131.76613347297342,-1.428049881053616,-1.9635475406666671,-0.5354976596130512,734257609,745437209.8,35.715598841998954,52.06774094178845,NaN,NaN,-15.393824479891387,0.10225402842412068
2021-03-05T09:30:00-05:00,157.01,157.28,149.65,156.82,10313504,4090103.45,35.170267533273034,44.40320842181707,NaN,NaN,-173.0906895986967,-135.50208904499092,-1.4366149711391631,-2.331266373537005,-0.894651402397842,744571113,744748362.4,33.898878431074834,49.63219102852221,NaN,NaN,-17.959659028893217,-2.478019265478356
2021-03-08T09:30:00-05:00,157.45,160.22,156.74,157.01,6268083,4291902.95,35.63395838461885,43.05957859970659,NaN,NaN,-109.35953550692345,-139.51276080471217,-1.3463919508035125,-2.5776413409022325,-1.23124939009872,750839196,744443124.8,33.09553859671931,47.61236472551793,NaN,NaN,-19.79503719244024,-4.951878969330053
2021-03-09T09:30:00-05:00,160.13,163.995,159.31,162.94,9307193,4639260.55,48.108770991315396,42.448148095230295,NaN,NaN,-45.04410355938829,-129.2885358741893,-0.8295980065956923,-2.2682468983433353,-1.438648891747643,760146389,746661347.8,43.56276379328418,46.44010620306634,NaN,NaN,-17.05484916276953,-6.680874711249978
2021-03-10T09:30:00-05:00,165.08,165.99,162.61,163.77,7121825,4904966.9,49.5816726289177,41.93364468871073,NaN,NaN,-9.076279456290687,-103.28577126807525,-0.3961081276763967,-1.9337840513431388,-1.537675923666742,767268214,751416504.2,58.53793261746068,46.172647897847504,NaN,NaN,-14.430911138780496,-7.788022772325767
2021-03-11T09:30:00-05:00,166,166.92,165.02,166.28,4229235,4994349.35,53.847968070632696,41.94276674338135,NaN,NaN,28.309337221309953,-61.65225417999784,0.070560606988058,-1.4494751649316697,-1.5200357719197277,771497449,758864472.2,71.35752490703078,46.68652429032959,NaN,NaN,-10.806915147483654,-8.219293111634036
2021-03-12T09:30:00-05:00,164.52,166.775,164.06,166.77,4171691,5105141.9,54.65464993652332,42.675888259295164,NaN,NaN,30.457314021267116,-20.942653456005083,0.4044891566397535,-1.0144243261200359,-1.4189134827597893,775669140,765084077.6,77.58903755959734,47.78837001412811,NaN,NaN,-7.696811442583522,-8.144652873198249
2021-03-15T09:30:00-04:00,167,169.06,166.42,169.01,4402490,5225407.55,58.24743510437424,43.836463483276155,NaN,NaN,76.23035493206433,16.175324631792485,0.7484726426398525,-0.48332267945997387,-1.2317953220998263,780071630,770930564.4,81.63399884452033,49.5509572614613,NaN,NaN,-3.9169298554151735,-7.540692442086381
2021-03-16T09:30:00-04:00,169.01,169.33,166.49,167.26,3436809,5284337.85,54.607249670850926,44.387691975625515,NaN,NaN,71.37323426648562,39.45879219696726,0.8243877860192459,-0.20131058957576897,-1.0256983755950149,776634821,774228250.8,83.44862438503318,51.731225111112686,NaN,NaN,-1.8856764169242595,-6.7328330099203635
2021-03-17T09:30:00-04:00,166.01,170.2,165.83,169.61,4355996,5341093.5,58.36969971069323,46.03002264598336,NaN,NaN,90.4008107932312,59.35421024687164,0.9880767634625854,0.20939757873321696,-0.7786791847293685,780990817,776972771.4,84.79509804203512,54.78078069951034,NaN,NaN,1.0338520560985025,-5.623306571917668
2021-03-18T09:30:00-04:00,168.02,168.76,165.18,165.46,5075696,5465876.3,50.421560819656335,46.97639669535048,NaN,NaN,55.57860884900585,64.80806457241081,0.7811329913285692,0.19773705443134304,-0.5833959368972261,775915121,777856305.8,85.21216895081619,58.09591902485433,NaN,NaN,1.01458278822809,-4.675036663325417
2021-03-19T09:30:00-04:00,165.27,166.8,163.54,166.45,6060525,5643371.05,52.097312446990216,47.39438790723018,NaN,NaN,44.75656460154228,67.66791468846584,0.6789745585312348,0.26532226126681735,-0.41365229726441743,781975646,779117607,85.81054211304784,61.33754092035266,NaN,NaN,1.530019073237997,-3.7886001295306437
2021-03-22T09:30:00-04:00,167.36,168.71,166.66,167.28,3612136,5681631.1,53.515876742803464,48.15320456946734,NaN,NaN,86.12088402844998,69.64602050774297,0.6360905136846761,0.3814608448414276,-0.25462966884324845,785587782,780220837.4,86.33152075479892,64.36643338421746,NaN,NaN,2.3787383351981384,-2.907551777426532
2021-03-23T09:30:00-04:00,167.29,168.01,165.28,165.71,3995066,5612174.15,50.471214353836345,49.111188550479994,NaN,NaN,54.94128625244866,66.35963090493559,0.4779943872523728,0.3428633152222176,-0.13513107203015523,781592716,781212416.4,86.80060821037877,67.699274003414,NaN,NaN,2.1793565038437253,-2.1808505943879237
2021-03-24T09:30:00-04:00,166.48,167.365,163.26,163.26,4676194,5646645.3,46.06673067830073,50.05674050519906,NaN,NaN,19.82445493489947,52.244359733269235,0.1987242302436639,0.11327421577442465,-0.08545001446923925,776916522,780397557.4,84.24200954474632,71.16544619646739,NaN,NaN,0.6585861327431245,-1.7752167762263453
2021-03-25T09:30:00-04:00,161.69,165.24,161.35,164.69,5659948,5563596.3,48.87132729423253,51.03538763098188,NaN,NaN,-0.529362007725622,41.022765561922945,0.10530394439724186,0.046179916027313084,-0.05912402836992878,782576470,781729827.2,85.019508583878,74.81691977881046,NaN,NaN,0.22623916510325906,-1.4892944988935448
2021-03-26T09:30:00-04:00,165.34,166.18,163.165,166.06,4269824,5470701.2,51.47478393686187,52.166875170427815,NaN,NaN,26.731033122227526,37.41765926605999,0.12919893421965828,0.10237463940464409,-0.0268242948150142,786846294,782703956.8,85.57975726003177,78.56579254047564,NaN,NaN,0.6320884222163101,-1.1862397958778512
2021-03-29T09:30:00-04:00,165.63,166.47,163.94,165.15,4679152,5487157.1,49.665743475881094,52.27808749075393,NaN,NaN,26.655335373730193,25.524549535116034,0.07957350719598222,0.07264258917996358,-0.006930918016018646,782167142,782019828.8,83.22569724812425,81.39885921582136,NaN,NaN,0.4498644631121918,-0.9525106160221308
2021-03-30T09:30:00-04:00,164.43,167.02,163.77,166.77,3660883,5504695.75,52.8430407283396,52.51104235499836,NaN,NaN,39.08648502791777,22.35358929020985,0.14774567944679778,0.17775118129247858,0.0300055018456808,785828025,782866890.6,83.81918173904884,83.20466272450622,NaN,NaN,1.2087128783060501,-0.6437644025466764
2021-03-31T09:30:00-04:00,167.48,168.98,167.03,168.07,3968927,5425000,55.28245288332275,52.613505555904794,NaN,NaN,83.59004739336507,35.10670778190299,0.26541901217459396,0.36177926706392327,0.09636025488932931,789796952,785442976.6,85.49945240075947,84.2148004026297,NaN,NaN,2.554002004181132,-0.18694063015698953
2021-04-01T09:30:00-04:00,169.59,169.7,168.85,169.42,4070000,5166758.85,57.72795342782973,52.83302723385525,NaN,NaN,117.20660325482808,58.65390083441373,0.41053602231834574,0.6095302827872615,0.19899426046891577,793866952,787701073,86.79399684575925,84.87229749449841,NaN,NaN,4.404638543870731,0.4689992518469705
2021-04-05T09:30:00-04:00,172.12,173.905,171.8,173.27,4314317,4866799.5,63.806886713499914,53.23013092022137,NaN,NaN,225.41078140052363,98.38985049007294,0.723855389234216,1.1038134970116857,0.37995810777746974,798181269,789968068,87.95646071422918,85.32390191376332,NaN,NaN,8.008271615189956,1.5460381608959686
2021-04-06T09:30:00-04:00,173.11,174.7,172.99,174.02,3150965,4710943.6,64.8668158532727,53.96295707610864,NaN,NaN,220.5293309728588,137.16464960989867,0.9266914451165115,1.538322414173109,0.6116309690565976,801332234,793801086.4,89.62015643605028,85.76472563169311,NaN,NaN,11.275457383511267,2.935955192698154
2021-04-07T09:30:00-04:00,173.92,174.54,173.2,173.5,2524693,4371818.6,63.47876267030427,54.327890144652294,NaN,NaN,183.28470994511943,166.004294593339,0.9664851505381142,1.8197374072292405,0.8532522566911263,798807541,796396989.6,90.57022186261673,86.17723447602039,NaN,NaN,13.570643942085386,4.455196442610616
2021-04-08T09:30:00-04:00,174.47,174.72,173.2,174.32,3212506,4176352.65,64.75938820705139,55.35202067232336,NaN,NaN,162.19551430372022,181.72538797541003,0.9853138719097574,2.084894596578323,1.0995807246685656,802020047,798841608.6,91.37119969461517,86.61716524343458,NaN,NaN,15.864471160013666,6.0850928308110515
2021-04-09T09:30:00-04:00,174.16,176.02,173.97,175.98,3046893,4117235.55,67.26207629313822,56.435218089905355,NaN,NaN,158.66314056413816,190.01669543727206,1.0413762227350538,2.401301003087383,1.359924780352329,805066940,801081606.2,92.03851935341731,87.06202076060383,NaN,NaN,18.582960323265198,7.870502472590215
2021-04-12T09:30:00-04:00,175.97,177.28,175.82,177.11,3142797,4065790.85,68.88212565854201,57.53280729817239,NaN,NaN,155.19520058347985,175.9735792738633,1.0816401412139958,2.711974956869824,1.6303348156558282,808209737,803087299.8,92.59103284734925,87.50912876721456,NaN,NaN,21.366228164517015,9.798463285722615
2021-04-13T09:30:00-04:00,177.41,179.33,177.17,178.98,2675731,3979452.9,71.40403632883553,59.02800886781519,NaN,NaN,154.29110790546915,162.72593466038535,1.154651001775051,3.073648567874642,1.9189975660995908,810885468,804997946.6,93.08345624469449,87.95790362680854,NaN,NaN,24.546962933319215,11.905391806807843
2021-04-14T09:30:00-04:00,179.38,180.16,176.85,177.22,3338329,3974528.9,65.98386203323976,60.4506611074537,NaN,NaN,124.11293106755137,150.89157888487176,1.0100698584111116,3.1815848891134806,2.171515030702369,807547139,806745866.2,93.50851667814095,88.6197969934796,NaN,NaN,25.740070367965444,13.881774458401786
2021-04-15T09:30:00-04:00,178.46,178.6,177.49,178.49,2515680,3882513.1,67.87864752029742,61.80832683788691,NaN,NaN,108.82314433682707,140.21710489149314,0.9277508127328113,3.331203546618383,2.4034527338855716,810062819,808354420.6,93.88118935240853,89.25277419123178,NaN,NaN,27.303472358607234,15.79915987271685
2021-04-16T09:30:00-04:00,178.92,180.105,178.44,179.87,2638033,3760629.95,69.84429052321464,63.120434451197816,NaN,NaN,111.76988880338119,130.83845453934174,0.8936771553198817,3.5205491780354237,2.626872022715542,812700852,809881203,94.220354251358,89.86995969061222,NaN,NaN,29.212550659421165,17.71535855653175
2021-04-19T09:30:00-04:00,178.88,179.05,177.29,177.85,3515424,3633374.9,63.69954220689154,64.12284864627,NaN,NaN,84.43252379027814,116.68591918070142,0.672612042039455,3.467637075264861,2.795025033225406,809185428,810076341.2,94.26411594113881,90.65841816868469,NaN,NaN,29.060338892169174,19.33607003305138
2021-04-20T09:30:00-04:00,177.22,177.63,174.3,175.61,4231039,3664320.05,57.64329846770813,64.46572419908203,NaN,NaN,50.15367041096582,95.85843168180074,0.3303600004396525,3.2079750337749715,2.877615033335319,804954389,808890125.4,89.81232369047035,91.08649973664338,NaN,NaN,27.064373182952732,20.440113340180147
2021-04-21T09:30:00-04:00,174.95,178.14,174.6,177.95,2770095,3603071.5,61.735998727099386,64.92669175935178,NaN,NaN,59.84828829725321,83.00550312774111,0.2216237005344608,3.154644659003395,2.9330209584689344,807724484,808925594.4,89.82779309508183,91.39566692909497,NaN,NaN,26.590279139791622,21.31870845441036
2021-04-22T09:30:00-04:00,178.17,178.43,175.33,175.98,2980037,3518263.65,56.763317412422055,64.85778918682267,NaN,NaN,51.43612624722546,71.5280995098208,-0.010608576206497133,2.919760238210813,2.93036881441731,804744447,807861920,85.62863774370325,91.31242699323381,NaN,NaN,24.611456640948326,21.78910105248721
2021-04-23T09:30:00-04:00,176.55,178.545,175.98,177.82,1911924,3330862.45,60.003782527413144,64.58613888781647,NaN,NaN,61.71952603944896,61.518026957034365,-0.06490226078470007,2.849240988436435,2.914143249221135,806656371,806653023.8,80.99447182888763,90.81514207285228,NaN,NaN,23.94799804677279,22.09751490881372
2021-04-26T09:30:00-04:00,178.42,179.17,177.44,178.6,2230458,3228894.15,61.326979628852996,64.33329344321507,NaN,NaN,74.05970862505099,59.44346392398893,-0.07232011664301119,2.823743103417371,2.896063220060382,808886829,806593304,80.76194486127719,90.18241267465422,NaN,NaN,23.805290405572478,22.341482836922115
2021-04-27T09:30:00-04:00,178.69,179.11,177.99,178.39,2219281,3105900.6,60.74431236951371,64.13797556458717,NaN,NaN,73.13669285427798,64.04006841265137,-0.11298290993871518,2.754834582636988,2.8678174925757034,806667548,806935935.8,81.09724752555233,89.50577165057818,NaN,NaN,23.521403036796404,22.510042865475583
2021-04-28T09:30:00-04:00,178.17,179.14,177.77,178.18,2380670,3041889.95,60.12908125575555,63.807239353780325,NaN,NaN,67.37490738567479,65.5453922303357,-0.17209386423623396,2.6527001622804107,2.8247940265166447,804286878,806248414.6,78.1537167188413,88.56166572373719,NaN,NaN,23.11744445259776,22.59681452077875
2021-04-29T09:30:00-04:00,179.31,179.42,176.65,178.23,3222526,3004569.9,60.23235690075265,63.3051165400385,NaN,NaN,56.408505808161614,66.5398681425229,-0.22268424522871078,2.546438719980756,2.769122965209467,807509404,806801406,78.81962301801569,87.61745884263709,NaN,NaN,22.8090535757051,22.62713438576823
2021-04-30T09:30:00-04:00,178.02,179.49,177.88,178.92,2825542,2942347,61.70647012990894,62.7925697165647,NaN,NaN,77.75570882184701,69.7471046990025,-0.22393121729368604,2.4892089435923594,2.7131401608860455,810334946,807537121,79.705923082892,86.69709385946157,NaN,NaN,22.924746115668068,22.669650347182493
2021-05-03T09:30:00-04:00,179.89,179.98,177.83,178.07,3685859,2910924.1,58.814207292057226,61.89329621393768,NaN,NaN,67.26207089031426,68.38757715205517,-0.2919541459857813,2.3481974784038186,2.6401516243896,806649087,807089572.6,77.57921654395403,85.58964816655153,NaN,NaN,22.26853007067101,22.612347450537996
2021-05-04T09:30:00-04:00,176.74,177.02,174.01,176.21,4603630,2983557.35,52.96405728416158,60.9633101604321,NaN,NaN,-76.92760051750027,38.374718477699524,-0.462055494202807,2.062582256636091,2.524637750838898,802045457,806165154.4,73.23275817922804,84.14137970234347,NaN,NaN,20.05170350093301,22.246541172022997
2021-05-05T09:30:00-04:00,177.45,177.71,175.36,175.66,3162545,3015449.95,51.337919112799376,59.78182955989653,NaN,NaN,-65.61694709716599,11.776347581131366,-0.6025663669010717,1.7714297922125581,2.37399615911363,798882912,805084361.2,68.40716686461019,82.32180666750072,NaN,NaN,17.723131051016814,21.60033972616497
2021-05-06T09:30:00-04:00,176.04,176.3,174.36,176.04,3925315,3051090.4,52.42475218982817,58.537576821797494,NaN,NaN,-116.96696235816472,-22.898746052133895,-0.6564408926896697,1.5534450432515428,2.2098859359412124,802808227,804144125.8,64.4296709832983,80.19390071978218,NaN,NaN,16.02732662498377,20.8041949974248
2021-05-07T09:30:00-04:00,176.73,178.1,175.81,177.62,3375197,3067505.6,56.750049449536824,58.04118448198644,NaN,NaN,-26.286372412861,-43.70716229907549,-0.5751118848350272,1.4909960798974282,2.0661079647324554,806183424,803313821.4,61.05364960073095,77.82172455261018,NaN,NaN,15.667272620575822,20.070348943589234
2021-05-10T09:30:00-04:00,177.68,177.68,174.44,174.46,3488011,3084766.3,47.45715008202847,57.3136024544379,NaN,NaN,-125.48584119933327,-82.25674471700499,-0.7144882525790557,1.1729976490086358,1.8874859015876915,802695413,802523086.6,57.93995764386113,75.54512697785239,NaN,NaN,12.482552051114602,18.98637795895
2021-05-11T09:30:00-04:00,171.53,173.1492,169.81,172.49,7110357,3306497.6,42.75656786458623,55.95792882140125,NaN,NaN,-271.64517759183,-121.200260131871,-0.9073206512722636,0.7533350874973621,1.6606557387696257,795585056,801231006.4,53.1683926019609,72.92659837120091,NaN,NaN,8.213011697418652,17.447325635874094
2021-05-12T09:30:00-04:00,170.52,171.33,166.28,166.65,7061881,3492675.2,32.48450700985826,54.22372807836098,NaN,NaN,-318.755173861552,-171.82790548474821,-1.3684560532470573,-0.04991432778919602,1.3185417254578613,788523175,799159059,46.54834840461635,70.13514913269469,NaN,NaN,0.1530310342913839,14.97671212136228
2021-05-13T09:30:00-04:00,167.81,169.45,166.02,167.83,7042133,3718997.85,35.83865375005311,52.49764745140669,NaN,NaN,-246.29991294258244,-197.69449560163176,-1.5224661118686291,-0.584540914377925,0.937925197490704,795565308,797710475.2,42.55861039063906,67.38973045853409,NaN,NaN,-4.964301468583935,12.127995894227105
2021-05-14T09:30:00-04:00,169.42,171.105,168.94,170.74,4105949,3792393.65,43.317327665557364,51.21124373974271,NaN,NaN,-144.09918494638504,-221.25705810833657,-1.3620279268838242,-0.7646097111140762,0.597418215769748,799671257,796408041.8,39.29724962546815,64.42796651311916,NaN,NaN,-6.593397480010362,9.453511126478896
2021-05-17T09:30:00-04:00,170.23,170.83,168.91,170.43,5222522,3877748.55,42.74572115554058,49.925630081601774,NaN,NaN,-122.57833756610816,-220.67555738169153,-1.215298649787381,-0.9217050964644784,0.29359355332290266,794448735,794758706.2,35.57896287540204,61.17666046667984,NaN,NaN,-8.030619394660278,6.955778194887586
2021-05-18T09:30:00-04:00,170.81,171.58,169.08,169.1,3878442,3860118.7,40.289315815080506,48.50850397869642,NaN,NaN,-105.52212891610776,-187.4509476465471,-1.1471777473751978,-1.1403786308960946,0.0067991164791031955,790570293,793755753.6,33.502995963051006,57.98732326983769,NaN,NaN,-9.998353095877608,4.533759439063987
2021-05-19T09:30:00-04:00,166.34,167.77,165.49,167.68,7060207,4074624.3,37.79224174291029,46.905638610279105,NaN,NaN,-136.95970002495727,-151.09185287922816,-1.1350270011938637,-1.4119846350132264,-0.2769576338193627,783510086,792753135.8,31.522871024546177,54.608983841732716,NaN,NaN,-12.420037716715585,2.1117884168097625
2021-05-20T09:30:00-04:00,168.51,169.77,168.2935,169.4,4534058,4152325.35,42.44538548099183,45.529846849642176,NaN,NaN,-85.05857449348458,-118.84358518940856,-0.9556198062933403,-1.4714823916860382,-0.5158625853926979,788044144,791248903,28.77504468454093,50.97106395613621,NaN,NaN,-12.971591715808495,-0.04298017356427408
2021-05-21T09:30:00-04:00,170.53,170.53,168.475,168.55,3885631,4251010.7,40.820382546225765,44.24457365351136,NaN,NaN,-75.11117550517321,-105.04598330116619,-0.8426176764153626,-1.5691346809119011,-0.7265170044965386,784158513,788146354.2,24.107360807591903,47.151645689253215,NaN,NaN,-13.917641332155629,-2.0250746247916105
2021-05-24T09:30:00-04:00,169.46,171.02,168.88,170.22,3363363,4307655.95,45.25494516189077,43.69392278763487,NaN,NaN,-54.68075860766087,-91.46646750947674,-0.6144197042399163,-1.494541634796434,-0.8801219305565177,787521876,786760982.4,22.362956863408797,43.51808845240898,NaN,NaN,-13.348738740397001,-3.642740927020952
2021-05-25T09:30:00-04:00,170.99,171.54,169.69,170.76,3566929,4375038.35,46.647134675761876,43.35886675641791,NaN,NaN,-39.28536120669171,-78.21911396759353,-0.39669529793109914,-1.3759910529703916,-0.9792957550392924,791088805,786864684.8,22.813200489520895,40.261376568474034,NaN,NaN,-12.469089146484846,-4.903647815515794
2021-05-26T09:30:00-04:00,171.57,173.12,171.4,172.39,3736873,4442848.5,50.7208891831332,43.2371622559397,NaN,NaN,-5.642822169492133,-51.955738396500486,-0.1264835905635633,-1.1374002432437464,-1.0109166526801832,794825678,789127803.2,32.071547590009985,37.95008204038201,NaN,NaN,-10.480311305353114,-5.7003140283496965
2021-05-27T09:30:00-04:00,173.03,173.47,172.5,173.08,3891780,4476311.2,52.378513920893774,42.924909718179485,NaN,NaN,14.033206113623306,-32.137382275078906,0.10276087375496235,-0.8824655604864802,-0.9852264342414425,798717458,791262466,39.44918198099983,36.406905781829785,NaN,NaN,-8.342877853556985,-6.077823146236452
2021-05-28T09:30:00-04:00,173.8,173.8,172.43,172.84,3227221,4496395.15,51.726757310504716,43.22988166307065,NaN,NaN,22.416561037438523,-12.631834966556578,0.2347258500015661,-0.6918191217394849,-0.926544971741051,795490237,793528810.8,46.137724487047,35.563889127771624,NaN,NaN,-6.762474642825481,-6.1756305028920275
2021-06-01T09:30:00-04:00,173.87,173.9889,172.2,172.51,4680590,4546131.7,50.7909086223655,43.80376314576917,NaN,NaN,29.370645758932344,4.178445906762059,0.2925215281890011,-0.5608930615047996,-0.8534145896938007,790809647,794186365,47.934731791070206,35.19005621270801,NaN,NaN,-5.687160597537984,-6.10584908784145
2021-06-02T09:30:00-04:00,172.67,172.685,171.07,171.71,3531628,4492531.6,48.50007513029824,44.947732297229166,NaN,NaN,6.943712005205181,13.424260549141437,0.2701385645695512,-0.5157413839818616,-0.7858799485514129,787278019,793424207.8,46.01829985743645,35.15219560219516,NaN,NaN,-5.365245446004096,-6.000048567578971
2021-06-03T09:30:00-04:00,170.61,171.07,169.38,169.67,4351398,4551974.25,43.154893637279265,45.47032086060246,NaN,NaN,-37.533001800309506,7.046224622977969,0.11892492995703052,-0.6372237861051246,-0.7561487160621552,782926621,791044396.4,40.56480224221825,35.009780734450814,NaN,NaN,-6.579264009405588,-6.082793630697059
2021-06-04T09:30:00-04:00,170.61,171.18,170.13,171.03,3216726,4516544.8,47.32296184353252,45.75643758760069,NaN,NaN,-8.461771447647767,2.547229110723755,0.11159859823463747,-0.6166504682688583,-0.7282490665034957,786143347,788529574.2,35.744216928468134,34.755992684665095,NaN,NaN,-6.4421120372114675,-6.134124831627688
2021-06-07T09:30:00-04:00,170.9,171.13,169.73,171.03,3194996,4507534.75,47.322961843532525,46.083383351028694,NaN,NaN,-2.9322730821937535,-2.5225377132027007,0.10779572024708961,-0.5935044161946337,-0.7013001364417233,786143347,786660196.2,32.63919694047377,34.546009403598795,NaN,NaN,-6.3299118412391735,-6.162094404429329
2021-06-08T09:30:00-04:00,172.17,172.96,171.24,172.41,3062429,4486255.65,51.5073077114331,46.88466848648245,NaN,NaN,80.52520735039735,7.708374605090301,0.19422331576504903,-0.45852099173541205,-0.6527443075004611,789205776,786339422,32.1235304987932,34.44747615615181,NaN,NaN,-5.0556712433537525,-6.004033952847104
2021-06-09T09:30:00-04:00,172.89,172.995,171.39,171.46,3565787,4309027.15,48.64277508709512,47.659706582495645,NaN,NaN,67.59573469679854,19.838779143408974,0.1835371157305007,-0.42332291283733525,-0.6068600285678359,785639989,786011816,31.574864558745134,34.45118998002316,NaN,NaN,-4.751601366342252,-5.825115011917839
2021-06-10T09:30:00-04:00,171.77,172.58,171.25,172.27,2612492,4086557.7,51.13795933852599,48.28060471517666,NaN,NaN,64.51442814925474,40.24826513332182,0.22444282842104613,-0.32630649304152826,-0.5507493214625744,788252481,787076988,35.436106555750115,34.92698011368096,NaN,NaN,-3.794409631469538,-5.535014243282368
2021-06-11T09:30:00-04:00,172.56,173.23,172.28,173.21,2734178,3871159.95,53.935005378178836,49.21736348888759,NaN,NaN,96.51442794753083,61.24350501235754,0.3033257531436894,-0.1715921300329626,-0.474917883176652,790986659,788045650.4,38.8173542986486,35.97769393447073,NaN,NaN,-2.1806582585328194,-5.055820531175289
2021-06-14T09:30:00-04:00,173.22,173.59,172.25,173.26,2885055,3810115.25,54.08556347186064,49.84812193959972,NaN,NaN,91.38993163535179,80.10794595586665,0.3443878238197561,-0.04443310340195694,-0.388820927221713,793871714,789591323.8,43.86886287858467,37.51383007841186,NaN,NaN,-0.8034395053244461,-4.448337527482312
2021-06-15T09:30:00-04:00,173.28,173.28,171.74,172.34,2829844,3690481.35,50.795809111168914,50.14445582784309,NaN,NaN,57.738983236277925,75.55070113304276,0.29690391087834583,-0.01769103862378074,-0.3145949495021266,791041870,789958542.6,45.03007050423276,39.10074936517699,NaN,NaN,-0.4733269726155515,-3.88047887678706
2021-06-16T09:30:00-04:00,172.49,172.83,170.93,172.42,4707076,3731913.05,51.0744881688618,50.16971289825227,NaN,NaN,34.89261418683866,69.01007703105078,0.2595512357533638,0.009844095189578184,-0.24970714056378562,795748946,791980334,51.03598545919148,40.45535207011853,NaN,NaN,-0.12420541218093077,-3.3438683818433272
2021-06-17T09:30:00-04:00,172,173.69,171.6,173.07,4633524,3610578.9,53.38463396928777,50.2415786159947,NaN,NaN,68.62366876410596,69.83192515402104,0.2662912117774455,0.08315687415802131,-0.18313433761942421,800382470,794406331.8,57.09376111829621,41.71567915135398,NaN,NaN,0.7837416651678593,-2.7542098036988722
2021-06-18T09:30:00-04:00,171.8,172.83,171.38,172.16,6995647,3733658.35,49.83677259996517,50.10657970809903,NaN,NaN,22.98905326303164,55.126850217121195,0.20015179955229553,0.06705541182094521,-0.13309638773135032,793386823,794886364.6,58.195860230465534,42.57697456159816,NaN,NaN,0.6531055742245853,-2.2674504639955213
2021-06-21T09:30:00-04:00,172.46,173.67,171.99,173.23,4803679,3779560.75,53.73055544240713,50.31655448095914,NaN,NaN,81.58748646005226,53.16636118206128,0.21770292388119478,0.13903226712014316,-0.07867065676105162,798190502,795750122.2,60.17797674363187,43.451492058209716,NaN,NaN,1.5985116346812784,-1.71517016418455
2021-06-22T09:30:00-04:00,173.36,175.555,173.24,174.86,3370281,3779906.65,58.95708024150792,51.06348341747412,NaN,NaN,199.52299631089613,81.52316379698493,0.32203129896546734,0.32386846694578253,0.0018371679803152186,801560783,797853904.8,64.58270335438388,44.777520879420244,NaN,NaN,3.9820843856903023,-0.9012766570595712
2021-06-23T09:30:00-04:00,175.2,176.56,175.11,176.21,2658923,3734506.35,62.71371279271683,52.460541928576795,NaN,NaN,262.40381522855796,127.0254040053288,0.45667798751257804,0.5726846523710378,0.11600666485845976,804219706,799548056.8,67.68273699361919,46.71451621880602,NaN,NaN,7.2154740990445,0.25825916524101045
2021-06-24T09:30:00-04:00,177.55,177.94,176.46,176.81,3979477,3746636.55,64.27862784209265,53.67166092847389,NaN,NaN,262.51770179798604,165.8042106121048,0.554365096294885,0.808963035227066,0.254597938932181,808199183,801111399.4,70.268859202603,49.180562095529936,NaN,NaN,10.388953221515385,1.7055011732802066
2021-06-25T09:30:00-04:00,178.65,178.75,177.55,177.93,4974593,3800777.2,67.05797841344452,55.081304969181886,NaN,NaN,244.9100279191878,210.18840554333605,0.6556874118381851,1.0742072037299124,0.4185197918917273,813173776,805068790,75.59318899785168,52.24870438534265,NaN,NaN,13.981431462097271,3.4592055002540727
2021-06-28T09:30:00-04:00,177.95,178.13,177.03,177.97,2792062,3779019.25,67.15626503058297,56.19908763483545,NaN,NaN,173.14138018621443,228.4991842885685,0.6835592001790686,1.272968792115563,0.5894095919364944,815965838,808623857.2,79.19728940788927,55.61111573599237,NaN,NaN,16.932647845150917,5.383982978096479
2021-06-29T09:30:00-04:00,178.08,178.78,177.89,178.41,2314644,3660721.95,68.27748075096261,57.60156661082598,NaN,NaN,155.99060005801726,219.7927050379927,0.6879016316819331,1.4492866315389108,0.7613849998569777,818280482,811967797,81.90411888599131,59.206062473652814,NaN,NaN,19.747638755655057,7.43593380346199
2021-06-30T09:30:00-04:00,178.21,179.36,178.21,178.55,2899311,3629106.1,68.64426749600685,58.85201719350319,NaN,NaN,137.48590372095023,194.80912273647115,0.6565555146111091,1.582079393120864,0.925523878509755,821179793,815359814.4,84.15620271320472,62.686069342042416,NaN,NaN,22.203798327924687,9.545628735528089
2021-07-01T09:30:00-04:00,178.99,179.6,178.84,179.56,3105437,3566808.05,71.22879979374393,60.087288223186405,NaN,NaN,132.03533960101163,168.71265029707627,0.6585086666462721,1.748659711817595,1.090151045171323,824285230,818577023.8,85.94310264391551,66.0521942238472,NaN,NaN,25.121459343811654,11.770747393854313
2021-07-02T09:30:00-04:00,180,181.17,179.83,181.14,2901718,3551057.65,74.73690042867324,61.56238372010159,NaN,NaN,142.8714786894979,148.3049404511383,0.7161059619080805,1.9852834975564235,1.269177535648343,827186948,821379658.2,87.28810502624681,69.15356866296592,NaN,NaN,28.842490197688903,14.209567794402112
2021-07-06T09:30:00-04:00,181.41,181.88,179.705,181.35,3896040,3586109.85,75.17024502867177,63.30341485706607,NaN,NaN,129.58109584118768,139.59288358213294,0.716498232974774,2.1648003268668106,1.4483020938920366,831082988,824403088.2,88.55980631209857,72.26283550638492,NaN,NaN,32.03897872947787,16.756626499412935
2021-07-07T09:30:00-04:00,181.84,182.29,179.97,181.25,3347081,3600342.45,74.51477245664299,64.97772087762188,NaN,NaN,118.11458078099226,132.01767972672795,0.6595984194348394,2.272800118185586,1.6132016987507465,827735907,826294173.2,89.28204782067392,74.99469710363367,NaN,NaN,34.516440209210344,19.293742743669707
2021-07-08T09:30:00-04:00,178.43,181.4,177.64,180.8,5641793,3704142.75,71.49361732510145,66.27121968875143,NaN,NaN,82.79405890256558,121.07931076305101,0.5459322788867409,2.2956170473591726,1.7496847684724317,822094114,826477037.4,89.35205093413289,77.29886066190771,NaN,NaN,35.842155549274665,21.657801715898987
2021-07-09T09:30:00-04:00,181.58,182.61,181.37,182.49,2816441,3714340.2,75.50954890740954,68.10498942499746,NaN,NaN,118.21097698927447,118.31443824070357,0.5379701817038061,2.4221474956021893,1.8841773138983833,824910555,826602102.4,89.40302849923388,79.52794410967688,NaN,NaN,38.25293627805127,24.028535224777883
2021-07-12T09:30:00-04:00,182.7,183.79,182.555,183.74,5407275,3847995.05,77.98047692818568,69.83712667398163,NaN,NaN,130.5868765739304,115.85751781759006,0.567372802421557,2.5933933169253294,2.0260205145037724,830317830,827228278.8,89.66969703295376,81.63449555891415,NaN,NaN,41.13484657715076,26.47229398940258
2021-07-13T09:30:00-04:00,183.38,183.68,181.385,181.54,6196427,4013563.65,65.46203780671833,70.3017665000681,NaN,NaN,97.89422922359739,109.520144494072,0.39718947292563866,2.522507355660821,2.125317882735182,824121403,825835961.8,84.57345336603447,83.06240627403206,NaN,NaN,39.63602922588736,28.35282759461469
2021-07-14T09:30:00-04:00,182.54,182.75,181.11,181.21,3741973,4059170.1,63.807369019318074,70.37988480196819,NaN,NaN,81.04908272914842,102.10704488370325,0.22926458399207927,2.411898612725281,2.182634028733202,820379430,824364666.4,79.43577342898641,83.9019088765583,NaN,NaN,37.91226356617685,29.718461304837856
2021-07-15T09:30:00-04:00,180.89,181.71,178.97,180.23,3333752,3990503.9,59.03506178230913,70.0053443691265,NaN,NaN,44.371391554563225,94.42251141410279,0.02955412016646264,2.21957667894128,2.1900225587748174,817045678,823354979.2,76.0226827315823,84.31289627148537,NaN,NaN,34.930328720319494,30.463013792763803
2021-07-16T09:30:00-04:00,180.77,180.98,177.8692,178.01,4212380,3969446.7,49.9256050625228,68.78160341548923,NaN,NaN,3.8214810435452726,71.54461222495695,-0.25881103664485483,1.8665087629687491,2.125319799613604,812833298,820939527.8,68.446050134163,83.80238635265049,NaN,NaN,29.080472335522263,30.265507870300727
2021-07-19T09:30:00-04:00,175.14,176.01,173.77,175.97,8044419,4021885.3,43.31181091487305,67.07842812150996,NaN,NaN,-112.16624184247209,22.993988541676448,-0.5755495972801534,1.4058828030134123,1.9814324002935657,804788879,815833737.6,55.789036614815124,82.13036829600232,NaN,NaN,21.62628994904403,29.03133388154977
2021-07-20T09:30:00-04:00,176.49,179.69,175.62,179.22,4919011,4027651.9,53.80997607071584,66.04503493006375,NaN,NaN,-36.093332695816464,-3.8035238422063244,-0.5545608634646517,1.2882313209627512,1.842792184427403,809707890,812951035,50.150345088200545,79.86224159616013,NaN,NaN,18.94274787691955,27.59010730945974
2021-07-21T09:30:00-04:00,179.88,180.97,179.83,180.87,4092741,4063774.9,58.05683009564254,65.2887894014663,NaN,NaN,38.43946872492868,-12.325446643050268,-0.4238357741854375,1.312997466695606,1.7368332408810434,813800631,811635275.2,47.77674531090942,77.26370892456761,NaN,NaN,18.407606885714195,26.27832153463895
2021-07-22T09:30:00-04:00,180.72,181.86,179.81,181.65,4030888,4132373.15,59.93229505804883,64.48189620605952,NaN,NaN,53.209501077423944,-10.557824738478125,-0.28573824849992446,1.3796604302561377,1.6653986787560622,817831519,811792443.4,48.09277951620032,74.5601144154451,NaN,NaN,18.66421359408283,25.190591828845218
2021-07-23T09:30:00-04:00,182.27,183.57,181.84,183.27,3504462,4108622.4,63.57521629957729,63.68463305398124,NaN,NaN,115.49005546769199,11.775890146351212,-0.09600103012045302,1.545397391105496,1.641398421225949,821335981,813492980,51.51187723715465,72.00466957336708,NaN,NaN,20.166052058522045,24.472800433084764
2021-07-26T09:30:00-04:00,183.37,184.65,182.9,184.63,3447513,4032268.4,66.3418645461217,63.0540344480848,NaN,NaN,146.912655529394,63.59166962072443,0.09978282187320953,1.7661269485674609,1.6663441266942514,824783494,817491903,58.44390388069828,69.85353368540993,NaN,NaN,22.347651388613585,24.169207712446024
2021-07-27T09:30:00-04:00,184.51,184.51,180.8,182.76,3679890,4076659.8,59.63463858299569,61.99116774282428,NaN,NaN,85.35120368418953,87.88057689672561,0.08273479426840469,1.7697626195297573,1.6870278252613526,821103604,819771045.8,61.79621575114357,67.89025996615776,NaN,NaN,21.825553003525382,23.834399896885934
2021-07-28T09:30:00-04:00,182.55,183.2044,181.3,182.17,2986882,4110271.7,57.65411215672315,61.00263165936868,NaN,NaN,60.3697423571608,92.26663162317206,0.014679593902508614,1.7053773176394884,1.6906977237369798,818116722,820634264,63.0132141327588,66.00891448034533,NaN,NaN,20.75867770017897,23.395011011642083
2021-07-29T09:30:00-04:00,182.99,184.69,182.87,184.22,3653691,4147990.7,62.334792156857134,60.06157760575779,NaN,NaN,121.8414600677021,105.99302342122766,0.08666682659690683,1.7990312569831133,1.7123644303862064,821770413,821422042.8,64.13603456872087,64.20412919959439,NaN,NaN,21.42809843866422,23.114023501216675
2021-07-30T09:30:00-04:00,180.43,182.095,180.09,180.43,4663590,4225898.35,51.091014118582954,58.14090169078617,NaN,NaN,-13.094356213225987,80.27614108504407,-0.13023643435422283,1.549568887443428,1.6798053217976507,817106823,820576211.2,61.961095457411496,62.224943372769935,NaN,NaN,17.87740451776687,22.36593507500956
2021-08-02T09:30:00-04:00,181.9,182.38,180.76,180.95,3651451,4263385,52.36069899204237,57.205091775452175,NaN,NaN,7.714826985332668,52.4365753762318,-0.24148926639663193,1.3779437388018607,1.6194330051984926,820758274,819771167.2,59.8797444322113,60.461107020354,NaN,NaN,15.601736333940808,21.399620969142596
2021-08-03T09:30:00-04:00,181.69,182.34,180.09,182.29,4223109,4279738.45,55.56214727905144,56.61614736543313,NaN,NaN,15.87347362367254,38.54102936412841,-0.22780951187888077,1.3346711153498916,1.5624806272287723,824981383,820546723,61.23085407487486,59.16075563791746,NaN,NaN,14.829147343604813,20.460981879780057
2021-08-04T09:30:00-04:00,181.9,182.18,180.52,180.52,3956466,4310207.7,50.71413935023933,56.021795763142435,NaN,NaN,-6.590468941739818,25.148987104348286,-0.3344952583023937,1.1443615543507804,1.478856812653174,821024917,821128362,62.257412624148245,58.17752205881503,NaN,NaN,12.553833954321192,19.33138931900022
2021-08-05T09:30:00-04:00,181.07,182.38,180.93,182.25,2700604,4163148.25,54.85990097972616,56.374245471514094,NaN,NaN,25.265194942926907,5.833734079393246,-0.28690692001435747,1.1202231626352273,1.4071300826495847,823725521,821519383.6,62.96734062160361,57.78618566506079,NaN,NaN,12.049662181017094,18.291142585002632
2021-08-06T09:30:00-04:00,182.5,182.61,180.81,181.01,2911137,4167883.05,51.51505289149994,56.96019132698745,NaN,NaN,9.383104709057006,10.329226263849842,-0.3340017761763172,0.9896278624291881,1.3236296386055053,820814384,822260895.8,64.33727387814153,58.39677404101268,NaN,NaN,10.544319556941572,17.18445358099391
2021-08-09T09:30:00-04:00,181.05,181.2,180.32,180.76,2780326,4036535.6,50.84200333771093,56.748193274629955,NaN,NaN,-19.559292719082553,4.874402322966798,-0.37403268933165523,0.8560887769409362,1.2301214662725914,818034058,821716052.6,62.50755267319621,59.27943172565522,NaN,NaN,9.147305897303056,16.03628962618093
2021-08-10T09:30:00-04:00,180.96,182.15,180.56,181.47,2600524,3856740.45,52.73083746954962,56.367765229909025,NaN,NaN,14.61058689959785,4.621824978151863,-0.34542011982322185,0.7983463164935642,1.143766436316786,820634582,820846692.4,59.59518411024162,60.12360592560752,NaN,NaN,8.559112006961971,14.968121394863937
2021-08-11T09:30:00-04:00,181.87,182.27,181.2,182,2750365,3807160.05,54.14717874852781,55.95454263637181,NaN,NaN,36.25773379460551,13.191465525420927,-0.28598296056286854,0.7862877356132003,1.0722706961760688,823384947,821318698.4,60.66671935054886,61.02174448520385,NaN,NaN,8.482265782367456,14.041570593078726
2021-08-12T09:30:00-04:00,181.88,182.17,180.62,182.08,2615611,3771253,54.369430246640725,55.29698648973348,NaN,NaN,23.120697111995966,12.762565959234738,-0.2384074754236447,0.7742613518965129,1.0126688273201576,826000558,821773705.8,61.72060623903154,61.750939413909336,NaN,NaN,8.480547194070036,13.247138678934627
2021-08-13T09:30:00-04:00,182.2,182.3,181.19,181.56,2468219,3684044.95,52.58524248641608,54.31437062832594,NaN,NaN,21.235971504941414,15.133139318411619,-0.23850786279971514,0.7145339988205137,0.9530418616202289,823532339,822317296.8,62.996217746692125,62.07610469005176,NaN,NaN,7.999745963488551,12.497511148156617
2021-08-16T09:30:00-04:00,180.5,180.86,178.81,180.72,3328796,3448263.8,49.74536860889333,53.60799420160435,NaN,NaN,-109.53613074104075,-2.862228285980002,-0.2883633457182502,0.5925876794724161,0.8809510251906663,820203543,822751193.8,64.02668203803715,62.23542371054415,NaN,NaN,6.81469040846498,11.685679613914955
2021-08-17T09:30:00-04:00,178.44,178.44,174.95,176.43,5532624,3478944.45,38.35334030366353,52.22936764067152,NaN,NaN,-342.06694553823456,-74.19773477354649,-0.5863045535856921,0.14807033320855112,0.7343748867942432,814670919,821558461.2,59.15043293577023,61.95951076790211,NaN,NaN,1.9216850325610972,10.290823245150118
2021-08-18T09:30:00-04:00,176.38,178.88,176.17,177.06,4999073,3524261.05,40.507981920405015,50.67030976663922,NaN,NaN,-232.15584210780546,-127.88044995402868,-0.7088033045332743,-0.15162924387234966,0.5571740606609247,819669992,820815470.2,56.27523750127151,61.39802526308431,NaN,NaN,-1.37838745796394,8.623793144705253
2021-08-19T09:30:00-04:00,175.54,177.2,174.87,175.93,5667299,3606081.6,37.94612149584117,49.731388865014814,NaN,NaN,-230.22769419308094,-178.55012821504405,-0.8256201176363317,-0.4748510863844899,0.3507690312518418,814002693,818415897.2,48.1371089952103,60.41059765864136,NaN,NaN,-4.943451849025763,6.685615288457965
2021-08-20T09:30:00-04:00,176.21,177.8181,176.05,177.62,3309224,3596319.7,43.682660272626826,49.11152895648513,NaN,NaN,-144.7913781893315,-211.75559815389866,-0.7509043045826715,-0.5878613494764977,0.16304295510617386,817311917,817171812.8,44.540732712108436,59.3149539643483,NaN,NaN,-6.235809815807349,4.839697416420064
2021-08-23T09:30:00-04:00,178.57,180.32,178.39,179.91,3445183,3596203.2,50.37686053645621,48.74115133201404,NaN,NaN,-41.017220344542544,-198.051816074599,-0.5200542173468046,-0.4870248165773319,0.03302940076947272,820757100,817282524.2,44.93499747687334,58.15096420734819,NaN,NaN,-5.183291976529717,3.4078417888558095
2021-08-24T09:30:00-04:00,180.67,181.7,180.35,181.18,2895826,3557000,53.666190912733704,48.952012157906495,NaN,NaN,24.923253823290622,-124.65377620229397,-0.26735244324821184,-0.30116115329079207,-0.03380871004258024,823652926,819078925.6,51.01959599315481,57.34826301942009,NaN,NaN,-3.2454668148527417,2.4573691311831594
2021-08-25T09:30:00-04:00,181.18,182.11,180.84,181.88,3633349,3589323.35,55.42023317733045,48.992035886306795,NaN,NaN,48.91462488941145,-68.43968280285057,-0.04996821780779159,-0.09626898230231973,-0.046300764494528135,827286275,820602182.2,55.50894467772563,56.815520452000236,NaN,NaN,-1.1221882708909443,1.9460037880297159
2021-08-26T09:30:00-04:00,181.26,181.35,179.83,180.2,3697138,3591495.7,50.48093376132967,48.91817023415177,NaN,NaN,8.428843463510784,-20.708375271532226,-0.017888140169774046,-0.0686609397067457,-0.05077279953697165,823589137,822519471,60.425647336852975,56.53611855619391,NaN,NaN,-0.8385459903590831,1.5482109625456018
2021-08-27T09:30:00-04:00,180.6,182.155,180.3,181.84,3982446,3557438.5,54.72314693599721,49.195394776886516,NaN,NaN,50.292084603938996,18.308317287121877,0.10828061144846941,0.08457796477361512,-0.023702646674854295,827571583,824571404.2,64.89669784769804,56.70677178294404,NaN,NaN,0.7550307488299798,1.43489950344337
2021-08-30T09:30:00-04:00,182.36,183.83,182.25,183.21,3683341,3559033,57.96291580988224,49.56911465833885,NaN,NaN,116.43067465689843,49.79789628741007,0.26933078402601474,0.3129608333576641,0.04363004933164939,831254924,826670969,68.78300880107906,57.363044975146714,NaN,NaN,3.123382998309761,1.6761114312814258
2021-08-31T09:30:00-04:00,183.38,183.74,182.62,183.65,4777883,3586771.7,58.978158199976896,49.914184619156636,NaN,NaN,118.78702885601939,68.5706512939558,0.3838371526389017,0.5234264901302765,0.1395893374913748,836032807,829146945.2,72.63112662247408,58.21764549456994,NaN,NaN,5.346391220978195,2.2004371155238216
2021-09-01T09:30:00-04:00,184.28,184.62,183.505,183.64,4099168,3593906.8,58.943316147477645,50.2408907549307,NaN,NaN,129.14365443982993,84.6164572040395,0.4335753623434794,0.6815585404207241,0.24798317807724468,831933639,830076418,73.930303255742,59.08976671004927,NaN,NaN,7.126261037645033,2.904126247255423
2021-09-02T09:30:00-04:00,184.13,184.695,183.35,183.63,3357643,3626758.75,58.90583994634228,50.692362002068286,NaN,NaN,119.00908812897067,106.73250613713148,0.4391225797168121,0.7968864027232598,0.3577638230064477,828575996,831073789.8,75.28599068624408,59.96760763430297,NaN,NaN,8.576260460631953,3.7144311348806416
2021-09-03T09:30:00-04:00,183.15,183.57,182.36,183.52,3444849,3653444.35,58.46548998973801,51.31522781498576,NaN,NaN,85.03285009694984,113.68065923573366,0.4092983293513523,0.8693867346956381,0.4600884053442858,825131147,830585702.6,73.27772762328354,60.62839660467772,NaN,NaN,9.676941458407622,4.566218323955924
2021-09-07T09:30:00-04:00,183.6,184.5,183.52,184.06,4375270,3733191.55,60.04455963272016,52.864600624204094,NaN,NaN,104.6261644309414,111.31975719054223,0.3994159725491565,0.9593583710307314,0.5599423984815749,829506417,830236001.2,71.79992958713345,61.53193207977508,NaN,NaN,11.041894202748194,5.4913148780691055
2021-09-08T09:30:00-04:00,184.01,184.705,182.76,184.27,3692758,3787803.25,60.670766596187235,54.304799529617114,NaN,NaN,92.14759226395941,105.99186987213025,0.38058067891234326,1.035668247122004,0.6550875682096607,833199175,829669274.8,69.3587208081603,62.46646660169571,NaN,NaN,12.366380822436804,6.47346715583592
2021-09-09T09:30:00-04:00,184.41,185.56,183.96,184.03,4357399,3868154.95,59.52261144585702,55.84597738318967,NaN,NaN,102.12701153761178,100.58854129168661,0.32753586606229834,1.0645074007875337,0.7369715347252354,828841776,829050902.2,66.69413313724873,63.79196832612702,NaN,NaN,13.226729398234072,7.438218904749942
2021-09-10T09:30:00-04:00,185.01,185.18,182.82,182.9,4813633,3978056.05,54.311123168565686,56.605153304328155,NaN,NaN,68.99779547265355,90.58628276042319,0.19828564476978827,0.9848285906874708,0.7865429459176825,824028143,828141331.6,62.868254398371306,65.10107701800294,NaN,NaN,12.671572775099829,8.185840886228497
2021-09-13T09:30:00-04:00,183.72,183.87,181.55,183.35,5767325,4143011.35,55.964608710437666,57.004278173898264,NaN,NaN,44.89449255828543,82.55861125269031,0.1284268357240579,0.9470764905727549,0.818649654848697,829795468,829074195.8,65.08071529480098,66.54005686214063,NaN,NaN,12.611117176511783,8.818023213411823
2021-09-14T09:30:00-04:00,183.7,183.94,181.98,182.74,4231237,4188133.4,53.15628881405842,56.96785659542145,NaN,NaN,40.136705761879846,69.660719518878,0.03151609309471848,0.8580447712170951,0.8265286781223766,825564231,828285758.6,61.73276259704122,67.30528304813251,NaN,NaN,11.829483227791119,9.24823178689458
2021-09-15T09:30:00-04:00,182.32,184.215,180.98,183.92,5147309,4168867.65,57.58973043216706,57.12282068505264,NaN,NaN,39.356332993204525,59.10246766472703,0.03689173052664141,0.8726433412806784,0.835751610754037,830711540,827788231.6,59.64753377948875,67.6008965554013,NaN,NaN,12.310044383265152,9.68563358637609
2021-09-16T09:30:00-04:00,183.54,185.22,183.2011,184.76,6085705,4223199.25,60.45867944838019,57.835516805556246,NaN,NaN,80.68727083680936,54.81451952456655,0.08431460015320391,0.941144860945542,0.856830260792338,836797245,829379325.4,63.85265242213606,67.84568263292152,NaN,NaN,13.52450938498471,10.23404441474875
2021-09-17T09:30:00-04:00,184.54,185.595,183.69,184.11,7462549,4312961.75,57.23232596255688,58.01474387888193,NaN,NaN,84.88860142124389,57.99268071428462,0.060325386023542205,0.9322369933217658,0.8719116072982236,829334696,830440636,66.37012541550797,67.95092745919366,NaN,NaN,13.68892787116224,10.727599194236392
2021-09-20T09:30:00-04:00,180.35,181.28,177.38,179.64,8095950,4552298.05,41.02046902945149,56.80456910885117,NaN,NaN,-171.1204968034783,14.789682841931882,-0.25108695401839365,0.5580529147752316,0.8091398687936252,821238746,828729291.6,59.20937610772538,67.26709655252554,NaN,NaN,8.196116203292782,10.365958766958734
2021-09-21T09:30:00-04:00,180.72,181.37,179.34,179.91,6251847,4692631.25,42.08756653539093,55.59809827566646,NaN,NaN,-137.7884092857072,-20.79534016758553,-0.4232577871677361,0.280067634833955,0.7033254220016911,827490593,829114564,60.249169846277276,66.38267106851148,NaN,NaN,4.265290133947792,9.494434676528599
2021-09-22T09:30:00-04:00,181.03,183.2,180.62,182.36,6183735,4857026.7,50.78833910312007,55.0155999153552,NaN,NaN,-43.22614399762186,-37.311835565750805,-0.3590420645448896,0.2545228413205791,0.6135649058654687,833674328,829707121.6,61.8595201528994,65.5204722754513,NaN,NaN,3.7673242766047514,8.676276047968049
2021-09-23T09:30:00-04:00,183.14,185,183.14,184.21,4137596,4882239.05,56.14611345056468,54.81847659422823,NaN,NaN,69.6572487700924,-39.517839979094205,-0.18750239142270475,0.3791869165870878,0.5666893080097926,837811924,829910057.4,62.420997429627334,64.60154418569296,NaN,NaN,5.246317191444087,8.186281925607483
2021-09-24T09:30:00-04:00,183.03,185.06,182.81,184.9,4016516,4898207.95,57.98349100647765,54.78404809542392,NaN,NaN,74.77161569316476,-41.54123712471004,-0.031287672609534356,0.5275797172478747,0.558867389857409,841828440,832408806.2,68.558573501741,64.26446174843991,NaN,NaN,7.035399553637801,8.021870158183242
2021-09-27T09:30:00-04:00,184.16,186.39,184.09,185.89,4743961,4936283.7,60.538180993837955,54.819306764075186,NaN,NaN,142.88828304826268,21.26051884563815,0.12634923812371623,0.7168039375120543,0.5904546993883381,846572401,837475537.2,76.82420742477119,64.62333873684261,NaN,NaN,9.34018925704511,8.210201458020652
2021-09-28T09:30:00-04:00,184.79,185.07,181.33,182.31,7470897,5125661.5,48.948097336307065,53.98197324551232,NaN,NaN,-28.179124663441552,43.18237577009128,-0.015320735261473817,0.5713037803114958,0.5866245155729696,839101504,839797719.4,79.48601733074835,65.34671705988463,NaN,NaN,7.25702776167452,8.074033787114061
2021-09-29T09:30:00-04:00,182.93,184.32,182.05,182.49,6096109,5191572.8,49.47189597754658,53.264064997775854,NaN,NaN,-23.109410015817488,47.20572256645215,-0.0971745559616507,0.46515632062090617,0.5623308765825569,845197613,842102376.4,81.72887825046978,66.4206274251147,NaN,NaN,5.852180080122791,7.756626114686736
2021-09-30T09:30:00-04:00,182.52,182.655,179.45,179.45,8248401,5399034.45,41.691741302590344,52.36268057877761,NaN,NaN,-154.3550638691484,2.4032600386039915,-0.34251725547564427,0.13418430723800157,0.47670156271364583,836949212,841929834,81.01472642875618,67.71680399871362,NaN,NaN,1.799749657371856,6.905643763641754
2021-10-01T09:30:00-04:00,180.36,181.65,178.5,180.8,7759894,5619147,45.77034393102454,51.63451880881953,NaN,NaN,-141.75744110723372,-40.9025513214757,-0.3965301369372036,-0.0189611084578587,0.3775690284793449,844709106,842505967.2,81.59309867603677,68.89625995451617,NaN,NaN,-0.02695113832584205,5.915273063360669
2021-10-04T09:30:00-04:00,181.35,181.88,178.76,179.37,9247058,5909257.45,42.38804735463151,50.86535870457475,NaN,NaN,-130.72277320479554,-95.62476257208735,-0.5042990836409917,-0.2528048260718947,0.251494257569097,835462048,840283896.6,72.42838274457641,69.66023282219724,NaN,NaN,-2.673800209836259,4.688262595761108
2021-10-05T09:30:00-04:00,179.99,181.75,179.57,180.09,5484317,5964709.8,44.607567492193034,49.93806135171946,NaN,NaN,-93.49096329861517,-108.68713029912206,-0.501754487515806,-0.37569885182566054,0.12605563569014547,840946365,840652868.8,72.97127251302405,70.61192844602121,NaN,NaN,-4.049908933169081,3.43995237734251
2021-10-06T09:30:00-04:00,178.97,180.87,178.24,180.66,5136267,6036885.25,46.3690919894263,48.93166224750848,NaN,NaN,-101.28254046951481,-124.32175638986152,-0.43862994140861994,-0.42223179107062947,0.016398150337990483,846082632,840829872.6,73.24345059447347,71.2826997440453,NaN,NaN,-4.603506785013356,2.2908867827202437
2021-10-07T09:30:00-04:00,182.22,184.16,182.03,183.47,3768898,6007460.2,54.11580572124415,48.70905365884328,NaN,NaN,36.01317790421522,-86.24810803518879,-0.19689285598293427,-0.22971791964067734,-0.032825063657743084,849851530,843410336.2,76.89613403548627,72.03455750261519,NaN,NaN,-2.5080088727213323,1.6053302605143043
2021-10-08T09:30:00-04:00,183.54,183.71,182.46,182.63,3699794,5951768.25,51.71119604725501,49.47267701725781,NaN,NaN,25.943192738496013,-52.70798126604285,-0.08836286297028825,-0.1432786423706034,-0.05491577940031515,846151736,843698862.2,77.26977760874503,73.32458618125943,NaN,NaN,-1.588670833886537,1.1490443898856126
2021-10-11T09:30:00-04:00,182.56,184,181.88,181.89,3318544,5829329.2,49.61944737879288,50.01066850607224,NaN,NaN,12.139762378709475,-24.135474149341853,-0.06243065318247082,-0.13295409587840368,-0.07052344269593286,842833192,845173091,79.12722951480254,74.67301901472554,NaN,NaN,-1.487976009495694,0.7723271899739974
2021-10-12T09:30:00-04:00,183,184.07,182.5,183.33,5141105,5874822.6,53.55645065687498,50.20839075991188,NaN,NaN,41.298180112601706,2.8223545329015196,0.04963625618647991,-0.008478122462832971,-0.05811437864931288,847974297,846578677.4,80.74300065581947,76.0218390506484,NaN,NaN,-0.17156836451954793,0.637484967903491
2021-10-13T09:30:00-04:00,183.89,184.73,182.78,184.23,5415987,5888256.5,55.87721207558363,50.1891835188418,NaN,NaN,64.06791640069446,35.89244590694339,0.17524132444579432,0.16093727690793003,-0.014304047537864302,853390284,848040207.8,82.279103940177,77.44027522997337,NaN,NaN,1.6315385923979753,0.7794926285455601
2021-10-14T09:30:00-04:00,185.3,186.46,185.1,186.16,3757300,5771836.25,60.44217242551076,50.364803620201315,NaN,NaN,138.53680676531627,56.397171679163606,0.36808020649526857,0.44579621058122143,0.07771600408595286,857147584,849499418.6,83.67893362410669,78.52030095299949,NaN,NaN,4.653998818806731,1.3329935128685846
2021-10-15T09:30:00-04:00,187.32,189.085,187.04,189.01,4358788,5616648.2,66.031092265457,50.75715442531696,NaN,NaN,209.3340146482714,93.07533606111868,0.6508243291114841,0.8912464154753081,0.24042208636382395,861506372,852570345.8,86.1572079820987,79.18694384995146,NaN,NaN,9.24927360695775,2.4638906691670366
2021-10-18T09:30:00-04:00,188.61,191.45,188.57,191.32,3933554,5408528.4,69.76036232219982,52.24374478145216,NaN,NaN,238.75831193626883,138.39904597263052,0.9391525018851307,1.4143627137202373,0.4752102118351066,865439926,857091692.6,88.84329353708799,79.85532072183285,NaN,NaN,14.454031630505519,4.176767949358249
2021-10-19T09:30:00-04:00,191.77,191.77,190.5804,190.78,2904405,5241156.3,67.88417053393125,53.558907249765355,NaN,NaN,206.1389578247759,171.36720151506537,1.0318451494567837,1.7650166486560863,0.7331714991993026,862535521,860003937.4,90.16682604207,80.45803127837573,NaN,NaN,17.950324885913588,6.144418940294726
2021-10-20T09:30:00-04:00,190.78,191.49,190.31,190.64,4803471,5172143.1,67.37822122858728,55.39365581590799,NaN,NaN,163.41236165040652,191.2360905650078,1.020233419879354,2.008463274048495,0.988229854169141,857732050,860872290.6,90.52766135665591,81.13752663036857,NaN,NaN,20.562608554683155,8.204160313778786
2021-10-21T09:30:00-04:00,190.32,193.55,190.31,193.44,3565138,5143520.2,71.8905927966317,57.259387877737076,NaN,NaN,161.62828704158736,195.854386620262,1.1291530467563862,2.3996711626146237,1.2705181158582375,861297188,861702211.4,90.87240525313437,81.80033424301838,NaN,NaN,24.389398363362275,10.516337178005
2021-10-22T09:30:00-04:00,193.32,193.81,191.9,192.75,3688354,5127112.1,69.34500464838871,59.18488482729116,NaN,NaN,139.98205769166145,181.98399522894002,1.0826124310352727,2.6237836546523283,1.5411712236170556,857608834,860922703.8,87.64584993934247,82.88729618550168,NaN,NaN,26.69728190408302,12.82790071030186
2021-10-25T09:30:00-04:00,194.43,198.37,193.65,197.53,5538566,5166842.35,75.75084574106705,61.409404702210736,NaN,NaN,166.62440103820236,167.55721304932672,1.2876872113621405,3.150780237819731,1.8630930264575907,863147400,860464198.6,85.71793709333201,83.79777222695225,NaN,NaN,31.18075597826045,15.449737177153086
2021-10-26T09:30:00-04:00,198.39,201.61,196.78,197.56,7515725,5169083.75,75.78504656636905,63.5105443148495,NaN,NaN,163.11127895146618,158.95167727466477,1.3336504857159301,3.530156133602503,2.196505647886573,870663125,862089719.4,86.82445295825772,84.76784382436541,NaN,NaN,34.605460601436924,18.18626909490792
2021-10-27T09:30:00-04:00,198.47,199.87,197.94,198,4915522,5110054.4,76.31272720157251,65.09603870630153,NaN,NaN,137.83402777435424,153.83601049945432,1.30060186277412,3.822257976354223,2.5216561135801028,875578647,865659038.8,88.86455482120522,85.62273102334532,NaN,NaN,37.50090001663318,20.945502083725813
2021-10-28T09:30:00-04:00,199.66,201.22,199.1,200.63,4500777,4922673.2,79.2266721888179,67.0614298592703,NaN,NaN,138.35389045021722,149.18113118118026,1.3565589257778279,4.2173547708023875,2.8607958450245596,880079424,869415486,90.52699987215586,86.56967547073181,NaN,NaN,41.00962044583819,23.811804706884722
2021-10-29T09:30:00-04:00,198.34,201.26,197.79,201.15,4254187,4747387.85,79.75691556476079,69.21410615826801,NaN,NaN,120.58126757107023,145.30097315706206,1.32762252384742,4.520323999833835,3.1927014759864147,884333611,874760441.4,92.29063851245134,87.50991897056387,NaN,NaN,43.98726360117752,26.69401312035512
2021-11-01T09:30:00-04:00,202.63,204.88,201.42,204.84,5617181,4565894,83.06108603403521,71.32158011377946,NaN,NaN,143.98590291191053,140.77327353180368,1.4462695107800725,5.000538364461505,3.5542688536814326,889950792,880121119.8,93.58134241118448,88.42694338166139,NaN,NaN,47.835899862437905,29.714282654938373
2021-11-02T09:30:00-04:00,203.08,204.7,202.43,203.46,6779623,4630659.3,77.93754870573561,72.89731844450459,NaN,NaN,126.66882326120299,133.48478239375103,1.3243473392559983,5.209703027751431,3.8853556884954323,883171169,882622728.6,94.07948325428066,89.26982761838306,NaN,NaN,49.293607501649475,32.511329061611384
2021-11-03T09:30:00-04:00,203.41,207.25,203.22,207.12,6408160,4694253.95,81.24229861645324,74.38304174385765,NaN,NaN,133.84042055408125,132.6860609496964,1.3766550116753855,5.606174453089665,4.229519441414279,889579329,885422865,94.58597532259103,90.04890202541766,NaN,NaN,51.730055930811105,35.25686147149706
2021-11-04T09:30:00-04:00,208.12,210.72,207.86,209.91,5800106,4795814.35,83.29631931639325,75.61627224749593,NaN,NaN,146.62505962319992,134.34029478429298,1.476765477501365,6.075476288290986,4.598710810789621,895379435,888482867.2,95.08119705403186,90.68632981627003,NaN,NaN,54.49164691713548,38.00468796373112
2021-11-05T09:30:00-04:00,211.24,212.7,211.06,211.26,4815600,4851604.65,84.19799752180757,76.64753190461079,NaN,NaN,146.8777813758879,139.59959754525647,1.506326568957654,6.481619021986688,4.975292453029034,900195035,891655152,95.53696604055753,91.16444928080357,NaN,NaN,56.99021398666987,40.71690596700809
2021-11-08T09:30:00-05:00,209.01,210.82,208.19,208.27,5857743,4978564.6,74.59373838421934,77.12678675105994,NaN,NaN,112.43897038903576,133.29021104068153,1.2097171541481604,6.487438895714234,5.277721741566074,894337292,892532452,95.65682038420505,91.55659173381322,NaN,NaN,55.76322526265225,42.86638015210011
2021-11-09T09:30:00-05:00,209.02,209.28,203.83,204.42,16551175,5549068.1,64.40630634396379,76.91450711644396,NaN,NaN,75.83923187846925,123.12429276413482,0.6665787596540849,6.1109451911336805,5.444366431479596,877786117,891455441.6,92.37704499085741,91.68869056482762,NaN,NaN,50.998548626729544,44.0281185056186
2021-11-10T09:30:00-05:00,203.09,206.53,201.07,203.66,11344110,5845474.25,62.58912293305939,76.25011641190308,NaN,NaN,50.15720521434569,106.3876496961877,0.19307030225503308,5.685704309298387,5.492634007043354,866442007,886827977.2,79.72827229763763,90.89268106800644,NaN,NaN,46.70265972555127,44.41019582275184
2021-11-11T09:30:00-05:00,205.83,205.848,203.02,203.11,6206672,5967942.85,61.242466457838844,75.67136368400668,NaN,NaN,46.809463298849664,86.42453043131765,-0.19901170062763995,5.243869381258804,5.442881081886444,860235335,879799157.2,65.13856640187345,89.2850179581872,NaN,NaN,42.893211664473036,44.193483800140584
2021-11-12T09:30:00-05:00,203.17,204.05,201.86,203.79,5167534,6008380.15,62.32185638670727,74.71215015869527,NaN,NaN,32.42541451629557,63.53405705939919,-0.4405542784187473,4.89218823386301,5.332742512281757,865402869,872840724,54.50489131339147,87.05551468819145,NaN,NaN,40.144234199407016,43.61501957146436
2021-11-15T09:30:00-05:00,203.94,204.33,202.45,203.62,5306038,6077004.35,61.858043191845965,73.71736420337218,NaN,NaN,29.63559488710646,46.97338195901333,-0.6283205018673037,4.5473418849476275,5.175662386814931,860096831,865992631.8,46.4655717001968,84.17273745547281,NaN,NaN,37.795245938157755,42.783623338134845
2021-11-16T09:30:00-05:00,203.88,207.3,203.84,206.83,5650554,6214311.8,66.87158028534253,73.04299656649862,NaN,NaN,58.265637969275815,43.45866317717464,-0.5554019593092532,4.4814099376783645,5.036811896987618,865747385,863584885.4,44.00781199218654,80.96868439625722,NaN,NaN,37.1780806668934,41.982831527957494
2021-11-17T09:30:00-05:00,207.71,209.41,207.31,208.15,8273677,6387822.1,68.69389698331673,72.29065548039138,NaN,NaN,88.90160361265751,51.207542856836994,-0.442263277418399,4.483982800214619,4.926246077633018,874021062,865100696.4,45.94625449353661,77.78434544064154,NaN,NaN,37.213098400089045,41.301441081119144
2021-11-18T09:30:00-05:00,209.23,210.86,208.13,210.51,7402103,6579670.35,71.69205321935992,71.71459388429132,NaN,NaN,111.4764390884692,64.1409380147609,-0.24246793020452717,4.623161164877359,4.865629095081887,881423165,869338262.4,51.048353618514525,74.8384679482175,NaN,NaN,38.1743223858614,40.85470983893946
2021-11-19T09:30:00-05:00,210.51,211.99,210.08,211.42,7494774,6769991.35,72.77476043991808,70.97985634185439,NaN,NaN,122.72845262944287,82.20154563739037,-0.09081444530838834,4.752111038446401,4.842925483754789,888917939,874041276.4,56.01098293388198,72.15487084269589,NaN,NaN,39.291152065498444,40.63134444273361
2021-11-22T09:30:00-05:00,212.78,215.06,210.02,210.89,9215599,6953843,71.06982833175219,70.48930488656985,NaN,NaN,125.14764874538423,101.30395640904592,-0.06897572473056268,4.756705827841586,4.825681552572148,879702340,877962378.2,59.68102115713311,69.69783783575677,NaN,NaN,39.71544866632213,40.50050218896054
2021-11-23T09:30:00-05:00,211.08,212.24,206.49,209.36,11481416,7152127.55,66.24502290045945,69.418070906856,NaN,NaN,68.22440347296671,103.29570950978409,-0.1933076595056713,4.5840469781900595,4.777354637695731,868220924,878457086,60.13294556987768,67.23690713913439,NaN,NaN,38.67961451777776,40.24037537879157
2021-11-24T09:30:00-05:00,207.15,210.43,206.05,209.79,8170624,7314882.65,66.92463467692511,68.2486648611797,NaN,NaN,48.49210189028452,95.21380916530951,-0.27721563544941485,4.430835093383962,4.708050728833377,876391548,878931183.2,60.58885507384602,64.77316842626398,NaN,NaN,38.01173917234127,39.9219987778701
2021-11-26T09:30:00-05:00,206.32,207.03,203.73,204.07,7664595,7473073.55,51.94291536762197,65.94473042159503,NaN,NaN,-39.98587949390356,64.92134544883496,-0.7232348643600108,3.804007148383363,4.527242012743374,868726953,876391940.8,56.839664984380505,62.0090754936799,NaN,NaN,32.38136273631143,38.844765057647436
2021-11-29T09:30:00-05:00,206.75,208.89,206.23,207.24,8383754,7679551.9,57.60686172284286,64.73138208863956,NaN,NaN,9.629180559767196,42.301491034899826,-0.803849916487879,3.5224296171335254,4.326279533621404,877110707,874030494.4,53.5226967220101,58.999495232094546,NaN,NaN,29.43210728670734,37.50009966179885
2021-11-30T09:30:00-05:00,206.77,208.08,203.35,204.44,13217909,8059588.3,51.79959795950817,63.83090291832129,NaN,NaN,-48.45573333680477,7.580814618462026,-1.0303700518506744,3.0383169688080613,4.068687020658736,863892798,870868586,49.368424518149205,55.927450912615384,NaN,NaN,24.950576586460162,35.70731065103618
2021-12-01T09:30:00-05:00,206.75,208.75,200.61,200.75,12970499,8369132.1,45.31618487116335,62.59712162818586,NaN,NaN,-97.93426864457652,-25.650919805046613,-1.3909154059585775,2.330042763210514,3.7209581691690916,850922299,867408861,45.23152325831918,53.46339740980693,NaN,NaN,18.806642885486994,33.29292954167201
2021-12-02T09:30:00-05:00,201.83,204.57,200.57,203.61,16643942,8880921.2,50.4887454502695,61.82899869907378,NaN,NaN,-100.13297165044355,-55.375934513192234,-1.3953889118715188,1.976722029329693,3.372110941201212,867566241,865643799.6,43.24074900027948,51.899267595407366,NaN,NaN,15.573887194612347,30.761637777806342
2021-12-03T09:30:00-05:00,204.37,204.97,197.6,199.65,14271618,9304496.8,44.247775929192265,60.53799295210842,NaN,NaN,-135.62980974339388,-74.50472056309032,-1.6085050666699754,1.3614796078637426,2.969984674533718,853294623,862557333.6,39.93112461635012,50.8582842599044,NaN,NaN,10.58122283495938,27.878721357399634
2021-12-06T09:30:00-05:00,200.45,203.75,197.66,201.93,11663235,9646878.55,48.21668946973637,59.563610543386304,NaN,NaN,-118.30544419686123,-100.091645514416,-1.5393341600814652,1.0458169744318866,2.5851511345133518,864957858,860126763.8,37.49715527035018,50.21768308634393,NaN,NaN,7.987863038468923,25.03717016898096
2021-12-07T09:30:00-05:00,205.29,207.3,204.785,206.64,6937789,9700880.85,55.296501076578,58.7368191713317,NaN,NaN,9.054778921743576,-88.58954306270633,-1.1382718684446433,1.1623112989575475,2.300583167402191,871895647,861727333.6,40.087012036710505,49.937625946667076,NaN,NaN,8.362560587267813,22.65508308587908
2021-12-08T09:30:00-05:00,206.79,207.51,205.54,207.16,5994066,9173025.4,56.01155309714474,57.830937465176554,NaN,NaN,20.246503602794387,-64.95338861323214,-0.8150124940748666,1.2818175498086077,2.0968300438834744,877889713,867120816.4,47.91841416154387,50.07849449438188,NaN,NaN,8.891073128782283,20.68879594915097
2021-12-09T09:30:00-05:00,206.32,206.64,203.5,203.57,5878756,8899757.7,50.0583776686675,56.285674925841384,NaN,NaN,-35.84141929686489,-52.095078142516414,-0.8178972914768359,1.0744584295374295,1.8923557210142654,872010957,868009759.6,49.09936320436967,49.93928089337153,NaN,NaN,7.3029257200357485,18.77652877356308
2021-12-10T09:30:00-05:00,204.55,205.06,202.1,204.99,7186480,8948748.1,52.22150512180341,54.817585260261765,NaN,NaN,-49.25552891020409,-34.820221975878454,-0.7034610623386897,1.0130293930909033,1.716490455429593,879197437,873190322.4,55.44059918370852,49.89853919693057,NaN,NaN,6.752034879804728,17.0587439315976
2021-12-13T09:30:00-05:00,203.8,204.14,199.18,199.71,7497827,9065262.75,44.50291190978593,52.91994837297846,NaN,NaN,-119.09391067905463,-34.977915272317134,-0.9474642404012115,0.5321601549280786,1.47962439532929,871699610,874538672.8,56.94406725813015,49.70304248985894,NaN,NaN,3.57774685251722,15.13288720601469
2021-12-14T09:30:00-05:00,197.5,199.12,196.35,198.55,7686000,9184260.85,42.999222566275904,51.25953406339392,NaN,NaN,-169.09014908736057,-70.60690087413796,-1.1382510073967478,0.05681063608335535,1.1950616434801031,864013610,872962265.4,54.62354811890667,49.30951410050387,NaN,NaN,0.5885092949828015,13.055118933010135
2021-12-15T09:30:00-05:00,197.85,201.17,195.2,201.07,9521136,9377789.95,47.17499189995646,49.84884529361045,NaN,NaN,-124.69838999429392,-99.59587959355562,-1.048238094183217,-0.11523597424891818,0.9330021199342988,873534746,872091272,53.33041650505854,48.79105420273333,NaN,NaN,-0.5207065418411061,11.115715293745673
2021-12-16T09:30:00-05:00,202.05,202.41,196.37,196.63,9184428,9423327.5,41.417809832850395,49.097052041126766,NaN,NaN,-122.61681331805728,-116.9509583977941,-1.2287258005759312,-0.602905130785615,0.625820669790316,864350318,870559144.2,51.04139350058529,48.37689195389082,NaN,NaN,-3.4286620901444147,9.03794709604709
2021-12-17T09:30:00-05:00,194.99,197.64,193.65,195.29,11755384,9640991.55,39.83765932632198,47.82782329851814,NaN,NaN,-157.3313935363181,-138.56613132301692,-1.3686613185791554,-1.0850059784336281,0.2836553401455272,852594934,865238643.6,43.98165049272761,47.695388651799206,NaN,NaN,-6.256226641226351,6.853065133579456
2021-12-20T09:30:00-05:00,191.88,192.28,189.9,191.85,11163482,9824426.95,36.03668856314065,46.701901198777605,NaN,NaN,-199.15647340396316,-154.5786438679986,-1.6067414974604033,-1.724771531679977,-0.1180300342195737,841431452,859185012,37.607917958983435,46.85535246900166,NaN,NaN,-9.907111254096035,4.458754221054386
2021-12-21T09:30:00-05:00,193.9,196.87,192.4,196.82,6765259,9701909.95,44.30471366073194,46.62965325517536,NaN,NaN,-116.42610196038346,-144.0458344426032,-1.3534876504264945,-1.8098895972526918,-0.45640194682619734,848196711,856021632.2,34.772130695602556,46.10825300023619,NaN,NaN,-10.264477365838435,2.3554354229268406
2021-12-22T09:30:00-05:00,197.46,200.62,197.11,200.41,5745536,9415115.95,49.39334749103735,46.55141054380164,NaN,NaN,-42.0579143932746,-127.51773932239932,-0.8905346437451442,-1.5695702515076277,-0.6790356077624835,853942247,852103132.4,31.59413036618912,45.27635166922973,NaN,NaN,-8.81122397373035,0.7601983662615279
2021-12-23T09:30:00-05:00,200.66,203.73,200.36,203.19,5294422,9271305.85,52.97625045385182,47.174873009848746,NaN,NaN,20.064311838780185,-98.98151429103184,-0.37007762705099145,-1.1416326415762228,-0.7715550145252313,859236669,851080402.6,30.80283417136681,44.624330923159505,NaN,NaN,-6.412595792003108,-0.26448651349056274
2021-12-27T09:30:00-05:00,203.57,205.79,203.48,205.17,4214980,9098825.1,55.398304772754294,47.68784553149288,NaN,NaN,67.18805079396428,-54.07762542497537,0.10892792296874443,-0.6353951108143008,-0.7443230337830452,863451649,853251745.6,34.55074773639869,44.41387324216297,NaN,NaN,-3.679386825185432,-0.7523294151612583
2021-12-28T09:30:00-05:00,205.63,206.35,204.91,205.26,4153112,8887293,55.51047726587125,47.70312954501383,NaN,NaN,85.19146853029017,2.7919629618752824,0.41597858088846196,-0.2243498076724677,-0.6403283885609297,867604761,858486407.4,42.61956653679782,44.59476999216921,NaN,NaN,-1.4989885848165696,-0.8589950108263027
2021-12-29T09:30:00-05:00,205.76,206.18,204.37,205.67,3792250,8416010.05,56.052719132734765,47.7060699761274,NaN,NaN,82.90069003867423,42.65732136168681,0.6186286939864191,0.1329574789220942,-0.48567121506432487,871397011,863126467.4,48.661402442444505,44.64784058366211,NaN,NaN,0.4250711601745503,-0.6755569863976094
2021-12-30T09:30:00-05:00,204.97,206.7332,204.75,204.93,3570064,7945988.3,54.755551790888525,48.041582413428905,NaN,NaN,79.54404196522866,66.97771263338748,0.6704190210531205,0.3523525612520757,-0.31806645980104475,867826947,865903407.4,51.92398244167688,44.84959910061263,NaN,NaN,1.6655550270269968,-0.34111241305123713
2021-12-31T09:30:00-05:00,205.09,205.81,204.3,204.44,3442753,7285928.85,53.86662070091381,48.159090669079646,NaN,NaN,63.669816782602375,75.6988136221519,0.6393648177444557,0.48113956237952493,-0.15822525536493082,864384194,866932912.4,53.11360891950554,44.68338551031241,NaN,NaN,2.4639683054873482,0.05961340388284647
2022-01-03T09:30:00-05:00,208.29,210.33,207.1,210.31,7232741,6933985,61.85569327578681,49.398575052365416,NaN,NaN,128.1387191443341,87.88894729222586,0.9624362805443567,1.0448200953155151,0.08238381477115839,871616935,868565969.6,55.015151348716984,44.545605802497185,NaN,NaN,5.663832107926779,0.8602160758891224
2022-01-04T09:30:00-05:00,210.66,211.81,207.89,209.03,6584725,6680059.5,59.43853148203129,50.5728114034908,NaN,NaN,118.51685379978073,94.55402434612397,1.0320410271161369,1.3724350986663296,0.34039407155019263,865032210,868051459.4,54.26838729270237,44.520237172054024,NaN,NaN,7.61347196772547,1.8249669175800292
2022-01-05T09:30:00-05:00,208.75,209.39,203.29,203.39,8637798,6765059.95,50.14090620615774,50.78466242536233,NaN,NaN,50.40652722281809,88.05519178295275,0.6585317060845118,1.1635587041558324,0.5050269980713206,856394412,865050939.6,50.005480021047326,44.282741708910365,NaN,NaN,6.45160370278899,2.485915029752738
2022-01-06T09:30:00-05:00,203.11,204.29,199.66,202.86,8622723,6896492.8,49.35953664152433,51.35192862598189,NaN,NaN,3.1270737789324863,72.77179814569351,0.35147438297128286,0.9443699767854241,0.5928955938141413,847771689,861039888,44.92511830230431,43.84586490903315,NaN,NaN,5.286550674011554,2.8860058360754257
2022-01-07T09:30:00-05:00,203.16,203.68,198.83,199.48,7502625,6977686.25,44.58750815094307,51.69120354202626,NaN,NaN,-21.51637583089221,55.73455962299458,-0.08051708606514574,0.4922492362327091,0.5727663222978548,840269064,856216862,39.7019405417251,43.5401713411044,NaN,NaN,2.7814897297880044,2.8710749637486512
2022-01-10T09:30:00-05:00,196.86,198.36,192.58,198.26,10635732,7150148.85,42.97258719923495,52.18662487317585,NaN,NaN,-85.60796371845477,12.985223050436806,-0.4301394821784606,0.035091969574779114,0.4652314517532397,829633332,847820141.4,32.596495690409,43.1822126076348,NaN,NaN,0.23737131317302243,2.49483158509499
2022-01-11T09:30:00-05:00,197.97,200.57,196.45,200.17,8443681,7197441.55,46.25458088494164,52.325901103476546,NaN,NaN,-38.43424204576784,-18.404996118672916,-0.5090770927723378,-0.1711149142121826,0.33796217856015526,838077013,842429102,29.007026448313383,42.77041944711414,NaN,NaN,-0.9378977069877212,2.004441686226031
2022-01-12T09:30:00-05:00,201.58,202.52,199.77,201.49,6578370,7142060.05,48.46210762834564,52.25938397042713,NaN,NaN,-5.398416730799902,-29.565984909396512,-0.45070881583512307,-0.2254238412337486,0.22528497460137448,844655383,840081296.2,27.58251003876417,42.483875138012365,NaN,NaN,-1.2776150838868066,1.5355764333527686
2022-01-13T09:30:00-05:00,202.15,203.13,196.96,197.44,8247020,7078354.25,42.67098263070326,51.5232934116308,NaN,NaN,-40.91221627379041,-38.37384291994109,-0.6510132283171021,-0.5884815607950031,0.06253166752209893,836408363,837808631,26.239210154100277,42.1579019939219,NaN,NaN,-3.361021415583751,0.8360624549332659
2022-01-14T09:30:00-05:00,195.87,197.43,193.69,196.52,10357643,7137015,41.45899849390957,50.527628677427614,NaN,NaN,-91.82159729687396,-52.434887213137436,-0.8017153043315297,-0.9396124628923133,-0.1378971585607835,826050720,834964962.2,24.623312313337536,41.448799463703246,NaN,NaN,-5.426571634104352,-0.05859955778639381
2022-01-18T09:30:00-05:00,193.74,194.67,192.09,192.8,9094291,7003960.35,36.895690984213154,49.198001085880605,NaN,NaN,-130.5229107978202,-61.41787662901047,-1.090289732297577,-1.5007593239327548,-0.41046959163517777,816956429,832429581.6,23.248609089478364,40.06515964603757,NaN,NaN,-8.675864042761223,-1.2896373413542264
2022-01-19T09:30:00-05:00,193.64,194.27,189.17,189.32,8702358,6880904.15,33.212811122503894,47.566579085149826,NaN,NaN,-165.66230837131656,-86.86348989412022,-1.4323511009158887,-2.200908467780039,-0.76855736686415,808254071,826464993.2,20.367717938171424,38.04418218144664,NaN,NaN,-12.67367713349328,-2.9159287402312337
2022-01-20T09:30:00-05:00,190.48,192.86,185.54,185.87,9046917,6994987.05,30.014188236648394,45.79933883127553,NaN,NaN,-187.29342829386007,-123.24249220673225,-1.7848264777398477,-2.9995904640389597,-1.214763986299112,799207154,817375347.4,16.925604182557606,35.54429802008097,NaN,NaN,-17.147415957287723,-4.948998342667875
2022-01-21T09:30:00-05:00,185.25,186.03,180.34,180.42,18697163,7642568.4,25.78893366616181,43.793789757364664,NaN,NaN,-213.18629247011728,-157.69730744599764,-2.248919158522454,-4.02591293445218,-1.7769937759297254,780509991,806195673,13.829845768025635,32.73831493783241,NaN,NaN,-22.57573083167571,-7.4671029839547085
2022-01-24T09:30:00-05:00,176.68,182.77,172.05,182.59,26618462,8708770.4,30.013558111952847,41.51935153137652,NaN,NaN,-198.0659807594883,-178.9461841385205,-2.267226557873982,-4.611026973272203,-2.343800415398221,807128453,802411219.6,12.96534450384496,29.734757306055837,NaN,NaN,-25.569144617558614,-10.053108931612408
2022-01-25T09:30:00-05:00,179.48,182.26,176.98,179.5,17945156,9395279.2,27.60380874719209,39.245442764602295,NaN,NaN,-158.92438542662117,-184.62647906428066,-2.335678118737746,-5.263398063820404,-2.9277199450826576,789183297,796856593.2,11.799481319619659,26.701264022264215,NaN,NaN,-28.857997869658647,-12.739521637047586
2022-01-26T09:30:00-05:00,183.29,184.93,176.34,178.63,21691975,10272222.35,26.947780045087526,37.588790895954425,NaN,NaN,-133.37449520931355,-178.16891643188006,-2.2849720280852805,-5.783934980189258,-3.4989629521039776,767491322,788704043.4,10.331116188074958,23.867380891337614,NaN,NaN,-31.680605091146518,-15.445390701918862
2022-01-27T09:30:00-05:00,180.29,180.59,173.92,174.3,16861785,10925699.1,23.902977333216313,35.77046523107528,NaN,NaN,-138.17452193884415,-168.34513516087688,-2.3778395303444224,-6.471262365034505,-4.093422834690083,750629537,778988520,8.908371731404543,21.29475613627335,NaN,NaN,-35.13447295046954,-18.2581167374261
2022-01-28T09:30:00-05:00,174.91,178.1,171.48,178.1,15842944,11539343.1,31.24507809862027,34.81743451305222,NaN,NaN,-122.23682187743788,-150.155241042341,-2.0315707271184165,-6.6328862435881035,-4.601315516469687,766472481,776181018,8.542278306864688,19.069065976640456,NaN,NaN,-35.661634565189544,-20.744333569963736
2022-01-31T09:30:00-05:00,179,185.09,178.3,184.95,11097392,11922075.05,42.09150327745336,34.754499947210675,NaN,NaN,-66.2849859553964,-123.79904208152263,-1.2289375426699811,-6.137487444807164,-4.908549902137183,777569873,770269302,7.81408006576757,17.29889343202321,NaN,NaN,-32.28891716004441,-22.39355979711812
2022-02-01T09:30:00-05:00,185.31,186.41,182.35,186.07,11182951,12119585.55,43.65658890172831,34.56892909126687,NaN,NaN,-45.10628996119976,-101.03542298843834,-0.5452135795627893,-5.590066876590669,-5.044853297027879,788752824,770183207.4,7.803646793355597,15.784366313811944,NaN,NaN,-29.13812888191266,-23.357069666374482
2022-02-02T09:30:00-05:00,187.29,187.53,183.2,184.96,9647122,12272705.4,42.43257914187343,34.13824848509028,NaN,NaN,-36.75181837786879,-81.71088762214941,-0.11293229096441326,-5.186018660733396,-5.0730863697689825,779105702,772506083.4,11.246839387060703,14.617532695833123,NaN,NaN,-27.00752627382496,-23.878563467438838
2022-02-03T09:30:00-05:00,180.65,183.51,178.92,179.3,9583255,12319978.25,36.771213784182564,33.71683642462452,NaN,NaN,-66.90272917161266,-67.45652906870312,-0.15102427378876992,-5.261866712004945,-5.110842438216175,769522447,776284665.4,16.696840063165254,13.935934832194908,NaN,NaN,-26.975231166339007,-24.320944567281717
2022-02-04T09:30:00-05:00,183.27,186.6,180.67,184.4,10010890,12389386.6,44.01893290197959,33.8996888823438,NaN,NaN,-34.47238800483809,-49.90364229418314,0.20508201173443652,-4.85448992354813,-5.059571935282566,779533337,778896836.6,20.338654672710504,13.629887857864407,NaN,NaN,-24.46513299855978,-24.341542914607157
2022-02-07T09:30:00-05:00,185.04,187.09,183.34,184.02,9382276,12483369.15,43.617745005390695,34.3798355981422,NaN,NaN,-20.99715739809011,-40.84607658272189,0.4394082339341283,-4.510311642864906,-4.949719876799034,770151061,777413074.2,19.8089126769233,13.384195256967619,NaN,NaN,-22.642840589343194,-24.09887115385516
2022-02-08T09:30:00-05:00,183.48,187.01,182.53,186.61,9159316,12409548.35,47.15306681390495,35.375568147527986,NaN,NaN,-10.9782562444141,-34.020469839364765,0.7736582652312993,-3.9826470452599096,-4.756305310491209,779310377,775524584.8,19.126097114355403,13.29550805526648,NaN,NaN,-20.011154132104593,-23.514911579319364
2022-02-09T09:30:00-05:00,188.95,190.17,188.3,189.08,8459372,12410332.9,50.350374007573784,36.82815284545122,NaN,NaN,38.66257363312191,-18.93759143716661,1.1435952219227214,-3.3268112830878067,-4.470406505010528,787769749,777257394.2,21.79004507072331,13.642968118706888,NaN,NaN,-16.818132159488925,-22.558228805057873
2022-02-10T09:30:00-05:00,185.74,189.47,184.63,185.82,12973248,12730076.8,46.36338496887055,38.29775650993042,NaN,NaN,20.57271525309249,-1.4425025522255808,1.14822564700754,-3.0351244462511033,-4.183350093258643,774796501,778312205,23.443185116318205,14.3296352150135,NaN,NaN,-15.327809258748646,-21.525311727013698
2022-02-11T09:30:00-05:00,186.01,186.7,179.67,180.48,12659731,12950712.35,40.680866270301394,39.059707092669605,NaN,NaN,-33.684497073634,-1.2849243659847631,0.788288501458104,-3.197989466436013,-3.986277967894117,762136770,774832891.6,21.805896569729484,14.961103219719538,NaN,NaN,-15.854530305978612,-20.715200095437257
2022-02-14T09:30:00-05:00,180.25,183.88,179.79,181.51,15427354,13204197.9,42.15359501083378,40.098977540072575,NaN,NaN,-35.49035991705988,-4.183564869778716,0.6234378149896136,-3.2069806991571,-3.8304185141467135,777564124,776315504.2,24.234187469358346,15.849296516129446,NaN,NaN,-15.82078046551312,-20.015997291162382
2022-02-15T09:30:00-05:00,184.38,185.74,184,185.57,10361604,13267563.55,47.66880561763679,41.57905079525467,NaN,NaN,39.11701626824442,5.835489632752989,0.7814518674864521,-2.853603679788648,-3.6350555472751003,787925728,778038574.4,27.068839788238904,17.04484820185544,NaN,NaN,-14.049946884855357,-19.163704375975662
2022-02-16T09:30:00-05:00,184.45,186.62,183.62,186.1,8698885,13267389.9,48.360952818938756,43.32604904423484,NaN,NaN,56.915593705295954,9.486093647187797,0.9064904855458273,-2.501942440342816,-3.4084329258886434,796624613,779809547.2,29.968925965742372,18.549173504308147,NaN,NaN,-12.42473449646138,-18.20099439318791
2022-02-17T09:30:00-05:00,184.91,185.79,180.86,181.12,9068339,13268461,42.65247620659344,44.14086319480436,NaN,NaN,-2.3882719534866013,4.89389620587198,0.6506046063488471,-2.595177167952585,-3.245781774301432,787556274,782361501.8,34.03925104066582,20.370385842436797,NaN,NaN,-12.756930487744386,-17.42327097812455
2022-02-18T09:30:00-05:00,181.6,182.18,178.21,180,9495389,12808372.3,41.46697740148739,44.09625420366393,NaN,NaN,-59.05015706111579,-0.17923579162437875,0.4142299154588249,-2.7279943799779005,-3.1422242954367254,778060885,785546324.8,38.81845728310661,22.584984215103873,NaN,NaN,-13.383898500533428,-16.846217767040102
2022-02-22T09:30:00-05:00,177.48,179.22,172.65,174.75,13672872,12161092.8,36.364712593209745,43.5754058959126,NaN,NaN,-154.36322170207322,-23.953808148627047,-0.062035454042149496,-3.2197686129894123,-3.157733158947263,764388013,782911102.6,36.464202116153416,24.63216673816086,NaN,NaN,-15.564377301897553,-16.663097700591166
2022-02-23T09:30:00-05:00,176.12,176.58,168.6,168.91,13567193,11942194.65,31.693130540638492,42.808302424395826,NaN,NaN,-205.6859100940844,-72.91439342109281,-0.7012040660854977,-4.034238241554135,-3.3330341754686375,750820820,775490121,30.799382695044542,26.028776974445417,NaN,NaN,-19.055050448240046,-17.004805235969577
2022-02-24T09:30:00-05:00,161.97,173.0399,161.49,172.77,20867997,11900995.75,37.415908730136536,42.85435206339254,NaN,NaN,-199.5647265407508,-124.21045747030216,-0.7883414748377868,-4.318461019015871,-3.530119544178084,771688817,770502961.8,27.686492149933073,26.81375212350026,NaN,NaN,-20.08284564524124,-17.444525294436957
2022-02-25T09:30:00-05:00,173.29,176.22,170.96,176.19,13669221,11741367.55,42.0485663112063,42.71361159262302,NaN,NaN,-108.40289785746471,-145.41338265109778,-0.5511915154278832,-4.219108938462938,-3.6679174230350546,785358038,770063314.6,27.42335738826239,27.319802317468255,NaN,NaN,-19.41518070419585,-17.726047495831086
2022-02-28T09:30:00-05:00,174.46,178.2,174.15,177.43,16160931,11757266.9,43.67649794745704,42.71780823134204,NaN,NaN,-76.18821639054791,-148.8409945169842,-0.2610825390524911,-3.9942705968506687,-3.7331880577981775,801518969,774754931.4,34.56982272735223,28.374153035356038,NaN,NaN,-18.37127348474392,-17.81822263710435
2022-03-01T09:30:00-05:00,177.17,177.71,173.53,174.74,13499037,11877349.15,40.986638671876904,42.27734907834004,NaN,NaN,-84.20898417890668,-134.8101470123509,-0.20319622763906553,-3.9871833423470093,-3.783987114707944,788019932,779481315.2,40.88496980003279,29.928358227190134,NaN,NaN,-18.325524756314106,-17.89069436842003
2022-03-02T09:30:00-05:00,175.37,179.19,174.94,178.41,10131414,11824772.3,45.883418459077774,41.95828082487604,NaN,NaN,-46.18277062431407,-102.90951911839684,0.11244638736543733,-3.643429130501147,-3.7558755178665844,798151346,788947420.4,51.07087920607228,32.01984637971506,NaN,NaN,-16.758810918394815,-17.72899673270214
2022-03-03T09:30:00-05:00,179.32,179.6298,173.53,174.37,11201968,11902514.6,41.774121460192426,41.63047628854189,NaN,NaN,-63.17990366101034,-75.63255454244873,0.08080867634158695,-3.654864672439601,-3.7356733487811877,786949378,791999532.6,53.83302839714424,34.19054947120264,NaN,NaN,-16.708567672355557,-17.583221152652627
2022-03-04T09:30:00-05:00,173.38,173.8,169.82,171.6,10829887,11964846.2,39.1829733368328,41.52348393615127,NaN,NaN,-106.31438480677396,-75.21485193231058,-0.08597486027898871,-3.843141924129924,-3.757167063850935,776119491,790151823.2,51.92207703178811,36.34170521849254,NaN,NaN,-17.475334747534127,-17.56780880906427
2022-03-07T09:30:00-05:00,172.02,172.4101,163.12,163.19,16073060,12267954.7,32.576239961148204,40.83938714688802,NaN,NaN,-153.43661834167534,-90.66453232253608,-0.6884577834216605,-4.617739293128011,-3.9292815097063505,760046431,781857315.6,44.3168627459486,37.77618202396327,NaN,NaN,-20.44327001495883,-17.978588981334923
2022-03-08T09:30:00-05:00,163,168.72,161.71,163.53,25444159,13071048.85,33.0675927679806,39.79644337191258,NaN,NaN,-151.86210793532328,-104.1951570738194,-0.9724717977959294,-5.144871256951262,-4.172399459155333,785490590,781351447.2,43.89458136342273,38.978020707904975,NaN,NaN,-22.589729449107466,-18.63732333387386
2022-03-09T09:30:00-05:00,167.88,169.75,167.12,168.79,15969053,13411535.7,40.314323198126665,39.22168411328314,NaN,NaN,-97.76976711408874,-114.51255637177432,-0.7257878200568797,-5.0796342342264325,-4.353846414169553,801459643,782013106.6,44.63765022075785,40.025786726120366,NaN,NaN,-22.090094843366177,-19.130576406658477
2022-03-10T09:30:00-05:00,168.75,170.54,167.32,169.99,12927637,13634948.95,41.8608398507427,39.1651386592938,NaN,NaN,-83.04656232292531,-118.48588810415734,-0.4168497017749022,-4.87490854138818,-4.458058839613278,814387280,787500687,50.49383330120948,41.20111403044491,NaN,NaN,-21.209045699248623,-19.427500591314214
2022-03-11T09:30:00-05:00,171.34,171.824,166.59,166.72,12078157,13590194.4,38.902720826527904,38.981977475368126,NaN,NaN,-85.97518737371655,-114.41804861754585,-0.3694018133946617,-4.919811106356605,-4.550409292961943,802309123,792738613.4,55.348902734776594,42.38186013413563,NaN,NaN,-21.377254010553614,-19.7060367940627
2022-03-14T09:30:00-04:00,166.53,167.87,162.92,163.94,15174630,13715939.35,36.538744851309104,38.99440835094665,NaN,NaN,-115.42266326251811,-106.81525760171442,-0.45622563519641623,-5.120691336957464,-4.664465701761047,787134493,798156225.8,59.74611261170698,44.04485374096088,NaN,NaN,-22.241918237596497,-20.068305571710386
2022-03-15T09:30:00-04:00,165.14,169.91,164.73,169.43,13560294,13622586.35,43.801479783223826,39.85929043970275,NaN,NaN,-69.18953881905277,-90.28074377846032,-0.09384500517684113,-4.781771958232099,-4.687926953055258,800694787,801197065.2,62.00768775181436,46.27401838787301,NaN,NaN,-20.6904829118947,-20.157188048879576
2022-03-16T09:30:00-04:00,171.39,175.21,169.75,175.21,16889592,13948985.75,50.256111203899195,40.776447759257216,NaN,NaN,6.149935966068305,-69.4968031624289,0.5498126955335163,-4.000661083638363,-4.550473779171879,817584379,804422012.4,64.29856924386118,48.88916675172502,NaN,NaN,-17.201312608526763,-19.734920128829174
2022-03-17T09:30:00-04:00,173.67,178.18,173.2,178.13,13042915,14166187.25,53.1816278491034,41.57166644053558,NaN,NaN,62.224502171445806,-40.44259026355469,1.152256161777994,-3.1101535769493864,-4.2624097387273805,830627294,807670015.2,66.49015176614114,51.67965206443064,NaN,NaN,-13.392287134501746,-18.828829701068113
2022-03-18T09:30:00-04:00,177.63,182.095,176.78,181.88,15064602,14466000.4,56.70331359360674,42.50215327240341,NaN,NaN,125.83721871964057,1.919890955116739,1.747628698419006,-2.077873865703623,-3.825502564122629,845691896,816346569.8,71.51973328782091,54.318931390178406,NaN,NaN,-9.062658350507633,-17.433662365273758
2022-03-21T09:30:00-04:00,181.79,182.89,178.42,180.08,12824015,14632431.7,54.58103695742992,43.47318172137148,NaN,NaN,128.44437146587725,50.69329790079581,1.949187667693388,-1.3890179795058941,-3.338205647199282,832867881,825493247.4,75.66613386430019,56.803300251911786,NaN,NaN,-6.197664323680395,-15.828519787903279
2022-03-22T09:30:00-04:00,181.26,185.15,181.14,184.55,8210774,14359326.8,58.71360678255661,44.38962374447711,NaN,NaN,157.06497903300402,95.94420147120717,2.2890400273111657,-0.47690561306032464,-2.7659456403714904,841078655,833570021,78.62540237778298,58.77148047846255,NaN,NaN,-2.425258108269325,-13.913768119384143
2022-03-23T09:30:00-04:00,183.03,185.35,181.87,182.26,7879016,14074917.95,55.907121553182044,45.39912375111923,NaN,NaN,130.8507909439415,120.88437246678181,2.261131789882602,0.060469096981762505,-2.2006626929008397,833199639,836693073,79.65565326502954,60.6159536833115,NaN,NaN,-0.16925857688960122,-11.950266756170636
2022-03-24T09:30:00-04:00,183.09,183.885,181.04,183.68,7567043,13409870.25,57.27102620002955,46.69112752706185,NaN,NaN,113.38808377573513,131.11708878763966,2.235791286888756,0.5940764157101057,-1.6417148711786504,840766682,838720950.6,80.3189982575428,62.644305199436836,NaN,NaN,2.085679850484744,-9.945131526648439
2022-03-25T09:30:00-04:00,183.92,184.3,181.68,183.36,8204363,13136627.35,56.84430049773089,48.424560422532046,NaN,NaN,103.17656187193838,126.58495741809922,2.0972500254937936,0.9798476606885913,-1.117402364805202,832562319,836095035.2,76.82577508795158,64.96637036672277,NaN,NaN,3.8021331496452344,-7.9812365728921995
2022-03-28T09:30:00-04:00,185.29,188.3,185.04,188.25,11532846,12905223.1,61.558014333257454,50.45959053433754,NaN,NaN,134.3007877711389,127.75624067915155,2.222729255098921,1.6610092040684492,-0.5617200510304717,844095165,838340492,77.71819069961829,67.38234246216531,NaN,NaN,6.7408194681633145,-5.878085709884269
2022-03-29T09:30:00-04:00,190.74,192.19,189.05,191.53,9686677,12714605.1,64.36926458445187,52.1778006333608,NaN,NaN,149.48415619017297,126.24007611058535,2.399301096644804,2.4374063197755333,0.03810522313072928,853781842,840881129.4,78.71685694656355,69.81657151400857,NaN,NaN,10.11023978761292,-3.5940392102418137
2022-03-30T09:30:00-04:00,190,191,187.68,188.62,8148128,12615440.8,60.16543968422742,53.48527205003829,NaN,NaN,115.74510437491249,123.21893879677955,2.198140778262506,2.7857811959588616,0.5876404176963558,845633714,843367944.4,79.67701534027147,71.9010845167987,NaN,NaN,11.739765823159296,-1.4034956340416556
2022-03-31T09:30:00-04:00,188.58,188.58,184.83,185,8389039,12474794.35,55.32496981087748,54.65828983463468,NaN,NaN,79.16194280346178,116.37371060232488,1.7204498674341213,2.7382027519890073,1.017752884554886,837244675,842663543,78.59541762736882,73.56154986626959,NaN,NaN,11.687984225285147,0.4667157744336019
2022-04-01T09:30:00-04:00,186.01,186.47,184.21,185.23,4989382,12182769.1,55.56955213441731,56.01763321199955,NaN,NaN,65.39826927672418,108.81805208328203,1.3362530378796875,2.6880691819044955,1.351816144024808,842234057,844597890.6,79.42154033318197,74.96693756066065,NaN,NaN,11.715195937612377,2.0736415120305693
2022-04-04T09:30:00-04:00,185.31,189.45,184.07,189.39,7712120,11764722.1,59.850950669351114,57.16402398958007,NaN,NaN,78.95024256879896,97.74794304281404,1.2785545476806885,2.9500093286256686,1.67145478094498,849946177,845768093,79.92629062784972,76.24683776609176,NaN,NaN,12.992002394368457,3.633407352364553
2022-04-05T09:30:00-04:00,188.43,189.4,184.41,184.95,8109886,10898008.45,53.88292786263754,57.4230823223471,NaN,NaN,62.5957354472499,80.37025889422944,0.8767775481931639,2.767426716186435,1.890649167993271,841836291,843378982.8,75.83649281203535,77.07097516381847,NaN,NaN,12.294478054429101,4.870703166945203
2022-04-06T09:30:00-04:00,182.44,182.44,178.56,180.23,13922378,10795674.7,48.36205347782819,57.07882701011315,NaN,NaN,0.6928048273704163,57.359798984721024,0.2605333199550184,2.216315817937044,1.9557824979820257,827913913,839835022.6,70.10584466956927,77.32923894263477,NaN,NaN,9.93643462578053,5.594379089635964
2022-04-07T09:30:00-04:00,179.84,182.13,177.41,181.15,11269220,10712753.85,49.449266519322805,56.56068079052144,NaN,NaN,-7.969720110493901,39.933466401929884,-0.09849245580883048,1.8326669282209878,1.9311593840298182,839183133,840222714.2,70.36962649455727,77.24708845740166,NaN,NaN,8.352572228507714,5.988406680903357
2022-04-08T09:30:00-04:00,180.04,181.64,178.89,179.48,9297502,10573721.1,47.4944678141166,56.05449728028477,NaN,NaN,-19.981008195448485,22.85761090749535,-0.44254122934175344,1.3779828473526265,1.82052407669438,829885631,837753029,66.35302103753739,76.58186611263288,NaN,NaN,6.455926317754977,6.055195200453588
2022-04-11T09:30:00-04:00,176.78,179.54,175.96,176.15,9296910,10279835.1,43.778156371871574,54.98767939380726,NaN,NaN,-76.7727053720393,-8.286978680672274,-0.8640957837656376,0.7404043469873329,1.6045001307529705,820588721,831881537.8,57.89265941091576,75.10095590071379,NaN,NaN,3.6968844990855203,5.718293671686721
2022-04-12T09:30:00-04:00,178.61,180.47,175.84,176.54,11648784,10184259.6,44.32758864536747,54.160569900391934,NaN,NaN,-89.14266516080457,-38.63465880228317,-1.0727597153051671,0.2635504866215115,1.3363102019266786,832237505,829961780.6,55.40517081662142,73.36877858297035,NaN,NaN,1.598253796277756,5.129716546628298
2022-04-13T09:30:00-04:00,176.18,181.24,176,180.93,8410075,9760283.75,50.22431440523265,53.65723334362074,NaN,NaN,-68.74783897258253,-52.522787562273756,-0.8793337290465952,0.2371430406184345,1.1164767696650297,840647580,832508514,57.984288631132515,71.77344218108391,NaN,NaN,1.4382123950569803,4.602358810689538
2022-04-14T09:30:00-04:00,180.59,181.59,178.27,178.4,8919713,9554123.65,47.12635694002127,52.963094518070044,NaN,NaN,-74.24539666150194,-65.77792287247537,-0.8836393360881536,0.011927599554837798,0.8955669356429914,831727867,831017460.8,55.94425870419198,70.28190529652964,NaN,NaN,0.38818996185177324,4.000334689427
2022-04-18T09:30:00-04:00,177.81,179.97,177.11,178.94,7692817,9185534.4,47.86552695959496,51.98505970566559,NaN,NaN,-85.93410100704443,-78.96854143479456,-0.8137193473678751,-0.12158224856685251,0.6921370988010226,839420684,832924471.4,57.98046644207596,68.87206784956234,NaN,NaN,-0.2662593389574616,3.3908212568006486
2022-04-19T09:30:00-04:00,179.04,184.39,178.89,184.13,8735045,8981085.9,54.45570800206231,51.27694852120919,NaN,NaN,-11.781825741233714,-65.97036550863344,-0.4023347468155374,0.1892186652816008,0.5915534120971382,848155729,838437873,63.2665337186908,67.76847333328571,NaN,NaN,1.1115518053862323,3.0652113351700176
2022-04-20T09:30:00-04:00,184.49,184.98,181.47,181.76,6938323,8917463.35,51.26865039193004,50.64146357175939,NaN,NaN,-5.3574461968634814,-49.21332171584522,-0.28003673956709196,0.24150748763827323,0.5215442272053652,841217406,840233853.2,64.81911662053324,66.70719485330442,NaN,NaN,1.330101950604383,2.8173385659463555
2022-04-21T09:30:00-04:00,186.73,187.88,179.43,180,11723462,9109685.65,48.97629757299648,50.187986983339314,NaN,NaN,-10.83191013731876,-37.63013594879247,-0.3057766367874798,0.13932343122101543,0.4451000680084952,829493944,838003126,61.350618718489855,65.4754235026702,NaN,NaN,0.8424900016962641,2.5352173424820568
2022-04-22T09:30:00-04:00,179.61,180.275,175.64,175.82,11153687,9289017.85,43.95011885062528,49.35802746306846,NaN,NaN,-105.48995516834518,-43.87904765016111,-0.5766963162439726,-0.27577032729647044,0.3009259889475021,818340257,835325604,57.381607665229176,63.90114259781643,NaN,NaN,-1.1197149465247067,2.0130841583382333
2022-04-25T09:30:00-04:00,174.28,177.24,173.24,177.09,12904845,9524041.95,45.77105717740774,48.3523207850725,NaN,NaN,-116.11921730853915,-49.91607091046005,-0.6379672006490105,-0.496533011863761,0.1414341887852495,831245102,833690487.6,55.039855365761184,62.123540079095825,NaN,NaN,-2.2068504600296257,1.4102363557142534
2022-04-26T09:30:00-04:00,175.78,176.05,168.06,168.13,14598291,9677314.2,36.7097485492136,47.125665119827936,NaN,NaN,-180.93960937209235,-83.74762763663179,-1.216023005438986,-1.378594568013483,-0.162571562574497,816646811,827388704,47.06746514393398,60.0686095313743,NaN,NaN,-6.30397704690287,0.3082058696260932
2022-04-27T09:30:00-04:00,169.2,171.73,167.1,168.15,12551501,9820555.4,36.7398534251969,46.29550797321141,NaN,NaN,-195.1812815437,-121.71239470599907,-1.5118327625714088,-2.052362515788758,-0.5405297532173492,829198312,824984885.2,44.42412488576525,58.2342009753883,NaN,NaN,-9.482011491534536,-1.090396610539711
2022-04-28T09:30:00-04:00,170.45,173.33,166.2,171.6,6992763,9762787.15,41.875911866418235,45.754554069432515,NaN,NaN,-155.0669882672672,-150.55941033198877,-1.392888969202528,-2.281640964720509,-0.8887519955179812,836191075,826324311.4,46.23598917841573,56.51036973852104,NaN,NaN,-10.593438582759411,-2.447974035142525
2022-04-29T09:30:00-04:00,167.86,169.36,162.56,162.88,9418264,9814248.4,34.29655530370742,44.81184603297471,NaN,NaN,-203.10421899237613,-170.08226309679497,-1.7937072086323358,-3.130886006308401,-1.3371787976760654,826772811,828010822.2,48.51213087672379,55.23602044132007,NaN,NaN,-14.257022231067463,-4.134980920274659
2022-05-02T09:30:00-04:00,162.38,165.38,160.14,165.26,16774109,10403484.75,37.61542671182865,44.37165105725735,NaN,NaN,-184.63648741708485,-183.7857171185041,-1.7868263763906114,-3.5707117681643297,-1.7838853917737183,843546920,830471185.8,51.72313972805027,54.795340463972536,NaN,NaN,-16.08143230762474,-5.841616832753242
2022-05-03T09:30:00-04:00,165.18,165.91,163.43,164.85,12034360,10619596.75,37.26619878510624,43.867266067238695,NaN,NaN,-141.35970611304606,-175.86973646669486,-1.698747112366565,-3.9073192822319243,-2.2085721698653593,831512560,833444335.6,55.34713864702909,54.79119530900165,NaN,NaN,-17.620339513733065,-7.524291501464645
2022-05-04T09:30:00-04:00,164.59,169.8635,161.88,169.69,9348331,10681519,43.88893794006931,43.41473917686989,NaN,NaN,-96.09981943006142,-156.05344404396712,-1.2254769816075877,-3.740418396874844,-2.5149414152672565,840860891,835776851.4,58.0102239997566,54.79304783533195,NaN,NaN,-16.828775377311267,-8.853503483728447
2022-05-05T09:30:00-04:00,167.42,167.525,158.28,160.18,11388436,10554821.9,35.87497254561244,42.61106886298354,NaN,NaN,-132.61426943046135,-151.56290027660594,-1.4485766461163871,-4.32566222291274,-2.877085576796353,829472455,834433127.4,55.940408711053735,54.79277283582207,NaN,NaN,-18.920399276824742,-10.291631454170775
2022-05-06T09:30:00-04:00,159.29,160.86,155.37,158.15,12772707,10629996.25,34.42977638992389,41.651372393721324,NaN,NaN,-147.57319024745945,-140.45669452762263,-1.6157944297564035,-4.8968286139918575,-3.281034184235454,816699748,832418514.8,52.8932607403207,54.42940099998241,NaN,NaN,-21.051223526634782,-11.828716035951347
2022-05-09T09:30:00-04:00,154.7,156.86,150.57,151.41,11047704,10717506.35,30.094900446169888,39.91131471115758,NaN,NaN,-168.46216715559714,-137.22183047532508,-2.036119174781275,-5.826183152712048,-3.7900639779307728,805652044,824839539.6,43.330825706124664,53.00542185622768,NaN,NaN,-24.40229197273226,-13.624941169777191
2022-05-10T09:30:00-04:00,154.6,155.51,148.84,150.96,12723549,10888838.3,29.824903520404092,38.37961850604859,NaN,NaN,-154.66771204923353,-139.8834316625626,-2.186998509140606,-6.523812114356531,-4.336813605215925,792928495,817122726.6,36.16221007353836,50.95849996001376,NaN,NaN,-27.071035741417415,-15.545811822868652
2022-05-11T09:30:00-04:00,150.62,152.15,145.14,145.55,12856753,10949236.75,26.721129108923122,36.78996361575764,NaN,NaN,-161.09591596379255,-152.88265096930883,-2.4726363366453583,-7.427609026022623,-4.954972689377264,780071742,804964896.8,28.23630365692648,48.59319174133066,NaN,NaN,-30.387460515598796,-17.66604735040153
2022-05-12T09:30:00-04:00,143.01,149.99,142.03,146.55,11800635,11118764.75,28.20833985699349,35.665550830498226,NaN,NaN,-148.9101833332887,-156.14183374987428,-2.4130577065905694,-7.9712948226154765,-5.558237116024907,791872377,797444881.2,24.63909165249858,46.2544405975642,NaN,NaN,-32.55110407999361,-19.79248402605754
2022-05-13T09:30:00-04:00,149.87,153.03,148.72,152.32,6286718,10987115,36.24817041448367,34.985344633146504,NaN,NaN,-100.91833132709479,-146.81086196580134,-1.830317196093124,-7.846133611141312,-6.015816415048188,798159095,793736750.6,23.077835283595277,43.971439163123776,NaN,NaN,-31.83750982836998,-21.51320199781646
2022-05-16T09:30:00-04:00,151.71,151.82,148.66,149.03,5865148,10895731.55,33.91588939410239,34.78578326492428,NaN,NaN,-100.56967600376505,-133.23236373543492,-1.5242335458204517,-7.921108347323752,-6.396874801503301,792293947,791065131.2,21.99638847978443,42.18064797282738,NaN,NaN,-31.981925910122875,-23.008733985288803
2022-05-17T09:30:00-04:00,152,152.86,148.95,152.79,5605093,10739233.95,38.765093627755014,34.93044327939272,NaN,NaN,-79.9318873441879,-118.28519879442578,-0.9542099000429864,-7.589637176557034,-6.635427276514047,797899040,792059240.2,23.43415794458207,40.68136461988572,NaN,NaN,-30.5569436799076,-24.087049655948633
2022-05-18T09:30:00-04:00,148.63,148.63,141.71,142.8,7380772,10761356.4,32.038336963326074,34.227759357743274,NaN,NaN,-115.97232698793484,-109.26048099925427,-1.1239533999954485,-8.040369026508358,-6.91641562651291,790518268,794148545.4,26.500438277444232,39.271682412673464,NaN,NaN,-31.56118845418242,-25.154783769982032
2022-05-19T09:30:00-04:00,141.91,145.27,141.05,142.9,7706910,10560528.8,32.16522960390259,34.07552180775722,NaN,NaN,-113.34575762738842,-102.1475958580742,-1.1019884353936886,-8.29390117075502,-7.191912735361332,798225178,795419105.6,28.37887250531911,37.833592529001706,NaN,NaN,-32.290295564311755,-26.174142597743423
2022-05-20T09:30:00-04:00,144.07,144.27,136.33,140.41,7812395,10393464.2,30.631580942861433,33.57667568140242,NaN,NaN,-120.48806986753505,-106.06154356616226,-1.1237918536934632,-8.596652552478162,-7.472860698784698,790412783,793869843.2,27.4573944775143,36.100325011106285,NaN,NaN,-33.364058602019256,-27.201273455497113
2022-05-23T09:30:00-04:00,140.97,141.83,137.83,141.46,6803474,10088395.65,32.1017671054546,33.20778770428444,NaN,NaN,-110.69360863924888,-108.08633009325902,-0.9434095963768652,-8.65212269425578,-7.708713097878915,797216257,794854305.2,29.034269181938782,34.22083433502841,NaN,NaN,-33.79482821188841,-28.143209849267297
2022-05-24T09:30:00-04:00,139.14,139.515,136,137.82,7436021,9730282.15,29.747992036366995,32.19772013973427,NaN,NaN,-120.33579471002953,-116.16711156642734,-0.9429118325700401,-8.887352888591465,-7.944441056021425,789780236,793230544.4,27.95490061183898,32.07402552160572,NaN,NaN,-34.86580443351801,-29.103580504160256
2022-05-25T09:30:00-04:00,136.93,142.92,136.86,141.71,6477511,9426582.65,35.214926593388384,32.1505740002897,NaN,NaN,-94.24020677328284,-111.82068752349694,-0.5724921826097606,-8.660056284283627,-8.087564101673866,796257747,794378440.2,29.937831338547397,30.216698566426693,NaN,NaN,-34.132477998465816,-29.821994431918192
2022-05-26T09:30:00-04:00,143.7,149.7,143.6,148.66,8023014,9478095.2,43.651859723330745,32.80929423839019,NaN,NaN,-34.99733336871561,-96.15100267176238,0.20695620564275963,-7.828868844620416,-8.035825050263176,804280761,795589556.8,32.06245076015145,28.72878356784318,NaN,NaN,-30.7582482329046,-29.95574497491625
2022-05-27T09:30:00-04:00,150.32,153.8,150.32,153.76,7624352,9388399.6,48.90981822930612,34.153216937185626,NaN,NaN,18.933144863165865,-68.2667597256222,1.0833815372455247,-6.68159812870627,-7.7649796659517945,811905113,799888022.8,39.118988272199026,28.42793803684849,NaN,NaN,-26.157131940121815,-29.413085969945616
2022-05-31T09:30:00-04:00,153.92,156.09,151.57,154.54,7072748,8903331.55,49.68313995090446,35.57166239650708,NaN,NaN,40.1552306068425,-38.09699187640392,1.696484920716565,-5.644373515056088,-7.340858435772653,818977861,804240343.6,45.31281988856215,29.08155302363591,NaN,NaN,-22.260829899319663,-28.391335102713338
2022-06-01T09:30:00-04:00,155.37,156.44,151.95,152.93,6116477,8607437.4,48.06589518926522,37.096288545102944,NaN,NaN,46.60488554493617,-4.7088558254107795,1.9560124672035109,-4.895842851768265,-6.851855318971776,812861384,808856573.2,51.00619606248997,30.707973909747587,NaN,NaN,-19.530651536071456,-27.12552316462164
2022-06-02T09:30:00-04:00,153.08,157.695,152.45,157.61,5812958,8430668.75,52.86855809231065,38.85773270476846,NaN,NaN,84.29328804184755,30.9978431376153,2.377275623475012,-3.880260789628011,-6.257536413103023,818674342,813339892.2,55.81718796508704,32.93498078921819,NaN,NaN,-15.675195966892682,-25.489762136374647
2022-06-03T09:30:00-04:00,154.39,155.4951,152.48,153,5357286,8129111.25,48.14548391293786,39.707540811800904,NaN,NaN,66.1756737425726,51.23244455987293,2.279543826978486,-3.4081066293799154,-5.687650456358401,813317056,815147151.2,57.623624517788315,35.40253716308912,NaN,NaN,-13.78488933312263,-23.81763745019579
2022-06-06T09:30:00-04:00,155.72,156.51,153.59,154.53,5117405,7746346.15,49.74998023674628,40.83854730056118,NaN,NaN,86.97771058270423,64.8413577037806,2.2482842253109796,-2.877295174719677,-5.125579400030657,818434461,816453020.8,58.930262811652035,38.040671043936804,NaN,NaN,-11.75849291395025,-22.094902516446428
2022-06-07T09:30:00-04:00,151.38,154.6,150.51,154.15,4818740,7434897.95,49.34162098181409,41.59401354013683,NaN,NaN,62.400650716007235,69.29044172561355,2.1333107551329906,-2.458940956114418,-4.592251711247409,813615721,815380592.8,57.3658967805875,40.46436667508005,NaN,NaN,-10.225285227954489,-20.399242903804723
2022-06-08T09:30:00-04:00,153.36,155.49,152.84,153.24,4405110,7018976,48.318780440275,42.756902359918904,NaN,NaN,70.11873969860513,73.99321255634734,1.9332085447124499,-2.1757410303568463,-4.108949575069296,809210611,814650438.2,56.2706467587797,42.59081013803258,NaN,NaN,-9.224426504001713,-18.80284056097572
2022-06-09T09:30:00-04:00,153.33,154.98,150.46,150.47,3864385,6569357.6,45.24423556975536,43.691117071765525,NaN,NaN,41.38559324785169,65.41167359754817,1.567131949626952,-2.1500346380356063,-3.7171665876625584,805346226,811984815,52.341701843769435,44.30244080506475,NaN,NaN,-9.199432110057588,-17.430925067987417
2022-06-10T09:30:00-04:00,147.36,148.29,144.02,144.47,6719588,6315305.25,39.396606097206416,44.31719029707589,NaN,NaN,-41.848820623372426,43.80677472435916,0.9065133008764499,-2.584024961566996,-3.490538262443446,798626638,809046731.4,48.33569170771006,45.79374775007873,NaN,NaN,-10.91922562366811,-16.500682290227516
2022-06-13T09:30:00-04:00,139.45,140.95,136.76,137.8,10085881,6505263.4,34.11757717999603,44.4611767309717,NaN,NaN,-115.86653630220026,3.2379253473782654,0.05108815836529912,-3.426678064486822,-3.477766222852121,788540757,803067990.6,41.39308915807651,46.67652060551713,NaN,NaN,-14.17045492221878,-16.16779266622627
2022-06-14T09:30:00-04:00,138.5,139.52,136.47,137.69,6677948,6545903.4,34.03657576101699,44.76750413987527,NaN,NaN,-107.70272829711186,-30.782750455245555,-0.46306768651575414,-4.056600830996814,-3.59353314448106,781862809,796717408.2,35.551848894464044,47.21915976856179,NaN,NaN,-16.77743388927474,-16.254884269518907
2022-06-15T09:30:00-04:00,138.66,143.15,138.42,141.56,9060399,6718668.7,39.480507660578326,45.072188501817415,NaN,NaN,-65.6129155913418,-57.92908151323494,-0.48131992121547906,-4.195183046000409,-3.71386312478493,790923208,793059927.6,32.69061427194198,47.415787120947115,NaN,NaN,-17.41058357566055,-16.419984170396283
2022-06-16T09:30:00-04:00,137.56,137.72,133.04,134.63,12009639,6950112.05,34.05977252511042,44.38703941623025,NaN,NaN,-116.48568596366457,-89.50333735553818,-0.875926311768938,-4.808771014496102,-3.9328447027271642,778913569,787773396.2,29.05121987731303,47.200699200744374,NaN,NaN,-19.73296886133402,-16.893267697673103
2022-06-17T09:30:00-04:00,134.65,137.28,134.17,136.1,11195039,7124518.5,36.065086250268365,43.469558560584694,NaN,NaN,-99.96098585863912,-101.12577040259153,-0.9476734876563473,-5.117436562297598,-4.169763074641251,790108608,786069790.2,27.970557117855307,46.40438268971982,NaN,NaN,-20.99473349036217,-17.479191382342968
2022-06-21T09:30:00-04:00,138.47,141.23,138.22,139.67,6428315,7055314.5,40.77559843086051,42.83330559486728,NaN,NaN,-62.15289144610658,-90.38304143137279,-0.6771206235067906,-5.0161638540247395,-4.339043230517949,796536923,787669023.4,30.581100161133932,45.35211699490351,NaN,NaN,-20.6170398800323,-17.927455453441443
2022-06-22T09:30:00-04:00,137.69,142.23,137.69,139.4,6010892,7015685.4,40.53237114719896,42.29519673471968,NaN,NaN,-60.960649927900405,-81.03462575753049,-0.44972008811339137,-4.901193340659688,-4.451473252546297,790526031,789401667.8,33.397495946777084,44.09435270092403,NaN,NaN,-20.38431797842519,-18.278435814153408
2022-06-23T09:30:00-04:00,140.39,141.97,138.47,141.59,5888654,6938317.05,43.477461599339456,41.62440412807888,NaN,NaN,-54.846223111848,-78.88128726163174,-0.10327085217040555,-4.580561817759303,-4.477290965588898,796414685,790499963.2,35.19238016709207,42.62115214392439,NaN,NaN,-19.338271260447595,-18.42984087790972
2022-06-24T09:30:00-04:00,142.6,147.04,141.93,146.99,6702349,6949558.95,50.046720115017244,41.76020671394169,NaN,NaN,-12.275430025544257,-58.03923607400767,0.5047244375084272,-3.8463854187033633,-4.3511098562117905,803117034,795340656.2,42.54206857592972,41.543898148077346,NaN,NaN,-16.395509767494353,-18.13922214785038
2022-06-27T09:30:00-04:00,147.71,148.47,144.98,145.45,7287194,6912767.95,48.321874946205575,41.65819919318879,NaN,NaN,-1.8438722256464055,-38.41581334740913,0.8007346529473569,-3.350191540027595,-4.150926192974952,795829840,796484902.6,44.1543068951897,40.48847272547289,NaN,NaN,-14.464866248951184,-17.61431416229335
2022-06-28T09:30:00-04:00,145.79,147.52,139.59,139.64,5684916,6815796.15,42.38657206463519,41.16140998481887,NaN,NaN,-38.7636220051508,-33.73795945921797,0.6113548626335743,-3.386732614682984,-3.9980874773165582,790144924,795206502.8,42.71231061100601,39.44178799907421,NaN,NaN,-14.559637585247497,-17.177931794143944
2022-06-29T09:30:00-04:00,139.57,140.49,138.03,139.53,5959633,6760140.4,42.28068513354822,40.7301174629098,NaN,NaN,-63.09827492239192,-34.165484458116275,0.4900369041889112,-3.3855413470804194,-3.8755782512693306,784185291,793938354.8,41.27238977474204,38.3704839287858,NaN,NaN,-14.666378531343364,-16.81913847088672
2022-06-30T09:30:00-04:00,137.71,139.21,134.76,137.48,6284661,6768549.6,40.26205893402061,40.374247703214465,NaN,NaN,-79.15541742569239,-39.02732332088516,0.2928153101978972,-3.5095591135219593,-3.8023744237198565,777900630,790235543.8,37.316594224121204,37.297261955953786,NaN,NaN,-15.339601235164457,-16.607776008640684
2022-07-01T09:30:00-04:00,137.7,140.19,137.17,140.01,5667697,6761286.55,43.82654073951072,40.6906716062362,NaN,NaN,-52.561207343334495,-47.08447878444319,0.3499749847569906,-3.3649056927736183,-3.714880677530609,783568327,786325802.4,33.64925680997099,36.24823089182957,NaN,NaN,-14.894161726844631,-16.362973968384104
2022-07-05T09:30:00-04:00,138,143.23,137.03,143.14,5758246,6781334.55,47.96333663052189,41.6796544241309,NaN,NaN,-23.710509987192776,-51.45780633675247,0.6010724401745682,-2.963540127312399,-3.564612567486967,789326573,785025149,32.504812243096836,35.61335396933102,NaN,NaN,-13.300688638796544,-15.925504635585881
2022-07-06T09:30:00-04:00,142.89,144.145,141.05,142.67,7944926,6922710.6,47.39886891716563,42.63410393528438,NaN,NaN,4.781992226815706,-42.74868349035918,0.7294498404839991,-2.652800266881968,-3.382250107365967,781381647,783272493.6,30.97596609496692,35.286505197938375,NaN,NaN,-12.147220680600157,-15.385749784873635
2022-07-07T09:30:00-04:00,143.04,146.63,143.02,146.35,4279535,6895750.35,52.14750560439694,43.5388895027,NaN,NaN,60.020921301236605,-18.124844245633472,1.0373596733807102,-2.0855505156400795,-3.1229101890207898,785661182,783567671.8,31.559814006339025,35.205733750395304,NaN,NaN,-9.749569920197235,-14.580581232777007
2022-07-08T09:30:00-04:00,145.14,147.45,144.47,146.37,3098318,6830410.75,52.17277622415655,44.832675481203296,NaN,NaN,91.59771998432065,16.025783236369136,1.205718812560011,-1.615761673320776,-2.821480485880787,788759500,785739445.8,35.85866527770219,35.691979850423095,NaN,NaN,-7.781204177549668,-13.609241653458815
2022-07-11T09:30:00-04:00,145.44,145.84,142.01,142.36,3807659,6827574.45,46.83256630622023,45.60178119948557,NaN,NaN,54.466936732640605,37.43141205156415,1.0178513539365466,-1.5491662934601038,-2.5670176473966504,784951841,786016148.6,36.40673519911379,36.29456399908442,NaN,NaN,-7.521274465104431,-12.739532055122474
2022-07-12T09:30:00-04:00,142.36,144.59,140.585,141.5,7437181,6863454.1,45.75099857510444,45.95716692407442,NaN,NaN,32.485786147573315,48.670671278517375,0.8152620395834878,-1.5479400979172908,-2.3632021375007786,777514660,783653766,33.75484545389578,36.521260091424544,NaN,NaN,-7.6050412689106865,-12.006033371377933
2022-07-13T09:30:00-04:00,138.7,143.92,138.14,142.66,7118057,6715062.9,47.51180503986392,46.45569791640764,NaN,NaN,12.543952180030061,50.22306326916024,0.7411189517031178,-1.4368034478718812,-2.177922399574999,784632717,784303980,35.15488959130823,36.64678820889105,NaN,NaN,-7.199179814615504,-11.319340006126158
2022-07-14T09:30:00-04:00,141.09,142.78,139.37,142.54,5257660,6644048.5,47.34062159104926,46.731637915815476,NaN,NaN,7.878999418269267,39.79467889256678,0.667994403650769,-1.342929395011538,-2.010923798662307,779375057,783046755,33.67301651144733,36.538262233487856,NaN,NaN,-6.905170251575347,-10.688744326904613
2022-07-15T09:30:00-04:00,144.33,145.5,143.44,144.84,3759801,6379018.6,50.985758159930924,46.798712061880735,NaN,NaN,82.81376589524463,38.03788807475157,0.7522578183431528,-1.070601525733366,-1.8228593440765188,783134858,781921826.6,32.35866240177633,35.810876078191185,NaN,NaN,-5.673180038747286,-9.972235142882138
2022-07-18T09:30:00-04:00,146.82,148.57,144.7,145.26,4021256,5979599.45,51.64401360511554,47.036007680374304,NaN,NaN,114.70925696452588,50.08635212112863,0.8090599758242314,-0.8115343742962295,-1.620594350120461,787156114,782362681.2,33.45489238102914,35.046632184322576,NaN,NaN,-4.460049066064519,-9.18477998905105
2022-07-19T09:30:00-04:00,147.39,149.94,146.14,149.71,4419964,5640845.7,58.069392335274074,48.15620912827708,NaN,NaN,160.98331078033883,75.78585704768173,1.1010134601861905,-0.2443275248877228,-1.3453409850739133,791576078,785174964.8,40.1215542381846,34.86157815769247,NaN,NaN,-1.50070405543165,-8.08705485567685
2022-07-20T09:30:00-04:00,150,152.46,149.62,152.17,4670205,5552940.2,61.14319086273672,49.50353096607626,NaN,NaN,193.9140446187585,112.05987553542741,1.395543973133325,0.39908898134274295,-0.9964549917905821,796246283,787497678,45.020620226607996,35.12930890425433,NaN,NaN,1.9780497379226363,-6.649182770876924
2022-07-21T09:30:00-04:00,152.72,155.75,151.85,155.65,5381584,5521474.8,65.04674888604296,51.27386596264928,NaN,NaN,214.00390438356192,153.28485652848593,1.7381632315847326,1.1762490476903338,-0.5619141838943988,801627867,791948240,52.961993796164315,36.246837445114544,NaN,NaN,6.254783236991409,-4.805759055467162
2022-07-22T09:30:00-04:00,156.64,157.8,153.8,154.75,3897424,5421913.3,63.2763034206195,52.66313472558562,NaN,NaN,194.84891894996144,175.6918871394293,1.8094799232844911,1.699935720211215,-0.109544203073276,797730443,794867357,57.31684784622876,37.93737966199011,NaN,NaN,9.292310950756272,-2.7917490545780996
2022-07-25T09:30:00-04:00,154.88,154.96,152.48,153.42,4561693,5314880.5,60.64920764994272,53.56926836982996,NaN,NaN,137.11431390419278,180.1728985273627,1.6754451171173903,1.984762193323462,0.30931707620607163,793168750,796069884.2,59.0007941305073,39.82994979680514,NaN,NaN,11.123372011283559,-0.8038746165978627
2022-07-26T09:30:00-04:00,149.92,150.6,148.21,148.48,4098223,5155431.95,52.01157377425346,53.89874728819338,NaN,NaN,59.67437381823687,159.9111111349423,1.1855258517168517,1.7912243908521361,0.6056985391352845,789070527,795568774,57.97436082331783,41.75840656311591,NaN,NaN,10.16736417697383,0.7634452110552361
2022-07-27T09:30:00-04:00,150.73,154.9,150.01,154.1,5201300,5131251.15,59.140956170102136,54.39827947145803,NaN,NaN,105.12546515289337,142.15339524176926,1.1694399560332653,2.067498484176866,0.8980585281436009,794271827,795173882.8,57.1308848311989,43.58491162203448,NaN,NaN,11.626395247078136,2.3152952162013642
2022-07-28T09:30:00-04:00,155,157.01,152.57,156.75,5537181,5110128.55,62.00718657409324,55.10073735359638,NaN,NaN,122.21638582862454,123.7958915307818,1.2589830342912078,2.4717873210076107,1.2128042867164028,799809008,794810111,56.31801620499026,45.046293831126484,NaN,NaN,13.768123659193565,3.9514135652002498
2022-07-29T09:30:00-04:00,160.33,163.48,159.25,162.83,6802744,5136032.7,67.6195762376916,56.5855237772729,NaN,NaN,178.44858500274998,120.5158247413395,1.6260634208105693,3.2453835627296144,1.619320141919045,806611752,796586372.8,59.358754545508226,46.68572378444038,NaN,NaN,17.623441373019286,5.904560394888684
2022-08-01T09:30:00-04:00,162.86,165.99,162.0601,163.64,8960929,5300694.3,68.29160330732475,58.19556697243149,NaN,NaN,174.83089478218108,128.05914091693717,1.8078306391501902,3.8791084408567826,2.0712778017065925,815572681,801067159,65.82205784917954,48.976238955532075,NaN,NaN,20.85182822334102,8.039884370381873
2022-08-02T09:30:00-04:00,162.62,165.38,161.98,162.52,6907906,5358177.3,66.24435371375243,59.53360616342353,NaN,NaN,143.88748874272704,144.9017639018352,1.7366301129647188,4.242065442912491,2.505435329947772,808664775,804986008.6,70.27456659313131,51.484787312805146,NaN,NaN,22.809274220445275,10.149797206105216
2022-08-03T09:30:00-04:00,164.3,167.24,163.67,166.48,6013751,5261618.55,69.70270558387256,61.130897877196624,NaN,NaN,148.78466901238275,153.6336046737331,1.8308423554285587,4.79398827423347,2.9631459188049116,814678526,809067348.4,74.06412508762904,54.369866496818126,NaN,NaN,25.611377140830484,12.358594339637397
2022-08-04T09:30:00-04:00,166.89,167.86,165.93,167.16,4913758,5293329.7,70.26604971239117,62.50806155951521,NaN,NaN,139.63396284958296,157.11712007792477,1.8102985578843578,5.226019116160359,3.415720558276001,819592284,813024003.6,77.11064554509908,57.566436721341184,NaN,NaN,28.028752626890174,14.597188380673508
2022-08-05T09:30:00-04:00,165.29,166.74,163.46,164.31,4394244,5358126,64.82557341341307,63.449601545822176,NaN,NaN,106.29070272509374,142.68554362239354,1.48950244759581,5.277598617770764,3.7880961701749536,815198040,814741261.2,78.30193195521316,60.76979669092576,NaN,NaN,28.430130215002762,16.57332292843483
2022-08-08T09:30:00-04:00,166.02,168.58,164.42,165.05,3647030,5350094.55,65.57097052852811,63.98542855962603,NaN,NaN,105.04594728736016,128.72855412342935,1.223041202456761,5.316897673245904,4.093856470789143,818845070,815395739,78.75573612921906,63.529381111713924,NaN,NaN,28.973303015240788,18.344748655121396
2022-08-09T09:30:00-04:00,164.05,164.58,161.46,162.42,3319700,5144220.5,60.65157778197241,63.95031333957143,NaN,NaN,68.21712100251976,113.59448057538786,0.7867512515669706,5.077295535247856,4.290544283680886,815525370,816767858,79.71366350761684,66.00745563178599,NaN,NaN,27.97565341463394,19.720592192194616
2022-08-10T09:30:00-04:00,167.16,167.695,165.14,167,3623656,4969500.45,65.50502324736394,63.98304722252293,NaN,NaN,92.18818237561901,102.27518324803513,0.7252191890815896,5.197068270032872,4.471849080951283,819149026,817661958,80.33588402263668,67.96273350510545,NaN,NaN,28.573930456369983,20.985354801362526
2022-08-11T09:30:00-04:00,168.47,169.25,165.63,166.15,3911035,4902169.2,63.929013266248226,64.02966935435356,NaN,NaN,87.0413830422833,91.75666728657521,0.5536208874151418,5.16387519022021,4.610254302805068,815237991,816791099.4,77.83182730631775,69.42808918082609,NaN,NaN,28.585193299236895,22.071046015344578
2022-08-12T09:30:00-04:00,167.35,169.96,165.91,169.91,2948935,4861625.9,67.63813818604646,64.52887867836095,NaN,NaN,94.41265074021095,89.38105688959865,0.6149682821044902,5.378964655435681,4.7639963733311905,818186926,817388876.6,78.33111126016726,70.80882611865893,NaN,NaN,29.731433372650905,23.165387066388337
2022-08-15T09:30:00-04:00,169.48,171.618,169.27,171.08,3857446,4853435.4,68.7161327527644,65.72206146254031,NaN,NaN,108.261829816849,90.02423339549641,0.6524162081622578,5.579516633534013,4.927100425371755,822044372,818028737,78.87945563229727,72.3020471764432,NaN,NaN,30.992628257448583,24.283564379396942
2022-08-16T09:30:00-04:00,171.35,174.76,170.84,172.97,3612426,4813058.5,70.4296935728632,66.52839984845183,NaN,NaN,125.53033224777703,101.48687564454787,0.7173830575677531,5.823829247331446,5.106446189763693,825656798,820055022.6,80.55737738967795,73.97536807347741,NaN,NaN,32.562655468978654,25.466291677908615
2022-08-17T09:30:00-04:00,171.07,172.8893,169.99,171.11,3747857,4766941.1,66.56545595581795,66.85399051857502,NaN,NaN,103.22042386363825,103.69332394215171,0.5552412649829153,5.800497770992337,5.245256506009421,821908941,820607005.6,81.00019558334307,75.7383808862169,NaN,NaN,32.75801692002813,26.50796671249712
2022-08-18T09:30:00-04:00,170.91,171.45,169.96,171.06,2834591,4639591.45,66.45989351834967,66.77115603862202,NaN,NaN,91.40519019073145,104.56608537184134,0.3734963804712983,5.712126981598544,5.338630601127246,819074350,821374277.4,81.62661889404166,77.32894262539786,NaN,NaN,32.887534570527855,27.41933354935865
2022-08-19T09:30:00-04:00,169.56,169.78,166.965,167.53,3574762,4623458.35,59.30885051331085,66.1295308390496,NaN,NaN,52.772833340198126,96.23812189183877,-0.03394471900687357,5.296199702368654,5.330144421375527,815499588,820836809.8,79.64569040866476,78.31634495107538,NaN,NaN,30.905859586075557,27.917408697461067
2022-08-22T09:30:00-04:00,164.99,164.99,162.53,162.88,4184671,4604607.25,51.454723371937796,65.07312867177713,NaN,NaN,-17.487684245215306,71.08821907942591,-0.6328875144594956,4.539035028301157,5.171922542760653,811314917,818690918.8,72.12021321148958,78.44817685238668,NaN,NaN,26.622438653198866,27.73241297685218
2022-08-23T09:30:00-04:00,163.01,164.55,162.48,163.34,4393526,4619372.4,52.1300761937004,63.81794085819341,NaN,NaN,-34.90543147724223,39.00106633442207,-0.9929115511271664,3.930783103851695,4.923694654978862,815708443,816701247.8,65.90248350110832,77.86520245334948,NaN,NaN,23.365445545747423,27.10856048669436
2022-08-24T09:30:00-04:00,163.01,165.68,162.61,164.04,3332025,4525908.65,53.19711749952123,62.59873141441699,NaN,NaN,-39.71817339380422,10.413346882933572,-1.1667335979137432,3.4652776575866824,4.632011255500426,819040468,816127553.2,64.18422957476477,76.94188702689702,NaN,NaN,20.97621270259241,26.232510803251223
2022-08-25T09:30:00-04:00,165.06,166.2,163.82,166,3044906,4401294.9,56.14481019362119,61.97867689871757,NaN,NaN,-27.585835005786304,-13.384858156369981,-1.1316663275691061,3.2174283460390427,4.349094673608149,822085374,816729758,65.20962828545217,76.00672247905696,NaN,NaN,19.745845257358088,25.30584429669506
2022-08-26T09:30:00-04:00,166.3,166.85,159.635,159.68,3947005,4258507.95,46.06930265111812,60.58570062175971,NaN,NaN,-114.38855596948639,-46.81713601830688,-1.4933405242997528,2.4824190182334576,3.9757595425332104,818138369,817257514.2,66.12494684683426,75.10452324460091,NaN,NaN,15.3137101745667,23.878396564962436
2022-08-29T09:30:00-04:00,157.46,160.16,157.46,158.83,3525682,3986745.6,44.90219368841271,59.46074461507688,NaN,NaN,-176.94975321432688,-78.7095498121292,-1.7322387811935633,1.8104610660412561,3.5426998472348195,814612687,817917068.2,67.28341181596497,74.21664812376864,NaN,NaN,11.381126398193091,22.09307225542396
2022-08-30T09:30:00-04:00,160.17,160.53,155.48,157.06,3667167,3824708.65,42.48835256448196,57.81669670915674,NaN,NaN,-179.98205983271097,-107.72487548322295,-1.9364241443098802,1.1221696668474692,3.0585938111573494,810945520,816964483.6,63.8852697290589,73.04160424565592,NaN,NaN,7.349679816321486,19.986873335552175
2022-08-31T09:30:00-04:00,157.87,158.35,155.47,155.51,4431484,3745595.3,40.43824549728357,56.13878472565926,NaN,NaN,-170.7628834598011,-133.9338174964223,-2.089695015609003,0.44647504164609586,2.5361700572550987,806514036,814459197.2,55.890434420929616,71.47436189669962,NaN,NaN,3.3567809519508782,17.611145852180563
2022-09-01T09:30:00-04:00,154.49,157.06,152.93,156.93,5972093,3798512.05,43.14480829710105,54.38926116216316,NaN,NaN,-157.1467417072743,-159.84599883671993,-2.0087176582922384,0.025272984389800968,2.0339906426820393,812486129,812539348.2,50.65857427314113,69.49775211191205,NaN,NaN,0.7835579677980141,15.2072047258402
2022-09-02T09:30:00-04:00,158.5,159.19,154.6,155.49,8241303,3990865,41.10493397007523,52.41703267768536,NaN,NaN,-123.23548432436624,-161.6153845076959,-1.9631032609541172,-0.41988843351060723,1.54321482744351,804244826,809760639.6,44.208236609480345,67.02123646742511,NaN,NaN,-1.9837215784446531,12.751358110942364
2022-09-06T09:30:00-04:00,156.17,156.54,152.85,155.17,8960978,4256562.4,40.64504326897386,50.289557655978975,NaN,NaN,-128.01153940645239,-151.82774174612098,-1.8660947710164493,-0.7894036363270516,1.0766911346893977,795283848,805894871.8,37.12579926096902,63.918980886803055,NaN,NaN,-4.394952622235502,10.301885149059812
2022-09-07T09:30:00-04:00,155,160.15,155,159.93,6316741,4406414.45,49.666196866579355,49.08246772103337,NaN,NaN,-71.5652617880489,-130.14438213718856,-1.4135118651988363,-0.6901986968091478,0.7233131683896885,801600589,804025885.6,34.267443579107166,60.58092717221478,NaN,NaN,-3.945860567315613,8.266492903863323
2022-09-08T09:30:00-04:00,158.29,161.54,157.79,161.42,4695917,4460027.5,52.11937397643915,48.05814489661118,NaN,NaN,-41.43771855597882,-104.2793491564241,-0.9672490291285112,-0.4857481180209504,0.4815009111075607,806296506,803982379.6,34.20143315750606,57.19341390531938,NaN,NaN,-2.833342603313007,6.680802117123847
2022-09-09T09:30:00-04:00,162.19,164.75,162.19,164.48,4475444,4488247.95,56.778348699790186,47.877394767073994,NaN,NaN,9.104174788304336,-71.02916585730836,-0.4459430372313826,-0.07592788543166762,0.370015151799715,810771950,803639543.8,33.65131680191324,53.90810150483713,NaN,NaN,-0.4128775004961713,5.667419314606702
2022-09-12T09:30:00-04:00,165.39,167.19,165.39,166.6,4395833,4560592.85,59.703805479865316,48.46661491764024,NaN,NaN,47.665833699627505,-36.84890225250961,0.0360986197961477,0.41513842654489963,0.37903980674875193,815167783,805824135.2,40.24671163763976,51.631422820990714,NaN,NaN,2.547315263931987,5.221690164510314
2022-09-13T09:30:00-04:00,161.29,162.08,157.57,158.01,6675433,4701492.2,46.09093201789397,48.0352474765112,NaN,NaN,-48.21317868682466,-20.889230108584066,-0.21530872333712664,0.10990390257734362,0.32521262591447025,808492350,808465835.6,47.09529595194501,50.28805228176476,NaN,NaN,0.6503304533450907,4.568638777200997
2022-09-14T09:30:00-04:00,158.56,160.705,157.765,160.04,7462413,4893991.55,49.04758351684166,47.73885219203409,NaN,NaN,-37.55756754267192,-14.087691259508665,-0.23501418026832765,0.031444900579060686,0.26645908084738834,815954763,811336670.4,53.35245395648891,49.51435402331648,NaN,NaN,0.15904618521239183,3.938696978345482
2022-09-15T09:30:00-04:00,159.83,162.44,158.44,159.22,5682247,4990711.05,47.9046563892144,47.15026977743361,NaN,NaN,-22.08645899166555,-10.217439346646012,-0.2898050881504714,-0.09579727934070092,0.19400780880977048,810272516,812131872.4,54.9421257776789,48.78096098704696,NaN,NaN,-0.5957233710266219,3.290922642720896
2022-09-16T09:30:00-04:00,156.82,158.21,155.69,157.94,8682148,5283088.9,46.098847469821216,47.152380121626685,NaN,NaN,-67.89344477084744,-25.616963258476414,-0.3924102479803638,-0.29650500116568423,0.09590524681467953,801590368,810295556,50.64963175883763,47.67558133790435,NaN,NaN,-1.7699106034693328,2.567946464693721
2022-09-19T09:30:00-04:00,156.26,159.87,156.16,159.84,5014331,5355067.35,49.16228082583033,47.45667206001366,NaN,NaN,-34.671194569668536,-42.08436891233562,-0.3157711693180989,-0.29880871483294413,0.016962454485154793,806604699,808582939.2,46.96435606835891,46.224220213075334,NaN,NaN,-1.809639425140628,1.9425770518602423
2022-09-20T09:30:00-04:00,158.19,158.79,155.81,157.13,4571015,5374384.55,45.21503954869921,47.65143541602919,NaN,NaN,-62.04421264838953,-44.8505757046486,-0.4242825454810728,-0.5133907273661862,-0.08910818188511341,802033684,807291206,44.34362653157496,44.828388556112195,NaN,NaN,-3.0614277378004715,1.2277192247658548
2022-09-21T09:30:00-04:00,157.57,159.03,153.38,153.41,5111182,5410267.35,40.41778767747662,47.64997414318583,NaN,NaN,-102.83020052485355,-57.90510230108492,-0.7066431088342563,-0.9724120679279338,-0.2657689590936775,796922502,803484753.8,37.67235205428593,43.52709695849479,NaN,NaN,-5.686564135882832,0.23996445895889962
2022-09-22T09:30:00-04:00,152.63,153.18,149.1,149.87,5669455,5527138.85,36.454087113520494,47.17206548721579,NaN,NaN,-196.1172145421685,-92.71125341118552,-1.0700694053187472,-1.6033557157421114,-0.5332863104233643,791253047,799680860,32.422814995272645,42.22454272436132,NaN,NaN,-9.232663591203748,-1.1132681196357643
2022-09-23T09:30:00-04:00,147.88,148.12,144.55,146.42,5606475,5655217.3,33.05213401574953,46.596865490478244,NaN,NaN,-256.743425688432,-130.48124959470243,-1.4570722314593918,-2.354626599747604,-0.8975543682882123,785646572,796492100.8,28.799832346837874,41.123942419886866,NaN,NaN,-13.367480148869614,-2.8638698380977425
2022-09-26T09:30:00-04:00,145.82,149.27,145.8,146.09,6419829,5778858.5,32.737427185779126,46.03203577025005,NaN,NaN,-199.5659356461081,-163.46019780999035,-1.6361329685350707,-2.9427205789570507,-1.30658761042198,779226743,791016509.6,23.867837785471977,40.176945171637065,NaN,NaN,-16.72312160124269,-4.843762947118449
2022-09-27T09:30:00-04:00,148.24,149.74,144.97,146.55,7281665,5966657.65,33.68528919859145,44.89054236539376,NaN,NaN,-164.03284291739843,-183.85792386379214,-1.6213279405642922,-3.3332475361273453,-1.711919595563053,786508408,787911454.4,21.608033322115475,39.272701581851955,NaN,NaN,-19.158818503556933,-6.888770883752518
2022-09-28T09:30:00-04:00,147.17,151.3,146.43,150.51,6930654,6129832,41.34790748779698,44.12115190191933,NaN,NaN,-105.55911737991927,-184.40370723480527,-1.2587305531974549,-3.285332787059872,-2.026602233862417,793439062,787214766.4,21.124748648008378,38.3386526883164,NaN,NaN,-18.985616990235737,-8.616891756107265
2022-09-29T09:30:00-04:00,148.13,148.33,143.91,145.31,6156824,6216099,35.54048406828758,42.60416157109772,NaN,NaN,-136.0242650489943,-172.38511733617042,-1.2788525060524671,-3.6251678664280007,-2.3463153603755336,787282238,786420604.6,20.560239103127486,37.403575709831706,NaN,NaN,-20.717328156038864,-10.345525527526064
2022-09-30T09:30:00-04:00,143.61,146.54,142.03,142.45,6116165,6223302.6,32.81090581905349,40.683240166754025,NaN,NaN,-138.34904475386577,-148.70624114925718,-1.3855526039542676,-4.078256115318368,-2.6927035113641002,781166073,785524504.8,19.913600539794928,35.95121063141422,NaN,NaN,-23.049408389720053,-12.16036593641092
2022-10-03T09:30:00-04:00,142.32,143.91,140.2,142.59,8645781,6243526.5,33.08183943341389,39.75401926786259,NaN,NaN,-130.57224904126292,-134.90750382828816,-1.3463138643225654,-4.375595841767307,-3.0292819774447417,789811854,787641527,25.84715551220725,34.43348631429009,NaN,NaN,-24.801134632825946,-13.96619003589878
2022-10-04T09:30:00-04:00,146.13,149.01,145.71,147.57,9831909,6287073.05,42.03570649082639,39.25317090886149,NaN,NaN,-65.95153783805578,-115.29124281241961,-0.9057144336948437,-4.161425019563296,-3.2557105858684525,799643763,790268598,32.52771311459752,32.94600482558356,NaN,NaN,-23.474131698553112,-15.32446741627797
2022-10-05T09:30:00-04:00,145.23,147.665,143.68,146.7,6270580,6284765,41.00351023833199,38.76023189808418,NaN,NaN,-72.41816840552084,-108.66305301753994,-0.6079158747408231,-4.015605429294482,-3.4076895545536585,793373183,790255422.2,32.51189273068846,31.3438453222271,NaN,NaN,-22.723931902136506,-16.38153377140062
2022-10-06T09:30:00-04:00,146.39,147.83,145.025,145.66,7214462,6410692.25,39.747053228918666,38.306532309448286,NaN,NaN,-64.4369124512366,-94.34558249798839,-0.4246966677901334,-3.9385603892913252,-3.513863721501192,786158721,790030718.8,32.224046270543,30.02773207306319,NaN,NaN,-22.478308817179585,-17.252501635083327
2022-10-07T09:30:00-04:00,143.5,143.82,139.83,140.65,5597674,6466803.75,34.295147464118756,37.24459421218317,NaN,NaN,-105.3348061760253,-87.7427347824203,-0.5752863882308956,-4.232971706789812,-3.657685318558916,780561047,789909713.6,32.059437258676084,28.96309501522871,NaN,NaN,-23.972092641081584,-18.212443207368793
2022-10-10T09:30:00-04:00,140.86,141.26,138.4,139.78,4864176,6490220.9,33.437433366833076,36.40333662776416,NaN,NaN,-117.90171937200141,-85.208628848568,-0.661690593171445,-4.484798560023222,-3.823107966851777,775696871,787086717,28.41290411110782,27.825186270909626,NaN,NaN,-25.438106884065153,-19.244680875468273
2022-10-11T09:30:00-04:00,139.09,141.47,137.72,138.64,6001697,6456534.1,32.29757707973347,35.82332158506823,NaN,NaN,-116.26788170837307,-95.27189762263144,-0.7190577518000527,-4.721930156601843,-4.00287240480179,769695174,781096999.2,22.551727844015417,26.745141684461736,NaN,NaN,-26.98368386205444,-20.35025273069487
2022-10-12T09:30:00-04:00,138.65,140.07,137.53,139,9720185,6569422.7,33.07346296591622,35.58184843166792,NaN,NaN,-115.5845458047688,-103.90517310248103,-0.6578523972980532,-4.825187901424357,-4.167335504126304,779415359,778305434.4,20.435861887316776,25.888930748179177,NaN,NaN,-28.03216562741568,-21.447668858797844
2022-10-13T09:30:00-04:00,134.84,141.31,133.55,140.52,9782193,6774420,36.38825814729668,35.820143012492714,NaN,NaN,-117.67053040241375,-114.55189669271647,-0.45000870580540386,-4.729846386383059,-4.279837680577655,789197552,778913200.6,22.148435265817668,25.413830956677735,NaN,NaN,-28.00603770708527,-22.384578694267475
2022-10-14T09:30:00-04:00,141.92,142.66,135.05,135.27,6710967,6675860.95,30.727374844591054,35.67656784526499,NaN,NaN,-119.56127705134794,-117.397190867781,-0.5921703784747718,-5.02005065367112,-4.427880275196348,782486585,779298308.2,23.275365123340507,25.3715114808112,NaN,NaN,-29.702196561650325,-23.429952675322166
2022-10-17T09:30:00-04:00,138.16,141.135,138.1,140.76,6565588,6753423.8,41.05433560125421,36.202928302598046,NaN,NaN,-76.5036095804377,-109.11756890946826,-0.25950489739984395,-4.752261396946153,-4.492756499546309,789052173,781969368.6,30.761590930635307,26.0253370242769,NaN,NaN,-27.835076888348308,-24.0592561343259
2022-10-18T09:30:00-04:00,145.15,145.57,141.31,142.7,5184185,6784082.3,44.21888680102519,36.40799825354292,NaN,NaN,-19.2058012549097,-89.70515281877559,0.12737292809073786,-4.333540339432886,-4.460913267523624,794236358,786877605.4,41.96704066468137,27.514072168324976,NaN,NaN,-25.286134484319323,-24.234524470039247
2022-10-19T09:30:00-04:00,141.54,142.46,139.61,141.1,3572424,6707144.4,42.206362557243594,36.88413243132549,NaN,NaN,-49.79878203709252,-76.54800006524034,0.30174438731334163,-4.083732783381947,-4.385477170695289,790663934,789127320.4,46.2600895143359,29.34977576912558,NaN,NaN,-23.820973971966417,-24.175445827457413
2022-10-20T09:30:00-04:00,139.18,141.78,137.91,138.37,5097643,6678553.8,38.94906315614832,37.32257224111798,NaN,NaN,-76.27343404664425,-68.26858079408643,0.26097843645475827,-4.0592541251268415,-4.3202325615816,785566291,788401068.2,45.1002062529256,31.148819034349195,NaN,NaN,-23.587910309715475,-24.091512182065706
2022-10-21T09:30:00-04:00,138.21,142.53,137.45,142.4,7787897,6787624.9,45.6208101656345,38.218213007705174,NaN,NaN,-41.61271288936604,-52.67886796169006,0.5183181281282669,-3.672334901421266,-4.190653029549533,793354188,790574588.8,49.20498618198274,32.817235510761726,NaN,NaN,-21.223458423648736,-23.681790216577568
2022-10-24T09:30:00-04:00,141.75,143.6,139.22,142.99,4540644,6693665.65,46.541880017171586,38.54008254530125,NaN,NaN,-12.645570883517639,-39.90726022230605,0.7283003740119476,-3.2802775620345983,-4.008577936046546,797894832,792343120.6,52.32828635284132,34.23156217063629,NaN,NaN,-19.054058744099358,-23.020685720509253
2022-10-25T09:30:00-04:00,143.06,146.97,143.06,146.57,3727504,6515957.6,51.86908767780802,39.31619521954955,NaN,NaN,74.36998786379289,-21.192102398565538,1.086747144974717,-2.6501440048281495,-3.7368911498028665,801622336,793820316.2,54.826808657481784,35.825484736835804,NaN,NaN,-15.479714687711871,-21.94340414439534
2022-10-26T09:30:00-04:00,144.8,148.32,144.4,145.39,3432303,6341040.05,50.09701528011816,40.055478223206656,NaN,NaN,97.40962104111556,8.249578217076074,1.2132092356403814,-2.22037960525239,-3.4335888408927713,798190033,795325536,57.28357560277403,37.61545111770945,NaN,NaN,-13.09151840773464,-20.6788490391581
2022-10-27T09:30:00-04:00,146.1,147.03,144.32,144.83,6361053,6351251.5,49.23729389327112,41.12277439671754,NaN,NaN,82.30700558422026,39.965666143248974,1.2244402735364392,-1.9030384989722222,-3.1274787725086615,791828980,796578073.8,59.26869709598367,39.55896967751714,NaN,NaN,-11.39157713879453,-19.352095910534732
2022-10-28T09:30:00-04:00,140.94,145.155,139.925,144.96,7041298,6397508.15,49.45414986828093,42.26682557539238,NaN,NaN,29.914348734041127,54.27107846793041,1.2041014113600639,-1.6223520083085816,-2.8264534196686455,798870278,797681291.8,60.988353420692796,41.885787485344636,NaN,NaN,-9.940151855576127,-18.007532474112075
2022-10-31T09:30:00-04:00,144.19,145.12,142.81,144.03,4683740,6199406.1,47.87838856352904,43.37974068137778,NaN,NaN,42.7127755971329,65.34274776406052,1.0946502298646523,-1.4581406323378303,-2.5527908622024826,794186538,796939633,59.17946454228685,44.50205439236402,NaN,NaN,-9.129786555001546,-16.739283057096287
2022-11-01T09:30:00-04:00,146.48,146.9,142.29,142.57,6257333,6020677.3,45.43104464086502,44.26242508673126,NaN,NaN,49.01758084579547,60.27226636046104,0.8987644936838799,-1.4293352450976329,-2.3280997387815128,787929205,794201006.8,52.935951903048306,46.823489393487705,NaN,NaN,-9.085818161948254,-15.645930929217997
2022-11-02T09:30:00-04:00,142.43,143.26,137.14,137.18,9927546,6203525.6,37.75774553125305,44.360245614156725,NaN,NaN,-72.88861242079717,26.212619668078514,0.40612002223245636,-1.8204497109909425,-2.226569733223399,778001659,790163332,45.34089076832717,48.48009335795267,NaN,NaN,-11.372449251132206,-15.035433546634312
2022-11-03T09:30:00-04:00,136.2,137.93,135.46,136.36,5558719,6120738.45,36.74105040101499,44.789793868187004,NaN,NaN,-135.56666462720096,-17.36211437420573,0.04401925590176381,-2.171545663346194,-2.215564919247958,772442940,786286124,39.48274314350911,49.637763216536136,NaN,NaN,-13.553847553786607,-14.823778404798926
2022-11-04T09:30:00-04:00,139.59,140.96,134.905,137.5,6314460,6156577.75,39.19247043026367,44.656803498830534,NaN,NaN,-90.48021213606947,-41.44102654822785,-0.09229503230266856,-2.3309337096262936,-2.238638677323625,778757400,782263548.4,34.50209834492058,49.90494231755651,NaN,NaN,-14.692629224052464,-14.805042807549432
2022-11-07T09:30:00-05:00,138.33,138.45,135.2,136.54,3712348,6098986.35,37.86186639078521,44.20273061238482,NaN,NaN,-109.15917467534398,-71.81541660272323,-0.21375164496127708,-2.5058282335252215,-2.2920765885639445,775045052,778435251.2,30.55203138495142,49.08958451186152,NaN,NaN,-16.025965368956673,-14.979460316321894
2022-11-08T09:30:00-05:00,136.7,137.83,134.325,136.2,4767911,6037297.05,37.37785790679291,43.85783742306692,NaN,NaN,-114.57144110586106,-104.53322099305453,-0.27947466329231885,-2.641419917679343,-2.3619452543870243,770277141,774904838.4,27.432890150395465,47.744784557294345,NaN,NaN,-17.268828038800894,-15.306512848104608
2022-11-09T09:30:00-05:00,135.48,136.11,131.9,132.04,5077890,5805182.3,31.98948863928851,43.36072495757692,NaN,NaN,-159.47040238670658,-121.84957898623642,-0.5499661317088789,-3.049402919023123,-2.4994367873142442,765199251,772344356.8,25.40694255328654,46.33812286446299,NaN,NaN,-20.038128148872055,-15.982457891071386
2022-11-10T09:30:00-05:00,138.66,141.85,137.2,141.69,7758021,5703973.7,49.99712107662433,43.67331859407619,NaN,NaN,-8.348374158427365,-96.4059208924817,-0.052047466491758065,-2.5644961204289416,-2.5124486539371835,772957272,772447223.2,25.64452053414307,44.65523246104586,NaN,NaN,-16.457022903561118,-16.05025289285563
2022-11-11T09:30:00-05:00,141.9,145.89,141.47,145.09,5675152,5652182.95,54.56206503145636,44.24618895223939,NaN,NaN,73.39440813569956,-63.630996838127885,0.5026522925504189,-1.88413328824916,-2.386785580799579,778632424,772422228,25.623165104572706,42.74772380045524,NaN,NaN,-11.88910969594179,-15.455803864725082
2022-11-14T09:30:00-05:00,143.83,145.1,142.64,142.79,7920558,5719931.45,51.15954481414038,44.195507319120274,NaN,NaN,53.49537295127974,-31.10008731280314,0.6989567331912072,-1.51308966431057,-2.2120463975017772,770711866,771555590.8,24.850460391018117,40.60655606713641,NaN,NaN,-9.408968989572756,-14.591970311131893
2022-11-15T09:30:00-05:00,146.18,146.96,143.14,144.74,4369776,5679211,53.79061000982038,44.45933551409901,NaN,NaN,81.19584055459609,8.053369019288288,0.9299673358187399,-1.0495872277283524,-1.9795545635470924,775081642,772516491,27.462437603857325,38.476474781499505,NaN,NaN,-6.535627702937632,-13.441064224246999
2022-11-16T09:30:00-05:00,142.08,143.71,141.49,142.53,4786922,5739935.9,50.47208210840456,44.54753467232282,NaN,NaN,27.718050795140904,45.49105965565778,0.9030200657399365,-0.8507794813721716,-1.7537995471121082,770294720,773535584.8,30.23205359690263,36.402428817279436,NaN,NaN,-5.26631904280157,-12.27324348404051
2022-11-17T09:30:00-05:00,140.47,141.4,139.48,140.8,3782556,5674181.55,47.97685930165268,44.442013917563656,NaN,NaN,-16.856070904243563,43.78952030649454,0.7443767321895272,-0.8233286318751993,-1.5677053640647265,766512164,772246563.2,28.737418838587203,34.09879063284332,NaN,NaN,-5.023074072778184,-11.23750499671732
2022-11-18T09:30:00-05:00,142.62,142.67,139.36,140.99,3706963,5470134.85,48.27928231345402,44.470649185415446,NaN,NaN,-7.401504317541628,27.630337815846303,0.6323385325075646,-0.7772821984302709,-1.4096207309378355,770219127,770563903.8,26.86994345459489,31.79096769800818,NaN,NaN,-4.739688195384173,-10.309245453669728
2022-11-21T09:30:00-05:00,140.2,140.6,138.2,138.95,3376388,5411922.05,45.23848437060935,44.45689488039718,NaN,NaN,-41.79274096171401,8.572715033247555,0.4116301376666147,-0.8950830588545671,-1.3067131965211818,766842739,769790078.4,26.032128223854812,29.869266006637215,NaN,NaN,-5.404770175586477,-9.608606128229264
2022-11-22T09:30:00-05:00,139.5,140.59,138.54,140.52,2760449,5363569.3,47.95528375785663,45.18529046801172,NaN,NaN,-23.55923609937215,-12.378300297546094,0.36382284658626096,-0.8519346382883555,-1.2157574848746164,769603188,768694387.6,24.850589624925377,28.4056730678228,NaN,NaN,-5.172682541036573,-8.974902758630307
2022-11-23T09:30:00-05:00,141.02,142.85,140.73,142.55,3088882,5346398.25,51.31829964382023,46.22652255678353,NaN,NaN,31.75657987474839,-11.570594481624596,0.45541965438321874,-0.646482916895593,-1.1019025712788117,772692070,769173857.6,26.42432107714974,27.472928634511415,NaN,NaN,-3.9891942586410143,-8.262658687203265
2022-11-25T09:30:00-05:00,142.62,143.03,141.88,142.63,1364226,5096556.9,51.45143924931671,47.10216318671588,NaN,NaN,49.15970850065087,1.6325613993542887,0.5041081566703142,-0.47176737544091907,-0.9758755321112332,774056296,770682684,31.299886836277224,27.244199241036885,NaN,NaN,-2.9886802512338155,-7.509233196350486
2022-11-28T09:30:00-05:00,141.86,143.3414,141.44,141.75,3020516,4895517.8,49.83682326767002,47.95751724935051,NaN,NaN,42.98553959860619,11.709970182583852,0.4609363108674086,-0.3997051435269725,-0.8606414543943811,771035780,770846014.6,31.826533195509597,27.335235084648183,NaN,NaN,-2.580189292817072,-6.805084067274285
2022-11-29T09:30:00-05:00,141.88,142.4,140.755,141.3,5211468,4921904.2,48.99018992677672,48.78696953649221,NaN,NaN,29.514874082448376,25.97149319141633,0.38884234635876147,-0.37458852144592925,-0.7634308678046907,765824312,770642329.2,31.50220876426218,27.62590069992438,NaN,NaN,-2.459735550424619,-6.184319993438618
2022-11-30T09:30:00-05:00,141.37,146.22,140.46,146.17,8204277,5019251.4,57.420551127142886,50.60347399991038,NaN,NaN,104.5563507626418,51.59461056381913,0.6410235640569716,0.03784858726652374,-0.6031749767904478,774028589,771527409.4,34.61997001235838,28.28397408985808,NaN,NaN,0.14195309290201996,-5.280566695389956
2022-12-01T09:30:00-05:00,146.71,147.32,145.04,146.15,4827066,4764227.4,57.37861114650146,51.13072329061589,NaN,NaN,136.360289436733,72.51535247621605,0.769705029130153,0.35895630962224345,-0.4107487195079096,769201523,770829300,33.33129325497367,28.83302928420312,NaN,NaN,2.2414087409251673,-4.205998775916367
2022-12-02T09:30:00-05:00,144.09,146.395,144.06,145.96,5986259,4785604.4,56.95302648690548,51.301506251719395,NaN,NaN,109.263740433227,84.53615886273128,0.8016302305048744,0.5912890686231833,-0.210341161881691,763215264,768661093.6,29.64091612403564,29.120011499879045,NaN,NaN,3.8703628708075652,-3.052232826384377
2022-12-05T09:30:00-05:00,144.02,144.47,141.37,141.75,5789994,4759381.1,48.388702493497576,51.103588943102054,NaN,NaN,29.43789689430818,81.82663032187168,0.5128628224683248,0.43073736620371506,-0.08212545626460976,757425270,765938991.6,25.78154934279368,29.186517853577303,NaN,NaN,2.8971601877853232,-2.2023195386458485
2022-12-06T09:30:00-05:00,141.34,141.95,138.33,139.54,3949926,4771260,44.59746238539233,50.4469355413572,NaN,NaN,-49.159795377259364,66.09169642993012,0.1646955739173138,0.12374401113203248,-0.04095156278528131,753475344,763469198,22.87173968451839,28.858610859338807,NaN,NaN,0.9111675752330269,-1.7575356652345806
2022-12-07T09:30:00-05:00,138.59,140.18,138.16,138.7,5426310,4804179.95,43.21163324140535,49.92833205085726,NaN,NaN,-86.7871305254714,27.82300017230749,-0.11539601651114702,-0.18519658342421508,-0.06980056691306806,748049034,758273287,18.214244142968838,28.000195898343538,NaN,NaN,-1.1415086698986154,-1.6695318087580142
2022-12-08T09:30:00-05:00,138.93,140.57,138.27,140.04,3203509,4710460.9,46.089578100707854,49.79352625078976,NaN,NaN,-92.32625284992166,-17.914308285023445,-0.19875072128702864,-0.31823896852185385,-0.11948824723482522,751252543,754683491,15.817681314607853,27.077357503773584,NaN,NaN,-2.0694056706778263,-1.7266566461751303
2022-12-09T09:30:00-05:00,139.19,140.815,138.97,139.43,3609238,4503021.75,44.97225827141476,49.557310247786965,NaN,NaN,-85.90656044356788,-56.94836846038241,-0.2784164175487503,-0.4675087691707631,-0.18909235162201282,747643305,751569099.2,14.086051344259218,26.16422235303532,NaN,NaN,-3.1567890187914984,-1.9309612708346113
2022-12-12T09:30:00-05:00,139.14,139.78,138.23,139.78,3272791,4382903.7,45.78438177736891,49.59630291969836,NaN,NaN,-92.75633710779562,-81.38721526080317,-0.28969418270398467,-0.5512100800019937,-0.261515897298009,750916096,750267264.4,13.424479460183335,25.26367601277307,NaN,NaN,-3.849493661517922,-2.205037326646513
2022-12-13T09:30:00-05:00,144.42,145.32,138.27,139.78,5372102,4255480.9,45.78438177736891,49.44123849252067,NaN,NaN,-21.100481200919926,-75.77535242553527,-0.2791924291457025,-0.6105064337301371,-0.3313140045844346,750916096,749755414.8,13.162718697231455,24.428828089366363,NaN,NaN,-4.428097936432888,-2.522617413758852
2022-12-14T09:30:00-05:00,139.49,140.64,137.18,138.74,5451851,4309584.65,43.56849478396906,48.887681002531295,NaN,NaN,-99.6594126217752,-78.34980884479604,-0.3213242488215715,-0.732969315611399,-0.4116450667898275,745464245,749238457,12.889358176583812,23.46204502504023,NaN,NaN,-5.511921817567054,-2.9496609000171663
2022-12-15T09:30:00-05:00,136.59,137.25,135.45,136.46,5974800,4368978.55,39.100628348349844,48.00548022389081,NaN,NaN,-171.3673662690511,-94.15803152862195,-0.4726386930855281,-1.0024434331467376,-0.5298047400612095,739489445,746885837.4,11.698645255209243,22.06195634067823,NaN,NaN,-7.737915917505145,-3.6336973310868776
2022-12-16T09:30:00-05:00,135.68,136.21,133.21,133.91,6685875,4514144.5,34.80207094800167,46.9315693439145,NaN,NaN,-198.61506325703903,-116.69973209131618,-0.7006080680630131,-1.405564825139976,-0.7049567570769628,732803570,743917890.4,10.394119671319046,20.531069660378904,NaN,NaN,-11.023586193137644,-4.689395739951273
2022-12-19T09:30:00-05:00,133.52,133.8,130.88,131.4,4337910,4545691.85,31.169702643579214,45.65867739511469,NaN,NaN,-220.9433813316468,-142.33714093608643,-0.9605232031628654,-1.9056107610305446,-0.9450875578676792,728465660,739427803.2,8.796073895230279,18.909202884019486,NaN,NaN,-15.067117397980603,-6.171927405384034
2022-12-20T09:30:00-05:00,130.59,131.68,129.69,129.87,3855346,4569639.75,29.17104172454306,43.64085529492898,NaN,NaN,-216.94060869020166,-181.50516643394278,-1.1621056037286515,-2.3977195625284935,-1.235613958799842,724610314,734166646.8,7.366866036082683,16.96255259999979,NaN,NaN,-19.119549181110152,-8.021587659059193
2022-12-21T09:30:00-05:00,131.45,132.67,130.95,131.94,5335112,4698372.9,35.22293583187633,42.058307058170044,NaN,NaN,-151.58158097579616,-191.889600104747,-1.0841666303602921,-2.590822246750207,-1.506655616389915,729945426,731062883,6.67755370074147,15.058714060411774,NaN,NaN,-20.797525468043336,-9.846721631771214
2022-12-22T09:30:00-05:00,130.45,130.54,126.63,128.55,6448606,4866359.1,30.61018074851023,40.17667521971324,NaN,NaN,-174.4084734928575,-192.49782154950825,-1.1810881742004244,-2.9830158341404456,-1.8019276599400211,723496820,727864358,6.049366682378022,13.373603386007659,NaN,NaN,-23.796390879125482,-11.839531524250395
2022-12-23T09:30:00-05:00,128.21,129.79,127.34,129.43,3275639,4961929.75,33.060839077338784,39.08182783284476,NaN,NaN,-139.54582047911947,-180.68397299392433,-1.1073347517723042,-3.1860960996554013,-2.078761347883097,726772459,726658135.8,5.826748766813054,11.948260487723331,NaN,NaN,-25.466286791919785,-13.786210848203165
2022-12-27T09:30:00-05:00,128.83,129.07,127.2501,127.33,4268096,5024308.75,30.30983120261571,38.06128274836072,NaN,NaN,-130.12381836774824,-162.52006040114463,-1.118124641572812,-3.4764171498491123,-2.3582925082763,722504363,725465876.4,5.6071059105526615,10.715072361011494,NaN,NaN,-27.75688612458,-15.782021601971284
2022-12-28T09:30:00-05:00,127.39,128.63,126,126.26,5036867,5015578.7,28.986341598894924,37.0451904881814,NaN,NaN,-122.94289866620554,-143.72051839634543,-1.113058391785597,-3.7496154980082963,-2.6365571062226993,717467496,724037312.8,5.347020410939976,9.795984951580863,NaN,NaN,-30.04970305163692,-17.820261809066373
2022-12-29T09:30:00-05:00,128.07,129.8,127.57,129.51,3746103,4792670,37.8616061373517,36.457478205084534,NaN,NaN,-87.07250960138282,-130.81870412146276,-0.820090209158943,-3.661669867671378,-2.841579658512435,721213599,722290947.4,5.039292312498333,9.026100022858753,NaN,NaN,-29.23627955632248,-19.451121487245818
2022-12-30T09:30:00-05:00,128.23,129.19,127.68,129.16,3765556,4739594.5,37.320654993029265,35.91093511377129,NaN,NaN,-82.00069334216059,-112.33714809132334,-0.5899029871257953,-3.578958392419679,-2.989055405293884,717448043,721081192,4.831841506792799,8.365085034468295,NaN,NaN,-28.749655996054795,-20.779483559932814
2023-01-03T09:30:00-05:00,129.93,130.3,126.83,128.39,4783631,4679463.1,36.098692579448326,35.21910017106267,NaN,NaN,-77.04374839555703,-99.83673367461087,-0.4365913600393574,-3.5347946053430803,-3.098203245303723,712664412,718259582.6,4.379039403577096,7.718982173282137,NaN,NaN,-28.703837012107414,-21.911534053100613
2023-01-04T09:30:00-05:00,129.59,131.21,127.9574,130.25,4039840,4591955.4,41.11431914221215,34.88552426855148,NaN,NaN,-53.632974916818256,-84.53856498442487,-0.17066517950170157,-3.31153471968085,-3.1408695401791484,716704252,717099560.4,4.204588453462563,7.079115727298647,NaN,NaN,-27.158999425890478,-22.661171963499164
2023-01-05T09:30:00-05:00,129.34,129.9,128.17,129.04,3888190,4588868.6,38.97134021425459,34.55715608500044,NaN,NaN,-59.44586933045197,-71.83915911727415,-0.04362591582737796,-3.195401934963371,-3.151776019135993,712816062,716169273.6,4.064738496175053,6.448785750126589,NaN,NaN,-26.47896531313871,-23.20657101344767
2023-01-06T09:30:00-05:00,128.68,132.58,127.765,132.07,4619865,4548546.35,46.49244813762424,35.08514321280576,NaN,NaN,-28.802188457940147,-60.1850948885856,0.26038843779316423,-2.826290471894538,-3.086678909687702,717435927,715413739.2,3.949833297270615,5.895299181702401,NaN,NaN,-23.50755766979131,-23.249569107211048
2023-01-09T09:30:00-05:00,133.67,135.025,132.77,132.87,4693885,4623065.15,48.303944380395514,36.049562743691034,NaN,NaN,22.64316476424949,-39.25632326730359,0.5164835462037756,-2.4410744769329824,-2.957558023136758,722129812,716350093,7.4419727308173265,5.684431543095134,NaN,NaN,-20.52058507590567,-22.859714245595995
2023-01-10T09:30:00-05:00,132.94,134.56,132.22,134.54,4415358,4663371.15,51.96018563445428,37.53459724303925,NaN,NaN,35.50914141012621,-16.745745306166945,0.7834630683525594,-1.9782291876960585,-2.761692256048618,726545170,719126244.6,17.06911991468816,6.275363401627841,NaN,NaN,-16.849963047469927,-22.001178360149414
2023-01-11T09:30:00-05:00,135.69,138.18,135.57,138.17,6354032,4817433.2,58.78387748209271,39.649799797149946,NaN,NaN,111.6317691266717,16.307203502531042,1.166566172724071,-1.303484540143529,-2.4700507128676,732899202,722365234.6,26.65447597192191,7.653049825616358,NaN,NaN,-11.27236299063027,-20.46849045021811
2023-01-12T09:30:00-05:00,139.03,139.19,136.18,138.4,4786339,4788145.05,59.1795192151555,41.360984324527024,NaN,NaN,135.14372334636982,55.225122037895424,1.3827314937063733,-0.7416363457346336,-2.124367839441007,737685541,727339130.4,38.42437104374442,9.920679635830854,NaN,NaN,-6.725839428258847,-18.505254589938215
2023-01-13T09:30:00-05:00,136.26,139.83,136.073,139.7,3984731,4714789.05,61.43298608467132,43.56261327710996,NaN,NaN,149.68378886045028,90.92231750157352,1.548065078373395,-0.18928649147426313,-1.737351569847658,741670272,732185999.4,47.29929573817947,12.867103139816672,NaN,NaN,-2.2175526524023783,-16.178440027433094
2023-01-17T09:30:00-05:00,140.11,140.92,139.4,139.8,3749889,4603543.5,61.608555493199965,45.6017358782429,NaN,NaN,167.4069102189623,119.87506659251608,1.5927617057471344,0.2536005623362598,-1.3391611434108746,745420161,736844069.2,54.14025287493359,16.318067718968138,NaN,NaN,1.48330731772381,-13.655333263839252
2023-01-18T09:30:00-05:00,141.22,142.03,137.92,137.98,4798499,4509174.7,56.56180149056125,47.476876613096145,NaN,NaN,134.7897029884178,139.7311789081744,1.433342213711192,0.4525166237281155,-0.9808255899830765,740621662,739659367.6,57.71306199445734,20.039921724961328,NaN,NaN,3.2763684275936193,-11.236518736491698
2023-01-19T09:30:00-05:00,136.97,137.4,134.99,135.69,6478626,4616210.5,50.91074861626096,49.042905685765156,NaN,NaN,65.10781372059378,130.4263878269588,1.1210825467817298,0.42052759349408575,-0.700554953287644,734143036,739908134.4,58.024254583131665,23.802581308689305,NaN,NaN,3.1624468693000454,-9.17952364995002
2023-01-20T09:30:00-05:00,135.99,139.06,135.32,138.98,3751294,4611007.9,57.48299584651768,50.444433522134155,NaN,NaN,84.8922750563848,120.37609816896182,1.0829421771670646,0.6531227681711869,-0.42981940899587784,737894330,739949892.2,58.080021153295135,27.59120479731765,NaN,NaN,5.151049270181122,-7.132298947074143
2023-01-23T09:30:00-05:00,139.35,141.68,138.54,141.15,4584149,4573459.75,61.17519629617402,52.148329329501635,NaN,NaN,112.60552692776209,112.96044578242416,1.1446698259809827,1.0010178734803503,-0.14365195250063223,742478479,740111533.6,58.31090717413158,31.41113805927042,NaN,NaN,8.030779978842476,-4.966144814800341
2023-01-24T09:30:00-05:00,140.66,141.66,139.75,140.99,3186475,4410353.2,60.756249853692466,53.90958342051908,NaN,NaN,105.72008600280274,100.62308093919225,1.1144528578585202,1.249414119822518,0.13496126196399783,739292004,738885902.2,55.80126066720664,35.08415386381539,NaN,NaN,10.184245161971592,-2.801803389547208
2023-01-25T09:30:00-05:00,138.85,141.9,137.8,141.71,3770193,4435080.9,62.016833025432746,55.4026201264634,NaN,NaN,90.25755440019951,91.71665122154859,1.0818102891695474,1.487224123425932,0.4054138342563847,743062197,739374009.2,56.60232801383481,38.826849546699115,NaN,NaN,12.331630064852597,-0.6398843246329502
2023-01-26T09:30:00-05:00,144.22,145.03,142.79,144.61,4820567,4462704.45,66.66190049499221,57.38051728937324,NaN,NaN,129.8222163300986,104.65953174344955,1.1860154210729272,1.8879331105975439,0.7019176895246166,747882764,742121954.8,60.89893394375736,42.88643493581214,NaN,NaN,15.706106801189538,1.695257264770262
2023-01-27T09:30:00-05:00,144.73,149.03,144.7,147.89,5472665,4484494.35,70.98403607145491,59.12991642750399,NaN,NaN,159.2527837488919,119.53163348195099,1.3920789785217411,2.442016412676793,1.0499374341550518,753355429,745214174.6,65.08768583308502,47.25342440265602,NaN,NaN,20.131176312295914,4.328959985845355
2023-01-30T09:30:00-05:00,146.78,147.75,145.25,145.37,4789220,4536650.2,64.10738498215312,60.25873361334383,NaN,NaN,132.2187027742494,123.45426865124844,1.2778679518682818,2.647272373990404,1.3694044221221222,748566209,746431720.6,66.60467145274188,51.47933145422206,NaN,NaN,21.615281704797013,6.7984345171241625
2023-01-31T09:30:00-05:00,145.53,148.7,145.53,148.7,3487788,4522761.8,68.45609221577857,61.43701265486699,NaN,NaN,143.09622565091263,130.92949658087042,1.339322965176195,3.043558128592366,1.704235163416171,752053997,748984119.2,69.58796576694665,55.230677586526234,NaN,NaN,24.37854344342969,9.309878649453523
2023-02-01T09:30:00-05:00,148.31,152.71,146.78,151.52,6956867,4631423.6,71.59474530204498,62.352074642006436,NaN,NaN,163.55611479643332,145.58920866011718,1.4720608792661332,3.5443112624988373,2.072250383232704,759010864,752173852.6,72.8518932405637,58.53049310571494,NaN,NaN,27.772317870869813,11.947369966798707
2023-02-02T09:30:00-05:00,154.81,158.025,154.1,156.16,7019836,4780423.4,75.85227427082032,63.542985717411064,NaN,NaN,209.86411284125722,161.5975879623489,1.7553122174283504,4.266390655018142,2.511078437589792,766030700,755803439.8,76.00734066849765,61.214990936054456,NaN,NaN,32.28323287364853,14.852493239205824
2023-02-03T09:30:00-05:00,151.48,154.95,150.68,151.35,6796853,4925856.55,64.97935637924607,63.796297881309265,NaN,NaN,135.4022140653479,156.8274740256401,1.5109763159888159,4.3997988325758115,2.8888225165869956,759233847,756979123.4,76.94222256955102,63.33234285258099,NaN,NaN,31.993329861569492,17.301184185257775
2023-02-06T09:30:00-05:00,150.78,152.05,149.87,151.13,4385136,4914120.1,64.52378167434475,64.0045283228196,NaN,NaN,103.56496347153329,151.09672616509687,1.2382467017894463,4.4366308938238035,3.198384192034357,754848711,758235623.8,77.93191416771599,65.03174723063687,NaN,NaN,31.618666893722942,19.346538857895656
2023-02-07T09:30:00-05:00,150.47,151.8617,147.655,151.48,4916600,4925255.85,64.94486293418026,64.60331842593524,NaN,NaN,84.5754756001803,139.3925761549504,0.9955712492216633,4.442848253561436,3.447277004339773,759765311,759777886.6,79.116757187384,66.56058260156021,NaN,NaN,31.462529642145228,21.077394684217023
2023-02-08T09:30:00-05:00,150.98,151.35,149.15,150.19,5564043,4982690.1,62.02282090173925,65.39703787489798,NaN,NaN,75.12630681034683,121.70661455773313,0.6775245342231369,4.294182672118694,3.6166581378955573,754201268,758815967.4,76.36288750282674,67.870484952967,NaN,NaN,30.41723224364122,22.411657192706194
2023-02-09T09:30:00-05:00,152.19,153.19,149.17,149.91,4158092,4872893.1,61.37731157683555,65.67520328420639,NaN,NaN,73.54679138907609,94.44315026729689,0.3918207314577886,4.106434052217793,3.7146133207600043,750043176,755618462.6,67.90201996147142,68.57205629640816,NaN,NaN,29.387118222811488,23.40815162557838
2023-02-10T09:30:00-05:00,148.6,149.31,146.95,148.15,3216695,4794410.9,57.33777833125602,65.40110200099797,NaN,NaN,35.97242285799154,74.55719202582561,0.0460227237836115,3.7721417254895186,3.726119001705907,746826481,753136989.4,62.147133942316835,68.84607249413568,NaN,NaN,27.30405767523306,23.964709632671905
2023-02-13T09:30:00-05:00,148.14,150.385,147.14,150.32,3360818,4763215.25,60.76635403494091,65.40182372823,NaN,NaN,46.246688204307915,63.093536972380534,-0.06861534063632169,3.640349825910505,3.7089651665468266,750187299,752204707,60.08671711140512,69.15217652586415,NaN,NaN,26.511852448485467,24.32858717778813
2023-02-14T09:30:00-05:00,149.26,152.525,148.33,152.12,4361298,4793785.7,63.39430008418437,65.50021423242654,NaN,NaN,64.53806605612272,59.086055063569006,-0.05581346154124933,3.6391983396202647,3.695011801161514,754548597,751161364.2,57.778051179009275,69.23615675194803,NaN,NaN,26.616051949011005,24.655367859391397
2023-02-15T09:30:00-05:00,151.69,153.93,151.1,153.9,3411511,4724436.3,65.83162947143532,65.44090915931534,NaN,NaN,87.5987904188558,61.58055178527081,0.03504506646320271,3.7388181342405176,3.703773067777315,757960108,751913132.2,59.00042343614718,69.10054885854731,NaN,NaN,27.43007275611201,25.051754273208626
2023-02-16T09:30:00-05:00,151.54,153.69,150.51,150.54,5628901,4681950.05,57.983376870625264,64.51229064497036,NaN,NaN,62.56243277625547,59.38368006270669,-0.1580376311972902,3.506226028780702,3.6642636599779923,752331207,752370738.4,59.76403479755319,68.72028807029504,NaN,NaN,25.688785314023338,25.142758707610728
2023-02-17T09:30:00-05:00,149.68,150.64,148.045,150.57,3740078,4681389.25,58.03148612425953,64.07829786940654,NaN,NaN,24.415200051387384,57.072235501385855,-0.3022653941123976,3.286431917337495,3.588697311449893,756071285,754219699.2,62.780408201601105,68.44712640949926,NaN,NaN,24.318718763447674,25.025038715587435
2023-02-21T09:30:00-05:00,148.32,148.72,145.5,145.54,4418791,4673121.35,48.08919653341243,62.623519606380384,NaN,NaN,-50.72725351079385,37.6774471583655,-0.7305396276915883,2.6755227768354075,3.406062404526996,751652494,754512738.2,63.25063023776658,67.9944595859864,NaN,NaN,19.766495857550442,24.273818307296438
2023-02-22T09:30:00-05:00,145.87,147.24,145.22,146.28,4964246,4762009.9,49.461018090720565,61.04253909128578,NaN,NaN,-72.52228489325067,10.265376968490827,-0.9445048753622052,2.2254313103242396,3.1699361856864448,756616740,754926366.8,63.94308242110498,67.35811595602506,NaN,NaN,16.540378899195712,23.169041248996333
2023-02-23T09:30:00-05:00,146.79,146.98,143.69,146.16,5284323,4837716.4,49.23380284713761,59.14121970387987,NaN,NaN,-107.36204124543698,-28.726789364367725,-1.065659463895161,1.8378618558174935,2.9035213197126546,751332417,753600828.6,60.03882496206425,66.21750769127982,NaN,NaN,13.891744334336096,21.843713118330584
2023-02-24T09:30:00-05:00,143.45,144.14,142.68,143.86,5957288,4894552.45,44.96971788744382,57.71195981160828,NaN,NaN,-162.84710562542998,-73.80869704470481,-1.2589846592360705,1.3297904956675666,2.588775154903637,745375129,752209613,56.16285058284638,64.73326683508664,NaN,NaN,10.294144483030298,20.193774741859116
2023-02-27T09:30:00-05:00,145.49,146.73,145.039,145.64,5622337,4902036.05,48.674578245638976,56.57987385241501,NaN,NaN,-94.53447784325166,-97.59863262363262,-1.224165017471825,1.058568883063856,2.282733900535681,750997466,751194849.2,53.452223935117935,62.984717532758204,NaN,NaN,8.32023976803178,18.49755545988378
2023-02-28T09:30:00-05:00,145.55,146.61,144.97,145.54,5592583,4942204.2,48.47712166553205,55.403606618940145,NaN,NaN,-95.61568188304997,-106.57631829808386,-1.1653610031472958,0.8260326466015613,1.9913936497488571,745404883,749945327,50.2370227854763,60.92187936119337,NaN,NaN,6.665288978908521,16.807231676887316
2023-03-01T09:30:00-05:00,145.02,145.5,142.87,143.71,6344416,5085035.6,44.88840355059774,54.17971966528717,NaN,NaN,-125.09550010455239,-117.0909613403442,-1.2023551173065465,0.48844975311567396,1.6908048704222205,739060467,746434072.4,42.50059603438591,58.503144256304736,NaN,NaN,4.187648237011074,15.004434042619282
2023-03-02T09:30:00-05:00,141.41,143.45,141.03,143.23,5491848,5011784.65,43.96896316280502,52.93626620714214,NaN,NaN,-136.36582705052527,-122.89171850136185,-1.2085600932095253,0.18010475391031378,1.388664847119839,733568619,742881312.8,36.393574863142995,56.252541034995566,NaN,NaN,1.8715599254405808,13.12830916873661
2023-03-03T09:30:00-05:00,144.48,146.56,144.15,146.31,5017622,4911673.95,50.91633526420644,52.47759170235288,NaN,NaN,-59.885631793658554,-102.29942373500757,-0.9651963225382456,0.18216944394703205,1.1473657664852777,738586241,741523535.2,34.36143675159164,54.26784837851519,NaN,NaN,1.7908135050602454,11.508666931068559
2023-03-06T09:30:00-05:00,146.68,147.19,145.19,145.24,4927198,4818191.2,48.65911544119101,51.61278894565646,NaN,NaN,-48.99544943891099,-93.19161805413944,-0.8408086546475474,0.09635494817584345,0.9371636028233908,733659043,738055850.6,29.786878786461344,52.10357421244778,NaN,NaN,1.0707657833781854,10.01753819568422
2023-03-07T09:30:00-05:00,145.02,145.74,143.185,143.26,5970907,4897479.75,44.70926756740067,50.278143765886206,NaN,NaN,-85.71437327761788,-91.21135633305302,-0.8536712111933537,-0.12992541116830125,0.7237458000250524,727688136,734512501.2,25.98071103273992,49.8323356305714,NaN,NaN,-0.7216648373035844,8.48336633382882
2023-03-08T09:30:00-05:00,143,143.3,141.53,143,5408306,4922065.05,44.20186854132803,48.7331608423071,NaN,NaN,-111.35116776613158,-88.46248986536885,-0.8401732018320862,-0.3264707022650555,0.5137024995670307,722279830,731156373.8,22.98489833385625,47.2597981232649,NaN,NaN,-2.331407045062803,6.938398708272874
2023-03-09T09:30:00-05:00,142.75,144.23,139.465,139.59,6668682,4977297,38.09539754813768,47.31259089070085,NaN,NaN,-137.23432007823604,-88.63618847091102,-1.0099712047535256,-0.7487615063748763,0.2612096983786493,715611148,727564879.6,20.28876891755897,44.44013627469389,NaN,NaN,-5.6817265297211055,5.135523674273735
2023-03-10T09:30:00-05:00,140.05,141.5,137.73,138.2,14529366,5495860.7,35.91720008223585,45.7329990305563,NaN,NaN,-170.647513234556,-110.78856475909052,-1.1545408956653995,-1.1819664212031,-0.027425525537700557,701081782,720063987.8,16.05342820773241,41.10249484656041,NaN,NaN,-9.16189541356019,3.0930352331546027
2023-03-13T09:30:00-04:00,136.16,140.26,135.71,138.49,11814122,5925732.05,36.730012570467316,44.921628747488796,NaN,NaN,-168.63705173359944,-134.71688521802818,-1.1658742798210773,-1.4847683753140473,-0.31889409549296993,712895904,715911360,14.276575265313511,37.60434806281376,NaN,NaN,-11.763783453581855,0.9706325636208235
2023-03-14T09:30:00-04:00,140.37,141.24,139.08,140.84,7519125,6133647.4,43.035357021522074,44.462652956831754,NaN,NaN,-103.54861801920279,-138.28373416634517,-0.9589819626130025,-1.517621548759223,-0.5586395861462206,720415029,714456738.6,13.704366749374387,34.01586837197586,NaN,NaN,-12.20407330879339,-0.9114682752954926
2023-03-15T09:30:00-04:00,138.75,140.71,137.9921,140.63,9001425,6365653.75,42.626541588243235,43.99070572405359,NaN,NaN,-105.52622883082974,-137.1187463792848,-0.7873431461642044,-1.542818518851476,-0.7554753726872716,711413604,712283493.4,12.874148578338676,30.646962915995466,NaN,NaN,-12.677984131251554,-2.592399111860644
2023-03-16T09:30:00-04:00,139.75,143.78,139.64,143.17,10748673,6732511.85,48.94406955054794,44.27458798570388,NaN,NaN,-45.553308542438934,-118.78254407212538,-0.4695050416036567,-1.3423566746918425,-0.8728516330881858,722162277,713593719.2,16.171367218538492,27.790428389973474,NaN,NaN,-11.215598532544382,-3.8242847433868925
2023-03-17T09:30:00-04:00,143.13,143.22,140.19,141.34,8440207,6873077.15,45.091643878757246,44.018664102355196,NaN,NaN,-53.43642565477934,-95.34032655617004,-0.3545067481714479,-1.3159850683024956,-0.9614783201310477,713722070,716121776.8,22.282804154070874,25.564041262755833,NaN,NaN,-11.09808754265334,-4.863399428996385
2023-03-20T09:30:00-04:00,140.74,142.39,139.75,141.52,5865029,6979324.7,45.54566157046484,43.809274095564675,NaN,NaN,-56.2662445613734,-72.86616512172483,-0.24359142239975617,-1.265967598130743,-1.0223761757309868,719587099,717460015.8,25.38389800485453,23.788818064139996,NaN,NaN,-10.872185818942384,-5.7217974847029565
2023-03-21T09:30:00-04:00,143.35,145.65,143.29,145.43,6388423,7077806.3,54.371559419825935,44.48664237193812,NaN,NaN,55.86833418201031,-40.98277468148222,0.09754549385172895,-0.9004443084163256,-0.9979898022680546,725975522,718572114.4,27.95658169759284,22.74995989722621,NaN,NaN,-7.857701346754456,-6.026926607853171
2023-03-22T09:30:00-04:00,145.5,146.56,142.13,142.19,5492358,7104211.9,47.50113821819372,44.738940590180164,NaN,NaN,25.113241528873104,-14.854880609541643,0.10857925982241123,-0.8622657274900405,-0.9708449873124517,720483164,720386026.4,32.07062678430847,22.44117789159517,NaN,NaN,-7.439425455538356,-6.228712157522483
2023-03-23T09:30:00-04:00,143.91,144.96,140.63,142.04,6127786,7146385.05,47.20375323301564,44.473756159380834,NaN,NaN,-6.318809952982143,-7.00798089165028,0.10908146521334594,-0.8344931557957693,-0.9435746210091153,714355378,718824646.6,30.458284651005968,22.16238131298191,NaN,NaN,-7.202508588357827,-6.367825933356103
2023-03-24T09:30:00-04:00,141.71,141.83,139.78,141.58,4717403,7084390.8,46.24753964570719,44.3015007454177,NaN,NaN,-54.278631244060165,-7.176422009506444,0.08292427151905823,-0.8399192816102925,-0.9228435531293507,709637975,718007827.6,29.619351682474274,22.15041509126855,NaN,NaN,-7.291092398565036,-6.499721142671665
2023-03-27T09:30:00-04:00,142.94,143.47,141.28,141.87,4207320,7013639.95,46.97677773650538,44.4634657574966,NaN,NaN,-8.029465504888654,2.4709338017905043,0.08910293294731852,-0.8114648869452026,-0.9005678198925211,713845295,716859466.8,28.43360751744092,22.325621983032907,NaN,NaN,-7.157480939997112,-6.593686828003872
2023-03-28T09:30:00-04:00,141.83,142.21,140.74,141.7,2859759,6876998.75,46.57785745927744,44.633179251635845,NaN,NaN,-27.557148965485517,-14.214162827708662,0.08566597731100278,-0.7934853482537676,-0.8791513255647704,710985536,713861469.6,25.557105632369826,22.509351075783876,NaN,NaN,-7.1542177679677605,-6.673762676570141
2023-03-29T09:30:00-04:00,143.24,144.44,142.74,144.39,3862941,6752925,53.3311835043735,45.72144967708126,NaN,NaN,69.84802852130282,-5.267205429222718,0.25870557850557274,-0.5557693524328045,-0.8144749309383772,714848477,712734532.2,24.551641716883637,22.813841990021356,NaN,NaN,-5.185171737165655,-6.4611068280837864
2023-03-30T09:30:00-04:00,145.77,146.38,145.07,145.65,3239185,6640291.85,56.12874367142652,47.165131362023445,NaN,NaN,127.15254120977353,21.427064803328413,0.44143734317023264,-0.26267825197558636,-0.704115595145819,718087662,713480989,26.611200419512613,23.56796857657708,NaN,NaN,-2.678708244282656,-5.920764173255053
2023-03-31T09:30:00-04:00,146.58,149.63,146.37,149.54,5223705,6650596,63.419408197619454,49.07151676396289,NaN,NaN,210.00646023078252,74.28408309829693,0.7874991979177113,0.28025840225132015,-0.5072407956663911,723311367,716215667.4,33.746607678066226,24.958685177487986,NaN,NaN,2.0480944037529065,-4.782355805111059
2023-04-03T09:30:00-04:00,148.19,148.89,147.14,148.17,5669193,6687695.75,59.65913299704242,50.25892933364292,NaN,NaN,178.69957461406685,111.62989112208804,0.880316272985772,0.5931545455658238,-0.28716172741994817,717642174,716975043.2,35.61851836903038,26.52398172174913,NaN,NaN,4.793367143133883,-3.41439538393321
2023-04-04T09:30:00-04:00,148.66,149,146.64,147.93,4691733,6623737.05,58.999171323544026,51.428402886164406,NaN,NaN,147.74181364606306,146.68968364439775,0.8796463431275972,0.8123962014895483,-0.06725014163804888,712950441,717368024.2,36.61656822923895,28.21986883967058,NaN,NaN,6.797851814137005,-1.9555029270660367
2023-04-05T09:30:00-04:00,147.31,147.36,144.59,144.9,4430824,6574862.95,51.28563413803776,51.59565749955653,NaN,NaN,72.78957920786947,147.27799378171107,0.6403595145546379,0.7331992515552486,0.09283973700061063,708519617,716102252.2,34.748078644764604,29.54677679868673,NaN,NaN,6.175236442328192,-0.7939687314382897
2023-04-06T09:30:00-04:00,144.23,145.19,142.89,144.93,3818138,6432335.75,51.3534487111873,52.04292927330153,NaN,NaN,33.56160111542728,128.55980576284182,0.4578785900183041,0.6651879745234908,0.20730938450518666,712337755,714952270.8,33.095717920046255,30.319127781970682,NaN,NaN,5.70091462922622,0.1338717486566402
2023-04-10T09:30:00-04:00,143.45,145.62,142.59,145.57,3638373,5887786.1,52.861059372049866,52.565457687700466,NaN,NaN,34.90551971182175,93.53961765904967,0.3584536342212862,0.6553764272817943,0.29692279306050817,715976128,713485223,31.066167350201226,30.72500416378116,NaN,NaN,5.738673773156298,0.9345577521565912
2023-04-11T09:30:00-04:00,145.65,146.62,145.14,145.8,4404143,5517287.15,53.41975014881736,52.497471311199845,NaN,NaN,64.65253521051027,70.73020977833836,0.2893163405380805,0.6585682187331088,0.3692518781950283,720380271,714032842.4,32.724621481873854,31.065578434086948,NaN,NaN,5.923441766314249,1.647255468464828
2023-04-12T09:30:00-04:00,147.01,147.06,143.38,143.54,4531332,5367897.5,47.46662121345607,52.49500581086145,NaN,NaN,22.445347553313635,45.670916559788466,0.08322166450837021,0.4732789588304911,0.3900572943221209,715848939,714612542,34.520533394117535,31.24057176335902,NaN,NaN,4.356520177059153,2.034293283978303
2023-04-13T09:30:00-04:00,144.58,146.84,144.11,146.71,6570029,5246327.7,55.03575599542376,53.05443457960489,NaN,NaN,56.981476866857435,42.509296091586066,0.1484288135245479,0.5755933112278058,0.4271644977032579,722418968,717392412.2,42.45379491231732,32.09739392488126,NaN,NaN,5.275872377166336,2.4973760115765935
2023-04-14T09:30:00-04:00,146.38,147.8,145.68,146.9,5400808,4978934.45,55.45007693698152,53.711758671838766,NaN,NaN,81.38651896190402,52.074279660881416,0.18974948652186308,0.6643513558555867,0.4746018693337236,727819776,720488816.4,49.755921194720905,33.53572031861316,NaN,NaN,6.135356678425356,3.0170875354121307
2023-04-17T09:30:00-04:00,147.27,148.26,146.53,147.94,4551234,4784485.8,57.745220471622616,54.48093315291857,NaN,NaN,99.3734798113027,64.9678716807776,0.26774501793365846,0.8092831417507966,0.5415381238171382,732371010,723767792.8,56.107584369141144,35.51243295087746,NaN,NaN,7.535501179299365,3.6625751988245927
2023-04-18T09:30:00-04:00,148.68,149.02,147.54,148.18,4529399,4717704.3,58.27938637832201,55.31675664713604,NaN,NaN,111.33604458503551,74.30457355568265,0.312974609342219,0.9327563854949119,0.6197817761526929,736900409,727071820.4,61.40242239928691,38.07281271994297,NaN,NaN,8.83593487166485,4.401626580658915
2023-04-19T09:30:00-04:00,146.8,148.885,146.66,148.04,3800223,4588294.3,57.82020797627172,55.63740125227163,NaN,NaN,87.1167484412896,87.23885373327785,0.3103320897248174,1.0076968883087147,0.6973647985838973,733100186,730522069.8,66.01311402812252,41.03434645646003,NaN,NaN,9.791630275269075,5.171627108460366
2023-04-20T09:30:00-04:00,145.61,147.01,144.94,145.76,4143578,4520855.3,50.800401758714514,55.25680540136363,NaN,NaN,16.755369814743574,79.19363232285507,0.14054567342217916,0.8730468903616213,0.7325012169394421,728956608,731829597.8,67.59301493688517,43.96161892198664,NaN,NaN,8.658771706539072,5.66979062247161
2023-04-21T09:30:00-04:00,146.95,147.96,145.82,147.37,4435299,4436230.95,54.95884436022414,54.65247941297825,NaN,NaN,53.29308802862677,73.57494613619963,0.1228275655254133,0.8860356738462087,0.7632081083207954,733391907,732944024,68.91917519529495,46.47394517321727,NaN,NaN,8.879043399378164,6.1282553048868325