time,open,high,low,close,Volume,Volume MA,RSI,RSI-based MA,Upper Bollinger Band,Lower Bollinger Band,CCI,Smoothing Line,Histogram,MACD,Signal,OnBalanceVolume,Smoothing Line,RSI,RSI-based MA,Upper Bollinger Band,Lower Bollinger Band,True Strength Index,Signal
1998-12-22T09:30:00-05:00,23.3125,23.39101,23.188,23.26601,15200,NaN,NaN,NaN,NaN,NaN,NaN,NaN,NaN,NaN,NaN,NaN,NaN,NaN,NaN,NaN,NaN,NaN,NaN
1998-12-23T09:30:00-05:00,23.34375,23.75,23.3125,23.75,67800,NaN,NaN,NaN,NaN,NaN,NaN,NaN,NaN,NaN,NaN,67800,NaN,NaN,NaN,NaN,NaN,NaN,NaN
1998-12-24T09:30:00-05:00,23.8125,23.8125,23.59375,23.625,12300,NaN,NaN,NaN,NaN,NaN,NaN,NaN,NaN,NaN,NaN,55500,NaN,NaN,NaN,NaN,NaN,NaN,NaN
1998-12-28T09:30:00-05:00,23.75,23.75,23.34375,23.5,13500,NaN,NaN,NaN,NaN,NaN,NaN,NaN,NaN,NaN,NaN,42000,NaN,NaN,NaN,NaN,NaN,NaN,NaN
1998-12-29T09:30:00-05:00,23.5625,23.73437,23.34375,23.73437,22000,NaN,NaN,NaN,NaN,NaN,NaN,NaN,NaN,NaN,NaN,64000,NaN,NaN,NaN,NaN,NaN,NaN,NaN
1998-12-30T09:30:00-05:00,23.71875,23.71875,23.35937,23.375,21800,NaN,NaN,NaN,NaN,NaN,NaN,NaN,NaN,NaN,NaN,42200,54300,NaN,NaN,NaN,NaN,NaN,NaN
1998-12-31T09:30:00-05:00,23.34375,23.34375,23.21875,23.34375,13000,NaN,NaN,NaN,NaN,NaN,NaN,NaN,NaN,NaN,NaN,29200,46580,NaN,NaN,NaN,NaN,NaN,NaN
1999-01-04T09:30:00-05:00,23.28125,23.75,23.28125,23.32812,28600,NaN,NaN,NaN,NaN,NaN,NaN,NaN,NaN,NaN,NaN,600,35600,NaN,NaN,NaN,NaN,NaN,NaN
1999-01-05T09:30:00-05:00,23.46875,23.46875,23.17187,23.20312,42700,NaN,NaN,NaN,NaN,NaN,NaN,NaN,NaN,NaN,NaN,-42100,18780,NaN,NaN,NaN,NaN,NaN,NaN
1999-01-06T09:30:00-05:00,23.46875,24,23.3125,23.96875,56400,NaN,NaN,NaN,NaN,NaN,NaN,NaN,NaN,NaN,NaN,14300,8840,NaN,NaN,NaN,NaN,NaN,NaN
1999-01-07T09:30:00-05:00,23.96875,23.98437,23.57812,23.85937,72600,NaN,NaN,NaN,NaN,NaN,NaN,NaN,NaN,NaN,NaN,-58300,-11260,NaN,NaN,NaN,NaN,NaN,NaN
1999-01-08T09:30:00-05:00,24,24.5625,23.375,23.96875,421100,NaN,NaN,NaN,NaN,NaN,NaN,NaN,NaN,NaN,NaN,362800,55460,NaN,NaN,NaN,NaN,NaN,NaN
1999-01-11T09:30:00-05:00,23.75,23.78125,23.4375,23.51562,35000,NaN,NaN,NaN,NaN,NaN,NaN,NaN,NaN,NaN,NaN,327800,120900,NaN,NaN,NaN,NaN,NaN,NaN
1999-01-12T09:30:00-05:00,23.5,23.59375,23.125,23.15625,89200,NaN,NaN,NaN,NaN,NaN,NaN,NaN,NaN,NaN,NaN,238600,177040,NaN,NaN,NaN,NaN,NaN,NaN
1999-01-13T09:30:00-05:00,22.75,23.1875,22.6875,22.8125,42400,NaN,43.7708948561225,NaN,NaN,NaN,NaN,NaN,NaN,NaN,NaN,196200,213420,NaN,NaN,NaN,NaN,NaN,NaN
1999-01-14T09:30:00-05:00,22.75,22.875,22.375,22.375,70000,NaN,38.75488907494631,NaN,NaN,NaN,NaN,NaN,NaN,NaN,NaN,126200,250320,NaN,NaN,NaN,NaN,NaN,NaN
1999-01-15T09:30:00-05:00,22.5625,22.75,22.45312,22.71875,10700,NaN,44.168661270679785,NaN,NaN,NaN,NaN,NaN,NaN,NaN,NaN,136900,205140,NaN,NaN,NaN,NaN,NaN,NaN
1999-01-19T09:30:00-05:00,22.8125,22.8125,22.53125,22.71875,12800,NaN,44.168661270679785,NaN,NaN,NaN,NaN,NaN,NaN,NaN,NaN,136900,166960,NaN,NaN,NaN,NaN,NaN,NaN
1999-01-20T09:30:00-05:00,22.59375,22.8125,22.51562,22.53125,15800,NaN,41.829607155191034,NaN,NaN,NaN,NaN,NaN,NaN,NaN,NaN,121100,143460,NaN,NaN,NaN,NaN,NaN,NaN
1999-01-21T09:30:00-05:00,22.53125,22.90625,22.5,22.71875,23900,54340,44.96812790192717,NaN,NaN,NaN,-106.05438020166675,NaN,NaN,NaN,NaN,145000,133220,58.882585989555196,NaN,NaN,NaN,NaN,NaN
1999-01-22T09:30:00-05:00,22.75,22.8125,22.5625,22.59375,19300,54545,43.2911938114112,NaN,NaN,NaN,-98.92798869340528,NaN,NaN,NaN,NaN,125700,133120,58.86831517938136,NaN,NaN,NaN,NaN,NaN
1999-01-25T09:30:00-05:00,22.6875,22.6875,22.375,22.5625,18200,52065,42.86086854569354,NaN,NaN,NaN,-101.81609196466367,NaN,NaN,NaN,NaN,107500,127240,57.978518304400275,NaN,NaN,NaN,NaN,NaN
1999-01-26T09:30:00-05:00,22.59375,22.59375,22.15625,22.34375,25700,52735,39.87301642838699,NaN,NaN,NaN,-112.5935999944922,NaN,NaN,NaN,NaN,81800,116220,56.262134430071676,NaN,NaN,NaN,NaN,NaN
1999-01-27T09:30:00-05:00,22.375,22.375,21.875,21.9375,37100,53915,34.99410417977825,NaN,NaN,NaN,-135.88115278967666,-111.05464272878092,NaN,NaN,NaN,44700,100940,53.88034100509533,NaN,NaN,NaN,NaN,NaN
1999-01-28T09:30:00-05:00,22,22,21.625,21.8125,30800,54355,33.63052945560433,NaN,NaN,NaN,-149.6105904819982,-119.7658847848472,NaN,NaN,NaN,13900,74720,49.97103013733085,NaN,NaN,NaN,NaN,NaN
1999-01-29T09:30:00-05:00,21.6875,21.8125,21.4375,21.8125,18600,54195,33.63052945560433,NaN,NaN,NaN,-147.85119260408575,-129.55052556698328,NaN,-0.6115732240249869,NaN,13900,52360,46.84929046074924,NaN,NaN,NaN,NaN,NaN
1999-02-01T09:30:00-05:00,21.8125,21.875,21.59375,21.59375,23100,54700,31.165797362876134,NaN,NaN,NaN,-132.30117554578064,-135.6475422832067,NaN,-0.6312955857901521,NaN,-9200,29020,43.775176101326984,NaN,NaN,NaN,NaN,NaN
1999-02-02T09:30:00-05:00,21.625,21.8125,21.53125,21.625,26500,54595,31.933260643120377,39.217152958001556,NaN,NaN,-125.83771735339656,-138.29636575498756,NaN,-0.6370604494433145,NaN,17300,16120,42.129746195120376,NaN,NaN,NaN,NaN,NaN
1999-02-03T09:30:00-05:00,21.75,22.25,21.75,22.125,29400,53930,42.90246960836974,39.155122583162076,NaN,NaN,-73.80746286318559,-125.88162776968935,NaN,-0.5944310924827612,NaN,46700,16520,42.202292794485956,NaN,NaN,NaN,NaN,NaN
1999-02-04T09:30:00-05:00,22.125,22.3125,22.0625,22.25,26000,52410,45.27677583917465,39.620971637749804,NaN,NaN,-47.42545548282922,-105.44460076985555,NaN,-0.5442863701634373,NaN,72700,28280,44.40877256230232,NaN,NaN,NaN,NaN,NaN
1999-02-05T09:30:00-05:00,22.3125,22.9375,22.1875,22.875,66000,52080,55.28820730284888,40.41522492576189,NaN,NaN,21.822750316526708,-71.50981218573307,NaN,-0.44893895102250525,NaN,138700,53240,48.8703090514444,NaN,NaN,NaN,NaN,NaN
1999-02-08T09:30:00-05:00,22.96875,23.1875,22.9375,23.1875,31100,32580,59.297773231073855,41.49587578007574,NaN,NaN,98.81834141757557,-25.28590879306182,NaN,-0.3441916687779276,NaN,169800,89040,54.50956036116984,NaN,NaN,NaN,NaN,NaN
1999-02-09T09:30:00-05:00,23.21875,23.21875,22.75,22.75,64300,34045,52.23536770802992,42.23914439099281,NaN,NaN,78.02719377387136,15.487073432391753,NaN,-0.2931025824748801,NaN,105500,106680,57.02472918437887,51.11520012548662,NaN,NaN,NaN,NaN
1999-02-10T09:30:00-05:00,22.84375,23.0625,22.6875,22.8125,69300,33050,53.09481988805616,42.81962239000203,NaN,NaN,76.32829449605727,45.514224904240315,0.2385426002860444,-0.24474956520069568,-0.4832921654867401,174800,132300,60.44538513637029,51.22682863597341,NaN,NaN,NaN,NaN
1999-02-11T09:30:00-05:00,22.71875,22.71875,22.28125,22.625,216800,41770,50.17784162212217,43.31152580505282,NaN,NaN,25.793690386222636,60.15805407805069,0.21140633780422513,-0.2190342432314587,-0.43044058103568383,-42000,109360,56.136774953544055,51.03171861984218,NaN,NaN,NaN,NaN
1999-02-12T09:30:00-05:00,22.375,22.625,22.15625,22.15625,242300,50385,43.71224190009119,43.37233818750978,NaN,NaN,-13.76035487019924,53.0414330407055,0.15732529933618294,-0.23378395686545517,-0.3911092562016381,-284300,24760,43.75098918632359,50.015466539979556,NaN,NaN,NaN,NaN
1999-02-16T09:30:00-05:00,22.32812,22.4375,21.78125,22,36600,51680,41.77971418363983,43.508530884313565,NaN,NaN,-51.73020901047613,22.93172295509516,0.10877525845039904,-0.2551401831386393,-0.3639154415890383,-320900,-73380,34.29738375906663,48.44655577776491,NaN,NaN,NaN,NaN
1999-02-17T09:30:00-05:00,21.875,22.09375,21.75,21.78125,41700,53125,39.168895597461386,43.806730271290924,NaN,NaN,-78.44490713298975,-8.36269722627706,0.06200048825873139,-0.28641483126562406,-0.34841531952435545,-362600,-167000,28.067022791642074,46.602747333946816,NaN,NaN,-5.403817588640771,NaN
1999-02-18T09:30:00-05:00,21.75,21.96875,21.53125,21.84375,83000,56485,40.31647393908717,44.28429773439684,NaN,NaN,-85.07596067917724,-40.643548261323964,0.03659784038508668,-0.3026680190429971,-0.3392658594280838,-279600,-257880,23.587614908228232,44.71821767472521,NaN,NaN,-7.096278286748476,NaN
1999-02-19T09:30:00-05:00,21.9375,21.96875,21.53125,21.71875,130300,61805,38.74228605882709,44.64942320605561,NaN,NaN,-83.81309412237182,-62.564905163042866,0.01387324766395348,-0.32192429984814197,-0.33579754751209545,-409900,-331460,20.706229022827443,42.85085614344508,NaN,NaN,-8.970800757435967,NaN
1999-02-22T09:30:00-05:00,21.875,22,21.6875,21.9375,79500,64815,42.94104163620516,45.49051208272197,NaN,NaN,-55.28098114588964,-70.86903041818093,0.015924170730543974,-0.3158923340989155,-0.33181650482945946,-330400,-340680,20.370434575289778,41.17908889158527,NaN,NaN,-9.399463096879913,NaN
1999-02-23T09:30:00-05:00,22,22.09375,21.75,21.75,309600,79385,40.385830894722346,46.094267100693536,NaN,NaN,-52.28208005985703,-70.97940462805711,0.007434174003084215,-0.32252378732560416,-0.3299579613286884,-640000,-404500,18.173479641097558,39.46792699486936,NaN,NaN,-10.518215422287923,NaN
1999-02-24T09:30:00-05:00,21.8125,22.09375,21.65625,21.65625,34500,79825,39.13199464237586,45.82494746026541,NaN,NaN,-58.64414731409792,-67.01925266427875,-0.001251645385650313,-0.3315225180607513,-0.33027087267510097,-674500,-466880,16.320665058414406,37.61923929943568,NaN,NaN,-11.810526172132588,NaN
1999-02-25T09:30:00-05:00,21.64062,21.90625,21.625,21.76562,44600,80200,41.417039520664396,45.54925200894325,NaN,NaN,-60.83035004038665,-62.17013053652063,0.0033606190078958043,-0.3260700989152312,-0.329430717923127,-629900,-536940,14.52906530805879,35.48497449556114,NaN,NaN,-12.29004784895584,NaN
1999-02-26T09:30:00-05:00,21.84375,22,21.625,21.625,24900,79905,39.370544689907184,44.41227610801884,NaN,NaN,-62.66019961712875,-57.939551635472014,0.00010464486028316511,-0.3292999118477731,-0.32940455670805624,-654800,-585920,13.419924828979049,32.952804193956474,NaN,NaN,-13.272809098323954,NaN
1999-03-01T09:30:00-05:00,21.67187,21.6875,21.34375,21.40625,13300,79640,36.36066543494122,42.77391126543794,NaN,NaN,-106.01301559679627,-68.08595852565334,-0.012898617807630075,-0.3455278289675938,-0.33262921115996374,-668100,-653460,12.053490770834685,29.920227794646816,NaN,NaN,-14.997548400945421,NaN
1999-03-02T09:30:00-05:00,21.4375,21.53125,21.09375,21.1875,55100,81240,33.594780306966385,41.442440736790545,NaN,NaN,-133.0929519005847,-84.24813289379887,-0.03130024100868051,-0.37175451242081436,-0.34045427141213386,-723200,-670100,11.73642356971078,26.68534882217053,NaN,NaN,-17.314116169179535,NaN
1999-03-03T09:30:00-05:00,21.375,21.75,21.21875,21.65625,103300,85080,43.51096048616016,40.75787935094082,NaN,NaN,-86.64794098554671,-89.84889162808862,-0.008174825057549406,-0.35067280273407064,-0.34249797767652124,-619900,-659180,13.347344977680521,23.32120309654983,NaN,NaN,-16.468496637228217,NaN
1999-03-04T09:30:00-05:00,21.84375,22.5625,21.84375,22.4375,90400,88130,55.45116955897775,41.1345456321448,NaN,NaN,31.224160467297246,-71.43798952655185,0.05972831402755957,-0.2678375851420718,-0.32756589916963136,-529500,-639100,16.36994692534077,20.480715380249595,NaN,NaN,-11.48262793706581,NaN
1999-03-05T09:30:00-05:00,23,23.03125,22.625,22.85937,92700,91465,60.32767476815598,42.321362265577996,NaN,NaN,105.24297906011613,-37.85735379110286,0.12906674279667552,-0.166232470673787,-0.2952992134704625,-436800,-595500,22.6768490516953,18.97541965634758,NaN,NaN,-5.592692970818017,-11.124418491280185
1999-03-08T09:30:00-05:00,22.98437,23.25,22.89062,23.1875,107600,93545,63.65973226777637,43.884220700159176,NaN,NaN,133.7132668860418,10.087902705464751,0.18939351130052975,-0.05855732434480032,-0.24795083564533008,-329200,-527720,31.34498553127186,18.76453406864795,NaN,NaN,0.3580351108716156,-9.48406797668707
1999-03-09T09:30:00-05:00,22.9375,23.3125,22.84375,22.9375,79000,95940,59.555557203801165,45.34041081489773,NaN,NaN,124.58394546261194,61.62328217810408,0.20358294473922733,0.006527845278704092,-0.19705509946052324,-408200,-464720,38.27165549690966,19.493436404738496,NaN,NaN,3.734812762729018,-7.595656442484772
1999-03-10T09:30:00-05:00,23.03125,24.3125,23.03125,24.25,1733800,179415,70.35965142693892,47.48635206403001,NaN,NaN,208.70500720093338,120.6938718154001,0.287361649843458,0.16214696284379926,-0.12521468699965874,1325600,-75620,63.060237898464244,22.312909475469638,NaN,NaN,11.414824444091531,-4.879873458688158
1999-03-11T09:30:00-05:00,25,25.25,24.25,24.59375,909000,221400,72.43644270251096,49.893077538578844,NaN,NaN,249.3301949318315,164.31507870830694,0.34788742694946967,0.30964459668717836,-0.038242830262291305,2234600,477200,77.11904370797595,26.342396238694526,NaN,NaN,18.049642094036926,-1.6042283797274313
1999-03-12T09:30:00-05:00,24.875,25.0625,24.25,24.5,604300,240775,70.97583591974663,51.89556284454609,NaN,NaN,188.38286836612548,180.94305656950883,0.3619527242836341,0.41419807509225137,0.05224535080861724,1630300,890620,82.48698423976272,30.779292643299733,NaN,NaN,22.474202718511176,1.8355474914495122
1999-03-15T09:30:00-05:00,24.5625,24.625,24.01562,24.3125,523000,254810,68.02164858961076,53.86954982275241,NaN,NaN,134.52157499717046,181.10471819173455,0.339352297400755,0.476435722559561,0.137083425158806,1107300,1177920,85.10259428494186,35.55994368928861,NaN,NaN,24.94477240880317,5.136865336785749
1999-03-16T09:30:00-05:00,24.09375,24.3125,24,24.1875,273300,266645,66.0479524220777,55.792118235588255,NaN,NaN,105.93239808638053,177.3744087164883,0.29817040809330175,0.5097964352754332,0.21162602718213144,834000,1426360,86.9216117242041,40.60286845113073,NaN,NaN,26.265023076788392,8.155173585357556
1999-03-17T09:30:00-05:00,24.3125,24.84375,24.25,24.8125,362800,282700,70.63577281574076,57.879170613808,NaN,NaN,118.4240624375059,159.31821976380277,0.2946844979977496,0.5799816496793184,0.28529715168156883,1196800,1400600,85.75243091297023,45.69025170862441,NaN,NaN,28.957289339214746,11.126904407337154
1999-03-18T09:30:00-05:00,25.25,25.3125,24.9375,25.125,332600,295180,72.62741338065845,60.25466123457595,NaN,NaN,129.00805778622043,135.25379233468055,0.2943937690246398,0.6532893629623686,0.3588955939377288,1529400,1259560,79.45106424400535,50.406761666840566,NaN,NaN,31.810951422444223,14.081768266638164
1999-03-19T09:30:00-05:00,25.25,25.28125,24.625,24.78125,260400,301685,67.22600447236364,62.45932830867755,NaN,NaN,102.7421248013551,118.1256436217265,0.2535696333416261,0.6758576356147614,0.42228800227313534,1269000,1187300,76.35530027098972,54.999748059708786,NaN,NaN,32.40317866937338,16.69911260988605
1999-03-22T09:30:00-05:00,25,25.125,24.73437,24.9375,165000,305960,68.37725041035256,64.94379045891942,NaN,NaN,92.81987433309355,109.78530348891111,0.2208109076691948,0.6983016368596289,0.47749072919043406,1434000,1252640,77.21965934076611,59.677122043355595,NaN,NaN,33.234995554967654,19.061381602040566
1999-03-23T09:30:00-05:00,24.75,24.75,24.25,24.5,137900,297375,61.8283403727055,66.2521747365298,NaN,NaN,62.70158881720617,101.13914163507624,0.1564296806536487,0.673027830007495,0.5165981493538463,1296100,1345060,78.42125431815697,64.3252584248182,NaN,NaN,31.850237232380408,20.8883609778034
1999-03-24T09:30:00-05:00,24.625,24.71875,24.15625,24.375,61100,298705,60.05844294019319,66.5812656923309,NaN,NaN,52.71667091158569,87.99766332989219,0.09518953778931838,0.6355850715904943,0.5403955338011759,1235000,1352700,78.522110280101,68.76469866444394,NaN,NaN,30.18820963589291,22.216910786101902
1999-03-25T09:30:00-05:00,24.3125,24.5625,24.0625,24.4375,166500,304800,60.66475616969262,66.6053429352978,NaN,NaN,44.56199630497218,71.10845103364254,0.050877330855870206,0.6039921973710136,0.5531148665151434,1401500,1327120,77.22073905991459,72.66069080788817,NaN,NaN,29.014874322968527,23.188048434225706
1999-03-26T09:30:00-05:00,24.6875,24.875,24.46875,24.75,44700,305790,63.63701273394474,66.60372011145269,NaN,NaN,60.29083750797041,62.61819357496561,0.035336601551155145,0.5972856184540873,0.5619490169029322,1446200,1362560,77.77042947467544,75.97679394670271,NaN,NaN,28.85829000731045,23.998082944666383
1999-03-29T09:30:00-05:00,25.375,25.6875,25.34375,25.4375,84400,309345,69.1584054285768,67.2896378417938,NaN,NaN,107.35014349993105,65.52424740833311,0.06249503240680132,0.6400678074114339,0.5775727750046326,1530600,1381880,78.08095566964113,78.82031538761211,NaN,NaN,30.45593463841375,24.920633186630294
1999-03-30T09:30:00-05:00,25.28125,25.3125,24.90625,24.96875,60800,309630,62.221255020910384,66.70832381279176,NaN,NaN,76.88353238909922,68.36063612271171,0.041061167198660375,0.628899234002958,0.5878380668042976,1469800,1416620,78.6582594233432,79.93445978224632,NaN,NaN,29.568265982167535,25.5845807288499
1999-03-31T09:30:00-05:00,25.15625,25.1875,24.59375,24.59375,67000,307815,57.27186020421244,65.62513934862758,NaN,NaN,51.77055436449675,68.17141281329393,-0.003816489884015728,0.583067454449278,0.5868839443332937,1402800,1450180,79.22743941130817,80.08505947534147,NaN,NaN,27.209668767283997,25.816736162911916
1999-04-01T09:30:00-05:00,24.625,24.65625,24.29687,24.5625,22000,304395,56.86591371341148,64.61728776246079,NaN,NaN,13.434006354734242,61.94581482324635,-0.03908968010107905,0.5380218442069449,0.5771115243080239,1380800,1446040,78.94772009972712,79.83225489391035,NaN,NaN,25.22485794648956,25.732182131994435
1999-04-05T09:30:00-04:00,24.5625,25.25,24.5625,25.15625,58400,302680,62.329383153726106,64.21069737418331,NaN,NaN,74.1276903862766,64.71318539890758,-0.026518764464839917,0.5439630687269741,0.570481833191814,1439200,1444640,78.84634278990478,79.38537978712199,NaN,NaN,25.18252228245762,25.65365929634632
1999-04-06T09:30:00-04:00,25.09375,25.125,24.71875,24.90625,42600,299430,58.94399439536528,63.703271800846714,NaN,NaN,58.018712548450964,54.84689920861157,-0.03840479056195867,0.5224758449893656,0.5608806355513243,1396600,1417840,76.81292365043834,78.66333063899586,NaN,NaN,24.08483549627289,25.429541610621545
1999-04-07T09:30:00-04:00,24.875,24.90625,24.46875,24.65625,836400,337300,55.68673633182811,62.635483480567245,NaN,NaN,-1.1870686849152832,39.23277899380867,-0.06490933651292874,0.47974396491016336,0.5446533014230921,560200,1235920,64.62862333262669,77.1544872403999,NaN,NaN,22.16633546395673,24.963369303955144
1999-04-08T09:30:00-04:00,24.76562,25.1875,24.67187,24.90625,852300,293225,58.17574009415589,61.60322110295992,NaN,NaN,49.64357154917198,38.807382430743694,-0.06713030198851233,0.46074042393745174,0.5278707259259641,1412500,1237860,64.69294152084396,76.10033561731696,NaN,NaN,21.309497177367916,24.44138757158554
1999-04-09T09:30:00-04:00,24.92187,25.5,24.89062,25.375,52400,250395,62.43611901665673,61.26108642755228,NaN,NaN,119.26810296353968,59.97420175250478,-0.03990124549563867,0.4779941690564158,0.5178954145520545,1464900,1254680,65.28238299714499,75.30941295489947,NaN,NaN,21.88431524335791,24.07609152469588
1999-04-12T09:30:00-04:00,25.25,25.75,25.25,25.5625,62500,223305,64.01512799583828,60.94950625508697,NaN,NaN,157.04865655088,76.55839498542545,-0.013498652848957904,0.5010220984908571,0.514520751339815,1527400,1272320,65.9248839430727,74.50264328363565,NaN,NaN,22.836260855263344,23.89897285763409
1999-04-13T09:30:00-04:00,25.40625,25.73437,25.40625,25.53125,67800,200545,63.5357635382397,61.07146505262513,NaN,NaN,148.1417363389147,94.58299974351822,-0.002927487064333878,0.5108613925093977,0.5137888795737315,1459600,1284920,66.40316032821848,73.64420799864004,NaN,NaN,23.46753978169008,23.83733956107066
1999-04-14T09:30:00-04:00,25.5,25.65625,25.21875,25.21875,27000,188230,58.79439391294092,60.98117583639282,NaN,NaN,99.02297739555475,114.6250089596122,-0.020775356523123234,0.48781968391982744,0.5085950404429507,1432600,1459400,72.21830057824366,73.19393587707881,NaN,NaN,22.63827011934523,23.666043926538457
1999-04-15T09:30:00-04:00,25.375,26.4375,25.375,26.3125,259400,183060,67.840270764613,61.493712593172845,NaN,NaN,203.47187945428882,145.39067054063557,0.03429082908848302,0.5514585768035545,0.5171677477150715,1692000,1515300,73.78390012957044,72.94844738205423,NaN,NaN,24.86947442857261,23.837962569686194
1999-04-16T09:30:00-04:00,26.59375,27.15625,26.375,27.14062,88500,170855,72.72288764206318,62.14270365803845,NaN,NaN,267.11447653844385,174.95994525561642,0.11514142962021434,0.6610945347403394,0.5459531051201251,1780500,1578420,75.46519669658002,72.78378789790456,NaN,NaN,28.598749661729407,24.518075011406655
1999-04-19T09:30:00-04:00,27.875,28.34375,27.4375,27.46875,245500,170110,74.38252762628622,62.51585524358912,NaN,NaN,279.0765808796872,199.36553012137784,0.17574425547658012,0.7656334244658503,0.5898891689892701,2026000,1678140,77.87889519237648,72.76935500667136,NaN,NaN,32.14240099756079,25.607264438000104
1999-04-20T09:30:00-04:00,27.5625,27.5625,26.76562,27.03125,386400,181180,68.4062839427748,62.9576430237223,NaN,NaN,169.26881028471834,203.59094491053858,0.1712179935018383,0.803911660866568,0.6326936673647297,1639600,1714140,78.69380808381857,72.77189419670532,NaN,NaN,32.99901082371614,26.66322820738811
1999-04-21T09:30:00-04:00,26.875,27.0625,26.375,26.625,181200,183345,63.31894107202023,63.38957737142285,NaN,NaN,110.64529600086053,205.91540863159975,0.1277114167199448,0.7923329382646607,0.6646215215447159,1458400,1719300,78.81427825374296,72.74238268545066,NaN,NaN,31.979859982726033,27.422747032436384
1999-04-22T09:30:00-04:00,26.5625,27.09375,26.25,27.09375,395900,200085,66.42195030344013,64.07215141356775,NaN,NaN,105.0892734472668,186.23888743019535,0.11760279612562485,0.8116250167017469,0.6940222205761221,1854300,1751760,79.59586185860041,72.78867852537017,NaN,NaN,32.170459908850624,28.10099172906699
1999-04-23T09:30:00-04:00,26.98437,27,26.54687,26.75,16300,192575,62.2623390494497,64.06736254897659,NaN,NaN,87.04264185485482,150.22452049347754,0.07683738562618114,0.7900689526088485,0.7132315669826673,1838000,1763260,79.87907546686552,72.86244514515309,NaN,NaN,30.955919650935805,28.508838575048248
1999-04-26T09:30:00-04:00,26.5625,26.5625,26.01562,26.15625,297800,205230,55.76616704343833,63.8403748809818,NaN,NaN,38.9029859433452,102.18980150620914,0.002864339416083883,0.7168119912527722,0.7139476518366883,1540200,1666100,70.92227555139237,72.44168456664981,NaN,NaN,27.735206887099995,28.398319762484213
1999-04-27T09:30:00-04:00,26.45312,27,26.4375,26.98437,82400,205130,61.75904158529454,64.27411097051512,NaN,NaN,75.32825702725744,83.40169085471697,0.002689073041854728,0.7173089931390066,0.7146199200971519,1622600,1662700,70.62384225310875,72.86991448954139,NaN,NaN,27.011583913437697,28.200214641191852
1999-04-28T09:30:00-04:00,27.125,28.28125,27.125,27.875,103700,207275,66.94579971684058,64.90054380070688,NaN,NaN,129.95189390326115,87.26301043519709,0.052761126344956666,0.7805713280283477,0.7278102016833911,1726300,1716280,72.58183668222532,73.43340700106863,NaN,NaN,28.272945013818973,28.210604694424298
1999-04-29T09:30:00-04:00,26.8125,28.875,26.75,28.71875,240100,215930,70.96378532024002,65.5096628223914,NaN,NaN,137.4379086827949,93.73273748230272,0.12859034103597555,0.8885481279783605,0.7599577869423849,1966400,1738700,73.38133993073286,74.01190392489634,NaN,NaN,30.812726183143095,28.58233633566984
1999-04-30T09:30:00-04:00,28.375,28.625,28,28.23437,966100,263135,66.00350924286289,65.65169005432173,NaN,NaN,134.13435022420825,103.15107915617341,0.13153731550533942,0.9243794313240592,0.7928421158187198,1000300,1571160,59.434181191594035,73.54828229979071,NaN,NaN,31.05057818103885,28.9349423135797
1999-05-03T09:30:00-04:00,28.25,28.9375,28,28.9375,276600,274045,69.35239078330969,66.0671634289696,NaN,NaN,140.50997569430083,123.47247710636452,0.1641329423068829,0.9980082937023234,0.8338753513954404,1276900,1518500,55.841612476213854,72.79388602464753,NaN,NaN,32.44070331961691,29.435765314442158
1999-05-04T09:30:00-04:00,28.96875,29.125,28.73437,28.96875,358500,289840,69.496210545829,66.83157890274731,NaN,NaN,147.62834087669074,137.9324938762512,0.17035114923972494,1.0468142879450966,0.8764631387053716,1635400,1521060,55.9809132797223,71.63407264618172,NaN,NaN,33.54426065538277,30.022693220290815
1999-05-05T09:30:00-04:00,28.9375,28.9375,28.15625,28.54687,381000,267070,65.05763289095992,66.63281905462924,NaN,NaN,110.40656564030678,134.02342822366032,0.13040456899857722,1.0394688499535931,0.9090642809550159,1254400,1426680,49.74991732228877,69.91735958851875,NaN,NaN,33.02023650862853,30.450913690053344
1999-05-06T09:30:00-04:00,28.6875,28.75,28.03125,28.46875,402500,244580,64.23946469742054,66.02686027286904,NaN,NaN,90.46996514262975,124.62983951562725,0.08525760198523824,1.0156362834365638,0.9303786814513255,851900,1203780,38.77336873087322,67.2965147338254,NaN,NaN,32.35539387389388,30.72298228774485
1999-05-07T09:30:00-04:00,28.28125,28.67187,28.10937,28.64062,360700,259995,65.27417652544085,65.37626376566581,NaN,NaN,84.28195391195925,114.65936025317747,0.05497727036099975,0.9991002694025752,0.9441229990415755,1212600,1246240,41.42457485980287,64.69263471007015,NaN,NaN,32.111288848956534,30.921311796489373
1999-05-10T09:30:00-04:00,28.60937,28.90625,28.3125,28.3125,270700,270405,61.6091435752586,64.89075373941465,NaN,NaN,78.35245581564203,102.2278562774457,0.0035689047515770067,0.9485841299810467,0.9450152252294697,941900,1179240,38.58531783877621,61.827742549709974,NaN,NaN,30.837320676957653,30.909313065127698
1999-05-11T09:30:00-04:00,28.5,28.53125,28.25,28.40625,71600,270595,62.26114487233838,64.8151968680088,NaN,NaN,64.17705935736456,85.53759997358047,-0.03147256818926769,0.9056745149928851,0.9371470831821528,1013500,1054860,33.93526086879031,58.62209845078478,NaN,NaN,29.967733454236896,30.7748016921433
1999-05-12T09:30:00-04:00,27.75,28,27.25,27.875,531700,295830,56.41429217333213,64.10036414442966,NaN,NaN,5.415240201636998,64.53933488584651,-0.0942329655068922,0.8193558762985376,0.9135888418054298,481800,900340,29.223462537958866,55.02406992788182,NaN,NaN,27.49941376278121,30.306889130805857
1999-05-13T09:30:00-04:00,28.0625,28.3125,27.875,28.01562,264700,296095,57.55063425477326,63.763813801952764,NaN,NaN,30.894731878277355,52.62428823297605,-0.12798509410611847,0.7536074741727816,0.8815925682789001,746500,879260,28.639254139935616,51.36408269024396,NaN,NaN,25.75924184562727,29.657225232923203
1999-05-14T09:30:00-04:00,27.875,28.0625,27.65625,27.8125,254900,304415,55.30757929461281,63.73105753417951,NaN,NaN,5.109574698697757,36.78981239032376,-0.1634310393447771,0.6773037690979287,0.8407348084427058,491600,735060,24.9629504834014,48.08127375681603,NaN,NaN,23.660033570345433,28.800483566840665
1999-05-17T09:30:00-04:00,27.4375,27.78125,27.375,27.70312,105800,297430,54.08511145057215,63.18291966741363,NaN,NaN,-17.03981122487239,17.71135898222088,-0.191725740813659,0.601077632425632,0.792803373239291,385800,623840,22.557767599318638,44.64798271011674,NaN,NaN,21.563206472555915,27.7665868390857
1999-05-18T09:30:00-04:00,27.4375,27.5,27.01562,27.0625,33800,279800,47.46756491537945,61.79161718159498,NaN,NaN,-61.17729667281045,-7.359512223814117,-0.24752044020553665,0.48340282298237014,0.7309232631879068,352000,491540,20.079405918885257,40.89780908416388,NaN,NaN,17.714218043339304,26.330534153979073
1999-05-19T09:30:00-04:00,27.28125,27.59375,27.01562,27.4375,280700,284775,51.229344343753034,60.38201425470305,NaN,NaN,-51.45561897240708,-18.733684058622938,-0.2522481103156018,0.41561312529340455,0.6678612356090063,632700,521720,22.17981977405809,37.2405576444014,NaN,NaN,15.451833734053938,24.776434093989767
1999-05-20T09:30:00-04:00,27.34375,27.84375,27.34375,27.75,147500,272355,54.174297322800996,59.5370705461272,NaN,NaN,-25.6409031429612,-30.04081106287065,-0.22813380304596076,0.38269398180155534,0.6108277848475161,780200,528460,22.66861538953478,34.61444580139716,NaN,NaN,14.361611326776046,23.288602270102093
1999-05-21T09:30:00-04:00,27.875,28.34375,27.6875,28.1875,215100,282295,57.998148045144056,58.726053207686796,NaN,NaN,18.12983768641705,-27.43675846532679,-0.1787088438896779,0.3874417299854187,0.5661505738750966,995300,629200,29.76913038120935,32.752125651753985,NaN,NaN,14.537949126272775,22.038508963840762
1999-05-24T09:30:00-04:00,28.3125,28.59375,27.51562,27.51562,310300,282920,50.96482345983582,57.402382701544425,NaN,NaN,-21.29535693636234,-28.287867607624783,-0.186401322791239,0.3331489203860478,0.5195502431772868,685000,689040,33.66539573564914,31.158160112891615,NaN,NaN,12.516337088571007,20.67819869594508
1999-05-25T09:30:00-04:00,27.5625,28.1875,27.40625,27.40625,451000,301350,49.90392834410612,56.31997523391201,NaN,NaN,-67.5435787950307,-29.561124032068854,-0.193167732469736,0.2780905775901168,0.4712583100598528,234000,665440,32.89040797672959,29.953909445351673,NaN,NaN,10.562171510256446,19.233051955132417
1999-05-26T09:30:00-04:00,27.78125,28.28125,27.625,28.1875,64700,299400,56.81864918199549,55.78991698281022,NaN,NaN,-6.863947343674597,-20.642789706322354,-0.14172143743844623,0.29410651326179504,0.4358279507002413,298700,598640,30.733775336067126,29.379652774294097,NaN,NaN,10.979015984281283,18.05390395929654
1999-05-27T09:30:00-04:00,28,28.375,27.34375,27.34375,76700,291230,48.95886283573413,54.62453743354545,NaN,NaN,-62.25806377316072,-27.96622183236226,-0.1598661385395569,0.2359952775257952,0.3958614160653521,222000,487000,27.489606251305176,28.384297873687114,NaN,NaN,8.715384676700227,16.719829776068497
1999-05-28T09:30:00-04:00,27.40625,27.8125,27.3125,27.625,107800,248315,51.3735232828763,53.893421698375285,NaN,NaN,-72.37203543496705,-46.06659645663908,-0.14851871353820706,0.21021302414259324,0.3587317376808003,329800,353900,24.208645926558603,27.357392737100145,NaN,NaN,7.675003284041279,15.427711705778895
1999-06-01T09:30:00-04:00,27.5625,27.5625,27.01562,27.46875,421500,255560,49.95947014879314,53.01473064669348,NaN,NaN,-102.10064469111339,-62.22765400758929,-0.14686276975238977,0.17515327549031312,0.3220160452427029,-91700,198560,21.05079964220141,26.437074078058085,NaN,NaN,6.402313124599539,14.138369051324702
1999-06-02T09:30:00-04:00,27.57812,27.84375,27.57812,27.78125,32000,239235,52.76006537544858,52.753714446844654,NaN,NaN,-30.164201463121223,-54.7517785412074,-0.12111880607276743,0.1706175376517436,0.291736343724511,-59700,139820,19.988990004652692,25.777468897107642,NaN,NaN,6.194764956745283,13.003568466384785
1999-06-03T09:30:00-04:00,28.09375,28.25,27.875,27.875,43300,222350,53.59906376316962,52.471459411730116,NaN,NaN,29.917982743864627,-47.395392523699556,-0.09531053900343145,0.1725981699702217,0.26790870897365315,-16400,76800,18.888216045887404,25.080966176104198,NaN,NaN,6.271388496967736,12.041828470753778
1999-06-04T09:30:00-04:00,28.15625,28.3125,27.875,28.3125,22500,203350,57.40130443610598,52.62101120755106,NaN,NaN,71.72463024550366,-20.598853719966677,-0.04866032588604963,0.20708330161609112,0.25574362750214075,6100,33620,18.150670423672082,24.59437474326639,NaN,NaN,7.471746801649748,11.388959660881774
1999-06-07T09:30:00-04:00,28.34375,28.73437,28.28125,28.64062,182300,194430,60.04563886450882,53.04676316568939,NaN,NaN,155.5203026169598,24.979613890418698,0.0017382646385108447,0.2579164583002793,0.25617819366176847,188400,5340,17.66418154344686,24.24483288213269,NaN,NaN,9.283575909456243,11.08819055353527
1999-06-08T09:30:00-04:00,28.5,28.59375,28.1875,28.1875,169800,189385,54.97085251185734,53.58271227972352,NaN,NaN,110.43184652278626,67.48611213319863,0.001983414571093911,0.2586574618756359,0.25667404730454196,18600,27400,19.477231339702286,24.20182041219105,NaN,NaN,9.342616949615794,10.838822895832488
1999-06-09T09:30:00-04:00,28.15625,28.46875,28.125,28.25,14400,186525,55.52914685011012,53.8898410301776,NaN,NaN,104.2203792048977,94.36302826680242,0.0036816516243312614,0.261276111834956,0.25759446021062476,33000,45940,21.05070006024839,24.121169004061787,NaN,NaN,9.551184166590625,10.654874505940793
1999-06-10T09:30:00-04:00,28.375,28.53125,28.125,28.40625,122100,166045,56.96565914137291,54.08922401721845,NaN,NaN,106.71274813540288,109.72198134511007,0.01217614589541366,0.27281464257989185,0.2606384966844782,155100,80240,24.009186494362595,24.216924082978064,NaN,NaN,10.129561078091314,10.579829730533724
1999-06-11T09:30:00-04:00,28.5625,28.75,28.4375,28.625,81700,156895,58.964184541231795,54.15822662408186,NaN,NaN,142.25503706489454,123.82806270898823,0.028445959188212855,0.2961959456697443,0.2677499864815314,236800,126380,27.922025901544018,24.08498804871625,NaN,NaN,11.181904364815374,10.66584039257396
1999-06-14T09:30:00-04:00,28.75,28.9375,28.53125,28.875,271000,157700,61.182864356482305,54.88808668812804,NaN,NaN,149.66267913913765,122.6565380134238,0.050665769212746126,0.3310821979974641,0.28041642878471795,507800,190260,33.06106288078527,24.04182141622598,NaN,NaN,12.710805625908177,10.957978283050277
1999-06-15T09:30:00-04:00,28.9375,29.34375,28.76562,29.23437,151300,159975,64.18087411330114,55.907868528784824,NaN,NaN,178.31379450180532,136.23292760922763,0.08231438311522987,0.3833094076787553,0.30099502456352545,659100,318360,41.992693912389186,24.69198469734452,NaN,NaN,14.915470652387459,11.523334335812732
1999-06-16T09:30:00-04:00,29.375,29.375,28.84375,28.9375,228800,169725,60.054538334352,56.13900346823886,NaN,NaN,148.344431803689,145.05773812898587,0.07614640115119287,0.3961780260025165,0.32003162485132364,430300,397820,46.739899676028976,25.835279293056082,NaN,NaN,15.658393565051307,12.114057082846815
1999-06-17T09:30:00-04:00,28.75,29.0625,28.6875,28.96875,64300,158905,60.3435670399742,56.952196625684586,NaN,NaN,112.04699093781304,146.12458668946792,0.0673653441346837,0.4042383050196783,0.3368729608849946,494600,465720,50.47007245875869,27.476741165017046,NaN,NaN,16.350341773823793,12.71924061012924
1999-06-18T09:30:00-04:00,29,29.125,28.78125,28.875,59800,154520,58.96516784649961,57.49445695165768,NaN,NaN,102.94361813842698,138.26230290417442,0.04927603259468022,0.39846800162834484,0.3491919690336646,434800,505320,52.557008453572166,29.501624202660874,NaN,NaN,16.571435733442843,13.26955419917404
1999-06-21T09:30:00-04:00,28.8125,28.8125,27.96875,28.20312,87500,148140,50.127715848506526,57.50647450163721,NaN,NaN,9.65115935278157,110.2599989469032,-0.010706456976404488,0.33580889781315904,0.3465153547895635,347300,473220,50.69243656072294,31.618883982555268,NaN,NaN,14.196322093466257,13.401949612644357
1999-06-22T09:30:00-04:00,27.875,28.07812,27.84375,27.90625,251000,145175,46.7907567737004,57.080095315798054,NaN,NaN,-51.08167885577503,64.38090427538711,-0.06984573342255684,0.25920818801136747,0.3290539214339243,96300,360660,44.703450801220136,33.38420261088151,NaN,NaN,11.16506148673314,13.082394166085612
1999-06-23T09:30:00-04:00,28.125,28.25,28.01562,28.125,261800,135715,49.460504933880436,56.784483970848825,NaN,NaN,-26.917418414498368,29.328534231749636,-0.09229146525095155,0.2136895898702349,0.30598105512118645,358100,346220,43.98551178474705,35.17686659222863,NaN,NaN,9.365186128645872,12.551364446451363
1999-06-24T09:30:00-04:00,27.9375,27.9375,27.51562,27.65625,232500,144105,44.32789537706206,55.85066903805997,NaN,NaN,-91.21072811726657,-11.323009579266284,-0.13422604478946287,0.1381984991343579,0.27242454392382076,125600,272420,40.41324351162745,36.76705038422544,NaN,NaN,6.2050665474423985,11.644750460878653
1999-06-25T09:30:00-04:00,27.65625,27.65625,27.375,27.4375,265500,153545,42.13069449289208,54.571030154373055,NaN,NaN,-120.49930179833102,-56.011593566617876,-0.1699172322963066,0.060028003553437514,0.2299452358497441,-139900,157480,35.56821829156752,38.04591015194835,NaN,NaN,2.894363173757676,10.394695134147085
1999-06-28T09:30:00-04:00,27.40625,27.51562,27.17187,27.26562,55600,150935,40.43475844023508,53.53273772068575,NaN,NaN,-140.33695384431414,-86.00921620603701,-0.19644578196004836,-0.015611991600316344,0.18083379035973202,-195500,48920,31.70234950662163,38.91913287815687,NaN,NaN,-0.3741972495659144,8.856281936473799
1999-06-29T09:30:00-04:00,27.26562,27.65625,27.15625,27.64062,68700,133295,45.58166961763232,52.82220363265163,NaN,NaN,-118.32507791372359,-99.45789601762672,-0.18049235366121427,-0.04478165171678583,0.13571070194442844,-126800,4300,30.247177703189806,39.576024138366975,NaN,NaN,-1.716327489232807,7.345909161372855
1999-06-30T09:30:00-04:00,27.75,28.21875,27.75,28.04687,108000,137095,50.5651606690637,52.36502517034383,NaN,NaN,-42.34312145496899,-102.54303662572086,-0.13634266908318798,-0.03471763440955655,0.10162503467363143,-18800,-71080,27.915941140846613,39.855078041687264,NaN,NaN,-1.3683820992968696,6.101010409848609
1999-07-01T09:30:00-04:00,28.125,28.3125,27.96875,28.26562,33200,136590,53.057973520391975,51.943152954569555,NaN,NaN,-16.182115857705952,-87.53731417380872,-0.08848957618478157,-0.008986935557345532,0.07950264062743603,14400,-93320,27.248658319672458,39.80698035726787,NaN,NaN,-0.32478182900267133,5.183040090012712
1999-07-02T09:30:00-04:00,28.28125,28.45312,28.09375,28.35937,51600,138045,54.1256372529407,51.43906530431658,NaN,NaN,2.1350537307836803,-63.0104430679858,-0.048599319234805344,0.01875349158392936,0.0673528108187347,66000,-52140,30.558542089310365,39.628228872162516,NaN,NaN,0.8445456440401211,4.5632551691594845
1999-07-06T09:30:00-04:00,28.5,29.10937,28.5,28.89062,48800,131370,59.71687727126387,51.1202083870282,NaN,NaN,84.30599966820945,-18.081852365481073,0.012239868823014685,0.08265264684750306,0.07041277802448838,114800,9920,35.33341457625569,39.15256606243869,NaN,NaN,3.629073069719651,4.429800583525223
1999-07-07T09:30:00-04:00,28.84375,28.84375,28.59375,28.8125,120600,128910,58.586090843938365,51.01531928057009,NaN,NaN,64.38153135586833,18.459469488437314,0.04410368334352638,0.12554238220389635,0.08143869886036997,-5800,34120,37.14829611061103,38.4674515220517,NaN,NaN,5.572400170119294,4.593029095895805
1999-07-08T09:30:00-04:00,29,29.21875,28.95312,29,94300,132905,60.518507534211714,51.027815030158486,NaN,NaN,97.27152351172543,46.38239848177619,0.07298666791514345,0.1726720337542993,0.09968536583915584,88500,55580,38.78887731762367,37.63308044054205,NaN,NaN,7.7791529170180675,5.0481896417704135
1999-07-09T09:30:00-04:00,28.89062,29.09375,28.8125,28.98437,25700,128085,60.266060805071206,51.12073595577074,NaN,NaN,75.18890702953684,64.65660305922475,0.08535759881381008,0.20638236435641844,0.12102476554260835,62800,65260,39.555301527992206,36.70438708871491,NaN,NaN,9.52179137411054,5.687275603533289
1999-07-12T09:30:00-04:00,29.25,29.28125,29,29.28125,92200,128610,63.38990285636969,52.06803502776096,NaN,NaN,95.38671256864032,83.30693482679607,0.10647970060810141,0.2541243913027351,0.1476446906946337,155000,83060,41.01777944546429,36.013340151910725,NaN,NaN,11.951672017549118,6.582189376964122
1999-07-13T09:30:00-04:00,29.03125,29.0625,28.8125,29,46200,117370,58.68299207632106,52.91748040651959,NaN,NaN,64.62140936092895,79.37001676533997,0.09484201654352081,0.26619721137403474,0.17135519483051392,108800,81860,40.945853272225264,35.74494032841109,NaN,NaN,12.74642730627749,7.46279479543746
1999-07-14T09:30:00-04:00,29.04687,29.21875,28.84375,29.04687,18800,110745,59.226345767294674,53.61504046604917,NaN,NaN,75.22924552703721,81.53955959957375,0.08400488770572614,0.2763613044626716,0.19235641675694545,127600,108540,43.32539104928746,35.69778884730683,NaN,NaN,13.554661858749212,8.33306151876771
1999-07-15T09:30:00-04:00,29.23437,29.375,29.0625,29.3125,33000,100955,62.255841580202876,54.8956080519878,NaN,NaN,98.59339741621358,81.80393438047138,0.08800691958116016,0.30236506623339565,0.2143581466522355,160600,122960,44.62414466923042,35.99856750142133,NaN,NaN,15.118066592450191,9.302347957865207
1999-07-16T09:30:00-04:00,29.09375,29.21875,28.9375,29.125,27000,99090,58.927574861094186,56.095385221145094,NaN,NaN,77.17180565741697,82.2005141060474,0.07198177320798219,0.3043353631622132,0.23235358995423103,133600,137120,45.93435878259557,36.73900610792333,NaN,NaN,15.538644596413667,10.193247477657843
1999-07-19T09:30:00-04:00,29.0625,29.09375,28.78125,29.01562,24600,97330,57.01274028915942,57.27952678178256,NaN,NaN,61.21429978402145,75.36603154912362,0.04906541902855538,0.29368536373992526,0.24461994471136989,109000,127920,45.18629637653252,37.702145170059815,NaN,NaN,15.370111514750615,10.932799482956812
1999-07-20T09:30:00-04:00,28.90625,28.9375,28.25,28.25,18400,93875,45.795302742614716,57.294786290709865,NaN,NaN,2.7210005314285466,62.985949783223546,-0.01896043126396818,0.22091940563140966,0.23987983689537784,90600,124280,44.87490829536851,38.746983069501155,NaN,NaN,11.651731250112004,11.03550402112184
1999-07-21T09:30:00-04:00,28.0625,28.57812,28,28.5625,40500,83350,50.11005811236767,57.26227896523158,NaN,NaN,-12.324508855775191,45.47519890666107,-0.04284769795104476,0.18632021445657188,0.22916791240761664,131100,124980,44.95346921018527,39.96394936016821,NaN,NaN,9.847658888512743,10.86581185932054
1999-07-22T09:30:00-04:00,28.03125,28.1875,27.70312,28.14062,53500,72935,44.91238490113147,56.68045120671297,NaN,NaN,-57.28324761261765,14.299869900894816,-0.08458630293270217,0.12343503374173892,0.2080213366744411,77600,108380,43.374806015014165,41.11581705269261,NaN,NaN,6.5861958364786695,10.254438141771702
1999-07-23T09:30:00-04:00,28.375,28.45312,28.17187,28.28125,56300,64125,46.88996628221449,56.163617565946815,NaN,NaN,-26.331307490772833,-6.400752728743143,-0.09923491090808861,0.0839776980393303,0.18321260894741892,133900,108440,43.382545364475305,42.03181728663298,NaN,NaN,4.559792333816084,9.440917312063757
1999-07-26T09:30:00-04:00,28.21875,28.4375,27.75,27.75,71800,54440,40.91460215095534,54.820597914496204,NaN,NaN,-75.66077991717047,-33.77576866898151,-0.13878776487534955,0.009727902853231996,0.14851566772858155,62100,99060,42.4067340436645,42.53705439144789,NaN,NaN,0.7873584397552206,8.20469461601968
1999-07-27T09:30:00-04:00,27.9375,28.0625,27.67187,27.75,29700,53145,40.91460215095534,53.55834872214028,NaN,NaN,-105.64096579740833,-55.448161934748896,-0.15765723249877514,-0.048555872894887386,0.10910135960388775,62100,93360,41.79156264757282,42.868716286945165,NaN,NaN,-2.16742093420085,6.722963823131033
1999-07-28T09:30:00-04:00,27.78125,28.25,27.59375,28.15625,14200,50420,46.91425559039653,52.586616440439194,NaN,NaN,-89.37170547758458,-70.85760125911077,-0.13628832694295798,-0.061259049074809724,0.07502927786814825,76300,82400,40.57280671968961,42.99613981566416,NaN,NaN,-2.8665301106395233,5.353036118306668
1999-07-29T09:30:00-04:00,27.96875,28.21875,27.90625,27.98437,29400,46490,44.839698737743575,51.484733435630076,NaN,NaN,-84.28281461696629,-76.2575146599805,-0.1274032592824124,-0.08422479623486723,0.043178463047545156,46900,76260,39.871301283149776,43.01871122674684,NaN,NaN,-4.076477030781858,4.0059628112940215
1999-07-30T09:30:00-04:00,28.4375,28.75,28.375,28.57812,40600,46860,52.632042924008154,50.71631486903283,NaN,NaN,-5.076192154697671,-72.00649159276547,-0.07765749354348,-0.05389340388180486,0.02376408966167515,87500,66980,38.77994276815091,42.85886574979588,NaN,NaN,-2.615665911072864,3.060015850955895
1999-08-02T09:30:00-04:00,28.39062,28.45312,27.95312,27.95312,13500,44955,45.36693579762059,49.7651679919828,NaN,NaN,-74.69530177168244,-71.81339596366786,-0.08250956973479888,-0.07937287250682346,0.0031366972279754275,74000,69360,39.23929255293966,42.7369685555612,NaN,NaN,-3.8183958681872654,2.077385605364015
1999-08-03T09:30:00-04:00,28.20312,28.3125,28,28.3125,24500,43740,49.66908247270103,49.08250632808325,NaN,NaN,-55.043743767141365,-61.69395155761447,-0.05831927375217493,-0.06976239496224323,-0.011443121210068305,98500,76640,40.704867180664415,42.54978827923098,NaN,NaN,-3.3363568095589784,1.3039938318035875
1999-08-04T09:30:00-04:00,28.26562,28.82812,28.26562,28.70312,29100,39165,53.916817089940515,48.48686172163594,NaN,NaN,7.6661036002264975,-42.28638974205225,-0.015067291583829415,-0.030277235689855075,-0.01520994410602566,127600,86900,42.79893105948228,42.41941587853468,NaN,NaN,-1.488818264390631,0.9050206752044134
1999-08-05T09:30:00-04:00,28.92187,29.25,28.84375,29.20312,58600,37380,58.71933927824575,48.47198775143248,NaN,NaN,86.89877801707155,-8.050071215244682,0.044879563297416644,0.040889510015745145,-0.003990053281671497,186200,114760,48.153323918749194,42.577913388259944,NaN,NaN,1.7354035342012297,1.0236467979182444
1999-08-06T09:30:00-04:00,29.375,29.5,29.09375,29.15625,40400,38115,58.108013689034905,48.5502215657093,NaN,NaN,105.07131396965826,13.979430009626507,0.07714567235639937,0.0924420371638277,0.015296364807428344,145800,126420,50.25217816408786,42.93976208737104,NaN,NaN,4.0418535325656695,1.4548191885821622
1999-08-09T09:30:00-04:00,29.5,29.85937,29.32812,29.85937,101700,38590,64.13953079562597,49.86052356949582,NaN,NaN,157.89623929689785,60.49773822334256,0.13805736253940326,0.18786806798168243,0.04981070544227916,247500,161120,55.96528282767166,43.73193169682126,NaN,NaN,8.171291889527426,2.4143152887171997
1999-08-10T09:30:00-04:00,29.85937,29.9375,29.375,29.6875,61400,39350,61.79734814942271,50.69533000071403,NaN,NaN,137.96693468308936,99.0998739133887,0.15757597824345204,0.24678067824659422,0.08920470000314218,186100,178640,58.5533573481322,44.70335227810319,NaN,NaN,10.697972642886201,3.5976949107413425
1999-08-11T09:30:00-04:00,29.59375,29.875,29.26562,29.875,105900,43705,63.36890730292079,52.01365302941326,NaN,NaN,124.95171618868609,122.55699643108062,0.17270202501040471,0.3050822312661481,0.13238020625574337,292000,211520,62.953901958719996,46.101859131225034,NaN,NaN,13.24434062218712,4.975787155233596
1999-08-12T09:30:00-04:00,29.6875,30.17187,29.6875,29.9375,146800,49395,63.90197708772301,53.22879665837816,NaN,NaN,142.1102470585641,133.59929023937914,0.17591113147342638,0.35226912059752635,0.17635798912409997,438800,262040,68.48976058529871,47.895231646998134,NaN,NaN,15.450637753475688,6.472194383553894
1999-08-13T09:30:00-04:00,29.82812,29.90625,29.6875,29.84375,223400,59215,62.43429053070059,54.765917256931395,NaN,NaN,115.66286126845888,135.71759969913927,0.16111025693655232,0.3777458102947904,0.21663555335823806,215400,275960,69.82762644590643,49.85386681858684,NaN,NaN,16.84928438168925,7.954635811858945
1999-08-16T09:30:00-04:00,29.70312,29.70312,29.29687,29.54687,872000,101585,57.8992002745798,55.97910283719028,NaN,NaN,76.92885470598164,119.52412278095603,0.12246647660466825,0.36971864911407337,0.24725217250940512,-656600,95140,43.80780639137105,49.99788422885814,NaN,NaN,16.75349392588651,9.211615542434311
1999-08-17T09:30:00-04:00,29.53125,29.76562,29.46875,29.76562,550700,128200,60.19359189872788,56.92762685921395,NaN,NaN,81.5687965582408,108.2444951559863,0.10353137177683064,0.37666638723044343,0.2731350154536128,-105900,36740,38.78146189997937,49.869931027450264,NaN,NaN,17.328288299089785,10.371140221956521
1999-08-18T09:30:00-04:00,29.53125,29.78125,29.51562,29.54687,675400,159945,56.85668985272357,57.78598336742681,NaN,NaN,68.85793815437233,97.02573954912356,0.0697856955595389,0.3603671349030364,0.2905814393434975,-781300,-177920,26.6690381248294,48.926912230427384,NaN,NaN,16.86328412572448,11.29858935106623
1999-08-19T09:30:00-04:00,29.40625,29.84375,29.40625,29.75,252400,169890,59.12281984130818,58.24961029009109,NaN,NaN,67.13755855557905,82.03120184852654,0.05529038452820356,0.35969442000375196,0.3044040354755484,-528900,-371460,20.46337233890344,47.61858577119542,NaN,NaN,17.106586273737218,12.128303197162085
1999-08-20T09:30:00-04:00,29.6875,29.92187,29.64062,29.84375,41600,169155,60.16283967051336,59.306460566726294,NaN,NaN,73.50210621526519,73.5990508378878,0.04651430357169295,0.36254691494016456,0.3160326113684716,-487300,-512000,17.312967046203383,46.052419663571406,NaN,NaN,17.596560474262425,12.909482808176419
1999-08-23T09:30:00-04:00,29.90625,30.0625,29.78125,30,98400,170485,61.902600144238875,60.18028325755042,NaN,NaN,81.96912692166791,74.60710528102507,0.045665570373602304,0.37311457433547446,0.32744900396187215,-388900,-458460,22.22533055865982,44.732452761999646,NaN,NaN,18.49181458017718,13.706958775605099
1999-08-24T09:30:00-04:00,29.73437,29.8125,29.57812,29.8125,380700,188035,58.5956158036373,60.51448316567163,NaN,NaN,56.286513775079065,69.55064872439272,0.027788634159550518,0.3621847966613103,0.3343961625017598,-769600,-591200,19.182568598437726,43.04556972906789,NaN,NaN,18.36268088977569,14.372061934772326
1999-08-25T09:30:00-04:00,29.9375,29.9375,29.35937,29.67187,292800,201965,56.1717820065591,60.33251478912258,NaN,NaN,43.179442638282794,64.41494962117481,0.003103686707605191,0.33827577088626626,0.33517208417866107,-1062400,-647420,18.055127113603604,40.89569852870034,NaN,NaN,17.59244651986632,14.83211687550004
1999-08-26T09:30:00-04:00,29.4375,29.4375,28.875,28.90625,55600,203275,45.207744139464275,59.41106696415325,NaN,NaN,-41.92631191552285,42.602175526954426,-0.06444684019900437,0.2546135339299056,0.31906037412891,-1118000,-765240,15.940636464147715,38.44487412156177,NaN,NaN,13.388465710740268,14.625880994820072
1999-08-27T09:30:00-04:00,29,29.10937,28.71875,28.89062,38900,203190,45.01457583011277,58.044998752330876,NaN,NaN,-71.74905785850815,13.551942712199756,-0.10731407454944453,0.18491778094210432,0.29223185549154884,-1156900,-899160,13.941969425581945,35.44320887855535,NaN,NaN,9.96855831856069,13.960549183925874
1999-08-30T09:30:00-04:00,29,29,28.5,28.5,103600,207695,40.37176527551645,56.51459997562329,NaN,NaN,-121.88474785307316,-27.21883224274846,-0.1561495233328074,0.09704495132553959,0.253194474658347,-1260500,-1073480,11.857831211149843,32.10781415448518,NaN,NaN,5.5042236965043445,12.7525026857228
1999-08-31T09:30:00-04:00,28.59375,29.10937,28.5625,28.89062,291200,221030,46.332797156415694,55.29773496515863,NaN,NaN,-107.50867626093684,-59.977870249951636,-0.1559528903468305,0.05825336172480888,0.21420625207163937,-969300,-1113420,11.436015592587964,28.42796512833289,NaN,NaN,3.454943044386402,11.4242798798176
1999-09-01T09:30:00-04:00,28.89062,29.0625,28.79687,28.8125,70800,223115,45.35623711164151,53.97303925258139,NaN,NaN,-109.18982047650316,-90.45172287290885,-0.15459264979792126,0.02096543982423782,0.17555808962215907,-1040100,-1108960,11.81326808890077,24.379644235733036,NaN,NaN,1.5031491382522977,10.006975488165414
1999-09-02T09:30:00-04:00,28.59375,28.70312,28.3125,28.5,49900,222680,41.580732238643826,52.48349937457733,NaN,NaN,-160.04537361370697,-114.07553521254565,-0.1671796247544719,-0.0334164413209308,0.1337631834335411,-1090000,-1103360,12.318303431787356,20.271835449010247,NaN,NaN,-1.337376315532455,8.386353801922862
1999-09-03T09:30:00-04:00,28.84375,28.9375,28.70312,28.84375,15300,221425,46.8243188767738,51.69243641759118,NaN,NaN,-93.54797723770032,-118.43531908838409,-0.14558723609904742,-0.04822086169026818,0.09736637440877924,-1074700,-1086920,13.877615494005838,18.13396467062702,NaN,NaN,-2.1813155369569643,6.876686753511459
1999-09-07T09:30:00-04:00,28.78125,29.40625,28.78125,29.375,149900,223835,53.735622624637465,51.2311528980133,NaN,NaN,-31.078883745482297,-100.27414626686593,-0.0914061584628432,-0.01689132366977475,0.07451483479306845,-924800,-1019780,20.12501248845436,16.80136114123237,NaN,NaN,-0.6706889304469923,5.79849022723168
1999-09-08T09:30:00-04:00,29.3125,29.6875,29.1875,29.46875,48900,223210,54.85082517243399,51.08787684942119,NaN,NaN,13.019115535663195,-76.16858790754591,-0.0473512783365104,0.01532573687243044,0.06267701520894084,-875900,-1001100,21.824178186915844,16.45529971709569,NaN,NaN,0.8867044948217485,5.096806551173119
1999-09-09T09:30:00-04:00,29.73437,30.29687,29.73437,30.125,111800,223505,61.79350249763184,51.27863989630145,NaN,NaN,105.58989915501212,-33.212643981242856,0.024052626793166915,0.09274279870039948,0.06869017190723256,-764100,-945900,26.78091773285496,16.9065529595208,NaN,NaN,4.652978498632961,5.033402543667382
1999-09-10T09:30:00-04:00,30.3125,30.3125,29.90625,30.03125,67300,219530,60.36542405655623,51.29311020959023,NaN,NaN,107.80505220426042,20.35744118235063,0.06093719159496731,0.1448616614009417,0.08392446980597439,-831400,-894180,31.183622590154414,17.897314069803013,NaN,NaN,7.1858942637044665,5.340901360815537
1999-09-13T09:30:00-04:00,29.75,29.75,29.48437,29.5625,161000,216410,53.68482400878201,50.70612619991474,NaN,NaN,34.241490947807826,45.91533481945226,0.05018164067664431,0.14665152065177978,0.09646987997513547,-992400,-877720,32.573203428188805,18.63644784619794,NaN,NaN,7.215410361645251,5.608688360934067
1999-09-14T09:30:00-04:00,28.25,29.625,28.25,29.23437,226200,184120,49.55085066183154,50.06007154692861,NaN,NaN,-50.30077440907981,42.07095668673276,0.018989677695444032,0.1202069770944405,0.10121729939899647,-1218600,-936480,30.226709065506455,19.42531502241714,NaN,NaN,5.893615053593807,5.649392174171173
1999-09-15T09:30:00-04:00,29.0625,29.1875,28.75,28.8125,28200,157995,44.77680440862538,49.246144575647634,NaN,NaN,-62.05780038755503,27.05557350208911,-0.029401847328878794,0.06446499023789798,0.09386683756677677,-1246800,-1010660,27.530447394604536,20.102123613917204,NaN,NaN,3.18809916510341,5.297778887161493
1999-09-16T09:30:00-04:00,28.875,28.875,28.5625,28.79687,19300,125190,44.605334731943806,49.20311533225332,NaN,NaN,-79.8136218341066,-10.025130695734637,-0.060044660419229734,0.018811012042739605,0.07885567246196934,-1266100,-1111060,24.362844491277173,20.703709901569304,NaN,NaN,1.0156328860674253,4.686043744148055
1999-09-17T09:30:00-04:00,28.6875,28.96875,28.46875,28.9375,410900,133115,46.58724018869861,49.31544850072373,NaN,NaN,-66.84662163506361,-44.955465463599445,-0.06784757574698101,-0.005953797221756929,0.06189377852522408,-855200,-1115820,24.220559348173495,21.437894896040127,NaN,NaN,-0.1847636975548772,3.990214109619065
1999-09-20T09:30:00-04:00,28.96875,28.96875,28.39062,28.5,231800,142625,41.600689031353724,49.40322876899781,NaN,NaN,-86.56961762025082,-69.11768717721118,-0.09766611155792745,-0.06018886092218523,0.03747725063574222,-1087000,-1134740,23.629826716748454,22.2787517178686,NaN,NaN,-2.792420002123649,3.021266379370106
1999-09-21T09:30:00-04:00,27.96875,28.09375,27.3125,27.5625,203500,147880,33.360399972695774,48.47662897016068,NaN,NaN,-216.34591543395996,-102.3267153821872,-0.17140670593905713,-0.1767811317880792,-0.00537442584902207,-1290500,-1149120,23.167333590442354,23.11670300342963,NaN,NaN,-8.167503797104722,1.4228706398737019
1999-09-22T09:30:00-04:00,27.6875,28,27.57812,27.59375,26900,130190,33.83090099596596,47.653390676183854,NaN,NaN,-185.90648232907296,-127.09645177049079,-0.20659715953408228,-0.2636208752666249,-0.05702371573254264,-1263600,-1152480,23.0537927238843,23.91959762021417,NaN,NaN,-12.15090728405713,-0.516240492116417
1999-09-23T09:30:00-04:00,27.8125,27.9375,27.28125,27.28125,130600,122080,31.44033857547778,46.92907684310057,NaN,NaN,-194.1021097424372,-149.9541493521569,-0.23724683521822523,-0.3535822597553242,-0.11633542453709897,-1394200,-1178100,22.161909765070618,24.62271235830583,NaN,NaN,-16.24278451449453,-2.7628896381704333
1999-09-24T09:30:00-04:00,27.25,27.25,26.35937,27,187200,128660,29.425077432838677,45.686273882819485,NaN,NaN,-220.50658719238996,-180.68614246362216,-0.2609086971098997,-0.44247129592447365,-0.1815625988145739,-1581400,-1323340,17.927625178234408,24.91199876432216,NaN,NaN,-20.28621563230525,-5.266221923046835
1999-09-27T09:30:00-04:00,27.1875,27.4375,27.0625,27.25,146500,134040,33.50511814367913,44.24123784846531,NaN,NaN,-144.66281193874593,-192.30478132732122,-0.24445254119291812,-0.48712827530572156,-0.24267573411280344,-1434900,-1392920,16.319018849561786,24.64014207582983,NaN,NaN,-22.377739918271303,-7.710724493793188
1999-09-28T09:30:00-04:00,27.03125,27.03125,26.25,26.8125,694200,163570,30.21330583282753,42.481415038493424,NaN,NaN,-160.7028249516463,-181.17616323085846,-0.24703133489990792,-0.5514649027376883,-0.3044335678377804,-2129100,-1560640,13.236042028329976,24.026703778787983,NaN,NaN,-25.23167445092383,-10.213717344811851
1999-09-29T09:30:00-04:00,26.78125,27.5625,26.78125,27.17187,367800,167400,35.7935241482036,40.624273727819975,NaN,NaN,-102.72479975822505,-164.53982671668888,-0.20998826548765193,-0.5669188996973453,-0.3569306342096934,-1761300,-1660180,11.810025624102295,22.957354342448504,NaN,NaN,-25.861416427894273,-12.44910292810934
1999-09-30T09:30:00-04:00,27.25,27.5,27.09375,27.4375,609600,194340,39.6357123170779,39.14358003214295,NaN,NaN,-78.3643536184782,-141.3922754918971,-0.15555650085762202,-0.5513762602817209,-0.3958197594240989,-1151700,-1611680,16.528826884115063,21.910583220588553,NaN,NaN,-25.17216167867607,-14.266682749618873
1999-10-01T09:30:00-04:00,27.5,27.5,27.25,27.34375,85100,196100,38.754261469339895,38.07711127932565,NaN,NaN,-68.6032749400414,-111.01161304142738,-0.1156594892777244,-0.5403941210212544,-0.42473463174353,-1236800,-1542760,22.846488770532744,21.215817887898833,NaN,NaN,-24.87568478327305,-15.782254468712328
1999-10-04T09:30:00-04:00,27.625,27.625,26.98437,27.03125,68200,198745,35.889171320059575,37.10127704062766,NaN,NaN,-71.11117958848693,-96.30128657137558,-0.10066054918693468,-0.5505603182271983,-0.44989976904026363,-1305000,-1516780,25.146400214776435,20.852938684275262,NaN,NaN,-25.475904799443107,-17.167061658816724
1999-10-05T09:30:00-04:00,26.78125,26.78125,26.125,26.4375,66200,194560,31.173508028714437,36.12961301349115,NaN,NaN,-110.22757549337359,-86.20623667972104,-0.11977279936943797,-0.5996157682520611,-0.4798429688826231,-1371200,-1365200,36.954887864665395,21.52611300356532,NaN,NaN,-27.51433470333684,-18.645243522319596
1999-10-06T09:30:00-04:00,26.625,26.90625,26.53125,26.90625,69200,195575,38.089665160991096,35.66420804413739,NaN,NaN,-81.63190849878227,-81.9876584278325,-0.09118413279202464,-0.5938231348726539,-0.5026390020806293,-1302000,-1273340,42.839856112397065,22.845899547931026,NaN,NaN,-27.006524302772412,-19.839712205241426
1999-10-07T09:30:00-04:00,26.625,26.625,26.28125,26.40625,220500,201010,34.1479335369697,34.775686140442474,NaN,NaN,-100.68647215690538,-86.45208213551794,-0.09581165559241778,-0.6224035715711516,-0.5265919159787338,-1522500,-1347500,39.62412073057038,23.946153932387947,NaN,NaN,-27.872481252360735,-20.987250640544186
1999-10-08T09:30:00-04:00,26.1875,26.1875,25.6875,26.10937,365400,215915,32.02853517740364,34.091960865160324,NaN,NaN,-130.7790854479809,-98.88724423710582,-0.1078348419800369,-0.6613854684537799,-0.553550626473743,-1887900,-1477720,34.69875140509703,24.736791410127132,NaN,NaN,-29.269096064585792,-22.170371415407274
1999-10-11T09:30:00-04:00,26.125,26.53125,26.125,26.5,184300,217080,37.523142714451936,34.389299632428624,NaN,NaN,-95.5392693688859,-103.7728621931856,-0.07974215225960157,-0.6532283167982449,-0.5734861645386433,-1703600,-1557440,32.070543230118176,25.372734955818263,NaN,NaN,-28.648676088544722,-23.09584351156977
1999-10-12T09:30:00-04:00,26.71875,26.875,26.54687,26.64062,45700,208055,39.42157117810008,34.78863321686678,NaN,NaN,-64.00252363711677,-94.52785182193425,-0.043751579420296394,-0.6281756388140138,-0.5844240593937174,-1657900,-1614780,30.293219930870393,25.889836899174412,NaN,NaN,-27.556449387013753,-23.733072922347482
1999-10-13T09:30:00-04:00,26.75,27,26.75,26.8125,22200,207755,41.75139728711226,35.525137410554954,NaN,NaN,-41.730361732728696,-86.54754246872352,-0.0026027928788703303,-0.5876775504923053,-0.585074757613435,-1635700,-1681520,28.32555246851925,26.33009709227789,NaN,NaN,-25.952360800978987,-24.05011404786627
1999-10-14T09:30:00-04:00,26.78125,26.96875,26.625,26.71875,562800,234930,40.82902732511973,36.339705260003605,NaN,NaN,-44.487595330736205,-75.30776710348968,0.022676020945767483,-0.5567297314312256,-0.5794057523769931,-2198500,-1816720,24.80989634618328,26.821687889988517,NaN,NaN,-24.90212186092604,-24.171829449731952
1999-10-15T09:30:00-04:00,26.3125,26.59375,26.125,26.32812,278100,228290,37.14661525872051,36.599812196792264,NaN,NaN,-91.44795940864779,-67.44154189562308,0.01768481485922635,-0.5572997338029602,-0.5749845486621865,-2476600,-1934460,22.22308706483554,27.24340704822236,NaN,NaN,-25.06285879541875,-24.299119356258636
1999-10-18T09:30:00-04:00,26.15625,26.40625,25.96875,26.375,243500,228875,37.87082709093108,37.14677800094252,NaN,NaN,-103.05621125418844,-68.94493027268358,0.02186315281726081,-0.5476556076406105,-0.5695187604578713,-2233100,-2040360,20.18456478510697,27.73973010227786,NaN,NaN,-24.98879067641123,-24.39764383056615
1999-10-19T09:30:00-04:00,26.46875,26.67187,26.45312,26.45312,263800,231890,39.12947230214419,37.38506001193827,NaN,NaN,-53.32127558271768,-66.80868066180376,0.033513581228643785,-0.5276267839220665,-0.5611403651507103,-1969300,-2102640,19.076302383695705,28.25874987082025,NaN,NaN,-24.581852465766115,-24.42395934988043
1999-10-20T09:30:00-04:00,26.59375,27,26.51562,27,160700,238580,47.194428172561636,37.924968287329975,NaN,NaN,10.387963629153885,-56.38501558942725,0.07907542032944037,-0.4622960897389099,-0.5413715100683503,-1808600,-2137220,18.469916327104514,28.397399116748065,NaN,NaN,-21.81643423846806,-24.051455762535806
1999-10-21T09:30:00-04:00,27.0625,27.125,26.875,27.125,24100,233255,48.86221112308731,38.64696469116907,NaN,NaN,59.79111503241486,-35.52927351679703,0.11640022289448826,-0.39587123145023995,-0.5122714543447282,-1784500,-2054420,24.646501837064832,28.525971478643214,NaN,NaN,-19.033201756211575,-23.334562333060916
1999-10-22T09:30:00-04:00,27.40625,27.70312,27.34375,27.57812,299000,238845,54.475217797684394,39.97453943957084,NaN,NaN,144.1027825667037,11.58087487827326,0.1672801349086065,-0.3031712857089701,-0.4704514206175766,-1485500,-1856200,36.95922066437468,29.369744367900232,NaN,NaN,-14.832453237112539,-22.119975319354005
1999-10-25T09:30:00-04:00,27.375,27.4375,27.0625,27.125,54600,234250,48.716635435221335,41.227619968607044,NaN,NaN,80.50370696238247,48.29285852158745,0.16577353293357477,-0.26323450445060814,-0.4290080373841829,-1540100,-1717600,43.866019750502105,29.863396645459996,NaN,NaN,-12.899857491572824,-20.802815629670977
1999-10-26T09:30:00-04:00,26.875,27,26.5,26.5,16800,200380,42.10509408272654,41.514436320159575,NaN,NaN,-24.66869200647659,54.02337523683566,0.12016424597957248,-0.27880272990971733,-0.3989669758892898,-1556900,-1635120,47.54883944391017,30.19975259771093,NaN,NaN,-13.342931517928744,-19.73711789942209
1999-10-27T09:30:00-04:00,26.60937,26.82812,26.5,26.71875,73800,185680,44.9225182466714,42.2840495137097,NaN,NaN,-17.756630466379033,48.394456417729074,0.1028754399024811,-0.2703726760111884,-0.3732481159136695,-1483100,-1570020,50.319344556300116,30.963697156691627,NaN,NaN,-12.804847105906445,-18.746793500348424
1999-10-28T09:30:00-04:00,27.07812,27.14062,26.84375,26.84375,88800,159640,46.52398366306391,43.319438691256856,NaN,NaN,42.08423415390102,44.85308024202631,0.09802629044310252,-0.25071525285979135,-0.34874154330289386,-1394300,-1491980,53.49083462249027,32.30598881507686,NaN,NaN,-11.87981657947418,-17.765796797366388
1999-10-29T09:30:00-04:00,26.9375,27.09375,26.75,27.03125,98500,160310,48.92306124252839,44.133718586119464,NaN,NaN,53.44272917347825,26.721069563381224,0.10499345942701349,-0.217499719019127,-0.3224931784461405,-1295800,-1454040,54.9950199941634,33.943451441080086,NaN,NaN,-10.393011217683005,-16.712541714554476
1999-11-01T09:30:00-05:00,27.0625,27.1875,26.9375,27.01562,230400,168420,48.72681756136297,44.79837904206681,NaN,NaN,78.28782459577928,26.277893090060594,0.10579905399690354,-0.19024436095001107,-0.2960434149469146,-1526200,-1451260,55.1095841070437,35.71604888223532,NaN,NaN,-9.244124900329131,-15.645625026807998
1999-11-02T09:30:00-05:00,26.8125,27,26.71875,26.76562,44000,167310,45.57762333417875,45.071680902571565,NaN,NaN,22.04913879106072,35.621459249568055,0.08750237918112547,-0.18666544097050775,-0.2741678201516332,-1570200,-1453920,54.965406109769155,37.61889557089603,NaN,NaN,-9.144038224031402,-14.716826912125628
1999-11-03T09:30:00-05:00,26.76562,26.78125,26.5,26.625,320200,179860,43.860518051994184,45.28821595449117,NaN,NaN,-23.845851992290115,34.403614944385836,0.06497285436084405,-0.19295175220057814,-0.2579246065614222,-1890400,-1535380,50.59958198317855,39.46101597353855,NaN,NaN,-9.540508532177002,-13.977352857847253
1999-11-04T09:30:00-05:00,26.59375,26.73437,26.07812,26.20312,24100,170040,39.10103260681295,45.42781719364063,NaN,NaN,-93.98876325272977,7.189015463059678,0.02287385367792588,-0.22933228946401485,-0.25220614314194073,-1914500,-1639420,45.61607231583361,41.131943491466984,NaN,NaN,-11.302814275820303,-13.595275917557688
1999-11-05T09:30:00-05:00,26.28125,26.34375,25.375,25.5625,116000,157570,33.20815717056706,45.094769342186055,NaN,NaN,-221.4970185541769,-47.79893408247135,-0.043295626093762585,-0.30632567575914393,-0.26303004966538135,-2030500,-1786360,39.67303833665103,42.523977316577266,NaN,NaN,-14.831779224153314,-13.771919247071349
1999-11-08T09:30:00-05:00,25.78125,26.54687,25.78125,26.53125,46700,150690,46.370633593152064,45.61199514868662,NaN,NaN,-96.70517299351718,-82.79753360033064,-0.018278389258196914,-0.28587803623812746,-0.26759964697993055,-1983800,-1877880,36.4847178062435,43.76743556104497,NaN,NaN,-13.474839442840409,-13.729479275038358
1999-11-09T09:30:00-05:00,27,27.10937,26.85937,27.09375,114300,154120,52.25425053277098,45.97341103155871,NaN,NaN,64.12288748356767,-74.38278386182925,0.036697204293118735,-0.22172814161353216,-0.2584253459066509,-1869500,-1937740,34.530066419640704,44.91458913908327,NaN,NaN,-10.215843412454067,-13.227531294669173
1999-11-10T09:30:00-05:00,27.34375,27.70312,27.34375,27.6875,258700,165945,57.54845818010445,46.593857249917086,NaN,NaN,160.80598245097588,-37.45241697317606,0.10947886562986406,-0.12157676386932081,-0.23105562949918487,-1610800,-1881820,37.878307594983255,45.85971812179173,NaN,NaN,-5.574947868624445,-12.134305090948498
1999-11-11T09:30:00-05:00,27.71875,27.71875,27.51562,27.6875,217600,148685,57.548458180104454,46.81337442008994,NaN,NaN,147.4673043992038,10.838796557210657,0.15146442796858545,-0.04172509453845308,-0.19318952250703852,-1610800,-1821080,41.38483420137512,46.17583337443461,NaN,NaN,-2.082550530972924,-10.69834015380913
1999-11-12T09:30:00-05:00,27.3125,28,27.3125,27.875,137100,141635,59.205138581254,47.56255321623513,NaN,NaN,144.06351701804422,83.95090367165487,0.18356723341564823,0.036269519262521754,-0.14729771415312648,-1473700,-1709720,47.26234934479231,46.41842834545535,NaN,NaN,1.2540306954593543,-8.990858603913633
1999-11-15T09:30:00-05:00,27.98437,28.0625,27.875,28.03125,26700,130795,60.5855365834653,48.88258482343076,NaN,NaN,165.7209404290981,136.43612635617794,0.20538014734384302,0.1094274700266773,-0.09595267731716572,-1447000,-1602360,52.23503686966256,46.75315673300908,NaN,NaN,4.386854780471602,-7.0797566918585995
1999-11-16T09:30:00-05:00,28.3125,28.5,28.15625,28.5,78100,121510,64.46974981698435,50.27881564988168,NaN,NaN,189.33713594638985,161.47897604874237,0.23907500466717782,0.20289107851680654,-0.03618392615037127,-1368900,-1502240,56.3669308939701,47.1851271856998,NaN,NaN,8.337388936224777,-4.8773073164181175
1999-11-17T09:30:00-05:00,28.59375,29.1875,28.59375,29,56900,116320,68.08288701583103,51.818737317936474,NaN,NaN,206.02530719908336,170.52284099836385,0.2799002955188537,0.31369144324819587,0.03379114772934216,-1312000,-1442480,58.66534598896432,47.55473514044794,NaN,NaN,12.923145738153883,-2.334385451479261
1999-11-18T09:30:00-05:00,29.125,29.15625,28.76562,29,66500,118440,68.08288701583103,53.1872963017438,NaN,NaN,170.5997195632876,175.1493240311806,0.29050789345927536,0.39692601455343635,0.10641812109416099,-1312000,-1382720,60.88430092833579,47.9753980643174,NaN,NaN,16.531308599189924,0.36071369861633684
1999-11-19T09:30:00-05:00,28.65625,28.75,28.34375,28.34375,179400,112460,58.95672422491673,53.91800392056907,NaN,NaN,107.74487619797372,167.8855958671665,0.23907709095141816,0.4052644847834337,0.16618739383201553,-1491400,-1386260,60.67650735716512,48.373035439326074,NaN,NaN,16.87599449046388,2.720039526023129
1999-11-22T09:30:00-05:00,28.48437,28.5625,27.89062,27.89062,359900,127725,53.61283771940404,54.491947805228016,NaN,NaN,66.48322945905757,148.0380536731584,0.1638756474029913,0.37103195308575465,0.20715630568276336,-1851300,-1467120,55.977007716036454,48.4452926969166,NaN,NaN,15.43035566571939,4.535798974551166
1999-11-23T09:30:00-05:00,28,28.03125,27.25,27.3125,359300,144850,47.675411908439614,54.76444022354555,NaN,NaN,12.463568359041782,112.6633401556888,0.0693673349498472,0.2938654743700724,0.22449813942022517,-2210600,-1635460,47.69489376284522,48.23781496689279,NaN,NaN,12.188478035452214,5.6290388403941725
1999-11-24T09:30:00-05:00,27.28125,27.65625,27.21875,27.65625,23500,142335,51.14030283832355,55.62438809722488,NaN,NaN,7.202280525145488,72.89873482090121,0.026385620565479023,0.25748016512707395,0.23109454456159492,-2187100,-1810480,40.91665738482594,47.90214247182081,NaN,NaN,10.642865242524351,6.345299754984198
1999-11-26T09:30:00-05:00,27.4375,27.5625,27.25,27.25,7400,138265,47.16526405183165,56.62132430302949,NaN,NaN,-9.742408778809772,36.830309152481746,-0.02997043392330337,0.19363150215746572,0.2236019360807691,-2194500,-1986980,35.44584444986994,47.60020005133645,NaN,NaN,8.048132970309084,6.588561642887753
1999-11-29T09:30:00-05:00,27.10937,27.125,26.95312,27.03125,29500,134815,45.13106687877413,56.53278382343107,NaN,NaN,-41.25288644576244,7.030756623734507,-0.07972086753812582,0.12395085165811182,0.20367171919623764,-2224000,-2133500,31.6612709384697,47.25566813220975,NaN,NaN,5.294438989904308,6.403686978175832
1999-11-30T09:30:00-05:00,27.01562,27.25,26.92187,26.98437,14300,124010,44.68626252086671,55.99221325115219,NaN,NaN,-39.7673267163266,-14.219354611342322,-0.11157298415917086,0.06420548899727407,0.17577847315644493,-2238300,-2210900,29.848264144662807,46.921253683997044,NaN,NaN,2.9587257170505814,5.911549655157939
1999-12-01T09:30:00-05:00,26.9375,27.51562,26.9375,27.51562,21700,122895,50.62502975443814,55.49768264931888,NaN,NaN,-16.345780494238305,-19.981224381998338,-0.09338783846743867,0.059043675072146584,0.15243151353958526,-2216600,-2212100,29.81975395465055,46.34564270968757,NaN,NaN,2.7074499365816047,5.453821123932749
1999-12-02T09:30:00-05:00,27.5,27.5,27.125,27.25,53800,109575,47.8582979568466,54.805528347657614,NaN,NaN,-24.18614431646899,-26.258909350321233,-0.09543513351970262,0.03313759663995697,0.1285727301596596,-2270400,-2228760,29.399893259549316,45.48957549955715,NaN,NaN,1.656679787511652,4.911372361586878
1999-12-03T09:30:00-05:00,27.25,27.51562,27.09375,27.125,248500,120795,46.56848191370521,53.90291001426126,NaN,NaN,-36.622137783269,-31.63485515121308,-0.10086485201328413,0.0024916651430544334,0.10335651715633856,-2518900,-2293640,27.76062178567554,44.096594959620234,NaN,NaN,0.41608708281058293,4.269188750333122
1999-12-06T09:30:00-05:00,27.1875,27.3125,26.9375,27.10937,148600,122425,46.400089318468474,52.889663781047204,NaN,NaN,-65.28557334257171,-36.44139253057493,-0.1009203438834928,-0.02279391269802744,0.07812643118546536,-2667500,-2382340,25.654577691219743,42.1979907325886,NaN,NaN,-0.6419860335386101,3.56759235263716
1999-12-07T09:30:00-05:00,26.9375,27.0625,26.59375,26.59375,126000,126390,41.11786407784977,51.22167194253759,NaN,NaN,-119.61187625631861,-52.41030243857333,-0.1292826415011107,-0.08347687069092302,0.04580577081018768,-2793500,-2493380,23.2741618224196,39.834221513192134,NaN,NaN,-3.1575348244431334,2.6068598987685467
1999-12-08T09:30:00-05:00,26.34375,26.875,26.15625,26.875,67900,124070,44.808631848763135,49.55922514488988,NaN,NaN,-128.60770480241595,-74.86268730020886,-0.12275125500210102,-0.10763329794243859,0.015117957059662426,-2725600,-2595180,21.3209574883561,37.16676519172012,NaN,NaN,-4.236362205624763,1.6292567409980738
1999-12-09T09:30:00-05:00,27.03125,27.1875,26.78125,27.09375,49100,113590,47.561730232654384,48.09342823180583,NaN,NaN,-72.23282505231333,-84.47202344737772,-0.09840039842309857,-0.1078825409692108,-0.00948214254611222,-2676500,-2676400,19.886979927034773,34.23838512019862,NaN,NaN,-4.3550972090581395,0.7743490338471862
1999-12-10T09:30:00-05:00,27,27,26.3125,26.3125,49000,105160,39.90557402338201,46.73263178883906,NaN,NaN,-117.06391799151363,-100.56037948902666,-0.12775054476351766,-0.1691703235005093,-0.04141977873699164,-2725500,-2717720,19.180221052382464,31.274364669856997,NaN,NaN,-6.897865625098358,-0.3216816317164629
1999-12-13T09:30:00-05:00,26.3125,26.75,26.1875,26.46875,44900,100550,41.919296814066506,45.89737886702924,NaN,NaN,-112.97856279690812,-110.09897737989395,-0.12910062704068181,-0.20279556253784392,-0.07369493549716209,-2680600,-2720340,19.133787805797766,28.642706104839952,NaN,NaN,-8.351680189621359,-1.4688242828457336
1999-12-14T09:30:00-05:00,26.28125,26.625,26.21875,26.40625,507300,124580,41.32281112693058,45.44362166835001,NaN,NaN,-109.15330972823588,-108.0072640742774,-0.12649590558722537,-0.2318148174811938,-0.10531891189396844,-3187900,-2799220,17.7412412074535,26.503159493740544,NaN,NaN,-9.70424013201109,-2.6453122612979274
1999-12-15T09:30:00-05:00,26.65625,27.25,26.65625,26.9375,218100,131580,48.084933997643105,45.22538103687283,NaN,NaN,-46.888132785264936,-91.6633496708472,-0.08336888592732122,-0.20953001930311999,-0.12616113337579876,-2969800,-2848060,16.92012290322684,24.78912131648346,NaN,NaN,-8.853461733742542,-3.5321907573614437
1999-12-16T09:30:00-05:00,27.03125,27.375,27.01562,27.20312,62100,131840,51.11818003112592,45.507732178251,NaN,NaN,-7.667538704988209,-78.75029240138215,-0.03386593591864959,-0.16849355327411075,-0.13462761735546117,-2907700,-2894300,16.157646029106147,23.411392857857475,NaN,NaN,-7.215516084759906,-4.058380089846938
1999-12-17T09:30:00-05:00,27.1875,27.25,26.75,27,955900,176310,48.77148421527,45.7677619880007,NaN,NaN,-27.500508087923343,-60.8376104206641,-0.01279840714842767,-0.15062562629099574,-0.13782721914256807,-3863600,-3121920,13.042020126423793,22.081446371282773,NaN,NaN,-6.5379183843437465,-4.4125998462036256
1999-12-20T09:30:00-05:00,26.875,27.03125,26.375,26.40625,781300,206405,42.61318198710403,45.619684807017656,NaN,NaN,-95.61421210587729,-57.36474028245793,-0.035557968053737954,-0.1822746792097405,-0.14671671115600254,-4644900,-3514780,9.600950131283057,20.635209656041358,NaN,NaN,-7.8521005225770475,-4.903957085685543
1999-12-21T09:30:00-05:00,26.5625,26.8125,26.46875,26.48437,725800,224700,43.62185203992817,45.119457827409796,NaN,NaN,-90.36539811630115,-53.60715796007099,-0.041636188313794203,-0.1987619465482453,-0.1571257582344511,-3919100,-3661020,8.682593896623644,19.125412509039432,NaN,NaN,-8.611265225421336,-5.433572534219228
1999-12-22T09:30:00-05:00,26.40625,26.5625,26.3125,26.34375,605300,237000,42.18451190326427,44.71418739501106,NaN,NaN,-115.67467986023333,-67.36446737506466,-0.050804815567038614,-0.22063177769324938,-0.16982696212621076,-4524400,-3971940,7.122659565513345,17.534181530894006,NaN,NaN,-9.657803334522615,-6.037034077119712
1999-12-23T09:30:00-05:00,26.53125,27.09375,26.53125,27.09375,144400,243045,51.385244552125286,45.058241869183924,NaN,NaN,2.6507179313866196,-65.30081604778971,-0.004476733260703358,-0.17542287870208995,-0.1709461454413866,-4380000,-4266400,6.019626127393181,15.981253269588125,NaN,NaN,-7.716158623172387,-6.276909012270094
1999-12-27T09:30:00-05:00,27.25,28,26.90625,26.90625,1251200,305235,49.27408304839305,45.2635271356071,NaN,NaN,93.13950954503113,-41.172812521198814,0.01438816037121654,-0.1529609449773659,-0.16734910534858244,-5631200,-4619920,5.01541365115493,14.50702726672635,NaN,NaN,-6.7724402197085185,-6.347699184761297
1999-12-28T09:30:00-05:00,26.71875,27.1875,26.71875,26.9375,56100,306565,49.6454091981098,45.87263750133996,NaN,NaN,15.210566968013888,-19.007856706420576,0.028978050927646437,-0.13112654168902438,-0.16010459261667082,-5575100,-4805960,4.582195418221616,13.171886809283635,NaN,NaN,-5.90455458716114,-6.28439281367556
1999-12-29T09:30:00-05:00,27.03125,27.40625,26.92187,27.21875,47400,308220,52.98138328830972,46.45640546130757,NaN,NaN,70.47604117168444,13.160431151176553,0.05601199532001,-0.09008959846665832,-0.14610159378666832,-5527700,-5127680,3.947231585463939,11.930906387648479,NaN,NaN,-4.180113960174682,-5.983781548889721
1999-12-30T09:30:00-05:00,27.0625,27.125,26.875,27,58200,310045,50.195951650953255,46.64456413404321,NaN,NaN,31.454241153209775,42.58621535386517,0.05739197296259757,-0.07436162758342135,-0.13175360054601892,-5585900,-5339980,3.5933696156038764,10.76707707968913,NaN,NaN,-3.5163583823892135,-5.631292525103934
1999-12-31T09:30:00-05:00,27,27.25,26.8125,27.09375,34800,309095,51.37580898873619,47.46386663156851,NaN,NaN,49.67500952208277,51.991073672004404,0.0624324125654617,-0.053713084839191794,-0.11614549740465349,-5551100,-5574200,3.2474735862455617,9.629023689250781,NaN,NaN,-2.633389913005328,-5.203020723375562
2000-01-03T09:30:00-05:00,27.3125,27.3125,26.375,26.5625,380300,315685,44.886571917800495,47.67581485326379,NaN,NaN,-25.08212808453281,28.34674614609162,0.02947459465412236,-0.07930225408700053,-0.1087768487411229,-5931400,-5634240,3.1634113867330456,8.488282516460442,NaN,NaN,-3.757858211574812,-4.996568935975454
2000-01-04T09:30:00-05:00,26.3125,26.3125,25.875,26.0625,722200,344365,39.79222064575061,47.566486961750925,NaN,NaN,-178.04079087386737,-10.303525422284633,-0.023644968212425635,-0.13833305900665493,-0.1146880907942293,-6653600,-5849940,2.875437445118891,7.4264393905793975,NaN,NaN,-6.356684293588616,-5.1908711299201915
2000-01-05T09:30:00-05:00,26.125,26.75,26,26.75,337800,354955,48.45481423440766,47.592906978662675,NaN,NaN,-66.54107713711662,-37.706949084044844,-0.010779539508694452,-0.12816251518009736,-0.1173829756714029,-6315800,-6007560,2.683217166478485,6.4095175522402315,NaN,NaN,-5.823181160955408,-5.281201134353794
2000-01-06T09:30:00-05:00,26.75,27.84375,26.75,27.78125,133100,358215,58.175593102181544,48.097007912309515,NaN,NaN,142.69995803255895,-15.457805708175005,0.06473146722614909,-0.03646864163871655,-0.10120010886486563,-6182700,-6126920,2.5445000923995167,5.437149985332616,NaN,NaN,-1.7466061396396317,-4.776258992251771
2000-01-07T09:30:00-05:00,27.6875,28.40625,27.6875,28.07812,468000,379160,60.48581159082412,48.93374558199195,NaN,NaN,228.84214479328875,20.37562134606619,0.1285351448132471,0.059468822151693246,-0.06906632266155385,-5714700,-6159640,2.5062495518798613,4.684594944293762,NaN,NaN,2.2718788555694927,-3.7693821568487333
2000-01-10T09:30:00-05:00,28.07812,28.07812,27.625,27.84375,122100,382815,57.77270797766497,50.01656886703201,NaN,NaN,165.4417853782739,58.48040403862753,0.1474607477679897,0.11525961204843327,-0.03220113571955643,-5836800,-6140720,3.4104356661328694,4.2424153396401785,NaN,NaN,4.54112142866669,-2.5821673589179586
2000-01-11T09:30:00-05:00,27.84375,28.0625,27.5625,27.875,144800,387810,58.042948525758305,51.04664718744845,NaN,NaN,142.7295517910405,122.63447257160911,0.15388068658683612,0.16014972251398873,0.006269035927152611,-5692000,-5948400,12.312798063439345,4.50171563726987,NaN,NaN,6.394597157515001,-1.2997724279989644
2000-01-12T09:30:00-05:00,27.84375,27.84375,27.5625,27.75,57300,365310,56.485760915457206,52.06816497403366,NaN,NaN,107.80528722811823,157.5037454446561,0.1418035384158442,0.18352345894695787,0.04171992053111367,-5749300,-5835100,17.15698718559301,5.218453324418418,NaN,NaN,7.432883807963542,-0.05225010857574919
2000-01-13T09:30:00-05:00,27.9375,28.3125,27.71875,28.23437,149200,361865,60.86690537797738,52.745426461594526,NaN,NaN,141.72744816524224,157.30924347119273,0.1573312493840216,0.23838398226114066,0.08105273287711906,-5600100,-5718580,21.933436665414405,6.355154077134219,NaN,NaN,9.699560816778355,1.3408657379034084
2000-01-14T09:30:00-05:00,28.09375,28.09375,27.6875,28.0625,35700,360545,58.611890391686686,53.41241270040121,NaN,NaN,105.8987830288227,132.72057111829952,0.14710886955247388,0.2649388198177114,0.11782995026523753,-5635800,-5702800,22.58441853041772,7.610082997081562,NaN,NaN,10.888776992785942,2.7048530600294844
2000-01-18T09:30:00-05:00,27.875,28.5625,27.875,28.40625,110500,318275,61.67053019479103,54.27134991444988,NaN,NaN,128.60937904940255,125.35408985252525,0.15385307865915226,0.31014629858917786,0.1562932199300256,-5525300,-5640500,25.235157618363687,9.085294582805995,NaN,NaN,12.830387305144114,4.151357952188717
2000-01-19T09:30:00-05:00,28.3125,28.625,28.28125,28.3125,190300,288725,60.360389219043356,54.79842176664514,NaN,NaN,125.42151803506474,121.89248310133011,0.1426071842214458,0.33455220020683285,0.19194501598538705,-5715600,-5645220,25.16485497263045,10.600839110460745,NaN,NaN,14.041484370678587,5.564233154830127
2000-01-20T09:30:00-05:00,28.40625,28.40625,27.9375,28.3125,344300,269650,60.360389219043356,55.52445302150873,NaN,NaN,93.06177069362491,118.94377979443144,0.1263328451413221,0.3498610724120397,0.22352822727071758,-5715600,-5638480,25.48409490478994,12.16446234540261,NaN,NaN,15.029179403772853,6.916368333250516
2000-01-21T09:30:00-05:00,28.9375,29.23437,28.78125,29.09375,483300,263550,67.11275502148033,56.64852059527616,NaN,NaN,163.5438054269007,123.30705124676315,0.1573295138721123,0.42019011961085795,0.26286060573874565,-5232300,-5564920,29.041883914477907,14.006920225990635,NaN,NaN,18.04700769967357,8.506459671310953
2000-01-24T09:30:00-05:00,29.28125,29.375,28.03125,28.0625,296500,271155,54.02949184045228,57.301586304037,NaN,NaN,94.23537182480351,120.9743690059593,0.10030173645662227,0.3882377763095235,0.2879360398529012,-5528800,-5543520,30.087667299208306,15.93008136259601,NaN,NaN,16.402187021858715,9.634420721389205
2000-01-25T09:30:00-05:00,28.125,29.46875,27.8125,28,57800,211485,53.35067645055362,58.2700474329515,NaN,NaN,79.76957686897153,111.20640856987309,0.0526861857166242,0.35379377199868145,0.30110758628205725,-5586600,-5555780,29.816549256093793,17.85444649195136,NaN,NaN,14.905555842783812,10.387440024445578
2000-01-26T09:30:00-05:00,27.8125,28.28125,27.5625,27.5625,46900,211025,48.734911333896946,58.2900543686293,NaN,NaN,10.438187657121114,88.20974249428437,-0.010585584243741841,0.28787560597737993,0.2984611902211218,-5633500,-5539360,30.717008171662584,19.8568601351788,NaN,NaN,12.130902673881456,10.636506117222131
2000-01-27T09:30:00-05:00,27.65625,27.875,26.64062,27,1688800,293095,43.521341483291394,57.24332211013715,NaN,NaN,-60.192030881047735,57.55898217934985,-0.0883066396565707,0.18807789065040836,0.27638453030697907,-7322300,-5860700,24.17901918514484,21.402182927517746,NaN,NaN,7.9962645794679865,10.259328754685825
2000-01-28T09:30:00-05:00,26.9375,26.96875,26.5,26.6875,33100,291840,40.90336221778234,55.84457572634845,NaN,NaN,-106.16683424429647,3.616854245110389,-0.1548542764603426,0.0828166847315508,0.2376709611918934,-7355400,-6285320,18.55798297100104,22.54873531459783,NaN,NaN,3.7515563981448263,9.329646989465683
2000-01-31T09:30:00-05:00,26.1875,27.3125,26.125,27.3125,101600,295180,47.6818247040482,55.123798349661534,NaN,NaN,-82.70831400398687,-31.77188292064769,-0.15072808981012548,0.049260848929236545,0.19998893873936202,-7253800,-6630320,15.421111567651792,23.4066407361349,NaN,NaN,2.333545966735234,8.330203986218477
2000-02-01T09:30:00-05:00,27.3125,27.3125,27,27.25,114200,281875,47.10002400898852,54.34216088417798,NaN,NaN,-58.69004969098374,-59.46380823263875,-0.1460523253896461,0.017423532002304398,0.1634758573919505,-7368000,-6986600,12.980898591037914,23.454362202391938,NaN,NaN,1.0387119177699322,7.288562262154399
2000-02-02T09:30:00-05:00,27.3125,27.60937,27.25,27.42187,29400,247235,48.94489206312067,53.80352739472537,NaN,NaN,-45.578309661628,-70.66710769638857,-0.12598737890525566,0.005991633760380921,0.13197901266563658,-7338600,-7327620,11.160491696785797,23.026041096048566,NaN,NaN,0.5381030716373487,6.324210949223392
2000-02-03T09:30:00-05:00,27.375,27.375,26.71875,27.09375,96800,235185,45.67027323259136,52.718053670054935,NaN,NaN,-103.52771244184699,-79.33424400854841,-0.12894967190271253,-0.02920807721275409,0.09974159468995844,-7435400,-7350240,11.049799868527359,22.248638467699493,NaN,NaN,-0.8762389375814212,5.295575251108419
2000-02-04T09:30:00-05:00,26.84375,27,26.15625,26.3125,65600,231810,38.982716357361745,51.315969810460295,NaN,NaN,-157.59628951781625,-89.62013506325236,-0.17481349982133948,-0.1187752800867159,0.05603821973462357,-7501000,-7379360,10.899921466461748,21.41403153455978,NaN,NaN,-4.346495047617442,3.918136637004724
2000-02-07T09:30:00-05:00,26.3125,26.71875,26.3125,26.60937,55300,211175,42.43235277851944,49.94181428072661,NaN,NaN,-127.56305478832687,-98.59108322012037,-0.1759613859995079,-0.1639135127647613,0.01204787323474659,-7445700,-7417740,10.694036522712409,20.375380027727545,NaN,NaN,-6.1075947357381235,2.48588929804146
2000-02-08T09:30:00-05:00,26.75,27.0625,26.375,26.375,149400,212540,40.48632428498213,48.52223821400796,NaN,NaN,-104.96812075648656,-107.84669743322092,-0.18252345623072366,-0.216106447053658,-0.03358299082293433,-7595100,-7463160,10.442651812325522,19.32379408770576,NaN,NaN,-8.155846450260142,0.9656413339983743
2000-02-09T09:30:00-05:00,26.125,26.125,25.5,25.5,86200,209610,34.183204368191824,46.65243929608999,NaN,NaN,-164.95229753471125,-131.72149500783758,-0.23260253966544833,-0.32433616540474475,-0.09173362573929641,-7681300,-7531700,10.05840696400054,18.221959234792234,NaN,NaN,-12.139390162914445,-0.9065060227034569
2000-02-10T09:30:00-05:00,25.75,26.4375,25.71875,26.03125,615000,237495,40.263981248947935,44.734669740909105,NaN,NaN,-116.39501824244354,-134.29495616795688,-0.21705827762393853,-0.3630564727692196,-0.14599819514528106,-7066300,-7457880,13.739882553117226,17.128959137552183,NaN,NaN,-13.444835004875925,-2.6976958772995236
2000-02-11T09:30:00-05:00,26.28125,26.4375,25.3125,25.71875,207800,240425,38.03773720948642,43.59240155298297,NaN,NaN,-121.5879424483621,-127.09328675406604,-0.2145488640003555,-0.4141842751457254,-0.19963541114536992,-7274100,-7412500,16.015685551119958,16.1238175841173,NaN,NaN,-15.229586545997398,-4.487965972827792
2000-02-14T09:30:00-05:00,25.875,26.25,25.59375,26.125,523000,264790,42.489492564486035,42.81660270397814,NaN,NaN,-98.22653809114372,-121.22598341462943,-0.17398304231813247,-0.4171142140430355,-0.24313117172490303,-6751100,-7273580,22.735959856085444,15.618061198402419,NaN,NaN,-15.272068177969034,-6.028552002133683
2000-02-15T09:30:00-05:00,26.625,27.21875,26.4375,27.21875,300700,274300,52.404240117129326,43.07869761706616,NaN,NaN,-16.591474388657915,-103.5506541410637,-0.06741954232308106,-0.3274055996287544,-0.2599860573056733,-6450400,-7044640,32.344037090214655,15.734277549727567,NaN,NaN,-11.796018616689818,-6.852475804213131
2000-02-16T09:30:00-05:00,27.15625,27.5,27.15625,27.34375,123900,270980,53.39315919963583,43.783827453947914,NaN,NaN,21.7090598313939,-66.21838266784266,0.013254090044536815,-0.2434184447500023,-0.2566725347945391,-6326500,-6773680,41.60034037959518,16.97865763504545,NaN,NaN,-8.774863897337964,-7.127102674659535
2000-02-17T09:30:00-05:00,27.40625,27.48437,26.9375,27.3125,88000,258165,53.0961429851798,44.654740365904864,NaN,NaN,19.433512422018524,-39.05267653495024,0.06346969111404785,-0.1773354209019793,-0.24080511201602714,-6414500,-6643320,45.465992445942405,18.90065831182698,NaN,NaN,-6.4981128810023385,-7.037246989851364
2000-02-18T09:30:00-05:00,27.1875,27.1875,26.4375,26.51562,141700,241085,46.05983968897198,44.53888429339942,NaN,NaN,-25.474397005545548,-19.829967446386924,0.04295702523725467,-0.1871088304694588,-0.23006585570671348,-6556200,-6499740,49.435973016402976,21.330291272452065,NaN,NaN,-6.738212106467359,-6.994527720796507
2000-02-22T09:30:00-05:00,26.625,26.625,26,26.28125,74600,229990,44.20442455468193,44.332055760948954,NaN,NaN,-65.87844704213614,-13.360349236585435,0.014988726037828776,-0.21132994815942752,-0.2263186741972563,-6630800,-6475680,50.09163598949817,23.98105822948494,NaN,NaN,-7.514943490240544,-7.068872830717083
2000-02-23T09:30:00-05:00,26.0625,26.0625,25.40625,25.59375,76200,230910,39.214227428309236,43.63700828703385,NaN,NaN,-134.03142294564566,-36.84833894798298,-0.0451383355733945,-0.2827415936639994,-0.23760325809060492,-6707000,-6527000,48.64275447372146,26.658362713551778,NaN,NaN,-9.816986360309553,-7.4614604778017215
2000-02-24T09:30:00-05:00,25.25,25.4375,24.9375,25.3125,316000,244365,37.35633431145883,43.043155506952964,NaN,NaN,-170.76354860576723,-75.3428606354152,-0.09624112119740569,-0.35790465958736206,-0.2616635383899564,-7023000,-6666300,44.85060768626019,29.072706129104123,NaN,NaN,-12.28268571539277,-8.150206940314728
2000-02-25T09:30:00-05:00,25.15625,25.53125,24.6875,24.8125,662800,193065,34.24966159167373,42.70508016654667,NaN,NaN,-165.73779162667847,-112.3771214451546,-0.15274953397348323,-0.4526004558568104,-0.2998509218833272,-7685800,-6920560,38.890880669357664,31.072060357882403,NaN,NaN,-15.368456102078603,-9.181385391995281
2000-02-28T09:30:00-05:00,25.0625,25.84375,24.625,25.5625,456100,214215,42.03650999054977,42.67680568169169,NaN,NaN,-110.18532189205087,-129.31930642245567,-0.12956359789256383,-0.46180541924903196,-0.3322418213564681,-7229700,-7055260,36.150290686277835,32.890364226708506,NaN,NaN,-15.509781594184988,-10.085441992308096
2000-02-29T09:30:00-05:00,25.625,26.34375,25.625,26.15625,80300,213150,47.35232619543356,43.16723438958108,NaN,NaN,-31.971906451247882,-122.53799830427802,-0.06731844129038278,-0.41638987296944663,-0.34907143167906385,-7149400,-7158980,34.15446168599277,34.58406493197045,NaN,NaN,-13.860339637972297,-10.624713084545839
2000-03-01T09:30:00-05:00,26.01562,26.90625,25.9375,26.8125,880600,251470,52.53376735553769,44.47798888867721,NaN,NaN,27.903603186463364,-90.15099307785621,0.020287320400773967,-0.32371228117809636,-0.34399960157887033,-6268800,-7071340,37.304200374356874,36.530193032710194,NaN,NaN,-10.715112715959549,-10.63762731760494
2000-03-02T09:30:00-05:00,26.89062,27.40625,26.875,27.3125,392700,269635,56.08039186926578,45.607732504414194,NaN,NaN,104.50490013363897,-35.09730332997498,0.10917843037721997,-0.20752656360734534,-0.3167049939845653,-5876100,-6841960,44.75312761489113,38.7454248228369,NaN,NaN,-6.933584800622854,-10.1084783866075
2000-03-03T09:30:00-05:00,27.25,27.25,26.59375,26.875,611700,295380,52.39159449190967,46.63300802458729,NaN,NaN,72.53480722146884,12.557216439654486,0.13413745333057808,-0.1490331773213427,-0.2831706306519208,-6487800,-6602360,51.2664064652155,41.263333459558005,NaN,NaN,-5.019595223966034,-9.38149507765872
2000-03-06T09:30:00-05:00,26.6875,27,26.53125,26.71875,279800,306090,51.098853358819795,47.2479623670397,NaN,NaN,51.63629275108427,44.92153936828153,0.13535968104152452,-0.11397102935001513,-0.24933071039153964,-6767600,-6509940,53.54160855345893,43.463736937941825,NaN,NaN,-3.8891637269700343,-8.596876313274622
2000-03-07T09:30:00-05:00,26.65625,28.5625,26.65625,28.5625,499500,328300,62.77196738822005,47.98851431497475,NaN,NaN,159.90382718729677,83.29668609599045,0.24896688969821223,0.06187790173122565,-0.1870889879669866,-6268100,-6333680,57.60662253723206,45.2682073270145,NaN,NaN,1.496988797996049,-7.154895583093098
2000-03-08T09:30:00-05:00,27.75,28.84375,27.75,28.09375,1089400,375300,58.92106754790306,48.38336491127955,NaN,NaN,162.27137557151954,110.17024057300168,0.27891355606720863,0.16155295711702422,-0.11736059895018443,-7357500,-6551420,51.6001688359037,45.982480788179394,NaN,NaN,4.4077832805925015,-5.5030843168522985
2000-03-09T09:30:00-05:00,27.6875,28.15625,27.375,28.125,358400,388910,59.101203514901975,48.81229780625971,NaN,NaN,117.05751181039453,112.68076290835279,0.2861266930648805,0.24029776738091613,-0.04582892568396432,-6999100,-6776020,46.2439660525547,46.03805033150884,NaN,NaN,6.693291013369142,-3.7607449839635216
2000-03-10T09:30:00-05:00,28,28.6875,27.71875,27.75,663100,391315,55.931603320727476,49.51742377995652,NaN,NaN,116.82501690944851,121.53880484594872,0.2521347031767995,0.269339453287035,0.017204750110235548,-7662200,-7010900,41.40373216020704,45.46431884178056,NaN,NaN,7.566965309811809,-2.1425006562813316
2000-03-13T09:30:00-05:00,27.75,28.21875,27.21875,27.34375,350600,398455,52.638121062798746,50.119830673393444,NaN,NaN,71.81528164970432,125.57460262567274,0.19152908632727245,0.2566161080193261,0.06508702169205366,-8012800,-7259940,36.983664038016414,44.52803513096044,NaN,NaN,7.267024134740849,-0.7982828289924486
2000-03-14T09:30:00-05:00,27.1875,27.71875,27,27.6875,360400,390325,55.050033030781016,51.25095964499857,NaN,NaN,55.60403020913426,104.71464323004025,0.1648463246043867,0.27114492744753704,0.10629860284315035,-7652400,-7536800,32.79245609684507,43.395870961183554,NaN,NaN,7.749409847631757,0.42281612481100916
2000-03-15T09:30:00-05:00,27.39062,27.75,27.15625,27.5625,419500,396265,53.97365130079476,52.43791085852257,NaN,NaN,53.46527337311511,82.95342279035935,0.13053425770736732,0.2694664249773595,0.1389321672699922,-8071900,-7679680,30.849456542073355,42.395788736598774,NaN,NaN,7.828245028441221,1.480734539615325
2000-03-16T09:30:00-05:00,27.375,28.78125,26.75,28.75,566300,418385,61.64599048318051,54.3947914936302,NaN,NaN,96.51040529683638,78.84400148764772,0.17670215515915114,0.3598098612189311,0.18310770605977997,-7505600,-7780980,29.51423605034003,41.726028406668945,NaN,NaN,10.360298469146326,2.749243672405468
2000-03-17T09:30:00-05:00,28.625,28.625,27.76562,27.78125,149800,421475,53.77128268384887,55.23298954315157,NaN,NaN,86.35628957836244,72.75025602143052,0.13288356007388924,0.3492121561521415,0.21632859607825228,-7655400,-7779620,29.558316837598795,41.2551731317633,NaN,NaN,9.941119068894007,3.7766544433324025
2000-03-20T09:30:00-05:00,27.90625,27.90625,27.21875,27.34375,237500,426265,50.62603703278263,55.46682603153364,NaN,NaN,39.42074220442097,66.27134813237384,0.06856048334577461,0.30202920026047053,0.23346871691469592,-7892900,-7755640,30.38501245365029,40.985926758024554,NaN,NaN,8.56638684594812,4.460901929420362
2000-03-21T09:30:00-05:00,26,28.21875,26,28.21875,176500,431360,56.150425800958644,55.72515877763514,NaN,NaN,34.97078337512763,62.14469876557253,0.0783619372834557,0.33142113851901556,0.25305920123555986,-7716400,-7768440,30.181401663482134,40.477155421533496,NaN,NaN,9.231644384271794,5.142436565827709
2000-03-22T09:30:00-05:00,28.15625,28.34375,27.875,28,41900,429645,54.508420568126965,55.61287511326808,NaN,NaN,75.83050376157799,66.61774484326509,0.064130230093487,0.3332219888524186,0.2690917587589316,-7758300,-7705720,32.56592479619212,39.606640934483565,NaN,NaN,9.234839013179098,5.727065486877907
2000-03-23T09:30:00-05:00,27.8125,28.3125,27.65625,27.96875,41500,415920,54.26428994994252,55.74663907455614,NaN,NaN,64.96324254659125,60.308312293216055,0.04740069891530613,0.32834263240306427,0.28094193348775814,-7799800,-7764560,31.479717928876468,38.19330603903078,NaN,NaN,9.164202808491826,6.218085104251324
2000-03-24T09:30:00-05:00,28.1875,28.3125,27.9375,28.03125,161400,390850,54.70126775565035,56.00395438861546,NaN,NaN,75.4497609503668,58.127006567616924,0.03585743992270696,0.32576373339114184,0.2899062934684349,-7638400,-7761160,31.621642871416896,36.6275942045992,NaN,NaN,9.230607791566774,6.6484454881535315
2000-03-27T09:30:00-05:00,27.9375,28.4375,27.59375,28.125,219100,379000,55.389784048338925,55.476655578623955,NaN,NaN,67.43624236645464,63.73010660002367,0.03008252820746604,0.3275094537277674,0.29742692552030137,-7419300,-7666440,35.6222233765732,35.057279978837855,NaN,NaN,9.473327179668473,7.052000015512809
2000-03-28T09:30:00-05:00,28.1875,28.34375,27.8125,28,69300,378450,54.20672942084047,55.139917140976635,NaN,NaN,61.75734341340163,69.08741860767847,0.014197157101952906,0.3151733718977425,0.3009762147957896,-7488600,-7620880,37.51587783365262,34.05125919296278,NaN,NaN,9.363534208033064,7.382219185872846
2000-03-29T09:30:00-05:00,27.875,29.5625,27.875,29.46875,232800,346060,63.94996789630516,55.486257453934,NaN,NaN,198.09753992173356,93.54082583970958,0.09448452684202302,0.41908187334831837,0.32459734650629535,-7255800,-7520380,41.596888903362185,33.7193251108776,NaN,NaN,12.28572940180757,8.082720645292092
2000-03-30T09:30:00-05:00,29.71875,30.21875,29.21875,29.46875,177900,335320,63.94996789630516,56.058997780760976,NaN,NaN,270.189690924,134.58611551519135,0.13689476769701736,0.49571580612756705,0.3588210384305497,-7255800,-7411580,45.729366502122716,34.028298992443005,NaN,NaN,14.611033676000487,9.015336792536148
2000-03-31T09:30:00-05:00,29.375,29.98437,29.3125,29.3125,627900,336130,62.31416870489198,56.75014404091049,NaN,NaN,228.7744702789357,165.2510573809051,0.14305762222549168,0.5376430662124143,0.39458544398692263,-7883700,-7460640,44.2102846726059,34.54448618062797,NaN,NaN,16.079332894360416,10.024479092796758
2000-04-03T09:30:00-04:00,29.5,29.8125,29.39062,29.8125,140700,329175,65.3670751166787,57.487075618474606,NaN,NaN,194.11000902502101,190.58581071261838,0.16773253483676764,0.6042511125328822,0.4365185776961146,-7743000,-7525380,42.21728985790933,35.21768859213256,NaN,NaN,18.252891746957165,11.199966614819672
2000-04-04T09:30:00-04:00,30,30.15625,28.9375,29.4375,414600,324930,61.3527254545059,58.01415234373969,NaN,NaN,138.45154842366424,205.92465171467092,0.14649419490758497,0.6196363213305958,0.4731421264230108,-8157600,-7659180,38.36768176723184,35.754704679643886,NaN,NaN,18.961611007885327,12.308772956686195
2000-04-05T09:30:00-04:00,29.48437,29.5625,28.5625,28.5625,50800,273000,53.15061017704754,57.40733946473019,NaN,NaN,61.70430848325368,178.64600542697494,0.06534894483557929,0.5548283074674849,0.4894793626319056,-8208400,-7849700,33.66092879009955,36.050897018198135,NaN,NaN,17.06750874422808,12.988592354906464
2000-04-06T09:30:00-04:00,28.6875,29.375,28.6875,29.3125,38000,256980,58.296942206531355,57.73060085920751,NaN,NaN,74.61449134150534,139.530965510476,0.054463732410399146,0.5575590281449045,0.5030952957345054,-8170400,-8032620,29.871930261205065,36.07329797702715,NaN,NaN,17.040782285073647,13.567476630644633
2000-04-07T09:30:00-04:00,29.3125,29.375,28.8125,28.85937,255400,236595,54.40823924234188,58.00075815989032,NaN,NaN,56.91046181021682,105.15816381673221,0.011281691509428482,0.5171974101212911,0.5059157186118626,-8425800,-8141040,27.869487040799612,35.89361759039496,NaN,NaN,15.782453766582169,13.883901935778566
2000-04-10T09:30:00-04:00,28.6875,28.79687,28.32812,28.4375,27000,220415,50.99750092570201,57.63269209737199,NaN,NaN,5.978796247922721,67.53192126131255,-0.047910474933720526,0.44602762494471193,0.49393809987843246,-8452800,-8283000,25.462674766251766,35.55656566916422,NaN,NaN,13.659437353629128,13.851835566900075
2000-04-11T09:30:00-04:00,28.4375,29.15625,28.4375,28.9375,487900,226790,54.6278557753622,57.641223183603074,NaN,NaN,32.56245656854676,46.35410289028906,-0.05509373931640893,0.42507092573292127,0.4801646650493302,-7964900,-8244460,27.29831728386266,35.18030798971212,NaN,NaN,12.99124493651614,13.728894048273798
2000-04-12T09:30:00-04:00,29.0625,29.5625,28.95312,29.1875,242200,217925,56.36840621451375,57.79151720250102,NaN,NaN,65.67029625619237,47.1473004448768,-0.04513111905694178,0.423750766228153,0.4688818852850948,-7722700,-8147320,31.853727407805337,35.20702295249275,NaN,NaN,12.968495940672826,13.620265747187945
2000-04-13T09:30:00-04:00,29.25,29.375,29.01562,29.125,440800,211650,55.792176952562826,57.86943928799477,NaN,NaN,53.62054814595162,42.94851180576605,-0.044784204484811685,0.4129016296790802,0.45768583416389186,-8163500,-8145940,31.91899155544283,35.22826214420889,NaN,NaN,12.784156859454205,13.50082162036884
2000-04-14T09:30:00-04:00,29.125,29.375,28.21875,28.5,1849100,296615,50.25918913356496,57.50296822265377,NaN,NaN,-0.5015643646905047,31.466106570784586,-0.08627777742194842,0.3498386123864563,0.4361163898084047,-10012600,-8463300,25.79965605088786,34.52665019237422,NaN,NaN,10.968284936265439,13.139030665496925
2000-04-17T09:30:00-04:00,28.25,28.40625,27.51562,27.8125,216100,295545,44.97547259252322,56.84359273491683,NaN,NaN,-95.78239768090569,11.113867785018915,-0.15561295516836848,0.24160019584794412,0.3972131510163126,-10228700,-8818480,20.957166741323974,33.34388511435075,NaN,NaN,7.7213087038336194,12.36507038525931
2000-04-18T09:30:00-04:00,27.625,28.04687,27.625,27.95312,79600,290700,46.22083895325752,55.57722638184199,NaN,NaN,-106.52126549403631,-16.702876627497698,-0.18556068967653483,0.1652622889206441,0.3508229785971789,-10149100,-9255320,16.784438120895558,31.571567201317414,NaN,NaN,5.4449976294410005,11.376488562999551
2000-04-19T09:30:00-04:00,28,28.60937,28,28.5625,377800,307495,51.35858673493709,54.67784201317284,NaN,NaN,-46.71131168275669,-39.179198215287514,-0.15891312965732968,0.15218156652551684,0.3110946961828465,-9771300,-9665040,13.974087645215576,29.30333299725262,NaN,NaN,5.001856741464073,10.46582687420877
2000-04-20T09:30:00-04:00,28.5625,28.76562,28.3125,28.60937,235600,317200,51.74047231956871,53.92257798564975,NaN,NaN,-30.480690849847644,-55.99944601444737,-0.13372552349740185,0.14393779181109423,0.2776633153084961,-9535700,-9939480,12.468169692434515,27.036039070097523,NaN,NaN,4.753856889119064,9.649831162053097
2000-04-24T09:30:00-04:00,28.8125,29,28.45312,28.92187,22000,310230,54.31580202140354,53.13320133598724,NaN,NaN,-4.612722514456513,-56.821677644400566,-0.09351669051008138,0.1607674521708944,0.25428414268097577,-9513700,-9839700,16.012023033433536,25.16423429692068,NaN,NaN,5.28030378255594,9.025612964982075
2000-04-25T09:30:00-04:00,28.92187,29.29687,28.92187,28.96875,430800,320815,54.7062920155534,52.658456090347784,NaN,NaN,29.844271553495332,-31.696343797520363,-0.06273876143310925,0.17586069088958922,0.23859945232269847,-9082900,-9610540,23.65672429616123,24.11345162041564,NaN,NaN,5.821540672521436,8.567888351773412
2000-04-26T09:30:00-04:00,29.0625,29.40625,28.90625,29.34375,429500,338825,57.812669958225165,52.9914603604319,NaN,NaN,49.02831402584131,-0.5864278935448368,-0.0184025239406021,0.21559629739694586,0.23399882133754796,-8653400,-9311400,32.317205777138724,24.01747140520415,NaN,NaN,7.16320995341611,8.367220009150941
2000-04-27T09:30:00-04:00,29.125,29.78125,29.01562,29.75,27500,328560,60.93814523942861,53.18011771992456,NaN,NaN,89.46962084586403,26.649758612179312,0.03414386483597337,0.27667865238251466,0.2425347875465413,-8625900,-9082320,38.10757325654031,24.605731619156668,NaN,NaN,9.232689933900188,8.490858569829404
2000-04-28T09:30:00-04:00,29.6875,29.6875,28.875,28.875,53000,322315,52.001943486050074,53.008239451618,NaN,NaN,35.83300625551939,39.91249803325272,0.007237446310947998,0.2515815954352263,0.2443441491242783,-8678900,-8910960,42.098077637018164,25.622059518886562,NaN,NaN,8.430689785237591,8.482263029173431
2000-05-01T09:30:00-04:00,29.1875,29.5625,29.03125,29.34375,34700,292655,55.74593467048381,53.34741329053099,NaN,NaN,67.78832258146592,54.39270705243721,0.017680516496633103,0.26644479474506966,0.24876427824843655,-8644200,-8737060,45.90949188877993,27.08254645621,NaN,NaN,8.902550530216676,8.542304100751037
2000-05-02T09:30:00-04:00,29.34375,30,29.34375,29.76562,148000,293020,58.85646748365341,53.649456983980365,NaN,NaN,135.12456138019715,75.44876501777756,0.04795401007759259,0.3087067908454273,0.2607527807678347,-8496200,-8619720,48.37867611779446,28.588286372919413,NaN,NaN,10.265494511444398,8.788474159421517
2000-05-03T09:30:00-04:00,29.75,29.75,29,29,79100,276245,51.74773357477562,53.31940893828478,NaN,NaN,60.52140988950552,77.74738419051042,0.013177707809577832,0.277224915529807,0.26404720772022916,-8575300,-8604100,48.71429653987379,29.79261273949573,NaN,NaN,9.178453054614609,8.844185430163387
2000-05-04T09:30:00-04:00,29.1875,29.79687,29.1875,29.75,44000,275905,57.20108518348472,53.420045240493494,NaN,NaN,105.90171614116908,81.03380324957142,0.03614577793104773,0.3092294301340388,0.2730836522029911,-8531300,-8585180,49.145589777580014,31.023084041076963,NaN,NaN,10.051727868196028,9.01669149273948
2000-05-05T09:30:00-04:00,29.75,30.10937,29.625,30.0625,35600,275785,59.266788183149366,54.06344517260667,NaN,NaN,146.60030290411174,103.18726257928988,0.06610026632347743,0.35570898510733784,0.2896087187838604,-8495700,-8548540,50.022132462825326,32.75326092764392,NaN,NaN,11.426980296907415,9.36101846476347
2000-05-08T09:30:00-04:00,29.875,30.59375,29.875,30.4375,83000,267165,61.65829940800968,55.25507565942713,NaN,NaN,173.22952198148218,124.27550245929315,0.10270139067069683,0.41798545712223145,0.3152840664515346,-8412700,-8502240,51.167548307352966,34.911145325217426,NaN,NaN,13.32358008523468,9.927098696259357
2000-05-09T09:30:00-04:00,30.75,30.78125,30.1875,30.45312,122400,271935,61.75901281972759,56.36494522131784,NaN,NaN,174.70845043779818,132.19228027081334,0.11838093698238589,0.46326023767951696,0.3448793006971311,-8290300,-8461060,52.21649519911921,37.44200654509054,NaN,NaN,14.859869283840654,10.631780208770971
2000-05-10T09:30:00-04:00,30.4375,30.71875,30.21875,30.54687,353700,265225,62.3974355356287,57.15343442136725,NaN,NaN,153.59279553714384,150.80655740034098,0.1248415557455323,0.5009312453790464,0.37608968963351413,-7936600,-8333320,55.41576965206076,40.40212668843663,NaN,NaN,16.302432977437125,11.441873461437565
2000-05-11T09:30:00-04:00,30.6875,31.54687,30.6875,31.5,130800,259655,68.2085012319197,58.32972220082089,NaN,NaN,193.50927212639678,168.32806859738656,0.17974433778355708,0.6007701118629605,0.4210257740794034,-7805800,-8188220,58.79090905635066,43.710893785859206,NaN,NaN,19.47208910889079,12.589047125359453
2000-05-12T09:30:00-04:00,31.375,31.625,31.32812,31.60937,45100,239870,68.80425182442326,59.36461147246515,NaN,NaN,178.83423936523306,174.77485588961082,0.2078751689975008,0.6808697353262794,0.47299456632877857,-7760700,-8041220,61.93483805101086,46.991094858543306,NaN,NaN,22.215340336653952,13.964231869830096
2000-05-15T09:30:00-04:00,31.6875,32.3125,31.5,32.26562,1278300,211330,72.17374117684977,60.61228641255775,NaN,NaN,183.17105992242696,176.76316347779976,0.25217800986719174,0.7882170786627682,0.5360390687955765,-6482400,-7655160,68.69062887419807,50.207802328403076,NaN,NaN,25.69646003105383,15.64026446429063
2000-05-16T09:30:00-04:00,32,32.125,31.375,31.64062,930400,247045,64.97568945093516,61.12393066203703,NaN,NaN,137.3144399460199,169.2843613794441,0.2219535784986174,0.8134810419188483,0.5915274634202309,-7412800,-7479660,71.19353985630195,52.98468333405759,NaN,NaN,26.449274222950642,17.184408715527773
2000-05-17T09:30:00-04:00,31.8125,31.8125,31.35937,31.79687,45600,245345,65.89153576677953,61.47774427113353,NaN,NaN,116.91395862880846,161.94859399777704,0.19595298411569528,0.83646869356485,0.6405157094491547,-7367200,-7365780,72.7176217584471,55.456829655622364,NaN,NaN,27.334901922709015,18.634479173696523
2000-05-18T09:30:00-04:00,31.75,31.98437,31.375,31.75,889700,270940,65.33959930465589,62.430433972462524,NaN,NaN,106.11925012082403,144.47058959666248,0.16055354268489985,0.8412076378052795,0.6806540951203797,-8256900,-7456000,69.576941020807,57.41960561160728,NaN,NaN,27.89311911282007,19.957142022142744
2000-05-19T09:30:00-04:00,31.53125,31.98437,31.39062,31.8125,71400,262730,65.75157332348701,63.14512244767703,NaN,NaN,96.99828772746501,128.10339926910885,0.1277325871163455,0.8403198290158116,0.7125872418994661,-8185500,-7540960,66.65730805111978,58.90159248034585,NaN,NaN,28.466811901972918,21.17280914783277
2000-05-22T09:30:00-04:00,31.5625,31.92187,31.54687,31.54687,108400,267050,62.359089372117815,63.3953097254245,NaN,NaN,83.90695120231916,108.25057752508731,0.0770166868254597,0.8088581004312907,0.731841413605831,-8293900,-7903260,55.8873302990362,59.43792492186311,NaN,NaN,28.028215295066662,22.152152883151896
2000-05-23T09:30:00-04:00,31.5,31.75,31.21875,31.42187,140300,252525,60.77010647047787,64.03976493226037,NaN,NaN,61.91083112233782,93.16985576035088,0.02654233461713651,0.7650193318772516,0.7384769972601151,-8434200,-8107540,50.894151558914665,59.593628851794605,NaN,NaN,27.228651055498652,22.87736690777286
2000-05-24T09:30:00-04:00,31.375,31.60937,31.0625,31.45312,64800,234290,61.03740222236887,64.31378757789494,NaN,NaN,49.603560229726895,79.70777608053459,-0.011223656362975176,0.7244474268063961,0.7356710831693712,-8369400,-8307980,46.50383582985579,59.40493214124287,NaN,NaN,26.625525360553247,23.412818115312916
2000-05-25T09:30:00-04:00,31.5,31.5,30.59375,30.875,331800,249505,53.74211586337054,63.91916812648218,NaN,NaN,17.288911379250194,61.94170833221982,-0.07790752589200123,0.6382866758043697,0.7161942016963709,-8701200,-8396840,44.664353887181974,59.022233671554055,NaN,NaN,24.026534563560897,23.500491893634056
2000-05-26T09:30:00-04:00,30.9375,31.35937,30.89062,30.89062,34600,248585,53.902430085737166,63.36517746060556,NaN,NaN,15.96782402171545,45.735615591069894,-0.12115221610681848,0.5647539315628478,0.6859061476696663,-8666600,-8493060,42.69498382099094,58.41705049395677,NaN,NaN,21.912060887529165,23.273573178476216
2000-05-30T09:30:00-04:00,31.09375,31.5,31,31.32812,62400,249970,58.265236625270155,63.11562201814432,NaN,NaN,30.469566548436866,35.04813866029343,-0.12023919828185425,0.5356071498173485,0.6558463480992027,-8604200,-8555120,41.42624296101537,57.646318191235075,NaN,NaN,21.18669550282433,22.975447796240232
2000-05-31T09:30:00-04:00,31.3125,32.3125,31.3125,32.26562,114700,248305,65.74644112878596,63.35483670336991,NaN,NaN,91.6307049052515,40.992113416876165,-0.059513965073989206,0.5814538917567162,0.6409678568307055,-8489500,-8566180,41.19131765725247,56.630285905891625,NaN,NaN,22.81297713642244,22.952237701980547
2000-06-01T09:30:00-04:00,32.15625,32.15625,31.375,31.96875,41300,246415,61.958903025675255,62.90843683149531,NaN,NaN,75.69210794180607,46.209822959292005,-0.043121876409506155,0.5870655113188228,0.6301873877283289,-8530800,-8598460,40.469960880384804,55.32164675046549,NaN,NaN,23.006712478087437,22.96001981285296
2000-06-02T09:30:00-04:00,31.875,31.90625,30.6875,30.875,49600,246695,50.43168133686735,61.59611036809845,NaN,NaN,-17.77246351763254,39.197547979915456,-0.10613298070753818,0.49752116184390616,0.6036541425514443,-8580400,-8574300,41.29855399139916,53.84762646049323,NaN,NaN,19.214885121706097,22.42500057126055
2000-06-05T09:30:00-04:00,30.6875,31,30.375,30.4375,1123300,301080,46.689819121835974,59.77583022131176,NaN,NaN,-111.81692414748159,13.640598346076064,-0.1734870814389149,0.3867952907528007,0.5602823721917156,-9703700,-8781720,36.58982336275715,51.55471178110459,NaN,NaN,14.829742324332667,21.33996367884228
2000-06-06T09:30:00-04:00,30.59375,31.625,30.59375,31.625,65700,300215,56.191185941662994,59.14836568493517,NaN,NaN,-14.470909301865609,4.652503176015569,-0.13593335908404425,0.3903656733366603,0.5262990324207045,-9638000,-8988480,32.59972571730266,48.79801077117606,NaN,NaN,14.350638989310674,20.34148872319491
2000-06-07T09:30:00-04:00,31.5,31.60937,31.03125,31.21875,37900,295990,52.72885401151929,58.20817413098801,NaN,NaN,-23.570077450483655,-18.387653295131464,-0.135993655888966,0.356306962559497,0.492300618448463,-9675900,-9225760,28.727973969502372,45.65589307196573,NaN,NaN,12.743234725056146,19.256023866317943
2000-06-08T09:30:00-04:00,31.15625,31.5,31.0625,31.375,74500,282030,53.90527579850924,57.39143673769182,NaN,NaN,-30.413250358977884,-39.60872495528825,-0.12341913739255878,0.33802669670776453,0.4614458341003233,-9601400,-9439880,25.755338818817336,42.525778628966464,NaN,NaN,11.887772164845737,18.203416480393344
2000-06-09T09:30:00-04:00,31.35937,31.40625,31,31.17187,129800,281980,52.09033362334999,56.415633901967745,NaN,NaN,-57.26347252489406,-47.506926756740555,-0.12623803332386596,0.30364829244549085,0.4298863257693568,-9731200,-9670040,23.000301778547865,39.40742103806847,NaN,NaN,10.625894242342481,17.120913303528933
2000-06-12T09:30:00-04:00,31.125,32.0625,31.125,31.875,257500,292600,57.432920771682596,56.06376471622237,NaN,NaN,53.778994291546525,-14.387743068934935,-0.08043433399107636,0.32934340828051134,0.4097777422715877,-9473700,-9624040,24.73321262547374,37.18212691852829,NaN,NaN,11.283242050362606,16.286960267362314
2000-06-13T09:30:00-04:00,31.9375,32.125,31.78125,31.875,357100,246540,57.432920771682596,55.82539430916557,NaN,NaN,110.63495222778245,10.633429236994676,-0.05124482737175906,0.34572170805688884,0.3969665354286479,-9473700,-9591180,26.014156894580594,35.40498444250443,NaN,NaN,11.797466644131854,15.645604035472248
2000-06-14T09:30:00-04:00,32.0625,32.5,31.4375,31.82812,216200,210830,56.941920288847534,55.53285988534261,NaN,NaN,103.36503701216938,36.02045212952528,-0.03687391179763172,0.35087414568160824,0.38774805747923996,-9689900,-9593980,25.97359352252512,33.938538563409374,NaN,NaN,12.071024608033733,15.13494983155246
2000-06-15T09:30:00-04:00,31.96875,32,31.17187,31.375,251400,221120,52.28884207409711,55.429054614680226,NaN,NaN,15.547674279016931,45.21263705712425,-0.0583855937934975,0.31476606523736805,0.37315165903086556,-9941300,-9661960,24.956151386318524,32.530809813347695,NaN,NaN,10.942523667901305,14.536031808173723
2000-06-16T09:30:00-04:00,31.375,32.1875,31.375,31.75,478500,200560,55.527760172107676,55.54514962084954,NaN,NaN,71.67428145773458,71.00018785364998,-0.04827835852907619,0.3128037108695203,0.3610820693985965,-9462800,-9608280,27.375383625711763,31.43655265654204,NaN,NaN,10.929868966657867,14.020865687957173
2000-06-19T09:30:00-04:00,31.8125,32.0625,31.25,31.48437,234700,208725,52.79379229922383,55.15433216898909,NaN,NaN,35.47611428571714,67.3396118524841,-0.059656310286821446,0.2865116815400697,0.3461679918268911,-9697500,-9653040,26.60520523325843,30.3779071045594,NaN,NaN,10.123800110018056,13.46414203396587
2000-06-20T09:30:00-04:00,31.375,31.46875,30.70312,31.3125,90400,207825,51.042639613315096,54.10406063216975,NaN,NaN,-58.659122370998546,33.4807969327279,-0.07778479704258456,0.24893699552366044,0.326721792566245,-9787900,-9715880,25.51968671461239,29.258504894370823,NaN,NaN,8.9523391485494,12.819598764620661
2000-06-21T09:30:00-04:00,31.125,31.96875,31.0625,31.875,160700,208845,56.167103725928165,53.69036068218781,NaN,NaN,46.15802807695717,22.03939514568546,-0.052150998059382225,0.26153304499201724,0.31368404305139946,-9627200,-9703340,26.167077814073096,28.236870389634277,NaN,NaN,9.418388486674905,12.333711582056981
2000-06-22T09:30:00-04:00,32.01562,32.125,31.03125,31.03125,94300,210320,48.043622993877584,53.519785086259965,NaN,NaN,-7.109824859583392,17.507895317965392,-0.09005633936185425,0.20111361884908163,0.2911699582109359,-9721500,-9659380,28.512913860740966,27.323610380301545,NaN,NaN,7.258363001675158,11.608661784859578
2000-06-23T09:30:00-04:00,31.25,31.75,31.25,31.42187,77700,197615,51.538128129245635,53.86609287250351,NaN,NaN,5.194643792918124,4.211967785002104,-0.08681985591045949,0.18264513832286156,0.26946499423332104,-9643800,-9695580,27.731543014720685,26.690876069727516,NaN,NaN,6.556877956045147,10.88697838074323
2000-06-26T09:30:00-04:00,31.6875,31.6875,31,31.17187,44500,198110,49.25481370249581,53.370637712562996,NaN,NaN,-44.057054263562314,-11.69466592485379,-0.09865112734489712,0.14615108505219965,0.24480221239709676,-9688300,-9693740,27.83978788841418,26.350880510521197,NaN,NaN,5.278550196715879,10.085774354453608
2000-06-27T09:30:00-04:00,31.21875,31.21875,30.625,30.95312,14600,195720,47.28095501966814,52.98150207028791,NaN,NaN,-119.97590771098692,-23.958022992851465,-0.11708721296341729,0.09844319619282516,0.21553040915624244,-9702900,-9676740,28.899401657664356,26.363125345389907,NaN,NaN,3.6308295604025638,9.163639383874887
2000-06-28T09:30:00-04:00,30.76562,30.875,30.4375,30.6875,90100,194490,44.926618695346306,52.340169420062,NaN,NaN,-162.20822801301705,-65.63127421084631,-0.14142088654418075,0.03875430097601651,0.18017518752019726,-9793000,-9709900,28.034642638341637,26.525932761070216,NaN,NaN,1.5500532283812718,8.07598421880437
2000-06-29T09:30:00-04:00,30.625,31,30.5625,30.75,544400,219645,45.61286867373548,51.87749335223238,NaN,NaN,-125.39846454306385,-89.28900214754239,-0.14691326396702664,-0.003466392438586041,0.1434468715284406,-9248600,-9615320,34.09239161555588,27.31822489228507,NaN,NaN,0.03724922539890528,6.927593505460733
2000-06-30T09:30:00-04:00,30.59375,30.8125,30.09375,30.34375,127600,223545,41.95349477303764,50.771820066614886,NaN,NaN,-175.73836739638114,-125.47560438540226,-0.16988804734287805,-0.06891318765015697,0.10097485969272108,-9376200,-9561800,37.3082693167747,28.216443227377997,NaN,NaN,-2.3470053880523714,5.602650806387432
2000-07-03T09:30:00-04:00,30.1875,30.64062,30.1875,30.53125,54000,170080,44.1793990737421,49.82513994533342,NaN,NaN,-162.99035947711977,-149.26226542811372,-0.16433714085454318,-0.1044465663754579,0.05989057447908527,-9322200,-9488580,41.51285039311149,29.32349276298735,NaN,NaN,-3.732897859984242,4.269000996905764
2000-07-05T09:30:00-04:00,30,30.10937,29.25,29.26562,1032400,218415,34.548795716166524,48.22563104728478,NaN,NaN,-248.39842547468652,-174.94676898085368,-0.23355867652171108,-0.2320577711730536,0.0015009053486574886,-10354600,-9618920,36.78353177948619,30.09563120991314,NaN,NaN,-8.298673489070307,2.4736189274806115
2000-07-06T09:30:00-04:00,29.6875,30.125,29.5625,29.5625,217800,227410,37.96489197039923,47.202491754163496,NaN,NaN,-171.98491029334028,-176.9021054369183,-0.24576935770659322,-0.30571079178458405,-0.059941434077990824,-10136800,-9687680,34.54751205227558,30.780728400338642,NaN,NaN,-10.928861988638774,0.5589787966064137
2000-07-07T09:30:00-04:00,29.8125,29.90625,29.625,29.70312,522000,249785,39.573646129248885,46.06291217967358,NaN,NaN,-142.69354087266908,-180.36112070283934,-0.23101862576876955,-0.3487147162889528,-0.11769609052018323,-9614800,-9760920,32.29554528314671,31.13216851872685,NaN,NaN,-12.554941916653325,-1.3144384481449776
2000-07-10T09:30:00-04:00,29.6875,30.10937,29.6875,29.84375,173300,251960,41.21548541296031,45.23589025922619,NaN,NaN,-110.19505104767626,-167.25245743309839,-0.1996150838025817,-0.36721494527341036,-0.16759986147082867,-9441500,-9773980,31.896277084241277,31.510102222368484,NaN,NaN,-13.401942027364209,-3.041224673747725
2000-07-11T09:30:00-04:00,30,30.98437,30,30.90625,71100,242640,51.85839682069723,45.29415863118205,NaN,NaN,-30.29209360102577,-140.71280425787958,-0.10013355579336386,-0.2927668062125335,-0.19263325041916962,-9370400,-9783620,31.585868684497825,31.943400934503156,NaN,NaN,-10.681320633460086,-4.132666953706633
2000-07-12T09:30:00-04:00,31,31.04687,30.5,30.5,154300,232500,48.26057908686352,44.729406871248855,NaN,NaN,-19.651582976291625,-94.96343575820063,-0.05670102020941176,-0.26350952568093433,-0.20680850547152257,-9524700,-9617640,42.0440243222363,33.0774685422291,NaN,NaN,-9.588301906329683,-4.912043375509926
2000-07-13T09:30:00-04:00,30.21875,30.34375,29.875,30.03125,68900,225135,44.430287917801536,44.471311508672,NaN,NaN,-78.24782373898799,-76.21601844733016,-0.05453508340647378,-0.2749773597296148,-0.220442276323141,-9593600,-9509000,47.681483204481495,34.44665206678199,NaN,NaN,-9.908152860635306,-5.625773301956409
2000-07-14T09:30:00-04:00,30.1875,30.1875,29.6875,30,211700,223150,44.178552589780146,43.94562754156732,NaN,NaN,-84.27592734723218,-64.53249574224279,-0.050303268832231796,-0.28332136236343075,-0.23301809353119896,-9805300,-9547100,45.99187434902573,35.75096144780378,NaN,NaN,-10.236779148396232,-6.284488422876383
2000-07-17T09:30:00-04:00,30.0625,30.1875,29.60937,29.60937,228000,210625,41.047756913919464,43.359409199526155,NaN,NaN,-92.38839823464808,-60.97116517963714,-0.06781858150417949,-0.31779132041142333,-0.24997273890724384,-10033300,-9665460,41.11741063203352,36.69936307234803,NaN,NaN,-11.46675267693488,-7.024811887741882
2000-07-18T09:30:00-04:00,29.625,30.1875,29.625,29.875,101000,203940,43.95624112233267,43.12192963543077,NaN,NaN,-73.48009024208596,-69.60876450784919,-0.05601083826670861,-0.31998628674062957,-0.26397544847392096,-9932300,-9777840,37.09714311371732,37.28491603349466,NaN,NaN,-11.624239830932403,-7.681873022483385
2000-07-19T09:30:00-04:00,30,30.09375,29.65625,29.79687,57200,202280,43.27988126801273,43.004305533478366,NaN,NaN,-71.90414560214805,-80.05927703302048,-0.048253253162812704,-0.32429201492743687,-0.27603876176462416,-9989500,-9870800,34.124849481859485,37.719930808031656,NaN,NaN,-11.945387573382373,-8.290946529754669
2000-07-20T09:30:00-04:00,29.75,29.9375,29.5,29.5,185600,203525,40.71623523492964,42.65454600213509,NaN,NaN,-88.04457876618969,-82.01862803846082,-0.0572903910012772,-0.34765175051622066,-0.29036135951494346,-10175100,-9987100,30.800012052067643,37.48476083921106,NaN,NaN,-12.951314179704484,-8.956713336890356
2000-07-21T09:30:00-04:00,29.5625,29.59375,28.90625,28.9375,37500,200685,36.325615005793125,42.25255459018906,NaN,NaN,-138.03947431524801,-92.77133743206397,-0.09320170376364523,-0.4068634892195,-0.31366178545585477,-10212600,-10068560,28.69138145298166,36.86926884894013,NaN,NaN,-15.165186089713858,-9.843638015865142
2000-07-24T09:30:00-04:00,29.25,29.25,28.46875,28.64062,116300,202615,34.2277401242019,41.541721808079046,NaN,NaN,-172.2142972860944,-108.73651724235324,-0.12691102497450257,-0.472300566673983,-0.34538954169948044,-10328900,-10127680,27.23411939325443,35.84935949180748,NaN,NaN,-17.664749885150957,-10.960939711477401
2000-07-25T09:30:00-04:00,28.71875,29,28.28125,28.375,487700,224775,32.42351307171181,41.38991590490371,NaN,NaN,-189.13603203959323,-131.86770560185468,-0.1551888861523355,-0.5393756493898998,-0.3841867632375643,-10816600,-10304540,23.40442549923891,34.893709043218394,NaN,NaN,-20.309722151448184,-12.296480060044656
2000-07-26T09:30:00-04:00,28.65625,28.78125,28.4375,28.60937,35000,225795,35.6468712152634,41.22434299382258,NaN,NaN,-164.15480160004878,-150.31783680143482,-0.14631814060122472,-0.5670844389890952,-0.4207662983878705,-10781600,-10462960,20.6088594680306,33.89809100148661,NaN,NaN,-21.614584802631587,-13.627637880414218
2000-07-27T09:30:00-04:00,28.51562,29.65625,28.51562,29.59375,156200,229100,47.06730072466749,41.759604036352485,NaN,NaN,-70.0771355195435,-146.7243481521056,-0.06643101250108491,-0.5038050640142266,-0.43737405151314174,-10625400,-10553020,19.204490644703625,32.96301567016925,NaN,NaN,-19.157689186450042,-14.417645209847906
2000-07-28T09:30:00-04:00,29.625,29.8125,29.375,29.375,29500,203355,45.14978717284972,42.04062559063029,NaN,NaN,-27.295783299837748,-124.57560994902353,-0.022849543051251475,-0.46593598032720607,-0.4430864372759546,-10654900,-10641480,17.91326637149521,31.964229190687387,NaN,NaN,-17.750638491200064,-14.893787107183929
2000-07-31T09:30:00-04:00,29.625,29.75,29.15625,29.1875,267200,210335,43.51342180384636,41.444555946569515,NaN,NaN,-43.440339587726164,-98.82081840934988,-0.0022619890045550983,-0.4459139235316485,-0.4436519345270934,-10922100,-10760120,16.327672176736385,30.874358011561572,NaN,NaN,-17.086468159563502,-15.207027257523867
2000-08-01T09:30:00-04:00,29.4375,29.84375,29.4375,29.73437,73900,211330,49.28659819381417,41.517843025637426,NaN,NaN,8.530910377836504,-59.28742992586395,0.04970512403944294,-0.3815205294777897,-0.43122565351723263,-10848200,-10766440,16.245180065955864,29.031583421827253,NaN,NaN,-14.694941068777384,-15.13387208770294
2000-08-02T09:30:00-04:00,30,30.40625,29.96875,30.29687,105800,165000,54.44407773013983,42.23311372651873,NaN,NaN,87.75293801979048,-8.905882001896085,0.11950031685599205,-0.28185025744724257,-0.4013505743032346,-10742400,-10758600,16.806693559669625,26.826241304340694,NaN,NaN,-10.954005464928231,-14.536748284449411
2000-08-03T09:30:00-04:00,30.5,30.625,29.875,29.875,42100,156215,50.31148413595009,42.67118026553087,NaN,NaN,67.34729002401633,18.579003106815883,0.13371846622140815,-0.23420249152647443,-0.3679209577478826,-10784500,-10790420,16.328219910667485,24.707408844457962,NaN,NaN,-9.114163580348139,-13.762093326720658
2000-08-04T09:30:00-04:00,29.875,30.1875,29.65625,30,30000,131615,51.48651844903208,43.41680608946749,NaN,NaN,38.765564847458464,31.79127273627514,0.14695185695277785,-0.18423113655691026,-0.3311829935096881,-10754500,-10810340,16.02072929392837,22.914788748879023,NaN,NaN,-7.27265229667327,-12.835030322428175
2000-08-07T09:30:00-04:00,30.03125,30.59375,30.03125,30.39062,34600,124680,55.06278456176925,44.210130620855814,NaN,NaN,88.29654338734566,58.1386493312895,0.17549061869694016,-0.11181972013851293,-0.2873103388354531,-10719900,-10769900,19.34157913094647,21.646534178681105,NaN,NaN,-4.602611105626061,-11.658970434313588
2000-08-08T09:30:00-04:00,30.375,30.5625,30.3125,30.45312,29800,122615,55.626424853155335,45.092026591223146,NaN,NaN,105.97412791776367,77.62729283927493,0.19078661095894872,-0.048827075136767206,-0.23961368609571593,-10690100,-10738280,21.94076207386813,20.776242220967436,NaN,NaN,-2.2747572593205265,-10.318368552171723
2000-08-09T09:30:00-04:00,30.75,31.75,30.625,31,48900,117345,60.31671970134749,46.492061195967274,NaN,NaN,191.43751970325204,98.36420917596725,0.22745760939628235,0.044708325649637004,-0.18274928374664534,-10641200,-10718040,23.637063700697084,20.264603053012397,NaN,NaN,1.2268426503191625,-8.669052666101596
2000-08-10T09:30:00-04:00,31.03125,31.375,31.03125,31.28125,54000,116600,62.51134679214735,48.3624706092783,NaN,NaN,178.98696078494896,120.69214332815378,0.2581333853259453,0.1399174479107863,-0.11821593741515901,-10587200,-10678580,26.969151043174335,20.141586595169013,NaN,NaN,4.837656855484086,-6.739522734446498
2000-08-11T09:30:00-04:00,31.5,31.5,31.01562,31.25,158400,113935,62.100396100707435,50.353374607600124,NaN,NaN,156.30289980584016,144.19961031983013,0.26291203892781495,0.2104241112446097,-0.052487927683205274,-10745600,-10676800,27.12362956206489,20.133694464369764,NaN,NaN,7.654113896710703,-4.68328892999547
2000-08-14T09:30:00-04:00,31.3125,31.84375,31.25,31.6875,173100,111190,65.51810238356273,52.7172738441609,NaN,NaN,160.36429501762782,158.61316064588655,0.2805236732432712,0.29816666387088375,0.01764299062761253,-10572500,-10647320,29.773090168994955,20.58859908363805,NaN,NaN,11.152358911439238,-2.421053524076226
2000-08-15T09:30:00-04:00,32,32.09375,31.5625,31.5625,268900,119585,63.749249233763734,54.72458655976806,NaN,NaN,145.3316774083194,166.48467054399768,0.26871873418833286,0.3535414083630286,0.08482267417469574,-10841400,-10677580,28.622796008196786,21.161023122221348,NaN,NaN,13.564162398000649,-0.13745124949381538
2000-08-16T09:30:00-04:00,31.625,32.125,31.5625,32,42500,118850,67.09745883745995,56.15531213925324,NaN,NaN,135.28130709600634,155.25342802254855,0.27437986279656446,0.4277975026704013,0.15341763987383686,-10798900,-10709120,27.433096499179413,21.74878068325533,NaN,NaN,16.68577365659856,2.2658665942336667
2000-08-17T09:30:00-04:00,32.375,32.875,32.375,32.75,226200,120880,71.89055170397403,58.06536674861927,NaN,NaN,162.46620371402653,151.94927660836407,0.31000927126026157,0.5409292289491638,0.23091995768890228,-10572700,-10706220,27.73053764336153,22.450014345531493,NaN,NaN,21.08621042411805,4.954487141360007
2000-08-18T09:30:00-04:00,32.8125,32.8125,32.25,32.375,718800,154945,66.66157551791105,59.71880629962389,NaN,NaN,129.9331003009692,146.67531670738987,0.2900530188563282,0.5934862312593125,0.3034332124029843,-11291500,-10815400,23.77884637086281,22.982241073683383,NaN,NaN,23.14968218642928,7.553800719227047
2000-08-21T09:30:00-04:00,32.4375,32.5,32.25,32.5,78200,153040,67.50989490497952,61.02047035042141,NaN,NaN,110.77076374892911,136.75661045365013,0.2675506332280931,0.6378715039381007,0.3703208707100076,-11213300,-10943560,20.14911287006865,23.261093416834296,NaN,NaN,25.076902160588034,10.057100925135758
2000-08-22T09:30:00-04:00,32.5,32.75,32.34375,32.40625,650000,161155,66.15035350669177,61.856632905889406,NaN,NaN,104.66455306320789,128.62318558462783,0.23006207688655356,0.6578984668181995,0.42783638993164597,-11863300,-11147940,15.964083356854673,23.200906973776082,NaN,NaN,26.26114408979154,12.371964234372298
2000-08-23T09:30:00-04:00,32.75,33.375,32.75,33.25,203200,169565,71.67838184301094,63.38283988496518,NaN,NaN,131.73611542201505,127.91414724982954,0.24445039296167526,0.73339938113374,0.4889489881720648,-11660100,-11320180,13.432070712262686,22.994039173890027,NaN,NaN,29.122341627507502,14.76487529053447
2000-08-24T09:30:00-04:00,33.375,33.375,32.4375,32.53125,239100,173710,62.33887698041892,64.15800835149281,NaN,NaN,101.51672973555172,115.72425245413459,0.19032761673341625,0.7268585090888351,0.5365308923554188,-11899200,-11585480,10.634266398170155,22.609291824193015,NaN,NaN,28.518744818170948,16.72971379448254
2000-08-25T09:30:00-04:00,32.5625,32.625,32.1875,32.625,261800,185325,63.01578577741553,64.72607986689611,NaN,NaN,74.11467538933087,104.56056747180692,0.1475186772073499,0.7209292388646062,0.5734105616572563,-11637400,-11654660,10.046612004636117,21.945365600885133,NaN,NaN,28.253357386681593,18.37594859336812
2000-08-28T09:30:00-04:00,32.40625,33.0625,32.3125,32.75,110800,177505,63.94627313394084,65.32035474409507,NaN,NaN,82.39205256181094,98.88482523438327,0.11570322377813969,0.7180395913799309,0.6023363676017912,-11526600,-11717320,9.532771706887715,21.05908057467224,NaN,NaN,28.31564401148643,19.795905081670735
2000-08-29T09:30:00-04:00,32.75,32.92187,32.59375,32.78125,106500,179135,64.1888431534239,65.59693499067197,NaN,NaN,80.01230083337568,93.95437478841684,0.08619947606226985,0.7100857126796285,0.6238862366173586,-11420100,-11628680,16.07218082971461,20.518731798173494,NaN,NaN,28.43463865555016,21.030009877939225
2000-08-30T09:30:00-04:00,32.625,32.78125,32.1875,32.5,165800,182135,60.25933251968282,65.43607682835307,NaN,NaN,53.994096359059505,78.40597097582574,0.0395518099249107,0.673325999023497,0.6337741890985863,-11585900,-11613840,17.1519191467804,19.81750094843107,NaN,NaN,27.406294239558477,21.94090764388483
2000-08-31T09:30:00-04:00,32.5,32.625,32.26562,32.375,78500,183955,58.543941841586935,65.18204438127303,NaN,NaN,43.3758739393778,66.77779981659094,-0.005514621009426346,0.6268809128368034,0.6323955338462297,-11664400,-11566880,20.63159737406569,19.353784363573986,NaN,NaN,26.062830436779915,22.529753757155557
2000-09-01T09:30:00-04:00,32.28125,32.9375,32.28125,32.70312,102700,187590,61.63153800713002,64.90443264009926,NaN,NaN,57.29552304501934,63.41396934772864,-0.01829787880796907,0.6095231853362684,0.6278210641442374,-11561700,-11551740,21.7723704793262,18.7823043857405,NaN,NaN,25.74537205819808,22.989127800161633
2000-09-05T09:30:00-04:00,32.875,33.125,32.5,32.70312,722500,221985,61.63153800713002,64.75316755248257,NaN,NaN,67.11553061112576,60.3586649575916,-0.031074696901627896,0.5889776930172026,0.6200523899188305,-11561700,-11558760,21.617222030611046,18.281906244484375,NaN,NaN,25.484572035261206,23.345619833747286
2000-09-06T09:30:00-04:00,32.875,33.46875,32.875,33.42187,228000,231895,67.7362106828638,64.79879268429713,NaN,NaN,123.47444358575919,69.0510935080683,0.002762074593089192,0.623504983160192,0.6207429085671028,-11333700,-11541480,23.070425288444753,17.97028687228904,NaN,NaN,27.044786771693673,23.874072253453914
2000-09-07T09:30:00-04:00,33.3125,33.4375,33.1875,33.26562,104400,234670,65.30371147108366,64.32830409623354,NaN,NaN,131.13775973792715,84.47982618384185,0.008194810344968717,0.6309864214983136,0.6227916111533449,-11438100,-11511920,25.611157465673358,17.818902573882742,NaN,NaN,27.635443085433735,24.411410943736744
2000-09-08T09:30:00-04:00,33.1875,33.25,32.65625,32.875,892200,276580,59.54656042136049,63.8200887321942,NaN,NaN,72.36946287035202,90.2785439700367,-0.019435969713793133,0.5984966490111034,0.6179326187248966,-12330300,-11645100,22.07391952012756,17.69712208454451,NaN,NaN,26.432881473604297,24.700192448003538
2000-09-11T09:30:00-04:00,32.875,34,32.875,33.92187,820300,309675,67.75190443451328,63.83737512716092,NaN,NaN,178.0929634806149,114.43803205715581,0.02543968228018534,0.6497322215751282,0.6242925392949429,-11510000,-11634760,22.963525472535906,17.898151556149315,NaN,NaN,28.036144798014558,25.176757069433684
2000-09-12T09:30:00-04:00,34.0625,34.125,33.4375,33.875,553100,328675,67.09572431529381,63.90490161348964,NaN,NaN,194.01923181956766,139.8187722988442,0.043550591565018726,0.6787307787512162,0.6351801871861975,-12063100,-11735040,20.517214233511922,18.22337519019626,NaN,NaN,29.076755250765167,25.733899666766753
2000-09-13T09:30:00-04:00,33.9375,33.9375,33.28125,33.3125,109800,320720,59.63142562532983,63.044404740798136,NaN,NaN,121.93491313095548,139.51086620788345,0.010930912245563973,0.6488438274931525,0.6379129152475885,-12172900,-11902880,17.21218707011856,18.49338350147168,NaN,NaN,27.530108539494908,25.990500934299348
2000-09-14T09:30:00-04:00,33.3125,33.4375,33.01562,33.21875,417300,339460,58.46403452192531,62.76763027947716,NaN,NaN,61.14952882081947,125.51322002446193,-0.021886123550421077,0.6105552608095621,0.6324413843599832,-12590200,-12133300,13.901441163675003,18.72675312757917,NaN,NaN,25.93485767861519,25.98255189777304
2000-09-15T09:30:00-04:00,33.5,34.3125,33.5,33.9375,762800,366290,64.24349747173653,62.85532397192867,NaN,NaN,156.56324343716543,142.35197613782458,-0.0012048005639295756,0.6309353836550713,0.6321401842190009,-11827400,-12032720,21.040942681578144,19.512062461646458,NaN,NaN,26.393275588836357,26.041226710782084
2000-09-18T09:30:00-04:00,34.375,34.46875,34,34,205500,340625,64.7034178688247,62.909405738706084,NaN,NaN,164.08266108026314,139.54991565775424,0.010046512250610595,0.6446983245322642,0.6346518122816536,-11621900,-12055100,20.630997886173674,20.30479290302403,NaN,NaN,26.89760215332628,26.16356605971697
2000-09-19T09:30:00-04:00,34.0625,34.0625,33.03125,33.09375,3814500,527440,53.881172803626576,62.173143570863424,NaN,NaN,46.46952899408771,110.03997509265824,-0.04704879488760427,0.5758408186721482,0.6228896135597525,-15436400,-12729760,12.63756707054803,20.05946334879784,NaN,NaN,23.685019370379706,25.80948796124022
2000-09-20T09:30:00-04:00,33.4375,33.54687,32.4375,32.4375,1429200,566400,47.66408016918676,61.273482688685135,NaN,NaN,-46.63818909203302,76.32535464806055,-0.12792775929748035,0.4629799144379021,0.5909076737353824,-16865600,-13668300,7.996178189714442,19.405481851864558,NaN,NaN,18.767261818997532,24.80345565520555
2000-09-21T09:30:00-04:00,32.3125,32.40625,32.01562,32.1875,4575602,785020.1,45.50976013451383,60.34246970960849,NaN,NaN,-122.83073797173763,39.529301289549124,-0.19325655119221974,0.34933698474510777,0.5425935359373275,-21441202,-15438500.4,4.579712649663733,18.25891865726442,NaN,NaN,14.132461167809113,23.279027871291774
2000-09-22T09:30:00-04:00,32.01562,33.375,31.625,31.98437,1469500,846540.1,43.77836081109672,59.06724276703468,NaN,NaN,-97.346948001497,-11.25273699818336,-0.24198254831445565,0.24011535054425792,0.48209789885871357,-22910702,-17655160.8,2.905582534012879,16.911290946884897,NaN,NaN,9.853764544047827,21.361133110256926
2000-09-25T09:30:00-04:00,31.875,31.875,31,31.5,507200,858810.1,39.88201380346946,57.513705323916064,NaN,NaN,-191.80844438030965,-82.43095809029792,-0.2951444906342675,0.11316728556587918,0.4083117762001467,-23417902,-20014361.2,2.047644540219764,15.513463983285519,NaN,NaN,4.946181241469303,19.01613998614441
2000-09-26T09:30:00-04:00,31.6875,32.3125,31.6875,32.25,465300,876535.1,47.65116950903272,56.07905952578528,NaN,NaN,-103.83340428695911,-112.49154474650729,-0.268852656920674,0.0722459550493042,0.3410986119699782,-22952602,-21517601.6,1.70266047959079,13.98719506836738,NaN,NaN,3.2426141504159305,16.762779152468912
2000-09-27T09:30:00-04:00,32.3125,32.9375,32.0625,32.85937,83200,875370.1,52.96925977916094,55.19802726207651,NaN,NaN,-38.48938023858037,-110.86178297581675,-0.20250090550748812,0.08797248008561809,0.2904733855931062,-22869402,-22718362,1.4871311691767204,12.264050332903334,NaN,NaN,3.6267987891824878,14.88621052914228
2000-09-28T09:30:00-04:00,32.92187,33,32.5,32.73437,322600,883210.1,51.806613641141034,54.64517392063226,NaN,NaN,-25.773750152096316,-91.45038541188849,-0.16092287947232925,0.08931978625269466,0.2502426657250239,-23192002,-23068522,1.4302730991281862,10.789504159974806,NaN,NaN,3.5559581518365246,13.267603046670029
2000-09-29T09:30:00-04:00,33,33.25,32.76562,32.76562,127200,885645.1,52.08973777408517,53.52644773060168,NaN,NaN,-7.161002266601625,-73.41319626490942,-0.12671384762131646,0.09185035619837834,0.2185642038196948,-23064802,-23099342,1.4251084415252393,9.251045800616899,NaN,NaN,3.5856348909814804,11.884464738714522
2000-10-02T09:30:00-04:00,32.9375,33.48437,32.9375,33.4375,314500,896235.1,57.82636763185701,52.86435082464191,NaN,NaN,34.038971601471,-28.243713068553284,-0.05774453607934238,0.14638353372051682,0.2041280697998592,-22750302,-22965822,3.058279444695728,8.003979029987171,NaN,NaN,5.434623375826981,10.963058829730588
2000-10-03T09:30:00-04:00,33.35937,33.48437,33.1875,33.42187,92200,864720.1,57.653423698736596,52.7230649727424,NaN,NaN,39.991877777382896,0.5213433443151161,-0.014347310496056392,0.1861939316797887,0.2005412421758451,-22842502,-22943802,3.3426965433375813,7.013301135217101,NaN,NaN,6.851777575238051,10.375732936231655
2000-10-04T09:30:00-04:00,33.3125,33.3125,32.4375,32.4375,151800,860910.1,47.930898754450126,51.970698132208454,NaN,NaN,-36.06649415755527,1.0059205605201256,-0.05104315047757388,0.13673730407887774,0.18778045455645162,-22994302,-22968782,3.3307580953062086,6.258252344619331,NaN,NaN,5.019425050085078,9.610546095353573
2000-10-05T09:30:00-04:00,32.42187,33.48437,32,32.39062,2279800,969680.1,47.51989728598993,50.77615526179799,NaN,NaN,-44.624996396537114,-2.7643286883680283,-0.0760713564084188,0.09269125904592812,0.16876261545434693,-25274102,-23385202,3.1300668780613705,4.978904072939562,NaN,NaN,3.4484548245863063,8.730247342386821
2000-10-06T09:30:00-04:00,32.625,33,32.0625,32.25,540000,952070.1,46.23909727754224,49.45727521956353,NaN,NaN,-62.236907426484926,-13.779509720344683,-0.0982833812412528,0.04590838890278093,0.14419177014403373,-25814102,-23935062,2.8830415903659627,3.711192908953296,NaN,NaN,1.7853133740350173,7.7381139183365635
2000-10-09T09:30:00-04:00,32.375,32.90625,32.375,32.75,1375800,979845.1,51.268571273171766,49.27066082453104,NaN,NaN,-29.66191369521486,-26.519686779681855,-0.07645900777357656,0.04861801042706304,0.1250770182006396,-24438302,-24272662,2.7400591426901144,3.004228056963446,NaN,NaN,1.8464109348065694,6.896442063546564
2000-10-10T09:30:00-04:00,32.9375,33.8125,32.9375,33.48437,1231400,1013760.1,57.55006146909391,49.976802345952976,NaN,NaN,67.01147953873343,-21.11576642741175,-0.013046331284457799,0.10876910409506735,0.12181543537952515,-23206902,-24345542,2.708826863592435,2.626560105097589,NaN,NaN,3.919499133289751,6.471164502081305
2000-10-11T09:30:00-04:00,33.6875,34.3125,33.53125,33.79687,398900,1028215.1,59.917754334097665,51.00594478878039,NaN,NaN,120.68880915380198,10.2352942348597,0.04621586794638613,0.17958527031250782,0.1333694023661217,-22808002,-24308282,3.315590241266591,2.536265647354935,NaN,NaN,6.381333883168994,6.4583315565224035
2000-10-12T09:30:00-04:00,34,34.59375,34,34.3125,2032800,1108990.1,63.53211672578118,52.416927354114996,NaN,NaN,148.96225425831165,48.952744365829446,0.1126279527697471,0.27415434332830557,0.16152639055855847,-20775202,-23408502,16.80843123610164,3.5293262689327034,NaN,NaN,9.651604978199458,6.91451347390484
2000-10-13T09:30:00-04:00,34.3125,34.75,32.875,33,304100,1086055.1,50.940333202060145,53.20680731115719,NaN,NaN,68.75729816802476,75.15158548473138,0.06311632849735085,0.24042180118024703,0.17730547268289618,-21079302,-22461542,28.16987575934826,5.395199927441881,NaN,NaN,8.263055479743308,7.1071623318817645
2000-10-16T09:30:00-04:00,32.89062,32.95312,32.57812,32.6875,328100,1092185.1,48.476773869144985,53.265779051165204,NaN,NaN,-18.165942246665395,77.45077977444127,0.007215259275517222,0.1863245467772927,0.1791092875017755,-21407402,-21855362,34.350603694862954,7.727195871389895,NaN,NaN,6.3247261703099324,6.995385737371503
2000-10-17T09:30:00-04:00,33,33.25,32.70312,32.70312,511400,927030.1,48.61055377130988,52.95444290774727,NaN,NaN,4.577902736216274,64.96406441393785,-0.028836757019293058,0.14306334122765918,0.17190009824695224,-20896002,-21393182,38.682813277664145,10.384030307710427,NaN,NaN,4.869404954771968,6.691674197000141
2000-10-18T09:30:00-04:00,32.875,33,32.25,32.26562,1417200,926430.1,45.07991998296888,52.47396478930641,NaN,NaN,-45.21941389862793,31.782419803451866,-0.07940920023893444,0.0726385979482842,0.15204779818721864,-22313202,-21294222,39.601855659219815,13.110571919145542,NaN,NaN,2.530199189052571,6.097177767293346
2000-10-19T09:30:00-04:00,32.3125,32.8125,32.0625,32.42187,977400,746520,46.57241971609188,52.07987064230689,NaN,NaN,-57.78265216627821,-9.566561481466106,-0.09835894718515842,0.029099114205770604,0.12745806139092902,-21335802,-21406342,38.890631662572915,15.786680720648947,NaN,NaN,1.0824212741327102,5.380783982556112
2000-10-20T09:30:00-04:00,32.1875,33.0625,32.1875,33.0625,488600,697475,52.29649480403608,51.68487972603396,NaN,NaN,-14.435502995045146,-26.205121714080082,-0.06535864375613047,0.04575975669576593,0.1111184004518964,-20847202,-21359922,39.37607843859489,18.380809220213173,NaN,NaN,1.5939153574378033,4.839802750396354
2000-10-23T09:30:00-04:00,33.125,33.125,32.46875,32.53125,205500,682390,47.72976356093241,50.97604685904795,NaN,NaN,-35.88444412159128,-29.74882208906526,-0.07616466393261842,0.015912570536123383,0.0920772344687418,-21052702,-21288982,40.15843992839376,21.010505176288614,NaN,NaN,0.5919829872352326,4.232971355659051
2000-10-24T09:30:00-04:00,32.5625,32.625,31.95312,31.98437,80300,663140,43.51697774136367,50.66076678668463,NaN,NaN,-120.58540897245796,-54.781484430800106,-0.11468504505161466,-0.051279071845776514,0.06340597320583814,-21133002,-21336382,39.788954085209575,23.61466203271028,NaN,NaN,-1.6095738346219968,3.3983220427617584
2000-10-25T09:30:00-04:00,32.125,32.125,31.125,31.20312,397200,678840,38.3143343961167,50.003226580265114,NaN,NaN,-205.11362366151155,-86.76032638337684,-0.1832525041156821,-0.1656596569387645,0.017592847176917614,-21530202,-21179782,41.69751546664031,26.36947978903735,NaN,NaN,-5.26588766437532,2.1605777988850328
2000-10-26T09:30:00-04:00,31.625,31.75,31.1875,31.34375,450900,685255,39.71157719885586,49.53697514607323,NaN,NaN,-182.65863284505176,-111.73552251913154,-0.20780857257531982,-0.24216786854223216,-0.03435929596691234,-21079302,-21128482,42.342274972806834,29.187996459211696,NaN,NaN,-7.728557943555889,0.7478441213934728
2000-10-27T09:30:00-04:00,31.6875,31.6875,30.875,31.125,342200,696005,38.25984792705381,48.607780621350514,NaN,NaN,-178.78612514488447,-144.6056469490994,-0.22595303861133634,-0.31680059423108275,-0.09084755561974642,-21421502,-21243342,41.242529666122245,31.938172925171134,NaN,NaN,-10.184088978427754,-0.8138606071524166
2000-10-30T09:30:00-05:00,31.3125,31.75,31,31.65625,376600,699110,43.64770051479697,47.61475483890074,NaN,NaN,-130.91222224581117,-163.61120257394336,-0.1907494330258426,-0.32928434690204966,-0.13853491387620706,-21044902,-21241782,41.26484259267331,34.69217404867691,NaN,NaN,-10.646389683910574,-2.2185076181178673
2000-10-31T09:30:00-05:00,31.9375,32.01562,31.40625,31.875,463300,717665,45.747145066007405,46.60256846260857,NaN,NaN,-86.77363157932668,-156.84884709531713,-0.14346198424838089,-0.31786239418668316,-0.17440040993830228,-20581602,-21131502,42.91517328040807,37.52071569432987,NaN,NaN,-10.397593179887975,-3.386948412656454
2000-11-01T09:30:00-05:00,32.125,32.90625,32.125,32.90625,2120100,816080,54.376560429745375,45.94860015574887,NaN,NaN,9.841071871561113,-113.85790798870259,-0.03890067213153403,-0.22302625010271981,-0.18412557797118578,-18461502,-20517762,51.14278682505094,39.97316966496911,NaN,NaN,-7.337590835997709,-3.951325901705205
2000-11-02T09:30:00-05:00,32.73437,32.73437,31.625,31.75,118000,707990,45.61571985976079,45.568270631298915,NaN,NaN,-51.937718678774374,-87.71372515544712,-0.043434965913770635,-0.23841928536339907,-0.19498431944962843,-18579502,-20017802,56.62693100722012,42.00581646838854,NaN,NaN,-7.6317497297611805,-4.47710073428463
2000-11-03T09:30:00-05:00,31.75,31.98437,31.4375,31.625,341800,698080,44.775833223600564,45.30391772804575,NaN,NaN,-80.41952546740441,-68.0404052199511,-0.050199613882548205,-0.2577338368028137,-0.2075342229202655,-18921302,-19517762,61.30521691832917,43.9311459843504,NaN,NaN,-8.13468340693589,-4.999612544663381
2000-11-06T09:30:00-05:00,31.625,31.95312,31.25,31.75,508100,654695,45.8495576431728,45.106703718893094,NaN,NaN,-74.78651419791468,-56.8152636103718,-0.04193875959293558,-0.25995767241143497,-0.2180189128184994,-18413202,-18991422,65.52090766369727,45.84815272620991,NaN,NaN,-8.200494356456597,-5.456881374919555
2000-11-07T09:30:00-05:00,31.875,32.375,31.875,32,242600,605255,48.0260832637828,45.31714395323695,NaN,NaN,-28.66758735095943,-45.19405476469834,-0.016620464318738037,-0.23879449321692192,-0.22217402889818388,-18170602,-18509222,68.86731232200611,47.9385424878375,NaN,NaN,-7.59771009033622,-5.7627140485505075
2000-11-08T09:30:00-05:00,32.125,32.4375,32.09375,32.3125,60200,588320,50.69390659014104,45.61153587281189,NaN,NaN,-1.1458075616665582,-47.391430651343875,0.02208836302104067,-0.19456357512188305,-0.21665193814292372,-18110402,-18439002,69.3340759320301,50.113074221370155,NaN,NaN,-6.2973197965897985,-5.839086298270407
2000-11-09T09:30:00-05:00,32.45312,32.5625,31.73437,31.96875,304100,501885,47.78808708785848,45.28950675022777,NaN,NaN,-12.566632610567046,-39.51721343770241,0.0252302500216727,-0.18511412561583285,-0.21034437563750555,-18414502,-18406002,69.5650117578607,52.26942660131772,NaN,NaN,-6.044911061868671,-5.868489835927302
2000-11-10T09:30:00-05:00,32.375,32.54687,31.375,32.0625,335200,503440,48.652547341615744,45.355419877419436,NaN,NaN,-17.132014773082002,-26.85971129883793,0.033777488032439906,-0.16812251559695568,-0.20190000362939559,-18079302,-18237602,70.77452242537117,54.4562896368161,NaN,NaN,-5.5931610323836845,-5.829157149706785
2000-11-13T09:30:00-05:00,32.26562,32.48437,31.51562,31.8125,50000,489535,46.44423424776364,45.564509627876575,NaN,NaN,-21.19850332443338,-16.14210912414167,0.0232503273321171,-0.17283709446424922,-0.19608742179636632,-18129302,-18180822,71.19025491370056,56.69923969599403,NaN,NaN,-5.821952989823574,-5.828127984009184
2000-11-14T09:30:00-05:00,31.5625,32.28125,31.5625,32,48200,466375,48.33819336420048,46.28049955416827,NaN,NaN,-12.769884860624854,-12.962568626074756,0.029186789932591606,-0.1596039343806268,-0.18879072431321842,-18081102,-18162922,71.32872046816652,58.81575433896018,NaN,NaN,-5.497293431518108,-5.780865905081887
2000-11-15T09:30:00-05:00,32.21875,32.75,32.21875,32.625,71300,399080,54.15779543914576,47.31237228561755,NaN,NaN,95.40410856896447,6.347414600051438,0.07298483880765341,-0.09755967580365166,-0.17054451461130507,-18009802,-18142802,71.49456062575291,60.89806045702777,NaN,NaN,-3.511623873977772,-5.456688472067014
2000-11-16T09:30:00-05:00,32.5625,32.9375,32.51562,32.75,155400,357980,55.24370219356536,48.525504733225524,NaN,NaN,125.06946329308623,33.87463378078209,0.10614265124415062,-0.03786620055611678,-0.1440088518002674,-17854402,-18030782,72.45002842931086,63.12716751154124,NaN,NaN,-1.5543553516950899,-4.899212312013882
2000-11-17T09:30:00-05:00,32.5,32.71875,32.34375,32.48437,170600,342080,52.40294244436654,49.15087915676621,NaN,NaN,91.46826825052935,55.594690385504364,0.10572216770824121,-0.011856142164965888,-0.1175783098732071,-18025002,-18019922,72.54610361847247,65.36154329909832,NaN,NaN,-0.6588077040737211,-4.293440225165288
2000-11-20T09:30:00-05:00,32.5625,32.875,32.32812,32.32812,217600,342685,50.74978755438355,49.508210763078786,NaN,NaN,94.93414656208812,78.82122036280866,0.09101691508106814,-0.0038071660218719217,-0.09482408110294006,-18242602,-18042582,71.98203881654933,67.43774798025126,NaN,NaN,-0.35061011434321554,-3.7301787807621345
2000-11-21T09:30:00-05:00,32.375,33.0625,32.375,33.0625,317600,354550,57.53110846129827,49.733535622475415,NaN,NaN,137.23776136559007,108.82274960805164,0.1247595995370813,0.06112541831841156,-0.06363418121866973,-17925002,-18011362,72.30158053970648,68.94909038844095,NaN,NaN,1.9452372934817757,-2.9194050558701474
2000-11-22T09:30:00-05:00,32.875,32.875,32.4375,32.53125,242600,346820,51.95772295482424,50.186535843551376,NaN,NaN,88.70981893855624,107.48389168197,0.10604576286682665,0.06892302236486358,-0.03712274050196307,-18167602,-18042922,71.41489701904227,70.00537367499967,NaN,NaN,2.272740033877705,-2.1776700430490257
2000-11-24T09:30:00-05:00,32.76562,33,32.625,33,50000,326775,56.007422224267145,50.98879220074184,NaN,NaN,117.2896758964583,105.92793420264441,0.11901016932096065,0.11163997114923774,-0.007370198171722908,-18117602,-18095562,69.8756432208495,70.61754698232255,NaN,NaN,3.805548453234463,-1.3229245435799561
2000-11-27T09:30:00-05:00,32.8125,33,32.59375,32.73437,45900,311960,53.267237207706806,51.518626455351416,NaN,NaN,91.77414178347318,105.98910890923318,0.10401260504333613,0.12264555813244726,0.01863295308911113,-18163502,-18123262,69.03245734193554,70.86837195933957,NaN,NaN,4.2528358747131385,-0.5263873409666568
2000-11-28T09:30:00-05:00,32.85937,33.125,32.6875,32.70312,49900,295625,52.93909026718732,51.869555527023174,NaN,NaN,93.85828312050938,105.77393622091742,0.08699573460527205,0.1273776213457012,0.04038188674042914,-18213402,-18117422,69.11706969418799,70.88621177163829,NaN,NaN,4.5204419456307114,0.19458827140439583
2000-11-29T09:30:00-05:00,32.84375,32.84375,31.21875,31.26562,761800,310550,40.56087529185314,51.14576757714546,NaN,NaN,-97.65262828801974,58.795858290195476,-0.020336615966467207,0.01496111678234513,0.03529773274881234,-18975202,-18327462,62.502545972177955,70.39824534593457,NaN,NaN,0.567999750297232,0.2479327683890867
2000-11-30T09:30:00-05:00,31.4375,31.4375,29.90625,30.20312,1260000,267545,34.19633699550408,50.17492828483443,NaN,NaN,-256.99616732801405,-10.345338963118582,-0.15467244541602812,-0.15804282402122283,-0.0033703786051947,-20235202,-18740982,51.95967523558082,69.14072130862886,NaN,NaN,-5.264546889242455,-0.5395643255582764
2000-12-01T09:30:00-05:00,30.25,31.125,30.1875,30.875,309600,277125,40.549137315078,49.59611328293887,NaN,NaN,-186.94136513274697,-71.19154716895964,-0.18785481656051026,-0.23818889930583254,-0.05033408274532227,-19925602,-19102582,44.83740809495913,67.288070285028,NaN,NaN,-7.752313297133792,-1.56995703578335
2000-12-04T09:30:00-05:00,31.125,31.5625,31,31.40625,201300,270100,45.06514844383924,49.497607154087135,NaN,NaN,-102.57160602808455,-110.0606967312712,-0.16444320391744946,-0.2558880876421341,-0.09144488372468465,-19724302,-19414742,39.76943018496128,65.04372566154662,NaN,NaN,-8.160995639977513,-2.511533979239659
2000-12-05T09:30:00-05:00,31.3125,31.6875,30.75,30.75,166700,253030,40.92911317042922,48.96838714024633,NaN,NaN,-124.9763166823758,-153.82761669184822,-0.18219553052294016,-0.31918929687835984,-0.13699376635541968,-19891002,-19750262,35.16823524052916,62.460833859572524,NaN,NaN,-9.949393825429604,-3.574085385838223
2000-12-06T09:30:00-05:00,30.75,30.875,30.125,30.5,509200,266360,39.44393341543881,47.917396995695846,NaN,NaN,-158.57992250256683,-166.01307553475766,-0.19847682408205342,-0.38508979645798647,-0.18661297237593305,-20400202,-20035262,31.802403937280047,59.62567981039589,NaN,NaN,-11.85039909444258,-4.756415915638845
2000-12-07T09:30:00-05:00,31,31.10937,30.76562,31,223400,274520,43.83366017443973,47.102393994329724,NaN,NaN,-97.12709381454468,-134.03926083206377,-0.1646669936213469,-0.3924467144026167,-0.2277797207812698,-20176802,-20023582,32.089259253647796,56.74276772641996,NaN,NaN,-11.97551331009795,-5.7877155434187175
2000-12-08T09:30:00-05:00,30.6875,31,30.3125,30.98437,48600,261745,43.72695077370034,46.48268030356786,NaN,NaN,-100.13493550944743,-116.67797490740386,-0.1337643768393274,-0.394985191830429,-0.2612208149911016,-20225402,-20083542,31.36001410096975,53.80090418945549,NaN,NaN,-12.106040942777287,-6.690333457612799
2000-12-11T09:30:00-05:00,30.8125,31.25,30.6875,31.07812,62400,248105,44.59814745705038,46.043277439472625,NaN,NaN,-70.21711315197568,-110.2070763321821,-0.09901865936394671,-0.384994139196035,-0.28597547983208826,-20163002,-20171282,30.27576354616852,50.82188452728543,NaN,NaN,-11.957018536415239,-7.442717040298862
2000-12-12T09:30:00-05:00,31.125,31.4375,31.09375,31.4375,124900,251850,47.92628767787623,45.35721881208534,NaN,NaN,-39.777267394562735,-93.16726647461948,-0.04650801915784164,-0.34411050377939034,-0.2976024846215487,-20038102,-20200702,29.902436289319795,47.793374223686385,NaN,NaN,-10.858427936287463,-7.930675739725805
2000-12-13T09:30:00-05:00,31.6875,31.8125,31.3125,31.5,194200,259150,48.50564664577574,45.11064193286759,NaN,NaN,-20.021219921666464,-65.4555259584394,-0.004455550928106011,-0.3031719232816812,-0.2987163723535752,-19843902,-20089442,33.25439263832432,45.06762391077796,NaN,NaN,-9.794508482281042,-8.19693756009084
2000-12-14T09:30:00-05:00,31.4375,31.45312,30.45312,30.53125,56600,258415,40.9083728013559,44.03213840265965,NaN,NaN,-72.46857522024978,-60.52382223958042,-0.03696433286785006,-0.3449217884383877,-0.30795745557053766,-19900502,-20034182,34.91897886638854,42.57071931403074,NaN,NaN,-11.10090837623437,-8.61179053382563
2000-12-15T09:30:00-05:00,30.5,31.0625,30.5,30.79687,629100,282100,43.520475536087964,43.33594114040117,NaN,NaN,-68.79008037540443,-54.254851212771825,-0.035643638976537884,-0.35251200429121,-0.3168683653146721,-19271402,-19843382,40.441990472782116,40.52854310909122,NaN,NaN,-11.406188224748306,-9.01099020395744
2000-12-18T09:30:00-05:00,30.9375,31.85937,30.9375,31.75,204300,283785,51.76073743475453,43.25177308094168,NaN,NaN,-3.400442128659012,-40.891517008108494,0.030768003138174904,-0.27840836139195346,-0.30917636453012837,-19067102,-19624202,46.10063581399241,38.884512117648676,NaN,NaN,-9.028285462985492,-9.013460955247162
2000-12-19T09:30:00-05:00,31.6875,32.40625,31.6875,32.29687,258900,285850,55.74989282847775,44.33670290498629,NaN,NaN,55.87280600334992,-21.761502328525967,0.10849929195296448,-0.1735522495889228,-0.2820515415418873,-18808202,-19378222,51.65239733509611,38.10950150071425,NaN,NaN,-5.724023496525864,-8.543541318286977
2000-12-20T09:30:00-05:00,31.625,31.90625,31.3125,31.34375,190900,279515,48.25940020790356,45.34120742015769,NaN,NaN,5.47642909565324,-16.66197252506203,0.09327756403345788,-0.16545458650006495,-0.25873215053352283,-18999102,-19209262,55.0753482148686,38.33204957066338,NaN,NaN,-5.336852539104816,-8.085442921260954
2000-12-21T09:30:00-05:00,31.625,31.76562,31.45312,31.57812,329900,283880,50.03707897541037,46.01891753875286,NaN,NaN,20.78438988305786,1.9886204955995168,0.09616287332462514,-0.1385285588777414,-0.23469143220236655,-18669202,-18963002,59.56839892174312,39.38426320114795,NaN,NaN,-4.453661390595251,-7.566616988308711
2000-12-22T09:30:00-05:00,31.6875,32,31.51562,32,58400,284300,53.15696314100545,46.59690430283615,NaN,NaN,60.09435705066937,27.765507980814277,0.12199334556944344,-0.08219975024056225,-0.2041930958100057,-18610802,-18830882,61.77711281136985,40.95624053160571,NaN,NaN,-2.727921027839731,-6.875374708241714
2000-12-26T09:30:00-05:00,32.0625,33.35937,32.0625,33.34375,967100,330360,61.42042945697169,48.060569751874894,NaN,NaN,193.93766581656638,67.23312956985936,0.21940486762634948,0.07006298872293115,-0.14934187890341832,-17643702,-18546202,66.07725297643609,43.16402751274193,NaN,NaN,1.7644959686404873,-5.641107468687114
2000-12-27T09:30:00-05:00,33.5625,33.59375,33.01562,33.3125,291200,342425,61.150262784518404,49.611021849666294,NaN,NaN,228.21511991377537,101.70159235194444,0.2683261761753138,0.1860658413157239,-0.08226033485958988,-17934902,-18371542,68.42435785764664,45.77988136419668,NaN,NaN,5.123014162549982,-4.1033758070818145
2000-12-28T09:30:00-05:00,33.5625,33.89062,33.28125,33.85937,67500,307710,64.12424733200774,51.0603495037783,NaN,NaN,219.84692890097335,144.57569231300846,0.32057292065023496,0.3184558159532038,-0.002117104697031122,-17867402,-18145202,71.2048015123214,48.573848668387654,NaN,NaN,8.900349317040456,-2.2457007893500616
2000-12-29T09:30:00-05:00,33.82812,33.9375,33.15625,33.1875,185400,253980,58.22685786140147,52.0960571528998,NaN,NaN,159.55165908782635,172.32914615396217,0.29365733312757486,0.36495456171243745,0.0712972285848626,-18052802,-18021922,72.6190521486413,51.520922814649914,NaN,NaN,10.198155635237587,-0.46800701440896897
2001-01-02T09:30:00-05:00,33.75,34.10937,33.26562,33.26562,398500,258425,58.70243789455283,53.103506469864264,NaN,NaN,140.34196823220347,188.37866839026898,0.2657285943355461,0.4034579715042952,0.1377293771687491,-17654302,-17830622,74.69589800096895,54.693789561421376,NaN,NaN,11.370362920662679,1.2231886906012661
2001-01-03T09:30:00-05:00,33.5625,33.5625,32.25,32.25,519100,274315,50.63186944532127,53.296762310396055,NaN,NaN,63.91623654092895,162.3743825351415,0.16822332175161475,0.34800852935826754,0.17978520760665279,-18173402,-17936562,71.46318011724541,57.66241412055892,NaN,NaN,9.793964307929045,2.447585207362377
2001-01-04T09:30:00-05:00,31.875,32.25,31.0625,31.25,386500,285305,44.189825114183385,52.98848934385374,NaN,NaN,-26.969701455507252,111.33741826128498,0.03283363014752169,0.2208272452910549,0.18799361514353322,-18559902,-18061562,67.73807419550158,60.12553423178587,NaN,NaN,6.211334896943004,2.985263734445324
2001-01-05T09:30:00-05:00,31.25,32.1875,31.25,31.92187,424600,281075,48.8945764202293,53.55893245948755,NaN,NaN,-12.016797043331346,64.96467307242403,-0.012583926878329627,0.17226370654562118,0.1848476334239508,-18135302,-18115142,66.1464511596808,62.35606796702103,NaN,NaN,4.8206972964407555,3.2474685290161
2001-01-08T09:30:00-05:00,32.3125,32.3125,31.6875,31.8125,371600,288485,48.18252640184999,53.89193609275627,NaN,NaN,-3.840597861493512,32.28622168256006,-0.049056059978285105,0.12352755845109442,0.17258361842937953,-18506902,-18205962,63.42601662473696,63.99778412073209,NaN,NaN,3.505706031112945,3.2843596007442204
2001-01-09T09:30:00-05:00,32,32,31.07812,31.17187,132000,292655,44.12870389630668,53.346790840009994,NaN,NaN,-52.548693248896036,-6.291910613659844,-0.11180140857475845,0.032831857710931445,0.1446332662856899,-18638902,-18402882,57.86866113760969,64.83835735813332,NaN,NaN,1.0909853797789586,2.9710204263206115
2001-01-10T09:30:00-05:00,31.375,31.46875,31.09375,31.375,127600,295915,45.68902590052268,52.6281574880132,NaN,NaN,-63.95033225001005,-31.865224371847653,-0.13362347474445263,-0.022396077144875903,0.11122739759957673,-18511302,-18470462,56.053494593956664,65.15272144805193,NaN,NaN,-0.3866211319041201,2.491357346574221
2001-01-11T09:30:00-05:00,31.4375,32,31.4375,31.71875,48600,292100,48.31933565967247,52.63243859171098,NaN,NaN,-30.084826589607736,-32.48824939866775,-0.11937307672266892,-0.03798894830375943,0.08138412841890949,-18462702,-18451022,56.47641675560049,65.25279777238993,NaN,NaN,-0.8358567857396826,2.016041041957949
2001-01-12T09:30:00-05:00,31.375,31.79687,31.3125,31.51562,30100,283895,46.87464991844361,52.406550801927644,NaN,NaN,-46.155632788853836,-39.31601654777224,-0.11788871499745593,-0.06597676532791041,0.05191194966954551,-18492802,-18522522,54.402692735720564,64.8838187591026,NaN,NaN,-1.6251347857505254,1.4958730665710243
2001-01-16T09:30:00-05:00,31.8125,31.875,31.3125,31.5,33400,282735,46.75887668961784,51.94954462682852,NaN,NaN,-49.434323754490705,-48.43476172637168,-0.11224852782777664,-0.0883987101151753,0.02384981771260134,-18526202,-18526382,54.28680324925326,64.34879664752285,NaN,NaN,-2.3016469166913263,0.95337021181926
2001-01-17T09:30:00-05:00,31.875,31.875,31.0625,31.34375,95700,256065,45.547013228289465,50.815729181922656,NaN,NaN,-67.32460994020907,-51.38994506463429,-0.11301805867484477,-0.11742275563095461,-0.004404696956109851,-18621902,-18522982,54.378989221675035,63.51320637932563,NaN,NaN,-3.1987350703587643,0.3602123143652566
2001-01-18T09:30:00-05:00,31.0625,31.25,30.5,30.75,372000,264450,41.179456883909396,49.38924304616487,NaN,NaN,-117.62108509821257,-62.124095634274795,-0.14542737342264467,-0.1861889137344157,-0.040761540311771025,-18993902,-18619502,51.22111138362497,62.284403059752655,NaN,NaN,-5.2337066526600875,-0.43891896663836394
2001-01-19T09:30:00-05:00,30.3125,30.8125,30.1875,30.60937,321900,267600,40.19629799974692,47.68010380814623,NaN,NaN,-130.07406893370745,-82.12194410309473,-0.16672042369199513,-0.24916206992676493,-0.08244164623476981,-19315802,-18790122,46.122262872970424,60.49279315694188,NaN,NaN,-7.2126221561518875,-1.4065908508545815
2001-01-22T09:30:00-05:00,30.8125,31,30.60937,30.9375,39400,260025,43.58100503563675,46.63397146344875,NaN,NaN,-96.8481081085433,-92.26043916703263,-0.14963464020302986,-0.26948494648855714,-0.11985030628552729,-19276402,-18946842,41.98774536703187,58.3048426725412,NaN,NaN,-8.017711969795105,-2.351036724988942
2001-01-23T09:30:00-05:00,31.0625,31.48437,30.90625,31.42187,61700,246615,48.23814046086988,45.88652164675711,NaN,NaN,-58.322990485942796,-94.03817251332305,-0.09907749283145853,-0.24369717232485044,-0.1446196794933919,-19214702,-19084542,38.70473309611842,55.7340451793376,NaN,NaN,-7.427943477632882,-3.07630911822379
2001-01-24T09:30:00-05:00,31.6875,31.6875,31.3125,31.39062,47300,246060,47.963061178056414,45.695892484809626,NaN,NaN,-39.75046952469405,-88.52334443022005,-0.06287127840347176,-0.2232087774977316,-0.16033749909425984,-19262002,-19212562,35.89471554055372,53.19344056671675,NaN,NaN,-7.013255675690619,-3.6387300550047654
2001-01-25T09:30:00-05:00,31.6875,32.42187,31.6875,32.32812,112800,203345,56.05862193651193,46.543663686404514,NaN,NaN,22.16761922238913,-60.56560356609971,0.024408717875396113,-0.1298266017500147,-0.15423531962541082,-19149202,-19243622,35.2264906508662,50.871184599242795,NaN,NaN,-4.203432035958616,-3.719401766569601
2001-01-26T09:30:00-05:00,32.4375,32.67187,31.75,31.78125,172200,197395,51.0677185909067,46.69888812716719,NaN,NaN,23.23755009255211,-29.903279760847784,0.04434075148008415,-0.09880938027530561,-0.14315013175538976,-19321402,-19244742,35.20104292852868,48.66079829701764,NaN,NaN,-3.2529443984772346,-3.652764999699263
2001-01-29T09:30:00-05:00,31.89999,31.89999,31.52,31.52,63200,197180,48.83110885503364,46.74521544525174,NaN,NaN,-10.789179742362915,-12.691494087611702,0.039142056287533006,-0.09422256139597351,-0.13336461768350652,-19384602,-19266382,34.679752862711936,46.60749374258728,NaN,NaN,-3.1223246089119012,-3.576987801015354
2001-01-30T09:30:00-05:00,31.77,31.87,31.28999,31.78999,234800,199650,51.209352783950536,47.25097608008344,NaN,NaN,0.5964247271307752,-0.9076110449969816,0.052277714403020176,-0.0680174746797313,-0.12029518908275147,-19149802,-19253402,35.29867951042429,44.99535219778833,NaN,NaN,-2.317738753189744,-3.3970950798974098
2001-01-31T09:30:00-05:00,32,32.2,31.8,32.13,99000,184675,54.10248485513225,47.85193743398412,NaN,NaN,88.8293135995275,24.80834557984732,0.08056575840717081,-0.019587991073787947,-0.10015374948095876,-19050802,-19211162,37.37814256101788,43.66139848114984,NaN,NaN,-0.7851756164149,-3.023963727971337
2001-02-01T09:30:00-05:00,32.13,32.13,31.55,31.72,346100,176025,50.234286230644436,47.98871961762497,NaN,NaN,58.64868283679948,32.10455830272939,0.06882060662528813,-0.0141279911993486,-0.08294859782463673,-19396902,-19260702,35.92002845387569,42.193085031026634,NaN,NaN,-0.5909238596117177,-2.676386603919963
2001-02-02T09:30:00-05:00,31.94,32.31,31.92999,32.25,176500,165525,54.73923767852554,48.55047588620226,NaN,NaN,119.37614896425457,51.33227807706987,0.09243087146608445,0.03258999150796882,-0.05984087995811562,-19220402,-19240502,36.99922302452237,40.949980051655345,NaN,NaN,0.9360836355246414,-2.160319426856448
2001-02-05T09:30:00-05:00,32.5,32.99001,32.5,32.89999,204300,154510,59.57261814787496,49.46574313322062,NaN,NaN,204.1368233375197,94.31747869304641,0.14441035022923288,0.1206720578284255,-0.023738292400807395,-19016102,-19166802,40.909401933782384,39.994451386264565,NaN,NaN,3.7994220861658654,-1.3089277821389746
2001-02-06T09:30:00-05:00,32.92999,33.19,32.5,33.11,72500,139555,61.02098302258271,50.57102668995585,NaN,NaN,193.20607838098584,132.83940942381741,0.18303861638125057,0.20505997807575582,0.022021361694505248,-18943602,-19125562,43.03978733588563,39.18450839442247,NaN,NaN,6.58908466722907,-0.1806402893721113
2001-02-07T09:30:00-05:00,33.14,33.47,32.81,33.2,103100,138110,61.65499632341426,52.03356522134906,NaN,NaN,183.33893512528482,151.74133372896887,0.20319770371631365,0.2760184913398973,0.07282078762358365,-18840502,-19083502,45.209394888131506,38.755100073315795,NaN,NaN,9.050231615915983,1.1380556970976163
2001-02-08T09:30:00-05:00,33.28999,33.56,33.17,33.38,39200,133690,62.952882446641446,53.65903553898438,NaN,NaN,172.20864330292613,174.45332582219422,0.21600435598109063,0.34282623259994693,0.1268218766188563,-18801302,-18964382,50.9121378823602,39.09723400255791,NaN,NaN,11.485555231411828,2.6162699162853604
2001-02-09T09:30:00-05:00,33.45,34.03999,33.45,33.92,241500,143335,66.60477595587571,55.30359060471574,NaN,NaN,178.63781487847584,186.30565900503848,0.24601333986433285,0.43433855144927236,0.1883252115849395,-18559802,-18832262,56.3400132388719,40.122395993403636,NaN,NaN,14.739186688322533,4.348115169433528
2001-02-12T09:30:00-05:00,33.60001,33.77,33.45,33.47,295500,156605,61.191522317878,56.2288321659306,NaN,NaN,133.87237532373263,172.25276940228105,0.22149109007441378,0.46518907417795674,0.24369798410354296,-18855302,-18800102,57.56989128999991,41.46990729296659,NaN,NaN,15.96521370947491,6.007700675153725
2001-02-13T09:30:00-05:00,33.39999,33.53,33.2,33.39999,1013900,205630,60.36946410496794,57.11500380356714,NaN,NaN,102.54326157567618,154.12020604121912,0.18782046739554925,0.4784735683479795,0.29065310095243024,-19869202,-18985222,49.01139443993575,42.40681292863673,NaN,NaN,16.73396852200126,7.540024653274801
2001-02-14T09:30:00-05:00,33.47,33.61,33.13,33.16,83600,205025,57.516968059493806,57.21917138378012,NaN,NaN,84.29307895077639,134.31103480631742,0.13890508416911518,0.4642844561638242,0.325379371994709,-19952802,-19207682,41.10344959075042,42.82659571005704,NaN,NaN,16.58404440522263,8.832027474981635
2001-02-15T09:30:00-05:00,32.60001,32.8,32.39999,32.73,554600,214155,52.711120693917394,57.33655724828089,NaN,NaN,26.232327389748598,105.11577162368192,0.07055621850271165,0.4135746451230986,0.34301842662038695,-20507402,-19548902,32.45378673552139,42.63036312484223,NaN,NaN,15.0553816031037,9.721078064713359
2001-02-16T09:30:00-05:00,33.11,33.25999,32.75,33.02,57300,200925,55.416700923437105,57.80695668173828,NaN,NaN,50.00333936063697,79.38887652011417,0.03939768906611424,0.39226553795302976,0.3528678488869155,-20450102,-19926962,25.94038026222698,42.00612222480759,NaN,NaN,14.516071966633227,10.406077193559055
2001-02-20T09:30:00-05:00,33.05,33.3,32.83,32.83,374900,217700,53.266420055030544,57.95389005824399,NaN,NaN,41.94117727767168,61.00263691090197,0.0024604495467263066,0.35594341082032344,0.35348296127359713,-20825002,-20320902,21.172108958551007,40.99708147110236,NaN,NaN,13.44945796091933,10.840845874610523
2001-02-21T09:30:00-05:00,32.98,33.21001,32.61,32.61,94900,219360,50.80808479144323,57.71857576798049,NaN,NaN,18.90122077170011,44.27422875010676,-0.03808260014558151,0.30587971109162027,0.3439623112372018,-20919902,-20531042,19.149948724051242,39.69506762560474,NaN,NaN,11.84477629269152,10.984264505764951
2001-02-22T09:30:00-05:00,32.75,32.89,32.25,32.45,210000,227495,49.035605661031006,57.63295572729381,NaN,NaN,-19.32512838560829,23.550587282829824,-0.07484451036093215,0.2504066732860366,0.32525118364696876,-21129902,-20766462,17.171278622611368,38.35587120908586,NaN,NaN,9.990700936542117,10.842326853018832
2001-02-23T09:30:00-05:00,32.36,32.44,31.7,32.03999,341300,238920,44.729347895407905,56.91796359992827,NaN,NaN,-74.93073795976339,3.317974212927415,-0.12309382387776346,0.17138390379976443,0.2944777276775279,-21471202,-20959222,15.737446552777484,36.83717288967551,NaN,NaN,7.099938941641065,10.307700008536294
2001-02-26T09:30:00-05:00,31.95,32.42999,31.95,32.39,340600,247340,48.8582514457648,56.152651692634684,NaN,NaN,-53.50999652959225,-17.38469296511843,-0.12723065391456617,0.13543941028432016,0.26267006419888633,-21130602,-21095322,14.79789322540411,34.97206512479135,NaN,NaN,5.750353548147171,9.656650514194991
2001-02-27T09:30:00-05:00,32.5,32.67999,32.14999,32.19,40500,246205,46.71094971931238,55.1305064566868,NaN,NaN,-51.14131230334933,-36.001190881322636,-0.1383121433205703,0.08977988504817347,0.22809202836874376,-21171102,-21164542,14.329326861804006,32.921317948071234,NaN,NaN,3.9923727669073097,8.84746797886818
2001-02-28T09:30:00-05:00,32.33,32.33,31.74001,31.74001,23500,235640,42.21539245136407,53.741963322968935,NaN,NaN,-109.32362467148637,-61.64615996995993,-0.1688040371182991,0.017086981970869886,0.185891019089169,-21194602,-21219482,13.95171929101609,30.68862683399156,NaN,NaN,1.0934295227030024,7.739748199416011
2001-03-01T09:30:00-05:00,31.85001,32.22,31.85001,32.10001,164100,238895,46.639908024007745,52.57675086420939,NaN,NaN,-93.30656452686442,-76.44244719821116,-0.1577871528265858,-0.011342921944063278,0.14644423088252254,-21030502,-21199602,14.826365646810231,28.11107167430942,NaN,NaN,-0.10607378845062818,6.618916486863634
2001-03-02T09:30:00-05:00,32.39999,32.87,32.34,32.83,78800,225530,54.28392420135551,51.6966900246008,NaN,NaN,-16.367658051509416,-64.72983121656037,-0.09735936759192884,0.024745021392611477,0.12210438898454032,-20951702,-21095702,19.4354848714964,25.4750339337826,NaN,NaN,1.247706909702306,5.851600832983444
2001-03-05T09:30:00-05:00,32.64,33.17999,32.64,33.00999,1607900,297100,55.959163070376064,51.322950078350665,NaN,NaN,18.471714924128754,-50.33348892581616,-0.04400732465584942,0.06709523316472854,0.11110255782057796,-19343802,-20738342,32.88760084832904,23.712013187948966,NaN,NaN,2.8713361659976955,5.425848737699766
2001-03-06T09:30:00-05:00,33.10001,33.39,33.09,33.17999,95900,291680,57.54170622718628,51.12096737279484,NaN,NaN,57.151419273023755,-28.674942610541546,0.0015757409697315233,0.11307223403274236,0.11149649306301083,-19247902,-20353702,43.77049185664616,23.337663003428283,NaN,NaN,4.68608052259709,5.32016756411367
2001-03-07T09:30:00-05:00,33.39999,33.91,33.39999,33.89,233400,299725,63.449127876080645,51.5446930739796,NaN,NaN,120.07865432773659,17.20551318930304,0.07435840771042651,0.20444450270104397,0.13008609499061746,-19014502,-19917682,53.06229525429685,24.191866265110175,NaN,NaN,8.248605438336279,5.738515831859757
2001-03-08T09:30:00-05:00,33.99001,34.23,33.66,34.23,152800,302210,65.8961504262236,52.48648091200149,NaN,NaN,145.17126130929546,64.90107835653502,0.13659121818652625,0.3008251177237753,0.16423389953724904,-18861702,-19483922,60.12214268444022,26.16817740431866,NaN,NaN,12.008914541688258,6.634287076120971
2001-03-09T09:30:00-05:00,34.34,34.35001,33.8,34.07001,239500,312225,63.73388393784715,53.08056541303078,NaN,NaN,135.8125353238729,95.33711703161148,0.15672972363265275,0.360146054078065,0.20341633044541224,-19101202,-19113822,64.96429646418375,28.95559999017272,NaN,NaN,14.41208723555953,7.745401384612194
2001-03-12T09:30:00-05:00,33.55,33.64,32.94,32.94,1411200,370710,51.003927332663544,52.918958790004574,NaN,NaN,30.836170795945325,97.81000820597481,0.08716701145567779,0.31237509476500946,0.22520808330933167,-20512402,-19347542,60.00884205122453,31.729652353935112,NaN,NaN,12.31216672737103,8.397796433577742
2001-03-13T09:30:00-05:00,32.60001,32.75,32.22,32.55,152400,363555,47.479189361816395,52.681180545031225,NaN,NaN,-50.10514793111493,76.35869476514706,0.012054944343686869,0.24027676373894025,0.22822181939525338,-20664802,-19630922,54.573253294288506,34.25988839466634,NaN,NaN,9.40030194916692,8.541011507233339
2001-03-14T09:30:00-05:00,31.89999,32.49001,31.89999,32.06,109100,318315,43.41923165882582,52.280010973445144,NaN,NaN,-88.29807693538544,34.683348512522656,-0.06900709429627477,0.1419629515249099,0.21097004582118467,-20773902,-19982802,48.677132135643404,36.51030650274006,NaN,NaN,5.595910017641907,8.120282723005992
2001-03-15T09:30:00-05:00,32.3,32.48,31.89999,32.08,79700,318120,43.63110500913131,52.20156505299682,NaN,NaN,-79.92372292527534,-10.335648334391504,-0.11684476413207673,0.06491409065608877,0.1817588547881655,-20694202,-20349302,43.41577057470261,38.48732964716328,NaN,NaN,2.706789749234915,7.346926583895838
2001-03-16T09:30:00-05:00,32.03999,32.03999,31.42999,31.45,223000,301540,38.713384210301435,51.47693167903515,NaN,NaN,-129.01358200616212,-63.300871800398525,-0.18256548219238877,-0.04644799795232046,0.1361174842400683,-20917202,-20712502,38.925579751031066,40.21073582756521,NaN,NaN,-1.430804978741812,6.09296493209046
2001-03-19T09:30:00-05:00,31.55,32.14,31.55,31.85001,241300,310740,43.09873707415238,51.21891649009515,NaN,NaN,-93.95641401056538,-88.25938876170066,-0.1899008242165971,-0.10125854603067808,0.08864227818591902,-20675902,-20745202,38.53911876251229,41.94000667761579,NaN,NaN,-3.470557367580117,4.72674746070895
2001-03-20T09:30:00-05:00,31.96001,32.44,31.96001,32.13,488300,316410,46.01080888189185,51.49001766370427,NaN,NaN,-51.04052136527952,-88.44646344853359,-0.16748338652410283,-0.1207119549692095,0.046771431554893314,-20187602,-20649762,40.39902602005068,43.82910001540398,NaN,NaN,-4.230863777572593,3.4470887123830147
2001-03-21T09:30:00-05:00,32.06,32.06,31.16,31.21001,350800,329205,38.95607498543149,50.94117244666311,NaN,NaN,-118.91140979193167,-94.56913001984283,-0.20379083375083734,-0.20796711063365336,-0.004176276882816028,-20538402,-20602662,41.342417235724014,45.7231037003264,NaN,NaN,-7.305112805174724,1.9110599241604809
2001-03-22T09:30:00-05:00,30.91,30.91,29.45,30.28999,266600,332035,33.435029508633605,49.45196568289725,NaN,NaN,-214.2975764817792,-121.4439007311436,-0.2745400387731766,-0.3473513253492868,-0.07281128657611019,-20805002,-20624822,41.01349083037011,47.26438984024594,NaN,NaN,-11.961976412218077,-0.07080240960788453
2001-03-23T09:30:00-05:00,30.32001,30.74001,30.28,30.53,440000,336970,35.9839244183331,48.02516292203705,NaN,NaN,-163.23644749030797,-128.28847382797275,-0.2885117432587733,-0.43345096564957686,-0.14493922239080353,-20365002,-20514382,43.42915663620956,48.01735811080884,NaN,NaN,-14.753524836285257,-2.168334184847509
2001-03-26T09:30:00-05:00,31.14999,31.14999,30.77,30.92999,52900,322585,40.10048022196758,46.779361064521424,NaN,NaN,-110.59651250679326,-131.61649352721832,-0.25529686405427293,-0.4640603024586447,-0.20876343840437178,-20312102,-20441622,45.02646511150318,48.10707048615576,NaN,NaN,-15.674246252404961,-4.097750194498573
2001-03-27T09:30:00-05:00,31.10001,31.3,30.8,31.10001,99500,325535,41.813271572462796,45.23394275712015,NaN,NaN,-90.56739621002649,-139.5218684961677,-0.20834180215546205,-0.4691906910986994,-0.2608488889432373,-20212602,-20446622,44.93257508778073,47.526376188547474,NaN,NaN,-15.869731528943056,-5.779461813704928
2001-03-28T09:30:00-05:00,30.89999,30.89999,30.33,30.64999,138100,331265,38.66202621852495,43.28864817085596,NaN,NaN,-112.68097267796368,-138.27578107337413,-0.1943307730329047,-0.5037623552343682,-0.3094315822014635,-20350702,-20409082,45.845624114775326,46.506624862142836,NaN,NaN,-17.019355466085287,-7.385160906902122
2001-03-29T09:30:00-05:00,30.05,30.24001,29.84,30,107200,328420,34.60534571599861,41.20803829786678,NaN,NaN,-133.20209763212353,-122.05668530344299,-0.21402160581406415,-0.5769585894690437,-0.3629369836549795,-20457902,-20339662,47.57663287655808,45.26464889159815,NaN,NaN,-19.322299693070292,-9.090466447783289
2001-03-30T09:30:00-05:00,30.64,30.89999,30.46001,30.7,113100,330135,41.69999358022268,40.54347160126385,NaN,NaN,-80.47351749539588,-105.50409930446058,-0.16716288022198827,-0.5718905839324648,-0.40472770371047656,-20344802,-20335622,47.68144292170318,44.38412038234662,NaN,NaN,-18.955382659904142,-10.499740192371982
2001-04-02T09:30:00-04:00,30.5,30.75,29.88,30.13,106400,255060,38.0774169966044,39.87191643232014,NaN,NaN,-97.05934789676272,-102.79666638245449,-0.16171602757749876,-0.60687273818235,-0.44515671060485124,-20451202,-20363442,46.98482277082678,43.842089630670785,NaN,NaN,-19.84246491428584,-11.834415152645391
2001-04-03T09:30:00-04:00,29.98,30,29.05,29.3,1229500,311740,33.51209803642877,39.16426403072035,NaN,NaN,-131.2834061371823,-110.93986836788562,-0.19873487668533663,-0.693575306461522,-0.49484042977618536,-21680702,-20657062,40.293726614141974,43.24327495056354,NaN,NaN,-22.166571215197177,-13.310437447295646
2001-04-04T09:30:00-04:00,29.52,30.00999,29.41,29.82001,164000,308270,38.48810562217256,38.79690693165186,NaN,NaN,-103.98928417722074,-109.20153066773705,-0.17382237439881354,-0.7121183977747023,-0.5382960233758888,-21516702,-20890262,35.918635487869494,42.70776530150403,NaN,NaN,-22.388841910494317,-14.607352370609743
2001-04-05T09:30:00-04:00,30.14999,30.7,30,30.60001,211900,311225,45.1224867746331,39.25469997196127,NaN,NaN,-55.734490674436174,-93.70800927619959,-0.09441032463591903,-0.6563089291707875,-0.5618986045348685,-21304802,-21059642,33.106828460403094,42.292140209316315,NaN,NaN,-20.288505320289836,-15.41894564913547
2001-04-06T09:30:00-04:00,30.21001,30.69,30.11,30.64,69800,302740,45.447348588306156,39.42245793725797,NaN,NaN,-47.00785561276013,-87.01487689967243,-0.03201245439190292,-0.6019141725247472,-0.5699017181328443,-21235002,-21237682,30.411887827540127,41.71162371396117,NaN,NaN,-18.561834249600864,-15.86792973491624
2001-04-09T09:30:00-04:00,30.89999,31.41,30.89999,31.36,88900,236625,51.06424379089401,39.78341757361527,NaN,NaN,21.77797894160365,-63.24741153199915,0.05991987071499005,-0.4950018797391067,-0.5549217504540968,-21146102,-21376662,28.46407129547957,40.85912694792038,NaN,NaN,-15.230967520826667,-15.776935132903445
2001-04-10T09:30:00-04:00,31.75999,32.13,31.58,31.89999,242000,241105,54.82133513757661,40.916650441625634,NaN,NaN,86.9419427373073,-19.60234175710122,0.15392018838967192,-0.3625215149670069,-0.5164417033566788,-20904102,-21221342,33.583706981428975,40.304933358327865,NaN,NaN,-11.218895243529477,-15.125786577278593
2001-04-11T09:30:00-04:00,31.60001,31.74001,31.33,31.33,66200,238960,50.42083828458155,42.12992249705049,NaN,NaN,54.72330259221009,12.140175596784939,0.17310188603298027,-0.3000643458154535,-0.47316623184843376,-20970302,-21112062,36.99998702986338,40.018254515434535,NaN,NaN,-9.266755111646932,-14.288782082188355
2001-04-12T09:30:00-04:00,31.75,31.84,31.39999,31.66,215400,245745,52.783892440425035,43.329920212914196,NaN,NaN,76.819554372512,38.650984606174575,0.2014239108775307,-0.2213863432515204,-0.4228102541290511,-20754902,-21002082,40.32670920718324,39.79665112764694,NaN,NaN,-6.926864541914981,-13.237079576435017
2001-04-16T09:30:00-04:00,31.95,32.28999,31.95,32.28,132300,241210,56.93672118592435,44.53250885319682,NaN,NaN,124.67332457610189,72.98722064394698,0.2520382650623367,-0.10776242280113024,-0.3598006878634669,-20622602,-20879602,43.88076146935158,39.71481515320754,NaN,NaN,-3.6017295657574486,-11.86060100348108
2001-04-17T09:30:00-04:00,32.34,32.62,32.00999,32.45,49700,231630,58.0268243116836,45.690619763141164,NaN,NaN,135.46623839511,95.72487253464826,0.2846793364146815,-0.003951517345115008,-0.2886308537597965,-20572902,-20764962,47.05903559838978,39.866705189679614,NaN,NaN,-0.5865504394031829,-10.250022351469951
2001-04-18T09:30:00-04:00,32.3,32.7,32.06,32.28,78900,211160,56.486922296328935,46.963826625841456,NaN,NaN,131.77332909721528,104.69114980662985,0.2819971559004855,0.06386559111581036,-0.21813156478467516,-20651802,-20714502,48.44311810363919,40.05224047459846,NaN,NaN,1.4384693054318867,-8.580237829055402
2001-04-19T09:30:00-04:00,32.16,32.16,31.58,31.72,63800,196810,51.62663550674381,48.17963303946611,NaN,NaN,78.36299916011893,109.41908912021162,0.2317840323267529,0.07159847562376598,-0.16018555670298693,-20715602,-20663562,49.86800852117958,40.21591016349999,NaN,NaN,1.7614172805881407,-7.102858527677753
2001-04-20T09:30:00-04:00,32.06,32.23,31.92,32.06,142500,190605,54.20310829433872,49.072712661902976,NaN,NaN,90.62369850023921,112.17991794575707,0.21131930412280642,0.1039635734505211,-0.10735573067228532,-20573102,-20627202,50.910877403700425,40.446584055071234,NaN,NaN,2.790664709606088,-5.6894980652086335
2001-04-23T09:30:00-04:00,32.5,32.95,32.5,32.91,90700,173140,59.94668497504031,50.63480323179125,NaN,NaN,134.17912300631588,114.08107763179987,0.2426384577906787,0.19594234156606305,-0.04669611622461564,-20482402,-20599162,51.74455832904632,40.78656516637262,NaN,NaN,5.50930759787718,-4.089668684767803
2001-04-24T09:30:00-04:00,33.22,33.35001,32.82001,32.97,482900,194640,60.324936820636665,52.55000600209182,NaN,NaN,134.1175959014533,113.81134913306853,0.2538039670656155,0.2705588426074037,0.01675487554178824,-19999502,-20484482,55.10291701663769,41.844364480836596,NaN,NaN,7.801312761852625,-2.3909570495363135
2001-04-25T09:30:00-04:00,33,33.58,32.99001,33.44,264900,202910,63.252471295482984,54.31888926447114,NaN,NaN,135.06043243230957,114.4687698000874,0.27733901961474944,0.36342865006022507,0.08608963044547562,-19734602,-20301042,59.90927124813463,43.55798132085554,NaN,NaN,10.649240425057007,-0.5280716960229821
2001-04-26T09:30:00-04:00,33.67999,34.17,33.67999,34.10001,751100,233560,66.94144529928462,55.87738630194624,NaN,NaN,157.32483329119205,130.261136626302,0.31888719848219227,0.484698628548216,0.1658114300660237,-18983502,-19954622,67.0771231914052,45.98443094449855,NaN,NaN,14.29195164783642,1.5890744959569325
2001-04-27T09:30:00-04:00,34.03999,34.07001,33.75,33.87,143400,235370,64.51096620893351,57.239073274848195,NaN,NaN,137.33580161529537,139.60355724931324,0.31202182618177804,0.5558387127932463,0.24381688661146822,-19126902,-19665382,71.63685717155026,48.92907161192784,NaN,NaN,16.57543852328068,3.729983642717468
2001-04-30T09:30:00-04:00,33.88,34.24001,33.69,33.87,183200,238875,64.51096620893351,58.1995534475653,NaN,NaN,124.80810794818363,137.7293542376868,0.2891392120934777,0.6052409017283154,0.31610168963483765,-19126902,-19394282,75.11561705629589,52.26132488055758,NaN,NaN,18.421781039213982,5.82881184221697
2001-05-01T09:30:00-04:00,33.58,33.84,33.42999,33.64999,235200,245315,62.01323189676928,58.71326035893621,NaN,NaN,97.30389572848655,130.36661420309343,0.24271731463257729,0.6194983329255592,0.37678101829298194,-19362102,-19266802,76.57082267016047,55.331833144038406,NaN,NaN,19.30111584931733,7.753426700374164
2001-05-02T09:30:00-04:00,32.74001,32.83,32.25999,32.34,419000,204790,49.679371487738216,58.66029844487597,NaN,NaN,16.975239528431214,106.74957562231778,0.11386178389417878,0.5191082481607054,0.40524646426652666,-19781102,-19276102,76.22063919437669,58.1333082986465,NaN,NaN,16.23434502089654,8.96498646044879
2001-05-03T09:30:00-04:00,32,32.2,31.81,32.17999,135200,203350,48.41277446321864,58.34807573221837,NaN,NaN,-23.208670701421884,70.64287482379498,0.013222791666964107,0.4217749538502318,0.4085521621832677,-19916302,-19462662,69.36722578707406,60.20763091149585,NaN,NaN,13.366783248923905,9.593814573088093
2001-05-04T09:30:00-04:00,32.25,32.84,32.22,32.69,636500,224580,52.5640909841003,58.035745003516645,NaN,NaN,10.9376774904273,45.36324999882138,-0.021725984901830253,0.38139468105597985,0.4031206659578101,-19279802,-19493242,68.28341564235578,61.950677638139,NaN,NaN,12.160605096094558,9.960498933517588
2001-05-07T09:30:00-04:00,32.98,33,32.45,32.78,162600,229220,53.27860050621767,57.696586160269085,NaN,NaN,16.7418876329828,23.75000593578122,-0.040423873374779595,0.35259082423933563,0.3930146976141152,-19117202,-19491302,68.31723543092008,63.469120483319735,NaN,NaN,11.389951802192796,10.164706486185475
2001-05-08T09:30:00-04:00,32.50999,32.8,32.39999,32.75,133900,231470,52.99206721793099,57.44695365466924,NaN,NaN,0.6427130962637243,4.417769409336666,-0.055521831284513046,0.32361240850847395,0.379134239792987,-19251102,-19469102,68.72817095701544,64.91805282998946,NaN,NaN,10.680371223930269,10.238372877291875
2001-05-09T09:30:00-04:00,32.78,33.33,32.78,33.33,89400,223840,57.72565646621374,57.88259800891708,NaN,NaN,47.62544297914046,10.547810099478482,-0.028516642144470805,0.3434884371123985,0.3720050792568693,-19161702,-19345222,70.98937913372222,66.42672215945679,NaN,NaN,11.404872250179292,10.40501564484722
2001-05-10T09:30:00-04:00,33.28,33.39,33,33.09,1699800,305520,55.24656457141404,57.95713060013674,NaN,NaN,42.217072193165556,23.632958678395976,-0.028803161880520733,0.3360011269062184,0.36480428878673915,-20861502,-19534262,63.44968187069669,67.32235104995652,NaN,NaN,11.310980142393948,10.534439144496753
2001-05-11T09:30:00-04:00,33.05,33.05,32.64999,32.77,32600,296380,52.03760347196869,57.3921962070602,NaN,NaN,-3.587714260792518,20.727880328152015,-0.05122034104703865,0.30077886247794083,0.3519992035249795,-20894102,-19857122,53.080574687046244,67.41778078981366,NaN,NaN,10.314309721746394,10.502992084103845
2001-05-14T09:30:00-04:00,32.99001,33.42999,32.97,33.28,82500,293890,56.38564342655298,57.11081810748279,NaN,NaN,41.06050483336254,25.59160376822795,-0.03324804074119092,0.31043915259849086,0.3436871933396818,-20811602,-20196002,44.804089368776154,66.68215024353783,NaN,NaN,10.699957070374115,10.531129939285313
2001-05-15T09:30:00-04:00,33.67999,33.7,33.39999,33.58,137700,298290,58.754325756780474,56.78952199757548,NaN,NaN,75.1204493368329,40.48715101634179,-0.004228465247637314,0.33840161178013517,0.3426300770277725,-20673902,-20480562,39.26734505112014,65.2077269437511,NaN,NaN,11.716517002901616,10.700470948373356
2001-05-16T09:30:00-04:00,33.75999,33.99001,33.7,33.86,397700,314230,60.889308201786854,56.35722649061135,NaN,NaN,101.10995178048633,51.18405277661096,0.02892735846361194,0.37878927510728744,0.3498619166436755,-20276202,-20703462,35.56033659606619,62.95652790122687,NaN,NaN,13.19757338810484,11.057199868334996
2001-05-17T09:30:00-04:00,33.84,34,33.60001,33.97,68700,314475,61.72745970285012,56.15840459731968,NaN,NaN,94.73372186997936,61.687382711973726,0.052022685208578334,0.4148902731543984,0.3628675879458201,-20207502,-20572662,39.18828930649714,60.63877305372308,NaN,NaN,14.663451841637446,11.572378721663917
2001-05-18T09:30:00-04:00,34.3,34.71001,34.27,34.67999,536300,334165,66.6894216802055,56.31400855955339,NaN,NaN,164.51022538462558,95.30697064105735,0.10577298205937602,0.4950838155200401,0.3893108334606641,-19671202,-20328082,45.38060538894017,58.514843648911956,NaN,NaN,17.503813591761983,12.419726560249355
2001-05-21T09:30:00-04:00,34.89999,34.89999,34.39999,34.60001,589100,359085,65.65675676876374,56.57426033612443,NaN,NaN,149.58362339545158,117.01159435347515,0.12526442300014506,0.5458913622108454,0.4206269392107004,-20260302,-20217822,47.95359686773298,56.47075609159571,NaN,NaN,19.535153941835098,13.436216186190176
2001-05-22T09:30:00-04:00,34.53999,34.55,34.10001,34.25,152500,342565,61.1912042095248,57.39653410196633,NaN,NaN,97.7126177929743,121.53002804470343,0.10474311649955326,0.5515558348351419,0.44681271833558867,-20412802,-20165602,49.17476214815328,54.53890773115118,NaN,NaN,20.013017245000146,14.3757591945916
2001-05-23T09:30:00-04:00,33.89999,34.10001,33.52,33.73,2010000,429820,55.1859440093462,57.880331926689735,NaN,NaN,37.08482442037128,108.72500257268044,0.049131260452836834,0.5082267939016347,0.4590955334487979,-22422802,-20594922,40.716468374672225,52.49242505883676,NaN,NaN,18.640434616216766,14.984998540538053
2001-05-24T09:30:00-04:00,33.5,33.67999,33.3,33.67,404200,412475,54.52106934364486,58.02011609522863,NaN,NaN,14.469986972613484,92.67225559320725,0.003684738431051715,0.4637014564876125,0.4600167180565608,-22827002,-21118822,33.209638039947535,49.987155230093315,NaN,NaN,17.32869574612743,15.31981242705082
2001-05-25T09:30:00-04:00,33.7,33.7,33.36,33.38,78400,409225,51.303766169924636,57.87905649977913,NaN,NaN,9.225961136144965,61.615402743511126,-0.04769442832024101,0.40039868265625955,0.44809311097650056,-22905402,-21765662,26.671342728159004,47.01244860846752,NaN,NaN,15.274959480130537,15.313404863205065
2001-05-29T09:30:00-04:00,33.66,33.89999,33.33,33.33,884600,444295,50.7477326730354,57.71874688942945,NaN,NaN,16.826643952751166,35.06400685497105,-0.08467373646644744,0.3422509403934413,0.4269246768598887,-23790002,-22471602,21.65943450876057,43.650396005020745,NaN,NaN,13.42120350674469,15.043090383710727
2001-05-30T09:30:00-04:00,33.42,33.48,33.12,33.2,349300,450000,49.253070480420924,57.11356217615853,NaN,NaN,-11.530534616521395,13.215376373071908,-0.115601400304432,0.28242292647934875,0.39802432678378075,-24139302,-23216902,17.846500335003114,39.854476090826516,NaN,NaN,11.439433883251546,14.528282312216557
2001-05-31T09:30:00-04:00,33.38,33.57001,33.06,33.55,113400,434720,53.24568582917636,56.970642265998684,NaN,NaN,-1.838416246177601,5.430728239762132,-0.11021877387840168,0.26025085943577864,0.3704696333141803,-24025902,-23537522,16.500762738744044,36.50098186711562,NaN,NaN,10.75925746874398,13.989850191720475
2001-06-01T09:30:00-04:00,33.5,33.55,33.14,33.39999,1051100,480515,51.37983360136246,56.92365870381253,NaN,NaN,-16.622534096624683,-0.7877759740855094,-0.11401798633856453,0.22794715039097468,0.3419651367295392,-25077002,-23987522,14.812492195492567,33.76754740343322,NaN,NaN,9.671976017271176,13.373011023942004
2001-06-04T09:30:00-04:00,33.85001,33.98,33.81,33.85001,174000,457390,56.32439769249302,56.91928400852253,NaN,NaN,55.31858149298234,8.430748097281967,-0.08482065366089653,0.23593931965341852,0.32075997331431505,-24903002,-24387042,13.492583659602545,31.53101128134939,NaN,NaN,10.084307296811017,12.903196205780434
2001-06-05T09:30:00-04:00,33.85001,34.03,33.63,33.95,364200,467470,57.36196945172371,56.81982998673277,NaN,NaN,46.34269476973836,14.333958260679404,-0.05861707160436669,0.24748863380885666,0.30610570541322335,-24538802,-24536802,13.02408858005289,29.656492961987446,NaN,NaN,10.716654480155254,12.590833102119694
2001-06-06T09:30:00-04:00,33.5,33.5,33,33.09,152100,468380,47.01638481012681,55.82890688732848,NaN,NaN,-75.15033321977882,1.6099985400279195,-0.0967942684344677,0.18511286987013875,0.28190713830460645,-24690902,-24647122,12.674948878788186,28.021822410753305,NaN,NaN,8.11099693064421,11.950856506194626
2001-06-07T09:30:00-04:00,33.03,33.09,32.67999,32.7,359900,481905,43.2103753587168,54.506258005604664,NaN,NaN,-133.85305932029323,-24.792930074795205,-0.14310786275356913,0.10302230986264505,0.24613017261621417,-25050802,-24852102,12.029669890724847,26.081921023912425,NaN,NaN,4.682093512526323,10.91246179281344
2001-06-08T09:30:00-04:00,32.8,32.92,32.42999,32.78999,52700,399550,44.33021162639025,52.909171573189305,NaN,NaN,-142.3386873935254,-49.936160734175346,-0.1611353460239588,0.04471099008626567,0.20584633611022446,-24998102,-24836322,12.399403189522062,23.72612086681113,NaN,NaN,2.242276082167834,9.673863834149783
2001-06-11T09:30:00-04:00,33.2,33.21001,32.88,32.88,23900,399115,45.48807741815471,51.46855161957436,NaN,NaN,-100.01564506293163,-81.00300604535815,-0.1601200760188229,0.0056962410866958635,0.16581631710551875,-24974202,-24850562,12.348963717447305,21.182932784647864,NaN,NaN,0.5680563770846101,8.373034197426186
2001-06-12T09:30:00-04:00,33,33.28,33,33.13,127400,401360,48.68073962838348,50.574947006635696,NaN,NaN,-74.17159704383023,-105.10586440807185,-0.13664726523495188,-0.004992764438171093,0.1316545007967808,-24846802,-24912162,12.11929465317563,18.536113677863742,NaN,NaN,0.0459802087113535,7.18345505618121
2001-06-13T09:30:00-04:00,33.5,33.56,32.88,32.97,344200,411685,46.79189279232051,49.97537191970529,NaN,NaN,-67.83354087386486,-103.64250593888907,-0.12618278190098214,-0.026073976579446878,0.10010880532153525,-25191002,-25012182,11.737577836788816,16.46619292515778,NaN,NaN,-0.9269668450511038,6.024823356005165
2001-06-14T09:30:00-04:00,32.7,32.74001,32.3,32.3,197000,401650,39.82369278927284,48.925559308678714,NaN,NaN,-155.4428788864223,-107.96046985211487,-0.1566796441704319,-0.0957407498915046,0.06093889427892728,-25388002,-25079622,11.475133568294154,14.913728320039683,NaN,NaN,-3.983144632901312,4.59511364330424
2001-06-15T09:30:00-04:00,32.5,32.64,32.16,32.39,97400,403085,41.09272120067006,48.19619895373195,NaN,NaN,-143.10638901835134,-108.11401017708008,-0.16239305929360676,-0.1420524298380812,0.020340629455525575,-25290602,-25138122,11.240353319806403,13.81151479087164,NaN,NaN,-6.100927605185875,3.067107750662795
2001-06-18T09:30:00-04:00,32.12,32.41,31.89999,32.03,228000,387670,37.67061706567714,47.26211926749208,NaN,NaN,-165.57369231889237,-121.22561962827221,-0.18062100530601738,-0.20543562717699615,-0.02481462187097877,-25518602,-25247002,10.797554805384635,13.035666240630501,NaN,NaN,-8.974225819836775,1.3469172405914278
2001-06-19T09:30:00-04:00,32.10001,32.10001,31.66,32,365600,376495,37.39116919664368,46.41484060436513,NaN,NaN,-172.80119497995182,-140.95153921549655,-0.18426577691602267,-0.2551468430160071,-0.07088106609998443,-25884202,-25454482,9.989944110507238,12.474483653166512,NaN,NaN,-11.38917463323411,-0.4725244556693631
2001-06-20T09:30:00-04:00,31.61,32.61,31.39999,31.39999,223100,380025,32.239905877980206,44.91442775070827,NaN,NaN,-161.33655978732847,-159.65214299818928,-0.21453575995711963,-0.33905076604638396,-0.12451500608926433,-26107302,-25637742,9.326404265067993,11.962029476475363,NaN,NaN,-15.205604142109156,-2.577250125160762
2001-06-21T09:30:00-04:00,31.60001,31.60001,30.74001,30.92999,637000,311375,28.883194625821105,43.30752496674103,NaN,NaN,-204.01330453641754,-169.3662281281883,-0.25112120231138174,-0.4384165089784915,-0.18729530666710975,-26744302,-25909002,8.43348204206005,11.506385894087328,NaN,NaN,-19.614809364517154,-5.011187159354532
2001-06-22T09:30:00-04:00,30.95,31.53,30.62,31.53,196200,300975,37.78827380023519,41.98351611729404,NaN,NaN,-157.82368735635967,-172.30968779578998,-0.22088928839136232,-0.46340691715631266,-0.24251762876495034,-26548102,-26160502,7.697625602793565,11.092460318600972,NaN,NaN,-20.554321489906304,-7.231634920861928
2001-06-25T09:30:00-04:00,31.39999,31.53,31.10001,31.16,88700,301490,34.88719505112951,40.378175088680166,NaN,NaN,-131.67263392691638,-165.52947611739478,-0.2117626776197002,-0.5072209757895756,-0.2954582981698754,-26636802,-26384142,7.104034466206954,10.66959931046912,NaN,NaN,-22.284306437610113,-9.382016566111668
2001-06-26T09:30:00-04:00,31.12,31.37,31.00999,31.35001,58100,260165,37.53917126101841,39.70123126374386,NaN,NaN,-116.28287593004451,-154.22581230741332,-0.18012171410941352,-0.5206104408066423,-0.3404887266972288,-26578702,-26523042,6.75559169269799,10.246788082891248,NaN,NaN,-22.838258538090166,-11.304336847822881
2001-06-27T09:30:00-04:00,31,31,30.56,30.60001,1840100,334705,31.999153055534194,38.90042967065938,NaN,NaN,-140.38939534067927,-150.03637941808347,-0.19560657041337948,-0.5849969397139532,-0.3893903693005737,-28418802,-26985342,5.745500469128245,9.797918838491492,NaN,NaN,-25.199708588791957,-13.289389953675606
2001-06-28T09:30:00-04:00,30.3,30.3,29.84,29.95,112500,334660,28.125111913870867,37.74292254833657,NaN,NaN,-165.7257359393812,-142.3788656986762,-0.23299028069686833,-0.6806282201716591,-0.4476379394747908,-28531302,-27342742,5.109456356997626,9.27720835045403,NaN,NaN,-28.57304455758915,-15.472769182806111
2001-06-29T09:30:00-04:00,30.10001,30.60001,29.85001,30.35001,236700,293940,33.46362571999656,36.88403314132527,NaN,NaN,-130.18390096385826,-136.85090842017593,-0.214599197196086,-0.7158869359698983,-0.5012877387738123,-28294602,-27692042,4.576247232817565,8.722014315837619,NaN,NaN,-29.4808128286347,-17.473918275067337
2001-07-02T09:30:00-04:00,30.2,30.56,30.14999,30.27,123000,291390,32.936661808032994,35.75945615415738,NaN,NaN,-113.31023706480345,-133.17842904775335,-0.19235828448196568,-0.7417355943762693,-0.5493773098943037,-28417602,-28048202,4.10576016009027,8.149618994902951,NaN,NaN,-30.356676347801987,-19.314312285458
2001-07-03T09:30:00-04:00,30.10001,30.3,30.10001,30.23,84800,277420,32.65976285632158,34.750018301586024,NaN,NaN,-109.44000977678377,-131.8098558171012,-0.16587851062659253,-0.7567254481775443,-0.5908469375509517,-28502402,-28432942,3.6671544342839724,7.573160180438317,NaN,NaN,-31.134674448196836,-21.00293545156355
2001-07-05T09:30:00-04:00,30.2,30.72,30.2,30.5,831000,311365,36.538080627493144,34.51533171860176,NaN,NaN,-81.81563839817656,-120.09510442860066,-0.11796846776654901,-0.738307522259138,-0.620339054492589,-27671402,-28283462,7.788747163208413,7.309846865789337,NaN,NaN,-30.625808077299656,-22.37763154095442
2001-07-06T09:30:00-04:00,30.56,30.67999,30.2,30.39,299200,308330,35.63756677635347,34.125677831150576,NaN,NaN,-77.8662267960084,-102.5232025999261,-0.083119709332107,-0.7242386911577228,-0.6411189818256158,-27970602,-28171322,10.86965303038717,7.283368273687963,NaN,NaN,-30.462746609080178,-23.5326479792581
2001-07-09T09:30:00-04:00,30.25,30.28999,29.91,29.96001,66200,309005,32.287667888321025,33.74118146133942,NaN,NaN,-96.66999680513293,-95.82042176818103,-0.07851590805253272,-0.7392638668912817,-0.6607479588387489,-28036802,-28119762,12.320197704348402,7.392128480756804,NaN,NaN,-31.30245482399397,-24.64262038564894
2001-07-10T09:30:00-04:00,30.11,30.14,29.75999,30,465400,331080,32.91920602414079,33.42175552044636,NaN,NaN,-96.97712941443831,-92.55380023810801,-0.0629384195683248,-0.739420983299155,-0.6764825637308302,-27571402,-27950522,17.08986332822093,7.899265567736355,NaN,NaN,-31.807942677683787,-25.66623785593963
2001-07-11T09:30:00-04:00,29.55,29.7,29.11,29.60001,236000,336510,29.91390906948945,33.25561289126845,NaN,NaN,-124.47089466569217,-95.55997721588969,-0.06923448056398829,-0.7630256644358155,-0.6937911838718273,-27807402,-27811522,20.89599084271775,8.72566460899705,NaN,NaN,-33.12553826287126,-26.731852199787006
2001-07-12T09:30:00-04:00,29.39999,29.58,29.2,29.56,31700,320885,29.622592488426278,33.30842702431168,NaN,NaN,-117.91842349146361,-102.7805342345471,-0.06577952668444298,-0.776015592227381,-0.710236065542938,-27839102,-27845062,20.649658454574165,9.598248638462346,NaN,NaN,-34.287319482513126,-27.81120466874788
2001-07-13T09:30:00-04:00,29.37,29.98,29.22,29.67,62800,314175,31.594964914023876,32.86604781815373,NaN,NaN,-96.68761586421785,-106.54481204818899,-0.04667072738463829,-0.768574474773736,-0.7219037473890977,-27776302,-27806202,21.79990320528404,10.605554181497379,NaN,NaN,-34.731906496719375,-28.799876358458093
2001-07-16T09:30:00-04:00,29.75,29.75,28.92,29.17999,154400,317025,27.85053169375847,32.363429006912945,NaN,NaN,-120.43597633492197,-111.29800795414681,-0.056936980314897134,-0.7930749727827191,-0.736137992467822,-27930702,-27784982,22.460885102784715,11.702472084110076,NaN,NaN,-36.21448538041965,-29.859106218738315
2001-07-17T09:30:00-04:00,29.35001,29.35001,28.85001,29.05,108800,311065,26.938456580627317,31.60623510117073,NaN,NaN,-132.65246965700044,-118.43307600265923,-0.06197136672790504,-0.8136022008777033,-0.7516308341497983,-28039502,-27878602,21.593689498672887,12.762336213108282,NaN,NaN,-37.71400032530833,-30.981233948248317
2001-07-18T09:30:00-04:00,28.62,29.62,28.3,28.74001,67400,296155,24.84857789135367,31.095479732300685,NaN,NaN,-141.62515644289041,-121.86392835809889,-0.07480854391818526,-0.8451415140475298,-0.7703329701293445,-28106902,-27938502,21.034115752841473,13.854380161944942,NaN,NaN,-39.62879713316081,-32.21660011752153
2001-07-19T09:30:00-04:00,28.95,29.35001,28.95,29.03999,587200,314360,30.47004430968353,31.262974903430166,NaN,NaN,-108.15702899138344,-119.91164945808285,-0.052766048959077994,-0.8362905313281921,-0.7835244823691141,-27519702,-27874622,23.316328589378585,15.154871035686439,NaN,NaN,-39.655807521313804,-33.279344032348995
2001-07-20T09:30:00-04:00,29.5,29.73,29.37,29.66,911800,328100,40.39416956735872,31.758013749670315,NaN,NaN,-51.00055893756482,-110.77423807275223,0.01052667621309289,-0.7703661371027479,-0.7808928133158408,-26607902,-27640942,31.154804018619103,17.053339377529404,NaN,NaN,-36.54081995608037,-33.74526916431062
2001-07-23T09:30:00-04:00,29.78,29.89999,28.78,29.32001,113000,323940,37.25405183315734,32.06639875146491,NaN,NaN,-71.79560957457842,-101.04616472068352,0.035067387603882394,-0.7370585788109878,-0.7721259664148702,-26720902,-27398982,38.19899259146165,19.4885702654845,NaN,NaN,-34.873128906274765,-33.90639198459121
2001-07-24T09:30:00-04:00,29.14999,29.14999,28.25,28.27,108100,324910,29.600846670620243,31.84790473820053,NaN,NaN,-146.88680984603113,-103.89303275848968,-0.011359120468511175,-0.7863248670005092,-0.774965746531998,-26829002,-27156882,44.33613992702541,22.39349780068032,NaN,NaN,-35.9923266852127,-34.204382656108564
2001-07-25T09:30:00-04:00,28.73,29.69,28.55,29.58,240500,334030,44.828890082186476,32.44010541353577,NaN,NaN,-56.45747574277114,-86.85949661846583,0.05080346195199259,-0.7114614190920072,-0.7622648810439998,-26588502,-26853202,50.92001392268552,25.474302569214398,NaN,NaN,-30.90781581394954,-33.73344453580013
2001-07-26T09:30:00-04:00,29.87,30.17999,29.5,30.17999,212900,252670,50.14775311774862,33.476547295063995,NaN,NaN,40.54665254558048,-57.11876031107304,0.13234194643044028,-0.5968374480059495,-0.7291793944363898,-26375602,-26624382,55.21808258859257,28.642047537657643,NaN,NaN,-24.82353235070597,-32.46059993792954
2001-07-27T09:30:00-04:00,29.85001,30.48,29.67,30.32001,115800,252835,51.32705622836977,34.83650360506748,NaN,NaN,67.5399618095896,-33.410656161642166,0.19209464396073783,-0.48906108948546745,-0.6811557334462053,-26259802,-26554762,56.467219513953474,31.79540623834372,NaN,NaN,-19.86115332480382,-30.66067899319729
2001-07-30T09:30:00-04:00,30.37,30.53999,30.19,30.35001,67000,244350,51.5912850123983,36.17022353280016,NaN,NaN,94.34111927906834,-0.18331039091281126,0.22760105522801966,-0.39665441441118077,-0.6242554696392004,-26192802,-26449142,58.364652236406165,34.743605446071236,NaN,NaN,-16.007435454200735,-28.567358487626354
2001-07-31T09:30:00-04:00,30.5,30.60001,30,30,200900,248245,48.297032816244176,37.483303800425496,NaN,NaN,74.12665693256673,44.01938296480676,0.2212789599728966,-0.3476567696730797,-0.5689357296459763,-26393702,-26362082,59.91554972983216,37.53071679515084,NaN,NaN,-13.909131286000706,-26.47332603025126
2001-08-01T09:30:00-04:00,30.35001,30.48,29.72,29.89,486900,268350,47.275359029837645,38.74421569624059,NaN,NaN,52.59261492491539,65.82940109834406,0.203883519845369,-0.31408132983926507,-0.5179648496846341,-26880602,-26420502,58.344998512167045,40.2232410849789,NaN,NaN,-12.54978622612836,-24.48424891537656
2001-08-02T09:30:00-04:00,29.95,29.96001,29.57001,29.87,568400,255220,47.08035055656721,39.850314670707974,NaN,NaN,26.52206750119376,63.024484089466725,0.18573831735471574,-0.2857919529912394,-0.4715302703459551,-27449002,-26635182,52.86139675243119,42.44191919548941,NaN,NaN,-11.517340433190073,-22.63183341792135
2001-08-03T09:30:00-04:00,29.78999,29.78999,29.35001,29.42,203000,250410,42.80223693537776,40.91829361653792,NaN,NaN,-11.135055589687616,47.28948060961128,0.14020944920040407,-0.29626845884545006,-0.4364779080458541,-27652002,-26913622,46.72721183582216,44.17522824784923,NaN,NaN,-11.886408956329623,-21.096772780551102
2001-08-06T09:30:00-04:00,29.35001,29.62,29.27,29.38,33200,248760,42.43313197997448,42.02505614506272,NaN,NaN,-23.444642205250023,23.73232831274761,0.10574940488846962,-0.3042911519352671,-0.41004055682373675,-27685202,-27212102,41.20698007515866,45.57617757474107,NaN,NaN,-12.291624154930851,-19.838894405462494
2001-08-07T09:30:00-04:00,29.5,29.53,29.27,29.38,42700,227625,42.43313197997448,43.281095722821355,NaN,NaN,-24.925782909170646,3.921840344400136,0.08234521965559827,-0.3071090322542389,-0.3894542519098372,-27685202,-27470402,37.12011237154468,46.72517733321987,NaN,NaN,-12.624113119943747,-18.8082113646741
2001-08-08T09:30:00-04:00,29.45,29.45,28.62,28.78,599100,245780,36.897790749199494,43.74022046850106,NaN,NaN,-97.74930500292376,-26.146543641167693,0.0286192390664734,-0.3536802030767454,-0.3822994421432188,-28284302,-27751142,33.25915046832185,47.43537889600153,NaN,NaN,-14.54870654747957,-18.199710676503454
2001-08-09T09:30:00-04:00,28.5,28.95,28.5,28.95,220100,255200,39.31333467188368,43.66301797596713,NaN,NaN,-110.146867568559,-53.480330655118244,0.007778921363988334,-0.3725757904382334,-0.38035471180222175,-28064202,-27874182,31.70278918990985,47.47452069395087,NaN,NaN,-15.486096971951929,-17.812051575853236
2001-08-10T09:30:00-04:00,28.95,29.28999,28.83,28.98,379300,271025,39.75163586264744,43.84141683521642,NaN,NaN,-65.41881876681877,-64.33708329054448,-0.0003090187211323703,-0.3807409852036372,-0.3804319664825048,-27684902,-27880762,31.61757888280107,47.00441971476083,NaN,NaN,-16.141174210750478,-17.573354809409985
2001-08-13T09:30:00-04:00,29.10001,29.38,29.03,29.12,288100,277710,41.86187588484498,44.71720463623247,NaN,NaN,-40.89115368560691,-67.82638558661586,0.007040614949767432,-0.3716311977952955,-0.37867181274506295,-27396802,-27823082,33.309737713361926,46.21681955664201,NaN,NaN,-16.139638041841874,-17.368538128328826
2001-08-14T09:30:00-04:00,29.14999,29.33,29.07001,29.28,80700,276305,44.2645493035564,44.676894580616036,NaN,NaN,-34.493458027861365,-69.739920610354,0.02494124712443263,-0.3474952538395222,-0.3724365009639548,-27316102,-27749262,35.509255677801264,45.116051110578844,NaN,NaN,-15.50129038503156,-17.10178845071493
2001-08-15T09:30:00-04:00,29.25,29.89,29.21001,29.72,543700,300120,50.342235474292835,44.69078617751206,NaN,NaN,22.327937340438694,-45.72447214168151,0.06632875975811142,-0.2895255512663155,-0.35585431102442694,-26772402,-27446882,43.70022751915276,44.29334717704744,NaN,NaN,-13.20465373720849,-16.54505492021401
2001-08-16T09:30:00-04:00,29.95,29.95,29.37,29.55,180600,279790,48.157246118534886,44.46437116966671,NaN,NaN,21.410885567057043,-19.4129215145583,0.08118784065594042,-0.2543695102045014,-0.3355573508604418,-26953002,-27224642,48.84299622878664,43.74875979953551,NaN,NaN,-11.848019433415217,-15.874049850671325
2001-08-17T09:30:00-04:00,29.58,29.58,29.14999,29.33,54100,236905,45.410422253567084,44.02288097260733,NaN,NaN,-23.384778947402445,-11.006113550675035,0.075264550206385,-0.24147666310246052,-0.3167412133088455,-27007102,-27089082,51.738884010320845,43.27549064052942,NaN,NaN,-11.435788775041553,-15.240012554152786
2001-08-20T09:30:00-04:00,29.25,29.28,29,29.12,31900,232850,42.895294118017674,43.637042494162586,NaN,NaN,-58.35190217599668,-14.498263248752988,0.05709241419467109,-0.24537569556550665,-0.30246810976017774,-27039002,-27017522,53.2435550635767,42.79891959293974,NaN,NaN,-11.781344578264287,-14.745917129025857
2001-08-21T09:30:00-04:00,29.05,29.33,28.7,29.10001,555300,255210,42.653116764158106,43.30688233232833,NaN,NaN,-82.24754788103743,-24.049081219388203,0.04419142162337314,-0.2472288327309613,-0.29142025435433444,-27594302,-27073162,51.888926087583386,42.33777156261234,NaN,NaN,-12.133017607811523,-14.372645768852381
2001-08-22T09:30:00-04:00,29.60001,29.83,29.12,29.12,210300,253700,42.99968267048329,43.015406054750905,NaN,NaN,-27.18264335530418,-33.951197358536774,0.037721280000518886,-0.24426865435368583,-0.2819899343542047,-27384002,-27195482,48.94097055898741,42.0577411202235,NaN,NaN,-12.339998382718981,-14.082267570833324
2001-08-23T09:30:00-04:00,29.28,29.48,29.22,29.38,23000,244205,47.44813921804479,43.347256217798545,NaN,NaN,-22.49067075073634,-42.731508622095454,0.05085194974666135,-0.21842499717087804,-0.2692769469175394,-27361002,-27277082,47.021760547262495,42.07878031389781,NaN,NaN,-11.349443398028287,-13.691864117575461
2001-08-24T09:30:00-04:00,29.38,29.63,29.3,29.62,98200,243325,51.231631750122894,43.97572048709486,NaN,NaN,15.37006727556009,-34.98053937750294,0.07418744176645747,-0.17654264470946757,-0.25073008647592504,-27262802,-27328222,45.80932390474625,42.40751915886835,NaN,NaN,-9.438423897479007,-13.084229800418825
2001-08-27T09:30:00-04:00,29.60001,29.78,29.42,29.58,249800,252465,50.57804943512075,44.55750030531959,NaN,NaN,46.87011724195468,-13.936135493912635,0.08465779958006511,-0.14490783700084364,-0.22956563658090876,-27512602,-27422942,43.56854565716346,42.868121536412545,NaN,NaN,-8.000869891062187,-12.358035527653591
2001-08-28T09:30:00-04:00,29.48,29.48,29.10001,29.27,99200,247380,45.71096501202696,45.187012752664415,NaN,NaN,-22.99786619766758,-2.086199157238665,0.06909194557373782,-0.14320070461373646,-0.21229265018747429,-27611802,-27426442,43.48390392087686,43.598461068737905,NaN,NaN,-8.02660256403125,-11.739259389993256
2001-08-29T09:30:00-04:00,29.39999,29.56,29.14999,29.14999,38900,224980,43.9478335346861,45.51804838572173,NaN,NaN,-12.55557391837357,0.839214730147457,0.04999032962117772,-0.14980473816100215,-0.19979506778217987,-27650702,-27479782,42.140277479509976,44.34399594656649,NaN,NaN,-8.530253811628558,-11.280830021655442
2001-08-30T09:30:00-04:00,29.39999,29.42999,28.64,28.73,656900,229405,38.370036365946156,45.41936270738592,NaN,NaN,-118.82885311587053,-18.428421742879383,0.010415943986731735,-0.1867751377987652,-0.19719108178549694,-28307602,-27669102,37.68892548403238,44.77766356094015,NaN,NaN,-10.638908189284818,-11.189126902745352
2001-08-31T09:30:00-04:00,28.66,28.95,28.53999,28.73,76200,223065,38.37003636594616,45.16994559889315,NaN,NaN,-156.4051717736775,-52.7834695527269,-0.013136781788825214,-0.21361205902152847,-0.20047527723270325,-28307602,-27878062,33.484645762857696,44.79015699304699,NaN,NaN,-12.35836931070706,-11.356161532454168
2001-09-04T09:30:00-04:00,28.74001,29.32001,28.74001,28.89999,938600,268335,41.835316935271784,44.99642900115854,NaN,NaN,-71.24374631314882,-76.4062422637476,-0.014534462696413314,-0.2186433556032199,-0.2041088929068066,-27369002,-27849342,34.56506787209082,44.722715006924815,NaN,NaN,-12.895616248443032,-11.576083634738291
2001-09-05T09:30:00-04:00,28.8,29,28.7,29,133000,272850,43.83613773856112,44.531707734320555,NaN,NaN,-87.26275885974572,-89.25922079616323,-0.006405355086024633,-0.2121155867643374,-0.20571023167831276,-27236002,-27774182,37.42943480618385,44.274801241712744,NaN,NaN,-12.808620722082487,-11.752160361501748
2001-09-06T09:30:00-04:00,29.05,29.05,28.71001,28.8,269800,256385,40.812606811612994,44.007090640969,NaN,NaN,-97.53883260974078,-106.25587253443666,-0.011862520472809779,-0.22053838226932498,-0.2086758617965152,-27505802,-27745202,38.546458042819495,43.539334228429375,NaN,NaN,-13.57130736841948,-12.012038505347139
2001-09-07T09:30:00-04:00,28.75,28.98,28.62,28.78,102000,250480,40.51168950140839,43.657181158671946,NaN,NaN,-114.64354527938109,-105.41881096713878,-0.014035008366379914,-0.2262196222544901,-0.2121846138881102,-27607802,-27605242,43.76763832524304,42.96995953663811,NaN,NaN,-14.287502591670304,-12.337104803393306
2001-09-10T09:30:00-04:00,28.8,28.92,28.39999,28.87,584300,260730,42.563959635759296,43.63351440993921,NaN,NaN,-120.54377526364344,-98.24653166513198,-0.006982906993737437,-0.22091324763028197,-0.21393034063654454,-27023502,-27348422,51.85142428912899,42.87052162417756,NaN,NaN,-14.366074328585338,-12.626957592706454
2001-09-17T09:30:00-04:00,28.5,28.5,27.78,28.28,2009600,346805,34.227645046182175,43.031695001512354,NaN,NaN,-211.31622392315577,-126.26102718713337,-0.03789879052449954,-0.26130382879216896,-0.22340503826766941,-29033102,-27681242,43.1868825849161,42.24894708827276,NaN,NaN,-16.98917211107872,-13.250131095331064
2001-09-18T09:30:00-04:00,28,28,26.89,26.91,598200,372680,22.975239800394434,41.60137765364887,NaN,NaN,-304.40277712523385,-169.689030840231,-0.1406830084978894,-0.39925879889003113,-0.25857579039214174,-29631302,-28160302,34.30171022283204,41.20328563569023,NaN,NaN,-24.417754585792068,-14.845505879682635
2001-09-19T09:30:00-04:00,26.75,27,24.87,25.94,242800,357635,18.370329782879665,39.524391265422786,NaN,NaN,-358.26777071402125,-221.83481846108708,-0.2572770770692001,-0.5801721367286419,-0.32289505965944176,-29874102,-28633962,28.13769150555966,39.85442356128288,NaN,NaN,-32.85056896532589,-17.417657749060243
2001-09-20T09:30:00-04:00,25.39999,25.61,25.05,25.21001,983100,397760,15.803260173302007,36.99379329564987,NaN,NaN,-284.18333234834716,-255.74277587488032,-0.36051157472363043,-0.7735345280639798,-0.4130229533403494,-30857202,-29283842,22.234072340606488,38.17047702098718,NaN,NaN,-40.61866773452944,-20.732087746984412
2001-09-21T09:30:00-04:00,24.3,25.3,24.10001,25.08,1167500,453430,15.39075893258034,34.480415402611264,NaN,NaN,-226.985186067817,-277.03105803571503,-0.4108498284511819,-0.9265852389043268,-0.5157354104531449,-32024702,-30284082,16.496997567642467,36.23679501459282,NaN,NaN,-46.34085045947064,-24.39048242019673
2001-09-24T09:30:00-04:00,24.89999,25.02,24.25,24.42,1634800,533575,13.468741015495851,32.177399402859045,NaN,NaN,-185.38599146238948,-271.8450115435618,-0.4582812405967912,-1.088586961199134,-0.6303057206023427,-33659502,-31209362,13.123534540723753,34.068197201724736,NaN,NaN,-51.74443438753348,-28.29818984410198
2001-09-25T09:30:00-04:00,24.2,24.5,23.75,24.14999,850100,548315,12.766341121334165,29.95014994476248,NaN,NaN,-162.69612609917755,-243.5036813383505,-0.47547150139202,-1.2246450973423677,-0.7491735959503477,-34509602,-32185022,10.6504035636531,31.818920493449248,NaN,NaN,-56.113736198519405,-32.27183932330447
2001-09-26T09:30:00-04:00,24.3,24.45,23.75,23.98,495200,562560,12.330366092694959,28.09017349667311,NaN,NaN,-136.7709886291577,-199.2043249213778,-0.46533931404813544,-1.330847738510517,-0.8655084244623816,-35004802,-33211162,8.776986294863875,29.75378197993721,NaN,NaN,-59.61830610375649,-36.178477434797614
2001-09-27T09:30:00-04:00,24.25,25.00999,24.02,24.92999,1094400,616130,27.27711140440026,27.29782171370554,NaN,NaN,-98.95948613593136,-162.1595556788946,-0.3660779819899618,-1.323105901949834,-0.9570279199598721,-33910402,-33821802,7.887809383206985,27.925436524247868,NaN,NaN,-57.125994936214155,-39.17097993499998
2001-09-28T09:30:00-04:00,25.35001,25.92999,25.35001,25.82001,348500,628645,37.950475291887635,27.020333024892388,NaN,NaN,-54.68505912077267,-127.69953028948575,-0.21914845131963268,-1.230963484109413,-1.0118150327897804,-33561902,-34129242,7.477098990107365,25.99058160410619,NaN,NaN,-50.8566120986783,-40.840355958382595
2001-10-01T09:30:00-04:00,25.60001,25.64999,25.03,25.46001,74900,619900,35.670022942600326,26.437039110895192,NaN,NaN,-58.704059715130526,-102.36314394003398,-0.12931757850857628,-1.1734620059255008,-1.0441444274169245,-33636802,-34124702,7.553649699745634,23.856596953646324,NaN,NaN,-46.85433594554441,-41.69949595654857
2001-10-02T09:30:00-04:00,25.55,26.17999,25.42,26.02,60700,617975,41.5533853090823,26.489951860714424,NaN,NaN,-36.085169348257,-77.04095258984985,-0.020977767594831498,-1.0703666369104639,-1.0493888693156324,-33576102,-33938002,10.82129051031086,21.876227844181415,NaN,NaN,-41.46764183778837,-41.666373939582826
2001-10-03T09:30:00-04:00,25.89999,26.44,25.67,26.38,73700,619715,45.03367816849951,26.81295105122093,NaN,NaN,-20.859915368717793,-53.85873793776186,0.08056865322163342,-0.9486780527885905,-1.029246706010224,-33502402,-33637522,15.96929016810985,19.890631547243327,NaN,NaN,-35.98711193777664,-40.85505079646766
2001-10-04T09:30:00-04:00,26.64999,27.38,26.52,27,117200,592730,50.50045684780914,27.379843709224495,NaN,NaN,15.25002891280037,-31.016834928015516,0.18894283789279087,-0.7930681586442354,-0.9820109965370263,-33385202,-33532482,17.75660952009696,17.455287635169615,NaN,NaN,-29.505419862881606,-39.23367494881251
2001-10-05T09:30:00-04:00,27.05,27.28999,26.62,27.2,70600,592450,52.15358752468032,28.660268171974366,NaN,NaN,23.05440053596735,-15.468942996667526,0.2686813210818103,-0.6461593451847634,-0.9148406662665737,-33314602,-33483022,18.63419640806731,15.701524336823274,NaN,NaN,-23.876025675102458,-37.039725052568215
2001-10-08T09:30:00-04:00,26.95,27.58,26.7,27.25,341000,562570,52.57996334870261,30.774891282567808,NaN,NaN,35.58995553639111,3.389860053636802,0.3161064496451498,-0.5197076042101365,-0.8358140538552863,-32973602,-33350382,21.06670529381921,14.756166841893783,NaN,NaN,-19.333153881941616,-34.51021488533584
2001-10-09T09:30:00-04:00,27.3,27.50999,27.12,27.3,38500,557845,53.0307196239656,33.25063341407395,NaN,NaN,48.68191826878045,20.34327757704429,0.34007161939672037,-0.41072452960938577,-0.7507961490061061,-32935102,-33222182,23.44881963815544,14.421247422793487,NaN,NaN,-15.55618363098707,-31.802496134714588
2001-10-10T09:30:00-04:00,27.64999,28.66,27.64999,28.50999,261200,557415,62.35617592711673,36.575841682203574,NaN,NaN,101.18532001126134,44.75232465304012,0.4213290075028878,-0.2241348896274964,-0.6454638971303842,-32673902,-33056482,26.53486851626144,14.728447149625982,NaN,NaN,-8.768460395959742,-28.511919600606753
2001-10-11T09:30:00-04:00,28.7,28.89999,28.16,28.5,395200,572075,62.2462910177167,39.92266540257045,NaN,NaN,115.99582357091231,64.9014835846625,0.45541983404454567,-0.07618910457470207,-0.5316089386192477,-33069102,-32993262,27.731923423273997,15.530941853599662,NaN,NaN,-3.5239779742871473,-24.94221365398967
2001-10-12T09:30:00-04:00,28.39999,28.63,28.00101,28.31,399000,562810,60.07785893745884,43.25188811128209,NaN,NaN,108.23714555595484,81.93803258866001,0.4456346645184093,0.025434392028763853,-0.4202002724896454,-33468102,-33023962,27.497610450755715,16.55766156145909,NaN,NaN,0.12963475684767298,-21.36052102387005
2001-10-15T09:30:00-04:00,28.19,28.19,27.42,27.78999,81400,466400,54.48361922702337,46.231693690259895,NaN,NaN,83.32321242251652,91.48468396588508,0.38678566665253483,0.06328181082602313,-0.3235038558265117,-33549502,-33139142,26.589881624630493,17.69619570867176,NaN,NaN,1.6042803205399203,-18.079835117525768
2001-10-16T09:30:00-04:00,27.64999,28.23,27.64999,28.12,102400,441610,57.2069474100401,49.43716378435598,NaN,NaN,89.24751450199614,99.59780321252822,0.3536341012444035,0.11853877072899266,-0.23509533051541082,-33447102,-33241542,25.77523116506306,18.91035605654313,NaN,NaN,3.664690284487667,-14.973474345809564
2001-10-17T09:30:00-04:00,28.35001,28.59,27.78999,27.98,228400,440890,55.684807407913716,51.46628492746408,NaN,NaN,84.93978528820594,96.34869626791713,0.30752610467734837,0.14931230033127463,-0.15821380434607374,-33675502,-33441862,24.212434755946404,20.07640072602452,NaN,NaN,4.910086983640998,-12.132965584459484
2001-10-18T09:30:00-04:00,27.5,27.59,26.82001,26.85001,3142700,548870,45.225157256567215,51.98590506779834,NaN,NaN,29.903276599754193,79.13018687368552,0.19183456223601464,0.08157939844894457,-0.11025516378707007,-36818202,-34191682,19.456974666260194,20.932106131464003,NaN,NaN,2.65083388970102,-10.020994231007984
2001-10-19T09:30:00-04:00,26.64999,27.14,26.27,26.95,369000,508945,46.18837221386135,52.737215730031274,NaN,NaN,10.393024607195354,59.56136268393361,0.11665136349494136,0.03555904058160664,-0.08109232291333472,-36449202,-34787902,16.655724972565707,21.582254365236867,NaN,NaN,1.1563940919428548,-8.424224470586436
2001-10-22T09:30:00-04:00,27,27.28999,26.67,27.28,1430300,498720,49.35379031917316,53.29438751646633,NaN,NaN,21.542827566248892,47.205285712680094,0.08521206612166135,0.025422759738741973,-0.05978930638291938,-35018902,-35081782,15.473213909633287,21.91453460804561,NaN,NaN,0.866050397985436,-7.0970423465047405
2001-10-23T09:30:00-04:00,26.89999,27.75,26.89999,27.17999,2317700,572100,48.4241160206461,53.53656164876252,NaN,NaN,27.81332316757559,34.91844744579598,0.05520224943125103,0.009213505406144407,-0.04598874402510662,-37336602,-35859682,12.868759399485555,21.69306812457244,NaN,NaN,0.3568356279677404,-6.032202635865815
2001-10-24T09:30:00-04:00,26.85001,26.88,26.42,26.8,197800,557230,44.95883258542711,53.14073134430665,NaN,NaN,-26.353821628420754,12.659726062470636,0.009668081110610294,-0.033903642636843756,-0.04357172374745405,-37534402,-36631462,10.907190461757835,21.20382390611965,NaN,NaN,-1.1091352620805761,-5.328907296753638
2001-10-25T09:30:00-04:00,26.64999,27.48,26.64999,27.48,44300,504725,51.62963198724501,53.103305948775564,NaN,NaN,6.5537074161941105,7.989812225758615,0.024414576247405548,-0.013053503438197112,-0.03746807968560266,-37490102,-36765842,10.604103908234151,20.630245870417276,NaN,NaN,-0.37391705658561414,-4.6210515481582055
2001-10-26T09:30:00-04:00,27.55,28.02,27.53999,28.00999,269100,500755,56.09584388735248,53.35444027296484,NaN,NaN,65.06912561590507,18.925032427500582,0.06654185425919085,0.0457092381383859,-0.020832616120804948,-37221002,-36920202,10.251704893926345,19.8577458418535,NaN,NaN,1.6668069151022042,-3.7227860534067183
2001-10-29T09:30:00-05:00,28,28.25,27.75,27.75,1094800,551750,53.48680678143942,53.38701792707011,NaN,NaN,62.31476284199222,27.079419482649246,0.07305615458913226,0.07048757711561038,-0.0025685774735218804,-38315802,-37579582,8.892268312028207,18.817992175701555,NaN,NaN,2.545594442033365,-2.8273031254867065
2001-10-30T09:30:00-05:00,27.25,27.33,26.82001,26.82001,76400,552535,45.359857181294345,52.172995159511366,NaN,NaN,-54.48552445119386,10.619649958895355,0.013983095546575688,0.01491029195969773,0.0009271964131220417,-38392202,-37790702,8.503458904932373,17.53003434632091,NaN,NaN,0.6465288073273474,-2.3310414207989845
2001-10-31T09:30:00-05:00,27,27.35001,26.62,26.86,324900,565095,45.741630386501534,50.994090828710284,NaN,NaN,-69.13954281419251,2.0625057217410045,-0.02123215509712887,-0.025612997458289044,-0.004380842361160176,-38067302,-37897282,8.306013131776098,16.14246932549963,NaN,NaN,-0.724114090419311,-2.101480373601888
2001-11-01T09:30:00-05:00,26.78999,27.28,26.45,27.27,328500,575660,49.6276332056458,50.24764613358078,NaN,NaN,-62.05364740396604,-11.658965242291025,-0.015986185844347415,-0.024363574666594445,-0.00837738882224703,-37738802,-37947022,8.21020094361721,14.76479721784688,NaN,NaN,-0.6897356471534859,-1.8998025555378306
2001-11-02T09:30:00-05:00,26.8,26.8,26.45,26.53,1114200,627840,43.56321869295994,49.46761752400482,NaN,NaN,-109.03793136071846,-46.480376637615734,-0.05900878784041455,-0.08213837362276522,-0.023129585782350668,-38853002,-38273422,7.591362970598723,13.407760171130324,NaN,NaN,-2.6280474330476147,-2.003837538039228
2001-11-05T09:30:00-05:00,26.85001,26.85001,26.32001,26.37,383800,629980,42.35797882323268,48.40697691066144,NaN,NaN,-109.4547266039105,-80.83427452679628,-0.0928811413115475,-0.13923101242178504,-0.04634987111023754,-39236802,-38457622,7.25884519828692,12.08516117350346,NaN,NaN,-4.560555929535294,-2.369083022538666
2001-11-06T09:30:00-05:00,26.2,26.35001,22.97,26.21001,230300,639570,41.13252640333775,47.36752826747744,NaN,NaN,-224.0570692585038,-114.74858348825826,-0.11903031845104686,-0.19513776917404613,-0.07610745072299926,-39467102,-38672602,6.880070377006248,10.847135146436306,NaN,NaN,-6.5067401265882205,-2.960176894545745
2001-11-07T09:30:00-05:00,26.2,26.56,25.92,26.32001,2067800,729900,42.367097894621686,47.16338117019561,NaN,NaN,-102.01612645175592,-121.32390021577093,-0.12146654998630987,-0.22794063820588661,-0.10647408821957674,-37399302,-38539002,10.022325302096135,10.173231620424586,NaN,NaN,-7.7565308904579755,-3.6453703225332066
2001-11-08T09:30:00-05:00,26.85001,26.95,26.63,26.83,152800,717780,47.829908039337674,47.280633729158204,NaN,NaN,-38.43448979914917,-116.60006869480758,-0.08310898114216997,-0.21036031464728921,-0.12725133350511925,-37246502,-38440542,12.369219509195744,9.867052658755302,NaN,NaN,-7.259292253857532,-4.1616448841509674
2001-11-09T09:30:00-05:00,27.2,27.49001,27.13,27.35001,629900,729325,52.748039865140775,47.52308012529875,NaN,NaN,33.90728259566652,-88.01102590353057,-0.020364540498455985,-0.15270700912818924,-0.13234246862973326,-36616602,-37993262,22.285830741051,10.35366814671371,NaN,NaN,-5.329695605423848,-4.3285092729042365
2001-11-12T09:30:00-05:00,27,27.28,26.55,27.28,89400,729725,52.036790112964496,47.78112827475007,NaN,NaN,0.43818063970114196,-66.03244445480824,0.01676866857961809,-0.11138163290521064,-0.12815030148482873,-36706002,-37487102,31.70454146413219,11.699081151331326,NaN,NaN,-3.966194079190348,-4.276749959516538
2001-11-13T09:30:00-05:00,27.3,27.53,27,27.5,70100,728110,54.12990344155691,48.43620476447362,NaN,NaN,53.91588340865218,-10.437853921377048,0.05437221120087858,-0.0601850374837305,-0.11455724868460908,-36635902,-36920862,40.40598493873662,13.806137899686954,NaN,NaN,-2.215939768458092,-3.9823485036510458
2001-11-14T09:30:00-05:00,26.7,26.89999,26.00999,26.16,4191602,926270.1,42.08337595358338,47.7543293334978,NaN,NaN,-90.30501306942023,-8.095631244909908,-0.009380170889229572,-0.12628246229614604,-0.11690229140691646,-40827504,-37606502.4,34.64927704272658,15.52365026643641,NaN,NaN,-4.467004639186029,-4.051585094441758
2001-11-15T09:30:00-05:00,25.7,25.72,24,24.84,4745199,1006395.05,34.04554706086495,46.17930813160583,NaN,NaN,-251.57191517580216,-50.72311632024051,-0.1320207451996591,-0.28192822290649033,-0.14990747770683124,-45572703,-39271742.6,25.242733847479442,16.594438048833062,NaN,NaN,-9.52554506817177,-4.833579376403188
2001-11-16T09:30:00-05:00,24.86,25.35001,24.32001,25.3,4478898,1211889.95,38.45694105349642,45.10574629389561,NaN,NaN,-183.90466855925075,-94.28550655122396,-0.17124593240181835,-0.3639648932091042,-0.19271896080728584,-41093805,-40167183.2,21.813440582690447,17.517378925308936,NaN,NaN,-11.962228927409154,-5.851957883689755
2001-11-19T09:30:00-05:00,25.25,25.35001,24.75999,25.24001,1058400,1193294.95,38.099049393234885,44.58711716617707,NaN,NaN,-141.7519469055553,-122.72353206027523,-0.18892596474853857,-0.42887641674295907,-0.2399504519944205,-42152205,-41256423.8,18.51786759089586,18.232693831449186,NaN,NaN,-13.943407598101201,-7.007879271462818
2001-11-20T09:30:00-05:00,25.89999,26.35001,25.77,26.17,2052900,1180054.95,46.4231632301937,44.635798083583666,NaN,NaN,-43.17306088379437,-142.14132091876456,-0.12856628360472971,-0.40065830650033263,-0.2720920228956029,-40099305,-41949104.4,16.781537112518734,18.838088401502233,NaN,NaN,-12.805564928806618,-7.83612007965479
2001-11-21T09:30:00-05:00,26.17999,26.87,25.57001,25.83,547400,1197534.95,44.0888721873669,44.24017229656374,NaN,NaN,-39.8537342410703,-132.05106515309458,-0.10321174245592568,-0.40110670096551004,-0.29789495850958436,-40646705,-41912944.6,17.21790772141854,19.481496028488042,NaN,NaN,-12.669120475623732,-8.526548707650353
2001-11-23T09:30:00-05:00,25.5,26.14999,25.3,26.07001,50500,1197844.95,46.14742426094879,44.424758408562944,NaN,NaN,-56.10791111819108,-92.95826434157235,-0.06387674820761308,-0.3777408937691007,-0.3138641455614876,-40596205,-40917645,28.354164729407984,20.96455329697442,NaN,NaN,-11.902864375218575,-9.008879517302956
2001-11-26T09:30:00-05:00,25.64999,25.75,25.32001,25.64,307700,1199774.95,43.08659120615107,44.47680215019998,NaN,NaN,-72.71183869569653,-70.71969836886151,-0.06045460528041907,-0.38943240216201147,-0.3289777968815924,-40903905,-40879665,28.748064138214247,22.499497506969224,NaN,NaN,-12.224849891101911,-9.468303856417092
2001-11-27T09:30:00-05:00,25.5,25.98,25.25999,25.66,414900,1165779.95,43.27504395161897,44.62983911793435,NaN,NaN,-59.277968573329524,-54.224902702416365,-0.05086496103208976,-0.3925589981717046,-0.3416940371396148,-40489005,-40547025,32.2607472695242,24.312402999291937,NaN,NaN,-12.425039950063535,-9.890694726938014
2001-11-28T09:30:00-05:00,25.35001,25.53999,25.06,25.06,719100,1197914.95,39.092963329737614,44.39597236329977,NaN,NaN,-90.0773696635788,-63.60576445837326,-0.07736337146949918,-0.4383982514764888,-0.36103488000698963,-41208105,-40768785,31.157928111196057,25.822088914227642,NaN,NaN,-13.872179301671729,-10.459478237614258
2001-11-29T09:30:00-05:00,25.25,25.49001,25.10001,25.49001,802100,1221774.95,43.32054980980337,44.073875346904465,NaN,NaN,-68.82335102778099,-69.3996878157154,-0.059182826299039315,-0.43501341288078876,-0.37583058658174945,-40406005,-40720645,31.70372923530232,27.20312532323526,NaN,NaN,-13.81895777900129,-10.939403886383834
2001-11-30T09:30:00-05:00,25.42999,25.59,25.19,25.36,370300,1223864.95,42.36314390956778,43.33209706436354,NaN,NaN,-60.042054391662546,-70.18651647040967,-0.04955571000711784,-0.43777522409064673,-0.3882195140835289,-40776305,-40756665,31.502473873640866,27.861456975563105,NaN,NaN,-14.053889485929979,-11.384330400604712
2001-12-03T09:30:00-05:00,25.23,25.92999,25.07001,25.7,144400,1175374.95,45.740411538233786,42.88235573759705,NaN,NaN,-37.005855557614346,-63.04531984279324,-0.015686498914747937,-0.40782763772696384,-0.3921411388122159,-40631905,-40702265,32.20246237246718,27.897022754729893,NaN,NaN,-13.27340612724768,-11.654198361553707
2001-12-04T09:30:00-05:00,25.8,26.10001,25.53,26.06,496400,1181004.95,49.138704961882816,42.52584156047748,NaN,NaN,0.07243788061082893,-51.17523855200517,0.03291381351987066,-0.35099887191237755,-0.3839126854322482,-40135505,-40631565,33.15848354281495,27.379344083592628,NaN,NaN,-11.613504275779459,-11.648384920728814
2001-12-05T09:30:00-05:00,26.60001,26.73,26.39,26.60001,1065400,1222759.95,53.81174907689706,43.363582497857024,NaN,NaN,65.34912787839134,-20.08993904361114,0.09961238662595084,-0.25939720214980966,-0.3590095887757605,-39070105,-40203965,38.781142890870356,27.67447735846004,NaN,NaN,-8.749765965469066,-11.23429649854885
2001-12-06T09:30:00-05:00,26.39999,26.89999,25.8,25.81,873600,1163049.95,47.00729623141473,44.28942172432487,NaN,NaN,22.676234442924876,-1.7900219494699663,0.08905234347353819,-0.24769415943383777,-0.33674650290737596,-39943705,-40111505,39.957276703883785,28.725516133917495,NaN,NaN,-8.304793382818248,-10.81579605344448
2001-12-07T09:30:00-05:00,25.8,27,25.50999,25.98,337900,1172304.95,48.51595080293252,45.00792242071316,NaN,NaN,26.970032026378313,15.61239533413821,0.09168429844749681,-0.22214112984800494,-0.31382542829550175,-39605805,-39877405,42.94602691081156,30.234986585926144,NaN,NaN,-7.486941392186863,-10.340245387550535
2001-12-10T09:30:00-05:00,25.75,25.85001,25.50999,25.62,111900,1146404.95,45.55809144922248,45.54071113899799,NaN,NaN,-24.224792464797513,18.168607952701578,0.06841444196140573,-0.2283073758437446,-0.29672181780515033,-39717705,-39694565,45.23877770642786,32.14362302274986,NaN,NaN,-7.6827232529625675,-9.960599368323683
2001-12-11T09:30:00-05:00,25.60001,25.62,25.11,25.2,1213300,1202599.95,42.31666702916006,45.247389981781296,NaN,NaN,-63.83378442338909,5.387363491901584,0.02614468600114095,-0.26404096030372415,-0.2901856463048651,-40931005,-39853665,43.597011433002294,34.05901404564154,NaN,NaN,-8.82883758793772,-9.798919113982832
2001-12-12T09:30:00-05:00,25.2,25.25999,24.94,25.25999,303700,1214279.95,42.941131576332396,45.16540850956455,NaN,NaN,-82.84810551426834,-24.252083186630355,0.004754263022495486,-0.28424281752674574,-0.2889970805492412,-40627305,-40165105,40.498664379374965,35.72192523549557,NaN,NaN,-9.5814323993545,-9.767849583321642
2001-12-13T09:30:00-05:00,24.91,25.25,24.7,24.85001,59100,1007654.85,39.77224942842817,44.710038878670225,NaN,NaN,-109.95164182695864,-50.777658440607055,-0.032431300616129755,-0.3295362063194034,-0.29710490570327364,-40686405,-40313645,39.07240916398323,36.487514123679524,NaN,NaN,-11.158719580305831,-9.966545297176525
2001-12-14T09:30:00-05:00,24.89999,26.25,24.8,25.10001,260700,783429.9,42.556054890790115,44.67214342757302,NaN,NaN,-40.26814188569897,-64.22529322302252,-0.035375324464878344,-0.34132406128437154,-0.3059487368194932,-40425705,-40477625,37.50224188999649,37.112812534521105,NaN,NaN,-11.700611665171392,-10.214269064032935
2001-12-17T09:30:00-05:00,25.10001,25.44,24.96001,25.03999,55300,562250,42.05349822951065,44.58489016170813,NaN,NaN,-86.2733131520715,-76.6349973604773,-0.0364072085638768,-0.3514577475243392,-0.3150505389604624,-40481005,-40630285,36.049803586994415,37.38345941434041,NaN,NaN,-12.286478758408457,-10.510299020372296
2001-12-18T09:30:00-05:00,25.10001,25.41,25.10001,25.37,134400,516050,45.84065162562237,45.066867897128475,NaN,NaN,-62.15290376745676,-76.29882122929084,-0.011212724630914939,-0.32906644474910607,-0.31785372011819113,-40346605,-40513405,38.02873371893371,37.87423124346453,NaN,NaN,-11.7499486393685,-10.687391823086038
2001-12-19T09:30:00-05:00,25.38,25.95,25.21001,25.95,230300,424920,51.802681244256654,45.672734428160844,NaN,NaN,20.349073674164902,-55.65938539160419,0.04507853606093082,-0.2615055500420276,-0.3065840861029584,-40116305,-40411205,39.783422200036675,38.45135216951699,NaN,NaN,-9.516240069550209,-10.520084429723777
2001-12-20T09:30:00-05:00,25.95,26.16,25.81,25.83,88700,401985,50.56249438493083,46.25840231925821,NaN,NaN,70.09014789843292,-19.65102744652588,0.07313466530370921,-0.21516575447332187,-0.2883004197770311,-40205005,-40314925,41.464917880145535,39.16295531283875,NaN,NaN,-8.01030590401157,-10.161544640336318
2001-12-21T09:30:00-05:00,26.10001,26.19,25.89999,25.89999,131800,406050,51.29489516767612,46.65515114993267,NaN,NaN,79.44544883496464,4.291690697606841,0.09398084175701105,-0.17082436758076724,-0.2648052093377783,-40073205,-40244425,42.72608964684115,39.91464297529403,NaN,NaN,-6.556691261191849,-9.646565586172823
2001-12-24T09:30:00-05:00,26.12,26.39999,26,26.33,325700,406950,55.64283272508143,47.11973170444685,NaN,NaN,111.97107664284124,43.940568656589384,0.13197660244441503,-0.09983445628225951,-0.23181105872667454,-39747505,-40097725,45.36401478727609,40.786466635612676,NaN,NaN,-4.023450211565772,-8.843263389800388
2001-12-26T09:30:00-05:00,26.35001,26.95,26.35001,26.78999,341200,403265,59.77915634756378,47.54597508092304,NaN,NaN,160.91064954902015,88.55327931988477,0.18034204191500358,-0.006383506332920064,-0.18672554824792365,-39406305,-39909665,48.63036758430511,41.48998268514374,NaN,NaN,-0.55284266293135,-7.658917571676239
2001-12-27T09:30:00-05:00,26.73,26.89999,26.55,26.88,193400,376980,60.5542916570798,48.51361761132769,NaN,NaN,148.0340826075813,114.09028110656804,0.2086493036434569,0.07408608130639749,-0.13456322233705942,-39212905,-39728985,51.622793662550585,42.32323389647708,NaN,NaN,2.5398358838585584,-6.201952792314126
2001-12-28T09:30:00-05:00,26.95,27.22,26.87,27,408200,357285,61.616348591577626,49.44936031051663,NaN,NaN,158.0573137947131,131.6837142858241,0.22433891248875176,0.1458604182738803,-0.07847849421487146,-38804705,-39448925,55.91007531801913,43.24923735413476,NaN,NaN,5.43894463612701,-4.538967445393964
2001-12-31T09:30:00-05:00,27.05,27.05,26.7,26.7,121000,344820,57.451724555317234,50.298905532380545,NaN,NaN,115.17526982254618,138.8296784833404,0.2039828131658433,0.17650002224243266,-0.027482790923410633,-38925705,-39219425,59.10818877180858,44.23990957309053,NaN,NaN,6.837108605250046,-2.913813723873391
2002-01-02T09:30:00-05:00,26.7,26.7,26.10001,26.5,289900,352095,54.79285402973125,51.19006174670705,NaN,NaN,59.4623276868916,128.32792869215046,0.16801791093696702,0.18253959774779815,0.01452168681083113,-39215605,-39113045,60.537100752636,45.44991595306436,NaN,NaN,7.305891161378289,-1.4538558831231514
2002-01-03T09:30:00-05:00,26.56,26.7,26.21001,26.34,309500,342750,52.69191814528251,51.886546501632054,NaN,NaN,52.3888002172949,106.62355882580542,0.12632481279056226,0.17242770279903397,0.046102890008471696,-39525105,-39136805,60.03252442649365,46.84519167071569,NaN,NaN,7.133389058071801,-0.22710660580958675
2002-01-04T09:30:00-05:00,26.60001,26.60001,26.25,26.46001,580300,318495,54.11313198888296,52.91089525595026,NaN,NaN,56.337466210487506,88.28423554638665,0.10080867776041343,0.17211373720898848,0.07130505944857506,-38944805,-39083185,60.82606208175221,48.399024021984914,NaN,NaN,7.362548208647116,0.8571297962556563
2002-01-07T09:30:00-05:00,26.64999,28,26.3,26.45,332100,291420,53.96749968757225,53.72599845572041,NaN,NaN,104.46710331860787,77.56619345116562,0.0782422117556831,0.16910782414317893,0.09086561238749583,-39276905,-39177625,58.618517394800406,49.90732941518519,NaN,NaN,7.517299774728488,1.8085826503232036
2002-01-08T09:30:00-05:00,26.55,26.55,26.2,26.22,266000,287825,50.59798971748627,54.3363192762901,NaN,NaN,33.765178751217015,61.284175236899785,0.04448993489817529,0.14647803101021495,0.10198809611203966,-39542905,-39301065,55.769462110035356,51.315876452545254,NaN,NaN,6.770640242087891,2.517448020575302
2002-01-09T09:30:00-05:00,26.2,26.42999,26.00999,26.25,449800,304720,51.02749143122929,54.706807833833444,NaN,NaN,20.127662907268036,53.417242280975074,0.021987149660749578,0.12947203318797662,0.10748488352722704,-39093105,-39276565,56.22423508106731,52.61555512126908,NaN,NaN,6.244698989708412,3.0499124447371746
2002-01-10T09:30:00-05:00,26.03,26.17,25.96001,26.05,42200,246165,48.029555995870844,54.43729888752017,NaN,NaN,-4.581574459104986,42.0231673456951,-0.007013214821525948,0.09871836500031961,0.10573157982184556,-39135305,-39198605,57.714138234104524,53.896320552273934,NaN,NaN,4.997639067692603,3.3281591051593784
2002-01-11T09:30:00-05:00,26.09,26.09,25.52,25.55,140900,238025,41.469969475114674,53.787832822533304,NaN,NaN,-54.47274004647324,19.86112609430294,-0.05769520367854808,0.03361257522366046,0.09130777890220854,-39276205,-39264885,55.97002316238708,54.93239950100547,NaN,NaN,1.9434497722385047,3.1303434861706823
2002-01-14T09:30:00-05:00,25.2,25.53999,25.2,25.24001,308700,250505,38.004476588815315,52.83851720975753,NaN,NaN,-115.12071346555143,-24.056437262528924,-0.10705248770517492,-0.04250783072926012,0.0645446569759148,-39584905,-39326485,54.32682426760992,55.76102340248895,NaN,NaN,-1.7773811072162915,2.429239972829686
2002-01-15T09:30:00-05:00,25.64999,25.82001,25.57001,25.64999,122900,243615,44.598527206045596,52.049638244112124,NaN,NaN,-69.86033460684604,-44.781539934141534,-0.1068012843274144,-0.0689569484333532,0.03784433589406119,-39462005,-39310305,54.70299639259073,56.42809351715429,NaN,NaN,-3.1410551684172083,1.6334835240801298
2002-01-16T09:30:00-05:00,25.5,25.5,25.10001,25.12,216500,251675,38.8463546711103,50.55443812436544,NaN,NaN,-136.24381699901448,-76.05583591539803,-0.13521287834487372,-0.13117176203703096,0.0040411163078427625,-39678505,-39427385,51.40379045692516,56.62619515091286,NaN,NaN,-6.218443789975104,0.5117796220722393
2002-01-17T09:30:00-05:00,25.25999,25.25999,25.03999,25.11,114200,250665,38.74481354619765,48.99661825930243,NaN,NaN,-147.5192087328865,-104.64336277015434,-0.14660765126362518,-0.17921844777168872,-0.03261079650806353,-39792705,-39558865,47.90933044073336,56.360947777925915,NaN,NaN,-8.691513188906901,-0.8029764937819237
2002-01-18T09:30:00-05:00,25.05,25.10001,24.88,24.89999,185500,248425,36.58216587304373,47.208462350835724,NaN,NaN,-154.0369684124348,-124.55620844334665,-0.15916930001020227,-0.23157242152081636,-0.0724031215106141,-39978205,-39699265,44.43551126448554,55.54133605981637,NaN,NaN,-11.432761577039,-2.321517219961506
2002-01-22T09:30:00-05:00,25.13,25.14,23.2,24.72,168000,252390,34.78983709651371,45.58975610377833,NaN,NaN,-190.41685222807655,-139.6154361958517,-0.1695252362359159,-0.28430966680550895,-0.11478443056959306,-40146205,-39811525,41.824207239547746,54.306765950369176,NaN,NaN,-14.276323142580804,-4.0293466374785485
2002-01-23T09:30:00-05:00,24.87,25.45,24.87,25.42,300300,260815,45.89277413755681,44.95403611148016,NaN,NaN,-79.26765377519173,-141.49690002952082,-0.121410511008261,-0.2665475693299193,-0.1451370583216583,-39845905,-39888305,40.08896598366449,52.84618489544264,NaN,NaN,-13.366715586055452,-5.363256487275249
2002-01-24T09:30:00-05:00,25.45,25.87,25.3,25.77,132700,251165,50.43675997268036,44.79295338486572,NaN,NaN,-33.7076901428757,-120.98967465829305,-0.06122922457160801,-0.2216735890361683,-0.16044436446456029,-39713205,-39895245,39.9277148975165,51.41012707194427,NaN,NaN,-11.107190871725505,-6.183818542196715
2002-01-25T09:30:00-05:00,25.95,26.08,25.75999,26.05,470000,257605,53.78085262134507,44.7692191443273,NaN,NaN,3.017854129329454,-90.88226208584987,-0.0009673364962023145,-0.16165353508481317,-0.16068619858861086,-39243205,-39785345,43.783929414043754,50.19283188139366,NaN,NaN,-8.141903681334988,-6.4635449906450395
2002-01-28T09:30:00-05:00,26.14999,26.14999,25.50999,25.64999,99800,252925,48.72316919986341,44.39462410949096,NaN,NaN,-13.319053138395072,-62.73867903104192,0.012791598556799733,-0.14469670039261118,-0.1574882989494109,-39343005,-39658305,47.943863428597275,49.43035659809344,NaN,NaN,-7.250412654385315,-6.57595465689365
2002-01-29T09:30:00-05:00,25.27,25.47,24.78999,24.95,467700,255900,41.388087035121934,43.73677391789351,NaN,NaN,-86.78140273445311,-42.01158913231724,-0.022491059976382344,-0.18560212391988884,-0.1631110639435065,-39810705,-39591205,50.046473904471945,49.021571726267474,NaN,NaN,-9.005521061898222,-6.923035571894303
2002-01-30T09:30:00-05:00,24.58,25.28999,24.39999,25.14999,577700,278735,43.98281517105,43.23358275645213,NaN,NaN,-93.42608723196953,-44.84327582367279,-0.029176581255911133,-0.19958179051339542,-0.17040520925748429,-39233005,-39468625,53.723754635796105,48.84296598017668,NaN,NaN,-9.535149907378218,-7.296194762677719
2002-01-31T09:30:00-05:00,25.45,25.75,25.31,25.75,390300,283755,50.99256938442688,43.445226569920415,NaN,NaN,-6.541913829219378,-39.41012056094153,0.008007336360145278,-0.1603960388073027,-0.16840337516744797,-38842705,-39294525,58.40697875777292,48.89245458901013,NaN,NaN,-7.563779448416954,-7.334421146354752
2002-02-01T09:30:00-05:00,25.77,25.95,25.59,25.89,258600,281210,52.48657449708422,44.232126928632525,NaN,NaN,26.58384060607293,-34.696923265592844,0.0413635121067025,-0.11669898503406984,-0.15806249714077233,-38584105,-39162705,61.57756068539458,49.292992983510665,NaN,NaN,-5.519330886672022,-7.075122537828648
2002-02-04T09:30:00-05:00,25.60001,25.75,25.14,25.2,635700,283980,45.1766931646374,44.744428112619815,NaN,NaN,-30.562557559126777,-38.145624149739184,0.01750901077430747,-0.136176233672888,-0.15368524444719547,-39219805,-39138065,62.15823679075799,49.85237959230695,NaN,NaN,-6.232369075226583,-6.954729186028353
2002-02-05T09:30:00-05:00,25.10001,25.22,24.85001,25.03,277300,281240,43.56678135160645,44.67073198015988,NaN,NaN,-72.29662429957554,-35.24866846276367,-0.007808263610713129,-0.1634455739605869,-0.15563731034987377,-39497105,-39075345,63.66359884008638,50.49242262427093,NaN,NaN,-7.326438101266532,-7.007830459633807
2002-02-06T09:30:00-05:00,25.22,25.39,25.17999,25.2,758300,305855,45.65248232858794,45.156883955694,NaN,NaN,-29.613256838183204,-22.486102384006397,-0.010999400138200999,-0.16938656052262502,-0.15838716038442402,-38738805,-38976505,65.96159932449743,51.53226611481186,NaN,NaN,-7.551208484747166,-7.085455891792858
2002-02-07T09:30:00-05:00,25.10001,25.16,24.83,24.91,718500,319290,42.749890362183216,45.442960871121535,NaN,NaN,-76.71900170687181,-36.52151995953689,-0.02948607295949532,-0.19524475158379317,-0.16575867862429786,-39457305,-39099425,60.810922576570945,52.453808410228824,NaN,NaN,-8.64496923132465,-7.308243511725971
2002-02-08T09:30:00-05:00,25,25.19,24.85001,25.19,302900,332325,46.29999102013461,46.137091238770886,NaN,NaN,-49.74599989782202,-51.78748806031588,-0.02014731656813537,-0.19094282433446708,-0.1707955077663317,-39154405,-39213485,56.40923864023482,53.309074651353775,NaN,NaN,-8.467361853473063,-7.47383184626127
2002-02-11T09:30:00-05:00,25.2,25.64999,25,25.52,235900,337075,50.21809910362431,47.2391099535645,NaN,NaN,22.33319158304182,-41.20833823188216,0.009379129744700898,-0.15907159558545558,-0.16845072533015648,-38918505,-39153225,58.133428564225014,54.47401903168787,NaN,NaN,-7.1044389568478525,-7.421061433487925
2002-02-12T09:30:00-05:00,25.49001,25.64,25.34,25.39999,75500,325415,48.822969908336866,47.44840965147737,NaN,NaN,35.867423381562446,-19.57552869565455,0.021271040065434205,-0.14186192524836372,-0.16313296531379792,-38994005,-39052605,60.91350803834589,55.961486321307966,NaN,NaN,-6.403491378467642,-7.275694282770742
2002-02-13T09:30:00-05:00,25.2,25.61,25.17999,25.55,159800,327260,50.66786439496695,47.46491711021212,NaN,NaN,37.08408936908293,-6.236059454201325,0.03867013585563803,-0.11479529549425038,-0.1534654313498884,-38834205,-39071685,60.098554996356434,57.402260614082245,NaN,NaN,-5.284802407146065,-6.991281157681502
2002-02-14T09:30:00-05:00,25.52,25.92999,25.52,25.75999,786400,355755,53.21063227092538,47.42418708518214,NaN,NaN,92.20399827237964,27.548540541648965,0.06234858586823469,-0.07552969901459505,-0.13787828488282974,-38047805,-38789785,67.1017093134017,59.06781632117924,NaN,NaN,-3.60120333263634,-6.506984325532193
2002-02-15T09:30:00-05:00,25.7,26,25.67,25.78,555700,377830,53.45681977910167,47.76230498369915,NaN,NaN,98.01436575711189,57.100613672635745,0.07645536516857787,-0.042309078422107405,-0.11876444359068528,-37492105,-38457325,73.09840613495969,60.8645693716337,NaN,NaN,-2.150393816790228,-5.88461425285477
2002-02-19T09:30:00-05:00,25.7,25.86,25.39999,25.55,731400,405125,50.18804820047804,48.39087363836745,NaN,NaN,48.63649033815142,62.361273423657664,0.06769399464568311,-0.03414695028358139,-0.1018409449292645,-38223505,-38318325,75.13883004664694,62.65688052464619,NaN,NaN,-1.7798024169115387,-5.298212562005737
2002-02-20T09:30:00-05:00,25.5,25.55,25.14999,25.47,422200,417835,49.06423704438386,48.75383234360559,NaN,NaN,-10.380309351511421,53.1117268770429,0.05447695762931894,-0.033744747892615834,-0.08822170552193477,-38645705,-38248665,76.11650313193445,64.25636256008464,NaN,NaN,-1.7681847607909922,-4.793922876117916
2002-02-21T09:30:00-05:00,25.5,26.09,25.5,25.77,1211600,463400,53.28833812681143,48.91781582520448,NaN,NaN,83.66165757132678,62.42724051749167,0.06328660234068748,-0.009113452596075433,-0.07240005493676291,-37434105,-37968645,79.59094642098509,65.76950310745694,NaN,NaN,-0.5928086844854812,-4.193763705884711
2002-02-22T09:30:00-05:00,25.97,26.62,25.94,26.48,1548400,534185,61.438824542300466,49.55726225700564,NaN,NaN,189.32203738304682,81.8508483396251,0.111461327495188,0.06692660443222209,-0.04453472306296591,-35885705,-37536225,83.56665609205032,67.34015277936092,NaN,NaN,3.0781641740982626,-3.1549168658871434
2002-02-25T09:30:00-05:00,26.67999,26.89,26.47,26.86,796900,550530,64.96253943953575,50.97053699092695,NaN,NaN,234.5492001380729,109.1578152158173,0.1604700517740521,0.1560528416545992,-0.004417210119452883,-35088805,-37055565,86.67411126425225,69.0912866703248,NaN,NaN,7.3658760607155385,-1.6519464478010462
2002-02-26T09:30:00-05:00,26.85001,26.89999,26.55,26.72,608800,575980,62.68966436681475,52.33645720629897,NaN,NaN,192.67944211571802,137.96640557133065,0.17388146334410826,0.21293461906068245,0.03905315571657419,-35697605,-36550385,89.02341434773707,70.90270206372841,NaN,NaN,10.179164111278096,0.038212203495974206
2002-02-27T09:30:00-05:00,26.95,27,26.56,26.7,1209300,613060,62.35403206033759,53.52942504428108,NaN,NaN,164.7785764512267,172.99818273187825,0.17153992921757794,0.2534780672385466,0.08193813802096866,-36906905,-36202625,90.292183436442,72.64060092886731,NaN,NaN,12.35232365351795,1.7973709820705421
2002-02-28T09:30:00-05:00,26.89999,26.97,26.63,26.63,413800,604865,61.120619719295796,54.84161999836056,NaN,NaN,140.52749601803825,184.37135042122054,0.1558656436132831,0.2767701925375725,0.12090454892428944,-37320705,-36179945,90.37035944656839,74.75198927672427,NaN,NaN,13.815865107364136,3.5142987142553412
2002-03-01T09:30:00-05:00,26.98,27.11,26.72,27.00999,448700,607785,65.15055793657058,56.188089063820264,NaN,NaN,140.8163389385963,174.67021073233045,0.1610183808440873,0.32217752497939856,0.16115914413531127,-36872005,-36377205,84.03199405764863,76.72504323511097,NaN,NaN,16.305914693644407,5.341672425596636
2002-03-04T09:30:00-05:00,27.35001,27.60001,27.2,27.60001,680800,628895,70.29853066538769,57.62240560394622,NaN,NaN,162.8587049069398,160.33211168610381,0.19199160797232936,0.401148654100723,0.20915704612839361,-36191205,-36597685,77.48997732813031,78.1076538611042,NaN,NaN,20.23913555594465,7.469881444217781
2002-03-05T09:30:00-05:00,27.33,27.73,27.33,27.61,691400,631680,70.37831792754781,59.16207331960415,NaN,NaN,143.40970622506734,150.47816450797367,0.200071202940739,0.4592460498043174,0.2591748468635784,-35499805,-36558125,77.82358050318629,79.31551618002138,NaN,NaN,23.393697974141777,9.744712377064065
2002-03-06T09:30:00-05:00,27.8,28.33,27.534,28.14,345300,635080,74.31971769633775,60.8514914125592,NaN,NaN,156.65373504064792,148.85319622585791,0.22610778769565754,0.5418095814831503,0.31570179378749275,-35154505,-36207645,80.57084124669939,80.77782234076017,NaN,NaN,27.5065880017699,12.28212318059347
2002-03-07T09:30:00-05:00,28.45,28.55,28.17,28.35001,326700,613500,75.69948255743934,62.45783786159591,NaN,NaN,160.46443087853123,152.8405831979565,0.24109822533771463,0.6170745754596361,0.37597635012192143,-34827805,-35709065,83.67004264432933,81.9612747215407,NaN,NaN,31.34810840870317,15.005835356037712
2002-03-08T09:30:00-05:00,28.64999,28.64999,28.06,28.22,189100,587030,73.08168937925505,63.85961426160686,NaN,NaN,138.87820928121516,152.45295726648027,0.2261305347811592,0.6586395185983704,0.43250898381721126,-35016905,-35338045,85.52094372740942,82.84859883528712,NaN,NaN,33.72223113876133,17.679606182141086
2002-03-11T09:30:00-05:00,28.57001,28.73,28.5,28.52,420900,592930,75.21186519534098,65.64702976123992,NaN,NaN,143.51061833025375,148.58333995114307,0.22009713731497405,0.7076304054609288,0.48753326814595477,-34596005,-35019005,86.89632690403172,83.68842003938603,NaN,NaN,36.41122959234288,20.355552383598486
2002-03-12T09:30:00-05:00,28.55,28.86,28.5,28.77,250700,593670,76.85554791980388,67.63212339519849,NaN,NaN,134.62325387251363,146.82604948063232,0.21628733324881,0.7578924347069673,0.5416051014581573,-34345305,-34788105,87.79960373002207,84.52292722496371,NaN,NaN,39.19090772972917,23.046317433045726
2002-03-13T09:30:00-05:00,28.97,29.10001,28.58,28.58,617100,620750,72.89919392500485,69.03289880935517,NaN,NaN,119.69234775319579,139.4337720231419,0.185498216009494,0.7734778714700248,0.5879796554605308,-34962405,-34749685,87.94846722652429,85.11989299678794,NaN,NaN,40.34526817193977,25.51759611003059
2002-03-14T09:30:00-05:00,28.7,28.7,28.3,28.57001,118400,618680,72.68732115029523,69.83636285278337,NaN,NaN,92.24927452255118,125.79074075194589,0.1504780340587859,0.7760771980340131,0.6255991639752272,-35080805,-34800285,86.45233883231454,85.3260131925211,NaN,NaN,41.22143520939972,27.76100169565475
2002-03-15T09:30:00-05:00,28.60001,28.85001,28.5,28.67999,1567900,657755,73.59710229459917,70.45311734243076,NaN,NaN,92.0791733096513,116.43093355763313,0.12195495377229992,0.7780428561906021,0.6560879024183022,-33512905,-34499485,87.78286097005507,85.40520960007845,NaN,NaN,42.20928987830017,29.825042864604093
2002-03-18T09:30:00-05:00,28.74001,28.98,28.62,28.89999,88600,634400,75.36485459944366,71.35848807333282,NaN,NaN,93.53932331376163,106.4366745543347,0.10574261730456058,0.7882661740490029,0.6825235567444423,-33424305,-34265145,88.71288467482911,85.38302890915645,NaN,NaN,43.56022412939609,31.787211616717236
2002-03-19T09:30:00-05:00,29.06,29.25,28.95,29.25,376700,616665,77.90000877147506,72.4689149812712,NaN,NaN,105.07990591653683,100.52800496313935,0.10615221968949418,0.81521383135631,0.7090616116668158,-33047605,-34005605,89.65240559996184,85.337330492265,NaN,NaN,45.50650657267554,33.74711089613985
2002-03-20T09:30:00-05:00,29,29.21001,28.83,28.94,251000,608105,70.93713072978923,73.1700943391636,NaN,NaN,87.43364290562013,94.07626399362422,0.07459642061560545,0.8023071374363226,0.7277107168207172,-33298605,-33672845,90.71906711379393,85.36223818278111,NaN,NaN,45.123520524990745,35.37231227168998
2002-03-21T09:30:00-05:00,28.96001,29.10001,28.64999,29.10001,355500,565300,72.31275895531053,73.68168012621643,NaN,NaN,79.17475256732509,91.461359602579,0.05448445415005054,0.7958162845082803,0.7413318303582298,-32943105,-33245305,91.87758495601955,85.92263753266475,NaN,NaN,45.19845440941427,36.77604686279345
2002-03-22T09:30:00-05:00,28.75,28.75,28.39999,28.42,191000,497430,59.437012415959906,72.90585739411446,NaN,NaN,40.29914164895451,81.10535327043965,-0.011132732277098212,0.7274159150118571,0.7385486472889553,-33134105,-33169545,92.06656683317316,86.96382249731066,NaN,NaN,41.009142321674766,37.38077478549078
2002-03-25T09:30:00-05:00,28.25,28.50999,28.16,28.16,90600,462115,55.37698012160718,71.8343332651187,NaN,NaN,13.245466845804355,65.04658197684819,-0.0750025169249573,0.6447955011327586,0.7197980180577159,-33224705,-33129625,92.16994646058023,87.98856292283881,NaN,NaN,36.20106310910758,37.21224454600746
2002-03-26T09:30:00-05:00,28.2,28.55,28.2,28.39,134000,438375,58.10338661284242,70.67602390201189,NaN,NaN,17.646491330935067,47.55989905972784,-0.10298730316112581,0.5910638891063087,0.6940511922674345,-33090705,-33138245,91.8914943424879,88.79718100110941,NaN,NaN,33.07729318472858,36.62153720868191
2002-03-27T09:30:00-05:00,28.63,29.05,28.63,29.05,344300,395125,64.75761526529871,69.89446195257327,NaN,NaN,76.66284281049754,45.40573904070332,-0.07933673452593315,0.5948802741100181,0.6742170086359512,-32746405,-33027805,92.21596095289568,89.4076037374356,NaN,NaN,32.504621735842605,36.03340642684772
2002-03-28T09:30:00-05:00,29,29.14999,28.83,28.89,693500,409110,62.17936076639646,69.11572419451194,NaN,NaN,80.61809650867391,45.69440782897308,-0.0767115875533293,0.5783275241942896,0.6550391117476189,-33439905,-33127165,88.77416093705668,89.63997639526754,NaN,NaN,31.19870235428095,35.342734416481036
2002-04-01T09:30:00-05:00,29.05,29.25,28.95,29.09,516400,412495,64.10326975975013,68.32225309196973,NaN,NaN,102.32773574426906,58.10012664803598,-0.06425318189133067,0.5747226343834555,0.6389758162747862,-32923505,-33085045,88.96223211982982,89.78754105353882,NaN,NaN,30.744830796588257,34.68589104221064
2002-04-02T09:30:00-05:00,29.27,29.52,29.24001,29.45,494300,403170,67.3252651881561,67.64151861113774,NaN,NaN,152.11331794536244,85.8736968679476,-0.03592729818659801,0.5940666935415386,0.6299939917281366,-32429205,-32925945,89.66646888821026,89.920888564838,NaN,NaN,31.395917930374896,34.21589488337696
2002-04-03T09:30:00-05:00,29.3,29.3,28.69,28.81,615500,399375,57.452455216103054,66.53818013193047,NaN,NaN,51.37529313911306,92.6194572295832,-0.06287665451666968,0.5513981735822995,0.6142748280989692,-33044705,-32916745,89.70736352961,90.04652401505838,NaN,NaN,28.580313173252907,33.41081178193067
2002-04-04T09:30:00-05:00,28.85001,28.92999,28.14999,28.28999,656800,414950,50.9187859029238,64.98328475711824,NaN,NaN,-72.58527191106096,62.76983428527151,-0.11525794055491922,0.4702024024053202,0.5854603429602394,-33701505,-33107765,82.41451710783824,89.75810817759579,NaN,NaN,23.88907785696259,32.0505640783638
2002-04-05T09:30:00-05:00,28.39999,28.39999,27.91,27.97,354100,416320,47.350325208184564,63.108514965231485,NaN,NaN,-154.79385657842494,15.687443667851738,-0.16780604858818737,0.3757027822250052,0.5435088308131926,-34055605,-33230905,78.01167060250383,89.060166008485,NaN,NaN,18.860175748820353,30.166222888429022
2002-04-08T09:30:00-04:00,28.5,28.64,28.19,28.39999,241000,418915,52.1982239801122,61.45375563527923,NaN,NaN,-79.96701595835613,-20.7715066726733,-0.16945962332293973,0.3316843016595179,0.5011439249824576,-33814605,-33409125,72.01519665454217,87.86747400703594,NaN,NaN,16.332907503247938,28.190034976260296
2002-04-09T09:30:00-04:00,28.17999,28.94,27.84,27.99001,576400,426690,47.689348533598775,59.29585133257378,NaN,NaN,-107.55839037872965,-72.70584833749172,-0.19234549777435744,0.2607120527645108,0.45305755053886826,-34391005,-33801485,60.91407209266703,85.814735899372,NaN,NaN,12.69914140228307,25.977050179977837
2002-04-10T09:30:00-04:00,27.89999,28.35001,27.89999,28.31,225300,425420,51.230307909100034,57.88822113109599,NaN,NaN,-107.90696323359599,-104.56229961203353,-0.18031627664041933,0.2276622047383441,0.4079784813787634,-34165705,-34025685,55.63645540973113,83.30883506336752,NaN,NaN,10.919746834327889,23.826006844884986
2002-04-11T09:30:00-04:00,28.22,28.34,27.96001,28.02,607300,424930,48.055481230574784,56.15555843647201,NaN,NaN,-109.44922077091584,-111.9350893840045,-0.18555070114401595,0.17604010494874345,0.3615908060927594,-34773005,-34239985,51.08081655671816,80.39478017770314,NaN,NaN,8.427048310529344,21.626155625691325
2002-04-12T09:30:00-04:00,27.60001,27.60001,27.03,27.10001,747900,456405,39.658883763855904,54.742834961321726,NaN,NaN,-225.59443647940313,-126.09520536420014,-0.24111282954640612,0.06019976915975178,0.3013125987061579,-35520905,-34533045,45.583886138935696,77.07458869954333,NaN,NaN,3.152611932644641,18.987077955256083
2002-04-15T09:30:00-04:00,27.62,27.88,27.62,27.63,297500,392885,45.5601667516886,54.041634006327534,NaN,NaN,-128.17630217858598,-135.7370626082461,-0.2322228480670078,0.011034038622398157,0.24325688668940595,-35223405,-34814805,41.01403188019922,73.42059480094467,NaN,NaN,0.9149971371065775,16.40535212409187
2002-04-16T09:30:00-04:00,28.05,28.25,27.98,28.14999,104400,393675,50.65881101238711,53.50987860629501,NaN,NaN,-58.55979794802784,-125.93734412210577,-0.18351045407129682,0.013868819100284924,0.19737927317158174,-35119005,-34960405,38.846764118061536,69.63168549919993,NaN,NaN,0.8941664074962351,14.189468450292493
2002-04-17T09:30:00-04:00,28.25,28.61,28.25,28.5,685500,409115,53.79564125804364,52.72688046291966,NaN,NaN,-3.350022867078349,-105.02595604880223,-0.12282119663591454,0.04385277737668858,0.16667397401260312,-34433505,-35013965,38.05023559320405,65.76270511636481,NaN,NaN,1.9625758254554613,12.442769503887202
2002-04-18T09:30:00-04:00,28.77,28.77,28.5,28.64,121600,402645,55.02722337593638,52.216013506458225,NaN,NaN,32.060776209897064,-76.72395665263964,-0.07092891761299411,0.07801282699636047,0.14894174460935458,-34311905,-34921745,40.319314106093046,62.301644628438844,NaN,NaN,3.2039152545195875,11.122933182548971
2002-04-19T09:30:00-04:00,28.42,28.8,28.33,28.77,118100,390775,56.19485421614306,51.65112668191487,NaN,NaN,35.798094512805726,-24.445450454197868,-0.02774720853501139,0.11425773394059036,0.14200494247560175,-34193805,-34656325,46.40396589146131,59.26176846926967,NaN,NaN,4.5616654140795045,10.185609215624762
2002-04-22T09:30:00-04:00,28.7,28.82001,28.35001,28.49001,498300,406140,53.00302002333291,50.62810917014178,NaN,NaN,20.64917932198385,5.319645845916105,-0.018390134978665318,0.11901727375227011,0.13740740873093543,-34692105,-34550065,48.66066179104409,56.33278224804351,NaN,NaN,4.730989436503218,9.406377818607398
2002-04-23T09:30:00-04:00,28.12,28.58,28.02,28.42,333900,418305,52.20455768750183,50.25325934667027,NaN,NaN,-19.374846506426813,13.156636134236322,-0.01728185304685509,0.11580509242236658,0.13308694546922167,-35026005,-34531465,49.064944331534946,53.429752305323866,NaN,NaN,4.637780970384049,8.725149697432634
2002-04-24T09:30:00-04:00,28.08,28.28999,27.91,27.91,335100,428360,46.687026284722016,49.950990802513,NaN,NaN,-69.2075025845502,-0.014859809258058475,-0.049441596934151774,0.07128494930153195,0.12072654623568373,-35361105,-34716985,45.23841883069172,50.77431671409911,NaN,NaN,2.894760221568626,7.892236915166348
2002-04-25T09:30:00-04:00,27.92999,28.27,27.71001,28.11,667900,444540,48.96500153933622,50.06632482616669,NaN,NaN,-63.604498340158116,-19.147914719269096,-0.05534399926911536,0.05154654714928952,0.10689054641840488,-34693205,-34793245,43.72871833127707,48.32553440901148,NaN,NaN,2.1136538882267315,7.066725054174974
2002-04-26T09:30:00-04:00,28.07001,28.2,27.67999,27.8,635200,441625,45.70515145083696,49.60253393121845,NaN,NaN,-80.49223371377694,-42.40598036458563,-0.07690026330238825,0.010765217290419571,0.08766548059280782,-35328405,-35020165,39.50411114530602,46.00331401549461,NaN,NaN,0.48385111658880026,6.126314491662663
2002-04-29T09:30:00-04:00,27.8,27.89,27.53999,27.62,102300,420920,43.8784861208575,49.33032947316551,NaN,NaN,-110.15554280614295,-68.56692479021099,-0.0986664820501177,-0.0356676219698393,0.0629988600802784,-35430705,-35167885,36.998277166941165,44.29504294937134,NaN,NaN,-1.4077865365874414,5.050014344769791
2002-04-30T09:30:00-04:00,27.77,28,27.77,27.85001,60200,399215,46.80418864929948,49.01417809746547,NaN,NaN,-68.05864027853929,-78.30368354463349,-0.09303251397899213,-0.05329178239346177,0.03974073158553036,-35370505,-35236785,35.8558344339703,42.882141451102704,NaN,NaN,-2.1827727504741405,4.01675904544923
2002-05-01T09:30:00-04:00,27.64999,28.08,27.57001,28.02,278400,382360,48.9234460908333,49.07617558748393,NaN,NaN,-58.328558225702864,-76.12789467286402,-0.07413827782005339,-0.052932115689536374,0.021206162130517014,-35092105,-35182985,37.47923232361473,41.910599720166736,NaN,NaN,-2.2410871724288763,3.122781014323786
2002-05-02T09:30:00-04:00,28.11,28.24001,27.92999,28.23,327500,365895,51.494312716236486,49.921563369796836,NaN,NaN,4.85690952074246,-62.435613100683895,-0.045200908737327475,-0.035294973791142326,0.009905934946185146,-34764605,-35197265,37.21004252432153,41.312468033408585,NaN,NaN,-1.5700142262142498,2.452381694246924
2002-05-03T09:30:00-04:00,28.46001,28.5,28.14,28.33,50700,350725,52.71484196620715,50.4326115994053,NaN,NaN,49.32084102803505,-36.47299815232152,-0.018402564215562443,-0.013097270323267907,0.005305293892294535,-34713905,-35074365,41.129060346204916,41.320684352408996,NaN,NaN,-0.671645728867318,2.006092062373461
2002-05-06T09:30:00-04:00,28.16,28.22,27.31,27.36,303300,353840,41.74267868822285,49.795745004822145,NaN,NaN,-109.08237694514236,-36.25836498012141,-0.06259268946941117,-0.07293556794446943,-0.010342878475058256,-35017205,-34991665,43.676562232078936,41.66566993198167,NaN,NaN,-3.225402334947684,1.2587357198990117
2002-05-07T09:30:00-04:00,27.3,27.37,27.09,27.23,227200,336380,40.525255917927744,48.84786033767101,NaN,NaN,-171.18201252151937,-56.88303942871742,-0.09521099390955166,-0.12935662086199784,-0.034145626952446176,-35244405,-34966445,44.46578291126523,42.12392331184318,NaN,NaN,-5.668445666518115,0.2691383789822793
2002-05-08T09:30:00-04:00,27.5,27.87,27.37,27.8,213000,335765,47.72433374810057,48.326225364254164,NaN,NaN,-67.559890012637,-58.72930578610425,-0.0739770300424495,-0.12661691450550805,-0.05263988446305855,-35031405,-34954305,44.866266745397226,42.448705643222056,NaN,NaN,-5.554131919113396,-0.5627573778885314
2002-05-09T09:30:00-04:00,27.67,27.89,27.55,27.55,198800,315340,45.143335173681464,47.53683114693547,NaN,NaN,-63.97518463810692,-72.49572461787412,-0.07226450288055439,-0.14297051306375153,-0.07070601018319714,-35230205,-35047425,42.3438127139195,42.158694701969075,NaN,NaN,-6.261726686158953,-1.3768958504985918
2002-05-10T09:30:00-04:00,27.67,27.78,27.48,27.53,125300,284210,44.93397340201105,46.96047067398391,NaN,NaN,-85.02162595155434,-99.364218013792,-0.06803463945831874,-0.15574930950609556,-0.08771467004777682,-35355505,-35175745,39.08299008663153,41.474575294511034,NaN,NaN,-6.888539624542305,-2.1642735325048363
2002-05-13T09:30:00-04:00,27.37,28.09,27.31,28.06,122900,275480,51.3702714374341,46.90087879897907,NaN,NaN,-40.4510495584376,-85.63795253645105,-0.02719391506208281,-0.12170706387538033,-0.09451314881329752,-35232605,-35218825,38.0243103779618,40.68595858354153,NaN,NaN,-5.460728191337673,-2.635195626623813
2002-05-14T09:30:00-04:00,28.3,28.3,28.00999,28.14,202400,280380,52.27700337438679,47.30016287681227,NaN,NaN,28.961809062517098,-45.60918821964376,0.005796881178704,-0.08726704733991753,-0.09306392851862152,-35030205,-35175985,39.771489300672364,40.29546361711157,NaN,NaN,-4.033294833201841,-2.834924084706388
2002-05-15T09:30:00-04:00,28.09,28.09,27.55,27.67,384000,265305,46.760671791220325,47.142710751946844,NaN,NaN,-45.812735502277285,-41.25975731757181,-0.0029748648881191275,-0.09678250962877044,-0.09380764474065131,-35414205,-35252545,37.72467399754394,39.86660330755921,NaN,NaN,-4.442301692439489,-3.0645494572396883
2002-05-16T09:30:00-04:00,27.99001,28.07001,27.78,27.99001,169900,267720,50.584131241512516,47.49120930842367,NaN,NaN,0.7137121806097557,-28.321977953828473,0.012960638936409391,-0.07760684607013957,-0.09056748500654896,-35244305,-35255365,37.64781787377707,39.73401093102142,NaN,NaN,-3.6179623593943577,-3.143608443261784
2002-05-17T09:30:00-04:00,27.82001,27.82001,27.46001,27.75999,511200,287375,47.920163592205824,47.77990055637713,NaN,NaN,-61.47996355717401,-23.61364547495241,0.008415633343781953,-0.08004794332682152,-0.08846357667060348,-35755505,-35335365,35.44187035380196,39.62283901579719,NaN,NaN,-3.7274579538759753,-3.2270155162066687
2002-05-20T09:30:00-04:00,27.64999,27.72,27.50999,27.57001,55300,265225,45.77589840313288,47.706451253079514,NaN,NaN,-77.71694910041577,-31.066825383348043,-0.006191823746125785,-0.09620335635326072,-0.09001153260713493,-35810805,-35451005,32.47932416232116,39.3816597106794,NaN,NaN,-4.450772609278141,-3.401837958074022
2002-05-21T09:30:00-04:00,27.57001,27.92999,27.5,27.59,679800,282520,46.04945402306053,47.50116610538146,NaN,NaN,-48.61575620056576,-46.582338435964616,-0.01292657616352881,-0.10616975281154595,-0.09324317664801714,-35131005,-35471165,31.97749025562345,38.98867813439431,NaN,NaN,-4.963112715770016,-3.62487720917345
2002-05-22T09:30:00-04:00,27.50999,28.06,27.50999,28.05,718600,301695,52.0448546468144,47.54049052899417,NaN,NaN,23.731540374520655,-32.67348326060503,0.013736049576795625,-0.0760731146770226,-0.08980916425381823,-34412405,-35270805,41.63014572460711,39.30439979155757,NaN,NaN,-3.659142552964427,-3.6297722582864465
2002-05-23T09:30:00-04:00,28.17999,28.33,27.92,28.28999,240700,280335,54.86307123780959,47.69393547696577,NaN,NaN,125.70817508612383,-7.674590679502214,0.045861974580415577,-0.03248169602829876,-0.07834367060871433,-34171705,-35056285,49.83768830977427,39.92644464609824,NaN,NaN,-1.7166716677199667,-3.3564721739198067
2002-05-24T09:30:00-04:00,28.24001,28.24001,27.89,27.98,173900,257270,50.71704259184249,48.33496147008146,NaN,NaN,71.25190205946524,18.871782443825634,0.04452512818288076,-0.022687260380113372,-0.06721238856299414,-34345605,-34774305,58.16491508274819,40.96132699257462,NaN,NaN,-1.257582636174556,-3.056630811384771
2002-05-28T09:30:00-04:00,28.08,28.08,27.73,27.75999,186200,261465,47.94756316762339,48.865126273631155,NaN,NaN,8.955718008178165,36.206315865544425,0.027925376266581273,-0.03230566822976755,-0.06023104449634882,-34531805,-34518505,64.00283421698344,42.35683065726879,NaN,NaN,-1.6810756047207738,-2.860122924718486
2002-05-29T09:30:00-04:00,27.39,27.59,27.17999,27.5,110100,263960,44.83203567897863,48.65853355440815,NaN,NaN,-120.25109180263608,21.87924874513036,0.000014239507314842137,-0.06021324511220527,-0.060227484619520114,-34641905,-34420685,65.95911020962637,43.863462333285156,NaN,NaN,-2.961802143393183,-2.8746485273862996
2002-05-30T09:30:00-04:00,27.17999,27.36,26.78,26.97,252600,262670,39.235174389114654,48.23652206979624,NaN,NaN,-199.17967646388738,-22.70299462255125,-0.05075494608582341,-0.12367116722679938,-0.07291622114097597,-34894505,-34517105,62.36159073252918,45.2933036203287,NaN,NaN,-5.869176294127805,-3.302438208349372
2002-05-31T09:30:00-04:00,27.08,27.60001,27.08,27.36,328400,262715,44.70548008929756,48.220201118888134,NaN,NaN,-104.27320822770463,-68.69927128531694,-0.054361777752091445,-0.14086844333109028,-0.08650666557899883,-34566105,-34595985,59.50237374659752,46.75183102461199,NaN,NaN,-6.645887487607418,-3.7800738196719497
2002-06-03T09:30:00-04:00,27.25,27.25,26.5,26.5,71800,263770,36.831455745609524,47.1817142837578,NaN,NaN,-233.27274221151322,-129.60420013951264,-0.10786726187200144,-0.22134074291900063,-0.1134734810469992,-34637905,-34654445,57.40182752535486,48.13593939228292,NaN,NaN,-10.105979483223528,-4.683774628750746
2002-06-04T09:30:00-04:00,26.5,26.7,26.21001,26.5,149300,256070,36.831455745609524,46.07846088170229,NaN,NaN,-227.5880978696117,-176.9129633150706,-0.1347143665688203,-0.28186643925802457,-0.14715207268920427,-34637905,-34675665,56.62048264681514,49.3394389170074,NaN,NaN,-12.758302078720668,-5.837278550175021
2002-06-05T09:30:00-04:00,26.16,26.39999,26.07001,26.39999,245000,256960,35.97683527632017,45.3081868449237,NaN,NaN,-212.07048038598617,-195.27684103174062,-0.149520509178022,-0.3340527091617318,-0.1845321999837098,-34882905,-34723865,54.7959491280401,50.558815712042836,NaN,NaN,-15.152763899772903,-7.168062171546147
2002-06-06T09:30:00-04:00,26.7,26.75,26.00999,26.12,55700,249095,33.624526342458196,44.09678649499125,NaN,NaN,-167.3112874971554,-188.90316323839423,-0.1671485632099324,-0.3934679039961253,-0.2263193407861929,-34938605,-34732685,54.45018188726401,51.758984570149046,NaN,NaN,-17.8976209258532,-8.700856279304297
2002-06-07T09:30:00-04:00,26.11,26.45,26,26.39,168700,247590,37.84492905740103,43.37712688536234,NaN,NaN,-139.78563445705782,-196.00564848426487,-0.1501412026214448,-0.41399584406299894,-0.2638546414415541,-34769905,-34773445,52.79229015282835,52.998300270079504,NaN,NaN,-18.946901437573292,-10.164577016199868
2002-06-10T09:30:00-04:00,26.28,26.3,25.82001,25.89999,83500,245500,33.6617297939907,42.511829127566465,NaN,NaN,-142.99275020241978,-177.94965008244617,-0.1604764496006057,-0.46445020344231125,-0.30397375384170555,-34853405,-34816545,51.023190798557174,54.32286217266778,NaN,NaN,-21.185561752552154,-11.739003407107337
2002-06-11T09:30:00-04:00,26.05,26.11,25.5,25.50999,125300,245620,30.74853433913023,41.41890629300001,NaN,NaN,-145.7612402257717,-161.5842785536782,-0.1806595597159067,-0.5297982034865889,-0.3491386437706822,-34978705,-34884705,48.26844202824879,55.486501584998166,NaN,NaN,-24.023328221575245,-13.493906952031324
2002-06-12T09:30:00-04:00,25.64,25.91,25.50999,25.87,61800,238590,36.234506041766636,40.28959567835375,NaN,NaN,-122.06374959595537,-143.582932395672,-0.15768144195672618,-0.54624044621659,-0.3885590042598638,-34916905,-34891505,47.99006733134247,55.940781699764976,NaN,NaN,-24.676248266897083,-15.091384282726432
2002-06-13T09:30:00-04:00,25.82001,26.19,25.63,25.84,247400,231760,35.97872886868414,38.940714080559076,NaN,NaN,-98.12081805980088,-129.7448385082011,-0.13338539280386258,-0.555290745264692,-0.42190535246082944,-35164305,-34936645,46.08982553809362,55.6730772160735,NaN,NaN,-25.27164363791738,-16.54570704775371
2002-06-14T09:30:00-04:00,25.55,25.81,25.25,25.81,105500,228540,35.707284432562304,37.86858849775334,NaN,NaN,-107.9086673967168,-123.3694450961329,-0.10923291653863293,-0.5584464981341206,-0.4492135815954877,-35269805,-35036625,42.112385756165935,54.52646797846048,NaN,NaN,-25.831726070364315,-17.872281193840937
2002-06-17T09:30:00-04:00,26.06,26.50999,26.03,26.48,417400,223850,45.581833362344376,37.69960779737627,NaN,NaN,-42.09916501829306,-103.19072805930755,-0.04151521310909556,-0.5011075979818571,-0.45959238487276155,-34852405,-35036425,42.123145576386214,52.96363307556068,NaN,NaN,-23.275242015834557,-18.644132739840025
2002-06-18T09:30:00-04:00,26.48,26.57001,26.3,26.35001,265200,234345,44.16457389887858,37.651931955940555,NaN,NaN,-32.33515205346165,-80.50551042484554,-0.0010004145128067465,-0.46084290301376996,-0.4598424885009632,-35117605,-35064205,40.98363906505318,51.17967085094831,NaN,NaN,-21.603574835339607,-19.06691018205425
2002-06-19T09:30:00-04:00,26.25,26.50999,26.00999,26.09,53300,203020,41.39226535790659,37.80600988228283,NaN,NaN,-46.26240658423256,-65.34524182250098,0.012044985149366638,-0.4447862570642549,-0.45683124221362154,-35170905,-35115005,38.91072411656938,49.50460894980832,NaN,NaN,-21.001204007903507,-19.343237871461287
2002-06-20T09:30:00-04:00,26.25999,26.47,26.03,26.03999,614600,197820,40.86098007694221,37.53140273854316,NaN,NaN,-44.15308658662446,-54.5516955278657,0.020563492767639024,-0.43112687625407276,-0.4516903690217118,-35785505,-35239245,34.33657468708178,47.70705187412863,NaN,NaN,-20.65958563614493,-19.53128755213038
2002-06-21T09:30:00-04:00,25.8,26.03999,25.46001,25.72,262600,198915,37.54069669358265,37.58206280625553,NaN,NaN,-89.00065960917819,-50.77009397035799,0.008521716670671087,-0.44103822318337293,-0.449559939854044,-36048105,-35394905,29.635907230685362,45.72377185308081,NaN,NaN,-21.319397000760297,-19.78673175907751
2002-06-24T09:30:00-04:00,25.72,26.03999,25.61,25.95,257100,203075,41.23683060298673,37.896732438925326,NaN,NaN,-72.2680486273719,-56.803870692173746,0.019304057067992486,-0.4254298685190534,-0.4447339255870459,-35791005,-35582625,25.162184145129984,43.47675053153188,NaN,NaN,-20.811955579229867,-19.933192304813563
2002-06-25T09:30:00-04:00,26.3,26.38,25.8,25.84,439200,215725,40.017149640092896,38.18532632205195,NaN,NaN,-47.78049086418303,-59.89293845431803,0.02208487985784402,-0.41712782576474083,-0.43921270562258485,-36230205,-35805145,21.096728910049578,41.069663373103985,NaN,NaN,-20.729700143399015,-20.0469791388972
2002-06-26T09:30:00-04:00,25.7,25.86,25.45,25.85001,124800,216460,40.19051292211096,38.65432536345572,NaN,NaN,-91.72604813553593,-68.9856667645787,0.027313153027004322,-0.40507126433882945,-0.4323844173658338,-36105405,-35992045,18.40667423709843,38.495127112377865,NaN,NaN,-20.615190935192125,-20.128152252653617
2002-06-27T09:30:00-04:00,25.98,25.98,25.58,25.98,281800,217920,42.51406376149101,38.98783498517644,NaN,NaN,-60.41001042752798,-72.23705153275941,0.04139595706429483,-0.38063947103546525,-0.4220354280997601,-35823605,-35999665,18.304197091228872,36.03169189369219,NaN,NaN,-19.89696239842248,-20.0951251306206
2002-06-28T09:30:00-04:00,26.05,26.42,26.05,26.2,269400,214970,46.31534243448044,39.89166445949713,NaN,NaN,36.22203429603698,-47.19251275171637,0.06594024381113484,-0.3396101233358415,-0.40555036714697634,-35554205,-35900885,24.19592876879679,34.11545889156645,NaN,NaN,-18.228995121079706,-19.828535129257613
2002-07-01T09:30:00-04:00,26.25999,26.35001,25.95,25.95,60400,214400,42.847970956922566,40.75590993219659,NaN,NaN,10.573207820420194,-30.62426146215795,0.06561034003065103,-0.32353744210866253,-0.38914778213931356,-35614605,-35865605,26.241889230701986,32.542133691741675,NaN,NaN,-17.700353848300825,-19.524509231978072
2002-07-02T09:30:00-04:00,26.10001,26.16,25.36,25.44,71500,210510,36.79607037975396,40.796021670624256,NaN,NaN,-104.61761023593893,-41.99168533650913,0.03296493779297327,-0.34794160989809697,-0.38090654769107024,-35686105,-35756785,32.31051996472111,31.42216602269729,NaN,NaN,-19.019403821098972,-19.452351316138202
2002-07-03T09:30:00-04:00,25.45,25.75999,25.2,25.60001,73500,201935,39.674933179322295,41.06003626424126,NaN,NaN,-127.04026496333002,-49.05452870206794,0.02445947227995582,-0.35033220734112547,-0.3747916796210813,-35612605,-35658225,37.33919481924616,30.79712097135104,NaN,NaN,-19.277565275742063,-19.427381881795895
2002-07-05T09:30:00-04:00,25.8,26.22,25.8,26.2,35400,200920,49.046869498587775,42.01286376895737,NaN,NaN,34.797839564777156,-30.012958703606916,0.05955306963600576,-0.30035034257607407,-0.35990341221207983,-35577205,-35608945,39.7493702559355,30.628334149906006,NaN,NaN,-16.500116432655386,-19.00920110334725
2002-07-08T09:30:00-04:00,26.13,26.24001,25.82001,25.88,64800,195725,45.02884165413414,41.973364361228064,NaN,NaN,12.292654792793483,-34.79883460425562,0.061286704553688176,-0.2832950315199696,-0.3445817360736578,-35642005,-35626505,39.17119696772717,30.417480677858936,NaN,NaN,-15.441194937567854,-18.49948593680734
2002-07-09T09:30:00-04:00,25.81,25.98,25.33,25.56,163900,199745,41.378287115064744,41.77434387666994,NaN,NaN,-90.78462885828785,-55.070401939997225,0.04188039650108871,-0.29223124044729687,-0.3341116369483856,-35805905,-35664765,37.878416668562416,30.1956790781096,NaN,NaN,-15.72594063068798,-18.103265178790288
2002-07-10T09:30:00-04:00,25.42999,25.42999,24.38,24.47,167600,201860,31.893434974681426,41.09585599215386,NaN,NaN,-282.2787467281166,-90.60262923843275,-0.038993762555767864,-0.3828538401430954,-0.34386007758732756,-35973505,-35722245,35.958359206205046,29.98479587022643,NaN,NaN,-19.557107528986,-18.31095694310396
2002-07-11T09:30:00-04:00,24.3,24.42,23.78999,24,605400,229040,28.82521396570779,40.236158412779965,NaN,NaN,-317.4636552148044,-128.68730728872765,-0.11449939649651697,-0.4869843232079738,-0.37248492671145683,-36578905,-35915505,30.382022498092724,29.702327856727216,NaN,NaN,-23.7963717141965,-19.094587624688607
2002-07-12T09:30:00-04:00,24.03,24.07001,23.31,23.57001,489500,241145,26.32961376031558,39.43536677468946,NaN,NaN,-278.8594029619597,-191.41875579407503,-0.17986770078698067,-0.5973195526951827,-0.417451851908202,-37068405,-36213745,24.156318494219335,29.31092866126536,NaN,NaN,-28.119891373581897,-20.383916731673363
2002-07-15T09:30:00-04:00,23.14999,23.32001,22.06,23.05,179300,244835,23.661619105493656,38.179994524868526,NaN,NaN,-264.35672869535057,-246.74863249170386,-0.24079031994172234,-0.7184397518353549,-0.47764943189363257,-37247705,-36534885,19.518347491754497,28.907797471738537,NaN,NaN,-32.640710311120024,-22.134887243022884
2002-07-16T09:30:00-04:00,22.63,23.06,22.35001,22.7,280300,237980,22.04262658386422,36.896100020852195,NaN,NaN,-201.26441626115923,-268.84458997227813,-0.28433435454302214,-0.8330673750724102,-0.5487330205293881,-37528005,-36879305,15.975647381497552,28.54200593398482,NaN,NaN,-36.81771223041535,-24.232433669793238
2002-07-17T09:30:00-04:00,23.58,23.58,22.75999,22.95,274300,238435,25.9405859113934,35.878248091515225,NaN,NaN,-138.85323248911732,-240.15948712447826,-0.2757645249789208,-0.8934386767530391,-0.6176741517741183,-37253705,-37135345,13.948754019276834,28.22358306128328,NaN,NaN,-38.81614426282337,-26.315820897368972
2002-07-18T09:30:00-04:00,23,23.41,22.72,22.8,104100,240975,25.128716198324653,34.636437551289056,NaN,NaN,-122.85823983751223,-201.23840404901983,-0.2598785219892018,-0.9425223042606206,-0.6826437822714188,-37357805,-37291125,12.87818275391355,27.8360106086179,NaN,NaN,-40.661965732992726,-28.365270159600936
2002-07-19T09:30:00-04:00,22.45,22.64,21.39999,21.39999,631600,241825,19.115395043508357,32.69358416621962,NaN,NaN,-158.51430848076242,-177.16938515278036,-0.319420055990316,-1.0819188522593137,-0.7624987962689977,-37989405,-37475325,11.73161294323782,26.945702335363688,NaN,NaN,-44.72119744980152,-30.701831201058162
2002-07-22T09:30:00-04:00,21.45,21.62,20,20.09,5282699,492829.95,15.401506769812698,30.73312243856892,NaN,NaN,-180.25315464871395,-160.34867034345302,-0.4166439542865096,-1.2833037391271347,-0.8666597848406251,-43272104,-38680204.8,7.209829916929266,25.586269527237068,NaN,NaN,-49.80546220467368,-33.43092134443181
2002-07-23T09:30:00-04:00,20.2,20.59,19.63,19.8,1043100,532129.95,14.719703139769663,29.15623906428433,NaN,NaN,-170.40655619580102,-154.1770983303814,-0.4663467963229746,-1.4495932802443434,-0.9832464839213688,-44315204,-40037644.6,4.912526214145856,23.62926997362455,NaN,NaN,-53.845027525720155,-36.347222227473004
2002-07-24T09:30:00-04:00,19.39999,21.21001,19.38,21.11,2777700,649054.95,29.830932124436174,28.45309613179246,NaN,NaN,-128.89197516454928,-152.18484686546776,-0.3804876950327505,-1.458856102712307,-1.0783684076795566,-41537504,-40894404.4,4.03798334678514,21.2506120113059,NaN,NaN,-51.233483112620924,-38.47383092535128
2002-07-25T09:30:00-04:00,21,21.45,20.57001,21.02,345700,660099.95,29.44490560006379,27.052955853326463,NaN,NaN,-99.69655982827807,-147.55251086362094,-0.30263939082469915,-1.4566676462104304,-1.1540282553857313,-41883204,-41799484.2,3.357907404187884,18.65122180760964,NaN,NaN,-49.47100105951929,-40.04485523023242
2002-07-26T09:30:00-04:00,20.91,21.31,20.78999,21.3,112500,651634.95,32.37678655567464,26.149237632007925,NaN,NaN,-85.99794977801164,-133.04923912307078,-0.20959072377575394,-1.4160166601054236,-1.2064259363296697,-41770704,-42555744,2.9159841328795437,16.06156374797767,NaN,NaN,-47.084874007389445,-41.05057219839771
2002-07-29T09:30:00-04:00,21.8,22.53,21.63,22.53,179400,647134.95,43.48648004058416,26.2998228409736,NaN,NaN,-41.247554616600326,-105.24811911664806,-0.050788048378327844,-1.2699109968025795,-1.2191229484242516,-41591304,-42219584,8.669753981676621,13.975230698914402,NaN,NaN,-40.84778680533568,-41.02160285653171
2002-07-30T09:30:00-04:00,22.34,22.47,21.91,22.17999,142900,651259.95,41.40204625787438,26.97900936120167,NaN,NaN,-38.11885467394225,-78.7905788122763,0.040186476158861284,-1.168889853225675,-1.2090763293845364,-41734204,-41703384,16.821873464360323,12.608338860211207,NaN,NaN,-36.72613441665272,-40.40796450797757
2002-07-31T09:30:00-04:00,22.16,22.64,21.91,22.57001,144200,654894.95,44.58931355496284,28.105016474719886,NaN,NaN,-25.755289869564052,-58.16324175327925,0.13101398752891336,-1.0453088449733947,-1.176322832502308,-41590004,-41713884,16.78904595687979,11.637411964410282,NaN,NaN,-32.358947735969,-39.2581049691192
2002-08-01T09:30:00-04:00,22.17999,22.42,21.24001,21.24001,145500,658494.95,37.165522710073255,28.879009971131147,NaN,NaN,-53.17714712164378,-48.8593592119524,0.10692176016391963,-1.0426706322974084,-1.149592392461328,-41735504,-41684344,17.27813702193373,11.146113287818453,NaN,NaN,-31.13253561827376,-38.097309347569855
2002-08-02T09:30:00-04:00,21.45,21.50999,20.66,21,174900,665469.95,36.00067808128354,29.76037132654471,NaN,NaN,-74.34656964737171,-46.52908318582441,0.08137994035925145,-1.0478674670122636,-1.129247407371515,-41910404,-41712284,17.175308317580843,10.97875334680605,NaN,NaN,-30.58331042954997,-37.02388093070987
2002-08-05T09:30:00-04:00,20.95,21.2,20.12,20.22,128600,668659.95,32.44202494473636,30.503185495178432,NaN,NaN,-96.61886575629495,-57.603345413763336,0.021622106866237445,-1.1022197737887183,-1.1238418806549557,-42039004,-41801824,16.829633704621813,11.039752369886356,NaN,NaN,-31.345219717918955,-36.212643614596885
2002-08-06T09:30:00-04:00,20.60001,21.3,20.60001,20.95,59900,663459.95,38.56296552475225,31.40478403898978,NaN,NaN,-65.1644238683124,-63.012459252637385,0.03986633445396848,-1.0740089625874951,-1.1138752970414636,-41979104,-41850804,16.632434508820282,11.231443833425175,NaN,NaN,-29.88242877120333,-35.308327208397806
2002-08-07T09:30:00-04:00,21.2,21.27,20.60001,21.25,142900,662224.95,40.93150445508417,32.53355462875832,NaN,NaN,-53.47672735850085,-68.55674675042474,0.07851189133681946,-1.0157354328704393,-1.0942473242072588,-41836204,-41900044,16.42408351925603,11.484722459521066,NaN,NaN,-27.94754378919268,-34.25678671993993
2002-08-08T09:30:00-04:00,21.27,22.14999,21.27,22.14999,116300,637769.95,47.473762749617336,34.559152322051816,NaN,NaN,11.437617580962547,-55.63379380990348,0.16602975786415142,-0.8867101268770696,-1.052739884741221,-41719904,-41896924,16.495462616818514,11.824997436205399,NaN,NaN,-24.08904874546806,-32.804252723586806
2002-08-09T09:30:00-04:00,21.83,22.64999,21.64,22.55,152600,620924.95,50.1181911841815,37.03891549450673,NaN,NaN,53.81845091821486,-30.00078969678616,0.2473060391247881,-0.743607335835236,-0.9909133749600241,-41567304,-41828304,18.15116850002019,12.606521620711893,NaN,NaN,-20.11199363012077,-30.99107285309166
2002-08-12T09:30:00-04:00,22.10001,22.71001,21.99001,22.5,164300,620174.95,49.78082507158564,39.543281346779295,NaN,NaN,67.27098071152243,2.7771795967773185,0.291127331310876,-0.6270042108214291,-0.9181315421323051,-41731604,-41766824,19.687635921365256,13.661886599798992,NaN,NaN,-17.07854194835844,-29.00356843812977
2002-08-13T09:30:00-04:00,22.39999,22.72,22.16,22.16,104700,611394.95,47.44218007165751,40.80122762872368,NaN,NaN,65.57021870244111,28.924108110928024,0.29000471683692486,-0.5556256460861491,-0.8456303629230739,-41836304,-41738264,20.43484614758141,14.833091085570155,NaN,NaN,-15.242108263395057,-27.03764555602481
2002-08-14T09:30:00-04:00,22.50999,23.05,22.2,23.03,167800,606069.95,53.46631482425242,42.51704257330858,NaN,NaN,105.56909482883877,60.73327254839595,0.3373293754901562,-0.42396864356037867,-0.7612980190505348,-41668504,-41704724,21.360167355447203,16.11896679637439,NaN,NaN,-11.735721279563077,-24.851656373673134
2002-08-15T09:30:00-04:00,23.25999,23.7,23.14999,23.67999,239900,612859.95,57.395354358169435,44.304083130629635,NaN,NaN,165.2298706421099,91.49172316062541,0.3977296434549824,-0.2641359647318069,-0.6618656081867893,-41428604,-41646464,23.03456061720692,17.556007973826347,NaN,NaN,-7.503769265395829,-22.373386786776376
2002-08-16T09:30:00-04:00,23.5,23.5,23.16,23.3,179200,590239.95,54.49832889238128,45.09064376290086,NaN,NaN,129.73132858945175,106.6742986948728,0.3965217444774558,-0.1662134275899696,-0.5627351720674254,-41607804,-41654564,22.961360508449175,18.57683701145296,NaN,NaN,-4.8872987403139545,-19.875374208710316
2002-08-19T09:30:00-04:00,23.39999,23.64,23.02,23.49001,684800,360345,55.70238004498538,46.11209617626593,NaN,NaN,121.43490127844363,117.50708280825704,0.3922346751816564,-0.07244182809035493,-0.4646765032720113,-40923004,-41492844,27.888551640092217,19.367314024005235,NaN,NaN,-2.3953610227014592,-17.37822946785191
2002-08-20T09:30:00-04:00,23.35001,23.35001,22.55,22.89999,307500,323565,51.17400913574449,46.582431574893185,NaN,NaN,79.86010791499918,120.36506065076864,0.33556870236699143,-0.045215625313272056,-0.3807843276802635,-41230504,-41371684,31.42708761450153,20.412888428121075,NaN,NaN,-1.586615474045883,-15.122284611593905
2002-08-21T09:30:00-04:00,22.92,23.05,22.5,22.95,115400,190450,51.53366177621596,47.608727222474805,NaN,NaN,66.24026816388084,112.49929531777707,0.28912356192766986,-0.019379875270676195,-0.30850343719834605,-41115104,-41261004,34.58493920258401,21.64908858388181,NaN,NaN,-0.829247264231177,-13.08042213339923
2002-08-22T09:30:00-04:00,23.17999,23.75999,22.95,23.60001,194400,182885,56.06371578069646,49.04180134386145,NaN,NaN,112.12060749979925,101.87744268931493,0.28915099942884914,0.0529353120877154,-0.23621568734113374,-40920704,-41159424,37.432742451306616,23.09604816486222,NaN,NaN,1.1614412657705802,-11.045870219232114
2002-08-23T09:30:00-04:00,23.38,23.55,23.17999,23.22,645400,209530,52.947901296154065,50.50650679753414,NaN,NaN,93.56908699408835,94.64499437024224,0.25191260643814023,0.07867507070654156,-0.17323753573159867,-41566104,-41151084,37.672655231217135,24.584835416761887,NaN,NaN,1.9485380562903485,-9.189526179871763
2002-08-26T09:30:00-04:00,23.39999,23.7,23.11,23.53,87100,204915,55.13826931236587,51.690457068077976,NaN,NaN,94.26910910027306,89.21183593460813,0.2367294773723932,0.12267431098389281,-0.11405516638850037,-41479004,-41262284,35.706675224155845,25.947281182143,NaN,NaN,3.2381479038454746,-7.414144167912157
2002-08-27T09:30:00-04:00,23.86,23.99001,23.34,23.52,830300,239285,55.049244218502615,52.698867051179285,NaN,NaN,96.55110089771074,92.55003453115044,0.2152048783818689,0.15495093158883577,-0.060253946793033135,-42309304,-41478044,32.19589095836599,27.07383885636514,NaN,NaN,4.2697605289470415,-5.745014925503701
2002-08-28T09:30:00-04:00,23.35001,23.35001,22.78,22.96001,158400,239995,50.164716000169115,52.89107799764728,NaN,NaN,44.07242596243357,88.116466090861,0.15524435157160243,0.1338014926714699,-0.021442858900132526,-42467704,-41748564,28.4225128145699,27.925771013347383,NaN,NaN,3.8151300223069673,-4.379279932959319
2002-08-29T09:30:00-04:00,22.72,22.95,22.38,22.75999,206700,243055,48.509053186051034,52.776139569209384,NaN,NaN,13.6207628918533,68.4164971692718,0.09695477089155613,0.09975060471431263,0.0027958338227565063,-42674404,-42099304,24.425433514451854,28.3739328000925,NaN,NaN,2.9715209446953788,-3.329165521865791
2002-08-30T09:30:00-04:00,22.72,23.34,22.60001,22.91,145500,241585,49.84598936525588,52.780794161614395,NaN,NaN,30.250158396969542,55.752711449848036,0.06488526034384491,0.08390240925256265,0.019017148908717738,-42528904,-42291864,22.550435986626468,28.57841851903973,NaN,NaN,2.6136110774280854,-2.4801974362523804
2002-09-03T09:30:00-04:00,22.39999,23.25999,21.85001,22,88900,239600,42.61712876931539,52.43614764001854,NaN,NaN,-40.31831191811887,28.835227246169655,-0.016864129933453577,-0.002063013508099232,0.014801116425354343,-42617804,-42519624,20.541834814808567,28.586060566698812,NaN,NaN,0.13451348440224883,-2.1066673047302906
2002-09-04T09:30:00-04:00,21.92999,22.19,21.3,21.95,624500,267830,42.254530104079485,51.635305874291895,NaN,NaN,-119.06685437276178,-14.288363807924847,-0.07054484059667437,-0.07337993432048862,-0.0028350937238142467,-43242304,-42706224,19.045112671809775,28.42069951786757,NaN,NaN,-1.995346782830372,-2.0907643730303023
2002-09-05T09:30:00-04:00,21.75,22.10001,21.62,21.99001,258300,273600,42.67484086945941,50.583840625098325,NaN,NaN,-124.26961400345735,-47.956771801103024,-0.09791360122064491,-0.1252270952496204,-0.027313494028975475,-42984004,-42809484,18.252555161851205,28.079127699627872,NaN,NaN,-3.6497869789654516,-2.313481888163895
2002-09-06T09:30:00-04:00,22.35001,22.57001,22.14999,22.35001,210500,278310,46.45158730953739,50.0090733691809,NaN,NaN,-69.47334645130435,-64.57559366973456,-0.08671164650247216,-0.13570305215706568,-0.04899140565459352,-42773504,-42829304,18.096884324170375,27.73166511503653,NaN,NaN,-4.089579745741935,-2.5672101535321867
2002-09-09T09:30:00-04:00,22.3,22.44,22.08,22.32001,103300,275845,46.17855356679862,49.328800049310416,NaN,NaN,-80.60473387085307,-86.74657212329907,-0.0766127951299978,-0.14475739956709077,-0.06814460443709297,-42876804,-42898884,17.531595383089268,26.99188252525061,NaN,NaN,-4.528608675472765,-2.8474099423808408
2002-09-10T09:30:00-04:00,22.39,22.8,22.39,22.8,114300,273345,51.128153836273356,49.32552467077677,NaN,NaN,-27.653348649731168,-84.21357946962154,-0.0350137596128047,-0.11191180395309885,-0.07689804434029415,-42762504,-42927824,17.289686078659443,25.982068129833316,NaN,NaN,-3.581755438827333,-2.952316441873197
2002-09-11T09:30:00-04:00,23.03999,23.10001,22.66,22.67999,70400,271630,49.89271339182139,49.208314071891444,NaN,NaN,-9.200976288501886,-62.24040385276955,-0.014062503964523534,-0.09447617429594857,-0.08041367033142503,-42832904,-42845944,20.62678511436296,24.98505712353181,NaN,NaN,-3.1074099265927355,-2.974472653975988
2002-09-12T09:30:00-04:00,22.64,22.67999,22.12,22.12,211400,273810,44.490447044837396,48.38165201933008,NaN,NaN,-81.1882235528935,-53.62412576265679,-0.03519762060090491,-0.12441069608255617,-0.08921307548165126,-43044304,-42858004,20.49561810886439,23.775262527643083,NaN,NaN,-4.194273970691662,-3.14872998493537
2002-09-13T09:30:00-04:00,21.98,22.48,21.88,22.36,129300,268280,47.13251030286385,47.966266948380785,NaN,NaN,-81.91623880964937,-56.11270423432579,-0.03047000692400051,-0.1273005841366519,-0.0968305772126514,-42915004,-42886304,20.171461973067693,22.52517729491812,NaN,NaN,-4.3904595545180936,-3.326119923447188
2002-09-16T09:30:00-04:00,22.27,22.59,22.23,22.52,97800,264210,48.87939753079575,47.51920467826863,NaN,NaN,-45.32321536285355,-49.0564005327259,-0.014815930048213688,-0.11535048977291851,-0.10053455972470482,-42817204,-42874384,20.7400809555879,21.456134847163266,NaN,NaN,-4.0790602969294305,-3.4336828339446512
2002-09-17T09:30:00-04:00,22.16,22.16,21.71001,21.78999,135500,236745,42.051984374982425,46.590828975160036,NaN,NaN,-118.14299197943049,-67.15432919866575,-0.049898560769925826,-0.1629077606871121,-0.11300919991718628,-42952704,-42912424,20.244494920087106,20.602463701571917,NaN,NaN,-5.821135419211242,-3.7747474889827357
2002-09-18T09:30:00-04:00,21.8,22.05,21.53999,21.85001,136300,228185,42.75990175691624,46.061913672070546,NaN,NaN,-113.30508284981573,-87.97515051092853,-0.06441128954734587,-0.19352331185136862,-0.12911202230402274,-42816404,-42909124,20.422142367353985,20.031008669627926,NaN,NaN,-7.046158077366963,-4.242091858751911
2002-09-19T09:30:00-04:00,21.60001,21.85001,21.23,21.23,60500,225440,37.64394853436052,45.285834768378365,NaN,NaN,-144.39300219526956,-100.61610623940373,-0.10852154063563119,-0.26476394809856174,-0.15624240746293055,-42876904,-42875644,22.312762052070838,19.88010356517214,NaN,NaN,-9.709938180363324,-5.023212761839256
2002-09-20T09:30:00-04:00,21.39999,21.5,21.10001,21.27,115000,221470,38.15801499238508,44.450979456030446,NaN,NaN,-150.24227899514224,-114.2813142765023,-0.1265029742192405,-0.3143711252369812,-0.18786815101774068,-42761904,-42845024,24.089079614994816,19.990006681484157,NaN,NaN,-11.72813593234224,-5.981058929053968
2002-09-23T09:30:00-04:00,21.23,21.35001,20.89,21.14999,161700,197285,37.1679773293998,44.06175435317933,NaN,NaN,-154.77827448439618,-136.17232610081084,-0.13708789324916335,-0.35922801757919487,-0.22214012433003152,-42923604,-42866304,23.683782865958264,20.21443154228057,NaN,NaN,-13.695740346843241,-7.083156274452436
2002-09-24T09:30:00-04:00,20.99001,20.99001,20.53999,20.53999,276000,206730,32.545694010997195,43.36826606081632,NaN,NaN,-180.43054214553268,-148.62983613403125,-0.17343950736010966,-0.4389395085301686,-0.26550000117005895,-43199604,-42915684,22.728170972581353,20.477507135192827,NaN,NaN,-16.886671354212805,-8.483658428703917
2002-09-25T09:30:00-04:00,20.8,21.2,20.50999,21.10001,444500,187440,39.931422936684264,43.172307637046664,NaN,NaN,-133.477000384582,-152.66421964098453,-0.14897232834369312,-0.4517154115996753,-0.3027430832559822,-42755104,-42903424,23.55290803775641,20.856103769186053,NaN,NaN,-17.450238661391744,-9.764598461945035
2002-09-26T09:30:00-04:00,21.28,22,21.28,21.99001,359000,197470,49.411403908192135,43.38372310837914,NaN,NaN,-29.596312777792974,-129.7048817574892,-0.06626962722815283,-0.38558011729117325,-0.3193104900630204,-42396104,-42807264,29.874933956065675,21.697393028607145,NaN,NaN,-14.775890796007019,-10.480497366811033
2002-09-27T09:30:00-04:00,21.89999,22.24001,21.5,21.58,324300,203350,45.82352527109008,43.35836394439996,NaN,NaN,-22.868818407128376,-104.23018963988645,-0.034214000576819115,-0.36207799078404435,-0.32786399020722523,-42720404,-42798964,30.40988150198075,22.617270608527964,NaN,NaN,-13.747693476613962,-10.947239668211452
2002-09-30T09:30:00-04:00,21.2,21.36,20.78,21.16,372000,214675,42.42513459027959,42.73671971254326,NaN,NaN,-105.01530207604362,-94.27759515821595,-0.03614294575468058,-0.373042672400576,-0.3368997266458954,-43092404,-42832724,29.42657992695176,23.4841915976917,NaN,NaN,-14.006464450365488,-11.384271779947744
2002-10-01T09:30:00-04:00,21.2,21.88,21.14,21.83,116200,216040,48.931628289599,42.66807077667023,NaN,NaN,-28.50509638709185,-63.892506006527775,0.010371986974731684,-0.3239347429274808,-0.3343067299022125,-42976204,-42788044,32.5357269688964,24.334830301586948,NaN,NaN,-12.026092912483705,-11.475960513167166
2002-10-02T09:30:00-04:00,21.53999,22.35001,21.5,21.59,336800,201655,46.887571561223965,42.83929395641212,NaN,NaN,0.09727068941045937,-37.177651791729275,0.02671450029616218,-0.30091360453200977,-0.32762810482817195,-43313004,-42899624,29.089142742035506,24.948653489670598,NaN,NaN,-11.097993772490577,-11.421965264499082
2002-10-03T09:30:00-04:00,21.60001,22.07001,21.44,21.73,252700,201375,48.245731537972354,42.91880975891987,NaN,NaN,-8.481863032102371,-32.95476184259115,0.047478648617291896,-0.2682797940565571,-0.315758442673849,-43060304,-43032464,25.610755253292467,25.33717443825808,NaN,NaN,-9.93194106974372,-11.209104665248317
2002-10-04T09:30:00-04:00,21.83,21.89999,21.17999,21.36,106700,196185,44.972616309753896,42.63975395741688,NaN,NaN,-42.320340491839445,-36.84506625953337,0.03727047913765108,-0.26917034375178517,-0.30644082288943625,-43167004,-43121784,23.56991252161545,25.53930526440291,NaN,NaN,-9.950926341629513,-11.029364904731345
2002-10-07T09:30:00-04:00,21.58,21.72,21.09,21.09,186000,200320,42.696266393772454,42.68577410161617,NaN,NaN,-62.02947064940627,-28.247899974205886,0.014481409427086533,-0.28833906110557805,-0.3028204705326646,-43353004,-43173904,22.44591625810557,25.69654964568994,NaN,NaN,-10.654989715964074,-10.975882734907449
2002-10-08T09:30:00-04:00,21.14999,21.25,20.59,20.86,442600,216735,40.80166643147164,42.5459001497987,NaN,NaN,-110.72008557794283,-44.69089781237609,-0.012478783632964063,-0.31841895007386967,-0.3059401664409056,-43795604,-43337784,19.325306148395043,25.618204201478587,NaN,NaN,-11.804570572794159,-11.094266711748407
2002-10-09T09:30:00-04:00,20.59,20.92,20.39999,20.45,619400,244185,37.59877631317759,42.542673562571345,NaN,NaN,-143.94202299397332,-73.49875654905284,-0.05209879594565303,-0.37106366137297186,-0.31896486542731883,-44415004,-43558184,16.086195190971864,25.1734494256858,NaN,NaN,-13.7626889718761,-11.475469891766648
2002-10-10T09:30:00-04:00,20.47,20.92999,20.19,20.92999,500300,258630,43.218371108815205,42.90412757088779,NaN,NaN,-116.9886366449745,-95.20011127162726,-0.040660964874495886,-0.36979107152043866,-0.3291301066459428,-43914704,-43729064,14.111352879850003,24.460754658889744,NaN,NaN,-13.753298658022661,-11.800874001231794
2002-10-11T09:30:00-04:00,21.17,21.46001,20.98,21.28,215300,262930,46.96876258353469,43.60418366046885,NaN,NaN,-23.85108052167178,-91.50625927759374,-0.00602300210921819,-0.33665885928246553,-0.33063585717324734,-43699404,-43835544,13.037294116464338,23.700291176783033,NaN,NaN,-12.60010039690425,-11.915049200613574
2002-10-14T09:30:00-04:00,21.38,21.88,21.23,21.87,317300,273905,52.64652076757467,45.03995700022439,NaN,NaN,59.491328596176,-67.20209942847728,0.05666990327575144,-0.25979847807855805,-0.3164683813543095,-43382104,-43841364,12.979144736052987,23.003932159888148,NaN,NaN,-9.786801966537208,-11.611013881459806
2002-10-15T09:30:00-04:00,22.35001,22.53999,21.35001,22.53,160600,275160,58.05639857758496,46.33459811743158,NaN,NaN,141.918612926769,-16.67435972753493,0.13799871177932138,-0.14396999163015778,-0.28196870340947916,-43221504,-43726544,20.511664385037335,22.786700470408217,NaN,NaN,-5.543591801454262,-10.74423929860187
2002-10-16T09:30:00-04:00,22.47,22.62,22.03999,22.17999,179700,277330,54.50043940124918,46.69810065264994,NaN,NaN,153.3065335374996,42.775351578759654,0.16197374717805818,-0.07950151943690642,-0.2414752666149646,-43401204,-43523784,31.74704541627669,22.920422717566144,NaN,NaN,-3.1793883140806787,-9.66354630081313
2002-10-17T09:30:00-04:00,22.5,22.69,22.36,22.64999,469500,297780,58.202621742793156,47.58232182920016,NaN,NaN,168.20159675522862,99.81339825880028,0.200705689322827,0.009406845038569145,-0.19129884428425786,-42931704,-43327184,40.525201444727145,23.642945570619453,NaN,NaN,0.012530900569513776,-8.281249557758466
2002-10-18T09:30:00-04:00,22.52,22.86,22.39999,22.63,140800,299070,57.986510581411565,48.69384868570959,NaN,NaN,151.45354901529956,134.87432416619453,0.21492911635991985,0.07736255116564195,-0.1375665651942779,-43072504,-43201804,45.35226933592215,24.78049481411734,NaN,NaN,2.470660850033383,-6.745262356645345
2002-10-21T09:30:00-04:00,22.41,22.85001,22.39,22.74001,120100,296990,58.89114699033238,49.40524287861911,NaN,NaN,136.5052217633148,150.2771027996223,0.22085189475239791,0.13849830324621948,-0.08235359150617842,-42952404,-43115864,48.441178764266134,25.916598513786607,NaN,NaN,4.748152084668144,-5.103346007886275
2002-10-22T09:30:00-04:00,22.5,22.5,21.8,22.10001,291200,297750,51.89096189620592,49.76262790254639,NaN,NaN,64.31884390978482,134.75714899622545,0.17289425337268496,0.1337642252096778,-0.039130028163007174,-43243604,-43120284,48.28999616192726,27.288088043778878,NaN,NaN,4.673747142077968,-3.7066184150342405
2002-10-23T09:30:00-04:00,21.92999,22.5,21.83,22.46001,223000,286675,55.12240348676754,50.25381875603176,NaN,NaN,74.68148994128504,119.03214027698255,0.15710303036563789,0.15724875979404018,0.00014572942840229697,-43020604,-43044164,51.11933778447307,29.110129653148913,NaN,NaN,5.588988459130417,-2.378674575867861
2002-10-24T09:30:00-04:00,22.59,22.7,21.95,22.09,547900,296120,51.30780594695064,50.70633230154582,NaN,NaN,66.0718222255116,98.60618537103915,0.11535529488287581,0.14433984803199706,0.028984553149121253,-43568504,-43171524,46.53180027704986,30.750264492822804,NaN,NaN,5.20459594705313,-1.2953502154505767
2002-10-25T09:30:00-04:00,21.85001,21.85001,21.57001,21.75,141400,286975,48.0193856726899,51.08655510718278,NaN,NaN,-2.006105576649252,67.91425445264937,0.06117925556057265,0.10545862259983707,0.04427936703926442,-43709904,-43299004,42.42753091901554,32.177522682887805,NaN,NaN,3.8780564538202937,-0.5562921198404523
2002-10-28T09:30:00-05:00,21.73,22.10001,21.46001,21.71001,549500,295850,47.63269279063422,51.57448556140867,NaN,NaN,-2.0632362913092215,40.200562841724576,0.021059891094053165,0.07060423090683088,0.04954433981277771,-44259404,-43560404,35.51088281384395,33.33363530184844,NaN,NaN,2.6922382590232576,-0.09221635143135098
2002-10-29T09:30:00-05:00,21.31,21.31,20.8,21.08,590500,319565,41.90712955947373,51.88222507900125,NaN,NaN,-89.75487144866136,9.385819770035349,-0.0458475962739369,-0.007765155529643408,0.03808244074429349,-44849904,-43881664,29.2086414124027,34.2709528890935,NaN,NaN,-0.13422648995286127,-0.09821779979156674
2002-10-30T09:30:00-05:00,21.47,21.91,21.42999,21.78,501600,327805,49.2119552229611,52.31033823001167,NaN,NaN,-4.212604646078427,-6.392999147437349,-0.041055332057126595,-0.013236724327114757,0.027818607730011838,-44348304,-44147204,25.223871180999254,35.06470419631844,NaN,NaN,-0.34437374054311526,-0.13338293418464509
2002-10-31T09:30:00-05:00,22.11,22.14999,21.32001,21.55,621800,346260,47.11559376047284,52.32082617122155,NaN,NaN,-8.09768307511665,-21.226900207563002,-0.05083112495509555,-0.0357202984638576,0.015110826491237949,-44970104,-44427524,21.83703348914213,35.693257008652566,NaN,NaN,-1.1675739557153646,-0.2811245086890336
2002-11-01T09:30:00-05:00,21.55,22.12,21.55,22.12,377600,359805,52.51430444184308,52.311382147955,NaN,NaN,22.866697951727076,-16.252339501887718,-0.018055445135010374,-0.007458479927525019,0.010596965207485355,-44592504,-44604044,20.014590808686464,36.195788870983534,NaN,NaN,-0.16816967311932116,-0.26498810360764613
2002-11-04T09:30:00-05:00,22.17999,22.21001,21.7,21.75,157600,358385,49.01634403995111,51.66566396669543,NaN,NaN,13.689646482883182,-13.101762947049238,-0.02027493384658377,-0.014746702100744358,0.005528231745839413,-44750104,-44702184,19.062085365911017,36.09224751247451,NaN,NaN,-0.4354165470476947,-0.28933502409908163
2002-11-05T09:30:00-05:00,21.75,22.2,21.62,22.2,94600,340985,53.10741418708658,51.56616216568382,NaN,NaN,24.49661503729135,9.748534350141307,0.008064328046992109,0.015608641804579548,0.007544313757587439,-44655504,-44663304,20.672760587249073,35.30122716754396,NaN,NaN,0.6322460891661609,-0.15768057934690413
2002-11-06T09:30:00-05:00,22.35001,22.5,21.89999,22.39999,233400,321685,54.84171274556678,51.32609723731051,NaN,NaN,57.681781662950954,22.127411611947185,0.03809819749570293,0.0551670606272161,0.017068863131513172,-44422104,-44678064,20.505928268718776,33.87127908354337,NaN,NaN,2.035421550424268,0.15561972490612044
2002-11-07T09:30:00-05:00,22.25,22.5,21.85001,21.98,377800,315560,50.60860430009593,50.79910393150225,NaN,NaN,22.55935548983077,28.258819324936667,0.027967280352609564,0.05202796357227513,0.024060683219665563,-44799904,-44644024,22.067945121770222,32.208113068246796,NaN,NaN,1.934695289762797,0.4097733770285028
2002-11-08T09:30:00-05:00,22.14999,22.14999,21.85001,21.85001,165700,313080,49.33921082735587,50.116822777003925,NaN,NaN,-18.55544138874995,19.97439145684126,0.011636311930184218,0.038606073132395835,0.026969761202211617,-44965604,-44718644,21.089648204639815,30.254432313987774,NaN,NaN,1.4768994175677257,0.5622199542483918
2002-11-11T09:30:00-05:00,21.75,22.05,21.55,21.58,156400,305035,46.71794983380066,49.74732191540355,NaN,NaN,-70.2236993374333,3.191722292777962,-0.016686902965245932,0.0061111324956542035,0.022798035460900135,-45122004,-44793024,20.131630883465746,28.243120508383385,NaN,NaN,0.3208704442032206,0.5277414528133673
2002-11-12T09:30:00-05:00,21.78,21.83,21.45,21.50999,37800,298895,46.03502739236335,49.098223622946115,NaN,NaN,-89.29684597790161,-19.56696991026063,-0.03824031030401777,-0.025002352419122076,0.013237957884895693,-45159804,-44893884,18.879250522725016,25.94025713254424,NaN,NaN,-0.8226976118867859,0.3348215864276311
2002-11-13T09:30:00-05:00,21.55,21.64999,20.8,21.03,297600,304790,41.55046293747038,48.40127055084037,NaN,NaN,-159.7900939563819,-63.0613450341272,-0.08049747660079067,-0.08738388786609264,-0.006886411265301973,-45457404,-45100944,16.596604987896143,23.80202889760469,NaN,NaN,-3.157157794390936,-0.1640326108321642
2002-11-14T09:30:00-05:00,21.24001,21.75999,21.24001,21.71001,604000,311515,49.113591117943294,48.47942808264418,NaN,NaN,-70.10484391482804,-81.59418491505896,-0.05930420736941394,-0.0810166704770694,-0.02171246310765546,-44853404,-45111644,16.485679123708707,21.9490394836542,NaN,NaN,-2.9521458324884504,-0.5623344996402051
2002-11-15T09:30:00-05:00,21.7,21.88,21.56,21.88,301300,319540,50.82653812419751,48.70755989218442,NaN,NaN,-20.300307461162795,-81.94315812954153,-0.03186553919720638,-0.061544387104163434,-0.029678847906957052,-44552104,-45028944,20.886854079611297,20.90446600263758,NaN,NaN,-2.270500981826537,-0.8063582828096811
2002-11-18T09:30:00-05:00,21.99001,22.02,21.71001,21.89999,65700,316820,51.03527517630368,49.35957029338656,NaN,NaN,15.085546522134658,-64.88130895762794,-0.011450777851292067,-0.043992320221072134,-0.03254154236978007,-44486404,-44901824,27.234682317562473,20.763468924434708,NaN,NaN,-1.658948493591737,-0.9281568843499748
2002-11-19T09:30:00-05:00,21.94,22.16,21.78,21.89999,62100,305365,51.035275176303664,49.48980743291103,NaN,NaN,38.027095812814316,-39.416520599484755,0.0022417427873070578,-0.02973936388564624,-0.0319811066729533,-44486404,-44767144,33.33752085687193,21.343015329854186,NaN,NaN,-1.1566219529101605,-0.9607947512871442
2002-11-20T09:30:00-05:00,21.82001,22.37,21.82001,22.33,159000,302165,55.72417106993123,50.10470581215805,NaN,NaN,105.14568817280312,13.57063582635225,0.038440232857276255,0.016069184398642022,-0.022371048458634232,-44327404,-44541144,42.11138006810513,22.791182942637256,NaN,NaN,0.6171140792585948,-0.7353792040663243
2002-11-21T09:30:00-05:00,22.5,22.56,22.25,22.5,189800,284260,57.458590755074866,50.45786912024604,NaN,NaN,171.03453476028147,61.798511561374156,0.07016660005353409,0.06533720160828338,-0.00482939844525071,-44137604,-44397984,46.880730445608535,24.710192916703118,NaN,NaN,2.608837114793934,-0.25763401565771593
2002-11-22T09:30:00-05:00,22.35001,22.35001,22,22.02,290300,291705,51.342907914448276,50.6240522541387,NaN,NaN,76.34337320881623,81.12724769536996,0.05578537332195714,0.06490231820719572,0.009116944885238577,-44427904,-44373144,47.68610458026219,26.7547657177282,NaN,NaN,2.6453448223380067,0.15707724691310154
2002-11-25T09:30:00-05:00,21.92999,22.27,21.85001,22.2,75500,268005,53.34818539559735,50.64125019760376,NaN,NaN,65.6703195378,91.24420229850303,0.05525119960770194,0.078180944394866,0.022929744787164065,-44352404,-44346344,48.59172560303798,28.748977504570266,NaN,NaN,3.2472863869037263,0.5985356954831907
2002-11-26T09:30:00-05:00,22.05,22.05,21.74001,21.78,82000,242580,48.34192186613998,50.17697942050184,NaN,NaN,-11.732788635425655,81.29222540885503,0.02500756578081595,0.054189202013184,0.029181636232368052,-44434404,-44335944,48.96097098119903,30.781480555461716,NaN,NaN,2.306092002825032,0.8424723108177394
2002-11-27T09:30:00-05:00,21.95,22.25,21.86,22.17,186400,226820,52.77369968817964,50.33162909107926,NaN,NaN,57.2364598531896,71.71037974493234,0.029363349575045182,0.06588582320117453,0.03652247362612935,-44248004,-44320064,49.55675235757659,32.744966786590744,NaN,NaN,2.8123792825018175,1.1238875924868934
2002-11-29T09:30:00-05:00,22.36,22.48,22.24001,22.44,67500,199105,55.612803613738954,50.77974286153518,NaN,NaN,134.82206367340385,64.46788552755682,0.04745199597660045,0.09583746859687992,0.048385472620279465,-44180504,-44328644,49.22242723039567,34.75445100271616,NaN,NaN,4.090650133151234,1.547710812581799
2002-12-02T09:30:00-05:00,22.53,22.61,22.28,22.50999,242100,192330,56.34543238419947,51.46742018656367,NaN,NaN,135.6342065141335,76.32605218862025,0.06032757423867495,0.12379494041862316,0.0634673661799482,-43938404,-44230744,53.10956993004214,37.11001807747162,NaN,NaN,5.348122497606543,2.090626767585334
2002-12-03T09:30:00-05:00,22.72,22.95,22.59,22.73,394100,204155,58.65555248252094,52.36888626443207,NaN,NaN,180.2073953890527,99.2334673588708,0.07869717047767438,0.16183882927704119,0.0831416587993668,-43544304,-44069124,58.72681788403906,39.95627288899404,NaN,NaN,7.083642845236217,2.803914778678317
2002-12-04T09:30:00-05:00,22.59,22.67,22.42,22.53,481200,223485,55.76653110126132,53.384319704702854,NaN,NaN,111.45550195288095,123.87112547653211,0.07256392240825256,0.1738465618096825,0.10128263940142994,-44025504,-43987344,61.25600229431208,43.146229839452324,NaN,NaN,7.754174258535247,3.511094704372164
2002-12-05T09:30:00-05:00,22.66,22.74001,22.48,22.67999,126800,218155,57.45879618678341,53.98040578104857,NaN,NaN,121.58395850347337,136.74062520658887,0.07356443752600438,0.1932381863089354,0.11967374878293104,-43898704,-43917484,63.32359711504787,46.49179541026227,NaN,NaN,8.793059538709633,4.2656611092775165
2002-12-06T09:30:00-05:00,22.46001,22.97,22.42,22.89999,711900,234860,59.88311461030046,54.62730410148449,NaN,NaN,129.98453113811598,135.77311869953127,0.08328401495996784,0.22377876748289083,0.14049475252292298,-43186804,-43718744,68.47736552253701,49.89111765618555,NaN,NaN,10.36913087242683,5.13758536115599
2002-12-09T09:30:00-05:00,22.8,23.14999,22.5,22.5,262800,239715,53.87201103691229,54.82992809152796,NaN,NaN,106.01106544314392,129.84849048533334,0.05820288092046688,0.21324835367350659,0.1550454727530397,-43449604,-43620984,70.66130007870998,52.99301892483894,NaN,NaN,10.043560895877741,5.838439008973383
2002-12-10T09:30:00-05:00,22.55,22.85001,22.39999,22.85001,405200,252155,57.858376364251335,55.31729246209566,NaN,NaN,91.87389301278382,112.1817900100796,0.06035472134657455,0.23048887443625787,0.17013415308968333,-43044404,-43521004,72.74128023552001,55.80757316617095,NaN,NaN,10.937298418283232,6.5668474960176475
2002-12-11T09:30:00-05:00,22.60001,22.85001,22.47,22.73,413500,270940,56.06917824393034,55.34193583166701,NaN,NaN,80.17471432874736,105.92563248525286,0.04932972058042026,0.23179630381520866,0.1824665832347884,-43457904,-43407484,74.9157961087435,58.15074574050226,NaN,NaN,11.163374046481923,7.223494146083972
2002-12-12T09:30:00-05:00,22.72,23.02,22.72,22.92999,157800,263950,58.37900887829522,55.407679983325615,NaN,NaN,110.78404230620653,103.76564924579952,0.050932899800974846,0.24613270798600695,0.1951998081850321,-43300104,-43287764,76.99966458907502,60.3020981793213,NaN,NaN,12.01619675684789,7.908165947621675
2002-12-13T09:30:00-05:00,22.89999,23.07001,22.77,22.87,173900,242445,57.40400075024633,55.84061518588262,NaN,NaN,107.15869677398008,99.20048237297233,0.043659733664198286,0.24977447526527996,0.20611474160108167,-43474004,-43345204,73.83054614472883,62.16955829106892,NaN,NaN,12.455446754543896,8.557777491467707
2002-12-16T09:30:00-05:00,22.91,23.28,22.91,23.25999,602400,257500,61.86318328883209,56.44882932111367,NaN,NaN,146.3912007491729,107.27650943417814,0.059821480608259925,0.2808915923614066,0.22107011175314667,-42871604,-43229604,75.97375105919457,64.12541725222296,NaN,NaN,14.141178544076084,9.355406213268903
2002-12-17T09:30:00-05:00,23.28,23.38,22.96001,23.02,206600,264545,57.8497825279183,57.12796222552641,NaN,NaN,128.07683630856366,114.51709809333411,0.04948435447404598,0.28292555484570414,0.23344120037165816,-43078204,-43236364,75.58392396808338,66.02705675128612,NaN,NaN,14.42906741473269,10.080214956335158
2002-12-18T09:30:00-05:00,22.78,23,22.64,22.83,192800,271080,54.817665627910166,57.27395979265002,NaN,NaN,58.871778764855705,110.25651098055577,0.026157597456841403,0.2661381971927099,0.23998059973586852,-43271004,-43198984,76.3078435495483,67.9378489792841,NaN,NaN,13.797067293376179,10.611193861626733
2002-12-19T09:30:00-05:00,22.67999,22.89999,22.56,22.60001,840900,305175,51.311752929240384,56.9667418866144,NaN,NaN,23.203582619425436,92.74041904319957,-0.0066996682301830035,0.23160601444813977,0.23830568267832278,-44111904,-43361344,67.01382957274697,69.2086634323092,NaN,NaN,12.230942458416113,10.84258651831093
2002-12-20T09:30:00-05:00,22.62,22.94,22.53,22.94,258600,308615,55.81096957891625,56.92856597195131,NaN,NaN,47.73376958570005,80.85543360554354,-0.0074179780315543065,0.2290332101388799,0.2364511881704342,-43853304,-43437204,63.14405985995426,69.9254127130172,NaN,NaN,12.178333064091031,11.033407453422372
2002-12-23T09:30:00-05:00,23.05,23.11,22.89,23.03999,123900,300295,57.06750294211489,56.81513386192231,NaN,NaN,95.6692333789951,70.71104013150799,-0.00325389017590369,0.23238382545055458,0.23563771562645827,-43729404,-43608764,55.358452335932206,69.68481517386671,NaN,NaN,12.496284333912195,11.242389864920918
2002-12-24T09:30:00-05:00,23,23,22.86,22.92999,67800,299910,55.20764582801408,56.775213485261794,NaN,NaN,70.31962277341928,59.15959742447912,-0.009641553373977346,0.2235857739089866,0.23322732728296394,-43797204,-43752564,49.8142263150399,68.86754546106155,NaN,NaN,12.238937282954911,11.384753781782917
2002-12-26T09:30:00-05:00,22.92,23.03,22.62,22.67,197300,305675,50.97873608262457,56.31235204925046,NaN,NaN,11.938591297505633,49.7729599310091,-0.03185803419677263,0.19340478453699816,0.2252628187337708,-43994504,-43897264,44.937177462738745,67.5542297716109,NaN,NaN,10.795444550472862,11.300566748738623
2002-12-27T09:30:00-05:00,22.73,22.77,22.16,22.17999,473600,320035,44.11926760098079,55.186362977156186,NaN,NaN,-159.01986458385161,13.328270490353692,-0.07743781474304642,0.12846555030496276,0.20590336504800918,-44468104,-43968504,42.71963806741705,65.71439209624518,NaN,NaN,7.339597843223878,10.734714047950803
2002-12-30T09:30:00-05:00,22.35001,22.52,22.2,22.28999,248100,329065,45.87975758973749,54.61548773092942,NaN,NaN,-168.86475133411201,-29.991433693608723,-0.09680415860931954,0.08489816678635975,0.1817023253956793,-44220004,-44041844,40.50367914447688,63.560276315228535,NaN,NaN,5.017831951925899,9.918016605661531
2002-12-31T09:30:00-05:00,22.31,22.34,21.95,22.33,229500,328435,46.53948594452633,53.80699555809191,NaN,NaN,-199.00502339057564,-88.92628504752288,-0.10297117448805257,0.052988357285613574,0.15595953177366614,-43990504,-44094064,38.95425716181555,61.14691752424965,NaN,NaN,3.304236810174706,8.973190920591986
2003-01-02T09:30:00-05:00,22.45,22.83,22.42,22.8,75700,312515,53.682257934398336,53.6365012502682,NaN,NaN,-19.556985652489452,-106.90160673270461,-0.07286617273425261,0.06487681585585037,0.13774298859010298,-43914804,-44117584,38.24462902799257,58.52754844705316,NaN,NaN,3.895535077880621,8.247811514490362
2003-01-03T09:30:00-05:00,22.89999,22.89999,22.67999,22.75999,43100,290610,53.032678013987386,53.25462047424622,NaN,NaN,12.282430793200938,-106.83283883356555,-0.05398629694890186,0.07026011740397564,0.1242464143528775,-43957904,-44110264,38.61939959640628,55.78610094757682,NaN,NaN,4.187613339704326,7.667783203806643
2003-01-06T09:30:00-05:00,22.8,23.07001,22.78999,22.95,118800,290210,55.76991370336473,53.13789997089753,NaN,NaN,66.9313820422432,-61.6425895083466,-0.028329442217539372,0.0888346115809533,0.11716405379849266,-43839104,-43984464,44.8173428373726,53.71372928276566,NaN,NaN,5.232289292159467,7.319855502142761
2003-01-07T09:30:00-05:00,22.75,22.75,22.12,22.2,450200,277125,44.69695209574862,51.911740599963004,NaN,NaN,-132.2385164750219,-54.31734253652858,-0.05969455673165035,0.04254585788392973,0.10224041461558007,-44289304,-43998324,44.286754632703214,51.450372395159135,NaN,NaN,2.599110795522257,6.645463401196975
2003-01-08T09:30:00-05:00,22.2,22.2,21.92,21.99001,710400,299505,42.17223635879462,50.79191587359702,NaN,NaN,-193.03873772294617,-53.12408540300269,-0.09055749313054438,-0.010956451797600408,0.07960104133294398,-44999704,-44200164,37.351691062697846,48.71949861620302,NaN,NaN,-0.3771888125925422,5.642227370655615
2003-01-09T09:30:00-05:00,22.2,22.39,22.07001,22.27,616300,310060,46.51064567062209,50.1985573052193,NaN,NaN,-114.7364650541393,-72.15998128333266,-0.08801201012889343,-0.030413971328172806,0.05759803880072062,-44383404,-44293884,34.639281937508315,45.743172786771595,NaN,NaN,-1.4826099576781497,4.624393466607934
2003-01-10T09:30:00-05:00,22.08,22.35001,22.06,22.09,215600,300165,44.21412766330581,49.69158407193826,NaN,NaN,-113.25742616190185,-97.26795267435321,-0.09381510550617889,-0.05967084308200299,0.0341442624241759,-44599004,-44422104,31.291344541396754,43.191566713103725,NaN,NaN,-3.110823454621058,3.519362477860935
2003-01-13T09:30:00-05:00,22.17,22.17,21.89,22.00999,496800,317115,43.19321298927404,48.79031574410667,NaN,NaN,-123.81922238402099,-135.41807355960606,-0.09795176841628131,-0.08829544809617573,0.00965632032010557,-45095804,-44673444,25.988791167190158,40.537618949334856,NaN,NaN,-4.737542100426515,2.339804680962728
2003-01-14T09:30:00-05:00,22.19,22.19,21.95,22.10001,67100,311775,44.7392662601912,47.909727409683555,NaN,NaN,-98.29515975668298,-128.62940221593826,-0.0897529237621181,-0.10253483438254207,-0.012781910620423963,-45028704,-44821324,23.46887752721841,38.25979217728388,NaN,NaN,-5.633964612758038,1.2006947818597615
2003-01-15T09:30:00-05:00,22.08,22.25999,22,22.17,752300,319270,45.970489844927314,47.24993055374879,NaN,NaN,-77.39610808928524,-105.50087628920608,-0.07532592166774486,-0.10693931270510504,-0.031613391037360175,-44276404,-44676664,30.561748456420517,36.884615187382494,NaN,NaN,-6.034804429933615,0.16705203731785057
2003-01-16T09:30:00-05:00,22.28,22.53,22.28,22.39,512100,334545,49.75966090436981,47.16285375530202,NaN,NaN,-19.774198969799734,-86.50842307233816,-0.048006547676951596,-0.09162157563354967,-0.04361502795659807,-43764304,-44552844,36.02697168677501,36.248171917670795,NaN,NaN,-5.308719457604387,-0.6152010333853263
2003-01-17T09:30:00-05:00,22.31,22.42,22.14999,22.22,177600,333785,47.01576511373716,47.36974643478461,NaN,NaN,-45.385871094503564,-72.93411205885852,-0.03881808373196221,-0.09213763262155084,-0.053319548889588626,-43941904,-44421424,41.307162101143774,36.147280777222704,NaN,NaN,-5.454828636796987,-1.3065764053012776
2003-01-21T09:30:00-05:00,21.97,21.97,21.67999,21.7,209400,302210,39.78831849565007,46.9346436423498,NaN,NaN,-140.49384248733978,-76.26903607952227,-0.06372310548406221,-0.1329734307446664,-0.06925032526060418,-44151304,-44232524,47.956444962933716,36.679621192826765,NaN,NaN,-7.825680260758588,-2.2378769560808935
2003-01-22T09:30:00-05:00,21.49001,21.82001,21.25,21.64,166100,297585,39.042536322834174,46.39914724080036,NaN,NaN,-171.55731585238595,-90.92146729866286,-0.079190337973296,-0.16823824772722418,-0.08904790975392818,-44317404,-44090264,52.33586817794253,37.63545055112155,NaN,NaN,-9.970556740378909,-3.3425454966948953
2003-01-23T09:30:00-05:00,21.63,21.77,21.5,21.7,195500,301165,40.24865156563049,45.43960392874551,NaN,NaN,-140.84127824242137,-103.61050132929009,-0.08009271865053469,-0.18916380806709654,-0.10907108941656185,-44121904,-44059364,53.255971206878854,38.70768927818485,NaN,NaN,-11.396620300335575,-4.493127611500707
2003-01-24T09:30:00-05:00,21.58,21.72,21.21001,21.32001,234700,309510,35.46298140717779,44.184625599687685,NaN,NaN,-174.8433803155696,-134.62433759844404,-0.09971541449010707,-0.2337153575291957,-0.13399994303908863,-44356604,-44177824,49.32491669598547,39.47236907101194,NaN,NaN,-14.132506687100015,-5.870181765157751
2003-01-27T09:30:00-05:00,21.08,21.16,20.46001,20.64999,962200,347755,28.930874656948077,42.267551382086495,NaN,NaN,-253.48021271747302,-176.24320592303792,-0.14832475249683993,-0.31940588366013856,-0.17108113116329862,-45318804,-44453204,41.63166579817922,39.244820711069565,NaN,NaN,-18.936337552577807,-7.7367754490749014
2003-01-28T09:30:00-05:00,20.85001,21.09,20.78999,21,278600,338005,35.6037912730654,41.61803989475198,NaN,NaN,-174.89952616934733,-183.12434265943946,-0.1471201806900491,-0.35498135702586,-0.2078611763358109,-45040204,-44630984,37.55888178580805,38.76425836486277,NaN,NaN,-20.713751969493323,-9.590629237706104
2003-01-29T09:30:00-05:00,21.05,21.81,21.02,21.67999,348300,343015,46.17705248615755,41.90409818956362,NaN,NaN,-76.00817904469996,-164.01451529790225,-0.09336249155481957,-0.32456429077933535,-0.23120179922451578,-44691904,-44705884,35.962625641188566,38.66503940618354,NaN,NaN,-18.438859533150637,-10.854662137055323
2003-01-30T09:30:00-05:00,21.75,22,21.34,21.34,1010200,382050,42.42619116409162,41.612351439097154,NaN,NaN,-59.86433295841662,-147.8191262411013,-0.0743635422332308,-0.3241562270160543,-0.2497926847828235,-45702104,-45021924,30.14158161206207,38.343775097223094,NaN,NaN,-17.93325586617713,-11.865889812644152
2003-01-31T09:30:00-05:00,21.21001,21.78,21.12,21.77,631700,409850,48.161350328511084,41.89429591518325,NaN,NaN,-53.198689783853204,-123.49018813475803,-0.0288382014379423,-0.2858404365802514,-0.2570022351423091,-45070404,-45164684,27.941454977188002,38.10449727120818,NaN,NaN,-15.45516204755767,-12.378642989060369
2003-02-03T09:30:00-05:00,21.8,22,21.60001,21.94,511900,433290,50.270464386990646,42.39981387216301,NaN,NaN,-2.7081813156426753,-73.33578185439194,0.01439998954176358,-0.23900224821510463,-0.2534022377568682,-44558504,-45012624,33.50869124826815,38.641632991285185,NaN,NaN,-12.791062776777618,-12.437560101591405
2003-02-04T09:30:00-05:00,21.77,22.23,21.55,22.09,391100,446905,52.12149658883751,42.92711603849489,NaN,NaN,26.696521930949825,-33.01657223433251,0.05262884814230118,-0.18761617757899174,-0.24024502572129292,-44167404,-44838064,39.305852862009154,39.77284551519881,NaN,NaN,-10.063652668727933,-12.098430468325194
2003-02-05T09:30:00-05:00,22.28999,22.28999,21.91,21.92999,333800,441085,49.9841618995345,43.213806899538255,NaN,NaN,47.733723006983595,-8.268191823995798,0.06580986856568777,-0.1579826900141832,-0.22379255857987096,-44501204,-44799924,40.52596175668942,40.484575036646596,NaN,NaN,-8.511851400499161,-11.586062030064332
2003-02-06T09:30:00-05:00,21.89999,22,21.64999,21.84,233800,417255,48.77282382516845,43.14331853673816,NaN,NaN,8.411183226584633,5.386911413004464,0.06691893722378181,-0.1401438870501437,-0.2070628242739255,-44735004,-44606504,46.409577905423625,41.226189766550064,NaN,NaN,-7.614188114157957,-11.018651470649136
2003-02-07T09:30:00-05:00,22,22,21.56,21.64,659700,419425,46.09892960723214,43.07783028627352,NaN,NaN,-6.174382474867027,14.791772874801694,0.053230298185433844,-0.14052495154213318,-0.19375524972756702,-45394704,-44671364,44.80876660260799,41.476304373797504,NaN,NaN,-7.645141042991487,-10.536721409555186
2003-02-10T09:30:00-05:00,21.72,21.92,21.64,21.92,345000,425895,50.21407882357443,43.822527452553835,NaN,NaN,18.060318446415216,18.945472827213273,0.06149547973551894,-0.11688590005816835,-0.1783813797936873,-45049704,-44769604,42.42194899067161,41.08098323292164,NaN,NaN,-6.4416034784785134,-9.951704562258518
2003-02-11T09:30:00-05:00,22.08,22.14,21.67999,21.78,525300,427320,48.231310606247,44.4788684727976,NaN,NaN,29.39449580865569,19.485067602754448,0.05614403679883767,-0.10820133379514019,-0.16434537059397786,-45575004,-45051124,36.432927198186746,39.9450588772248,NaN,NaN,-6.01450162689081,-9.389247000063131
2003-02-12T09:30:00-05:00,21.8,21.8,21.34,21.39999,127300,430330,43.24031723260853,44.69255887758174,NaN,NaN,-45.20363089998648,0.8975968213604304,0.027093647803772714,-0.13047831083926198,-0.1575719586430347,-45702304,-45291344,32.24915348114564,38.44457189681528,NaN,NaN,-7.145508266023085,-9.068712895200267
2003-02-13T09:30:00-05:00,21.38,21.42,21.06,21.3,363300,410880,42.00851362487327,45.16009689313142,NaN,NaN,-93.19539925838161,-19.423719675632817,0.002520558257204597,-0.15442126082152896,-0.15694181907873356,-46065604,-45557464,28.36331971905075,36.94731496989137,NaN,NaN,-8.437353222982338,-8.978518656311993
2003-02-14T09:30:00-05:00,21.3,21.58,21.19,21.47,343200,402435,44.88334571232707,46.29955911137278,NaN,NaN,-50.97540688716029,-28.383924558091472,-0.0007336985836089993,-0.15785894230824482,-0.15712524372463582,-45722404,-45623004,27.484955684526355,35.93683567605903,NaN,NaN,-8.70454142007709,-8.939379051135578
2003-02-18T09:30:00-05:00,21.64999,21.91,21.60001,21.82001,86000,397855,50.34163867808013,47.35226249744526,NaN,NaN,51.33026287401023,-21.729935672572466,0.0210343593334216,-0.13083229455785883,-0.15186665389128043,-45636404,-45740344,25.936316944252184,35.106652473090755,NaN,NaN,-7.3099052099761295,-8.706597073827085
2003-02-19T09:30:00-05:00,21.88,21.97,21.72,21.8,52300,390000,50.0365593695012,47.627941560541224,NaN,NaN,64.83651212755494,-14.641532408792619,0.03368304828631044,-0.10976284353339238,-0.14344589181970283,-45688704,-45763084,25.634867000900243,34.36895542735588,NaN,NaN,-6.264324967729204,-8.357701058670244
2003-02-20T09:30:00-05:00,22.03999,22.07001,21.75,21.75,401100,401750,49.233670896978516,48.11419011289029,NaN,NaN,65.39130851231077,7.477455473666831,0.03796216604981775,-0.09599318425743064,-0.1339553503072484,-46089804,-45840584,24.58606883161798,33.972133085895585,NaN,NaN,-5.613031729497555,-7.965605440217003
2003-02-21T09:30:00-05:00,21.78,22.32001,21.78,22.23,2248000,504375,56.45706626885202,48.706741251486065,NaN,NaN,116.69270417935762,49.45507616121468,0.07050791868126256,-0.045820451955670194,-0.11632837063693276,-43841804,-45395824,39.806281685227155,34.81962070789838,NaN,NaN,-2.8490801850707888,-7.234673260910402
2003-02-24T09:30:00-05:00,22.3,22.58,22.23,22.42,436400,514460,58.947106939439685,49.326501433803855,NaN,NaN,166.51415240302669,92.95298801925205,0.10039672398388634,0.009167534342925165,-0.09122918964096118,-43405404,-44932424,50.920611498260826,36.06332929718357,NaN,NaN,0.2367389631290549,-6.167328657476194
2003-02-25T09:30:00-05:00,22.69,22.83,22.14,22.3,441500,488425,56.74016123799922,49.65640605160112,NaN,NaN,168.41125659078443,116.36918676260689,0.10704108538595156,0.042572167091478264,-0.06446891829447329,-43846904,-44574524,57.45455704072335,37.35966530994887,NaN,NaN,2.1857205784168454,-4.974035909491474
2003-02-26T09:30:00-05:00,22.36,22.58,22.25,22.36,325800,490785,57.59503222510644,50.200039646284836,NaN,NaN,156.55080631431903,134.7120455999597,0.11001118246827575,0.07304505979087139,-0.03696612267740436,-43521104,-44141004,63.74987906192892,39.018516546037404,NaN,NaN,4.042817806231139,-3.6859139501025293
2003-02-27T09:30:00-05:00,22.55,22.58,22.16,22.23,283800,487560,55.05639726804837,50.64886632077626,NaN,NaN,117.85415723943728,145.204615345385,0.09814653059722969,0.08571704056913276,-0.012429490028096932,-43804904,-43684024,68.96320118732959,40.62948963760211,NaN,NaN,4.9369960136983115,-2.4540696695595523
2003-02-28T09:30:00-05:00,22.27,22.58,22.27,22.41,222900,448195,57.82813344410028,51.48666659483826,NaN,NaN,122.3609550350012,146.33826551651373,0.09716549012278482,0.10902737262538409,0.011861882502599272,-43582004,-43632064,69.50030377749106,42.393170864379485,NaN,NaN,6.484948290185051,-1.177067103881752
2003-03-03T09:30:00-05:00,22.36,22.60001,22.36,22.49001,126700,422945,59.037416034211546,52.11690496702663,NaN,NaN,119.67141961491096,136.96971895889058,0.09645492617222923,0.1324305402178858,0.03597561404565658,-43455304,-43642044,69.25241246040841,44.30963254078925,NaN,NaN,8.12370715404999,0.15161493296563977
2003-03-04T09:30:00-05:00,22.55,22.56,22.33,22.38,1572700,475985,56.63280079663741,52.717011409197376,NaN,NaN,92.75384561075097,121.8382367628839,0.08360466783707995,0.14048144884200653,0.056876781004926574,-45028004,-43878264,63.480913922824925,46.241631592549126,NaN,NaN,8.889176977183778,1.3998380821396597
2003-03-05T09:30:00-05:00,22.42,22.58,22.34,22.58,413300,477095,59.83568428443041,53.90239477004179,NaN,NaN,96.17698046094401,109.7634715922089,0.08341267803323038,0.16114262854646455,0.07772995051323417,-44614704,-44096984,58.610295476449124,48.12457030649937,NaN,NaN,10.446712888950122,2.6922487688268686
2003-03-06T09:30:00-05:00,22.58,22.64999,22.41,22.60001,153400,468075,60.15277217353888,55.19841323780362,NaN,NaN,94.50389996339861,105.09342013700116,0.07948805445972473,0.17709001858789009,0.09760196412816535,-44461304,-44228264,55.840881022433564,50.087253256741,NaN,NaN,11.831098572835822,3.9977987408281477
2003-03-07T09:30:00-05:00,22.44,22.67,22.34,22.60001,1263400,519555,60.15277217353888,56.289086556461605,NaN,NaN,82.46678197718718,97.11458552543836,0.07197146279750193,0.18756629262504276,0.11559482982754084,-44461304,-44404124,52.27734809106937,51.858138428636934,NaN,NaN,12.99309131726058,5.282840537461352
2003-03-10T09:30:00-05:00,22.5,22.67999,22.33,22.37,403700,506755,54.42474963005334,56.58073733874541,NaN,NaN,62.782297235209334,85.73676104949804,0.04775478890402296,0.17528831595756955,0.1275335270535466,-44865004,-44686064,47.08907331488914,53.369049597968136,NaN,NaN,12.532203721195836,6.318463849423421
2003-03-11T09:30:00-05:00,22.5,22.58,22.11,22.14999,53400,492175,49.56305653661199,56.546915707824745,NaN,NaN,26.256734770102906,72.43733888136845,0.014869638878466152,0.14612057565162928,0.13125093677316313,-44918404,-44664144,47.52511643777125,54.932638843458925,NaN,NaN,10.757393515764132,6.952596658900665
2003-03-12T09:30:00-05:00,21.89999,21.89999,21.45,21.8,3274400,629630,42.984890613783875,56.10057425902513,NaN,NaN,-77.38944034792445,37.72405471959472,-0.030053761003759047,0.09368373551846432,0.12373749652222336,-48192804,-45379764,36.848560050957744,55.808531073411764,NaN,NaN,7.119796989188133,6.976482420370304
2003-03-13T09:30:00-05:00,22,22.03999,21.72,21.89,850400,665785,45.006196572640896,55.28265499501005,NaN,NaN,-53.21959838304046,8.179355050306905,-0.05201991131854897,0.05871260737403716,0.11073251869258613,-47342404,-45955984,30.84066561712254,55.16812992569,NaN,NaN,4.668724121012545,6.646802663319195
2003-03-14T09:30:00-05:00,21.83,21.97,21.72,21.8,994900,697365,43.35108693064204,54.16865356581021,NaN,NaN,-77.19932808847263,-23.75386696282506,-0.0698140160501963,0.02346499862984075,0.09327901468003705,-48337304,-46731184,24.947606737655292,53.31291529993247,NaN,NaN,2.130154793270817,6.001567253312285
2003-03-17T09:30:00-05:00,21.88,22.22,21.88,22.08,683800,714395,49.565274052031214,53.65616162395536,NaN,NaN,-38.71688625200447,-44.05370366026782,-0.06028871118585462,0.01791812569771878,0.0782068368835734,-47653504,-47288884,21.730546131601614,50.76120023499521,NaN,NaN,1.6824607858899518,5.3845520436805225
2003-03-18T09:30:00-05:00,22.10001,22.5,21.82001,22.5,486700,734430,57.15711937835161,53.62488213490144,NaN,NaN,9.746464075180425,-47.355757799252316,-0.02506757877004842,0.046872363421012864,0.07193994219106128,-47166804,-47738564,19.542311459574222,47.60351683482701,NaN,NaN,3.726477494158833,5.14768425089171
2003-03-19T09:30:00-05:00,22.58,22.62,22.32001,22.53,417300,752680,57.64752241977262,53.80996250288174,NaN,NaN,67.05617050193956,-18.466635629279516,-0.0004189042235080709,0.07141631191167619,0.07183521613518426,-46749504,-47449904,24.778699360762644,44.44748099007223,NaN,NaN,5.502757875738611,5.198409054441267
2003-03-20T09:30:00-05:00,22.5,22.85001,22.35001,22.75,1052500,785250,61.15871158917724,54.04786094181581,NaN,NaN,111.56078511940575,14.489441071209729,0.02843734519620418,0.10738189763043948,0.0789445524342353,-45697004,-47120824,30.344400213550514,41.65063073550505,NaN,NaN,8.123088457795768,5.616220397777624
2003-03-21T09:30:00-05:00,22.57001,22.66,22.33,22.38,110100,678355,53.17433198979863,53.62906922435774,NaN,NaN,44.206430117653454,38.77059271243495,0.020700892640466734,0.10482066823481873,0.08411977559435199,-45807104,-46614784,37.94774417546443,39.41458300086619,NaN,NaN,7.869764615507363,5.93815528602473
2003-03-24T09:30:00-05:00,22.41,22.52,22,22.05,577400,685405,47.2494887827271,52.95883265193557,NaN,NaN,-42.731411259647665,37.967687710906304,-0.007060073937165151,0.07529468317289556,0.08235475711006071,-46384504,-46360984,41.40251341300279,37.837554393021755,NaN,NaN,5.655162105412441,5.8977276887944035
2003-03-25T09:30:00-05:00,22.24001,22.52,22.19,22.25,386400,682650,50.82562771786254,52.31525718289502,NaN,NaN,2.616872080347496,36.54176931193972,-0.012077289063626234,0.06725814578052791,0.07933543484415415,-45998104,-46127244,44.468879556421825,36.827453255876954,NaN,NaN,5.0094693911192065,5.7708336462693754
2003-03-26T09:30:00-05:00,22.39999,22.39999,22.17,22.3,360100,684365,51.707074142419415,51.71199303781505,NaN,NaN,-5.86531742864062,21.957471725823684,-0.012121273680580358,0.0641838427434287,0.07630511642400906,-45638004,-45904944,47.2937482232183,36.21694377021872,NaN,NaN,4.771549713505262,5.628078798731645
2003-03-27T09:30:00-05:00,22.25,22.64999,22.21001,22.48,843300,712340,54.84505032132797,51.33287004837142,NaN,NaN,44.90373814182653,8.626062330307839,-0.00072190488446848,0.07540273531842345,0.07612464020289193,-44794704,-45724484,49.537905407399684,36.02126929281374,NaN,NaN,5.541417610596245,5.615698628998016
2003-03-28T09:30:00-05:00,22.47,22.81,22.47,22.67999,414800,721935,58.1024789623365,51.595565000677354,NaN,NaN,105.27832191297269,20.840440689371682,0.018529722854478126,0.09928679377098959,0.08075707091651146,-44379904,-45439044,52.95035360132002,36.43993217041595,NaN,NaN,7.204551765686666,5.842677648524966
2003-03-31T09:30:00-05:00,22.55,22.55,22.3,22.32001,435600,737380,50.97434320666527,51.69637119139544,NaN,NaN,22.842856823558805,33.95529430601298,0.005915582042834849,0.08815154847005502,0.08223596642722017,-44815504,-45125244,56.43799217322965,37.07656615152012,NaN,NaN,6.37290534979172,5.918424462991646
2003-04-01T09:30:00-05:00,22.35001,22.78,22.35001,22.74001,330700,675280,57.522196663508836,52.73475019494723,NaN,NaN,91.83842404283385,51.799604698510244,0.02375286756785873,0.11192705088704358,0.08817418331918485,-44484804,-44822584,59.55226120944792,38.698259091412275,NaN,NaN,7.866301971473984,6.196692678489122
2003-04-02T09:30:00-05:00,22.67,22.69,22.5,22.69,325600,670895,56.553632747347834,53.55956706456915,NaN,NaN,88.5255455984131,70.67777730392099,0.029692379435761987,0.12528965761388733,0.09559727817812534,-44810404,-44657064,61.186484344949996,40.86581757197138,NaN,NaN,8.726375096772045,6.558075881100969
2003-04-03T09:30:00-05:00,22.69,22.72,22.2,22.27,1372500,731850,49.0793616277667,53.96872954293521,NaN,NaN,21.437341941521982,65.98449806386007,0.0041836658720884184,0.10082686051823586,0.09664319464614744,-46182904,-44934704,57.02455008751526,43.15702781124709,NaN,NaN,6.973159169554098,6.61737349373713
2003-04-04T09:30:00-05:00,22.33,22.42999,22.3,22.39,142300,675795,51.069153744661634,54.07614952098023,NaN,NaN,17.254753385712824,48.37978435840811,-0.005246974181817868,0.09008447691887511,0.09533145110069298,-46040604,-45266844,52.42999599374619,45.34984565854313,NaN,NaN,6.207091043638512,6.558761715151613
2003-04-07T09:30:00-04:00,22.60001,22.60001,22.14,22.22,272600,669240,48.19588540045026,53.43606137970157,NaN,NaN,2.184399898021871,44.24809297330073,-0.022600983100439287,0.06708022222514387,0.08968120532558316,-46313204,-45566384,48.624957425749834,47.42717751326997,NaN,NaN,4.665986796412916,6.288365298188942
2003-04-08T09:30:00-04:00,22,22.08,21.87,21.95,223900,677765,43.965063376207624,52.45874287658978,NaN,NaN,-101.61569218029268,5.557269728675419,-0.050341734468219324,0.026754037240309003,0.07709577170852833,-46537104,-45976844,43.921109822173385,48.79449254622788,NaN,NaN,1.9947082231857234,5.674985716045625
2003-04-09T09:30:00-04:00,22.07001,22.17999,21.89,21.94,398600,533975,43.81166334270974,51.2196680018421,NaN,NaN,-102.91086974099879,-32.73001333920696,-0.06643114716384294,-0.005943162246275335,0.06048798491756759,-46935704,-46401904,39.644131959882436,49.4587590995373,NaN,NaN,-0.16827487021914062,4.840234203722087
2003-04-10T09:30:00-04:00,22.10001,22.24001,22.00999,22.24001,595400,521225,49.504053774064225,50.95750527214678,NaN,NaN,-58.83663669685587,-48.78480906688253,-0.05443876892155927,-0.007560476234381497,0.046878292687177775,-46340304,-46433384,39.33860340665126,49.55810618747921,NaN,NaN,-0.3213574585554709,4.102863966253865
2003-04-11T09:30:00-04:00,22.14999,22.21001,21.96001,22.11,44300,473695,47.26918351774865,50.95891203893404,NaN,NaN,-95.71761116963569,-71.37928197795223,-0.052792723266690246,-0.01911261139618503,0.033680111870505215,-46384604,-46502184,38.63775645440686,49.36062354757951,NaN,NaN,-1.1206614017416243,3.3566460565402236
2003-04-14T09:30:00-04:00,22.16,22.28,22.00999,22.22,251300,452070,49.35256876941461,50.853693542616334,NaN,NaN,-70.28635788336582,-85.87343353422978,-0.042280644080951627,-0.01917069323068432,0.023109950850267305,-46133304,-46466204,39.247331269936744,48.98765581283057,NaN,NaN,-1.1740965313233755,2.709397115416852
2003-04-15T09:30:00-04:00,22.2,22.24001,22.02,22.16,135900,434530,48.23314652558651,50.6055558556997,NaN,NaN,-76.58510160688557,-80.86731541954835,-0.03751520411163197,-0.02378405428927266,0.01373114982235931,-46269204,-46412624,40.2000243844141,48.48096125291598,NaN,NaN,-1.5345958087921048,2.10311241195843
2003-04-16T09:30:00-04:00,22.12,22.19,21.83,21.86,3117400,569535,42.983386121487456,49.75829412713966,NaN,NaN,-128.22851360867196,-85.93084419308299,-0.05183219308749504,-0.05105909153700949,0.0007731015504855478,-49386604,-46902804,34.82032457182946,47.42970547894669,NaN,NaN,-3.416615650525194,1.3145798316036266
2003-04-17T09:30:00-04:00,21.92999,22.31,21.81,22.3,399200,536870,51.34742141106351,49.27579001633445,NaN,NaN,-55.71994577584467,-85.30750600888075,-0.030015951340604065,-0.036746837625269535,-0.0067308862846654684,-48987404,-47432224,30.13039808428472,45.79970865630131,NaN,NaN,-2.4720945811440767,0.7736263440682404
2003-04-21T09:30:00-04:00,22.33,22.42999,22.2,22.28999,423800,552555,51.16353861745405,49.28930397424794,NaN,NaN,11.099624380951937,-63.94405889876323,-0.015345918505578633,-0.02591328441663876,-0.010567365911060127,-49411204,-48037544,25.84425554213756,43.61444175408044,NaN,NaN,-1.7794344782273361,0.4089033694545866
2003-04-22T09:30:00-04:00,22.28999,22.7,22.14999,22.60001,195600,533465,56.374342815140984,49.20731441365024,NaN,NaN,73.92997534660333,-35.100792252769395,0.014534525070273587,0.007600790426781856,-0.006933734643491731,-49215604,-48654004,22.356332719239276,40.95758971906554,NaN,NaN,0.4605904785887923,0.4162872421880446
2003-04-23T09:30:00-04:00,22.72,22.75,22.38,22.60001,490400,538665,56.374342815140984,49.19450798992118,NaN,NaN,98.60678002493087,-0.06241592640610918,0.03256429793709317,0.03377163777787473,0.0012073398407815607,-49215604,-49243284,19.62919642071556,37.98921201019165,NaN,NaN,2.245977479057535,0.6776715617408289
2003-04-24T09:30:00-04:00,22.49001,22.7,22.44,22.52,191100,530215,54.62967360305349,49.59095884529881,NaN,NaN,80.80074398998067,41.74343559332442,0.03704087759853725,0.047508436838953116,0.010467559240415873,-49406704,-49247304,19.611620875611464,35.31685992362709,NaN,NaN,3.2435806154832285,1.044229997989743
2003-04-25T09:30:00-04:00,22.39999,22.39999,22.12,22.24001,357500,505925,48.92365205471193,49.43770872458811,NaN,NaN,-19.76620529360939,48.93418368977147,0.019941228561886334,0.03539409494277379,0.015452866380887456,-49764204,-49402664,18.90704497756606,32.92236342247137,NaN,NaN,2.4528100144714315,1.245455714629984
2003-04-28T09:30:00-04:00,22.28999,22.56,22.28,22.34,403800,505375,50.896160993927516,49.63058555269363,NaN,NaN,36.204507941766884,53.955160401934464,0.014418395040459088,0.033475860181461314,0.019057465141002226,-49360404,-49392504,19.11170788450174,30.81427416952507,NaN,NaN,2.360596630802902,1.4047615597975438
2003-04-29T09:30:00-04:00,22.34,22.34,21.94,22.03,230800,495135,45.083125567663494,49.71044713779763,NaN,NaN,-65.20971330574659,26.127222671464484,-0.009756265164411786,0.006862133685487493,0.01661839884989928,-49591204,-49467624,18.735211196775893,29.01528141056811,NaN,NaN,0.5096048239571662,1.2768820261060614
2003-04-30T09:30:00-04:00,22,22.2,22,22.13,51100,481155,47.178917809762204,49.95096531401566,NaN,NaN,-56.847769565757694,-4.963687246673233,-0.018166774686823692,-0.006090069508630336,0.012076705178193356,-49540104,-49532524,18.39799688147434,27.497700333538965,NaN,NaN,-0.4081650479829016,1.0361610155219239
2003-05-01T09:30:00-04:00,22.32001,22.32001,21.98,22.24001,441100,486930,49.463790108951095,49.948089337936146,NaN,NaN,-23.401870186790873,-25.804210082027545,-0.015575506587857812,-0.00739267805662891,0.008182828531228903,-49099004,-49470984,19.87077002970298,26.10714080661409,NaN,NaN,-0.5176875311071436,0.8141826517177714
2003-05-02T09:30:00-04:00,22.32001,22.67999,22.32001,22.59,455400,441075,55.986769919593584,50.57077408092507,NaN,NaN,118.85704156703723,1.9204392901017855,0.009126086721795598,0.0195904369334734,0.010464350211677801,-48643604,-49246864,25.167787768223704,25.14500018617244,NaN,NaN,1.399993881557884,0.8978699702663588
2003-05-05T09:30:00-04:00,22.67999,22.77,22.53999,22.73,426500,455285,58.30514104438204,51.21024352913703,NaN,NaN,157.55469186870874,26.190476075490153,0.03296923376386429,0.05167589241650816,0.018706658652643874,-48217104,-49018204,30.235035145248673,24.501264748694723,NaN,NaN,3.7095357219484906,1.299536506220949
2003-05-06T09:30:00-04:00,22.78999,22.85001,22.55,22.7,542200,468765,57.60491675306964,51.87965568824297,NaN,NaN,140.10921847621606,67.25426243188268,0.04410027974765818,0.07383200833721659,0.02973172858955842,-48759304,-48851824,33.75033835737082,24.0405728896202,NaN,NaN,5.382956357108934,1.8828821992049467
2003-05-07T09:30:00-04:00,22.64999,22.97,22.48,22.85001,553700,485255,60.18013335436261,53.10799477630549,NaN,NaN,139.25816769011925,106.47544988305808,0.05806742344449986,0.10231600789518325,0.04424858445068339,-48205604,-48584924,39.05542634892705,24.34308015941289,NaN,NaN,7.5676808347533875,2.6949962899975812
2003-05-08T09:30:00-04:00,22.73,23.05,22.7,22.88,164000,473525,60.69417245307875,53.77561985073515,NaN,NaN,148.17976772808103,140.79177746603244,0.06528825407607541,0.12585890204577765,0.06057064796970224,-48041604,-48373444,42.953443726616314,25.259011991008,NaN,NaN,9.514100637524546,3.6691540539300047
2003-05-09T09:30:00-04:00,22.94,23.10001,22.78,23.03,322100,459860,63.24956879094709,54.63890772027037,NaN,NaN,149.62469994075974,146.94530914077694,0.07541205119984715,0.15483571196951118,0.07942366076966403,-47719504,-48188624,46.192481684159155,26.712456715438112,NaN,NaN,11.932297589367206,4.849603130421033
2003-05-12T09:30:00-04:00,23,23.3,22.92,23.14,1686400,541965,65.04432366964629,55.258192067020744,NaN,NaN,162.26221002830823,147.88681277269686,0.08410007943543227,0.18454876006395438,0.10044868062852211,-46033104,-47751824,52.986511248233036,28.900326610366232,NaN,NaN,14.511577681519405,6.229885209149372
2003-05-13T09:30:00-04:00,23.10001,23.53999,23.10001,23.39999,535300,556165,68.90910217510178,56.15353202130366,NaN,NaN,184.49859439930785,156.7646879573152,0.10081308505425174,0.2264650369463368,0.12565195189208506,-45497804,-47099524,60.92188685860436,31.84980449878686,NaN,NaN,17.993427660329523,7.910391273603679
2003-05-14T09:30:00-04:00,23.42,23.52,23.25,23.5,259100,562325,70.2707425733798,57.270751233469824,NaN,NaN,171.80576046944947,163.27420651318124,0.11124054438498346,0.2647026323733144,0.15346208798833091,-45238704,-46506144,66.46675035646794,35.19659946170514,NaN,NaN,21.325938703920936,9.826898049363287
2003-05-15T09:30:00-04:00,23.60001,23.60001,23.41,23.50999,780900,445500,70.41014768749542,58.80550092152579,NaN,NaN,161.55314878821312,165.94888272520765,0.1111833146257678,0.29244123127054067,0.18125791664477287,-44457804,-45789384,71.691847201758,38.96694247771885,NaN,NaN,24.10084186703045,11.866032880458595
2003-05-16T09:30:00-04:00,23.63,23.67999,23.39999,23.59,1007900,475935,71.56037067246814,60.28151589856441,NaN,NaN,146.76993679964207,165.37793009698413,0.10877258850210447,0.31722365227240346,0.20845106377029898,-43449904,-44935464,76.40821451545663,43.05955009421563,NaN,NaN,26.791868221268842,13.998295072002916
2003-05-19T09:30:00-04:00,23.55,23.56,23.33,23.35001,174400,463465,63.57721982398725,61.60252263115897,NaN,NaN,106.13457915922294,154.1524039231671,0.08434354354566728,0.3138804932023831,0.2295369496567158,-43624304,-44453704,78.57680962004693,47.333949981592134,NaN,NaN,26.969122110011156,15.85127036314695
2003-05-20T09:30:00-04:00,23.39,23.39999,23.14,23.25999,264500,466910,60.83570350683238,62.57800732380684,NaN,NaN,72.63936656651086,131.78055835660768,0.05677295286031636,0.30050314073211126,0.2437301878717949,-43888804,-44131904,79.90553174227429,51.72734532879213,NaN,NaN,26.339345282626585,17.34956678021547
2003-05-21T09:30:00-04:00,23.19,24,23.19,23.95,1252200,505000,71.11673425558152,64.1246461914233,NaN,NaN,125.53881953664141,122.52717017004606,0.07832889336004234,0.3416413045718478,0.2633124112118055,-42636604,-43611484,81.86451943986134,56.15547028666059,NaN,NaN,29.208766164358817,19.043738120807376
2003-05-22T09:30:00-04:00,23.95,24.00999,23.85001,23.89999,239600,507425,69.6888410614191,65.10336555869655,NaN,NaN,135.2919738600601,117.27493518441547,0.08214151887638471,0.3659893098072864,0.2838477909309017,-42876204,-43295164,82.95238723242628,60.28294167696077,NaN,NaN,30.981387901857083,20.749116660957334
2003-05-23T09:30:00-04:00,23.92,24.21001,23.78999,24.12,729100,526005,72.32173315448554,66.10455070941823,NaN,NaN,134.60084852983502,114.84111753045406,0.09167794262365675,0.3984452192104726,0.30676727658681585,-42147104,-43034604,83.8136991120893,64.10998910316367,NaN,NaN,33.337164572039605,22.547409219683374
2003-05-27T09:30:00-04:00,24.03999,24.64,24,24.60001,316500,521640,77.01313658592302,67.49085212605061,NaN,NaN,161.75532577341195,125.96526685329187,0.12068565713945711,0.45762434801113727,0.33693869087168016,-41830604,-42675864,84.94174859454306,67.76651840581883,NaN,NaN,37.14146926435775,24.63227494035114
2003-05-28T09:30:00-04:00,24.56,24.62,24.25,24.31,504200,535310,69.36347689693807,68.14680523623458,NaN,NaN,144.72309563584923,140.38201266715956,0.1109610226417968,0.47563996917392615,0.36467894653212934,-42334804,-42365064,85.86110101286377,71.10978088181432,NaN,NaN,37.5512515504821,26.47784302751271
2003-05-29T09:30:00-04:00,24.42,24.42,24,24.08,487100,557110,63.93917471179362,68.37859111185706,NaN,NaN,107.81411659355007,136.8370720785413,0.08104627895234368,0.4659867952225589,0.38494051627021525,-42821904,-42402124,85.19318566108073,74.12690530570464,NaN,NaN,35.9732862445852,27.834334915665924
2003-05-30T09:30:00-04:00,24.17999,24.57001,24.14,24.48,497900,559950,68.54603701461058,68.75691027069017,NaN,NaN,125.72758555940119,134.9241944184095,0.08006535360628464,0.4850222082780711,0.40495685467178644,-42324004,-42291684,85.55383343575271,76.93843043081846,NaN,NaN,36.27232563613408,29.03976216144709
2003-06-02T09:30:00-04:00,24.60001,24.87,24.52,24.61,598300,567095,69.89225634953117,69.10319117639624,NaN,NaN,141.67622159815292,136.33926903207308,0.07985775241699972,0.5047790451930361,0.42492129277603635,-41725704,-42207404,85.83733113544162,79.28491756561905,NaN,NaN,36.96438836616581,30.17185161926405
2003-06-03T09:30:00-04:00,24.62,24.78999,24.45,24.78999,571300,574335,71.69835645195165,69.30242362474266,NaN,NaN,124.99922390671863,128.9880486587344,0.08315397166771654,0.528863757360682,0.4457097856929655,-41154404,-42072164,86.30187152011621,81.09777361286991,NaN,NaN,38.122605621721135,31.307673619615063
2003-06-04T09:30:00-04:00,24.84,25,24.66,24.95,554800,574965,73.23547237697515,69.51419003928518,NaN,NaN,131.1138713073345,126.26620379303145,0.08700892278524763,0.5544709391745251,0.4674620163892774,-40599604,-41725124,87.44032630437755,82.59588618057774,NaN,NaN,39.56015886826712,32.48660008370821
2003-06-05T09:30:00-04:00,24.89999,24.89999,24.66,24.82001,158400,555200,69.91344527356085,69.47871129543272,NaN,NaN,109.70187873055512,126.64375622043244,0.07230655986263584,0.5578452162175722,0.48553865635493637,-40758004,-41312344,88.64875704814108,83.80709402674795,NaN,NaN,39.68734589838979,33.51527805723415
2003-06-06T09:30:00-04:00,24.85001,25.13,24.66,24.77,246300,559315,68.62374820179645,69.2689525475276,NaN,NaN,106.10267137643037,122.71877338383828,0.051682889649581176,0.5501422684169128,0.49845937876733165,-41004304,-41048404,89.35409498814901,84.73179977479742,NaN,NaN,39.403443858599395,34.35644460028632
2003-06-09T09:30:00-04:00,24.64999,24.77,24.56,24.73,154900,550955,67.55039483847119,69.55275076284788,NaN,NaN,78.60507078478865,110.10454322116543,0.028950004668156115,0.5346468846025267,0.5056968799343706,-41159204,-40935104,89.6513617902428,85.52283921552569,NaN,NaN,38.863861451582174,35.00036129332859
2003-06-10T09:30:00-04:00,24.72,24.89999,24.67,24.88,70200,470145,69.47833044108182,70.1700812581514,NaN,NaN,87.20105714746849,102.54490986931542,0.018146173335968685,0.5283795966043314,0.5102334232683627,-41089004,-40922024,89.68716355806747,86.22152720236807,NaN,NaN,38.94384706026739,35.563716402891274
2003-06-11T09:30:00-04:00,25.05,25.61,24.92,25.60001,1012200,493990,76.64976847634674,70.56529798820607,NaN,NaN,144.18759209617318,105.15965402708314,0.05172094417095052,0.574884603482051,0.5231636593111004,-40076804,-40817464,89.98542446103386,86.80159184673754,NaN,NaN,41.442613478707216,36.40355884229355
2003-06-12T09:30:00-04:00,25.75,25.8,25.12,25.37,210600,491565,70.91728345760372,70.65304387364782,NaN,NaN,138.75697759323114,110.97067379961834,0.05060537864717518,0.5864203826200693,0.5358150039728942,-40287404,-40723344,90.25853808351422,87.32345976467239,NaN,NaN,41.57705923079227,37.142630326364795
2003-06-13T09:30:00-04:00,25.3,25.3,24.74001,24.94,494500,477245,61.63665170728186,69.88982377027612,NaN,NaN,77.05501617031551,105.16114275839536,0.014926827664122455,0.5544735385530473,0.5395467108889248,-40781904,-40678864,90.39189516801487,87.79333091152421,NaN,NaN,38.44426349523577,37.32857792191779
2003-06-16T09:30:00-04:00,25,25,24.62,24.92,438800,448790,61.23525555295961,68.7628322679216,NaN,NaN,51.539052631287134,99.74793912769506,-0.014413583504356065,0.5215297315084797,0.5359433150128358,-41220704,-40691164,90.0248837794857,88.15641199616297,NaN,NaN,35.90499874128405,37.125209467541545
2003-06-17T09:30:00-04:00,24.77,24.94,24.60001,24.67999,96300,444885,56.48162549745308,67.84270002510125,NaN,NaN,30.30307940856543,88.36834357991445,-0.05225097133519996,0.47062960084383576,0.5228805721790357,-41317004,-40736764,88.58882113283117,88.35124914758921,NaN,NaN,32.23309248938359,36.42633561351898
2003-06-18T09:30:00-04:00,24.60001,24.75999,24.42,24.53,180100,440665,53.67727705488876,67.10970733532233,NaN,NaN,-9.637825652056163,57.603260030268586,-0.08756664450098572,0.41342226655280356,0.5009889110537893,-41497104,-41020824,80.02502075328047,87.98209451131777,NaN,NaN,28.33663671907683,35.27066434288439
2003-06-19T09:30:00-04:00,24.59,24.85001,24.5,24.66,207600,388435,55.72895997208384,66.19420183228469,NaN,NaN,0.9662885187867114,30.045122215379696,-0.1013825600366779,0.3742607110079419,0.4756432710446198,-41289504,-41221244,74.54923482247821,87.19605175322673,NaN,NaN,25.747539871383808,33.91021798981288
2003-06-20T09:30:00-04:00,24.64999,24.64999,24.39,24.45,1209700,436940,51.74218645545662,64.89776826842224,NaN,NaN,-53.56300619905757,3.9215177415051086,-0.12246552522334353,0.3225613645154404,0.4450268897387839,-42499204,-41564704,66.19057567854543,85.79271207773415,NaN,NaN,22.321582692436163,32.2546986616162
2003-06-23T09:30:00-04:00,24.39999,24.48,24.24001,24.38,180700,409520,50.44668854057517,63.379791989038196,NaN,NaN,-99.01460402189254,-26.189213589130826,-0.13778453583337547,0.2727962199470646,0.41058075578044007,-42679904,-41856544,60.031366044998286,83.91624740094002,NaN,NaN,19.13763684545561,30.380832687878975
2003-06-24T09:30:00-04:00,24.46001,24.49001,24.32001,24.36,56800,396535,50.06102523415053,61.72447433597929,NaN,NaN,-91.55754531842501,-50.56133853452891,-0.14518284151249333,0.22910220388982339,0.3742850454023167,-42736704,-42140484,54.69838795390877,81.57753751876366,NaN,NaN,16.42886302090959,28.387694164026204
2003-06-25T09:30:00-04:00,24.5,24.78,24.3,24.39999,71000,374875,50.86980492541743,60.3642143111119,NaN,NaN,-64.67395734887805,-61.56856487389327,-0.14306944866594884,0.1954482345698807,0.33851768323582954,-42665704,-42374204,50.70538491813843,78.86729665233493,NaN,NaN,14.383201881445471,26.38705240937181
2003-06-26T09:30:00-04:00,24.35001,24.52,24.21001,24.28999,421600,371600,48.54103997322033,58.92973515192789,NaN,NaN,-115.89382710324949,-84.94058799830051,-0.14435102218350365,0.15807890550644998,0.30242992768995364,-43087304,-42733764,45.23452803281319,75.71589901266806,NaN,NaN,11.987790017311266,24.330014924791733
2003-06-27T09:30:00-04:00,24.28,24.39999,24.13,24.2,90400,351225,46.65917320531715,57.437505035274036,NaN,NaN,-138.45015511707842,-101.9180177819047,-0.14608731601339875,0.11982078267320517,0.2659080986866039,-43177704,-42869464,43.334214093562906,72.40753132004808,NaN,NaN,9.423527984949791,22.2005167905286
2003-06-30T09:30:00-04:00,24.3,24.33,24.05,24.05,92800,325950,43.623323699406775,55.59071883944011,NaN,NaN,-145.06570618009533,-111.12823821354525,-0.1515143357961013,0.0765151789414773,0.2280295147375786,-43270504,-42987584,41.69234005426454,68.979329641205,NaN,NaN,6.336784556819129,19.934269328570103
2003-07-01T09:30:00-04:00,23.89,24.11,23.67999,24.03,223300,308550,43.219541863055504,53.20284550991931,NaN,NaN,-164.26717904885106,-125.67016495963045,-0.15032850964426564,0.040118877682246534,0.19044738732651217,-43493804,-43139004,39.61996894545232,65.38179710437774,NaN,NaN,3.6396769452953706,17.606470416673712
2003-07-02T09:30:00-04:00,23.92,24.08,23.85001,24,140200,287820,42.58283642998223,51.178956436517765,NaN,NaN,-134.8265717824353,-139.7006878463419,-0.14535559029550965,0.008752899457125096,0.15410848975263475,-43634004,-43332664,37.0812917520113,61.58342236641325,NaN,NaN,1.179403626259616,15.2597465894717
2003-07-03T09:30:00-04:00,24,24.05,23.8,23.96001,159800,287890,41.700937037447964,49.754976817243914,NaN,NaN,-125.95499916541321,-141.71292225877465,-0.13857592661757462,-0.019111418519333512,0.11946450809824109,-43793804,-43473964,35.303822879599906,57.6485600600979,NaN,NaN,-1.163334458713519,12.91359215401667
2003-07-07T09:30:00-04:00,24.05,24.05,23.75999,23.8,692700,310210,38.284395856962234,48.11562969610124,NaN,NaN,-123.71260276077615,-138.7654117875142,-0.1383627852130314,-0.05348897341804815,0.08487381179498324,-44486504,-43735724,32.22240301469252,53.51981143404124,NaN,NaN,-4.188398936962874,10.470450569591021
2003-07-08T09:30:00-04:00,23.64999,23.88,23.64,23.75999,241600,314545,37.45799365223339,46.75679885001413,NaN,NaN,-126.78642272597182,-135.1095550966895,-0.13430310954586705,-0.08300507513735056,0.05129803440851648,-44728104,-44027244,29.168896196692856,49.27553108145994,NaN,NaN,-6.996972989352292,7.975104346884834
2003-07-09T09:30:00-04:00,23.95,24.07001,23.77,24,146400,318355,45.11205763371131,46.14499746278716,NaN,NaN,-84.66729266154586,-119.18957781922845,-0.10986898945380574,-0.08603820240874072,0.023830787045065034,-44581704,-44244824,27.104391253334768,45.495486117178096,NaN,NaN,-7.545949263695786,5.757810973944745
2003-07-10T09:30:00-04:00,24,24,23.42999,23.64,243400,279915,37.665982323507016,44.85478477360311,NaN,NaN,-121.61655642600105,-116.5475747479416,-0.11198626208155611,-0.11615204055688011,-0.004165778475323994,-44825104,-44483044,25.016683972941905,41.957446770782646,NaN,NaN,-10.32283273634679,3.460576158188812
2003-07-11T09:30:00-04:00,23.53,23.83,23.5,23.71001,266600,282715,39.748760571847654,43.99811149620246,NaN,NaN,-114.02036604112271,-114.1606481230835,-0.10293696938834508,-0.13283699021075535,-0.029900020822410268,-44558504,-44635984,23.751790778507015,38.92610499220848,NaN,NaN,-11.997802269665815,1.2522363827810081
2003-07-14T09:30:00-04:00,23.84,23.84,23.42,23.5,129700,264475,35.87627475638922,42.957367654474886,NaN,NaN,-120.25486250838351,-113.46910007260499,-0.10499867680748008,-0.16114836683176037,-0.05614969002428029,-44688204,-44676324,23.415490776565107,36.310685330177535,NaN,NaN,-14.646319546426135,-1.0189858928200124
2003-07-15T09:30:00-04:00,23.35001,23.55,23.2,23.3,538500,269460,32.61724569230667,41.711383401486046,NaN,NaN,-150.7692307692309,-118.2656616812568,-0.1130383376931637,-0.19744761214073492,-0.08440927444757122,-45226704,-44776044,22.564948478320375,34.0154396533498,NaN,NaN,-17.952706485188415,-3.4380888345869267
2003-07-16T09:30:00-04:00,23.27,23.38,23,23.08,105300,269910,29.448275671630896,40.18127416907272,NaN,NaN,-169.83842590350784,-135.29988832964918,-0.1254221277303842,-0.24118693411055148,-0.11576480638016727,-45332004,-44926104,21.310497769435088,31.915804857013843,NaN,NaN,-21.821770727302496,-6.064329104974865
2003-07-17T09:30:00-04:00,23.08,23.39999,22.95,23.23,177500,269780,34.14618920145607,39.15307054251814,NaN,NaN,-147.63588177134065,-140.50375339871712,-0.11598115701110548,-0.2607412526440491,-0.14476009563294365,-45154504,-44991984,20.764716541972533,30.167961179096654,NaN,NaN,-23.573844706563555,-8.565688476630392
2003-07-18T09:30:00-04:00,23.3,23.86,23.3,23.75999,161700,267485,47.45868353668555,39.21017842333016,NaN,NaN,-55.09376333622624,-128.7184328577378,-0.06884134175961903,-0.23081177283246745,-0.16197043107284842,-44992804,-45078844,20.036116056665776,28.50381131931828,NaN,NaN,-20.45517148935948,-10.264186049877404
2003-07-21T09:30:00-04:00,23.92,23.97,23.52,23.63,165200,215260,45.05304892827115,39.31230165396333,NaN,NaN,-35.50235980665968,-111.76793231739305,-0.042505246537007435,-0.21510198924410773,-0.1725967427071003,-45158004,-45172804,19.24927729808404,26.90073540816253,NaN,NaN,-18.795584212957735,-11.482957216031737
2003-07-22T09:30:00-04:00,23.55,23.75,23.39999,23.57001,126400,212545,43.945949988956414,39.36418794867053,NaN,NaN,-57.69785269539652,-93.15365670262618,-0.026024987101342434,-0.20512797658377835,-0.17910298948243591,-45284404,-45184344,19.149809125434047,25.43858113530408,NaN,NaN,-17.842171609221513,-12.391416415058847
2003-07-23T09:30:00-04:00,23.75,23.75,23.17999,23.44,556800,237545,41.56229005598681,39.29129177909944,NaN,NaN,-77.00196473089852,-74.5863644681043,-0.02099529364021885,-0.2053471065327095,-0.18435181289249064,-45841204,-45286184,18.253391190207466,24.093731095175233,NaN,NaN,-17.801340190026238,-13.164262668625618
2003-07-24T09:30:00-04:00,23.55,23.66,23.16,23.22,202000,244095,37.823604352667914,39.01433944447229,NaN,NaN,-96.81501810783655,-64.42219173540347,-0.02910135698584776,-0.22072850912480035,-0.1916271521389526,-46043204,-45463924,16.77727988672703,22.77040659568431,NaN,NaN,-18.952314622399605,-13.991127233450474
2003-07-25T09:30:00-04:00,23.10001,23.42999,23.10001,23.42999,894500,267740,43.08617432951185,39.357323621082976,NaN,NaN,-96.34791375387127,-72.67302181893248,-0.017508439836714684,-0.21351270193484595,-0.19600426209813127,-45148704,-45495104,16.524822566494223,21.64915084938443,NaN,NaN,-18.228659390678224,-14.596488970197296
2003-07-28T09:30:00-04:00,23.39999,23.46001,23.23,23.33,457700,286105,41.29391425175547,39.631317949620275,NaN,NaN,-82.25267908132123,-82.02308567386478,-0.013918597373697661,-0.21340250881525336,-0.1994839114415557,-45606404,-45584784,15.788915633374259,20.69343795200453,NaN,NaN,-18.191319454301937,-15.110036182212244
2003-07-29T09:30:00-04:00,23.2,23.37,22.96001,23,449500,303940,35.9751817529784,38.97868395813935,NaN,NaN,-132.0925831148463,-96.90203175775474,-0.030180090108304247,-0.237209024076936,-0.20702893396863176,-46055904,-45739084,14.585380269317241,19.799222881717558,NaN,NaN,-19.889502694735555,-15.792817112572717
2003-07-30T09:30:00-04:00,23,23.12,22.92,23.03,140100,299780,36.77247897273156,38.91486229022682,NaN,NaN,-135.71192299086715,-108.64402340974848,-0.03498841533600067,-0.2507644531386326,-0.21577603780263194,-45915804,-45754004,14.470517785443818,19.045925296896264,NaN,NaN,-20.986824996993665,-16.534818238918568
2003-07-31T09:30:00-04:00,23.25,23.59,23.10001,23.2,614900,323515,41.23808290475255,39.02124245686288,NaN,NaN,-56.202770511180375,-100.52157389041723,-0.023351838090825222,-0.24496583541616346,-0.22161399732533824,-45300904,-45605544,21.126566761742424,18.858409295698795,NaN,NaN,-20.539233841836136,-17.106877610763934
2003-08-01T09:30:00-04:00,23.25,23.25,22.96001,23.14,428600,336955,40.159993705048066,39.32722238176708,NaN,NaN,-97.60668852878567,-100.7733288454001,-0.016642762289538482,-0.24241745018726135,-0.22577468789772287,-45729504,-45721704,19.826463771069868,18.602050223877708,NaN,NaN,-20.489711428379678,-17.59013958470904
2003-08-04T09:30:00-04:00,23.00999,23.08,22.73,22.89999,251800,314910,36.09494812282841,39.57562969823292,NaN,NaN,-143.45873687638615,-113.01454040441308,-0.02482373521351583,-0.25680435691461767,-0.23198062170110184,-45981304,-45796684,19.013117142218192,18.34834798558469,NaN,NaN,-21.680854777785193,-18.174527469434203
2003-08-05T09:30:00-04:00,22.95,23.12,22.8,22.8,756300,340645,34.52696251587622,39.93839304425045,NaN,NaN,-130.92548007984362,-112.78111979741257,-0.03291631448959112,-0.27312601481309073,-0.24020970032349961,-46737604,-45933024,17.599314770079687,18.083263485630738,NaN,NaN,-23.137368640806653,-18.883504779630268
2003-08-06T09:30:00-04:00,22.75,23.25,22.75,23.2,296200,348135,44.84843375301201,40.70283908364729,NaN,NaN,-79.8546312471151,-101.60966144866214,-0.00854604729042674,-0.25089225943653304,-0.2423462121461063,-46441404,-46038144,16.575883208426745,17.784061104663177,NaN,NaN,-21.123633300748924,-19.203523139790075
2003-08-07T09:30:00-04:00,23.2,23.78,23.16,23.78,490000,360465,55.743077102942635,41.29458148123708,NaN,NaN,81.927584969889,-73.98359035244826,0.046400431150675464,-0.18434567320776196,-0.23074610435843743,-45951404,-46168244,15.383553561018957,17.451735212116976,NaN,NaN,-15.242597097049654,-18.63767656225573
2003-08-08T09:30:00-04:00,23.95,23.95,23.63,23.85001,653700,379820,56.851082409475694,42.13729815846598,NaN,NaN,151.0362318840595,-24.25500626987923,0.08497897490514042,-0.12452238572701191,-0.20950136063215233,-45297704,-46081884,19.521814405096194,17.471202148332132,NaN,NaN,-10.34121335862229,-17.45246753316524
2003-08-11T09:30:00-04:00,23.95,24.14999,23.88,23.96001,302700,388470,58.604676980054045,43.18435008640153,NaN,NaN,184.64829805206975,41.36640071581194,0.11363444738876133,-0.06745830139620068,-0.181092748784962,-44995004,-45884624,28.16387052304546,18.115063676732944,NaN,NaN,-5.849687288782565,-15.79492749825343
2003-08-12T09:30:00-04:00,24.00999,24.14,23.86,24.13,1019500,412520,61.22710110330868,44.58897944692451,NaN,NaN,159.9664900896636,99.54479474971339,0.13813758958407293,-0.008420761804870835,-0.14655835138894377,-43975504,-45332204,45.73726425034678,20.078197466742893,NaN,NaN,-1.288220615992349,-13.722540800787561
2003-08-13T09:30:00-04:00,24.25,24.28999,24.08,24.11,218500,418180,60.73955625109357,46.225833153954916,NaN,NaN,157.2948906542015,146.97469912997673,0.14631407493753865,0.036334242282979545,-0.1099798326545591,-44194004,-44882724,55.31567721323657,22.830940132922144,NaN,NaN,2.187408825165984,-11.44969085422277
2003-08-14T09:30:00-04:00,24.33,24.33,24.05,24.2,739700,446290,62.19830128726856,47.59098507950897,NaN,NaN,140.68798229137354,158.72677859427364,0.1505151668560753,0.07816412591553501,-0.07235104094054028,-43454304,-44383304,63.10796116928449,26.158307175978592,NaN,NaN,5.502753323001329,-9.027913114619327
2003-08-15T09:30:00-04:00,24.25,24.3,24.13,24.28,236400,450025,63.496643415079134,49.176894305460664,NaN,NaN,130.6755488946747,154.65464199639666,0.15102309985589185,0.11642783387932454,-0.034595265976567306,-43217904,-43967344,68.09793937071785,29.894666014360276,NaN,NaN,8.645599698230763,-6.503125569926457
2003-08-18T09:30:00-04:00,24.3,24.37,24.2,24.28,106800,447105,63.496643415079134,51.142712995610715,NaN,NaN,123.34038314914122,142.39305901581096,0.14373998040784736,0.1450797095332419,0.0013397291253945398,-43217904,-43611924,71.6290754661188,33.969215671274675,NaN,NaN,11.219716173686264,-3.97129103512464
2003-08-19T09:30:00-04:00,24.28,24.34,24.06,24.17,262000,453885,60.199464415899065,52.81606909869411,NaN,NaN,94.81663055151688,129.36308710818162,0.12460781786860191,0.15709950146114693,0.03249168359254502,-43479904,-43512804,72.54186544455492,38.117169075496896,NaN,NaN,12.564399821923963,-1.6090494841176968
2003-08-20T09:30:00-04:00,24.12,24.38,24.10001,24.28,374800,444785,62.30728600999657,54.32101217764011,NaN,NaN,91.65791223737824,116.23569142481696,0.11280772386600513,0.17350133842505144,0.06069361455904631,-43105104,-43295024,74.48429937688103,41.928435690863935,NaN,NaN,14.303094478300856,0.6641139390849538
2003-08-21T09:30:00-04:00,24.45,24.60001,24.37,24.50999,403400,454855,66.32313638069738,56.18980808304365,NaN,NaN,110.29653791954031,110.15740255045031,0.11362217866288492,0.20272133788765245,0.08909915922476754,-42701704,-43144504,75.76061398978179,45.92373213505765,NaN,NaN,17.031287515813037,3.0022815929032514
2003-08-22T09:30:00-04:00,24.60001,24.60001,24.13,24.13,361100,428185,55.753907114047955,57.594019439559325,NaN,NaN,74.97171794322452,99.01663636016028,0.0831140266925062,0.19299169259040028,0.10987766589789408,-43062804,-43113484,76.02675350519404,49.99613473241306,NaN,NaN,16.279132469101,4.898974575217215
2003-08-25T09:30:00-04:00,24.22,24.23,24.05,24.13,114500,411025,55.753907114047955,59.110229768000174,NaN,NaN,50.66412039298882,84.48138380892979,0.05863339975376228,0.18316941559009692,0.12453601583633464,-43062804,-43082464,76.30690581732921,54.18953409293089,NaN,NaN,15.681303825064289,6.439307325195369
2003-08-26T09:30:00-04:00,24.13,24.2,23.86,24.14999,258000,401450,56.179957585203184,59.919624327442406,NaN,NaN,37.793878158814884,73.07683333038939,0.04035610137009035,0.1749811425489476,0.13462504117885724,-42804804,-42947444,77.53736994874703,58.54392600295376,NaN,NaN,15.310451442931944,7.7066136277291655
2003-08-27T09:30:00-04:00,24.25999,24.37,24.22,24.25,159500,402420,58.341222299273745,60.10520612718034,NaN,NaN,63.1840724467996,67.38206537227367,0.03193976506983648,0.17454974751615282,0.14260998244631634,-42645304,-42855484,78.36161722172923,63.04235912157593,NaN,NaN,15.589173067960033,8.832693547762146
2003-08-28T09:30:00-04:00,24.21001,24.66,24.10001,24.64999,532700,398310,65.64039614411132,60.733014251082885,NaN,NaN,87.4890161762414,62.82056102361388,0.049216512627757114,0.20413062323101272,0.1549141106032556,-42112604,-42737664,79.4043594397673,67.31968376690958,NaN,NaN,18.127648508736144,10.160544256472717
2003-08-29T09:30:00-04:00,24.58,24.7,24.45,24.67999,150600,384410,66.11987449051017,61.26981407325833,NaN,NaN,109.28468886196295,69.68315520736157,0.05796743991112305,0.22737341049215942,0.16940597058103637,-41962004,-42517504,81.22504575182822,71.10976771182263,NaN,NaN,20.314180251680064,11.61106368435948
2003-09-02T09:30:00-04:00,24.61,24.84,24.46001,24.84,389300,391285,68.63401923067565,61.79887965378454,NaN,NaN,132.03754011152836,85.95783915106946,0.06908062510233809,0.25575675195895897,0.18667612685662088,-41572704,-42219484,83.36836317144605,73.79770334904401,NaN,NaN,22.950494743057533,13.23098240703063
2003-09-03T09:30:00-04:00,24.74001,24.92999,24.72,24.85001,173400,362140,68.79004990160139,62.3739149145351,NaN,NaN,164.76035917259333,111.35113535382516,0.07136175796343075,0.2758783243109093,0.20451656634747856,-41399304,-41938384,85.09656372474737,75.92490952843764,NaN,NaN,25.133064976685855,14.931279916981376
2003-09-04T09:30:00-04:00,24.89,24.89,24.72,24.81,216000,358130,67.34795229208129,62.74174712916459,NaN,NaN,153.06787262048627,129.3278953885625,0.06463274334975933,0.2853074955346777,0.2206747521849184,-41615304,-41732384,86.22611670028483,77.57620635208052,NaN,NaN,26.561285954880702,16.592709350966995
2003-09-05T09:30:00-04:00,24.78999,24.8,24.62,24.7,71700,337215,63.41200448103789,62.73570149101879,NaN,NaN,108.0308723599231,133.43626662529883,0.04799517953313259,0.28066872660133413,0.23267354706820154,-41687004,-41647264,86.67550326250769,78.90317520149408,NaN,NaN,26.716799685761313,18.039007970223327
2003-09-08T09:30:00-04:00,24.77,25.05,24.7,25.03999,277600,318410,69.37034342624774,63.15525149181654,NaN,NaN,146.24044124108318,140.82741710112288,0.05462721744286014,0.3009575688717767,0.24633035142891657,-41409404,-41536744,87.25684895415526,80.01944473635383,NaN,NaN,28.670562594504702,19.55780148797781
2003-09-09T09:30:00-04:00,25.02,25.02,24.7,24.77,1171600,361855,60.890251259081666,63.20459340918673,NaN,NaN,105.2724273914503,135.47439455710727,0.036444523467415,0.29188600576318535,0.25544148229577035,-42581004,-41738404,80.36677688369869,80.57836698200695,NaN,NaN,27.677354298727803,20.717737603799236
2003-09-10T09:30:00-04:00,24.77,24.78,24.5,24.50999,674400,344600,54.039123307954696,62.61401035904088,NaN,NaN,38.820098167936145,110.28634235617582,0.004215438995210541,0.2607107810397835,0.25649534204457297,-43255404,-42109624,69.48907707089997,80.2215653887226,NaN,NaN,24.524001704998085,21.261489618256213
2003-09-11T09:30:00-04:00,24.67999,24.7,24.42999,24.46001,106700,339010,52.80909828062879,61.648721923321695,NaN,NaN,16.48753844393193,82.97027552086497,-0.021734132959033814,0.22932767584578073,0.25106180880481455,-43362104,-42458984,61.10655315227291,79.17484675747197,NaN,NaN,21.62638433447341,21.31361743485867
2003-09-12T09:30:00-04:00,24.55,24.55,24.31,24.49001,116700,307860,53.493372513873204,61.487255166166356,NaN,NaN,-10.722339066278883,59.21963323562458,-0.037233835442405466,0.20451951450180772,0.2417533499442132,-43245404,-42770664,54.75994479808115,77.65578899267817,NaN,NaN,19.4969570177758,21.054094518132548
2003-09-15T09:30:00-04:00,24.42,24.48,24.31,24.33,218800,306980,49.380563819044305,61.032016359380385,NaN,NaN,-37.22277386407707,22.526990214592523,-0.05741237303221419,0.16998788365394546,0.22740025668615965,-43464204,-43181624,47.72197185171236,75.61400799513412,NaN,NaN,16.411550667757403,20.390873968078957
2003-09-16T09:30:00-04:00,24.39999,24.42999,24.25,24.37,71700,305225,50.40705675037397,60.61966629974973,NaN,NaN,-46.25400147347133,-7.778295558391808,-0.06657069618708814,0.1441868864522995,0.21075758263938763,-43392504,-43343924,45.248578537522334,73.3076657514752,NaN,NaN,14.175758229833047,19.503000291186684
2003-09-17T09:30:00-04:00,24.36,24.37,24,24.05,169400,300595,42.91027852560803,59.51745603020218,NaN,NaN,-111.006498705053,-37.74361493298962,-0.09116429888986713,0.09680220902705372,0.18796650791692085,-43561904,-43405224,44.31436539067997,70.87571919211454,NaN,NaN,9.727089452370192,18.106441599927184
2003-09-18T09:30:00-04:00,24,24.21001,23.89,24.14999,375600,300635,45.63124973939901,58.08823128700845,NaN,NaN,-121.29008005554927,-65.29913863288587,-0.09713263598494459,0.06655071293574011,0.1636833489206847,-43186304,-43370064,45.01558446694793,68.41937812262745,NaN,NaN,6.87342144354942,16.50172443473036
2003-09-19T09:30:00-04:00,24.05,24.25,24.00999,24.25,173200,289125,48.2861280589578,56.81439225618328,NaN,NaN,-84.87521446790845,-80.12971371321179,-0.09089148605713976,0.05006899134926002,0.14096047740639978,-43013104,-43323604,45.98353186302754,65.90212713057025,NaN,NaN,5.2856500047207815,14.899428087586134
2003-09-22T09:30:00-04:00,24.17,24.25999,24,24.11,177700,279955,44.97528576849841,55.124482723170615,NaN,NaN,-92.60085273709876,-91.20532948781613,-0.09243455500338578,0.025417283652167555,0.11785183865555333,-43190804,-43268924,47.162463673188,63.31599145212324,NaN,NaN,2.9319074385843593,13.18978228058588
2003-09-23T09:30:00-04:00,24.28,24.28,24.12,24.25,56300,277045,48.75900051671938,53.69369348139333,NaN,NaN,-69.1821086544773,-95.79095092401732,-0.08069610839315505,0.01698170316410952,0.09767781155726457,-43134504,-43217324,48.30898836558515,60.68830749789737,NaN,NaN,2.0590716201932238,11.599680757672644
2003-09-24T09:30:00-04:00,24.35001,24.63,24.3,24.37,325200,280405,51.81736361669488,52.58436571886573,NaN,NaN,-14.743297149578668,-76.53831061292246,-0.062340844428191794,0.019751756022024836,0.08209260045021663,-42809304,-43066804,51.607713909256454,58.21556444139534,NaN,NaN,2.2361568481642506,10.262034484885731
2003-09-25T09:30:00-04:00,24.35001,24.42,24.14999,24.14999,111500,278005,46.35462542128108,51.36598150031167,NaN,NaN,-71.73220383145271,-66.62673536810314,-0.062357057281954315,0.004146278847773743,0.06650333612972806,-42920804,-43013704,52.753196718623606,55.79254254540363,NaN,NaN,0.7053244959457379,8.896790200751447
2003-09-26T09:30:00-04:00,24.10001,24.10001,23.78,23.92999,204000,261570,41.62864134292432,49.38443135150287,NaN,NaN,-139.33392058517023,-77.5184765915555,-0.07374454346273504,-0.02567734319869075,0.04806720026404429,-43124804,-43036044,52.19343697189446,53.288013118099286,NaN,NaN,-2.1334311617762345,7.321044291818921
2003-09-29T09:30:00-04:00,23.92999,24.06,23.8,24.05,95000,258790,44.92713953680651,48.244209085626075,NaN,NaN,-115.2205084380046,-82.04240773173667,-0.06979565001801491,-0.039177362258474346,0.030618287759540563,-43029804,-43003844,52.96808238763524,51.3309635112376,NaN,NaN,-3.4567268068195536,5.781362706299139
2003-09-30T09:30:00-04:00,24.08,24.2,23.75,24.05,108100,244730,44.92713953680651,47.59335310197263,NaN,NaN,-97.37592641388096,-87.6811712836174,-0.06394089788884356,-0.04930783460151389,0.014633063287329672,-43029804,-42982904,53.495813830515296,50.18858756549583,NaN,NaN,-4.510142818745036,4.311147631292828
2003-10-01T09:30:00-04:00,24,24.44,24,24.39999,155700,243845,53.76410715896035,47.661568021853455,NaN,NaN,-21.47642745124136,-89.02779734394994,-0.034717227840260066,-0.02876347151299541,0.005953756327264656,-42874104,-42995864,53.09869803264011,49.61659791409348,NaN,NaN,-2.647862230718801,3.317003365291167
2003-10-02T09:30:00-04:00,24.39999,24.57001,24.25999,24.56,113600,238725,57.14941782206488,47.92271411529572,NaN,NaN,36.171002827777336,-67.44715601210393,-0.004423278031989468,0.0004246587872778207,0.004847936819267288,-42760504,-42963804,54.008235588632566,49.562904399132876,NaN,NaN,0.005993378031352849,2.844001938539765
2003-10-03T09:30:00-04:00,24.63,24.94,24.61,24.7,628800,266580,59.91488202151887,48.67516541547247,NaN,NaN,119.25716683418922,-15.728938528232046,0.023686533579936532,0.03445610379418795,0.010769570214251421,-42131704,-42765184,59.27711671180288,50.38827188913934,NaN,NaN,3.1008796744437643,2.880698757954622
2003-10-06T09:30:00-04:00,24.8,24.89999,24.75,24.85001,76900,256545,62.69316560054173,49.55274461905588,NaN,NaN,148.26452455073778,36.96806806951643,0.04953863532371601,0.07269286436889644,0.023154229045180427,-42054804,-42570184,63.67677590433915,51.704571701054824,NaN,NaN,6.5838177306635135,3.4097157540558922
2003-10-07T09:30:00-04:00,24.72,24.97,24.58,24.97,579000,226915,64.79504011953887,51.11594187576522,NaN,NaN,149.77563594727823,86.39838054174825,0.07059172353092619,0.11139388345883816,0.040802159927911974,-41475804,-42259384,69.35895779753773,53.493471158687576,NaN,NaN,10.140518638921986,4.371259023322477
2003-10-08T09:30:00-04:00,24.85001,24.96001,24.64999,24.8,308500,208620,59.6660243065139,52.11842577341629,NaN,NaN,129.71406054502242,116.63647814100102,0.06886586820570675,0.1268844951850454,0.05801862697933866,-41784304,-42041424,72.59651207276245,55.46353741624576,NaN,NaN,11.591942215555916,5.402785193641539
2003-10-09T09:30:00-04:00,24.85001,24.88,24.64999,24.72,230700,214820,57.36477679442814,52.76690068309274,NaN,NaN,105.87227389149402,130.57673235374438,0.0585397150636351,0.13119327080888254,0.07265355574524744,-42015004,-41892324,74.57553521027572,57.505823369620636,NaN,NaN,12.09372809713123,6.358634179854352
2003-10-10T09:30:00-04:00,24.8,25.03999,24.78999,24.89999,228300,220400,61.00852968614812,53.91213239149629,NaN,NaN,129.2413087934579,132.5735607455981,0.0598229064402407,0.1474321887955483,0.08760928235530761,-41786704,-41823324,75.45881184854885,59.52699109643212,NaN,NaN,13.643361205786706,7.39930946927326
2003-10-13T09:30:00-04:00,25.05,25.08,24.86,25,541000,236510,62.90553780020159,54.922599340316445,NaN,NaN,124.18258733549816,127.75717330255017,0.06307485778159647,0.1664528545823032,0.10337799680070672,-41245704,-41661504,77.438432533455,61.607665679851394,NaN,NaN,15.506865047846025,8.557531694783655
2003-10-14T09:30:00-04:00,24.89999,24.94,24.71001,24.89999,674300,266640,59.77373331780124,55.490911461824055,NaN,NaN,84.84628962907746,114.77130403891002,0.0544817475883059,0.1714801812860891,0.1169984336977832,-41920004,-41750344,73.91334201150471,63.20092483001198,NaN,NaN,16.14850813476749,9.641956900495632
2003-10-15T09:30:00-04:00,24.95,24.99001,24.46001,24.53999,556200,285980,50.10386150749101,55.75871403941047,NaN,NaN,41.400394695341475,97.10857086897383,0.022198717998612214,0.14474683119604848,0.12254811319743626,-42476204,-41888724,68.66975276920454,64.33782169076777,NaN,NaN,13.607972205849878,10.208530515546238
2003-10-16T09:30:00-04:00,24.64999,24.85001,24.63,24.8,113800,272890,55.680556219955314,56.76242224491268,NaN,NaN,55.251039947260104,86.98432408012705,0.016276630012461046,0.14289390071301256,0.1266172707005515,-42362404,-41958204,66.13290396189421,65.33349790433918,NaN,NaN,13.259636672453388,10.644402823675831
2003-10-17T09:30:00-04:00,24.7,24.85001,24.53999,24.63,100800,269270,51.61838781846116,57.24036855074515,NaN,NaN,32.6652728848493,67.66911689840532,-0.0002918161853289192,0.12625250046889036,0.12654431665421928,-42463204,-42093504,61.3777687801494,65.93418978951877,NaN,NaN,11.628621467712668,10.785005487109665
2003-10-20T09:30:00-04:00,24.66,24.66,24.41,24.62,138000,267285,51.38092694795363,57.701353365827096,NaN,NaN,4.127550164054084,43.65810946411651,-0.012453156809250035,0.11097787064265674,0.12343102745190677,-42601204,-42364604,53.13386216485964,65.90833609911479,NaN,NaN,10.27636638759721,10.712342758607885
2003-10-21T09:30:00-04:00,24.7,24.8,24.60001,24.7,155200,272230,53.23441036224295,57.663517880347285,NaN,NaN,32.419893531360266,33.17283024457307,-0.015442718461155774,0.10412762937546205,0.11957034783661782,-42446004,-42469804,50.30997725066943,65.70914175754545,NaN,NaN,9.711815865441372,10.569410345298383
2003-10-22T09:30:00-04:00,24.55,24.58,24.3,24.37,454400,278690,45.52470462125109,56.8331812231463,NaN,NaN,-37.88796723417469,17.31515785866984,-0.0386569140646061,0.0712492052558602,0.1099061193204663,-42900404,-42554644,48.09023713636848,65.28642758238374,NaN,NaN,6.711540135982329,10.018286029681803
2003-10-23T09:30:00-04:00,24.3,24.39999,24.09,24.33,106300,278430,44.68002980997587,55.74497749375036,NaN,NaN,-74.46871976431666,-8.62879408364552,-0.05473536248567777,0.041486916213369085,0.09622227869904686,-43006704,-42683504,44.85322842573363,64.2561498476645,NaN,NaN,4.051878952750284,9.16594216154873
2003-10-24T09:30:00-04:00,24.14999,24.32001,24.14,24.32001,129700,274715,44.45816718769265,54.44247760711829,NaN,NaN,-88.28114018059814,-32.81807669673502,-0.0634584829265221,0.01689917504089422,0.08035765796741633,-43136404,-42818144,41.69521598430765,62.68603842480511,NaN,NaN,1.8451716135956517,8.120117797555432
2003-10-27T09:30:00-05:00,24.3,24.42,24.17999,24.22,242500,282090,42.19906370479869,52.828479291779715,NaN,NaN,-95.84268070260505,-52.812122870066844,-0.07271437727590459,-0.010535313627464404,0.06217906364844018,-43378904,-42973684,38.33712581163248,60.47019328295473,NaN,NaN,-0.6826575824985901,6.8625784575477145
2003-10-28T09:30:00-05:00,24.3,24.35001,24.12,24.28999,286200,290995,44.33100480700335,51.733120756100384,NaN,NaN,-112.86280168712224,-81.86866191376335,-0.07080426108975955,-0.026326262713759263,0.04447799837600029,-43092704,-43103024,35.75809824317177,57.83887800941255,NaN,NaN,-2.2239136155614023,5.564508161389269
2003-10-29T09:30:00-05:00,24.34,24.49001,24.21001,24.24001,240300,295225,43.10823279331329,50.714796184592174,NaN,NaN,-95.54303528943426,-93.39967552481525,-0.06949046516326199,-0.0423850830780772,0.02710538208518479,-43333004,-43189544,34.10527530447942,54.94814515899852,NaN,NaN,-3.8572087030310045,4.21854860932923
2003-10-30T09:30:00-05:00,24.2,24.35001,23.75999,23.91,344200,306755,36.03962738146179,48.931303162828875,NaN,NaN,-163.784077834313,-111.26274713881453,-0.0863317801485602,-0.08080934310051546,0.00552243704804474,-43677204,-43323644,31.66244490499757,51.81983323445915,NaN,NaN,-7.572957865427152,2.5340476843640327
2003-10-31T09:30:00-05:00,24.02,24.38,23.97,24.28,151500,282890,46.61004978835445,47.76733973341122,NaN,NaN,-93.98365924332334,-112.40325095135957,-0.06879974693085403,-0.0804772466155228,-0.01167749968466877,-43525704,-43401504,30.30519702176315,48.453173555052594,NaN,NaN,-7.520033351499728,1.0977503935263528
2003-11-03T09:30:00-05:00,24.34,24.39999,24.13,24.13,278713,292980.65,43.473311407958114,46.60302388270814,NaN,NaN,-81.10988927146582,-109.45669266513171,-0.06367059977867814,-0.09126574940801646,-0.02759514962933831,-43804417,-43486606.6,28.84951552136812,45.234328805757116,NaN,NaN,-8.498329677271386,-0.27311818801618104
2003-11-04T09:30:00-05:00,24.06,24.19,24.00999,24.05,153747,271718,41.855475671874345,46.01385346587837,NaN,NaN,-103.51520505119933,-107.58717333794714,-0.06197186505440565,-0.10505998094734537,-0.04308811589293972,-43958164,-43659698.6,26.103134650648357,42.1938560830031,NaN,NaN,-9.796014990605038,-1.6335320169574463
2003-11-05T09:30:00-05:00,24.10001,24.16,23.98,24.12,374000,274993,43.8253775783112,45.16705499147522,NaN,NaN,-93.13676270000467,-107.10591882006122,-0.05279840087435089,-0.10908611698587833,-0.05628771611152744,-43584164,-43709930.6,25.34896233760277,39.28071739555371,NaN,NaN,-10.257542587215495,-2.8655335269943105
2003-11-06T09:30:00-05:00,24.10001,24.24001,23.98,24.14999,136800,270298,44.68995305878626,44.67216679435559,NaN,NaN,-77.34212871231318,-89.81752899566126,-0.041853815725471005,-0.10860498576836619,-0.06675117004289519,-43447364,-43663962.6,27.415677244619346,36.85485371444442,NaN,NaN,-10.38246121916988,-3.939380340162249
2003-11-07T09:30:00-05:00,24.24001,24.32001,24.16,24.21001,219000,269833,46.46577129436351,44.32108424767058,NaN,NaN,-45.80202850445336,-80.18120284788725,-0.02836102174757979,-0.10220244722736993,-0.07384142547979014,-43228364,-43604494.6,30.111329756563663,35.210387113851844,NaN,NaN,-9.984851354353859,-4.803019056475336
2003-11-10T09:30:00-05:00,24.25,24.36,24.11,24.17,98700,247718,45.4189116669482,43.76283434086382,NaN,NaN,-45.788949994659035,-73.1170149925259,-0.020297414805052733,-0.09921319398610606,-0.07891577918105333,-43327064,-43509024,34.3280244963327,34.06881905997064,NaN,NaN,-9.935690208113753,-5.536257792423681
2003-11-11T09:30:00-05:00,24.25999,24.25999,24.05,24.16,222700,225138,45.145143799118955,43.73572285356867,NaN,NaN,-60.87196924708121,-64.58836783170227,-0.01409799471061246,-0.0965382725693189,-0.08244027785870645,-43549764,-43427344,37.786470396630925,33.332835721417965,NaN,NaN,-9.966046952114947,-6.169084815236719
2003-11-12T09:30:00-05:00,24.10001,24.34,24.10001,24.3,240400,209348,49.71494588032703,44.0953597157366,NaN,NaN,-23.428194072815188,-50.64665410626437,0.00021278709166497323,-0.08217429399412524,-0.08238708108579021,-43309364,-43372384,40.07331593410965,32.991413400587675,NaN,NaN,-8.748427855298099,-6.537562392388344
2003-11-13T09:30:00-05:00,24.3,24.59,24.3,24.52,139200,210618,55.92824151350476,44.91465073900889,NaN,NaN,86.06144366705094,-17.965939630391553,0.023962346560295278,-0.05243414788542111,-0.07639649444571639,-43170164,-43316944,42.374380367024486,33.0399251422103,NaN,NaN,-5.801061669244097,-6.432348003367737
2003-11-14T09:30:00-05:00,24.58,24.71001,24.48,24.57001,469500,229053,57.222200161302084,45.98773191447342,NaN,NaN,149.9681798949643,21.188102049491977,0.04147997815179219,-0.02454652175597616,-0.06602649990776835,-42700664,-43211404,46.57964969351005,33.6286768480587,NaN,NaN,-2.968579569553318,-5.937523941394248
2003-11-17T09:30:00-05:00,24.39999,24.44,24.16,24.32001,144500,229378,49.41202913219154,46.35066222341544,NaN,NaN,20.07340897594164,34.360573843612116,0.034932776305183856,-0.02236052952628853,-0.05729330583147239,-42845164,-43115024,50.15681114756715,34.65715634122979,NaN,NaN,-2.7020550640598535,-5.475314101775049
2003-11-18T09:30:00-05:00,24.35001,24.36,24.09,24.14999,265900,234913,44.921524345872335,46.48018304859823,NaN,NaN,-33.15751916040867,39.90346386094662,0.018669936101173852,-0.03395588570500507,-0.052625821806178925,-43111064,-43027284,53.22738039765601,36.02302099074241,NaN,NaN,-3.864046219941609,-5.245132975798843
2003-11-19T09:30:00-05:00,24.13,24.24001,24.05,24.21001,395100,231948,46.76091395499372,47.245989232421934,NaN,NaN,-51.1602192242378,34.357058830662105,0.011808109778199155,-0.03786568458342998,-0.04967379436162914,-42715964,-42908604,57.07903345857549,37.83849160171227,NaN,NaN,-4.267091274741695,-5.105412732790679
2003-11-20T09:30:00-05:00,24.02,24.28,24.02,24.14999,277900,240528,45.13755511023997,47.14081104112803,NaN,NaN,-58.336769944875236,5.477416108276874,0.0035107796670430305,-0.04528531977782535,-0.04879609944486838,-42993864,-42873344,58.18087677999615,39.829611584443185,NaN,NaN,-5.075282823307032,-5.101108460007301
2003-11-21T09:30:00-05:00,24.10001,24.2,23.89999,23.97,348600,251473,40.58708307028344,46.93465187415128,NaN,NaN,-134.35646680510453,-51.3875132317369,-0.012915543558326643,-0.06494052889277668,-0.05202498533445004,-43342464,-43001704,52.8608193045997,41.54470471181687,NaN,NaN,-7.169679036787395,-5.396618542404457
2003-11-24T09:30:00-05:00,24,24.14,23.99001,24.10001,186400,248668,44.907484358266444,47.152652494607864,NaN,NaN,-87.34740956713016,-72.87167694035125,-0.013762954256439613,-0.06922867815499956,-0.05546572389855994,-43156064,-43063884,50.45403241538606,43.28405455215528,NaN,NaN,-7.655655599777811,-5.719338122029222
2003-11-25T09:30:00-05:00,24.10001,24.38,24.06,24.24001,315500,250133,49.19208679537749,47.535988867255455,NaN,NaN,14.929887238401099,-63.2541956605893,-0.004132474708837222,-0.06063131728460647,-0.056498842575769245,-42840564,-43009784,52.48124830239325,45.222074978211744,NaN,NaN,-6.760545315669322,-5.868082006834951
2003-11-26T09:30:00-05:00,24.39,24.57001,24.28999,24.47,391100,257673,55.33719485471722,48.29650613839338,NaN,NaN,148.5252124321056,-23.31710932932064,0.017312868115543743,-0.034857757431339564,-0.05217062554688331,-42449464,-42956484,54.45828920842728,47.15369011848374,NaN,NaN,-3.984014815386673,-5.598929550913768
2003-11-28T09:30:00-05:00,24.57001,24.57001,24.38,24.47,144300,247678,55.33719485471722,48.93017924984722,NaN,NaN,142.23285117664227,16.796814894982862,0.03032245401237598,-0.01426755803141333,-0.04459001204378931,-42449464,-42847604,58.27712065658135,49.16553232562786,NaN,NaN,-1.7917347902923475,-5.055044585110708
2003-12-01T09:30:00-05:00,24.59,24.75,24.5,24.72,191000,249653,61.24618245685084,50.06069859198312,NaN,NaN,191.04376920900478,81.87686209780472,0.05324799185287493,0.02196997777230436,-0.03127801408057057,-42258464,-42630804,64.63597264408052,51.330385764752705,NaN,NaN,2.0875315431193933,-4.034676566792122
2003-12-02T09:30:00-05:00,24.72,24.94,24.67999,24.89,900400,280737.35,64.6692361067865,51.45527661395938,NaN,NaN,208.06674768255735,140.95969354774223,0.07596008564169146,0.06367209297154375,-0.012287992670147706,-41358064,-42271204,72.20330343992373,53.78873098213076,NaN,NaN,6.506214068737476,-2.528835047430751
2003-12-03T09:30:00-05:00,24.89,24.97,24.75,24.75,249700,285535,59.971306314046245,52.18787378779647,NaN,NaN,164.83399329084625,170.94051475823125,0.07739118716385046,0.08445099128466538,0.007059804120814913,-41607764,-42024644,75.99603124548852,56.35463921865782,NaN,NaN,8.711167225914043,-0.9231204369529233
2003-12-04T09:30:00-05:00,24.72,25.42999,24.72,25.35001,445800,289125,70.0225294185452,53.19460863815649,NaN,NaN,216.4971235655894,184.53489698492803,0.1124580735395592,0.1476323960452639,0.03517432250570471,-41161964,-41767144,79.18961238183722,58.9842986482873,NaN,NaN,14.726085215502954,1.3124803705407733
2003-12-05T09:30:00-05:00,25.44,25.56,25.35001,25.53,581900,311380,72.27180978333992,54.26958075401634,NaN,NaN,235.92136284354214,203.27259931830798,0.1397079442447127,0.20980925281159557,0.07010130856688288,-40580064,-41393264,82.77334460505438,61.56956257054047,NaN,NaN,20.297392263032318,4.024610640896708
2003-12-08T09:30:00-05:00,25.60001,25.85001,25.5,25.81,557500,328305,75.36809491175627,56.123585452556675,NaN,NaN,220.66815023010585,209.1974755225282,0.16669375961114136,0.2784685080808096,0.11177474846966823,-40022564,-40946084,85.90076198428515,64.12270191602033,NaN,NaN,26.03771365827362,7.169339643379124
2003-12-09T09:30:00-05:00,25.87,25.99001,25.82001,25.83,1059000,376320,75.5778727279451,58.313324622704734,NaN,NaN,196.29953659210315,206.84403330443737,0.17512690778398138,0.33068338319964496,0.1555564754156636,-38963564,-40467184,88.34174881413429,66.63087108862592,NaN,NaN,30.431772570899764,10.492544347310645
2003-12-10T09:30:00-05:00,25.95,25.97,25.75,25.85001,1183400,424355,75.79993757761378,60.38754059574902,NaN,NaN,157.61359150015085,205.3999529462983,0.17109101255169992,0.3694202411052885,0.19832922855358856,-37780164,-39701664,91.01853348752903,69.05512109069403,NaN,NaN,33.92035433737153,13.839374345890771
2003-12-11T09:30:00-05:00,25.8,26.02,25.75,25.98,531100,438890,77.24729848376957,62.68109369385828,NaN,NaN,138.7269529354703,189.84591882027448,0.1660800464165882,0.4059292865743238,0.23984924015773562,-37249064,-38919084,92.83075185481253,71.53011216746663,NaN,NaN,37.27217983122245,17.18691798665244
2003-12-12T09:30:00-05:00,26.10001,26.3,25.98,26.27,317900,447825,80.10592167521422,65.50386787992477,NaN,NaN,142.60565512515973,171.182777276598,0.17055354222201752,0.4530411679352575,0.28248762571324,-36931164,-38189304,94.03870891673515,74.47138999690488,NaN,NaN,41.17359614983876,20.613586295679056
2003-12-15T09:30:00-05:00,26.17,26.2,25.91,25.94,687400,458720,69.41792742296482,67.25461381311752,NaN,NaN,106.8546129991311,148.42006983040304,0.1407815293958813,0.45846453745809157,0.3176830080622103,-37618564,-37708504,94.67526028118118,77.63004913017595,NaN,NaN,40.92647413074858,23.515427414974702
2003-12-16T09:30:00-05:00,26.00999,26.36,26.00999,26.33,591600,481075,73.85726316574868,69.01641212528689,NaN,NaN,111.51362010316532,131.46288653261547,0.1367336416795502,0.48860006016164803,0.3518664184820978,-37026964,-37321184,95.1267063294266,80.67615327496404,NaN,NaN,42.288049806146795,26.19723061371357
2003-12-17T09:30:00-05:00,26.33,26.58,26.22,26.58,990400,517300,76.23841240574988,70.50935623607492,NaN,NaN,117.09142457147253,123.35845314687978,0.1397752176235985,0.526585440511596,0.38681022288799743,-36036564,-36972464,95.49688557886026,83.60748158713784,NaN,NaN,44.23884451724526,28.774604028503813
2003-12-18T09:30:00-05:00,26.72,27.41,26.67,27.28999,1707300,582910,81.41547985689334,72.37209087908751,NaN,NaN,153.06337929830036,126.22573841944582,0.17613779879218688,0.606982471378231,0.43084467258604414,-34329264,-36388504,96.03943308299347,86.30478961759583,NaN,NaN,48.08612190878429,31.53339229711531
2003-12-19T09:30:00-05:00,27.21001,27.25999,27,27.12,1107700,624400,77.0850184221688,73.50343630518164,NaN,NaN,137.45826743303147,125.19626088102015,0.1749194324304711,0.649493963124133,0.4745745306936619,-35436964,-36089664,96.2860384382996,88.56550860289721,NaN,NaN,49.35717232372161,34.079646586630496
2003-12-22T09:30:00-05:00,27.00999,28,27,27.14999,392700,626605,77.31427281632905,74.4066532130061,NaN,NaN,143.6982733849719,132.56499295818833,0.16257350463982057,0.6777914114934376,0.515217906853617,-35044264,-35574804,96.6706637931112,90.31317719955345,NaN,NaN,50.38573999366638,36.40908850192134
2003-12-23T09:30:00-05:00,27.11,27.11,26.82001,26.96001,752600,654915,72.37457604742907,75.29260105110487,NaN,NaN,102.39069071640677,130.7404070808366,0.12949172144538246,0.6770825586603451,0.5475908372149626,-35796864,-35328784,96.83911537528003,91.80196892310998,NaN,NaN,49.55208384292732,38.28665926492219
2003-12-24T09:30:00-05:00,26.94,27.38,26.94,27.25,173900,647835,75.00022431976147,75.64815068690605,NaN,NaN,113.0043521982966,129.9229926062014,0.11548273382014362,0.6919442544901422,0.5764615206699986,-35622964,-35246064,96.89598315918191,93.06670969292033,NaN,NaN,49.72747270537701,39.92106118498717
2003-12-26T09:30:00-05:00,27.22,27.41,27.22,27.36,338000,645180,75.9345865415745,75.9097775982085,NaN,NaN,112.70942927320004,121.85220260118135,0.1024128294156208,0.7044775574395246,0.6020647280239038,-35284964,-35437204,92.74387518990788,93.7788904489813,NaN,NaN,50.16543167325559,41.384542683311224
2003-12-29T09:30:00-05:00,27.39999,27.7,27.3,27.67999,555200,665725,78.45698684584744,76.13041273635788,NaN,NaN,119.51876233712781,118.26430158200063,0.10378432183750663,0.731795130320787,0.6280108084832804,-34729764,-35295764,92.98347703860838,94.28479866714724,NaN,NaN,51.365287943182715,42.81036343472144
2003-12-30T09:30:00-05:00,27.71001,27.92,27.63,27.74001,509200,681635,78.90364208813446,76.36796769065711,NaN,NaN,121.61422365717938,113.84749163644213,0.0973082825892374,0.7496461617198271,0.6523378791305897,-34220564,-35131024,93.26253439693143,94.63628335163276,NaN,NaN,52.45462548386167,44.18811515602719
2003-12-31T09:30:00-05:00,27.83,27.89,27.45,27.55,764800,674855,73.6944998646403,76.21757928258758,NaN,NaN,99.22661900478427,113.2146772941176,0.07007493145681998,0.7399315434516147,0.6698566119947947,-34985364,-34968724,93.53532075704932,94.81605387088419,NaN,NaN,51.75500968475541,45.26910008870265
2004-01-02T09:30:00-05:00,27.81,27.81,27.39999,27.53999,494000,687070,73.41950604960702,75.94416553729026,NaN,NaN,86.38576919200686,107.89096069285965,0.04258638118240077,0.7230895884727957,0.6805032072903949,-35479364,-34940004,93.58481852727024,94.86991577605976,NaN,NaN,51.11544520129089,46.104292247643826
2004-01-05T09:30:00-05:00,27.7,28.13,27.66,28.07001,824400,706000,78.08300357568277,75.79967138732373,NaN,NaN,110.36174219515819,107.42142327725128,0.050745262272264946,0.7439347851307261,0.6931895228584611,-34654964,-34814004,93.80878615580096,94.85349272170731,NaN,NaN,51.999883568009054,46.946519579124576
2004-01-06T09:30:00-05:00,28.10001,28.13,27.86,28.03999,691100,711460,77.25623237230946,76.35955031227691,NaN,NaN,108.01854988172839,105.1213807861714,0.044963457545239005,0.7493938447900099,0.7044303872447709,-35346064,-34937264,90.48089218237288,94.55389500036385,NaN,NaN,52.447930392569866,47.73243540961676
2004-01-07T09:30:00-05:00,27.89,27.89,27.58,27.75,1676800,767425,69.59078376801307,76.05480178386722,NaN,NaN,76.96963866198793,96.19246378713312,0.014053833904321023,0.7219976796251721,0.7079438457208511,-37022864,-35497724,77.0894315089973,93.26551822747605,NaN,NaN,50.437359192468975,48.118853092881366
2004-01-08T09:30:00-05:00,27.78,27.88,27.53999,27.83,1337100,781330,70.46151459982647,75.64216622630127,NaN,NaN,73.59580656525522,91.06630129922732,-0.0074052203724528365,0.698687320255285,0.7060925406277379,-35685764,-35637804,74.13606856385171,91.73974558354688,NaN,NaN,49.05956382542577,48.25324034038771
2004-01-09T09:30:00-05:00,27.75,28.2,27.62,27.97,2369800,840650,71.97390534947843,74.96776804720021,NaN,NaN,89.12801994202071,91.61475144923008,-0.017969983950929524,0.683630060689076,0.7016000446400055,-33315964,-35205124,77.05954368469098,90.38403919795384,NaN,NaN,48.34358441437744,48.26614663667196
2004-01-12T09:30:00-05:00,28.06,28.14,27.95,28.05,820000,855095,72.8299814238099,74.66383683303171,NaN,NaN,97.87130690004086,89.11666439020662,-0.024940697413654123,0.6704241728729379,0.695364870286592,-32495964,-34773324,79.54448318109884,89.1882138224395,NaN,NaN,47.992545640451524,48.227060780069046
2004-01-13T09:30:00-05:00,28.14999,28.33,28,28.06,1003000,889350,72.94124481302413,74.3514776899385,NaN,NaN,103.23698459014635,88.16035133189021,-0.03370370514671728,0.6532352388531955,0.6869389439999127,-31492964,-34002704,83.0692627201287,88.21668517436933,NaN,NaN,47.73479965320558,48.15673776194569
2004-01-14T09:30:00-05:00,28.05,28.05,27.81,27.99001,830200,896490,70.75723844106524,74.23595357519822,NaN,NaN,73.74907552323384,87.5162387041394,-0.04815867422755693,0.6267406012154666,0.6748992754430235,-32323164,-33062764,86.1941196982747,87.45632834029753,NaN,NaN,46.93147605246785,47.98170037487743
2004-01-15T09:30:00-05:00,28.05,28.12,27.50999,27.52,1024100,918115,58.16272810408431,73.03327527407843,NaN,NaN,29.351626063298497,78.66740260374804,-0.09084207956492107,0.5613466759868722,0.6521887555517932,-33347264,-32595064,87.43666214775395,86.78066255376696,NaN,NaN,42.324783834803156,47.173569440581105
2004-01-16T09:30:00-05:00,27.7,27.85001,27.48,27.78,355600,886375,62.17374667262395,72.05035814058196,NaN,NaN,17.829387112643044,64.4076760378725,-0.10218640699509574,0.5244557468079236,0.6266421538030194,-32991664,-32530204,87.60329008858044,86.41347790367215,NaN,NaN,39.532485614853776,46.081986036905775
2004-01-20T09:30:00-05:00,28.05,28.50999,27.95,28.48,956200,848820,70.40133885984724,71.47495471301052,NaN,NaN,151.83822722150987,75.20106010216632,-0.06498064357087174,0.5454163493394297,0.6103969929103015,-32035464,-32438104,87.84972168123132,86.04678109243093,NaN,NaN,39.74011674164689,45.17600470901165
2004-01-21T09:30:00-05:00,28.48,28.75999,28.41,28.64999,748000,830835,71.99440654313112,70.98143788836742,NaN,NaN,198.16698927731008,94.18706103959906,-0.03297090733805297,0.5691833587377353,0.6021542660757883,-31287464,-32397004,87.96469941952078,85.66836430833018,NaN,NaN,40.45246082534667,44.501212725630936
2004-01-22T09:30:00-05:00,28.8,28.85001,28.33,28.50999,425100,832455,68.71422299484871,70.62570382623946,NaN,NaN,159.07081686795445,111.25140930854317,-0.02560363379162045,0.5701497238362627,0.5957533576278832,-31712564,-32274884,88.31841877539057,85.29572845249741,NaN,NaN,39.94310676610709,43.850054731413245
2004-01-23T09:30:00-05:00,28.55,28.89999,28.55,28.75999,1697300,879690,71.23460509683754,70.4696394724702,NaN,NaN,175.62768807706087,140.50662171129565,-0.009120738356942715,0.5843524346817048,0.5934731730386476,-30015264,-31608484,90.03887339048075,85.04244665701243,NaN,NaN,40.34481700282487,43.349306484472045
2004-01-26T09:30:00-05:00,28.60001,28.99001,28.55,28.92999,683900,905190,72.83707392143334,70.0949302114524,NaN,NaN,168.25282170515436,170.59130862979794,0.00712696656520273,0.6023818812451509,0.5952549146799482,-29331364,-30876424,91.51692983437896,84.87874263405374,NaN,NaN,41.18832150887396,43.04059434510089
2004-01-27T09:30:00-05:00,29,29.11,28.8,28.87,754500,926015,71.32703533252894,69.67141613718236,NaN,NaN,158.4277477558842,171.90921273667283,0.007681858790548057,0.6048572381681332,0.5971753793775851,-30085864,-30486504,92.18231659509271,85.00027294924801,NaN,NaN,41.406188174724115,42.80710774933278
2004-01-28T09:30:00-05:00,28.85001,28.92,28.42999,28.46001,940500,945280,61.88435081384641,69.12095664045617,NaN,NaN,86.1030092819241,149.4964167375956,-0.023981979175772272,0.5671979054078697,0.591179884583642,-31026364,-30434284,92.26976658086386,86.08458259723848,NaN,NaN,38.5583529240441,42.20014277429154
2004-01-29T09:30:00-05:00,28.64999,28.72,28.3,28.44,3247100,1082175,61.45671980340833,68.47775701214059,NaN,NaN,57.60441078249783,129.2031355205043,-0.04923775002028474,0.5296326970582861,0.5788704470785708,-34273464,-30946464,82.51965672845077,86.68341032328127,NaN,NaN,36.17545608299929,41.339473246964076
2004-01-30T09:30:00-05:00,28.39999,28.48,28.11,28.17,613500,1074610,55.84877931778877,67.32596229559132,NaN,NaN,11.509425121377687,96.37948292936764,-0.08499467428259422,0.47262710422532805,0.5576217785079223,-34886964,-31920804,67.83464651579202,86.02448909693135,NaN,NaN,32.36958616442076,40.05806080660074
2004-02-02T09:30:00-05:00,28.24001,28.47,28.02,28.33,938900,1096855,58.27838625808007,66.28656264089634,NaN,NaN,9.514462146043401,64.63181101754546,-0.09782376551374339,0.435342071615743,0.5331658371294864,-33948064,-32844144,57.40839806230555,84.44334015987468,NaN,NaN,29.921368015775833,38.609961836482896
2004-02-03T09:30:00-05:00,28.14999,28.34,28.07001,28.22,434500,1077360,55.99691606260595,65.07625344443791,NaN,NaN,-5.971369717106281,31.75198752294735,-0.11261742210694936,0.39239405949579975,0.5050114816027491,-34382564,-33703484,49.745112920570776,82.06304374562055,NaN,NaN,27.215992420233054,36.98225191987578
2004-02-04T09:30:00-05:00,28.14999,28.2,27.86,28.02,536000,1069605,52.01017873692727,63.73717775128519,NaN,NaN,-44.45604877438769,5.64017591168499,-0.13335383414360447,0.33831918892324353,0.471673023066848,-34918564,-34481924,44.013576957876516,79.05014783559209,NaN,NaN,23.702392298702446,35.085129116851014
2004-02-05T09:30:00-05:00,27.99001,28.05,27.52,27.77,1040200,1037775,47.461457906519605,62.972801308602,NaN,NaN,-97.00489509337773,-25.281685263490125,-0.15961495600581588,0.2721543280595782,0.43176928406539405,-35958764,-34818984,41.76945642167541,75.78820456944364,NaN,NaN,19.25948069970352,32.82432220011566
2004-02-06T09:30:00-05:00,27.81,27.96001,27.64999,27.96001,515900,996715,50.971185893252986,62.17261839578979,NaN,NaN,-83.41307712699798,-44.266185713165264,-0.15951800252487203,0.232371780909304,0.391889783434176,-35442864,-34930164,41.02639114365012,72.46128321623432,NaN,NaN,16.541853852697216,30.498255293341597
2004-02-09T09:30:00-05:00,28,28.39999,28,28.3,739300,915190,56.56273659049568,61.18414680512182,NaN,NaN,-6.423844327838763,-47.4538470079417,-0.13297045350699,0.22567671655043853,0.3586471700574285,-34703564,-35081264,39.98529479150739,69.04239558125404,NaN,NaN,15.89777329533191,28.412472150768785
2004-02-10T09:30:00-05:00,28.35001,28.74001,28.31,28.67999,941800,921280,61.80562902525545,60.456376982416415,NaN,NaN,63.19134255987735,-33.62130455254497,-0.08838007691360411,0.2481720739154234,0.3365521508290275,-33761764,-34957104,41.30337744276655,65.70944401148587,NaN,NaN,17.066815827132633,26.791664104535048
2004-02-11T09:30:00-05:00,28.60001,29.10001,28.53,29.07001,2014100,971835,66.30154215706794,60.28404263686065,NaN,NaN,116.45315229047296,-1.439464339572845,-0.03397677952584871,0.2940811764217166,0.3280579559475653,-31747664,-34322924,47.63014474324438,62.803138723475435,NaN,NaN,19.620058258481208,25.767148983670214
2004-02-12T09:30:00-05:00,29.05,29.27,28.92,29.16,782900,969470,67.25917755568904,60.00008352677862,NaN,NaN,139.8344867761208,45.928412034326854,0.00465538203982202,0.33387718349734286,0.32922180145752084,-30964764,-33324124,55.724510041839416,60.35211277000105,NaN,NaN,21.95179511251826,25.222098430648508
2004-02-13T09:30:00-05:00,29.13,29.21001,28.89,29.09,860300,961280,65.69526416024047,59.48995425812198,NaN,NaN,118.90003786997717,86.39103503372189,0.021156540872445673,0.3556674775480779,0.33451093667563225,-31825064,-32600564,60.48884073734284,58.13582069164132,NaN,NaN,23.347767258993287,24.954336834697763
2004-02-17T09:30:00-05:00,29.3,29.39,29.22,29.34,532700,970135,68.51132590649375,59.28883215626233,NaN,NaN,155.115613665375,118.69892663236467,0.0432948303133619,0.38862947456733465,0.34533464425397276,-31292364,-31918324,64.38081381386542,56.14999906441081,NaN,NaN,25.424289973562452,25.021472997392717
2004-02-18T09:30:00-05:00,29.37,29.39,28.95,29.03,754000,960025,61.74298697979114,59.2787347395441,NaN,NaN,105.23302076221891,127.10726227283298,0.0319692688820889,0.3852962303565839,0.353326961474495,-32046364,-31575244,66.1846884587965,54.28677919854885,NaN,NaN,25.093253529037817,25.0317273590563
2004-02-19T09:30:00-05:00,29.11,29.23,29,29,420700,943660,61.11376625519705,59.25423805752901,NaN,NaN,86.05619389587453,121.0278705939133,0.018059000109925227,0.37590071161190153,0.3578417115019763,-32467064,-31719124,64.70473474168807,53.014284770922934,NaN,NaN,24.641178004890985,24.97593459417554
2004-02-20T09:30:00-05:00,29.25,29.25,28.84,28.99001,322700,938540,60.891230882764674,59.614413169313,NaN,NaN,69.34175444227608,106.92932412714435,0.004493717464043645,0.36345885833203084,0.3589651408679872,-32789764,-32084124,60.97951666796887,52.52463263893556,NaN,NaN,24.212371261898863,24.866854118136015
2004-02-23T09:30:00-05:00,29.10001,29.25,29.03999,29.22,605500,883950,64.12958647759396,60.032356042135426,NaN,NaN,85.37467148564444,100.22425085027781,0.007160500842363027,0.36791576692094097,0.36075526607857794,-32184264,-32155964,60.24434281277456,52.72720012111192,NaN,NaN,24.771217407163864,24.853191730854277
2004-02-24T09:30:00-05:00,29.14999,29.38,29.14,29.27,468100,873160,64.81175816513706,60.66198762088764,NaN,NaN,92.00238617859303,87.60160535292142,0.008358570005551569,0.3712034785855174,0.3628449085799658,-31716164,-32240724,59.335415050874225,53.41222170184788,NaN,NaN,25.424954229372553,24.93487208778546
2004-02-25T09:30:00-05:00,29.17,29.46001,29.17,29.41,979800,884425,66.72020748762515,61.71270396022321,NaN,NaN,96.88784669954917,85.93257054038746,0.014297811658951831,0.3807171731536556,0.3664193614947038,-30736364,-31978724,61.280070572585245,54.645542674327075,NaN,NaN,26.522580889883212,25.161687630942282
2004-02-26T09:30:00-05:00,29.45,29.58,29.32001,29.50999,751800,874990,68.05289341208524,63.18352078204932,NaN,NaN,101.7179643923876,89.06492463969008,0.020311451181572182,0.391808675471669,0.3714972242900968,-29984564,-31482224,64.72294587634681,56.28507763537503,NaN,NaN,27.827321161506504,25.542492421022885
2004-02-27T09:30:00-05:00,29.60001,29.75,29.50999,29.64999,515200,738395,69.87206125794435,64.53358330809871,NaN,NaN,111.67905846408797,97.53238544405245,0.028563527749968398,0.40720163397755726,0.37863810622758887,-29469364,-30818144,68.72816215986887,58.26377556510494,NaN,NaN,29.46625082530463,26.103029335920276
2004-03-01T09:30:00-05:00,29.87,30.25999,29.78999,30.22,1836400,799540,75.89143959595502,65.9142049513458,NaN,NaN,155.75962472962465,111.60937609284849,0.06516315736398476,0.46009205293256983,0.39492889556858507,-27632964,-29907884,73.21690003721649,60.63746165408416,NaN,NaN,33.019181873045724,27.091051126938197
2004-03-02T09:30:00-05:00,29.75,30.3,29.48,29.96001,1254800,815335,69.10914579459273,66.43588472058418,NaN,NaN,123.77949871343175,117.96479859981623,0.06449468999579844,0.4755472580633331,0.41105256806753465,-28887764,-29342204,75.56429299729548,63.08466990797909,NaN,NaN,33.88244859022465,28.061250764550547
2004-03-03T09:30:00-05:00,29.95,30.02,29.62,29.92,660600,826640,68.10051826957593,66.56438301433475,NaN,NaN,110.52099592288165,120.69142844448274,0.0543939568483931,0.479045014128026,0.4246510572796329,-29548364,-29104604,76.49609837326788,65.14652373869505,NaN,NaN,34.26522859603835,28.947533311905946
2004-03-04T09:30:00-05:00,30,30.00999,29.73,29.83,643500,832015,65.77502568775952,66.4583721666255,NaN,NaN,105.2259640382147,121.39302837364815,0.0355965395215147,0.4691467316815263,0.4335501921600116,-30191864,-29146064,75.95183872121935,66.59133293007933,NaN,NaN,33.896662440449326,29.654551758840714
2004-03-05T09:30:00-05:00,29.89999,30.25999,29.8,30.09,863900,823200,69.06183572434409,66.69884156406147,NaN,NaN,123.72865925807288,123.80294853244513,0.03458865133342015,0.4767860063267868,0.44219735499336665,-29327964,-29117784,76.07687027860956,67.7047636115984,NaN,NaN,34.56421418797197,30.355932105859466
2004-03-08T09:30:00-05:00,30.23,30.48,30.14999,30.22,565300,825670,70.58302805652687,66.84682028906383,NaN,NaN,145.00802644363347,121.65262887524689,0.03640859970409005,0.48770810462347924,0.4512995049193892,-28762664,-29343724,72.81937988356214,68.30751833086244,NaN,NaN,35.57634648179644,31.101705588136177
2004-03-09T09:30:00-05:00,30.12,30.2,29.86,30.02,891800,833295,65.26623820601131,67.0984810909367,NaN,NaN,93.42358835247653,115.58144680305584,0.018762764921326447,0.47475296107104725,0.4559901961497208,-29654464,-29497064,70.6096381904719,68.62358616883925,NaN,NaN,34.85120643461641,31.637348566204782
2004-03-10T09:30:00-05:00,30,30.03,29.41,29.5,481400,810275,53.898286954722764,66.58308971233139,NaN,NaN,24.00952302373255,98.27915222322602,-0.030623238367673278,0.4177111481901292,0.4483343865578025,-30135864,-29614564,68.88465792521737,68.92215211051992,NaN,NaN,30.373180099159967,31.456753070912665
2004-03-11T09:30:00-05:00,29.2,29.39,28.78,28.84,1594200,789280,43.533845016658475,65.34327643618096,NaN,NaN,-92.32636789934732,58.76868583571362,-0.1061791448480156,0.315610455497783,0.4217896003457986,-31730064,-29922204,64.44548311066609,69.16972114214114,NaN,NaN,22.382731485677294,30.160464273021898
2004-03-12T09:30:00-05:00,29.05,29.32001,28.94,29.25999,544200,777345,50.108556880028594,64.34177432206914,NaN,NaN,-62.69159533182048,21.484634917734954,-0.12501263169011895,0.2655238107331499,0.39053644242326885,-31185864,-30293784,59.46114790297862,69.1137786485843,NaN,NaN,18.2081435209937,28.452989879875012
2004-03-15T09:30:00-05:00,29.39999,29.58,29.25,29.32001,871400,777900,50.98685669025482,63.35428135957755,NaN,NaN,-28.678936799569904,-13.252757730905723,-0.1299938376670981,0.2280441453393962,0.3580379830064943,-30314464,-30604144,55.59358375704155,68.8465049847391,NaN,NaN,15.35086815488298,26.58125820487615
2004-03-16T09:30:00-05:00,29.45,29.45,29.10001,29.31,586500,780590,50.82615267453223,62.21899173007091,NaN,NaN,-46.43833640467409,-41.225142682335836,-0.13020444805878023,0.195282422933019,0.32548687099179924,-30900964,-30853444,52.632185224278594,68.22879888843148,NaN,NaN,13.09764045837315,24.655027098232864
2004-03-17T09:30:00-05:00,29.60001,29.89,29.42999,29.72,1586100,822195,56.828244820734675,61.41723111640301,NaN,NaN,23.045261069050262,-41.4179950732723,-0.10031308175981335,0.20009551879203258,0.30040860055184593,-29314864,-30689244,54.356768338368894,67.48835763571877,NaN,NaN,13.115056614663409,23.00645988629437
2004-03-18T09:30:00-05:00,29.8,30.06,29.67,30.02,520500,827185,60.61622655331746,60.75610006607252,NaN,NaN,62.9859589596898,-10.355529701464881,-0.05991264367323934,0.22551779596029675,0.2854304396335361,-28794364,-30102104,59.969168062603096,66.8627152001998,NaN,NaN,14.397204669618926,21.776566283912164
2004-03-19T09:30:00-05:00,29.89999,29.89999,29.28,29.28,584200,840260,49.15842537138343,58.84659905003169,NaN,NaN,-30.556338828762893,-3.928478400853367,-0.08127699804416261,0.18383419207833285,0.26511119012249545,-29378564,-29740644,62.98658050653756,66.13197809086559,NaN,NaN,11.387332980092088,20.292390097652152
2004-03-22T09:30:00-05:00,29.28,29.28,28.95,29,978800,858925,45.642852098758524,57.17043521461496,NaN,NaN,-116.95377647733001,-21.583446336405387,-0.11069300091021064,0.12674493898473216,0.2374379398949428,-30357364,-29749224,62.86544713729418,65.22491767229407,NaN,NaN,7.738953383748321,18.49904199566589
2004-03-23T09:30:00-05:00,29.10001,29.14999,28.57001,28.8,1202700,895655,43.26288831216508,55.39631878908562,NaN,NaN,-151.79064370555915,-42.6539077965824,-0.13825588074338999,0.06461808896570531,0.2028739697090953,-31560064,-29881044,60.92678239710618,64.1128236739968,NaN,NaN,4.036331567881019,16.432940505982337
2004-03-24T09:30:00-05:00,28.74001,28.91,28.10001,28.19,1011800,897255,36.936723955648155,53.336440093934804,NaN,NaN,-199.0968557784369,-87.08233116607983,-0.1890624963009115,-0.03345415066704405,0.15560834563386744,-32571864,-30532444,52.33753524860094,62.42608771166691,NaN,NaN,-1.4790901759841666,13.874078979987123
2004-03-25T09:30:00-05:00,28.35001,28.35001,28.00999,28.08,1014900,910410,35.91679466116882,50.968937160850864,NaN,NaN,-194.71216375145443,-138.6219557083087,-0.21943472478167095,-0.11868506034322124,0.10074966443844971,-33586764,-31490924,42.78068870943032,60.04778902815411,NaN,NaN,-6.084365954320951,11.022872560800256
2004-03-26T09:30:00-05:00,28.14999,28.64,28.14999,28.39999,775000,923400,41.01893831700226,48.85721646517054,NaN,NaN,-133.8896238895182,-159.28861272045975,-0.20746581952807344,-0.15858260997164209,0.048883209556431356,-32811764,-32177564,37.49815823623522,57.524844624773614,NaN,NaN,-8.186119528092837,8.278730833815528
2004-03-29T09:30:00-05:00,28.60001,28.83,28.49001,28.55,1410400,902100,43.29809707816704,47.28806352746737,NaN,NaN,-93.03131128877665,-154.50411968274906,-0.1799606116519261,-0.17606755500847626,0.003893056643449827,-31401364,-32386364,36.04077284246229,55.055639957058645,NaN,NaN,-9.136783627831193,5.790800196437425
2004-03-30T09:30:00-05:00,28.64999,29.19,28.55,29.07001,815400,880130,50.44654992857262,47.041510882742365,NaN,NaN,-47.464558183605256,-133.63890257835828,-0.12013671647845373,-0.14627783895461732,-0.026141122476163604,-30585964,-32191544,38.44468056511788,52.88135585990868,NaN,NaN,-7.567010044683971,3.8825415905629406
2004-03-31T09:30:00-05:00,29.12,29.47,28.99001,29.34,2080600,951130,53.70961603979565,47.768351670109304,NaN,NaN,-1.0020295090477747,-94.01993732448045,-0.05887403809301032,-0.09973367009242651,-0.04085963199941619,-28505364,-31378244,47.342379946075255,51.65970563386647,NaN,NaN,-5.199485719459107,2.585109117702648
2004-04-01T09:30:00-05:00,29.39,29.5,28.91,29,3314500,1084680,49.306388850174635,47.71105395369117,NaN,NaN,-14.538508755503418,-57.98520632529026,-0.03871500000723345,-0.089253382008458,-0.050538382001224555,-31819864,-31024864,50.678374967035516,51.03236470987054,NaN,NaN,-4.648834732524251,1.551688567670234
2004-04-02T09:30:00-05:00,29,29.17,28.94,29.13,1160100,1099490,50.961788235681276,47.70926334979305,NaN,NaN,-17.09138098447056,-34.62555774428073,-0.015293156128578525,-0.06965482716194771,-0.05436167103336918,-30659764,-30594464,54.46236206196359,50.951563160222115,NaN,NaN,-3.685359001880897,0.8035389148772154
2004-04-05T09:30:00-04:00,29.05,29.35001,29.05,29.28,541500,1098300,52.87402853524009,47.85554019698647,NaN,NaN,16.10067854770269,-12.799159776984865,0.010257148923775883,-0.04154023487864933,-0.05179738380242521,-30118264,-30337844,56.600332017524806,51.235002216882556,NaN,NaN,-2.3121542899967227,0.35843988560951
2004-04-06T09:30:00-04:00,29.28,29.42999,29.17,29.28,592000,1083310,52.874028535240086,47.573096176594,NaN,NaN,37.94498246107588,4.282748351951363,0.026206115304084808,-0.0190397396723192,-0.04524585497640401,-30118264,-30244304,57.38570854654216,51.451355088894935,NaN,NaN,-1.2103485978108555,0.13432724512088637
2004-04-07T09:30:00-04:00,29.25,29.45,28.99001,29.28,1406200,1129550,52.874028535240086,47.02008203244561,NaN,NaN,33.25785799809754,11.134725853380425,0.035241348403792574,-0.0011941694716632867,-0.03643551787545586,-30118264,-30566884,53.77184925472861,51.008689459761044,NaN,NaN,-0.3089727653604934,0.07099867219497498
2004-04-08T09:30:00-04:00,29.55,29.75,29.45,29.53999,1161800,1107930,56.542553516926155,47.54751975712723,NaN,NaN,93.32866719359102,32.70816104319931,0.055981177829737674,0.03354095441171623,-0.022440223418021443,-28956464,-29994204,58.73960397705206,50.705333993369216,NaN,NaN,1.5135446538078907,0.27707666956824867
2004-04-12T09:30:00-04:00,29.78999,30.25,29.78999,30.10001,1281200,1144780,63.18965914896874,48.80086311785653,NaN,NaN,159.75349315416025,68.07713587092547,0.1019896265949214,0.1050468098256303,0.003057183230708905,-27675264,-29397304,63.1808207679936,50.72786068127632,NaN,NaN,5.273986242771135,0.990920894311518
2004-04-13T09:30:00-04:00,30.25,30.35001,29.8,29.84,1258800,1164150,58.700342787473716,49.90353843752143,NaN,NaN,135.3405231785825,91.92510479710143,0.10885926366801188,0.13913126281572374,0.03027199914771187,-28934064,-29160464,64.7998377466906,51.004507491960915,NaN,NaN,7.120017957836764,1.8665061891008388
2004-04-14T09:30:00-04:00,29.75,29.98,29.58,29.89999,1442800,1206965,59.41674119217683,51.509253954416344,NaN,NaN,95.790553582467,103.49421902137965,0.11101087423016566,0.16903559193541895,0.05802471770525329,-27491264,-28635064,68.14609747207388,52.13369050792327,NaN,NaN,8.83109982102059,2.861448136517946
2004-04-15T09:30:00-04:00,29.89999,30.34,29.89999,30.3,934100,1174365,63.911935078423404,53.50890684136311,NaN,NaN,140.64679406985968,124.97200623573208,0.13153879201131088,0.2224482077193919,0.090909415708081,-26557164,-27922844,72.02802083354847,54.22278565964599,NaN,NaN,11.735443967866594,4.12916182671061
2004-04-16T09:30:00-04:00,30.45,30.53999,30.25,30.53999,732200,1184950,66.3221348707545,55.316278023773975,NaN,NaN,165.413122243147,139.38889724564328,0.15199660969956755,0.28090517783254043,0.12890856813297288,-25824964,-27296544,74.92220753926728,56.895932038434005,NaN,NaN,14.93691362863716,5.673126369842974
2004-04-19T09:30:00-04:00,30.55,30.67,30.33,30.47,979000,1204690,64.95956098387154,56.86352544561002,NaN,NaN,146.1060577609832,136.65941016700788,0.15120942695004785,0.3179203518205327,0.16671092487048483,-26803964,-27122284,75.6763140948831,59.72704212789263,NaN,NaN,17.158808766877694,7.313938140847934
2004-04-20T09:30:00-04:00,30.42999,30.44,29.81,29.85001,689600,1190230,54.31444731137658,57.139803830096014,NaN,NaN,78.62274305565936,125.31585414242325,0.10170320296041768,0.29383992857100694,0.19213672561058925,-27493564,-26834184,76.91241021061869,62.47473710257127,NaN,NaN,15.849340817872367,8.533281380422853
2004-04-21T09:30:00-04:00,29.64999,29.85001,29.49001,29.75,1343000,1197245,52.81104434115327,57.07562013733584,NaN,NaN,34.67606967452407,113.09295736083467,0.05720813249276854,0.26364689122654994,0.2064387587337814,-28836564,-27103244,73.17249888811313,64.31974559843111,NaN,NaN,14.329632103066062,9.361331483657597
2004-04-22T09:30:00-04:00,29.8,30.34,29.64999,30.34,459500,1169630,59.868369284845656,57.83004731124091,NaN,NaN,75.15303185886373,99.99420491863548,0.06209089839391638,0.28405238172617686,0.22196148333226048,-28377064,-27467224,68.33187554260346,65.5807099252574,NaN,NaN,15.253421181705113,10.20305858337867
2004-04-23T09:30:00-04:00,30.39999,30.39999,29.98,30.10001,1326800,1185225,56.187381638415424,58.20330398286478,NaN,NaN,74.81752739513865,81.87508594903382,0.044557232357281346,0.2776580237788622,0.23310079142158083,-29703864,-28243004,59.32387043445764,65.92796052329268,NaN,NaN,14.823342664910601,10.86309916645466
2004-04-26T09:30:00-04:00,30.3,30.5,30.14999,30.27,1103400,1201645,58.15017892172385,58.58017186761363,NaN,NaN,87.1791531283297,70.08970502250313,0.03995493567356917,0.2830444610135423,0.24308952533997313,-28600464,-28602304,55.66386316583133,65.86106989102886,NaN,NaN,15.084553510420326,11.46616407273547
2004-04-27T09:30:00-04:00,30.5,31.03999,30.45,30.89999,2551100,1258680,64.49799190957395,59.41045496578027,NaN,NaN,143.38002656543537,83.04116172445835,0.07296409075078042,0.33429463877844867,0.26133054802766825,-26049364,-28313464,57.91186644087618,65.89865259776701,NaN,NaN,17.454942477655692,12.32170384486693
2004-04-28T09:30:00-04:00,30.85001,30.89999,30.39999,30.46001,1366800,1286250,57.89343346329036,59.76898388921243,NaN,NaN,104.79579018063303,97.06510582568015,0.059367695005719034,0.335540166784817,0.276172471779098,-27416164,-28029384,60.05696925097915,66.34758974035634,NaN,NaN,17.208564576403724,13.019826806515043
2004-04-29T09:30:00-04:00,30.5,30.53999,29.53,29.73,1067900,1235615,48.93908490132916,59.22587898809836,NaN,NaN,4.057564552083377,82.84601236432407,-0.0013717595860524012,0.27445777229653245,0.27582953188258486,-28484064,-28050784,59.80967292186839,66.42402323641464,NaN,NaN,13.737837169195066,13.122399715469331
2004-04-30T09:30:00-04:00,29.89999,30.14,29.8,29.84,1252200,1132500,50.18927515798755,58.29728013159969,NaN,NaN,-3.6942646655721245,67.14365395218191,-0.03486490527217745,0.23224840029236304,0.2671133055645405,-27231864,-27556384,63.544470280866136,66.44999820161982,NaN,NaN,11.48961237810483,12.889144381560117
2004-05-03T09:30:00-04:00,29.92999,30.59,29.8,30.53,2239600,1186475,57.25859176063831,58.194297915397165,NaN,NaN,59.04539178517479,61.51690168355093,-0.01243111715749412,0.2515744091176728,0.26400552627516694,-24992264,-26834744,68.19094042633822,66.69221982159465,NaN,NaN,12.02938138961565,12.766321096996622
2004-05-04T09:30:00-04:00,30.8,30.8,30.35001,30.55,905500,1204675,57.44710820416554,58.05360984482494,NaN,NaN,102.61366470358534,53.36362931118089,0.0011510716084527362,0.2654443657857328,0.2642932941772801,-24086764,-26442224,70.40080430714778,66.85327030981422,NaN,NaN,12.50238025050598,12.728615261783673
2004-05-05T09:30:00-04:00,30.3,30.7,30,30.64999,689000,1209525,58.434178394238124,57.66234151024027,NaN,NaN,71.48483260606378,46.70143779626704,0.013575400011716088,0.2812625441919252,0.2676871441802091,-23397764,-25638544,74.3326917304612,67.01788965959369,NaN,NaN,13.186200677410826,12.793984606873266
2004-05-06T09:30:00-04:00,30.8,30.8,30.21001,30.5,648100,1171620,56.32360798745216,56.94816101857582,NaN,NaN,76.28653664059728,61.14723221396982,0.008638619462216834,0.27848541850798014,0.2698467990457633,-24045864,-24750904,77.8348114064031,67.22593279296053,NaN,NaN,13.11389705467102,12.839686385130088
2004-05-07T09:30:00-04:00,30.55,30.55,29.75999,29.75999,665600,1146810,47.254999864269635,55.683549510032826,NaN,NaN,-52.54477888575638,51.37712936993297,-0.04459436081111873,0.21410384803186489,0.2586982088429836,-24711464,-24246824,79.54192604246714,67.50204793207368,NaN,NaN,10.069121648604275,12.443891422769259
2004-05-10T09:30:00-04:00,29.50999,29.50999,28.64999,28.89999,1884900,1176995,39.329690208124,54.61320971694335,NaN,NaN,-258.8854208145318,-12.209033150008349,-0.1328637445419083,0.09261852816559824,0.22548227270750654,-26596364,-24567644,75.55357893886223,67.40498855551965,NaN,NaN,4.47847861328174,11.305975307128184
2004-05-11T09:30:00-04:00,29.14999,29.45,29.10001,29.39999,1000300,1164070,45.095167681602724,54.0620756698326,NaN,NaN,-163.94830829703255,-65.52142775013193,-0.15137119409708416,0.03626828008615135,0.1876394741832355,-25596064,-24869504,71.90051188710913,67.31413234116222,NaN,NaN,1.9138332275179935,9.964240724326729
2004-05-12T09:30:00-04:00,29.28,29.7,29.2,29.58,3252000,1254530,47.04621319521091,53.14620737771583,NaN,NaN,-118.78554074936712,-103.5755024212181,-0.14525903241087107,0.00606568366964666,0.15132471608051773,-22344064,-24658764,72.8861552430139,67.63943803404868,NaN,NaN,0.5607560636052058,8.620885772795083
2004-05-13T09:30:00-04:00,29.5,29.8,29.45,29.5,1569000,1286275,46.259465498719514,52.4370705105947,NaN,NaN,-89.3773664180065,-136.70828303293888,-0.1402983410266255,-0.024048210202764153,0.11625013082386135,-23913064,-24632204,73.01462933486211,68.61734938407757,NaN,NaN,-0.7506219700761824,7.282098952384902
2004-05-14T09:30:00-04:00,29.60001,30.14,29.5,29.85001,1557400,1327535,50.184558407823985,51.86809761674471,NaN,NaN,-40.73001563043658,-134.34533038187493,-0.10855741464261566,-0.019446637479408224,0.08911077716320744,-22355664,-24161044,75.25460768421453,70.01668827824781,NaN,NaN,-0.6223553436708656,6.152891195805506
2004-05-17T09:30:00-04:00,29.8,30.10001,29.78,29.85001,1728400,1365005,50.184558407823985,50.845709509476855,NaN,NaN,-22.137242524839106,-86.99569472393637,-0.0837844637965056,-0.015619802582424569,0.06816466121408103,-22355664,-23312904,78.68459720281464,71.5004547612434,NaN,NaN,-0.5206061382161158,5.199534433802418
2004-05-18T09:30:00-04:00,29.85001,30,29.3,29.41,1893700,1425210,45.35482744378181,49.950094793797675,NaN,NaN,-76.93678850118432,-69.59339076476672,-0.09256699255971118,-0.047544079485557944,0.04502291307415324,-24249364,-23043564,79.64930478668435,72.89990729950807,NaN,NaN,-1.8874132143815119,4.1871133412047135
2004-05-19T09:30:00-04:00,29.45,29.7,29.21001,29.28,3015100,1508815,44.00728366274789,49.59782327675616,NaN,NaN,-100.9502791407679,-66.02633844304687,-0.1019259583336241,-0.08238453484287689,0.01954142349074721,-27264464,-24027644,67.60939032473132,73.45702997114113,NaN,NaN,-3.4061330610833807,3.1023638551635573
2004-05-20T09:30:00-04:00,29.35001,29.49001,29.2,29.25,1319000,1551790,43.68472290090628,49.13321240125036,NaN,NaN,-102.14800027310562,-68.5804652140667,-0.10454153494927464,-0.11113549519584609,-0.006593960246571454,-28583464,-24961724,58.560694638635965,73.10104599669613,NaN,NaN,-4.737026098939054,1.9824510045774701
2004-05-21T09:30:00-04:00,29.45,29.49001,29.02,29.11,1603800,1565640,42.13270136619507,48.05279165879012,NaN,NaN,-105.64125513289429,-81.56271311455825,-0.10957504474867025,-0.14356276618240926,-0.033987721433739015,-30187264,-26528044,47.16206000677777,71.59898310958467,NaN,NaN,-6.291212122503594,0.8004991292801753
2004-05-24T09:30:00-04:00,29.10001,29.83,29.08,29.77,2885000,1654720,50.97536507974607,47.590524292760165,NaN,NaN,-46.62078034293928,-86.45942067817829,-0.064556328577453,-0.11468313215555526,-0.050126803578102265,-27302264,-27517364,41.64788501731754,69.54520316031108,NaN,NaN,-5.11240049559578,-0.04420081713067536
2004-05-25T09:30:00-04:00,29.75,30.28,29.75,30.27,2283200,1641325,56.409745722537906,47.44592195906729,NaN,NaN,44.93229664740662,-62.08560364846009,-0.0005894916118053192,-0.050863668092858916,-0.0502741764810536,-25019064,-27671304,40.84758371095373,67.15340973034627,NaN,NaN,-2.3578789131158477,-0.37472625941427135
2004-05-26T09:30:00-04:00,30.35001,30.38,29.94,30.02,2151100,1680540,53.2323865463219,47.22512042755799,NaN,NaN,53.95272974248242,-31.105001871810043,0.024038508795143715,-0.020226040487123953,-0.04426454928226767,-27170164,-27652444,40.99717567505758,64.52215003525015,NaN,NaN,-1.0313612261256146,-0.46853125465874895
2004-05-27T09:30:00-04:00,29.95,30.02,29.45,29.60001,3255400,1789915,48.30941246271703,47.300435613161376,NaN,NaN,-18.293249064821044,-14.334051630153123,0.011815494793438505,-0.029495180790469533,-0.04131067558390804,-30425564,-28020864,38.926249895737826,61.62103031048377,NaN,NaN,-1.420494230530476,-0.6045259654975671
2004-05-28T09:30:00-04:00,29.55,29.8,29.5,29.75,2400700,1847340,50.08479723490749,48.068657543645905,NaN,NaN,-17.432935417534672,3.307612312918799,0.013483591594845676,-0.02445618609035094,-0.037939777685196616,-28024864,-27588384,42.592219545054775,59.266647496640374,NaN,NaN,-1.2015669566597702,-0.689817535663596
2004-06-01T09:30:00-04:00,30.03,30.21001,29.96001,30.16,2931600,1881940,54.66822107220332,48.75244707154595,NaN,NaN,61.5898860098152,24.949745583469696,0.04033342207791629,0.01247699991219875,-0.027856422165717543,-25093264,-27146584,46.14834979979446,57.42720734754647,NaN,NaN,0.40698795160998785,-0.5331310374816555
2004-06-02T09:30:00-04:00,30.14999,30.35001,30.03999,30.10001,1792900,1926310,53.8885111640115,49.241182640746,NaN,NaN,79.82189060831072,31.92766437565053,0.05147357105504269,0.03648554165308582,-0.01498802940195687,-26886164,-27520004,43.6851626654676,55.341422163436015,NaN,NaN,1.4790205646998142,-0.24568080859858837
2004-06-03T09:30:00-04:00,30.14999,30.34,29.78,29.83,2167300,2000225,50.40394803825699,49.53721710785582,NaN,NaN,53.42104061451787,31.82132655005762,0.03866290655829356,0.033340603795910084,-0.0053223027623834785,-29053464,-27896664,41.291106350978104,53.075456236015725,NaN,NaN,1.377960248943863,-0.01373208609252391
2004-06-04T09:30:00-04:00,29.8,29.84,29.53999,29.67999,940900,2014865,48.52654894473571,49.418787860492365,NaN,NaN,-0.24555947462431577,35.43086446809696,0.01908189145539424,0.018530061556859323,-0.0005518298985349186,-29994364,-27810424,42.07384901461677,50.705402045330175,NaN,NaN,0.755119085915186,0.0961037956228632
2004-06-07T09:30:00-04:00,29.85001,30.24001,29.71001,30.23,1962700,2079720,55.126186500955136,49.77176129571602,NaN,NaN,89.67214306041062,56.85188016368602,0.040913970458980084,0.05059063317519019,0.009676662716210104,-28031664,-27811784,42.06432447763822,48.08966827924614,NaN,NaN,2.2006116210130706,0.3967477706786071
2004-06-08T09:30:00-04:00,30.35001,30.44,29.96001,30.10001,1819100,2076430,53.384088152358174,50.34527991775718,NaN,NaN,103.08406581953938,65.15071612563085,0.044069238275650624,0.06476321056077339,0.02069397228512276,-29850764,-28763284,35.93510571224223,44.96722548821457,NaN,NaN,2.8772155285933247,0.7511003075235667
2004-06-09T09:30:00-04:00,29.85001,29.98,29.56,29.86,3214500,2187140,50.22789363235622,50.78960920130064,NaN,NaN,7.651146959656391,50.716567395899986,0.02823117623600271,0.05598294258012615,0.02775176634412344,-33065264,-29999104,29.851180993961677,42.270210536016734,NaN,NaN,2.5273645492998056,1.0048523420630293
2004-06-10T09:30:00-04:00,30.10001,30.3,30.03,30.24001,1934000,2121240,54.785912080623284,51.58255128556613,NaN,NaN,99.71851775904446,59.97606282480531,0.04082260374663999,0.07878002102742343,0.03795741728078344,-31131264,-30414664,28.126743118493337,40.09635685600654,NaN,NaN,3.5927561789702223,1.3745528901926283
2004-06-14T09:30:00-04:00,30.14999,30.35001,29.96001,30.00999,899100,2087745,51.699649226561135,52.265904704163724,NaN,NaN,70.88161265404942,74.20149725054004,0.03154928867001226,0.07739402811829876,0.0458447394482865,-32030364,-30821864,26.51065439954506,38.62125645548991,NaN,NaN,3.5731892343593508,1.6886437965021601
2004-06-15T09:30:00-04:00,30.35001,30.55,30.21001,30.44,1337700,2076760,56.619543529793475,52.669060307738526,NaN,NaN,126.7394784991447,81.61496433828687,0.05110736446881238,0.10972894503430197,0.05862158056548959,-30692664,-31354064,24.527101596013594,37.3983433539682,NaN,NaN,5.072012548377988,2.171982189627278
2004-06-16T09:30:00-04:00,30.55,31.06,30.55,31.03,1934700,2087075,62.29456584275542,53.08940460203978,NaN,NaN,197.6981857132982,100.53778831703863,0.09780483487251948,0.18087762415613895,0.08307278928361947,-28757964,-31135504,26.944545796034618,36.40526921718826,NaN,NaN,8.268767291617019,3.042951489911527
2004-06-17T09:30:00-04:00,31.03999,31.34,31,31.25999,911600,2037970,64.2574754686185,53.87691095363239,NaN,NaN,224.32262708297023,143.8720843417014,0.13586687932110514,0.2529063884350009,0.11703950911389577,-27846364,-30091724,37.27723971305547,36.13955950561668,NaN,NaN,11.514860456611181,4.253224199440049
2004-06-18T09:30:00-04:00,31.34,31.34,31.09,31.22,865800,1930505,63.637129343693985,54.97174787370217,NaN,NaN,201.79787325291713,164.28795544047594,0.14898196983397036,0.3032669714063587,0.15428500157238836,-28712164,-29607904,41.41359022686861,36.31722667212602,NaN,NaN,13.920442452529128,5.6342553784527745
2004-06-21T09:30:00-04:00,31.25,31.35001,30.33,31.14999,476600,1888385,62.49955266409796,55.858516118644346,NaN,NaN,134.91209604238918,177.0940521181439,0.14351791189338162,0.3336823914391154,0.19016447954573376,-29188764,-29039584,45.92471456782937,36.55526203089563,NaN,NaN,15.56591541282545,7.053063954791728
2004-06-22T09:30:00-04:00,31,31.37,30.98,31.36,1087000,1862545,64.5468882720198,56.56413520434552,NaN,NaN,151.08666506696179,181.9634894317073,0.14423835445658872,0.37046242261646967,0.22622406815988094,-28101764,-28521404,49.72578243139658,36.810792933152925,NaN,NaN,17.55915207811386,8.55393368669489
2004-06-23T09:30:00-04:00,31.36,31.94,31.33,31.89,2666700,1851630,69.12769736204677,57.652648504205175,NaN,NaN,180.05694838336515,178.4352419657207,0.16888962119104078,0.43733609464868195,0.26844647345764117,-25435064,-27856824,54.17478464355221,37.56005164587326,NaN,NaN,20.78317666580198,10.300968397995902
2004-06-24T09:30:00-04:00,31.92,31.99001,31.63,31.7,3682300,1921585,65.8432557542854,58.755456198207206,NaN,NaN,152.00610416274102,163.97193738167488,0.16091435320414493,0.46958941496282236,0.3086750617586774,-29117364,-28111024,52.2694206663913,38.34421695411705,NaN,NaN,22.496506919589795,12.04318818679503
2004-06-25T09:30:00-04:00,31.69,31.8,31.48,31.52,1424000,1885230,62.799102725737086,59.77492432542159,NaN,NaN,112.70950877555057,146.15426448620155,0.13317890233890345,0.4751486896823067,0.3419697873434033,-30541364,-28476864,49.56746752587667,38.87947541920705,NaN,NaN,23.04105080457159,13.614311417905967
2004-06-28T09:30:00-04:00,31.5,31.5,30.92999,31.07001,3422000,1893560,55.84765635216423,59.82645788622224,NaN,NaN,59.52819261181467,131.07748380008667,0.0769784171169976,0.4381928087396503,0.3612143916226527,-33963364,-29431784,43.27870914086459,38.96621718086607,NaN,NaN,21.38862303443154,14.724927363123905
2004-06-29T09:30:00-04:00,30.89999,31.27,30.89999,31.24001,1666000,1856825,57.75037820421556,60.1383357470692,NaN,NaN,50.20932141122817,110.9020150689399,0.04527358612849658,0.4178063742832734,0.3725327881547768,-32297364,-30270904,38.63952392316527,39.15938991021771,NaN,NaN,20.57948481691821,15.56129271366595
2004-06-30T09:30:00-04:00,31.25,31.55,31.2,31.48,2492400,1834865,60.34822247316493,60.86121637855553,NaN,NaN,72.75105645746699,89.4408366837603,0.03494758691387989,0.41621727179712664,0.38126968488324675,-29804964,-31144884,34.4923495414031,39.49090194932067,NaN,NaN,20.65880102835694,16.289508187193235
2004-07-01T09:30:00-04:00,31.60001,31.60001,31.31,31.52,952100,1792825,60.78107257964704,61.2894421284858,NaN,NaN,73.50069092972363,73.73975403715681,0.025720184013434177,0.4134199149000395,0.3876997308866053,-28852864,-31091984,34.94746711164274,39.97809652025991,NaN,NaN,20.845663726002016,16.940387549880203
2004-07-02T09:30:00-04:00,31.55,31.75,31.42,31.64,363300,1702625,62.11712570962021,62.03354759156145,NaN,NaN,81.87269229140772,67.57239074032825,0.02271186731034669,0.41608956502453864,0.39337769771419195,-28489564,-30681624,38.51598463768687,40.83562010869861,NaN,NaN,21.37261022067547,17.57356221713667
2004-07-06T09:30:00-04:00,31.85001,31.94,31.64999,31.72,681700,1689665,63.02154578462676,62.490833466906686,NaN,NaN,96.01731937613035,74.87021609319139,0.021154782792184357,0.4198211762044224,0.39866639341223803,-27807864,-29450524,47.77228868240261,42.49599061486926,NaN,NaN,22.060221581614176,18.21451355491917
2004-07-07T09:30:00-04:00,31.62,31.91,31.53999,31.91,577700,1620415,65.1496029886911,62.69476469161639,NaN,NaN,93.07649075834283,83.44364996261433,0.027560654426685205,0.43311721144559456,0.40555655701890936,-27230164,-28437084,53.92204589825056,44.42295490788469,NaN,NaN,23.238439279571658,18.932217229869526
2004-07-08T09:30:00-04:00,31.99001,32.03999,31.61,31.75,1566400,1607780,61.918109407427565,62.52766711581704,NaN,NaN,91.26030710201773,87.14550009152447,0.016222747690726624,0.42583499163231764,0.409612243941591,-28796564,-28235404,55.05621062606944,45.6928814016714,NaN,NaN,23.382260193524637,19.567937653248826
2004-07-09T09:30:00-04:00,31.89999,31.98,31.73,31.92999,517700,1472940,64.07674945078193,62.55906855203761,NaN,NaN,98.30832064188095,92.10702603395593,0.016018128830231515,0.4296349049793804,0.4136167761491489,-28278864,-28120604,55.72426599308003,46.715072527829356,NaN,NaN,24.09377302683579,20.21448556376125
2004-07-12T09:30:00-04:00,31.92999,31.92999,31.60001,31.75,833400,1417910,60.39025747690638,62.40840461009535,NaN,NaN,73.03547113769177,90.33958180321275,-0.00020722559558605802,0.4133577441546663,0.41356496975025236,-29112264,-28245144,54.773088301141286,47.347099223065925,NaN,NaN,23.70083765939087,20.71253586313691
2004-07-13T09:30:00-04:00,31.67999,31.74001,31.46001,31.67,776100,1411760,58.77177529243222,61.99589654012481,NaN,NaN,42.770009601124215,79.69011984821154,-0.019241906296220024,0.38951258687997736,0.4087544931761974,-29888364,-28661244,51.60372593012816,47.481238044403895,NaN,NaN,22.931180791296306,21.029485138588253
2004-07-14T09:30:00-04:00,31.60001,32.09,31.60001,32.05,1351900,1412470,63.742474627332655,61.61123777335951,NaN,NaN,100.11442696809128,81.09770709016121,-0.00963960731175223,0.3967049840365071,0.40634459134825934,-28536464,-28922504,49.6607051696621,47.15880379626889,NaN,NaN,23.632518523483252,21.40134705071611
2004-07-15T09:30:00-04:00,32.10001,32.38,32,32.25999,833100,1357390,66.16979546379976,61.634562038324816,NaN,NaN,160.62850860613693,94.97134739098506,0.006580756958344591,0.4145705375461901,0.4079897805878455,-27703364,-28703864,51.312864708803296,47.090478370726885,NaN,NaN,24.940662047541863,21.906963478834076
2004-07-16T09:30:00-04:00,32.47,32.71001,32.38,32.64999,1138800,1368750,70.16473005366895,62.16067827603423,NaN,NaN,218.9056561578978,119.09081449418844,0.03757171682588456,0.45495442662020125,0.4173827097943167,-26564564,-28361004,53.86970148974197,47.397780796717264,NaN,NaN,27.34352148116157,22.68361462202372
2004-07-19T09:30:00-04:00,32.60001,32.73,32.38,32.53999,717000,1361310,67.73514625037598,63.00978469733508,NaN,NaN,184.72591177531163,141.4289026217124,0.04420153708206903,0.47263463114690296,0.42843309406483393,-27281564,-27994864,56.49707765129607,48.3419499760338,NaN,NaN,28.612572932418338,23.530608666365808
2004-07-20T09:30:00-04:00,32.55,32.55,32.33,32.44,665300,1370745,65.5144028581105,63.564357886898996,NaN,NaN,149.0078221094003,162.67646512336762,0.03575279142122434,0.47312408334136435,0.43737129192014,-27946864,-27606564,59.15406639212149,49.807274438102105,NaN,NaN,29.031082071373486,24.316390581366903
2004-07-21T09:30:00-04:00,32.44,32.7,31.86,31.86,1015500,1367170,54.37760174371246,63.13788497765239,NaN,NaN,71.82470494551647,157.01852071885267,-0.012418614680427542,0.4218480235696056,0.43426663825003314,-28962364,-27691744,58.31269197743965,51.50872746924757,NaN,NaN,25.855670414300373,24.5362877003574
2004-07-22T09:30:00-04:00,31.8,32.10001,31.72,31.96001,1836300,1325650,55.77366390463416,62.78021292943719,NaN,NaN,21.8684036170903,129.26649972104332,-0.03953723597571457,0.38484509328038996,0.42438232925610453,-27126064,-27576284,59.16062659864398,53.23823886117623,NaN,NaN,23.70331770045886,24.41729198608618
2004-07-23T09:30:00-04:00,31.98,31.99001,31.71001,31.84,2736300,1278350,53.652025073386326,62.17556288399191,NaN,NaN,3.434970247776084,86.17236253901899,-0.06598982570970113,0.3418950471189781,0.40788487282867925,-29862364,-28235844,52.58108685079238,54.24288901925519,NaN,NaN,21.285221771728835,23.96985338403513
2004-07-26T09:30:00-04:00,31.8,31.98,31.34,31.56,1955900,1304945,48.97133876952535,61.17197666862752,NaN,NaN,-45.778907952771135,40.07139859340243,-0.10069805517257568,0.2820123038629596,0.3827103590355353,-31818264,-29143184,45.14311244497047,54.05509071658146,NaN,NaN,17.744304751274317,23.080489293640728
2004-07-27T09:30:00-04:00,31.37,31.96001,31.35001,31.88,1770600,1222375,53.91922620324982,60.36980689823887,NaN,NaN,-31.583495125598137,3.9531351464027376,-0.10024118741067156,0.2574088747721959,0.35765006218286743,-30047664,-29563344,42.16842185602064,53.21554614213647,NaN,NaN,16.184947576112613,22.095411905422427
2004-07-28T09:30:00-04:00,31.8,32.16,31.75,32.10001,1855200,1231835,57.00590589775372,60.018935218976445,NaN,NaN,26.1272575837264,-5.186354325955277,-0.0839201259947438,0.2527499046894377,0.3366700306841815,-28192464,-29409364,43.634305363029725,52.39969576620506,NaN,NaN,15.826150426022789,21.19980312265105
2004-07-29T09:30:00-04:00,32.25,32.38,31.99001,32.33,1574200,1185925,60.020703525000556,59.72921765284921,NaN,NaN,75.5211407906634,5.544193108759342,-0.0576831011183368,0.2645661542862605,0.3222492554045973,-26618264,-29307804,44.6311849527651,51.60733283475399,NaN,NaN,16.457184768103335,20.52228621485852
2004-07-30T09:30:00-04:00,32.5,32.55,32.38,32.45,1079400,1192290,61.536212071307915,59.81107155244932,NaN,NaN,116.47498701430783,28.152196462065696,-0.033494164035455076,0.28038155036027845,0.31387571439573353,-25538864,-28443104,52.35715436266819,51.43476612486305,NaN,NaN,17.4344961913911,20.081173354363177
2004-08-02T09:30:00-04:00,32.5,32.5,32.06,32.41,888000,1218525,60.71008376486459,59.94952215762305,NaN,NaN,72.41726468750137,51.79143099012019,-0.02199143899152206,0.28638641565633094,0.308377854647853,-26426864,-27364824,59.875877266672184,52.025634077473335,NaN,NaN,17.995818511912066,19.783265519727305
2004-08-03T09:30:00-04:00,32.5,32.85001,32.5,32.8,1918000,1280340,65.56425924826188,60.07964963054656,NaN,NaN,144.03345772424709,86.91482156008924,0.008448540644478475,0.3189385304534511,0.31048998980897263,-24508864,-26257064,65.8401927831667,53.181311764152234,NaN,NaN,19.989054307050484,19.812663917916332
2004-08-04T09:30:00-04:00,32.85001,32.85001,32,32.03999,3842100,1443560,52.064760881114985,59.072147160354795,NaN,NaN,44.15277803131174,90.51992564960631,-0.02424789694904461,0.2801801186226669,0.3044280155717115,-28350964,-26288764,65.53995904629099,54.197532788258506,NaN,NaN,17.237955837097154,19.444848477799308
2004-08-05T09:30:00-04:00,32,32.2,31.55,31.56,2372800,1483880,45.669292945277455,57.32247308118398,NaN,NaN,-75.29395250410927,60.35690699065177,-0.07687752833520767,0.20833110515270192,0.2852086334879096,-30723764,-27109864,58.14399578248077,54.502839523454135,NaN,NaN,12.59900157819745,18.466870349284758
2004-08-06T09:30:00-04:00,31.60001,31.64999,30.86,30.92999,2749100,1595450,38.91280611219219,55.26373449988513,NaN,NaN,-185.33704138731952,-0.005498689673711965,-0.148640673664978,0.0994077914066871,0.2480484650716651,-33472864,-28696664,47.08569521888532,53.83059792113908,NaN,NaN,6.056806786585682,16.69400412604203
2004-08-09T09:30:00-04:00,31,31.67,30.94,31.42999,2115800,1659570,45.76995888430898,53.85341707318503,NaN,NaN,-132.5115832135579,-40.991268269885566,-0.15618101174287885,0.05282220039306651,0.20900321213594536,-31357064,-29682704,41.76951198413692,52.58884403485447,NaN,NaN,3.2649147742320666,14.775562790069179
2004-08-10T09:30:00-04:00,31.45,31.60001,31.21001,31.31,2278900,1734710,44.479589205090875,53.1464161775692,NaN,NaN,-120.76966776143101,-93.95189336702119,-0.16228280672836068,0.006149703725494504,0.16843251045385518,-33635964,-31508124,34.09494467639752,50.85900494192288,NaN,NaN,0.6891171371370677,12.763213411078878
2004-08-11T09:30:00-04:00,31.23,31.36,30.85001,31.14999,4726199,1903424.95,42.74879949119902,52.21606871946668,NaN,NaN,-143.82146524525365,-131.54674202233429,-0.16934719215985924,-0.04325147974596888,0.12609571241389037,-38362163,-33510363.8,28.014730060643444,48.63429804635142,NaN,NaN,-1.9190434981401636,10.665748138333301
2004-08-12T09:30:00-04:00,31.25,31.37,30.75,30.75,2015400,1962539.95,38.695314150587684,51.14773222498106,NaN,NaN,-145.71819119397412,-145.63158976030724,-0.1915735703334018,-0.1133712505028619,0.07820231983053991,-40377563,-35441123.6,23.637262482493156,46.566882020044325,NaN,NaN,-5.4773559054612715,8.35959041779122
2004-08-13T09:30:00-04:00,30.8,31.23,30.8,31.13,1652800,1988239.95,44.11664943093543,50.80096870079607,NaN,NaN,-116.91045921888909,-131.94627332662114,-0.17192427383055955,-0.13670302245765953,0.03522125137290002,-38724763,-36491503.4,21.65484812292968,44.88914885418427,NaN,NaN,-6.629491959193845,6.218292935364781
2004-08-16T09:30:00-04:00,31.14999,31.32001,31.05,31.32001,890200,1996899.95,46.65685440651815,50.28222785817237,NaN,NaN,-82.21316278500085,-121.88658924090973,-0.13879103205074783,-0.13826753869053476,0.0005234933602130606,-37834563,-37787003.2,19.484352531356905,43.26885818813686,NaN,NaN,-6.73200701620305,4.368250085140805
2004-08-17T09:30:00-04:00,31.25,31.28,30.56,30.60001,5489398,2238104.85,39.356506061904724,49.02155644132602,NaN,NaN,-126.99494202774534,-123.13164409417259,-0.15670159329707234,-0.19535349826112736,-0.038651904964055024,-43323961,-39724602.6,16.77600905055398,41.35040845153145,NaN,NaN,-9.346815507231756,2.408955000516154
2004-08-18T09:30:00-04:00,30.75999,31.0358,30.75999,31,2191100,2296884.85,44.54750062964432,47.916327663086285,NaN,NaN,-97.97117731322673,-113.96158650776722,-0.13383422025331163,-0.20594468028069457,-0.07211046002738294,-41132861,-40278742.2,16.087292376840267,39.311558981822536,NaN,NaN,-9.705175056047121,0.678364992435686
2004-08-19T09:30:00-04:00,31.14999,31.32001,31.00999,31.10001,2264500,2318294.85,45.79681052170241,46.792084695257316,NaN,NaN,-62.37886382975324,-97.29372103492305,-0.10544576101007605,-0.20391766128997801,-0.09847190027990196,-38868361,-39976901.8,18.060568035574235,36.86180281560154,NaN,NaN,-9.57863330220012,-0.786920478226572
2004-08-20T09:30:00-04:00,31.35001,31.74001,31.35001,31.42,2204100,2291684.85,49.701460346915844,46.00575445111813,NaN,NaN,-11.741832776886984,-76.25999574652265,-0.060806019936022596,-0.1744794251999302,-0.11367340526390761,-36664261,-39564801.4,20.798994424845716,34.070596898328226,NaN,NaN,-8.211427339469358,-1.8475643155469699
2004-08-23T09:30:00-04:00,31.49001,31.53,31.02,31.03,1656900,2276734.85,45.40804470091342,44.566024840593236,NaN,NaN,-49.90512951886158,-69.79838909329479,-0.053491693155512055,-0.1805380217082977,-0.12704632855278564,-38321161,-39662121,20.623704577047704,30.840847740748302,NaN,NaN,-8.432732472405936,-2.7883026236696793
2004-08-24T09:30:00-04:00,30.91,31,30.64999,30.95,1890600,2282734.85,44.557754556426595,44.0298101031155,NaN,NaN,-85.35902747378948,-61.4712061825036,-0.050050247864508346,-0.18960913838342108,-0.13955889051891274,-40211761,-39039681,24.97863527064949,27.94361032820248,NaN,NaN,-8.868529150329143,-3.65690641319246
2004-08-25T09:30:00-04:00,31,31.19,31,31.14999,2187200,2299334.85,47.2185917008839,44.14047429994453,NaN,NaN,-49.36717755402453,-51.75040623066316,-0.031234273578502447,-0.1786017324920408,-0.14736745891353836,-38024561,-38418021,29.159009484361547,25.87325416405111,NaN,NaN,-8.431585841517359,-4.339003474381731
2004-08-26T09:30:00-04:00,31.14,31.44,30.91,31.37,1312400,2286244.85,50.058212755290306,44.936574774451536,NaN,NaN,-28.197838052670928,-44.9142010752467,-0.002419387979384846,-0.1503916938877694,-0.14797230590838456,-36712161,-37986781,31.99009610739607,24.794997084659027,NaN,NaN,-7.218958760465506,-4.750425658107985
2004-08-27T09:30:00-04:00,31.45,31.64,31.45,31.57001,1020400,2283294.85,52.55708881478723,45.4213697694857,NaN,NaN,29.175262746690212,-36.730781970531254,0.02988125860047891,-0.11062073265778594,-0.14050199125826485,-35691761,-37792281,33.285116234155154,24.18896881680318,NaN,NaN,-5.462194875171084,-4.852106974831285
2004-08-30T09:30:00-04:00,31.5,31.81,31.35001,31.42999,1970500,2337419.85,50.64655981565567,45.86186767024033,NaN,NaN,37.04456179056422,-19.340843708646098,0.04090543370403421,-0.08937019912822208,-0.1302756328322563,-37662261,-37660501,34.19933310857128,24.19642513338702,NaN,NaN,-4.531440752672677,-4.806297514522912
2004-08-31T09:30:00-04:00,31.60001,32,31.50999,31.95,1141100,2298574.85,56.91116103084211,46.873464923071985,NaN,NaN,124.11510141245229,22.55398206860226,0.08004436409631613,-0.03022017771186114,-0.11026454180817727,-36521161,-36922381,39.223075616111316,24.99702124449187,NaN,NaN,-1.7696888475561452,-4.372496276384803
2004-09-01T09:30:00-04:00,32,32.55,31.96001,32.50999,2222200,2217579.85,62.44023195678769,48.5695304806577,NaN,NaN,245.45243749916972,81.5179050792411,0.13712234392741565,0.06113838810109229,-0.07598395582632336,-34298961,-36177261,43.880985113299104,26.44300143240658,NaN,NaN,2.496831247180224,-3.391163773018371
2004-09-02T09:30:00-04:00,32.62,32.77,32.5,32.77,1363200,2167099.85,64.70485931294793,50.040116900801436,NaN,NaN,263.8874789545594,139.93496848068716,0.1829954980391616,0.15276041672262863,-0.030235081316532963,-32935761,-35421981,48.213456466340624,28.340044885507357,NaN,NaN,6.7558263342038485,-1.941593757700911
2004-09-03T09:30:00-04:00,32.75999,32.92,32.64999,32.84,2269300,2143109.85,65.31125363297782,51.372573988405705,NaN,NaN,217.07628286169071,177.5151725036873,0.20689785986501735,0.2283872435147387,0.021489383649721375,-30666461,-34416921,53.37215012002999,30.76060185612686,NaN,NaN,10.36388513341232,-0.18366820182759258
2004-09-07T09:30:00-04:00,32.75,32.84,32.5,32.8,1313200,2102979.85,64.62796013136366,53.177677850509916,NaN,NaN,163.49344589368852,202.80494932431216,0.20828484833365996,0.28184544406679635,0.07356059573313638,-31979661,-33280401,58.41658730591786,33.734928874367135,NaN,NaN,13.105279644927922,1.7147529191374808
2004-09-08T09:30:00-04:00,32.60001,32.95,32.60001,32.83,2848000,2131434.85,64.92435513705303,54.633167458181966,NaN,NaN,142.3290112292221,206.4477312876661,0.19947944191604408,0.3229098981281915,0.1234304562121474,-29131661,-31802501,63.887694178858204,37.14924328879699,NaN,NaN,15.447878600700765,3.676628016503664
2004-09-09T09:30:00-04:00,32.85001,33.35001,32.85001,33.3,1885700,1989409.9,69.26895155165947,56.30974896032176,NaN,NaN,150.70333970545803,187.49791172892375,0.21237235187897502,0.38889589606086616,0.17652354418189115,-27245961,-30391901,68.18965946884373,40.72989267688767,NaN,NaN,18.883029800808735,5.848971128547246
2004-09-10T09:30:00-04:00,33.3,33.34,32.96001,33.12,2258000,2001539.9,65.90225937469476,57.4669488908774,NaN,NaN,125.70250713725594,159.86091736546308,0.19622395750829394,0.42180349106725856,0.22557953355896462,-29503961,-29705541,70.05868535718162,44.248442029197385,NaN,NaN,20.82903369029698,7.988980065940066
2004-09-13T09:30:00-04:00,33.25,33.41,33.23,33.35001,1781800,2007989.9,68.03988674453072,59.08350903685006,NaN,NaN,122.55554000909441,140.9567687949438,0.18843820797241562,0.4611272935244841,0.2726890855520685,-27722161,-29116681,71.60039999000854,47.88963455869458,NaN,NaN,23.12029529374694,10.150596527055333
2004-09-14T09:30:00-04:00,33.44,33.61,33.3,33.5,1525000,2039729.9,69.38761946521188,60.85707081604902,NaN,NaN,116.48811188249516,131.55570199270514,0.1807659658118707,0.4986465428169069,0.3178805770050362,-26197161,-27960181,74.3895310729165,51.418984258856504,NaN,NaN,25.44017351819973,12.334821811504533
2004-09-15T09:30:00-04:00,33.89,33.89,33.34,33.39,2619100,1896215,67.15114497778842,62.28082462154219,NaN,NaN,108.99977571462884,124.8898548897865,0.1565631028697838,0.513584455592266,0.35702135272248214,-28816261,-27897101,74.536425998399,54.660228295573475,NaN,NaN,26.776599645300376,14.397932930618225
2004-09-16T09:30:00-04:00,33.35001,33.55,33.3,33.49001,1103300,1841825,68.1560932979468,63.57353037458908,NaN,NaN,92.76927571726492,113.30304209214789,0.13631342973936977,0.5274131398966944,0.3910997101573246,-27712961,-27990501,73.86089743365991,57.65099981887803,NaN,NaN,28.180752374281937,16.366907136855897
2004-09-17T09:30:00-04:00,33.56,33.96001,33.50999,33.92,2439900,1850595,72.10717177755318,64.96996487192952,NaN,NaN,109.92863534611611,110.14826773391992,0.14035092755019818,0.5665383695950723,0.42618744204487413,-25273061,-27144321,75.98447353131134,60.70095391153205,NaN,NaN,30.6224210919173,18.403409130436096
2004-09-20T09:30:00-04:00,34.00999,34.19,33.89999,33.92999,1626800,1821730,72.19349497837801,66.50903166926682,NaN,NaN,115.21624360032264,108.68040845216558,0.13227619432203425,0.591532684947417,0.4592564906253827,-23646261,-26329141,77.85128766855368,63.8189506658165,NaN,NaN,32.64224865128327,20.437529061985693
2004-09-21T09:30:00-04:00,34,34.85001,33.99001,34.77,3899100,1933840,78.28033357166305,68.03540113646832,NaN,NaN,146.02022379935116,114.58683083553679,0.1697014933085791,0.6713833572611065,0.5016818639525275,-19747161,-25039141,80.44218487991104,66.76317275608791,NaN,NaN,36.65005692331043,22.753604470746367
2004-09-22T09:30:00-04:00,34.7,34.7,34.35001,34.55,3762800,2027450,73.7283291096251,68.84169379024242,NaN,NaN,134.7714129562011,119.74115828385122,0.1656492891362571,0.7087434753728488,0.5430941862365917,-23509961,-23977881,82.27877486822088,69.50587202429661,NaN,NaN,38.50803186165933,25.004236955162504
2004-09-23T09:30:00-04:00,34.45,34.45,34,34.23,3271900,2081685,67.57320894810464,69.04657590703933,NaN,NaN,101.64658953188822,121.5166210467759,0.12905289815626786,0.7044103089319265,0.5753574107756586,-26781861,-23791661,82.5877587060297,71.96117932713155,NaN,NaN,38.10774684833803,26.876166939901864
2004-09-24T09:30:00-04:00,34.23,34.73,34.23,34.62,3236700,2177900,70.77541855449843,69.43687340143366,NaN,NaN,119.13930972657913,123.35875592286848,0.11899328830967348,0.7240990211627505,0.605105732853077,-23545161,-23446081,83.17406973831042,74.08988787129442,NaN,NaN,38.79417071993109,28.57873890847747
2004-09-27T09:30:00-04:00,34.75,34.86,34.38,34.60001,2318100,2242785,70.3917111535108,69.8485699030156,NaN,NaN,117.07640241075529,123.73078768495502,0.09965794638294967,0.7296781658317641,0.6300202194488145,-25863261,-23889481,79.47627609994561,75.59415135658212,NaN,NaN,39.217493873397345,30.098561046323166
2004-09-28T09:30:00-04:00,34.85001,35.28,34.82001,35.19,2498700,2269195,74.74383867811096,70.54996158451975,NaN,NaN,146.8748717374314,123.90171727257106,0.11422270382010014,0.7727985992239397,0.6585758954038395,-23364561,-24612961,73.7173690342024,76.29627098910672,NaN,NaN,41.01570932068892,31.658153656946844
2004-09-29T09:30:00-04:00,35.12,35.2,34.50999,34.72,3216800,2372980,66.37387852690978,70.34317065418047,NaN,NaN,107.1467168006072,118.37677804145228,0.08136545601551248,0.7602827154232301,0.6789172594077176,-26581361,-25227241,69.13663252034733,76.36391192135696,NaN,NaN,39.73337767412859,32.81175708797281
2004-09-30T09:30:00-04:00,34.85001,35.07001,34.78999,34.92999,864200,2305080,68.0930482214628,70.49965557180677,NaN,NaN,106.73483389581023,119.39442691423669,0.06371737015283618,0.7585639720987629,0.6948466019459267,-25717161,-25014301,69.83635348306194,76.34803107320556,NaN,NaN,39.250454145816875,33.731570953379105
2004-10-01T09:30:00-04:00,35.05,35.48,34.89,35.42999,1179700,2295905,71.79118436952491,70.7676054021635,NaN,NaN,123.54374637207141,120.27531424333515,0.07488977007640707,0.7884588145414355,0.7135690444650284,-24537461,-25212761,68.28256526401529,76.11104287849176,NaN,NaN,40.06540687151284,34.63640465596964
2004-10-04T09:30:00-04:00,35.45,35.53,35.25,35.39,2241500,2294515,71.0815727933521,70.88860206845924,NaN,NaN,121.46240850347566,121.15251546187922,0.06890902726014203,0.799705328540206,0.730796301280064,-26778961,-25395901,66.8054410698036,75.56932216398368,NaN,NaN,40.478492725209954,35.470988665861114
2004-10-05T09:30:00-04:00,35.67,35.87,35.55,35.77,2836800,2370695,73.73797959660581,71.35909025551761,NaN,NaN,138.7455476982962,119.52665065405219,0.0791362703220797,0.8297166391826636,0.7505803688605839,-23942161,-25511421,65.83796060055165,74.9480032069946,NaN,NaN,41.6748937615359,36.35726082238608
2004-10-06T09:30:00-04:00,35.8,36.42999,35.8,36.42999,3006600,2378625,77.58857454637631,72.03283891611973,NaN,NaN,165.5024846144555,131.19780421682185,0.11667417607520059,0.8964230889545846,0.779748912879384,-20935561,-24382261,70.35690416102418,74.6977179732349,NaN,NaN,44.053122916480305,37.45666969297097
2004-10-07T09:30:00-04:00,36.60001,36.83,36.03,36.14999,3680600,2468370,72.71729789932078,72.07641935338884,NaN,NaN,159.74762922529973,141.80036328271976,0.1091081871996723,0.9161341468789743,0.807025959679302,-24616161,-24162061,71.15814455673141,74.35298018933634,NaN,NaN,44.366313061574196,38.44376160277143
2004-10-08T09:30:00-04:00,36.35001,36.42,35.94,36.19,2246400,2467790,72.97836482263955,72.13248148512182,NaN,NaN,129.00962331548826,142.89353867140312,0.09384218358695096,0.9243286891629907,0.8304865055760398,-22369761,-23728521,72.72149515194627,73.9865664381501,NaN,NaN,44.692607736492505,39.33645390758873
2004-10-11T09:30:00-04:00,36.37,36.37,35.69,35.88,2421100,2499755,67.58232179811387,71.36833778701116,NaN,NaN,100.10480336220552,138.62201764314912,0.05199952321475543,0.895485909594484,0.8434863863797286,-24790861,-23330901,74.10770041051178,73.53410326176444,NaN,NaN,43.28529609938682,39.90057422070274
2004-10-12T09:30:00-04:00,35.85001,36.05,35.46001,35.47,3046700,2575840,61.1430706055956,70.46939075100904,NaN,NaN,64.81914362961312,123.83673682941249,-0.01080769315404806,0.8299767699371685,0.8407844630912166,-27837561,-24109981,66.93088069214039,72.43782510633011,NaN,NaN,40.014821188001044,39.916895216031065
2004-10-13T09:30:00-04:00,35.35001,35.35001,34.35001,34.73,7132801,2801525.05,51.588935615745946,69.32765694155485,NaN,NaN,-19.065630266827736,86.92311385315584,-0.10449782514548811,0.7101621816593564,0.8146600068048445,-34970362,-26916941.2,48.650204607961776,70.01371409932526,NaN,NaN,33.75424035328987,39.03651594992518
2004-10-14T09:30:00-04:00,34.95,35.32001,34.87,35.00999,4796699,2986195,54.4867932646762,68.16418370656756,NaN,NaN,-2.1166361396638917,54.5502607801631,-0.14730182821447912,0.6305327215367456,0.7778345497512247,-30173663,-28028441.6,43.57492038831511,67.18520343146845,NaN,NaN,29.636861521885994,37.693708174491015
2004-10-15T09:30:00-04:00,35.33,35.35001,34.97,35.16,1767500,2952575,56.0062413234814,67.13665014727974,NaN,NaN,0.702453269751331,28.888826771015733,-0.16392682421229543,0.5729260194858554,0.7368528436981509,-28406163,-29235722,38.835863977590655,64.28231685130024,NaN,NaN,26.822256435595104,36.140643640363024
2004-10-18T09:30:00-04:00,35.14999,35.3,34.67999,34.69,1691000,2955785,50.336141851071005,65.3932432310626,NaN,NaN,-39.68310862021523,0.931244374531586,-0.20246578334006715,0.4837706145230669,0.6862363978631341,-30097163,-30296982.4,35.21069415911559,61.53184007450833,NaN,NaN,22.548707157038063,34.198938428459456
2004-10-19T09:30:00-04:00,34.64999,34.82001,34.41,34.59,1705300,2846095,49.19494245571262,64.16617636883423,NaN,NaN,-77.01407987051788,-27.435400325494612,-0.22864571800620903,0.4004292503553728,0.6290749683615818,-31802463,-31089962.8,32.750662737960695,58.93284223290929,NaN,NaN,18.777822942462798,31.995921930459936
2004-10-20T09:30:00-04:00,34.71001,35.38,34.64999,35.35001,2475500,2781730,57.146804087747924,63.3843017878546,NaN,NaN,-14.220502799902446,-26.466374832109558,-0.190301901236958,0.39119759181538427,0.5814994930523423,-29326963,-29961283,39.25590014780634,56.748524137533884,NaN,NaN,17.966509738114862,29.991720188696355
2004-10-21T09:30:00-04:00,35.46001,35.77,34.45,35.55,2468600,2741565,58.96680199998651,62.4682744757447,NaN,NaN,-3.8848376752541576,-26.82001513922761,-0.14883132490012463,0.3954603369271865,0.5442916618273111,-26858363,-29298223,42.758974140642046,54.92541048586436,NaN,NaN,17.899403245817787,28.264246339713704
2004-10-22T09:30:00-04:00,35.64,35.91,35.45,35.48,1429900,2651225,58.037681228626546,61.53656793540716,NaN,NaN,41.679313922248106,-18.62464300872832,-0.1244658267393921,0.38870937840307107,0.5131752051424632,-28288263,-29274643,42.88511916929478,53.216816064399445,NaN,NaN,17.564803744740214,26.735754540431778
2004-10-25T09:30:00-04:00,35.55,35.69,35.25999,35.50999,2573000,2663970,58.340540819340546,60.436750879888216,NaN,NaN,16.888152124671542,-7.310390859750967,-0.1054339288735518,0.38138279405052344,0.48681672292407524,-25715263,-28398263,47.514622461786395,51.90800619734478,NaN,NaN,17.38188870102949,25.399487991945737
2004-10-26T09:30:00-04:00,35.39999,35.92999,35.39999,35.89999,1827400,2630405,62.16482713677336,59.33505463634514,NaN,NaN,51.96727039946672,18.48587919424595,-0.0675274094763948,0.4024074610785817,0.4699348705549765,-23887863,-26815343,54.66273855923645,50.78699436864566,NaN,NaN,18.355194026314425,24.393160282569834
2004-10-27T09:30:00-04:00,35.95,36.13,35.03,35.28,5301398,2734634.9,53.72190242188114,57.97824067367088,NaN,NaN,5.576759680847966,22.445331690396035,-0.08407905900356571,0.3648360468005194,0.4489151058040851,-29189261,-26787802.6,54.778136401524655,49.61699378613089,NaN,NaN,16.58749584201392,23.278065362490416
2004-10-28T09:30:00-04:00,35.14,35.28999,34.45,34.66,7697801,3076314.95,46.86692079072908,56.113137528534416,NaN,NaN,-105.92850045271938,2.0365991349029926,-0.13370537395765192,0.2817833883570202,0.41548876231467213,-36887062,-28793542.4,45.662427769157595,47.68420325878885,NaN,NaN,12.751039919539458,21.774204584925993
2004-10-29T09:30:00-04:00,34.45,35.14999,34.45,35.14,4532898,3243974.85,51.97605143598284,54.998403931239345,NaN,NaN,-80.71906197272884,-22.443076044092397,-0.13095658321259301,0.2517930332989309,0.3827496165115239,-32354164,-29606722.6,42.56944130675575,45.431470465663416,NaN,NaN,11.213216524441357,20.26549200485676
2004-11-01T09:30:00-05:00,35.35001,35.52,34.71001,34.92999,3995900,3331694.85,49.723239892861635,54.182701737472634,NaN,NaN,-53.714297034050546,-36.563565875836815,-0.13926053671063332,0.20867394562323227,0.3479344823338656,-36350064,-31733682.8,35.74863474987616,43.204167184073114,NaN,NaN,9.250980318723416,18.69199033540914
2004-11-02T09:30:00-05:00,34.8,34.92999,34.32001,34.41,6923602,3536034.95,44.57187638876068,53.6814832212594,NaN,NaN,-115.51825199171799,-70.06067035407376,-0.17352162570653878,0.1310324502006921,0.3045540759072309,-43273666,-35610843.4,27.194771436348248,41.671636243243576,NaN,NaN,5.869531547712241,16.860210508595298
2004-11-03T09:30:00-05:00,35.10001,35.25,34.60001,35.10001,3469800,3559194.95,51.719757166829,53.48383778569888,NaN,NaN,-47.88629842069116,-80.75328197438158,-0.14464125735611666,0.12375250421208506,0.2683937615682017,-39803866,-37733764.4,23.832198733900753,40.261441839356834,NaN,NaN,5.370878701489438,15.218877393294461
2004-11-04T09:30:00-05:00,35.19,35.60001,35.19,35.52,3600200,3555174.95,55.48283236315458,53.44645143138983,NaN,NaN,35.61304291223069,-52.44497330139158,-0.09460138232641083,0.1501420336601882,0.24474341598659902,-36203666,-37597085.2,24.479644764367364,39.23599760984088,NaN,NaN,6.243089454052822,13.936621973402799
2004-11-05T09:30:00-05:00,35.7,35.91,35.52,35.73,6127898,3749249.85,57.27595836716812,53.942152611111055,NaN,NaN,97.94595836614914,-16.711969233615974,-0.04710776691278043,0.1858587073456235,0.23296647425840392,-30075768,-37141406,26.716209826815742,38.62924872896232,NaN,NaN,7.5256567531990255,13.020769799087974
2004-11-08T09:30:00-05:00,35.72,35.72,35.05,35.14,3533300,3804859.85,51.053957125953644,54.07493937327113,NaN,NaN,26.253112778053712,-0.7184872711951215,-0.05464655442113975,0.16465828123197923,0.21930483565311898,-33609068,-36593206.8,29.424140633333693,38.39164000720325,NaN,NaN,6.569567475828681,12.09916946719379
2004-11-09T09:30:00-05:00,34.89999,35.13,34.77,34.82001,5973602,3951204.95,48.00789029115587,53.42215981637168,NaN,NaN,-55.084086089212754,11.368345909305926,-0.07892743226894341,0.12064554531693972,0.19957297758588313,-39582670,-35855007.6,33.013655647615934,37.945765400046795,NaN,NaN,4.799561572844754,11.05636833942964
2004-11-10T09:30:00-05:00,35.05,35.3,34.59,35.23,5078699,3848499.85,51.962570074383734,52.92185753597148,NaN,NaN,-27.987073443596813,15.348190904724799,-0.06566357443715767,0.11749350953943605,0.18315708397659372,-34503971,-34795028.6,37.897867436662196,37.59854349261966,NaN,NaN,4.599635765922581,10.133977971785775
2004-11-11T09:30:00-05:00,35.12,35.32001,35.03,35.16,3028500,3760089.9,51.2458622470195,52.436727608713845,NaN,NaN,1.8994988915790938,8.605482100594473,-0.06004489687615372,0.10810096288140159,0.1681458597575553,-37532471,-35060789.6,37.16616478419945,37.19004675082714,NaN,NaN,4.223015332793198,9.289554737643979
2004-11-12T09:30:00-05:00,35.10001,35.94501,35,35.89999,2879400,3815684.9,57.86243976466559,52.40257753337992,NaN,NaN,95.87007777377059,8.190305982118767,-0.00768408657781125,0.15854075153529124,0.16622483811310249,-34653071,-35976250.2,34.682124461886374,36.273439750834285,NaN,NaN,6.03415959269952,8.824498288366199
2004-11-15T09:30:00-05:00,35.75,35.75,34.91,35.12,4111898,3936729.8,50.13846531224507,51.54355168877074,NaN,NaN,13.094296592460772,5.558542745000179,-0.02575511228520805,0.1340309477565924,0.15978606004180046,-38764969,-37007430.4,32.081126045072125,34.66046742839398,NaN,NaN,5.01513574667572,8.280303639553273
2004-11-16T09:30:00-05:00,35.2,35.42999,35.12,35.12,2441900,3973559.8,50.13846531224507,51.28759189522532,NaN,NaN,-2.829811564020944,16.00939765003854,-0.0371882945692939,0.1133006918301831,0.150488986399477,-38764969,-36843890.2,32.94008426734483,33.10060656166685,NaN,NaN,4.228818634969582,7.701520067469888
2004-11-17T09:30:00-05:00,35.19,35.72,35.19,35.67,3971000,4048334.8,55.04591922817942,51.87180606932891,NaN,NaN,68.66453851097305,35.339720040952514,-0.008677184138807137,0.13964250622596808,0.14831969036477521,-34793969,-36901889.8,32.78174131420174,32.18055752917,NaN,NaN,5.128488082317661,7.3339440695909985
2004-11-18T09:30:00-05:00,35.78999,36,35.63,35.95,2195000,4034654.8,57.3474441099919,52.25547697461527,NaN,NaN,130.4812613996227,61.05607254256123,0.02616464342156971,0.18102549464173734,0.15486085122016763,-32598969,-35915189.4,38.222383586279776,31.87005340627886,NaN,NaN,6.591612001447264,7.227896631284751
2004-11-19T09:30:00-05:00,36.14999,36.50999,35.98,36.38,3936400,4159979.8,60.67701409648664,53.03788941773134,NaN,NaN,196.6658362188134,81.2152242315698,0.07266099071622123,0.24568708961544417,0.17302609889922294,-28662569,-34717089,44.1351921146921,32.46909321805143,NaN,NaN,8.884107701864217,7.464498212796103
2004-11-22T09:30:00-05:00,36.42999,37,36.38,36.96001,3719800,4217319.8,64.68191640339246,54.47432084734789,NaN,NaN,232.5332171793591,125.10300834894947,0.13343242849162368,0.33981663451375255,0.20638420602212887,-24942769,-31952649,54.868649491277196,34.4457987934035,NaN,NaN,12.166217010688754,8.136172326780768
2004-11-23T09:30:00-05:00,37,37.39,36.97,37.19,1845900,4218244.8,66.1539300686799,55.505333197480105,NaN,NaN,239.27698351785494,173.52436736532462,0.17732389905308438,0.4280390798384843,0.25071518078539995,-23096869,-28819029,63.44291184485548,37.27513544418598,NaN,NaN,15.302222243303683,9.159893743426899
2004-11-24T09:30:00-05:00,37.3,37.5,36.89,37.5,3549200,4130634.9,68.08478610808864,56.40547275068968,NaN,NaN,197.0172606882102,199.19491180077208,0.21303636401727782,0.5170106358069972,0.3039742717897194,-19547669,-25769769,69.51266128652453,40.49177948148292,NaN,NaN,18.517352683149145,10.496673591958649
2004-11-26T09:30:00-05:00,37.62,37.89999,37.60001,37.66,1032100,3797349.85,69.06568692497876,57.24759621910472,NaN,NaN,192.9530888900305,211.68927729885363,0.2316920777622275,0.5935893689925038,0.3618972912302763,-18515569,-22953089,73.83439227895121,43.85736394234974,NaN,NaN,21.448578883471573,12.06123149074621
2004-11-29T09:30:00-05:00,37.85001,37.85001,37.05,37.46001,2701900,3705799.95,66.32185816780427,58.338160579236906,NaN,NaN,138.78177293846437,200.11246464278383,0.21517719303609079,0.6308687825253898,0.415691589489299,-21217469,-21464069,75.78832978368507,47.16909173880341,NaN,NaN,23.112145847299796,13.639933541682435
2004-11-30T09:30:00-05:00,37.46001,37.62,37.39999,37.50999,3489800,3680494.95,66.67814233845807,59.671750011187065,NaN,NaN,120.98779679272413,177.80338056545685,0.1929458651785978,0.6568739209625463,0.46392805578394847,-17727669,-20021049,77.53885449860478,50.34946308530261,NaN,NaN,24.579143748808985,15.202677856986227
2004-12-01T09:30:00-05:00,37.39999,37.52499,36.53999,36.61,7173398,3692984.75,55.32760563333017,59.91210969396895,NaN,NaN,64.16083823637017,142.78015150915988,0.10723235570154993,0.5979685004108859,0.49073614470933596,-24901067,-20381888.6,76.05799152190976,53.07518623424887,NaN,NaN,22.48960441208476,16.243667364857448
2004-12-02T09:30:00-05:00,36.3,36.39,35.36,35.64,6399801,3839484.8,46.199355075531955,59.551644896005556,NaN,NaN,-24.204860335956656,98.53572730432651,-0.018489590432152037,0.4676241566691459,0.48611374710129795,-31300868,-22732528.4,67.07150144884434,55.211281710294934,NaN,NaN,17.46152927811537,16.417647638180007
2004-12-03T09:30:00-05:00,35.53,36.07001,35.52,35.99001,3980100,3858479.8,49.440804381045176,58.95009951146124,NaN,NaN,-21.262473025116996,55.69261492129702,-0.07841540147542092,0.3880944952570218,0.4665098967324427,-27320768,-24493568.2,61.234262062923335,57.107862967511856,NaN,NaN,14.420512166957186,16.132342570862463
2004-12-06T09:30:00-05:00,36.58,36.58,35.74001,36.00999,1497700,3626969.9,49.627376197465004,58.91359314611981,NaN,NaN,-2.4841608568172417,27.4394281622407,-0.11484307871733918,0.32295604833576874,0.4377991270531079,-25823068,-25414688,58.37265152278932,58.98582907306309,NaN,NaN,12.092850724980416,15.555272307165028
2004-12-07T09:30:00-05:00,36.05,36.05,35.25999,35.25999,3441100,3622359.9,43.185216997849544,58.416932552234414,NaN,NaN,-52.83156578846897,-7.324444353997906,-0.18350955607173514,0.20841218196343902,0.39192173803517416,-29264168,-27721987.8,51.83780708855227,60.33566641743504,NaN,NaN,7.913125473760023,14.463537045250028
2004-12-08T09:30:00-05:00,35,35.59,34.75999,35.5,4576398,3552499.7,45.6180788097148,57.743515379486944,NaN,NaN,-76.0705892759765,-35.37072985646723,-0.20518469780381698,0.13544086578040293,0.3406255635842199,-24687770,-27679328.4,51.94492460453658,61.70446522388754,NaN,NaN,5.267552114476502,13.149824912282382
2004-12-09T09:30:00-05:00,35.60001,35.8,35.31,35.8,3256000,3461364.75,48.581878810671796,57.11740357239264,NaN,NaN,-49.836900224106905,-40.497137834097266,-0.1919742549119018,0.10065774494434265,0.29263199985624444,-21431770,-25705508.8,56.73923186852375,63.027097244047816,NaN,NaN,3.975562052389931,11.839215932297746
2004-12-10T09:30:00-05:00,35.83,36.00999,35.44,35.55,2796900,3449784.75,46.31653637908315,56.09165516400668,NaN,NaN,-50.71794522001565,-46.388232273076994,-0.19225288360973733,0.05231589534407277,0.2445687789538101,-24228670,-25087089.2,58.148074599343836,64.02801742152295,NaN,NaN,2.2211236053829713,10.465202742738493
2004-12-13T09:30:00-05:00,35.60001,36.17999,35.60001,36.17999,3042100,3457919.75,52.34672179883088,55.210569835109425,NaN,NaN,-23.787633860114294,-50.64892687373641,-0.14437450568311555,0.06410064684991568,0.20847515253303123,-21186570,-24159789.6,60.23903915088159,64.41161668292327,NaN,NaN,2.552700430460572,9.334845269555933
2004-12-14T09:30:00-05:00,36.14999,36.36,36.00999,36.28999,2412900,3372969.85,53.33243148517869,54.294748507716484,NaN,NaN,-6.954579989340599,-41.473529713910736,-0.10167760095285822,0.08137815134195847,0.1830557522948167,-18773670,-22061690,64.55410906269614,64.49098791276904,NaN,NaN,3.1162808543240845,8.446478924522811
2004-12-15T09:30:00-05:00,36.38,36.64999,36.10001,36.56,5307898,3516269.75,55.75191447902754,53.413829105640694,NaN,NaN,8.782001441086427,-24.503011570498206,-0.05402337733221754,0.11552653062954477,0.1695499079617623,-13465772,-19817290.4,68.49318403515616,64.41816810909988,NaN,NaN,4.307525535909173,7.855199869006578
2004-12-16T09:30:00-05:00,36.57001,36.57001,36.02,36.19,2678900,3451664.75,51.789535808722384,52.179818311622384,NaN,NaN,-13.866634546168195,-17.308958434910465,-0.046480928232571495,0.11144874767104795,0.15792967590361945,-16144672,-18759870.8,70.17486139505641,64.15677304596453,NaN,NaN,4.164907348527767,7.328015223223891
2004-12-17T09:30:00-05:00,35.92,36.22,35.92,36.05,3142600,3499044.75,50.33189516228479,51.03767809694242,NaN,NaN,-36.71528804320705,-14.508426999548742,-0.04969114783795231,0.09581574110617908,0.14550688894413139,-19287272,-17771591.2,71.69544947593734,63.864424452553976,NaN,NaN,3.6297909181107513,6.799697465350585
2004-12-20T09:30:00-05:00,36.24001,36.53999,36.12,36.49001,1947300,3399589.75,54.65192278310744,50.178662414417374,NaN,NaN,-2.177295163464968,-10.186359260218879,-0.022344507489200943,0.11757625458263021,0.13992076207183116,-17339972,-17002271.6,72.85561707985062,63.529907494071544,NaN,NaN,4.4292977374663,6.461068932795687
2004-12-21T09:30:00-05:00,36.38,36.82001,36.38,36.8,2912300,3359214.75,57.45919458430701,50.33091876805859,NaN,NaN,30.022190617796635,-2.7910051387914323,0.014474379621617822,0.15801373659885343,0.1435393569772356,-14427672,-16133072,74.14506929821553,63.39327019237909,NaN,NaN,5.940157792129084,6.386653055557601
2004-12-22T09:30:00-05:00,36.8,36.92,35.96001,36.3,3989800,3466409.75,51.88045179157784,50.73671139063329,NaN,NaN,4.269796216498068,-3.693446183709104,0.00357552103761824,0.1480087582742584,0.14443323723664017,-18417472,-17123412,70.06137322882026,63.606832462377376,NaN,NaN,5.593132987115433,6.273293045780148
2004-12-23T09:30:00-05:00,36.39,36.55,36.28999,36.50999,2130600,3395479.75,53.90462400602339,51.055555649560304,NaN,NaN,17.69234257390613,2.6183492403057627,0.008641193873143188,0.15523472957806916,0.14659353570492598,-16286872,-17151852,69.9422378869409,64.22883073552148,NaN,NaN,5.9024013458368865,6.220308517216825
2004-12-27T09:30:00-05:00,36,36.5,35.86,35.87,4468000,3567274.75,47.36513313030896,50.89396685904916,NaN,NaN,-24.054600224191613,5.1504868041088505,-0.030815858143110858,0.10807371302603741,0.13888957116914827,-20754872,-17445372,68.64487087039404,64.96256068892183,NaN,NaN,4.1469376415222,5.924112677831879
2004-12-28T09:30:00-05:00,35.89999,36.23,35.89999,36.12,2194800,3541919.75,49.92092631733518,51.37508895329814,NaN,NaN,-14.591917722872084,2.667562292227427,-0.039243169486374574,0.08983560931118006,0.12907877879755464,-18560072,-17689392,67.52349641639157,66.08296706948178,NaN,NaN,3.467366240055006,5.573148901006611
2004-12-29T09:30:00-05:00,35.85001,36.41,35.85001,36.39,2106800,3472769.75,52.59798225925767,51.87365348540834,NaN,NaN,25.650426163119196,1.7932094012919386,-0.02641407053799756,0.09606119062505769,0.12247526116305525,-16453272,-18094512,65.60731006594776,67.05885174529685,NaN,NaN,3.7008225649107565,5.305673710135775
2004-12-30T09:30:00-05:00,36.34,36.36,36.19,36.23,1155500,3171874.85,50.86281071326783,52.03657719273664,NaN,NaN,46.67813448476469,10.274877054945263,-0.028315780421702602,0.08708053563592699,0.1153963160576296,-17608772,-17932772,66.02188264197017,67.72189822911446,NaN,NaN,3.390224391430258,5.032038093177844
2004-12-31T09:30:00-05:00,36.17999,36.45,36.12,36.32001,632200,2883494.8,51.82563012629967,52.43008388896639,NaN,NaN,50.82066840892819,16.900542221949674,-0.023331193601304645,0.08623232405599879,0.10956351765730343,-16976572,-18070712,65.29894957947766,68.23267501340975,NaN,NaN,3.4032423967063843,4.7993529936819215
2005-01-03T09:30:00-05:00,36.10001,36.2,34.98,34.98,3981600,2883569.8,39.43662941140901,51.507934432721974,NaN,NaN,-154.77462851920868,-9.243463437053737,-0.10549906879717534,-0.022310318339165747,0.0831887504580096,-20958172,-18111372,65.07276069908363,68.57794083828131,NaN,NaN,-0.7429415456370695,4.007596630922066
2005-01-04T09:30:00-05:00,35.2,35.35001,34.78,34.8,6334500,3125409.8,38.11844546873187,50.42122114583291,NaN,NaN,-190.2128796145395,-44.36765581538722,-0.1637154610441565,-0.12145557584718603,0.042259885196970465,-27292672,-19857892,56.08587125958248,67.97306670948748,NaN,NaN,-4.476502738550208,2.79558243528317
2005-01-05T09:30:00-05:00,34.8,35.05,34.56,34.64999,3974000,3152054.8,37.00823085035279,49.08238660092756,NaN,NaN,-196.43028913190543,-88.78379887439215,-0.20158069592664066,-0.20971598471133035,-0.008135288784689693,-31266672,-22820572,44.78652329713563,66.27973379962887,NaN,NaN,-7.836856761235037,1.2766625500662836
2005-01-06T09:30:00-05:00,34.55,35.50999,34.53999,35.25,5028801,3174674.95,44.03005000524325,48.52813761496476,NaN,NaN,-135.02908304553722,-125.12524238045253,-0.17638129406050498,-0.22861190636032092,-0.05223061229981594,-26237871,-24546391.8,39.76129478351785,64.10733618451897,NaN,NaN,-8.565004844452844,-0.12928993486502027
2005-01-07T09:30:00-05:00,35.39999,35.39999,34.66,34.97,4722898,3248019.85,41.69429801960555,47.91116639048768,NaN,NaN,-130.75883418417226,-161.44114289907262,-0.16873336761998417,-0.26314732182479617,-0.094413954204812,-30960769,-27343231.2,33.25013136176396,61.36124203350659,NaN,NaN,-9.892092646570743,-1.5239760365372663
2005-01-10T09:30:00-05:00,35.35001,35.60001,35.10001,35.23,4501801,3333264.9,44.63154170626688,47.19542488499907,NaN,NaN,-81.47952401974474,-146.78212199917982,-0.13764116695166878,-0.26646541289439796,-0.12882424594272918,-26458968,-28443390.4,31.093200641604625,58.3782122879176,NaN,NaN,-10.09622497491915,-2.748583027734678
2005-01-11T09:30:00-05:00,35.22,35.39,35,35.28,1647900,3263554.9,45.20323775227627,46.31999939699688,NaN,NaN,-81.03922919342425,-124.94739191495678,-0.10657245126518683,-0.2620398100242127,-0.1554673587590259,-24811068,-27947069.6,33.198532011354246,55.45345962457036,NaN,NaN,-10.095171788487429,-3.7980957078422137
2005-01-12T09:30:00-05:00,35.39999,35.89999,35.21001,35.89999,3524000,3319109.9,51.8431211508725,46.31733292266078,NaN,NaN,-22.422373520512938,-90.14580879267828,-0.04052879855198621,-0.20612835694900866,-0.16559955839702245,-21287068,-25951148.8,41.0047542227583,53.37798683842307,NaN,NaN,-8.052043315418054,-4.405802508924476
2005-01-13T09:30:00-05:00,36.14999,36.42999,35.95,36.14,3599800,3233705,54.15886364485833,46.33549289686328,NaN,NaN,42.45139248625981,-54.649713686318876,0.01981728713784836,-0.140827949474712,-0.16064523661256036,-17687268,-24241028.2,46.74682482915899,51.72117162001008,NaN,NaN,-5.646942233650991,-4.583108183885407
2005-01-14T09:30:00-05:00,36.25,36.47,36.05,36.46001,1646000,3182060,57.119663268117925,47.03224504956392,NaN,NaN,61.11358723517834,-16.275229402448762,0.07848905216801044,-0.06253392140254732,-0.14102297357055776,-16041268,-21257128,54.980511056681515,50.74514591903062,NaN,NaN,-2.7042718140504256,-4.314702988194695
2005-01-18T09:30:00-05:00,36.7,36.91,36.59,36.82001,4408000,3245330,60.23149789954379,47.7687144482931,NaN,NaN,107.11042584048764,21.442760569597702,0.1354088905217742,0.028238139581659993,-0.10717075094011422,-11633268,-18291988,61.3719315531058,50.30574842879592,NaN,NaN,0.7669266153326526,-3.5887559019765027
2005-01-19T09:30:00-05:00,36.64999,36.96001,36.64999,36.69,2677000,3281815,58.57819195852646,48.19587228395516,NaN,NaN,101.24363449536759,57.89933330735607,0.15666690549395573,0.08866288092733043,-0.06800402456662528,-14310268,-16191828,65.14624737241817,50.2728153792581,NaN,NaN,3.1518617218508274,-2.625810527144027
2005-01-20T09:30:00-05:00,36.60001,36.60001,36.05,36.32001,3944200,3333410,54.03266862623344,48.42229070630985,NaN,NaN,52.97596732424842,72.97900147630835,0.13878636165180105,0.10547892749812604,-0.033307434153675014,-18254468,-15585308,66.1741716258235,50.28369316381905,NaN,NaN,3.894592981395722,-1.6943243116383488
2005-01-21T09:30:00-05:00,36.55,36.84,36.39,36.39999,4351801,3351510.05,54.848307764752086,48.63819625191359,NaN,NaN,77.45134288393079,79.97899155584254,0.12571156703534536,0.12383202464050669,-0.0018795423948386736,-13902667,-14828387.8,67.46380991232033,50.43832604473638,NaN,NaN,4.736855105237965,-0.7755843949417326
2005-01-24T09:30:00-05:00,36.8,37.02,36.67999,36.72,3857500,3437855.05,58.05526421354452,49.96809873778041,NaN,NaN,103.7615173410893,88.50857757702474,0.13136595702563883,0.16232790388720986,0.030961946861571034,-10045167,-13629167.6,69.45104548176985,50.75106067207111,NaN,NaN,6.390467419517274,0.24813729283812547
2005-01-25T09:30:00-05:00,36.95,37.05,36.60001,36.87,2128500,3320880.05,59.50707678559507,51.49585811755636,NaN,NaN,98.04585545544127,86.69566350001546,0.13731397400180959,0.20260441436383303,0.06529044036202344,-7916667,-12885847.4,70.64774683738656,51.79119464191427,NaN,NaN,8.191641303603243,1.382923580090285
2005-01-26T09:30:00-05:00,36.92999,37.28999,36.81,37.23,3548200,3388550.05,62.8321165644754,53.34042138285083,NaN,NaN,114.23650085203566,89.29423677134908,0.15622296888490433,0.26056915146815385,0.10434618258324953,-4368467,-10897487.2,73.62419894697092,53.8510286169025,NaN,NaN,10.740463517593778,2.7197149997336414
2005-01-27T09:30:00-05:00,37.14999,37.71001,37.10001,37.56,2962300,3431325.05,65.6190803608064,54.88249497967677,NaN,NaN,133.21967882794547,105.34297907208847,0.1799938192055094,0.3293384565901363,0.1493446373846269,-1406167,-7527827,77.74323205463452,56.56402413626797,NaN,NaN,13.777933419150429,4.2994604882217535
2005-01-28T09:30:00-05:00,37.35001,37.35001,36.98,37.10001,5000301,3623565.1,58.980282039000464,56.11720812391926,NaN,NaN,94.4734937831869,108.74740925193969,0.1547403205089858,0.34277003802085915,0.18802971751187333,-6406468,-6028587.2,79.29270060220291,59.85277908201361,NaN,NaN,14.479147228398572,5.753701451104156
2005-01-31T09:30:00-05:00,37,37.7,36.85001,37.55,5630699,3873490.05,62.93127404784591,57.424331862603474,NaN,NaN,103.81211741640718,108.75752926700326,0.15780325296870565,0.3852837837227554,0.22748053075404975,-775769,-4174707.6,81.04955283736707,63.42108995313949,NaN,NaN,16.312098878794103,7.262043940774149
2005-02-01T09:30:00-05:00,37.75999,38.2,37.71001,38.19,4165602,3882690.15,67.69689546461423,59.03102169919904,NaN,NaN,144.4746580819524,118.0432897923055,0.19022014068409643,0.46525570660917026,0.27503556592507383,3389833,-1913407.6,82.94977046766773,66.97474984287616,NaN,NaN,19.503088364757577,9.01076457277178
2005-02-02T09:30:00-05:00,38.35001,38.74001,38.22,38.72,3102600,3721095.15,71.01963507037902,60.400772693449504,NaN,NaN,168.50610230792958,128.89721008348428,0.23188267885457137,0.564888914493288,0.3330062356387167,6492433,258772.4,84.55217957484402,70.085280225168,NaN,NaN,23.343503128576508,11.058298652172455
2005-02-03T09:30:00-05:00,38.5,38.94,38.37,38.88,3435100,3694150.15,71.95741072277708,61.67209748472942,NaN,NaN,166.19723297288724,135.49272091247263,0.25301514937461606,0.6492751723569867,0.3962600229823707,9927533,2525512.4,86.02787342421215,72.89106941052894,NaN,NaN,26.71461922146981,13.294915876357791
2005-02-04T09:30:00-05:00,39,39.11,38.78999,39.05,4417801,3663600.15,72.95864825784334,62.803453555424085,NaN,NaN,166.27508833064965,149.85303982196518,0.26023347613351916,0.7215518681492696,0.4613183920157505,14345334,6675872.8,88.24255286972154,75.2669295400318,NaN,NaN,29.770029904461815,15.648503594658365
2005-02-07T09:30:00-05:00,39.14999,39.2,38.50999,38.78999,3674100,3611160.25,68.90632649395369,63.423084169310506,NaN,NaN,135.52998152377157,156.19661264343807,0.2303169321781109,0.749214557238389,0.5188976250602781,10671234,8965273.4,89.25436762246017,77.25853211641426,NaN,NaN,31.108783112014937,17.857114954280732
2005-02-08T09:30:00-05:00,38.62,39.14,38.56,39.07001,2208100,3496475.2,70.78811336008178,64.29522141227874,NaN,NaN,124.76078039446831,152.25383710594124,0.21263175946454993,0.7846873243909656,0.5720555649264156,12879334,10863173.6,90.02103950966209,79.03530298336025,NaN,NaN,32.80231527224767,19.992143571133152
2005-02-09T09:30:00-05:00,39.10001,39.38,38.69,39,5913199,3709740.15,69.65311649581403,65.41096768867736,NaN,NaN,116.37518440591002,141.8276535255373,0.18071733160444414,0.7979522294319707,0.6172348978275266,6966135,10957914,90.05916775597873,80.74137413551419,NaN,NaN,33.86006828211835,21.973275672702467
2005-02-10T09:30:00-05:00,39.42,40.12,39.25,40.07001,5704199,3818750.1,75.98957521328563,66.92105822071547,NaN,NaN,147.44045489240054,138.07629790944003,0.21389881108082365,0.8846084116785562,0.6707096005977325,12670334,11506474.2,90.29049791219953,82.37185184979128,NaN,NaN,36.9874151934926,24.118152747101057
2005-02-11T09:30:00-05:00,40.03,40.63,39.95,40.42,4245199,3851020.05,77.63456196033678,68.31957948834348,NaN,NaN,155.3590636596557,135.89309297524125,0.2397042032147335,0.9703398546161495,0.730635651401416,16915533,12020514,90.5132812297984,83.87629726036475,NaN,NaN,40.10567274710089,26.40208417567246
2005-02-14T09:30:00-05:00,40.47,40.63,40.38,40.47,2877100,3912575.05,77.86784614248994,69.63106301383597,NaN,NaN,144.4721864648549,137.6815339634579,0.23984265006893524,1.030438963987585,0.7905963139186498,19792633,13844793.8,91.27812859251097,85.34989595715935,NaN,NaN,42.64200274857865,28.722072543230485
2005-02-15T09:30:00-05:00,40.64999,40.67999,40.25999,40.56,2719600,3828155.05,78.30647301851438,70.73637418912446,NaN,NaN,127.19947032569057,138.16927194970236,0.22589235189832824,1.0729617537915601,0.8470694018932319,22512233,15771373.6,92.01069652205777,86.6632172125227,NaN,NaN,44.833563503521425,31.023714108986333
2005-02-16T09:30:00-05:00,40.67999,41.75,40.59,41.7,5429801,3965795.1,82.9231237076696,71.97237728532897,NaN,NaN,154.05141629647983,145.70451832781632,0.27033649161764184,1.1849900164152842,0.9146535247976424,27942034,19966553.4,93.32535932038861,87.7762263029337,NaN,NaN,48.54319729742335,33.52649742162019
2005-02-17T09:30:00-05:00,41.8,41.99001,41.07001,41.14,5190102,4028090.2,74.53221950739331,73.08322996164274,NaN,NaN,142.8120436187808,144.77883607309235,0.23994511843567978,1.214584922842242,0.9746398044065623,22751932,21982873,93.84923480962448,88.81597874632097,NaN,NaN,48.781229235848535,35.705744823652815
2005-02-18T09:30:00-05:00,41.23,42.25999,41.2,42.05,6549898,4137995.05,78.36360656517535,74.18553942716629,NaN,NaN,147.3466286889642,143.17634907895408,0.25750654392471284,1.2965229843124533,1.0390164403877404,29301830,24460132.4,94.42788615359234,89.7715739831942,NaN,NaN,50.35831682087956,37.79896939468521
2005-02-22T09:30:00-05:00,42.5,42.77,41.72,41.75,6547301,4272485.1,74.39035462035041,74.663643652576,NaN,NaN,136.38476524571274,141.55886483512566,0.22639697295642258,1.3220126565832686,1.095615683626846,22754529,25052511.6,94.55968892751976,90.60085387318362,NaN,NaN,50.21485223124169,39.572666942764705
2005-02-23T09:30:00-05:00,41.7,42.35001,41.7,42.28,3254700,4328795.1,76.64345049141235,75.0653447540784,NaN,NaN,120.83362914825419,140.28569659963838,0.2188648359107619,1.3691967285152984,1.1503318926045365,26009229,25751910.8,94.71853233977534,91.32702192782156,NaN,NaN,50.86236415149483,41.18548082972615
2005-02-24T09:30:00-05:00,42.45,43.14999,42.25,43.11,5047602,4403765.2,79.66123116762338,75.61561764299599,NaN,NaN,136.7829180882167,136.83199695798572,0.24515188665966225,1.4567717509291143,1.211619864269452,31056831,26374870.2,94.86241994119754,91.9580609647491,NaN,NaN,52.48179976402786,42.79924067748354
2005-02-25T09:30:00-05:00,43.28,44.39,43.17999,44.17,6829398,4597120.1,82.73011764969239,76.31357974241378,NaN,NaN,161.1676032307335,140.50310888037626,0.30537745043332576,1.593341677311109,1.2879642268777833,37886229,29401729.6,95.50343316544385,92.47669527158641,NaN,NaN,55.018458153136315,44.544843174005365
2005-02-28T09:30:00-05:00,44.5,44.75,42.41,43.85001,9474500,4820830.05,78.86166461667005,77.02467532260779,NaN,NaN,136.37276724901128,138.30833659238567,0.294954138228837,1.6566568996638296,1.3617027614349926,28411729,29223709.4,94.7546250817974,92.8695708043962,NaN,NaN,55.60419759869719,46.12475094896134
2005-03-01T09:30:00-05:00,43.75,44,42.94,43,7461398,4912365,69.55726233679808,76.93675739237324,NaN,NaN,108.1950924077765,132.67040202479842,0.2062989881861299,1.619576496667655,1.413277508481525,20950331,28862869.8,93.16017319439948,93.0937946390203,NaN,NaN,52.7241671073322,47.06752468587146
2005-03-02T09:30:00-05:00,42.82001,43.71001,42.72,43.63,6115801,5009874.95,72.17738532753874,77.11706230892501,NaN,NaN,98.97553727345769,128.29878364983912,0.16723767075262352,1.6223245969223044,1.4550869261696808,27066132,29074250.4,93.23201970884399,93.32042692136783,NaN,NaN,51.30951613789827,47.67352346473243
2005-03-03T09:30:00-05:00,43.8,44.44,43.75,44.35001,9863500,5347919.95,74.84234583549654,77.03511735336863,NaN,NaN,121.28959347234047,125.20011872666389,0.16667152505187643,1.6634263324845264,1.49675480743265,36929632,30248810.6,93.63227730151632,93.55912544917616,NaN,NaN,51.08296822241748,48.160587001544584
2005-03-04T09:30:00-05:00,44.39999,45.09,44.12,44.92,5991000,5475714.95,76.74161203208426,76.97133521563633,NaN,NaN,128.88245163490905,118.743088407499,0.18030928146525427,1.7221414092642178,1.5418321277989635,42920632,31255691.2,93.96193674991083,93.80545798632706,NaN,NaN,51.55534720392452,48.64555274474172
2005-03-07T09:30:00-05:00,44.75,44.96001,44.10001,44.61,7201898,5614919.8,73.49197571513334,76.65877304225371,NaN,NaN,111.53892430223198,113.77631981814314,0.14556498751376123,1.723788362191165,1.5782233746774037,35718734,32717092.2,94.41396073481151,94.02944599649139,NaN,NaN,50.84906847041385,48.96034070555203
2005-03-08T09:30:00-05:00,44.45,44.92999,44.39999,44.56,5793398,5720884.7,72.95537146412966,76.2765515026548,NaN,NaN,104.5730765440609,113.05191664540003,0.09857793555208572,1.701445794117511,1.6028678585654252,29925336,34512093.2,94.91727623684653,94.23705883326203,NaN,NaN,50.12976331180945,49.12740107787452
2005-03-09T09:30:00-05:00,44.89,45.14,43.25,43.33,15577000,6389329.7,61.13060276127329,74.71994286362649,NaN,NaN,66.65190265486717,106.5871897216819,-0.029149023402721186,1.5664315793120238,1.595580602714745,14348336,31968534,83.44386469934712,93.5312377889019,NaN,NaN,45.47372870815213,48.60544788219989
2005-03-10T09:30:00-05:00,43.3,43.55,42.05,42.45,19841392,7085739.35,54.34404448677499,73.27793036215375,NaN,NaN,4.998733774858077,83.32901778218545,-0.17838391476492843,1.3726007092585846,1.550984624023513,-5493056,23483996.4,58.18031448288932,90.9834577655637,NaN,NaN,39.16219832525233,47.25641223120738
2005-03-11T09:30:00-05:00,42.31,43.2,42.19,42.8,10945500,7347804.4,56.41649019167662,71.71027919261813,NaN,NaN,0.0471548106437015,57.561958417332356,-0.2543741223571996,1.2330169710770136,1.4873910934342132,5452444,15990358.8,45.17205922370123,87.4651844134286,NaN,NaN,34.806411662215595,45.477840721351406
2005-03-14T09:30:00-05:00,42.89999,43.24001,42.13,43.11,10158199,7643454.4,58.22523809732385,70.55562801240195,NaN,NaN,-1.716692665846583,34.91083502371665,-0.2824453853712052,1.1343343617202066,1.4167797470914119,15610643,11968740.6,40.00282213286496,83.56826535666755,NaN,NaN,31.861924095233977,43.532709774763205
2005-03-15T09:30:00-05:00,43.2,43.67,42.5,42.50999,12323602,8115779.5,53.58951836023395,68.90891857446063,NaN,NaN,-5.667960225533402,12.862627669797794,-0.33644140235964604,0.9962279941418544,1.3326693965015004,3287041,6641081.6,34.38858075154269,79.25898310036523,NaN,NaN,27.896589638380732,41.298978326708564
2005-03-16T09:30:00-05:00,42.5,43.25,42.10001,42.64999,12203301,8589964.55,54.49979517438671,67.1116731463723,NaN,NaN,-32.61192582942516,-6.990138027060672,-0.3558634650458141,0.8878400651942329,1.243703530240047,15490342,6869482.8,34.81097846365209,74.9695944233977,NaN,NaN,24.98757066169231,38.96877723170624
2005-03-17T09:30:00-05:00,42.89999,43.45,42.89999,43.39,11795102,8908229.6,59.069599797220484,65.42163615691001,NaN,NaN,6.010493693693703,-6.787786043293542,-0.3134947850768124,0.8518350488940314,1.1653298339708438,27285444,13425182.8,45.63039157651684,71.40723430990292,NaN,NaN,23.85681626508065,36.80992566504544
2005-03-18T09:30:00-05:00,43.85001,43.85001,43.243,43.78,8066000,9052024.5,61.276922586945744,64.16558315478684,NaN,NaN,32.11555244339695,-0.3741065167428983,-0.25624020339622544,0.845029579725562,1.1012697831217875,35351444,19404982.8,53.2519685417199,68.44275884275451,NaN,NaN,23.59037450512576,34.92141835648549
2005-03-21T09:30:00-05:00,43.7,43.89999,43.03999,43.39999,8859699,9167514.55,57.99502018516878,63.33970871538475,NaN,NaN,8.206923130882002,1.6106166426028188,-0.24121302275169776,0.7997535046821653,1.040966527433863,26491745,21581203.2,55.686554193027675,65.76607177122796,NaN,NaN,22.38480969866532,33.13047426251118
2005-03-22T09:30:00-05:00,43.25,44.06,42.82001,42.88,9790000,9329649.5,53.752607599661786,62.02365316339354,NaN,NaN,-20.060098926411037,-1.267811097572708,-0.26182433194645416,0.7136861125007954,0.9755104444472495,16701745,24264144,58.55240737361523,63.2889566044259,NaN,NaN,20.074646286833534,31.265355980271515
2005-03-23T09:30:00-05:00,42.39999,42.59,41.7,42.06,24337504,10383789.7,47.81282989840846,60.09297345360154,NaN,NaN,-151.0605513681067,-24.957536205309015,-0.3222418639614524,0.572708114495434,0.8949499784568864,-7635759,19638923.8,52.2757980948583,60.3349223753789,NaN,NaN,16.169136719226895,29.10875322869371
2005-03-24T09:30:00-05:00,42.3,42.67,41.63,42.03,10880500,10675434.6,47.605567515501185,58.01182741670274,NaN,NaN,-139.74594817988384,-54.10882458002452,-0.35329156959526864,0.45333551646280057,0.8066270860580692,-18516259,10478583.2,42.54783896700217,56.66248681945685,NaN,NaN,12.996314232675582,26.80697622926255
2005-03-28T09:30:00-05:00,42.10001,42.33,41.7,42.08,10815602,10874744.8,48.01007694101738,56.19169178998017,NaN,NaN,-131.0760428216675,-86.74714363303741,-0.35839577767012354,0.35863236397041476,0.7170281416405383,-7700657,1868163,35.80344032110902,52.476021075620956,NaN,NaN,10.52246717226485,24.480617792548593
2005-03-29T09:30:00-05:00,42.10001,42.62,41.34,41.39999,9198602,10860949.9,43.13276248068009,54.06150543401948,NaN,NaN,-135.29039193457612,-115.44660664612903,-0.3927409557914514,0.22610194690122398,0.6188429026926754,-16899259,-6810037.8,30.54769612402005,47.878193924704775,NaN,NaN,6.877992261220475,21.965957002358863
2005-03-30T09:30:00-05:00,41.5,42.08,40.78,42.02,24176000,11696680,48.29079735868105,53.14437647669147,NaN,NaN,-128.9654600842195,-137.22767887769072,-0.35975400105853494,0.16915040136950665,0.5289044024280416,7276741,-8695038.6,29.53357008054958,44.02745859479067,NaN,NaN,5.2205502616023,19.57375603939364
2005-03-31T09:30:00-05:00,42.69,43,42.39999,42.87,12487102,12015245.05,54.397610820044754,53.1482026433536,NaN,NaN,-28.621458810128356,-112.73986036609506,-0.27079642392762493,0.19040887251851046,0.4612052964461354,19763843,-3215118.2,36.16794063221108,42.45514617688509,NaN,NaN,5.665991515716689,17.58693253601122
2005-04-01T09:30:00-05:00,43.42999,43.99001,42.85001,43.92999,9587102,12001425.15,60.64023060343968,53.44989838705096,NaN,NaN,47.59533552325325,-75.27160362546763,-0.13740257714574444,0.28945207501395487,0.4268546521596993,29350945,6358322.6,45.77321550533952,42.49808591128782,NaN,NaN,8.15987447043849,16.240209955215114
2005-04-04T09:30:00-04:00,44.10001,44.48,43.22,43.55,14104199,12407085.1,57.59633855260863,53.40497699099988,NaN,NaN,71.34271130036517,-34.787852801061106,-0.07473265456857953,0.3334388339489749,0.4081714885175544,15246746,10947803.2,49.682273531922675,43.1894752969348,NaN,NaN,9.210656025685756,15.235987965282348
2005-04-05T09:30:00-04:00,43.16,43.75,42.7,43,8952602,12494620.3,53.41686123272859,53.39264433903521,NaN,NaN,22.693290124262074,-3.1911163892934646,-0.07035568862048203,0.3202268777419519,0.39058256636243394,6294144,15586483.8,53.34318297954661,44.54337545607793,NaN,NaN,8.759342465939298,14.310752893947626
2005-04-06T09:30:00-04:00,42.99001,43.88,42.7,43.67999,10449602,12727430.5,57.521033305183344,53.60844706266354,NaN,NaN,65.67926901619948,35.73782943079034,-0.024089623187894482,0.36047053737756585,0.38456016056546033,16743746,17479884.8,54.78910185502449,45.97038426974739,NaN,NaN,9.70647701112238,13.652999196401163
2005-04-07T09:30:00-04:00,44,44.2,43.02,43.50999,19291600,12913160.5,56.18820846940187,53.40263339639078,NaN,NaN,89.48133544142036,59.35838828110009,-0.008183096270468815,0.3743312902273743,0.38251438649784314,-2547854,13017545.4,50.7938459884341,46.3392024420272,NaN,NaN,10.058536468234308,13.139504520948755
2005-04-08T09:30:00-04:00,43.2,43.59,42.71001,42.72,11712301,12506705.95,50.349715345017955,52.622118593395946,NaN,NaN,15.934123001450725,53.02614577673959,-0.05168684881628355,0.3179058254774887,0.36959267429377224,-14260155,4295325.4,44.03466285763861,45.68082346459282,NaN,NaN,8.526666715061424,12.48052769153628
2005-04-11T09:30:00-04:00,42.64999,43.13,42.3,43.03999,11625898,12540725.85,52.50261972192224,52.22980427459262,NaN,NaN,-7.927323235719597,37.172138869522634,-0.05919313969833584,0.29560124967085244,0.3547943893691883,-2634257,719124.8,41.590889942470774,44.67399030383876,NaN,NaN,7.9303735645045546,11.83050567338889
2005-04-12T09:30:00-04:00,42.89,43.03999,42.16,42.36,14681199,12766875.85,47.76298113617782,51.8019738129152,NaN,NaN,-43.31964626199858,23.9695515922705,-0.1074249011501413,0.22051326293151163,0.32793816408165294,-17315456,-4002795.2,38.54888815766038,43.245167502699125,NaN,NaN,5.9382224836473565,10.988750931997242
2005-04-13T09:30:00-04:00,42.00999,42.60001,41.3,41.32001,18089296,13055160.55,41.58046925643768,51.35680519563157,NaN,NaN,-120.12495335868435,-13.191292882706268,-0.20138372583189879,0.07620850679177948,0.27759223262367827,-35404752,-14432494.8,32.83607132195452,41.856615590348845,NaN,NaN,2.132283794671307,9.72354134095068
2005-04-14T09:30:00-04:00,41.55,42.02,41.17,41.3,19536704,13421830.7,41.46924429501249,50.91849639416809,NaN,NaN,-127.03524607258831,-56.494609185508,-0.25352617602868815,-0.03931548741218194,0.21421068861650622,-54941456,-24911215.2,28.298504225589696,40.838805965962244,NaN,NaN,-0.8829133903589956,8.208333522192156
2005-04-15T09:30:00-04:00,41.05,41.25,39.67,39.73,40282496,14846200.4,33.82423370934205,49.90522187761985,NaN,NaN,-204.65657829607736,-100.61274944501362,-0.37506444271798123,-0.2546198647809703,0.12044457793701091,-95223952,-41103974.6,23.00749518702878,39.92480988495651,NaN,NaN,-6.341630425770424,6.129767243911788
2005-04-18T09:30:00-04:00,39.69,40.53,39.41,40.45,31338608,16009830.8,39.346593458449036,49.63478123317477,NaN,NaN,-178.34194875517412,-134.69567454890452,-0.3867301281169288,-0.3629680822091501,0.023762045907778695,-63885344,-53354192,19.96608160482033,39.16898027644224,NaN,NaN,-8.984700763210892,3.970557528608548
2005-04-19T09:30:00-04:00,40.96001,41.64999,40.75999,41.39999,20136304,16573661.05,45.776232944388624,49.45516948929674,NaN,NaN,-80.75785691369906,-142.18331667924463,-0.3133594129526033,-0.3679372202829754,-0.054577807330372125,-43749040,-58640908.8,18.810417786079952,38.40304082683726,NaN,NaN,-8.998776139666722,2.1177955759977953
2005-04-20T09:30:00-04:00,41.67,41.81,40.55,40.55,21364496,17152385.85,41.533821524812325,48.536327396780145,NaN,NaN,-94.05547238831112,-136.96942048516996,-0.30469205250264175,-0.43544287295867434,-0.1307508204560326,-65113536,-64582665.6,17.578891544800953,37.075251606307965,NaN,NaN,-10.463218664526014,0.3205078273515367
2005-04-21T09:30:00-04:00,40.66,41.95,40.55,41.95,14900000,16680510.65,49.78808651685826,47.76117424773861,NaN,NaN,-50.880963822859634,-121.73856403522423,-0.19275029839865016,-0.3716886934543453,-0.17893839505569514,-50213536,-63637081.6,18.493442079862604,35.12669636163105,NaN,NaN,-8.746094934288312,-0.9747211385970131
2005-04-22T09:30:00-04:00,42.10001,42.49001,41.07001,42.03999,11454199,16709195.6,50.27405448963831,47.23815395752644,NaN,NaN,-21.44239054731724,-85.09572648547223,-0.10510878769326282,-0.31032437967227366,-0.20521559197901085,-38759337,-52344158.6,28.67269710117425,33.626012330863304,NaN,NaN,-7.276707837042459,-1.8750049526606483
2005-04-25T09:30:00-04:00,42.39999,42.89,42.31,42.63,12959602,16816395.6,53.45477709327481,47.24086223327975,NaN,NaN,30.1164417009044,-43.40404839425652,-0.005142839137495331,-0.21164414090088002,-0.2065013017633847,-25799735,-44727036.8,34.605173891408754,32.28758311028203,NaN,NaN,-5.026469215521087,-2.325214133069282
2005-04-26T09:30:00-04:00,42.5,42.8,41.92999,41.92999,14065000,17059715.5,49.41608593117753,46.661937420850755,NaN,NaN,0.6466682984456229,-27.123143351827576,0.0149931069822766,-0.18775991803553893,-0.20275302501781553,-39864735,-43950175.8,35.19715982678653,30.8881586796936,NaN,NaN,-4.449646728471265,-2.6287045038409937
2005-04-27T09:30:00-04:00,41.91,42,40.82001,40.85001,29949104,17348370.7,43.90469476874708,45.7845435850897,NaN,NaN,-69.20017585747185,-22.15208404565974,-0.04024537547374882,-0.25305974436000156,-0.21281436888625274,-69813839,-44890236.4,34.78678612561883,29.744797260921082,NaN,NaN,-5.78221660924313,-3.079206233184156
2005-04-28T09:30:00-04:00,40.55,40.7,39.97,40.03,23943600,17921195.6,40.2353478713376,45.0620887655411,NaN,NaN,-121.8766591127307,-36.351223103633956,-0.12314899157395603,-0.36675060835369777,-0.24360161677974174,-93757439,-53599017,31.16199237836588,28.825320798115886,NaN,NaN,-8.112775201655015,-3.798287514394279
2005-04-29T09:30:00-04:00,40.39999,40.77,40.00999,40.55,14931898,18188435.4,43.46224589038119,44.41634777757389,NaN,NaN,-98.50615823273951,-51.7639766407184,-0.13324964377735016,-0.4101636715014294,-0.27691402772407925,-78825541,-61612257.8,28.245542964326432,27.872081728248435,NaN,NaN,-8.966342283442467,-4.536581052829734
2005-05-02T09:30:00-04:00,40.49001,41.33,40.17,41.28,22853696,18625910.25,47.72907482355555,44.413925898100864,NaN,NaN,-60.21489923366908,-69.8302448276331,-0.08348390346546025,-0.38126890705590455,-0.2977850035904443,-55971845,-67646679.8,26.25294608664997,26.993800151747696,NaN,NaN,-8.306394906391686,-5.07512588905287
2005-05-03T09:30:00-04:00,41.2,41.2,40.16,40.31,12265000,18791530.15,43.07700971475801,44.52082164512375,NaN,NaN,-79.52867546848461,-85.86531358101914,-0.1071036222578558,-0.43166453141276406,-0.32456090915490826,-68236845,-73321101.8,24.502493181525026,26.398544570288443,NaN,NaN,-9.255833665232533,-5.672369857078536
2005-05-04T09:30:00-04:00,40.31,40.82001,39.36,40.78,18984096,19218254.85,45.8319776906479,44.832445459097706,NaN,NaN,-90.8258795934333,-90.19045432821143,-0.0833401936979864,-0.4287361512773913,-0.3453959575794049,-49252749,-69208883.8,28.23682750425138,26.394139090192855,NaN,NaN,-9.155297684349907,-6.1699309752601605
2005-05-05T09:30:00-04:00,41.14999,41.45,40.75,41.22,13358801,18921614.9,48.35209667644734,45.87014995674809,NaN,NaN,-19.467610340238487,-69.70864457371299,-0.03284822528924075,-0.38645623919095584,-0.3536080139017151,-35893948,-57636185.6,37.5922291557604,27.435905802245117,NaN,NaN,-8.2936945314456,-6.473325769000938
2005-05-06T09:30:00-04:00,41.39999,41.77,41.05,41.10001,8991000,18785549.85,47.700353157461976,46.46684707810616,NaN,NaN,3.219174002393781,-49.363578126686335,-0.003912584150411402,-0.35849874408972937,-0.35458615993931797,-44884948,-50848067,42.34045630176755,29.03407542345563,NaN,NaN,-7.78806328092279,-6.6611454135612025
2005-05-09T09:30:00-04:00,41.3,41.67999,41.16,41.64999,9266000,18667554.95,50.96301241607443,46.837331326083714,NaN,NaN,32.34215088784715,-30.852168102383093,0.05275995234736247,-0.28863621950511487,-0.34139617185247734,-35618948,-46777487.6,45.04083358357099,30.90767655184785,NaN,NaN,-6.399216325522364,-6.623726972412797
2005-05-10T09:30:00-04:00,41.69,41.69,40.83,40.95,16337301,18750360.05,46.94857236687588,47.22409924337397,NaN,NaN,2.044371312325311,-14.537558746221105,0.04395615364721028,-0.28645097979346446,-0.33040713344067474,-51956249,-43521368.4,47.1721358411649,33.021479715873845,NaN,NaN,-6.376394633563141,-6.58839378114856
2005-05-11T09:30:00-04:00,40.66,41.24001,40.5,41.2,10909102,18391350.35,48.508617957476794,47.13270863198959,NaN,NaN,-15.853018501957628,0.45701347207402493,0.05510052369241558,-0.26153147882515526,-0.31663200251757084,-41047147,-41880248,48.261181890573674,35.14774684521035,NaN,NaN,-5.909495528994457,-6.491408316555117
2005-05-12T09:30:00-04:00,40.85001,41.05,39.36,39.39999,23390896,18584059.95,39.50171035301766,46.36325547937383,NaN,NaN,-131.123626694059,-21.874189798690075,-0.05278862108803645,-0.3826177788776164,-0.32982915778957994,-64438043,-47589067,44.80127746482925,36.29978829975713,NaN,NaN,-8.367437135880568,-6.75941243360161
2005-05-13T09:30:00-04:00,39.7,39.7,38.60001,38.8,22101392,17675004.75,37.03337652847699,45.19029829617398,NaN,NaN,-209.70804445276667,-64.45963348972217,-0.15292715077109365,-0.520988096253447,-0.36806094548235335,-86539435,-55919964.4,40.26477058906057,36.70404520673226,NaN,NaN,-11.19143908061699,-7.39255909746095
2005-05-16T09:30:00-04:00,38.59,38.7,37.94,38.63,24119296,17314039.15,36.34048021773745,44.25632645949969,NaN,NaN,-227.07004010924496,-116.34207168914058,-0.21516880869285887,-0.637021956348427,-0.4218531476555681,-110658731,-70927921,33.653615224495894,36.593792020854366,NaN,NaN,-13.667728581307761,-8.289011880867637
2005-05-17T09:30:00-04:00,38.67,39.39,38.55,39.32001,18545808,17234514.35,41.153183206978596,44.05978991937337,NaN,NaN,-138.05518429703315,-144.3619828110123,-0.19502038872232685,-0.6656286335584767,-0.4706082448361498,-92112923,-78959255.8,30.7444418984892,36.30505314748795,NaN,NaN,-14.329256741667606,-9.15190400383906
2005-05-18T09:30:00-04:00,39.66,39.98,39,39.24001,27927008,17562639.95,40.768353877587394,44.097861776962645,NaN,NaN,-97.49451743775572,-160.6902825981719,-0.17298342596026273,-0.6868375272864782,-0.5138541013262155,-120039931,-94757812.6,25.98575084035899,35.935321609058896,NaN,NaN,-14.974827976881134,-9.983750285702214
2005-05-19T09:30:00-04:00,39.44,39.99001,39.10001,39.95,15784199,17606849.9,45.62781841553787,44.25254552875954,NaN,NaN,-69.06237498823174,-148.27803225700646,-0.10010839470794064,-0.6389895947111413,-0.5388812000032006,-104255732,-102721350.4,23.9716032490755,35.630040200826684,NaN,NaN,-14.109590337261114,-10.573156007353486
2005-05-20T09:30:00-04:00,39.75,40.2,39.64,39.64999,12816500,17674964.95,43.98566415578839,43.98515905249047,NaN,NaN,-51.906655516413046,-116.71775446973572,-0.06341694975595469,-0.618152387198144,-0.5547354374421893,-117072232,-108827909.8,22.529542308272568,35.36408278808544,NaN,NaN,-13.853937609467822,-11.04183909336982
2005-05-23T09:30:00-04:00,39.89999,40.46001,39.78,40.31,11286102,17591289.95,48.386610701781755,44.3644162658493,NaN,NaN,-17.04730553873892,-74.71320755563451,0.010082671796072362,-0.5421320976970989,-0.5522147694931713,-105786130,-107853389.6,23.322289320217195,35.27978251227774,NaN,NaN,-12.343666885293821,-11.227814492216107
2005-05-24T09:30:00-04:00,40.37,40.62,40.28,40.48,12284898,17502284.85,49.48746329737062,44.62552238061521,NaN,NaN,16.534773724686506,-43.79521595129059,0.07150569983816879,-0.46283264469546026,-0.534338344533629,-93501232,-108131051.4,23.24929011005358,34.92352984126361,NaN,NaN,-10.7818616126406,-11.164106937991034
2005-05-25T09:30:00-04:00,40.57001,41.3,40.31,41.10001,15605500,16785104.65,53.39193534325447,44.985510856815715,NaN,NaN,62.84996789353069,-11.726318885033299,0.15069506734457638,-0.34596951035290857,-0.49666457769748495,-77895732,-99702211.6,30.37381533480722,34.40792885405266,NaN,NaN,-8.285023841769581,-10.752809352816541
2005-05-26T09:30:00-04:00,41.17,41.42,40.92,41.31,8960000,16035924.65,54.6699445768743,45.48333881534517,NaN,NaN,84.75411173187256,19.03697845898757,0.21035881167762616,-0.23371606310045223,-0.4440748747780784,-68935732,-92638211.6,35.75617244809092,33.937622864504334,NaN,NaN,-5.836298973275434,-10.050450727167812
2005-05-27T09:30:00-04:00,41.48,42.00999,41.39999,42,10041199,15791389.7,58.679310056938974,46.034502932549785,NaN,NaN,123.26865320972401,54.07204020421498,0.2848102681382872,-0.08806203960521941,-0.3728723077435066,-58894533,-81002671.8,43.5033441649466,33.82780219174545,NaN,NaN,-2.4973257137922467,-8.97143286811416
2005-05-31T09:30:00-04:00,42.09,42.09,41.37,41.67999,8958398,15096624.8,56.19675013328834,46.695087058722095,NaN,NaN,107.00603516539059,78.88270834504088,0.2995218888573222,0.0015300533281461526,-0.2979918355291761,-67852931,-73416032,47.913786739030364,33.8807772558787,NaN,NaN,-0.3640243023330333,-7.741803073002571
2005-06-01T09:30:00-04:00,41.92,42.77,41.81,42.47,13916602,15179204.9,60.62552166293535,47.56058018054056,NaN,NaN,137.70094702057347,103.11594300421828,0.34617474263767595,0.13472659276791887,-0.21144814986975707,-53936329,-65503051.4,52.11286175708385,34.155897246343706,NaN,NaN,2.8564501974741465,-6.2277668915058975
2005-06-02T09:30:00-04:00,42.38,42.66,42,42.39,16950000,15077500.1,59.96435312645721,49.02219752150053,NaN,NaN,120.37483310809505,114.62091604713115,0.354091114850579,0.23116574369346665,-0.12292537115711233,-70886329,-64101170.8,52.83825963376481,34.72996740126767,NaN,NaN,5.310525762407291,-4.579439369518299
2005-06-03T09:30:00-04:00,42.47,42.85001,42.35001,42.63,9112199,14865170,61.32696110545776,50.757453562713444,NaN,NaN,124.74652318232131,122.6193983372209,0.3569278287004094,0.3232344147183994,-0.03369341398200998,-61774130,-62668850.4,53.61144228514413,35.68330109384507,NaN,NaN,7.766321137309698,-2.8157592971143
2005-06-06T09:30:00-04:00,42.89999,42.89999,42.39,42.75999,8766199,14853929.95,62.079759265434426,52.5959734946918,NaN,NaN,117.89744316986626,121.54515632924935,0.348597913952883,0.40205397845909374,0.053456064506210765,-53007931,-61491530,54.27500973545519,37.15625784462788,NaN,NaN,10.036260533902645,-0.9797564641118794
2005-06-07T09:30:00-04:00,42.8,43.08,42.32001,42.35001,9317801,14856520,58.22982641116058,53.815733723561934,NaN,NaN,103.73546671089262,120.89104263834975,0.29845149153804584,0.42652042892876807,0.12806893739072223,-62325732,-60386090.2,54.92696251585006,38.883580745867945,NaN,NaN,10.99614028493575,0.7310859286092104
2005-06-08T09:30:00-04:00,42.31,43.14,42.14,42.47,16627602,14871035.05,59.030636278534836,55.12018246648675,NaN,NaN,94.20441054506333,112.19173534324773,0.2578652665374307,0.45040052056251056,0.1925352540250799,-45698130,-58738450.4,55.93543457983102,41.02284387011594,NaN,NaN,12.018475496212787,2.3435701525525783
2005-06-09T09:30:00-04:00,42.60001,43.74001,42.5,43.7,16471301,15149145,66.1869887965901,56.58869463656191,NaN,NaN,117.06243414716273,111.52925555106128,0.2956493029553667,0.5620968827192883,0.2664475797639216,-29226829,-50406550.4,60.721399484618345,43.64782931551186,NaN,NaN,15.143695763128598,4.17215952549201
2005-06-10T09:30:00-04:00,43.62,43.78,43.16,43.64999,11706602,14564930.3,65.68460855670806,58.138619236627605,NaN,NaN,114.19115151038739,109.4181812166745,0.2982125068936043,0.639213213380927,0.34100070648732267,-40933431,-46238410.6,62.89271109759717,46.53091280046362,NaN,NaN,17.548295850720553,6.083036143381801
2005-06-13T09:30:00-04:00,43.41,43.95,43.28999,43.82001,10933398,14006530.6,66.61244698788963,59.4404646856353,NaN,NaN,111.2133763148088,108.081367845663,0.2919277219329547,0.705910358903516,0.41398263697056137,-30000033,-41636831,65.18110350483698,49.52082809936503,NaN,NaN,19.826266386182983,8.046354749496256
2005-06-14T09:30:00-04:00,43.64999,44.17,43.64999,44.09,10563102,13328720.9,68.08804857083385,60.769077919454105,NaN,NaN,118.27808843066559,110.98989218961758,0.28614113727992185,0.7716590585704637,0.48551792129054183,-19436931,-33059070.8,69.01683892340044,52.78993872888981,NaN,NaN,22.188389857888318,10.066645479266551
2005-06-15T09:30:00-04:00,44,44.62,44,44.62,11246801,12963770.55,70.81488337807934,62.01357420765588,NaN,NaN,130.92135181288535,118.333280443182,0.2969112144943171,0.8566569394084382,0.5597457249141211,-8190130,-25557470.8,71.92924797930596,55.758183917782574,NaN,NaN,25.06623312197545,12.209443713939251
2005-06-16T09:30:00-04:00,44.74001,45.25,44.59,45.25,9819398,12058390.05,73.6925088131224,63.37232879595932,NaN,NaN,152.61261637397558,125.44331688854456,0.3231991470320523,0.9637446587041865,0.6405455116721341,1629268,-19386251.4,74.0872044662561,58.496114776222946,NaN,NaN,28.48659707810818,14.534751337391954
2005-06-17T09:30:00-04:00,45.8,45.91,45.25999,45.84,19227808,12230570.5,76.07195652222438,64.61466068633685,NaN,NaN,172.4001039714721,137.0851073807615,0.3545459710080161,1.0837279754321543,0.7291820044241382,20857076,-7028150,77.77229899630564,60.94389726417717,NaN,NaN,32.206618840925806,17.059303837896792
2005-06-20T09:30:00-04:00,46.00999,46.14999,45.53,45.89,10947898,12137140.4,76.26785738878134,66.04831120458634,NaN,NaN,157.99178364952348,146.44078884770448,0.3521507373727054,1.16937042614002,0.8172196887673145,31804974,5332851.4,80.72497561736091,63.287553612629345,NaN,NaN,35.28592502975214,19.663106865304698
2005-06-21T09:30:00-04:00,45.25,45.82001,44.89,44.92,16646500,12405160.3,65.12791913309611,66.36991102388355,NaN,NaN,109.98794749668997,144.78276066090933,0.26283555796677716,1.145764136225786,0.8829285782590088,15158474,12251932.4,82.154006188627,65.43334964345385,NaN,NaN,34.685904350713784,21.80922079179171
2005-06-22T09:30:00-04:00,45,45.47,44.58,45.17999,23739104,12977870.6,66.53868154601422,66.83950591099476,NaN,NaN,93.32222091006935,137.26293448034613,0.20161872267811098,1.1349519816066476,0.9333332589285366,38897578,21669474,83.90327998120526,67.65227966827102,NaN,NaN,34.60825698831536,23.63765453415223
2005-06-23T09:30:00-04:00,45.21001,46.03999,45.16,45.22,14940500,12944620.6,66.76153204234981,67.22768954934419,NaN,NaN,103.23017862779247,127.3864469311095,0.1467243332497432,1.1167386754907156,0.9700143422409724,53838078,32111236,85.58985731283182,69.93645217024871,NaN,NaN,34.608010033970885,25.204848176983464
2005-06-24T09:30:00-04:00,45.39999,45.60001,44.88,44.94,8988699,12946055.55,63.57071560884426,67.33418643101633,NaN,NaN,76.65209084316261,108.2368443054476,0.07791367996995291,1.0674064422034135,0.9894927622334606,44849379,36909696.6,86.30024355431043,72.22396887159552,NaN,NaN,33.69626718003142,26.417908034561744
2005-06-27T09:30:00-04:00,45.3,45.75999,45.14999,45.63,11096699,12998830.55,67.67124767667781,68.00857366426756,NaN,NaN,87.7102472180205,94.18053701914701,0.06571330312622758,1.0716343911412451,1.0059210880150176,55946078,41737917.4,86.99496037316756,74.5145401471182,NaN,NaN,34.07265481809061,27.511443289351583
2005-06-28T09:30:00-04:00,45.45,45.63,44.77,44.78,12751699,13188495.6,58.87891892799051,67.99773671065725,NaN,NaN,55.87912402764446,83.35877232533791,-0.008794261445822293,0.9949282612077397,1.003722522653562,43194379,47345098.4,87.77057021414338,76.78847840671195,NaN,NaN,31.609222247871475,28.096840283425852
2005-06-29T09:30:00-04:00,44.67999,45.03999,44.35001,44.74001,12513500,13118340.5,58.49386001754084,67.44822751215374,NaN,NaN,30.336794142451854,70.76168697181441,-0.06673596477271604,0.920302566687667,0.987038531460383,30680879,45701758.6,86.14895017711491,78.60473202760456,NaN,NaN,29.52785212541846,28.301270546567654
2005-06-30T09:30:00-04:00,44.8,45.3,44.41,44.45,14718301,13006755.55,55.65142906445271,66.7315718341355,NaN,NaN,25.807223665188445,55.277095979293605,-0.12706069491736516,0.8282126628136766,0.9552733577310417,15962578,38126658.6,78.91149123642401,79.74893060894932,NaN,NaN,26.930472828842074,28.105442301178286
2005-07-01T09:30:00-04:00,44.50999,45.46001,44.50999,45.44,8586398,12980465.5,62.37320162178376,66.42876859369936,NaN,NaN,49.63755342929103,49.874188496519295,-0.1037398931797131,0.8255984912564003,0.9293383844361134,24548976,34066578,75.26191567277823,80.46898862094513,NaN,NaN,26.639075068528665,27.895961267942624
2005-07-05T09:30:00-04:00,45.82001,46.83,45.64,46.8,16744199,13379365.5,69.26491230262755,66.5128302888275,NaN,NaN,138.61139289543345,60.054417632001886,-0.005365227690838581,0.9226318498225652,0.9279970775134038,41293175,31135997.4,72.65010289820368,80.72850747628821,NaN,NaN,28.79251034635003,28.02403970771511
2005-07-06T09:30:00-04:00,47.3,47.3,45.84,45.96001,14680602,13647505.55,61.74285914270684,65.86482855772947,NaN,NaN,129.6852309578117,74.81563901803534,-0.005491210742059605,0.9211330640858293,0.9266242748278889,26612573,27819636.2,69.70224608367965,80.56943591231492,NaN,NaN,27.901063920610884,28.006471738128795
2005-07-07T09:30:00-04:00,45.35001,46.56,45.35001,46.55,15702102,13601230.55,64.64691920078764,65.21871501399127,NaN,NaN,110.60067694763735,90.86841557907243,0.023921610702204443,0.9565262882056444,0.93260467750344,42314675,30146395.4,70.60348572347257,80.32059885925894,NaN,NaN,28.192575426423303,28.033057979313725
2005-07-08T09:30:00-04:00,46.74001,46.95,45.88,46.24001,15167699,13536050.45,61.9845736725838,64.21247338187409,NaN,NaN,122.15685791140969,110.13834242831668,0.012817770567751241,0.948626890713129,0.9358091201453778,27146976,32383275,71.4817565871583,79.87127440146271,NaN,NaN,27.53176745246069,27.96144504690615
2005-07-11T09:30:00-04:00,45.8,46.62,45.67,46.58,9960301,13448735.4,63.747978237513884,63.318196299640704,NaN,NaN,103.60406459721803,120.93164466190208,0.01835194437831633,0.9587490506182732,0.9403971062399569,37107277,34894935.2,72.47612025783047,79.28207044721054,NaN,NaN,27.563744118771737,27.904630628601232
2005-07-12T09:30:00-04:00,46.81,47.23,46.46001,47,14030199,13603575.45,65.85508235284172,63.37013652962253,NaN,NaN,151.4187943262397,123.4931249480633,0.0390886159503846,0.9892578761779376,0.950169260227553,51137476,36863795.4,73.26311523592402,78.64700680773174,NaN,NaN,28.254714386758756,27.954642594052306
2005-07-13T09:30:00-04:00,47.02,47.2,46.55,46.73,11765102,13663675.45,63.307613612934915,63.13934596297401,NaN,NaN,128.20704209799337,123.19748717609961,0.02414358911174841,0.9803487466172385,0.9562051575054901,39372374,39415755.6,74.28928715853584,77.96029303468393,NaN,NaN,28.040291714842873,27.96687818273667
2005-07-14T09:30:00-04:00,46.71001,47.03,45.35001,45.61,32261696,14714420.2,53.97961833246868,62.226352126553934,NaN,NaN,33.99930117839801,107.87721202225175,-0.06668263438732247,0.872851864521337,0.9395344989086595,7110678,32374956.2,66.6848156713533,76.60993291743547,NaN,NaN,24.76970265651326,27.51013882184761
2005-07-15T09:30:00-04:00,46,46,45.19,45.37,21364704,15291685.5,52.204535938159935,61.41448215007648,NaN,NaN,-23.420938631912467,78.76165271358731,-0.1439969337992204,0.759538331659634,0.9035352654588544,-14254026,24094755.8,59.03180267861173,74.66218714059985,NaN,NaN,21.580011356940098,26.66297775543225
2005-07-18T09:30:00-04:00,45.02,45.45,44.86,45.17999,12683301,14964460.15,50.7807722647589,60.20801962065371,NaN,NaN,-59.85513204820712,46.0698133845023,-0.2052708344777996,0.646946722361605,0.8522175568394046,-26937327,11285835,49.55706034374631,71.98805142421263,NaN,NaN,18.558142341268958,25.505144124837496
2005-07-19T09:30:00-04:00,45.39999,46.14999,45.14999,46.14999,12304801,15032305.3,57.198337169124734,60.087978066449004,NaN,NaN,14.042870209297076,18.594628561113772,-0.17878186290167708,0.6287402282123082,0.8075220911139853,-14632526,-1868165.4,42.08648555810326,68.72490252020977,NaN,NaN,17.871822510529704,24.41466960850781
2005-07-20T09:30:00-04:00,46.13,46.35001,45.55,46.2,11033602,14751660.4,57.50597036309447,60.01741451970283,NaN,NaN,34.30675276458919,-0.18542930556706239,-0.15697755141286296,0.6113001518479066,0.7682777032607696,-3598924,-10462425,38.05054582451711,65.28930220930991,NaN,NaN,17.41887918556067,23.41527097665822
2005-07-21T09:30:00-04:00,46.03,46.36,45.48,45.75,11860699,14157740.15,53.761549366626724,59.88242311271527,NaN,NaN,10.909127834048375,-4.803463974436985,-0.1708041986404948,0.5547724549601512,0.7255766536006459,-15459623,-14976485.2,36.09275791681491,62.23082125790927,NaN,NaN,15.91237437354903,22.34342860478548
2005-07-22T09:30:00-04:00,46.22,47.46001,46.2,47.39,24123008,14616865.55,63.17295730916801,59.939548518957004,NaN,NaN,132.44761876403135,26.370247504751774,-0.07247061011233746,0.6349883909602241,0.7074590010725615,8663385,-10393003,39.49680787441493,59.67617070088331,NaN,NaN,17.666307585638975,21.675268459193124
2005-07-25T09:30:00-04:00,47.17999,48.21001,47.17999,47.83,17041696,15019515.4,65.21843148214357,59.65051417463671,NaN,NaN,185.68968025053837,75.47920996450087,0.014592010682044854,0.7256990144251176,0.7111070037430728,25705081,135478.6,46.54086190322086,57.811224915527404,NaN,NaN,19.764350775044147,21.402280218600414
2005-07-26T09:30:00-04:00,47.78,48.05,47.45,47.72,7902801,14859820.5,64.25753651485923,59.8301339869333,NaN,NaN,159.39056731687808,104.54874938601706,0.054893267565916615,0.7797235882004685,0.7248303206345519,17802280,6622439.8,50.37448700774018,56.43067069581745,NaN,NaN,21.12149242229211,21.362167676270655
2005-07-27T09:30:00-04:00,47.86,47.99001,47.25999,47.96001,12297500,14837110.55,65.45353470456874,59.88774938006053,NaN,NaN,141.1142921946469,125.91025727202862,0.0859844566405803,0.8323108914352773,0.746326434794697,30099780,13362180.6,54.06052881851189,55.249030916891684,NaN,NaN,22.59335940452202,21.538052208877993
2005-07-28T09:30:00-04:00,48.17,48.3,47.57001,48.10001,8478199,14635345.5,66.16474634938976,60.18633314268953,NaN,NaN,147.0798880175287,153.14440930872468,0.10309472160609445,0.875194836802315,0.7721001151962206,38577979,24169701,59.28324003179507,54.37770830579431,NaN,NaN,24.00533768857817,21.890521563120874
2005-07-29T09:30:00-04:00,48.48,48.48,47.59,47.60001,8821398,14340500.35,61.31013812521475,60.01220170609673,NaN,NaN,120.03997072656941,150.6628797012323,0.06946678726488076,0.8589335992773215,0.7894668120124407,29756581,28388340.2,61.14035933609355,53.56801109709881,NaN,NaN,23.819681412637184,22.16611582733749
2005-08-01T09:30:00-04:00,47.82001,48.34,47.78,48.10001,7080602,14265210.55,64.14336739682227,59.88993635209534,NaN,NaN,120.01972893978007,137.52888943908061,0.06945929940396356,0.8762909362673952,0.8068316368634316,36837183,30614760.6,62.12226566325603,52.77223612762253,NaN,NaN,24.49127777640027,22.498281820060743
2005-08-02T09:30:00-04:00,48.28999,48.94,48.22,48.89999,7837801,13819890.65,68.1607334389513,60.23658776823936,NaN,NaN,147.04183097714133,135.05914217113326,0.10951055958516664,0.94371983634489,0.8342092767597233,44674984,35989301.4,64.45703412201367,52.069932339299505,NaN,NaN,26.328709082969148,23.045485714761945
2005-08-03T09:30:00-04:00,49.28999,49.3,48.50999,48.66,10628199,13617270.5,65.77971589213098,61.07945187964382,NaN,NaN,135.37381556963663,133.91104684613123,0.10595226117452994,0.9666496032278857,0.8606973420533558,34046785,36778702.4,64.80022888722094,51.93531899757577,NaN,NaN,27.13358304718864,23.62949961939433
2005-08-04T09:30:00-04:00,48.60001,49.25,48.60001,48.75999,10547602,13359545.5,66.30780325513224,62.08682811657041,NaN,NaN,120.81921374787898,128.65891199220127,0.09670211088814584,0.9815749806635381,0.8848728697753923,44594387,37981984,65.34945521098729,52.386579892745445,NaN,NaN,27.942889959678617,24.245698239434944
2005-08-05T09:30:00-04:00,48.8,49,48.05,48.39,9250801,13063700.6,62.46642630478972,62.92151769085832,NaN,NaN,84.58959552968868,121.56883695282514,0.05415589696613132,0.9525677409830564,0.8984118440169251,35343586,39099385,65.88183750277722,53.5526354041048,NaN,NaN,27.54638429087683,24.717224818212355
2005-08-08T09:30:00-04:00,48.78,49.595,48.78,49.09,11612801,13146325.6,66.42901590486522,63.58085188626836,NaN,NaN,114.47845442953924,120.46058205077698,0.061131528111782574,0.9748262541566532,0.9136947260448707,46956387,41123225.8,66.87455844759383,55.3232120390684,NaN,NaN,28.363276195145566,25.238089300631383
2005-08-09T09:30:00-04:00,49.22,49.35001,48.75,48.98,8927602,12891195.75,65.26299718814829,64.13492523091506,NaN,NaN,95.98251630523112,110.24871911639494,0.04694917942644228,0.9723812003279235,0.9254320209014812,38028785,39793986,65.52600879878234,57.28574510865878,NaN,NaN,28.70176618720663,25.732900284427846
2005-08-10T09:30:00-04:00,49.25,49.87,49.10001,49.78,11965699,12901225.6,69.46135502016467,65.25633992045348,NaN,NaN,117.1605587956237,106.60606776159234,0.07821594843183632,1.0232019564412766,0.9449860080094403,49994484,42983525.8,67.2334512905253,59.51008034963809,NaN,NaN,30.275269486119594,26.381810170383808
2005-08-11T09:30:00-04:00,49.96001,50.41,49.71001,50.25999,12800500,11928165.8,71.67346845708371,65.86351928816175,NaN,NaN,139.58932200561122,110.36008941313881,0.11572972764667777,1.0896481675677876,0.9739184399211098,62794984,46623645.2,69.11360773783193,61.62556605416787,NaN,NaN,32.29416953972424,27.226432937432442
2005-08-12T09:30:00-04:00,50.5,50.55,49.92,50.17,9199102,11319885.7,70.64033335782194,66.25079799356735,NaN,NaN,133.76167517247427,120.19450534169592,0.11855391405926863,1.1221108324951956,1.003556918435927,53595882,50274104.4,70.9159400654745,63.36664306575742,NaN,NaN,33.63909962927729,28.142528179124565
2005-08-15T09:30:00-04:00,49.95,50.10001,49.5,49.67999,10230602,11197250.75,65.13470935151219,66.3134531961854,NaN,NaN,97.87917164465902,116.87464878471988,0.07368873700253209,1.0956678396890922,1.0219791026865601,43365280,49555883,70.04983548559031,64.77202509988958,NaN,NaN,33.19634149549586,28.86450151003475
2005-08-16T09:30:00-04:00,49.57001,49.72,48.57001,48.59,16694602,11416740.8,54.88702470971852,65.55870248226753,NaN,NaN,40.48453879683545,105.77505328304073,-0.03717257593742884,0.975513382764774,1.0126859587022028,26670678,47284261.6,67.25217444395832,65.71428550170718,NaN,NaN,29.48228185452716,28.952755844962237
2005-08-17T09:30:00-04:00,48.55,49.10001,47.25,47.47,28085696,12269345.5,46.74825325523571,64.17181011839939,NaN,NaN,-43.322270676951625,73.67848738852567,-0.18541789934879738,0.7809135845162061,0.9663314838650034,-1415018,37002361.2,56.29328189200694,65.50071706315087,NaN,NaN,23.334373409095324,28.150129782695537
2005-08-18T09:30:00-04:00,47.14999,47.67,46.87,47.37,16363898,12494505.45,46.0910906995563,63.08473530228093,NaN,NaN,-109.1790029582714,23.92482239574915,-0.2838069094651857,0.6115728470335213,0.895379756498707,-17778916,20887581.2,44.150205238828605,64.28713462763196,NaN,NaN,18.32696777434045,26.746820924359096
2005-08-19T09:30:00-04:00,47.64999,48.32001,47.64999,48.17999,12292898,11902999.95,51.979505435648875,62.21588801933997,NaN,NaN,-52.113733424083506,-13.250259323562412,-0.2870689445427911,0.5365435758202182,0.8236125203630092,-5486018,9071201.2,37.72425205577687,62.54441936995487,NaN,NaN,15.916086237971742,25.199573112018044
2005-08-22T09:30:00-04:00,48.46001,48.89,47.81,48.3,13101500,11705990.15,52.80209469067205,61.11884239446289,NaN,NaN,-29.630659315362806,-38.752225515566785,-0.2739148568010499,0.48121894936169696,0.7551338061627468,7615482,1921241.6,34.456288890938055,60.40150899630662,NaN,NaN,14.260784935238217,23.636889086763784
2005-08-23T09:30:00-04:00,48.3,48.60001,47.64999,48.21001,16927008,12157200.5,52.08164673946763,60.14040888355836,NaN,NaN,-50.73960862518548,-56.99705499997096,-0.2639384223605935,0.4252107782120049,0.6891492005725984,-9311526,-5275199.2,31.49863655352965,58.022823829614374,NaN,NaN,12.713861812693345,22.076456619039437
2005-08-24T09:30:00-04:00,48.60001,49,48.19,48.67,14560398,12270345.4,55.42929474549847,59.36337256144167,NaN,NaN,-8.806815743543556,-50.09396401328935,-0.22077665282639414,0.41317838453960576,0.6339550373659999,5248872,-3942421.2,32.6516394348392,55.68726555988951,NaN,NaN,12.376135875557276,20.6906965128277
2005-08-25T09:30:00-04:00,48.87,48.87,48.27,48.53999,12915500,12492210.45,54.275171579184,58.77828293818412,NaN,NaN,-19.11212592815424,-32.080588607265916,-0.1962267964447445,0.38867154181006924,0.5848983382548137,-7666628,-1919963.6,34.454573579777616,53.44246099396097,NaN,NaN,11.770186656577671,19.41633796193484
2005-08-26T09:30:00-04:00,48.31,48.74001,47.95,47.99001,10194602,12560870.65,49.57285801927106,57.57427166064168,NaN,NaN,-59.90791011412329,-33.639423945273876,-0.21098373440448515,0.32116867024920737,0.5321524046536925,-17861230,-4395006,33.28040791318763,51.04287881293196,NaN,NaN,9.864442248716784,18.051781431475117
2005-08-29T09:30:00-04:00,49,49.05,48,48.38,15091000,12961390.55,52.70212939133337,56.677066818012044,NaN,NaN,-34.54169354929749,-34.621630792060806,-0.1891362624187073,0.2957320766303084,0.4848683390490157,-2770230,-6472148.4,32.28599893445343,48.668592394051316,NaN,NaN,9.145282624787646,16.779424459091192
2005-08-30T09:30:00-04:00,48.58,49.42,48.55,49.28,15100301,13324515.55,59.02193904725979,55.93139424851883,NaN,NaN,34.453255757573764,-17.58305791550896,-0.11251240948304303,0.34422782719521194,0.456740236678255,12330071,-2143829,36.541070341234324,46.47627946910196,NaN,NaN,10.4680294249419,15.877796597069866
2005-08-31T09:30:00-04:00,49.32001,50.89,49.23,50.64,21407392,13863475.2,66.34085239177875,55.55049310099705,NaN,NaN,144.27333653864014,13.032972540927776,0.024040032747622786,0.4867902776127835,0.4627502448651607,33737463,3553889.2,41.73177713130237,44.520434425778426,NaN,NaN,14.249834294733487,15.645230553878955
2005-09-01T09:30:00-04:00,51.3,52.03,51,51.96001,19806400,14326415.1,71.63607811714286,55.621617726662826,NaN,NaN,225.4798922723294,61.951376181024514,0.18838938860124732,0.6982369806167199,0.5098475920154726,53543863,15795987.4,51.004899374484665,43.09821723356487,NaN,NaN,19.549981763804688,16.203052155296916
2005-09-02T09:30:00-04:00,51.55,51.55,50.83,50.95,14485301,14588140.1,63.41537331189295,55.498808009547176,NaN,NaN,149.5700141612215,103.84696103609346,0.2124200360174393,0.7753726370372718,0.5629526010198325,39058562,27179945.8,57.74002328608318,42.21894493360007,NaN,NaN,20.902168899444728,16.87435454731803
2005-09-06T09:30:00-04:00,50.96001,51.42,50.44,51.31,12097398,14612369.95,64.95890800172108,56.218228244690216,NaN,NaN,122.51945897696086,135.25919154134513,0.23418859854045715,0.8556883491954039,0.6214997506549468,51155960,37965183.8,62.938090008142325,41.9107960453275,NaN,NaN,22.49011382700677,17.67660587298785
2005-09-07T09:30:00-04:00,51.19,51.95,51.08,51.39,13099102,14820944.95,65.30917926677407,57.54400867408581,NaN,NaN,127.52680259583437,153.87390090899726,0.23499547700149137,0.915244096906811,0.6802486199053196,64255062,48350182,67.13052844565377,42.684885084873706,NaN,NaN,23.827204586125536,18.555262832007518
2005-09-08T09:30:00-04:00,51.25,51.87,51.25,51.46001,15902102,15017765.1,65.6329398960984,58.939855045267386,NaN,NaN,113.94006917338542,147.8072474359463,0.22144853939722764,0.9570592941518541,0.7356107547546265,80157164,57634122.2,70.35863383960191,44.556915699214656,NaN,NaN,24.983292031491676,19.47355271764811
2005-09-09T09:30:00-04:00,51.67999,52.82001,51.67999,52.8,13494301,15052455.15,71.17750188559711,60.311140505977974,NaN,NaN,142.41283349726524,131.1938356809335,0.2801574914967644,1.0858076191255819,0.8056501276288175,93651465,65655642.6,72.84053894553533,47.06522190562597,NaN,NaN,27.897168619623542,20.676926417930314
2005-09-12T09:30:00-04:00,52.59,52.7,51.64,51.72,13978500,15291425.05,62.43457401713996,60.99917474358283,NaN,NaN,109.37142235415563,123.15411731952028,0.22600077129717866,1.0881510917502908,0.8621503204531121,79672965,73778523.2,75.11300534896988,49.96927308119968,NaN,NaN,27.413829651660905,21.639341165606112
2005-09-13T09:30:00-04:00,51.75,52.14999,51.27,51.28,10862898,15323039.85,59.24188493943529,61.510620329294795,NaN,NaN,78.85582814288496,114.42139115270513,0.144269222404795,1.0424868484591059,0.8982176260543109,68810067,77309344.6,76.05102849499883,53.151586791304624,NaN,NaN,25.96446115375367,22.257215449627193
2005-09-14T09:30:00-04:00,51.56,52.14999,51.34,51.92,12282398,15102429.65,62.26456908568108,61.99885421073641,NaN,NaN,79.62949411888258,104.84192945731476,0.11813306613144658,1.045883958718619,0.9277508925871725,81092465,80676825.2,76.94360715482838,56.315298771303844,NaN,NaN,25.75122026779536,22.75635899507979
2005-09-15T09:30:00-04:00,52.38,52.42,51.28999,51.92,14960500,14446169.85,62.264569085681075,62.56952546120049,NaN,NaN,75.31093668666293,97.11610295997026,0.08710057139288474,1.0366266068282783,0.9495260354353936,81092465,80863885.4,76.99489857919086,59.35389341411907,NaN,NaN,25.584569167624586,23.160389019729045
2005-09-16T09:30:00-04:00,51.95,52.33,51.83,52.28,13895199,14322734.9,64.00597870828128,63.60046265327264,NaN,NaN,80.3699395287763,84.70752416627246,0.0774017603686532,1.0462782358962102,0.968876475527557,94987664,81131125.2,77.07336757440913,62.48196196134918,NaN,NaN,25.964629281905243,23.5609947714685
2005-09-19T09:30:00-04:00,52.91,53.95,52.8,53.66,16191301,14517655.05,69.76582637929106,64.81929815241249,NaN,NaN,127.58665250797614,88.35057019703657,0.14650051952020937,1.1520021249278187,1.0055016054076094,111178965,87432325.2,78.9008209543606,65.81159210562826,NaN,NaN,28.19577876016875,24.22310676985425
2005-09-20T09:30:00-04:00,53.45,53.69,52.82001,53.14999,15213301,14623245.1,65.58855237961686,65.28834196186655,NaN,NaN,109.67166339713053,94.51373724788569,0.14041587085031315,1.1810214439705007,1.0406055731201875,95965664,92863444.6,80.35434842914418,68.9411119690504,NaN,NaN,28.70010992274763,24.86267864883902
2005-09-21T09:30:00-04:00,54.2,54.31,53.47,53.89999,19926608,14773225.1,68.5689635188136,65.44749275665475,NaN,NaN,135.69831029766914,105.72750048364301,0.16761754445427757,1.2501275036880344,1.0825099592337568,115892272,99823406,82.05997120721989,71.82169726018736,NaN,NaN,30.08694766038168,25.609002793345113
2005-09-22T09:30:00-04:00,54.64999,54.64999,52.45,53.5,25917200,15341065.2,65.3196641094072,64.99632032753077,NaN,NaN,112.50628515560834,113.16657017743208,0.1404847738142938,1.258115926501624,1.1176311526873302,89975072,101599927.4,82.47813382395982,74.06978543514988,NaN,NaN,30.206090346613173,26.26572958666912
2005-09-23T09:30:00-04:00,53.2,53.39999,52.25999,52.56,16032602,15496920.3,58.32480681040752,64.63270843456753,NaN,NaN,67.7080399239931,110.63419025647542,0.04593620097219331,1.1750514039025717,1.1291152029303784,73942470,97390888.6,77.84827013517769,75.50608878151377,NaN,NaN,28.052172903036414,26.52093577472159
2005-09-26T09:30:00-04:00,52.2,53.61,52.2,53.52,11712199,15572800.15,62.71602654044147,64.4725026159047,NaN,NaN,84.0051264522152,101.91788504532325,0.03523796515302746,1.1731626593716626,1.1379246942186352,85654669,92286029.4,72.53043141555216,76.1912560249002,NaN,NaN,27.63751125027834,26.680446556943984
2005-09-27T09:30:00-04:00,53.17,53.58,52.89999,53.56,7098000,15173150.15,62.89147705941006,64.29980960109299,NaN,NaN,91.81627565614818,98.34680749712678,0.01886375016575048,1.1615043819258233,1.1426406317600728,92752669,91643430.4,71.86493731934729,76.52942808730687,NaN,NaN,27.366511976780867,26.778455902634967
2005-09-28T09:30:00-04:00,53.89999,54.10001,53.09,54,17224608,15279365.5,64.85088229258021,64.24394834369883,NaN,NaN,108.57456193790527,92.92205782517401,0.025274376029336354,1.1742336017967432,1.1489592257674068,109977277,90460431.4,70.58100886534534,76.54531201771712,NaN,NaN,27.73145052762373,26.914597991919077
2005-09-29T09:30:00-04:00,54.33,54.56,53.86,54.52,13777301,14897860.95,67.06424968528732,63.95014461510527,NaN,NaN,136.6008441287365,97.74096961979964,0.05067785081164922,1.2123065392819683,1.161628688470319,123754578,97216332.6,73.49347064619293,76.59194999633553,NaN,NaN,28.706152310728978,27.170534323177634
2005-09-30T09:30:00-04:00,54.38,54.49001,53.59,53.67,10169301,14416006,60.37196154147135,63.802815152557514,NaN,NaN,95.09585525663509,103.21853268632803,-0.0008917212850205747,1.1605140368640434,1.161405758149064,113585277,105144894,76.44116263510402,76.68681837391652,NaN,NaN,27.49034534807856,27.216221612449196
2005-10-03T09:30:00-04:00,54.05,54.3,53.33,53.53,6628699,14023175.9,59.3219530866711,63.8085343059315,NaN,NaN,73.83433248097607,101.18437389208023,-0.05269057204199479,1.0955425430965704,1.1482331151385652,106956578,109405275.8,77.86557670748648,76.8164289605228,NaN,NaN,26.19630888172784,27.070519793774718
2005-10-04T09:30:00-04:00,53.06,53.3,51.50999,51.60001,17605808,14298596.4,47.14798068735616,62.72877799176543,NaN,NaN,-53.41120651335398,72.13887745817979,-0.21603063645625187,0.8781948195682503,1.0942254560245022,89350770,108724896,77.06422568666746,76.82504456993988,NaN,NaN,20.80680297690253,26.17570310565012
2005-10-05T09:30:00-04:00,51.7,51.81,49.62,49.62,31556000,15221441.3,38.43378944862667,61.02657944626156,NaN,NaN,-180.71483972598517,14.280997125401694,-0.44341979862041314,0.5399507077489858,0.9833705063693989,57794770,98288394.6,65.86649426702684,76.03015854764246,NaN,NaN,12.640972617624211,24.242170178789273
2005-10-06T09:30:00-04:00,48.39999,49.52,47.66,48.44,50851904,16968931.4,34.35817256020796,58.90887900711346,NaN,NaN,-258.174009303971,-64.67397356113979,-0.64696816614714,0.17466029868547395,0.821628464832614,6942866,74926052.2,48.77964479846143,74.00917834936047,NaN,NaN,4.4453141631982165,21.414047890847694
2005-10-07T09:30:00-04:00,49.03,49.61,48.75,49.53,21521008,17370266.75,40.62193608428086,56.82717255746987,NaN,NaN,-171.69045266900932,-118.03123514626868,-0.6785625755096364,-0.02657475455443148,0.6519878209552049,28463874,57901771.6,40.52880253675953,71.2683198909604,NaN,NaN,0.09956131349730664,18.369121236940497
2005-10-10T09:30:00-04:00,49.5,49.62,48.44,48.78,16225602,17482621.85,37.939290245654306,54.852225262186835,NaN,NaN,-160.21348379078506,-164.84079840062094,-0.7166012641063039,-0.2437637591776749,0.47283750492862897,12238272,38958110.4,33.69836775737235,67.93574984297669,NaN,NaN,-4.292623928038452,15.131729070514933
2005-10-11T09:30:00-04:00,49.46001,50.25,49.25,49.95,17041296,17791541.75,44.1370645535231,53.10708962180894,NaN,NaN,-106.82471670473144,-175.5235004388964,-0.632521857403971,-0.31781481682633483,0.3147070405776362,29279568,26943870,30.219851872123527,64.2328841761841,NaN,NaN,-5.7235815058546216,12.152398988176426
2005-10-12T09:30:00-04:00,50.10001,50.13,48.7,48.99001,20663504,18210597.05,40.55806399503272,51.33840389935362,NaN,NaN,-113.76409900919467,-162.13335229553832,-0.6107981163187948,-0.4487906048208572,0.16200751149793752,8616064,17108128.8,27.69901411203965,60.320089911046935,NaN,NaN,-8.13003032118553,9.254909086839003
2005-10-13T09:30:00-04:00,48.39999,48.7,46.71001,47.66,39214192,19423281.65,36.18074042129297,49.75668487155973,NaN,NaN,-145.5080993454903,-139.6001703038422,-0.6515181723238905,-0.6523902039069256,-0.0008720315830351155,-30598128,9599930,25.921450245202564,56.611031347477294,NaN,NaN,-11.684701794568248,6.263536103780824
2005-10-14T09:30:00-04:00,47.3,48.52,46.60001,48.34,31082000,20282621.7,39.76048150839795,48.11700308355662,NaN,NaN,-119.03496851789906,-129.06907347362014,-0.5994830938318564,-0.7502258988728556,-0.15074280504099924,483872,4003929.6,24.651655156462112,53.19111875754229,NaN,NaN,-13.295144563077644,3.469438865658186
2005-10-17T09:30:00-04:00,49.39999,49.39999,48.66,48.94,14986602,20222386.75,42.80877164387179,46.682524125303885,NaN,NaN,-73.17810799066024,-111.66199831359518,-0.4957777286726405,-0.7704649658817999,-0.2746872372091594,15470474,4650370,25.108054380593487,49.85134140477415,NaN,NaN,-13.584536163218559,1.0331567186757935
2005-10-18T09:30:00-04:00,48.32001,48.78999,46.66,46.67,31285104,21025976.9,35.491370429020904,44.58541613504965,NaN,NaN,-108.02889439680445,-111.90283385200978,-0.5471495528843986,-0.9586241783146576,-0.41147462543025903,-15814630,-4368469.6,23.013636725098138,46.45367196618507,NaN,NaN,-16.43861070116538,-1.4628100555872314
2005-10-19T09:30:00-04:00,46.7,47.81,45.64999,47.72,46291104,22344201.7,40.553126857227156,42.691764504473916,NaN,NaN,-105.80232719211305,-110.31047948859346,-0.4799060507537318,-1.0113571888724238,-0.5314511381186919,30476474,3612.4,26.22636312744119,43.07745000055995,NaN,NaN,-16.971752684690067,-3.678373288316208
2005-10-20T09:30:00-04:00,47.39999,47.62,44.94,45.55,47943904,23445536.9,34.523938170215374,40.84547712081278,NaN,NaN,-122.9043795648537,-105.78973553246615,-0.5462408500568801,-1.214252200689792,-0.668011350632912,-17467430,2629752,28.16549452020722,39.62918799235303,NaN,NaN,-19.637080892756444,-5.958188660379099
2005-10-21T09:30:00-04:00,45.78,46.81,45.36,46.02,31482096,24218011.6,36.718432998142376,39.230939971632154,NaN,NaN,-111.45667987457465,-104.27407780380126,-0.5230989351954044,-1.3218850196271674,-0.798786084431763,14014666,5335910.8,30.20146967711898,36.22460891875535,NaN,NaN,-20.928824522901316,-8.096850926453701
2005-10-24T09:30:00-04:00,45.8,47.67,45.78999,47.66,30875104,25176156.85,43.79695419401808,38.991580936393724,NaN,NaN,-78.74579954496446,-105.38761611466211,-0.36922897181277503,-1.2603222991977319,-0.8910933273849568,44889770,11219770,34.54530965344047,33.18754348781057,NaN,NaN,-19.52611593050351,-9.729603069889388
2005-10-25T09:30:00-04:00,47.83,48.89,47.55,48.64999,33592896,26500901.65,47.60683664180793,39.646798593049525,NaN,NaN,-36.315956463935535,-91.04502852808832,-0.18212789012284336,-1.118753190038511,-0.9366252999156677,78482666,30079229.2,46.11994278792336,31.777075525017462,NaN,NaN,-17.084288856734663,-10.780272468010141
2005-10-26T09:30:00-04:00,48.64,49.94,48.14999,48.36,30925904,27185966.45,46.610126441863905,40.521938156024945,NaN,NaN,-16.559835809219145,-73.19653025150954,-0.0652765621747683,-1.018221002634128,-0.9529444404593598,47556762,33495286.8,47.91652480977024,31.715424097253806,NaN,NaN,-15.49119719037981,-11.45326171406295
2005-10-27T09:30:00-04:00,48.55,48.87,46.77,46.99001,27264704,27860336.6,42.12328363191703,40.62917726657039,NaN,NaN,-58.21881240153624,-60.259416818846056,-0.06735625704069037,-1.0371397617602227,-0.9697835047195323,20292058,41047184.4,51.74705113640107,32.51672756865677,NaN,NaN,-15.584251935244872,-12.043403174231797
2005-10-28T09:30:00-04:00,47.05,48.49001,46.31,48.27,28839808,28793861.95,47.23407328378464,41.293090340722564,NaN,NaN,-45.6946063781326,-47.10700211955765,0.025398459409878837,-0.9380354304571838,-0.9634338898670627,49131866,48070624.4,55.057551886324035,34.0423835778676,NaN,NaN,-13.983743485137143,-12.320594647218275
2005-10-31T09:30:00-05:00,48.55,49.49001,47.85001,48.82001,22685008,29596677.4,49.305610376032895,41.66227218518754,NaN,NaN,20.475692780486654,-27.26270365446743,0.12608768565933182,-0.8058242827928979,-0.9319119684522297,71816874,53456045.2,57.467171797594574,35.98862071540125,NaN,NaN,-12.036594763236465,-12.280023235220874
2005-11-01T09:30:00-05:00,48.56,49.25,48.5,49.12,20702496,29751511.8,50.448275039573645,42.368715831226176,NaN,NaN,50.84149146440372,-9.831214068799579,0.2102287416644485,-0.6691260413716691,-0.8793547830361176,92519370,56263386,58.70996049074619,38.20368831388028,NaN,NaN,-10.120929835557927,-11.97158132098331
2005-11-02T09:30:00-05:00,49.06,50.11,48.95,50.08,20930304,29220227,54.019992333311286,43.64294811065606,NaN,NaN,108.4642717935093,15.173607451746108,0.3212280544285908,-0.4778197150003791,-0.7990477694289699,113449674,69441968.4,64.02420650474713,40.92531376099061,NaN,NaN,-7.401301753301759,-11.318684239885945
2005-11-03T09:30:00-05:00,50.48,51.28999,50.31,51.03,18998704,27627567,57.30005871210964,44.895775053778316,NaN,NaN,164.43664810563203,59.704699553179765,0.4418725144536578,-0.24670712636189762,-0.6885796408155554,132448378,91873232.4,70.89150394406839,44.228160102962484,NaN,NaN,-4.082490410361803,-10.284942264239639
2005-11-04T09:30:00-05:00,50.75,50.95,49.39,49.5,29471104,28025071.8,50.991063831857424,45.48022449577729,NaN,NaN,100.08914994165156,88.8614508171366,0.4029630608644207,-0.18487581473502956,-0.5878388755994503,102977274,102642314,73.50624451015888,47.685173683645736,NaN,NaN,-3.1176724441132295,-9.261046575650152
2005-11-07T09:30:00-05:00,49.2,49.57001,48.38,48.64,21536704,28290626.9,47.804892279444594,46.35976177080756,NaN,NaN,33.08855740811851,91.38402374266296,0.3079274035777515,-0.20292962112726087,-0.5108570247050124,81440570,104567053.2,73.95652759540957,51.32395160295369,NaN,NaN,-3.2972239632389093,-8.409071916734261
2005-11-08T09:30:00-05:00,48.50999,49.39999,48.28,49.05,13473898,28112257,49.427304734544066,46.99363161918734,NaN,NaN,40.37203106206588,89.2901316621954,0.26304145956111247,-0.18205520025362176,-0.44509665981473423,94914468,105046072.8,74.07462307229343,54.74168445615742,NaN,NaN,-2.960712601172743,-7.630734871654044
2005-11-09T09:30:00-05:00,48.89999,49.84,48.14999,48.60001,32216000,28689881.8,47.67571505259751,47.93304425364321,NaN,NaN,39.38153805389676,75.47358491427289,0.1964593022158712,-0.19952253204489523,-0.39598183426076644,62698468,94895831.6,67.12840424173675,57.524749436266674,NaN,NaN,-3.189195477022535,-6.996229243849543
2005-11-10T09:30:00-05:00,48.23,48.25,46.73,47.09,40050608,28731702.6,42.26330657724564,48.329106652150585,NaN,NaN,-58.01803905989682,30.982647481167124,0.05167295490222751,-0.33139064063298207,-0.3830635955352096,22647860,72935728,55.09169316064967,59.30262254223315,NaN,NaN,-5.0433077359848255,-6.717240457011726
2005-11-11T09:30:00-05:00,46.75,47.73,46.75,47.47,15590199,27957112.55,43.98665586301923,48.34265677136495,NaN,NaN,-57.432925496220584,-0.5217676064073075,-0.014042074366979962,-0.40061618849393454,-0.3865741141269546,38238059,59987885,49.46041485848274,60.36798719973616,NaN,NaN,-6.063875328283219,-6.623902581479082
2005-11-14T09:30:00-05:00,48.14999,48.2,47.31,47.72,15448602,27980212.55,45.146675784163364,48.166930995818916,NaN,NaN,-26.871714161319417,-12.513821920294896,-0.03501613449708141,-0.43034428224830634,-0.39532814775122493,53686661,54437103.2,47.231497331979504,60.44738395288304,NaN,NaN,-6.579501439689552,-6.617559561223435
2005-11-15T09:30:00-05:00,47.64,48.94,47.58,47.8,25190608,27675487.75,45.53538340739976,48.090163636214335,NaN,NaN,-6.155208679288441,-21.819269868565762,-0.03761712105284454,-0.44234954906728063,-0.4047324280144361,78877269,51229663.4,45.94311222092272,60.3064259108225,NaN,NaN,-6.900625001548416,-6.65799748126986
2005-11-16T09:30:00-05:00,47.8,49.03999,47.74001,49.03999,22876192,26504742.15,51.29633977916567,48.74538193244638,NaN,NaN,22.93236840364797,-25.109103798615514,0.04554771585527717,-0.3477977831953396,-0.3933454990506168,101753461,59040662,49.55213407711032,60.149646120873165,NaN,NaN,-5.558523395706171,-6.500929754760762
2005-11-17T09:30:00-05:00,49.59,49.60001,48.62,49.02,18462000,25030646.95,51.202313550955395,49.02882766581571,NaN,NaN,50.266879227499984,-3.4521201411361533,0.09759647866157967,-0.2713499007236422,-0.36894637938522185,83291461,71169382.2,54.618645526126365,60.118295666573324,NaN,NaN,-4.481588816312827,-6.212452477839628
2005-11-18T09:30:00-05:00,49.2,49.39,48.47,49.03999,24014304,24657257.35,51.29845044800553,49.171173385242334,NaN,NaN,35.222760435353266,15.079017045178617,0.12974279496940588,-0.2067678856734645,-0.3365106806428704,107305765,84982923.4,59.59566077413366,60.27033059346898,NaN,NaN,-3.5587515880386436,-5.833352350725201
2005-11-21T09:30:00-05:00,49.53,50.25999,49.27,50.25999,17802704,24003637.35,56.881667885201075,49.6307014456443,NaN,NaN,115.02978826999265,43.45931753144103,0.2240156050501495,-0.05649117433018347,-0.28050677938033297,125108469,99267285,63.99326148168853,60.647709235679145,NaN,NaN,-1.1536581761446405,-5.164824611499407
2005-11-22T09:30:00-05:00,50.75,51.17,50.42,51.06,14411500,23044567.55,60.111016976060576,50.0657746344121,NaN,NaN,176.51113399565634,79.99258606643,0.32497280385031313,0.12570922543255847,-0.19926357841775466,139519969,111395825,67.25237826712599,60.87829293299192,NaN,NaN,1.8821843051858207,-4.1581090519729464
2005-11-23T09:30:00-05:00,50.66,51.34,50.33,50.87,12215102,22109027.45,58.98119637984787,50.1858558963934,NaN,NaN,145.87988459804916,104.58208930531023,0.36090650070537283,0.2518695474639614,-0.10903695324141144,127304867,116506106.2,68.54430070079624,60.710635558472475,NaN,NaN,4.113426851300959,-2.97646106579096
2005-11-25T09:30:00-05:00,50.85001,51.22,50.81,51,3675000,20929542.25,59.541520609467234,50.79660280907982,NaN,NaN,134.5001553794528,121.42874453570077,0.37380009599171776,0.3582131667482358,-0.015586929243481984,130979867,126043787.4,70.8552957440222,60.521282075177005,NaN,NaN,6.137251964228376,-1.6745020615024833
2005-11-28T09:30:00-05:00,50.71001,50.71001,49.22,49.28,22096096,20592356.65,49.84066538955828,50.94201517408794,NaN,NaN,37.441200126886066,121.87243247400734,0.25266205431174665,0.3002406386462013,0.04757858433445468,108883771,126359388.6,70.9313991904393,60.30520147482198,NaN,NaN,5.250265124102652,-0.6852496064160354
2005-11-29T09:30:00-05:00,49.7,49.96001,49.2,49.36,15002102,20208211.35,50.246695513322805,51.00054308685785,NaN,NaN,17.995849711112626,102.46564476223134,0.16816176246330594,0.2577807874135871,0.08961902495028118,123885873,126114869.4,70.77719469991509,60.06967087679495,NaN,NaN,4.6380007683057425,0.07521473282993285
2005-11-30T09:30:00-05:00,49.25,50.10001,49.25,49.55,17792000,20062686.55,51.25589469447399,51.256270204134736,NaN,NaN,24.70377217592095,72.10417239828426,0.11769161569458193,0.2367335445685086,0.11904192887392666,141677873,126546450.2,70.89745527937951,60.33888880805516,NaN,NaN,4.397052394825162,0.6926201131149656
2005-12-01T09:30:00-05:00,49.95,51.12,49.94,51.12,18679904,19950166.55,58.70905577972803,52.43096657574062,NaN,NaN,95.49985096516434,62.0281656717073,0.17899676614957777,0.34278788656089887,0.1637911204113211,160357777,133157032.2,72.74745122877223,61.60001438434962,NaN,NaN,6.388838846030895,1.5063656463886697
2005-12-02T09:30:00-05:00,51.55,51.55,50.63,51.17,15446602,19772561.45,58.92446124011173,53.497952674104376,NaN,NaN,120.14110062906978,59.15635472163071,0.20973597132801597,0.4259610845713411,0.2162251132433251,175804379,142121934.6,75.06261283979505,63.42874281158622,NaN,NaN,8.067014570623101,2.4436012069935886
2005-12-05T09:30:00-05:00,51.7,52,51.25999,51.53,20271392,19312575.85,60.521373688735316,54.5961453815738,NaN,NaN,135.81002269993206,78.83011923623995,0.2390110793178738,0.5149889623906674,0.2759778830727936,196075771,159560334.6,78.83000401014874,65.68577900288402,NaN,NaN,9.937358242435517,3.5141379263424355
2005-12-06T09:30:00-05:00,51.41,52.2,51.23,51.75,14015000,18936490.65,61.50627483433427,55.736923340640544,NaN,NaN,125.62639316239206,100.35622792649583,0.2563546424873587,0.5964211861819919,0.34006654369463324,210090771,176801314.2,81.76341706163115,68.24437220579176,NaN,NaN,11.782363515976115,4.695313010575818
2005-12-07T09:30:00-05:00,52.09,52.53999,51.23,51.56,33403296,19932960.55,60.111501017275515,56.36657771479124,NaN,NaN,113.09694098116448,118.03486168754455,0.23856104002495565,0.6382678437258278,0.39970680370087214,176687475,183803234.6,82.80545390485543,70.619609336345,NaN,NaN,12.978510276490754,5.878626905706523
2005-12-08T09:30:00-05:00,51.67999,52.52,51.60001,52.47,16306602,19137490.65,64.28850481540651,57.30130566225204,NaN,NaN,119.24446696290003,122.78378488709168,0.2693326142413874,0.7363725715026064,0.467039957261219,192994077,190330494.6,83.73828777436265,72.69958378264758,NaN,NaN,15.240925212810119,7.216098092435608
2005-12-09T09:30:00-05:00,52.00999,52.35001,51.59,51.82001,14143500,17842135.25,59.49607809511612,57.886850494188515,NaN,NaN,95.26869324655227,117.80930341058817,0.22876202268110035,0.7529924856125945,0.5242304629314941,178850577,190939734.2,83.82648600535481,74.43035701344908,NaN,NaN,15.867202308739092,8.451970123336105
2005-12-12T09:30:00-05:00,52.50999,52.53,51.94,52.49001,13506199,17737935.25,62.59166726742468,58.29470759291877,NaN,NaN,107.94878266120772,112.23705540284331,0.22931960432789333,0.8108799683413608,0.5815603640134674,192356776,190195935.2,83.23295818209496,75.80462106347811,NaN,NaN,17.30718560070171,9.717000905816906
2005-12-13T09:30:00-05:00,52.64999,53.19,52.2,52.27,18908304,17910920.35,60.944517140326695,58.35424331893778,NaN,NaN,114.23635065638369,109.95904690164164,0.19830527406526421,0.8294419565950477,0.6311366825297835,173448472,182867475.4,77.41679213913132,76.53065062576421,NaN,NaN,18.046220400135617,10.906889405005293
2005-12-14T09:30:00-05:00,52.3,52.96001,52.08,52.89999,15863500,17444564.95,63.87600659656181,58.703872620131634,NaN,NaN,114.49619174997189,110.23889705540311,0.20292113992088756,0.884788107430893,0.6818669675100054,189311972,185392374.8,77.98751669464997,77.20516605389662,NaN,NaN,19.528994139505222,12.138618652790997
2005-12-15T09:30:00-05:00,52.60001,52.95,52.10001,52.48,15362000,17068855.35,60.609832100108086,58.780180583748844,NaN,NaN,98.17631858429311,106.02526737968174,0.16215758213644904,0.8845639451805667,0.7224063630441176,173949972,181583553.8,74.91196328705853,77.49492802125636,NaN,NaN,19.86853626722607,13.242892597710293
2005-12-16T09:30:00-05:00,52.35001,52.59,51,51.07001,22733296,17282420.15,51.1532054069467,58.873933442133726,NaN,NaN,28.59225597282375,92.68997992493603,0.03153889670730703,0.7618299839282514,0.7302910872209444,151216676,176056773.6,70.56341699215542,77.46864357852179,NaN,NaN,17.221384631959737,13.81124860260307
2005-12-19T09:30:00-05:00,51.32001,51.60001,50.64,50.64999,19436192,17053514.55,48.71487059539818,58.764517376567674,NaN,NaN,-23.86169336878748,66.32788471893699,-0.0854463054947785,0.6234832053524713,0.7089295108472498,131780484,163941515.2,62.05902898129556,76.84591745576326,NaN,NaN,14.271383727721346,13.87698219190568
2005-12-20T09:30:00-05:00,50.8,51.5,50.8,51.34,14594500,16893104.35,52.70346527853416,58.86791527542913,NaN,NaN,-9.540658853817924,41.57248281689667,-0.11671947614453981,0.563030165666575,0.6797496418111149,146374984,158526817.6,58.65647049160893,75.97156139949394,NaN,NaN,12.954095364998983,13.745141216633295
2005-12-21T09:30:00-05:00,51.5,51.97,51.21001,51.45,17689200,17056989.35,53.326653696485764,58.48345798376896,NaN,NaN,16.890477303694265,22.05133992764114,-0.12937947054819665,0.5180253036258691,0.6474047741740657,164064184,153477260,55.59519985421344,74.74640058702543,NaN,NaN,12.067811415258173,13.505522673579707
2005-12-22T09:30:00-05:00,51.75,51.86,51.23,51.39,8416102,16867039.35,52.9170827014965,58.054359516725015,NaN,NaN,9.84288183668099,4.384652578118721,-0.14026354971649835,0.47207533702844273,0.6123388867449411,155648082,149816882,53.41880708779863,73.20041446188284,NaN,NaN,11.226639131743156,13.179967881888771
2005-12-23T09:30:00-05:00,50.89,51.42999,50.41,51.25,13896500,17378114.35,51.91514571910399,57.43962894746563,NaN,NaN,-33.26254026899398,-7.986306670244827,-0.1542496823086006,0.4195267838591903,0.5737764661677909,141751582,147923863.2,52.278975417941396,71.30391241958232,NaN,NaN,10.248795198996842,12.761228927189924
2005-12-27T09:30:00-05:00,50.8,50.8,49.46001,49.74001,25652192,17555919.15,42.556003121058495,56.08603811080308,NaN,NaN,-133.06693257364998,-29.827354511217322,-0.256524940734583,0.2531202902495622,0.5096452309841452,116099390,144787644.4,50.361706286193986,69.06093307847966,NaN,NaN,6.410492622992494,11.853980883733149
2005-12-28T09:30:00-05:00,50.03999,50.78,49.98,50.49001,19398896,17775758.85,47.60816727791954,55.19294284370623,NaN,NaN,-106.0713097812392,-49.13348469670158,-0.2639647204592312,0.17968933041010615,0.44365405086933735,135498286,142612304.8,49.01886507873429,66.6476053051853,NaN,NaN,4.653358019379374,10.825320474539753
2005-12-29T09:30:00-05:00,50.39999,50.97,50.05,50.10001,12562102,17514263.95,45.373449774207735,53.8418674836206,NaN,NaN,-122.76120685815013,-77.06382152907045,-0.28372396161522295,0.08899909885030866,0.3727230604655316,122936184,134386704.8,44.217710587374235,63.82470693468613,NaN,NaN,2.512686078802157,9.637801275148668
2005-12-30T09:30:00-05:00,49.8,50.7,49.64,50.31,12112801,17185908.8,46.820890922026116,52.93649697125703,NaN,NaN,-130.63312670877394,-105.15902323816144,-0.2712323660428238,0.03368260291200187,0.30491496895482567,135048985,130266885.4,41.9989223679782,60.83702381773066,NaN,NaN,1.1763681804682022,8.429025118765745
2006-01-03T09:30:00-05:00,50.63,52.7,50.63,52.7,24191008,17623129.1,59.85797321507341,52.741233110374786,NaN,NaN,53.503441659267665,-87.80582685250911,-0.09944006216687157,0.1806148912462362,0.28005495341310777,159239993,133764567.6,44.543181832436574,58.07346836418363,NaN,NaN,4.395683506088277,7.852833459811821
2006-01-04T09:30:00-05:00,52.39999,52.95,51.99001,52.85001,19997904,17609454.7,60.512319983506686,52.71036188488764,NaN,NaN,103.43104986893614,-40.50623036399189,0.020468918305094896,0.3056411012944764,0.2851721829893815,179237897,146392269,52.623317025696466,56.30250585608115,NaN,NaN,7.1066516826632675,7.746236063076314
2006-01-05T09:30:00-05:00,52.95,53,51.67999,52.17999,23561008,18086755.1,56.112635136647,52.15583535203659,NaN,NaN,67.14164299277662,-5.8636398091887285,0.04919355825224703,0.3466641308046903,0.29747057255244325,155676889,150427989.6,54.88566651376874,54.65237370030392,NaN,NaN,7.9392579606340625,7.773810619870278
2006-01-06T09:30:00-05:00,53.03,53.60001,52.77,53.46001,18145904,17323885.5,61.82333601549454,52.24251420313562,NaN,NaN,139.2927062200061,46.54714280644252,0.1435947020823492,0.47696395015537973,0.33336924807303053,173822793,160605311.4,60.0647039650232,53.5918551773014,NaN,NaN,10.620069659977387,8.180419054171294
2006-01-09T09:30:00-05:00,53.45,53.69,52.88,53.39999,15235199,17270315.35,61.419763144886836,52.975839755845634,NaN,NaN,129.0861378205111,98.49099571229954,0.1883664386364013,0.5688272963685321,0.38046085773213084,158587594,165313033.2,62.22494202153114,52.9962498222568,NaN,NaN,12.575773475860686,8.80832682869835
2006-01-10T09:30:00-05:00,53.39999,54.25999,53.3,53.98,17491296,17437705.15,63.87398468339998,54.05863361927434,NaN,NaN,146.35523143010553,117.06135366646711,0.240100309936225,0.6805862451524121,0.44048593521618706,176078890,168680812.6,63.73618977007705,53.11604702145548,NaN,NaN,14.98174167497672,9.690243235309545
2006-01-11T09:30:00-05:00,53.75,54.45,53.10001,54.21001,19714496,17748120,64.82946933419197,54.92477676610703,NaN,NaN,134.3034273179361,123.2358291562671,0.27060251788620415,0.7787390825739422,0.508136564687738,195793386,171991910.4,65.20985820745584,53.58414614401597,NaN,NaN,17.225987073279487,10.76677806930525
2006-01-12T09:30:00-05:00,54.64999,55.03999,53.69,53.82001,22318800,17918644.8,61.84274602726537,55.533069075448445,NaN,NaN,135.38253618265793,136.88400779424336,0.2460138068118175,0.8156538232025099,0.5696400163906924,173474586,175551449.8,66.77308795055728,54.382566722326246,NaN,NaN,18.228831355367824,11.832785681599903
2006-01-13T09:30:00-05:00,53.35001,54.57001,53.35001,54.46001,17708496,18010894.6,64.71554959728061,56.3758167108616,NaN,NaN,118.94096050412537,132.81365865106721,0.25335563434983943,0.8863345593279917,0.6329789249781522,191183082,179023507.6,68.27071844544874,55.44341753358697,NaN,NaN,19.949817754409327,12.99236169200125
2006-01-17T09:30:00-05:00,55.3,55.71001,55.13,55.66,15398000,18012694.6,69.37176558538329,57.62271812988154,NaN,NaN,165.5194595557634,140.10032299811766,0.31548583898345595,1.0273362237074721,0.7118503847240162,206581082,188622205.2,72.02475607433058,56.85383043761476,NaN,NaN,22.98619482035125,14.420052138908392
2006-01-18T09:30:00-05:00,55.50999,55.64999,54.19,54.96001,21610096,17956534.6,64.06116673711688,59.15880124531429,NaN,NaN,118.66058546158312,134.5613938044132,0.286728028017592,1.0702604197460062,0.7835323917284142,184970986,190400624.4,72.6699428177089,58.44727590415154,NaN,NaN,23.87233237803472,15.77037788735501
2006-01-19T09:30:00-05:00,54.62,56.3,54.62,56.16,26410192,18305234.6,68.51141616220292,60.65189045133452,NaN,NaN,133.85233314691942,134.47117497020986,0.32310967536362234,1.187419485932942,0.8643098105693198,211381178,193518182.8,73.81021525085139,60.21808663073133,NaN,NaN,26.121483996654348,17.249107331540632
2006-01-20T09:30:00-05:00,56.89999,57.50999,56,56.41,28719904,19011504.8,69.36259233812113,62.3654006344712,NaN,NaN,150.1342145307619,137.42151063983064,0.3370497123881626,1.285621951054523,0.9485722386663604,240101082,206843482,78.02963239529471,62.63322390272565,NaN,NaN,28.18375724170164,18.811200175849347
2006-01-23T09:30:00-05:00,56.10001,57.3,55.91,57.03,21652096,19209649.6,71.42550684602135,64.12287320047086,NaN,NaN,135.79174055696572,140.79166665039872,0.359037354193644,1.3973689314084154,1.0383315772147714,261753178,220957501.2,81.44036971246555,65.45047014161761,NaN,NaN,30.55985645979619,20.48957964498461
2006-01-24T09:30:00-05:00,56.52,57.2,56.50999,56.69,19697504,19773719.7,68.69389330490361,64.75401034974445,NaN,NaN,123.1324220593613,132.3142591511183,0.32283317423055413,1.4418730450029642,1.11903987077241,242055674,228052419.6,82.87922083284607,68.18875864164686,NaN,NaN,31.6845366059277,22.088859210833622
2006-01-25T09:30:00-05:00,57.21001,57.3,54.95,55.5,37099104,20933849.9,60.03916746224543,64.72021374108292,NaN,NaN,83.09451100263075,125.20104425932784,0.1970725543325682,1.3653805636881202,1.168308009355552,204956570,232049536.4,83.6483380883566,70.40483157469401,NaN,NaN,29.921644373999545,23.207828519857326
2006-01-26T09:30:00-05:00,55.36,55.75,54.55,55.67999,27029696,21002725.1,60.84275539590324,65.05807947388693,NaN,NaN,56.304352218591525,109.69144807366226,0.1087526654231259,1.3042488411344593,1.1954961757113334,231986266,236170554,84.42518294937115,72.5147970343799,NaN,NaN,28.746650872537515,23.999088855954497
2006-01-27T09:30:00-05:00,56.11,56.91,56.00999,56.64999,22876496,21176605.1,64.93516183041372,65.28035274638115,NaN,NaN,95.28108944348301,98.72082305620647,0.09869849913782813,1.3188692996336187,1.2201708004957905,254862762,239122890,84.97587350191927,74.29416628701533,NaN,NaN,28.98526839582646,24.711400218793347
2006-01-30T09:30:00-05:00,57.31,58.28,57.2,57.95,28847200,21990860,69.53118161078737,65.85973977965976,NaN,NaN,133.9910503498547,98.36068501478428,0.159062340937012,1.4189987266670556,1.2599363857300436,283709962,243514246.8,85.78118816254823,75.97675529708798,NaN,NaN,30.709206922982563,25.568229747963237
2006-01-31T09:30:00-05:00,57.75,57.95,57.27,57.66,17568800,22263659.95,67.40861445831143,66.1122133350106,NaN,NaN,118.45460247762497,97.42512109843702,0.1585651947496669,1.4581428791671271,1.2995776844174602,266141162,248331344.4,86.62792156623193,77.61187899681333,NaN,NaN,31.419946217691763,26.40418924363874
2006-02-01T09:30:00-05:00,57.49001,58.07001,56.25999,56.28999,32495600,22678889.55,58.346906041217146,65.6491730997981,NaN,NaN,78.21396442910498,96.44901178373185,0.05066250433728525,1.362905814839067,1.3122433105017817,233645562,254069142.8,87.57690314026762,79.20952506344274,NaN,NaN,29.02971860407233,26.779264866557824
2006-02-02T09:30:00-05:00,55.99001,56.59,55,55.73,35982192,23478103.95,55.08714216087785,65.1666299664847,NaN,NaN,21.4115500911807,89.47045135824969,-0.06732534912178822,1.2280866240995465,1.2954119732213347,197663370,247204563.6,80.24014987062105,80.17145805773302,NaN,NaN,26.016924245166933,26.670359063501984
2006-02-03T09:30:00-05:00,55.75,55.88,54.94,55.22,20860896,23343098.35,52.225436404608544,64.27447902415099,NaN,NaN,-9.588382338711414,68.49655700181081,-0.1821055760490371,1.0677800031600384,1.2498855792090755,176802474,231592506,66.57912395627588,80.05062987993496,NaN,NaN,22.634883437442692,26.093862545493515
2006-02-06T09:30:00-05:00,55.75999,56.64999,55.7,56.3,21975008,23534553.55,57.285836998938684,63.41119841083353,NaN,NaN,35.91752066959779,48.881851065759406,-0.186973214733255,1.0161690607925067,1.2031422755257617,198777482,214606010,55.50621907866687,78.8707343802447,NaN,NaN,21.33089063692615,25.41343798712675
2006-02-07T09:30:00-05:00,55.7,55.7,53.72,53.95,36514400,24598513.6,45.894439012418395,62.11357500192649,NaN,NaN,-85.49405494054969,8.092119582124477,-0.34116303992162633,0.7766884756237289,1.1178515155453552,162263082,193830394,45.53207331340566,76.93231512993732,NaN,NaN,15.95515737808866,24.06225504297845
2006-02-08T09:30:00-05:00,54.09,54.25,52.8,53.96001,44288704,25938384,45.94374805737734,60.501598708724664,NaN,NaN,-137.1888348675356,-34.988440277203644,-0.4294743289718508,0.5810086043305418,1.0104829333023926,206551786,188411638.8,43.34432856220538,74.7561803664626,NaN,NaN,11.920204818472572,22.32767643947761
2006-02-09T09:30:00-05:00,54.5,54.95,52.62,52.73,31248096,26515064,40.999274013150504,58.475647399798184,NaN,NaN,-147.6723987865744,-68.80523005275465,-0.5500211247682453,0.322956527342086,0.8729776521103313,175303690,183939702.8,41.569192904576674,72.15186325998275,NaN,NaN,6.792240319373182,20.108328422319836
2006-02-10T09:30:00-05:00,52.89999,53.17,51.59,52.53999,43384096,27568328.8,40.278140643062585,56.25083552815828,NaN,NaN,-189.65610772693512,-104.8187751303994,-0.6168292696862655,0.10194106500249944,0.718770334688765,131919594,174963126.8,38.188314333410375,69.06243073290737,NaN,NaN,2.5430130346891002,17.5989976526583
2006-02-13T09:30:00-05:00,52.64999,53.3,52.07001,52.33,23419600,27853884,39.452258389805664,54.16214731993699,NaN,NaN,-164.27481647759757,-144.85724255983845,-0.6463220742182914,-0.08913225808409919,0.5571898161341922,108499994,156907629.2,32.468256927761104,65.46164759682988,NaN,NaN,-1.1207209990459643,14.924752130986263
2006-02-14T09:30:00-05:00,51.5,52.25,51.28,51.74001,30850000,28626484,37.14758181137205,52.52703405916033,NaN,NaN,-169.53128418890898,-161.66468840951035,-0.6736578982725872,-0.28488255670654183,0.3887753415660453,77649994,139985011.6,28.204170553685856,61.50134991578197,NaN,NaN,-4.903790952510709,12.092103119058125
2006-02-15T09:30:00-05:00,52.05,52.5,51.09,51.46001,52032192,30147588.8,36.0706453138207,50.75759762472586,NaN,NaN,-143.68453070258923,-162.96382757652106,-0.6768905394598844,-0.45733783275881024,0.21955270670107419,25617802,103798214.8,21.654928316412395,57.01776029914206,NaN,NaN,-8.338841727869708,9.17339671235415
2006-02-16T09:30:00-05:00,51.96001,52.72,51.94,52.64,27137392,30183948.8,43.5039602327203,49.226797510604904,NaN,NaN,-97.39609051106429,-152.908565921419,-0.5701303907322095,-0.4931102817141877,0.07702010901802181,52755194,79288515.6,18.5183722524594,52.27079592418064,NaN,NaN,-9.168095443675533,6.553183547207052
2006-02-17T09:30:00-05:00,53.71001,53.98,52.7,53.00999,23606608,29928284,45.638337962769135,47.520165821460736,NaN,NaN,-59.91115204045646,-126.95957478412329,-0.45041830081567547,-0.4860027670015725,-0.03558446618589706,76361802,68176957.2,17.2953158720305,47.37894790342938,NaN,NaN,-9.218856208159828,4.300035010726069
2006-02-21T09:30:00-05:00,53.89999,54.5,53.61,54.05,20876400,29889499.2,51.217275962837235,46.36364164321258,NaN,NaN,-24.859078062868946,-99.07642710117756,-0.28507798512211335,-0.3919319475885388,-0.10685396246642541,97238202,65924598.8,17.049504128201036,42.409060943570026,NaN,NaN,-7.541748298228623,2.608351680875399
2006-02-22T09:30:00-05:00,53.60001,53.64999,52.78999,53.03999,24284000,30118824,46.25283853487112,45.49977967847358,NaN,NaN,-53.8053613816368,-75.93124253972312,-0.22998393082375967,-0.394333875996125,-0.16434994517236534,72954202,64985440.4,16.941383382243913,37.36366667513976,NaN,NaN,-7.625948897440287,1.1463087411160153
2006-02-23T09:30:00-05:00,52.91,53.69,52.10001,52.98,28979392,29712838.4,45.96783810471724,44.84840081731925,NaN,NaN,-57.64891174700347,-58.724118748605974,-0.18572598182846853,-0.396507422457951,-0.21078144062948248,43974810,68656842,19.101201023061947,32.996598900314105,NaN,NaN,-7.776821372163625,-0.12842413220964755
2006-02-24T09:30:00-05:00,54,54.13,53.56,53.63,16514898,29187098.5,49.5921415361567,44.66030832671555,NaN,NaN,-20.9779096269125,-43.44048257177562,-0.10484675831102636,-0.3418398885182654,-0.23699313020723906,60489708,70203744.8,20.04460130115494,29.67270442494833,NaN,NaN,-6.828163112343318,-1.0855297008001719
2006-02-27T09:30:00-05:00,53.35001,53.5,52.7,52.7,16032699,28844908.65,44.94672623916856,43.778943272446256,NaN,NaN,-49.66604321131061,-41.39146080594644,-0.10584679379984985,-0.36930162245705134,-0.2634548286572015,44457009,63822786.2,19.05735798399087,27.06921434675719,NaN,NaN,-7.396792771977975,-1.9871387109684293
2006-02-28T09:30:00-05:00,52.55,52.55,51.87,52.34,23835008,28594299.05,43.257539245032184,43.59059328906152,NaN,NaN,-77.78339953056161,-51.976325099484995,-0.12149742442640654,-0.4153266091902097,-0.29382918476380315,20622001,48499546,16.90422255108318,25.02436786373416,NaN,NaN,-8.364685387172068,-2.898216807568949
2006-03-01T09:30:00-05:00,52.74001,53.25999,52.58,53.23,13395398,28385628.95,48.418664896465934,43.767373063282136,NaN,NaN,-33.942263162317154,-48.003705455621066,-0.06546133535846216,-0.37565585396188084,-0.3101945186034187,34017399,40712185.4,15.919823334735014,23.06547463320056,NaN,NaN,-7.647494845398309,-3.5766850986874292
2006-03-02T09:30:00-05:00,53.39999,54.22,53.19,54.12,21050400,27813368.95,53.020483473007836,44.62603088184336,NaN,NaN,27.5136500684324,-30.971193092533895,0.03271829605200316,-0.26929664853841473,-0.3020149445904179,55067799,42930783.2,17.39570541673956,21.33879695549791,NaN,NaN,-5.598235775528127,-3.8654780525218144
2006-03-03T09:30:00-05:00,53.62,54.52,53.55,54.13,22522704,27140394.55,53.07114421613706,45.53981685134868,NaN,NaN,54.56159096084186,-15.863292974983022,0.09593182905950909,-0.18210015826603154,-0.27803198732554063,77590503,46350942.2,19.734747432998162,20.02068503403989,NaN,NaN,-3.9437940472874007,-3.876666051774041
2006-03-06T09:30:00-05:00,53.64999,53.78,52.22,52.25,23586608,27276680.15,43.56070731345974,45.83327748875255,NaN,NaN,-42.31414039434205,-14.392912411589311,0.013081498479448173,-0.2616801142262304,-0.27476161270567856,54003895,48260319.4,21.078322157179315,19.20711826471262,NaN,NaN,-5.4260735094920545,-4.098009974305186
2006-03-07T09:30:00-05:00,52,52.35001,51.16,51.48,23866096,27371234.55,40.36978648275851,46.063434965280145,NaN,NaN,-134.90622805802508,-25.817478117082004,-0.08616788938088249,-0.38247147443178164,-0.29630358505089915,30137799,50163479,22.471365233031534,18.797632170380172,NaN,NaN,-7.693468666134799,-4.611646930280845
2006-03-08T09:30:00-05:00,50.97,52.09,50.64999,51.48,40786608,27584844.95,40.36978648275851,46.370516477347145,NaN,NaN,-143.12712881470466,-47.65445124755951,-0.14115707653900322,-0.4727499307246532,-0.33159285418565,30137799,49387559,22.29855424155346,18.84360545074739,NaN,NaN,-9.47935068158827,-5.30703318046762
2006-03-09T09:30:00-05:00,52,52.22,51.08,51.11,22813504,26511084.95,38.78642097967459,46.03354938784388,NaN,NaN,-120.79723415175239,-77.31662809159647,-0.18881301338537415,-0.5676091209173677,-0.37879610753199355,7324295,39838858.2,20.236115425476996,18.966301391677217,NaN,NaN,-11.430515416261292,-6.181816357009573
2006-03-10T09:30:00-05:00,50.89999,51.75,50.55,51.39,23899696,26143664.95,40.68246667533989,45.679558581598926,NaN,NaN,-125.72380356822596,-113.37370699741003,-0.18746258351588085,-0.6131243369268446,-0.4256617534109638,31223991,30565555.8,18.451251856955565,19.048868247743293,NaN,NaN,-12.517954417760869,-7.086978937116902
2006-03-13T09:30:00-05:00,51.69,52.46001,51.55,52.39999,11998500,24574385.15,47.05313511358525,45.3821199495095,NaN,NaN,-42.381734329344035,-113.38722578441043,-0.1084531826073486,-0.5612282316701496,-0.45277504906280097,43222491,28409275,18.052528664959553,19.120512857511756,NaN,NaN,-11.596211188761343,-7.731154973066108
2006-03-14T09:30:00-05:00,52.60001,53.45,51.44,53.37,16599102,24233360.25,52.346595575803384,45.81738830957609,NaN,NaN,10.883623589469954,-84.22925545491141,0.012785310033262998,-0.4367934115212222,-0.4495787215544852,59821593,34346033.8,22.986976974614237,19.552340971252494,NaN,NaN,-9.148005904984464,-7.933562249054444
2006-03-15T09:30:00-05:00,53.10001,53.66,52.91,53.64999,21665200,23774120.25,53.78292120004893,46.375608530671215,NaN,NaN,62.524186627197274,-43.098992366531036,0.11007205244151586,-0.3119886560025904,-0.42206070844410626,81486793,44615832.6,30.754649028770856,20.384730114517417,NaN,NaN,-6.709674326153131,-7.758721117211399
2006-03-16T09:30:00-05:00,53.48,54.57001,53.3,54.5,27302400,22537630.65,57.928743267204304,46.971080082888896,NaN,NaN,116.16434448258141,4.293323360335722,0.223372838287417,-0.14284466058483503,-0.366217498872252,108789193,64908812.2,42.99069323477136,22.023736681204305,NaN,NaN,-3.3110808429336926,-7.123343935171727
2006-03-17T09:30:00-05:00,54.3,54.64999,53.60001,53.64999,23296800,22345601.05,52.82560506012457,47.53385714152862,NaN,NaN,92.48709772758126,47.93550361949717,0.23177108517631334,-0.07650364240186036,-0.3082747275781737,85492393,75762492.6,48.25712945102033,24.109434643134982,NaN,NaN,-1.9290722109304752,-6.3813051174229765
2006-03-20T09:30:00-05:00,53.5,53.89,52.39999,52.46001,22892704,22309905.85,46.63220057245141,47.774904379201416,NaN,NaN,1.9875425736672523,56.80935900009941,0.15175385861381374,-0.1185824043109065,-0.27033626292472024,62599689,79637932.2,50.03209858647551,26.47571150280586,NaN,NaN,-2.6952676429900486,-5.85472833536113
2006-03-21T09:30:00-05:00,52.3,53.14999,52.02,52.37,25416400,22536905.85,46.19105831635644,47.61578962347931,NaN,NaN,-28.229424870827184,48.986749308040004,0.09036579935202954,-0.15737901373468333,-0.24774481308671287,37183289,75110271.4,47.96207248247677,28.76444358478741,NaN,NaN,-3.437636703882354,-5.509429530864161
2006-03-22T09:30:00-05:00,52.37,53.42,52.33,52.72,21962800,22420845.85,48.241449932713174,47.27443008488683,NaN,NaN,2.166022300245876,36.915116442649726,0.07174665307342232,-0.15806149674493497,-0.2298081498183573,59146089,70642130.6,45.94196570349945,30.803462176698837,NaN,NaN,-3.4511531964415045,-5.215390054518068
2006-03-23T09:30:00-05:00,53.16,53.59,53.02,53.5,17357008,21839726.65,52.57826632567325,47.23922452128227,NaN,NaN,50.4615548820113,23.7745585225357,0.10818834960212217,-0.09457271281570456,-0.20276106241782674,76503097,64184911.4,43.115686559867385,32.4735292571895,NaN,NaN,-2.162377113891696,-4.7792453487143005
2006-03-24T09:30:00-05:00,53.45,54.3,53.42,53.86,21258496,22076906.55,54.47426689568659,48.01876449144133,NaN,NaN,94.69026541911246,24.21519206084194,0.15018077981116462,-0.01503508765387096,-0.16521586746503558,97761593,66638751.4,44.51264943393393,34.14740977695768,NaN,NaN,-0.530855229355646,-4.172332474520207
2006-03-27T09:30:00-05:00,53.45,54.28,53.28,54.14,19370608,22243802,55.94947187608427,49.13159916239317,NaN,NaN,88.40554707564125,41.49879296123673,0.18800328429364788,0.06978823790202426,-0.11821504639162361,117132201,77545253.8,50.34903504346771,36.13867190627455,NaN,NaN,1.2534063169296485,-3.3972269328845135
2006-03-28T09:30:00-05:00,54.45,55.09,54.38,54.56,22502400,22177171.6,58.140583652126104,50.400941817348006,NaN,NaN,135.29103016043575,74.20288396748933,0.22973541735232567,0.16895422529878346,-0.060781192053542196,139634601,98035516.2,59.06129448598733,38.76458192373411,NaN,NaN,3.400022999597944,-2.4261912282441624
2006-03-29T09:30:00-05:00,54.39999,55.24001,54.39999,55.2,18209600,22417881.7,61.29954862710719,52.00902236359319,NaN,NaN,133.75385354718392,100.52045021687692,0.2852466350394954,0.29577710174582705,0.010530466706331662,157844201,117775138.6,65.3662082617723,41.98815998346944,NaN,NaN,6.192705934763369,-1.1949202049573724
2006-03-30T09:30:00-05:00,55.3,55.7,54.92999,55.17,23464704,22538596.9,61.06690907942345,53.46505396388487,NaN,NaN,140.8521320033666,118.59856564114799,0.30307635672893113,0.3893759126174956,0.08629955588856446,134379497,129350418.6,68.43603552810656,45.55850167426594,NaN,NaN,8.42123148729322,0.1788157510784263
2006-03-31T09:30:00-05:00,54.7,54.75,54.06,54.39999,25848896,22704906.5,55.269045088655524,54.05190467638989,NaN,NaN,80.57689010264471,115.77589057785444,0.24843690154094805,0.3968456828147495,0.14840878127380147,108530601,131504220.2,68.98686658545847,49.196668668587286,NaN,NaN,8.78304964685832,1.4079920219041253
2006-04-03T09:30:00-04:00,54.75,55.67999,54.53999,54.7,18388400,22444996.1,56.98272243377175,54.383056594816196,NaN,NaN,104.86278230891743,119.06733762450968,0.2189593994617891,0.42210803060103785,0.20314863113924875,126919001,133461580.2,69.50766216934423,52.51957475392515,NaN,NaN,9.566599932917507,2.5735074377631797
2006-04-04T09:30:00-04:00,54.25,55.52,54.25,55.42,13776102,21940496.4,60.85834535240439,54.88844403427016,NaN,NaN,101.04011467172536,112.2171545267676,0.23310190935592434,0.4945260178341542,0.26142410847822983,140695103,133673680.6,69.56729941819135,55.29190692459804,NaN,NaN,11.38027730546918,3.831617418864037
2006-04-05T09:30:00-04:00,55.39999,56.35001,55.11,56.33,20414800,20921906,65.13392703380649,55.4031000175989,NaN,NaN,141.65549675528501,113.79748316838781,0.2854372936790931,0.6182207255770962,0.3327834318980031,161109903,134326821,69.76341377071101,57.20424410573658,NaN,NaN,14.300164632630445,5.3271241636878095
2006-04-06T09:30:00-04:00,56.75999,56.86,55.87,56.45,21271904,20844826,65.66652357777436,56.32030848314532,NaN,NaN,157.48274519723768,117.12360580716204,0.30790120070281946,0.7176599327765274,0.40975873207370794,182381807,143927283,72.56230942512516,58.94032838960121,NaN,NaN,16.836797902336954,6.971363269209116
2006-04-07T09:30:00-04:00,56.2,56.42,55.25999,55.35001,21693696,20734526,57.061868394764566,57.06528475616768,NaN,NaN,102.10822901565669,121.42987358976443,0.2319059685365833,0.699641192744437,0.46773522420785374,160688111,154358785,75.24380587638592,60.741164624594816,NaN,NaN,16.510236667304508,8.334059468937028
2006-04-10T09:30:00-04:00,55.97,56.55,55.8,56.39999,17288192,20999010.6,62.15903286180129,58.2058543665566,NaN,NaN,126.29222135435045,125.71576139885103,0.23485975310891516,0.7613099155939977,0.5264501624850826,177976303,164570245.4,77.55615124921178,62.85502739364732,NaN,NaN,17.850163474775453,9.693502898342517
2006-04-11T09:30:00-04:00,56.89999,57.12,55.73,56,13796000,20858855.5,59.27240471626177,58.99377970823865,NaN,NaN,115.39188281292822,128.5861150270916,0.19407341871790984,0.7690419358824698,0.57496851716456,164180303,169267285.4,78.54868181647286,65.18407854457398,NaN,NaN,18.04307744847617,10.886299262647324
2006-04-12T09:30:00-04:00,55.83,56.34,55.37,55.63,16350398,20593115.4,56.65159201009677,59.284731542840326,NaN,NaN,74.75139844995324,115.20529536602525,0.12948127135222498,0.7368201063548412,0.6073388350026162,147829905,166611285.8,76.48884373357136,67.56787548555283,NaN,NaN,17.400491846043835,11.81689820313254
2006-04-13T09:30:00-04:00,55.06,55.86,54.78999,55.81,11404398,19798215.3,57.633037605135286,59.510358022086656,NaN,NaN,50.41076989940186,93.7909003064581,0.08815872979854378,0.7175372472507959,0.6293785174522522,159234303,161981785,72.90033074663636,69.59556700788873,NaN,NaN,17.159305095750263,12.580099187792214
2006-04-17T09:30:00-04:00,56.67,56.84,56.19,56.84,13716102,19319180.4,62.82040633728562,60.00113905502961,NaN,NaN,113.3317012037841,96.03559474408357,0.11763140493829416,0.7764177736251199,0.6587863686868257,172950405,164434243.8,73.60674843268842,71.25683224997593,NaN,NaN,18.53459961183856,13.43074210551312
2006-04-18T09:30:00-04:00,57.3,58.33,57.2,58.23,29224400,19635765.2,68.43686080165827,60.73658742285334,NaN,NaN,177.92537067508707,106.36222460823089,0.21263839724621814,0.9245843652445984,0.7119459679983803,202174805,169273944.2,74.9921490790401,72.39475043519398,NaN,NaN,21.6568744984582,14.605903875933846
2006-04-19T09:30:00-04:00,57.89999,59.14999,57.8,59.13,24264800,19578185.2,71.44471320895727,61.46124203584263,NaN,NaN,200.87833255337534,123.45951455632034,0.31198530522575674,1.1019275995305762,0.7899422943048194,226439605,181725804.6,78.16746603156808,73.3091259901794,NaN,NaN,25.306339278084018,16.134537504812442
2006-04-20T09:30:00-04:00,58.8,59.17999,57.5,58.52,26265296,19793310,66.79834080271971,61.87063001607809,NaN,NaN,163.65423306390747,141.24008147911118,0.3117687092074356,1.179653180814114,0.8678844716066784,200174309,192194685.4,80.41861768131211,74.16502471540836,NaN,NaN,26.765891339708798,17.653302338369066
2006-04-21T09:30:00-04:00,58.95,59.85001,58.52,59.74001,19604608,19905690,70.87766606223083,62.985531514190605,NaN,NaN,187.9063148388293,168.73919046699666,0.36523537108039994,1.3244286854571783,0.9591933143767783,219778917,204303608.2,82.64734291989372,75.14077302501087,NaN,NaN,29.421729679370827,19.33450624422646
2006-04-24T09:30:00-04:00,59.5,59.60001,58.52,58.83,29455296,20315530,64.51076372388964,63.52324874919903,NaN,NaN,143.89801256894484,174.8524527400288,0.3127815026421312,1.3501701926794425,1.0373886900373113,190323621,207778251.4,83.2369407180683,76.12143577849118,NaN,NaN,29.451516857717913,20.77979347472524
2006-04-25T09:30:00-04:00,59.45,59.73,57.41,58.07001,33836304,21038814.8,59.6884498250975,63.43968478296282,NaN,NaN,98.37388495798669,158.94215559660876,0.20554944989810298,1.29432550240994,1.088776052511837,156487317,198640753.8,75.9304691875907,76.57594790487683,NaN,NaN,27.843135406742096,21.788842322156217
2006-04-26T09:30:00-04:00,58.19,59.13,57.08,57.14999,29427104,21385050,54.38813647288636,62.67212831432567,NaN,NaN,58.621831233159355,130.49085533256556,0.05892354434298186,1.1624304829405645,1.1035069385975826,127060213,178764875.4,62.980186032323985,76.0914316378492,NaN,NaN,24.69991592314811,22.204709979440775
2006-04-27T09:30:00-04:00,55.85001,57.60001,55.25,56.5,44879504,22718545.2,50.94609397467942,61.62066905696174,NaN,NaN,-13.579335165127253,95.04414168675859,-0.08760890762724749,0.9939958040635233,1.0816047116907708,82180709,155166155.4,51.704599143649254,74.60159518917234,NaN,NaN,20.988254528761342,22.030930629343715
2006-04-28T09:30:00-04:00,56.87,57.86,56.87,57.14,19053904,22498005.2,54.03095439823679,61.4041752000669,NaN,NaN,25.950258413964438,62.652930401785625,-0.14387748486519603,0.9017578556092758,1.0456353404744718,101234613,131457294.6,43.314364824700064,72.32092082833763,NaN,NaN,18.924114459493712,21.58709974793657
2006-05-01T09:30:00-04:00,57.55,58.63,57.42999,58.08,19595808,22185350.8,58.18983427097731,61.120661015008054,NaN,NaN,58.78325439764778,45.629978767526204,-0.12114749728783858,0.8942009688646735,1.015348466152512,120830421,117558654.6,39.28936196625223,69.58757873669767,NaN,NaN,18.523933661195528,21.14950459268785
2006-05-02T09:30:00-04:00,58.73,59.44,58.37,59.37,19041504,22218006,63.12086946937302,61.395551354515995,NaN,NaN,103.56696738375987,46.66859525268083,-0.027481981260981003,0.9809959895762859,1.0084779708372669,139871925,114235576.2,38.37125514667947,66.71776254599814,NaN,NaN,19.83888033542601,20.96227255593616
2006-05-03T09:30:00-04:00,59.14,59.36,58.00999,58.45,25784800,22818440.9,57.878182818254025,61.483164983670086,NaN,NaN,71.26353211149116,49.196935428347196,-0.035239951419291926,0.9644280315631519,0.9996679829824439,114087125,111640958.6,37.63183531886057,63.94226194494737,NaN,NaN,19.170478687882767,20.706302003357102
2006-05-04T09:30:00-04:00,57.95,58.72,57.13,58.17999,27810400,23188220.9,56.39764799698162,61.39492286880197,NaN,NaN,32.24394631909491,58.36159172519164,-0.06460034992145391,0.9189175455806264,0.9835178955020804,86276725,112460161.8,38.037824729738155,61.45208294374036,NaN,NaN,18.169504598998618,20.343902374163033
2006-05-05T09:30:00-04:00,58.88,59.14999,58.38,58.86,15718398,22910545.6,59.22644907072993,61.138211635476566,NaN,NaN,73.26606994904544,67.82475403220784,-0.04518631715087473,0.927034999063487,0.9722213162143617,101995123,112612263.8,38.11837026149152,58.91719878865485,NaN,NaN,18.220946916598272,20.040623023082354
2006-05-08T09:30:00-04:00,58.12,58.71001,57.60001,58.60001,17092800,22680500.8,57.685510728282814,60.37025805880689,NaN,NaN,38.69489817665237,63.807082788008756,-0.056104746685868956,0.9020903828570255,0.9581951295428944,84902323,105426644.2,35.753806325597566,56.11446002055182,NaN,NaN,17.79904984642821,19.720398283560332
2006-05-09T09:30:00-04:00,58.39999,59.25,58.34,58.95,13166602,22474421.3,59.223533721939255,59.49731666687703,NaN,NaN,70.951450830512,57.28397947735918,-0.04640724119645434,0.9001860780473265,0.9465933192437809,98068925,97066044.2,33.17518264533737,52.9007254929639,NaN,NaN,17.897870216699218,19.4600371311516
2006-05-10T09:30:00-04:00,58.77,59.50999,58.57001,59.5,20595392,22814390.9,61.58645805900827,59.1250393280405,NaN,NaN,91.45303838480338,61.321880732021626,-0.011426483862822412,0.9323102144152529,0.9437366982780753,118664317,97981482.6,33.738693185392734,49.56644517182681,NaN,NaN,18.66936710662927,19.347084270505555
2006-05-11T09:30:00-04:00,60.00999,60.14999,58.55,58.73,21775904,23085666.2,56.63809469450773,58.107927087488854,NaN,NaN,83.6482982948143,71.6027511271655,-0.04664569616485503,0.8854295780720065,0.9320752742368615,96888413,100103820.2,35.10499165397806,46.170562938547114,NaN,NaN,17.880217775899148,19.13753191413321
2006-05-12T09:30:00-04:00,58.55,58.55,56.67,56.74001,35139696,24272431.1,46.28711765948619,56.806238082888605,NaN,NaN,-94.44072014247936,38.06139310886054,-0.20176923683315207,0.6798637281954214,0.8816329650285735,61748717,92054539,32.37812098227333,42.53779010027605,NaN,NaN,13.693198154209178,18.359769948429776
2006-05-15T09:30:00-04:00,55.63,56.5,54.92999,55.55,29083296,25040790.8,41.41302215363313,55.50085039206972,NaN,NaN,-235.5156887822189,-16.780724282913717,-0.3724019276519138,0.41613055546368116,0.788532483115595,32665421,81607158.6,29.206968396275045,39.200397186610644,NaN,NaN,8.465547976436262,16.946309666716417
2006-05-16T09:30:00-04:00,55.89999,56.52,55.2426,55.75,20602496,24609695.6,42.50874261653972,54.652322259473536,NaN,NaN,-178.66726209055508,-66.70446686712714,-0.4542546355074758,0.22071418873125026,0.6749688242387261,53267917,72646957,26.784060160419713,36.61495962433177,NaN,NaN,4.700591886731571,15.196921412432868
2006-05-17T09:30:00-04:00,55.25,55.91,53.92,54.33,36464704,25219690.8,37.190440219300385,53.66977556266075,NaN,NaN,-206.2524722586676,-126.24556899582133,-0.5785201929788465,-0.048181416984832026,0.5303387759940145,16803213,52274736.2,22.26214188983566,34.51192696334508,NaN,NaN,-0.39012211888117626,12.970200907959434
2006-05-18T09:30:00-04:00,54.36,54.95,53.60001,53.67,24759392,25144395.6,34.998710072933676,52.310329539424814,NaN,NaN,-192.9349374419929,-181.56221614318275,-0.6730351080103874,-0.3109551090189697,0.36207999899141763,-7956179,31305817.8,18.752738216484005,32.75752506275822,NaN,NaN,-5.2693489567261835,10.364550927290061
2006-05-19T09:30:00-04:00,53.38,54.45,52.59,54.02,40303808,26179355.6,37.11517186479962,50.804996510412124,NaN,NaN,-174.23847796899872,-197.52176770848664,-0.6779584450939229,-0.485368057375986,0.1925903877179369,32347629,25425600.2,17.90055134580068,31.22975287558311,NaN,NaN,-8.549961528158715,7.662477719368807
2006-05-22T09:30:00-04:00,53.10001,54.14,52.25,53.71001,37540000,26583590.8,35.99722339993403,48.86759321973791,NaN,NaN,-155.67761455738074,-181.55415286351902,-0.667043242841352,-0.641213665833753,0.025829577007598914,-5192371,17854041.8,16.839409207739223,29.691763879944524,NaN,NaN,-11.563827168808064,4.91586273534354
2006-05-23T09:30:00-04:00,54.71001,55.39999,53.5,53.72,29176000,26350575.6,36.06406053817569,47.30944162830374,NaN,NaN,-104.20200088221867,-166.66110062185174,-0.6248322413672156,-0.7552107247014206,-0.130378483334205,23983629,11997184.2,16.046972937529546,28.149987995563738,NaN,NaN,-13.979145564570967,2.2165758353557528
2006-05-24T09:30:00-04:00,53.10001,54.14999,52.14999,53.06,38276400,26793040.4,33.5698582707757,45.678885219289036,NaN,NaN,-124.75311093383026,-150.36122835688428,-0.6065514872015854,-0.8885678423361867,-0.2820163551346013,-14292771,5777987.4,15.227525416445928,26.52068090175715,NaN,NaN,-16.79135428921063,-0.4988427538680158
2006-05-25T09:30:00-04:00,53.78999,55.11,53.50999,54.92,32248000,26161465.2,45.09448148832662,44.66945896340309,NaN,NaN,-68.78971310279233,-125.53218348904413,-0.4420250894312744,-0.8345477169236943,-0.39252262749241995,17955229,10960269,18.941982911205713,25.150938948165308,NaN,NaN,-15.810600551557878,-2.6862367249665673
2006-05-26T09:30:00-04:00,54.89,55.32001,54.61,55.10001,14383301,25927935.05,46.06961360293849,43.8397520258785,NaN,NaN,-47.52243834419058,-100.18897556408251,-0.30066507358233024,-0.7683539694703327,-0.4676888958880025,32338530,10958449.2,18.941669043876374,23.95007199947094,NaN,NaN,-14.7267337943922,-4.406307734884514
2006-05-30T09:30:00-04:00,55.60001,55.89999,54.17,54.23,19404608,25918375.05,42.1713002139076,42.621735346733374,NaN,NaN,-50.32593724349565,-79.11864010130552,-0.24756016957229032,-0.7771391078533654,-0.529578938281075,12933922,14583707.8,21.72425070979729,23.1321482897895,NaN,NaN,-14.970205813506851,-5.915436031830562
2006-05-31T09:30:00-04:00,54.03999,55.55,54.02,55.55,19921104,25962355.05,49.19552665545813,41.73666881790837,NaN,NaN,-36.93572173365205,-65.66538427159217,-0.1122301450570844,-0.6698666196024305,-0.5576364745453462,32855026,16357987.2,23.115348354615023,22.373337944733947,NaN,NaN,-12.920138719197261,-6.916107844311519
2006-06-01T09:30:00-04:00,55,55.99001,54.61,55.7,19853904,25665810.25,49.93966019629533,41.2582092108932,NaN,NaN,-19.280796283812112,-44.57092134158856,-0.006868102946135601,-0.5662216032280156,-0.55935350028188,52708930,29758327.4,32.82525208996711,22.210499404447454,NaN,NaN,-11.05648923302022,-7.5075908998413325
2006-06-02T09:30:00-04:00,56.25,56.63,55.59,56.53,17686304,25159605.45,53.95823798011981,41.80614637665274,NaN,NaN,15.300045704618194,-27.752969580106463,0.1175990012120397,-0.4123547487668304,-0.5299537499788701,70395234,40246328.4,39.287921679483574,22.704056597105332,NaN,NaN,-8.2120070133939,-7.608221773205985
2006-06-05T09:30:00-04:00,57.16,57.17999,54.71001,54.75,36699104,26208640.75,45.5190875739557,42.09943676381863,NaN,NaN,-6.906953151452593,-19.629872541558864,0.08068388238705004,-0.42909889699505754,-0.5097827793821076,33696130,40517848.4,39.45033119382858,23.435725368359154,NaN,NaN,-8.377837427569297,-7.718166866686458
2006-06-06T09:30:00-04:00,54.64,55.36,54.19,54.7,24921696,26600085.55,45.30473964471412,42.29915083725966,NaN,NaN,-37.94071812768293,-17.152828718396318,0.054773327733500465,-0.441316119715232,-0.49608944744873246,8774434,39685950.8,39.10516896548352,24.315804568720853,NaN,NaN,-8.573721172537867,-7.840388910379517
2006-06-07T09:30:00-04:00,54.32001,54.59,52.60001,52.60001,46408000,28262155.45,37.349663465379194,42.3105239262653,NaN,NaN,-106.33865138337777,-31.03341464834146,-0.09383191734411245,-0.6133793441288731,-0.5195474267847606,-37633566,25588232.4,33.72080736734809,25.134280674257457,NaN,NaN,-11.467240920827505,-8.3585106261578
2006-06-08T09:30:00-04:00,52.22,53.45,50.95,53.34,75385504,31001661.05,41.263494868822505,42.758008554543075,NaN,NaN,-141.32986329880174,-55.44322805133938,-0.13009493407411765,-0.6821660943774077,-0.5520711603032901,37751938,22596834,32.69218926057334,26.12995574883527,NaN,NaN,-12.515874962241389,-8.952419817026884
2006-06-09T09:30:00-04:00,53.81,53.81,52.31,52.8,31437008,31484716.25,39.33249267083102,42.91638861211675,NaN,NaN,-112.55553323656724,-81.01434383957647,-0.17543251008741723,-0.7713617979125615,-0.5959292878251443,6314930,9780773.2,28.658726318249336,26.898396818295886,NaN,NaN,-13.984215102033051,-9.671247714884908
2006-06-12T09:30:00-04:00,53.12,53.44,51.64,51.72,21739008,30814681.85,35.73104463967563,42.89737584352686,NaN,NaN,-144.2643689527381,-108.48582699983356,-0.2581428656893413,-0.918607869936821,-0.6604650042474797,-15424078,-43268.4,26.009680880322193,27.553416223480383,NaN,NaN,-16.404310436687386,-10.633113817999547
2006-06-13T09:30:00-04:00,51.05,51.86,50.00999,50.19,37585600,31239797.05,31.35143445588014,42.56075969479146,NaN,NaN,-208.58115864620734,-142.61391510353843,-0.38807153090343527,-1.1455544178767738,-0.7574828869733385,-53009678,-12400090.8,23.115432247699857,28.058306174206837,NaN,NaN,-19.994890746821785,-11.97051052211701
2006-06-14T09:30:00-04:00,50.38,51.58,50.2,51.48,39586192,32188981.85,38.22647253478256,42.89337499936338,NaN,NaN,-157.44121553596182,-152.83442793405524,-0.35993433700076893,-1.2074008082242997,-0.8474664712235308,-13423486,-7558074.8,26.563811623872738,28.86804090330875,NaN,NaN,-20.674243081215042,-13.213900887702444
2006-06-15T09:30:00-04:00,52.12,53.78,52.03999,53.44,38283296,32279911.45,46.92394944810644,43.02405128220479,NaN,NaN,-39.68587342065676,-132.50562995842625,-0.1906213251280714,-1.08574312763362,-0.8951218025055486,24859810,-10136500.4,25.89769534517484,29.364877505735116,NaN,NaN,-18.144082432327178,-13.918212536934549
2006-06-16T09:30:00-04:00,53.05,53.47,52.12,53.10001,29671600,32525521.85,45.721394023166155,42.9991784550782,NaN,NaN,-46.185698980090386,-119.23166310713088,-0.08804323748600007,-1.0051758493630487,-0.9171326118770486,-4811790,-12361844.4,25.307844711566744,29.81960433914157,NaN,NaN,-16.587656234625875,-14.299561636604738
2006-06-19T09:30:00-04:00,52.89999,52.89999,51.03999,51.10001,46718496,32846256.25,39.33522109107176,42.79660137487564,NaN,NaN,-100.72429291879409,-110.52364790034207,-0.13840791210422088,-1.0901425020073248,-0.9517345899031039,-51530286,-19583086,23.442001981525294,29.942300858550713,NaN,NaN,-17.461017788217227,-14.751198229692235
2006-06-20T09:30:00-04:00,51.63,52.07001,50.73,50.86,22317696,32085141.05,38.63776443011424,42.042475501636794,NaN,NaN,-110.67629162701,-90.94267449650262,-0.16936003787516285,-1.1634346372470574,-0.9940745993718946,-73847982,-23750746.8,22.414881263324318,29.892267494887097,NaN,NaN,-18.364846927526376,-15.267433757954256
2006-06-21T09:30:00-04:00,51.03,52.62,50.99001,52,39253504,32589016.25,43.7403775553506,41.599669598712175,NaN,NaN,-72.46566462969432,-73.94756431524911,-0.09806717250398056,-1.1166585650018703,-1.0185913924978898,-34594478,-27984945.2,21.38948745409948,29.07542716375369,NaN,NaN,-17.44557518300766,-15.578596818676171
2006-06-22T09:30:00-04:00,52,52.5,51.59,52.22,17693392,31559865.85,44.69613884053972,40.93809108874217,NaN,NaN,-57.36903547893879,-77.48419672690554,-0.02491515309735015,-1.0497353338695774,-1.0248201807722273,-16901086,-36337124.4,19.495003825637212,27.66164731705038,NaN,NaN,-16.42043053502692,-15.69885877815485
2006-06-23T09:30:00-04:00,53.28999,53.75,53.2,53.38,26866096,31290770.65,49.561701201941695,41.22684920502689,NaN,NaN,7.007215027205094,-66.84561392544643,0.10561278896795145,-0.892804194562288,-0.9984169835302394,9965010,-33381764.4,22.123411154876294,26.424010171410934,NaN,NaN,-14.00786542875261,-15.457288299668816
2006-06-26T09:30:00-04:00,53.3,54.0399,52.88,53.97,16526602,31397935.7,51.88057301971984,41.69655158895586,NaN,NaN,20.476670263294505,-42.6054212890287,0.228643576103717,-0.7126125134005932,-0.9412560895043102,26491612,-17777384.8,34.31728578968354,26.082018515996648,NaN,NaN,-11.305993357622338,-14.864246165090748
2006-06-27T09:30:00-04:00,54.33,54.78,53.96001,54.07001,24147392,31635074.9,52.28105524238604,42.76307957302778,NaN,NaN,55.563948284545845,-9.357373306717529,0.30873467255948084,-0.5553377488049591,-0.86407242136444,50639004,7120012.4,48.24245796339058,27.119279272856826,NaN,NaN,-9.011449395984888,-14.028132340932768
2006-06-28T09:30:00-04:00,54.23,55.13,54.2,55,22124000,31745219.7,55.95223934915044,43.81227560733692,NaN,NaN,83.60139069381876,21.856037757985085,0.40997721100261475,-0.35160090761117146,-0.7615781186137862,72763004,28591508.8,56.756951718975394,28.838190877028403,NaN,NaN,-5.933876484518221,-12.87181007573069
2006-06-29T09:30:00-04:00,55.34,56.58,55.34,56.56,30392704,32272159.7,61.32694643723536,45.38330801922295,NaN,NaN,149.8686018666825,63.303565227109345,0.5584411077393858,-0.06352673393955399,-0.6219678416789398,103155708,52602867.6,63.90752635532779,31.35596230824829,NaN,NaN,-1.4834521517877537,-11.2449018008817
2006-06-30T09:30:00-04:00,56.78,57.09,56.25999,56.75,11346602,31955174.6,61.936143002225236,47.25510075940507,NaN,NaN,173.02900518468263,96.50792325860485,0.64001671455721,0.17805305151757267,-0.4619636630396373,114502310,73510327.6,68.75267116717708,34.40903304302364,NaN,NaN,2.2935553055550084,-9.31083649996217
2006-07-03T09:30:00-04:00,57.05,57.53,56.88,57.36,3831000,30311769.4,63.902176511223374,49.58015376335816,NaN,NaN,182.74340626183053,128.96127045831207,0.7007364002375404,0.41395683725728816,-0.2867795629802522,118333310,91878667.2,72.27417309382298,37.92037167488958,NaN,NaN,6.066735886025314,-7.1140404448211
2006-07-05T09:30:00-04:00,57.03,57.75999,56.39999,57.62,16414898,29886429.5,64.73818555326402,51.473847550392556,NaN,NaN,160.01436586601866,149.85135397460664,0.7212676700006131,0.6148050245205141,-0.10646264548009893,134748208,108700508,75.04759387106628,41.38349897826055,NaN,NaN,9.43296913316759,-4.750181933679858
2006-07-06T09:30:00-04:00,57.55,58.05991,57.25999,57.47,16848608,28408459.9,63.81987723855405,52.68069953542452,NaN,NaN,142.94341762357388,161.71975936055765,0.6877241790758309,0.7531925783646898,0.06546839928885884,117899600,117727827.2,76.41125379944324,44.99161029642257,NaN,NaN,11.987504957006996,-2.3590838064388797
2006-07-07T09:30:00-04:00,57.7,58.21001,56.50999,56.69,19687296,25623549.5,59.12336794477742,53.63798338696819,NaN,NaN,108.17310704324798,153.38066039587073,0.5802734902548268,0.7908102621073922,0.21053677185256553,98212304,116739146.4,75.92187790335834,48.60689838155054,NaN,NaN,12.954877500250012,-0.17137504834046657
2006-07-10T09:30:00-04:00,56.72,57.44,56.44,56.86,14627199,24783059.05,59.81742627940866,55.10099804327796,NaN,NaN,88.60746091909779,136.49635154275376,0.491436164239907,0.8248319771524493,0.3333958129125423,112839503,116406585,75.74614777656997,52.34290879548231,NaN,NaN,13.950654737685758,1.8460577782347083
2006-07-11T09:30:00-04:00,57.05,58.06,57.00999,57.89999,12987500,24345483.65,63.86013389492895,56.9025958621933,NaN,NaN,99.04102792566195,119.75587587552006,0.47332297977661125,0.9250495376333063,0.4517265578566951,125827003,117905323.6,76.01557859055566,56.171530033141686,NaN,NaN,15.983306599989506,3.865664752771108
2006-07-12T09:30:00-04:00,58.14,58.24001,57.44,57.7,15130199,23222713.6,62.55674938189331,58.24662242123207,NaN,NaN,93.00200048125971,106.35340279856828,0.42027641454881737,0.9770720760427167,0.5567956614938994,110696804,113095042.8,73.20474591604066,59.87261992328035,NaN,NaN,17.332641648320767,5.789518594992487
2006-07-13T09:30:00-04:00,57.95,58.07001,57.05,57.14999,18516304,22169219.2,58.99080904398891,59.267670292907006,NaN,NaN,73.92579870668325,92.54987901519016,0.3248197179830197,0.9628203089726739,0.6380005909896542,92180500,107951222.8,70.2148149536987,63.49546357528474,NaN,NaN,17.534299727295206,7.467344471035733
2006-07-14T09:30:00-04:00,57.60001,57.92,56.56,57.82001,17629008,21136504.8,61.844206398334244,60.14499209264933,NaN,NaN,67.48809959478059,84.41287752549667,0.2849043050299438,0.9941309722770839,0.7092266672471401,109809508,110270663.6,70.79407699699529,66.97193970686466,NaN,NaN,18.495715588285375,9.042826059214253
2006-07-17T09:30:00-04:00,57.22,57.50999,55.66,55.95,32432096,21274529.6,51.14757671146523,60.09263521348829,NaN,NaN,30.542188898137855,72.79982312130468,0.11914538936778474,0.858158403956871,0.7390130145890863,77377412,103178245.4,66.53310861759368,69.27306990885825,NaN,NaN,16.083377948878127,10.048619186309091
2006-07-18T09:30:00-04:00,56.45,56.7,55.25999,56.02,18979296,19887569.6,51.485840296993416,60.035834145960244,NaN,NaN,12.530352777473862,55.49768809166708,0.006734910003886041,0.7474316520939439,0.7406967420900579,96356708,97284186.4,63.132406749135214,70.33663767926858,NaN,NaN,14.24512987783388,10.648120713669776
2006-07-19T09:30:00-04:00,55.84,56.8,55.64,56.60001,22578192,19900594.4,54.30891721585134,59.91845399358174,NaN,NaN,19.10562299576351,40.71841259456782,-0.03381276344003881,0.6984307877900093,0.7322435512300481,118934900,98931805.6,63.691096782273085,70.83193375521842,NaN,NaN,13.491836435230567,11.05436581674989
2006-07-20T09:30:00-04:00,56.75,56.78999,55.23,55.23,18935296,18884684,47.30650040038827,58.91699356237838,NaN,NaN,-18.35979089816875,22.261294673597426,-0.15156130097366216,0.5427919250129705,0.6943532259866326,99999604,100495626.4,64.24492948907987,70.85603397905787,NaN,NaN,10.615658606192383,10.991693358098818
2006-07-21T09:30:00-04:00,55.50999,55.50999,54.25,54.48,30416896,19520859.2,43.964538156434266,57.63330750196474,NaN,NaN,-89.31747139260754,-9.099819523880214,-0.27161224297548836,0.3548379222672722,0.6264501652427605,69582708,92450266.4,59.23866370753282,70.1764620176547,NaN,NaN,7.132592709352541,10.440393265420779
2006-07-24T09:30:00-04:00,54.5,56.22,54.5,56.12,22568496,19305979.2,51.956961072397874,56.780077827762916,NaN,NaN,-49.5753213262145,-25.12332156875069,-0.2336697429710075,0.3343629865290012,0.5680327295000087,92151204,95405024.8,60.457377406412064,69.33240518283965,NaN,NaN,6.612984312539321,9.893620557866285
2006-07-25T09:30:00-04:00,56.50999,57.19,56.14,57.10001,19038896,19431593.9,55.99600818055741,56.1556365868553,NaN,NaN,24.348031580210886,-22.759785808203283,-0.14027546223809773,0.3926884017023866,0.5329638639404843,111190100,98371703.2,61.6957005245784,68.37869851523337,NaN,NaN,7.514515572572075,9.553748417109968
2006-07-26T09:30:00-04:00,56.75999,58.57001,56.67999,58.25,19654704,19206959.5,60.22209657682471,55.89865225387464,NaN,NaN,100.37123367830041,-6.506663671695901,-0.005853519497893145,0.5256469645681179,0.531500484066011,130844804,100753684,62.705569343358604,67.39972105408447,NaN,NaN,9.695177316374695,9.573952545576358
2006-07-27T09:30:00-04:00,58.91,58.98,57.61,57.75,17333008,18967409.9,57.630545025586756,55.79202204536102,NaN,NaN,118.77537629075916,20.920369766089685,0.04195198082289031,0.5839404600946239,0.5419884792717335,113511796,103456122.4,63.86941311025619,66.53883071172002,NaN,NaN,10.617510948818857,9.723032317468144
2006-07-28T09:30:00-04:00,57.44,57.92999,56.86,57.77,14726301,18184089.75,57.70894162230813,55.641415998425266,NaN,NaN,57.97037450941976,50.37793894649515,0.06605149788773856,0.6245528516314067,0.5585013537436682,128238097,115187200.2,68.46933658832525,66.01905848398826,NaN,NaN,11.368787786156616,9.958140241566497
2006-07-31T09:30:00-04:00,58.2,58.95,57.75999,58.64999,15538801,18393699.7,61.117934433722226,55.44554460833907,NaN,NaN,129.72717051861866,86.23843731546178,0.12876123538389705,0.7194528979735395,0.5906916625896425,143776898,125512339,71.86458519902685,65.72255895602191,NaN,NaN,13.055094780935702,10.40056231861924
2006-08-01T09:30:00-04:00,58.53999,58.87,57.99001,58.72,11043000,18754299.7,61.384623267193355,55.361821314431936,NaN,NaN,122.28242641463426,105.82531628234646,0.16039925873947058,0.7911907360139807,0.6307914772745101,154819898,134238298.6,74.37583637602306,65.80620827459208,NaN,NaN,14.493271413780109,10.985235046499364
2006-08-02T09:30:00-04:00,59.36,59.88,58.42999,58.84,17779104,18822510,61.86741256017978,55.56729299415986,NaN,NaN,145.20524259450434,114.79211806558723,0.17372827882533948,0.8479518258061844,0.674223546980845,172599002,142589138.2,76.53442397616122,66.2576089190537,NaN,NaN,15.813662467469856,11.675010392352291
2006-08-03T09:30:00-04:00,58,58.95,57.95,58.33,11710500,18565604.6,58.518789226830926,55.32976319619534,NaN,NaN,89.31608104555875,108.90025901654717,0.13428175101384676,0.8420757357481534,0.7077939847343067,160888502,152064479.4,78.72445410773653,66.82406442696377,NaN,NaN,16.032563468916297,12.297517974718579
2006-08-04T09:30:00-04:00,58.5,58.83,57.33,57.84,16829696,18422724.6,55.415338032337516,55.63460329054335,NaN,NaN,54.289030588010796,108.16399023226536,0.06479468238611796,0.7887873377169541,0.7239926553308361,144058806,155228621.2,79.41534309053084,67.74422403217358,NaN,NaN,15.363234291686226,12.7354774485711
2006-08-07T09:30:00-04:00,58.25999,58.8,57.8,58.45,19058096,18644269.45,58.37487377876434,56.126677110669846,NaN,NaN,72.72245182716705,96.76304649397505,0.05017316172781794,0.7867091074906085,0.7365359457627906,163116902,159096622,80.25927229086383,68.96757157086849,NaN,NaN,15.598630040619266,13.144499247435123
2006-08-08T09:30:00-04:00,58.35001,58.83,58.03,58.11,20301808,19009984.85,56.13806273362378,56.2573303619393,NaN,NaN,66.89074771368809,85.68471075378582,0.00996565247693737,0.7489930113589622,0.7390273588820249,142815094,156695661.2,78.11836086146414,69.99809043366784,NaN,NaN,15.182804647001616,13.435685733087478
2006-08-09T09:30:00-04:00,58.7,59.35001,58.46001,58.60001,18526608,19179805.3,58.600200187105216,57.06402320384766,NaN,NaN,92.84262965598401,75.21218816608175,0.008775670741347441,0.7499969473087091,0.7412212765673617,161341702,154444201.2,76.06919940707701,70.84268114209621,NaN,NaN,15.497327009960642,13.73020591549793
2006-08-10T09:30:00-04:00,58.25999,58.39999,57.64999,58.12,17835392,19145759.7,55.324016719505124,57.87541452978129,NaN,NaN,40.68877116492557,65.4867261899551,-0.02982091161900613,0.7039451370436041,0.7337660486626102,143506310,150967762.8,72.88980202122367,71.81776245021697,NaN,NaN,14.863191590559707,13.892061011935326
2006-08-11T09:30:00-04:00,58.05,58.32001,57.67,58.14999,8161301,18672374.35,55.49144294778985,58.127877520880716,NaN,NaN,37.29430619083256,62.087781310519475,-0.05722495350279444,0.6622348567841172,0.7194598102869116,151667611,152489523.8,73.41363344821154,72.74320931034552,NaN,NaN,14.38052596592179,13.961841719647678
2006-08-14T09:30:00-04:00,57.72,57.72,55.86,56.95,16721699,17886854.5,47.7762425760844,57.5407514062755,NaN,NaN,-41.36388283344378,39.270514378397294,-0.15454118559083396,0.5262833282983692,0.6808245138892032,134945912,146855325.8,68.16225688620554,73.20510619331888,NaN,NaN,11.687696061914979,13.636963768543007
2006-08-15T09:30:00-04:00,57.45,57.67999,56.75999,57.24001,16599398,17767859.6,49.600018987486706,56.78203157846565,NaN,NaN,-22.134051995013177,21.46555443665705,-0.19513499667043888,0.43690576805115455,0.6320407647215934,151545310,148601369,68.90459243556299,73.64789355704777,NaN,NaN,9.9319086160194,13.10767017532535
2006-08-16T09:30:00-04:00,57.03999,57.89999,56.59,57,22339600,17755930,48.10283491655298,56.1014808563918,NaN,NaN,-31.072350893807787,-3.3174416733013103,-0.23142818455045733,0.34275553403352177,0.5741837185839791,129205710,142174170.6,63.07465034158711,73.59112478785711,NaN,NaN,8.034835610376453,12.382979523189793
2006-08-17T09:30:00-04:00,56.44,56.73,56.13,56.60001,34993600,18558845.2,45.630792885706306,55.23875594663453,NaN,NaN,-88.37424711859748,-29.13004533000592,-0.27280535445741916,0.2331770255122052,0.5059823799696244,94212110,132315330.6,55.33994784385279,72.65331130610909,NaN,NaN,5.708504255838235,11.429483056425283
2006-08-18T09:30:00-04:00,57,57.5,56.3,57.48,13639801,17719990.45,51.53215392302473,54.55405733872757,NaN,NaN,-60.083460128661656,-48.60559859390476,-0.23289289426772458,0.21486626213496862,0.4477591564026932,107851911,123552190.6,49.526365411190504,71.05772417840649,NaN,NaN,5.293473668381001,10.552910286704671
2006-08-21T09:30:00-04:00,57.94,58.12,57.63,57.86,12368500,17209990.65,53.86108739840602,54.016661919528474,NaN,NaN,2.4074665740983203,-39.85132871239634,-0.1754993296074106,0.22838499439342996,0.40388432400084057,120220411,120607090.4,47.71226978857183,69.15318370787426,NaN,NaN,5.609442694389423,9.846700630659637
2006-08-22T09:30:00-04:00,57.8,58.25,57.71001,58.25,6958898,16605990.75,56.187908751520354,53.61098307605279,NaN,NaN,20.028336480750458,-31.41885101724361,-0.10911943771783295,0.26748502685354936,0.3766044645713823,127179309,115733890.2,44.78884173120858,66.88564211894908,NaN,NaN,6.544090578758118,9.374899194673706
2006-08-23T09:30:00-04:00,57.98,58.14,56.97,57.03,12151801,16230845.6,48.02824423388276,52.861658433699354,NaN,NaN,-61.38756558691323,-37.4818939558647,-0.14308456711075024,0.19774875568294448,0.3408333227936947,115027508,112898249.8,43.132725476562655,64.34337578815094,NaN,NaN,4.901853792899934,8.735892708706023
2006-08-24T09:30:00-04:00,57.2,57.88,56.96001,57.77,10852301,15906810.25,52.5311676067599,52.65564626044381,NaN,NaN,-38.31850886023151,-27.470746304191504,-0.11275476387583216,0.1998898679489045,0.3126446318247367,125879809,119231789.6,47.777441490434455,62.08352567385834,NaN,NaN,4.897665013140162,8.187574466482328
2006-08-25T09:30:00-04:00,58.3,58.75,58.06,58.22,13189398,15829965.1,55.079950653604364,52.420294608646664,NaN,NaN,52.45447347584931,-4.963159583289313,-0.06196621246512385,0.23518686624333185,0.2971530787084557,139069207,125475248.8,51.944267886229895,60.061025359241626,NaN,NaN,5.6809622130719175,7.8294870017094125
2006-08-28T09:30:00-04:00,57.5,57.85001,57.27,57.38,17593200,15932685.05,49.713912908290744,51.96142676398002,NaN,NaN,-42.12746930134712,-13.8701467583784,-0.08320048663080198,0.1931524704199532,0.2763529570507552,121476007,125726368,52.10978137979292,58.2032696819794,NaN,NaN,4.673391757016926,7.378616252467629
2006-08-29T09:30:00-04:00,57.08,57.08,56.45,57.02,13488500,16054960.05,47.574746540166714,51.17389436062728,NaN,NaN,-104.83546126836553,-38.8429063082016,-0.1176420274427819,0.12930042274727782,0.24694245019005973,107987507,121888007.6,49.31396500255879,56.2921815102281,NaN,NaN,3.187130262165376,6.779832539567307
2006-08-30T09:30:00-04:00,56.81,57.03,55.57001,56.06,19990704,16165540.05,42.34241070912755,50.24663678845745,NaN,NaN,-156.8668151447692,-57.9387562197728,-0.19657861295359394,0.001219183998067308,0.19779779695166125,87996803,116481866.6,45.602824178239445,54.34311166430065,NaN,NaN,0.20951125363191472,5.841215213005109
2006-08-31T09:30:00-04:00,55.98,56.3,55.53999,55.67,10966500,16128340.05,40.39855930524122,49.16857367113254,NaN,NaN,-173.26407612643794,-84.92786967301409,-0.2624417334216273,-0.13025436982537286,0.13218736359625444,77030303,106711965.4,39.77700409110321,51.94049528165006,NaN,NaN,-2.8448317822450417,4.600351356540802
2006-09-01T09:30:00-04:00,56,56.5,55.81,56.5,8748500,15724280.25,46.072631761502734,49.046887184376715,NaN,NaN,-112.68776461226615,-117.95631729063719,-0.23820229801284182,-0.16556550891979782,0.07263678909304398,85778803,96053884.6,34.586126634015116,49.54220026363646,NaN,NaN,-3.7005550577599364,3.414507583069268
2006-09-05T09:30:00-04:00,56.3,57.27,56.24001,57.24001,16610199,15601885.4,50.58915815469891,49.11753998203473,NaN,NaN,-43.52807851269708,-118.23643913290718,-0.16395903776135978,-0.13231200810865573,0.03164702965270404,102389002,92236483.6,32.92861847593706,46.97248783794889,NaN,NaN,-2.986316189811734,2.5001041869434104
2006-09-06T09:30:00-04:00,56.63,56.7,55.24001,55.3,17227008,15448145.4,40.914716032310054,48.60410291887452,NaN,NaN,-145.83102933864134,-126.43555274696234,-0.23292522278914676,-0.2595094988337294,-0.02658427604458266,85161994,87671381,31.014428766829894,44.682472011180515,NaN,NaN,-5.740447214947142,1.322882558101903
2006-09-07T09:30:00-04:00,55,55.59,54.75,55.35001,25232800,15783455,41.226738480071745,48.28952760418634,NaN,NaN,-174.10464151502447,-129.8831180210134,-0.26050768126051893,-0.3522188776202313,-0.09171119635971238,110394794,92150979.2,35.00698769817488,43.230117715060665,NaN,NaN,-7.742036649981301,0.027894099804302463
2006-09-08T09:30:00-04:00,55.11,55.56,53.95,53.95,16800800,15731725.4,35.56456715121145,47.14898569191396,NaN,NaN,-204.26062921070314,-136.08242863786646,-0.35264884279942393,-0.5325222498589923,-0.1798734070595684,93593994,95463717.4,37.87065514118601,42.39756698148892,NaN,NaN,-11.460883450082555,-1.6133598358938201
2006-09-11T09:30:00-04:00,53.28999,53.45,52.13,52.28,44412192,17544269.95,30.230908231811284,45.461115751442904,NaN,NaN,-270.26394510817977,-167.59766473704917,-0.49685032977508753,-0.8009363192784278,-0.30408598950334026,49181802,88144317.2,34.277034577609584,41.437907323563046,NaN,NaN,-16.662423413145568,-3.763226061215498
2006-09-12T09:30:00-04:00,52.38,52.84,51.66,51.95,25096800,17963025,29.295939067092903,43.5402607739838,NaN,NaN,-228.77404269448184,-204.64685757340612,-0.5794748480097738,-1.0284295495155575,-0.4489547015057837,24085002,72483517.2,28.1270187051404,40.24777710741531,NaN,NaN,-20.99856773286933,-6.225417728594616
2006-09-13T09:30:00-04:00,52.39999,53.37,52.37,53.03,22531392,18259624.7,36.24541442281209,42.698630073193044,NaN,NaN,-153.47607471317733,-206.17586664831333,-0.5278691550280996,-1.1087911452909083,-0.5809219902628087,46616394,64774397.2,25.68408008417323,39.001445293673214,NaN,NaN,-22.23505352500032,-8.512508556652573
2006-09-14T09:30:00-04:00,53,53.31,51.69,51.85001,30635696,18674429.5,32.488148939115774,41.26698588264703,NaN,NaN,-151.74064216022052,-201.70306677735252,-0.5378599832978239,-1.2532469693850885,-0.7153869860872646,15980698,45891578,20.896562196636168,37.08138248697333,NaN,NaN,-24.57222992443667,-10.806754466336015
2006-09-15T09:30:00-04:00,51.88,52.11,51.42,51.85001,30574192,18453459.1,32.488148939115774,39.65328576018356,NaN,NaN,-142.22935144934743,-189.29681122508137,-0.5094044852100206,-1.3521425925997903,-0.8427381073897697,15980698,30368918.8,17.936691705357163,34.65226990262528,NaN,NaN,-26.361381273194763,-13.028844010172978
2006-09-18T09:30:00-04:00,52.14999,53.37,51.95,53.10001,33317008,19437319.45,40.11488557524711,38.96764095068044,NaN,NaN,-91.30278355278483,-153.5045789140024,-0.3774101431848699,-1.314500786370857,-0.9370906431859872,49297706,30392099.6,17.955381087658665,32.21266988175854,NaN,NaN,-25.382937007032396,-14.793714438295751
2006-09-19T09:30:00-04:00,53.10001,53.36,51.72,52.3,26296400,20133714.45,37.21706840954155,38.22780679849293,NaN,NaN,-91.07352877038917,-125.96447612918386,-0.31740567612410064,-1.3338477383411131,-1.0164420622170125,23001306,30175360.4,17.914300229751603,29.96983668370089,NaN,NaN,-25.511048078786075,-16.32476210122294
2006-09-20T09:30:00-04:00,51.8,52.27,50.75,50.89999,29323808,21251959.95,32.75746612695998,37.54316789976667,NaN,NaN,-113.75097466144814,-118.01945611883802,-0.343235767881513,-1.4454867720689037,-1.1022510041873907,-6322502,19587581.2,15.9897128436738,27.85461444551763,NaN,NaN,-27.12081892621417,-17.867055933364544
2006-09-21T09:30:00-04:00,51.14999,52.09,51.03999,51.55,23830400,21835889.9,36.55849384772698,37.268877509944225,NaN,NaN,-94.53172668738118,-106.57767302427017,-0.2899014511983551,-1.4646278181853347,-1.1747263669869796,17507898,19893021.2,16.269178764624172,26.175484065054842,NaN,NaN,-27.172021664354652,-19.196336752077418
2006-09-22T09:30:00-04:00,51.91,52.03999,50.96001,51.33,24287504,22507650.05,35.82046137965396,36.53657962552645,NaN,NaN,-88.58592625684082,-95.84898798576884,-0.24460555163509623,-1.48048330653085,-1.2358777548957538,-6779606,15340960.4,15.444586063328074,24.808231167148627,NaN,NaN,-27.440445724397932,-20.374066605266062
2006-09-25T09:30:00-04:00,50.7,51.75999,50.17,51.39999,34941904,23595275.35,36.26130880665205,35.51316181495168,NaN,NaN,-91.38640731632157,-95.86571273847619,-0.1876584722343293,-1.4704508451886653,-1.282792372954336,28162298,11113878.8,14.699520837356559,23.50615276439288,NaN,NaN,-27.525706649118465,-21.395729468673547
2006-09-26T09:30:00-04:00,51,52.58,51,52.53,31143600,24272795.35,43.06160623162852,35.666511114903,NaN,NaN,-55.71368273765481,-88.7937435319293,-0.058318207417429324,-1.3556901322261226,-1.2973719248086932,59305898,18374797.2,21.687989215256493,22.839978510709063,NaN,NaN,-25.519557051995427,-21.98484769486239
2006-09-27T09:30:00-04:00,53.14,53.57001,52.28,53.39999,35176096,25357175.15,47.68898031040053,36.12809981706935,NaN,NaN,-13.122460797344553,-68.66804075910858,0.09315552316829168,-1.1809275208483285,-1.2740830440166202,94481994,38535696.4,37.09785951430874,22.989326497575764,NaN,NaN,-22.36100090400176,-22.038583867596586
2006-09-28T09:30:00-04:00,53.39,53.97,53.09,53.23,24248096,25570044.75,46.88715987384815,36.936856440114816,NaN,NaN,6.906447938100817,-48.38040583401218,0.18398016374782133,-1.0441078393318435,-1.2280880030796648,70233898,49080896.4,43.37430498015532,23.382444343216427,NaN,NaN,-20.03491783420047,-21.752345862825713
2006-09-29T09:30:00-04:00,52.89999,53.75,52.77,53.45,16863904,25864914.95,48.10329781069906,38.21345569574966,NaN,NaN,8.699019736173339,-28.923416635409346,0.2564988746435253,-0.9074644097752582,-1.1639632844187835,87097802,67856378,52.46826342122724,24.681817832046267,NaN,NaN,-17.76460010215411,-21.182667897015484
2006-10-02T09:30:00-04:00,53.22,53.82001,52.81,52.84,14947801,26174880,45.024879007677065,39.33695140579139,NaN,NaN,9.529512135255121,-8.74023274509401,0.2601889590131967,-0.8387270856522875,-1.0989160446654842,72150001,76653918.6,56.03143388629412,26.674990344985815,NaN,NaN,-16.665570022994316,-20.537368200726746
2006-10-03T09:30:00-04:00,52,52.17999,50.89999,50.89999,34060800,27047410.05,36.930296362502155,39.385871544340674,NaN,NaN,-94.73131936067108,-16.543760069697274,0.13507399906565465,-0.930073545833416,-1.0651475448990706,38089201,72410579.2,53.9314024045095,28.692656225009834,NaN,NaN,-18.18340195563526,-20.20108730857082
2006-10-04T09:30:00-04:00,51.17999,51.86,50.2,51.64999,37667200,28069419.65,41.322246150110374,40.01687848798315,NaN,NaN,-96.30062746384793,-33.179393402997945,0.10714755853121094,-0.9312130967350569,-1.0383606552662679,75756401,68665460.6,52.07626374585639,30.91977776423985,NaN,NaN,-18.064491687935778,-19.895859362765815
2006-10-05T09:30:00-04:00,52.60001,52.83,52.03,52.64,31421392,28378849.25,46.60765483796047,41.025414623614914,NaN,NaN,13.583961646031279,-31.843890661411855,0.15667361580272043,-0.8425186355128673,-0.9991922513155878,107177793,76054239.6,55.340210873001595,33.59145770478588,NaN,NaN,-16.265418085427022,-19.37722489457456
2006-10-06T09:30:00-04:00,52.2,52.71001,51.75999,52.69,25624608,28820039.65,46.86795636760914,41.50777682306934,NaN,NaN,14.896121089866071,-30.604470390673306,0.19180282740719856,-0.7594387170565895,-0.9512415444637881,132802401,85195159.4,59.055478871385915,36.52717897505212,NaN,NaN,-14.762721447748953,-18.718010116456618
2006-10-09T09:30:00-04:00,53.14,53.24001,51.89,51.89999,20278608,27613360.45,43.27782441060115,41.94068796600218,NaN,NaN,11.99214044936071,-30.111944727852187,0.16202221051539478,-0.7487137813195446,-0.9107359918349394,112523793,93269917.8,62.05820468316601,39.68031500743886,NaN,NaN,-14.555453057476376,-18.12335910803087
2006-10-10T09:30:00-04:00,51.60001,52.99001,51.60001,52.87,26771808,27697110.85,48.494745179812476,43.06477932692021,NaN,NaN,25.527003879737723,-6.060280079770427,0.20506960306295174,-0.6543989880062497,-0.8594685910692015,139295601,113511197.8,68.32842331493961,43.41879432681498,NaN,NaN,-12.760794734745954,-17.35727848327588
2006-10-11T09:30:00-04:00,52.58,52.81,51.92,52.03,21725696,27656826.05,44.66380932834251,43.64373043267847,NaN,NaN,4.168567384828259,14.033558889964812,0.1755295607710019,-0.640056640105449,-0.815586200876451,117569905,121873898.6,70.49769536308153,47.29225979813337,NaN,NaN,-12.41871089258101,-16.651768827462327
2006-10-12T09:30:00-04:00,52.35001,53.25,52.33,53.25,23143904,27282236.45,50.749203131190725,44.71006912921681,NaN,NaN,74.8488275867122,26.286532078100993,0.23310597849290793,-0.524203727760316,-0.7573097062532239,140713809,128581101.8,72.14554861560686,51.34232855186757,NaN,NaN,-10.160671991171668,-15.724469279420804
2006-10-13T09:30:00-04:00,53.63,54.39,53.47,53.98,27233904,27115222.05,54.008365420484644,45.97771603020485,NaN,NaN,160.6612110602654,55.439550072180865,0.31046510371957636,-0.3692283266037535,-0.6796934303233299,167947713,135610164.2,73.79731636384139,55.5635996609022,NaN,NaN,-7.241332360972784,-14.512592576785373
2006-10-16T09:30:00-04:00,53.89999,55.25,53.81,55.25,28113008,26855022.05,59.08151653078898,47.121995337287736,NaN,NaN,204.44500281996855,93.93012254630243,0.4299222792707472,-0.1422905812348958,-0.572212860505643,196060721,152317549.8,77.25051612160925,59.532351582784536,NaN,NaN,-3.034603287719747,-12.87287982120457
2006-10-17T09:30:00-04:00,55.10001,55.13,54.27,54.64999,22786304,26679517.25,55.94190677667471,47.71149008487875,NaN,NaN,160.26919096346248,120.87855996304738,0.44918400530007635,-0.010732853880547566,-0.4599168591806239,173274417,159113313,78.4921332368695,62.489085420110314,NaN,NaN,-0.5932571923309152,-11.118648017079762
2006-10-18T09:30:00-04:00,54.58,55.10001,53.88,54.3,28710800,26648866.85,54.134805685938716,48.22917907145665,NaN,NaN,122.67143742996493,144.57913397207471,0.41956734426961523,0.06454232115639513,-0.3550250231132201,144563617,164512055.4,79.45160690269333,65.06603555743446,NaN,NaN,0.8330146404021698,-9.411267637439487
2006-10-19T09:30:00-04:00,54.56,55.42,54.3,55.42,22936192,26604156.45,58.729265442753196,48.98817675946051,NaN,NaN,145.61453977773536,158.73227641027933,0.453722260260212,0.21212780221204497,-0.24159445804816707,167499809,169869255.4,80.38662083864314,67.06020394439274,NaN,NaN,3.52067195995335,-7.563847694954796
2006-10-20T09:30:00-04:00,55.64999,55.64999,54.5,54.7,27554400,26767501.25,54.920494869811954,49.69500646389872,NaN,NaN,124.00106261622449,151.40024672147115,0.4075988818980971,0.2679041443244543,-0.13969473757364279,139945409,164268794.6,76.46922470303679,68.52004614558864,NaN,NaN,4.585040427354197,-5.828292248910654
2006-10-23T09:30:00-04:00,54.35001,55.03999,54.07001,54.8,19124000,25976606.05,55.353575850844315,51.0109549987803,NaN,NaN,92.75655340203599,129.06255683788464,0.3649779716235807,0.3165277269558331,-0.0484502446677476,159069409,156870532.2,71.51152294645406,69.77576904144182,NaN,NaN,5.566123535968036,-4.200518565356555
2006-10-24T09:30:00-04:00,54.71001,55.94,54.5,55.8,17725696,25305710.85,59.53962706054438,52.31219649238273,NaN,NaN,126.1540494574149,122.23952853667512,0.38339063784770766,0.430788052641887,0.04739741479417933,176795105,157574669.8,71.69958406585488,71.17743477858457,NaN,NaN,7.689971341696433,-2.5018771500632715
2006-10-25T09:30:00-04:00,55.67,57.14,55.46001,56.75999,30960304,25094921.25,63.11498264508145,53.49129133574852,NaN,NaN,158.57920641964395,129.42108233461096,0.435665575470418,0.5919793841322019,0.15631380866178385,207755409,170213028.2,74.90205869357479,72.57470962291123,NaN,NaN,10.630828234206673,-0.6257763808818511
2006-10-26T09:30:00-04:00,57.42,57.45,56.22,56.63,20414896,24903261.25,62.312031379839574,54.59443955090784,NaN,NaN,148.0981206240029,129.91779850386445,0.4358714429935573,0.7011531124037305,0.26528166941017317,187340513,174181169,75.82698019831457,73.77267400340614,NaN,NaN,12.771524354843445,1.2881237242217625
2006-10-27T09:30:00-04:00,56.58,57,55.99001,56.17,21020608,25111096.45,59.43065616442277,55.748213247609385,NaN,NaN,113.93030040142762,127.90364606090506,0.3813767277852877,0.7420025791417828,0.3606258513564951,166319905,179456068.2,77.03836298867229,74.8426853109423,NaN,NaN,13.749359182313391,3.068300218234852
2006-10-30T09:30:00-05:00,55.39999,55.91,55.05,55.16,38501696,26288791.2,53.57302160166243,56.110947277741516,NaN,NaN,61.42922338427179,121.63818005735223,0.25948450025990166,0.6849814766813722,0.42549697642147055,127818209,173205828.2,72.4081080461323,75.13409136317034,NaN,NaN,12.864570618290461,4.467767418242796
2006-10-31T09:30:00-05:00,55.14999,55.87,54.45,55.73,30609904,26116246.4,56.19696302903398,56.93474397064806,NaN,NaN,55.32483180931096,107.47233652773146,0.20197910087267712,0.6779708525123169,0.4759917516396398,158428113,169532429.8,69.75456277684154,75.08101046415321,NaN,NaN,12.883486405872036,5.670012987904117
2006-11-01T09:30:00-05:00,55.62,56.02,54.74001,55.16,27517392,25608756,52.972769658409874,57.0935701511637,NaN,NaN,48.83580721109774,85.5236566860222,0.11463215806215321,0.6192819492173314,0.5046497911551782,130910721,154163492.2,59.8689920865544,74.20411356922088,NaN,NaN,11.947850535606712,6.566846923290202
2006-11-02T09:30:00-05:00,54.84,55.73,54.72,55.38,18089008,24942136.8,54.068124720982134,57.09783867262781,NaN,NaN,42.91416677124581,64.48686591547079,0.0633146695768142,0.5837931281261959,0.5204784585493817,148999729,146495335.4,55.63265297955156,72.90663761320017,NaN,NaN,11.480948466636885,7.268861429482585
2006-11-03T09:30:00-05:00,55.74001,56.74001,55.73,56.60001,31898496,25255831.2,59.677090293316134,57.14037965566546,NaN,NaN,102.96176394794568,62.293158624774414,0.10094388765559947,0.646658318118881,0.5457144304632815,180898225,149410999.4,56.881987324463445,71.45174269911834,NaN,NaN,12.73052542703651,8.049099143418859
2006-11-06T09:30:00-05:00,56.39999,57.2,56.2,57.00999,19484800,25216140.8,61.3836586409522,57.52907621739957,NaN,NaN,124.7379424783263,74.95490244358533,0.14042629867265344,0.7212473038040983,0.5808210051314449,200383025,163923962.6,62.536858482363314,70.31208021665361,NaN,NaN,14.274675089885813,8.938467135771281
2006-11-07T09:30:00-05:00,57.00999,57.14999,55.60001,56.57001,31357008,25445400.8,58.521195141242366,57.84238974992125,NaN,NaN,93.8557784580835,82.66109177333983,0.12443800041554809,0.73636850565088,0.6119305052353319,169026017,166043543.4,63.29400434493161,69.15796574824206,NaN,NaN,14.748379548073382,9.76845462324301
2006-11-08T09:30:00-05:00,56.21001,57.61,56.21001,57.52,23062192,25512225.6,62.5788499623091,58.11736007274668,NaN,NaN,134.78392326146084,99.85071498341244,0.16294088804812934,0.8156066152954935,0.6526657272473642,192088209,178279041,67.39103084715696,68.22970932027877,NaN,NaN,16.37838272606506,10.712730066503303
2006-11-09T09:30:00-05:00,57.97,58.60001,57.64,58,20691104,25389585.6,64.4701032560032,58.79947495747462,NaN,NaN,178.48645723336006,126.96517307583528,0.20321437127289188,0.906683691338479,0.7034693200655872,212779313,191034957.8,71.0223888741298,67.84064961821399,NaN,NaN,18.30842157170999,11.7978288529614
2006-11-10T09:30:00-05:00,57.87,57.95,57.09,57.45,17297904,24892785.6,60.68547310706585,59.18032476149045,NaN,NaN,119.00554677263077,130.17392964077231,0.1762910665829106,0.9238331532942254,0.7475420867113148,195481409,193951594.6,71.79578392620024,67.86095397391014,NaN,NaN,18.84038644035369,12.803908508303156
2006-11-13T09:30:00-05:00,57.00999,57.88,56.81,57.35001,18944496,24434360,59.99592370635336,59.212917379048235,NaN,NaN,96.65134660251874,124.55661046561079,0.13697826506041078,0.9187649180368282,0.7817866529764175,176536913,189182372.2,68.57292432058682,67.63762113496242,NaN,NaN,19.082546769791172,13.700856831372873
2006-11-14T09:30:00-05:00,57.73,57.8,57.25,57.69,16591602,24124624.9,61.59391687828729,59.10426982427722,NaN,NaN,102.91796200809901,126.3690471756139,0.11972710351742877,0.9314455323732034,0.8117184288557746,193128515,194002871.8,70.03697869917431,67.29011542107666,NaN,NaN,19.72768151950661,14.56183178682055
2006-11-15T09:30:00-05:00,57.99001,58.4888,57.55,58.23,17303104,23554240.1,64.05020543562836,59.22842511397642,NaN,NaN,129.37473882790394,125.28721028890251,0.12969937355585037,0.9738426458005875,0.8441432722447372,210431619,197671553.8,71.13894457571212,66.95525573374792,NaN,NaN,20.973055179232635,15.47772084287942
2006-11-16T09:30:00-05:00,58.62,58.62,56.5,56.63,34538400,24134350.5,53.194521705785554,58.782986938359485,NaN,NaN,62.89151972056695,102.1682227863439,0.01934658855254745,0.8683265079354214,0.848979919382874,175893219,190294335,65.89114906860988,66.15902616802919,NaN,NaN,18.78136194548016,15.949669571822382
2006-11-17T09:30:00-05:00,56.03,57.2,55.92,57.10001,25283504,24020805.7,55.57641372728108,58.926086375903665,NaN,NaN,18.601202242253446,82.08735388026844,-0.028579627037535915,0.8132553855859541,0.84183501262349,201176723,191433397.8,66.30446442096162,65.72305162337413,NaN,NaN,17.677482419033584,16.196499978566838
2006-11-20T09:30:00-05:00,56.84,57.45,56.50999,56.95,26130096,24371110.5,54.62101870534918,58.8135189242119,NaN,NaN,31.038940400115255,68.96487263978773,-0.07436879607663416,0.7488740175276973,0.8232428136043315,175046627,191135340.6,66.07882582047718,65.46049898363383,NaN,NaN,16.49868359308653,16.239669066355365
2006-11-21T09:30:00-05:00,57.07001,58.06,57.07001,58,13886500,24179150.7,59.82676535161016,59.303090045154775,NaN,NaN,91.73197809351677,66.72767585687127,-0.03966682554764167,0.7736592816697794,0.813326107217421,188933127,190296263,65.4040454643106,65.85585993918785,NaN,NaN,17.0211799462347,16.3513134777667
2006-11-22T09:30:00-05:00,57.71001,58.14,57.05,57.66,18872496,23574760.3,57.525518899565235,59.550046772196424,NaN,NaN,75.08899933257999,55.87052795780649,-0.04494984673465896,0.7571387987990974,0.8020886455337564,170060631,182222065.4,59.14510460540938,66.10674934103483,NaN,NaN,16.768251037035675,16.410875986233695
2006-11-24T09:30:00-05:00,57.44,58.03999,57.33,57.53999,4512000,22779615.5,56.69653267932299,59.33714979976834,NaN,NaN,69.50800341470662,57.19382469663442,-0.06087604373446909,0.7259935908656701,0.7868696346001391,165548631,180153147.8,57.623422992352,66.1597090315983,NaN,NaN,16.324678068766772,16.398561998024135
2006-11-27T09:30:00-05:00,57.74001,58,57.03,57.28,13033000,22380235.1,54.85234195568788,58.87062717939232,NaN,NaN,47.55445070526417,62.98447438923656,-0.0914327473412031,0.6725787004236352,0.7640114477648383,152515631,170420929.4,50.979103353651574,65.33415509383317,NaN,NaN,15.436429351034988,16.261114477025686
2006-11-28T09:30:00-05:00,57.49001,58.45,57.48,58.2,17813296,21345815.1,59.831448003972284,58.964216669587316,NaN,NaN,96.11342848810257,75.99937200683402,-0.054045137299182366,0.6964550261408604,0.7505001634400428,170328927,169477389.4,50.372674816738964,64.41120298467656,NaN,NaN,16.079359857517083,16.235149531381598
2006-11-29T09:30:00-05:00,58.45,60.33,58.38,60.05,28197296,21225184.7,67.57535262761085,59.321109717108875,NaN,NaN,224.87445305688254,102.62786699950718,0.08344233908982357,0.8548030873023222,0.7713607482124987,198526223,171396008.6,51.632624249511466,63.285602513416165,NaN,NaN,19.272989724832996,16.669126701874657
2006-11-30T09:30:00-05:00,60.05,60.83,59.8,60.50999,27943696,21246499.9,69.1670142558212,59.656603359953024,NaN,NaN,265.2592971393584,140.66192656086287,0.18756577889622794,1.0058179718327835,0.8182521929365556,226469919,182677866.2,58.331695371421965,62.37912440607989,NaN,NaN,22.38332420125924,17.48544063035817
2006-12-01T09:30:00-05:00,60.11,60.75999,59.48,60.72,22244800,21454289.5,69.89363872953801,60.314329475843884,NaN,NaN,214.16278479123073,169.5928828361677,0.24893832421907924,1.1294250982104046,0.8804867739913254,248714719,199311083.8,65.84309565396674,61.95393238663461,NaN,NaN,25.108292317033364,18.57441944274034
2006-12-04T09:30:00-05:00,60.3,60.67,60.03,60.63,18398192,20779274.3,69.14163275976293,60.96759440823029,NaN,NaN,179.1315947573384,195.90831164658252,0.26058486874507325,1.206217859922667,0.9456329911775937,230316527,214871263,71.09289479189849,62.13393027744259,NaN,NaN,27.093982486982664,19.7914998776321
2006-12-05T09:30:00-05:00,61,61.27,60.25,60.87,22700800,20940074.3,70.06653131027369,61.57278115337217,NaN,NaN,163.78219486480356,209.44206492192274,0.2609194916483286,1.2717823557380044,1.0108628640896757,253017327,231408943,75.41740209183584,62.51824623406127,NaN,NaN,29.01468022730257,21.109097070442164
2006-12-06T09:30:00-05:00,60.64999,61.39999,60.47,60.7,20039504,20374199.1,68.50037019454413,61.890650064723296,NaN,NaN,136.35082848543922,191.73734000763406,0.22738654927596125,1.2950960506846272,1.067709501408666,232977823,238299263,76.96370360287216,62.93430045028699,NaN,NaN,30.194550792796726,22.40701903077853
2006-12-07T09:30:00-05:00,60.45,60.78,60.03,60.34,17318896,20087034.3,65.17787560042207,62.7466039143402,NaN,NaN,94.62765062304318,157.61101070437104,0.16174030929560557,1.269884888028173,1.1081445787325674,215658927,236137064.6,75.36172010389568,63.61076980995027,NaN,NaN,30.305699896755844,23.535402011632435
2006-12-08T09:30:00-05:00,60.62,60.97,60.17,60.27,14311898,19768074,64.52254107342958,63.385613010493664,NaN,NaN,86.45393610046845,132.06924096621856,0.09754584451308945,1.2300768843739291,1.1325310398608397,201347029,226663526.6,68.6220715905254,63.77631317920482,NaN,NaN,30.225675411428597,24.491155354460457
2006-12-11T09:30:00-05:00,60.00999,60.56,59.8,60.12,18443104,19825334,63.0593855672055,63.98835350062625,NaN,NaN,63.92391874320222,109.02770576339132,0.03229876440269974,1.1729044953642145,1.1406057309615147,182903925,217181006.2,62.58846469751777,63.52700167042201,NaN,NaN,29.778422450931924,25.246479225384952
2006-12-12T09:30:00-05:00,60.3,60.71001,59.85001,60.25999,24623296,20109274,63.882549896465605,64.27805239668736,NaN,NaN,62.29966037305364,88.73119886504134,-0.011754845934544678,1.125912173543334,1.1376670194778786,207527221,208082985,57.37591010767359,62.95356343066222,NaN,NaN,29.59925415388076,25.868304215170067
2006-12-13T09:30:00-05:00,60.3,61.06,60.21001,60.87,19773296,20268358.7,67.3018002089453,64.97635820450022,NaN,NaN,75.23192318933775,76.50741780582104,-0.010193066935480832,1.1249256858085275,1.1351187527440083,227300517,206947523.8,56.740781509343115,62.781826066657494,NaN,NaN,30.335313234314942,26.506448360762192
2006-12-14T09:30:00-05:00,61.2,62.13,60.91,61.75,22807296,20543568.3,71.49432419872922,66.03334331302923,NaN,NaN,105.19775042420797,78.62143776605399,0.03713104646231313,1.1815325608218998,1.1444015143595867,250107813,213837301,59.65886527127195,62.92721480086606,NaN,NaN,32.22328347554349,27.323139091445235
2006-12-15T09:30:00-05:00,61.88,61.88,60.94,61.00999,18060304,19719663.5,64.05636789312291,66.69077373713174,NaN,NaN,85.15523648340607,78.36169784264152,0.007187413546813293,1.1533857812931032,1.14619836774629,232047509,219977397,62.111756144061665,63.722404285895344,NaN,NaN,31.687106354384703,27.946562986150873
2006-12-18T09:30:00-05:00,61.10001,61.10001,59.23,59.25,35617392,20236357.9,50.57888954742387,66.02987670452113,NaN,NaN,12.568663551852936,68.09064680437166,-0.1347255734260071,0.9777914009637811,1.1125169743897882,196430117,222682635.4,63.17417951214723,64.6367974784245,NaN,NaN,26.49139660803777,27.738682074991857
2006-12-19T09:30:00-05:00,58.92999,60.35001,58.5,60.25999,20475104,19953608.3,56.265599381063744,65.22203718691063,NaN,NaN,-3.7599481161954085,54.87872510652185,-0.16229874978222125,0.9096435371620117,1.071942286944233,216905221,224558235.4,63.929386554036014,65.5151376430334,NaN,NaN,24.059661774983276,27.2131077464192
2006-12-20T09:30:00-05:00,60.39,60.39,59.32001,59.44,17605200,20139543.3,51.12237193114408,63.9331341637194,NaN,NaN,-10.516380800183557,37.72906430861758,-0.23317565325969936,0.7804727203696089,1.0136483736293083,199300021,218958136.2,59.97461631924778,65.63248913930667,NaN,NaN,20.23937615490318,26.216860376202625
2006-12-21T09:30:00-05:00,59.5,59.82001,58.60001,59.16,24209808,20406408.9,49.45980425416148,62.473574558335365,NaN,NaN,-59.714097941026324,4.746694635570728,-0.2924866548000974,0.6480400551291865,0.9405267099292839,175090213,203954616.2,50.89126537514557,64.56450126224802,NaN,NaN,16.683896254031247,24.855008358749572
2006-12-22T09:30:00-05:00,58.81,59.39999,58.59,58.59,11829500,20772283.9,46.168163404437735,60.832612461526416,NaN,NaN,-99.93924132233015,-32.27220092557651,-0.3592796786244239,0.4914271116487541,0.850706790273178,163260713,190197257,44.27034824081521,62.64860508002778,NaN,NaN,12.671059631395476,23.114444254841843
2006-12-26T09:30:00-05:00,58.5,59.19,58.19,58.66,10125801,20626923.95,46.637842571926775,59.15913469450164,NaN,NaN,-134.23119038445947,-61.63217171283899,-0.3855987124806566,0.36870839967235725,0.7543071121530138,173386514,185588536.4,42.28563508955498,60.28205029415057,NaN,NaN,9.645133993053387,21.19025707458635
2006-12-27T09:30:00-05:00,58.59,59.35001,58.39,59.35001,9326898,20202604.05,51.16127823346825,57.92062812585336,NaN,NaN,-114.99692827503345,-83.87956774460659,-0.3447232990835566,0.32340298829856806,0.6681262873821247,182713412,178750174.6,39.45889361623156,57.60313529510482,NaN,NaN,8.442192991453872,19.36910506271028
2006-12-28T09:30:00-05:00,59.5,59.64999,59.03,59.22,12174199,19401449.2,50.29615910281427,56.857648376024244,NaN,NaN,-82.60308005597658,-98.29690759576519,-0.3154205311893139,0.2738506233954823,0.5892711545847962,170539213,172998013,37.20585708212575,54.87771650783554,NaN,NaN,7.2137414204370405,17.632624542385532
2006-12-29T09:30:00-05:00,59.11,59.2,58.63,58.63,8064699,18407499.35,46.456922291780266,55.567247034477866,NaN,NaN,-113.8782951949673,-109.12974704655339,-0.32354395279631054,0.18484121358940797,0.5083851663857185,162474514,170474873.2,36.22868550571707,52.563903216063515,NaN,NaN,5.006326505622896,15.82886767999087
2007-01-03T09:30:00-05:00,58.31,58.39,56.16,56.58,47465600,19668539.35,36.13566389816322,53.6441240581177,NaN,NaN,-223.91013461060902,-133.92392570420915,-0.44713590879209475,-0.050534719604399925,0.3966011891876948,115008914,160824513.4,32.69206294011593,50.428445947677666,NaN,NaN,-0.7710664482648582,13.45744851881148
2007-01-04T09:30:00-05:00,55.88,56.24001,55.28999,55.55,50882096,21292734.55,32.257860217905616,51.38521765250626,NaN,NaN,-252.9950516975865,-157.67669796683455,-0.5705092803097582,-0.3165354111995029,0.25397386911025527,64126818,138972574.2,26.406102975698076,48.21631686682226,NaN,NaN,-6.993651856431827,10.53586275091958
2007-01-05T09:30:00-05:00,55.58,56.08,55.19,55.92,38303504,22072869.75,34.958039414573605,49.07494902433687,NaN,NaN,-202.75321124783204,-175.22795456139428,-0.5966331759147132,-0.4918176007831363,0.10481557513157694,102430322,122915956.2,22.918937615787186,45.800470874425415,NaN,NaN,-10.992259763051552,7.460416677495133
2007-01-08T09:30:00-05:00,56.48,56.7,55.39,55.92,32973808,22719584.95,34.958039414573605,46.465214396897174,NaN,NaN,-158.36461608553387,-190.38026176730574,-0.5826862141958561,-0.6235421926132432,-0.040855978417387084,102430322,109294178,20.451441051299724,42.999940572998824,NaN,NaN,-14.097474871231949,4.380717884819836
2007-01-09T09:30:00-05:00,55.14,55.84,54.8,55.44,37018096,23704544.95,32.98017931651728,44.24548664142535,NaN,NaN,-158.26008223817786,-199.25661917594783,-0.5736591570725321,-0.7579299247580522,-0.18427076768552011,65412226,89881720.4,17.551393743992676,39.817057544422475,NaN,NaN,-17.295202042414225,1.2841578952149701
2007-01-10T09:30:00-05:00,55.10001,55.17,54.17,54.37,38030896,24890494.85,29.036352905158793,42.7067340241207,NaN,NaN,-156.53162815081518,-185.78091788398908,-0.6045339504803323,-0.9399382057859356,-0.33540425530560325,27381330,72356203.6,15.424837980818708,36.40639029218472,NaN,NaN,-21.392349574872423,-1.9553431719403718
2007-01-11T09:30:00-05:00,54.55,55.73,53.89,54.06,49140192,26425349.25,27.991967478848693,40.687188888248194,NaN,NaN,-130.27886799564072,-161.2376811435999,-0.608920663425921,-1.0965550845880045,-0.48763442116208355,-21758862,55179067.6,13.675859733325211,32.81685266213395,NaN,NaN,-25.04310324460002,-5.253594610891749
2007-01-12T09:30:00-05:00,54.25,55.60001,54.2,55.44,32593008,26823834.85,38.58239910464068,39.79147654349795,NaN,NaN,-97.30706297970248,-140.148451489974,-0.48723549674009037,-1.0966787920871965,-0.6094432953471062,10834146,36859832.4,12.100087075611071,29.397243430445606,NaN,NaN,-24.844354016417753,-8.052274525966892
2007-01-16T09:30:00-05:00,55.05,55.63,54.58,54.87,31363504,27403345.25,36.213310023415815,38.84529838415898,NaN,NaN,-87.74794187684049,-126.02511664823533,-0.4162437920221118,-1.129748035374746,-0.7135042433526342,-20529358,12267896.4,10.372321021594644,26.503033119477685,NaN,NaN,-25.43916883966396,-10.53611657078076
2007-01-17T09:30:00-05:00,54.78,55.72,54.77,55.48,36132400,28069600.45,40.42898232262381,38.435356878315126,NaN,NaN,-70.51741925081097,-108.47658405076194,-0.30449372253524154,-1.094121396521686,-0.7896276739864445,15603042,2306059.6,9.764101819639038,24.03830123225081,NaN,NaN,-24.575042778936755,-12.541677457660187
2007-01-18T09:30:00-05:00,55.75,56.10001,54.71001,55.07001,31171504,28725160.45,38.58327036274679,37.86003029194513,NaN,NaN,-65.28116944484208,-90.22649230956733,-0.23745459906368205,-1.086445922816047,-0.848991323752365,-15568462,-6283898.8,9.259875351269486,21.679318393801847,NaN,NaN,-24.432892402055536,-14.240422449716664
2007-01-19T09:30:00-05:00,55.45,56.60001,55.33,56.58,31282000,28508390.85,47.999262928119485,37.634172055848786,NaN,NaN,-29.62969704758178,-70.09665811995555,-0.07888388674880409,-0.94759618218837,-0.868712295439566,15713538,1210581.2,13.458922634579764,19.82217760939815,NaN,NaN,-21.1258281265607,-15.224051832122955
2007-01-22T09:30:00-05:00,56.89999,56.91,55.89999,56.19,31568896,29063080.45,46.036113788954935,37.32988310485884,NaN,NaN,-18.61774716785415,-54.358794957585886,0.0076713826838396,-0.8591230670847665,-0.8667944497686061,-15855358,-4127319.6,12.997575918810014,18.093014669161313,NaN,NaN,-19.093537298768428,-15.776835470215165
2007-01-23T09:30:00-05:00,56.63,57.91,56.63,57.64999,36266800,29996160.45,53.67460848477787,37.84543211864438,NaN,NaN,32.284281548229494,-30.35235027257189,0.16259595269255633,-0.6635495089029106,-0.826145461595467,20411442,4060840.4,17.660169997560175,16.766692132864396,NaN,NaN,-14.657638016622098,-15.616950119701869
2007-01-24T09:30:00-05:00,57.49001,57.92,56.8,57.89999,21974400,29884390.05,54.85304935614964,39.18238822278626,NaN,NaN,45.38558598579583,-7.171749225250537,0.2746623496996171,-0.4828175244709456,-0.7574798741705627,42385842,9417400.4,20.65585055298287,15.906962676640607,NaN,NaN,-10.779529746575744,-14.925890066398138
2007-01-25T09:30:00-05:00,57.7,57.81,56.33,56.71001,22143808,30400105.45,48.52540316828688,40.34435557638493,NaN,NaN,23.691852772936237,10.622855218305126,0.26146919786037803,-0.43064337684509013,-0.6921125747054682,20242034,16579499.6,24.60554917152362,15.778351690628151,NaN,NaN,-9.497623078763485,-14.150423353878901
2007-01-26T09:30:00-05:00,57.10001,57.28,56.57001,56.85001,14685801,30628105.45,49.26689422686283,41.36641663440559,NaN,NaN,28.065415783748197,22.16187778457112,0.2547376696375687,-0.3736904876585072,-0.6284281572960759,34927835,20422359,26.713553790121367,16.04939570308059,NaN,NaN,-8.255890652486437,-13.308347253679978
2007-01-29T09:30:00-05:00,56.87,57.3,56.31,56.58,19949808,31159250.95,47.835690340018466,42.28624884336593,NaN,NaN,28.149722453792492,31.51537170890045,0.2256625607287317,-0.3463499563851613,-0.572012517113893,14978027,26589036,30.09143188767787,16.737966477107598,NaN,NaN,-7.672631349435013,-12.503244981644983
2007-01-30T09:30:00-05:00,56.81,57.87,56.67999,57.72,21511104,31626096.2,53.921945325446046,43.782089272575135,NaN,NaN,87.31552043424944,42.52161948610444,0.27357630710312364,-0.23004213323498846,-0.5036184403381121,36489131,29804573.8,31.855194639316636,17.75966654105931,NaN,NaN,-5.238736466020942,-11.465458050841548
2007-01-31T09:30:00-05:00,57.62,58.27,57.3,58.09,27846000,32615161.25,55.727426652667006,45.68859454025428,NaN,NaN,130.52636380428348,59.54977504980197,0.31747032180611257,-0.10678053808047139,-0.42425085988658395,64335131,34194431.6,34.29247984993138,19.10735524599593,NaN,NaN,-2.6911421693134234,-10.211984353480387
2007-02-01T09:30:00-05:00,58.10001,58.67999,57.77,58.3,23084304,31396096.45,56.76294366479111,47.7436642678216,NaN,NaN,142.9221295070508,83.39583039662489,0.3456094444986036,0.0077609457366705215,-0.33784849876193307,87419435,47629911.8,41.22160984776116,21.0749088255985,NaN,NaN,-0.3035552602623324,-8.796494483020666
2007-02-02T09:30:00-05:00,58.63,58.92999,57.96001,58.63,18443008,29774142.05,58.40920589030404,49.159864752511844,NaN,NaN,137.89800801801832,105.36234884347891,0.3692690126171533,0.12373776700950856,-0.24553124560764472,105862443,61816833.4,47.51543784123835,23.604576737429017,NaN,NaN,2.171822134092615,-7.22959210914734
2007-02-05T09:30:00-05:00,58.75,59.10001,58.39,58.57001,13109398,28514436.75,57.97704192357325,50.71441703109452,NaN,NaN,129.32289548687135,125.5969834500947,0.3631507195683473,0.2084071538527894,-0.1547435657155579,92753045,77371837,53.40644632625825,26.678442830619275,NaN,NaN,4.093752392015018,-5.611971466124146
2007-02-06T09:30:00-05:00,58.92,58.94,58.03999,58.39,19296400,27830566.35,56.62321170429317,51.87114770121376,NaN,NaN,102.92142065644403,128.7181634945336,0.3302018811053714,0.25800878566615637,-0.07219309543921502,73456645,84765339.8,55.937999698326585,29.97657839338267,NaN,NaN,5.361984528541716,-4.044263466886166
2007-02-07T09:30:00-05:00,58.59,58.86,57.71001,58.03999,19590800,26959201.55,53.98360896841224,52.97117188733272,NaN,NaN,81.35230393807723,118.88335152129234,0.2705618093994224,0.266009166310063,-0.004552643089359418,53865845,82671482.6,55.02617349746187,33.24559968953927,NaN,NaN,5.765686570064197,-2.642842033036114
2007-02-08T09:30:00-05:00,58.03,58.74001,57.73,58.63,24856400,26300476.75,57.573984840626615,53.65508059536894,NaN,NaN,84.26573577801852,107.15207277548589,0.25669183615050134,0.3163121520987673,0.05962031594826593,78722245,80932044.6,54.23525200957391,36.15819464489599,NaN,NaN,7.101822650720132,-1.2507470782137933
2007-02-09T09:30:00-05:00,58.7,58.91,58.10001,58.39,19041200,24795527.15,55.671179603720965,54.343299582137945,NaN,NaN,83.32173336183705,96.23681784424963,0.2186824090537297,0.33297332726542805,0.11429091821169836,59681045,71695765,50.11604468930935,38.8095138427888,NaN,NaN,7.732793779048727,0.03261590139513815
2007-02-12T09:30:00-05:00,57.8,58.03999,57.34,57.58,18696448,24100699.15,49.700947963868174,54.05946668778726,NaN,NaN,26.330940900292067,75.63842692693378,0.13066086709886438,0.27761700208527884,0.14695613498641447,40984597,61342075.4,45.90691018462381,40.82713814186478,NaN,NaN,6.617510488908724,0.9733151281827933
2007-02-13T09:30:00-05:00,57.81,58.42999,57.78999,58.42,15026789,23283863.4,55.08081538137068,54.07573568958876,NaN,NaN,61.44558247617798,67.34325929088057,0.12090827787765468,0.2980914823334828,0.17718320445582814,56011386,57853023.6,44.54906101644749,42.53379603211225,NaN,NaN,7.19485852694082,1.8621070422910826
2007-02-14T09:30:00-05:00,58.31,59.03999,58.12,58.42999,23517904,22653138.6,55.14226511408594,54.548368685717264,NaN,NaN,81.2996288506577,67.33272427339665,0.10747952518285722,0.31153261093439966,0.20405308575154243,79529290,62985712.6,47.031143891105515,44.1356242263681,NaN,NaN,7.680534784215511,2.6933110054231437
2007-02-15T09:30:00-05:00,58.25999,58.41,57.52,57.99001,24961104,22342618.6,51.78239566164587,54.72804735963034,NaN,NaN,24.80840846066327,55.44125880992559,0.06348958008136124,0.28341506085324397,0.21992548077188273,54568186,58154900.8,44.98995685384398,45.441081588062566,NaN,NaN,7.154156111220009,3.330574591965553
2007-02-16T09:30:00-05:00,58,58.08,57.74001,58,16274602,21592248.7,51.85412785256955,55.015078610526835,NaN,NaN,14.155458765149325,41.60800389058805,0.03122182585259589,0.2589527630876276,0.2277309372350317,70842788,60387249.4,46.152972541352206,46.58833449189645,NaN,NaN,6.739259176943335,3.8175295326766645
2007-02-20T09:30:00-05:00,57.37,57.50999,57.10001,57.35001,16283398,20827973.8,46.95911087450129,54.517733292602216,NaN,NaN,-72.64913208212235,21.811989294105164,-0.03419669986013335,0.184985062409865,0.21918176226999836,54559390,63102208,47.6038438598562,47.71323800764928,NaN,NaN,4.988189055720849,3.9847666073972623
2007-02-21T09:30:00-05:00,57.35001,58.07001,57.00999,57.98,20426800,20035973.8,51.71662565376485,54.23124750696635,NaN,NaN,-27.03631044156107,4.115610710557353,-0.03520086515539539,0.1751806808257541,0.2103815459811495,74986190,66897168.8,49.64618509980302,48.80993123978296,NaN,NaN,4.7918836920244505,4.100069048058289
2007-02-22T09:30:00-05:00,57.99001,58.71001,57.7,58.5,21559600,20015233.8,55.28200728432452,54.125466336933016,NaN,NaN,52.6029330035988,-1.623728458854427,-0.0027177922016558553,0.20698430572907967,0.20970209793073552,96545790,70300468.8,51.47298135442139,49.54217206168727,NaN,NaN,5.660912899523088,4.323046741124689
2007-02-23T09:30:00-05:00,59.00999,59.03,58.50999,58.64999,16639398,19740013.3,56.284739852799405,53.973718762825534,NaN,NaN,104.4110948956012,14.296808828133155,0.02544463717998302,0.2415078944057143,0.21606325722573128,113185188,82023869.2,57.22926860590285,50.236017116306165,NaN,NaN,6.664952156623443,4.657604657624511
2007-02-26T09:30:00-05:00,59.17,59.53,58.85001,59,21165072,20063976.85,58.61674903271437,54.01941212776419,NaN,NaN,153.23635113773733,42.11298730265075,0.062129465432760794,0.29372508901668226,0.23159562358392147,134350260,94725363.6,62.4291745781501,50.88049770572701,NaN,NaN,8.18592548331742,5.161650489866355
2007-02-27T09:30:00-05:00,58.12,58.89999,56.45,56.64999,52385808,21685776.85,42.300600173442945,52.996368446989166,NaN,NaN,-136.37981411990106,29.366850895095013,-0.07021768540433343,0.1438235168285047,0.21404120223283812,81964452,100206376,64.43836535688209,51.487666681338126,NaN,NaN,4.066216297786889,5.00515989099786
2007-02-28T09:30:00-05:00,56.89999,57.67999,56.73,56.89999,32625200,22241481.65,44.08375443541374,52.28923598034642,NaN,NaN,-164.12667488433468,1.9487780065402944,-0.1354863452899932,0.044683270620346605,0.1801696159103398,114589652,108127068.4,67.17061416075296,52.355126728716066,NaN,NaN,1.4295329883121783,4.494356047757049
2007-03-01T09:30:00-05:00,56.32001,57.47,55.05,56.72,31906176,22444490.45,43.05216782532759,51.25196333639649,NaN,NaN,-216.42820855440831,-51.85745030506113,-0.18242217204903208,-0.047858099150950295,0.13456407289808178,82683476,105354605.6,65.2799871753313,53.144036383413024,NaN,NaN,-0.992989624776153,3.7104495231094488
2007-03-02T09:30:00-05:00,56.81,56.94,55.72,56.05,33788096,22979680.05,39.359907605411976,50.086872479374414,NaN,NaN,-191.33382608967955,-111.00643450211729,-0.24626239699079686,-0.1732639233404143,0.07299847365038256,48895380,92496644,57.23412382818489,53.65247060761842,NaN,NaN,-4.243320283496983,2.574196693594244
2007-03-05T09:30:00-05:00,55.14999,56.25999,54.94,55.39999,35840496,23849554.45,36.12313199166588,49.117028481359974,NaN,NaN,-210.26199779581222,-183.7061042888272,-0.31551436422224943,-0.32139448162742923,-0.0058801174051798105,13054884,68237568.8,45.7717006002297,53.6428127801617,NaN,NaN,-8.04264670503767,1.0575047795039705
2007-03-06T09:30:00-05:00,56.21001,56.60001,55.88,56.45,21932096,24290689.35,44.11763356658511,48.33394406601815,NaN,NaN,-120.46047239584725,-180.52223594401642,-0.27531757822091857,-0.35002709018132805,-0.07470951196040947,34986980,58842074.4,42.243064311201074,53.47809872978695,NaN,NaN,-8.720120008334957,-0.33929876161587624
2007-03-07T09:30:00-05:00,56.58,58.23,56.32001,57.14999,44430000,25547369.35,48.724842091084504,47.87555670723233,NaN,NaN,-35.19012518806938,-154.73492600476337,-0.19033757024988993,-0.31263147477277187,-0.12229390452288194,79416980,51807540,39.77090891122331,52.959510516938224,NaN,NaN,-7.745458253558842,-1.3973215461791568
2007-03-08T09:30:00-05:00,57.92999,57.96001,57.25999,57.64999,23206896,25728174.15,51.782776269451375,47.87558389350415,NaN,NaN,1.6765751159310802,-111.11396927069548,-0.09407217554704805,-0.239884123956692,-0.14581194840964395,102623876,55795620,41.84865883644516,52.73513208712402,NaN,NaN,-5.947133630617581,-2.0472947010989317
2007-03-09T09:30:00-05:00,57.71001,58.03999,57.24001,57.39999,21747808,25572744.55,50.171633396621694,47.75540571807931,NaN,NaN,-0.4264971237965334,-72.93250347751888,-0.04342854848265487,-0.20009763401296254,-0.15666908553030767,80876068,62191757.6,45.11867695131721,52.66125383069295,NaN,NaN,-4.998306146192784,-2.468867764683768
2007-03-12T09:30:00-04:00,57,57.57001,56.95,57.32001,21401600,25690764.55,49.63952220815157,47.9468636704829,NaN,NaN,-22.129188488774506,-35.30594161611133,-0.013085322499906848,-0.17302573865519122,-0.15994041615528437,59474468,71475674.4,49.55296774741184,52.80047696551835,NaN,NaN,-4.391908442342142,-2.7435878614921068
2007-03-13T09:30:00-04:00,57.3,58.02,56.45,56.55,31470608,26329472.55,44.721809367384175,47.447233935741416,NaN,NaN,-44.66260023757387,-20.146367184456643,-0.041062915144069345,-0.21126906008537105,-0.1702061449413017,28003860,70079050.4,48.91271083629416,52.74808594669629,NaN,NaN,-5.348661836183253,-3.1157412864479848
2007-03-14T09:30:00-04:00,56.8,57.37,56.2,57.2,37926800,27474473.1,49.28890625615317,47.019155290872035,NaN,NaN,-47.560615924878704,-22.620465331818508,-0.01341292391686738,-0.18697229983738595,-0.17355937592051857,65930660,67381786.4,47.63268623084466,52.473779152155096,NaN,NaN,-4.7667016116078615,-3.3515927614708243
2007-03-15T09:30:00-04:00,57.19,57.61,56.97,57.19,20805872,27338871.5,49.22152907561907,46.51464023535915,NaN,NaN,-9.48374056813301,-24.85252846863132,0.005564813613045644,-0.16660335890421152,-0.17216817251725716,45124788,55881968.8,42.5232265679924,51.42334757801864,NaN,NaN,-4.3201520073756186,-3.489958368028652
2007-03-16T09:30:00-04:00,57.33,57.37,56.25999,56.39,28048464,27493239.5,44.03543261680958,45.473117634223094,NaN,NaN,-66.19381419889245,-38.00599188365051,-0.032316531577392976,-0.2125638369889984,-0.1802473054116054,17076324,43122020,37.69195719087677,49.65640347892769,NaN,NaN,-5.481935399518529,-3.774526515384349
2007-03-19T09:30:00-04:00,56.95,57.57001,56.82001,57.28999,21578736,27758446.2,50.37058448005611,46.04954508469546,NaN,NaN,-1.998768551266342,-33.97990789614887,0.004712800663191186,-0.17435630458261642,-0.1790691052458076,38655060,38958138.4,36.24480266954338,47.64257757268921,NaN,NaN,-4.522866305331059,-3.8814321996624503
2007-03-20T09:30:00-04:00,57.35001,57.89,57.16,57.7,24125280,28150540.3,52.98184903535557,46.68512327040559,NaN,NaN,36.77923536503356,-17.691540775627388,0.05547343512903838,-0.10972731133450964,-0.16520074646354801,62780340,45913434.4,40.36368109935904,45.7277966397325,NaN,NaN,-2.9195166503787116,-3.7440156926219164
2007-03-21T09:30:00-04:00,58.13,59.08,57.86,58.74001,24425520,28350476.3,58.890420552182306,47.816427036609504,NaN,NaN,130.8910169338659,17.99878579612153,0.15225832049882843,0.02512215415998753,-0.1271361663388409,87205860,50168474.4,42.798375492086976,44.121967233786485,NaN,NaN,0.4332328883994823,-3.1472658953331454
2007-03-22T09:30:00-04:00,59.05,60.17999,59.05,59.92,33614176,28953205.1,64.36247030818174,49.60232437252163,NaN,NaN,214.18501697978607,62.73253730570534,0.2814028601468616,0.22461740884473613,-0.05678545130212549,120820036,65307524,50.535920785178575,43.64352415928603,NaN,NaN,5.266202232737002,-1.9453418770374102
2007-03-23T09:30:00-04:00,60.19,60.42,59.82001,60.22,14929625,28867716.45,65.61560012537323,51.70892923921501,NaN,NaN,219.71867929617738,119.91503600471931,0.36725955399310767,0.4022889911892591,0.035029437196151425,135749661,89042191.4,59.73236923669922,44.64071477617671,NaN,NaN,9.518889671118949,-0.30759451301507323
2007-03-26T09:30:00-04:00,60.7,61,59.77,60.64,19012368,28760081.25,67.3467232577807,53.36814993144326,NaN,NaN,216.91369003652625,163.69752772227784,0.4283045757984436,0.5704101569442059,0.14210558114576233,154762029,112263585.2,66.328414092378,46.361096903403634,NaN,NaN,13.55280605503532,1.672462710992126
2007-03-27T09:30:00-04:00,60.49001,60.75,60.17,60.75,17175664,26999574.05,67.80391424929157,54.73094079988663,NaN,NaN,173.28723617149058,190.99912788356923,0.4498383727865255,0.7044035471289192,0.2545651743423937,171937693,134095055.8,71.11834254872184,48.600199306082104,NaN,NaN,16.925793151301708,3.8515099167506377
2007-03-28T09:30:00-04:00,61.14,61.14,60.28999,60.74001,18572944,26296961.25,67.71119095894886,55.8686847062793,NaN,NaN,146.48161416821083,194.11724733043823,0.43679570817173685,0.8005598095570647,0.3637641013853279,153364749,147326833.6,73.57218463089279,50.86616543425693,NaN,NaN,19.625792902684772,6.104978914741228
2007-03-29T09:30:00-04:00,60.92999,61.16,60.49001,61.12,23297072,25866506.05,69.42398937219345,57.24385299024872,NaN,NaN,130.29636239020226,177.33951641252148,0.42665697207473874,0.8970853164787513,0.4704283444040126,176661821,158495190.6,75.46685431907868,53.03389238909703,NaN,NaN,22.42729891053309,8.436738914140065
2007-03-30T09:30:00-04:00,60.86,60.95,59.89999,60.28,21184880,25236345.25,61.63989778702417,58.10102267445391,NaN,NaN,91.73738817181466,151.7432581876489,0.34004050218981685,0.8954789721412837,0.5554384699514668,155476941,162440646.6,76.11822972887623,54.93141110205878,NaN,NaN,22.66388255123319,10.469188005153368
2007-04-02T09:30:00-04:00,60.25999,61.05,60.19,60.87,17895456,24339093.25,64.63893029975597,59.52367416962324,NaN,NaN,94.15471912321652,127.19146400498698,0.3005140870364825,0.93108107874707,0.6305669917105875,173372397,166162720.2,76.74550401979148,56.91946775802287,NaN,NaN,23.7588540896446,12.367711731509258
2007-04-03T09:30:00-04:00,60.63,61.31,60.42999,61.25,16158762,24050426.55,66.45783036145211,60.75002589143031,NaN,NaN,94.69749417509352,111.47351560570755,0.2784882041057698,0.9786772468427998,0.70018904273703,189531159,169681413.4,77.3511492078213,59.0422151135212,NaN,NaN,25.215175772302352,14.203063737336842
2007-04-04T09:30:00-04:00,60.85001,61.48,60.62,61.35001,15812305,22619541.8,66.93981504371715,62.01561774629447,NaN,NaN,90.48474389325074,100.27414155071554,0.25008291026799145,1.0127926805720193,0.7627097703040279,205343464,180077156.4,79.08432288661614,61.6537219934229,NaN,NaN,26.545267763597696,15.966235741088393
2007-04-05T09:30:00-04:00,61.50999,61.82001,61.25999,61.75,12185828,22068488.4,68.8667077115962,63.78928025306494,NaN,NaN,98.58942146351214,93.93275336537751,0.23774221095683845,1.059887534000076,0.8221453230432375,217529292,188250650.6,80.35706166099706,64.70122945557435,NaN,NaN,28.234805644240442,17.718888584395827
2007-04-09T09:30:00-04:00,61.64,62.31,61.42,61.52,19618560,21962026,66.46772858815163,64.93907626078604,NaN,NaN,95.41078845630832,94.66743342227623,0.19537105550442668,1.0663591424237708,0.8709880869193442,197910732,196737408.8,81.60848326017107,67.9414923549049,NaN,NaN,28.99795259338895,19.330183442823415
2007-04-10T09:30:00-04:00,61.64999,62.61,61.56,62.45,17188384,21751365.2,70.88429048254093,66.21782207844214,NaN,NaN,106.31207142277752,97.09890388218841,0.20998175778660422,1.1334652841525994,0.9234835263659952,215099116,205082752.6,82.77086243188933,70.97057673579992,NaN,NaN,31.010533178974793,20.998804833702184
2007-04-11T09:30:00-04:00,62.47,62.77,61.89999,62.07001,24847472,21420208.4,67.00119728331305,66.79716327352291,NaN,NaN,102.72393517011965,98.70419208119365,0.17546257509268637,1.1428117452318531,0.9673491701391668,190251644,205226849.6,82.79108699279817,73.82719898585071,NaN,NaN,31.566168612151273,22.508428230623483
2007-04-12T09:30:00-04:00,62.14999,63.03999,61.98,63.02,16836096,20365673.2,71.24259553309155,67.28860078958789,NaN,NaN,118.48173010234831,104.30358932301314,0.1964355867200016,1.2128936535391688,1.0164580668191672,207087740,205575704.8,82.84359394672083,76.13488992596089,NaN,NaN,33.386941452052774,24.062501547970523
2007-04-13T09:30:00-04:00,63.13,63.17,62.7,63.05,13394227,19995090.95,71.36775197895439,67.69946877912939,NaN,NaN,129.1008557562042,110.40587618155158,0.19193126178706876,1.2563721440530031,1.0644408822659344,220481967,206166239.8,82.93849387335273,77.79247025715041,NaN,NaN,34.87757404087201,25.607511904099308
2007-04-16T09:30:00-04:00,63.19,63.52,62.58,63.42,14167996,19301067.55,72.93240607439509,68.09844612317328,NaN,NaN,134.48017500660518,118.21975349161093,0.19295491556092093,1.3056345267170855,1.1126796111561645,234649963,213514086,84.11583685030878,79.06300045414548,NaN,NaN,36.5979737285622,27.17757787902258
2007-04-17T09:30:00-04:00,63.57001,63.74001,62.73,63.06,14520238,18948142.65,68.98249557025173,68.18263050324187,NaN,NaN,124.54643988920682,121.86662718489681,0.15036305980088072,1.3006334359072653,1.1502703761063846,220129725,214520207.8,84.27583990465665,80.00282169385511,NaN,NaN,36.914029628528304,28.568499557523396
2007-04-18T09:30:00-04:00,62.77,62.88,62.41,62.84,15571105,18520433.9,66.60838742894683,68.10385882252744,NaN,NaN,87.29335460022352,118.7805110709176,0.09125834820234746,1.264343311359319,1.1730849631569715,204558620,217381603,84.74643485601749,80.80098242422115,NaN,NaN,36.50344269228315,29.702062862489075
2007-04-19T09:30:00-04:00,62.36,62.46001,61.84,61.96001,16121203,18105218.05,58.00849647935417,67.28846647303892,NaN,NaN,40.156103488612544,103.11538574817044,-0.01742495105892017,1.1513037743333214,1.1687287253922416,188437417,213651538.4,81.32939125203396,81.21973506228939,NaN,NaN,33.50287990406139,30.245036725570834
2007-04-20T09:30:00-04:00,62.53999,63.36,62.53999,63.10001,18204352,17334726.85,64.4177722398504,67.48688607681223,NaN,NaN,95.72271373027226,96.43975734298405,-0.0225350327091971,1.1405599345057453,1.1630949672149424,206641769,210883498.8,78.79050300264419,81.41061172470138,NaN,NaN,32.813582993642385,30.611971906723912
2007-04-23T09:30:00-04:00,63.12,63.78999,63,63.17,20016720,17589081.6,64.77326904383077,67.496481701389,NaN,NaN,107.63229444867893,91.0701812313988,-0.030693725747088063,1.1247278100310822,1.1554215357781703,226658489,209285204,77.29016344276432,81.44951596919944,NaN,NaN,32.37765162404437,30.86421186634112
2007-04-24T09:30:00-04:00,63.11,63.25,62.64999,62.98,21381840,17707555.2,62.93504927321871,67.2448544808009,NaN,NaN,74.39821832949646,81.04053691945674,-0.05685753437694774,1.0843496178069856,1.1412071521839333,205276649,206314588.8,74.45244786366462,81.24246587318825,NaN,NaN,31.473487239463203,30.95125120535856
2007-04-25T09:30:00-04:00,63.23,64.57001,63.2,64.16,28974784,18297511.2,68.84795858355622,67.38115044793226,NaN,NaN,137.5664541145833,91.0951568223287,-0.00537526130863375,1.1344880755481412,1.139863336856775,234251433,212253151.4,76.32388284194664,81.04529158428329,NaN,NaN,32.53263976343255,31.177163856511985
2007-04-26T09:30:00-04:00,64.11,64.4595,63.64,64.14,19139392,18325833.6,68.64806504175175,67.36553311437194,NaN,NaN,131.47103110456467,109.35814234551913,0.015506340415483377,1.1592462623761293,1.1437399219606459,215112041,217588076.2,77.89074638735961,80.8691262075949,NaN,NaN,33.307070199551184,31.48143619123187
2007-04-27T09:30:00-04:00,63.99001,64.59,63.67999,64.13,14125152,17867237.6,68.540910088782,67.5136175072741,NaN,NaN,122.68813593278591,114.75122678602186,0.016716220658752556,1.1646351977840865,1.147918977125334,200986889,216457100.2,76.73142530987386,80.52076492543081,NaN,NaN,33.900255616113455,31.826981823357812
2007-04-30T09:30:00-04:00,64.14,64.75,63.37,63.37,17561328,17686060,60.776350247168295,66.79162177617606,NaN,NaN,95.0971138074829,112.24419065778265,-0.04236852445065287,1.094958321562018,1.1373268460126709,183425561,207810514.6,68.35490767752549,79.49105387154768,NaN,NaN,32.0993307115336,31.865888807382923
2007-05-01T09:30:00-04:00,63.44,63.86,62.98,63.64999,26730192,18127796.8,62.46342835805442,66.46749542437188,NaN,NaN,63.35818144611098,110.03618328110556,-0.06968115402734254,1.0502254034784926,1.1199065575058351,210155753,208786335.4,68.76927209774959,78.48949566475848,NaN,NaN,31.084913778709623,31.75432094614388
2007-05-02T09:30:00-04:00,63.86,64.41,63.67999,64.17999,16662141,18152965.75,65.48935437232103,66.05654962717398,NaN,NaN,109.92540659984341,104.50797377815756,-0.05953399236577139,1.0454890670486208,1.1050230594143922,226817894,207299627.6,67.32290292542785,77.38087487752327,NaN,NaN,31.10041424493395,31.66090570311389
2007-05-03T09:30:00-04:00,63.92,65.03,63.86,64.7,17112864,18217993.7,68.19815203992663,65.83014963152915,NaN,NaN,140.2235497377819,106.25847750480102,-0.026941538704943202,1.0713461360332133,1.0982876747381565,243930758,213063371,69.96068244842093,76.453888347171,NaN,NaN,31.929654000501955,31.69929831702647
2007-05-04T09:30:00-04:00,65,65.74001,64.53,64.64999,20444336,18630919.1,67.64821915123196,65.45270770844607,NaN,NaN,162.1876290908731,114.15837613641845,-0.018305300646850098,1.0754060489295938,1.093711349576444,223486422,217563277.6,71.86987705830667,75.57917693345657,NaN,NaN,32.44440367506372,31.80574193960322
2007-05-07T09:30:00-04:00,64.42,64.94,64.35001,64.82001,11275172,18213749.7,68.57596055414045,65.42366949300954,NaN,NaN,121.48424379669682,119.43580213426124,-0.011053558236488126,1.0798944017808338,1.090947960017322,234761594,227830484.2,75.66953144322258,74.9644406147827,NaN,NaN,33.1342021470285,31.9955219692354
2007-05-08T09:30:00-04:00,64.60001,64.98,64,64.83,15386297,18123645.35,68.63287906963124,65.56827603877272,NaN,NaN,100.31648996513313,126.82746383806565,-0.015237286641687886,1.071901351715212,1.0871386383569,250147891,235828911.8,78.14603885341239,74.49298375745376,NaN,NaN,33.71978342804254,32.24184503477928
2007-05-09T09:30:00-04:00,64.75999,65.08,64.05,64.8,22117232,17987133.35,68.2331850526558,66.29861093686569,NaN,NaN,94.02796489599737,123.64797549729644,-0.028886568173529303,1.0510304281399883,1.0799169963135176,228030659,236071464.8,78.21844322549353,74.27077318412944,NaN,NaN,34.11000006463131,32.50872432475814
2007-05-10T09:30:00-04:00,65.06,65.13,63.66,63.75,20797120,18185184.55,55.95145512027448,65.69387399975314,NaN,NaN,44.636181618386516,104.53050187341736,-0.11278133589665051,0.9389403264427045,1.051721662339355,207233539,228732021,70.59660663540429,73.68549487218374,NaN,NaN,30.897884755592482,32.2786043863059
2007-05-11T09:30:00-04:00,63.85001,65.25,63.78,65.21001,21324160,18581681.2,65.303401607039,65.73174061141086,NaN,NaN,92.9459609258421,90.68216824041117,-0.07586668529286955,0.9568883057232682,1.0327549910161378,228557699,229746276.4,71.0169110940704,73.23740541870559,NaN,NaN,30.864035603322094,32.07652313159393
2007-05-14T09:30:00-04:00,65.19,65.63,65,65.23,16524789,18699520.85,65.41167994051702,65.90864280193217,NaN,NaN,132.7693257265204,92.93918462637589,-0.05689195546105763,0.9616400466898156,1.0185320021508733,245082488,231810455.2,71.89734854597162,73.05489832458466,NaN,NaN,30.871768276181427,31.90441529510643
2007-05-15T09:30:00-04:00,65.33,66,65.14999,65.45,16058793,18776448.6,66.64536807078875,65.75131490816307,NaN,NaN,142.36963241260284,101.34981311586985,-0.03726246789239229,0.9719539172853828,1.0092163851777751,261141281,234009133.2,72.84363890383595,72.80630947186246,NaN,NaN,31.2525647649002,31.811293790791254
2007-05-16T09:30:00-04:00,65.38,65.75,64.67999,65.7,17450992,18870442.95,68.04038496740237,65.70790918856667,NaN,NaN,117.53551901053069,106.0513239387765,-0.016252142417308324,0.9889012071561396,1.005153349573448,278592273,244121456,76.72543460695131,72.72307291611901,NaN,NaN,31.983334295933037,31.83587100581151
2007-05-17T09:30:00-04:00,65.89999,67.09,65.36,66.75,18787056,19003735.6,73.12448497314732,66.03530739459278,NaN,NaN,194.88371445625657,136.10083050635052,0.055613442501106336,1.0746701526998308,1.0190567101987245,297379329,262150614,81.73762500331316,73.08065860850753,NaN,NaN,34.31579141615762,32.190145350146665
2007-05-18T09:30:00-04:00,67,67.85001,66.94,67.83,21232224,19155129.2,77.15076005554364,67.20490809519102,NaN,NaN,255.3902158985902,168.58968150090013,0.15737458172444674,1.2157749373542828,1.058400355629836,318611553,280161384.8,85.17278585722246,74.28193562134302,NaN,NaN,37.80776269583346,32.99266211381621
2007-05-21T09:30:00-04:00,68.07001,69.02,67.92,68.39999,45360000,20422293.2,78.9436662502596,68.38206794463424,NaN,NaN,252.6333441546469,192.56248518652544,0.2396328529135925,1.3579414217718266,1.1183085688582342,363971553,303939197.8,88.30137726699097,75.67708599057455,NaN,NaN,41.28936748730953,34.17790573860097
2007-05-22T09:30:00-04:00,68.33,68.86,67.75999,67.75999,25106336,20608518,72.10245095234936,68.85443198606482,NaN,NaN,185.26073128734598,201.14070496147406,0.22759008296389283,1.4027961725631002,1.1752060895992074,338865217,319483985,89.81448496287224,77.28362756467773,NaN,NaN,41.84827916774434,35.27367337133574
2007-05-23T09:30:00-04:00,68.02,68.78999,67.89999,67.89999,24868432,20403200.4,72.66058426009911,69.17317714464858,NaN,NaN,155.79329952841573,208.79226106505106,0.20633160318558907,1.4331205935811937,1.2267889903956046,363733649,336512260.2,91.16287804425718,78.79807010723745,NaN,NaN,42.46506773026476,36.301015422611314
2007-05-24T09:30:00-04:00,68.06,68.66,66.59,66.66,28183392,20855400.4,61.016754998287524,68.69950113372398,NaN,NaN,92.1363393864592,188.2427860510916,0.09187329031062741,1.341630603283889,1.2497573129732615,335550257,344146445.8,91.69377926801054,80.2140631222163,NaN,NaN,38.983523447258236,36.684230854703735
2007-05-25T09:30:00-04:00,67.39,67.84,67.22,67.7,13020988,20800192.2,65.94584641854539,68.51163583832434,NaN,NaN,91.84397320670027,155.53353751271362,0.07029345904076978,1.3376241367742239,1.267330677733454,348571245,350138384.2,92.0951852882133,81.3873241111442,NaN,NaN,37.750207210567375,36.83651319125568
2007-05-29T09:30:00-04:00,67.39999,67.77,66.78,67.25,20560832,20950167.4,62.27659394594443,68.05761547234671,NaN,NaN,67.12686518019378,118.43224171782299,0.012810778999562844,1.2833441514829076,1.2705333724833447,328010413,342946156.2,86.68038979028464,81.99692060663509,NaN,NaN,35.506251337903485,36.64647578363394
2007-05-30T09:30:00-04:00,66.97,68.75,66.82001,68.66,19271520,20577233.8,68.23962478624226,68.05807545331717,NaN,NaN,93.59284762091319,100.09866498453643,0.05450988231977849,1.3386707253830679,1.2841608430632894,347281933,344629499.4,86.87489967248827,82.61523892427756,NaN,NaN,35.69525948699869,36.510587741257474
2007-05-31T09:30:00-04:00,68.84,69.07001,68.03999,68.3,16701441,20579198.8,65.3972351166502,68.73277402448686,NaN,NaN,100.35842119894961,89.0116893186432,0.04310676607464137,1.3380443006565912,1.2949375345819498,330580492,337998868,81.80722511226827,83.4159973869107,NaN,NaN,34.85761187453744,36.27444833172604
2007-06-01T09:30:00-04:00,68.64,69.17999,68.61,68.92,11915855,20319348.35,67.87873096458156,68.91672612145419,NaN,NaN,107.91383864755495,92.16718917086236,0.06146103906505518,1.3717638334132687,1.3103027943482135,342496347,339388086,82.04356376102484,84.20361543455031,NaN,NaN,35.016295521549964,36.094712215986604
2007-06-04T09:30:00-04:00,68.73,70.07001,68.64,70,17667952,20180529.15,71.68760112643629,69.3650062061627,NaN,NaN,123.29628111082847,98.45765075168799,0.12672054902854235,1.4687034806338914,1.341982931605349,360164299,341706696.8,82.45327143304522,84.95760992648414,NaN,NaN,36.480165424447634,36.14977696005246
2007-06-05T09:30:00-04:00,69.59,69.96001,69.21001,69.75,15325918,20383066.45,69.62935741386278,69.57814830209658,NaN,NaN,116.10296929448715,108.25287157454667,0.13279202683110758,1.5079729651442335,1.375180938313126,344838381,345072290.4,83.05756541374397,85.6871761057633,NaN,NaN,36.94962646347085,36.26404117482652
2007-06-06T09:30:00-04:00,69.50999,69.50999,68.5,68.86,18985376,20563020.4,62.724930745281554,69.19847300051651,NaN,NaN,81.19472388196483,105.773246826757,0.060301351105382484,1.4505576271948541,1.3902562760894717,325853005,340786504.8,79.31177699714623,85.87191484792007,NaN,NaN,35.04494230858664,36.089884193935106
2007-06-07T09:30:00-04:00,68.74001,69.25,67.41,67.64,20155488,20464933.2,54.71552472283235,67.88354726835117,NaN,NaN,36.67970865184133,93.03750431733535,-0.0788277474800434,1.2917215917394174,1.3705493392194608,305697517,335809909.8,75.07767421002295,85.39620407697078,NaN,NaN,30.609107093573407,35.306916036740574
2007-06-08T09:30:00-04:00,67.16,68.06,66.78999,67.92,20989632,20474558.8,56.10099644467889,66.37999272471797,NaN,NaN,2.0718124551127306,71.8690990788469,-0.15652498115714097,1.1748931127730344,1.3314180939301754,326687149,332648070.2,72.43194094214604,84.48614372589388,NaN,NaN,27.575289912808366,34.202398019035975
2007-06-11T09:30:00-04:00,68.06,68.98,67.75,68.44,13796047,20098153.15,58.63227510844114,64.92917907173093,NaN,NaN,44.541683009694026,56.11817945862001,-0.17597190325471423,1.1114532148617826,1.2874251181164968,340483196,328711849.6,69.16424838827,83.11920594884238,NaN,NaN,25.894401173684674,33.015541326842936
2007-06-12T09:30:00-04:00,68.35001,68.7,67.60001,67.60001,20556976,20299762.5,53.28708993404406,63.58522471328056,NaN,NaN,7.532340276500184,34.404053655022615,-0.24427952781184814,0.9820757083516867,1.2263552361635348,319926220,323729417.4,65.15723874239727,81.35797407595132,NaN,NaN,22.7313688269038,31.54637382685163
2007-06-13T09:30:00-04:00,67.94,69.09,67.8,68.95,25245872,20759116.45,59.65322633708957,62.65612771877988,NaN,NaN,54.54949692373069,29.075008263375782,-0.1993151256652652,0.9772113290819533,1.1765264547472185,345172092,327593234.8,66.76525684137115,79.61528684717373,NaN,NaN,22.10103376876745,30.197039532839607
2007-06-14T09:30:00-04:00,69.13,70.42999,69.11,70.11,19201792,20846656.45,64.17156681545663,62.88147142000624,NaN,NaN,164.56558219995225,54.65218297299797,-0.09738155834533013,1.0547995068155558,1.152181065160886,364373884,339328508.2,71.12413449429764,78.14602650619426,NaN,NaN,23.141346353751395,29.189083364398435
2007-06-15T09:30:00-04:00,70.50999,71.19,70.42,70.98,16225496,20718578.45,67.14348962190779,62.96701736310356,NaN,NaN,224.0353245783595,99.04488539764732,0.016630481755592008,1.172969167355376,1.156338685599784,380599380,350110954.4,74.44104813076981,76.885016709234,NaN,NaN,25.023052778428678,28.593936137831328
2007-06-18T09:30:00-04:00,71.07001,71.41991,70.89,71.06,11637734,20238853.95,67.411180611636,63.333773553510106,NaN,NaN,196.83921516007584,129.50439182772368,0.08178251641081213,1.2585668311132991,1.176784314702487,392237114,360461738,77.15404382984653,76.20456342634554,NaN,NaN,26.56402913474948,28.30394942310535
2007-06-19T09:30:00-04:00,70.98,71.45,70.62,71.14,11434105,18542559.2,67.69462753888226,63.29484517869867,NaN,NaN,156.55079497385623,159.3080827671949,0.11270827001520778,1.3176696522214968,1.204961382206289,403671219,377210737.8,80.72025934040231,75.76494625976797,NaN,NaN,27.87321858406503,28.24241644609959
2007-06-20T09:30:00-04:00,71.11,71.33,68.8,69.07001,29625360,18768510.4,54.4886117313696,62.51565779403578,NaN,NaN,58.1291004870851,160.02400347986577,-0.016903749353386566,1.1838316955145558,1.2007354448679424,374045859,382985491.2,81.77649173371255,75.76275101844257,NaN,NaN,24.65612942708213,27.730089729097095
2007-06-21T09:30:00-04:00,69.53,70.51891,69.27,70.45,22857680,18667972.8,60.079783933106896,61.95859014893045,NaN,NaN,72.59428141172096,141.62974332221953,-0.020135067577221166,1.175566610396416,1.1957016779736371,396903539,389491422.2,82.91229404986046,75.82480318193082,NaN,NaN,23.84666804696809,27.175315203078664
2007-06-22T09:30:00-04:00,70.3,70.53,69,69.75,19855888,18251597.6,56.30137817147705,60.85957422357622,NaN,NaN,45.26429827116127,105.87553806077987,-0.07667823035595189,1.0998538900286974,1.1765321203846493,377047651,388781076.4,82.30909088139734,75.81450457109882,NaN,NaN,21.911588858815023,26.42335429675529
2007-06-25T09:30:00-04:00,69.3,70.14,68.85001,69.19,24926784,18846887.4,53.40764595706035,59.70088054809033,NaN,NaN,15.677738053026488,69.64324263937,-0.15456290032177522,0.9833284949824304,1.1378913953042056,352120867,380757827,75.61746071084957,75.28306852089209,NaN,NaN,19.402669525923862,25.420399329493655
2007-06-26T09:30:00-04:00,69.23,69.41,67.61,67.7,25825456,19110118.6,46.55183212300338,58.54565921792761,NaN,NaN,-73.45450879293873,23.64218188601102,-0.300739317676582,0.761967248208478,1.06270656588506,326295411,365282665.4,64.69276340988839,74.23885326465937,NaN,NaN,14.863192800955588,23.91222696827393
2007-06-27T09:30:00-04:00,67.45,69.03999,66.95,68.75,23701248,19331605,51.29647659240795,58.301441494325864,NaN,NaN,-74.30119458310448,-2.843877128026905,-0.31927455808580163,0.663613368277808,0.9828879263636097,349996659,360472825.4,61.70866202978763,73.28392382321398,NaN,NaN,12.713066875841546,22.312346955069305
2007-06-28T09:30:00-04:00,69.2,69.67999,68.50999,68.75,17256000,19359332.95,51.29647659240795,57.958261504877946,NaN,NaN,-21.417361855705657,-21.646205781512236,-0.3231159893838538,0.5789929396337925,0.9021089290176463,349996659,351091449.4,56.257845515323446,72.12863129272665,NaN,NaN,11.057117110052179,20.704456977209716
2007-06-29T09:30:00-04:00,69.14999,69.85001,68.63,68.99001,18234688,19675274.6,52.41627209824725,57.51426128986409,NaN,NaN,-8.780826696968528,-32.45523077513819,-0.30149292742876477,0.5252427697316904,0.8267356971604551,368231347,349328188.6,55.269663497340595,71.13616094337455,NaN,NaN,10.05760003668806,19.18347741427805
2007-07-02T09:30:00-04:00,69.11,70.21001,69.11,70.21001,16079930,19595873.5,57.735724693423364,57.832020915534045,NaN,NaN,43.682894554750156,-26.854199474793443,-0.20181489533789276,0.5744670779880892,0.7762819733259819,384311277,355766270.6,58.159512937087975,70.63632338585246,NaN,NaN,10.840710585857375,17.991653581646528
2007-07-03T09:30:00-04:00,70.25999,70.78,70.13,70.75,5299363,19094545.75,59.87391257853053,57.84778421849411,NaN,NaN,90.51203513046771,5.939109309887843,-0.10137547989753792,0.6495626234540595,0.7509381033515974,389610640,368429316.4,63.196068426918465,70.3813813562487,NaN,NaN,12.147973107429868,17.156842085329863
2007-07-05T09:30:00-04:00,70.8,71.16,69.86,70.58,16792064,18984880.15,58.86425987347901,57.46869086549571,NaN,NaN,80.09775691608515,36.81889960972577,-0.050802892158876234,0.6874344881530021,0.7382373803118784,372818576,372993699.8,64.83902622786488,69.93244505150349,NaN,NaN,12.91551993745989,16.55093892134844
2007-07-06T09:30:00-04:00,71,71.56,70.85001,71.53999,11526191,18553415.3,62.690372568280786,57.15061107595092,NaN,NaN,122.47876979653431,65.59812594017376,0.038092147445770275,0.7858525646190913,0.747760417173321,384344767,379863321.4,67.21143736713381,69.41604428267235,NaN,NaN,14.744056240283104,16.292812824053392
2007-07-09T09:30:00-04:00,71.48,72.44,71.3,72.21001,19157280,18461797.7,65.12828178583058,56.98754687410764,NaN,NaN,156.05767552182405,98.56582638393228,0.12775490489608798,0.907454048293431,0.779699143397343,403502047,386917461.4,69.48807841764564,68.86847532465801,NaN,NaN,17.03579494792769,16.398953127464008
2007-07-10T09:30:00-04:00,71.81,72.67,71.39999,71.57001,29375520,19240771.35,61.02632814378703,56.511239774457984,NaN,NaN,131.15963601701574,116.06117467638539,0.12930498788785605,0.9413303782571631,0.8120253903693071,374126527,384880511.4,68.01940249951366,67.96127126459452,NaN,NaN,17.768658708145136,16.594625353275596
2007-07-11T09:30:00-04:00,71.3,72.03,71.07001,71.84,27644880,19595166.55,62.11048607015851,57.05565937008577,NaN,NaN,103.5810351302441,118.67497467634067,0.13332521931769725,0.9786819145164287,0.8453566951987315,401771407,387312664.8,68.86556151688603,67.03906196339263,NaN,NaN,18.68710017615742,16.893550327973
2007-07-12T09:30:00-04:00,72.39999,73.39999,72.39999,73.23,31088656,19887305.75,67.17338372528324,57.562345069526934,NaN,NaN,170.68156259722556,136.79173581256876,0.20985549126778535,1.1076760592834631,0.8978205680156778,432860063,399320962.2,72.70543368835061,66.31000050899907,NaN,NaN,21.09533679078375,17.493805536945963
2007-07-13T09:30:00-04:00,73.17,74.32001,73.02,73.95,25483984,20201415.35,69.45050679884753,58.50156854291054,NaN,NaN,183.7353642834712,149.04305470995615,0.28458567067531004,1.2535526563598154,0.9689669856845053,458344047,414120818.2,76.5449219939203,65.89827415989357,NaN,NaN,23.840118527027524,18.400421678386188
2007-07-16T09:30:00-04:00,74.08,74.08,72.17999,73,26056464,20692963.75,63.21912112380229,59.20238819767782,NaN,NaN,125.37772765295541,142.9070651361824,0.24704598057570393,1.2777744614041353,1.0307284808284314,432287583,419877925.4,77.85018708547264,66.05775461522379,NaN,NaN,24.267932459414908,19.238637504247432
2007-07-17T09:30:00-04:00,73.33,73.75,72.03,72.05,24575808,21339867.45,57.64875397920493,59.99502547312079,NaN,NaN,91.00127451793072,134.8753928363654,0.14054253612226675,1.2064066509812648,1.065864114858998,407711775,426594975,79.29775269299114,67.10096813544541,NaN,NaN,22.870864445820917,19.75752706732936
2007-07-18T09:30:00-04:00,72.08,73.84,71.87,73.67999,37319568,22634140.6,63.578536640180765,60.87231547653313,NaN,NaN,102.81775268598079,134.72273634751275,0.1607256426409196,1.2667711681601475,1.1060455255192279,445031343,435246962.2,81.01851315450152,68.48024321578211,NaN,NaN,23.604008878696202,20.307024468953195
2007-07-19T09:30:00-04:00,74.2,74.48,73.88,74.35001,18845904,22095167.8,65.7042301636925,61.90144073162488,NaN,NaN,132.34978269440347,127.05638036694832,0.19762602420174202,1.3530780557714053,1.1554520315696633,463877247,441450399,82.16328509074428,70.33063175688359,NaN,NaN,24.896873594452945,20.962717201167443
2007-07-20T09:30:00-04:00,74.3,74.73,73.42999,74,20082736,21956420.6,63.61549425313921,62.70138517126003,NaN,NaN,110.83987632543648,112.47728277534138,0.17752372960643714,1.3773566935777097,1.1998329639712726,443794511,438540491.8,79.73407993819924,72.07809007408778,NaN,NaN,25.28310088102922,21.579914869719126
2007-07-23T09:30:00-04:00,74.05,74.64,73.39999,74.3,15216711,21724461.75,64.65271628586737,63.19545599929173,NaN,NaN,102.1036477509806,107.82246679494642,0.16382456459096106,1.404613669709974,1.240789105119013,459011222,443885219.6,80.8537772659894,73.6991089547236,NaN,NaN,25.90844780102256,22.198276717048188
2007-07-24T09:30:00-04:00,73.64999,73.64999,71.77,72.14999,25113232,21733784.15,52.99322697606167,62.70397845625825,NaN,NaN,35.92594740041495,96.80740137144326,-0.0018704138371330448,1.2384510878225967,1.2403215016597298,433897990,449122462.6,81.90857435908303,75.03571652130678,NaN,NaN,22.59986318073403,22.25564621186045
2007-07-25T09:30:00-04:00,72.61,73.41,71.03999,73.3,32680512,22076536.95,57.41683382994777,62.6005908817203,NaN,NaN,32.86214990587441,82.81628081542199,-0.043543588893801166,1.1858920155424784,1.2294356044362795,466578502,453431894.4,82.75066741069539,76.31511946293755,NaN,NaN,21.296674423133158,22.118650242042268
2007-07-26T09:30:00-04:00,72.2,72.36,69.17999,70.53999,39764768,22879712.95,46.183750003449255,61.421546412803764,NaN,NaN,-64.92433299639747,43.3614576772618,-0.25472682083402853,0.9110270783937437,1.1657538992277723,426813734,446019191.8,76.18194935484644,76.95587031920273,NaN,NaN,15.892540691564136,21.22920602054539
2007-07-27T09:30:00-04:00,70.64999,70.99001,68.5,68.5,42547456,24144285.75,39.96080386683456,59.62386941858977,NaN,NaN,-136.13518852380648,-6.033555292586792,-0.5145545302386769,0.5225607364294262,1.0371152666681032,384266278,434113545.2,66.9849259479895,76.7770737142273,NaN,NaN,8.982157155992299,19.479627611323522
2007-07-30T09:30:00-04:00,69.19,70.11,68.105,69.67999,32400592,24852580.95,44.609953751867245,58.451271247738354,NaN,NaN,-138.86107728830672,-54.22650030044425,-0.5845866828482773,0.30638191310775653,0.8909685959560338,416666870,425644674.8,61.31450117653581,76.29815219115744,NaN,NaN,5.265648019900078,17.44905909826303
2007-07-31T09:30:00-04:00,70.64999,70.98,69,69,22764032,25186786.05,42.56447558409758,57.05512764159114,NaN,NaN,-119.0285926039132,-85.21740830130987,-0.6493546432948805,0.07927529183743331,0.7286299351323138,393902838,417645644.4,56.4534979224686,75.41157622012763,NaN,NaN,1.6654733337222394,15.194261131900062
2007-08-01T09:30:00-04:00,68.67,70.17,67.21001,68.82001,43085504,27076093.1,42.01531265910348,55.25812256543544,NaN,NaN,-150.25099418661605,-121.84003711980797,-0.6740390240756676,-0.11391884496227078,0.5601201791133968,350817334,394493410.8,45.26719598075891,73.4517020981568,NaN,NaN,-1.28741194497292,12.839736406632493
2007-08-02T09:30:00-04:00,68.99001,69.5,67.48,68.35001,34138288,27943404.3,40.54429515148816,53.19339316205264,NaN,NaN,-146.31070535852183,-138.11731159223285,-0.6892772870441599,-0.3014764296918031,0.3878008573523568,316679046,372466473.2,37.627925812486474,70.67191665662581,NaN,NaN,-4.126305990422392,10.416016064196082
2007-08-03T09:30:00-04:00,68.28999,69.17,66.00999,66.12,34070016,29070595.55,34.39170982116214,51.1342923547212,NaN,NaN,-167.379917267307,-144.36625734093295,-0.8085448155768832,-0.6228801621187472,0.185664653458136,282609030,352135023.6,32.222537270056534,67.41279881266752,NaN,NaN,-8.768227560537445,7.675409832091293
2007-08-06T09:30:00-04:00,66.28,66.71001,64.23,66.5,54607136,30843088.35,36.16924952826173,49.60004203679669,NaN,NaN,-171.98339738878414,-150.99072136102842,-0.8183560935302945,-0.8372804634547322,-0.01892436992443769,337216166,336244882.8,28.74677651778873,63.80201480015306,NaN,NaN,-11.879398308087572,4.881865812065741
2007-08-07T09:30:00-04:00,65.99001,68.64,65.75999,68.06,38243504,31286487.55,42.99708912532821,48.12993864287865,NaN,NaN,-103.59114663542181,-147.90323216733015,-0.6818779483594513,-0.8712718053737518,-0.18939385701430053,375459670,332556249.2,27.991952367844675,60.01440331539186,NaN,NaN,-12.335950694808528,2.422177739655132
2007-08-08T09:30:00-04:00,68.64999,70.09,68.16,69.35001,30247312,31416609.15,47.954862611834265,46.86212667488877,NaN,NaN,-49.09122002485627,-127.67127733497821,-0.47653883004080183,-0.7850673945653028,-0.308528564524501,405706982,343534178.8,33.58160259913771,56.54428313741995,NaN,NaN,-11.084994847187229,0.49258165582050895
2007-08-09T09:30:00-04:00,67.60001,69.23599,67.3,67.36,32535840,31488968.35,41.90065482417109,45.311066715676766,NaN,NaN,-76.09388612140332,-113.62791348755448,-0.4470402889885746,-0.8673289257602192,-0.42028863677164463,373171142,354832598,38.843341252379226,53.623516088432815,NaN,NaN,-12.0449481275905,-1.2984940275239207
2007-08-10T09:30:00-04:00,66.89,68.44,65.63,67.72,27683792,31598958.75,43.29533737537128,43.78553965064133,NaN,NaN,-87.15501118583548,-97.58293227126016,-0.37831053404114523,-0.8931768043230761,-0.5148662702819309,400854934,378481778.8,48.10971906685703,51.284654788494784,NaN,NaN,-12.34882569294105,-2.877112836869225
2007-08-13T09:30:00-04:00,68.66,69.42,67.57001,67.8,19688400,31280555.55,43.61923462979363,43.115968768765036,NaN,NaN,-54.095354147282315,-74.00532362295979,-0.305601041221505,-0.8968675718088122,-0.5912665305873072,420543334,395147212.4,53.46111878811197,49.25269367628257,NaN,NaN,-12.490954094654844,-4.250518730838599
2007-08-14T09:30:00-04:00,68.39,68.58,67,67.35001,20305488,31067039.55,42.16044963082923,42.02622704025657,NaN,NaN,-67.07793665337758,-66.702681626551,-0.26733487462129046,-0.9254351238639202,-0.6581002492426298,400237846,400102847.6,54.948950056177296,47.26685672238842,NaN,NaN,-13.031762858365333,-5.504982177628133
2007-08-15T09:30:00-04:00,67.39,67.97,65.39,65.5,26081840,30505153.15,36.72286858639555,41.35044979618131,NaN,NaN,-102.51226054831584,-77.38688973124292,-0.3413997887447803,-1.084849985173605,-0.7434501964288248,374156006,393792652.4,52.64118522856513,45.58537357051119,NaN,NaN,-15.202957729290015,-6.890407256436973
2007-08-16T09:30:00-04:00,64.33,65.45,62.73,65.10001,42047312,31665223.55,35.65222028674373,41.04269382617482,NaN,NaN,-153.4601184868974,-92.86013620434173,-0.38867403480088547,-1.2292927399299316,-0.8406187051290461,332108694,385580162.8,49.71478043678852,44.351791748282544,NaN,NaN,-17.293412088346578,-8.37655080385263
2007-08-17T09:30:00-04:00,67.14999,67.67,65.82001,67.5,30948672,32208520.35,45.85292579163039,41.13147754330076,NaN,NaN,-63.05984789590662,-88.04110354635597,-0.23710416595641826,-1.136998912574569,-0.8998947466181507,363057366,378020649.2,47.118203658695045,43.3377704970082,NaN,NaN,-15.910753556632551,-9.45286548282119
2007-08-20T09:30:00-04:00,67.19,67.91,65.95,67.35001,32988304,33097100,45.36887359372128,41.33179168684531,NaN,NaN,-54.88631709303338,-88.19929613550617,-0.13104155915140825,-1.063696695557411,-0.9326551364060027,330069062,359925794.8,41.527149626460414,42.27160276157905,NaN,NaN,-14.964170965793217,-10.24019483753148
2007-08-21T09:30:00-04:00,67.06,67.59,66,66.39999,20416208,32862248.8,42.3213977407762,41.353654906964785,NaN,NaN,-66.84078933660565,-88.15186667215178,-0.10981937504318096,-1.069929355209979,-0.9601099801667979,309652854,341808796.4,36.81666830922525,41.66799364218378,NaN,NaN,-15.083770586940595,-10.93213423030421
2007-08-22T09:30:00-04:00,67.2,67.47,66.64,67.2,18119456,32134196,45.633192814939555,41.71714759721131,NaN,NaN,-38.301834614138656,-75.30978148531635,-0.030952899427399427,-0.9988011044510472,-0.9678482050236478,327772310,332532057.2,34.649353101131936,41.45523844851561,NaN,NaN,-14.184287589334646,-11.39672756730856
2007-08-23T09:30:00-04:00,67.53999,68.06,66.94,67.8,17983424,31045128.8,48.042740272524526,42.69222120088005,NaN,NaN,-1.158951837571931,-44.84954815545127,0.06721596735610968,-0.8838282458285107,-0.9510442131846204,345755734,335261465.2,35.84598136303764,41.714055883728534,NaN,NaN,-12.719760272645988,-11.58573223949962
2007-08-24T09:30:00-04:00,68.10001,69.5,67.95,69.25,15634500,29699481,53.416022566847275,43.92413356077902,NaN,NaN,89.18626782032487,-14.400325012204974,0.2264288402199588,-0.6680081629096719,-0.8944370031296307,361390234,334928038.8,35.75983814020299,42.214988856758126,NaN,NaN,-9.771862348392578,-11.326607969341472
2007-08-27T09:30:00-04:00,68.92,68.95,68.17,68.39999,10691672,28614035,50.142324662891106,44.43450752774779,NaN,NaN,67.74505133975684,10.125948674353067,0.2682593695077393,-0.5591127912449565,-0.8273721607526958,350698562,339053938.8,37.753266377036425,42.9122255717004,NaN,NaN,-8.268873536268169,-10.889788764616714
2007-08-28T09:30:00-04:00,68,68.25,66.75,66.75,19639440,28457805.4,44.447779011556555,44.18400155629939,NaN,NaN,-14.770998534767333,20.539906834720725,0.18265982238174894,-0.5990473827755096,-0.7817072051572586,331059122,343335192.4,39.83940443378543,43.35921141703238,NaN,NaN,-8.72665178792909,-10.580769196518482
2007-08-29T09:30:00-04:00,67.24001,69.25,67.16,68.96001,27364608,27671760.6,52.26711552396564,44.924463034856146,NaN,NaN,83.65559058937656,44.931391875423806,0.26759670545002145,-0.4472113233447317,-0.7148080287947531,358423730,349465476.4,42.79571052798972,43.64152350814741,NaN,NaN,-6.514969275544772,-9.99994063637938
2007-08-30T09:30:00-04:00,68.56,69.37,68.22,68.92,16872192,26808455.8,52.12407278561214,45.55508699273049,NaN,NaN,110.16001595599313,67.19518543413682,0.3107690603984027,-0.32634670329674975,-0.6371157636951524,341551538,348624637.2,42.487311104551026,43.239922939411265,NaN,NaN,-4.838782101785219,-9.2626322742945
2007-08-31T09:30:00-04:00,69.74001,70.3,68.92999,69.83,13319500,25770930,55.131767601221576,46.37741077640391,NaN,NaN,150.86493704808552,79.53091927968894,0.3854201653019369,-0.1553405570677313,-0.5407607223696682,354871038,347320798,41.98209959287832,42.41999299689458,NaN,NaN,-2.501931538396555,-8.296817883451936
2007-09-04T09:30:00-04:00,69.60001,71.58,69.41,71.10001,15895750,23835360.7,59.00275432001251,47.580432539917005,NaN,NaN,188.7802354120878,103.73795609415515,0.49798475319026886,0.08172021911816785,-0.416264534072101,370766788,351334443.2,44.18241364438798,41.65095468176677,NaN,NaN,0.7206035546707368,-7.0086148208629835
2007-09-05T09:30:00-04:00,71,71.08,70.38,70.72,16364301,22741400.55,57.40680653989365,49.057856679452584,NaN,NaN,159.68069505865944,138.6282948128405,0.5219765263690667,0.23620612388923234,-0.2857704024798343,354402487,356003116.2,46.71390094314619,41.227577232808265,NaN,NaN,2.8657768922944915,-5.597987433269059
2007-09-06T09:30:00-04:00,71.39999,72.25,71.03,71.8,18007584,22129414.15,60.663352065841046,50.84436609224525,NaN,NaN,186.32177549613297,159.1615317941918,0.5811796240957908,0.4407041276399042,-0.1404754964558866,372410071,358800384.4,48.228917167067046,41.12144414211388,NaN,NaN,5.697037170451347,-3.9844124898804294
2007-09-07T09:30:00-04:00,70.96001,71.07001,70.08,70.25999,20089264,21507085.35,54.28929927576501,51.44696419825487,NaN,NaN,107.06443287138484,158.54241517727013,0.490821430378351,0.47305129151705216,-0.017770138861298843,352320807,360954238.2,49.42135928012785,41.28595525793052,NaN,NaN,6.202676320052788,-2.529114088461398
2007-09-10T09:30:00-04:00,70.53,70.62,68.78,70.14999,30897072,21667749.35,53.85402674460933,52.05304656617544,NaN,NaN,69.83000029024551,142.3354278257021,0.40159905860501,0.4842286843949637,0.08262962578995367,321423735,354264777.6,45.88633054211146,41.597325323334154,NaN,NaN,6.479084310387366,-1.2422286029115748
2007-09-11T09:30:00-04:00,70.2,71.50999,69.67999,71.35001,27076128,22037135.75,57.82655157872991,53.16055755460071,NaN,NaN,102.4922391874491,125.07782858077437,0.4004528726477661,0.5831957165996613,0.1827428439518952,348499863,349811392.6,43.647989136645066,42.085276811007006,NaN,NaN,7.909839819225353,0.06520974310798633
2007-09-12T09:30:00-04:00,71.14999,72.28999,71.14999,71.85001,24035904,22223656.55,59.3950288181093,54.1435458405414,NaN,NaN,123.70207240280202,117.88210404960289,0.408984864476944,0.6939739245480752,0.2849890600711312,372535767,353438048.6,45.959843142836625,42.893168956843056,NaN,NaN,9.55713338133908,1.4211988342838566
2007-09-13T09:30:00-04:00,71.96001,72.74001,71.87,72.3,15237539,21681441.5,60.807751220726985,55.05533233684157,NaN,NaN,129.04123872189408,106.42599669475513,0.4190120089322551,0.80875407123645,0.38974206230419495,387773306,356510695.6,47.90968314277844,43.754861941110256,NaN,NaN,11.337881958731872,2.8378678520621445
2007-09-14T09:30:00-04:00,71.82001,72.96001,71.8,72.5,14026609,20280406.35,61.4497244652638,55.62916818672847,NaN,NaN,122.0723218582929,109.42757449213673,0.4125418557027379,0.9054193819326173,0.4928775262298794,401799915,366406517.2,53.7033771942182,45.03654330211134,NaN,NaN,12.992824955071308,4.288576009634882
2007-09-17T09:30:00-04:00,72.35001,73.14999,72.14999,72.64999,13479809,19406963.2,61.953055286843025,56.47279180272504,NaN,NaN,118.87985735651037,119.2375459053897,0.39193890430856004,0.9828011566155794,0.5908622523070194,415279724,385177715,62.274832215940336,46.78808371917591,NaN,NaN,14.512382568117246,5.749119803703791
2007-09-18T09:30:00-04:00,72.89,75,72.27,74.85001,18643600,18689728,68.45825659208211,58.18782591561972,NaN,NaN,154.09366310022162,129.5578306879442,0.4934926468915136,1.2077280609214114,0.7142354140298978,433923324,402262407.2,68.06929979481453,48.804504816392274,NaN,NaN,17.931980273566978,7.489528442255675
2007-09-19T09:30:00-04:00,75.32001,76.03,75.00999,75.5,19370304,18637432.8,70.08562406002686,59.460576525338375,NaN,NaN,186.94012603225312,142.20544141383442,0.5662441606822562,1.422040614882718,0.8557964542004618,453293628,418413979.4,72.38730774430772,50.91819033184356,NaN,NaN,21.298819504419107,9.462284308279022
2007-09-20T09:30:00-04:00,75.34,75.74001,74.92999,75.45,16293000,18546110,69.78734372896417,60.72223873557781,NaN,NaN,160.0202119769899,148.40123606485358,0.5711669294115127,1.5697551159648526,0.9985881865533399,437000628,428259443.8,74.6387067859325,53.21471859479938,NaN,NaN,23.9583934275823,11.533157039608062
2007-09-21T09:30:00-04:00,76.08,76.3,75.64999,75.7,12222199,18258048.75,70.46420402379292,61.81741276576147,NaN,NaN,152.99993579165897,154.58675885152678,0.5511613893040885,1.6875399231834507,1.1363785338793622,449222827,437744026.2,76.61666396862128,55.68861605020959,NaN,NaN,26.376852093707193,13.653684904479366
2007-09-24T09:30:00-04:00,75.8,75.92999,75.05,75.56,17839872,18368317.35,69.524863658397,62.5689920042175,NaN,NaN,123.98251896437978,155.6072911731007,0.49043489444585786,1.7494221519366846,1.2589872574908267,431382955,440964672.4,77.26507225631342,58.05166309391854,NaN,NaN,28.165525458255548,15.726804983590249
2007-09-25T09:30:00-04:00,74.58,74.64,73.88,74.32001,17468816,18707174.55,61.68179096119828,62.87434803431069,NaN,NaN,76.01263194663304,139.99108494238297,0.3360520849000206,1.6790523636158525,1.343000278715832,413914139,436962835.4,74.50065719575977,60.03643139767666,NaN,NaN,27.62715438114906,17.42685489752722
2007-09-26T09:30:00-04:00,75.03999,75.32001,73.69,74.53,20665968,18758500.95,62.45424395855888,63.002268883790535,NaN,NaN,75.5977242787063,117.7226045916736,0.22282871921873015,1.6215361777392445,1.3987074585205144,434580107,433220131.2,71.90936560740043,61.72789200055761,NaN,NaN,27.381225089785215,18.848907782135505
2007-09-27T09:30:00-04:00,75.25999,75.58,74.871,75.5,12593039,18019922.5,65.87625461244323,63.829908550696125,NaN,NaN,92.1782281193102,104.15420782013766,0.18933284243590087,1.6353735115653905,1.4460406691294896,447173146,435254634.8,72.46992447323237,63.37421808577936,NaN,NaN,28.10890081589149,20.171763929814933
2007-09-28T09:30:00-04:00,75.83,76.10001,74.62,74.8,17413008,18046963.3,61.51873932343588,64.3773880206123,NaN,NaN,77.75358470708723,89.1049376032233,0.10055749390524937,1.5717375365110513,1.471180042605802,429760138,431362097,69.60787514625731,65.06861412893262,NaN,NaN,27.50120819553977,21.218827396347052
2007-10-01T09:30:00-04:00,74.75,76.14,74.67999,76.10001,19443360,18353156.3,66.01480935284198,64.96226357590602,NaN,NaN,84.83004150590556,81.27444211152847,0.10919456883135004,1.6076732536449896,1.4984786848136395,449203498,434926205.6,70.74705342942485,67.0042615784169,NaN,NaN,28.28060529365602,22.227652810248333
2007-10-02T09:30:00-04:00,75.52,75.59,74.25999,74.91,21891424,18652940,59.19661677803778,64.94809128732949,NaN,NaN,53.818260144525524,76.83556775110698,0.01927895807876423,1.522577382412095,1.5032984243333307,427312074,437605792.6,71.60867759469818,68.8363211821213,NaN,NaN,26.844269126256652,22.88716942682095
2007-10-03T09:30:00-04:00,74.41,74.85001,73.94,74.47,21925392,18930994.55,56.858273295731394,64.66598572125837,NaN,NaN,30.94556359418507,67.90513561420273,-0.07987409648558841,1.4034558037263452,1.4833299002119336,405386682,431767107.6,66.97931875890495,70.19843801184462,NaN,NaN,24.94820835902002,23.181603559992247
2007-10-04T09:30:00-04:00,74.14999,75.03999,73.5,74.75,15562301,18808730.4,57.995373110290366,64.41924633876027,NaN,NaN,27.564575079980038,54.98240500633669,-0.13348846773772527,1.316469315539777,1.4499577832775024,420948983,426522275,63.03699776988652,70.86512519582092,NaN,NaN,23.7121101542441,23.25739021631394
2007-10-05T09:30:00-04:00,75.11,75.28,74.08,75.11,16155602,18612047.3,59.47434612201346,64.24219568412958,NaN,NaN,39.787904158195026,47.38926889655826,-0.15033986026075286,1.2620329579515612,1.412372818212314,437104585,427991164.4,63.68172879940482,70.96561780892553,NaN,NaN,23.08989159236105,23.233461841463527
2007-10-08T09:30:00-04:00,74.53,74.82001,74.14,74.35001,13094500,17721918.7,55.06636630325258,63.28563209207034,NaN,NaN,13.24811832167885,33.072884259712914,-0.214398042438946,1.1443752651636316,1.3587733076025776,424010085,422952481.8,59.826772187087805,70.37686583694504,NaN,NaN,21.269224011078496,22.952856437122808
2007-10-09T09:30:00-04:00,74.7,75.86,74.67,75.85001,17951136,17265669.1,61.181631122903525,62.649632596561524,NaN,NaN,73.2497689877853,36.95918602836486,-0.1599705515063321,1.1588101182196624,1.3187806697259945,441961221,425882311.2,61.29398504350929,69.58448564403088,NaN,NaN,21.470601014659724,22.741105662485225
2007-10-10T09:30:00-04:00,74.73,77,74.73,76.83,21954800,17161613.9,64.57384206747957,62.277239620741206,NaN,NaN,119.49441897509327,54.66895710454649,-0.06695293324489637,1.235089503169874,1.3020424364147705,463916021,437588179,66.55043816132984,69.00675217084498,NaN,NaN,22.707533474394857,22.73630963561517
2007-10-11T09:30:00-04:00,77.39999,78.09,75.67999,76.45,32360640,18017768.95,62.300404305802445,61.69411106945616,NaN,NaN,155.0862565037219,80.17329338929487,-0.041262693379671145,1.2504640696901816,1.2917267630698528,431555381,439709458.6,67.4140599157222,68.34942330992361,NaN,NaN,23.0311171106795,22.77842498919579
2007-10-12T09:30:00-04:00,76.53999,77.42,76.49001,77.17,13934320,18013154.5,64.82718284545447,61.358562439960274,NaN,NaN,168.85062878067245,105.98583831379035,0.011174801454268746,1.3056952648876887,1.29452046343342,445489701,441386481.8,68.1149439445773,67.69584271622817,NaN,NaN,24.070543421757844,22.963013336704655
2007-10-15T09:30:00-04:00,77.85001,78.41,77.49001,77.8,18757184,18277023.25,66.91663712218443,61.73248002288785,NaN,NaN,225.61728668575049,148.4596719866047,0.0718590380175741,1.3843442609553875,1.3124852229378134,464246885,449433841.8,71.30449014584255,67.46754506980552,NaN,NaN,25.577886761503027,23.336566683104422
2007-10-16T09:30:00-04:00,77.7,78.39,77.59,78,20022800,18345983.25,67.57517013764298,62.098260464251,NaN,NaN,193.3759663873194,172.4849114665115,0.106925627849497,1.4461422577496847,1.3392166299001877,484269685,457895534.6,74.22421617149996,67.63289153866977,NaN,NaN,27.00448341622053,23.860554787835294
2007-10-17T09:30:00-04:00,78.39,78.5,76.83,77.5,23220352,18538485.65,64.13794756737856,61.974095675317805,NaN,NaN,134.36526037661648,175.45907974681614,0.07918125461562076,1.4381931981697136,1.3590119435540928,461049333,457322197,73.67720130552834,67.71912559811948,NaN,NaN,27.239082706734614,24.34320163339234
2007-10-18T09:30:00-04:00,77.5,78.17,77.25999,78.10001,21221856,18784928.45,66.34992031346451,62.319180031748424,NaN,NaN,126.50334053602671,169.7424965532771,0.0835421907530769,1.463439681995439,1.379897491242362,482271189,467465358.6,76.91814719517807,68.24128788732811,NaN,NaN,28.072980674735092,24.87602721072702
2007-10-19T09:30:00-04:00,77.45,77.46001,74.39999,74.39999,33434432,19845540.1,47.0695634732193,60.96594818320394,NaN,NaN,-22.318866092160242,131.50859757871058,-0.16681077315459025,1.1713840247991243,1.3381947979537145,448836757,468134769.8,77.11837797466143,68.69638249770215,NaN,NaN,21.961366729366596,24.459647141961245
2007-10-22T09:30:00-04:00,73.59,73.96001,72.67,73.55,31265504,20516821.7,43.912676734578504,59.87423818009971,NaN,NaN,-131.59858701779913,60.06542283800064,-0.38142710702095095,0.8614109141775259,1.2428380211984769,417571253,458799643.4,68.22954840140426,68.4550161267526,NaN,NaN,15.960791505324856,23.245524908156046
2007-10-23T09:30:00-04:00,74.11,74.89999,73.32001,74.60001,21291200,20707940.9,48.50709496075884,59.27772544188739,NaN,NaN,-80.83768967283116,5.2226916259705405,-0.44027095986782294,0.6924993213636981,1.132770281231521,438862453,449718197,60.878184972737536,68.01922085631205,NaN,NaN,12.641254448689587,21.730629128232266
2007-10-24T09:30:00-04:00,74.44,75.39,73.69,75.09,23171232,20833204.1,50.543065416814684,58.74541774949626,NaN,NaN,-55.86405976002063,-32.823172401356885,-0.4331306489409872,0.591356970055287,1.0244876189962742,462033685,449915067.4,60.976344718828116,67.87203135266502,NaN,NaN,10.684976966552613,20.15267881942089
2007-10-25T09:30:00-04:00,75.64,76.25999,74.94,75.8,20061552,21206629.75,53.41718991659481,58.3127637348235,NaN,NaN,-2.1888461549413933,-58.56160973955051,-0.36997933280529105,0.5620134529896603,0.9319927857949514,482095237,449879877,60.94690764960494,67.67668698482218,NaN,NaN,10.013704582954846,18.704253928497167
2007-10-26T09:30:00-04:00,76.89999,77.42999,76.42,76.95,15778008,21124879.75,57.70460599366892,58.501209426996105,NaN,NaN,63.954383194229074,-41.30695988227265,-0.2461088702442491,0.62435669798964,0.8704655682338891,497873245,459687174.6,65.88926451026114,68.10972215076313,NaN,NaN,10.849216414400372,17.582105712197624
2007-10-29T09:30:00-04:00,77,77.64999,77,77.32001,9664352,20635929.35,59.01176806603253,58.34621920864817,NaN,NaN,76.13961755490212,0.2406810322676023,-0.1398905250659649,0.695602411901433,0.8354929369673979,507537597,477680443.4,72.71246804419089,68.92532807938325,NaN,NaN,11.931352044832318,16.774855188288296
2007-10-30T09:30:00-04:00,76.81,76.81,74.69,74.69,24770368,20779876.55,47.722029406695945,57.142518304306485,NaN,NaN,-26.937865408825616,11.020645885068712,-0.24143975525930705,0.5336932428932641,0.7751329981525712,482767229,486461398.6,75.30823529728234,69.55088501766556,NaN,NaN,9.015935968124959,15.66643815683639
2007-10-31T09:30:00-04:00,75.5,76.92999,75.07001,76.7,29284592,21147836.55,54.83386249394602,56.60919388917388,NaN,NaN,13.613823360587785,24.916222509190394,-0.1712254097888033,0.561101235916567,0.7323266457053703,512051821,496465025.8,77.88879719532498,70.2990805376372,NaN,NaN,9.092628311478162,14.727322464642358
2007-11-01T09:30:00-04:00,75.57001,76.75999,74.39,74.45,22246560,21482049.5,47.10828011180378,55.343557979627406,NaN,NaN,-48.07482671154817,15.739026397869035,-0.268506725237887,0.3966932391580116,0.6651999643958986,489805261,498007030.6,78.26586326668499,71.02414620350201,NaN,NaN,6.2529514715076635,13.516698037051686
2007-11-02T09:30:00-04:00,74.75,75.88,74.16,75.85001,28034576,22075998.2,51.67099706040162,54.254583689500066,NaN,NaN,-44.763307329176094,-6.004511706811996,-0.23212433646435993,0.3750445438154486,0.6071688802798085,517839837,502000349,79.25260080063416,71.59186839313,NaN,NaN,5.669666626142577,12.395693549778956
2007-11-05T09:30:00-05:00,74.97,75.8,74.39,75.24001,24835264,22663036.4,49.66082536978987,52.97498763465342,NaN,NaN,-57.74365910170251,-32.78116703813292,-0.24161643645232456,0.30514833471440284,0.5467647711667274,493004573,499093744.2,76.52912977731116,71.75650507925937,NaN,NaN,4.521411035323071,11.27079604771383
2007-11-06T09:30:00-05:00,76.00999,77.75,76.00999,77.75,18133072,22672133.2,57.062789503004424,52.469619201483845,NaN,NaN,60.11223871376172,-15.371146213615456,-0.0797030200260046,0.4471359961342216,0.5268390161602262,511137645,504767827.4,78.11052009402262,72.07317070700896,NaN,NaN,6.230101290834026,10.550696796731001
2007-11-07T09:30:00-05:00,77.7,77.7,74.55,74.55,29903424,23069564.4,47.47775406695924,51.12160732673346,NaN,NaN,-32.02903756860671,-24.499718399454355,-0.1830602783435114,0.29801366823083697,0.4810739465743484,481234221,498604307.4,72.40376997784445,71.75071519148513,NaN,NaN,4.010707069427601,9.616412549973372
2007-11-08T09:30:00-05:00,75.14,77.16,74.62,75.85001,37162784,23309671.6,51.0733247252113,51.40759027330432,NaN,NaN,-13.455627945534438,-17.575878646251606,-0.15966854141293563,0.28148826980817887,0.4411568112211145,518397005,504322656.2,74.28117093497555,71.54805754579327,NaN,NaN,3.625799240412712,8.760610648607564
2007-11-09T09:30:00-05:00,74.89,75.7,74.39,74.45,28463008,24036106,47.31661743878908,51.650728895033645,NaN,NaN,-68.98943926720683,-22.421105033857753,-0.23000427505733817,0.1536514673994418,0.38365574245677997,489933997,498741488.2,69.32404118093346,71.62623560147392,NaN,NaN,1.9691827297036286,7.790406660192716
2007-11-12T09:30:00-05:00,73.25999,73.75999,70.85001,70.85001,31765488,24686521.2,39.30966253332542,50.993769435931256,NaN,NaN,-224.67125937728994,-55.80662508897524,-0.4952728138509985,-0.23543527485696814,0.25983753899403034,458168509,491774275.4,63.61660941979665,71.82183734769244,NaN,NaN,-2.5536460375951857,6.312684846223016
2007-11-13T09:30:00-05:00,71.45,73.35001,70.67,73.35001,28001440,25085453.2,46.1274662226207,50.67836949348883,NaN,NaN,-170.3467473509234,-101.89842230191228,-0.4783997052599115,-0.33816209258085905,0.14023761267905244,486169949,486780736.2,59.815546961348325,71.73892322215816,NaN,NaN,-3.600783335258987,4.896475106011302
2007-11-14T09:30:00-05:00,74.10001,74.53,72.64,73.24001,22113296,25030100.4,45.88322652724799,50.140229251392626,NaN,NaN,-100.43331938305798,-115.57927866480252,-0.45104392717942765,-0.42356729629523215,0.02747663088419551,464056653,483345222.6,57.27981141557778,71.47698777687052,NaN,NaN,-4.45963685994363,3.5598876823034544
2007-11-15T09:30:00-05:00,72.56,73.09,70.59,70.8,29054208,25421718,40.73131195042301,48.92785110544649,NaN,NaN,-179.29437370649597,-148.74702781699483,-0.566219624561257,-0.6802978998173757,-0.11407827525611873,435002445,466666310.6,46.88758748475591,70.11972513219156,NaN,NaN,-7.001190382594453,2.0511622444608966
2007-11-16T09:30:00-05:00,71.69,72.84,71.47,72.66,25440864,25022039.6,45.73342114273605,47.97939775378246,NaN,NaN,-115.50157332077389,-158.04945462770826,-0.48898646744232843,-0.7253113595590293,-0.23632489211670085,460443309,460768173,43.85732060764013,68.05864317243794,NaN,NaN,-7.323977933368868,0.7118565047709304
2007-11-19T09:30:00-05:00,72.35001,72.77,71.22,71.45,17765520,24347040.4,43.180304459488866,47.654988828981956,NaN,NaN,-126.87575082531505,-138.49035291731326,-0.49000958646831616,-0.848836875202096,-0.3588272887337799,442677789,457670029,42.31049112691475,65.7016614459831,NaN,NaN,-8.440119652539435,-0.5955686605591217
2007-11-20T09:30:00-05:00,72.39,74.21001,72,73.75,28190576,24692009.2,49.0076304701295,47.23882939870935,NaN,NaN,-55.13841787817491,-115.44868702276355,-0.3149117587496547,-0.7524669871708483,-0.43755522842119354,470868365,454609712.2,40.780454332023886,63.0510655271759,NaN,NaN,-7.38947211679534,-1.5661262971642957
2007-11-21T09:30:00-05:00,73.11,73.71001,72.13,72.14999,19768800,24521887.6,45.510875897569996,47.124729097692644,NaN,NaN,-73.59540250474049,-110.08110364710005,-0.28677543057288735,-0.7960245166373028,-0.5092490860644154,451099565,452018294.6,39.47857428825559,60.280544885859506,NaN,NaN,-7.698207752382255,-2.442137933624004
2007-11-23T09:30:00-05:00,72.25,74.05,72.25,74.05,6871109,23862365.45,50.067109924819825,47.010165730865374,NaN,NaN,-37.55452577090462,-81.7331340599818,-0.12820995707762628,-0.6695115324114482,-0.541301575333822,457970674,456611940.4,42.955062817300515,57.68786360133567,NaN,NaN,-6.430690582088711,-3.011931169118962
2007-11-26T09:30:00-05:00,74.03999,74.25999,71.49001,71.49001,25314432,24339186.65,44.649810040185706,46.65223606446508,NaN,NaN,-71.08897002179143,-72.85061340018531,-0.18054085046721602,-0.766977638417842,-0.5864367879506259,432656242,451054527,39.964160513923936,55.0760800825223,NaN,NaN,-7.188562233713683,-3.608592749775351
2007-11-27T09:30:00-05:00,70.60001,71.32001,69.61,70.7,28764432,25294190.65,43.09997189855701,45.65489194986169,NaN,NaN,-134.07656677095324,-74.29077658931294,-0.2489467512526109,-0.8976202270163895,-0.6486734757637787,403891810,443297331.2,36.17760431967536,52.08087181292607,NaN,NaN,-8.290708457273151,-4.277466422275037
2007-11-28T09:30:00-05:00,71.95,72.66,71.16,72.45,22973248,25204334.65,47.45127240370626,45.65300040248649,NaN,NaN,-65.15046925921138,-76.29318686552024,-0.16117730061811852,-0.8501451015364268,-0.6889678009183082,426865058,434496669.8,32.42410028122387,49.22518112031031,NaN,NaN,-7.809957848028665,-4.782108054525555
2007-11-29T09:30:00-05:00,72.75,73.7,72.47,73.25,19748368,24727523.45,49.357853671330304,45.53046675578071,NaN,NaN,-16.749185237742545,-64.92394341212065,-0.04038060992324777,-0.7394435633223679,-0.6990629533991202,446613426,433599442,32.058911066868745,46.20930541544554,NaN,NaN,-6.828771677940661,-5.074488572156284
2007-11-30T09:30:00-05:00,73.17,73.75,72.35001,73.47,17067360,24468563.45,49.89622379754194,45.71472435283448,NaN,NaN,-10.584005598458047,-59.52983937763133,0.057862343428143226,-0.6267350241139411,-0.6845973675420843,463680786,434741464.4,33.09187568961991,43.62129359463743,NaN,NaN,-5.882522566695312,-5.189921999947574
2007-12-03T09:30:00-05:00,72.88,74.13,72.88,73.75,19546560,24044162.65,50.61580018617261,46.52230561375213,NaN,NaN,14.10595577478024,-42.490854218317004,0.14051617304170516,-0.5089521512399529,-0.649468324281658,483227346,444855685.2,41.56542439653651,42.04620895011885,NaN,NaN,-4.904031514981896,-5.149080502095334
2007-12-04T09:30:00-05:00,73.59801,73.64999,73,73,14566637,23530731.3,48.602302186989924,46.699079611207075,NaN,NaN,-0.43403711602835754,-15.762348287332028,0.1430137330665402,-0.4707011579484828,-0.613714891015023,468660709,457809465,50.25476336866321,41.363295836355626,NaN,NaN,-4.625444602094464,-5.074275373523781
2007-12-05T09:30:00-05:00,74,75.05,73.87,74.61,24490064,23848580.9,52.930927839346545,47.20248684778555,NaN,NaN,92.69932207799592,15.807609980109442,0.24542369935796948,-0.3069352668175611,-0.5523589661755306,493150773,471066608,57.25953806257954,41.36184773971289,NaN,NaN,-3.150183477624211,-4.799405102680986
2007-12-06T09:30:00-05:00,74.64,76.64999,74.327,76.64999,21136432,23410231.3,57.78253231135098,48.420431159280405,NaN,NaN,178.8498809387304,54.92742321540403,0.43196991362489,-0.012396574144418082,-0.4443664877693081,514287205,484601363.8,62.98951201905569,42.51198520644859,NaN,NaN,-0.39015053078046924,-4.169511592409483
2007-12-07T09:30:00-05:00,76.3,76.71001,75.71001,76.17999,12377660,22170975.1,56.341632839516336,49.17816056619328,NaN,NaN,195.98174550132686,96.24057343536101,0.500305792510602,0.18101575286894445,-0.3192900396416576,501909545,492247115.6,65.78040246113235,44.077919624555186,NaN,NaN,1.482781759816339,-3.36204111352008
2007-12-10T09:30:00-05:00,76.60001,77.10001,76.33,76.95,11388105,21317229.95,58.18150927322832,50.24967519574609,NaN,NaN,207.99822727469734,135.01902773534442,0.5689616868112125,0.3919120688723581,-0.17704961793885446,513297650,498261176.4,67.8350314453297,45.90110107587054,NaN,NaN,3.5891155283291725,-2.369018736113044
2007-12-11T09:30:00-05:00,76.94,77.57001,75.00999,75.05,20001888,20729049.95,52.32216771068633,50.48642785578587,NaN,NaN,132.0943645662508,161.52470807180026,0.46252852580327497,0.4011110393152393,-0.061417486488035716,493295762,503188187,69.45320298138034,47.949154550824574,NaN,NaN,3.773464034059394,-1.4915211975169815
2007-12-12T09:30:00-05:00,76.75,77.75,76.28999,77.5,24019664,20529961.15,58.171819002397505,51.39078093470213,NaN,NaN,162.05717613547318,175.39627888329568,0.5284849806757361,0.5991887393566344,0.07070375868089832,517315426,508021117.6,70.99465903293569,50.20030346115886,NaN,NaN,5.74319049178385,-0.45799095618829133
2007-12-13T09:30:00-05:00,77.00999,77.77,76.42,77.69,15419551,20195273.9,58.59607422523401,51.99999267044599,NaN,NaN,136.78728016293834,166.98375872813727,0.5536019162875001,0.7627061540402735,0.20910423775277337,532734977,511710672,72.15007289447907,52.28566132381447,NaN,NaN,7.453559263288813,0.6722305037370093
2007-12-14T09:30:00-05:00,77.49001,77.53,76.38,76.45,15088004,19496963.7,54.69689113019494,52.717641319732365,NaN,NaN,101.21048647860094,148.02950692359212,0.4592837311424621,0.783208901680851,0.3239251705383889,517646973,514858157.6,73.13328820358768,54.654884730219024,NaN,NaN,7.782244186045456,1.6879467440667872
2007-12-17T09:30:00-05:00,76.3,76.45,74.53,75.08,27182160,19584028.5,50.68398134632028,53.25935628028689,NaN,NaN,41.501893841806364,114.73024023701392,0.2857071444454383,0.6810591010951867,0.3953519566497484,490464813,510291590.2,69.31004809994991,57.021487857381494,NaN,NaN,6.876939688945425,2.4292314504780212
2007-12-18T09:30:00-05:00,75.87,76.27,74.58,75.8,20871376,19739321.3,52.65011177470329,53.630701949643814,NaN,NaN,43.32147206936694,96.97566173763715,0.2042798316465217,0.6507017462079006,0.44642191456137886,511336189,513899675.6,70.61707094564338,59.74955719055431,NaN,NaN,6.684623359914281,3.037144580397487
2007-12-19T09:30:00-05:00,75.86,76.98,75.86,76.53,16833168,19171450.9,54.625320231783824,54.00694956110478,NaN,NaN,71.29985570993233,78.82419765252898,0.18505103436829534,0.677735707521748,0.4926846731534527,528169357,516070461.8,71.4060863803235,62.560069712943935,NaN,NaN,7.08156250200805,3.614918569198996
2007-12-20T09:30:00-05:00,77.17999,77.5,76.1324,77.5,13011199,18833570.85,57.18132000312268,54.527313575789115,NaN,NaN,85.38322904800967,68.54338742954323,0.22070953753731926,0.7685715950751018,0.5478620575377825,541180556,517759577.6,72.03534182670904,65.34174586559315,NaN,NaN,8.146587601979437,4.262299859596202
2007-12-21T09:30:00-05:00,77.56,79.3,77.42,79.3,17571552,19368593,61.51381038311622,55.3057428755708,NaN,NaN,132.62397705683077,74.8260855451892,0.3413666789116081,0.9745704061772926,0.6332037272656845,558752108,525980604.6,74.92738246791345,67.72474287069151,NaN,NaN,10.379266159801313,5.136152188196932
2007-12-24T09:30:00-05:00,79.59,79.66,78.8,79.66,19000784,19052910.6,62.334655012189394,56.28662522022791,NaN,NaN,146.9190159187782,95.90950996058356,0.41629879367833067,1.1535772193635978,0.7372784256852671,577752892,543438220.4,79.72297837857657,69.82961537139961,NaN,NaN,12.455827936452831,6.181820152233489
2007-12-26T09:30:00-05:00,79.74001,80.60001,79.46001,80.55,13995250,18314451.5,64.35853070340303,57.10288256766052,NaN,NaN,169.91081567553928,121.22737868181802,0.4915178149968549,1.3516756944313357,0.8601578794344809,591748142,559520611,82.95697739250114,71.6651467521083,NaN,NaN,14.812314616887104,7.414747932898291
2007-12-27T09:30:00-05:00,80.59,80.59,79.5,79.7,10901004,17710839.3,60.98798829952788,57.33184370967315,NaN,NaN,145.161328391711,135.99967321817377,0.4508105548257625,1.423671072966684,0.9728605181409214,580847138,570056167.2,84.68069574748506,73.21451701842469,NaN,NaN,15.888116794678089,8.625229198866833
2007-12-28T09:30:00-05:00,80.14,80.46001,79.64999,80.37,10490695,17247955.65,62.64850125263552,57.78233431061024,NaN,NaN,138.69343209726884,146.6617138280256,0.43555224968477946,1.5173008302468958,1.0817485805621163,591337833,580087622.6,86.12014325420284,74.66735564650115,NaN,NaN,17.265908265345704,9.85961192264953
2007-12-31T09:30:00-05:00,80.44,80.44,79.05,79.35001,11304836,16959829.45,58.561877029927814,57.809503436088775,NaN,NaN,105.49874146556314,141.2366667097721,0.32820079674171754,1.4919995764892633,1.1637987797475458,580032997,584343800.4,86.69152401665076,76.01424797302408,NaN,NaN,17.320428218835797,10.92544282210471
2008-01-02T09:30:00-05:00,79.95,80.3,79.27,79.5,19295632,16947283.05,58.98556084193434,58.28546008832077,NaN,NaN,96.28251304323359,131.10936613466316,0.24267203775962587,1.4671388269470782,1.2244667891874523,599328629,588658947.8,87.26397094341866,77.28644568459823,NaN,NaN,17.479181349911574,11.861691183219977
2008-01-03T09:30:00-05:00,80.07001,80.75,79.85001,80.44,14605340,16949218.2,61.633136188377186,58.532697030176465,NaN,NaN,107.0234620569798,118.53189541095125,0.22516837338287732,1.505927255916049,1.2807588825331717,613933969,593096113.2,87.84303516139612,78.48990112234542,NaN,NaN,18.33787156800433,12.786859809617741
2008-01-04T09:30:00-05:00,79.69,79.74001,77.5,77.5,26713728,17060401.4,50.62568800681395,57.96338372886074,NaN,NaN,17.543169590846198,93.00826365077832,0.0030933515673998713,1.2846255719924216,1.2815322204250217,587220241,594370733.8,88.01165624444275,79.62287136162854,NaN,NaN,15.768504955081339,13.212809116112542
2008-01-07T09:30:00-05:00,78,78.61,76.23,77.2,32408944,17624027,49.65123467995806,57.60297969670097,NaN,NaN,-24.715572790314685,60.32646267326161,-0.16708991217507285,1.0726698302061806,1.2397597423812534,554811297,587065426.6,81.07108917635058,80.18985714539733,NaN,NaN,13.38975248869165,13.2380867407667
2008-01-08T09:30:00-05:00,77.88,78.188,75.85001,75.85001,22607968,18135542.4,45.4149697388537,57.22662172473907,NaN,NaN,-58.11272650740143,27.60416907866869,-0.3624542164911424,0.7866919717673255,1.149146188258468,532203329,577499493,72.95774792574542,80.45040713295415,NaN,NaN,10.027808636333043,12.779475582990464
2008-01-09T09:30:00-05:00,75.85001,77.34,75.63,76.85001,25089456,18820609.95,48.89340661099819,56.95828564161728,NaN,NaN,-58.38048916204319,-3.3284313623866666,-0.41256321127326423,0.6334421741668876,1.0460053854401519,557292785,569092324.2,66.64513346338566,80.16669731279288,NaN,NaN,8.200205986883063,12.125294212117979
2008-01-10T09:30:00-05:00,76.35001,77,74.32001,76.53,23054112,18973221.15,47.842716523876355,56.473813948195314,NaN,NaN,-87.97227596351208,-42.327578966485035,-0.45230183519932865,0.48062809144099106,0.9329299266403197,534238673,553153265,56.639298959751265,79.11192678275201,NaN,NaN,6.393580150802005,11.306477917644267
2008-01-11T09:30:00-05:00,75.99001,77.03,75.36,75.60001,28771520,19210813.95,44.82782677752452,55.5914215749383,NaN,NaN,-80.38538928557833,-61.91329074176995,-0.5213539584509419,0.2812374785766423,0.8025914370275842,505467153,536802647.4,48.58157118462839,77.43665745117482,NaN,NaN,3.9608722979144586,10.257105686254295
2008-01-14T09:30:00-05:00,76.42999,77.23,76.3,77.10001,20145584,19447115.6,50.271122437411314,54.78837243595938,NaN,NaN,-41.07731630757827,-65.18563944522266,-0.44889483274822395,0.24147289609230427,0.6903677288405282,525612737,530962935.4,46.06115919920004,75.37478436055244,NaN,NaN,3.420161670457696,9.280399398283352
2008-01-15T09:30:00-05:00,76.09,76.09,73.91,73.91,26631952,20024313,41.005590240435644,53.264867809405544,NaN,NaN,-124.18019123716884,-78.39913239117615,-0.5898199841873184,-0.04690725139361973,0.5429127327936987,498980785,524318426.6,43.30804221093633,72.77371749143528,NaN,NaN,-0.20036127742536397,7.92600501603925
2008-01-16T09:30:00-05:00,73.5,74.14999,71.06,71.45,43787520,20854581,35.562214313873,51.207988067296256,NaN,NaN,-197.9961746692637,-106.32226949262024,-0.8091708854764788,-0.46855087405189977,0.340620011424579,455193265,503898522.6,36.1557853820872,69.43077520497714,NaN,NaN,-5.271430471302932,6.040657089276081
2008-01-17T09:30:00-05:00,72.13,73.16,68.60001,68.75,38167664,21719395.4,30.73907894305593,49.04735168469112,NaN,NaN,-232.16615866974232,-135.16104603386628,-1.0796507658964423,-1.0089434459459738,0.07070731995046842,417025601,480455908.2,30.025252227952265,65.52681495358193,NaN,NaN,-11.39448852415831,3.5499220016425963
2008-01-18T09:30:00-05:00,69.25,70.00999,67.14,68.89999,41543056,22954889.8,31.29652466528681,46.807924785594786,NaN,NaN,-224.03847849744938,-163.8916638762405,-1.183657851434154,-1.408864994342224,-0.2252071429080701,458568657,471076209,27.98092653297195,61.3740137592083,NaN,NaN,-15.85404422254193,0.7779268267590926
2008-01-22T09:30:00-05:00,63.8,68.16,63,66.95,40089472,24308803.45,28.12701072880256,44.634005764085835,NaN,NaN,-222.9808324676585,-200.27236710825656,-1.3091888129572384,-1.8616931591046182,-0.5525043461473798,418479185,449649498.6,23.966533283956963,56.8936572783016,NaN,NaN,-20.70765596717369,-2.2914421438027333
2008-01-23T09:30:00-05:00,65.03999,67.63,62.97,67.57001,54686896,26164570.65,30.535852402840277,42.60188373272198,NaN,NaN,-176.21925161331507,-210.6801791834858,-1.2746346803902784,-2.1457976966352277,-0.8711630162449493,473166081,444486557.8,23.106303214277347,52.31096672622009,NaN,NaN,-23.785630573618942,-5.362040490919334
2008-01-24T09:30:00-05:00,68.03999,70.34,67.98,69.95,32597056,26844384.25,38.98888650023559,40.984437326426146,NaN,NaN,-98.28708751040526,-190.7383617517141,-1.0263307347039587,-2.1540764346248977,-1.127745699920939,505763137,454600532.2,28.51895028974937,48.07353209253103,NaN,NaN,-23.625717238832905,-7.971137169192701
2008-01-25T09:30:00-05:00,70.98,71.57001,68.5,68.7,31375824,27713412.95,36.478133001416715,39.973897683183495,NaN,NaN,-83.53039496817597,-161.01120901140084,-0.886387316443868,-2.235729845475774,-1.3493425290319059,474387313,466072874.6,34.17873759591518,44.22832361763621,NaN,NaN,-24.31263523112975,-10.305636892326564
2008-01-28T09:30:00-05:00,68.59,70.45,68.14999,70.25999,22493200,28293022.75,41.537938842764476,39.394376551955375,NaN,NaN,-73.03642978444384,-130.81079926879974,-0.6403509895701138,-2.149781265994548,-1.5094302764244343,496880513,473735245.8,37.725369519251316,41.13220078498626,NaN,NaN,-23.218040667889333,-12.150266003121246
2008-01-29T09:30:00-05:00,70.42999,71.35001,70.17,71.05,18629760,28699976,43.97189090941357,39.291299492709655,NaN,NaN,-46.818586714843406,-95.57835011823671,-0.3883941491003762,-1.9949229627999046,-1.6065288136995284,515510273,493141463.4,45.70482957121569,39.18556375966271,NaN,NaN,-21.55629810987508,-13.49398487551465
2008-01-30T09:30:00-05:00,70.69,72.21001,69.77,70.16,24846208,29377044.6,41.85764828586696,38.78874532662885,NaN,NaN,-43.42441863279607,-69.0193835221329,-0.25226352388491313,-1.9218582185556699,-1.6695946946707567,490664065,496641060.2,47.02311828664021,37.78399124703804,NaN,NaN,-20.830731418137034,-14.542091524460705
2008-01-31T09:30:00-05:00,69.02,70.78999,68.5,69.60001,23912336,29607879.8,40.536943857468486,38.266904421885435,NaN,NaN,-55.88327781710188,-60.53862158347222,-0.17423129194807507,-1.8873838096058506,-1.7131525176577755,466751729,488838778.6,44.43286662871316,36.91210322339244,NaN,NaN,-20.6249656541761,-15.411073542991476
2008-02-01T09:30:00-05:00,70.52,71.61,70.22,71.35001,23664000,30060812.8,46.24504634015061,38.36813439064444,NaN,NaN,-24.839093297379897,-48.800361249313,0.011110687694235954,-1.6992641580399805,-1.7103748457342165,490415729,492044461.8,45.75499597300684,36.71020499399091,NaN,NaN,-18.691682817079407,-15.879732010718323
2008-02-04T09:30:00-05:00,71.47,71.8,70.46001,71.39999,17257744,29588013.6,46.403289722038636,38.09186062526068,NaN,NaN,-16.29100009604681,-37.45127531163358,0.14547977707909032,-1.5285251243853537,-1.674004901464444,507673473,494203053.8,46.67506608458155,36.75405548580387,NaN,NaN,-17.092800219854386,-16.05302746916633
2008-02-05T09:30:00-05:00,70.28,70.39999,68.45,68.45,27696464,29352389.6,39.08902212248501,37.954962902549916,NaN,NaN,-58.3417973132392,-39.75591743131277,0.04907354189703139,-1.6126629740931548,-1.6617365159901862,479977009,487096401,44.02739872032606,36.80543809361742,NaN,NaN,-17.882829468971977,-16.31442775485285
2008-02-06T09:30:00-05:00,69.2,69.55,67.35001,67.50999,28474784,29645730.4,37.08318477560306,38.06360364981634,NaN,NaN,-77.92207904931185,-46.655449514615924,-0.058764042318886434,-1.7351915688887942,-1.6764275265699078,451502225,479264033,41.25013857380463,37.16932046445437,NaN,NaN,-19.15491753730361,-16.720212009488673
2008-02-07T09:30:00-05:00,67.02,69.17999,66.92999,68.84,25600416,29671278.4,41.64586136260097,38.84265953692671,NaN,NaN,-69.20850782360752,-49.32049551591705,-0.02311224193089334,-1.7053178289835245,-1.6822055870526311,477102641,481334215.4,42.28640604582445,38.045117165730964,NaN,NaN,-18.8250700319443,-17.02090601269662
2008-02-08T09:30:00-05:00,68.78,69.85001,68.55,69.85001,17278160,29382480.8,44.9129287266604,39.815259827024825,NaN,NaN,-31.62487771055369,-50.677652398551814,0.08023802364021648,-1.5819080575023605,-1.662146081142577,494380801,482127229.8,42.703324947308865,39.096717052469316,NaN,NaN,-17.551386327042014,-17.09668891474596
2008-02-11T09:30:00-05:00,69.89999,71.64999,69.16,71.64999,30999856,29493897.6,50.257809501950646,41.396031167963976,NaN,NaN,26.451979487736537,-42.12905648179514,0.2708337451510914,-1.3236038997037127,-1.594437644854804,525380657,485668666.6,44.6270980792954,40.57247168070778,NaN,NaN,-14.764581080459504,-16.76353065270504
2008-02-12T09:30:00-05:00,71.87,72.75999,70.55,71.61,26031472,29788192,50.14140942059564,42.79642809780364,NaN,NaN,81.32975244804086,-14.194746529539131,0.38808201376975604,-1.109335127642609,-1.4974171414123651,499349185,489543101.8,46.73420436314185,42.260178905626674,NaN,NaN,-12.575941383382494,-16.16530361423039
2008-02-13T09:30:00-05:00,72.03999,73.35001,71.60001,73.35001,20713408,29492264.8,55.02263380046408,43.941695762105674,NaN,NaN,147.77090673199336,30.943850626721904,0.5659220960924431,-0.7900145212968113,-1.3559366173892544,520062593,503255175.4,53.481018863851865,44.04318380377685,NaN,NaN,-9.157373668902256,-15.164170764897799
2008-02-14T09:30:00-05:00,73.5,74.17999,72.71001,72.72,25334640,28569620.8,52.99942675552382,45.12178817311333,NaN,NaN,160.47522220947414,76.88059663333824,0.6198782918717429,-0.5810887525495758,-1.2009670444213187,494727953,506780237.8,55.05703418959981,45.534490703325744,NaN,NaN,-6.913627806550688,-13.985521770848212
2008-02-15T09:30:00-05:00,73.23,73.23,71.59,72.85001,21304864,27726480.8,53.380388704810905,45.967677448973795,NaN,NaN,113.50139949856386,105.90585207516173,0.640447867493265,-0.40040721005473756,-1.0408550775480025,516032817,511110641,56.984987468298904,46.91017769968629,NaN,NaN,-4.973312941173056,-12.698063366608904
2008-02-19T09:30:00-05:00,74.05,75.34,73.89999,75.25,28730336,27085844.8,59.85004059141701,47.10183099768832,NaN,NaN,177.8422787126339,136.18391192014124,0.782418175536043,-0.06283235812794885,-0.8452505336639918,544763153,514987140.2,58.69323955482465,47.83792126994407,NaN,NaN,-1.2041336222748762,-11.056073403132615
2008-02-20T09:30:00-05:00,74.21001,76.23,73.89999,76.14999,18641856,26013464,61.98077100790187,48.5391969064051,NaN,NaN,182.58482821034985,156.43492707260302,0.8955280075795419,0.27415947581043554,-0.6213685317691063,563405009,527798305,63.80854479985674,49.03688030660239,NaN,NaN,2.605469320390012,-9.104424442629382
2008-02-21T09:30:00-05:00,75.98,76.14,74,74.06,28623136,24710276,54.71855411119943,49.55216906738588,NaN,NaN,139.1555529437174,154.71185631494782,0.7917646201486824,0.3683372434167467,-0.42342737673193576,534781873,530742161,64.88466278474428,50.497722889176046,NaN,NaN,3.746902716192122,-7.268520562797739
2008-02-22T09:30:00-05:00,74.78999,75.16,73.17,74.89999,16818928,23921369.6,56.90411368647311,50.31353102069464,NaN,NaN,109.28216611978871,144.47324509701076,0.7426886354193806,0.5049334175422899,-0.2377552178770906,551600801,542116730.6,68.75094717079395,52.14029083187513,NaN,NaN,5.358586856684063,-5.464648074300339
2008-02-25T09:30:00-05:00,74.85001,77.16,74.82001,77.03999,20865424,23395849.6,61.94368338293741,51.423559139330266,NaN,NaN,150.71640988035475,151.91624717336893,0.8117331629551218,0.7769112358168115,-0.0348219271383102,572466225,553403412.2,72.040537084809,53.95211018903423,NaN,NaN,8.393532397738491,-3.4849080068662204
2008-02-26T09:30:00-05:00,76.41,78.35001,76.17,78.35001,16632988,23102839,64.66751733841556,53.250594511896736,NaN,NaN,161.53597235025907,148.65498590089396,0.8963764222894043,1.0856486007234452,0.18927217843404087,589099213,562270624.2,74.32711053087887,56.11637531835943,NaN,NaN,11.805805829111367,-1.3005203160122796
2008-02-27T09:30:00-05:00,77.92,78.36,77.14999,77.33,15848461,22963774.05,61.0061867446529,54.95938036682886,NaN,NaN,138.46972146438614,139.83196455170122,0.8356194305869258,1.2337964666676982,0.3981770360807724,573250752,564239772.8,74.81959787560486,58.51419383991659,NaN,NaN,13.49701374426383,0.8134131211700217
2008-02-28T09:30:00-05:00,77.10001,79.02,77.10001,78.66,15098082,22476367.75,63.87800149292792,56.54739037613793,NaN,NaN,134.73274820703134,138.94740360436398,0.834980962744176,1.4419032395109923,0.6069222767668163,588348834,574953165,77.36382860664764,61.01972402283253,NaN,NaN,15.821774453169338,2.9574647400270666
2008-02-29T09:30:00-05:00,78.14999,78.39999,75.75,76.05,20784832,22319992.55,55.274776873890296,57.28752238665436,NaN,NaN,86.74023244260013,134.43901686892627,0.6187124045517238,1.3803127824564712,0.7616003779047473,567564002,578145805.2,78.07478878409043,63.54625715403121,NaN,NaN,15.057709757721756,4.686071171126308
2008-03-03T09:30:00-05:00,76.10001,77.73,75.67,77,23935968,22333590.95,57.51755948875041,57.80607595714006,NaN,NaN,79.21016334675322,120.13776756220598,0.5044089508326761,1.3921115664455925,0.8877026156129164,591499970,581952554.2,78.92475917260968,65.99609008926794,NaN,NaN,15.147799866375443,6.180603841876184
2008-03-04T09:30:00-05:00,76.53999,76.96001,74.34,75.5,33742464,23157826.95,52.99847581995316,58.01015212852273,NaN,NaN,45.68079782946532,96.96673265804725,0.3025042987430139,1.2658329890416837,0.9633286902986699,557757506,575684212.8,73.84805174768478,67.93279347387815,NaN,NaN,13.76908536574511,7.264672631000316
2008-03-05T09:30:00-05:00,76.00999,77.39999,75.85001,77.39999,22168720,22881439.75,57.548254045681816,58.190553574609716,NaN,NaN,71.26115221989424,83.52501880914886,0.27256703844228447,1.3040374883515256,1.031470449909241,579926226,577019307.6,74.22829038515704,69.41474143968567,NaN,NaN,14.05775200192823,8.235112541132874
2008-03-06T09:30:00-05:00,77.06,77.35001,75.42,75.85001,23278576,22621629.35,53.03777140214102,58.193292477939515,NaN,NaN,49.332325962087815,66.44493436016015,0.13119470735052374,1.1954638340973958,1.064269126746872,556647650,570679070.8,69.09080601564573,70.41715371297467,NaN,NaN,12.82955695717697,8.891461743424887
2008-03-07T09:30:00-05:00,75,75.28999,73.14,73.75999,30411696,22862193.35,47.61811118354946,57.78170122642084,NaN,NaN,-24.987018004352485,44.09948427076965,-0.10737510649856286,0.9300502436236684,1.0374253501222312,526235954,562413461.2,62.97179516473465,70.84478283414865,NaN,NaN,9.972343041982128,9.045873357504494
2008-03-10T09:30:00-04:00,73.91,74.33,72.75999,72.85001,29025264,23449548.55,45.44090359241564,56.75247715506361,NaN,NaN,-63.64466054256614,15.528519492905783,-0.31880807005302125,0.6389152625559547,0.9577233326089759,497210690,543555605.2,51.71787678954246,70.34654263662848,NaN,NaN,6.95636851747978,8.747372666072392
2008-03-11T09:30:00-04:00,74.5,76.60001,74.03,76.60001,33912128,23595162.15,54.644221159648126,56.22843788018833,NaN,NaN,21.59742746842676,10.711845420698072,-0.2040328511281,0.702682268698851,0.906715119826951,531122818,538228667.6,49.05115969916341,69.29244370086467,NaN,NaN,7.3808837805963785,8.552159968147247
2008-03-12T09:30:00-04:00,76,76.44,74.89999,74.89999,21902144,23388695.75,50.486459404587706,55.92614540114464,NaN,NaN,-0.6238182889469142,-3.6651486810701543,-0.23815588178110458,0.6090202676005703,0.8471761493816748,509220674,524087557.2,42.7494628643603,67.71135799226582,NaN,NaN,6.301108446054942,8.230581179276918
2008-03-13T09:30:00-04:00,74.13,76.45,73.63,76.14999,25211248,23613587.75,53.30012049843121,55.66871731628451,NaN,NaN,-8.082325777958319,-15.14807902907942,-0.17501047493470356,0.6284130557132954,0.803423530647999,534431922,519644411.6,40.96851909428742,65.72689884394391,NaN,NaN,6.362524125495574,7.963715885879583
2008-03-14T09:30:00-04:00,76.84,76.96001,73.60001,74.75999,28160112,23754861.35,49.90407658705118,54.80874540229263,NaN,NaN,-32.18499920326844,-16.58767526886261,-0.22228903064144145,0.5255622423461972,0.7478512729876386,506271810,515651582.8,39.38078158695783,63.394059165525974,NaN,NaN,5.305543268646021,7.583976940560502
2008-03-17T09:30:00-04:00,72.3,73.81,71.17999,72.14999,31636448,24271440.55,44.20822604585325,53.347367452823896,NaN,NaN,-190.85898937339692,-42.03054103502877,-0.41365167498685773,0.23078667925406648,0.6444383542409242,474635362,511136517.2,37.60596595254239,60.771120267073364,NaN,NaN,2.47542479580766,6.854183777024382
2008-03-18T09:30:00-04:00,73.60001,75.3,73.53,75.3,27522320,24211039.75,51.41557770479665,52.66232394997702,NaN,NaN,-54.02876108868145,-57.155778746450416,-0.31675871108316644,0.2484899653869661,0.5652486764701325,502157682,505343490,35.40143611557238,57.95553728421391,NaN,NaN,2.5284860826312237,6.236226963539645
2008-03-19T09:30:00-04:00,74.72,75.14999,70.7,70.7,43511264,25454510.15,42.73381701130264,51.15202505843236,NaN,NaN,-168.3536483558158,-90.7017447598242,-0.5381375812312049,-0.10742330006887357,0.43071428116233135,458646418,495228638.8,31.886592854872234,54.70716330194424,NaN,NaN,-0.6720085625526573,5.249336174097888
2008-03-20T09:30:00-04:00,69.87,71.5,68.85001,70.81,37538640,25900285.35,42.98175693239072,50.2739522054681,NaN,NaN,-209.3103495876388,-130.94734952176026,-0.6455903038455465,-0.37627359864460175,0.26931670520094475,496185058,487579266,29.50111938817541,51.2376154879503,NaN,NaN,-2.9770271115088685,4.074141419011209
2008-03-24T09:30:00-04:00,71.38,73.08,71.16,72.05,15597785,25839228.2,45.829026246907894,49.43905697390791,NaN,NaN,-120.13663005614337,-148.53767569233528,-0.6024180840194462,-0.483705899823363,0.1187121841960832,511782843,488681472.6,30.310136948315588,47.7651424719293,NaN,NaN,-3.890890582269816,2.936279704542491
2008-03-25T09:30:00-04:00,72.25999,73.22,71.78,72.77,21927520,25892333,47.46932587127644,49.044117691859576,NaN,NaN,-87.9981990961164,-127.96551763687917,-0.49891237997878657,-0.5049282907774,-0.006015910798613439,533710363,500496472.8,38.4622923637996,45.23758823022322,NaN,NaN,-4.106873422235229,1.9301149721456738
2008-03-26T09:30:00-04:00,72.94,74.87,72.92,74.35001,23198896,26220628.4,50.977370940090395,48.57476889860305,NaN,NaN,-28.269537627456195,-122.81367294463412,-0.30699580563374096,-0.38976066784078967,-0.08276486220704869,556909259,511446788.2,44.89602947169625,43.142426736404595,NaN,NaN,-3.1941016270709666,1.1980840294004396
2008-03-27T09:30:00-04:00,74.61,75.33,73.60001,73.60001,22561200,26556265.35,49.294552622584526,48.30739612863472,NaN,NaN,-17.6227751564331,-92.66749830475757,-0.21772168387125906,-0.3549169670461225,-0.13719528317486346,534348059,526587116.4,52.3187479954172,41.944422592102555,NaN,NaN,-2.951040653436807,0.6053519318522614
2008-03-28T09:30:00-04:00,74.17999,74.75,73.33,73.39999,17525616,26677642.05,48.83157777584032,48.394072313798354,NaN,NaN,-25.130827553595662,-55.831593897948935,-0.16186708934950347,-0.3395291448617428,-0.17766205551223932,516822443,530714593.4,54.132666003503395,41.313056223443176,NaN,NaN,-2.885403780352825,0.10667254439439194
2008-03-31T09:30:00-04:00,73.63,74.96001,73.21001,74.06,21928224,26734811.65,50.484164850313334,48.75430526079105,NaN,NaN,-8.518242427118746,-33.50791637214402,-0.0746331639464903,-0.2709535104453522,-0.1963203464988619,538750667,536108158.2,56.4634393414893,41.652024977153665,NaN,NaN,-2.3701826433592443,-0.24716391099898466
2008-04-01T09:30:00-04:00,73.8,75.55,73.35001,75.45,36285488,27352287.65,53.86367888965093,48.69855224150554,NaN,NaN,33.692447478554534,-9.169787057209833,0.07445213210499751,-0.10325518136761502,-0.17770731347261254,575036155,544373316.6,59.83194520842565,42.422081084958116,NaN,NaN,-0.9671975157816035,-0.35002585453935875
2008-04-02T09:30:00-04:00,75.42999,77.03,74.66,76.5,21192496,26724789.25,56.29053919295476,49.113129369246046,NaN,NaN,98.71182868525231,16.226486205331863,0.2326216742808153,0.11306977937840657,-0.11955189490240872,596228651,552237195,62.78248108760995,43.85301095804738,NaN,NaN,0.9210478582605726,-0.16844389556793998
2008-04-03T09:30:00-04:00,76,77.46001,75.8,76.67999,18601888,26546447.65,56.71090183821921,49.356756607802325,NaN,NaN,131.00525536476587,45.952092309571654,0.33214133962439485,0.29562477962808487,-0.03651655999631001,614830539,568333691,67.96893700527201,45.781612237403415,NaN,NaN,2.6014746012197314,0.22725874683029879
2008-04-04T09:30:00-04:00,76.73,78.22,76.73,77.31,19280992,26346568.45,58.22531912194082,49.951131074580154,NaN,NaN,160.30706678640942,83.03967117757267,0.41764562087365287,0.4855404660957561,0.0678948452221032,634111531,591791508.6,73.71719148687563,48.2342129445404,NaN,NaN,4.446884825077543,0.8300624722941907
2008-04-07T09:30:00-04:00,78.27,79.03,77.38,77.72,17678720,25709919.65,59.22504651151351,51.0237611078416,NaN,NaN,159.59907033804132,116.66313373060468,0.4748906321159521,0.6615081353670433,0.18661750325109122,651790251,614399425.4,77.84399437928671,51.108357832165,NaN,NaN,6.2830362796575985,1.6090587304889632
2008-04-08T09:30:00-04:00,77.28,78.74001,77.13,78.60001,22726304,25394971.65,61.362356496714,51.73424530726427,NaN,NaN,143.7399897276342,138.6726421804206,0.5403349706685797,0.8620362165868158,0.3217012459182361,674516555,634295505.4,80.71395988355943,54.3449666727355,NaN,NaN,8.460200510038682,2.5877932704246374
2008-04-09T09:30:00-04:00,78.52,79.55,78.33,78.75,19490320,24673881.25,61.73055799514091,53.091155377538435,NaN,NaN,152.29266795456044,149.38881003428224,0.5596680847265232,1.0212863518263902,0.461618267099867,694006875,653851150.2,83.03944975866489,57.99874216586354,NaN,NaN,10.399061361518754,3.7036887120095114
2008-04-10T09:30:00-04:00,78.72,79.17,77.95,78.60001,14924848,24325016.45,61.10347430044461,54.385563760970854,NaN,NaN,122.94355959122157,147.7764708795734,0.5286664832423627,1.1224513711528203,0.5937848879104577,679082027,666701447.8,84.37289630195528,61.91815480256211,NaN,NaN,11.904385351897547,4.875216803422088
2008-04-11T09:30:00-04:00,78.17999,78.75999,77.5,77.5,16508508,23889879.45,56.56517192146394,55.152431309153435,NaN,NaN,89.94496212415102,133.70404994712172,0.40590821754581285,1.1011701598427237,0.6952619422969109,662573519,672393845.4,84.93782054757207,65.820132202509,NaN,NaN,12.12123078005681,5.910361657227048
2008-04-14T09:30:00-04:00,77.60001,79.41,77.60001,79.28,14933035,23228525.6,61.54270657693483,56.157672788129034,NaN,NaN,101.2796503392323,122.0401659473599,0.4149442065160871,1.2139422004420197,0.7989979939259326,677506554,677537106,85.44963619457201,69.17637104756417,NaN,NaN,13.675831164492127,7.019714443979202
2008-04-15T09:30:00-04:00,79.84,80.05,78.84,79.7,14293609,22361383.65,62.63089196214978,56.99006714684756,NaN,NaN,109.98229123673507,115.28862624918006,0.41837483498617656,1.3219665376586534,0.9035917026724768,691800163,680993827.6,85.798903690871,72.09800492036236,NaN,NaN,15.29021447728317,8.201214448736913
2008-04-16T09:30:00-04:00,80.2,82.39999,79.92,82.39999,22189504,22094742.85,68.75216385446241,58.37989652055312,NaN,NaN,144.84471521167325,113.79903570060264,0.5626623673255569,1.6069196618294228,1.044257294503866,713989667,684990386,86.21102285841849,74.51888169629103,NaN,NaN,18.68018641863869,9.698210444437166
2008-04-17T09:30:00-04:00,81.62,82.69,81.39999,82.33,16579410,20748150.15,68.4392012897134,59.78044105725834,NaN,NaN,143.28326750417918,117.86697728319416,0.6096164135177438,1.8062778114010456,1.1966613978833018,697410257,688656032,86.59526777075808,76.83763896538065,NaN,NaN,21.34593245368276,11.36217073147225
2008-04-18T09:30:00-04:00,81.99001,84.83,81.81,83.59,23538608,20048148.55,70.99863396707043,61.24576027988385,NaN,NaN,161.4122099589133,132.16042685014662,0.6765897231483124,2.0423985518186925,1.36580882867038,720948865,700331101.2,87.76472276636896,79.07344492430062,NaN,NaN,24.437019151047636,13.23000621998302
2008-04-21T09:30:00-04:00,83.75999,84.66,83.34,84.53999,15824281,20059473.35,72.79028293202798,62.59766056862507,NaN,NaN,164.95163137567843,144.89482305743587,0.7312736689062957,2.2799009148032496,1.5486272458969539,736773146,712184419.6,88.83018155244274,81.14474752030185,NaN,NaN,27.617623465510604,15.285380112201246
2008-04-22T09:30:00-04:00,84.17751,85.2901,84.11,84.58,26303760,20278285.35,72.86631162111672,63.78164431349377,NaN,NaN,158.21405940756844,154.54117669160252,0.7156487383422232,2.443188168824733,1.7275394304825098,763076906,726439768.2,89.96227132751558,83.08616110886655,NaN,NaN,30.243390766387446,17.42223877708499
2008-04-23T09:30:00-04:00,84.41,84.45,83.25,83.92,21766048,20206642.95,69.42042629894351,64.6894674892598,NaN,NaN,121.85697387051967,149.94362842337182,0.6104705398033718,2.4906276052367247,1.8801570654333528,741310858,731904006.4,90.36536544868693,84.68590599768189,NaN,NaN,31.56407320089048,19.44250083762863
2008-04-24T09:30:00-04:00,83.02,83.25,81.25,81.72,25737936,20365479.75,59.34582964730529,64.76950395535725,NaN,NaN,68.68161499654894,135.02329792184577,0.3550051146742581,2.3239134587761754,1.9689083441019173,715572922,735536539.4,90.63461878943382,85.89429366215033,NaN,NaN,29.77842102430912,20.919060864297272
2008-04-25T09:30:00-04:00,82.7,83.06,81.86,82.88,37613504,21369874.15,62.440933151090334,64.99921014389847,NaN,NaN,71.95206767666193,117.13126946539549,0.23235270914851913,2.259349230537566,2.026996521389047,753186426,741984051.6,91.10953564839505,86.8418323242295,NaN,NaN,29.158822844741046,22.096169718646383
2008-04-28T09:30:00-04:00,83.2,83.78999,82.60001,83.02,13207184,20933822.15,62.8089462588958,65.1025379840543,NaN,NaN,75.70113069970846,99.28116933020148,0.1337509771472618,2.1941852428231243,2.0604342656758625,766393610,747908144.4,91.53431984124744,87.61471517835007,NaN,NaN,28.759591589944684,23.048087128831856
2008-04-29T09:30:00-04:00,82.25,82.71001,81,81.14999,23202640,20279679.75,55.04994284612276,64.62535118769586,NaN,NaN,31.30830104688827,73.90001765806544,-0.07318638088678142,1.9689512895673857,2.042137670454167,743190970,743930957.2,88.47786896822554,88.00317369331869,NaN,NaN,26.011202647314676,23.471389345757974
2008-04-30T09:30:00-04:00,81.60001,82.71001,81.09,81.75,24474144,20443762.15,56.89012348637956,64.32439755811978,NaN,NaN,32.037946180078166,55.93621211997716,-0.1793806997033811,1.8179117958249407,1.9972924955283218,767665114,749201808.4,89.00199620907567,88.33382368668444,NaN,NaN,24.26597354709256,23.584901374520058
2008-05-01T09:30:00-04:00,80.72,80.82001,78.42999,79.96001,56100352,22318685.35,50.27740731173918,63.87527151456802,NaN,NaN,-36.899462869843184,34.81999654669872,-0.3689797232099248,1.5360678415159157,1.9050475647258405,711564762,748400176.4,88.34379459265843,88.57710754704775,NaN,NaN,20.6224321532653,23.161691485769378
2008-05-02T09:30:00-04:00,80.64,81.87,80.64,81.47,17592864,22234278.95,55.02647228080087,63.40982620770131,NaN,NaN,7.788043817754922,21.987191774917317,-0.3894781120176216,1.4181999247038135,1.8076780367214351,729157626,743594416.4,84.31800355758656,88.49627664440592,NaN,NaN,18.96834210268916,22.562641573900777
2008-05-05T09:30:00-04:00,81.63,83.17999,81.61,82.64999,12997547,22000220.3,58.37245777604701,63.1056523372654,NaN,NaN,43.51232801071763,15.549431237119148,-0.32308506926570524,1.4038217001393036,1.7269067694050089,742155173,738746729,80.34088094340545,88.10641787672981,NaN,NaN,18.632588902289125,22.001205477956255
2008-05-06T09:30:00-04:00,82.95,84.85001,82.64999,84.84,21096912,21918750.7,63.76126429803151,62.74915951180605,NaN,NaN,99.6011259203317,29.207996211807846,-0.14051710055398714,1.5512603937125249,1.691777494266512,763252085,742758952,81.13404425350994,87.74377654780777,NaN,NaN,20.13279537281259,21.734289748650017
2008-05-07T09:30:00-04:00,84.94,85,83.25999,83.25999,23126736,22100571.5,57.93425551583758,61.99880624224348,NaN,NaN,82.40920246569816,39.28224746893185,-0.13497705558214212,1.5230561747888345,1.6580332303709766,740125349,737250999,76.56705139641002,87.02747537821149,NaN,NaN,19.438198991973334,21.40627678341049
2008-05-08T09:30:00-04:00,83.67,85.10001,83.25999,84.92999,24908112,22599734.7,61.89777013423996,61.348744539898455,NaN,NaN,100.12858923378577,66.68785788965764,-0.03296941632478467,1.6168214599649957,1.6497908762897804,765033461,747944738.8,79.03454263409911,86.40389108304934,NaN,NaN,20.19167758673734,21.232762612457183
2008-05-09T09:30:00-04:00,85.06,85.11,83.50999,84.77,19919232,22770270.9,61.30185209627896,60.52814233734495,NaN,NaN,95.28381615322243,84.18701235675114,0.007444290492495842,1.6590962394054003,1.6516519489129045,745114229,751136059.4,79.7208274894425,85.75322293569218,NaN,NaN,20.59186169855507,21.141205339042596
2008-05-12T09:30:00-04:00,84.11,84.53,83.24001,84.3,18459152,22946576.75,59.48990907936752,59.57268501293429,NaN,NaN,67.21347377584917,88.92724150977745,-0.012667520566712387,1.635817548204514,1.6484850687712265,726655077,748036040.2,77.08129091058402,84.83315290591135,NaN,NaN,20.367665028390128,21.03069958037796
2008-05-13T09:30:00-04:00,84.3,85.67999,83.49001,85.67999,19690496,23216421.1,62.95243747807103,59.11068581144341,NaN,NaN,108.66588887093971,90.74019409989906,0.04842965243994657,1.7090221343211596,1.660592481881213,746345573,744654737.8,74.1956733008396,83.67817489535082,NaN,NaN,21.237527867743868,21.060246478573088
2008-05-14T09:30:00-04:00,85.3,86.02,84.3,84.7,24856144,23349753.1,59.08989112689722,59.092404488557115,NaN,NaN,102.3365016032734,94.7256539274141,0.00650543738167686,1.668724278608309,1.662218841226632,721489429,740927553.8,71.03873201307258,82.27846869703932,NaN,NaN,20.792243703222493,21.021960367808717
2008-05-15T09:30:00-04:00,85.39999,86.2,84.27,85.82001,28653456,23953455.4,61.96238660264547,59.05822259223963,NaN,NaN,114.43767863186527,97.58747180703,0.03620941557949253,1.7074806107009977,1.6712711951215051,750142885,737949438.6,68.52966713851856,80.66562094633386,NaN,NaN,21.287525260149504,21.059898209571685
2008-05-16T09:30:00-04:00,87.17999,88.95,87.02,88.95,27550704,24154060.2,68.59813477934287,59.471736057985815,NaN,NaN,223.62249622814377,123.25520782201427,0.23744112535860085,1.968072601819756,1.7306314764611552,777693589,744465310.6,70.94744684744279,79.19513001820495,NaN,NaN,23.989776283983716,21.478452220201977
2008-05-19T09:30:00-04:00,88.97,90.08,88.47,89.5,22751968,24500444.55,69.60166589568075,60.51114484723996,NaN,NaN,227.06879476505264,155.22627201985497,0.3704440846752053,2.193686582305162,1.8232424976299566,800445557,759223406.6,75.5325274253747,78.27046276514417,NaN,NaN,26.464414267681914,22.19073251269911
2008-05-20T09:30:00-04:00,89.62,90.39,89.09,90.39,25701984,24470355.75,71.20528136711573,61.53365612443539,NaN,NaN,205.94822109986802,174.68273846564063,0.4745640388040262,2.4164475461349895,1.9418835073309633,826147541,775183800.2,79.3315252595787,77.5797148401801,NaN,NaN,29.008736444130058,23.1647330743321
2008-05-21T09:30:00-04:00,90.02,91.42,88.83,89.05,45073248,25635715.75,65.59457130470548,62.62773926679013,NaN,NaN,163.0185846787504,186.81915508073604,0.41172752704016524,2.45654291613117,2.0448153890910046,781074293,787100773,81.62556512491389,77.09984130676979,NaN,NaN,29.40601451813858,24.0563447091616
2008-05-22T09:30:00-04:00,88.89,89.67999,87.57001,87.75,37355808,26216609.35,60.60527514002053,63.02622518530582,NaN,NaN,103.31820361376747,184.59526007711645,0.24915422695276712,2.3562581727819634,2.1071039458291962,743718485,785815893,80.5869879816039,76.83334019419961,NaN,NaN,28.167072546396465,24.643591543052295
2008-05-23T09:30:00-04:00,88.48,88.688,85.77,86.25999,25001504,25586009.35,55.40363657120549,62.81416652781714,NaN,NaN,55.5810582421979,150.9869724799273,0.019896334013127515,2.1319743633456056,2.112078029332478,718716981,774020571.4,71.58264182074784,76.20775168543834,NaN,NaN,25.447707388178365,24.758465235213162
2008-05-27T09:30:00-04:00,85.91,86.34,85.03,85.7,25728464,26212073.35,53.54363476221308,62.08433584668727,NaN,NaN,17.628654900575565,109.09894450703189,-0.17983373631857225,1.8872858589342627,2.067119595252835,692988517,752529163.4,58.71069477532675,74.6060838655681,NaN,NaN,22.66308066058407,24.45912458169472
2008-05-28T09:30:00-04:00,85.24001,87.53,84.72,87.50999,26214224,26362652.55,58.404384255240736,62.11791647093035,NaN,NaN,37.51406168829525,75.41211262471731,-0.1989296948072261,1.8184574767438022,2.0173871715510283,719202741,731140203.4,49.22385387040766,72.65299832799651,NaN,NaN,21.74564439632417,24.071484555213214
2008-05-29T09:30:00-04:00,86.62,87.10001,85.12,85.12,35942224,26936056.55,50.84008242310147,61.32808163442046,NaN,NaN,8.14828611219513,44.43805291140626,-0.37138616042550976,1.5531544710191412,1.924540631444651,683260517,711577448.2,42.465167759455326,70.04090012266481,NaN,NaN,18.416639305943804,23.263649519603298
2008-05-30T09:30:00-04:00,85.78,86.39,85.37,86,26786224,25470350.15,53.24143456123195,60.75233752477424,NaN,NaN,3.142782289202976,24.402968646493356,-0.4213959812369419,1.3977956548984736,1.8191916361354155,710046741,704843099.4,40.40829484892957,67.23286207691389,NaN,NaN,16.482467821520626,22.29490927702006
2008-06-02T09:30:00-04:00,85.58,87.34,85.49001,86.50999,25311856,25856299.75,54.62476911100585,60.40482752703412,NaN,NaN,14.076397673770629,16.102036532807915,-0.4146897469332096,1.3008294524689035,1.715519199402113,735358597,708171422.6,41.90598030037838,64.72033989047063,NaN,NaN,15.344797714592895,21.302036196673324
2008-06-03T09:30:00-04:00,86.10001,87.25,84.60001,84.64999,38844112,27148628,48.938203725517056,59.403810830423126,NaN,NaN,-31.35529135107474,6.3052472824778665,-0.5230886031944493,1.0616584454090514,1.5847470486035007,696514485,708876616.2,42.237226109789894,62.437593662538504,NaN,NaN,12.547128330864158,20.0513350729863
2008-06-04T09:30:00-04:00,84.50999,85.44,83.39,83.39,31625232,27675044,45.48392635124632,58.431956203590914,NaN,NaN,-91.63087658543688,-19.52374037226856,-0.6584671918959519,0.7616630587335607,1.4201302506295126,664889253,698013918.6,38.587351481826786,60.119637910306665,NaN,NaN,9.104430778617296,18.48749160236216
2008-06-05T09:30:00-04:00,84.14999,87.74001,84.14,87.74001,34914224,28264418.4,56.81663047674175,58.06440219459779,NaN,NaN,7.506083189727162,-19.652180956762155,-0.4441415109428366,0.8649533619509668,1.3090948728938034,699803477,701322510.6,40.28009771384636,58.10181152283008,NaN,NaN,9.860077849742117,17.25500392341644
2008-06-06T09:30:00-04:00,88.3,89.72,85.96001,86.02,46825760,29360300.8,52.19628965008447,56.89284182822219,NaN,NaN,33.43296876678925,-13.594143661244896,-0.4082254824021745,0.7988130198910852,1.2070385022932597,652977717,689908705.8,36.538503436732626,55.64402985063651,NaN,NaN,8.849991073086276,16.054287801940703
2008-06-09T09:30:00-04:00,86.60001,88.92999,86.60001,88.55,26791840,29703931.2,57.65149223590405,56.039257995381,NaN,NaN,62.04254620189992,-4.000913955619042,-0.213859807337202,0.9397137431217573,1.1535735504589593,679769557,678790897.8,33.29429048575071,52.62701292637765,NaN,NaN,9.958904953339854,15.183518823569154
2008-06-10T09:30:00-04:00,88.19,88.41,85.24001,86.37,27995136,30180730.4,52.13113579981993,54.67681902628845,NaN,NaN,-7.5483298696301055,0.7604783406698857,-0.2304637001923775,0.8654939252184874,1.095957625410865,651774421,669842885,30.915139931681566,49.16869968867071,NaN,NaN,8.905381397599257,14.286642048430597
2008-06-11T09:30:00-04:00,87.17,87.81,86.08,86.89999,30961664,30744288.8,53.30185321295489,53.79876773402055,NaN,NaN,0.3831540228963964,19.16328446233654,-0.20495832340010645,0.8397597211607319,1.0447180445608384,682736085,673412251.4,32.97270267250755,45.693495227784545,NaN,NaN,8.482118741943568,13.457424433218165
2008-06-12T09:30:00-04:00,86.3,86.46001,85.34,85.58,35288224,31265892.8,50.020630097515436,53.04272165955591,NaN,NaN,-63.66831506678125,4.9284048110348575,-0.27199096641360276,0.704729336543835,0.9767203029574377,647447861,662941128.2,30.137021771283514,42.08992621276166,NaN,NaN,7.065993666939664,12.544362895178379
2008-06-13T09:30:00-04:00,85.33,86.84,85.05,86.60001,16595723,30663006.15,52.456227831649336,52.832192463873334,NaN,NaN,-46.4854329908219,-11.055275540487372,-0.24355742980512118,0.6722735157010362,0.9158309455061574,664043584,665154301.6,31.478357316227985,39.225334462438816,NaN,NaN,6.683471986528307,11.707092765371225
2008-06-16T09:30:00-04:00,87.10001,87.58,86.7,86.91,16242254,30097583.65,53.20261524337988,52.80783392681382,NaN,NaN,7.559469131151944,-21.951890954636966,-0.2015347752847212,0.663912476400256,0.8654472516849772,680285838,665257557.8,31.544393921212517,37.28488440143065,NaN,NaN,6.601365319383218,10.977703130230081
2008-06-17T09:30:00-04:00,86.56,88.64,86.56,88.35001,20171904,29968580.45,56.6103030058773,52.679685266145,NaN,NaN,63.9020547402572,-7.661814032659505,-0.08062304692479694,0.764668443028981,0.8452914899537779,700457742,674994222,37.64671491133902,36.457945904354325,NaN,NaN,7.560798297699726,10.489573868440031
2008-06-18T09:30:00-04:00,88.14999,88.85001,87.28999,88.69,21526624,29759812.45,57.399059088387695,53.14818359937973,NaN,NaN,106.45827857180586,13.553210877122387,0.013379481664243964,0.8620158420340829,0.8486363603698389,721984366,682843878.2,42.12586551093582,36.43371002946007,NaN,NaN,8.572542850183163,10.215712294403335
2008-06-19T09:30:00-04:00,89.35001,89.60001,86.56,86.56,40450672,29528683.65,51.12835808362112,52.997249565264674,NaN,NaN,73.73014932617534,41.032903755713704,-0.07207140872384421,0.7585470994650336,0.8306185081888778,681533694,689661044.8,45.76936702216698,36.81664375611989,NaN,NaN,7.5973111833241225,9.84165499282059
2008-06-20T09:30:00-04:00,87.2,87.47,85.21001,85.75,32726736,29297230.05,48.93880837428181,52.59110951264153,NaN,NaN,-36.730810989364024,42.98382815600528,-0.18111716710295755,0.6042220493101809,0.7853392164131384,648806958,686613719.6,44.4230648636283,36.99643551063774,NaN,NaN,6.139173924267389,9.312729125884418
2008-06-23T09:30:00-04:00,85.64,89.14999,85.61,89.14,32882208,29691265.25,57.19989474799471,53.18123029996136,NaN,NaN,111.67620336676592,63.80717500312808,-0.030788382092217015,0.7468537387978671,0.7776421208900841,681689166,686894385.2,44.5847432819294,37.1641153086477,NaN,NaN,7.441271711044947,9.045378066621637
2008-06-24T09:30:00-04:00,88.42999,88.58,87.39999,87.45,33138048,30061744.45,52.628595161868894,53.6915637864344,NaN,NaN,88.04245836525735,68.6352557281281,-0.04989270076454644,0.715276244934401,0.7651689456989474,648551118,676513060.4,39.95480931633489,37.261790868255424,NaN,NaN,7.065383117932451,8.762521645380325
2008-06-25T09:30:00-04:00,87.73,88.2,85.07001,87.12,40033744,30752720.45,51.758753544874985,53.33028686272963,NaN,NaN,5.5512328161025195,48.45384657698743,-0.08728718805823643,0.6560599606261519,0.7433471486843883,608517374,653819662,32.10596526676507,36.677924264892475,NaN,NaN,6.5004348052696805,8.439366382507375
2008-06-26T09:30:00-04:00,87.39,87.8,85.2,86.49001,32077088,30559463.65,50.05779200579311,53.177537030994536,NaN,NaN,-22.57891446020384,29.1920338197116,-0.15313103369962489,0.5519333565598572,0.7050643902594821,576440286,632800980.4,26.84575730188945,35.98558525526082,NaN,NaN,5.53342765995538,8.02423227928566
2008-06-27T09:30:00-04:00,86.64,87.64999,86.41,87.25,23467760,30393540.45,52.10273093320713,52.781196937944756,NaN,NaN,24.579516560496806,41.454099329683764,-0.1443004498530871,0.5246888279431232,0.6689892777962103,599908046,623021198,24.80901922543198,35.37949445095234,NaN,NaN,5.313258685400504,7.636950337302067
2008-06-30T09:30:00-04:00,88.05,89.00999,87.75999,88.48,29916464,30623770.85,55.29329303113434,53.00706531161007,NaN,NaN,122.85390182751867,43.68963902183432,-0.05880446399955552,0.5954836977967659,0.6542881617963214,629824510,612648266.8,22.83053496441714,34.80202266757631,NaN,NaN,6.050669053349985,7.410338725308912
2008-07-01T09:30:00-04:00,88.17,89.03999,87.27,88.85001,31946672,30278898.85,56.23767964814512,53.216767199837946,NaN,NaN,110.2763499242652,48.13641733363589,0.015513544284256442,0.6736800921516419,0.6581665478673855,661771182,615292279.6,24.48367852589419,34.195663799961075,NaN,NaN,6.9272167270110705,7.341321296980649
2008-07-02T09:30:00-04:00,89.16,90.16,85.53,86.17,36698928,30532583.65,48.28211412438266,53.09258748747133,NaN,NaN,6.112871761100087,48.2487451226354,-0.11575096952076702,0.5134778359664267,0.6292288054871937,625072254,618603255.6,26.60406132426141,33.94330948231664,NaN,NaN,5.339393422442277,7.0553316006180244
2008-07-03T09:30:00-04:00,86.27,86.69,83.59,84.89999,32590816,30416413.25,45.031150460080184,52.562224818073524,NaN,NaN,-191.0527803875326,14.553971937169631,-0.27874279680134395,0.2808003094855138,0.5595431062868578,592481438,621811486,28.69334639869176,33.744380131064055,NaN,NaN,3.002332315690558,6.476331702771244
2008-07-07T09:30:00-04:00,84.28,85.66,82.05,82.77,39520624,30051156.45,40.1485537914783,51.62979185722342,NaN,NaN,-253.27215777041755,-41.01636292901323,-0.5073229919030535,-0.07461063359195919,0.43271235831109434,552960814,612422039.6,26.330957238825178,33.371991796607816,NaN,NaN,-0.5993735476254515,5.465516667000287
2008-07-08T09:30:00-04:00,82,82.22,79.62,81.39999,49906336,31206881.25,37.34384548063278,50.25361631970595,NaN,NaN,-305.20496821843005,-126.62813693820299,-0.7153737138915298,-0.46150478405331796,0.25386892983821185,503054478,587068033.2,21.244569471825216,32.20040997949969,NaN,NaN,-4.515202853689701,4.039699592616003
2008-07-09T09:30:00-04:00,82.2,83.19,79.58,79.85001,32329760,31423612.45,34.41465100924168,48.611872885481226,NaN,NaN,-231.76794101226218,-195.03699512550844,-0.9095053807785514,-0.8830127961349774,0.026492584643573958,470724718,548858740.4,16.173905715794902,30.346698565561052,NaN,NaN,-8.76806739895233,2.2100185938205272
2008-07-10T09:30:00-04:00,80.14999,82.52,78.92999,82.3,37618944,31756476.45,42.14019445059923,47.96986119740824,NaN,NaN,-170.77813326598198,-230.41519613092487,-0.8273944633417359,-1.007750494533596,-0.18035603119186006,508343662,525513022,13.97856297740482,28.07592684807804,NaN,NaN,-9.989567780322593,0.4672205403715102
2008-07-11T09:30:00-04:00,82.5,82.96001,80.41,81.8,33984864,31691308.45,41.07676468730879,47.40828664833874,NaN,NaN,-127.29021713809628,-217.6626834810376,-0.7628201064716473,-1.1338811642814193,-0.37106105780977194,474358798,501888494,12.177293175227192,25.772657441763677,NaN,NaN,-11.29607703489908,-1.2132505418100026
2008-07-14T09:30:00-04:00,82,83.27,81.28,82.34,21595488,31941296.7,42.75689849629348,46.37664405893151,NaN,NaN,-94.03531079886639,-185.81531408672737,-0.6445134288206733,-1.1767028438356135,-0.5321894150149402,495954286,490487188.4,11.412946877612555,23.403243412883903,NaN,NaN,-11.859704970564335,-2.734172603060621
2008-07-15T09:30:00-04:00,82.02,82.35001,78.67999,78.87,32630240,32760696,35.710413063558704,45.16820248048078,NaN,NaN,-133.49624680230343,-151.47356980350202,-0.7531700604401523,-1.4736519905651306,-0.7204819301249783,463324046,482541102,10.89946178822251,21.32786144659016,NaN,NaN,-14.683795859173046,-4.44126163964811
2008-07-16T09:30:00-04:00,78.69,78.97,75.92,76.84,49363264,34220264,32.35140702999898,43.78196344370392,NaN,NaN,-166.14004031642486,-138.34798966433456,-0.904772874308501,-1.8514480230106045,-0.9466751487021036,413960782,471188314.8,10.193794762187522,19.762706410548905,NaN,NaN,-18.18953369033144,-6.405300504031443
2008-07-17T09:30:00-04:00,77.59,78.39999,74.05,75.58,53502032,35819034.4,30.43765240231653,42.38052490059845,NaN,NaN,-162.4380456933932,-136.67997214981682,-1.0241444916529832,-2.2268557632683326,-1.2027112716153494,360458750,441611332.4,8.626760288721286,18.461349481036898,NaN,NaN,-21.68090591565915,-8.587529848549686
2008-07-18T09:30:00-04:00,76.00999,77.67999,75.59,76.89999,39610768,35777039.2,34.7897039557178,41.14388011649207,NaN,NaN,-129.6112544330409,-137.14417960880573,-0.9500733950723601,-2.3903030154557996,-1.4402296203834395,400069518,426753476.4,7.964416322443867,17.258163559394884,NaN,NaN,-23.185370318424788,-10.672935629960413
2008-07-21T09:30:00-04:00,77.5,79.2,76.49001,79.2,34084128,35844908.8,41.64098129833784,40.168714992720886,NaN,NaN,-89.38161314019852,-136.21344007707216,-0.6939310859490162,-2.3076434778197097,-1.6137123918706935,434153646,414393348.4,7.4518484573889054,16.159685951750014,NaN,NaN,-22.23978672360418,-12.325342929052379
2008-07-22T09:30:00-04:00,78.25999,78.86,76.33,76.57001,48906192,36646108,36.87068224119227,38.7853580350814,NaN,NaN,-98.42602785968414,-129.19939628854831,-0.6501369445171563,-2.426383572517139,-1.7762466279999827,385247454,398778030,6.85189103802395,14.900272559759284,NaN,NaN,-23.012631692683485,-13.852098466713965
2008-07-23T09:30:00-04:00,76.52,77.12,73.39,73.78999,55644864,37771448.8,32.617154857231085,37.666432373142,NaN,NaN,-130.4451845110321,-122.06042512746976,-0.7498270524837369,-2.713530443604654,-1.963703391120917,329602590,381906391.6,6.264986272453655,13.447481484630158,NaN,NaN,-25.13340702092369,-15.463713974458212
2008-07-24T09:30:00-04:00,74.16,74.81,71.85001,73.61,52468336,38393178.4,32.356887359631656,36.761127865967104,NaN,NaN,-139.02815123328946,-117.37844623544902,-0.7665875400488735,-2.921937816182009,-2.1553502761331353,277134254,365241492.4,5.741823158432169,11.808086967468759,NaN,NaN,-26.855651900406112,-17.091133678165054
2008-07-25T09:30:00-04:00,73.45,75.21001,73.24001,73.81,37195872,38649117.6,32.99667598041242,36.25027945089097,NaN,NaN,-114.08156013217271,-114.27250737527538,-0.7044934535639862,-3.035967093088118,-2.331473639524132,314330126,348093614,5.255501568837545,10.302697276755357,NaN,NaN,-28.030474894440573,-18.653896709061556
2008-07-28T09:30:00-04:00,74.38,75.57001,73.85001,74.10001,24045024,38677980.8,33.97191106392553,36.00942699255474,NaN,NaN,-96.24078448048024,-115.64434164333173,-0.5888800113453856,-3.067573653705864,-2.4786936423604784,338375150,328937914.8,4.769519076008777,9.12590796276847,NaN,NaN,-28.705873009257683,-20.08989332337529
2008-07-29T09:30:00-04:00,73.75999,74.00999,72.28999,73.22,28984672,38631391.2,32.42945793903132,35.867627487539714,NaN,NaN,-108.37004939026006,-117.63314594944691,-0.5191080878342782,-3.127578752153326,-2.608470664319048,309390478,313766519.6,4.420841814972135,8.286403398423984,NaN,NaN,-29.712651532226285,-21.46457306749686
2008-07-30T09:30:00-04:00,73.25,77.59,72.74001,77.58,44434848,39255800,45.6066131875494,36.1152288258933,NaN,NaN,-53.20128788272562,-102.18436662378562,-0.14613795075616354,-2.791143102764252,-2.6450051520080886,353825326,318611066.8,6.76475491326201,7.771131393842355,NaN,NaN,-26.41786201384787,-22.172185774118432
2008-07-31T09:30:00-04:00,76.58,76.69,73.77,74.39999,33170912,39079399.2,39.54869871103894,36.00608125615973,NaN,NaN,-67.67335144005499,-87.91340666513872,-0.08353350364071188,-2.7494220315589786,-2.6658885279182667,320654414,327315098.8,10.98830219596671,7.686203466752319,NaN,NaN,-25.547752014424024,-22.654409522733516
2008-08-01T09:30:00-04:00,74.45,76.37,74.16,74.39,29770320,38938374.4,39.53093416642509,35.77565523259771,NaN,NaN,-62.27111205710146,-77.55131705012447,-0.016248426370841784,-2.686199060881819,-2.669950634510977,290884094,322625892.4,10.706901855314896,7.635771679445345,NaN,NaN,-24.88087708168991,-22.972476316870143
2008-08-04T09:30:00-04:00,74.5,74.55,70.28999,70.89,48180304,39371358.4,33.80225168864655,35.639357991532556,NaN,NaN,-127.36924392638623,-83.77700893930566,-0.17224406718271856,-2.8852557184893755,-2.713011651306657,242703790,303491620.4,9.623870405970507,7.544658009284488,NaN,NaN,-26.191420305975488,-23.432325458170908
2008-08-05T09:30:00-04:00,70.44,71.78,69.83,71.42,43906176,39071350.4,35.3305541829092,35.85215421674043,NaN,NaN,-136.35380141800997,-89.37375934485564,-0.20243242290428132,-2.9660521799370088,-2.7636197570327274,286609966,298935518,9.380553695442188,7.48656936165982,NaN,NaN,-26.742665864846416,-23.905231230553124
2008-08-06T09:30:00-04:00,71.48,73.11,71.28999,73.05,38526432,39381184,39.924244990159366,36.52976797301492,NaN,NaN,-92.95621563286807,-97.32474489488412,-0.08152387149344875,-2.8655245963995384,-2.7840007249060896,325136398,293197732.4,9.069565312562332,7.518198291934182,NaN,NaN,-25.754308355127208,-24.169385105492278
2008-08-07T09:30:00-04:00,73.75999,73.97,71.86,72.2,33703424,39185408,38.39270840347635,36.7871254335691,NaN,NaN,-81.74049711575994,-100.13817403002511,-0.030330928856520334,-2.82191438597674,-2.7915834571202196,291432974,287353444.4,8.751320553179696,7.5744057369867415,NaN,NaN,-25.409529577321788,-24.346548601467923
2008-08-08T09:30:00-04:00,71.28999,71.69,69.72,70.98,37646384,39368484,36.24365017684676,36.40160178203403,NaN,NaN,-126.85575871229784,-113.0551033610644,-0.049061403119007974,-2.8529102110189797,-2.8038488078999717,253786590,279933943.6,8.350706862488991,7.638609908779605,NaN,NaN,-25.763745712468417,-24.54900533161085
2008-08-11T09:30:00-04:00,71.69,72.00999,69.66,70.95,33375872,39957503.2,36.190004568155125,36.352981948245656,NaN,NaN,-119.09434888392225,-111.40012435257158,-0.03458179723603205,-2.8470760544450116,-2.8124942572089795,220410718,275475329.2,8.110433205396149,7.728505777877619,NaN,NaN,-26.06445219645786,-24.765497740874707
2008-08-12T09:30:00-04:00,71.59,71.84,70.62,70.99001,31029952,39877488.8,36.325367786866565,36.617854300362474,NaN,NaN,-101.03958280104669,-104.33728062917893,0.0045008921840894445,-2.8068681419788675,-2.811369034162957,251440670,268441470,7.732445040992928,7.83332426134471,NaN,NaN,-26.274889593874427,-24.981125148446097
2008-08-13T09:30:00-04:00,70.77,73.50999,70.77,73.5,44127584,39615704.8,44.30714439740376,37.471444088774774,NaN,NaN,-45.86271582503862,-94.91858066761306,0.21457363339650826,-2.5431519924173216,-2.75772562581383,295568254,262527841.2,7.419371517565466,7.953149144139945,NaN,NaN,-24.155436550591208,-24.86316963446683
2008-08-14T09:30:00-04:00,72.99001,73.36,71.36,72.14999,36174880,38749347.2,41.307873846291606,38.06510107919472,NaN,NaN,-51.28493201524811,-88.82746764751069,0.2739820271709932,-2.4152480918500885,-2.6892301190210817,259393374,256119921.2,7.084641189579543,8.083801974192946,NaN,NaN,-23.191693235672965,-24.62438729178199
2008-08-15T09:30:00-04:00,71.84,71.87,70.16,70.8,41754224,38856520,38.501185241477124,38.38862066330554,NaN,NaN,-93.45298818154143,-82.14691354135942,0.23521945654793397,-2.395205798336164,-2.630425254884098,217639150,248890433.2,6.716474527556599,8.222870220732077,NaN,NaN,-23.178577672085662,-24.417843060396798
2008-08-18T09:30:00-04:00,71.33,72.09,68.35001,69.89999,32069536,38755790.4,36.71036671333142,38.69439986146983,NaN,NaN,-119.19315656045717,-82.16667507666641,0.1651377849754989,-2.4240030236647243,-2.5891408086402232,185569614,241922212.4,6.372718455710768,8.362289980784835,NaN,NaN,-23.68306966541342,-24.31287543254203
2008-08-19T09:30:00-04:00,69.92,72.49001,69.86,72.41,44235936,38522277.6,44.468068160376525,38.61307521667178,NaN,NaN,-53.14582325158418,-72.5879231667739,0.2963428322637123,-2.2187122683105827,-2.515055100574295,229805550,237595188.4,6.161821550607328,8.319223312023789,NaN,NaN,-21.77135439758631,-23.949800998976926
2008-08-20T09:30:00-04:00,73.22,74.75,72.37,74.5,46729456,38076507.2,49.96739025499048,39.35726746981117,NaN,NaN,58.96463033014423,-51.62245393573734,0.519353027738334,-1.8658638159013776,-2.3852168436397116,276535006,233788538.8,5.974501013166915,7.961094656109516,NaN,NaN,-18.369797331684676,-23.152657617935176
2008-08-21T09:30:00-04:00,75.46001,76.709,74.91,76.37,33173072,37111744,54.32570171018282,40.41403658007958,NaN,NaN,140.74943291623234,-13.215580949441243,0.7729907519368573,-1.41897840371864,-2.191969155655497,309708078,243851479.6,13.463794112626402,8.158015531631767,NaN,NaN,-14.066500046777207,-21.854635107769752
2008-08-22T09:30:00-04:00,75.67999,75.83,73.96001,74.62,24973856,36500643.2,49.941339570856584,41.56682857166601,NaN,NaN,84.28021906670583,22.331060500208206,0.79974736386316,-1.1922849508265472,-1.9920323146897072,284734222,257270494,22.346340645873013,9.066763405910518,NaN,NaN,-11.807050953463822,-20.419265942868904
2008-08-25T09:30:00-04:00,74.82001,75.35001,73.37,73.64999,22392384,36418011.2,47.645982740832935,42.44650204008913,NaN,NaN,56.84072627240202,57.53783706678005,0.7308510178110494,-1.0784685424258953,-1.8093195602369447,262341838,272624938.8,31.06549711402603,10.615687935809362,NaN,NaN,-10.660470919960378,-19.025152368167685
2008-08-26T09:30:00-04:00,74.45,75.60001,74.12,75.14999,26955696,36316562.4,51.36826670804994,43.2639321627956,NaN,NaN,83.35192613357894,84.83738694381266,0.7615774216104012,-0.8573477832239433,-1.6189252048343445,289297534,284523335.6,36.97143628644408,12.608678719658059,NaN,NaN,-8.538447264197385,-17.52705163902907
2008-08-27T09:30:00-04:00,76.07001,76.66,75.60001,76.34,24056784,35297659.2,54.15318643748571,44.389680593796264,NaN,NaN,132.25662291340618,99.49578546046504,0.8316160795411551,-0.5794051054079006,-1.4110211849490557,313354318,291887198,40.376102813152414,14.867591738227537,NaN,NaN,-5.910271687647026,-15.867511645974494
2008-08-28T09:30:00-04:00,76.75999,76.91,74.10001,75,28420608,35060144,50.63678894366174,45.41776193428306,NaN,NaN,95.39787359758203,90.42547359673499,0.7592686056751907,-0.46193542785506736,-1.221204033530258,284933710,286932324.4,38.85521194846788,17.046484958654602,NaN,NaN,-4.750534254443725,-14.279372018612955
2008-08-29T09:30:00-04:00,75.91,75.98,74.35001,74.64999,22383216,34690788.8,49.7284679275801,46.38479503138484,NaN,NaN,81.66487854638902,89.90240549267163,0.6629171592716618,-0.3925575844406808,-1.0554747437123426,262550494,282495578.8,37.49331536875225,19.14526225603718,NaN,NaN,-4.069090844039049,-12.820760422245254
2008-09-02T09:30:00-04:00,72.10001,72.19,70.55,70.55,50450224,34804284.8,40.55205237444949,46.686701073355046,NaN,NaN,-70.00312444284337,64.53363534962254,0.31574550468620044,-0.660792862854592,-0.9765383675407925,212100270,272447265.2,34.54049679932049,21.06012309591772,NaN,NaN,-6.422185409573679,-11.906678277577885
2008-09-03T09:30:00-04:00,70.22,71.56,69.27,70.28,50175168,35117734.4,40.028210968801545,46.381062971312026,NaN,NaN,-95.61751661081524,28.739746800743717,0.07326528098564777,-0.8849567663087328,-0.9582220472943805,161925102,246972778.8,28.42791288785743,22.56073319379572,NaN,NaN,-8.44935398363644,-11.412774807014822
2008-09-04T09:30:00-04:00,70.31,71.00999,67.86,68.7,54047104,35893768,37.01491528248892,46.074423073897556,NaN,NaN,-125.08251858247904,-22.728081498433333,-0.17465329403691254,-1.1765386648405212,-1.0018853708036086,107877998,205877514.8,21.743106084048776,23.607766400543518,NaN,NaN,-11.115978220197844,-11.370375294612396
2008-09-05T09:30:00-04:00,69.09,69.13,66.81,68.42,50715056,36744349.6,36.49065988002353,45.930814119508014,NaN,NaN,-140.49036441792225,-69.90572910153419,-0.32962318779221755,-1.4139143555438807,-1.0842911677516631,57162942,160323361.2,16.977325444169395,24.34068432315872,NaN,NaN,-13.42749631032762,-11.664249725428856
2008-09-08T09:30:00-04:00,70.06,70.28999,67.22,67.95,50215024,37372781.6,35.579712892321425,45.85005313229301,NaN,NaN,-118.93050215347854,-110.02480524150769,-0.4295849491425958,-1.621272354179908,-1.191687405037312,6947918,109202846,13.42198536621261,24.844203388194565,NaN,NaN,-15.604999454227658,-12.227213972400113
2008-09-09T09:30:00-04:00,67.31,67.32001,63.25,63.25,65055040,38956740,28.041104463302702,44.67669858250203,NaN,NaN,-200.25220469241907,-136.07462129142283,-0.7587981250307407,-2.140185061325738,-1.3813869362949973,-58107122,55161367.6,10.838059313415755,25.178220371252312,NaN,NaN,-20.27616682407036,-13.377064379781576
2008-09-10T09:30:00-04:00,64.13,66.28,63.71001,65.74001,60378448,40424164.8,35.80178196614311,43.66486941901293,NaN,NaN,-156.478373597769,-148.2467926888136,-0.7538646520925261,-2.323717751410655,-1.5698530993181288,2271326,23230612.4,9.655301533808043,25.44113469415525,NaN,NaN,-21.676608766725984,-14.56271357791649
2008-09-11T09:30:00-04:00,65.00999,66.95,63.7,66.67999,51975504,40816560.8,38.49830680668317,42.534341211620095,NaN,NaN,-124.63870810938862,-148.1580305941955,-0.6369542373838912,-2.366045896047993,-1.7290916586641016,54246830,12504378.8,9.288596289030593,25.142906278184117,NaN,NaN,-21.92848533742067,-15.614966686417088
2008-09-12T09:30:00-04:00,66.75841,68.98,66.754,68.92999,53380880,41676860.8,44.506852876889965,42.146163590622486,NaN,NaN,-63.989097797191846,-132.85777727004944,-0.3709333185477375,-2.1927583068487735,-1.821824988301036,107627710,22597332.4,12.65036688662991,24.450336723952468,NaN,NaN,-20.165181934512656,-16.264997436145027
2008-09-15T09:30:00-04:00,65.62,67.21001,63.64999,63.64999,54457008,42312000,35.69404703053797,41.292453897029986,NaN,NaN,-118.81836656404396,-132.8353501521625,-0.5050996571010238,-2.4531995596773157,-1.948099902576292,53170702,31841889.2,15.730907958605002,23.35500892713668,NaN,NaN,-21.738775532610745,-17.04696573564013
2008-09-16T09:30:00-04:00,62,66.34,61.06,66.34,61229904,43770018.4,41.99566961906113,40.622982676387934,NaN,NaN,-109.51487090398761,-114.68788339447622,-0.37328375141106296,-2.4147045918401204,-2.0414208404290575,114400606,66343434.8,26.192621787661466,22.585093605795066,NaN,NaN,-20.72103452060571,-17.571832704920926
2008-09-17T09:30:00-04:00,65.42999,67.60001,63.75999,64.95,66505184,44883480.8,39.82400984733094,39.599470062805445,NaN,NaN,-84.15293359662775,-100.22279539424795,-0.34119125292921604,-2.4679099065905774,-2.1267186536613614,47895422,75468254,28.713277717819636,21.752034670414155,NaN,NaN,-20.67727552361807,-18.01546739330623
2008-09-18T09:30:00-04:00,66.98,67.64,63.61,66.89,63258832,45709949.6,44.163855755235495,39.13711769220357,NaN,NaN,-66.93781775660001,-88.68261732369024,-0.15999533152858758,-2.326712818072096,-2.1667174865435084,111154254,86849738.8,31.840092251225897,21.250954692039727,NaN,NaN,-19.157476751012886,-18.178611587264324
2008-09-19T09:30:00-04:00,71.36,78.10001,68.41,71.25,46144976,46358544.8,52.461681710620276,39.332347248135015,NaN,NaN,51.50242751308014,-65.58431226163586,0.25996054529536305,-1.8417668049243048,-2.101727350219668,157299230,96784042.8,34.53906730562923,21.039936973245226,NaN,NaN,-14.82416113217625,-17.6994043793946
2008-09-22T09:30:00-04:00,71.36,72.58,70,70,34272224,46823463.2,50.16015521129681,40.01864030790982,NaN,NaN,25.21706469505032,-36.77722600981701,0.4489421589379099,-1.5405496515472805,-1.9894918104851904,123027006,110755303.6,38.242805438888425,21.30438759035722,NaN,NaN,-12.217420328629116,-16.916263800713818
2008-09-23T09:30:00-04:00,70.17,71.10001,67.69,67.69,32193120,47313500,46.132370978492204,40.454651737173435,NaN,NaN,-9.595425044462301,-16.793336837911944,0.4145768970303716,-1.471270689197226,-1.8858475862275976,90833886,106041959.6,37.47252431481468,21.950431263711312,NaN,NaN,-11.43465096523792,-16.13317625278869
2008-09-24T09:30:00-04:00,68.7,69.03,67.6205,67.89,29590240,47445227.2,46.53268280266373,41.134492274328785,NaN,NaN,-17.66981517536993,-3.4967131536603793,0.40126105586488126,-1.384271266396496,-1.7855323222613773,120424126,120547700.4,41.3854399111861,23.353455108506836,NaN,NaN,-10.70020361212986,-15.357037304123143
2008-09-25T09:30:00-04:00,67.92,69.95,67.89999,69.55,27722192,47628497.6,49.863043700669536,42.08966254723207,NaN,NaN,14.303229322986672,12.751496262256957,0.4940958562834359,-1.1679125019070824,-1.6620083581905183,148146318,127946113.2,43.33322662210921,25.236019478359676,NaN,NaN,-9.050250438392318,-14.456067751875882
2008-09-26T09:30:00-04:00,67.59,68.49001,66.02,67.7,34621168,47938525.6,46.394718783875184,42.862162968057326,NaN,NaN,-24.391543684981563,-2.4272979773553613,0.4234711243252598,-1.1326694527839436,-1.5561405771092034,113525150,119191297.2,41.572720728406736,27.24678628994497,NaN,NaN,-8.733095177996171,-13.638500241321637
2008-09-29T09:30:00-04:00,65.99001,65.99001,59.13,59.64999,45861616,49112445.6,34.98980734653384,43.35849888828812,NaN,NaN,-177.99544655667464,-43.069800227700355,-0.14253994083609367,-1.7343155031543205,-1.5917755623182268,67663534,108118602.8,39.39287809856578,29.286416203169974,NaN,NaN,-12.619601018987057,-13.492943209559554
2008-09-30T09:30:00-04:00,61.92,64.28999,61.42999,63.3,33206944,48250281.6,41.956967342633284,43.79815498660884,NaN,NaN,-119.36218398012456,-65.0231520148328,-0.24238550671841996,-1.8947574457162517,-1.6523719389978317,100870478,110125921.2,40.00701444920726,31.454395697127058,NaN,NaN,-13.249015832072471,-13.458096441347113
2008-10-01T09:30:00-04:00,62.7,63.42999,60,62.25999,46615680,48072307.2,40.621127332289625,43.949785024152156,NaN,NaN,-133.4981054128228,-88.18881006232338,-0.3435671732873624,-2.0818309056070348,-1.7382637323196724,54254798,96892055.6,37.32191601130478,33.4567756772895,NaN,NaN,-14.194246356848133,-13.563260714990117
2008-10-02T09:30:00-04:00,61.3,61.42,57.62,58.71001,47000240,47719964,36.36506657761125,43.36822885991797,NaN,NaN,-178.46568237560794,-126.7425924020423,-0.5996795342937908,-2.487863150186911,-1.88818361589312,7254558,68713703.6,32.34416105635681,34.86347526084142,NaN,NaN,-16.4747020348913,-13.979180903547428
2008-10-03T09:30:00-04:00,58.5,61.69,57.49001,58.00999,48512528,47609837.6,35.57356379214144,43.359622914318216,NaN,NaN,-159.2111461237609,-153.70651288979815,-0.7562290397625979,-2.8334699155963676,-2.0772408758337697,-41257970,37757079.6,27.936008448469067,35.73526815297457,NaN,NaN,-18.50797416625037,-14.626151369647848
2008-10-06T09:30:00-04:00,55.75999,55.92999,50.98,54.89,69545312,48576352,32.20869154622176,42.66055305197255,NaN,NaN,-227.8365705188913,-163.6747376822415,-0.9948811254288019,-3.320842282619772,-2.32596115719097,-110803282,2063716.4,23.89263909076692,35.57098367462496,NaN,NaN,-21.34685065750481,-15.586251267913129
2008-10-07T09:30:00-04:00,56.53999,57.28,51.53999,51.88,48028000,47725000,29.326641537439414,41.91074102983744,NaN,NaN,-186.43019038307003,-177.0883389628306,-1.2631961409150256,-3.904956333334752,-2.6417601924197265,-158831282,-49876635.6,19.475262022836247,34.91112541069757,NaN,NaN,-24.693583494205278,-16.887298728812006
2008-10-08T09:30:00-04:00,50.32001,54.64999,49.16,52.86,80498256,48730990.4,31.476511337851846,41.004502142881464,NaN,NaN,-167.94472998760315,-183.97766387778665,-1.2785262315087307,-4.23991798180564,-2.961391750296909,-78333026,-76394200.4,17.678242219466313,33.899564694143315,NaN,NaN,-26.685763197409567,-18.287079367183086
2008-10-09T09:30:00-04:00,53.25,54.03,45.25,45.25,55291504,48896790.4,25.09308616850693,39.049602461301944,NaN,NaN,-182.85948266356635,-184.85642393537836,-1.679766355924405,-5.061099695202415,-3.3813333392780103,-133624530,-104570018,15.989961912358055,32.574628594623945,NaN,NaN,-30.85806749077876,-20.08293481341104
2008-10-10T09:30:00-04:00,42.99001,45.74001,38.84,43.39999,93384368,50896964.8,23.82797575129605,37.168732499873315,NaN,NaN,-201.60218836518985,-193.33463238366411,-1.9304361101601595,-5.79437847697821,-3.8639423668180504,-227008898,-141720203.6,14.080570867714755,30.848754696682967,NaN,NaN,-34.587068743886505,-22.154953946336107
2008-10-13T09:30:00-04:00,45.34,51.63,44.42,50.55,50497488,50698988.8,37.03967230567174,36.519254023243285,NaN,NaN,-115.62674716567778,-170.89266771302144,-1.494830645576406,-5.732480673788558,-4.237650028212152,-176511410,-154861829.2,13.467909593021659,29.13413935941204,NaN,NaN,-33.05616380909734,-23.712269641016285
2008-10-14T09:30:00-04:00,52.73,56.95,48.38,50.61,62725248,50773756,37.13820472756422,35.84821987502189,NaN,NaN,-76.0182934969276,-148.81028833579293,-1.1009771806837811,-5.6138715040668785,-4.512894323383097,-113786162,-145852805.2,16.161052037590153,27.3323973684409,NaN,NaN,-31.877121546783687,-24.878677056125913
2008-10-15T09:30:00-04:00,48.2,48.84,41.96001,43.3,59786256,50437809.6,30.811520987472775,34.48739682407927,NaN,NaN,-124.53684746843494,-140.1287118319593,-1.2217663424051945,-6.040102251389591,-4.8183359089843965,-173572418,-164900683.6,15.091577804259288,25.31513673859448,NaN,NaN,-33.106328454096605,-26.054055827264584
2008-10-16T09:30:00-04:00,43.78,46.08,40.25999,44.95,77418368,51145786.4,33.56269753469324,33.57082387770913,NaN,NaN,-115.18659387378192,-126.59413407400241,-1.0842006443131869,-6.17358671437588,-5.089386070062693,-96154050,-157406587.6,17.40736861071774,23.589040158759552,NaN,NaN,-33.11314038182524,-27.062496477916106
2008-10-17T09:30:00-04:00,44.53,49.64999,43.61,45.94,63332736,52005174.4,35.22693411903998,33.58776150431671,NaN,NaN,-84.890140591206,-103.25172451920564,-0.8315630920060544,-6.1288399350702605,-5.297276843064206,-32821314,-118569070.8,28.318559731985204,22.798017418289508,NaN,NaN,-32.57807949355134,-27.85043690872114
2008-10-20T09:30:00-04:00,47.73,51.28999,47.62,51.28999,45003440,52541735.2,43.46827322570041,33.695711924535786,NaN,NaN,-49.236376638654725,-89.97365041380104,-0.23990473218187613,-5.5971577582915515,-5.357253026109675,12182126,-80830363.6,37.02462414690997,22.584989539553987,NaN,NaN,-29.31593752173175,-28.059794139151226
2008-10-21T09:30:00-04:00,49.78,51.0576,47.89,48.96001,43901648,53127161.6,41.020409543921694,33.72423208250951,NaN,NaN,-50.897635754259504,-84.94951886526744,0.04365864080107862,-5.302679725108327,-5.346338365909405,-31719522,-64417035.6,40.41425083549786,22.80587059842492,NaN,NaN,-27.472230589476602,-27.975856489197707
2008-10-22T09:30:00-04:00,47,47,42.41,44.2,62101760,54752737.6,36.49842271796216,33.733757521106,NaN,NaN,-90.38977805131462,-78.12010498184337,-0.03592916023475645,-5.391249816202851,-5.355320655968095,-93821282,-48466808.4,43.59170284850132,23.609266440720955,NaN,NaN,-27.403663665514514,-27.894114657242966
2008-10-23T09:30:00-04:00,44.52,46.81,42.31,46.55,87318368,57732546.4,40.0142082663475,34.050946412120716,NaN,NaN,-78.65018538458769,-70.81282328400454,0.11486516004881242,-5.2117392059070795,-5.326604365955892,-6502914,-30536581.2,47.01239868267736,24.971865743164408,NaN,NaN,-26.199788100391793,-27.652068006264226
2008-10-24T09:30:00-04:00,41.27,45.52,41.2,43.64999,54316608,58717318.4,37.27178565840965,34.41259599156271,NaN,NaN,-92.20915943212553,-72.27662705218845,0.06684846913299047,-5.243043779539654,-5.309892248672645,-60819522,-36136222.8,46.072730455743034,26.556157983519842,NaN,NaN,-26.0832569084625,-27.427952135149695
2008-10-27T09:30:00-04:00,43.2,45.48,40.78,40.86,46605264,58754500.8,34.80065661481528,34.80359706851813,NaN,NaN,-98.46588240123215,-82.12252820470391,-0.09639313952164485,-5.430383673074701,-5.333990533553056,-107424786,-60057605.2,42.192904205167466,28.178846710829216,NaN,NaN,-26.77197775526808,-27.334241509452323
2008-10-28T09:30:00-04:00,43.47,47.09,41.06,47.09,62964480,60242377.6,43.76630903933705,35.681439761481364,NaN,NaN,-59.75303425265848,-83.89360790438371,0.2525562894542812,-5.018295171735204,-5.270851461189485,-44460306,-62605762,41.789205829229076,29.90105839724084,NaN,NaN,-24.372443212172048,-26.91112746698371
2008-10-29T09:30:00-04:00,47.48,50.46001,47.09,48.13,63809888,61102088,45.12293318519717,37.11214311981638,NaN,NaN,-1.6389171550762613,-66.14343572513604,0.5724553302649653,-4.555282298358279,-5.127737628623244,19349582,-39971589.2,46.670224820250986,32.09250574780462,NaN,NaN,-22.044994002386975,-26.215965543469892
2008-10-30T09:30:00-04:00,49.39,50.62,47.36,50.35001,52710928,61387622.4,48.00642616056658,38.83917529190713,NaN,NaN,24.053123315266525,-45.60277398516519,0.9313772542338254,-3.963516060830962,-4.894893315064787,72060510,-24258904.4,49.81610238522483,34.64504371334105,NaN,NaN,-19.226397920197503,-25.21745588300241
2008-10-31T09:30:00-04:00,49.48,52.63,48.88,51.39999,47996256,61361808.8,49.36167218749766,39.71931814060899,NaN,NaN,67.45550813765338,-13.669840471209412,1.2191513066653181,-3.37095418173314,-4.590105488398458,120056766,11916353.2,56.2193485761575,37.69871792642219,NaN,NaN,-16.52947554819079,-23.976315835172176
2008-11-03T09:30:00-05:00,50.60001,51.24001,48.89999,49.81,31029424,59436014.4,47.3489809376259,40.44865929847054,NaN,NaN,53.87285712891992,16.797907434821006,1.2759902498424145,-2.9951176760954397,-4.271107925937854,89027342,51206778.8,61.90481025432795,40.96612922761774,NaN,NaN,-14.860072261806057,-22.6739953246913
2008-11-04T09:30:00-05:00,50.96001,53.3,50.94,53.02,33952496,58732239.2,51.63644809742934,41.93615409203886,NaN,NaN,111.39062186596595,51.026638658545885,1.4885198574346186,-2.410458104144581,-3.8989779615791997,122979838,84694807.6,65.9620815250664,44.59973663624682,NaN,NaN,-12.13666820203604,-21.168662878597694
2008-11-05T09:30:00-05:00,51.64999,53.3,50.41,50.64999,42643296,56839491.2,48.496419995937664,43.00284855355632,NaN,NaN,91.41448330739053,69.63731875103925,1.4279963639033957,-2.113982506699955,-3.5419788706033506,80336542,96892199.6,67.32702499613094,48.165426378062044,NaN,NaN,-10.73915781711148,-19.678733584099664
2008-11-06T09:30:00-05:00,50.14999,50.61,47,47.60001,52272320,56688532,44.72696870380421,43.68142245246805,NaN,NaN,21.071303737946188,69.04095483557518,1.152852428613476,-2.1009133348365054,-3.2537657634499815,28064222,88092942,65.29288306936796,50.80644947358939,NaN,NaN,-10.652982000681579,-18.389340500754223
2008-11-07T09:30:00-05:00,48.23,49.92999,47.82001,49.85001,33573552,53697991.2,47.94158824066197,44.00094495353674,NaN,NaN,34.419526833705085,62.43375857478552,1.0932168160572626,-1.8872447433784032,-2.980461559435666,61637774,76409143.6,62.58885294613578,52.63246581639123,NaN,NaN,-9.633014642993093,-17.13843680678835
2008-11-10T09:30:00-05:00,51.32001,51.91,49.03,50.02,40687264,53207480,48.18676682292157,44.51282761632244,NaN,NaN,59.062901773726786,63.47176750374689,1.0365508012776998,-1.684773057838541,-2.7213238591162408,102325038,79068682.8,62.964834890425195,54.243221820314616,NaN,NaN,-8.735606129196151,-15.938032424275178
2008-11-11T09:30:00-05:00,48.74001,49.56,47.5,48.58,36854736,51913954.4,46.201707705697835,45.205919401160706,NaN,NaN,21.328597056868343,45.45936254192737,0.879608289466189,-1.6218134972835045,-2.5014217867496935,65470302,67566775.6,60.14940047610174,55.42591450800036,NaN,NaN,-8.52042837889317,-14.87837470350632
2008-11-12T09:30:00-05:00,47.2,47.53999,44.49001,44.60001,39566448,50902964,41.155369693293196,45.28743093165682,NaN,NaN,-57.431391405161534,15.690187599416959,0.5039405646596022,-1.8714960809251906,-2.375436645584793,25903854,56680238,57.52743506693395,56.17698853544726,NaN,NaN,-9.797771213736874,-14.152574204967829
2008-11-13T09:30:00-05:00,45.35001,50,43.00999,49.84,63994256,50231758.4,49.046284069775474,46.12846653246867,NaN,NaN,-9.381366709675106,9.599653509892695,0.5981222382171163,-1.6277838478133972,-2.2259060860305135,89898110,69047015.6,59.67770204984836,57.1487722207405,NaN,NaN,-8.525978517977743,-13.348774821112102
2008-11-14T09:30:00-05:00,48.5,50.5,46.88,47.77,55600464,49845144.8,46.39927022504701,46.95693893319951,NaN,NaN,10.060006422816437,4.727749427714963,0.5139895273189787,-1.5834191768817902,-2.097408704200769,34297646,63578990,58.27291873401078,58.297344687086444,NaN,NaN,-8.27535948243168,-12.624001201300613
2008-11-17T09:30:00-05:00,47.28999,48.96001,46.67,46.78,44605552,49825250.4,45.14438676779967,47.05537305666112,NaN,NaN,-13.4545720267436,-9.775745332379113,0.39025478131665814,-1.6095902275549463,-1.9998450088716044,-10307906,41052401.2,52.76264259523548,59.08116159894405,NaN,NaN,-8.439975548602995,-12.02628325091524
2008-11-18T09:30:00-05:00,47.08,48.5,45.92,48.09,52403664,50250351.2,47.18007293622825,47.2023116103062,NaN,NaN,-9.900235594006297,-16.021511862554043,0.3940757839709321,-1.5072502789079394,-1.9013260628788715,42095758,36377492.4,51.67066669896764,59.43833601885238,NaN,NaN,-7.995424642762507,-11.45044630689342
2008-11-19T09:30:00-05:00,47.97,48.88,45.425,45.60001,49142896,49602408,43.84916898840319,46.90536466943739,NaN,NaN,-42.168359172987245,-12.968905416119185,0.2342412926891302,-1.6085244470174587,-1.8427657397065889,-7047138,29787294,50.09666443246132,59.45837616508356,NaN,NaN,-8.57670003165091,-11.03991112471592
2008-11-20T09:30:00-05:00,44.3,44.67999,39.82001,39.96001,66121808,48542580,37.407120815852906,46.05146814289133,NaN,NaN,-185.21759781942842,-48.13615163806982,-0.22135066600151032,-2.1194540722084767,-1.8981034062069664,-73168946,-2826117.2,43.09958510167368,58.52125020262043,NaN,NaN,-11.149742162952705,-11.05560127303546
2008-11-21T09:30:00-05:00,41.28,44.94,40.52,44.42,75366064,49595052.8,44.36746783954785,45.83850292160004,NaN,NaN,-130.96238163982972,-76.34062925059905,-0.1933725228609129,-2.1398190597831075,-1.9464465369221946,2197118,-9246222.8,41.86010674506603,57.08948566624458,NaN,NaN,-11.149247852559148,-11.068979355824558
2008-11-24T09:30:00-05:00,45.62,49.07001,44.82001,47.63,55495040,50039541.6,48.781997431030526,45.63461358828584,NaN,NaN,-26.74172810496325,-78.99806046624299,0.05690062480211333,-1.875320755919553,-1.9322213807216664,57692158,4353790,45.43962849749412,55.62359616427513,NaN,NaN,-9.718040292704504,-10.875988061093121
2008-11-25T09:30:00-05:00,48.21001,48.85001,46.8,48.39,46598912,49221263.2,49.79771355176291,45.727563127987644,NaN,NaN,-3.9078048929380573,-77.79957432602933,0.2769012783856357,-1.5860947827396217,-1.8629960611252574,104291070,16792852.4,48.559176691156935,54.28303557106269,NaN,NaN,-8.26242540690512,-10.502621967637692
2008-11-26T09:30:00-05:00,47.85001,51.45,47.45,51.10001,39362176,47998877.6,53.35026877908149,46.34351313336459,NaN,NaN,63.40235841191669,-56.685430809048555,0.5902088899573745,-1.1252349486785391,-1.7154438386359137,143653246,46932929.2,55.23753567425028,53.56479647141144,NaN,NaN,-5.933580931670813,-9.849901819642424
2008-11-28T09:30:00-05:00,50.46001,50.60001,49.17999,50.28,15984961,46162579.25,52.14776627444449,46.64395442149191,NaN,NaN,62.2422879097283,-7.193453663217214,0.7189525573482629,-0.8167531419505849,-1.5357056992988478,127668285,87100375.4,62.26803023271871,53.541880563310215,NaN,NaN,-4.387953264238057,-9.069623454584658
2008-12-01T09:30:00-05:00,48.25,48.25,44.88,44.92999,37264080,45625970.45,45.018277630866685,46.417633764916566,NaN,NaN,-68.47453925487696,5.304114813773339,0.43453350893955434,-0.9925388131244048,-1.4270723220639592,90404205,104741792.8,64.87721465138105,53.67847911766421,NaN,NaN,-5.21979222566794,-8.519647564739412
2008-12-02T09:30:00-05:00,46.09,46.61,44.73,46.45,37802832,45964640.85,47.22587685162133,46.4907887039111,NaN,NaN,-64.46714781141564,-2.240969127517141,0.3435000280740288,-0.9976972869714231,-1.341197315045452,128207037,118844768.6,66.85069023258998,54.157142671699084,NaN,NaN,-5.231308348061439,-8.0498848194997
2008-12-03T09:30:00-05:00,45.28,46.63,44.59,46.48,47998736,46666952.85,47.270876791585934,46.92761063950344,NaN,NaN,-58.601484449331245,-13.179705038795777,0.2825771366243628,-0.9879758942649985,-1.2705530308893613,176205773,133227709.2,68.77747180251555,54.960716724240626,NaN,NaN,-5.2276637159611425,-7.646710376137049
2008-12-04T09:30:00-05:00,45.69,46.27,42.39999,43.25999,49103568,46989966.45,43.029757787412876,46.497858762191825,NaN,NaN,-115.99263994934354,-49.058704711047824,0.03566856188371159,-1.225967328534722,-1.2616358904184335,127102205,129917501,67.80071914707695,55.54093223118553,NaN,NaN,-6.479111892845332,-7.479910592809661
2008-12-05T09:30:00-05:00,42.36,44.23,40.53,44.16,52495440,47001122.45,44.527843453901134,46.364185421395696,NaN,NaN,-131.21211086119465,-87.7495844652324,-0.05202012510279608,-1.3266610467969286,-1.2746409216941326,179597645,140303373,69.27507255550712,56.3268003612924,NaN,NaN,-7.0908773423820435,-7.424334414177144
2008-12-08T09:30:00-05:00,45.95,47.17999,45.52,46.12,49188032,47781846.45,47.75015137759082,46.5503114649522,NaN,NaN,-13.709288857690016,-76.79653438579501,0.032448564681479386,-1.2340802158422832,-1.2665287805237626,228785677,167979667.4,72.84351460114966,57.761148361714845,NaN,NaN,-6.70182465726568,-7.321118734618364
2008-12-09T09:30:00-05:00,46.03,47.87,45.77,46.58,43003744,47897670.45,48.50617194664196,46.6450328228389,NaN,NaN,10.470798364594943,-61.8089451505929,0.1245937221175939,-1.1107866278767702,-1.235380349994364,271789421,196696144.2,75.9629554034111,59.49631184060367,NaN,NaN,-6.172070047215463,-7.1569689221322355
2008-12-10T09:30:00-05:00,47.49001,49.38,47.47,48.99001,41461136,48127990.45,52.39274977472598,47.25528859329052,NaN,NaN,84.18646072846046,-33.25135611503456,0.34088104767019933,-0.809279040406615,-1.1501600880768144,313250557,224105101,78.50135666320924,61.525218428514236,NaN,NaN,-4.616385424894169,-6.7940284225267975
2008-12-11T09:30:00-05:00,49.39,50.785,48.17999,48.75999,41017968,48200566.45,51.989421551164895,48.296881502955664,NaN,NaN,98.33971689839547,9.615115254513242,0.45438265629210095,-0.5821817677116883,-1.0365644240037892,272232589,253131177.8,80.8122683952958,64.21898152091582,NaN,NaN,-3.4332201692214444,-6.31391295776889
2008-12-12T09:30:00-05:00,47.02,48.73,46.56,48.28,40724432,47037075.25,51.105314688588294,48.77815627788713,NaN,NaN,44.78386101642942,44.814309630038046,0.4805220955452544,-0.43591180457222123,-0.9164339001174756,231508157,263513280.2,81.57515130216272,67.05577041785129,NaN,NaN,-2.661185543142431,-5.792094755679396
2008-12-15T09:30:00-05:00,49.24001,49.67999,47.14999,48,35638464,46038975.25,50.56511872743168,48.905522084772926,NaN,NaN,61.072245833628486,59.77061656830175,0.462202034457039,-0.33868135704617686,-0.8008833915032159,195869693,256930083.4,79.41892438313363,69.48286298111125,NaN,NaN,-2.141881362038103,-5.2706356994449255
2008-12-16T09:30:00-05:00,48.78,49.92,48.2,49.49001,40918384,45854616.85,53.38865110606524,49.162017624365944,NaN,NaN,88.95967195309812,75.46839128600239,0.5288804389567385,-0.1397828428072927,-0.6686632817640312,236788077,249929814.6,77.08561420992973,71.5204656610236,NaN,NaN,-0.9558983086138815,-4.65424464361192
2008-12-17T09:30:00-05:00,49.39,50.53999,48.92,49.17,41851056,45326986.45,52.69255756253599,49.11503825175555,NaN,NaN,92.4687264732648,77.12484443496325,0.528622169483161,-0.007885569910079937,-0.5365077393932409,194937021,226267107.4,69.6378142784929,72.54905698989806,NaN,NaN,-0.1153714419801569,-4.005834186235954
2008-12-18T09:30:00-05:00,49,49.14999,45.78999,46.31,49921648,45365924.05,46.817476958213696,48.73430330059621,NaN,NaN,6.979105152321336,58.852722085748425,0.323121763680823,-0.13260553479221215,-0.45572729847303517,145015373,200823664.2,62.63071645009272,72.57496314828192,NaN,NaN,-0.8998718662038345,-3.5621252833742227
2008-12-19T09:30:00-05:00,46.14999,47.42,45.85001,46,43739536,44246810.45,46.21597504254372,48.819853115716,NaN,NaN,-28.180716865765397,44.25980650930946,0.1617508167488374,-0.2535387775369884,-0.4152895942858258,101275837,174777200.2,56.37681336307313,71.9677916276885,NaN,NaN,-1.7202565787276656,-3.2990011827104286
2008-12-22T09:30:00-05:00,46.28999,46.46001,43.92,44.63,31803264,42068670.45,43.552863943206994,48.55749505082927,NaN,NaN,-92.95648731144152,13.45405988029546,-0.03151669507879945,-0.4546854631343251,-0.42316876805552567,69472573,149497776.2,51.04894347888861,70.83909543099554,NaN,NaN,-3.15149058882669,-3.2779282407270376
2008-12-23T09:30:00-05:00,44.94,45.49001,44.16,44.73,27998496,40693843.25,43.807394805113695,48.310103480366955,NaN,NaN,-90.65803671315679,-22.46948185295552,-0.14076115477923257,-0.5991202115295664,-0.45835905675033384,97471069,121634374.6,45.9000075619099,69.20499084238085,NaN,NaN,-4.296230463716786,-3.4233999868684304
2008-12-24T09:30:00-05:00,44.36,44.745,44.02,44.56,6340219,38680908.6,43.44871323697821,48.34002886962162,NaN,NaN,-93.72632166888825,-59.70849148138613,-0.2085247641939234,-0.7190150119927381,-0.5104902477988147,91130850,100873140.4,42.46325894234528,67.39517225632859,NaN,NaN,-5.364801049910935,-3.7007429958745024
2008-12-26T09:30:00-05:00,44.94,45.45,44.55,45.16,5782715,37001935.55,45.15550937951844,48.38486215002286,NaN,NaN,-65.00300855442097,-74.1049142227346,-0.19712182863012695,-0.7568925335864733,-0.5597707049563464,96913565,91252778.8,40.93379266028002,65.37079512095522,NaN,NaN,-5.887363547963269,-4.013117360458612
2008-12-29T09:30:00-05:00,46.25,46.48,45.56,46.14999,14656516,36935513.3,47.94707926898457,48.39892842797956,NaN,NaN,-18.347972654440472,-72.13836538046961,-0.11135906587602706,-0.6989695373013802,-0.5876104714253532,111570081,93311627.6,41.42008015227848,63.12626408889299,NaN,NaN,-5.663089387704568,-4.248827650065177
2008-12-30T09:30:00-05:00,46.27,47.35001,45.86,47.27,16455320,35895075.3,50.98660655144144,48.576102328322385,NaN,NaN,14.238946163574825,-50.699278685466346,0.025066552718223223,-0.5562772805275742,-0.5813438332457974,128025401,105022193.2,44.23245768602209,60.85979996622234,NaN,NaN,-4.690481578866435,-4.311921068465357
2008-12-31T09:30:00-05:00,47.14,48.41,46.75,47.77,23413760,35175621.7,52.325001887995306,48.57126319355591,NaN,NaN,46.33036132526669,-23.301599077781635,0.14647029000342493,-0.3982559707415163,-0.5447262607449412,151439161,115815811.6,46.76911837138389,58.59321151680625,NaN,NaN,-3.5072144714307854,-4.1969629831747035
2009-01-02T09:30:00-05:00,48.2,50.67,48.08,50.14999,34283648,34489867.3,58.17901524415117,49.013377028769206,NaN,NaN,118.09262540955486,19.062190337906987,0.37173715296942494,-0.08005481953316007,-0.451791972502585,185722809,134734203.4,50.978062702386936,56.46219682445561,NaN,NaN,-0.7866270528409275,-3.709772135984164
2009-01-05T09:30:00-05:00,50.03999,52.19,49.92,51.33,47644752,34416926.5,60.75221451930952,49.70244130239215,NaN,NaN,158.14422137228536,63.69163632324826,0.5728673653622777,0.26429223420026204,-0.3085751311620156,233367561,162025002.6,56.34097040679095,54.659755331929055,NaN,NaN,2.318197107921855,-2.8486336725690187
2009-01-06T09:30:00-05:00,52.11,53.19,51.57001,51.89,48376368,34210972.9,61.948775469501356,50.51555964111141,NaN,NaN,177.38275320274306,102.83778149468496,0.7074523443465522,0.5757402992711746,-0.13171204507537757,281743929,196059772.2,61.933901448124104,53.41082512228552,NaN,NaN,5.293658379030892,-1.6854490937690316
2009-01-07T09:30:00-05:00,51.10001,51.10001,49.2,49.69,39215696,33712356.1,54.87121508977787,50.62145706851946,NaN,NaN,82.51550100151223,116.49309246227244,0.6155237141038263,0.6376925975544054,0.022168883450579047,242528233,218960338.6,65.16730939098608,52.55951763521812,NaN,NaN,6.015662764231762,-0.5852902569117755
2009-01-08T09:30:00-05:00,49.42,50.41,49.16,50.33,33274400,33225888.9,56.4306730949729,50.888465320836374,NaN,NaN,73.31820099632628,121.89066039648438,0.5662790547877222,0.7300177019352319,0.1637386471475096,275802633,243833033,68.31529734890668,52.46505214024768,NaN,NaN,7.062659162391149,0.5072739458457851
2009-01-09T09:30:00-05:00,50.31,50.36,48.45,48.64,39957344,33150699.3,51.38152141478689,51.21446849630589,NaN,NaN,42.01628134921116,106.67539158441564,0.396383546729295,0.6592180805591283,0.26283453382983335,235845289,253857529,69.51123958554588,52.95651807849434,NaN,NaN,6.525802952633278,1.3670638039582839
2009-01-12T09:30:00-05:00,47.97,48.06,46.48,46.72,34441072,32821854.5,46.311695200483776,51.22130565044447,NaN,NaN,-28.55256787314187,69.33603373533018,0.1441911263847701,0.443073441810796,0.2988823154260259,201404217,247464860.2,67.7549113214066,53.769239361232444,NaN,NaN,4.510178229284874,1.8160801504335111
2009-01-13T09:30:00-05:00,46.8,48.13,46.67999,47.89,46765904,33123928.1,49.57672026781736,51.65158110220235,NaN,NaN,-10.46308148145883,31.766866798489797,0.05050487963081429,0.36201341496454376,0.31150853533372946,248170121,240750098.6,65.87219086195175,54.82804274573696,NaN,NaN,3.764510640522434,2.094427363303357
2009-01-14T09:30:00-05:00,47.12,47.17,45.16,45.60001,40609440,33372476.9,43.94376273408334,51.66132166855733,NaN,NaN,-62.13449805823399,2.836866986540552,-0.15984516989666436,0.11170207296289902,0.2715472428595634,207560681,233756588.2,63.88120813535863,56.112414215269006,NaN,NaN,1.321831306676469,1.9840564980709445
2009-01-15T09:30:00-05:00,45.52,46.27,44,46.17,44107728,33531944.1,45.60056769346268,51.81502555830622,NaN,NaN,-73.29752915512185,-26.486279043749086,-0.24940937202515118,-0.04021447217187557,0.2091948998532756,251668409,228929743.4,62.477610623751566,57.54201076394088,NaN,NaN,-0.17893661968701124,1.6750574812483794
2009-01-16T09:30:00-05:00,47.00999,47.37,45.42999,46.53999,43672368,33623009.7,46.70177136786944,51.92547284318844,NaN,NaN,-35.070698895060595,-41.90367509260344,-0.2707673198956194,-0.12926425001624864,0.14150306987937075,295340777,240828841,64.54572004669454,59.22857700582763,NaN,NaN,-1.0943430811512853,1.2794288294769989
2009-01-20T09:30:00-05:00,45.74001,46.86,43.96001,44.06,44919856,33372920.1,40.74761656368412,51.411225507095544,NaN,NaN,-82.01538073304975,-52.59623766458501,-0.42951722208661125,-0.39539345772889334,0.034123764357717926,250420921,250632181.8,66.19867678257174,60.99847676513429,NaN,NaN,-3.7753063526751967,0.5573238034552567
2009-01-21T09:30:00-05:00,44.67999,47.14999,44.42999,47.02,42387152,33305300.9,49.090432148678275,51.27578447832674,NaN,NaN,-37.86736157263202,-58.07709368281966,-0.31791339770361604,-0.36326798277180217,-0.0453545850681861,292808073,259559772.2,67.67660918076534,62.673059014758806,NaN,NaN,-3.465252684493186,-0.017329980537377887
2009-01-22T09:30:00-05:00,45.95,46.69,44.75999,45.73,53570624,34393668.9,46.047478378564485,50.82738994193882,NaN,NaN,-56.547189030174394,-56.959631877207734,-0.3132080343012684,-0.43686462794477166,-0.1236565936435032,239237449,265895125.8,68.72177279970157,64.24110575963864,NaN,NaN,-4.1938958308164205,-0.6139822448629554
2009-01-23T09:30:00-05:00,44.63,47.7,44.35001,47.06,44228896,35205188.9,49.52164248036748,50.20900617309713,NaN,NaN,-37.76616250512694,-49.85335854720876,-0.20783507453112374,-0.38345043680740787,-0.17561536227628413,283466345,272254713,69.77817855013357,65.58397117733482,NaN,NaN,-3.6900742853899104,-1.0534239649382346
2009-01-26T09:30:00-05:00,47.39999,49.14999,47.17,47.92999,43158896,37046122.75,51.712048701111414,49.56328004322584,NaN,NaN,19.522485681585596,-38.93472163187951,-0.07377250564198762,-0.26783099432876867,-0.19405848868678105,326625241,278511605.8,70.82230727559505,66.61835238224941,NaN,NaN,-2.5958140527924645,-1.2737654060602674
2009-01-27T09:30:00-05:00,47.7,48.44,47.14999,48.00999,38836880,38698831,51.918661114789515,48.84684330360356,NaN,NaN,5.985751641329797,-21.3344951570036,0.020997199267477507,-0.16781198960243415,-0.18880918886991166,365462121,301519845.8,74.33388945937868,67.50406581162473,NaN,NaN,-1.6571531996572901,-1.3285350908598421
2009-01-28T09:30:00-05:00,48.85001,49.69,48.02,49.32001,39301728,39931091.6,55.29211211783778,48.8769073770364,NaN,NaN,46.83052345710549,-4.394918151056089,0.16462005971745905,0.01696588577691216,-0.1476541739405469,404763849,323911001,77.20863854244035,68.36416075101432,NaN,NaN,0.15025714030275525,-1.1172790578366139
2009-01-29T09:30:00-05:00,48.31,48.63,47.35001,47.58,43713312,41293991.2,50.24915665272052,48.435370488304095,NaN,NaN,-2.761603422375691,6.362198970503648,0.1363131923579277,0.022737316506862726,-0.11357587585106496,361050537,348273618.6,79.85279323268223,69.18826759985544,NaN,NaN,0.21899347356208443,-0.9263829819225141
2009-01-30T09:30:00-05:00,48.38,48.64999,46.58,46.92,42919360,42269271.2,48.44430481632248,48.22556930269949,NaN,NaN,-21.838839605492446,9.547663550430551,0.07034102496259853,-0.025649594647816798,-0.09599061961041533,318131177,355206585,80.54452582759349,69.9763594742874,NaN,NaN,-0.2547349954915525,-0.8304332695752339
2009-02-02T09:30:00-05:00,45.94,46.60001,45.62,46.17,30590000,42084588.8,46.40456175166511,48.23220262778387,NaN,NaN,-67.921677710046,-7.941169127895767,-0.021684563936346726,-0.12309632453084873,-0.101411760594502,287541177,347389772.2,77.32110684930339,70.65965915485147,NaN,NaN,-1.2434046199190731,-0.8894291767672109
2009-02-03T09:30:00-05:00,46.42,47.27,45.97,46.97,31325504,41268626.4,48.87720104967714,48.18223696934529,NaN,NaN,-36.53590719127328,-16.445500894416384,-0.02624899683502782,-0.1342230066382868,-0.10797400980325897,318866681,338070684.2,73.54236928123125,71.20752904194286,NaN,NaN,-1.3817327693010766,-0.9597582614149059
2009-02-04T09:30:00-05:00,47.39999,48.06,46.92,47.41,36118256,40655720.8,50.23703708058428,48.63175656552392,NaN,NaN,10.945315043623408,-23.622542577112803,0.0013302713570694236,-0.10631117060692219,-0.10764144196399161,354984937,328114901.8,69.62750962669098,71.6179791484666,NaN,NaN,-1.1214367775462986,-0.9828551922908192
2009-02-05T09:30:00-05:00,47.08,48.74001,46.53999,48.57001,42584128,40824142.4,53.73128039194553,49.2125217582727,NaN,NaN,49.08221039205127,-13.253779814227409,0.09355716202252884,0.009305010564169436,-0.0842521514583594,397569065,335418607.4,70.85331167828342,72.21624350950458,NaN,NaN,0.09069098962812348,-0.8294914520166845
2009-02-06T09:30:00-05:00,48.00999,49.8,47.85001,49.47,38522256,41086535.2,56.295380012663436,49.89777951861513,NaN,NaN,126.13588865523798,16.341165837918673,0.20466213937253422,0.17157552275730836,-0.03308661661522585,436091321,359010636.2,74.44154918109663,72.92308844767616,NaN,NaN,1.8608803089025485,-0.4451526290282226
2009-02-09T09:30:00-05:00,49.71001,50.77,49.22,49.64999,34013904,40789363.2,56.81086649400783,51.045154513638245,NaN,NaN,172.80369800488322,64.48624098090451,0.27536004485890286,0.31111343945840275,0.03575339459949987,470105225,395523445.8,78.79301469195231,73.82268401263192,NaN,NaN,3.4749565583269617,0.11486296916537508
2009-02-10T09:30:00-05:00,49.89,50.35001,46.91,47.34,56727376,41903678.4,48.847784158791335,51.02782251436061,NaN,NaN,60.069743213636244,83.80737106188641,0.1574931716933204,0.23261985921615036,0.07512668752282997,413377849,414425679.4,80.63145902043327,74.74803042975107,NaN,NaN,2.6567137479996985,0.4779845089988498
2009-02-11T09:30:00-05:00,47.7,48.13,45.88,46.8,42516272,41691196.8,47.1828305859658,51.108919100603565,NaN,NaN,-15.191403777436078,78.58002729767453,0.040213992617363775,0.1253941782945347,0.08518018567717092,370861577,417601007.4,80.93052732029776,75.62008432407936,NaN,NaN,1.4922697427889346,0.6228823995402905
2009-02-12T09:30:00-05:00,45.92,46.99001,45.33,46.88,45132704,41917360,47.46849622405503,50.962265796581256,NaN,NaN,-50.34075693685175,58.69543383189392,-0.031073567083595433,0.04633822682267663,0.07741179390627206,415994281,421286050.6,81.29156261757288,76.44246890032503,NaN,NaN,0.6114241791248466,0.6212455109095127
2009-02-13T09:30:00-05:00,46.83,47.72,46.67999,46.99001,37459360,41584941.6,47.885908209763066,50.688970047199234,NaN,NaN,-10.71990521326912,31.3242750581925,-0.06781146805331568,-0.007352541160372539,0.060458926892943146,453453641,424758514.6,81.64422852163906,77.21546327504245,NaN,NaN,-0.01613030382250634,0.5301918230906528
2009-02-17T09:30:00-05:00,45.35001,45.61,43.66,43.74001,51900592,41996352.8,38.223037682509286,49.710711230607785,NaN,NaN,-174.05074486351143,-38.04661351548642,-0.2952418833445234,-0.3085934272877111,-0.013351543943187702,401553049,411048079.4,75.58574373345964,77.3048814374768,NaN,NaN,-3.6242537287339593,-0.06330039859857739
2009-02-18T09:30:00-05:00,44,44.23,42.99001,43.49001,42808080,41890764,37.59459571207012,48.4466029159101,NaN,NaN,-203.40580572680545,-90.74172330357476,-0.4381464866776012,-0.5610346522901892,-0.12288816561258802,358744969,400121503.4,71.06008513194683,76.86569905101297,NaN,NaN,-6.745995461772672,-1.0179711219091625
2009-02-19T09:30:00-05:00,43.96001,44.38,43.28,43.5,34000416,41471427.2,37.638718726537,47.54585734975414,NaN,NaN,-167.95112951906182,-121.2936684518999,-0.5029900742800167,-0.7516257584626089,-0.2486356841825922,392745385,404498265,71.78873345028624,76.28969478084183,NaN,NaN,-9.279208020339098,-2.1981478216848673
2009-02-20T09:30:00-05:00,42.62,42.985,41.37,42.38,44704192,41028105.6,34.67839515422554,46.56257808817578,NaN,NaN,-202.93754099971713,-151.81302526447297,-0.58647422731818,-0.9817284683303171,-0.3952542410121372,348041193,390907647.4,66.21379375170437,75.26607106113546,NaN,NaN,-12.366964755936083,-3.6508359551493266
2009-02-23T09:30:00-05:00,43.14999,43.31,40.28,40.39999,34484512,40540886.4,30.161940306841217,45.40239084211693,NaN,NaN,-191.57771719986007,-187.98458766179118,-0.7308126840546568,-1.3087700960804582,-0.5779574120258014,313556681,362928255.4,56.48802313058403,73.77799365265551,NaN,NaN,-16.592704159526466,-5.499674270060346
2009-02-24T09:30:00-05:00,40.83,42.53999,40.55,42.3,33884880,40077185.6,38.446419114687835,44.657334989617695,NaN,NaN,-143.9874659140752,-181.9719318719039,-0.6564474970943551,-1.3985167833937453,-0.7420692862993902,347441561,352105957.8,53.23110448041106,72.32718902402551,NaN,NaN,-17.726238676006943,-7.246326328052717
2009-02-25T09:30:00-05:00,42.28,43.11,41.16,42.05,43811008,40325892,37.810856494323154,43.76975066202761,NaN,NaN,-113.58706167889967,-164.00818306232276,-0.5846138879947547,-1.4728366462928335,-0.8882227582980788,303630553,341083074.6,50.06486334788992,70.92985714696829,NaN,NaN,-18.828048511495,-8.900858068544471
2009-02-26T09:30:00-05:00,42.82001,43.74001,42.10001,42.14999,32143136,39967962.4,38.250536666884805,42.663983253094706,NaN,NaN,-84.97875698119876,-147.41370855475014,-0.4944646618763262,-1.5063035856434865,-1.0118389237671603,335773689,329688735.4,46.95568717081859,69.22288396786367,NaN,NaN,-19.595275982838885,-10.428632056300815
2009-02-27T09:30:00-05:00,41.23,42.55,40.67999,41.134,43089248,39936759.2,35.5038136918357,41.17887137303558,NaN,NaN,-104.46902716317842,-127.72000578744242,-0.46765358472352236,-1.5964059046715633,-1.128752319948041,292684441,318617385,44.090497163534415,67.05495168089493,NaN,NaN,-21.05521446980782,-11.946715258230387
2009-03-02T09:30:00-05:00,40.19,40.44,38,38.12,46698016,40125692,28.878698398644403,39.183716509081044,NaN,NaN,-149.81171031752055,-119.36680441097451,-0.6083895666142276,-1.8892392782158254,-1.2808497116015978,245986425,305103333.8,40.81655347811988,64.34234730847832,NaN,NaN,-24.624809529427687,-13.757871582687144
2009-03-03T09:30:00-05:00,38.82001,39.5,37.89999,38.31,45466016,40869492.8,29.76840336053678,37.820903594920004,NaN,NaN,-136.45948915692222,-117.8612090595439,-0.6409047487029051,-2.081980647480229,-1.441075898777324,291452441,293905509.8,38.28007188932456,61.31724822768486,NaN,NaN,-27.18087492907878,-15.675443489314521
2009-03-04T09:30:00-05:00,39.64,40.97,39.25,40.14,46004144,41603424.8,37.834738359407375,37.153182721594405,NaN,NaN,-91.49947409428049,-113.44369154262009,-0.49776301026213066,-2.0632796616049873,-1.5655166513428567,337456585,300670716.2,40.678568470924326,58.442108309872474,NaN,NaN,-26.844750078948483,-17.271058716405086
2009-03-05T09:30:00-05:00,39.25999,39.78999,38,38.37,45164064,42055715.2,33.79209283415429,36.17629676517292,NaN,NaN,-112.31202355722753,-118.91034485782582,-0.48063573068923016,-2.1663113147043944,-1.6856755840151643,292292521,291974482.6,38.60194522107608,55.39284992440842,NaN,NaN,-27.873011324919744,-18.785623374764324
2009-03-06T09:30:00-05:00,38.97,39.92999,37.39999,38.78999,47780512,42315534.4,35.55178297706817,35.29528781998043,NaN,NaN,-103.16197257024206,-118.64893393923853,-0.4025342012887454,-2.188843335626096,-1.7863091343373507,340073033,301452201,42.07276555243806,52.56631685517977,NaN,NaN,-28.141188989858552,-20.122132748349213
2009-03-09T09:30:00-04:00,38.35001,40.13,38.09,38.86,42001184,42489480.8,35.85782133251769,35.12634379498103,NaN,NaN,-89.99112827763138,-106.6848175312607,-0.31172685370555686,-2.175967701469297,-1.86424084776374,382074217,328669759.4,50.69295047261284,50.788260193690725,NaN,NaN,-28.264700093739552,-21.285356654833546
2009-03-10T09:30:00-04:00,39.88,41.33,39.64999,40.83,41696752,42873623.2,43.92667913223322,35.57863546784982,NaN,NaN,-47.101658885684934,-88.81325147701324,-0.09575260501801397,-1.9839316040362576,-1.8881789990182436,423770969,355133465,57.340157585781704,49.80826536896465,NaN,NaN,-25.840062531182,-21.936028922883324
2009-03-11T09:30:00-04:00,41.08,41.63,39.92,40.66,38347408,41954624.8,43.41908522271469,35.99151878900537,NaN,NaN,-37.58225218614121,-78.0298070953854,0.05100054438497592,-1.8244283185370236,-1.8754288629219995,385423561,364726860.2,59.47310378797352,48.9285775359423,NaN,NaN,-24.03853910116084,-22.236387519780113
2009-03-12T09:30:00-04:00,41.05,42.06,40.33,41.88,31924064,41425014.4,48.05786171384589,36.9471949718354,NaN,NaN,-8.90592417829343,-57.34858721959857,0.23526451935171022,-1.5813482137323618,-1.816612733084072,417347625,389737881,64.4619288225805,48.80344432671926,NaN,NaN,-21.06627773516778,-22.06922897912121
2009-03-13T09:30:00-04:00,42.17,42.34,40.96001,41.5,29573168,40647037.6,46.771614942100065,38.13360030292532,NaN,NaN,6.735881785796159,-35.36901634839093,0.33073565348983136,-1.403193166221783,-1.7339288197116143,387774457,399278165.8,66.17249357752775,49.495192215786666,NaN,NaN,-18.984124758350934,-21.628499804725458
2009-03-16T09:30:00-04:00,41.48,43.03,41.31,42.03,28061488,40177144,48.82875014178105,38.87519537628912,NaN,NaN,44.20685245077948,-8.529420202708788,0.4228686612084911,-1.2053429932010005,-1.6282116544094916,415835945,406030511.4,67.36963538906065,50.505087280690205,NaN,NaN,-16.640869738607723,-20.915981223851496
2009-03-17T09:30:00-04:00,41.96001,44.85001,41.53,43.48,27707648,38967496.8,54.05980414918799,40.03583449449375,NaN,NaN,104.61278454882026,21.81346848419225,0.5658280789463286,-0.9209265557265809,-1.4867546346729095,443543593,409985036.2,68.08205338703614,51.792029426343504,NaN,NaN,-12.979833751171826,-19.782245870611543
2009-03-18T09:30:00-04:00,42.89,44.42999,41.895,43.92,42396832,38946934.4,55.54489882046189,41.2711460768921,NaN,NaN,111.72676250931818,51.67527142328413,0.6674048598029203,-0.652498559919259,-1.3199034197221793,485940425,430088409,71.48983666599538,53.544468675998985,NaN,NaN,-9.499672729098831,-18.313306850395442
2009-03-19T09:30:00-04:00,45.39999,46.02,44.83,44.98,39763456,39235086.4,58.984785653029626,42.94835835983452,NaN,NaN,190.09812465647585,91.47608119023798,0.7757647837664183,-0.3501974400141563,-1.1259622237805746,525703881,451759660.2,74.63389472635225,55.72613993048598,NaN,NaN,-5.445634139502083,-16.47506789169639
2009-03-20T09:30:00-04:00,45.08,45.22,42.86,43,37640592,38881906.4,51.040078489580445,44.53131408061567,NaN,NaN,108.43705034981859,111.81631490304248,0.6869220212785697,-0.2673096971823625,-0.9542317184609322,488063289,471817426.6,77.14599221429292,58.32109984021262,NaN,NaN,-4.208556314562641,-14.722709094962998
2009-03-23T09:30:00-04:00,44.03,46.58,43.92999,46.53999,46793008,39497331.2,61.12236905898945,46.77088305907658,NaN,NaN,167.12734581394162,136.40041357567492,0.8298409516495728,0.0830694711010338,-0.746771480548539,534856297,495621497,79.7136647580063,61.280642187975594,NaN,NaN,0.5598044751355857,-12.5394928706632
2009-03-24T09:30:00-04:00,45.85001,46.32001,45.07001,45.66,29798640,39293019.2,57.92882019703539,48.20617461890715,NaN,NaN,142.11248402403882,143.9003534707186,0.8265674015328333,0.2864377713675026,-0.5401296301653307,505057657,507924309.8,80.90758678463669,64.15414349609792,NaN,NaN,3.2569911101090914,-10.282852301981444
2009-03-25T09:30:00-04:00,45.53,46.31,44.22,45.44,33459856,38775461.6,57.12523666871208,49.872827749946985,NaN,NaN,112.93151855772128,144.14130468039923,0.7720699474093058,0.4249578040963016,-0.3471121433130042,471597801,505055785,79.72935831693758,67.091815860088,NaN,NaN,5.10561672088676,-8.084499584428844
2009-03-26T09:30:00-04:00,46.17,46.64999,45.28999,45.83,34223440,38879476.8,58.231384152372996,51.49279926246876,NaN,NaN,116.91411115713107,129.50450198053028,0.7254922605691199,0.5597531823983957,-0.16573907817072422,505821241,501079257,78.03288112429708,69.66039554379223,NaN,NaN,6.934316167379814,-5.9389544770276075
2009-03-27T09:30:00-04:00,44.85001,45.03,44.21001,44.47,28671712,38158600,53.08780903398526,52.72351266971645,NaN,NaN,68.60254384159104,121.53760067888477,0.5729857544461373,0.5504931148869474,-0.022492639559189898,477149529,498896505,77.06356841948826,71.54401111142619,NaN,NaN,6.915391136147367,-4.102619389431183
2009-03-30T09:30:00-04:00,43.35001,43.39,42.09,42.82401,27320448,37189721.6,47.60691981392208,52.98638700412279,NaN,NaN,12.285409439352177,90.56921340396688,0.3425225955222747,0.4056606048436535,0.0631380093213788,449829081,481891061.8,69.78999732389056,72.43328537843396,NaN,NaN,5.1382748926037785,-2.78249163485476
2009-03-31T09:30:00-04:00,43.49001,43.57001,42.44,42.46001,39341936,36883517.6,46.464472687754316,53.20391468019705,NaN,NaN,8.219020729413968,63.79052074504192,0.15631190506447218,0.258527890651969,0.10221598558749684,410487145,462976959.4,62.70142978633026,72.6638800926023,NaN,NaN,3.354716762422351,-1.9057475781008872
2009-04-01T09:30:00-04:00,41.5,43.67,41.47009,43.36,33200688,36243344.8,49.679829079858266,53.31976949205508,NaN,NaN,4.351737277638081,42.07456448902529,0.08790789905939556,0.21210085941174128,0.12419296035234573,443687833,457394965.8,60.74063165034787,72.39807315172854,NaN,NaN,2.811500068658708,-1.2318550571352307
2009-04-02T09:30:00-04:00,44.98,45.89,44.81,45.14,35305280,35750405.6,55.386936895409534,53.93514963157719,NaN,NaN,84.19259472150047,35.530261201899144,0.15288851405387635,0.3153036029196912,0.16241508886581482,478993113,452029340.2,58.835985989562026,71.87403689544526,NaN,NaN,4.1169824621857325,-0.4677354115179504
2009-04-03T09:30:00-04:00,44.97,46.34,44.83,46.02,27522640,34737512,57.927442930339765,54.58505625933138,NaN,NaN,93.5370093964496,40.517154312870865,0.24028127290237547,0.4627666799937842,0.2224854070914087,506515753,457902585,60.30332818158884,71.36930066634014,NaN,NaN,5.989962685654474,0.45479288807811025
2009-04-06T09:30:00-04:00,45.42,45.48,44.42,45.09,26212032,33948054.4,54.40166206582501,54.60947468194831,NaN,NaN,57.09307793928013,49.47868801285645,0.22108263535984896,0.4988387012912199,0.2777560659313709,480303721,463997513,61.82414740462409,70.92230738188213,NaN,NaN,6.48314925310854,1.3159866545110288
2009-04-07T09:30:00-04:00,44.125,44.25,43.5,43.74001,22315008,32978967.2,49.675133493913954,54.190205730052035,NaN,NaN,-0.9641487457311283,47.642054117827435,0.10877432720897656,0.4137239749425916,0.30494964773361505,457988713,473497826.6,64.1308850455705,70.39666798042323,NaN,NaN,5.434232895087029,1.904307546021886
2009-04-08T09:30:00-04:00,43.83,44.75,42.95,44.3,23558832,32239538.4,51.555360353986885,53.65953249440612,NaN,NaN,-0.7100666075362124,46.62969334079257,0.06563661129277976,0.38699541184958974,0.32135880055681,481547545,481069769,65.89946498190767,69.77278014153434,NaN,NaN,5.134722340679746,2.3657953738301516
2009-04-09T09:30:00-04:00,45.52,45.82001,45.03,45.60001,20336080,31660139.2,55.693857549133675,53.99194528437421,NaN,NaN,71.66248626660571,44.12367164981362,0.11519178134653191,0.4653485272399749,0.350156745893443,501883625,485647871.4,66.96019389561373,69.04522311877153,NaN,NaN,6.136961553359881,2.9045333994772555
2009-04-13T09:30:00-04:00,44.67,45.52,44.02,45.10001,17751792,31069070.4,53.79054176789401,53.46824333501025,NaN,NaN,31.294476689549693,31.67516510843364,0.1051123142473615,0.4815471387026449,0.37643482445528337,484131833,481171087.4,64.83632868533572,67.98255625643792,NaN,NaN,6.398772385996909,3.4037103975514915
2009-04-14T09:30:00-04:00,44.81,45.72,44.38,44.98,21087504,30720371.2,53.31954051556908,53.139009072048374,NaN,NaN,34.98766335886821,27.254082192351255,0.08219389606437982,0.47917719453575813,0.3969832984713783,463044329,477719209,63.172486053716824,66.7157633470865,NaN,NaN,6.4792493029145595,3.843073098317644
2009-04-15T09:30:00-04:00,44.78999,45.25,44.31,45.03999,21218416,30395909.6,53.53854602963083,52.88281688354256,NaN,NaN,19.64794576738805,31.37650109497509,0.06372953639785633,0.4766452189686987,0.4129156825708424,484262745,482974015.4,64.65929431330215,65.63933020396968,NaN,NaN,6.6044135594323095,4.237550307048311
2009-04-16T09:30:00-04:00,45.47,45.62,44.34,45.25,17763440,29164240,54.34604893326675,52.60529293932069,NaN,NaN,30.78927740264152,37.67636989701064,0.0584534999859429,0.485982557553271,0.4275290575673281,502026185,487069743.4,65.81765416465102,64.76681399256638,NaN,NaN,6.920608996005432,4.6208444054707565
2009-04-17T09:30:00-04:00,45.36,46.00999,45.07001,45.78,22068224,28279478.4,56.405283102150946,52.84225537276109,NaN,NaN,72.57945430324793,37.859763504339085,0.08200801453130457,0.5300390757314588,0.44803106120015423,524094409,491511900.2,67.07803415499515,64.0535615451026,NaN,NaN,7.733249673828207,5.065473729521821
2009-04-20T09:30:00-04:00,44.64,44.74001,43.31,43.56,18450704,27319984,46.869078325625686,52.78955240931135,NaN,NaN,-67.74251404403893,18.05236535762136,-0.05328729505056884,0.38142194238694316,0.434709237437512,505643705,495814274.6,68.29729048007246,63.94693962768701,NaN,NaN,5.718882223283847,5.158817800059253
2009-04-21T09:30:00-04:00,43.07001,44.53,42.89,44.42,18949280,25927797.6,50.369607149730626,53.0684905851668,NaN,NaN,-54.13706261706943,0.22742016243382893,-0.08437433618697898,0.32924131720378824,0.4136156533907672,524592985,508124005.8,71.54443435927864,64.57858281146903,NaN,NaN,5.01466177546415,5.138224082259952
2009-04-22T09:30:00-04:00,43.94,44.92,43.73,43.95,21435696,25509650.4,48.489352033807776,52.9834565104489,NaN,NaN,-28.816179616119793,-9.46540491426774,-0.13320120614430653,0.24711414571038404,0.38031535185469056,503157289,511902914.6,72.47642700844354,65.41685390847587,NaN,NaN,3.881352554880129,4.958671006919977
2009-04-23T09:30:00-04:00,44.60001,44.84,43.89,44.77,19214352,24797375.2,51.86538294363682,52.73191694246514,NaN,NaN,-0.9286536938354636,-15.80899113356314,-0.10795909310581908,0.24536648547241668,0.35332557857823577,522371641,515972005.8,73.4835362164674,66.46310749611197,NaN,NaN,3.875268377250051,4.803899202681416
2009-04-24T09:30:00-04:00,45.52,46.44,45.44,46.07001,23830368,24277721.6,56.70954913383012,52.64492452842874,NaN,NaN,124.7331298607469,-5.378256022063343,-0.006736032336118469,0.34490553815808767,0.35164157049420613,546202009,520393525.8,74.57230966789452,67.48232045941951,NaN,NaN,5.323683123976685,4.87815404858074
2009-04-27T09:30:00-04:00,45.08,45.66,44.71001,45.2,18361968,23762234.4,52.87450749961256,52.535842059413554,NaN,NaN,52.88088869466762,18.746424525677966,-0.0016661196901429087,0.3495589208815275,0.3512250405716704,527840041,524832793,75.65321560323065,68.47011104503426,NaN,NaN,5.410204851494735,4.954161306139882
2009-04-28T09:30:00-04:00,44.55,45.86,44.5,45.3,15706191,23181521.55,53.26571746338305,52.79231234294706,NaN,NaN,50.20433648351705,39.61470434579526,0.004778658812943648,0.35719836408785,0.35241970527490635,543546232,528623442.4,76.56913310969256,69.3585573353287,NaN,NaN,5.592029022996096,5.04528526569077
2009-04-29T09:30:00-04:00,45.75,47.75,45.64999,46.55,21155408,22272195.15,57.96332819278812,53.25002433143287,NaN,NaN,174.7863024549031,80.33520075999984,0.08512675252132307,0.4588281459265602,0.3737013934052371,564701640,540932312.6,79.29319572424083,70.31525238835249,NaN,NaN,7.147303735139006,5.345573618469089
2009-04-30T09:30:00-04:00,47.09,47.11,45.14,45.78,29583248,22091323.15,54.3398529340949,53.153309716072954,NaN,NaN,109.00558727335853,102.32204895343864,0.07847833061407294,0.4717993066728283,0.3933209760587554,535118392,543481662.8,79.81657859645365,71.23356558126963,NaN,NaN,7.404026613395416,5.639638332029993
2009-05-01T09:30:00-04:00,45.96001,47.63,45.74001,47.25999,21853232,21418720.75,59.571221784086774,53.56621543151529,NaN,NaN,172.2536790397718,111.82615878924362,0.16106093680699968,0.594647147067505,0.4335862102605053,556971624,545635585.8,80.27032349102396,72.33599378167592,NaN,NaN,9.255008178085816,6.156119738609396
2009-05-04T09:30:00-04:00,47.78999,49.21001,47.61,49.14999,28169168,21451047.15,65.07435666361067,54.405845156375406,NaN,NaN,265.38868704789417,154.32771845988893,0.3210414959305372,0.8348880801736769,0.5138465842431397,585140792,557095736,82.52175897673075,73.71808470474835,NaN,NaN,12.73584892901235,7.096081051524104
2009-05-05T09:30:00-04:00,48.96001,49.13,47.72,48.49001,17907840,21035837.55,61.90550114560563,55.003484807516465,NaN,NaN,194.32699010425247,183.152249184036,0.3576816623478525,0.9609486621779553,0.6032669998301028,567232952,561833080,83.36673862722058,75.05433072717109,NaN,NaN,14.56137400271586,8.162551473122926
2009-05-06T09:30:00-04:00,49.37,50.66,49.19,50.37,21849200,21012547.15,66.8565748391076,55.897093800790806,NaN,NaN,229.93706850821104,194.1824023946976,0.47637344475569565,1.1987338057747223,0.7223603610190267,589082152,566709182.4,84.21275257001592,76.36826632755431,NaN,NaN,17.836930488423068,9.544605618165804
2009-05-07T09:30:00-04:00,51.52,51.61,49.05,49.72,23492656,21009238.35,63.77054747824462,56.423184113368926,NaN,NaN,186.5733716025036,209.69595926052662,0.4777277683766624,1.3195200714898547,0.8417923031131923,565589496,572803403.2,85.22428250257863,77.66442692381027,NaN,NaN,19.48317252986905,10.964400891266267
2009-05-08T09:30:00-04:00,50.48,52.35001,50.46001,51.84,28240048,21404436.75,68.82495170296487,57.99146078317887,NaN,NaN,192.89354536301892,213.82393252517605,0.581152340708629,1.5682327289989786,0.9870803882903496,593829544,580174987.2,86.36252212405083,78.95480061266586,NaN,NaN,22.670296642480736,12.636671712868335
2009-05-11T09:30:00-04:00,51,51.09,49.81,50.25999,18340704,21433882.35,61.89439414653287,58.81465985437904,NaN,NaN,126.66721364309666,186.07963784421653,0.5056803224791866,1.6191807913893328,1.1135004689101462,575488840,578244596.8,84.52621401998312,79.88207058843047,NaN,NaN,22.951535170158458,14.110223635338352
2009-05-12T09:30:00-04:00,50.92,51.00999,49.50999,50.582,23465552,21552784.75,62.7183641954629,59.83101786592584,NaN,NaN,108.40198960280797,168.89463774392763,0.4422656801868585,1.6663325691437194,1.2240668889568609,598954392,584588884.8,85.60921104118185,80.82012659076894,NaN,NaN,23.437362508501316,15.442672045790204
2009-05-13T09:30:00-04:00,49.88,50.11,48.53999,48.91,30074064,21995567.15,55.95291177516752,60.12298421103517,NaN,NaN,63.27477329234655,135.5621787007547,0.26147159510305884,1.5509063828356844,1.2894347877326255,568880328,580548520,81.68807671696324,81.4061651979472,NaN,NaN,21.596026812098355,16.32172272669137
2009-05-14T09:30:00-04:00,48.53,49.50999,48.09,49.05,17989488,22006869.55,56.37723011733424,60.09924713842832,NaN,NaN,48.165005421139945,107.88050546448198,0.1316255341655208,1.4539667054395267,1.3223411712740059,586869816,584804584,82.5925557280397,81.979039916529,NaN,NaN,20.28197427496837,16.8874729478738
2009-05-15T09:30:00-04:00,48.81,49.25999,47.59,48,30052832,22406099.95,52.307335657035615,60.05873486395854,NaN,NaN,26.442488410813958,74.590294074041,-0.03572356835009716,1.2776867108363845,1.3134102791864817,556816984,577402072,75.59843695998836,81.9751271562974,NaN,NaN,17.896914197693437,17.031678840705176
2009-05-18T09:30:00-04:00,48.74001,49.72,48.7,49.66,16981488,22332639.15,57.52756994444606,60.36315289832019,NaN,NaN,53.68681592520651,59.99421453046299,-0.04477884410277144,1.2574367240580173,1.3022155681607888,573798472,577063998.4,75.28487982986289,81.88339477916672,NaN,NaN,17.474307028066196,17.094911438899608
2009-05-19T09:30:00-04:00,49.75,50.4104,49.42999,49.89999,16459391,22208144.7,58.23923653918968,60.38286063734887,NaN,NaN,66.27629341010585,51.56907529192256,-0.04466358413756577,1.2463860879888315,1.2910496721263973,590257863,575324692.6,73.59368445897344,81.47628683164761,NaN,NaN,17.352450711614093,17.131702763573106
2009-05-20T09:30:00-04:00,50.61,51.50999,49.92999,50.07001,22250688,22248894.3,58.76636041875551,60.69903974339605,NaN,NaN,82.42278487762371,55.398677608977984,-0.04316997675958234,1.2370872011769194,1.2802571779365017,612508551,584050337.2,76.45162518737247,81.23593301671325,NaN,NaN,17.405647253266103,17.170837690672105
2009-05-21T09:30:00-04:00,49.32001,49.36,48.03999,48.59,25606704,22568511.9,52.548334368269245,60.19740492798052,NaN,NaN,6.3248910537514424,47.03065473550028,-0.1460934120127575,1.0976404129205548,1.2437338249333123,586901847,584056743.4,76.45364010289823,80.96331277470428,NaN,NaN,15.576534145059584,16.943080041298888
2009-05-22T09:30:00-04:00,48.89999,49.46001,48.5,48.61,13648328,22059409.9,52.62128969498344,59.307900144507144,NaN,NaN,9.39011274068395,43.62017960147429,-0.21300789980321388,0.9774739501792951,1.190481849982509,600550175,592803381.6,79.08499393840843,80.71782955768126,NaN,NaN,14.122454190144621,16.540133491133993
2009-05-26T09:30:00-04:00,48.28999,49.78,47.64999,49.64,26906800,22486651.5,56.34385907178204,58.910639996376894,NaN,NaN,9.518847882862856,34.78658599300556,-0.1889035803657957,0.9543523745252642,1.14325595489106,627456975,603535082.2,81.77598149688141,80.60420404837132,NaN,NaN,13.919929447656653,16.165818627780087
2009-05-27T09:30:00-04:00,49.85001,50.5,49.03,49.10001,20871712,22744927.55,53.95060365767865,57.98878491198911,NaN,NaN,30.673088490672978,27.665945009118992,-0.20877656868684613,0.8822852440325022,1.0910618127193483,606585263,606800562.2,82.51325045460958,80.482811040128,NaN,NaN,13.067319357493304,15.723175874881976
2009-05-28T09:30:00-04:00,49.53999,51.21001,49.06,50.73,25906832,22982498.75,59.53759569455423,57.68643121315408,NaN,NaN,74.8026822153478,26.141924476663814,-0.11621300848028304,0.9457955521189945,1.0620085605992775,632492095,610797271,83.39850692824103,80.35239849910388,NaN,NaN,13.97247491507837,15.473075737767175
2009-05-29T09:30:00-04:00,51.53999,51.89,50.97,51.67999,22239168,22615294.75,62.40079481785461,57.22756286421763,NaN,NaN,146.50459342756355,54.17786495142623,-0.0011598711367950543,1.0605587216782837,1.0617185928150787,654731263,624363154.2,85.99089826155978,80.32585393749739,NaN,NaN,15.614417267823931,15.49326738491814
2009-06-01T09:30:00-04:00,52.67999,53.95,52.5701,53.58,29723472,23008806.75,67.37349184284518,57.6189269853828,NaN,NaN,243.69387483429503,101.03861737014844,0.18258872244576096,1.28995449587228,1.107365773426519,684454735,641144066.2,88.4032557275106,80.60278548803505,NaN,NaN,18.69999155638441,15.951370837984749
2009-06-02T09:30:00-04:00,53.31,53.815,53.03,53.436,20255040,22613100.35,66.65399185991565,57.90004324712942,NaN,NaN,206.71298851858032,140.47744549729197,0.2689017925887669,1.4434930141624776,1.1745912215737107,664199695,648492610.2,89.27427627777551,80.86457586207747,NaN,NaN,20.938299625313515,16.663789236174573
2009-06-03T09:30:00-04:00,52.77,52.77,50.62,51.38,28249504,23130183.55,57.252784229078216,57.99289127955161,NaN,NaN,82.79264376746774,150.9013565526509,0.1669872357192299,1.383325266222748,1.216338030503518,635950191,654365595.8,89.92553934011836,81.45296604944569,NaN,NaN,19.935786239849882,17.13121737955676
2009-06-04T09:30:00-04:00,51.99001,52.67,51.52,52.53999,31060960,23590771.55,60.62699251839409,58.296445736770174,NaN,NaN,107.14156459862244,157.36913302930583,0.15729414926297824,1.4129557170822409,1.2556615678192626,667011151,661269407,90.64466354301553,82.02811660765826,NaN,NaN,20.17957980094923,17.566697725469968
2009-06-05T09:30:00-04:00,53.10001,57.7045,51.46001,52.11,23215584,23576917.95,58.77497412764894,58.758419913242555,NaN,NaN,156.88766746418122,159.44574783662935,0.10408450714379347,1.3857672017490046,1.2816826946052111,643795567,659082267.8,88.48966561919485,82.94891865474445,NaN,NaN,19.802324247582693,17.886072942914645
2009-06-08T09:30:00-04:00,51.64,52.39999,50.99001,51.99001,18333104,23081570.75,58.24031819509857,58.80933050257487,NaN,NaN,59.88649892795217,122.68427265536077,0.0459351144930662,1.3391015877215438,1.2931664732284776,625462463,647283813.4,77.75113782951632,83.12507994043396,NaN,NaN,19.342060535429294,18.094071170416736
2009-06-09T09:30:00-04:00,52.58,52.96001,51.94,52.5,14804402,22904755.65,59.90957772639073,58.92864058737494,NaN,NaN,80.95987101232627,97.53364915410995,0.02783702559231971,1.327962755218877,1.3001257296265574,640266865,642497247.4,73.83636884750477,83.14241453961476,NaN,NaN,19.432044529031053,18.285210221647354
2009-06-10T09:30:00-04:00,53.39999,53.55,52.11,52.97,25063040,22984630.05,61.43936736526326,59.119569654982634,NaN,NaN,87.27273443468275,98.42966728755296,0.03317553509697335,1.341595148497774,1.3084196134008006,665329905,648373190.2,75.46922823824234,83.07224332896261,NaN,NaN,19.9373057091831,18.52122386272389
2009-06-11T09:30:00-04:00,53.14,54.82001,53.05,54.03,24945264,22728190.05,64.71002527800199,59.98826186282069,NaN,NaN,116.86651420872072,100.37465720957262,0.09050060484727318,1.421545369459892,1.331044764612619,690275169,653025993.8,76.7087805033446,83.0904676432802,NaN,NaN,21.32758351030555,18.922132383806986
2009-06-12T09:30:00-04:00,53.42999,53.50999,52.8,53.50999,19954432,22826437.25,61.93469001522167,60.653504742837704,NaN,NaN,81.45611595148601,85.28834690703358,0.07636595233763188,1.4265022050346587,1.3501362526970269,670320737,658331027.8,78.06947548941316,83.01793061120911,NaN,NaN,21.717682867175625,19.321496738573934
2009-06-15T09:30:00-04:00,52.59,52.62,51.41,52.09,19421968,22294894.05,54.99804584609434,60.55737522671716,NaN,NaN,26.933200584523014,78.69768723834775,-0.03942598237394468,1.300853774729596,1.3402797571035407,650898769,663418289,79.31730765542552,82.84231105110511,NaN,NaN,19.99752456731134,19.41807214267928
2009-06-16T09:30:00-04:00,52.55,52.75999,50.83,50.98,23438224,22617730.85,50.25939129893514,60.29371720109261,NaN,NaN,-0.4994417521851373,62.40582468544547,-0.19299203019046107,1.0990397193654644,1.2920317495559255,627460545,660857025,76.9435606511025,82.44447606514032,NaN,NaN,17.053111793014452,19.080220664155732
2009-06-17T09:30:00-04:00,50.60001,50.7,49.47,50.14999,36339312,23611726.9,46.99849652210548,59.398067260203426,NaN,NaN,-69.28743526951814,31.093790744605293,-0.3438757987451886,0.8621870011244397,1.2060627998696283,591121233,646015290.6,64.83503634977617,81.11851388096427,NaN,NaN,13.559914865529848,18.29160555006632
2009-06-18T09:30:00-04:00,50.07001,50.66,49.67,49.96001,23061328,23652258.9,46.25868333246808,58.24505929696153,NaN,NaN,-67.6924454365918,-5.818001184457211,-0.4435398082742785,0.6516380395267802,1.0951778478010588,568059905,621572237.8,50.68764096840247,78.59685264573875,NaN,NaN,10.497444279028567,17.17815393991807
2009-06-19T09:30:00-04:00,50.24001,50.36,48.82001,49.21001,24827872,23613317.3,43.357091569052,56.52960213454774,NaN,NaN,-102.86982443749302,-42.683189262253016,-0.5406039642204785,0.4194228925254606,0.9600268567459391,543232033,596154497,40.73385257779079,75.19189527790162,NaN,NaN,7.01609784821063,15.726431641102721
2009-06-22T09:30:00-04:00,48.45,48.45,46.66,46.75,32115472,24536674.5,35.49303731965895,54.30381966738654,NaN,NaN,-192.49288977914227,-86.56840733498606,-0.7388470163802922,0.03646808627057396,0.7753151026508661,511116561,568198055.4,33.047008019696335,71.17566183089598,NaN,NaN,1.1023670209575058,13.637279552510547
2009-06-23T09:30:00-04:00,47.00999,47.46001,46.31,47.03,25313984,24457033.7,36.89600939063841,52.849764321783695,NaN,NaN,-186.4784206790771,-123.76420312036446,-0.8135697933097629,-0.2416471389863375,0.5719226543234254,536430545,549992055.4,29.184556514912515,66.83702020052414,NaN,NaN,-3.197483771418737,11.232313363377791
2009-06-24T09:30:00-04:00,47.37,48.03999,46.91,47.22,18022640,24314580.1,37.88326879325377,51.22521262713081,NaN,NaN,-149.63808933854062,-139.83433393416894,-0.8108446628864576,-0.44163317428464666,0.36921148860181097,554453185,542658445.8,27.77626466072236,62.346420280360334,NaN,NaN,-6.391186647504937,8.714670504680258
2009-06-25T09:30:00-04:00,47.08,48.42999,47,48.21001,26717152,24355096.1,42.89639506803554,50.091028408587,NaN,NaN,-115.3864464520067,-149.37313413725195,-0.7068166921550851,-0.5143093765920455,0.19250731556303968,581170337,545280532.2,29.09372673960368,58.10385321753239,NaN,NaN,-7.673973343858409,6.373435669174734
2009-06-26T09:30:00-04:00,48.06,48.24001,47.67999,47.89,12309910,23858633.2,41.72420831959934,48.91130627462277,NaN,NaN,-97.84428683643225,-148.3680266170398,-0.6267388195432474,-0.5909162088660196,0.035822610677227806,568860427,550406211,31.715931724301797,54.81562421001706,NaN,NaN,-9.070604422783564,4.167144227466405
2009-06-29T09:30:00-04:00,48.2,48.8,48.07001,48.34,13812152,23063067.2,44.03993791444808,47.777760573769726,NaN,NaN,-73.60387449157179,-124.59022355952568,-0.5153015149847522,-0.6083042830537124,-0.09300276806896024,582672579,564717414.6,38.54906554348418,52.29510254544415,NaN,NaN,-9.592548283038536,2.201473868822842
2009-06-30T09:30:00-04:00,48.34,48.91,47.265,48.05,22869840,23193807.2,42.857981281700496,46.450518710658095,NaN,NaN,-75.63294740066226,-102.42112890384271,-0.4361010484992587,-0.6381290786930336,-0.2020280301937749,559802739,569391853.4,40.638568103601436,49.807198250112656,NaN,NaN,-10.353934317584603,0.40784412790749314
2009-07-01T09:30:00-04:00,48.58,49.12,48.00999,48.09,20011696,22781916.8,43.084878508626744,44.90586536998843,NaN,NaN,-59.19624872821135,-84.33276078177686,-0.3592040353487832,-0.6510330743797539,-0.2918290390309707,579814435,574464103.4,42.90713760665068,47.39279518606309,NaN,NaN,-10.926909044990202,-1.211406325363606
2009-07-02T09:30:00-04:00,47.27,47.27,46.13,46.16,23983424,22428040,35.71576048971343,43.03308468959499,NaN,NaN,-106.70659241982874,-82.59678997534128,-0.41268394968377153,-0.8076839761356851,-0.39500002645191357,555831011,569396238.2,41.21246653592342,44.760151689385246,NaN,NaN,-13.659462926779458,-2.9897001255658706
2009-07-06T09:30:00-04:00,45.12,45.7,44.55,45.69,31673904,22850956,34.18248733076244,41.54625908135699,NaN,NaN,-130.38159451997777,-89.10425151205037,-0.4509637114925088,-0.9587046658175495,-0.5077409543250407,524157107,560455574.2,38.335798245419085,41.83290101724193,NaN,NaN,-16.39915595649228,-4.905336672841072
2009-07-07T09:30:00-04:00,45.61,45.64999,44.39999,44.52,21584448,23013523.2,30.654503363456826,40.14590994310854,NaN,NaN,-129.05814041593598,-100.19510469692321,-0.5213541509586688,-1.1594336430233767,-0.6380794920647079,502572659,544435590.2,33.785235411411236,38.75016350012112,NaN,NaN,-19.903713597863646,-7.047961947844296
2009-07-08T09:30:00-04:00,44.39,45.03,43.66,44.53,34379632,23992284.7,30.720318781416935,38.98318296163079,NaN,NaN,-130.4525709715224,-111.15902941109523,-0.5316878430678035,-1.3026892958994623,-0.7710014528316588,536952291,539865500.6,32.596516648920016,36.447412092917105,NaN,NaN,-22.709338892669294,-9.285301511390724
2009-07-09T09:30:00-04:00,44.99001,45.64,44.60001,44.99001,24545600,23966412.7,33.83141323076478,38.09552081150912,NaN,NaN,-105.33421344196644,-120.38662235384625,-0.4739070091717932,-1.3633852142964002,-0.8894782051246071,561497891,536202191.8,31.635651484814503,35.08655570123225,NaN,NaN,-24.21965484039238,-11.41878055839096
2009-07-10T09:30:00-04:00,44.28,44.78,43.98,44.67,25188928,23978595.9,32.7302845940972,37.33646317044092,NaN,NaN,-118.75519720290683,-122.79634331046188,-0.4251612009601704,-1.42092970632482,-0.9957685053646497,536308963,532297782.2,30.600310018375737,34.3627312327026,NaN,NaN,-25.7979076359071,-13.472941569464695
2009-07-13T09:30:00-04:00,44.66,45.41,43.8,45.35001,22444032,24103075.9,37.39338306833826,37.47220215248944,NaN,NaN,-97.73803509724861,-116.26763142591604,-0.3198457390758691,-1.395575679209486,-1.075729940133617,558752995,539216959.8,34.68008514045795,34.47937959847128,NaN,NaN,-25.872358999238898,-15.244286916575295
2009-07-14T09:30:00-04:00,45.86,46.16,45.37,45.96001,27380800,24501017.5,41.322761714122095,37.78839874702398,NaN,NaN,-55.66032559873944,-101.58806846247674,-0.18833320624973693,-1.311146447945788,-1.122813241696051,586133795,555929187,43.343566819394496,35.490737477362856,NaN,NaN,-24.819642801937576,-16.612194900198478
2009-07-15T09:30:00-04:00,46.83,47.77,46.81,47.59,29928656,24825539.1,50.29924836270389,38.67525443055614,NaN,NaN,15.722600793431958,-72.35303410948585,0.018227667226534905,-1.1000286576628824,-1.1182563248894173,616062451,571751219,50.092365154439356,37.08474465548551,NaN,NaN,-21.021648569236216,-17.242116852918155
2009-07-16T09:30:00-04:00,47.32001,48.46001,47.08,48.17,16080418,23812594.4,53.05148828785034,39.40061823197148,NaN,NaN,46.37276208609397,-42.01163900387377,0.19394967100846117,-0.8758192361288408,-1.069768907137302,632142869,585880214.6,55.22188530390314,38.95104169579262,NaN,NaN,-16.98681439997774,-17.205645073926668
2009-07-17T09:30:00-04:00,48.14,48.72,47.71001,48.45,18896256,23604340.8,54.36530036980363,40.30355337841464,NaN,NaN,72.86733880861317,-3.687131801569774,0.32154348123156073,-0.6678395555978511,-0.9893830368294119,651039125,608826247,62.04469466600141,41.11738190591401,NaN,NaN,-13.2755088759313,-16.644197045641615
2009-07-20T09:30:00-04:00,49.09,49.46001,48.45,49.28,19622832,23344088.8,58.10770165862924,41.30839364585616,NaN,NaN,113.69701336569472,38.59987789101889,0.44664964622380354,-0.4310709790496574,-0.877720625273461,670661957,631208039.4,67.28146186266343,43.169695928712535,NaN,NaN,-8.905586635713094,-15.538681272794683
2009-07-21T09:30:00-04:00,49.83,50.02,48.91,49.71001,18334560,22655043.2,59.94062569201471,42.52858253230717,NaN,NaN,123.9255549211614,74.51705399499906,0.5370938992398971,-0.2063532512235895,-0.7434471504634866,688996517,651780583.8,71.21302008363178,45.353585355857554,NaN,NaN,-4.695549464983427,-13.989662443107362
2009-07-22T09:30:00-04:00,48.97,49.8714,48.85001,49.25999,21560368,22467362.4,57.12376700432996,43.53136028200026,NaN,NaN,101.0086498107169,91.57426379845604,0.5436858958182753,-0.06383978069064256,-0.6075256765089179,667436149,662055323.4,72.96059366797651,47.5002607888094,NaN,NaN,-1.939572744550801,-12.268221057599282
2009-07-23T09:30:00-04:00,49.2,50.85001,49.07001,50.66,21732176,22652839.2,62.95612535681956,45.47710062965069,NaN,NaN,123.94113862662823,107.08793910656291,0.6142007816559248,0.16022530056098816,-0.4539754810949367,689168325,673460414.6,74.79005756082677,49.89866014773107,NaN,NaN,2.4175832040443623,-10.170249020221618
2009-07-24T09:30:00-04:00,50.45,51.27,50.25,51.19,15468582,22090410.7,64.90252860968903,47.671389292431165,NaN,NaN,136.75501840519516,119.86547502587928,0.6641628957337564,0.3762281385722588,-0.2879347571614976,704636907,684179971,76.40587851606645,52.61795159563445,NaN,NaN,6.653058106274731,-7.76691943072214
2009-07-27T09:30:00-04:00,51.31,51.67,50.78,51.36,13207480,22135289.2,65.52818841943457,50.16236679642957,NaN,NaN,133.31322835683736,123.78871802410781,0.6741357135073682,0.5547348847227127,-0.1194008287846555,717844387,693616457,77.7574063069591,55.75882094531645,NaN,NaN,10.290161314090918,-5.187336467177419
2009-07-28T09:30:00-04:00,50.78,50.99001,49.61,50.61,19165360,22402949.6,60.4116074989012,52.28317313339274,NaN,NaN,94.56039510194478,117.91568606026449,0.5982724811249452,0.6284397726215261,0.030167291496580817,698679027,695552959,78.03546439226533,59.00446006984111,NaN,NaN,11.947580718360614,-2.7394911549576997
2009-07-29T09:30:00-04:00,49.78999,49.83,48.84,49.44,22256960,22372305.6,53.40592560446457,53.68135258865701,NaN,NaN,55.79990458017718,108.87393701415654,0.4444187486189047,0.5856907272702117,0.14127197865130697,676422067,697350142.6,78.30650773879248,62.33809265941097,NaN,NaN,11.253410305945751,-0.7405052319714927
2009-07-30T09:30:00-04:00,49.91,50.66,49.5,50.13,20685840,22406012.8,56.602210913121084,55.386490182873004,NaN,NaN,74.10534012292506,98.9067773134159,0.36743528292772987,0.6005660823109693,0.23313079938323944,697107907,698938059,78.55827331665799,65.76366146643112,NaN,NaN,11.646498863870487,1.0290667817202188
2009-07-31T09:30:00-04:00,49.88,50.85001,49.53,50.62,17915184,22102600.8,58.765465430894245,56.913067494484146,NaN,NaN,74.38646637897766,86.43306690817239,0.32906721963440777,0.6444648239262492,0.3153976042918414,715023091,701015295.8,78.90319978978333,68.92245536995436,NaN,NaN,12.626467085425071,2.685838253678055
2009-08-03T09:30:00-04:00,51.49001,52.28,51.41,51.92,20989360,21568373.6,63.905986532539664,58.52615498151397,NaN,NaN,112.09101182357823,82.18862360152056,0.3678561566727616,0.7752178001327934,0.4073616434600318,736012451,704648908.6,79.52371892233813,71.50675194873607,NaN,NaN,15.140689036823824,4.465102651270308
2009-08-04T09:30:00-04:00,51.66,52.10001,51.28999,51.83,14419387,21210120.55,63.31747701432367,59.45602845662967,NaN,NaN,100.52518396268685,83.38158137366898,0.3634272552670296,0.8616457125438188,0.4982184572767892,721593064,709231716,80.31032060931295,73.66517733836989,NaN,NaN,16.966540129753675,6.251022291053646
2009-08-05T09:30:00-04:00,51.81,51.81,51,51.31,16190949,20300686.4,59.88598746664354,59.94420696940061,NaN,NaN,84.76196833279295,89.17399412419213,0.3038725006531843,0.8780590830932695,0.5741865824400852,705402115,715027725.6,81.28930525058729,75.52713590599019,NaN,NaN,17.484452124570602,7.855797981556068
2009-08-06T09:30:00-04:00,51.5,51.5,50.49001,50.89,16703016,19908557.2,57.190047800539205,60.14597464302458,NaN,NaN,66.63709603473156,87.68034530655343,0.21857706734585303,0.8474079166224016,0.6288308492765485,688699099,713345964,80.04566415269309,76.81291944075387,NaN,NaN,17.128561983108334,9.180478553206392
2009-08-07T09:30:00-04:00,51.49001,51.61501,50.56,50.83,18632304,19580726,56.796683832351086,60.05233051257614,NaN,NaN,64.20729440975092,85.64451091270809,0.1440953804955355,0.8089500748959679,0.6648546944004324,670066795,704354704.8,73.56562881342937,77.26178850866573,NaN,NaN,16.727055122956653,10.258560920313572
2009-08-10T09:30:00-04:00,50.69,51.36,50.57001,51.05,14063754,19161712.1,57.93906018112137,59.909361547512326,NaN,NaN,59.0517851439222,75.03666557677688,0.09783651687653205,0.7871503404960976,0.6893138236195655,684130549,693978324.4,66.84065905447491,76.94947700658308,NaN,NaN,16.694899071784853,11.178037799095184
2009-08-11T09:30:00-04:00,50.87,50.99001,50.10001,50.31,20675104,18826427.3,52.87460238298285,59.60584978884468,NaN,NaN,22.761461962963104,59.48392117683213,0.010204191684822339,0.7020690632255935,0.6918648715407711,663455445,682350800.6,60.19963190410219,76.03797973773491,NaN,NaN,15.237705564622425,11.757990337027648
2009-08-12T09:30:00-04:00,50.2,51.31,50.17,50.85001,15600199,18110004.45,55.90373365902344,59.102107524716374,NaN,NaN,37.56796098535061,50.045119707343666,-0.017102395945117754,0.6704868766093739,0.6875892725544916,679055644,677081506.4,57.4155992325277,74.79694699999928,NaN,NaN,14.817216180144003,12.195022600329985
2009-08-13T09:30:00-04:00,51.25999,51.53,50.57001,51.47,16813088,18146637.95,59.15026691931773,58.69123168968986,NaN,NaN,65.01001830750583,49.71970416189852,-0.000023406957570970555,0.687560013857528,0.6875834208150989,695868732,678515433,57.98503359339974,73.48117236266594,NaN,NaN,15.375221633569828,12.649336747935676
2009-08-14T09:30:00-04:00,51.46001,51.52,50.14999,50.71001,16539488,18028799.55,53.91063959457387,57.86140677362838,NaN,NaN,21.670277914680764,41.21230086288449,-0.04408675362801984,0.6324749787800741,0.6765617324080939,679329244,680367922.8,58.75240454168914,72.12367223657523,NaN,NaN,14.31883870821983,12.88783702797627
2009-08-17T09:30:00-04:00,49.49001,49.60001,48.74001,49.07001,18735920,17984453.95,44.70734677840467,56.73967386502148,NaN,NaN,-150.82954259861157,-0.7639646856222541,-0.18022275802816046,0.4512832848728934,0.6315060429010538,660593324,675660477.8,55.955619099054054,70.54654042991729,NaN,NaN,10.29507028495039,12.517441778972572
2009-08-18T09:30:00-04:00,49.19,49.78,48.99001,49.56,12920488,17713750.35,47.58634410061627,56.32398947188947,NaN,NaN,-117.36627047636789,-28.78951117348845,-0.23058989636889082,0.3432686724399403,0.5738585688088311,673513812,677672151.2,56.8998308087174,69.01749207776906,NaN,NaN,7.905665792901112,11.85861663810522
2009-08-19T09:30:00-04:00,49.06,50.868,48.89999,50.48,20584064,17664935.15,52.57898125614183,56.03661592496237,NaN,NaN,-59.169290138829375,-48.136961398324445,-0.19659064782746927,0.3281202590244945,0.5247109068519638,694097876,680680597.6,58.3382512815645,67.5732047895481,NaN,NaN,7.463061423024618,11.23068017880799
2009-08-20T09:30:00-04:00,50.49001,51.05,50.46001,50.91,10026414,17079647.05,54.74859741982944,55.74969678131489,NaN,NaN,17.72537273056158,-57.593890513713305,-0.14231706464452626,0.34681457604630594,0.4891316406908322,704124290,682331709.2,59.14414908933423,66.16184402523031,NaN,NaN,7.782169211948584,10.738035754970932
2009-08-21T09:30:00-04:00,51.52,52.55,51.5,52.35001,21992640,17405849.95,61.157718739723514,55.55339193897088,NaN,NaN,148.89429429196767,-32.149087238255916,-0.013400184190126507,0.47238141045317406,0.48578159464330056,726116930,691689246.4,63.45835074387038,65.01431772676833,NaN,NaN,10.21529800058711,10.6633589329161
2009-08-24T09:30:00-04:00,52.84,53.41,52.82001,53.02,19081872,17699569.55,63.73156587099289,55.58296971444725,NaN,NaN,213.40613689993253,40.69804866145291,0.10643329725206074,0.6188232162083764,0.5123899189563157,745198802,708610342,69.69096073519498,64.25579202147418,NaN,NaN,13.06585969736171,11.006573327836902
2009-08-25T09:30:00-04:00,53.19,53.46001,52.03,52.21001,21259168,17804259.95,58.669943826945065,55.496109454468794,NaN,NaN,141.46889662587026,92.46508208190053,0.11960016194489109,0.6618901213874295,0.5422899594425384,723939634,718695506.4,72.68167585917828,63.640961350659246,NaN,NaN,13.796512167105302,11.40513601916096
2009-08-26T09:30:00-04:00,51.81,52.58,51.575,52.45,16270598,17504941.85,59.69142585844037,55.67477931574744,NaN,NaN,99.00137202620284,124.09921451490698,0.1319549066241532,0.70723359272273,0.5752786860985768,740210232,727917977.6,75.10120173985868,63.28778546402822,NaN,NaN,14.698503782312114,11.875617128182553
2009-08-27T09:30:00-04:00,52.14999,52.64999,51.12,52.28999,18414032,17391351.45,58.65060521633402,55.80720227174623,NaN,NaN,74.08915854057561,135.3719716769098,0.11732515662996068,0.7219351318860276,0.604609975256067,721796200,731452359.6,75.97924074926831,63.46018631658814,NaN,NaN,15.119260392655178,12.338994737392929
2009-08-28T09:30:00-04:00,52.67,52.75,51.8399,52.17999,10548281,17023006.3,57.903130968558784,55.80463589942032,NaN,NaN,83.88120559960423,122.3693539384371,0.08947307742331034,0.7164513220352049,0.6269782446118946,711247919,728478557.4,73.62661138900714,63.94489719762616,NaN,NaN,15.251926502359877,12.755127846673922
2009-08-31T09:30:00-04:00,51.35001,51.52,50.84,51.17,13312961,16639186.35,51.4229147266999,55.70094392397154,NaN,NaN,-2.8998728083386087,79.10815199678287,-0.002845636060479273,0.6234211995362955,0.6262668355967748,697934958,719025788.6,66.57040311904015,64.39995228440743,NaN,NaN,13.439810493900566,12.852939653420586
2009-09-01T09:30:00-04:00,51.02,51.69,50.16,50.28,20466736,16941553.8,46.48588060104646,55.02824013411605,NaN,NaN,-39.48925256588554,42.9165221584317,-0.12306732021099376,0.4724326853330325,0.5955000055440263,677468222,709731506.2,60.43726311277644,64.61578541871093,NaN,NaN,10.32854974232512,12.492312523264092
2009-09-02T09:30:00-04:00,50,50.59,49.91,49.91,14357223,16849867.5,44.570084445507575,53.98679852884389,NaN,NaN,-81.49948243715595,6.816351265759934,-0.22101014596305024,0.31923732309021347,0.5402474690532637,663110999,694311659.6,51.89494702344078,64.18077923514242,NaN,NaN,7.171383618910647,11.732179822642172
2009-09-03T09:30:00-04:00,50.31,50.5,49.94,50.25999,9435035,16486468.45,46.803403035875654,53.47913877465116,NaN,NaN,-67.7045220021069,-21.54238484277656,-0.25340288351491225,0.2234938646596234,0.47689674817453565,672546034,684461626.4,47.2962009474194,63.36247897840887,NaN,NaN,5.17857039126696,10.795949903874284
2009-09-04T09:30:00-04:00,50.16,51.105,50.11,50.96001,11823434,16146024.95,51.05141833475668,53.93228674296201,NaN,NaN,-25.973805728240922,-43.513387108345604,-0.22009636157443707,0.2017762962064893,0.42187265778092636,684369468,679085936.2,44.95482122015008,62.57670770134431,NaN,NaN,4.695966476811712,9.924523700008203
2009-09-08T09:30:00-04:00,52,54.4884,51.82001,52.36,19112224,16398448.45,58.23461672314508,54.69287764457122,NaN,NaN,126.05478024622728,-17.722456497432425,-0.1021847052354724,0.2941417762365859,0.3963264814720583,703481692,680195283,45.55382662870253,61.76627883134324,NaN,NaN,6.552188384751986,9.442761512114458
2009-09-09T09:30:00-04:00,52.5,53.009,52.13,52.48,13120703,16020728.4,58.79281905890036,55.13672320191112,NaN,NaN,88.69952375745109,7.915298767234903,-0.018878385491336303,0.3727284996078879,0.3916068850992242,716602395,688022117.6,49.71179424342265,61.15010332861883,NaN,NaN,8.204518307866756,9.265869625793359
2009-09-10T09:30:00-04:00,52.73,53.49001,52.35001,53.39,17491568,16115296.85,62.847932389846136,55.71524712834087,NaN,NaN,108.71362555462252,45.957920365590596,0.088829906828992,0.5026442686354642,0.4138143618064722,734093963,702218710.4,56.23973673185328,60.942645303084475,NaN,NaN,10.918327683852254,9.501935062658916
2009-09-11T09:30:00-04:00,53.7,54.32001,53.1604,53.60001,21178032,16333544.05,63.734888987922616,55.89933071749795,NaN,NaN,126.81802597339902,84.86242996069178,0.16131244833052355,0.6154549222196266,0.45414247388910306,755271995,718763902.6,62.37045695875177,60.864938604147426,NaN,NaN,13.39199245755781,10.057657547644473
2009-09-14T09:30:00-04:00,52.99001,54.03,52.81,54,15613449,16287242.1,65.42782270323616,56.02049191980104,NaN,NaN,108.71354606772498,111.79990031988496,0.21967293312997926,0.7287336403015772,0.5090607071715979,770885444,736067097.8,67.49872935853398,60.70835064867164,NaN,NaN,15.970993078205318,10.902419766296022
2009-09-15T09:30:00-04:00,54.25999,54.685,53.78999,54.53999,18486080,16274750.1,67.62507999200233,56.66014450301942,NaN,NaN,138.80725218838657,114.35039470831683,0.2745564272135721,0.852256241188563,0.5776998139749909,789371524,753245064.2,71.632059322578,60.63337803891448,NaN,NaN,18.830960789454014,12.03506848389002
2009-09-16T09:30:00-04:00,54.95,55.92,54.87,55.89,22886320,16773041.7,72.35549228327946,57.5647206762222,NaN,NaN,191.81205474691254,134.9729009062091,0.37545134183733675,1.0470139912716618,0.6715626494343251,812257844,772376154,75.38635380094614,60.65374604327787,NaN,NaN,22.981414859817352,13.598832251879639
2009-09-17T09:30:00-04:00,55.83,56.28,55.22,55.62,17369600,16612318.5,70.14791202768797,58.38595687703321,NaN,NaN,174.7652830690442,148.18323240909345,0.3956552622055167,1.166131727191221,0.7704764649857043,794888244,784535010.2,77.43070805507467,60.7574222794069,NaN,NaN,25.686392507997407,15.325626574182177
2009-09-18T09:30:00-04:00,55.72,55.75999,54.7,55.17999,18365936,17029294.6,66.58266490748414,59.00592358695644,NaN,NaN,129.89848461929878,148.79932413827342,0.3524730883264974,1.211067825393826,0.8585947370673287,776522308,788785072.8,78.11495815585467,61.07801847703887,NaN,NaN,26.888028384401537,16.97739826135637
2009-09-21T09:30:00-04:00,54.27,54.89999,53.98,54.71001,15571516,16708238.4,62.90508469405729,59.82607858462483,NaN,NaN,84.33120722861601,143.9228563704516,0.26910944662504854,1.1949815453486394,0.9258720987235909,760950792,786798142.4,76.94053621749705,61.818742269785794,NaN,NaN,26.813211631917955,18.382514457150883
2009-09-22T09:30:00-04:00,55.59,55.77,55.17,55.57001,13537113,16431000.45,66.54631918112719,61.258967054630595,NaN,NaN,115.52219895488356,139.265845723751,0.2491937608468875,1.2373642997822003,0.9881705389353128,774487905,783821418.6,75.11841635165015,62.867396072562485,NaN,NaN,27.850420175740126,19.735072416949347
2009-09-23T09:30:00-04:00,55.61,55.73,54.38,54.41,33993040,17067694.05,58.24175774376066,62.23551514736296,NaN,NaN,76.60642640035587,116.22472005443967,0.14060975573186862,1.1639327336001486,1.02332297786828,740494865,769468822.8,66.89264385998479,63.93866013231563,NaN,NaN,26.10153156707956,20.644566581253663
2009-09-24T09:30:00-04:00,54.50999,54.55,53.21001,53.63,22944816,17401404.95,53.41481706091314,62.70775900629421,NaN,NaN,28.732884964978954,87.01824043362662,0.0060731911736149335,1.0309144668352985,1.0248412756616836,717550049,754001183.8,59.3499129725825,64.79963956268442,NaN,NaN,23.05424249841464,20.988805997990944
2009-09-25T09:30:00-04:00,53.44,54.23,53.12,53.56,20103520,17485879.35,52.990370940154996,62.84625562096551,NaN,NaN,18.846817845098457,64.80790707878654,-0.09238060655438685,0.9093655174687001,1.001746124023087,697446529,738186028,52.79486242790659,65.3596425060956,NaN,NaN,20.508695065191244,20.9202187218767
2009-09-28T09:30:00-04:00,53.59,54.60001,53.49001,54.42,14062965,17661613.55,57.46253309545355,62.791106790416116,NaN,NaN,38.60176596080076,55.66201882522349,-0.10349633286901483,0.8723757079368184,0.9758720408058332,711509494,728297768.4,49.140382669258834,65.61582508042105,NaN,NaN,19.665270148996,20.740940354322316
2009-09-29T09:30:00-04:00,54.38,54.64999,53.83,54.27,17569904,17874460.7,56.45374267752532,62.624029906032185,NaN,NaN,37.98983091520503,40.155545217287795,-0.12350749467815447,0.8214876724581401,0.9449951671362946,693939590,712188105.4,43.8187470687772,65.19489313937495,NaN,NaN,18.68355895603947,20.447028725996194
2009-09-30T09:30:00-04:00,54.57001,54.58,53.2101,53.92,25384976,18120372.7,54.06855575616722,61.99693157505512,NaN,NaN,15.720179653481022,27.978295867912824,-0.16052715915327842,0.7443362181946966,0.9048633773479751,668554614,697800055.2,39.685092618504186,64.01241855985002,NaN,NaN,17.16638240713,19.978364966158168
2009-10-01T09:30:00-04:00,53.89999,53.92,52.24001,52.24001,23653312,18585177.15,44.37668026966973,60.6142023808942,NaN,NaN,-60.08611911696951,10.214495051523132,-0.2907777724399432,0.541391161798046,0.8321689342379892,644901302,683270305.8,35.99253321353078,62.128281149477075,NaN,NaN,12.556692343646446,18.918126020085065
2009-10-02T09:30:00-04:00,51.55,52.34,51.34,51.97,18563376,19041594.2,43.041296071270935,59.01516476432526,NaN,NaN,-134.30160490390193,-20.41518949827695,-0.3819914148893231,0.35467966562633535,0.7366710805156584,626337926,669048585.2,32.777707928936834,59.64820819022014,NaN,NaN,8.424266845881592,17.41900328091314
2009-10-05T09:30:00-04:00,52.03999,53.34,51.85001,53.12,16867776,19293811.3,49.9494632172675,57.75262070898706,NaN,NaN,-89.42723898114315,-46.02099048666573,-0.3524635139279291,0.29609168810574715,0.6485552020336762,643205702,655387826.8,30.005340005444765,56.6748710961392,NaN,NaN,6.994231039406144,15.929750103555
2009-10-06T09:30:00-04:00,53.89,54.77,53.83,54.38,21936480,19435024.1,56.215343254696975,56.599752921231165,NaN,NaN,25.43801677050082,-48.53135331560657,-0.24098177540578214,0.3473279827764486,0.5883097581822307,665142182,649628345.2,28.895658991279205,53.354107181162995,NaN,NaN,7.8641475815816815,14.777521171844526
2009-10-07T09:30:00-04:00,54.22,54.8,53.95,54.8,20582960,19808136.95,58.098416448930806,55.73907466560565,NaN,NaN,35.13399022757499,-44.64859120078778,-0.13703460755348562,0.4170164987403737,0.5540511062938593,685725142,653062450.8,30.54502817738333,50.00513004704219,NaN,NaN,9.17691820884741,13.97743503427351
2009-10-08T09:30:00-04:00,55.09,56.37,54.97,56.21001,36808128,20773964.95,63.7369612064825,55.535810115534105,NaN,NaN,134.7706589934077,-5.677235578712316,0.02023341001446044,0.5793428688119349,0.5591094587974744,722533270,668588844.4,37.593474458387874,47.110738354365985,NaN,NaN,12.271934385652811,13.733792084470553
2009-10-09T09:30:00-04:00,55.99001,56.41,55.7401,56.16,13314539,20380790.3,63.411033879228484,55.571949343046334,NaN,NaN,135.76801957823022,48.33668931771412,0.10945647227237998,0.6959300491379494,0.5864735768655694,709218731,685165005.4,44.11411467389557,44.765993958394446,NaN,NaN,14.566542906970062,13.852756487684768
2009-10-12T09:30:00-04:00,56.60001,57.35001,56.59,56.92,13572086,20278722.15,66.23666929479104,55.54983149402232,NaN,NaN,170.42721348513228,100.3075798109692,0.20279652686201277,0.8399692354430854,0.6371727085810727,722790817,701082028.4,49.56372907445175,42.94065915288028,NaN,NaN,17.40734023268395,14.360554165541794
2009-10-13T09:30:00-04:00,57.08,57.12,56.03999,57.00999,20638480,20386342.15,66.56591549082995,56.144414190241555,NaN,NaN,130.44445190304876,121.30886683747879,0.2506033053463368,0.9504268402639937,0.6998235349176569,743429297,716739451.4,54.28605013436165,42.04018817247862,NaN,NaN,19.773259709891853,15.13379781473466
2009-10-14T09:30:00-04:00,57.74001,57.9901,57.38,57.96001,22898176,20386934.95,69.90268644206836,57.322119146038354,NaN,NaN,170.19748244603318,148.32156528117042,0.321678527957282,1.1019216948642594,0.7802431669069774,766327473,732859917.6,58.58544682379694,41.98558344756537,NaN,NaN,22.88714871455233,16.24141937185147
2009-10-15T09:30:00-04:00,57.61,59.17999,57.50999,59.17,23100832,20673496.55,73.52661885029265,58.78899399676248,NaN,NaN,183.60871102601612,158.08917568769212,0.4194695875752077,1.304580151375987,0.8851105638007792,789428305,746238924.6,61.796809606442615,42.62857967460366,NaN,NaN,26.82453975729387,17.753293712628956
2009-10-16T09:30:00-04:00,58.89999,59.25,58.45,58.99001,22455536,20877976.55,72.13522202505068,59.837043206019416,NaN,NaN,161.67270143649947,163.27011205934596,0.4392179149267692,1.4341329574592407,0.9949150425324715,766972769,757789732.2,64.3658776608514,43.71611503114598,NaN,NaN,29.548806921511396,19.438367028183592
2009-10-19T09:30:00-04:00,59.09,59.99001,58.85001,59.75999,21588480,21178824.75,74.3696989365497,61.1167543673783,NaN,NaN,156.28625541418603,160.4419204451567,0.4686391293045098,1.5807139541631088,1.112074824858599,788561249,770943818.6,67.08080497210798,45.377690595669606,NaN,NaN,32.5760457648277,21.315178276275606
2009-10-20T09:30:00-04:00,59.95,59.99001,58.5,59.38,18498688,21426903.5,71.32973587315533,62.349695804306016,NaN,NaN,125.5258804479043,159.45820615412782,0.42812429096933036,1.647230188570262,1.2191058976009317,770062561,776270471.4,68.13938731512012,47.41014021685646,NaN,NaN,34.1684879791324,23.15136537668372
2009-10-21T09:30:00-04:00,58.91,60.56,58.83,59.22,26009504,21027726.7,70.03166256869598,64.18219453995076,NaN,NaN,116.27188316473733,148.67308629786865,0.35896221045680465,1.6678086606719376,1.308846450215133,744053057,771815588.2,66.22142282475062,49.56934661765788,NaN,NaN,35.099132304483305,24.858189223512234
2009-10-22T09:30:00-04:00,58.8,59.67,58.17999,59.45,18348672,20797919.5,70.85280391803617,66.1687308147197,NaN,NaN,92.07652107973604,130.3666483086126,0.29954092548287203,1.683272607068723,1.383731681585851,762401729,766410273,63.87220319896093,51.79038199408817,NaN,NaN,36.10485548100205,26.464855831725064
2009-10-23T09:30:00-04:00,59.78,59.84,57.8,58.3,21153360,20850411.5,61.743207322853266,67.01114110797583,NaN,NaN,70.83105353899572,112.19831872911186,0.16058885396086486,1.584467749036932,1.4238788950760672,741248369,761265393,61.63108961678369,54.049364109183806,NaN,NaN,34.30679328291328,27.58513261046624
2009-10-26T09:30:00-04:00,58.34,59.66,57.2018,57.34,26936336,21494080.05,55.346052910667034,66.94904894054511,NaN,NaN,48.41439137584111,90.62394592144288,-0.009168134962108665,1.4124187263734314,1.42158686133554,714312033,746415549.8,55.5703402057816,55.954698481648265,NaN,NaN,30.727410882805167,28.034029506514656
2009-10-27T09:30:00-04:00,57.48,58.41,57.25,57.85001,25299248,21880547.25,57.84490126254152,66.93094071294588,NaN,NaN,37.28138839714315,72.97504751129065,-0.09550060742941957,1.3022111020487657,1.3977117094781852,739611281,740325293.8,53.257193782699346,57.57699602488513,NaN,NaN,28.48217804765987,28.09805072667826
2009-10-28T09:30:00-04:00,57.55,57.55,55.81,55.94,23962672,21809432.05,47.19355760099743,65.7492690268398,NaN,NaN,-11.874748122878287,47.345721253767536,-0.279240875909299,1.0486606145915616,1.3279014905008606,715648609,734644404.2,51.119657529301136,58.54315195852178,NaN,NaN,22.714211693792652,27.32893086483746
2009-10-29T09:30:00-04:00,56.32001,57.55,56.10001,57.42999,21729328,21713232.85,54.26799561453922,65.09619486507628,NaN,NaN,1.2317966115223233,29.17677636012479,-0.29678599191626387,0.9569190006055308,1.2537049925217947,737377937,729639645.8,49.244472400336726,58.90960608183901,NaN,NaN,20.196404414713445,26.309998514819743
2009-10-30T09:30:00-04:00,57.27,57.49001,54.88,55.25,29888240,22279476.05,44.80933998423796,63.565671342893914,NaN,NaN,-57.30837685240933,3.548890281843781,-0.4427765766636791,0.7002342716921959,1.143010848355875,707489697,722887911.4,46.752855480158146,58.70882939653232,NaN,NaN,14.350906586655407,24.601556810796268
2009-11-02T09:30:00-05:00,55.64,56.53999,54.71001,55.60001,29419232,22907048.85,46.42394753277763,62.12695934589018,NaN,NaN,-82.2410485347446,-22.582197700273362,-0.4991533582835048,0.5190691505014939,1.0182225087849988,736908929,727407290.6,48.62659930205137,58.30458290851016,NaN,NaN,10.496106959495261,22.586492546324695
2009-11-03T09:30:00-05:00,54.89999,56.67999,54.69,56.32001,20031232,22811786.45,49.68484351545338,60.68282770827482,NaN,NaN,-76.93733915439302,-45.4259432105806,-0.4716570112523335,0.4286512447195818,0.9003082559719153,756940161,730873066.6,50.077431559270806,57.69686753247258,NaN,NaN,8.529368551240895,20.578331975598438
2009-11-04T09:30:00-05:00,57,57.32001,56.14,56.27,26028048,23084040.85,49.45966526072902,58.96375959473456,NaN,NaN,-51.74841746161856,-53.40067707832865,-0.4410972536033517,0.34893668896772567,0.7900339425710774,730912113,733925767.4,51.3798882014957,56.952801717833516,NaN,NaN,6.938584127780498,18.629796568767304
2009-11-05T09:30:00-05:00,56.57001,57.39999,56.31,57.23,18547776,22171023.25,53.78923502661123,57.65333195198889,NaN,NaN,-34.276527674235204,-60.502341935480146,-0.3447575740225879,0.3590869750428425,0.7038445490654304,749459889,736342157.8,52.4376722169875,56.100787043271815,NaN,NaN,6.974297746240874,16.964725308406386
2009-11-06T09:30:00-05:00,56.66,57.66,56.49001,57.08,21838720,22597232.3,53.02488710311552,56.128702535315014,NaN,NaN,-32.89263752742381,-55.61919407048305,-0.28229043353035244,0.35098150715248977,0.6332719406828422,727621169,740368452.2,54.22471603985212,55.182494976682115,NaN,NaN,6.772649737124091,15.508714512508917
2009-11-09T09:30:00-05:00,57.87,58.25,57.71001,58.17,16928640,22765060,57.725886090999225,55.15699897944672,NaN,NaN,22.38474255744919,-34.69403585204429,-0.16455127491193178,0.4275828470429275,0.5921341219548593,744549809,741896628.2,54.91708347970972,54.238044702724224,NaN,NaN,8.064260255568744,14.44522104723175
2009-11-10T09:30:00-05:00,58,58.48,57.57001,58.21001,17951840,22630728,57.8924607466471,54.28991313501466,NaN,NaN,21.67887887931061,-14.970792245303567,-0.08497363056954654,0.4859170837429261,0.5708907143124726,762501649,743008925.8,55.44532336948178,53.468323313062164,NaN,NaN,9.145044348762124,13.688052947450375
2009-11-11T09:30:00-05:00,58.74001,58.96001,57.89,58.19,18023552,22386996.8,57.769858357256894,53.35541702353042,NaN,NaN,35.62284630693643,2.5034605084074313,-0.03712313976612047,0.524486789604822,0.5616099293709425,744478097,745722122.6,56.77575209898526,52.96143394877818,NaN,NaN,9.990580922440156,13.159842658163202
2009-11-12T09:30:00-05:00,57.89999,58.25999,56.67999,56.91,25417632,22502836.8,50.41485299195598,52.54624885703776,NaN,NaN,-26.661648354565717,4.026436372341331,-0.09199202302974974,0.4466199005837552,0.538611923613505,719060465,739642237.8,52.95946822796353,52.34203242100532,NaN,NaN,8.599561903258959,12.508373978891166
2009-11-13T09:30:00-05:00,57.03999,57.73,56.49001,57.27,19356640,22347892,52.255956080698965,52.32552765489718,NaN,NaN,-29.65938326958675,4.673087223908744,-0.10349646533691426,0.40924134194236217,0.5127378072792764,738417105,741801425,54.13844746936694,52.23975436840426,NaN,NaN,7.970636744241132,11.86012580251259
2009-11-16T09:30:00-05:00,57.96001,59.13,57.83,58.77,20974016,22317168.8,59.07453088547489,52.41335834224956,NaN,NaN,68.27212597646928,13.850563907712765,-0.014229808153644274,0.4949505470872211,0.5091803552408654,759391121,744769687.4,55.77925145673594,52.41990134512116,NaN,NaN,9.520691251242082,11.525920866616802
2009-11-17T09:30:00-05:00,58.63,58.84,58.19,58.67,16850000,22234734.4,58.47496378487197,53.21917306966917,NaN,NaN,72.7355865330595,24.061905438462542,0.03144288675682638,0.5484839636868983,0.517041076930072,742541121,740777581.8,53.03120627126826,52.55644054097596,NaN,NaN,10.588550265628113,11.392010780761275
2009-11-18T09:30:00-05:00,58.95,58.98,58.03999,58.44,17149824,21791750.4,57.04100328696101,53.41724504627073,NaN,NaN,74.9621920315148,31.92977458337822,0.03902953153689026,0.5658279913511848,0.5267984598142945,725391297,736960221.8,50.470641346609035,52.644024037138266,NaN,NaN,11.06518456415133,11.345321321245569
2009-11-19T09:30:00-05:00,58,58.065,56.77,57.13,22436256,21996129.6,49.58291642320416,53.758214791911165,NaN,NaN,-6.058979124448463,36.05030842940167,-0.046665159631402275,0.4684670102750417,0.515132169906444,702955041,733739137,48.34926423354832,52.758053233808994,NaN,NaN,9.236676568212527,11.044086356526563
2009-11-20T09:30:00-05:00,56.81,56.91,56.14,56.60001,16900736,21783498.4,46.910574084402214,53.79297383131292,NaN,NaN,-63.956168645062405,29.190951354306538,-0.1364497524049284,0.34456997940028344,0.48101973180521185,686054305,723266577,42.146616048973094,52.29519728716054,NaN,NaN,6.897234007474043,10.451678878090489
2009-11-23T09:30:00-05:00,57.67,58.22,57.16,57.33,17535680,21313465.6,50.84064275735788,53.87553092002038,NaN,NaN,27.195149432817846,20.975556045576248,-0.1433711829111985,0.3018057531662137,0.4451769360774122,703589985,712106349.8,36.737766614744416,51.34236407683722,NaN,NaN,6.0729418248036104,9.82614501333522
2009-11-24T09:30:00-05:00,57.41,57.67999,56.58,57.66,15947699,20845888.15,52.550673335607364,54.096317211083125,NaN,NaN,6.259510933012281,7.680340925566805,-0.12319241123388108,0.29118642203506084,0.4143788332689419,719537684,707505662.4,34.75749387494591,50.15505019636938,NaN,NaN,5.891779814812518,9.264092842117691
2009-11-25T09:30:00-05:00,57.77,58.33,57.215,58.11,14609590,20378234.05,54.856750094638635,54.17256828737079,NaN,NaN,53.99880362651009,3.48766324456587,-0.0791466623186245,0.3154455053706613,0.3945921676892858,734147274,709256857.8,36.16791198161728,48.99292446527151,NaN,NaN,6.407018578817309,8.855939375931921
2009-11-27T09:30:00-05:00,56.42,57.12,56.10001,57.02,12811125,19932323.9,48.684631532287334,53.86255003231163,NaN,NaN,-50.92402230007276,-5.485345390558987,-0.1205493164171656,0.2439055221678288,0.3644548385849944,721336149,712933079.4,39.14221452677503,47.91560292862314,NaN,NaN,5.004000703492251,8.305662422726254
2009-11-30T09:30:00-05:00,56.7,57.33,56.36,56.82001,19448928,19410358.3,47.62583322639241,53.14111768483972,NaN,NaN,-49.95478866509473,-2.685069394565454,-0.15626586332051373,0.16912250943435225,0.325388372754866,701887221,716099662.6,41.66371339030868,46.96893363652306,NaN,NaN,3.5476030533749157,7.625939655676063
2009-12-01T09:30:00-05:00,57.58,58.03999,57.45,57.57001,15530680,18715930.7,51.85460073842736,52.709841969966874,NaN,NaN,25.501789541533647,-3.023741372822294,-0.12556384402266235,0.16843356772653806,0.2939974117492004,717417901,718865245.8,43.851773183482706,46.1408229089517,NaN,NaN,3.5277544553418902,7.0404846270568955
2009-12-02T09:30:00-05:00,57.57001,57.85249,56.97,57.23,15646996,18496718.9,49.88803620981062,52.14685467372071,NaN,NaN,-20.566185624364948,-8.38888068429774,-0.12411711109404372,0.13885102288164575,0.26296813397568947,701770905,715311890,41.688206584053496,45.06314108645658,NaN,NaN,2.944645590675883,6.455364764716751
2009-12-03T09:30:00-05:00,57.21001,57.37,56.25999,56.31,19716272,18181130.1,44.92353469528643,51.75461765253003,NaN,NaN,-106.17428500854757,-40.42349841130927,-0.17781358385841445,0.04070115415267139,0.21851473801108584,682054633,704893361.8,36.06906077203229,43.85668341103292,NaN,NaN,0.9418879893190247,5.667725225374219
2009-12-04T09:30:00-05:00,57.02,57.63,55.53999,55.89999,30194832,18763482.9,42.87575908564166,51.08460358145451,NaN,NaN,-130.79515706452096,-56.39772536419891,-0.23030624832223762,-0.06936807239171117,0.16093817593052645,651859801,690998092.2,30.218750700867815,42.14813364185441,NaN,NaN,-1.3404138234860574,4.666562504108465
2009-12-07T09:30:00-05:00,55.45,56.45,55.45,55.77,13579645,18350529.15,42.21868651015133,49.88061469750283,NaN,NaN,-162.6453384199425,-78.93583531516848,-0.26089750010539886,-0.1651836992012221,0.09571380090417674,638280156,678276679.2,26.05249078665237,40.0247935939913,NaN,NaN,-3.40320740951073,3.5137382307342944
2009-12-08T09:30:00-05:00,55.48,55.50999,54.49001,54.82001,20238416,18516017.95,37.67462472666823,48.39487619334541,NaN,NaN,-219.42831724573352,-127.9218566726219,-0.3278935729066788,-0.3141531652291718,0.013740407677507019,618041740,658401447,21.147021109825275,37.74735179674537,NaN,NaN,-6.608570049890826,2.0676941906449917
2009-12-09T09:30:00-05:00,55.00999,55.32001,54.17,54.82001,25316384,18884245.15,37.67462472666823,47.01156343903879,NaN,NaN,-191.13938656100075,-162.03649685994907,-0.35282195917268155,-0.42728704128834494,-0.07446508211566337,618041740,641655614,18.061282357414285,35.432397583231456,NaN,NaN,-9.2092249465365,0.45670574247620754
2009-12-10T09:30:00-05:00,55.27,55.74001,55,55.5,15191246,18742629.85,42.786614930199796,46.52611333239561,NaN,NaN,-121.08248761756515,-165.01813738175258,-0.30587682147175477,-0.4568111089553568,-0.15093428748360205,633232986,631891284.6,16.54526545059386,33.160683384448994,NaN,NaN,-10.05058653693538,-1.0443360117254479
2009-12-11T09:30:00-05:00,55.78999,55.92999,55.17,55.53,15628977,18253197.1,43.00870902819122,46.2474086855234,NaN,NaN,-97.84011998486493,-158.42712996582136,-0.2571273812175311,-0.4723435140055159,-0.21521613278798482,648861963,631291717,16.453937079420527,31.32549202948095,NaN,NaN,-10.681610375378654,-2.4210894922473343
2009-12-14T09:30:00-05:00,56.39,56.5,56.03999,56.10001,15632504,18066990.3,47.20242714130873,45.98753614151989,NaN,NaN,-44.60948564054018,-134.8199594099409,-0.17475434333931195,-0.4336590619621248,-0.25890471862281283,664494467,636534579.2,20.582176929065653,30.17152133764676,NaN,NaN,-10.069397463038937,-3.5137049166461347
2009-12-15T09:30:00-05:00,56.07001,56.63499,55.94,56.28,13432273,17689903.15,48.491334271719104,45.69758335124216,NaN,NaN,-33.68831663766961,-97.67195928832813,-0.1001166813728071,-0.38405057033882173,-0.2839338889660146,677926740,648511579.2,29.190079267147638,29.77384886566117,NaN,NaN,-9.20146036695648,-4.326241409547612
2009-12-16T09:30:00-05:00,56.64999,57.25,56.49001,56.64,18801984,17787502.35,51.06451546235228,45.42670944893599,NaN,NaN,14.16505496931706,-56.611070982264565,-0.022524028909615024,-0.31208892510303343,-0.2895648961934184,696728724,664248976,38.60622591024016,29.948014146277085,NaN,NaN,-7.745300585041225,-4.814678434618128
2009-12-17T09:30:00-05:00,56.28,56.7,56.00999,56.16,15438180,17701920.15,47.64671685487883,45.352572686263954,NaN,NaN,-21.959078109557048,-36.78638908066295,-0.0007022814974789737,-0.29044274806526715,-0.2897404665677882,681290544,673860487.6,43.544015429468345,30.262428496469465,NaN,NaN,-7.390601939235143,-5.182667506706273
2009-12-18T09:30:00-05:00,56.45,56.66,55.88,56.14999,20772192,17618716.95,47.57520378299105,45.34895629744956,NaN,NaN,-23.333010106260545,-21.884967104942067,0.015014675491809126,-0.2709721222030268,-0.2859867976948359,660518352,676191765.4,44.70566699599383,30.47971089687555,NaN,NaN,-7.114488056023248,-5.458641870894412
2009-12-21T09:30:00-05:00,56.55,57.07001,56.52,56.82001,16049043,17576132.3,52.69335352733161,45.408867210942724,NaN,NaN,31.68888778541945,-6.625292419750153,0.06944506370040537,-0.1991804680693292,-0.2686255317697346,676567395,678606351,45.94624765414679,30.629316216208696,NaN,NaN,-5.444311411402211,-5.456594662395526
2009-12-22T09:30:00-05:00,56.94,57.35001,56.75,57.09,10077523,17203224.45,54.61610264690739,45.74658624216392,NaN,NaN,61.75484980956355,12.463340869696495,0.11959969029717749,-0.11912591889826274,-0.23872560919544022,686644918,680349986.6,46.873196720245275,30.99967265450811,NaN,NaN,-3.4822602657600568,-5.174546891447601
2009-12-23T09:30:00-05:00,57.28,57.7,57.14999,57.53999,13031484,17057413.7,57.70185883267318,46.659323680548695,NaN,NaN,100.21364286819353,29.67305844947179,0.1756597515485899,-0.019150919759702845,-0.19481067130829274,699676402,680939522.2,47.20286666712152,31.79494450415734,NaN,NaN,-0.8903765714475754,-4.562522560019026
2009-12-24T09:30:00-05:00,57.74001,57.94,57.60001,57.81,2795293,16466698.85,59.482059077304186,47.84548796566744,NaN,NaN,133.71525133901585,60.807924339186364,0.2205961965486067,0.08093457437746565,-0.13966162217114106,702471695,685175752.4,49.62200526008077,33.180891258386836,NaN,NaN,1.8269397406751962,-3.649742231348423
2009-12-28T09:30:00-05:00,58.25,58.25951,57.67,57.91,5834980,16117891.6,60.150972840687004,49.12636556070571,NaN,NaN,132.13175910507127,91.90087818145273,0.2448525073020402,0.1664040119564092,-0.078448495345631,708306675,694733417,54.668683919550105,35.224905053593815,NaN,NaN,4.295716075746127,-2.5146767589063446
2009-12-29T09:30:00-05:00,58.14999,58.16,57.38,57.53,8514754,15571182.9,56.34433711731518,50.459916445751915,NaN,NaN,98.68145777108369,105.29939217858558,0.2236848076339626,0.20115751419682226,-0.02252729343714034,699791921,699378322.2,56.92697490962644,37.780616039293896,NaN,NaN,5.458651184720169,-1.3756299098168427
2009-12-30T09:30:00-05:00,57.32001,57.53999,57.11501,57.47,7253598,15157328.8,55.74447309521084,51.75061990064781,NaN,NaN,74.0908161972924,107.76658545613134,0.19506769353583647,0.22130732348265525,0.026239629946818777,692538323,700557003.2,57.50549501946697,40.59805980086909,NaN,NaN,6.282435517004433,-0.28162056312808903
2009-12-31T09:30:00-05:00,57.59,57.73,56.95,57.00999,5948855,14672421.75,51.2403015373462,52.35445465830113,NaN,NaN,62.22729964621066,100.16931681173477,0.13730928476524284,0.19787623590337233,0.06056695113812949,686589468,697939616.4,55.71592482464792,43.39596404187295,NaN,NaN,5.811888723845965,0.5888807635824901
2010-01-04T09:30:00-05:00,57.92,58.81,57.78999,58.81,16928448,14533030.55,63.62548935399691,53.82708182443012,NaN,NaN,147.2250843695324,102.8712834178381,0.2082297092300495,0.32085408767569135,0.11262437844564185,703517916,698148860.6,55.83425490447671,46.20884388651982,NaN,NaN,9.40113120237542,1.8477736834100518
2010-01-05T09:30:00-05:00,58.89,59.41,58.62,59.28999,17368896,13891733.75,66.09837512018714,55.17679239435,NaN,NaN,167.68277744548587,109.981487085921,0.27137057738218245,0.45183760017336994,0.18046702279118748,720886812,700664888,57.31134396367138,48.83235581756309,NaN,NaN,13.185730371952657,3.467481781773281
2010-01-06T09:30:00-05:00,59.32001,60.17999,59.1899,60,24351824,14430342.7,69.41111613997546,56.671062527796884,NaN,NaN,182.8462931979779,126.81445417129984,0.3403862523015706,0.6059498381681507,0.26556358586658013,745238636,709754231,62.226228085228655,51.1920807331403,NaN,NaN,17.520884884852308,5.475110796498856
2010-01-07T09:30:00-05:00,59.74001,60.00999,59.3,59.91,17450240,14290933.9,68.49741559396628,57.91626968005503,NaN,NaN,159.82596636238952,143.96148420431928,0.35763564821365906,0.712608146133654,0.3549724979199949,727788396,716804245.6,65.54024829050773,53.11593947458799,NaN,NaN,20.659834293084256,7.64435701029677
2010-01-08T09:30:00-05:00,59.7,60.35001,59.49001,60.3,13345039,13692366.65,70.3206243507926,59.53583450119173,NaN,NaN,158.51713712712944,163.21945170050304,0.3713520561344127,0.8191625680880108,0.4478105119535981,741133435,727713039,69.93555665196823,55.001049561909404,NaN,NaN,23.849304990754526,9.959349578933592
2010-01-11T09:30:00-05:00,60.69,60.87,59.73,60.22,19460864,13905847.55,69.4329253300672,61.09710032598288,NaN,NaN,148.75884681153042,163.52620418890262,0.35129433041201996,0.8869284249686231,0.5356340945566032,721672571,731343970,71.24999752226418,56.89707317092872,NaN,NaN,26.17196805914885,12.275437933250057
2010-01-12T09:30:00-05:00,59.3,59.7099,59.03999,59.35001,21510800,14199938.7,60.49007247998435,61.65400882260093,NaN,NaN,84.72731111087815,146.9351109219811,0.2599031040841362,0.8605129746617735,0.6006098705776373,700161771,727198961.8,67.61564409916761,58.44488720271592,NaN,NaN,25.495653468649337,14.164040152592811
2010-01-13T09:30:00-05:00,59.32001,59.8,58.52,59.57001,22137808,14525203.9,61.82894101069167,62.16921156287123,NaN,NaN,71.078447470678,124.5815417765211,0.1975605442746412,0.8475605509209387,0.6500000066462975,722299579,722611150.4,63.74020761292047,59.64967369504986,NaN,NaN,25.338210869756505,15.760350255044766
2010-01-14T09:30:00-05:00,59.56,59.89,59.33,59.74001,15545344,14630857.45,62.87582705870829,62.53878072187374,NaN,NaN,81.23548169403745,108.86344484285068,0.15305206224042867,0.8413150844468333,0.6882630222064047,737844923,724622455.8,64.69555210754359,60.89915122650861,NaN,NaN,25.508949846268848,17.15300733950535
2010-01-15T09:30:00-05:00,59.67,59.8,58.85001,59.25999,19055920,14643554.25,58.03571273261813,62.435470268681875,NaN,NaN,55.08207066166172,88.17643154975715,0.08022324838341466,0.788542082685673,0.7083188343022584,718789003,720153569.4,60.8587973800588,61.70177923507846,NaN,NaN,24.22319885137788,18.163034698344283
2010-01-19T09:30:00-05:00,59.10001,59.89999,58.99001,59.8,14613184,14602304.45,61.61548289352229,62.54007812959868,NaN,NaN,63.6081747007641,71.1462971276039,0.05837469257553729,0.78128720002168,0.7229125074461427,733402187,722499492.6,62.1284979158166,62.234623091954646,NaN,NaN,24.16368155726293,19.02026996390409
2010-01-20T09:30:00-05:00,59.16,59.16,58.42,58.87,15641758,14345782.75,53.19876665056439,62.31539452483077,NaN,NaN,11.926936099497421,56.58622212532775,-0.024320739461361818,0.6925115831194404,0.7168323225808022,717760429,726019224.2,64.01463597403739,62.74088459655543,NaN,NaN,21.393616976423882,19.359319537121205
2010-01-21T09:30:00-05:00,58.92,59.10001,57.53,57.67,25206928,14803677,44.71171018200177,61.52734003103012,NaN,NaN,-43.69618719604999,33.63129519198214,-0.1579941208695821,0.5193396714938245,0.6773337923634066,692553501,720070008.6,58.69370846441414,62.82575698548023,NaN,NaN,15.907472559636323,18.86619854033765
2010-01-22T09:30:00-05:00,57.39,57.72,56.14,56.3,23028656,15451233.65,37.379808896053056,60.537304842366325,NaN,NaN,-139.4481728730375,-10.50543572143285,-0.3271010160871646,0.26845752225445096,0.5955585383416155,669524845,706405993,48.68445476668448,62.32350912419713,NaN,NaN,8.29426988443972,17.355923018066516
2010-01-25T09:30:00-05:00,56.67999,57.22,56.49001,56.67,15902145,15594766.7,40.23044129743871,58.866229981183594,NaN,NaN,-126.89978530576975,-46.901806914919135,-0.39776382399188764,0.09835375835175597,0.4961175823436436,685426990,699733590.4,44.67772735490657,61.52661429922784,NaN,NaN,3.3759903415759567,15.358789778567864
2010-01-26T09:30:00-05:00,56.2,57.3,55.92,56.31,21515872,16530795.65,38.39884221009482,56.887691916177005,NaN,NaN,-132.39806259222573,-86.1030543735171,-0.4486998343653569,-0.06475721061305251,0.38394262375230437,663911118,685835376.6,37.71505903459582,60.126879661436725,NaN,NaN,-1.1429340593514734,13.001400658865101
2010-01-27T09:30:00-05:00,56.14999,56.64999,55.17999,56.09,26617648,17569929.05,37.28178058748282,54.59273937671325,NaN,NaN,-145.23276977311258,-117.53499554803912,-0.47464416976663426,-0.20936258845598843,0.26528158131064583,637293470,669741984.8,31.578210213007353,57.937735527706636,NaN,NaN,-5.092876512372466,10.416503920116877
2010-01-28T09:30:00-05:00,56.5,56.62,54.8,55.5,34434352,18865908.95,34.39221127769379,52.15665335412235,NaN,NaN,-143.53178981867595,-137.5021160725643,-0.5060948880708225,-0.3673370287778823,0.13875785929294018,602859118,651803108.2,26.418044570809926,55.143292404871076,NaN,NaN,-9.349174204077912,7.592835616660479
2010-01-29T09:30:00-05:00,55.91,56.46001,54.22,54.5,32803088,20143383.45,30.129713689183035,49.285874021150235,NaN,NaN,-151.31245537388054,-139.8749725727329,-0.5643599514216897,-0.5666920799841719,-0.002332128562482244,570056030,631909345.2,22.104259671046535,51.726771191948096,NaN,NaN,-14.514739489493847,4.434610601495576
2010-02-01T09:30:00-05:00,55.14999,56.31,55.11,56.3,21813280,20936604.7,43.66429858714872,47.44525782522749,NaN,NaN,-102.56587329970198,-135.00819017151935,-0.4564016266912945,-0.5728341619266004,-0.11643253523530589,591869310,613197809.2,18.967104270970324,47.99227881685567,NaN,NaN,-14.290666037553962,1.7595710816313566
2010-02-02T09:30:00-05:00,56.50999,57.14,56.05,57.03999,22250768,21202720.7,48.11409218226824,46.56125923253349,NaN,NaN,-58.70805614682678,-120.27018888243956,-0.3165241865643499,-0.5120877684407432,-0.19556358187639336,614120078,603239601.2,17.540333080097597,44.4154708869221,NaN,NaN,-12.49645156098264,-0.27700358159921423
2010-02-03T09:30:00-05:00,56.88,57.351,56.42,56.55,19749248,21321738.3,45.54856338561232,45.39837511645639,NaN,NaN,-51.52931317398338,-101.52949756261373,-0.24174609732584063,-0.49774620353369414,-0.2560001062078535,594370830,594655073.2,16.395362728975428,41.0336962523546,NaN,NaN,-11.960501160038337,-1.9460746642333746
2010-02-04T09:30:00-05:00,56.10001,56.11501,54.2,54.23,37173440,21962819.1,35.811772089193,43.46522833291959,NaN,NaN,-116.8215565906778,-96.1874509170141,-0.3279269857499599,-0.6659088383953033,-0.3379818526453435,557197390,585522727.6,15.254569436362047,37.502197490127344,NaN,NaN,-15.223124252402584,-3.8427960339718332
2010-02-05T09:30:00-05:00,54.22,54.48,52.67,54.24001,46378384,23409226.3,35.875465745076596,41.88235354809519,NaN,NaN,-141.249995564963,-94.1749589552306,-0.36103289169595193,-0.7892729672652834,-0.42824007556933147,603575774,592226676.4,19.673120318265575,34.56036341428497,NaN,NaN,-17.593519421779934,-5.80718508937299
2010-02-08T09:30:00-05:00,54.25,54.89,53.73,53.74001,24117456,23947847.15,34.057545814701896,39.91392947103658,NaN,NaN,-118.84225370723568,-97.43023503673733,-0.3908617402973472,-0.9168172509410155,-0.5259555106436683,579458318,589744478,19.272446554323025,31.499216888464,NaN,NaN,-20.089417819992907,-7.847504050890121
2010-02-09T09:30:00-05:00,54.48,55.56,54.31,54.87,33567328,24653170.35,41.29731095858579,39.06382549303811,NaN,NaN,-83.42460622411252,-102.37354505219449,-0.312159908493289,-0.9161553962602795,-0.6039954877669905,613025646,589525591.6,19.235243181912153,28.30068883188363,NaN,NaN,-19.715648896213477,-9.542953314507743
2010-02-10T09:30:00-05:00,54.89,54.979,53.78,54.64,24183152,24786787.95,40.32682049309749,38.7506190866878,NaN,NaN,-95.36654452052466,-111.14099132150275,-0.2556387379120253,-0.9235439101570222,-0.6679051722449969,588842494,588419924.4,19.035350603016084,25.467948984640913,NaN,NaN,-19.735021561755097,-10.998963064114507
2010-02-11T09:30:00-05:00,54.53,55.685,54.28999,55.57001,22946160,24827205.55,45.866447147469025,39.35680753321752,NaN,NaN,-57.90490605268429,-99.35766121390404,-0.14137112863383783,-0.8446190830372942,-0.7032479544034563,611788654,599338177.2,27.09255316886359,23.925670299082274,NaN,NaN,-17.93150329106811,-11.989325953679307
2010-02-12T09:30:00-05:00,54.89999,55.62,54.53999,55.59,19833888,25041632.75,45.98252395758045,39.7676705803705,NaN,NaN,-48.79411077672685,-80.86648425625681,-0.05465240424023432,-0.7715634597037493,-0.716911055463515,631622542,604947530.8,30.89732035028392,22.941355513037802,NaN,NaN,-16.48297405503106,-12.631275682443844
2010-02-16T09:30:00-05:00,56.3,57.10001,56.2399,56.89999,19834960,25080584.75,53.082454314184766,40.816500016376914,NaN,NaN,36.43624662317862,-49.810784190173955,0.09270262419878661,-0.6010327752150317,-0.6937353994138183,651457502,619347367.6,39.60998100060549,23.076707082038496,NaN,NaN,-12.877934500823656,-12.666512656498103
2010-02-17T09:30:00-05:00,57.06,57.17999,56.44,56.82001,18137792,25256815.15,52.62764241489248,41.912633004049034,NaN,NaN,54.767224174349714,-22.17241811048151,0.18142279300063868,-0.46695690816302005,-0.6483797011636587,633319710,623406180.4,41.83603674851875,23.809408977432163,NaN,NaN,-10.160848842614666,-12.308560683086183
2010-02-18T09:30:00-05:00,56.75999,57.28,56.48,57.14,16572871,25303370.8,54.31420214993186,43.335632352066035,NaN,NaN,77.07284438323893,12.315459670271222,0.2538525616300402,-0.3310639991261084,-0.5849165607561486,649892581,635616197.8,48.040928338506156,25.353900675124756,NaN,NaN,-7.4150351464562405,-11.609485606424762
2010-02-19T09:30:00-05:00,56.92999,57.565,56.66,57.36,16501898,24868119.3,55.48755632722545,45.146906826211925,NaN,NaN,100.53416329623734,44.00327354005555,0.30531522533059374,-0.2032725290929065,-0.5085877544235002,666394479,646537362.8,52.88263597902942,27.552356125694967,NaN,NaN,-4.805785896486093,-10.637528505004953
2010-02-22T09:30:00-05:00,57.5,57.50999,56.45,56.57001,17353072,24584340.1,50.47449005053167,45.63334907359642,NaN,NaN,73.9033428241548,68.54276426023189,0.27578727855621865,-0.1638536562282269,-0.43964093478444555,649041407,650021135.8,54.34413757264005,30.079287075814232,NaN,NaN,-3.9512055364211833,-9.682339509492985
2010-02-23T09:30:00-05:00,56.3,56.44,55.37,55.63,21101552,24844310.45,45.237281058021615,45.42786256472166,NaN,NaN,2.6931075304432723,61.79413644168481,0.18684138902777037,-0.20608919849973262,-0.392930587527503,627939855,645317606.4,51.998981028680326,32.540619072141574,NaN,NaN,-4.778507376244945,-8.981792061886122
2010-02-24T09:30:00-05:00,55.61,56.19,55.44,55.98,17630272,24650030.45,47.42469037687462,45.56187163552611,NaN,NaN,9.79004358716128,52.79870032424712,0.147215749784801,-0.20891090029650172,-0.35612665008130273,645570127,647767689.8,53.13352954712261,35.16477384486637,NaN,NaN,-4.821129557536827,-8.387411704121936
2010-02-25T09:30:00-05:00,55.17999,56.03999,54.72,56.00999,20948080,24366552.05,47.61776366634147,46.40515674817958,NaN,NaN,-10.863160645140068,35.211499318571335,0.11982250434538921,-0.20634851964956624,-0.32617102399495546,666518207,651092815,54.69846821366625,37.98219518610239,NaN,NaN,-4.8018158116557474,-7.875183719483909
2010-02-26T09:30:00-05:00,56.14,56.34,55.64999,56.14,17246800,23507174.45,48.500694543316776,47.30695880519672,NaN,NaN,23.242294537221824,19.753125566768226,0.10764222856236333,-0.1916182382920013,-0.29926046685436464,683765007,654566920.6,56.33886820836625,40.601177178252435,NaN,NaN,-4.547548209964095,-7.399807218123935
2010-03-01T09:30:00-05:00,56.39999,56.8,56.35001,56.66,13965984,22565319.25,51.98660594692253,48.587605957498205,NaN,NaN,61.54982754674068,17.282422511285404,0.13027856991883574,-0.13641225445581995,-0.2666908243746557,697730991,664304837.4,60.641044159850296,43.55607700721866,NaN,NaN,-3.3679460267265404,-6.823827047924307
2010-03-02T09:30:00-05:00,57.03,57.56,56.91,57.13,16746223,22311966.4,54.95448197814085,49.56311817318071,NaN,NaN,96.69324083048502,36.08244917129375,0.17006284356531826,-0.05411226991800788,-0.22417511348332614,714477214,681612309.2,66.88633521904468,46.95972643844242,NaN,NaN,-1.5157699257508306,-6.065533173328096
2010-03-03T09:30:00-05:00,57.35001,57.88,57.35001,57.38,16767695,22037812.75,56.494940298602,50.717983873573885,NaN,NaN,113.61186378180196,56.84681321022189,0.20408205793503353,0.03092745893546578,-0.17315459899956775,731244909,698747265.6,71.67781749747127,50.719902645189215,NaN,NaN,0.48014775185892516,-5.1304358983013785
2010-03-04T09:30:00-05:00,57.47,57.64999,56.84,57.08,16330902,21866895.45,54.10386851213785,51.30637111390738,NaN,NaN,85.7567813398424,76.17080160721838,0.1971396420151857,0.07326995351941434,-0.12386968849577133,714914007,708426425.6,73.96916076930572,54.0682317595065,NaN,NaN,1.5580264544565228,-4.174941276478821
2010-03-05T09:30:00-05:00,57.64,58.28,57.58,58.14999,15335273,20774987.1,60.521653499287375,52.34488036688644,NaN,NaN,126.07400285766707,96.73714327130743,0.2518674428349568,0.19096461504792472,-0.06090282778703211,730249280,717723280.2,75.97932568120406,57.28837499742938,NaN,NaN,4.456471013969421,-2.9418823778433576
2010-03-08T09:30:00-05:00,58.31,58.50999,57.815,58.06,12618797,19087007.75,59.76472781145031,52.822185616691115,NaN,NaN,124.46897959348159,109.32097368065561,0.26777874847912797,0.2738206078118779,0.006041859332749894,717630483,721703178.6,76.80509133415894,59.9451685926832,NaN,NaN,6.625589146181716,-1.5751007315540615
2010-03-09T09:30:00-05:00,57.75,58.38,57.67,58.06,16703738,18716321.85,59.76472781145031,53.33197743073096,NaN,NaN,112.02289188564384,112.38690389168737,0.2636591596467587,0.33561580889119824,0.07195664924443956,717630483,722333832.4,76.9403694914706,62.45262093146547,NaN,NaN,8.413469723879277,-0.1481620950635847
2010-03-10T09:30:00-05:00,58.12,58.64999,57.85001,58.57001,17372192,17906565.05,62.82101262101442,53.939606750094,NaN,NaN,127.34940534062366,115.13441220345172,0.2791472640393423,0.4208907292936175,0.14174346525427517,735002675,723085385.6,77.11168717264869,64.5291037053328,NaN,NaN,10.844930229064367,1.4222796655261227
2010-03-11T09:30:00-05:00,58.35001,58.58,58.17,58.47,13037586,17349286.75,61.82919933673603,54.392581250773326,NaN,NaN,124.43203336726818,122.86946260893687,0.26654689429355816,0.4749270831212229,0.20838018882766474,721965089,724495602,77.45022159749809,66.28393124950914,NaN,NaN,12.62816757933132,3.023120796069722
2010-03-12T09:30:00-05:00,58.85001,58.85001,58.25,58.5,13659777,16884967.6,62.02289032184533,55.21746698443859,NaN,NaN,122.7255098812538,122.1997640136542,0.2446911655091667,0.5142441457141231,0.26955298020495644,735624866,725570719.2,77.72076937989691,67.9536906643132,NaN,NaN,14.178711414676098,4.616776598727776
2010-03-15T09:30:00-04:00,58.28,58.36,57.28999,57.89999,18374688,16812007.6,55.91199246721819,55.97994637080977,NaN,NaN,59.894465623485544,109.284861219655,0.17741660335933024,0.49132373440411925,0.313907131044789,717250178,725494658.2,77.649789887463,69.78589129708338,NaN,NaN,13.961588613520885,5.95174974369822
2010-03-16T09:30:00-04:00,58.19,58.48,57.73,58.42,19161696,16778344.4,59.62482476999773,56.85138454174713,NaN,NaN,82.01569028227536,103.2834208989813,0.15627373158121477,0.5092492955213075,0.3529755639400927,736411874,729250936.4,78.68507509205298,71.61100169314984,NaN,NaN,14.789307208750882,7.214257952991457
2010-03-17T09:30:00-04:00,58.71001,59.42,58.63,59.06,21672896,16955099.6,63.67894209749182,57.998611572543595,NaN,NaN,132.35352571193602,104.28424497324377,0.17245495592056764,0.5685442588408023,0.39608930292023464,758084770,733867355.4,79.91634510016871,73.41227861361429,NaN,NaN,16.705726508666256,8.570182032373571
2010-03-18T09:30:00-04:00,59.06,59.14999,57.86,58.17999,19726848,17112798.45,55.43626690241956,58.49400959819379,NaN,NaN,73.72461990432814,94.14276228065576,0.11378540719228736,0.5383210619105938,0.42453565471830645,738357922,737145922,80.76611244983194,75.157081773719,NaN,NaN,15.901377405860723,9.61749565715745
2010-03-19T09:30:00-04:00,58.09,58.25,56.75751,57.28,22412304,17408318.75,48.51921725609099,58.24633897742011,NaN,NaN,-1.937040657307292,69.21025217294354,0.009741981814345269,0.43671313198623807,0.4269711501718928,715945618,733210072.4,76.57724886419207,76.2953821097434,NaN,NaN,12.918080434041949,10.08900776814095
2010-03-22T09:30:00-04:00,56.56,57.39,56.33,57.13,19856480,17533489.15,47.45639672764492,57.710761459527546,NaN,NaN,-40.204100706556076,49.19053890693522,-0.06944637638816725,0.34016317968668375,0.409609556074851,696089138,728977864.4,72.2386466655674,76.67769007020932,NaN,NaN,10.197060495156789,10.104443872000356
2010-03-23T09:30:00-04:00,57.25999,57.44,56.89,57.35001,17420864,17349454.75,49.21362901525243,57.19066779643115,NaN,NaN,-26.366606451315867,27.51407956021697,-0.10513341928973668,0.27819278196268016,0.38332620125241684,713510002,724397490,67.76391285107559,76.39812545260962,NaN,NaN,8.478775088182084,9.872205474312032
2010-03-24T09:30:00-04:00,56.97,57.52,56.84,57.02,20768832,17506382.75,46.6912288343568,56.6611935337325,NaN,NaN,-44.18763300753785,-7.794152183677802,-0.14654527788637856,0.20014460389444366,0.3466898817808222,692741170,711328770,56.92852850898871,75.18093743401555,NaN,NaN,6.279539350517628,9.358967456627118
2010-03-25T09:30:00-04:00,57.42999,57.57001,55.97,56.06,22122928,17565125.15,40.231380145988304,55.211888294211136,NaN,NaN,-112.46040878855356,-45.031157922254145,-0.22924494569221854,0.060133699665549045,0.2893786453577676,670618242,697780834,48.30537579929459,73.20422672816487,NaN,NaN,2.2061673238678967,8.337138866232944
2010-03-26T09:30:00-04:00,56.25,56.44,55.72,56.08,21493808,17777475.55,40.41633158962769,53.82985999265238,NaN,NaN,-159.16545172481392,-76.47684013575547,-0.2704239530474718,-0.04865129595157214,0.22177265709589963,692112050,693014120.4,45.68342018443292,70.98125021747016,NaN,NaN,-0.9813374955570685,7.0059279574058
2010-03-29T09:30:00-04:00,56.44,57.28,56.39999,57.17,19477152,18053033.95,49.574629768310466,53.10199584671381,NaN,NaN,-74.23105726703763,-83.28223144785179,-0.21451869203547358,-0.04637570794844237,0.1681429840870312,711589202,696114133.2,47.67266219395354,68.89069969621895,NaN,NaN,-0.9940254117073173,5.863077476103926
2010-03-30T09:30:00-04:00,57.3,57.37,56.91,57.25999,13058277,17868636.65,50.25445020104921,52.20438424528773,NaN,NaN,-49.96878548218558,-88.00266725402574,-0.1640229091095117,-0.03688565229985841,0.1271372568096533,724647479,698341628.6,49.11472877497794,66.89091695352818,NaN,NaN,-0.7965381654240442,4.911703813028502
2010-03-31T09:30:00-04:00,57.37,57.78,57.13,57.52,15168059,17788654.85,52.25723005099174,51.52067215344885,NaN,NaN,-18.557723535795294,-82.87668535967723,-0.10834063403960344,-0.008288535739851,0.10005209829975244,739815538,707756502.2,54.78636604216635,65.27207012814733,NaN,NaN,-0.03634404764365384,4.204839832932479
2010-04-01T09:30:00-04:00,58.09,58.67,58.03999,58.53999,17990384,17871628.95,59.197225960226994,51.31883898476183,NaN,NaN,71.88098322644278,-46.00840695667792,-0.0035794446745088665,0.09557779245661635,0.09915723713112522,757805922,725194038.2,63.00987948856266,64.22129227876631,NaN,NaN,2.8946742076253438,4.01767331503146
2010-04-05T09:30:00-04:00,58.89999,59.69,58.7,59.58,17455936,17977662.1,64.8135631856565,51.95466546465028,NaN,NaN,144.91824902686102,14.808333193657063,0.12773749060615255,0.2588291003888159,0.13109160978266335,775261858,741823999.8,68.83207398842256,63.591455428834855,NaN,NaN,7.421120850669105,4.503880105836838
2010-04-06T09:30:00-04:00,59.5,59.78,59.25999,59.58,13535746,18023509.55,64.8135631856565,52.325289637197336,NaN,NaN,145.55209298552975,58.764963244170545,0.2021530540912989,0.383782927396787,0.18162987330548808,775261858,754558531,72.41290139910501,63.14344302219571,NaN,NaN,10.92751827310176,5.421542701160398
2010-04-07T09:30:00-04:00,59.44,59.48,58.64999,58.99001,19536592,18165152.25,59.43141036347597,52.02189451333907,NaN,NaN,92.10602073597308,87.17992448780227,0.1988904221165863,0.430242900951221,0.23135247883463467,755725266,760774088.4,73.98398079360157,62.719702714583775,NaN,NaN,12.224205033160713,6.393351605731871
2010-04-08T09:30:00-04:00,58.55,59.39,58.27,59.2,19460288,18269557.05,60.682852504259024,52.39665062775617,NaN,NaN,79.77533792510661,106.84653677998264,0.19771117786116482,0.4784914511610907,0.2807802732999259,775185554,767848091.6,75.68144171119235,62.35651194753809,NaN,NaN,13.659239628935605,7.43133560904669
2010-04-09T09:30:00-04:00,59.59,59.92999,59.5,59.83,17488592,18492107.35,64.2462859148171,53.52001267480812,NaN,NaN,127.02617479969372,117.87557509463284,0.22425301181160007,0.5610965380644259,0.3368435262528259,792674146,774821736.4,77.25683535566299,62.405053839786014,NaN,NaN,16.008738051914975,8.65667881517073
2010-04-12T09:30:00-04:00,59.78,60.38,59.75999,59.97,15032969,18560766.95,65.00531925291294,54.773507140898694,NaN,NaN,131.37673378165653,115.16727204559193,0.2349967404946557,0.6305894518711455,0.39559271137648977,807707115,781310787.8,78.64324809958234,62.862525370787075,NaN,NaN,18.14307181766366,10.011877815526862
2010-04-13T09:30:00-04:00,59.89,60.035,59.13,59.75999,13856438,18334854.45,62.84985612095969,55.74752336273493,NaN,NaN,93.4613308430917,104.74911961710431,0.21240289322618444,0.6610963279092203,0.4486934346830359,793850677,785028551.6,79.41740164879943,63.69491742776735,NaN,NaN,19.300788863587382,11.338865108106937
2010-04-14T09:30:00-04:00,60.06,60.38,59.53,60.33,14585574,18106048.35,66.13235016983356,57.13617488669755,NaN,NaN,106.75820079389682,107.67955562868909,0.21939305098854966,0.722934748418723,0.5035416974301733,808436251,795570748.6,81.46871266890831,65.44778772490447,NaN,NaN,21.287842014500534,12.760147523306022
2010-04-15T09:30:00-04:00,60.25999,60.53999,60.07001,60.32001,13947781,17719792.6,66.02224658927622,58.978379632646686,NaN,NaN,110.9196540112251,113.90841884591278,0.20704516819012553,0.7623481576678302,0.5553029894777046,794488470,799431331.8,82.16952339167862,67.86665541007476,NaN,NaN,22.87093759598144,14.204546105116796
2010-04-16T09:30:00-04:00,59.98,60.25,58.91,59.3,36665568,18566728.6,55.805987309212846,60.0776407554742,NaN,NaN,59.49354065221481,100.40189201641701,0.11829485800015349,0.7031715619778964,0.5848767039777429,757822902,792461083,76.54130358792204,70.0707899388954,NaN,NaN,21.225855872259384,15.207590357565737
2010-04-19T09:30:00-04:00,58.75999,59.39999,58.58,59.38,21149024,18503564.6,56.37614617051169,60.563463355631434,NaN,NaN,35.96398362387427,81.31934198486054,0.05623987486133486,0.6551765475544116,0.5989366726930767,778971926,786714045.2,72.15301460385099,71.81938653960238,NaN,NaN,20.05870493367658,15.900606725581572
2010-04-20T09:30:00-04:00,59.83,60.75999,59.78,60.53999,19667408,18494111,63.69086009154386,61.52320691923819,NaN,NaN,95.50426832958811,81.72792948215982,0.08296428699636194,0.7026420314385291,0.6196777444421672,798639334,787671776.6,72.43662110132726,73.48523599148447,NaN,NaN,21.29739614264297,16.67157664230463
2010-04-21T09:30:00-04:00,60.56,60.92999,60.03999,60.48,18571584,18551647,63.101578547156926,62.297803240392845,NaN,NaN,95.41946235543806,79.46018179446807,0.08588760040592303,0.727037244949571,0.641149644543648,780067750,781998076.4,68.01721246983959,74.43029645060399,NaN,NaN,22.101754672151266,17.44731636085415
2010-04-22T09:30:00-04:00,59.97,60.64,59.52,60.63,19383104,18482360.6,63.998518116883,62.64075268015399,NaN,NaN,78.99436217979569,73.0751234281822,0.08694491732927445,0.7498307912052411,0.6628858738759666,799450854,782990553.2,68.38062336421105,74.8139210131503,NaN,NaN,23.02242167558053,18.24375997724363
2010-04-23T09:30:00-04:00,60.64999,62.09,60.57001,62.09,26012288,18676828.6,71.30901820771341,63.10471375315806,NaN,NaN,152.3122120340968,91.63885770455859,0.17018021205256395,0.8756111389416716,0.7054309268891077,825463142,796518601.2,72.90064076754481,75.10453292594475,NaN,NaN,26.361203032283115,19.403394699392127
2010-04-26T09:30:00-04:00,62.2,62.2999,61.78,61.88,17270224,18465649.4,69.13445335179208,63.413348765024885,NaN,NaN,173.7019840049182,119.18645778076737,0.19359636581698947,0.9474263841603445,0.7538300183433551,808192918,802362799.6,74.59052514686951,75.2600774793565,NaN,NaN,28.332687098131622,20.679007899212056
2010-04-27T09:30:00-04:00,61.45,61.91,59.83,59.98,41402624,19561923,53.29800325814649,62.97524825750135,NaN,NaN,69.01140992971622,113.88788610079298,0.06999843031397501,0.8413280562358239,0.7713296259218488,766790294,795992991.6,69.50320711078597,74.94002221629823,NaN,NaN,24.3939026302992,21.20970714651022
2010-04-28T09:30:00-04:00,60.39,60.75,59.77,60.59,23096480,20063833.15,56.725348105226985,62.69256937185621,NaN,NaN,46.21007376495285,104.04600838269593,0.020756915409721688,0.797275770184001,0.7765188547742793,789886774,797956796.4,70.17849876868952,74.54695486326231,NaN,NaN,22.478577176472385,21.39097429364767
2010-04-29T09:30:00-04:00,60.89999,61.39,60.25,60.66,28862720,20748566.2,57.11429277072552,62.183141290135374,NaN,NaN,75.12020640814438,103.27117722836567,-0.01380696167789075,0.7592601526769158,0.7730671143548066,818749494,801816524.4,71.51361072683463,74.13672453263173,NaN,NaN,21.14595751608281,21.35597189685269
2010-04-30T09:30:00-04:00,60.8,60.83,59.53,59.91,22916448,20994869.4,51.74776097828727,61.23617284194783,NaN,NaN,0.21667885331387596,72.85207059220909,-0.08965829965605743,0.6609942397847348,0.7506525394407922,795833046,795890505.2,66.58467130268143,73.27539761856737,NaN,NaN,18.22008003065255,20.907987344538384
2010-05-03T09:30:00-04:00,60.17,61.07001,59.49001,60.59,16689836,20956564.4,55.80263711938341,60.732800056120944,NaN,NaN,28.488551847536716,43.80938416073281,-0.09594795711399162,0.6307175930483027,0.7266655501622943,812522882,796756498,66.9432306858595,72.38438540692881,NaN,NaN,17.12487276120134,20.367542404061663
2010-05-04T09:30:00-04:00,59.78999,59.84,58.35001,58.97,30584304,21808992.3,45.90538671952705,59.28801695252763,NaN,NaN,-119.90565356061187,6.025971462667192,-0.20486992859651942,0.47057813941664506,0.6754480680131645,781938578,799786154.8,68.22771168959572,71.4385996226922,NaN,NaN,12.520243047614654,19.246499638854946
2010-05-05T09:30:00-04:00,57.89,58.85001,57.52,58.03999,35206480,22592486.7,41.369168733248564,57.527082819954224,NaN,NaN,-201.8376592306232,-43.58357513644802,-0.32790948659544217,0.2655612097688618,0.5934706963643039,746732098,791155219.6,60.96054346091878,69.92367248478078,NaN,NaN,7.100184667139751,17.511311785752774
2010-05-06T09:30:00-04:00,57.52,58.17999,52.28999,56.0549,47200688,23979506.7,33.711657558875615,55.94891640921585,NaN,NaN,-340.5744895100583,-126.72251432008855,-0.5199331060677288,-0.05644568622035706,0.46348741984737174,699531410,767311602.8,46.291427478346044,67.76296704838249,NaN,NaN,-0.7242904062676918,14.906225758321279
2010-05-07T09:30:00-04:00,55.89999,56.63,54.28999,54.99001,49490896,25579621.9,30.454955391745045,54.09740278216109,NaN,NaN,-253.80417905924025,-177.52668590259935,-0.6852183564260457,-0.3930355256851854,0.29218283074086027,650040514,738153096.4,35.15160839563265,65.12000946208117,NaN,NaN,-8.172495969488624,11.609265511491293
2010-05-10T09:30:00-04:00,57.13,57.56,56.52,57.34,29716848,26313815.85,43.4402392791947,52.650929866993295,NaN,NaN,-122.89638243189759,-207.80367275848621,-0.6055885740299208,-0.4648028867965408,0.14078568723338003,679757362,711599992.4,28.439809277041746,61.97738004606078,NaN,NaN,-9.284765359062161,8.624403958555085
2010-05-11T09:30:00-04:00,56.74001,57.83,56.69,56.96001,22836784,26762833.15,42.07228313006426,51.14883733720096,NaN,NaN,-103.82646868163908,-204.58783578269168,-0.5494658056819144,-0.5460465698690129,0.0034192358129014333,656920578,686596392.4,23.826381117268838,58.82089209230572,NaN,NaN,-10.614020022694087,5.8760576755194895
2010-05-12T09:30:00-04:00,57.08,57.94,57.08,57.75,18808448,26973976.85,45.8874380086016,49.855188758038004,NaN,NaN,-74.0014510301272,-179.02059414259247,-0.435101092557962,-0.5404571298845511,-0.10535603732658909,675729026,672395778,21.67577447873026,55.48483145762852,NaN,NaN,-10.26537229597377,3.5701391081633096
2010-05-13T09:30:00-04:00,57.66,58.11,57.11,57.38,21117648,27332470.2,44.41209884014936,47.93398023178342,NaN,NaN,-68.17383401834549,-124.54046304424992,-0.3632628124731165,-0.5594345529179847,-0.19617174044486824,654611378,663411771.6,20.42001475297141,51.736215313730426,NaN,NaN,-10.495912931845938,1.560703102447703
2010-05-14T09:30:00-04:00,56.85001,57.02,55.36,56.24001,28395616,26918972.6,40.13093952024895,45.86230067238749,NaN,NaN,-107.10280030545125,-95.2001872934921,-0.37015617162526226,-0.6588669549764461,-0.28871078335118383,626215762,658646821.2,19.765947247579007,47.82017403520967,NaN,NaN,-12.147366224452107,-0.3975925156808413
2010-05-17T09:30:00-04:00,56.42,56.58,54.46001,55.66,31949968,27459019.8,38.117653960880645,44.77799000829707,NaN,NaN,-113.06887636100458,-93.23468607931352,-0.3894553595137105,-0.775529982743322,-0.38607462322961145,594265794,641548507.6,17.588824502756523,44.11200384892185,NaN,NaN,-14.133220035370945,-2.359825018493713
2010-05-18T09:30:00-04:00,56.47,56.86,54.91,55.23,30676256,28009462.2,36.64969448244445,43.344014749526885,NaN,NaN,-97.34804803120016,-91.93900194922574,-0.4050576499013739,-0.8923966856063288,-0.4873390357049549,563589538,622882299.6,15.572291583270882,40.2115604785348,NaN,NaN,-16.194181093788607,-4.3361616006786985
2010-05-19T09:30:00-04:00,54.91,55.32249,53.66,54.60001,30109168,28586341.4,34.55032023717436,41.7323024257018,NaN,NaN,-120.92065815417521,-101.32284337403533,-0.42936458498070995,-1.0240447669308423,-0.5946801819501324,533480370,594432568.4,13.105995252912422,36.03958794468321,NaN,NaN,-18.554298510178363,-6.367324016321508
2010-05-20T09:30:00-04:00,53.2,53.37,52,52.16,44886576,29861515,27.887331249376672,40.027986016493905,NaN,NaN,-162.825034798602,-120.25308353008663,-0.5723858521361758,-1.310162497120352,-0.7377766449841763,488593794,561229051.6,10.930227515493357,32.06427053131263,NaN,NaN,-23.103634722234307,-8.758225545737622
2010-05-21T09:30:00-04:00,51.13,53.19,51.00999,53.07001,40155952,30568698.2,33.07136951661083,38.40432404486729,NaN,NaN,-149.95461195596116,-128.82344586018863,-0.567222518321208,-1.4468047928856862,-0.8795822745644782,528749746,541735848.4,9.89196125531572,27.989179857702368,NaN,NaN,-25.028462361772437,-11.082545090885453
2010-05-24T09:30:00-04:00,52.96001,53.10001,51.78,51.86,27414336,31075903.8,29.984740701967922,37.26713504361307,NaN,NaN,-139.1137651899879,-134.03242362598527,-0.6034525267114921,-1.6338979329538432,-1.0304454062423511,501335410,523149771.6,9.01287389694491,23.75954858679874,NaN,NaN,-27.68289651079775,-13.45402386515864
2010-05-25T09:30:00-04:00,50.47,52,50.14999,51.98,43113984,31161471.8,30.675766518030244,36.5033205996689,NaN,NaN,-145.06464545241232,-143.57574311022773,-0.5774743217382585,-1.7522883084151744,-1.1748139866769158,544449394,519321742.8,8.838650002461023,20.036556196908897,NaN,NaN,-29.52178369831721,-15.749418127038435
2010-05-26T09:30:00-04:00,52.59,53.075,51.7,51.87,29848496,31499072.6,30.37977298827822,36.26532884462624,NaN,NaN,-110.03272786241035,-141.39815705187473,-0.5272289161215615,-1.8338501318288678,-1.3066212157073063,514600898,515545848.4,8.660808874475237,17.34865486806098,NaN,NaN,-31.07259169336133,-17.93844292222742
2010-05-27T09:30:00-04:00,53.17999,54.14,52.99001,54.07001,30306672,31571270.2,42.35914065131651,37.11562779173848,NaN,NaN,-60.63585482851671,-120.96032105785768,-0.3157861435216345,-1.7013538951093494,-1.385567751587715,544907570,526808603.6,14.205953857773196,15.85253668678531,NaN,NaN,-28.556196451331058,-19.45526485495651
2010-05-28T09:30:00-04:00,53.94,54.00999,52.64999,53.05,26328688,31741882.2,39.00782984669575,36.79902711798856,NaN,NaN,-68.53039810384479,-104.6754782874344,-0.21916657708898102,-1.6595259729489413,-1.4403593958599603,518578882,524774430.8,14.040164812049952,14.823990653571608,NaN,NaN,-27.55130645893424,-20.61184222695333
2010-06-01T09:30:00-04:00,52.17,52.5425,50.44,50.53,36350416,32724911.2,32.22460822629688,36.095621767719464,NaN,NaN,-120.02925046532386,-100.85857534250158,-0.29480726170330374,-1.80886847298909,-1.5140612112857863,482228466,520953042,13.716316966960832,14.101843214263893,NaN,NaN,-29.047958613201303,-21.81700171070304
2010-06-02T09:30:00-04:00,50.88,52.8,50.78999,52.72,27650496,32578220.8,41.71096285422856,35.79730211383568,NaN,NaN,-81.59993262967782,-88.16563277795468,-0.1731990027964505,-1.7305599647813494,-1.557360961984899,509878962,514038955.6,13.126371645659546,13.491171583330273,NaN,NaN,-26.794055291593832,-22.52800936511601
2010-06-03T09:30:00-04:00,53.27,53.545,52.13,53.42999,33690176,32502405.6,44.426691494431495,35.7983444462844,NaN,NaN,-44.65227200494504,-75.08954160646162,-0.028389858382456,-1.5928482849629688,-1.5644584265805128,543569138,519832603.6,16.37220976651679,13.202042655726375,NaN,NaN,-24.087953596074914,-22.750858540967283
2010-06-04T09:30:00-04:00,52.28999,53.4425,51.17999,51.55,29859888,31635365.6,39.21647217825318,35.73302535042756,NaN,NaN,-71.44626138520887,-77.25162291780008,-0.04185174974890815,-1.616773113766648,-1.5749213640177397,513709250,513592939.6,15.692197955794,12.911060563456017,NaN,NaN,-23.667774154278785,-22.88184648572607
2010-06-07T09:30:00-04:00,51.75999,52.36,51,51.10001,24131520,30367396.8,38.06572956103393,35.72931646472422,NaN,NaN,-82.93118329765366,-80.13177995656186,-0.06245451767022736,-1.652989511105524,-1.5905349934352966,489577730,507792709.2,15.065772655818932,12.730842574389044,NaN,NaN,-23.72884004717821,-23.002845565933516
2010-06-08T09:30:00-04:00,51.17999,52.11,50.69,51.95,35094320,30636270.4,41.55437867991553,36.07965105025787,NaN,NaN,-74.79287025496146,-71.08450391448937,-0.003348984446769565,-1.5947212239937585,-1.591372239546989,524672050,516281426,20.093253699635028,13.053768439843624,NaN,NaN,-22.63611192493668,-22.95045504579111
2010-06-09T09:30:00-04:00,52.47,53.28,51.14,51.41,30679856,31028424,40.01237564212295,36.46979786489706,NaN,NaN,-57.711250627631706,-66.30676751408015,0.013919476492069371,-1.5739728939319022,-1.5878923704239716,493992194,513104072.4,19.624995432798798,13.51941130983551,NaN,NaN,-22.237377851952182,-22.84858687524269
2010-06-10T09:30:00-04:00,52.78,54.10001,52.66,53.99001,25993328,31387668,49.62971902140611,38.022825562899165,NaN,NaN,17.304575993632056,-53.91539791436473,0.20314005376969746,-1.3339673032118498,-1.5371073569815472,519985522,508387349.2,18.920110263024284,14.090117220373433,NaN,NaN,-18.599298134508306,-22.24154562656635
2010-06-11T09:30:00-04:00,53.23,54.35001,53.23,54.32001,15163043,31089937.75,50.71804408053514,39.283302317465186,NaN,NaN,50.93164790142332,-29.439816057038293,0.34616425192940303,-1.1044020420697933,-1.4505662939991963,535148565,512675212.2,21.674327152873104,14.931714784484674,NaN,NaN,-15.393864359424242,-21.26330544554605
2010-06-14T09:30:00-04:00,54.99001,55.39,54.00999,54.03999,23814528,30860883.35,49.73603565039341,40.69410909949557,NaN,NaN,90.64180408381844,5.274781419256129,0.41301686019274486,-0.9342952187582654,-1.3473120789510102,511334037,517026473.6,24.47793832300856,16.03636224348922,NaN,NaN,-13.124541793046705,-20.100624923760428
2010-06-15T09:30:00-04:00,54.60001,55.7,54.46001,55.62,17071520,30116960.95,55.027274813733754,42.43350254918868,NaN,NaN,139.71433964932493,48.17622340011341,0.5463834876657674,-0.6643327193688009,-1.2107162070345683,528405557,517773175,24.97423407728367,17.188903963119408,NaN,NaN,-9.469510390349274,-18.581894276130264
2010-06-16T09:30:00-04:00,55.23,55.96001,55,55.58,14496254,29307960.85,54.86979719198692,44.18278999231073,NaN,NaN,156.5543126837239,91.02933606238453,0.6098179427470338,-0.448443778600776,-1.0582617213478098,513909303,521756596.8,27.703694737826936,18.549110096215962,NaN,NaN,-6.608551266339234,-16.871416703302973
2010-06-17T09:30:00-04:00,55.75,55.75,54.92,55.52,17412960,28673150.45,54.61730552156425,45.05837319732843,NaN,NaN,140.7778007621045,115.72398101607901,0.6234286763072803,-0.27897587596370954,-0.9024045522709898,496496343,517058761,26.480168285853594,19.4258396982217,NaN,NaN,-4.351980660806305,-15.082925840089164
2010-06-18T09:30:00-04:00,55.25999,55.6981,54.86,55.61,13598199,27108731.6,54.95216574249625,46.19725433274275,NaN,NaN,120.89694884577644,129.71704120494965,0.6132490988328266,-0.13584317872995655,-0.7490922775627832,510094542,512047956.4,25.201672359327844,20.22309023731298,NaN,NaN,-2.3926441990178224,-13.270028462793258
2010-06-21T09:30:00-04:00,56.53,56.7,55.07001,55.49001,16625684,25932218.2,54.37610457345579,47.77950407182552,NaN,NaN,121.52652991216387,135.89398637061873,0.5738930556000544,-0.031725958062715165,-0.6056190136627696,493468858,508474920.6,24.30069898422758,20.979117524260605,NaN,NaN,-0.8919210336778249,-11.501727401491053
2010-06-22T09:30:00-04:00,55.45,55.48,53.685,53.87,21573840,25640193.4,47.18428918738844,48.170455952765515,NaN,NaN,47.20980191102163,117.39307882295807,0.42127708725096946,-0.07902265459905777,-0.5002997418500272,471895018,497172812.8,21.66255207151181,21.588844697535766,NaN,NaN,-1.4850467866093728,-10.070773027936527
2010-06-23T09:30:00-04:00,53.8,53.85001,53.14999,53.46001,17819536,24375471,45.54260885429125,48.25016433561264,NaN,NaN,-0.015890255084876525,86.07903823519631,0.28193284717034894,-0.14788368288709108,-0.42981653005744,454075482,485206048.6,19.276351137334785,21.796283366879912,NaN,NaN,-2.4413854937969446,-8.980860523059444
2010-06-24T09:30:00-04:00,53.14,53.47,52.10001,52.34,16955424,23730817.4,41.313785992661295,48.399972465213224,NaN,NaN,-47.07428456180819,48.508621170413775,0.11225732492109985,-0.2894948739060652,-0.40175219882716506,437120058,473330791.6,17.24614393061863,21.907279507938814,NaN,NaN,-4.512483647086665,-8.342520969349048
2010-06-25T09:30:00-04:00,52.42,52.96001,51.77,52.49001,20437680,23237367.8,42.08939471952709,48.68737711939131,NaN,NaN,-54.08952175752639,13.511327049753197,0.013259266125843161,-0.3851781161698611,-0.39843738229570425,457557738,462823430.8,15.67321553194705,21.950668284805108,NaN,NaN,-6.017881069928186,-8.010429555146068
2010-06-28T09:30:00-04:00,52.73,52.73,51.72,51.78,15954387,22718652.75,39.432984285290374,48.535848948346654,NaN,NaN,-65.3337358834647,-23.860726109372507,-0.09116457378391918,-0.5123930995256032,-0.421228525741684,441603351,452450329.4,14.28779441998961,21.535992621973293,NaN,NaN,-8.074345630550551,-8.019560423060994
2010-06-29T09:30:00-04:00,51.05,51.06,49.7,50.07001,22493552,22025809.55,33.886003768085004,48.09825095734394,NaN,NaN,-148.1079708580995,-62.924280663196726,-0.2571237229011545,-0.7426331793681271,-0.48550945646697263,419109799,441893285.6,13.025829008117782,21.064623591638934,NaN,NaN,-11.67766782983172,-8.542147195456812
2010-06-30T09:30:00-04:00,49.99001,50.75,49.57001,49.67999,16694016,21477985.55,32.75427343614621,46.892861986968235,NaN,NaN,-145.31581191799782,-91.98426499577931,-0.36812872017670095,-0.9456703566878488,-0.5775416365111479,402415783,431561345.8,11.916512072103558,20.56436657800174,NaN,NaN,-15.00060841323456,-9.464784512282204
2010-07-01T09:30:00-04:00,49.85001,50.13,48.56,49.5,25802512,21083602.35,32.21947849558751,45.57153587375769,NaN,NaN,-146.31196994688747,-111.83180207279516,-0.4246277905827768,-1.1083263747396188,-0.683698584156842,376613271,419459988.4,10.760602733054611,19.784814833728994,NaN,NaN,-17.895525429720614,-10.669176071916262
2010-07-02T09:30:00-04:00,49.81,50.03,48.96001,49.38,11419582,20161587.05,31.846147732831568,44.293686736788985,NaN,NaN,-128.6593199311414,-126.74576170751816,-0.43920559307084206,-1.2327055754953946,-0.7934999824245526,365193689,400987178.6,9.28068315429644,18.69929660739241,NaN,NaN,-20.407590940712666,-12.060378196030033
2010-07-06T09:30:00-04:00,50.24001,50.75999,49.31,49.86,17301200,19820071.05,35.08623526395483,42.86932676894764,NaN,NaN,-102.24990163734302,-134.12899485829382,-0.38745212780336014,-1.2778151421787527,-0.8903630143753926,382494889,389165486.2,8.477185549771718,17.520935998284415,NaN,NaN,-21.72352792456108,-13.440828157248754
2010-07-07T09:30:00-04:00,50.12,51.66,50,51.62,18908672,19010788.65,45.34613919978695,42.18906548379049,NaN,NaN,-60.79331501735849,-116.66606369014562,-0.21426681966538275,-1.158196538957121,-0.9439297192917382,401403561,385624238.6,8.246853567439231,16.131161628971007,NaN,NaN,-19.934611554158096,-14.368511499664374
2010-07-08T09:30:00-04:00,52.22,52.5,51.4101,52.35001,14872801,18220435.9,48.95027176517985,41.784277358334464,NaN,NaN,-26.207668604069113,-92.84443502735988,-0.03929224310147661,-0.9930450231685839,-0.9537527800671073,416276362,388396354.4,10.3014555843029,14.975539293145959,NaN,NaN,-17.323292095317225,-14.790623013329066
2010-07-09T09:30:00-04:00,52.3,52.7,52.08,52.62,9112840,17376411.5,50.25679526242558,41.44889375261513,NaN,NaN,-10.968731039063302,-65.77578724579504,0.0983635090732845,-0.8307983937255017,-0.9291619027987862,425389202,398151540.6,17.318049398336356,14.412423367360853,NaN,NaN,-14.78608073749022,-14.789974116780659
2010-07-12T09:30:00-04:00,52.42,52.87,51.99001,52.48,8207336,17028626.15,49.548652728633144,41.10407576369922,NaN,NaN,-9.255720752940253,-41.89506741015482,0.1790236087896777,-0.705382391811689,-0.8844060006013668,417181866,408549176,24.13033448844068,14.400254474804642,NaN,NaN,-12.879208890988188,-14.517007655953163
2010-07-13T09:30:00-04:00,53.17999,53.50999,52.92,53.11,14165027,16546151.1,52.77349788601242,41.503304956458074,NaN,NaN,21.14424007874998,-17.216239066936225,0.26846317214523796,-0.5488270354198193,-0.8172902075650572,431346893,418319576.8,29.969264466386264,14.99359107443853,NaN,NaN,-10.308506609253488,-13.915793220710352
2010-07-14T09:30:00-04:00,52.87,53.34,52.5,53.05,11942043,16289677.25,52.42977419250817,41.995245337759286,NaN,NaN,18.57189440828055,-1.3431971818084079,0.3140708936123635,-0.42470159054960277,-0.7387724841619663,419404850,421919834.6,32.044630848032114,15.905611053774056,NaN,NaN,-8.264244800125391,-13.108429160626786
2010-07-15T09:30:00-04:00,52.98,53.2,52.09,52.99001,14920695,16310899.3,52.064643130694876,42.76316370476167,NaN,NaN,17.276430058975645,7.353622550800543,0.3290996407052914,-0.32739793328035205,-0.6564975739856435,404484155,419561393.2,31.38840769709043,16.915772751379183,NaN,NaN,-6.637536361827211,-12.184015903655418
2010-07-16T09:30:00-04:00,52.53,52.73,51.35001,51.73,18130752,16346788.9,44.97926601447337,42.96958308297213,NaN,NaN,-13.276434212514568,6.892081916110291,0.24684168973155685,-0.34794546182119745,-0.5947871515527543,386353403,411754233.4,29.252823364712896,17.885744739433886,NaN,NaN,-7.074431701090578,-11.454075303289011
2010-07-19T09:30:00-04:00,51.94,52.36,51.50999,52.06,12541246,16293941.25,47.013089705875004,43.51101918444245,NaN,NaN,-3.2537403106434644,8.092478004569648,0.2088265403859365,-0.33375397607033364,-0.5425805164562701,398894649,408096790,28.282029029614847,18.885332925835687,NaN,NaN,-6.885853991772405,-10.801472258786639
2010-07-20T09:30:00-04:00,51.32001,53.321,51.31,53.25,16590367,16292175.4,53.66456351990736,44.92377345242977,NaN,NaN,44.96534328708403,12.856698646236442,0.25494197187745254,-0.22390305160945445,-0.478845023486907,415485016,404924414.6,27.431668086714907,19.914321431449768,NaN,NaN,-4.747364652220197,-9.936599743562862
2010-07-21T09:30:00-04:00,53.59,53.59,51.99001,52.38,22513776,16339172.2,48.83773593167991,46.07259220211075,NaN,NaN,54.11919558740366,19.966158882061062,0.21932592264880857,-0.20468762017589626,-0.4240135428247048,392971240,399637692.6,26.027215652107273,20.92222883002146,NaN,NaN,-4.333233670324486,-9.13611887595738
2010-07-22T09:30:00-04:00,53.11,54.02,52.955,53.53999,22992128,16597801.8,54.68957049746474,47.67759877367341,NaN,NaN,107.71526788129128,38.05392644652419,0.26339854809040314,-0.09476535771170091,-0.35816390580210405,415963368,401933535.2,27.756995903876046,22.13625691365156,NaN,NaN,-2.117141048722639,-8.133407757780988
2010-07-23T09:30:00-04:00,53.42,53.78999,52.8,53.78,18025728,16651317,55.815653734846165,49.38970634524588,NaN,NaN,99.76403721689707,60.66202073240652,0.2957968182067953,0.01158211695639011,-0.2842147012504052,433989096,411460673.8,34.59222964234853,23.944224519941,NaN,NaN,0.020137669803491312,-6.9686155538403485
2010-07-26T09:30:00-04:00,53.81,54.34,53.64999,54.25,11938602,16226363.1,58.016088111001515,51.027552977177784,NaN,NaN,127.11128604317851,86.73502600317092,0.3331827014392839,0.13226367554869967,-0.20091902589058425,445927698,420867283.6,40.57099315097692,26.236639348598512,NaN,NaN,2.4709082968362406,-5.620112146600835
2010-07-27T09:30:00-04:00,54.49001,54.58,53.52,53.99001,16409430,16249115.25,56.34447864605309,51.813148651911085,NaN,NaN,111.43668469148652,100.02929428405142,0.3243892469877548,0.20456753284410922,-0.11982171414364555,429518268,423673934,42.266690562466266,28.66662770538616,NaN,NaN,4.022145706122671,-4.242646739068906
2010-07-28T09:30:00-04:00,53.86,54.25999,53.7,53.87,10778070,15663341.15,55.54885629285962,52.28447611817392,NaN,NaN,99.31257299795222,109.06796976616113,0.295306293601287,0.24931115285796324,-0.04599514074332378,418740198,428827725.6,45.3503102002372,31.17011732081004,NaN,NaN,5.085568865042832,-2.9100445099100867
2010-07-29T09:30:00-04:00,54.23,54.72,53.42,53.95,14557203,15556500.5,55.994939087217084,52.69434353423046,NaN,NaN,99.4987796340442,107.42467211671172,0.26712195999186406,0.2879073092465063,0.020785349254642246,433297401,432294532.2,47.386051961460176,33.3178317896046,NaN,NaN,6.091939237431687,-1.624046831718405
2010-07-30T09:30:00-04:00,53.39999,54.1225,53.23,53.84,11816086,14857179.2,55.17503596649476,53.09622805122057,NaN,NaN,77.7929353126492,103.03045173586213,0.22824415208434268,0.3060905393600706,0.07784638727572792,421481315,429792976,46.05296669094558,34.883734089783516,NaN,NaN,6.732563534796661,-0.43024535078768134
2010-08-02T09:30:00-04:00,54.85001,55.89,54.77,55.72,27578944,15665147.3,64.69093504084658,53.94747356228015,NaN,NaN,184.4943604074055,114.50706660870753,0.31117885699235265,0.46681995851616875,0.1556411015238161,449060259,430419488.2,46.459219199239776,36.06158799927305,NaN,NaN,10.280405920171903,1.0998476879208305
2010-08-03T09:30:00-04:00,55.49001,56.06,55.24001,55.7,14260188,15513096.7,64.53398003996922,54.812059694241654,NaN,NaN,181.15053670142908,128.44983701069606,0.3441529099445717,0.5858322389545307,0.24167932900995903,434800071,431475848.8,47.1814603408738,37.1427901059046,NaN,NaN,13.092610249973946,2.813099482499847
2010-08-04T09:30:00-04:00,55.85001,56.27,55.58,56.13,13107605,15223043.35,66.42036713240779,55.83746855150686,NaN,NaN,180.41521008599167,144.67036442830394,0.3720175944279811,0.7067013220449354,0.3346837276169543,447907676,437309344.4,51.10404077184167,38.551049611243975,NaN,NaN,16.039476026467117,4.702581845923742
2010-08-05T09:30:00-04:00,55.75999,56.31,55.5,56.31,8908660,14924836.3,67.20667487069898,57.42514061266583,NaN,NaN,157.1803523327824,156.20667896805156,0.37841679363168124,0.8077047196565559,0.42928792602487464,456816336,442013131.4,54.0662826522273,40.32343956035215,NaN,NaN,18.72140673135246,6.705271115270701
2010-08-06T09:30:00-04:00,55.61,55.92,54.83,55.64,18118048,15375096.7,61.43964398189995,58.45560877523904,NaN,NaN,105.46459717785602,161.74101134109293,0.3159188832576393,0.8241865300969238,0.5082676468392845,438698288,445456526,56.160109839542365,42.31473104677554,NaN,NaN,19.45847632418513,8.527157573687049
2010-08-09T09:30:00-04:00,55.89999,56.07001,55.53,55.87,6714227,15300441.25,62.625290978996524,59.095660736602554,NaN,NaN,113.67416395707421,147.57697205102667,0.27022969749092585,0.8460547687029418,0.575825071212016,445412515,444726977.2,55.58201938405303,44.32547042515684,NaN,NaN,20.40618719825285,10.224161805767878
2010-08-10T09:30:00-04:00,55.22,55.67999,54.85001,55.41,12260473,15205213.55,58.73547097619344,59.80264181121066,NaN,NaN,73.46454525359569,126.03977376146,0.19282090110805816,0.8168511975970887,0.6240302964890305,433152042,444397371.4,55.3050334653224,46.41674312610077,NaN,NaN,20.13252552394325,11.639642336935788
2010-08-11T09:30:00-04:00,54.39,54.47,53.58,53.75999,18829616,15549592.2,47.36980742806117,59.279801591967555,NaN,NaN,-11.282043605228388,87.70032302321599,0.023205628363372144,0.6530373319432456,0.6298317035798735,414322426,437680321.4,49.85272190888308,47.99500926931556,NaN,NaN,16.179296401454366,12.288164346152728
2010-08-12T09:30:00-04:00,52.97,53.86,52.89999,53.44,15263855,15566750.2,45.529779557524265,58.54509629358741,NaN,NaN,-46.99303576141595,46.86564540437634,-0.11048548564566452,0.4917248465227928,0.6022103321684573,399058571,426128768.4,42.155758976886744,48.53526136463972,NaN,NaN,12.372842574033633,12.30026123585
2010-08-13T09:30:00-04:00,53.32001,53.84,53.19,53.35001,9109434,15115684.3,45.000382508451445,57.615403036262414,NaN,NaN,-50.521651933319575,15.668395582141216,-0.19972184236659962,0.35255802921020774,0.5522798715768074,389949137,416378938.2,36.96781096921192,48.27789120879936,NaN,NaN,9.142202880883012,11.849110042283288
2010-08-16T09:30:00-04:00,53.06,53.49001,52.75,53.34,10285656,15002904.8,44.93779002427088,56.80063956327797,NaN,NaN,-75.17741019240086,-22.101919247753806,-0.25085755794524955,0.23870792414524544,0.489565482090495,379663481,403229131.4,31.361879467255434,47.49897613057002,NaN,NaN,6.4941393932451765,11.084114235277843
2010-08-17T09:30:00-04:00,53.88,54.50999,53.62,54.23,18017328,15074252.85,51.40922275876742,56.50495145369996,NaN,NaN,-17.740614161082735,-40.34295113068948,-0.21742362034923746,0.21778595665394818,0.43520957700318563,397680809,396134884.8,28.822501675371583,46.31841837879391,NaN,NaN,5.966930670968028,10.353088011805012
2010-08-18T09:30:00-04:00,54.08,54.16,53.22,53.71001,18694336,14883280.85,47.86930180204103,55.92454879047309,NaN,NaN,-54.332127274284474,-48.952967864500714,-0.222222440180747,0.15743152677725192,0.3796539669579989,378986473,389067694.2,26.518907014823213,44.8279080254627,NaN,NaN,4.459563803010185,9.51115598197718
2010-08-19T09:30:00-04:00,53.45,53.55,52.53999,52.84,16499090,14558628.95,42.58569812111779,55.02531037294617,NaN,NaN,-104.45333907094654,-60.44502852640684,-0.2725642184083054,0.03894869394761713,0.31151291235592254,362487383,381753456.6,24.349819477129188,43.27768322447581,NaN,NaN,1.4712865162958177,8.362603201165555
2010-08-20T09:30:00-04:00,52.55,52.59,51.77,52.19,12424773,14278581.2,39.11225793330377,53.19826200812168,NaN,NaN,-150.90084422231035,-80.520866984205,-0.33415068823990146,-0.10617544794395428,0.22797524029594718,350062610,373776151.2,22.215545010129688,41.545992210967945,NaN,NaN,-2.1824358702996536,6.8561690480990976
2010-08-23T09:30:00-04:00,52.28999,52.72,52.17,52.21001,8176695,14090485.85,39.27645733477564,51.39415324346499,NaN,NaN,-124.10689947087477,-90.30676483989978,-0.356036578462931,-0.21707048278271657,0.13896609568021442,358239305,369491316,21.14354470482317,39.68614109410719,NaN,NaN,-5.053666054749125,5.154764033406495
2010-08-24T09:30:00-04:00,51.5,52.09,51.22,51.39999,14743766,14007202.65,35.14469939480426,49.16017697649331,NaN,NaN,-155.3936129982805,-117.83736460733932,-0.404050716102606,-0.36609729944804315,0.037953416654562894,343495539,358654262,18.68742666002339,37.370668657548734,NaN,NaN,-8.87766790587065,3.1501308992240453
2010-08-25T09:30:00-04:00,51.11,51.395,50.42,51.24001,19339376,14435267.95,34.37555667159039,46.815097105128416,NaN,NaN,-161.92851176155574,-139.35664150479357,-0.42351960509900244,-0.4914460897191901,-0.06792648462018772,324156163,347688200,16.587618501021595,34.69362121817691,NaN,NaN,-12.231268162147263,0.9527881761710013
2010-08-26T09:30:00-04:00,51.53,51.7,50.495,50.78,10982633,14256539.45,32.193803315377764,44.72610848609112,NaN,NaN,-140.35908665577549,-146.53779102175938,-0.4422582207531318,-0.6207492605616025,-0.1784910398084707,313173530,337825429.4,14.95951993845199,31.750721939527587,NaN,NaN,-15.752415636320135,-1.4336695113277322
2010-08-27T09:30:00-04:00,51.08,52.2,50.33,52.10001,19709008,14651185.55,43.312156825022164,43.34659890366438,NaN,NaN,-100.21373602771462,-136.4003693828402,-0.34495209213393974,-0.6096811549758954,-0.26472906284195563,332882538,334389415,14.428207762621952,28.811163966568223,NaN,NaN,-15.476240582254485,-3.439751092888697
2010-08-30T09:30:00-04:00,52,52.24001,51.33,51.34,9156594,13730068.05,39.314958609889025,41.95941944892836,NaN,NaN,-87.31932957456429,-129.04285540357813,-0.311968115516904,-0.6546892072380857,-0.34272109172118165,323725944,327486742.8,13.398673347244753,25.817852529562682,NaN,NaN,-16.53706131460788,-5.3107954102771515
2010-08-31T09:30:00-04:00,51.11,51.60001,50.81,51.2,17578736,13895995.45,38.608123713445586,41.333584897884386,NaN,NaN,-97.70871640038386,-117.5058760839988,-0.2807504640218434,-0.6936591717484859,-0.4129087077266425,306147208,320017076.6,12.370023350078739,23.14051691821951,NaN,NaN,-17.599298329887834,-7.066295827364391
2010-09-01T09:30:00-04:00,52.05,53.24001,51.97,53.11,19132864,14197258.4,51.436230435895425,41.75547424633946,NaN,NaN,-18.44248529524444,-88.80867079073656,-0.12081029384622821,-0.5639215750344277,-0.44311128118819954,325280072,320241858.4,12.587505679551228,21.028498825552692,NaN,NaN,-14.07662500670683,-8.067771424413312
2010-09-02T09:30:00-04:00,53.17999,53.64999,52.88,53.55,9848617,14244256.25,53.82964989716786,42.386136202676354,NaN,NaN,20.337325393459047,-56.66938838088966,0.017889714544678026,-0.42074913800735203,-0.43863885255203006,335128689,324632890.2,16.92493196295237,19.596864610819864,NaN,NaN,-10.459230292180576,-8.409408405522921
2010-09-03T09:30:00-04:00,54.03,54.44,53.75,54.2,13253879,14001047.8,57.18650412860677,43.26104435298606,NaN,NaN,71.60870243041185,-22.30490068926435,0.14936685251204135,-0.2519302869119784,-0.40129713942401973,348382568,327732896.2,19.94507347337894,18.78137846840011,NaN,NaN,-6.350275939374023,-8.115246624644508
2010-09-07T09:30:00-04:00,53.78999,53.85001,53.22,53.39,11406914,14235682.15,52.10273113717794,43.31058066572967,NaN,NaN,44.24469273131548,4.007903771911612,0.1759103599557842,-0.18140918947928952,-0.3573195494350737,336975654,330382838.2,22.537500906266033,18.332449842035427,NaN,NaN,-4.59524693086876,-7.612389525533686
2010-09-08T09:30:00-04:00,53.45,54.12,53.42,53.85001,9330344,14089175.7,54.57261900919274,43.789389037669075,NaN,NaN,74.59700381791154,38.4690478155707,0.21594018210002863,-0.08739432181003792,-0.30333450391006656,346305998,338414596.2,29.942609493229924,18.577000019064478,NaN,NaN,-2.366933258229537,-6.863038630204522
2010-09-09T09:30:00-04:00,54.50999,54.61,53.75999,53.96001,7836609,13539525.35,55.16795905059176,44.688121961202924,NaN,NaN,95.44708077551034,61.246961029721646,0.23949554373423432,-0.0039650742422736585,-0.24346061797650798,354142607,344187103.2,34.769103917400074,19.321234621940967,NaN,NaN,-0.4146524799498859,-5.941840608739574
2010-09-10T09:30:00-04:00,54.28,54.63,54.17999,54.52,7595273,13156096.25,58.17316775738163,46.049615520065636,NaN,NaN,110.0117544773909,79.18184684650802,0.2796616734560061,0.10611647384349965,-0.17354519961250645,361737880,349508941.4,38.945281582901586,20.51621580571039,NaN,NaN,2.160237478045294,-4.784400882056022
2010-09-13T09:30:00-04:00,55,55.07001,54.57001,54.96001,9131543,13157201.7,60.4183274082584,47.55974909674297,NaN,NaN,125.68366202935573,89.99683876629679,0.3198392870912141,0.22625390925151123,-0.0935853778397029,370869423,354006312.4,42.306774305761415,22.027875062920266,NaN,NaN,4.998401637746595,-3.3868576649413624
2010-09-14T09:30:00-04:00,54.85001,55.23,54.53999,54.77,13977855,13341811.65,58.94685709966984,49.25990321851908,NaN,NaN,111.37273881478417,103.42244798299052,0.3169825387332489,0.30264279557685825,-0.014339743156390666,356891568,357989495.2,45.18527531507199,23.920578538280882,NaN,NaN,6.908643515353289,-1.9160717820421267
2010-09-15T09:30:00-04:00,54.39999,54.67,54.0898,54.66,14112938,13146592.15,58.0652001344698,50.95202060872475,NaN,NaN,87.11300894869721,105.92564900914768,0.29168602541888006,0.3502677886172094,0.05858176319832935,342778630,357284021.6,44.759323677741286,25.932843193760856,NaN,NaN,8.242288898347317,-0.46487739912934933
2010-09-16T09:30:00-04:00,54.39,54.64,54.08,54.41,16758793,13049815,56.01463984302727,52.65350893212828,NaN,NaN,77.25770781643384,102.28777441733237,0.24405150280034912,0.36364614169876575,0.11959463889841662,326019837,351659467.6,41.40783404035086,27.822008486753635,NaN,NaN,8.817844234712753,0.8612256914195224
2010-09-17T09:30:00-04:00,54.32001,54.41,53.71001,53.89,14352832,12942502.1,51.90841783799367,53.26752757591197,NaN,NaN,51.416510512353895,90.56872562432497,0.1671260171249141,0.32850216030455925,0.16137614317964516,311667005,341645292.6,36.209243774887575,29.377796773344038,NaN,NaN,8.18206708872412,1.9070601767487505
2010-09-20T09:30:00-04:00,54.06,55.00999,53.82001,54.8,19424912,13292509.05,57.74598148156074,54.584029209602804,NaN,NaN,73.98012660996727,80.22801854044728,0.16675242959822154,0.3698166801774221,0.20306425057920055,331091917,333689791.4,32.69726739356686,30.75626777665276,NaN,NaN,9.315823658400442,2.965454959841849
2010-09-21T09:30:00-04:00,54.87,55.17,54.37,54.84,16772371,13722292.85,57.987386085649945,55.96826223618883,NaN,NaN,80.69116805905055,74.09170438930055,0.15847824281094833,0.40116205409288597,0.24268381128193764,347864288,331884335.4,31.940133129732303,32.15413276091373,NaN,NaN,10.306884066185058,4.014230546462307
2010-09-22T09:30:00-04:00,54.73,55.37,54.39999,54.44,16159000,13793054.55,54.62641399911475,56.1961324907045,NaN,NaN,73.1220770809531,71.29351801575174,0.11724488395903271,0.3892399162307285,0.2719950322716958,331705288,329669667,30.9921097108854,33.468747334580456,NaN,NaN,10.217127487204456,4.900358680854042
2010-09-23T09:30:00-04:00,53.96001,54.56,53.82001,54.10001,12359934,13444082.45,51.8742516254276,56.0564611855802,NaN,NaN,35.352351485695074,62.91244674960397,0.0610773485871286,0.34834171800560654,0.28726436941847794,319345354,328334770.4,30.406282855959162,34.43170096979522,NaN,NaN,9.366821146269317,5.538424747341939
2010-09-24T09:30:00-04:00,54.7,55.54269,54.465,55.27,24632464,14126574,59.446140670084304,56.21786379568573,NaN,NaN,95.07665901107939,71.64447644934907,0.09471794409150969,0.4056617995328651,0.3109438554413554,343977818,334796933,36.64916867437076,35.62485062700893,NaN,NaN,10.881436037962494,6.301712074573446
2010-09-27T09:30:00-04:00,55.41,55.595,55.06,55.06,10897676,13686007.4,57.69160894799958,56.617069353601565,NaN,NaN,106.01634118997285,78.0517193653502,0.09460142130594962,0.4291956320737924,0.3345942107678428,333080142,335194578,37.02353430440691,36.65956729830471,NaN,NaN,11.602125578251648,7.058914003670332
2010-09-28T09:30:00-04:00,55.11,55.64999,54.55,55.45,16579523,14057153.85,60.049838589392905,57.00829932361586,NaN,NaN,104.14851855240057,82.7431894640202,0.11140768159282038,0.4738538127588683,0.3624461311660479,349659665,335553653.4,37.38337322056196,37.19105042168557,NaN,NaN,12.906899497146934,7.894340502738418
2010-09-29T09:30:00-04:00,55.36,56.3,55.25,56.03999,21501360,14253285.05,63.375626254769436,57.59456126677141,NaN,NaN,174.1219744282179,102.94316893347316,0.15044877647051547,0.5505071017541923,0.4000583252836768,371161025,343444800.8,44.842282400266306,37.91056317046172,NaN,NaN,15.040755425726857,8.915256920308195
2010-09-30T09:30:00-04:00,56.48,56.75,55.5,56.06,23169744,14455129.05,63.48664972164589,57.974095692790286,NaN,NaN,183.75803836441895,132.62430630921793,0.1646619409865509,0.6058857515168654,0.4412238105303145,394330769,358441883.8,55.6539346113905,39.104038386782356,NaN,NaN,16.799652887140155,10.041599201284189
2010-10-01T09:30:00-04:00,56.60001,56.95,56.25999,56.81,20009808,14963188.6,67.46737774456605,58.47759928824083,NaN,NaN,215.21876171183052,156.65272684936815,0.2087793207178289,0.7021979614276006,0.4934186407097717,414340577,372514435.6,62.98566484850798,40.58110199697854,NaN,NaN,19.570809560699395,11.402914966914933
2010-10-04T09:30:00-04:00,56.53999,56.8902,55.67999,56.10001,14752645,15038126.9,60.71883637395794,58.60416923640427,NaN,NaN,141.51891281321713,163.753241174017,0.17567837595828872,0.7130166106576326,0.5373382346993438,399587932,385815993.6,68.31758884071769,42.23341010595323,NaN,NaN,19.94275915291411,12.622892707771959
2010-10-05T09:30:00-04:00,56.71001,57.63,56.60001,57.42,21615776,15548570,67.27310176362849,59.2618764956299,NaN,NaN,198.43396195296773,182.61032985413044,0.22506186223815006,0.8186655624970314,0.5936037002588813,421203708,400124802.2,72.84857083666417,44.23978490301915,NaN,NaN,22.481782963588955,14.031305601460101
2010-10-06T09:30:00-04:00,57.42,58.11,57.39999,57.92999,14105043,15787304.95,69.39766629759542,60.21780695667048,NaN,NaN,202.92357171847434,188.37064931218174,0.27135095874971327,0.9327923986960229,0.6614414399463097,435308751,412954347.4,76.14301491435593,46.72086925116237,NaN,NaN,25.26286625111624,15.635814265696691
2010-10-07T09:30:00-04:00,58.17,58.24001,57.21001,57.64,13562785,16073613.75,66.74436992158314,61.277517819784016,NaN,NaN,157.23914888073804,183.06687141544552,0.26160268235005824,0.9884447928838824,0.7268421105338242,421745966,418437386.8,77.40484137109217,49.663411936605556,NaN,NaN,26.664497965315526,17.211340508499383
2010-10-08T09:30:00-04:00,57.59,58.58,57.46001,58.36,15838750,16485787.6,69.82875302480772,62.14057293001594,NaN,NaN,154.7977766350161,170.98267440008266,0.2811012438404469,1.0782186653343828,0.7971174214939359,437584716,423086214.6,78.44577550066779,52.9311625156842,NaN,NaN,28.853559340062922,18.874514627294175
2010-10-11T09:30:00-04:00,58.39999,58.82001,58.3,58.52,8045977,16431509.3,70.483893413839,63.033180596315155,NaN,NaN,150.9925917656359,172.8774101905664,0.28153043156820057,1.1490304609541866,0.867500029385986,445630693,432294766.8,80.37446346477009,56.39075753961547,NaN,NaN,30.80999365292851,20.579583059527653
2010-10-12T09:30:00-04:00,58.27,58.69,57.63,58.42999,16665094,16565871.25,69.56870503623315,64.10048709896647,NaN,NaN,117.21647029255001,156.63391185848286,0.25338808759445386,1.1842351388790533,0.9308470512845994,428965599,433847145,80.68818442672585,59.940477162175505,NaN,NaN,32.12878786955793,22.22946946096055
2010-10-13T09:30:00-04:00,58.78,59.4402,58.66,59.14,14689742,16594711.45,72.59184841602189,65.58031544115178,NaN,NaN,138.29777695366673,143.70875290552132,0.25929081394752573,1.2549605687190066,0.9956697547714809,443655341,435516463,81.03918293595544,63.55711288217524,NaN,NaN,34.202200344314356,23.93985958715395
2010-10-14T09:30:00-04:00,58.95,59.46001,58.57001,59.05,11502750,16331909.3,71.62058086914566,66.4499183125133,NaN,NaN,118.58045750056587,135.9770146294869,0.23457715470471174,1.2888911981523705,1.0543140434476588,432152591,437597788,81.49088627237636,66.76009271060421,NaN,NaN,35.61273479613409,25.607413188436826
2010-10-15T09:30:00-04:00,59.38,59.47,58.56,59.21001,15085906,16368563,72.32943734636709,67.49547748382527,NaN,NaN,108.55224757560514,126.7279088176047,0.20738967430864563,1.3135511363334658,1.1061614620248201,447238497,439528544.2,81.92115439036317,69.9670655738868,NaN,NaN,36.98657360452693,27.233007533592556
2010-10-18T09:30:00-04:00,59.06,59.81,58.88,59.37,10950066,15944820.7,73.05416828186166,68.42435817614447,NaN,NaN,108.03051323451571,118.13549311138067,0.1796029040155036,1.3306650920441996,1.151062188028696,458188563,442040118.2,82.49133163834108,73.18906260372817,NaN,NaN,38.341076783183574,28.819874569248416
2010-10-19T09:30:00-04:00,58.75,58.86,57.7,58.19,19289488,16070676.55,60.47364254854839,68.21707362570011,NaN,NaN,53.50521567226101,105.39324218732285,0.06697275615205767,1.234778133218768,1.1678053770667103,438899075,444026813.4,82.9494190071746,75.91100093279304,NaN,NaN,35.80904050375865,29.81832684560702
2010-10-20T09:30:00-04:00,58.39,59.31,58.17,58.94,12628590,15894156.05,64.6414888837935,68.29956213728208,NaN,NaN,73.03359796494016,92.34040638957758,0.030084128090035467,1.2054105371792545,1.175326409089219,451527665,445601278.2,83.32183629170137,77.88727962424382,NaN,NaN,34.87519630742158,30.540736768723388
2010-10-21T09:30:00-04:00,59.11,59.58099,58.27,58.91,13420895,15947204.1,64.34919971009353,68.07683513481975,NaN,NaN,73.56637986904121,83.33759086327265,-0.007243765470039021,1.1662717022516702,1.1735154677217092,438106770,446792114,83.61336678671522,79.36068690554433,NaN,NaN,34.04349075063114,31.04113019471021
2010-10-22T09:30:00-04:00,59.21001,59.49001,59.02,59.3,6558707,15043516.25,66.47166869854183,68.48775172943289,NaN,NaN,87.48851968620829,79.12484528539328,-0.016070263462281353,1.1534276383938575,1.1694979018561389,444665477,446277510,82.93868519226619,80.40505093065495,NaN,NaN,33.953856362663764,31.45723393298929
2010-10-25T09:30:00-04:00,59.75999,60.28999,59.36,59.46001,11353949,15066329.9,67.33102791965193,68.491889312006,NaN,NaN,106.69825026783951,78.85839269205803,-0.021210736386858997,1.1429844813725651,1.1641952177594241,456019426,445843682.6,82.33551639209745,81.08268989890018,NaN,NaN,34.122423929670006,31.837975361086535
2010-10-26T09:30:00-04:00,59.28999,59.64999,59.11,59.58,10693539,14772030.7,67.99352394072281,68.39159342937224,NaN,NaN,87.91429064143915,85.74020768589367,-0.026277047471526815,1.1313489084200157,1.1576259558915425,466712965,451406460.6,83.9475783018717,81.64015871229415,NaN,NaN,34.44421094622032,32.21029473039136
2010-10-27T09:30:00-04:00,59.03999,59.39,58.44,59.33,12906059,14342265.65,65.03435160735143,68.26944926406998,NaN,NaN,55.687932481179175,82.27107458914148,-0.05458329768236703,1.0893968337885838,1.1439801314709508,453806906,451862308.8,84.07582638232834,82.11665764166818,NaN,NaN,33.91090892852891,32.453239615839585
2010-10-28T09:30:00-04:00,59.72,59.87,58.96989,59.2,11592578,13763407.35,63.48704685036795,67.81647025161,NaN,NaN,73.78092474918155,82.31398356516954,-0.08818950506053236,1.0337432501452852,1.1219327552058176,442214328,452683820.4,84.31897009054597,82.53617154094518,NaN,NaN,33.04506707786158,32.53778639612844
2010-10-29T09:30:00-04:00,58.89,59.3,58.75999,59.24001,9361398,13230986.85,63.77272602601989,67.33710115248006,NaN,NaN,47.48769906021611,74.3138194399711,-0.11230528724498079,0.9815511461495916,1.0938564333945724,451575726,454065870.2,84.74107910707858,82.84807265825293,NaN,NaN,32.38816258422423,32.51641156585641
2010-11-01T09:30:00-04:00,59.83,60.17,59.07001,59.31,12024199,13094564.55,64.29894296562087,66.96068957600775,NaN,NaN,88.31579906494032,70.63732919939126,-0.12703924559863955,0.9350573763962728,1.0620966219949124,463599925,455581970,85.21137021183243,83.17115735718912,NaN,NaN,31.95657775880896,32.43643530770677
2010-11-02T09:30:00-04:00,59.75,60.24001,59.53999,59.96249,10227590,12525155.25,68.84266744246676,66.69289093503953,NaN,NaN,135.58029520107368,80.17053011131817,-0.09765714277576865,0.9400251935252015,1.0376823363009702,473827515,457004880,85.65813895139668,83.5010827868635,NaN,NaN,32.77473762393962,32.48476421002575
2010-11-03T09:30:00-04:00,60.16,60.21001,59.19,60.09,22730448,12956425.5,69.65543598234669,66.55252344312531,NaN,NaN,120.29422306102751,93.09178822728784,-0.07544462262778406,0.9433765580162401,1.0188211806440242,496557963,465555091.4,88.00342680035635,83.96626425314777,NaN,NaN,33.68703171908961,32.65651671132059
2010-11-04T09:30:00-04:00,60.97,62.02,60.97,62,19328464,13244709.45,78.64268933862044,67.00347001400054,NaN,NaN,319.28160754404064,142.19192478625965,0.0550360261210705,1.0876162132953624,1.032580187174292,515886427,480289511.2,90.79651091369904,84.60021829052891,NaN,NaN,37.793832863944246,33.39041901883826
2010-11-05T09:30:00-04:00,61.94,62.31,61.7475,62.31,14689715,13187257.7,79.69389046444071,67.47773588418475,NaN,NaN,286.6783999046936,190.03006495515515,0.14430332881383778,1.212959348191589,1.0686560193777512,530576142,496089594.4,92.74668847397038,85.33274377878813,NaN,NaN,41.44362898995001,34.540877586139935
2010-11-08T09:30:00-05:00,61.95,62.58,61.91,62.5,11990320,13384474.85,80.33282708313938,68.89624906522697,NaN,NaN,228.83002001690897,218.13290914554887,0.19507234898542025,1.3124964556095264,1.1174241066241062,542566462,511882901.8,94.0938622572929,86.12877543951087,NaN,NaN,44.57278551008342,35.97400728956043
2010-11-09T09:30:00-05:00,62.78999,63.25999,62.00999,62.38,20069872,13554713.75,78.64961065921767,69.89682919204299,NaN,NaN,191.6880243298909,229.35445497131232,0.19882191045327913,1.3659514946907052,1.167129584237426,522496590,521616716.8,94.7420468275889,86.94450476350285,NaN,NaN,46.59148749207681,37.4907901756342
2010-11-10T09:30:00-05:00,62.58,63.21001,61.92999,63.1825,17787632,13709608.25,81.44899668630629,71.11824326177248,NaN,NaN,161.70064949013408,237.63574025713365,0.23132266743626495,1.4562829185327573,1.2249602510964923,540284222,530361968.6,95.24677485043307,87.77546248233982,NaN,NaN,49.30676191980415,39.17878613908705
2010-11-11T09:30:00-05:00,62.89,63.89,62.85001,63.88,18048512,14036896.35,83.47683816523829,72.33289822367935,NaN,NaN,162.22255539791817,206.22392982790916,0.27291228752720675,1.5661006105055009,1.2931883229782941,558332734,538851230,95.68026576848852,88.68557538064142,NaN,NaN,52.32840006801182,41.05730241464773
2010-11-12T09:30:00-05:00,63.17999,63.48,62.3799,62.94,17874240,14176313.05,72.04675593677383,72.66973593918807,NaN,NaN,111.91095137173954,171.27044012131833,0.2128949875157513,1.5593070573729833,1.346412069857232,540458494,540827700.4,95.77683412668989,89.64566950454086,NaN,NaN,51.01876401387745,42.48036835739483
2010-11-15T09:30:00-05:00,63.33,63.3602,62.61,62.62,10751230,14166371.25,68.60299309368155,72.71326945011369,NaN,NaN,94.42769447041651,144.38997501201985,0.13142036530391432,1.510687526487125,1.3792671611832106,529707264,538255860.8,92.86758950106677,90.28281316162624,NaN,NaN,48.81794081346047,43.38573585111849
2010-11-16T09:30:00-05:00,61.99001,62.00999,60.96001,61.45,23738480,14388820.85,57.736491216623115,72.19199370791881,NaN,NaN,30.913285762330656,112.23502729850782,-0.013776804280083876,1.3620461558331058,1.3758229601131897,505968784,534950299.6,89.12058844827098,90.64315330919358,NaN,NaN,42.943167462116826,43.32251179554682
2010-11-17T09:30:00-05:00,61.3,62.10001,61.12,61.7,16817792,14598280.95,59.222779800562364,71.88740320436126,NaN,NaN,33.14187874507616,86.52327314949623,-0.10065007374471935,1.2500103679322905,1.3506604416770098,522786576,531450770.4,85.20123323308177,90.70617210508898,NaN,NaN,38.847731256579024,42.68325743283714
2010-11-18T09:30:00-05:00,62.3,63.25999,62.3,63.06,16052594,14729865.9,66.18876050363227,72.05997709561929,NaN,NaN,80.58223080360837,70.19520823063426,-0.07534600348456211,1.256477937321307,1.3318239408058692,538839170,527552057.6,80.931035522561,90.4340261347663,NaN,NaN,37.6805210204929,41.968580802502245
2010-11-19T09:30:00-05:00,62.88,63.61,62.41,63.59,11360789,14969970,68.45067589044007,72.35652944739209,NaN,NaN,88.15476140736088,65.44397023775852,-0.03385476328293224,1.289505486702204,1.3233602499851362,550199959,529500350.6,81.4318629952737,90.16406133358352,NaN,NaN,37.54974032327959,41.33731787689901
2010-11-22T09:30:00-05:00,63.24001,63.42999,62.14999,63.392,18146912,15309618.15,66.6566337324746,72.20038418239265,NaN,NaN,72.97116753205893,61.152664850087,-0.030774855337597717,1.2848916808131392,1.315666536150737,532053047,529969507.2,81.55747457243874,89.87115673508653,NaN,NaN,36.851988098045766,40.69655647991997
2010-11-23T09:30:00-05:00,62.48,62.50999,61.58,62.15199,22534960,15901689.2,56.64389873921153,71.27098866502585,NaN,NaN,25.369106753800526,60.04382904838097,-0.11836038191735865,1.1677160587540385,1.2860764406713971,509518087,530679367.8,81.75855074091459,89.42509415941211,NaN,NaN,32.69471430747043,39.553436169570034
2010-11-24T09:30:00-05:00,62.58,63.34,62.53999,63.27251,22650240,16388898.25,62.1733977624711,70.0946106953009,NaN,NaN,71.03689614194704,67.62283252775515,-0.1072685911208251,1.1519907017703659,1.259259292891191,532168327,532555718,82.30765047108055,88.81874698493937,NaN,NaN,31.160459993325883,38.35443957296373
2010-11-26T09:30:00-05:00,62.64999,63.03999,62.35001,62.52,6589391,16138738.9,56.92290608838159,68.46811181129668,NaN,NaN,43.148206798426614,60.136027726718794,-0.15419713153504278,1.0665128784723876,1.2207100100074304,525578936,529903671.2,78.70163476894545,87.81552886315187,NaN,NaN,28.043743828208793,36.881483037998734
2010-11-29T09:30:00-05:00,62.2,63.07001,61.63,62.92999,14734371,16407387.55,58.95659458161621,66.94123806118789,NaN,NaN,31.683131141489408,48.841701673544506,-0.16049213923563488,1.0200948359628867,1.1805869751985216,540313307,527926340.8,76.02715753414728,86.52504995435575,NaN,NaN,26.280251445913173,35.36702138198651
2010-11-30T09:30:00-05:00,62.11,63.22,61.92,62.71001,19273392,16769847.2,57.39101005768613,65.42276658964991,NaN,NaN,30.837009606441725,40.41487008842107,-0.1808262607536668,0.9545541492564382,1.135380410010105,521039915,525723714.4,73.04921056793003,84.97556165009442,NaN,NaN,24.38641508699673,33.79836333984511
2010-12-01T09:30:00-05:00,63.74001,64.72501,63.74001,64.57001,19973712,17257153.3,65.68775429781864,64.2969635619008,NaN,NaN,192.43392815665132,73.82783436899123,-0.07574227456601479,1.0407025668025867,1.1164448413686014,541013627,532022822.4,75.95041713162526,83.59725038446528,NaN,NaN,25.597723555421993,32.62684337064181
2010-12-02T09:30:00-05:00,64.55,65.57001,64.53999,65.53,17677600,17004510.9,69.03867708241731,63.265666341699294,NaN,NaN,268.3114868770492,113.28275251601164,0.045178771932333106,1.1729183062840178,1.1277395343516847,558691227,537327402.4,78.08944826890672,82.34076342020944,NaN,NaN,27.80001639871461,31.937296660366496
2010-12-03T09:30:00-05:00,65.14,65.94,65.11,65.82001,10019355,16539055.45,69.99209200376926,63.11890463219897,NaN,NaN,246.51200027996066,153.95551121231844,0.12682776998405965,1.2862742468317592,1.1594464768476995,568710582,545953731.6,81.04237807713935,81.28830227381297,NaN,NaN,29.831754373325513,31.636504905074926
2010-12-06T09:30:00-05:00,65.77,66.2,65.72,66.03999,11992758,16404207.6,70.72840709202485,63.270719917794914,NaN,NaN,210.7398326123371,189.766851506488,0.17482341635944643,1.3779757472970076,1.2031523309375611,580703340,554031738.2,83.3106820705909,80.60566602877897,NaN,NaN,31.67168615724172,31.64153079824161
2010-12-07T09:30:00-05:00,66.89999,67,65.63,65.78999,22938480,16951615.6,68.6662912166244,64.05141991779502,NaN,NaN,173.1849033267306,218.23643025054577,0.16881829921578206,1.4141752049572887,1.2453569057415066,557764860,561376727.2,85.06097696499756,80.31569377997373,NaN,NaN,32.53190889356842,31.768727669002583
2010-12-08T09:30:00-05:00,65.86,66.16,65.0699,65.48,12760105,16586127.25,66.09312504000606,64.54215886346957,NaN,NaN,115.84567087296477,202.91877879380846,0.1250681551258901,1.4016920996488693,1.2766239445229792,545004755,562174952.8,85.24211759300965,80.31861409139715,NaN,NaN,32.48216710615722,31.870647588596103
2010-12-09T09:30:00-05:00,65.81,65.95,65.0368,65.63,10952352,16244363.25,66.74256829303123,64.58171656271234,NaN,NaN,97.85805254063528,168.82809192652567,0.08902404579094036,1.3879040017616546,1.2988799559707143,555957107,561628128.8,84.48635249510492,80.57256530372172,NaN,NaN,32.62557054458796,31.97849372516637
2010-12-10T09:30:00-05:00,65.78,65.97,65.49001,65.89999,8676078,15775741.55,67.93312790950243,64.54474884978823,NaN,NaN,95.62974809121675,138.65164148877687,0.06715399919450915,1.3828224549638506,1.3156684557693414,564633185,560812649.4,83.30023169489509,80.70602021083754,NaN,NaN,33.07760671013996,32.135509865876884
2010-12-13T09:30:00-05:00,66.31,66.97,66.22,66.46001,12889563,15526507.7,70.30750489785983,64.80552536160147,NaN,NaN,113.68483015070473,119.24064099645041,0.07367042399549706,1.4077564857637128,1.3340860617682158,577522748,560176531,82.3292607741383,80.76114779667321,NaN,NaN,34.14670353729253,32.422823247507694
2010-12-14T09:30:00-05:00,66.53999,66.72,65.92999,66.14999,11515484,15564720.4,67.33511655520525,65.56918377702958,NaN,NaN,90.25685143039269,102.65503061718282,0.0419455073488868,1.3865179459543242,1.3445724386054374,566007264,561825011.8,82.88598800592169,80.84167902988803,NaN,NaN,34.22881695926907,32.68082234918789
2010-12-15T09:30:00-05:00,65.87,66.38,65.60001,65.78999,11116086,14933600.7,63.953934143490514,65.69636494710241,NaN,NaN,69.35678130857298,93.35725270430444,-0.015370477839176777,1.3253593413064664,1.3407298191456432,554891178,563802296.4,83.55523346525425,80.93079210090043,NaN,NaN,33.36186370363719,32.778113971252075
2010-12-16T09:30:00-05:00,65.77,66.17999,65.25,66.16,11025715,14643996.85,65.85190322232589,66.33415045666985,NaN,NaN,60.74966584547619,85.93557536527263,-0.039099285162256914,1.291855712692822,1.330954997855079,565916893,565794253.6,84.224519406125,81.32528386069896,NaN,NaN,33.1364726596391,32.829308069593075
2010-12-17T09:30:00-05:00,65.85001,65.98,65.59,65.89,11325852,14407659.75,63.23536966734748,66.6397772485078,NaN,NaN,53.80477653826755,77.57058105468279,-0.0812872246415326,1.2293459670531632,1.3106331916946958,554591041,563785824.8,80.65998156618664,81.65619986298749,NaN,NaN,32.229235028089384,32.74358334937826
2010-12-20T09:30:00-05:00,66.14,66.53,65.77,66.32001,10234676,14351354.1,65.58098043718608,67.2247751327578,NaN,NaN,67.1113636998465,68.25588776451116,-0.08797515616707097,1.2006642464858572,1.2886394026529282,564825717,561246418.6,76.26506388568332,81.88590367139844,NaN,NaN,32.07928552237755,32.648683659806736
2010-12-21T09:30:00-05:00,66.69,67.075,66.4805,66.99001,8703348,13879175.9,68.90938415824971,67.45489155136002,NaN,NaN,93.87942999800104,68.98040347803283,-0.056545663718721384,1.2179573230045264,1.2745029867232478,573529065,562750778.8,77.06240622570297,81.96533146383256,NaN,NaN,32.899624754973296,32.684532387687675
2010-12-22T09:30:00-05:00,67.19,67.28999,66.99001,67.22,7855418,13145198.8,69.98246242848475,67.52230479036484,NaN,NaN,110.9921731880319,77.3074818539246,-0.030824025560467927,1.235972954772663,1.266796980333131,581384483,568049439.8,79.65488861231556,82.07714863121892,NaN,NaN,33.892274222582444,32.85706693552979
2010-12-23T09:30:00-05:00,67.14999,67.4899,67.11501,67.41,4531793,12239276.45,70.87673811334619,67.58549379819176,NaN,NaN,120.90203479308975,89.33795564344732,-0.012510144853744576,1.2511592992659502,1.2636694441196947,585916276,572049316.4,81.36694175241357,82.10033175088135,NaN,NaN,34.976386014234976,33.15982680391624
2010-12-27T09:30:00-05:00,67.09,67.291,66.91,67.17,4152645,12117439.15,68.11622841703803,67.39890960712128,NaN,NaN,108.35603561614185,100.24820745902218,-0.027212429185359266,1.2296539076379958,1.256866336823355,581763631,577483834.4,83.4096730177393,82.10740253282052,NaN,NaN,35.15972894797986,33.44552711021104
2010-12-28T09:30:00-05:00,67.25999,67.52499,67.11951,67.42,5154656,11638453.4,69.45096775958562,67.45495793161851,NaN,NaN,126.30105784738853,112.08614628853061,-0.03050521019327279,1.2187348240817641,1.249240034275037,586918287,581902348.4,84.86270525297262,82.0932402676759,NaN,NaN,35.67595552858228,33.76415974140693
2010-12-29T09:30:00-05:00,67.64999,68.25999,67.53,68.09,5532641,10951415.85,72.74408380710128,67.93002641498245,NaN,NaN,170.52681814889345,127.41562391870907,0.00039882381281275414,1.2497385640410528,1.24933974022824,592450928,585686721,85.99414701377819,82.14695665487363,NaN,NaN,37.08361304171229,34.238367355736266
2010-12-30T09:30:00-05:00,68.14999,68.47,67.91,68.14999,5984535,10251957,73.0244774655045,68.37873421301626,NaN,NaN,163.85266455013914,137.98772219113053,0.012186396332615201,1.264572735644009,1.2523863393113939,598435463,589096917,86.94136890147762,82.32231496961455,NaN,NaN,38.32673475123403,34.82241984080738
2010-12-31T09:30:00-05:00,68.13,68.5,67.92999,68.25,4444434,9590298.7,73.513668468917,68.77734425297443,NaN,NaN,144.87800679920667,142.78291659235393,0.013900424754381469,1.2697618702543707,1.2558614454999892,602879897,592489641.2,87.82366176074146,82.64541711717501,NaN,NaN,39.5062936081154,35.49154466470852
2011-01-03T09:30:00-05:00,68.89999,69.19,68.60001,68.75999,10196645,9599163.2,75.91251753569344,69.17770229853399,NaN,NaN,167.24156703197795,154.56002287552113,0.03534298262250024,1.3000401737781146,1.2646971911556144,613076542,598752223.4,89.26541207449418,83.14085649577184,NaN,NaN,41.237377157952245,36.312377878029054
2011-01-04T09:30:00-05:00,69.19,69.19,67.52,68.17,14543461,9726698.35,68.21535066117747,69.24057616324629,NaN,NaN,108.85452630371418,151.07071656678625,-0.0022517614258350527,1.2618824893733205,1.2641342507991555,598533081,601075182.2,89.75021033797748,83.6311580909187,NaN,NaN,40.591546545717634,36.92368768769885
2011-01-05T09:30:00-05:00,67.83,68.56,67.57001,68.44,11291496,9144349.15,69.72808013811328,69.6530151628622,NaN,NaN,90.11902977865118,134.98915889273778,-0.019991479041103988,1.2391449019977756,1.2591363810388796,609824577,604549912,90.4453240496403,84.12330741837484,NaN,NaN,40.46901229205652,37.43016263117852
2011-01-06T09:30:00-05:00,68.67,68.7,67.5,67.78999,11454023,9079045.05,62.06926785650772,69.38282692244661,NaN,NaN,69.40398906639038,116.09942379598803,-0.0830238296972945,1.1553565939172614,1.238380423614556,598370554,604536930.2,90.42065189409057,84.5658883103724,NaN,NaN,38.06402302264332,37.52071411567349
2011-01-07T09:30:00-05:00,67.82001,68.44,67.60001,68.28,11082234,9085539.15,65.17467458079204,69.52134870197837,NaN,NaN,71.18182020348702,101.3601864768441,-0.09819782409473254,1.1156331434961402,1.2138309675908727,609452788,605851508.4,90.69738568117096,85.28284574715698,NaN,NaN,36.91152187635013,37.43368665291301
2011-01-10T09:30:00-05:00,68.07001,68.14,67.49001,68.00999,10806438,9192057.15,62.154981564484864,69.27663449678542,NaN,NaN,47.77137698871138,77.46614846819078,-0.13085857024967118,1.0502577547787837,1.1811163250284549,598646350,602965470,84.8987241784562,85.89953576806934,NaN,NaN,35.04628260000176,37.092628931068546
2011-01-11T09:30:00-05:00,68.45,69.22,68.36,69.14,11371992,9116178.6,68.69258103318238,69.26114855928061,NaN,NaN,118.48176584822511,79.39159637709298,-0.08312328449919715,1.0772122194044584,1.1603355039036556,610018342,605262522.2,85.68329047005633,86.51531321409458,NaN,NaN,35.42892623934125,36.854957117964645
2011-01-12T09:30:00-05:00,69.75,70.13,69.42999,70.09,11026773,9091743.05,72.92681575573233,69.47145951122687,NaN,NaN,172.4139590800588,95.85058223737451,0.0012019510774372577,1.1618379427504522,1.160635991673015,621045115,607506629.8,86.42529069771494,86.99891336305168,NaN,NaN,37.234104189910774,36.90912098538552
2011-01-13T09:30:00-05:00,70.2,70.35001,69.638,69.895,11522652,9112071.35,70.80983487789013,69.46668070869428,NaN,NaN,164.26764575300808,114.82331357469805,0.03096662558934038,1.1993442736596904,1.16837764807035,609522463,609737011.6,87.13874224837228,87.41118482704873,NaN,NaN,37.96273627280114,37.05963745501632
2011-01-14T09:30:00-05:00,69.8,70.67,69.48,70.64999,14005320,9261051.6,73.96147962149152,69.88419865186954,NaN,NaN,173.90099270352576,135.3671480747058,0.08552904726441057,1.2752889571508632,1.1897599098864526,623527783,612552010.6,87.99624364419788,87.73879701465293,NaN,NaN,39.64756808930531,37.42934183134332
2011-01-18T09:30:00-05:00,70.60001,71.13,70.38,71.09,12535160,9321517,75.61400171825329,70.32441536320293,NaN,NaN,190.1860455853656,163.85008179403664,0.1324777383960809,1.3553570828815538,1.2228793444854729,636062943,620035329.2,89.92023261276857,88.10004896892407,NaN,NaN,41.57300093667203,38.02129313210457
2011-01-19T09:30:00-05:00,71.21001,71.23981,70.11,70.23,15126895,9566127.95,66.70353574099846,69.89294764419559,NaN,NaN,138.29691286643407,167.81311119767844,0.0889276180545644,1.3340388670536782,1.2451112489991139,620936048,622218870.4,90.4035663488202,88.41500749285565,NaN,NaN,40.21750156768108,38.335037194329786
2011-01-20T09:30:00-05:00,69.69,69.94,68.73,69.73,23179920,10289956.55,62.12014492521122,69.11406674846036,NaN,NaN,57.638993483924466,144.85811807845158,0.013709240151043245,1.262247799187918,1.2485385590368747,597756128,617561073,81.4333524269417,88.02157774467453,NaN,NaN,37.5744803574992,38.2263862176397
2011-01-21T09:30:00-05:00,70.44,70.62,69.71001,70.10001,14573961,10625883.7,64.0867660091275,68.4407165727611,NaN,NaN,92.19652817559506,130.44389456296895,-0.02192435684744476,1.2211331129775687,1.2430574698250134,612330089,618122598.2,81.66949001620027,87.58199404863588,NaN,NaN,36.0585002604218,37.91668822375143
2011-01-24T09:30:00-05:00,69.99001,70.52,69.72,70.36,13104203,11054504.2,65.4443277620677,67.69298873178784,NaN,NaN,85.72335145684391,112.80836631363259,-0.037850257352052497,1.1957446481349479,1.2335949054870003,625434292,618503900,81.83840566661296,87.05149359093005,NaN,NaN,35.24949685241743,37.535660884989426
2011-01-25T09:30:00-05:00,70.2,70.31,69.36,70.1575,15819094,11637826.65,63.43304242452825,67.3513952863129,NaN,NaN,60.54930607817994,86.88101841219546,-0.07001765642126356,1.146072834960421,1.2160904913816846,609615198,613214351,71.93529076917434,85.77899933601554,NaN,NaN,33.984888333616034,37.02840766336465
2011-01-26T09:30:00-05:00,70.39999,72.03,70.35001,71.84,24221520,12591169.85,71.31980127016479,67.465089652888,NaN,NaN,142.39763397245505,87.70116263339966,0.009777236771055131,1.2283120373455034,1.2185348005744483,633836718,615794485,73.61262331940003,84.57666356956982,NaN,NaN,35.47138163595805,36.80597537373514
2011-01-27T09:30:00-05:00,71.8,71.9501,71.05,71.42,14994184,13064247,67.41120575157308,67.84665664539267,NaN,NaN,131.51192481952646,102.47574890052006,0.021366023049925298,1.2452423293868549,1.2238763063369296,618842534,620011766.2,76.12443600181837,83.55550529155038,NaN,NaN,35.357719483971465,36.59908167519747
2011-01-28T09:30:00-05:00,71.3,71.64999,70.85001,71.11,23691760,13949608.25,64.59722232058553,67.80541005537792,NaN,NaN,103.56094827104904,104.74863291961087,-0.003431714907466521,1.2195866627025964,1.223018377610063,595150774,616575903.2,70.25674769359509,82.09545972100922,NaN,NaN,34.36067802380213,36.279309724998136
2011-01-31T09:30:00-05:00,71.72,73.14999,71.49001,73.14999,25114832,14983128.15,72.6794331439177,68.55715659676598,NaN,NaN,172.5538141085116,122.1147254499444,0.10024281043531369,1.348321890654205,1.2480790802188912,620265606,615542166,68.54485399429227,80.92732613642609,NaN,NaN,36.39883870860323,36.29638529408458
2011-02-01T09:30:00-05:00,73.44,74.41,71.21581,74.34,20443136,15495452.7,76.10620523857128,69.08670118286518,NaN,NaN,187.6565107611578,147.53616638653997,0.22453426002706078,1.5287469052527172,1.3042126452256564,640708742,621760874.8,72.83330385018013,80.00946994929207,NaN,NaN,39.39372002219913,36.73886168381523
2011-02-02T09:30:00-05:00,74,74.83,73.83,74.28,13560945,15446326.9,75.59138790861341,69.27702776521383,NaN,NaN,203.39302318752016,159.735244229553,0.2749479582064547,1.6478975929837247,1.37294963477727,627147797,620423090.6,70.60330725014686,78.87932827446575,NaN,NaN,41.447134382119586,37.41147206928728
2011-02-03T09:30:00-05:00,74.3,74.44,73.38,74.32001,14515496,15607526.9,75.70938561721529,69.62699567516563,NaN,NaN,160.3373720043878,165.50033366652525,0.28216948623260185,1.7256614925680225,1.4434920063354206,641663293,624987242.4,73.57588573484237,77.91055280921363,NaN,NaN,43.06655552080243,38.21934113378944
2011-02-04T09:30:00-05:00,74.49001,74.5701,73.73,74.13,13280430,15698847.25,73.88269167963462,69.62136796503299,NaN,NaN,142.28367650885892,173.24487931408723,0.24661797397846885,1.7517644738085068,1.505146499830038,628382863,631633660.2,77.19266237854082,77.13886843309525,NaN,NaN,43.81265056584982,39.0183853383695
2011-02-07T09:30:00-05:00,74.44,75.22,74.42999,74.56,16175191,15953495.1,75.33315374026768,69.60130739517687,NaN,NaN,145.36899183545006,167.80791485947492,0.22512631524180815,1.786554393882298,1.56142807864049,644558054,636492149.8,79.41112534476825,76.38821791395239,NaN,NaN,44.874612761440495,39.85498925595107
2011-02-08T09:30:00-05:00,74.44,74.56,73.64999,74.3075,15596879,16193017.15,72.77721181957077,70.03514140078919,NaN,NaN,106.21550897199943,151.51971450164325,0.1695050646031624,1.773309409394443,1.6038043447912806,628961175,634142636.4,75.5823547820388,75.32955994489657,NaN,NaN,45.0086446004079,40.59122573373062
2011-02-09T09:30:00-05:00,73.98,74.25,72.85001,73.37,16324473,16440641.2,64.08349308192498,70.17538055484017,NaN,NaN,68.55284387558902,124.55167863925703,0.05130636878398431,1.667937305771261,1.6166309369872767,612636702,631240417.4,71.0268403662635,74.58623765484812,NaN,NaN,42.45371395626126,40.857295479806425
2011-02-10T09:30:00-05:00,73.00999,74.24001,72.92999,74.12,16809776,16729791.35,67.43497064817814,70.41453802905806,NaN,NaN,70.87934957328477,106.6600741530364,0.007656883700782213,1.6262020416132543,1.618545157912472,629446478,628797054.4,67.346608090519,73.5631746601566,NaN,NaN,41.28272301326652,40.918070841729296
2011-02-11T09:30:00-05:00,73.82001,74.50999,73.621,74.11,18870480,17097182.75,67.34473683628232,70.55028153435912,NaN,NaN,75.26306367581043,93.25595158642673,-0.03549729830411397,1.5741735350323296,1.6096708333364436,610575998,625235681.4,62.281098408498664,72.16622414171987,NaN,NaN,40.325018958991606,40.83334914419534
2011-02-14T09:30:00-05:00,73.98,75.83,73.98,75.74001,15223172,17158075.35,73.55607298815761,71.27335514604692,NaN,NaN,107.95493947211405,85.77314111375952,0.028663691955268522,1.6455004482805293,1.6168367563252608,625799170,621483904.6,57.384377911293164,71.12687322329977,NaN,NaN,41.456204778363556,40.92232852050508
2011-02-15T09:30:00-05:00,75.62,75.75999,74.63,74.95,11443602,17103497.45,66.91299546041726,70.95858330249352,NaN,NaN,95.75965300468715,83.68196992029706,0.0022189748750480742,1.619610474919071,1.6173915000440229,614355568,618562783.2,53.83531569751988,69.71420839316548,NaN,NaN,40.19423225132333,40.81831476776483
2011-02-16T09:30:00-05:00,75.35001,76.03,75.095,75.95,15907918,17142548.6,70.53990722877265,71.18206197943636,NaN,NaN,108.75458784421004,91.72231871402126,0.03459983044345938,1.660641288098347,1.6260414576548876,630263486,622088140,57.27003043348466,68.36746513828452,NaN,NaN,40.34815245951962,40.7511487237298
2011-02-17T09:30:00-05:00,75.94,76.87,75.81,76.7,10796734,16523389.3,72.93607015996461,71.77769396796343,NaN,NaN,133.13666606649693,104.1737820126637,0.08612068138475415,1.7336923093858303,1.6475716280010761,641060220,624410888.4,59.41269783704884,67.5928901485312,NaN,NaN,41.28534384925226,40.82746231309015
2011-02-18T09:30:00-05:00,76.87,77.2,76.34,77.02,12408375,16415110,73.91108592073763,71.86566916630771,NaN,NaN,141.87196671519843,117.49556262054128,0.11929942058703635,1.7966959037348715,1.6773964831478352,653468595,632989407.8,66.16151861497853,67.42265190715166,NaN,NaN,42.34733965106561,41.044587647086644
2011-02-22T09:30:00-05:00,77.37,78.06,75.91,76.27,24833664,17001583.05,67.75040597327558,71.26882636164373,NaN,NaN,131.00933834855653,122.10644239582977,0.07068558736660524,1.7657534673560917,1.6950678799894865,628634931,633556560,66.55744020898766,66.97437593278076,NaN,NaN,41.25232635305668,41.07426460508236
2011-02-23T09:30:00-05:00,76.69,78.371,76.55,77.82001,32189888,17820122.75,72.79695507416302,71.06922401632585,NaN,NaN,157.39363418028512,134.43323863094938,0.11997433001045654,1.8450357925025571,1.7250614624921006,660824819,642850410.2,72.28089502455262,67.0942036309526,NaN,NaN,42.012526735002744,41.208302052213845
2011-02-24T09:30:00-05:00,78.02,78.06,76.25,76.72,22389488,17728521.15,65.02072861460323,70.30574851613927,NaN,NaN,114.93836422818471,135.6699939077443,0.05865118194630492,1.7983754399249818,1.739724257978677,638435331,644484779.2,73.15110545965483,67.06386218272492,NaN,NaN,39.91702275574677,41.02383358128998
2011-02-25T09:30:00-05:00,77,78,76.81,77.94,11768637,17567243.8,68.97862653080065,69.95545814836541,NaN,NaN,126.82538303561837,134.4077373015686,0.07913724477405326,1.8386458139462434,1.7595085691721901,650203968,646313528.8,74.12977072052585,66.84508420715242,NaN,NaN,39.56555067922319,40.8155074524233
2011-02-28T09:30:00-05:00,78.24001,78.69,77.7,78.53999,15878492,17176580.4,70.73253834087222,69.62684276269431,NaN,NaN,143.63871142701595,134.7610862439321,0.11007786328378333,1.8971058982769193,1.787028034993136,666082460,648836301.8,75.45873504151174,66.56277061406267,NaN,NaN,39.88886854589072,40.68313046577579
2011-03-01T09:30:00-05:00,79,79.08,76.97501,77.07001,20205584,16931118,61.55065986216696,68.82494619430832,NaN,NaN,102.19912590236952,128.9990437546947,0.013597697117795793,1.8040251563903809,1.790427459272585,645876876,652284690.8,77.18407205949664,66.67717899102395,NaN,NaN,36.90054649671541,40.14276132733859
2011-03-02T09:30:00-05:00,76.86,77.66,76.28999,77.50999,15045766,16661249.5,63.094866006832206,68.75432997465884,NaN,NaN,68.66509201439273,111.25333532151623,-0.03583150531284751,1.7456380776315257,1.7814695829443732,660922642,652304255.4,77.19386849369727,67.11768100012635,NaN,NaN,35.07722373029061,39.41911309918888
2011-03-03T09:30:00-05:00,78,78.91,77.75999,78.84,11329305,16549667.5,67.3620894780694,68.74912417679393,NaN,NaN,116.96888169436464,111.65943881475224,0.0037023878426865053,1.7860975677477313,1.7823951799050448,672251947,659067578.6,80.33694364420242,68.04556211110375,NaN,NaN,34.99499300326529,38.78709594262836
2011-03-04T09:30:00-05:00,78.82001,78.91,77.72,78.34,14133328,16530559.1,64.34974117039818,68.53519591494506,NaN,NaN,98.7947281524323,106.053307838115,-0.019871207649583722,1.757556170343065,1.7774273779926488,658118619,660650508.8,80.99704494506722,69.38241543514435,NaN,NaN,33.93219429812016,38.093538564841474
2011-03-07T09:30:00-05:00,78.86,79.22,77.36,77.78999,14671676,16600121.4,61.11228835496936,67.64635415543161,NaN,NaN,83.03601227459961,93.93276800763175,-0.08490981846758583,1.6712901049081665,1.7561999233757524,643446943,656123405.4,73.40706295643872,70.52689293836904,NaN,NaN,32.02990486597337,37.22730517928889
2011-03-08T09:30:00-05:00,77.75,77.81,76.38,77.14999,16187910,16600757.35,57.487959406201476,66.9731372944162,NaN,NaN,32.50465414873894,79.99387365690563,-0.17807789104581895,1.5336025595684788,1.7116804506142977,627259033,652399836.8,67.78101694209313,71.52301445583855,NaN,NaN,29.312919262789368,36.09667861978896
2011-03-09T09:30:00-05:00,76.91,77.41,76.37,76.619,13602996,16501063.2,54.5949959265475,65.83421505854298,NaN,NaN,11.956955221896854,68.65224629840647,-0.2766303019117362,1.3658925732246274,1.6425228751363636,613656037,642946515.8,56.038489552806865,71.43504725007585,NaN,NaN,26.176241067036592,34.679473255110054
2011-03-10T09:30:00-05:00,75.60001,75.61,73.61,73.83,36185408,17494109.95,42.49791606191796,63.66006119439679,NaN,NaN,-129.3155010267582,19.3953697541819,-0.5168616581389747,0.9964458024626452,1.51330746060162,577470629,623990252.2,40.78147786808357,70.10424582372119,NaN,NaN,18.79090433095376,32.4096776945163
2011-03-11T09:30:00-05:00,73.32001,75.64999,73.03,75.11,24211888,17864215.55,48.17367878221639,61.8216749702167,NaN,NaN,-123.3535149447258,-25.034278865249718,-0.5724492015411413,0.7977459586751934,1.3701951602163347,601682517,612703031.8,34.71996197364554,67.85842034934026,NaN,NaN,14.71701645003919,29.882154659590995
2011-03-14T09:30:00-04:00,74.75,75.78,74.36,75.52,16441504,17742766.75,49.88018804601119,60.545230832554964,NaN,NaN,-95.9226947296628,-60.826020266102205,-0.5636082293269351,0.6656848735576659,1.229293102884601,618124021,607638447.4,32.39339156557,65.41813116052471,NaN,NaN,12.116862116473403,27.34425572485991
2011-03-15T09:30:00-04:00,73.17999,75.61,72.89999,74.95,21834704,18073343.35,47.536698780170376,58.74092681155548,NaN,NaN,-134.70931433696032,-94.26881396324205,-0.5761049034650714,0.5091619735532618,1.0852668770183331,596289317,601444504.2,29.76632950245309,62.38137648037475,NaN,NaN,9.265234018442388,24.761538338228835
2011-03-16T09:30:00-04:00,75.17,75.81,72.98,73.75,31662784,19084302.45,42.96059135470048,57.16520272156244,NaN,NaN,-142.68029787012736,-125.19626458164689,-0.6402125732459629,0.28500116046087953,0.9252137337068425,564626533,591638603.4,26.150566372904862,59.02419511703547,NaN,NaN,5.3366806530102275,21.98655866891189
2011-03-17T09:30:00-04:00,75.2,76.39,74.71001,76,20945120,19336162.55,52.243527953480296,55.96983853746813,NaN,NaN,-54.55784703035364,-110.24473378236598,-0.5116782711147169,0.2856158948134464,0.7972941659281633,585571653,593258808.2,27.713001455565305,55.70871159810971,NaN,NaN,5.081160778232125,19.57150182738621
2011-03-18T09:30:00-04:00,76.67999,76.86,75.28999,75.39,24192112,20005931.45,49.8737148936034,54.47992257694892,NaN,NaN,-42.78186069075006,-94.13040293157084,-0.4504899938314897,0.23418167363880116,0.6846716674702908,561379541,585198213,24.89145633102555,52.096763118789276,NaN,NaN,4.083948441307375,17.35899420080352
2011-03-21T09:30:00-04:00,76.7,77.7,76.55,77.67999,17164704,20243747.9,57.641702473708875,54.20071133491621,NaN,NaN,37.50964367357298,-67.44393525092369,-0.2486231461024151,0.37389273484227203,0.6225158809446871,578544245,577282257.8,22.47175719786381,48.18874062867264,NaN,NaN,6.003756343964563,15.73681736411224
2011-03-22T09:30:00-04:00,77.7,77.96001,77.25999,77.50999,10019691,19503049.25,56.93630756569235,53.760814303406214,NaN,NaN,48.79465584694991,-30.743141214141644,-0.1255880419153621,0.46553082855048444,0.5911188704658465,568524554,571729305.2,20.934393019430672,44.17020666622502,NaN,NaN,7.23579453339584,14.522385531152754
2011-03-23T09:30:00-04:00,77.49001,77.97,76.9901,77.71001,10097273,18398418.5,57.59386456046805,53.06308395214897,NaN,NaN,47.811909373266865,7.355300234537206,-0.034512798305944004,0.5479778725834166,0.5824906708893606,578621827,574528364,23.765548638512115,40.129392737247144,NaN,NaN,8.412409944353518,13.64953187589572
2011-03-24T09:30:00-04:00,78.02,78.13,77.14999,77.99001,15369102,18047399.2,58.54805775131742,52.64867799364321,NaN,NaN,55.43148130219071,29.353165901046076,0.03693910749478513,0.628664555257842,0.5917254477630569,593990929,576212219.2,25.4939518520669,36.16488608774712,NaN,NaN,9.650831567070401,13.07828897463496
2011-03-25T09:30:00-04:00,78.07001,78.89999,77.78999,78.69,11647969,18041365.8,60.91576354497148,52.63464050721478,NaN,NaN,88.20518795930117,55.55057563105633,0.11906444728229837,0.7405560068659298,0.6214915595836314,605638898,585064090.6,33.96925117594529,33.34789953199759,NaN,NaN,11.402932802228792,12.838952378576936
2011-03-28T09:30:00-04:00,78.5,79.39999,78.33501,78.5,14147984,17954840.4,59.915377554151426,52.80802751778264,NaN,NaN,100.62625765280288,68.17389842690231,0.14650608811588217,0.8046241697284842,0.658118081612602,591490914,587653424.4,36.2535714917064,31.09593914268425,NaN,NaN,12.55876470809273,12.798925568507764
2011-03-29T09:30:00-04:00,78.39999,79.62,78.13,79.46001,16960208,17792571.6,63.20352278392064,53.4229222933093,NaN,NaN,109.38939569146955,80.29284639580624,0.21129154424379304,0.9222325119173433,0.7109409676735503,608451122,595638738,42.822907375215145,30.15196898714199,NaN,NaN,14.53099330141527,13.046363816065979
2011-03-30T09:30:00-04:00,79.98,80.37,79.33,80.00999,19044960,17992531.3,64.97605477378448,55.028503629871196,NaN,NaN,132.81013032854682,97.29249058686223,0.26943848680077787,1.0477390761745227,0.7783005893737448,627496082,605413589,49.661527716680304,30.78625826204176,NaN,NaN,16.714410657851143,13.570370507749574
2011-03-31T09:30:00-04:00,80.42999,80.97,79.72,79.75,18883696,18370250.85,63.420756506664205,56.117580610188895,NaN,NaN,134.12460089431414,113.03111450528691,0.26807188087314937,1.1133904404651815,0.8453185595920322,608612386,608337880.4,51.52928747339968,31.98692436916705,NaN,NaN,18.109215344189746,14.218776912955313
2011-04-01T09:30:00-04:00,80.45,80.69,79.78011,79.99001,12925184,18309843.65,64.27099095549083,57.14549510372316,NaN,NaN,124.17001858064803,120.22408062955628,0.2607728173323024,1.1712845812574102,0.9105117639251078,621537570,611517614.8,53.54758042886129,33.49793785940214,NaN,NaN,19.513647066739427,14.975186934924473
2011-04-04T09:30:00-04:00,80.36,80.5499,79.92999,80.03999,7476293,17950074.5,64.45626672140892,58.35403567095448,NaN,NaN,114.2066917858804,122.94016745617178,0.23741640860733348,1.2072822746842746,0.9698658660769411,629013863,619022204.6,57.993319418883786,35.51415142486148,NaN,NaN,20.736908550560994,15.798290022872548
2011-04-05T09:30:00-04:00,79.97,80.73,79.89,80.28,19323840,18106871,65.38456013565039,59.95574772673662,NaN,NaN,105.27634981354821,122.11755828058752,0.21680609917910032,1.2408734900508165,1.0240673908717162,648337703,626999520.8,62.14112040131301,38.08490528403349,NaN,NaN,22.02720677190412,16.6881352727342
2011-04-06T09:30:00-04:00,80.7,80.89999,79.08,79.44,16475875,18250514.95,59.52510748833127,60.47586055065454,NaN,NaN,79.18957532036916,111.393447278952,0.12957955801130483,1.1860418383858473,1.0564622803745425,631861828,627872670,62.57669051566602,40.5751687883264,NaN,NaN,21.6562899722258,17.39787165837586
2011-04-07T09:30:00-04:00,79.28999,79.77,78.73,79.44,14824625,17182475.8,59.52510748833127,61.165245735992244,NaN,NaN,55.73590241267778,95.71570758262473,0.05848331236593696,1.1295664208319636,1.0710831084660266,631861828,632522558.4,64.8931311081806,43.432431272408905,NaN,NaN,21.34584926144301,17.961868458814024
2011-04-08T09:30:00-04:00,80.02,80.38,79.27,79.72,19144976,16929130.2,60.880373823371265,61.39657940382527,NaN,NaN,67.10914775269349,84.3035334170338,0.01895985670609024,1.0947829293486393,1.075823072642549,651006804,638416405.2,67.62830772829533,46.65789916743973,NaN,NaN,21.416290442569597,18.45535731363625
2011-04-11T09:30:00-04:00,79.75,79.89999,77.87,78.14751,17694688,16991789.4,50.62761071872272,60.945958200470294,NaN,NaN,16.865979637751764,64.83539098740808,-0.11696729839650244,0.9296139496469209,1.0465812480434233,633312116,639276055.8,68.01967451695283,50.021133560119885,NaN,NaN,18.554356774737705,18.4695000937936
2011-04-12T09:30:00-04:00,77.25999,77.3,75.3,75.73,38093728,17804740.6,39.58922267334945,59.6599123513904,NaN,NaN,-101.37781390044537,23.504558244609363,-0.3598535087264618,0.596764362135346,0.9566178708618078,595218388,628652192.8,58.59204708556549,52.50874059205227,NaN,NaN,11.974828621859517,17.5416898835173
2011-04-13T09:30:00-04:00,76.42,76.67,75.45,76.03999,26848944,17564048.6,41.354910673686575,58.43183041727391,NaN,NaN,-117.29633668905826,-15.792624157276123,-0.48216422923581115,0.35391258431704387,0.836076813552855,622067332,626693293.6,57.02266151031911,54.76079128192743,NaN,NaN,7.283613741418149,16.076250434645992
2011-04-14T09:30:00-04:00,75.62,76.78,75.34,76.56,20674112,17550498.2,44.29616984362439,57.24471658146341,NaN,NaN,-112.65822868310585,-49.471450376432855,-0.507986903017824,0.20109318478057503,0.709080087798399,642741444,628869216.8,58.35694980037736,56.50276975510115,NaN,NaN,4.3179488005045785,14.396493058340075
2011-04-15T09:30:00-04:00,76.75999,77.3,76.17,77.19,15270414,17104413.3,47.71732654183474,56.373427223440785,NaN,NaN,-85.62011820584989,-80.01730356814153,-0.46380196141517527,0.12932763602942998,0.5931295974446052,658011858,630270227.6,59.234526833858055,58.14426656525484,NaN,NaN,2.8754279267671135,12.75062661097251
2011-04-18T09:30:00-04:00,76.03999,76.39,75.189,76.03999,20053936,17248874.9,42.57680981283969,54.900090582649284,NaN,NaN,-127.28923215500637,-108.84834592669316,-0.49059283169779355,-0.020111442177636718,0.47048138952015683,637957922,631199388.8,59.8390061358726,59.35970219101608,NaN,NaN,-0.022195872071374013,10.925937684823385
2011-04-19T09:30:00-04:00,75.99001,77,75.95,76.81,15062668,17501023.75,46.715925209126624,53.59579561374515,NaN,NaN,-85.4590210577104,-105.66458735814618,-0.43681619296674856,-0.0755388516882789,0.36127734127846967,653020590,642759829.2,66.49568603111635,60.56214207061866,NaN,NaN,-1.1491650524295531,9.200923008072966
2011-04-20T09:30:00-04:00,78.28999,78.66,77.92,78.62,22444880,18118404.1,54.9382585965424,52.98990290587931,NaN,NaN,-0.9749481766142322,-82.40030965565735,-0.267995136045593,0.02628342122147842,0.2942785572670714,675465470,653439456.8,71.23845384434802,61.96993966854354,NaN,NaN,0.6414171675318986,7.978136459424242
2011-04-21T09:30:00-04:00,78.78,79.19,78.41,78.98,12647113,17982304.65,56.38001463021353,52.426261739788075,NaN,NaN,19.447899166872798,-55.979084085661626,-0.1278411427617197,0.1344771288149218,0.2623182715766415,688112583,662513684.6,74.53670677668939,63.46916297910269,NaN,NaN,2.5324522419170874,7.200181571208934
2011-04-25T09:30:00-04:00,79.02,79.09,78.08,78.57001,7075711,17753691.75,54.25114926674666,51.69732477874078,NaN,NaN,4.996106649561142,-37.85583911457942,-0.06184980065282475,0.18500602076061057,0.24685582141343532,681036872,667118687.4,76.03843652709404,64.75809991540342,NaN,NaN,3.4072455030649658,6.658333561474081
2011-04-26T09:30:00-04:00,78.81,79.47,78.47,79.35001,9202340,17506409.55,57.53624078164022,51.136730539168624,NaN,NaN,29.867898884300594,-6.42441290671802,0.030281803243029315,0.284708075467222,0.2544262722241927,690239212,677574945.4,79.05850002552043,65.96648417427538,NaN,NaN,5.175951133849415,6.446564643241986
2011-04-27T09:30:00-04:00,79.66991,79.7,77.98,79.31,18717360,17594267.15,57.30891530801105,50.97843109771718,NaN,NaN,25.106344748069308,15.688660254437924,0.08156778502735829,0.35638600350839056,0.2748182184810323,671521852,681275197.8,80.01828389857474,67.21231227305458,NaN,NaN,6.523905628371226,6.457613355403306
2011-04-28T09:30:00-04:00,79.03999,79.53999,78.55,79.3,14998219,17391930.1,57.248034090221886,50.815782997852224,NaN,NaN,34.40903325414475,22.765456540589717,0.10629328488180212,0.4076848245832849,0.3013915397014828,656523633,677486830.4,76.16925817303255,68.017749920544,NaN,NaN,7.603680491646686,6.621337232009504
2011-04-29T09:30:00-04:00,79.32001,80.50999,79.28,80.479,9928586,16944174.6,62.3292113230889,50.91927139068919,NaN,NaN,83.68341403657587,35.61255951453033,0.1887119760473535,0.5372815097606747,0.34856953371332117,666452219,673154757.6,71.90958108113362,68.32355516003246,NaN,NaN,10.096887036407033,7.1178443469234365
2011-05-02T09:30:00-04:00,80.64999,80.8,78.92,79.41,17762784,17186054.6,55.84788928458442,51.29214843110789,NaN,NaN,66.18954513100657,47.85124721081942,0.15907889681449972,0.5474181547314458,0.3883392579169461,648689435,666685270.2,65.97568835316164,68.17755614833308,NaN,NaN,10.339483883850631,7.578078566484464
2011-05-03T09:30:00-04:00,78.8,78.97,76.74001,77.42,28751728,18249826.35,46.213927807587815,51.76534165498206,NaN,NaN,-31.364367579865704,35.604793917986164,0.0016287123189105968,0.3903751483155844,0.3887464359966738,619937707,652624969.2,55.29605154331819,67.94212789531541,NaN,NaN,7.32127307043156,7.541392067048335
2011-05-04T09:30:00-04:00,77.25999,77.27,75.39,76.05,29750336,18771151.15,40.97364296534042,51.73810824724304,NaN,NaN,-94.67030389625123,11.649464189122057,-0.18811771927905252,0.15359928689785818,0.3417170061769107,590187371,636358073,46.01554138977273,67.15590502956209,NaN,NaN,2.9256118012897696,6.881994886225683
2011-05-05T09:30:00-04:00,74.91,75.64999,73.58,74.47,44489488,20171831.8,35.915560922512114,51.13949332430646,NaN,NaN,-152.35705819796135,-25.70375410129916,-0.4011329424602111,-0.15969917189835314,0.24143377056185794,545697883,614192923,36.92232657448088,65.62486051342663,NaN,NaN,-2.6370565217979394,5.522130399365166
2011-05-06T09:30:00-04:00,75.33,76.45,73.98,74.8,35227152,21191958.15,37.64689513418227,50.42017679518842,NaN,NaN,-113.05529261765696,-65.05149543214573,-0.49475998241571467,-0.3770162074577854,0.11774377495792927,580925035,597087486.2,31.713856750230434,63.65909836459609,NaN,NaN,-6.3843709693703845,3.821201632402944
2011-05-09T09:30:00-04:00,75.14999,76.47,75.02,76.11,24228480,21446133.35,44.10284390278396,50.52917923018443,NaN,NaN,-70.32782082938742,-92.35496862422453,-0.4449797692921489,-0.43848093665725685,0.006498832634892038,605153515,588380302.2,29.437451693603222,61.48755876157685,NaN,NaN,-7.379402065506866,2.2211153898443996
2011-05-10T09:30:00-04:00,76.10001,76.83,75.50999,76.47,17766672,21449732.55,45.76472417722193,50.46123629933411,NaN,NaN,-47.36660608461623,-95.55541632517462,-0.36753681095103924,-0.452922181053907,-0.08538537010286779,622920187,588976798.2,29.8091541698858,58.867092200060384,NaN,NaN,-7.631353926207191,0.8136197732656012
2011-05-11T09:30:00-04:00,76,76.07899,73.71001,74.25999,41169888,21603540.55,38.247037178226776,49.26900619802585,NaN,NaN,-111.13465620721144,-98.84828678736667,-0.43998941111949685,-0.6353721340022389,-0.19538272288274203,581750299,587289383.8,29.338333482335216,55.87422645991661,NaN,NaN,-10.469708063672297,-0.7982842034398128
2011-05-12T09:30:00-04:00,73.89999,74.75,72.78,74.14999,38954880,22208837.35,37.91320589666308,47.94994843134367,NaN,NaN,-132.3348900283232,-94.84385315343904,-0.4675750013167534,-0.7798514745286838,-0.31227647321193036,542795419,586708891,29.167659533861254,52.63358022828603,NaN,NaN,-12.764823548086465,-2.50778982410362
2011-05-13T09:30:00-04:00,74.5,74.85001,73.13,73.78999,35934080,22971835.75,36.7817032682721,46.70213086002406,NaN,NaN,-118.87194124501185,-96.00718287891002,-0.4804814546070307,-0.9128782914707188,-0.43239683686368807,506861339,571896151.8,25.14744775221466,48.99850960150894,NaN,NaN,-14.962692564458765,-4.287061644154354
2011-05-16T09:30:00-04:00,73.48,74.73,73.03999,73.23,28148384,23615734.25,35.03035679268811,45.09456771795606,NaN,NaN,-113.11044342594637,-104.5637073982218,-0.49517851181823314,-1.0513699766364795,-0.5561914648182463,478712955,546608039.8,20.06332552565233,44.78456856580408,NaN,NaN,-17.315702987862586,-6.1482961218269585
2011-05-17T09:30:00-04:00,72.89,73.58,72.28,73.23,30273008,24126687.85,35.03035679268811,43.503242109718705,NaN,NaN,-122.31040088338712,-119.55246635797599,-0.4733615752985385,-1.1478934339414195,-0.674531858642881,478712955,517766593.4,16.07229332576513,40.21699781060339,NaN,NaN,-19.207248063708683,-8.013860684952919
2011-05-18T09:30:00-04:00,73.56,75.24001,73.28,74.71001,25846480,24665878.45,43.304824828394565,42.507298591016756,NaN,NaN,-69.55381251703862,-111.23629761994144,-0.3342723873569968,-1.092372342839127,-0.7580999554821302,504559435,502328420.6,14.418893830443565,35.80625750041846,NaN,NaN,-18.42502655426146,-9.501170094854139
2011-05-19T09:30:00-04:00,75.05,75.36,74.09,74.72,19666896,24526979.25,43.35726442499964,41.15215952686752,NaN,NaN,-54.662834670542466,-95.70188654838527,-0.2220218770092801,-1.0356273017437303,-0.8136054247344502,524226331,498614603,14.04459495249958,31.67304420551604,NaN,NaN,-17.78116728375657,-10.684026836125915
2011-05-20T09:30:00-04:00,74.64999,75.27,73.72,74.63,27054400,25247343.6,42.971646740824355,40.232427916598944,NaN,NaN,-55.86114316827074,-83.09972693303706,-0.1383527825003945,-0.9865464028599433,-0.8481936203595488,497171931,496676721.4,13.842666420921603,27.94925692464174,NaN,NaN,-17.35451265279619,-11.636953381364526
2011-05-23T09:30:00-04:00,73.33,73.87,73,73.47,20292928,25908204.45,38.24967889121582,39.663552994000945,NaN,NaN,-85.20194657804643,-77.51802756345708,-0.14495360422371562,-1.0293856256391933,-0.8844320214154777,476879003,496309931,13.802216961402522,24.985411597362056,NaN,NaN,-18.313746815901798,-12.590781014869851
2011-05-24T09:30:00-04:00,74.22,75.33,74.2,74.50999,24830784,26689626.65,44.17270284116033,39.89205727084522,NaN,NaN,-38.6583299357126,-60.78761337392217,-0.06705923383307211,-0.9682560637068178,-0.9011968298737457,501709787,500909297.4,17.074463309637636,22.91819173449526,NaN,NaN,-17.397686714598002,-13.277481829116729
2011-05-25T09:30:00-04:00,74.13,76.16,74.12,75.77,24918816,26999699.45,50.38238873303042,40.925402114453675,NaN,NaN,-8.25523593596321,-48.5278980577071,0.07390573837224568,-0.8088146569084387,-0.8827203952806844,526628603,505323131,20.205065256628984,21.72410164036298,NaN,NaN,-14.643112413864648,-13.472571912652146
2011-05-26T09:30:00-04:00,75.52,76.33,75.14,76.14999,18751728,27187374.9,52.11232322400439,41.958646978012396,NaN,NaN,23.069789379097887,-32.981373247779025,0.19068325849765322,-0.6443663221586178,-0.835049580656271,545380331,509553931,23.19804022674765,21.115829031542777,NaN,NaN,-11.857570788670847,-13.241857466369103
2011-05-27T09:30:00-04:00,76.57001,77.12,75.96001,76.34,16697098,27525800.5,52.994850660429904,42.59379031784425,NaN,NaN,71.34308366604468,-7.540527880915937,0.27362019618805944,-0.4930243354211967,-0.7666445316092562,562077429,522535030.6,31.667032074357166,21.275084773025203,NaN,NaN,-9.320622174591257,-12.681680996115125
2011-05-31T09:30:00-04:00,77.34,77.66,76.25,77.11,19312128,27603267.7,56.49392599207094,43.360161876047755,NaN,NaN,126.22757936070629,34.74537730683461,0.36738879215152775,-0.3074085414198464,-0.6747973335713742,581389557,543437141.4,42.635924094726555,22.191282624799545,NaN,NaN,-6.084512566509308,-11.739228363314293
2011-06-01T09:30:00-04:00,76.92,77.25,75.07001,75.27,27617360,27546549.3,47.41147428968304,44.01476452686607,NaN,NaN,64.04308877484078,55.28566104894528,0.2956295009942759,-0.30526045732852936,-0.6008899583228052,553772197,553849623.4,47.18418398763812,23.465986232321182,NaN,NaN,-5.930773875289324,-10.909449150739297
2011-06-02T09:30:00-04:00,75.3,75.89,74.42999,75.24001,24105216,27264293.3,47.27805939783447,44.68368263409259,NaN,NaN,20.10308674634421,60.957325585406764,0.23871908787103469,-0.3024910984840119,-0.5412101863550466,529666981,554457299,47.44607023077121,24.771586996386183,NaN,NaN,-5.848981243248835,-10.186525163954945
2011-06-03T09:30:00-04:00,74.11,75.98,73.97,75.25999,22378448,26158741.3,47.384287642319,45.441010089381656,NaN,NaN,9.260158722728896,58.195399454132975,0.19674388129666492,-0.29528033473421544,-0.49202421603088037,552045429,555790318.6,48.05454928125107,26.4078085341745,NaN,NaN,-5.7528244488233335,-9.553139347507573
2011-06-06T09:30:00-04:00,75.10001,75.41,73.39999,73.56,23439296,25569348.5,39.99948945669445,45.79594813681068,NaN,NaN,-58.978479948237045,32.131086731276625,0.05611729619433514,-0.42187759578796147,-0.4779948919822966,528606133,549096059.4,45.22283831409606,28.204916590491905,NaN,NaN,-7.95588830640149,-9.324960627349562
2011-06-07T09:30:00-04:00,74.2,74.58,73.44,73.56,19230528,25319450.9,39.99948945669445,46.1508861842397,NaN,NaN,-72.6096178501843,-7.636352710901494,-0.030608696165059346,-0.5162557621886208,-0.48564706602356145,528606133,538539374.6,41.10888097779017,29.99324427992227,NaN,NaN,-9.71388055571158,-9.380520617115565
2011-06-08T09:30:00-04:00,73.78999,74.67999,73.62,73.78,25056528,25683943.7,41.370886730889126,46.01274774870359,NaN,NaN,-55.29927059433784,-31.504824584737218,-0.0648948719438398,-0.5667656559533611,-0.5018707840095213,553662661,538517467.4,41.10052507576446,31.899075083159477,NaN,NaN,-10.788652240845323,-9.581682277648387
2011-06-09T09:30:00-04:00,74.14999,75.17999,74,74.78,17271920,24489045.3,47.27050547508912,46.292264966567124,NaN,NaN,-3.045623668475516,-36.13456666770117,-0.014589762310610377,-0.5201079868977843,-0.5055182245871739,570934581,546770987.4,45.58787931702318,34.15216682348259,NaN,NaN,-10.027884106470633,-9.645425396051564
2011-06-10T09:30:00-04:00,74.2,74.35001,73.205,73.33,20968496,23589726.1,40.85145442193758,46.14082265807521,NaN,NaN,-85.90820890530291,-55.16824019330753,-0.07022157409265062,-0.5932951922029872,-0.5230736181103366,549966085,546355118.6,45.40019048942091,36.40627568551825,NaN,NaN,-11.338767713781525,-9.887331441441559
2011-06-13T09:30:00-04:00,73.3701,73.89999,71.48,72.17,27751136,23180578.9,36.57274483853472,46.02104165431228,NaN,NaN,-158.03030368913394,-74.9786049414869,-0.17066911269889273,-0.7364100089839525,-0.5657408962850597,522214949,545076881.8,44.78979992053068,38.61967446831312,NaN,NaN,-13.861838129566397,-10.455118111173679
2011-06-14T09:30:00-04:00,73.11,74.07001,73.09,73.71001,22877840,22917051.7,44.83368533545862,46.0682546896193,NaN,NaN,-73.99609542374833,-75.25590045619973,-0.12124333478322213,-0.7172950647640874,-0.5960517299808653,545092789,548374213,46.77763454611073,40.741329556632635,NaN,NaN,-13.297518586238946,-10.861175321897289
2011-06-15T09:30:00-04:00,72.83,73.48,71.62,72.02,35640432,23185422.9,38.85326733974759,45.244746018670526,NaN,NaN,-159.87525644775044,-96.17109762688224,-0.1863268389501903,-0.8289602786686032,-0.6426334397184129,509452357,539532152.2,42.37193537265519,42.324677422063075,NaN,NaN,-14.911041903999282,-11.439727690769002
2011-06-16T09:30:00-04:00,72.05,72.78999,71.405,72.13,25264384,23156318.1,39.419697838749386,44.338129919723734,NaN,NaN,-150.50819504008246,-125.66361190120362,-0.20447364827483328,-0.8982255000619546,-0.6937518517871213,534716741,532288584.2,39.121263151956775,43.46205048814944,NaN,NaN,-15.96554924725225,-12.086273627409467
2011-06-17T09:30:00-04:00,72.5,72.62,71.22,71.685,27409808,23543463.7,37.89052692796946,43.25924965311942,NaN,NaN,-142.30445325622125,-136.9428607713873,-0.22720292746983417,-0.9777555111244141,-0.7505525836545799,507306933,523756753.8,35.65188432959221,43.7466827920948,NaN,NaN,-17.299547505074337,-12.831027038504448
2011-06-20T09:30:00-04:00,71.3,73.8,71.14,71.88,17362320,23058859.7,39.007085239645306,42.010189599374726,NaN,NaN,-103.80712120630821,-126.09822427482213,-0.2102517573551962,-1.0133672803485752,-0.803115522993379,524669253,524247614.6,36.00352228514569,43.27293980569617,NaN,NaN,-18.04078509314344,-13.575278189167161
2011-06-21T09:30:00-04:00,72.38,73.661,72.33,73.31,23195552,23203990.9,46.58994002496083,41.951508580466005,NaN,NaN,-57.56499641987116,-122.81200447404672,-0.09002423759982414,-0.9156458199931592,-0.825621582393335,547864805,524802017.8,36.42608476438324,42.504504146892245,NaN,NaN,-16.312721910866994,-13.966341577981423
2011-06-22T09:30:00-04:00,73.08,74.0825,72.86,73.10001,18561872,22890545.3,45.69160765430207,41.83819059878512,NaN,NaN,-40.719356561467904,-98.9808244967902,-0.015822774973961118,-0.8454000511107864,-0.8295772761368253,529302933,528772133,39.506475526010625,41.937390239409346,NaN,NaN,-15.18793086903654,-14.14085433384644
2011-06-23T09:30:00-04:00,71.55,72.41,70.45,72.3,45454176,23917313.3,42.341972761443664,41.47802525015117,NaN,NaN,-114.61017274493828,-91.80122003776137,-0.011976951267836489,-0.8445484652216209,-0.8325715139537844,483848757,518598536.2,34.846892963427905,40.99398621670769,NaN,NaN,-15.228738528696265,-14.296266361682129
2011-06-24T09:30:00-04:00,72.3,72.47,70.83,70.92999,17065648,23833009.3,37.299157483368845,41.28514439491362,NaN,NaN,-119.15113361030632,-87.17055610857838,-0.08877905393642016,-0.9435453313743096,-0.8547662774378895,466783109,510493771.4,31.64481525726542,40.02412742693407,NaN,NaN,-16.85784044573256,-14.662205516546477
2011-06-27T09:30:00-04:00,70.67999,71.75,70.50999,71.31,19694656,23982887.2,39.45317541420328,41.24612196330711,NaN,NaN,-119.5600831090782,-90.3211484891324,-0.10021908785909073,-0.9800401372617529,-0.8798210494026621,486477765,502855473.8,28.94529478826594,39.15529984196805,NaN,NaN,-17.53066840812624,-15.0719859296293
2011-06-28T09:30:00-04:00,71.92999,73.42,71.87,73.39,15857727,23810167.15,49.64928652867868,41.837436234577794,NaN,NaN,-21.081484709114054,-83.02444614698098,0.038626072003317136,-0.8315384593985158,-0.8701645314018329,502335492,493749611.2,26.088124532850003,38.08298551747417,NaN,NaN,-14.742484150955404,-15.0249142469616
2011-06-29T09:30:00-04:00,73.63,74.75999,73.28,74.25,21321408,23495369.55,53.16138762306352,42.258213530861674,NaN,NaN,62.3791721269077,-62.40474040930586,0.18644300062257402,-0.6371107806236154,-0.8235537812461894,523656900,492620404.6,25.74869443055178,36.665900882726206,NaN,NaN,-11.280975699036334,-14.490065882972276
2011-06-30T09:30:00-04:00,74.5,75.42101,74.49001,75.35001,19418784,23261047.95,57.26725602622356,43.430770788310674,NaN,NaN,128.74933048558177,-13.732839763201856,0.3470263886133689,-0.38977079547947824,-0.7367971840928471,543075684,504465790,35.263829775081845,35.941875117416274,NaN,NaN,-7.002047780269291,-13.420349011157564
2011-07-01T09:30:00-04:00,75.19,76.14,74.55,76.06,14888488,22886549.95,59.721483183000295,45.08425209862965,NaN,NaN,156.00085879447442,41.29755871775429,0.48151239088284414,-0.1349066954892919,-0.616419086372136,557964172,522702002.6,46.60766532431465,36.07172264625798,NaN,NaN,-2.7026186103125047,-11.889244668179698
2011-07-05T09:30:00-04:00,76.16,76.87,75.97,76.53,15683434,22498756.85,61.30575838766042,46.2608287452155,NaN,NaN,184.11779632417867,102.03313460440566,0.5761780136276594,0.10380343066243825,-0.47237458296522117,573647606,540135970.8,54.76795265398703,36.642459653963435,NaN,NaN,1.287767134833337,-10.006814410606408
2011-07-06T09:30:00-04:00,76.36,76.495,75.71001,76.39,10975488,22086004.85,60.54187357944148,47.810014905193626,NaN,NaN,146.6040431104455,135.57024016831758,0.6006804643928987,0.27847599752590213,-0.3222044668669965,562672118,552203296,59.39405858700889,37.85832559784584,NaN,NaN,4.273619876098142,-7.966752369648615
2011-07-07T09:30:00-04:00,77.42,77.64999,76.8434,77.53999,17824304,21724393.65,64.45931986173284,49.598559335406726,NaN,NaN,173.1843898165128,157.7312837062386,0.6608766151549991,0.5038913020767524,-0.1569853130782467,580496422,563571200.4,63.21120620827523,39.5790358161543,NaN,NaN,8.103932250339438,-5.670940281078893
2011-07-08T09:30:00-04:00,76.19,76.89,76.08,76.89,17131056,21717350.45,60.78593058028873,51.233945310572395,NaN,NaN,125.30203507296874,157.041824623716,0.6239125138748322,0.6229053292652935,-0.001007184609538636,563365366,567629136.8,64.49429587835418,41.6392080696373,NaN,NaN,10.2236296382372,-3.4002874354623085
2011-07-11T09:30:00-04:00,75.78999,75.8,74.77,75.065,19147024,21626276.85,51.85120941963228,52.15138275200004,NaN,NaN,58.710455813419394,137.583744027505,0.4515795522047859,0.5634672556464437,0.11188770344165784,544218342,564879970.8,62.89388931632085,43.55994857186409,NaN,NaN,9.262741452438295,-1.5912833086193652
2011-07-12T09:30:00-04:00,74.75999,75.82001,74.7,74.78999,20545824,21266011.25,50.64320257221839,52.44090150537558,NaN,NaN,48.61043256153648,110.48227127497657,0.3013214895865831,0.48853956542488675,0.18721807583830363,523672518,554884953.2,57.32439482538094,45.05268500479251,NaN,NaN,8.118262526908966,-0.20420533211531788
2011-07-13T09:30:00-04:00,75.13,76.425,75.05,75.35001,20165904,21130414.45,53.04234820337041,52.9659544017376,NaN,NaN,62.001442809598664,93.56175121480719,0.22537921315615578,0.46894209228349837,0.2435628791273426,543838422,551118214,55.33565021359733,46.18334033962013,NaN,NaN,7.884180743028091,0.9512783929051691
2011-07-14T09:30:00-04:00,76.13,76.2901,74.75,74.85001,22632848,20480035.25,50.67399780168256,53.56109904746895,NaN,NaN,45.262965055690444,67.97746626264271,0.1318359665750305,0.40835783734613074,0.27652187077110024,521205574,539260044.4,49.512101813346035,47.230855257471426,NaN,NaN,6.985600260634113,1.813324374009304
2011-07-15T09:30:00-04:00,75.7,76.95,75.64999,76.86,27367088,20585170.45,58.66420568410653,55.08717391895022,NaN,NaN,82.98098284517457,59.51325581708388,0.19204568161977004,0.5165789727958128,0.32453329117604274,548572662,536301503.6,48.150567256865024,48.4098375431571,NaN,NaN,8.718243993596563,2.7997414625217694
2011-07-18T09:30:00-04:00,76.53,76.74001,75.99001,76.60001,20362288,20232794.45,57.3696760728799,56.366923965998545,NaN,NaN,75.28598020679571,62.828360695759145,0.20016595009918442,0.5747407288000232,0.37457477870083883,528210374,533099910,46.65539076347241,49.674844398529004,NaN,NaN,9.706329923065537,3.7863969568851648
2011-07-19T09:30:00-04:00,77.14999,78.06,77.09,77.995,19557968,20342576.85,62.19067320116444,57.262737299747535,NaN,NaN,118.36138286046157,76.77855075554416,0.2803726232952109,0.7250405578198524,0.44466793452464154,547768342,537919074.8,49.21187708281352,51.32654100924068,NaN,NaN,12.11487991294432,4.976180236322187
2011-07-20T09:30:00-04:00,78.33,78.36,77.64999,77.8,10517758,19708687.15,61.14964998249466,57.833327468278334,NaN,NaN,119.70740483127422,88.31974315987928,0.29944861886220053,0.8189787081023923,0.5195300892401917,537250584,536601507.2,48.527140629636314,52.953572880603865,NaN,NaN,13.72753692738713,6.226374049331464
2011-07-21T09:30:00-04:00,78.25999,79.42999,78.21001,79.33,17361328,19648659.95,65.96378162840685,58.454507868434284,NaN,NaN,147.91605280533597,108.85036070980838,0.3886120608909891,1.0052951653539282,0.6166831044629391,554611912,543282774.8,52.1620743874989,54.16059035291937,NaN,NaN,16.702225931334088,7.722924318188982
2011-07-22T09:30:00-04:00,79.39999,79.83,78.92999,79.73,11499742,17950938.25,67.11120637949715,58.98234523961263,NaN,NaN,154.75748327309023,123.20566079539154,0.4440311759669362,1.1717220744216092,0.727690898454673,566111654,546790573.2,53.9988143464189,54.688529568783956,NaN,NaN,19.471484116475906,9.401290003658541
2011-07-25T09:30:00-04:00,78.74001,79.97,78.62,79.41,15484406,17871876.15,65.21703770023399,59.26172233336788,NaN,NaN,138.31991903643322,135.81244856131903,0.42843408424004836,1.2632335037547335,0.8347994195146852,550627248,551273948,56.307866242475576,54.79852339653314,NaN,NaN,21.18228439237071,11.084289202045994
2011-07-26T09:30:00-04:00,79.36,79.75999,78.75,79.03,16969360,17735611.35,62.945062552060406,59.43337868855495,NaN,NaN,123.4259875389224,136.8253694970112,0.36433748745264105,1.2902212788304865,0.9258837913778455,533657888,548451857.2,54.454962941444464,54.44573085042139,NaN,NaN,21.95583311405911,12.637366903762153
2011-07-27T09:30:00-04:00,78.49001,78.64999,77.3,77.535,23784432,18131946.6,54.849330616357385,58.746950885313844,NaN,NaN,51.051655851214555,123.09421970099925,0.20121529601455868,1.1774029113960438,0.9761876153814851,509873456,542976431.6,50.951690859132945,53.57005118262551,NaN,NaN,20.173449077239507,13.713950071401776
2011-07-28T09:30:00-04:00,77.23,78.17999,77.07001,77.22,19554064,18043579.4,53.293985764338686,58.21181196988884,NaN,NaN,27.530854750183607,99.01718008996878,0.05942314805939097,1.0504665504557238,0.9910434023963328,490319392,530117927.6,43.821786199477906,52.09344334842007,NaN,NaN,18.24901847738928,14.361816986542848
2011-07-29T09:30:00-04:00,76.19,77.12,75.96001,76.45,17335584,17939419.4,49.59202301862416,58.05044151267398,NaN,NaN,-29.684698662619702,62.128743702826796,-0.0907392375876187,0.8776193554118095,0.9683585929994282,472983808,511492358.4,35.96998683932945,50.17030745720639,NaN,NaN,15.48776810055634,14.522667145687633
2011-08-01T09:30:00-04:00,77.8,77.85001,75.625,76.34,21985696,18294279.8,49.067655486555445,57.937902435126624,NaN,NaN,-28.3231837999241,28.80012313555533,-0.1959496944774448,0.7234214749026222,0.919371169380067,450998112,491566531.2,29.81525500428434,48.205368898556635,NaN,NaN,13.082769889365533,14.316967537641618
2011-08-02T09:30:00-04:00,75.91,76.7,74.19,74.215,27201104,18870163.3,40.22018763753087,57.02203382328095,NaN,NaN,-109.27920237727064,-17.740914847683257,-0.39561583088596686,0.4248513807726084,0.8204672116585753,423797008,469594355.2,24.780095575923553,46.022829281579945,NaN,NaN,7.9217922222611525,13.403371064015838
2011-08-03T09:30:00-04:00,74.32001,74.36,72.05,73.785,35564096,20099593.7,38.69955650279408,56.166716587646064,NaN,NaN,-173.56222285641022,-62.6636905892082,-0.5349454998286499,0.15178533687276285,0.6867308367014128,388232912,445266246.4,20.62653188646847,43.959574286802976,NaN,NaN,3.2339242117116385,11.950592942258096
2011-08-04T09:30:00-04:00,72.41,72.49001,68.27,68.73,54529712,21934864.1,26.17223965191552,53.84586187106099,NaN,NaN,-275.7522752871183,-123.32031659666859,-0.9230909945522496,-0.4671329064888994,0.4559580880633503,333703200,413943008,16.736700824933934,41.71572668452218,NaN,NaN,-6.940985211404076,9.2517960631635
2011-08-05T09:30:00-04:00,69.57001,70.16,64.4727,68.07001,66409632,24398792.9,25.032872636490467,51.53609019703317,NaN,NaN,-264.65671222717975,-170.3147193095806,-1.1642590185443702,-0.9993656851171124,0.16489333342725776,267293568,372804960,13.212560297772583,39.32695307982933,NaN,NaN,-15.020277445947805,5.784356990433314
2011-08-08T09:30:00-04:00,65.31,66.38,62,62.28,55997024,26241292.9,17.737567551943172,48.36086836494594,NaN,NaN,-278.67932140612,-220.3859468308198,-1.6253942949090965,-1.8668495352091128,-0.2414552403000163,211296544,324864646.4,10.450856371301327,36.55830874329275,NaN,NaN,-26.19679993481025,1.2156202868270904
2011-08-09T09:30:00-04:00,63.58,65.49001,61.10001,65.45,50401120,27734057.7,29.799990956382103,46.12160700593789,NaN,NaN,-200.69016725422043,-238.66813980620972,-1.6247158020457138,-2.2723499928571584,-0.6476341908114447,261697664,292444777.6,9.070154576701526,33.739952596654554,NaN,NaN,-29.503037518937575,-3.172759399710719
2011-08-10T09:30:00-04:00,64.60001,65.78,62.92999,63.19,49373680,29194446.5,26.784547461074737,43.32309027969988,NaN,NaN,-158.25194296513365,-235.6060838279544,-1.67744381173751,-2.744438955483332,-1.0669951437458223,212323984,257262992,7.857048562920625,30.575307894898963,NaN,NaN,-33.25498585581177,-7.470220322010868
2011-08-11T09:30:00-04:00,63.60001,67.46001,63.21001,66.47,42033360,30164472.1,36.782726545392116,41.15677029154953,NaN,NaN,-110.9020429313541,-202.63603735680158,-1.403508801869241,-2.8213811460823734,-1.4178723442131325,254357344,241393820.8,7.377726240954146,27.245230173080053,NaN,NaN,-31.925213689088782,-10.963790803021999
2011-08-12T09:30:00-04:00,67.46001,67.85001,66.53,66.96001,26552960,30123765.7,38.141764148105366,39.222822180683195,NaN,NaN,-80.50470719343669,-165.805636350053,-1.1140396291430457,-2.8104218806419397,-1.696382251498894,280910304,244117168,8.410363999794953,23.82398001288858,NaN,NaN,-30.44858113898797,-13.747332279588566
2011-08-15T09:30:00-04:00,67.85001,69.35001,67.83,69.22,29311248,30571213.7,44.10962878920152,37.877434054764706,NaN,NaN,-52.410380084343366,-120.55184808569766,-0.7145132861778127,-2.58952385922116,-1.875010573043347,310221552,263902169.6,15.75848799426278,21.05994608808989,NaN,NaN,-27.000079805847616,-15.640581926197001
2011-08-16T09:30:00-04:00,68.33,69.05,67.28999,68.07001,29945120,31090571.3,41.89473400114559,36.95210572510672,NaN,NaN,-54.1457309926713,-91.24296083338781,-0.48293750910726807,-2.478682459427432,-1.995744950320164,280276432,267617923.2,17.10360873352525,18.642225936260775,NaN,NaN,-25.132881557350295,-16.996624730647472
2011-08-17T09:30:00-04:00,68.83,69.60001,67.89999,68.34,21666880,31648027.4,42.62317521187653,36.18990497135942,NaN,NaN,-43.11073035203213,-68.21471831076751,-0.27704895935194873,-2.3420561495100998,-2.065007190158151,301943312,285541788.8,23.453008840757576,17.18731326778075,NaN,NaN,-23.465937880633696,-17.92081232350265
2011-08-18T09:30:00-04:00,66.21001,66.36,63.66,64.38,37248368,32642379.4,35.577987316722925,35.18890242122362,NaN,NaN,-82.79597161742069,-62.59350404798083,-0.3673703131788706,-2.5242200816317393,-2.1568497684528687,264694944,287609308.8,24.174473774116862,16.344776620265563,NaN,NaN,-24.470693044978766,-18.856509569427807
2011-08-19T09:30:00-04:00,63.39,65.48,63,63.24001,27319584,33433371.5,33.843722378865095,34.101478627817166,NaN,NaN,-87.40315263039892,-63.97319313537328,-0.4578117400175672,-2.7291144434748276,-2.2713027034572604,237375360,278902320,23.183484915945016,15.871078756812755,NaN,NaN,-25.852372188796295,-19.855918515051876
2011-08-22T09:30:00-04:00,65.17,65.19,62.5,62.73,24532416,33885772,33.06713038485364,33.59054596691165,NaN,NaN,-88.1660058624319,-71.12431829099098,-0.5023400398384457,-2.8992277532553175,-2.396887713416872,212842944,259426598.4,21.09993846750004,15.608210391925358,NaN,NaN,-27.184366320946175,-20.90283963017963
2011-08-23T09:30:00-04:00,63.14,65.6087,62.71001,65.56,35856816,34830144.8,41.138357845030804,33.7647460627857,NaN,NaN,-68.01125305604413,-73.89742270366555,-0.3014600641821188,-2.7737127936445205,-2.4722527294624017,248699760,253111264,20.457882876017308,15.59616403403599,NaN,NaN,-25.653228637448354,-21.58146663121802
2011-08-24T09:30:00-04:00,65.17999,66.07001,64.60001,65.95,18867920,34584319.2,42.17324224275214,34.90767481927403,NaN,NaN,-49.72927295217863,-75.22113122369487,-0.1123214073170935,-2.6126544886087686,-2.500333081291675,267567680,246236137.6,19.75319341137653,15.811627790210464,NaN,NaN,-24.122305715935386,-21.9444436433205
2011-08-25T09:30:00-04:00,66.42,66.81,64.22,64.55901,26792608,34946246.4,39.50540075951826,35.94142682806173,NaN,NaN,-50.890700860848284,-68.84007707238038,-0.053859560408054286,-2.5676575318017427,-2.5137979713936884,240775072,241452163.2,19.256144340070747,16.243312364660337,NaN,NaN,-23.664544039425202,-22.19017227133546
2011-08-26T09:30:00-04:00,63.92,66.10001,63.11,65.81,23836256,35271280,42.99783998521359,37.74573200186676,NaN,NaN,-49.68920323421353,-61.297287193143305,0.08835967531831779,-2.4033483772457913,-2.491708052564109,264611328,246899356.8,21.67295344807006,17.044890727286674,NaN,NaN,-22.2136842743336,-22.19353112890662
2011-08-29T09:30:00-04:00,66.85001,67.82001,66.32899,67.73,35543184,35949154.4,47.963243487573365,39.04310718266613,NaN,NaN,13.826969499420615,-40.8986921207728,0.31811431805948764,-2.0940651549897495,-2.412179473049237,300154512,264361670.4,29.008812244391024,18.46908056069307,NaN,NaN,-19.42039886009372,-21.797369376219063
2011-08-30T09:30:00-04:00,67.27,68.60001,66.71001,68.13,19838768,35581037.6,48.96073923952539,40.62712088112689,NaN,NaN,44.71375297278174,-18.35369091500762,0.4929624441692355,-1.795976417837693,-2.2889388620069284,319993280,278620374.4,34.41058055273113,20.365761417108104,NaN,NaN,-16.865078723078618,-21.09275642577043
2011-08-31T09:30:00-04:00,68.75,69.64,67.99001,68.64,24485248,35027095.2,50.269671090364454,41.59047406291064,NaN,NaN,93.90606067294831,10.373375810017766,0.6301267835705167,-1.5012803825437828,-2.1314071661142995,344478528,294002544,39.73777893257134,22.677193752223616,NaN,NaN,-14.379255486431186,-20.13368486300768
2011-09-01T09:30:00-04:00,68.75,69.64999,67.96001,68.12,21294176,33365318.4,48.8928550738692,42.358409129036616,NaN,NaN,93.13777597172069,39.179071176531565,0.669312894060976,-1.2947660485380794,-1.9640789425990555,323184352,310484400,44.901666193988746,25.283715337523173,NaN,NaN,-12.677711580380857,-19.06854582263242
2011-09-02T09:30:00-04:00,66.31,66.89999,65.64999,66.22,20854704,31087572,44.136218928954584,42.36030842473326,NaN,NaN,7.873458773151653,50.6916035780046,0.5554400726179409,-1.2697788518266293,-1.8252189244445702,302329648,318028064,47.13454176918397,27.524862035731832,NaN,NaN,-12.51418728172796,-18.132208888217498
2011-09-06T09:30:00-04:00,64.11,65.60001,63.57001,65.5,19355680,29255504.8,42.45081446749717,42.4000284580441,NaN,NaN,-50.68751920310297,37.78870583749988,0.4256411623745975,-1.2931674714763233,-1.7188086338509208,282973968,314591955.2,46.21581592013578,29.604305406204013,NaN,NaN,-12.851874080043446,-17.377875344192635
2011-09-07T09:30:00-04:00,66.71001,67.94,66.61,67.89999,18525680,27661732.8,49.38857349730209,42.883271192717345,NaN,NaN,49.68420898483878,38.782797039911294,0.4908047121953767,-1.1053027436066998,-1.5961074558020765,301499648,310893228.8,45.194633110653335,31.15727856833942,NaN,NaN,-11.09218403003903,-16.47991944217069
2011-09-08T09:30:00-04:00,67.57001,68.56,66.73,67.11,18491824,26117640,47.36448411725443,43.72516382132674,NaN,NaN,43.23024508780697,28.647633922883024,0.4700552595308234,-1.0085383813885471,-1.4785936409193705,283007824,298599088,41.882016939883734,32.42210308017991,NaN,NaN,-10.212707117842491,-15.58460339583809
2011-09-09T09:30:00-04:00,66.23,66.55,64.42,64.89,35041360,25768040,42.138176102447034,44.31762480158259,NaN,NaN,-49.99881452128829,0.02031582428122789,0.30421367346067396,-1.0983265490935281,-1.402540222554202,247966464,283555510.4,38.19303867489783,33.49421406296226,NaN,NaN,-11.020320699935732,-14.932563010709183
2011-09-12T09:30:00-04:00,63.75999,65.34,63.34,65.19501,25761472,25728465.6,43.06767082642274,45.031949118837524,NaN,NaN,-70.96090847436759,-15.746557625222618,0.2165717138739589,-1.1318255802117534,-1.3483972940857123,273727936,277835168,36.8634123049078,34.620176479919955,NaN,NaN,-11.407173651022138,-14.428935959325319
2011-09-13T09:30:00-04:00,65.49001,65.83,64.19,65.38,28204528,25673129.6,43.65882339321457,45.21198237227922,NaN,NaN,-44.62217044123381,-14.533487872848786,0.1743850947762764,-1.1304159256153667,-1.3048010203916431,301932464,281626867.2,38.394367095581934,35.901353924174565,NaN,NaN,-11.561196225016465,-14.019258854424054
2011-09-14T09:30:00-04:00,65.77,67.12,64.48,66.19,25715824,25461664.8,46.28865595202675,45.50594049437027,NaN,NaN,-4.941424747090011,-25.45861461923455,0.20238971392123495,-1.0518138779900994,-1.2542035919113343,327648288,286856595.2,40.53609642280383,37.385846996419374,NaN,NaN,-10.970734027789566,-13.583755307761985
2011-09-15T09:30:00-04:00,67.00999,67.57001,66.45,67.505,17331184,25244880,50.34116617688027,46.27992373846756,NaN,NaN,61.61419970414022,-21.781823695967898,0.30468742608607036,-0.8733443093037465,-1.1780317353898169,344979472,299250924.8,45.38234649747651,39.252004293376935,NaN,NaN,-9.311411726933272,-12.97342051050074
2011-09-16T09:30:00-04:00,67.50999,67.75999,66.32001,67.09,23036368,24534280,49.082553010064025,46.71454609738544,NaN,NaN,49.574304203279475,-1.8671999510543458,0.3370889918682063,-0.7566704955545589,-1.0937594874227652,321943104,314046252.8,50.561987368704834,41.315506716279415,NaN,NaN,-8.259934088348533,-12.300065307336139
2011-09-19T09:30:00-04:00,65.45,66.63,64.75,66.03,20859824,24211292,45.92425184429273,46.568903837151105,NaN,NaN,-19.758418531028916,8.373298037613388,0.28205177643073354,-0.7411947668843482,-1.0232465433150817,301083280,319517321.6,52.36110896332061,42.98352791048867,NaN,NaN,-8.209616696638431,-11.715715505807895
2011-09-20T09:30:00-04:00,66.34,67.17,65.52,65.62,20134400,23991391.2,44.72545971114829,46.26638387083846,NaN,NaN,-11.748243048214835,14.948083516217185,0.21593339710320802,-0.7533297969360717,-0.9692631940392797,280948880,315320604.8,50.83295524800814,44.156554674437025,NaN,NaN,-8.490674744681959,-11.254995397075618
2011-09-21T09:30:00-04:00,65.44,65.67999,62.83,62.89,26782832,23537692,37.673617417864406,45.36666575137417,NaN,NaN,-142.04093756741577,-12.47181904784797,-0.002213542320810391,-0.9720301219402927,-0.9698165796194823,254166048,300624156.8,45.79281156977687,44.58905700566599,NaN,NaN,-10.87311569720333,-11.200441154236719
2011-09-22T09:30:00-04:00,60.67,60.7,58.25999,59.34,38065968,24497594.4,30.85978994408987,44.07858967067564,NaN,NaN,-301.09533289360843,-85.0137255673977,-0.35653885411509845,-1.4154901472633554,-1.058951293148257,216100080,274848278.4,38.569626158175666,44.13676843167934,NaN,NaN,-15.428327353699478,-11.804424897017114
2011-09-23T09:30:00-04:00,58.58,59.58,58.37,58.7,32795328,24797730.4,29.81291558092026,43.055496574387476,NaN,NaN,-249.49192336598364,-144.82697108125032,-0.5911217872802106,-1.7978535272485203,-1.2067317399683097,183304752,247120608,32.61060529570888,43.09934439785969,NaN,NaN,-19.414368528172453,-12.891559701467877
2011-09-26T09:30:00-04:00,59.13,60.97,57.95,60.84,34397552,25325795.2,37.45344537002376,42.69854163885366,NaN,NaN,-172.62479892541592,-175.40024716012772,-0.5595949007915142,-1.9062253659577024,-1.3466304651661882,217702304,230444412.8,29.644156574550394,41.9156544446036,NaN,NaN,-20.38023384798529,-13.961370293827507
2011-09-27T09:30:00-04:00,62.64,63.33,61.375,61.73,32486608,25172966.4,40.36118932764871,42.05372848387841,NaN,NaN,-89.5803510875447,-190.9666687679937,-0.4414248760319519,-1.898411560206128,-1.456986684174176,250188912,224292419.2,28.61019961293313,40.73105205190929,NaN,NaN,-20.24248287586153,-14.858672091260939
2011-09-28T09:30:00-04:00,61.84,62.41,59.59,59.71001,23093536,25335704.8,36.242876559197825,41.25932794401723,NaN,NaN,-116.63453937273219,-185.885389129057,-0.45984594567454407,-2.0317941162673563,-1.5719481705928122,227095376,218878284.8,27.694700603856006,39.7176723136216,NaN,NaN,-21.457912600620876,-15.801420735455215
2011-09-29T09:30:00-04:00,61.25,61.33,59.06,60.28,22869472,25254916,38.16033174533817,40.975196204223735,NaN,NaN,-108.0344723107762,-147.27321701249053,-0.396579449307205,-2.0676724822268184,-1.6710930329196134,249964848,225651238.4,30.682910245760624,39.18123456868323,NaN,NaN,-21.840741526713764,-16.66418084849215
2011-09-30T09:30:00-04:00,59.23,59.96001,58.50999,58.50999,29734400,25676927.2,34.67308878184903,40.3755832010399,NaN,NaN,-120.57107721397601,-121.48904778208903,-0.4338587519470545,-2.2134164728534316,-1.779557720906377,220230448,233036377.6,33.89114287741059,38.96892960957628,NaN,NaN,-23.269914423181067,-17.60785707344771
2011-10-03T09:30:00-04:00,57.84,58.50999,56.47,56.52,35068720,26387628,31.218889618561363,39.48701650285039,NaN,NaN,-139.07876038273244,-114.77984007355232,-0.5452537286936132,-2.4611248817733937,-1.9158711530797805,185161728,226528262.4,32.465128554795584,38.54541257094869,NaN,NaN,-25.619116518241427,-18.75232270841824
2011-10-04T09:30:00-04:00,55.5,58.53999,54.25999,58.37,41370336,27488360.8,37.456817340724626,38.856170887757386,NaN,NaN,-121.34325154888289,-121.13242016581997,-0.45096153093414015,-2.479573066747456,-2.0286115358133157,226532064,221796892.8,31.429759783717174,37.89495995387107,NaN,NaN,-25.583215447665392,-19.728164528310693
2011-10-05T09:30:00-04:00,58.8,60.7,57.92999,60.52,37564912,28440322.4,43.83224913944079,38.39124824222599,NaN,NaN,-60.32210692809329,-109.86993367689217,-0.21251841813962313,-2.2942595584878447,-2.0817411403482216,264096976,229197212.8,34.925484199797495,37.14804121832257,NaN,NaN,-23.4289088356586,-20.25684228650325
2011-10-06T09:30:00-04:00,60.39999,61.78,59.72,61.66,23819312,28706696.8,46.92181034601358,38.23690948050811,NaN,NaN,-27.6216672595253,-93.787372666642,0.03980464555746188,-2.031985333401394,-2.071789978958856,287916288,236787500.8,38.39455417606334,36.2789388474196,NaN,NaN,-20.66760963223574,-20.315523335893605
2011-10-07T09:30:00-04:00,62.13,62.17999,60.28999,60.89999,24391840,28174220.8,45.139174951769675,38.1808325596136,NaN,NaN,-22.41924886959745,-74.15700699776627,0.16625527936876816,-1.863970879747896,-2.030226159116664,263524448,245446300.8,42.18120523504787,35.551802866828695,NaN,NaN,-18.978122982883878,-20.1244661426065
2011-10-10T09:30:00-04:00,62.03,63.69,62.0201,63.66,17907952,27781544.8,52.23600552448883,38.71730011770935,NaN,NaN,26.17875516310177,-41.10550388859944,0.43144328508750407,-1.4909220527572842,-1.9223653378447882,281432400,264700435.2,49.59976674729296,35.46371797392047,NaN,NaN,-15.136827459918889,-19.411946330793985
2011-10-11T09:30:00-04:00,63.07001,64.33501,62.91,63.78999,22428176,27492727.2,52.54735383229383,39.77970986159717,NaN,NaN,42.28367771580235,-8.380118035662399,0.600862515553644,-1.1712871934027334,-1.7721497089563774,303860576,280166137.6,54.63481552416292,36.09528968494804,NaN,NaN,-12.0189609294701,-18.355805559176286
2011-10-12T09:30:00-04:00,64.3,65.095,63.84,64.13,18631488,27138510.4,53.40295366081554,41.38993584136329,NaN,NaN,62.73254885589196,16.230813121134652,0.7134079955679571,-0.880389714496431,-1.593797710064388,322492064,291845155.2,58.04353580647094,37.486283231254845,NaN,NaN,-9.234612275228026,-17.052777947183678
2011-10-13T09:30:00-04:00,63.48,64.36,62.78,64.03999,15159430,27029922.7,53.12984682415958,43.0554309301661,NaN,NaN,55.18971532608329,32.793089638256376,0.7553374176673984,-0.6496259379801401,-1.4049633556475385,307332634,295728424.4,59.14282728794854,39.38144194498625,NaN,NaN,-7.038209082122745,-15.622125252174973
2011-10-14T09:30:00-04:00,65.13,66.62,65.12,66.60001,16616801,26708944.35,59.47734349807586,44.628566510741244,NaN,NaN,123.97911515228432,62.07276244263274,0.9182052100174531,-0.2572068431257222,-1.1754120531431753,323949435,307813421.8,62.440918696941615,41.72406781087134,NaN,NaN,-3.089664788502378,-13.831773757364601
2011-10-17T09:30:00-04:00,66.42,66.64,65.24001,65.39,18806384,26606272.35,55.64171198810872,45.720032415059826,NaN,NaN,114.26016673663645,79.68904475733966,0.9056497485438048,-0.0433498674634194,-0.9489996160072242,305143051,312555552,63.67986760325588,44.22904409589439,NaN,NaN,-0.8694958078607296,-11.980019764578334
2011-10-18T09:30:00-04:00,65.31,67.94,64.59,67.49001,24455888,26822346.75,60.41318981675598,47.44648336202827,NaN,NaN,137.16082746164622,98.66447470650844,0.9929741527427066,0.29221807492115914,-0.7007560778215475,329598939,317703224.6,65.0284438934261,46.895740045149395,NaN,NaN,2.577818952058459,-9.900328519344505
2011-10-19T09:30:00-04:00,67.19,68.24001,66.48,66.78999,24029552,26684682.75,58.16708906635881,48.87553745638688,NaN,NaN,135.8048332901811,113.27893159336627,0.9573690700142796,0.49595525969630216,-0.4614138103179775,305569387,314318689.2,63.36260144869961,49.23000370250218,NaN,NaN,4.73828543499165,-7.80909795443934
2011-10-20T09:30:00-04:00,66.75,67.61,65.92,67.31,21877456,25875257.15,59.37538321843791,50.63998705900037,NaN,NaN,114.31913008130935,125.10481454441148,0.9222580703119996,0.6914087775720219,-0.23084929273997762,327446843,318341531,64.52582047707088,51.41819495962078,NaN,NaN,6.871698093857721,-5.711841376111189
2011-10-21T09:30:00-04:00,68.0401,68.83,67.71001,68.55,24171072,25444044.35,62.18058476894116,52.851536712598936,NaN,NaN,130.47387493537252,126.40376650102912,0.9331433959773126,0.935579952231663,0.0024365562543505193,351617915,323875227,66.11933428289511,53.82206679734217,NaN,NaN,9.532445259994756,-3.5340861423817684
2011-10-24T09:30:00-04:00,68.75999,69.63,68.57001,69.45,22973888,24872861.15,64.11729850568597,54.75585679581046,NaN,NaN,132.79086320569613,130.10990579484104,0.9484628722746733,1.1880151465976923,0.2395522743230189,374591803,337764977.4,69.78783905537844,56.56192960246083,NaN,NaN,12.350277868481315,-1.2648912836870423
2011-10-25T09:30:00-04:00,69.28,69.41251,67.5,68,21924320,24344746.75,58.88529911091755,55.83107465091593,NaN,NaN,100.24442316060563,122.72662493463292,0.8136252673109413,1.2565838584616955,0.4429585911507542,352667483,342378686.2,70.91440227551038,59.132566607868895,NaN,NaN,13.270624628394087,0.8116109894674044
2011-10-26T09:30:00-04:00,69.03999,69.71001,67.49001,69.47,18187680,24099453.95,62.24855609228093,56.92584220422075,NaN,NaN,101.27208883978035,115.82007604455278,0.7762336846835309,1.413250697005168,0.637017012321637,370855163,355435841.4,73.88256293913759,61.667424376659916,NaN,NaN,15.07093939117428,2.848657903996958
2011-10-27T09:30:00-04:00,71.37,73.19,71.17999,72.55,31190240,24515492.35,68.13090422666097,58.56810858099869,NaN,NaN,149.4906899756278,122.8543880234165,0.902856754724438,1.7655879557271845,0.8627312010027465,402045403,370355553.4,76.79637661224888,64.13993661788855,NaN,NaN,18.644678014399478,5.105232205483032
2011-10-28T09:30:00-04:00,71.8,73.17,71.60001,73.03999,17512528,23904398.75,68.95954522298223,59.76264713089108,NaN,NaN,139.62631082502202,124.6848752013464,0.9582970603622234,2.0606025264555257,1.1023054660933023,419557931,383943556.6,79.0849745461091,66.24602288923256,NaN,NaN,21.766471643712094,7.485409268087183
2011-10-31T09:30:00-04:00,71.8,71.85001,69.60001,69.71001,21955952,23248760.35,57.93465675948704,60.147454482833446,NaN,NaN,92.47165388143034,116.62103333649324,0.7202494017814471,2.002617218320111,1.282367816538664,397601979,388545591.8,79.81125118865494,68.04433972241057,NaN,NaN,20.908621377189554,9.403010997958951
2011-11-01T09:30:00-04:00,66.98,68.48,66.34,67.46001,41749408,23267713.95,51.89725870503171,60.0399048431346,NaN,NaN,25.28552450496302,101.62925360536471,0.3780082311447721,1.7548781054696292,1.376869874324857,355852571,389182609.4,79.91521853737595,69.60660277461807,NaN,NaN,18.09859773261303,10.645237674338105
2011-11-02T09:30:00-04:00,69.13,69.67999,68.44,69.49001,20310944,22405015.55,56.32000618357613,60.267773368807205,NaN,NaN,61.5911838368329,93.69307260477521,0.2606794773243535,1.702719220980299,1.4420397436559456,376163515,390244279.8,80.0991609644383,71.1034837515102,NaN,NaN,17.256751684587663,11.589739675802328
2011-11-03T09:30:00-04:00,70.5,71.56,69.575,71.32001,19714464,22199773.15,59.89942602280286,60.297922120573425,NaN,NaN,95.77243061597042,82.94942073284375,0.27711436221620245,1.7884326964261987,1.5113183342099963,395877979,389010795,79.19170972607996,72.29996882502009,NaN,NaN,17.76981986135887,12.472608273738976
2011-11-04T09:30:00-04:00,70.7,71.46001,70,71.25999,12554832,21607922.75,59.726553046669544,60.589696481899196,NaN,NaN,90.03583840047372,73.03132624793409,0.2552798999425643,1.8304182091382017,1.5751383091956375,383323147,381763838.2,73.89487749078998,73.02961238841537,NaN,NaN,18.1124759771523,13.27830365994088
2011-11-07T09:30:00-05:00,71.28,72.14999,70.39999,71.64999,13471793,21386114.8,60.52380039503816,60.59759723749078,NaN,NaN,96.3168579542266,73.80036706249334,0.2387409413996462,1.8735644859451952,1.634823544545549,396794940,381602430.4,73.77651661402776,73.6544747256012,NaN,NaN,18.626457230919264,14.042325598652077
2011-11-08T09:30:00-05:00,72.23,72.89999,71.27,72.82001,19152656,21222338.8,62.89680690662112,60.93543422608094,NaN,NaN,113.6704281010611,91.47734778171295,0.2756230167735949,1.9793523155125428,1.7037292987389479,415947596,393621435.4,76.7614311424074,74.61153398943748,NaN,NaN,19.76554390150954,14.859928213346
2011-11-09T09:30:00-05:00,70.67,71.35001,69.42,69.60001,25275056,21554517.2,53.38561186065783,60.507593414810934,NaN,NaN,39.743582678913086,87.10782755012899,0.063265920812547,1.7828116997546317,1.7195457789420847,390672540,396523240.4,77.42941912249607,75.53321960696783,NaN,NaN,17.74009908516519,15.271381195034456
2011-11-10T09:30:00-05:00,70.73,71.33,69.45,70.81,20355328,21814312.1,56.073689508199266,60.07138661047223,NaN,NaN,46.68410147097963,77.29016172113083,-0.011609932597702155,1.705033363194957,1.7166432957926592,411027868,399553218.2,78.13613068552125,76.39156220715542,NaN,NaN,16.911310197723225,15.505656766847137
2011-11-11T09:30:00-05:00,71.60001,72.55,71.5,72.25999,14401473,21703545.7,59.11625804147275,59.714169434457,NaN,NaN,94.88375456213804,78.2597449534637,0.018952610031946815,1.7403340583325928,1.721381448300646,425429341,407974457,80.0095825692455,77.12168674386021,NaN,NaN,17.166356430086665,15.742899575881355
2011-11-14T09:30:00-05:00,71.82001,71.98,70.64999,71.31,15382500,21532351.5,56.36178158281825,59.53391818244991,NaN,NaN,59.22541490390049,70.84145634339846,-0.03920455600972339,1.6723757532884918,1.7115803092982151,410046841,410624837.2,80.57376686863012,77.81164135765448,NaN,NaN,16.531340094150558,15.855533935634098
2011-11-15T09:30:00-05:00,71.09,71.82001,70.66,71.23,16675867,21143350.45,56.12462171898168,59.096494298642824,NaN,NaN,51.07643819436566,58.32265836205937,-0.094310737458001,1.593691887475714,1.688002624933715,393370974,406109512.8,76.6070314935839,78.00624625440064,NaN,NaN,15.95237221629893,15.869367975729073
2011-11-16T09:30:00-05:00,70.67,71.98,70.07001,70.16,21946784,21039212.05,52.91736889445443,58.009813203485216,NaN,NaN,23.526289902752918,55.07919980682734,-0.20758039771208026,1.4285271277936147,1.636107525505695,371424190,402259842.8,73.2939879583026,77.75607563626161,NaN,NaN,14.530838891675396,15.678149535149977
2011-11-17T09:30:00-05:00,70.13,70.5,67.91,68.56,25537408,21222209.65,48.45806823392767,56.545421989981314,NaN,NaN,-73.87619197535996,30.96714111755943,-0.38471826101581574,1.1552096992359253,1.539927960251741,345886782,389231625.6,63.314507879479685,76.62961373150237,NaN,NaN,11.965077546747303,15.14771067966388
2011-11-18T09:30:00-05:00,68.95,69.32001,67.73,68.14999,26953392,21361325.65,47.356758122288035,55.789857801609955,NaN,NaN,-105.9915997220574,-9.20792973927966,-0.5157823846538201,0.8951999794344658,1.410982364088286,318933390,367932435.4,51.07166298508818,74.57678600267617,NaN,NaN,9.5290067698614,14.34503869254924
2011-11-21T09:30:00-05:00,66.92,67.35001,65.98,66.92999,20014864,21213374.45,44.1420186386938,55.23591208258581,NaN,NaN,-168.17497466688263,-54.68800765343629,-0.6616138800606923,0.5839650140124206,1.245578894073113,298918526,345706772.4,41.954943898402256,71.86533781417806,NaN,NaN,6.485737076383899,13.222281318811334
2011-11-22T09:30:00-05:00,66.86,67.3,65.88,66.3,18698480,21052082.45,42.53625514322458,54.251358436846424,NaN,NaN,-163.49395041575445,-97.6020853754603,-0.7698955383439572,0.2832094711431665,1.0531050094871237,280220046,323076586.8,35.087050973841,68.65018710056397,NaN,NaN,3.4642365996308224,11.828274930356976
2011-11-23T09:30:00-05:00,65.35001,65.505,64.28,64.28999,21790416,21232219.25,37.810308081283104,52.67356429816643,NaN,NaN,-198.6520361778423,-142.03775059157937,-0.935280287481144,-0.11599534986430626,0.8192849376168377,258429630,300477674.8,29.83477809568747,65.12469198410736,NaN,NaN,-0.6794512039765678,10.04145691116647
2011-11-25T09:30:00-05:00,64.00999,64.92999,63.83,63.83,7149797,20030197.1,36.80258144416291,51.03613775513025,NaN,NaN,-176.94470207983417,-162.6514526124742,-1.0267360576261657,-0.4641351344158693,0.5626009232102964,251279833,281556285,26.286746808835574,61.72411122111061,NaN,NaN,-4.405915522491847,7.977546563500997
2011-11-28T09:30:00-05:00,66.16,66.78,65.61,66.22,21851248,20247133.1,45.00414532551476,49.92759096445001,NaN,NaN,-97.60460442384834,-160.97405355283237,-0.8828404705203404,-0.5409496649401291,0.34189080558021134,273131081,272395823.2,24.75204257624982,58.222363075555045,NaN,NaN,-5.335184050409891,6.07572790437087
2011-11-29T09:30:00-05:00,66.50999,67.89,66.28,67.17,14477496,19873210.3,47.89853913938435,48.856286123933096,NaN,NaN,-60.945801711658,-139.52821896178745,-0.6888597205402829,-0.5191838450951423,0.16967587544514062,287608577,270133833.4,24.37362960611128,54.48037725153389,NaN,NaN,-5.243243047706985,4.458732054074034
2011-11-30T09:30:00-05:00,69.6501,71.07001,69.63,70.87,33001984,19435839.1,57.31994011675918,49.13730957079748,NaN,NaN,42.338326077890365,-98.3617636630585,-0.2965867260897685,-0.20105753216707,0.0955291939226985,320610561,278211936.4,28.57333449196625,50.99065692078176,NaN,NaN,-1.9841560269931706,3.5383194710644332
2011-12-01T09:30:00-05:00,70.67999,71.39,70.09,70.48,16332551,19236919.45,56.16703217624172,49.14397690422908,NaN,NaN,42.98306647327236,-50.03474313283556,-0.0609298568059765,0.019366872915227873,0.08029672972120437,304278010,287381612.4,33.11390716498593,47.774783812172096,NaN,NaN,0.23054245289975275,3.0657798970409074
2011-12-02T09:30:00-05:00,71.16,71.53999,70.28,70.42,14939875,18998190,55.98048148673526,48.919992864604964,NaN,NaN,46.068948087224825,-5.432013099423753,0.08540823741784084,0.18705702649350542,0.10164878907566458,289338135,294993272.8,36.71050580999592,44.68199261508284,NaN,NaN,1.9372966413989197,2.9045680033777663
2011-12-05T09:30:00-05:00,71.7,72.16499,70.67999,71.28999,14862711,19113583.95,58.150927143124996,49.04778897605545,NaN,NaN,64.49837023605974,26.988581832557873,0.22724689563922573,0.38570740862469677,0.15846051298547104,304200846,301207225.8,39.56744093145105,41.75296933385575,NaN,NaN,4.016030962669541,3.063348426133734
2011-12-06T09:30:00-05:00,71.24001,71.86501,70.7,71.28,13859746,19132981.6,58.115492222853064,49.18999401204626,NaN,NaN,61.82401240738836,51.542544656367134,0.3021537682528672,0.5361527233015551,0.23399895504868784,290341100,301753730.4,39.824715846848534,39.12566107337466,NaN,NaN,5.698361123087407,3.4397788114128303
2011-12-07T09:30:00-05:00,71,71.14999,70,70.60001,17144592,19032578.4,55.63058507588665,49.38379516786285,NaN,NaN,44.29953534934786,51.93478651065864,0.2877358479764915,0.5936687650193022,0.3059329170428107,273196508,292270919.8,36.89001880989564,36.52537756277416,NaN,NaN,6.463416417688475,3.8717270408807796
2011-12-08T09:30:00-05:00,70.09,70.46001,68.42999,68.63,17146672,18626159.2,49.0827501593993,49.42841530539654,NaN,NaN,0.5964562143173645,43.45746445886765,0.13510481835226018,0.4748139399831359,0.33970912163087574,256049836,282625285,34.13462225751343,34.441100018348,NaN,NaN,5.263882480620934,4.0706063894150875
2011-12-09T09:30:00-05:00,69.06,70.48,68.91,70.192,15518305,18384308.05,53.73277067617365,49.88384477353123,NaN,NaN,24.474387030388392,39.13855224750036,0.12894235577610924,0.5008870663510123,0.3719447105749031,271568141,279071286.2,33.15206698456733,33.161128875453656,NaN,NaN,5.593482497098812,4.288160119084191
2011-12-12T09:30:00-05:00,69.34,69.39,67.59,68.55,19315104,18629989.6,48.69801924198915,50.209273388052324,NaN,NaN,-15.018634323870444,23.235151335514317,0.010140919346262822,0.38462085975773164,0.3744799404114688,252253037,268681724.4,30.39743570173502,32.33559257569171,NaN,NaN,4.33844185349379,4.295343223999848
2011-12-13T09:30:00-05:00,69.0799,69.965,67.48,67.91,18642496,18792989.4,46.855178110960516,50.517767885747745,NaN,NaN,-12.595805410168836,8.351187772002879,-0.10911049016899038,0.23809182770023085,0.34720231786922123,233610541,257335612.6,27.69140700353357,31.80733229209833,NaN,NaN,2.7500437708586367,4.074586159265389
2011-12-14T09:30:00-05:00,67.11,67.42,65.71001,66,26684288,19293410.45,41.774455606574264,50.8009212804114,NaN,NaN,-79.09107296240995,-16.326933890348688,-0.30319232632690735,-0.031788090039412964,0.2714042362874944,206926253,244081561.6,24.902554124543656,31.45503057987377,NaN,NaN,-0.24042053929928378,3.4581566308990075
2011-12-15T09:30:00-05:00,66.92,66.99001,65.55,65.72,17749904,19083566.45,41.07135692857579,51.105833815012325,NaN,NaN,-79.85949152814946,-32.41812343884205,-0.4292885049777506,-0.2652063949346939,0.16408211004305673,189176349,230706864.2,22.445932629094415,31.180686709892257,NaN,NaN,-2.870819783379547,2.5540171431449283
2011-12-16T09:30:00-05:00,65.97,66.50999,65.46001,66.14,21970560,18905224.05,42.6311170708429,50.93633179682148,NaN,NaN,-72.64640116927833,-51.8422810787754,-0.4605116205439478,-0.411557415636878,0.04895420490706978,211146909,218622617.8,20.480099260840674,30.87554790164875,NaN,NaN,-4.608721424309364,1.5307687763657438
2011-12-19T09:30:00-05:00,66.42,66.42,64.8,64.98,12540688,18184588.85,39.51983170598811,50.33785269443604,NaN,NaN,-83.73302140862751,-65.5851584957268,-0.5304156805503741,-0.6140653957808979,-0.08364971523052378,198606221,207893254.6,18.8975622007994,30.484400229840755,NaN,NaN,-7.024962124557198,0.3085215048053236
2011-12-20T09:30:00-05:00,66.28999,67.78,66.21001,67.64999,12665219,17817106.6,48.78487945023487,49.72820550397002,NaN,NaN,-26.9360096737931,-68.45319934845166,-0.37526978194793886,-0.5527369426654474,-0.1774671607175085,211271440,203425434.4,18.26465543345458,29.748066011375634,NaN,NaN,-6.362805937073753,-0.6445252726059729
2011-12-21T09:30:00-05:00,67.66,68.58,67.23,68.39999,12027406,17483552.9,51.05315437415306,49.362928518106536,NaN,NaN,-1.9287699330729664,-53.020738742584264,-0.208873894213835,-0.4385595284848023,-0.22968563427096728,223298846,206699953,20.36964083453684,28.83776127348641,NaN,NaN,-5.117502881040841,-1.283522073810954
2011-12-22T09:30:00-05:00,68.78,69.35001,68.55,69.2,10988789,16943471.55,53.42283272078147,49.18023932053841,NaN,NaN,24.94701036038433,-32.05943836487751,-0.04048189140840813,-0.28028799853147746,-0.23980610712306932,234287635,215722210.2,26.022779343089823,28.074352240135973,NaN,NaN,-3.361196639416559,-1.5803327260403262
2011-12-23T09:30:00-05:00,69.46001,69.67999,69.05,69.60001,5214668,16846715.1,54.606204755287415,48.927044864264296,NaN,NaN,33.5738557589351,-10.815386979234827,0.0948990515029863,-0.12118229274433645,-0.21608134424732275,239502303,221393289,29.414809499595933,27.349164280717755,NaN,NaN,-1.5694016861934872,-1.5787711489193492
2011-12-27T09:30:00-05:00,69.45,70.10001,69.45,69.78,5630207,16035663.05,55.15827300596938,48.715814920201176,NaN,NaN,41.78428626698922,14.288074555888523,0.188234952341868,0.01921234618001222,-0.16902260616185577,245132510,230698546.8,34.70519967514633,26.983484554167596,NaN,NaN,0.061605147072701885,-1.3444316780633419
2011-12-28T09:30:00-05:00,69.8,69.97,68.36,68.45,11320625,15877819.5,50.291114552041286,48.33442416849794,NaN,NaN,2.2595479146168342,20.127186073570503,0.1535319534848291,0.022892335694180588,-0.1306396177906485,233811885,235206635.8,37.16241030460021,27.00294108950364,NaN,NaN,0.1290803931068054,-1.1339299536104637
2011-12-29T09:30:00-05:00,68.61,69.24001,68.55,69.16,7702422,14612841.4,52.69104981617029,48.59215985826729,NaN,NaN,8.611118817812471,22.23516382374759,0.1702339451778806,0.08215281368170224,-0.08808113149617836,241514307,238849728,39.15514735413975,27.361550024976946,NaN,NaN,0.8675691040402784,-0.8480015168032149
2011-12-30T09:30:00-05:00,69,69.46001,68.92999,69.13,6586246,14125526.15,52.57554585425989,48.50950094241631,NaN,NaN,21.871135705376677,21.619988892746058,0.17066697424337188,0.12525258630803648,-0.045414387935335386,234928061,238977813.2,39.2281177389568,27.79555365029048,NaN,NaN,1.4444089060773757,-0.5205143135345591
2012-01-03T09:30:00-05:00,70.60001,71.39999,70.49001,71.05,24256144,14591339.6,58.80025688770339,49.23108934568161,NaN,NaN,108.7491830861145,36.65505435818194,0.28493569250468687,0.3107552276955232,0.02581953519083633,259184205,242914193.6,41.54820047426842,28.59203684832858,NaN,NaN,3.8017981263512968,0.09695889216342024
2012-01-04T09:30:00-05:00,70.78,71.32001,70.36,71.2,14018496,14549128.85,59.25026091491653,50.116452403107054,NaN,NaN,110.13395055005712,50.32498721479552,0.350957569321768,0.4645164968430464,0.11355892752127836,273202701,248528231.8,44.78573962944251,29.813060607322075,NaN,NaN,5.866715524506041,0.9212098396409375
2012-01-05T09:30:00-05:00,70.74001,70.91,70,70.86,12674652,14489874.15,57.711550214748925,51.25481630369095,NaN,NaN,95.61915082595297,68.99690779706275,0.35120772617695223,0.5525685852424687,0.20136085906551643,260528049,253871464.6,47.75194158004208,31.445159711286248,NaN,NaN,7.193738236550197,1.8172853249136889
2012-01-06T09:30:00-05:00,70.99001,71.02,70.28999,70.44,8894980,14077393.55,55.784318665551744,52.30574214204638,NaN,NaN,95.28499879650583,86.33168379280143,0.30431444297886423,0.5817539127890967,0.2774394698102325,251633069,255895217,48.87226641293391,33.3327549815605,NaN,NaN,7.81527639338324,2.6741411918379105
2012-01-09T09:30:00-05:00,70.59,70.94,70.38,70.78,12044586,13822289.25,57.035150039348665,53.33460163979679,NaN,NaN,93.03626291040085,100.56470923380625,0.27813861859772276,0.625112743057386,0.3469741244596632,263677655,261645135.8,52.020170726696165,35.58561722912161,NaN,NaN,8.675686528723284,3.531504811392964
2012-01-10T09:30:00-05:00,71.89,71.98,71.21001,71.41,13633559,13728051.95,59.330943713395285,54.7496810688973,NaN,NaN,123.03382396753021,103.4216374100894,0.28419346434039894,0.7022159548851619,0.4180224905447629,277311214,265270537.6,53.9455474754911,38.08904474874244,NaN,NaN,10.039507575789923,4.461219492021101
2012-01-11T09:30:00-05:00,71.08,71.09,70.17,70.45,13472781,13435935.8,54.54781283929343,55.161319168115774,NaN,NaN,72.27861268566521,95.85056983721101,0.20801464482411358,0.6780407965749049,0.4700261517507913,263838433,263397684,52.76751826015276,40.55353495064946,NaN,NaN,9.960866602590988,5.246883364959656
2012-01-12T09:30:00-05:00,70.07001,70.38,69.48,69.78999,19711840,13489403,51.47529897300052,55.191472353747734,NaN,NaN,38.45909055744612,84.41855778350964,0.1029573301689844,0.5987228144620218,0.4957654842930374,244126593,260117392.8,50.67999985478523,42.71856059495291,NaN,NaN,9.046391660839683,5.789670264371088
2012-01-13T09:30:00-05:00,69.35001,69.53999,68.74001,69.44,16217609,12966069.05,49.87111064021259,54.937777919421386,NaN,NaN,3.984858233807203,66.15852967096991,0.004856903818626412,0.5018366140663204,0.496979710247694,227908984,255372575.8,47.73814695702808,44.269658281662785,NaN,NaN,7.832038052792031,6.0814370912883655
2012-01-17T09:30:00-05:00,70.22,70.55,69.709,69.935,12527145,12704931.1,52.142745389066484,54.761816536119895,NaN,NaN,38.78388300383837,55.30805368965741,-0.02982627538403404,0.4596968660176515,0.4895231414016855,240436129,250724270.6,44.9833117460927,45.38169415641256,NaN,NaN,7.384086885905966,6.2675299190908795
2012-01-18T09:30:00-05:00,69.89,71.11011,69.55,71.08,15363039,12374555.05,56.99711644883999,54.89316249632493,NaN,NaN,61.49982691860201,43.00125427987177,0.01860685849059507,0.5127817145149294,0.4941748560243343,255799168,246421861.4,42.536537157339936,45.94107540514067,NaN,NaN,8.3396739185607,6.563550490443711
2012-01-19T09:30:00-05:00,71.45,71.63,71.03999,71.37,13304328,12412737.05,58.15484712859424,55.454857680364434,NaN,NaN,107.45911563685756,50.03735487011024,0.061990230903446464,0.5716626446536424,0.5096724137501959,269103496,247474874,43.34872919907904,46.38295532617487,NaN,NaN,9.463849700077006,6.977878948962753
2012-01-20T09:30:00-05:00,71.36,71.64,70.82001,71.38,15395375,12549244.85,58.196640541159994,55.84811416072084,NaN,NaN,96.32545619462367,61.61062799754576,0.08192404844818324,0.6120774743104249,0.5301534258622417,284498871,255549329.6,49.26977097516958,47.105428441962715,NaN,NaN,10.40974009561647,7.4681448270561415
2012-01-23T09:30:00-05:00,71.63,72.14999,71.42999,71.95,12987102,12597229.65,60.61149893161534,56.422110809103366,NaN,NaN,131.6108914787657,87.13583464653746,0.12166634590014103,0.682236358237418,0.560570012337277,297485973,269464727.4,57.51163661447243,48.41139407592812,NaN,NaN,11.887701091417762,8.09951000767923
2012-01-24T09:30:00-05:00,71.32001,71.78999,71.03,71.74001,10617195,12578649.95,59.25348928482205,56.45448455175471,NaN,NaN,97.06631426858772,98.79232089948732,0.12168641608643838,0.712678032445325,0.5909916163588866,286868778,278751257.2,61.953964680770895,49.86894866210687,NaN,NaN,12.798393692304646,8.77077910548286
2012-01-25T09:30:00-05:00,71.63,72.86,70.71001,72.62,19638464,13299839.75,62.99519601875175,56.72197991631437,NaN,NaN,133.4353640331584,113.17942832239859,0.1660909409087863,0.7986052924948694,0.6325143515860832,306507242,288892872,66.11999502166535,51.39282404726566,NaN,NaN,14.647175042567643,9.610264239352116
2012-01-26T09:30:00-05:00,73.07001,73.16,71.3501,71.63,16983696,13867514.2,56.688310132150804,56.64889133898593,NaN,NaN,119.33805609787245,115.55521641460157,0.11627007544759516,0.777851945895577,0.6615818704479819,289523546,292976882,67.65592739456665,52.8145373197317,NaN,NaN,14.530747619967205,10.313190436582843
2012-01-27T09:30:00-05:00,71.31,71.78999,71.2,71.48,9228199,13762892.9,55.777129562877555,56.64837783165206,NaN,NaN,65.18410984590902,109.32694714485865,0.0633440874842508,0.7407619798032954,0.6774178923190446,280295347,292136177.2,66.98274464096718,54.10814290744837,NaN,NaN,14.18220253234159,10.865906450262663
2012-01-30T09:30:00-05:00,70.66,71.19,70.13,71.14,13625902,14059066.9,53.671289843710014,56.40810210339216,NaN,NaN,-4.500534572305413,82.10466193464443,-0.001023393476045742,0.6761386504739875,0.6771620439500332,266669445,285972871.6,62.10406796969832,54.82842128194852,NaN,NaN,13.3087000419111,11.214876963355298
2012-01-31T09:30:00-05:00,71.64999,71.72459,70.34,70.69,14680891,14463799.15,50.93056206623168,55.808074842880465,NaN,NaN,-3.893015554422848,61.9127959700423,-0.07620554137333735,0.5819051172333616,0.6581106586066989,251988554,278996826.8,57.04000716922654,55.04945411721534,NaN,NaN,11.798245012450446,11.298215256083177
2012-02-01T09:30:00-05:00,71.33,71.58,70.82001,70.97,12779988,13889991.35,52.55406500593985,55.66566428335522,NaN,NaN,19.605151454945222,39.146753454399686,-0.10746435813593691,0.5237802109367777,0.6312445690727146,264768542,270649086.8,51.61614364127274,54.967213073009624,NaN,NaN,10.934434366989104,11.246246557641166
2012-02-02T09:30:00-05:00,71.08,71.78,70.86,71.50999,15471234,13962628.25,55.60470731243575,55.9606220218863,NaN,NaN,46.15687553668712,24.510517342162622,-0.09271735562626426,0.5153478745398843,0.6080652301661486,280239776,268792332.8,50.46665718521576,54.95197431089752,NaN,NaN,10.995760396556866,11.210462820343409
2012-02-03T09:30:00-05:00,72.44,72.84,72.03,72.77,14996559,14078723.6,61.77998009007524,56.811255554019354,NaN,NaN,154.760011746436,42.42569772226802,-0.003746543207115427,0.6033820511572543,0.6071285943643697,295236335,271780530.4,52.30746454994134,55.27835413896275,NaN,NaN,12.8786316618647,11.44877265484645
2012-02-06T09:30:00-05:00,72.36,73.64709,72.25,73.64,13385535,14303251.35,65.3625530260411,57.75552752808897,NaN,NaN,188.93533782181615,81.11287220109233,0.10220133036912027,0.73488025732577,0.6326789269566497,308621870,280171015.4,57.125522127533976,56.14565488049427,NaN,NaN,15.631877752786053,12.046359097409251
2012-02-07T09:30:00-05:00,73.4599,74.145,72.7,74.02,17548928,14578468.45,66.82527082249476,58.457538554778594,NaN,NaN,196.43420721430766,121.17831675483845,0.18173254159908703,0.8598446039555085,0.6781120623564215,326170798,295007464.2,64.04279730775511,57.68181631980964,NaN,NaN,18.3669496530173,12.949300605353258
2012-02-08T09:30:00-05:00,74.2,74.3,73.28999,73.77,11028395,14448210.25,64.88396851078494,58.93819008207794,NaN,NaN,173.70062537622755,151.9974115390949,0.1999178097062877,0.9280093244892811,0.7280915147829934,315142403,305082236.4,67.83748600113033,59.43101323424188,NaN,NaN,20.08150817024122,13.968187400337253
2012-02-09T09:30:00-05:00,73.88,74.06,73.19,73.78,9605785,14254860.45,64.9278578872765,59.41899132108625,NaN,NaN,139.88282238217755,170.74260090819297,0.19483626679369392,0.9716368482751108,0.7768005814814168,324748188,313983918.8,70.77245879551543,60.966919507123734,NaN,NaN,21.499998500014144,15.044160414576808
2012-02-10T09:30:00-05:00,72.92,73.17,72.56,73.03999,14836938,14011115.35,59.04658860402077,59.307212011972354,NaN,NaN,78.812187296063,155.55303601811838,0.1271299630600372,0.9357130353064633,0.8085830722464261,309911250,316918901.8,71.6897678915477,61.97964316977197,NaN,NaN,21.10058091494547,15.909363343200903
2012-02-13T09:30:00-05:00,73.78,73.83,73.06,73.62,9914297,13695949.75,61.95540015809802,59.50020564577778,NaN,NaN,106.77384961463518,139.1207383766822,0.10767178649907272,0.943172805370267,0.8355010188711943,319825547,319159637.2,72.4019187083813,62.72592560031556,NaN,NaN,21.582310591068705,16.71978437861059
2012-02-14T09:30:00-05:00,73.53999,73.88,73.14999,73.75,14547965,13796990.75,62.59665186824374,59.471738206455775,NaN,NaN,100.08274433882966,119.8504458015866,0.0905106384210661,0.9486393168975269,0.8581286784764608,334373512,320800180,72.93865334784317,63.212972623613986,NaN,NaN,22.159712865860378,17.496917019646276
2012-02-15T09:30:00-05:00,73.99001,74.2,73.39,73.63,14742816,13765979.6,61.56509623365917,59.82008007084922,NaN,NaN,97.69441263257114,104.64920325285532,0.05952813102724175,0.932538842260513,0.8730107112332712,319630696,321697838.6,73.24526573116785,63.612211076228355,NaN,NaN,22.36703550474038,18.192648231802576
2012-02-16T09:30:00-05:00,73.78,74.72,73.33,74.59,18102560,14005891.2,66.34352243270706,60.57482241869419,NaN,NaN,114.94802371197616,99.66224351881503,0.0902942178833932,0.9858784835875127,0.8955842657041195,337733256,324294852.2,74.15753274629847,64.12469594089488,NaN,NaN,23.930206792648896,19.01229945478062
2012-02-17T09:30:00-05:00,75.17999,75.27,74.42999,74.87,13496855,13910965.2,67.60844057980103,61.570333185557836,NaN,NaN,138.35105404188795,111.57001686798,0.11454850805160677,1.038769900768628,0.9242213927170212,351230111,332558624.4,76.8611872803439,65.17877589165528,NaN,NaN,25.609025035146587,19.95468882340433
2012-02-21T09:30:00-05:00,75.37,75.78999,75.17,75.38,14382398,13980730,69.83242142518479,62.920465996911624,NaN,NaN,152.2255168161705,120.66035030828706,0.14786686369879587,1.109054972340516,0.9611881086417202,365612509,341716016.8,79.42945972617785,66.77802250286608,NaN,NaN,27.710525985744805,21.06266556088154
2012-02-22T09:30:00-05:00,75.53999,76.07001,75.36,75.55,12342895,14067015,70.55807414781026,64.20646664990237,NaN,NaN,146.72440575896417,129.98868259231398,0.16308477253831,1.1650440743146078,1.0019593017762978,377955404,350432395.2,81.53080285074682,68.91478387497138,NaN,NaN,29.67239694154255,22.292627186690257
2012-02-23T09:30:00-05:00,75.60001,76.02,75.05,75.92999,14088602,13789521.9,72.16952451056227,65.38966787833998,NaN,NaN,131.48171417533973,136.7461429008677,0.17918929209473466,1.225945916894716,1.0467566247999813,392044006,364915057.2,84.38503499574591,71.33752514715209,NaN,NaN,31.821539421941896,23.653900363154776
2012-02-24T09:30:00-05:00,76.10001,76.5,76.03999,76.23,12274891,13554081.65,73.40708084616173,66.2201750752033,NaN,NaN,145.69860873706781,142.896259905886,0.18949275115032949,1.283622563737893,1.0941298125875636,404318897,378232185.4,86.45749910226934,73.77681332946123,NaN,NaN,34.00954049545152,25.133277524911453
2012-02-27T09:30:00-05:00,75.92999,76.31,75.41,75.99001,11183238,13651833.6,70.6987712089438,66.60133351683922,NaN,NaN,117.85857282439827,138.7977636623881,0.16072666274799619,1.2950381410225589,1.1343114782745627,393135659,386613295,87.57516560282747,75.95178786341079,NaN,NaN,35.14442645708959,26.563441658079757
2012-02-28T09:30:00-05:00,75.89,76.24001,75.31,75.74001,16606305,13800853.75,67.88887350240778,66.677305136833,NaN,NaN,98.734362607608,128.0995328206756,0.10797536139884212,1.2692806800231153,1.1613053186242732,376529354,388796664,87.8563384122957,77.65275508516368,NaN,NaN,35.36120792904238,27.820265411074416
2012-02-29T09:30:00-05:00,75.82001,76.14,74.67,74.88,17246224,13929120.4,59.17580733911324,66.26957933885645,NaN,NaN,62.24353291577976,111.2033582520387,0.003780392834311641,1.1660308096671628,1.1622504168328511,359283130,385062209.2,84.34069640604557,78.83155582837192,NaN,NaN,33.01261083285532,28.562029042757402
2012-03-01T09:30:00-05:00,75.21001,75.75999,75.03,75.60001,14008453,13990543.65,63.40985944015666,66.1611508783479,NaN,NaN,67.05377786250885,98.3177709894725,-0.02637182837997054,1.129285631357888,1.1556574597378586,373291583,381311724.6,80.84194441240885,79.55080480100716,NaN,NaN,32.17438644988631,29.078080100918676
2012-03-02T09:30:00-05:00,75.32001,75.62,74.44,74.74001,14522969,13943130.4,55.94617000638353,65.93969240708809,NaN,NaN,28.445829611875325,74.86721516443401,-0.10930730101846864,1.019023333464773,1.1283306344832416,358768614,372201668,72.92807140336512,79.63925505185125,NaN,NaN,29.040494862166472,29.072710781096934
2012-03-05T09:30:00-05:00,74.42,74.48,73.54449,74.25999,12685516,13827578.25,52.24939038101207,65.24640599443909,NaN,NaN,-34.01153130502981,44.493194338548406,-0.19648010920101955,0.8827304979819672,1.0792106071829868,346083098,362791155.8,65.76611929575532,79.16526937952082,NaN,NaN,25.233734061125723,28.52428553538676
2012-03-06T09:30:00-05:00,73.13,73.33,72.58,73.05,13867816,13851692.3,44.30263428548618,63.939690452813544,NaN,NaN,-110.59585783706225,2.6271502496143726,-0.327876216704863,0.6693653363019081,0.9972415530067711,332215282,353928341.4,59.80887521042614,78.22742808399104,NaN,NaN,19.050738443944574,27.17092166518073
2012-03-07T09:30:00-05:00,73.32001,73.86,72.82001,73.66,14482195,13698355.65,48.550967794886226,63.01010985004405,NaN,NaN,-77.0620571174478,-25.233967757031138,-0.3632078242065726,0.5432317727485554,0.906439596955128,346697477,351411210.8,58.19652633204117,77.15251812691055,NaN,NaN,15.350375190932262,25.48227216885952
2012-03-08T09:30:00-05:00,74.03999,74.50999,73.67,74.25999,10298953,13661883.55,52.397034539276255,62.013932143370425,NaN,NaN,-30.306851023839123,-44.706093534300734,-0.3362869136516595,0.4860809548905536,0.8223678685422131,356996430,348152180.2,56.08822607467847,75.86185336465199,NaN,NaN,13.55718505243668,23.77868829508483
2012-03-09T09:30:00-05:00,74.42,74.87,74.07001,74.19,14653191,13914253.85,51.9095470094282,60.89258260262951,NaN,NaN,-17.153680935318864,-53.825995643739574,-0.31374866193105855,0.43018204112838987,0.7439307030594484,342343239,344867105.2,53.96597406536186,74.22648099215327,NaN,NaN,11.99448127240107,22.09523014898715
2012-03-12T09:30:00-04:00,74.12,74.23,73.46001,73.78,12258672,13785340.55,49.03170877787364,59.40681741353586,NaN,NaN,-64.28253189590478,-59.88019576191457,-0.316122415468738,0.3487776837235259,0.6649000991922639,330084567,341667399,51.90586059490644,72.26050962563389,NaN,NaN,9.805920394508297,20.339614469775885
2012-03-13T09:30:00-04:00,74.17999,74.77,73.44,74.67,17793184,14179284.9,54.87940483825586,58.2869124628534,NaN,NaN,-32.5056268586789,-44.2621495662379,-0.25030262530087655,0.35202181756616824,0.6023244428670448,347877751,344799892.8,53.766625536034034,70.27735410315441,NaN,NaN,9.7350198866104,18.82467238646653
2012-03-14T09:30:00-04:00,74.72,74.92,73.77,73.95,13857594,14144766.35,49.89233217144204,56.69568443863052,NaN,NaN,-43.11793230269528,-37.473324603287395,-0.24736677366186166,0.2931159757897177,0.5404827494515794,334020157,342264428.8,52.012506538006484,67.9650306418873,NaN,NaN,8.06667287172231,17.28781531293164
2012-03-15T09:30:00-04:00,74.03999,74.41,73.57001,74.07001,15176984,14166474.75,50.69656738186162,55.07350490546623,NaN,NaN,-61.911509351148716,-43.794256268749315,-0.22982798392477727,0.2531977695456078,0.48302575347038507,349197141,340704571,50.912034609663735,65.42606889241547,NaN,NaN,6.981339613951428,15.815461641648755
2012-03-16T09:30:00-04:00,74.14,75.03,74.03,74.8,23591104,14440901.95,55.38711315729438,53.97981504463413,NaN,NaN,-12.303583926013385,-42.82423686688822,-0.1646044447929617,0.2772701974791829,0.4418746422721446,372788245,346793572.2,54.921499209398824,63.09366415002772,NaN,NaN,7.508509578962825,14.628754204122194
2012-03-19T09:30:00-04:00,74.75999,75.47,74.53999,75.14,14206707,14476394.55,57.41904130489103,53.23196988766865,NaN,NaN,24.349791781991872,-25.09777213130889,-0.09742523813221554,0.3200930946068752,0.4175183327390907,386994952,358175649.2,61.28694645087655,61.19585043849777,NaN,NaN,8.56822630219516,13.762964503846904
2012-03-20T09:30:00-04:00,74.47,74.56,73.86,74.00999,13284766,14421512.95,49.370716371998355,52.53160624716044,NaN,NaN,-49.30178918142301,-28.45700459585771,-0.12613245413725588,0.25985276506752086,0.38598521920477674,373710186,363342136.2,63.786640089337816,59.727703558732934,NaN,NaN,6.917878551617515,12.785095082099849
2012-03-21T09:30:00-04:00,73.92,73.92999,73.02,73.13,16582563,14633496.35,44.17755974620216,51.15787055473512,NaN,NaN,-108.09922425137131,-41.4532629855929,-0.19719136885645977,0.13949600813420204,0.3366873769906618,357127623,367963629.4,65.90726041001908,58.66094041570507,NaN,NaN,3.7696824870015946,11.497178997085813
2012-03-22T09:30:00-04:00,72.32001,72.42999,71.14999,71.48,20216528,14939892.65,36.438129978607144,49.76443912417967,NaN,NaN,-222.62027445005597,-73.59501600537435,-0.33976128241097964,-0.08801422602306275,0.2517470563879169,336911095,365506420.2,63.76905903689499,58.0067252466715,NaN,NaN,-1.9059218439557415,9.582450305508448
2012-03-23T09:30:00-04:00,71.64,72.49001,71.27,72.25999,13222016,14987248.9,41.64278085992925,49.00682415838804,NaN,NaN,-179.42077476742773,-107.0184541736572,-0.36382848459352635,-0.20303854935399102,0.1607899352395353,350133111,360975393.4,59.90939536121932,57.58838782277606,NaN,NaN,-4.636556808064919,7.551163574997968
2012-03-26T09:30:00-04:00,72.89999,73,72.39,72.8,10189844,14937579.2,45.00054928040113,49.0566752294534,NaN,NaN,-106.1462915900877,-133.11767084807315,-0.3268445648111995,-0.24776577077446404,0.07907879403673543,360322955,355640994,55.63969154704861,57.29058898967766,NaN,NaN,-5.654192264610959,5.66468416933955
2012-03-27T09:30:00-04:00,72.92999,72.95,72.05,72.07001,12772832,14745905.55,41.52247261236285,48.55463985927315,NaN,NaN,-118.50780851430291,-146.9588747146491,-0.33383723089746375,-0.33821774458509424,-0.004380513687630511,347550123,350408981.4,51.74444891934008,56.829726317341866,NaN,NaN,-7.66477118192816,3.760476262015591
2012-03-28T09:30:00-04:00,71.74001,71.99001,70.59,71.17,15285301,14647859.4,37.65797206973853,47.5018496828776,NaN,NaN,-170.64293507627426,-159.4676168796297,-0.3781163985517807,-0.4770260118773564,-0.0989096133255757,332264822,345436421.2,48.284620403409484,56.272325912251226,NaN,NaN,-10.658138000519914,1.7006742245105189
2012-03-29T09:30:00-04:00,70.67999,71.28999,70.17,71.17,16330223,14763947.9,37.65797206973853,46.48388004432833,NaN,NaN,-167.72777080133213,-148.48911614988495,-0.3851464965231673,-0.5803427339795348,-0.19519623745636755,332264822,344507166.6,47.64350841775409,55.82072122313638,NaN,NaN,-12.968584664469502,-0.39493418820091275
2012-03-30T09:30:00-04:00,71.7,71.92999,71.03999,71.75,12753293,14675464.1,41.71245917326677,45.96107650114214,NaN,NaN,-106.07400524480471,-133.81976224536032,-0.33056899811238416,-0.6084074850968477,-0.27783848698446356,345018115,343484167.4,46.90514392218026,55.46352717508451,NaN,NaN,-13.637350645043412,-2.286707967749841
2012-04-02T09:30:00-04:00,71.57001,72.99001,71.35001,72.45,17888128,14935594.7,46.25547217299298,45.34508131076621,NaN,NaN,-55.82981495794748,-123.75646691893228,-0.23182654120643126,-0.5676216634925026,-0.3357951222860714,362906243,344000825,47.34894298048854,55.005121278259836,NaN,NaN,-12.77738968818754,-3.7853767849552264
2012-04-03T09:30:00-04:00,72.3,72.41,71.09,71.82001,13995156,14941961.7,43.006662379772536,44.853247754218394,NaN,NaN,-77.69528772309923,-115.59396276069155,-0.19492706180808506,-0.5794539495461777,-0.3845268877380926,348911087,344273017.8,47.59745352136725,54.68976034849988,NaN,NaN,-13.055833079760266,-5.109727684213089
2012-04-04T09:30:00-04:00,70.95,71.27521,70.53,70.89999,15830273,15009365.6,38.72865191016234,43.99839664909702,NaN,NaN,-112.1548049973024,-103.89633674489718,-0.21678865313096862,-0.6555127041518034,-0.4387240510208348,333080814,344436216.2,47.75667164607692,54.464377279672256,NaN,NaN,-14.65365264637687,-6.473145535950772
2012-04-05T09:30:00-04:00,70.64999,71.49001,70.41,70.5,9578828,14973359.35,37.00517634519829,42.68540116251874,NaN,NaN,-105.74763450941731,-91.50030948651421,-0.24065331954167812,-0.7395407004479324,-0.4988873809062543,323501986,342683649,46.13553674257716,53.83680853204214,NaN,NaN,-16.494805861036713,-7.904811296677336
2012-04-09T09:30:00-04:00,69.42,70.14,69.35001,69.61,14430328,14962216.2,33.43938009161316,40.97256821871317,NaN,NaN,-146.12323026844967,-99.5101544912432,-0.2952452452165628,-0.8679439374269577,-0.5726986922103949,309071658,335494357.6,40.119184051508206,52.32482550351583,NaN,NaN,-19.21405166989693,-9.520417064280135
2012-04-10T09:30:00-04:00,69.50999,69.63,68.10001,68.243,21953200,15446942.6,28.842253828774574,39.506249465625764,NaN,NaN,-174.58499456601692,-123.2611904128571,-0.3960027247647643,-1.0677020981663503,-0.671699373401586,287118458,320336800.6,30.953982024458142,49.97963564173871,NaN,NaN,-23.178360141475792,-11.4715517895938
2012-04-11T09:30:00-04:00,69,69.2,68.12,68.25999,12826723,15198619.55,28.97294960176461,38.42020588388022,NaN,NaN,-160.57342986889455,-139.83681884201616,-0.4311884266737318,-1.2106849067437508,-0.779496480070019,299945181,310543619.4,26.708569959853563,47.179729181012604,NaN,NaN,-26.220673172624164,-13.57856913002671
2012-04-12T09:30:00-04:00,68.32001,69.91499,68.27,69.75,15058836,15258681.65,39.47253871738384,38.63694936522141,NaN,NaN,-113.30390299309407,-140.0666384411745,-0.3284430552576426,-1.1900502991420723,-0.8616072438844297,315004017,306928260,25.327523103265506,44.43390518575336,NaN,NaN,-25.473759675261498,-15.27788206506025
2012-04-13T09:30:00-04:00,69.45,69.66,68.56,68.7,13108805,15155272.7,35.49099491740465,38.19753608361251,NaN,NaN,-115.43045868430121,-142.00320327615128,-0.30598015751202656,-1.2440824407744628,-0.9381022832624363,301895212,302606905.2,23.74693580290581,41.850872360159535,NaN,NaN,-26.173227715529684,-16.834360015127313
2012-04-16T09:30:00-04:00,68.98,69.2,67.95,68.24001,15125367,14731985.85,33.87876213866906,37.40312271634593,NaN,NaN,-124.42850831491447,-137.6642588854442,-0.2966638506496466,-1.3089320965744946,-1.012268245924848,286769845,298146542.6,22.20650928033257,39.46278791253695,NaN,NaN,-27.255822212620405,-18.323140329054898
2012-04-17T09:30:00-04:00,68.87,69.7,68.81,69.35001,12757004,14659500.7,40.86025490886704,37.35582145181052,NaN,NaN,-79.35604436970381,-118.61846884618163,-0.19520669751962827,-1.2562766178243834,-1.061069920304755,299526849,300628220.8,25.117067148440128,37.56083207175839,NaN,NaN,-25.85647777954967,-19.399331393411295
2012-04-18T09:30:00-04:00,69.14,69.64,69,69.21001,10794367,14534980.75,40.28253956841167,37.5432905588586,NaN,NaN,-70.41037556199485,-100.58585798480166,-0.1206431628531317,-1.2118738738711698,-1.0912307110180381,288732482,298385681,24.23469867927463,35.842980520034466,NaN,NaN,-24.933371770306763,-20.189908590110647
2012-04-19T09:30:00-04:00,69.25,69.8,68.86501,69.12,20974560,14754580.6,39.89201691449201,37.70286519062671,NaN,NaN,-63.211450703226326,-90.56736752682812,-0.06337955573523324,-1.1704551556870797,-1.1070755999518465,267757922,288936462,20.902573876514822,33.932913767088806,NaN,NaN,-24.307528244375295,-20.77813996929131
2012-04-20T09:30:00-04:00,69.78,70.12,68.94,68.96001,15099980,14498753.2,39.165214010744535,37.52091910758941,NaN,NaN,-53.21442505683623,-78.12416080133511,-0.024282566244308246,-1.1374288077572317,-1.1131462415129234,252657942,279089008,18.108271713030973,31.87599432357814,NaN,NaN,-23.996729691681274,-21.237938501061304
2012-04-23T09:30:00-04:00,67.81,69.08,67.67999,68.89,17028240,14689064.4,38.83181045978116,36.99065755664571,NaN,NaN,-85.7621229855999,-70.39088373547222,0.0071760687407060875,-1.1041761555870409,-1.111352224327747,235629702,268860979.4,15.752771113656976,29.619124904518745,NaN,NaN,-23.82945204480553,-21.608154721596193
2012-04-24T09:30:00-04:00,69.14,69.63,68.81,69.39999,9915691,14675356.75,42.66099366713368,36.96596693431435,NaN,NaN,-42.52801301232076,-63.02527746399562,0.06919590677411036,-1.024857340860109,-1.0940532476342193,245545393,258064688.2,13.72350663691978,27.199557269915353,NaN,NaN,-22.6322534990625,-21.754454546948523
2012-04-25T09:30:00-04:00,69.83,70.13,69.36,70.09,14642996,14768864.95,47.453904786589135,37.58919928263055,NaN,NaN,-2.4035754969121252,-49.423917450979076,0.15845047678873092,-0.8959901516483058,-1.0544406284370367,260188389,252355869.6,12.785600943352463,24.701623648292177,NaN,NaN,-20.20966808390489,-21.53377076651372
2012-04-26T09:30:00-04:00,69.75,70.86,69.64,70.83,11231391,14566169.45,52.08012117163867,38.66598105594772,NaN,NaN,40.59127912863737,-28.66337148460634,0.26292548146481176,-0.725783776606022,-0.9887092580708338,271419780,253088241.2,13.601376770809182,22.377755078880178,NaN,NaN,-16.710597434084942,-20.84474600473818
2012-04-27T09:30:00-04:00,71,71.05,70.44,70.8,6712680,14085292.3,51.88070261826307,39.983218379279855,NaN,NaN,63.55838270673213,-5.308809931892671,0.3217247458397705,-0.5865533257711206,-0.9082780716108911,264707100,255498072.8,16.373215270774224,20.681614451684897,NaN,NaN,-13.901927770943146,-19.852914828481747
2012-04-30T09:30:00-04:00,70.73,71.287,70.53,71.24001,7608980,13828076.65,54.62502989798085,41.82484524136602,NaN,NaN,86.29074712780282,29.101764090787874,0.3780746508773607,-0.43568475801419027,-0.813759408891551,272316080,262835348.4,24.332985314383535,20.208686115251,NaN,NaN,-10.697461274512996,-18.544992892200497
2012-05-01T09:30:00-04:00,71.38,72.77,71.25999,72.25999,14256340,13646487.25,60.280106515686555,44.061070735217584,NaN,NaN,166.44031650270932,70.8954299937939,0.46608601167673247,-0.23115189429563543,-0.6972379059723679,286572420,271040753.8,32.114787674962386,20.594844523473057,NaN,NaN,-6.0589620737175975,-16.761274203845797
2012-05-02T09:30:00-04:00,71.64,71.66,70.88,71.08,12082262,13550842.55,52.178274911798844,44.96862332053295,NaN,NaN,107.59844125577787,92.89583334433189,0.4278692084292255,-0.1624013954358361,-0.5902706038650616,274490158,273901107.6,34.63827706756156,21.259898378065632,NaN,NaN,-4.365104419100492,-14.990392806025039
2012-05-03T09:30:00-04:00,71.06,71.14999,69.69,69.9001,16040695,13561363.65,45.58126505292838,45.68935690164178,NaN,NaN,39.10667608345452,92.59891273529531,0.31156896849422266,-0.2008093932472832,-0.5123783617415059,258449463,271307044.2,33.424775567503474,21.951172646965464,NaN,NaN,-5.046599582678591,-13.569850916975547
2012-05-04T09:30:00-04:00,69.19,69.3,67.97,68.3,22188720,14191858.25,38.476639986772746,46.017776747934896,NaN,NaN,-90.55632398062974,61.77597139782294,0.1248978828861892,-0.35625600813376934,-0.48115389101995854,236260743,265617772.8,30.870387560415978,22.570021095542852,NaN,NaN,-8.182325609836097,-12.800204444527054
2012-05-07T09:30:00-04:00,67.89999,68.533,67.44,68.10001,15207957,14230739.7,37.68599661801361,45.79104401287395,NaN,NaN,-116.76284111857449,21.165253748547478,-0.007027596964552629,-0.4899383872256493,-0.4829107902610967,221052786,255365114,26.8832223840639,22.696175040944553,NaN,NaN,-10.875184896371506,-12.525201651933404
2012-05-08T09:30:00-04:00,67.56,68,66.42999,67.88,25178752,14392017.3,36.79035091378402,45.54160196611482,NaN,NaN,-149.60061581182015,-42.042932714358415,-0.09898545238956258,-0.6066426057480498,-0.5076571533584873,195874034,237225436.8,21.574003566083462,22.506125390002328,NaN,NaN,-13.301184779988926,-12.636056384512765
2012-05-09T09:30:00-04:00,66.84,67.95,66.49001,67.55,21955856,14848473.95,35.430203164129765,45.22290098394609,NaN,NaN,-146.32249852691209,-92.8271206708964,-0.1678654893661754,-0.7174890150662065,-0.5496235257000311,173918178,217111040.8,17.45700157947266,22.260013083070742,NaN,NaN,-15.70450778926101,-13.074406585191085
2012-05-10T09:30:00-04:00,68.22,68.59,67.7,67.84,12308797,14710972,37.61300818336506,45.11202913913327,NaN,NaN,-88.24484147974914,-118.29742418353715,-0.17872044050085123,-0.7730240763260952,-0.5943036358252439,186226975,202666543.2,15.211999438434319,22.053136492028127,NaN,NaN,-17.05216760402987,-13.64265815931091
2012-05-11T09:30:00-04:00,67.36,68.34,67.22,67.34,10303387,14570701.1,35.39153241121325,44.86629499280699,NaN,NaN,-105.71842868791938,-121.32984512499506,-0.20264597186773947,-0.8476111006599183,-0.6449651287921788,175923588,190599112.2,13.634453841355878,21.901828115435187,NaN,NaN,-18.853113079173454,-14.387008862148416
2012-05-14T09:30:00-04:00,66.50999,66.62,66.08,66.22,13552957,14492080.6,30.977970916616798,44.03179336777007,NaN,NaN,-164.30720326946,-130.83871755517214,-0.2726147542216274,-0.985733571569213,-0.7131188173475856,162370631,178862681.2,12.298604821620387,21.80004941434237,NaN,NaN,-21.856742463194927,-15.454113662297917
2012-05-15T09:30:00-04:00,66.25999,66.50999,64.92,65.118,16977920,14703126.4,27.362286954259503,42.596677808317956,NaN,NaN,-169.81011636251256,-134.8806176653106,-0.36600461298134457,-1.1706245835742664,-0.8046199705929218,145392711,168766416.6,11.275187506491719,21.69216274028089,NaN,NaN,-25.681234747860444,-16.91513096023542
2012-05-16T09:30:00-04:00,65.28,66.31,64.75,64.75,16516293,14989222.7,26.260028116854357,40.75238544726193,NaN,NaN,-152.72571327629467,-136.16126061518713,-0.4215023341847217,-1.331497888323824,-0.9099955541391023,128876418,159758064.6,10.440386796891602,21.466377742143923,NaN,NaN,-29.139554829186338,-18.661477227228406
2012-05-17T09:30:00-04:00,64.89999,65.41,64.33,64.34,19182304,14899609.9,25.049297650138982,38.835856520967354,NaN,NaN,-151.99558308848566,-148.91140893693446,-0.452060368208935,-1.475071014400271,-1.023010646191336,109694114,144451492.4,9.19468732149953,20.95362574576716,NaN,NaN,-32.371726421803174,-20.620084255024803
2012-05-18T09:30:00-04:00,64.8,65.16,63.67,63.94,18484592,15068840.5,23.8919478005367,36.64063637114992,NaN,NaN,-144.73296200524962,-156.7143156004005,-0.4637162731732376,-1.602655987657883,-1.1389397144846454,91209522,127508679.2,8.049773922869193,19.790539217801847,NaN,NaN,-35.41462192507941,-22.733589636461176
2012-05-21T09:30:00-04:00,64.03,65.47,63.99001,65.41,13670484,14900952.7,35.65742554775777,34.88187344486929,NaN,NaN,-105.59442388148857,-144.9717597228062,-0.3425177335134244,-1.5670868813764258,-1.2245691478630014,104880006,116010554.2,7.378315563601504,18.023648352704644,NaN,NaN,-34.42366984009365,-24.40360109412296
2012-05-22T09:30:00-04:00,65.5,66.42,64.80499,65.25,21336176,15471976.95,35.02280056910193,33.65648242039094,NaN,NaN,-79.48645951186063,-126.90702835267582,-0.24764415432549014,-1.5341243407698641,-1.286480186444374,83543830,103640778,6.728113681482213,16.03006525369897,NaN,NaN,-33.825334605370124,-25.749563024301125
2012-05-23T09:30:00-04:00,64.7,65.58,63.78,65.49001,18880928,15683873.55,36.83878325329658,33.03201943470295,NaN,NaN,-87.74299692896602,-113.91048508321009,-0.14815184532960024,-1.4716699931063744,-1.3235181477767741,102424758,98350446,6.465684994572413,14.10441592706104,NaN,NaN,-32.796594795068955,-26.756281848696528
2012-05-24T09:30:00-04:00,65.83,65.83,64.6199,65.44,18681904,16056399.2,36.60919319780537,32.89863037834814,NaN,NaN,-70.1984266365761,-97.55105379282818,-0.06915088804741432,-1.4099567578360421,-1.3408058697886278,83742854,93160194,6.209776808796704,12.342943730516808,NaN,NaN,-32.02176494246765,-27.508493719235258
2012-05-25T09:30:00-04:00,65.37,65.81,64.98801,65.13,8014684,16121499.4,35.14693269972409,32.717268669898885,NaN,NaN,-63.13569347563596,-81.23160008690544,-0.02356921931386502,-1.370267393930959,-1.346698174617094,75728170,90063923.6,6.055792751183333,10.855270185311051,NaN,NaN,-31.761578385212495,-28.116077242946293
2012-05-29T09:30:00-04:00,65.88,66.69,65.53551,66.22,14054000,16443750.4,43.66706701140711,33.20846267687196,NaN,NaN,-29.020394123030982,-65.91679413521393,0.08807486876457205,-1.236604588661379,-1.324679457425951,89782170,87044356.4,5.902085013420447,9.735847431549406,NaN,NaN,-28.980410763227976,-28.23955346012939
2012-05-30T09:30:00-04:00,65.3,65.34,63.98,64.19,23235088,16892687.8,34.560575140905,33.14634638949877,NaN,NaN,-85.64512120871571,-67.14852647458494,0.0359611823137187,-1.2797279795338028,-1.3156891618475215,66547082,83645006.8,5.725886091694122,8.897910610993796,NaN,NaN,-29.338132059469945,-28.396493260035182
2012-05-31T09:30:00-04:00,64.14999,64.315,62.53999,63.63,26688416,17622995.5,32.54430483908878,32.78429615062189,NaN,NaN,-125.91131906972826,-74.7821909027374,-0.02233081613598631,-1.3436026820175044,-1.3212718658815181,39858666,71131788.4,5.119956785670368,8.177050421510655,NaN,NaN,-30.295869587700842,-28.667832735415992
2012-06-01T09:30:00-04:00,62.35001,62.73,61.96001,62.03999,19512224,17796571.95,27.617660695464565,32.22901959949698,NaN,NaN,-177.17994410444288,-96.17849439631075,-0.14712143343289963,-1.5051736576726427,-1.358052224239743,20346442,58452506,4.589932372315602,7.531013173722067,NaN,NaN,-32.88731136113246,-29.270615396232632
2012-06-04T09:30:00-04:00,62.28,62.47501,61.11,61.99001,19038160,17639043.95,27.476853685871788,31.97893979730091,NaN,NaN,-183.76295162862374,-120.3039460269083,-0.20843393004995425,-1.618594636802186,-1.4101607067522317,1308282,43568528.4,4.058763797810968,6.942453100592824,NaN,NaN,-34.915917682705796,-30.077087151443084
2012-06-05T09:30:00-04:00,61.85001,62.92999,61.82001,62.52,15802320,17668762.1,31.46703832854999,32.27213632403595,NaN,NaN,-139.78294224330324,-142.45645565096274,-0.1892580744409127,-1.6467332998033726,-1.4574752253624599,17110602,29034214.8,3.6184079054397102,6.3955402719462535,NaN,NaN,-35.310875860463504,-30.824771252731715
2012-06-06T09:30:00-04:00,63.17999,64.50999,63.17999,64.45,20785584,17449103.7,43.629985474632186,33.51284756387722,NaN,NaN,-50.40087537655715,-135.40760648453104,-0.030862184056694275,-1.4960529554333277,-1.4651907713766334,37896186,23304035.6,3.4590669690924045,5.896874569960596,NaN,NaN,-31.406942376874103,-30.90793855618063
2012-06-07T09:30:00-04:00,65.28999,65.88,64.36,64.49001,14686938,17085657.8,43.852452698101,34.85593006730308,NaN,NaN,2.474789452991146,-109.73038477998716,0.08594634739509388,-1.357757837132766,-1.44370418452786,52583124,25848927.2,5.450451226838311,5.62942913462765,NaN,NaN,-28.342037978744216,-30.541381330832568
2012-06-08T09:30:00-04:00,64.02,64.59,63.47,64.5,15585664,17249501.15,43.91197362235528,36.28593191171869,NaN,NaN,-31.334528106911538,-80.5613015804809,0.16845373633474314,-1.233137014109431,-1.4015907504441742,68168788,35413396.4,12.735886855625353,5.964151486967375,NaN,NaN,-25.912442228026265,-29.880104316145953
2012-06-11T09:30:00-04:00,65.16,65.46001,63.53,63.62,16148895,17541776.55,39.899533520667546,36.58893962406939,NaN,NaN,-21.47118805260919,-48.102948865277995,0.1679556372452249,-1.1916462038876432,-1.359601841132868,52019893,45555718.6,19.793634342381054,6.850959971165914,NaN,NaN,-25.02782665785963,-29.18692179353362
2012-06-12T09:30:00-04:00,63.97,64.67999,63.62,64.52,14517191,17589988.25,45.39497671116043,37.32980934850214,NaN,NaN,-9.911913037386059,-22.128743024094558,0.2286700542441482,-1.0737642733276829,-1.302434327571831,66537084,55441015,26.06973200734548,8.232504137299006,NaN,NaN,-22.53838815209844,-28.237131273328597
2012-06-13T09:30:00-04:00,64.14999,64.78999,63.41,63.7,12172648,17349724.65,41.657534637931505,37.67400587597606,NaN,NaN,-28.75431895538142,-17.79943173985941,0.21428097330369855,-1.034583110942208,-1.2488640842459064,54364436,58734665,28.088794943292484,9.77701199077901,NaN,NaN,-21.593060656720596,-27.287978328098884
2012-06-14T09:30:00-04:00,63.85001,64.98,63.595,64.7,14564633,17252141.65,47.35041971793981,38.44123634169995,NaN,NaN,12.129618524826151,-15.868465925492421,0.26923253271651015,-0.9123234183502689,-1.181555951066779,68929069,62003854,30.12853438805041,11.485494675011418,NaN,NaN,-18.94525040249704,-26.096160053012905
2012-06-15T09:30:00-04:00,64.83,65.69,64.50999,65.62,15500953,17068074.1,51.9916871610427,39.64443308893699,NaN,NaN,78.67336828556623,6.133113353003143,0.3590457620961349,-0.7327487484466104,-1.0917945105427453,84430022,65256100.8,32.18918904784029,13.352165839058342,NaN,NaN,-15.188814548126011,-24.537967838029065
2012-06-18T09:30:00-04:00,64.97,65.22,64.58501,65.03,14037480,16845718.5,49.00797252459531,40.02592633987901,NaN,NaN,47.53211981300915,19.933774926126812,0.3688184426508011,-0.630771457229244,-0.9995898998800451,70392542,68930630.6,34.53825861571082,15.397606810650514,NaN,NaN,-13.039047161078512,-22.895264884178985
2012-06-19T09:30:00-04:00,65.53999,66.3,65.2,65.97,15372949,16930841.75,53.578852054261056,41.38437469083301,NaN,NaN,108.67527332926744,43.65121219945751,0.4247113715877465,-0.4687006853953619,-0.8934120569831084,85765491,72776312,36.99809833758378,17.631336256785488,NaN,NaN,-9.735450522708303,-21.015291403968888
2012-06-20T09:30:00-04:00,65.94,66.42999,65.10001,65.71001,17625456,16745305.75,52.18550013916858,42.78731721226728,NaN,NaN,100.59080708416707,69.5202374073672,0.42903301748876777,-0.35712078512214873,-0.7861538026109165,68140035,75531431.8,38.77315812115975,20.035136352177584,NaN,NaN,-7.502529963972856,-19.084896912540884
2012-06-21T09:30:00-04:00,65.73,65.73,62.91,63.02,18964784,16749498.55,40.46117531315448,43.70471111353085,NaN,NaN,-34.577792860773016,60.178755130247374,0.24474818200382453,-0.48021857510613586,-0.7249667571099604,49175251,71580668.2,37.15649580675234,22.361319454637357,NaN,NaN,-9.48852714129758,-17.713986945220412
2012-06-22T09:30:00-04:00,63.44,63.73,62.67,63.44,20065280,16818667.35,42.62845334770032,44.78696823223289,NaN,NaN,-72.59495335581767,29.9250908019706,0.1498247155285921,-0.5376858626992203,-0.6875105782278124,69240531,68542770,35.916392947168205,24.636864393877154,NaN,NaN,-10.314861169912044,-16.656968977319217
2012-06-25T09:30:00-04:00,62.5,62.52,61.47,62.02,15558105,17195838.4,37.63977880269285,45.227878266100234,NaN,NaN,-145.33469920008935,-8.648273000649102,-0.0018787133601474437,-0.6898589699279967,-0.6879802565678492,53682426,65200746.8,34.550253217773175,26.84628191618669,NaN,NaN,-12.75898923171248,-16.100114727946824
2012-06-26T09:30:00-04:00,62.12,62.92,61.67,62.69,14262223,17206249.55,41.1398593087946,45.05001211139755,NaN,NaN,-102.55697955735486,-50.89472357797356,-0.04783497891194055,-0.747773980207775,-0.6999390012958344,67944649,61636578.4,33.10408939958896,28.963783518365016,NaN,NaN,-13.55596862982461,-15.736665285357937
2012-06-27T09:30:00-04:00,63.03,64.23,63.03,63.99001,11658133,16627401.8,47.31840007288572,45.29757978102503,NaN,NaN,-7.69390825411417,-72.55166664562981,0.015212924206954304,-0.6809228460371415,-0.6961357702440958,79602782,63929127.8,34.98903170675011,31.073682124073002,NaN,NaN,-12.134223801346062,-15.222030787641955
2012-06-28T09:30:00-04:00,63.62,64.53999,63.325,64.42999,16527945,16119378.25,49.25968251480534,45.6795589876286,NaN,NaN,15.145035464447666,-62.60710098058566,0.08835767447912257,-0.5856886771451926,-0.6740463516243151,96130727,73320223,42.17663468850904,33.17659268356469,NaN,NaN,-10.37313519722304,-14.52933141758211
2012-06-29T09:30:00-04:00,66.14,66.5,65.47,66.37,21747760,16231155.05,56.81597271655729,46.8878760730493,NaN,NaN,148.87561532729853,-18.312987243962432,0.2595235895066388,-0.34964186474101666,-0.6091654542476554,117878487,83047814.2,48.52507342332385,35.228838332203466,NaN,NaN,-6.183990680972047,-13.337139883780672
2012-07-02T09:30:00-04:00,66.37,66.66,65.67,66.39999,14556250,16007059.55,56.92277004715483,47.71128988276319,NaN,NaN,142.74744063051352,39.30344072215814,0.36066995051155293,-0.15832801610821434,-0.5189979666197673,132434737,98798276.4,56.796096478502484,37.42357865157182,NaN,NaN,-2.930703614041329,-11.850506130960767
2012-07-03T09:30:00-04:00,66.92999,68.7,66.87,67.99001,15693504,16001618.75,62.25283391203497,49.18238268805629,NaN,NaN,211.79405628866053,102.17364789136123,0.5113625824911902,0.1202052614942204,-0.39115732099696976,148128241,114834994.8,63.26778360980662,39.93636355632283,NaN,NaN,1.7039942015831453,-9.91414894059735
2012-07-05T09:30:00-04:00,67.59,67.63,66.86,67.10001,12141199,15569399.5,57.93192874303815,49.93820476127761,NaN,NaN,142.5747264966044,132.22737484150494,0.5257757190862681,0.26606232786086537,-0.2597133912254027,135987042,126111846.8,67.01003873921772,42.57075672426335,NaN,NaN,4.107534695977886,-7.9110512782294595
2012-07-06T09:30:00-04:00,66.07001,66.59,65.77,66.28999,11191070,15394606.1,54.24181112159278,50.09892790131689,NaN,NaN,77.32872285699915,144.66411232001525,0.4579217352448146,0.31268877783061555,-0.14523295741419906,124795972,131844895.8,68.75295935511853,45.18245460335466,NaN,NaN,4.897902477707646,-6.081200741667016
2012-07-09T09:30:00-04:00,66.24001,66.36,65.52,65.99001,9564324,15093539.1,52.89798646644174,50.376786040020214,NaN,NaN,57.07901794060925,126.30479284267737,0.37356719703997604,0.321726038885771,-0.051841158154205036,115231648,131315528,68.39365032209938,47.6006968680967,NaN,NaN,5.118405379702576,-4.481257010042789
2012-07-10T09:30:00-04:00,66.39,66.59,64.64,64.96001,18801504,15226169.55,48.45873166621527,50.011063155159796,NaN,NaN,24.382470805852194,102.63179887774511,0.2358528291638899,0.24297487830065734,0.007122049136767443,96430144,124114609.4,63.52991349801846,49.49582652241346,NaN,NaN,3.924003078889811,-3.2805055687667037
2012-07-11T09:30:00-04:00,65.3,66.17,65.13,65.84,20965280,15548574,52.153176912097926,50.00875435322619,NaN,NaN,37.625576628056415,67.79810294562428,0.1932663119371234,0.2487049390581717,0.055438627121048294,117395424,117968046,59.63174212067246,50.98572537952151,NaN,NaN,4.049482546388996,-2.233364409458747
2012-07-12T09:30:00-04:00,65.06,65.96001,64.82001,65.62,19368736,15908378.4,51.16575413775167,50.7733671264117,NaN,NaN,21.040634614591035,43.491284569221605,0.14189725912709772,0.23281020102992045,0.09091294190282273,98026688,110375975.2,55.1318912377558,52.269682196021755,NaN,NaN,3.8585672668367534,-1.363088455702247
2012-07-13T09:30:00-04:00,65.89,66.83,65.8,66.77,10209934,15690643.45,55.869276973756755,51.71914024255859,NaN,NaN,71.00612715471297,42.226765428764374,0.17482312066489883,0.30944184273394626,0.13461872206904743,108236622,107064105.2,53.24436921953893,53.50739478690538,NaN,NaN,5.1124930414411125,-0.4380053846817671
2012-07-16T09:30:00-04:00,66.56,67.3,66.16499,66.99001,11335664,15482379,56.72796489966376,53.08258210662793,NaN,NaN,82.56939711797082,47.32484126423669,0.1991091269539669,0.38350513076150605,0.18439600380753915,119572286,107932232.8,53.691918527955515,54.87465659477555,NaN,NaN,6.383903162794404,0.5365529792434001
2012-07-17T09:30:00-04:00,67.37,67.89999,66.3,67.83,17984896,15679749.8,59.93344232816903,54.42498089372611,NaN,NaN,100.98635339948996,62.645617782964244,0.2558185920122437,0.5041692438228438,0.24835065181060006,137557182,116157640.4,57.81242049876652,56.63953738757395,NaN,NaN,8.425248279318375,1.6635094506826822
2012-07-18T09:30:00-04:00,67.59,68.5,67.45,68.42,15518199,15687012.3,62.059388702472084,55.477908652982265,NaN,NaN,127.11898734357496,80.54429992606795,0.3133408089182328,0.6400266629583911,0.32668585404015826,153075381,123293631.8,61.05042627917254,58.501065571318414,NaN,NaN,10.774850628011299,2.9651296188724845
2012-07-19T09:30:00-04:00,68.69501,68.84,68.21001,68.63,13990137,15505246.35,62.81566802100895,56.44619333199682,NaN,NaN,130.77277556069046,102.49072811528784,0.3433921539390147,0.7559260464639266,0.4125338925249119,167065518,137101397.8,66.42093465864852,60.23280128347124,NaN,NaN,12.930978529522442,4.388822320393906
2012-07-20T09:30:00-04:00,68.41,68.81,68.10001,68.78999,13664930,15240253.65,63.41401198606065,56.917481851247054,NaN,NaN,120.20488875655049,112.33048043565535,0.35067576595045624,0.8508785999629822,0.500202834012526,180730448,151600163,70.95038364299751,61.83460915630507,NaN,NaN,14.891899439784106,5.88926190887822
2012-07-23T09:30:00-04:00,67.36,68.27,66.925,68.13,12720406,14873009.95,59.18324683190947,57.07894447872953,NaN,NaN,79.41734439825149,111.70006989171148,0.2901787160364624,0.8629262290581039,0.5727475130216415,168010042,161287714.2,73.5205077735402,63.02920996309348,NaN,NaN,15.459662292722761,7.256461963713154
2012-07-24T09:30:00-04:00,68.16,68.23,66.16,67.03999,12658867,14728048.05,52.905389849617976,56.411269902842605,NaN,NaN,42.61396552898647,100.02559231761077,0.16226516789452972,0.7755789728898037,0.613313804995274,155351175,164846512.8,74.41598885900329,63.825510338036096,NaN,NaN,14.16054032577361,8.242758872578934
2012-07-25T09:30:00-04:00,67.3,67.58,66.50999,67.09,9499531,14489913.45,53.15093120518558,56.069770078710285,NaN,NaN,29.61942689494728,80.52568022788525,0.07118528226356902,0.7022954078247352,0.6311101255611662,164850706,167201577.8,75.01807256921067,64.39751275446416,NaN,NaN,13.161039537515865,8.945370396141353
2012-07-26T09:30:00-04:00,68.12,69.23,68.08,69,14040875,14609050.55,61.42345410145432,56.58274457727182,NaN,NaN,129.02883622253773,80.1768923602547,0.12650455168163588,0.7892408151632111,0.6627362634815752,178891581,169566790.4,75.63815633685162,64.88931253887367,NaN,NaN,14.723274495681896,9.770785267504287
2012-07-27T09:30:00-04:00,69.37,70.49001,68.89999,70.22,15360289,14550667.75,65.60162404412819,57.49014726139228,NaN,NaN,184.79885232067392,93.09568507307938,0.22636153025112105,0.9456881762954765,0.7193266460443555,194251870,172271074.8,76.36063833057123,65.45838311090738,NaN,NaN,17.426052990414494,10.864394942205745
2012-07-30T09:30:00-04:00,70.12,70.6799,69.89999,70.42,9733672,13949963.35,66.24702509258272,58.76073964898996,NaN,NaN,179.52000162368407,113.1162165181659,0.2832892734457879,1.0734382378515903,0.7901489644058024,203985542,179466174.8,78.21204765757831,66.50710697944737,NaN,NaN,19.790973546340553,12.139620457082145
2012-07-31T09:30:00-04:00,70.25999,70.55,69.58,69.64999,12016148,13822958.25,61.46542072523758,59.42589992135708,NaN,NaN,132.96024252454427,131.18547191727745,0.24777611158061696,1.0998691038815736,0.8520929923009566,191969394,186789818.6,79.93466267780032,67.95731559067079,NaN,NaN,20.3566908272073,13.31348765281431
2012-08-01T09:30:00-04:00,69.91,70.34,69.16,69.99001,16144641,13845515.1,62.74419528731778,60.25293143204037,NaN,NaN,112.0010928300495,147.6618051042979,0.22645922941883057,1.1351670290744948,0.9087077996556643,208114035,195442484.4,81.76865657010876,69.85994168583885,NaN,NaN,21.19804518801722,14.439853014986154
2012-08-02T09:30:00-04:00,69.12,69.52,68.16,68.82001,15442473,14010578.8,55.87329377972862,60.25321834675265,NaN,NaN,55.533913412970385,132.96282054238443,0.11827567142510831,1.0565523889370496,0.9382767175119413,192671562,198198480.6,82.32286937891818,71.9369774115088,NaN,NaN,19.830666616210966,15.209969243732555
2012-08-03T09:30:00-04:00,70.10001,70.87,70.02,70.44,14382309,14170140.75,62.06721962058568,60.63459368396136,NaN,NaN,119.66825489221985,119.93670105669362,0.13909799447672966,1.1121492106078534,0.9730512161311238,207053871,200758880.8,82.84463069828473,74.01931399510374,NaN,NaN,20.606244280465543,15.980865677551554
2012-08-06T09:30:00-04:00,70.57001,71.0199,70.5,70.63,5936559,13988752.5,62.728023919002865,60.83420665473521,NaN,NaN,119.52861587181681,107.93842390632017,0.1481115103780566,1.1581906041036945,1.0100790937256379,212990430,202559858.4,83.21981274959475,75.83412772730576,NaN,NaN,21.426169599706615,16.75876623785942
2012-08-07T09:30:00-04:00,71.16,72.0005,71.10001,71.69,12251066,13661230.6,66.25942915364803,61.13420954410492,NaN,NaN,145.8684317798392,110.52006175737918,0.20443478276385907,1.2656225721804617,1.0611877894166026,225241496,209214278.8,84.56315630275832,77.51360844327618,NaN,NaN,23.247579555037902,17.685739568884916
2012-08-08T09:30:00-04:00,71.38,72,71.25,71.75,9499965,13087964.85,66.45318131133308,61.394031921985224,NaN,NaN,134.95294993121888,115.11043317761305,0.2231747229230827,1.340156193070456,1.1169814701473733,234741461,214539764,85.55949351170231,78.88064836135143,NaN,NaN,24.756305183660775,18.695820370995754
2012-08-09T09:30:00-04:00,71.60001,72.50999,71.5,72.24001,11984332,12718744.65,68.0660009596124,61.72631684866748,NaN,NaN,136.39505957603401,131.28266241022578,0.24430935320448777,1.422368161652983,1.1780588084484953,246725793,225350610.2,87.34512160221729,80.05170107272428,NaN,NaN,26.49748270322191,19.810343561313775
2012-08-10T09:30:00-04:00,71.75,72.46001,71.31,72.37,11315773,12774036.6,68.4986672660639,62.391704022535656,NaN,NaN,120.6559175335707,131.4801949384959,0.24230455085664926,1.4809394970193068,1.2386349461626576,258041566,235548149.2,88.7573289203874,81.14004544035622,NaN,NaN,28.05015184000465,20.987459029698186
2012-08-13T09:30:00-04:00,72.36,72.46001,71.75,72.10001,8289133,12621710.05,66.4838379151069,63.361593170070584,NaN,NaN,112.64432791976377,130.10333734808532,0.19982344521560358,1.488414252682162,1.2885908074665584,249752433,242900549.8,89.6538067196379,82.22846100183013,NaN,NaN,28.810236677396322,22.104998693655062
2012-08-14T09:30:00-04:00,72.45,72.53,71.74001,71.97,7123141,12078622.3,65.48496211762125,64.2425953781017,NaN,NaN,103.21788126094008,121.57322724430551,0.14267726511051548,1.4669373888547028,1.3242601237441873,242629292,246378109,90.05762879933403,83.30271501826749,NaN,NaN,29.184254163297794,23.116320903604024
2012-08-15T09:30:00-04:00,71.99001,72.17,71.67,71.96001,6533070,11629365.85,65.40364709480676,64.52689487762687,NaN,NaN,86.80456118911927,111.94354949588558,0.08666920329530514,1.4325966278633189,1.3459274245680137,236096222,246649061.2,90.09008384964417,84.33499555489554,NaN,NaN,29.477388064385647,24.025044783715686
2012-08-16T09:30:00-04:00,72.08,72.73,71.88,72.60001,6884883,11274103.15,68.13363604224995,64.70775287749272,NaN,NaN,98.20137396213363,104.3048123731055,0.07559383378364015,1.4404197167975639,1.3648258830139237,242981105,245900123.6,89.22310741301905,85.25374334649895,NaN,NaN,30.45445019923968,24.943531271647686
2012-08-17T09:30:00-04:00,72.75,72.77991,72.32001,72.57001,12104133,11196063.3,67.86330771439818,64.82320163619383,NaN,NaN,95.7955769605987,99.33274425851108,0.05033186609182194,1.4277407156287012,1.3774088495368793,230876972,240467204.8,82.98434113558096,85.59462145207057,NaN,NaN,31.2094611787196,25.8386641155151
2012-08-20T09:30:00-04:00,72.38,72.5786,72.07001,72.32001,5567715,10838428.75,65.52999180234136,65.11352814170124,NaN,NaN,78.14887422804226,92.43365352016677,0.003347685046774851,1.3815934558453478,1.378245770798573,225309257,235578569.6,77.71830549336374,85.43631022461082,NaN,NaN,31.280037340010136,26.616003147585822
2012-08-21T09:30:00-04:00,72.64999,73.03,71.97501,72.09,8730262,10641998.5,63.37114672532806,65.1583103872734,NaN,NaN,74.19685327746967,86.6294479234727,-0.053520485042475974,1.3113451644954779,1.3648656495379539,216578995,230368510.2,72.44213735502302,84.77013028067611,NaN,NaN,30.798811094503893,27.21354714000269
2012-08-22T09:30:00-04:00,71.86,72.42999,71.64,72.36,8538730,10593958.45,64.83563491575192,65.79847761127506,NaN,NaN,57.69165292294722,80.80686627023829,-0.0815711704366946,1.2629016864920857,1.3444728569287803,225117725,228172810.8,70.27681641776613,83.90969792630813,NaN,NaN,30.737308966872025,27.71694168669831
2012-08-23T09:30:00-04:00,72.19,72.39,71.42,71.55499,7328746,10258352,57.45923302510793,65.46933571159808,NaN,NaN,30.571342667858456,67.28086001138325,-0.15850786101466818,1.146338030660445,1.3048458916751131,217788979,223134385.6,65.44288927415647,82.66671639601324,NaN,NaN,28.68571289411856,27.85533757347263
2012-08-24T09:30:00-04:00,71.44,72.17999,71.06,71.98,7493121,9864993.6,60.04385448082434,65.27760932315675,NaN,NaN,22.842605781678404,52.6902657755992,-0.1831939297834526,1.0758534794457972,1.2590474092292498,225282100,222015411.2,64.3836990484242,81.32127970307249,NaN,NaN,27.573813089856085,27.81511979009884
2012-08-27T09:30:00-04:00,72.06,72.5,71.77,72.00999,6067883,9681704.15,60.22748155819617,64.84675592348162,NaN,NaN,47.12134453441811,46.484759836874375,-0.19862795408730238,1.0107624666201218,1.2093904207074242,231349983,223223556.4,65.04157947755812,79.92688135841533,NaN,NaN,26.691073030277995,27.654541681553006
2012-08-28T09:30:00-04:00,71.86,72.28,71.73,72.06,6820789,9421936.2,60.55304207176751,64.4253174063698,NaN,NaN,37.88484477169801,39.22235813572005,-0.2057235561895956,0.9522359754704297,1.1579595316600253,238170772,227541911.8,67.36219418954002,78.62707426397516,NaN,NaN,26.023373559792713,27.421517664158678
2012-08-29T09:30:00-04:00,72.10001,72.16,71.50999,71.58,6351820,8932295.15,55.82936311971288,63.551271846376984,NaN,NaN,1.9097266835612352,28.065972887842843,-0.2405759480127465,0.8572395966440922,1.0978155446568387,231818952,228882157.2,68.07061676951312,77.25032391878202,NaN,NaN,24.173028105819814,26.957447727253125
2012-08-30T09:30:00-04:00,71.3,71.3,70.61,70.82001,7785383,8549440.65,49.27510835495852,62.17816049558373,NaN,NaN,-151.1393030476193,-8.27615625525271,-0.3083187243676202,0.7124171391973135,1.0207358635649337,224033569,230131075.2,68.75128869119914,75.82132104526856,NaN,NaN,20.59344965687007,26.04830514576983
2012-08-31T09:30:00-04:00,71.41,71.89,70.98,71.53,10149848,8337817.6,54.63339521647392,61.33170030282423,NaN,NaN,-80.98221774211571,-29.04112096001153,-0.298611958080207,0.647470915964675,0.946082874044882,234183417,231911338.6,69.74150406538165,74.39901371282168,NaN,NaN,18.915593011408703,25.029346269432526
2012-09-04T09:30:00-04:00,71.46001,71.50999,70.39999,70.98,8775492,8479764.25,50.20874129772764,60.24054167283184,NaN,NaN,-187.7328137176253,-76.01195261042021,-0.32059918481821126,0.5453338930221179,0.8659330778403291,225407925,230722927,68.18813844268378,72.83690725877524,NaN,NaN,16.12354080948604,23.75708834658303
2012-09-05T09:30:00-04:00,70.94,71.2,70.59,70.71001,7226586,8228540.25,48.147337529232495,59.007948132433675,NaN,NaN,-181.19322430853074,-119.82756642646595,-0.3426986911737382,0.4375597138731564,0.7802584050468946,218181339,226725040.4,63.096734700347184,70.9088108909683,NaN,NaN,13.176988759720393,22.245645548459795
2012-09-06T09:30:00-04:00,71.27,72.67999,71.25999,72.2,13522547,8429669.35,58.3180639544286,58.30683584044643,NaN,NaN,29.339863141456394,-114.34153913488694,-0.25061118797366433,0.4669944200798142,0.7176056080534785,231703886,226702027.2,63.06754256686637,69.04055625910026,NaN,NaN,13.696144564142768,21.024288264985934
2012-09-07T09:30:00-04:00,72.37,73.47,72.3,73.45,13423883,8501646.9,64.59265735305357,58.073217957493206,NaN,NaN,186.77393324493926,-46.758891876375216,-0.10652526598801448,0.5844490255684605,0.6909742915564749,245127769,230920867.2,66.15860603091545,67.83871803733845,NaN,NaN,16.39859452235182,20.36347487318106
2012-09-10T09:30:00-04:00,73.35001,73.83,73.10001,73.13,5842430,8227979.75,62.01879295040907,57.82241803949804,NaN,NaN,196.7233827900639,8.782228230060706,-0.03735190417022749,0.6442844113436905,0.681636315513918,239285339,231941251.6,66.8806065813732,67.06459668648199,NaN,NaN,17.661873199751216,19.977531776976797
2012-09-11T09:30:00-04:00,73.35001,74.11,73.35001,73.91,7505715,8188808.85,65.61542102764483,57.98272334680639,NaN,NaN,212.26757475704,88.78230592499376,0.05152609704629918,0.7460439368217919,0.6945178397754928,246791054,236217877.4,69.78975364489075,66.87514070718683,NaN,NaN,19.953608674097996,19.974114190851253
2012-09-12T09:30:00-04:00,74.35001,74.55009,74.05,74.36,8342609,8249782.25,67.5260006435304,58.17489232736199,NaN,NaN,213.66645375922047,167.75424153854402,0.1269181853502973,0.8531655714633644,0.726247386113067,255133663,243608342.2,74.03436082624523,67.14353673636391,NaN,NaN,22.44626709500767,20.327278891445026
2012-09-13T09:30:00-04:00,74.53,76.00999,73.95,75.57001,14177199,8631988.7,72.02693440670582,59.21544242604755,NaN,NaN,229.5892816600518,207.80412524226307,0.23811817731859053,1.0238951077613052,0.7857769304427147,269310862,251129737.4,77.49926536985068,68.00470645748491,NaN,NaN,26.218787162592793,21.168922930180422
2012-09-14T09:30:00-04:00,76.10001,77.35201,76.02,76.57001,15240246,9049756.85,75.09867806918126,60.29078696807304,NaN,NaN,248.31349583185974,220.1120377596472,0.3519875151902344,1.2257613244305077,0.8737738092402733,284551108,259014405.2,80.44515404492094,69.15195324294898,NaN,NaN,30.48889629828489,22.50034769705249
2012-09-17T09:30:00-04:00,76.25999,76.81,75.74001,75.99001,10183500,8953725.2,70.27832358019637,61.00870425535878,NaN,NaN,172.02376634260042,215.17211447015447,0.359926568930089,1.3236820204028845,0.9637554514727955,274367608,266030859,82.62516767269979,70.40792382831624,NaN,NaN,32.271946017158584,23.896290314210503
2012-09-18T09:30:00-04:00,75.74001,75.77,74.86,75.45,9920133,9171346.1,66.02881527722543,61.39983091289149,NaN,NaN,111.57765445094532,195.03413040893557,0.30278611739090344,1.3422380982114248,1.0394519808205214,264447475,269562143.2,83.61519196624064,71.56885224093772,NaN,NaN,32.29612835206606,25.096267176761298
2012-09-19T09:30:00-04:00,75.38,75.45,74.64999,74.72,14808328,9475249.4,60.68666272665625,61.74678088481601,NaN,NaN,81.77709642286491,168.65625894166445,0.19503566087453938,1.2832465569136957,1.0882108960391563,249639147,268463240,82.04841607203036,72.5672664768318,NaN,NaN,30.53493074084391,25.873219114487387
2012-09-20T09:30:00-04:00,74.08,75.08,73.78,74.9287,11743824,9635504.1,61.64214227769194,62.63014045072554,NaN,NaN,60.18823266408351,134.7760491424708,0.12067340599984488,1.2390526535389625,1.1183792475391177,261382971,266877661.8,79.72706732921766,73.35125066526169,NaN,NaN,29.433994297934795,26.381901283551304
2012-09-21T09:30:00-04:00,75.24001,75.27,74.5,74.675,12699832,9904058.4,59.741330659528145,62.99499298237227,NaN,NaN,62.41777368563129,97.59690471322513,0.041352094504253145,1.170069365669434,1.128717271165181,248683139,259704068,70.06822447231109,73.37458783718522,NaN,NaN,27.96020022484118,26.607372560878428
2012-09-24T09:30:00-04:00,74.03,74.5,74.02,74.3,7390410,9898922.85,56.94608053117582,63.47623149904714,NaN,NaN,35.57507331648589,70.30716610800222,-0.04475463579670569,1.072773976419299,1.1175286122160046,241292729,253089092.2,62.543700252000875,72.97141368070787,NaN,NaN,25.894929913673437,26.505595039849144
2012-09-25T09:30:00-04:00,74.5,74.64,73.42,73.485,13493219,10270189.65,51.32539708465093,63.70323575300561,NaN,NaN,14.430249296363447,50.87768507708584,-0.15857824527431497,0.9193058056231109,1.077884050897426,227799510,245759499.2,55.43952428463531,72.42447007958559,NaN,NaN,22.34740620293687,25.911568063147392
2012-09-26T09:30:00-04:00,73.19,73.28,72.5399,72.78999,15804254,10719362.9,47.05967695405349,62.89906525297881,NaN,NaN,-31.15648282207452,28.290969228097943,-0.27578852258171915,0.7331483976702771,1.0089369202519962,211995256,238230721,49.251159267172056,71.43758555817887,NaN,NaN,17.967120222126113,24.776646943001495
2012-09-27T09:30:00-04:00,73.35001,73.99001,73.03999,73.78,8327469,10818145.35,53.046069660618215,62.07430898923343,NaN,NaN,-2.423028143065912,15.768717066668057,-0.2808145235416408,0.6579187658249452,0.9387332893665861,220322725,230018671.8,43.54194926532828,69.82211007492263,NaN,NaN,16.024776920294645,23.526379796900518
2012-09-28T09:30:00-04:00,73.57001,73.64,72.99001,73.435,8448598,10851306.1,50.886604099209094,61.27915264271915,NaN,NaN,-22.584422137106586,-1.231722097879525,-0.2998193084532923,0.5639591537999706,0.8637784622532629,211874127,222656869.4,39.15952633178815,67.84203291423799,NaN,NaN,13.76972968450353,22.132572637986662
2012-10-01T09:30:00-04:00,73.94,74.53,73.7,73.8,11121527,10899890.05,53.06361767222351,60.38259526018904,NaN,NaN,6.331785048440605,-7.080379751488581,-0.2805955719411356,0.5130339973268434,0.793629569267979,222995654,218997454.4,37.15752050414488,65.51115911847043,NaN,NaN,12.56210658211783,20.76536320143397
2012-10-02T09:30:00-04:00,74.3,74.3,73.48,73.92999,8791145,10900672.7,53.84822319542419,59.4056111567529,NaN,NaN,-9.89999204252474,-11.946428019266218,-0.2527769339504412,0.47765840182992747,0.7304353357803687,231786799,219794912.2,37.90256514913271,62.93031657010524,NaN,NaN,11.804542497552958,19.485245958022396
2012-10-03T09:30:00-04:00,73.78999,73.89,72.67,73.02,12576344,11168160.6,47.821560917072254,57.676655907493355,NaN,NaN,-73.83082684413861,-20.48129682367905,-0.2868224414486107,0.3719072839696054,0.6587297254182161,219210455,221237952,39.30485635835484,60.20214449785555,NaN,NaN,9.3011359639908,18.030373101732167
2012-10-04T09:30:00-04:00,73.42999,73.936,73.28,73.755,11377223,11060894.4,52.4505521512316,56.058932627639805,NaN,NaN,-48.82104844071712,-29.760900883209292,-0.2522253299052556,0.34344806303664654,0.5956733929419021,230587678,223290942.6,41.33459427389837,57.40853308563965,NaN,NaN,8.557419417151339,16.677094003934904
2012-10-05T09:30:00-04:00,74.17,74.25999,73.34,73.58,13890914,11084245.95,51.283977936094296,54.70219365306109,NaN,NaN,-47.44928890527308,-34.73387423684259,-0.23391719385857457,0.30327690061868395,0.5371940944772585,216696764,224255470,42.310692754254426,54.528927734322124,NaN,NaN,7.608519154031361,15.381583311091541
2012-10-08T09:30:00-04:00,73.17,73.78999,73.10001,73.7,5443777,11064313.3,52.07118125202855,53.705219794118456,NaN,NaN,-65.6363903697867,-49.127509320488045,-0.20741905940005917,0.2779202702271846,0.48533932962724374,222140541,224084447.4,42.17669186225643,51.569034869751825,NaN,NaN,7.05208631171185,14.191655168323013
2012-10-09T09:30:00-04:00,73.77,74.38,73.675,73.8,10291910,11203623.05,52.756294689293036,53.13876493430679,NaN,NaN,-30.160115763548518,-53.1795340646928,-0.17798027188146598,0.26286398977541126,0.44084426165687723,232432451,224213577.8,42.32521810305519,48.731663586253596,NaN,NaN,6.776549471347801,13.132354354469411
2012-10-10T09:30:00-04:00,73.37,73.49001,72.22,72.42,15193051,11546145.15,43.51261805629304,51.84379891849259,NaN,NaN,-121.81114434870732,-62.77559756560654,-0.24228605929056318,0.13798668754367327,0.38027274683423645,217239400,223819366.8,41.97078662225538,46.03478639289915,NaN,NaN,3.685978394429021,11.782872074463642
2012-10-11T09:30:00-04:00,73.12,73.565,72.92,72.96001,8272723,11250921.35,47.39672052309593,50.96204105160457,NaN,NaN,-80.63087498135481,-69.13756287373408,-0.23889534284875225,0.08165356827329617,0.3205489111220484,225512123,222804255.8,41.01825426799996,43.95978852116264,NaN,NaN,2.2487807961575657,10.42085903470563
2012-10-12T09:30:00-04:00,72.94,73.07001,72.03999,72.56,10761777,11026997.9,44.93210205645789,50.10389973198187,NaN,NaN,-132.1387323379728,-86.07545156027402,-0.25269690578314996,0.00467777889311094,0.2573746846762609,214750346,222414972.2,40.63736787759182,42.39505049441914,NaN,NaN,0.30514775577511605,8.975757423429842
2012-10-15T09:30:00-04:00,72.42999,73.03999,71.91,72.92999,8093980,10922521.9,47.64399016572929,49.84094209491604,NaN,NaN,-121.1076554011339,-97.16970456654346,-0.2268352071225393,-0.026169324226913204,0.2006658828956261,222844326,222555729.2,40.85123917801303,41.35303012966041,NaN,NaN,-0.5232018176257237,7.61876324613619
2012-10-16T09:30:00-04:00,73.36,74.23,73.36,74.09,13350715,11094051,55.10838977887966,50.415850153832196,NaN,NaN,29.004202730129627,-85.33684086780784,-0.1265348233871395,0.04249735366170171,0.16903217704884121,236195041,223308247.2,42.05322733297153,40.83889213436037,NaN,NaN,1.1045555054230711,6.68816214032003
2012-10-17T09:30:00-04:00,74.3,75.0701,74.14999,75.02,10346191,10870944.15,60.028599402234796,50.914602278233374,NaN,NaN,138.81420913680768,-33.21177017070484,0.0007740717853890189,0.1699997667805775,0.16922569499518847,246541232,229168613.6,50.49105696954341,41.33525697037574,NaN,NaN,4.148789761663005,6.3253946576547415
2012-10-18T09:30:00-04:00,74.67999,75.19,74.63,75.00999,14413426,11004424.25,59.95243341942298,51.56216151539151,NaN,NaN,156.5460845596971,14.223621737505539,0.07834662960053934,0.26715898199586263,0.1888123523953233,232127806,230491750.2,52.18398868681945,42.26557571002083,NaN,NaN,6.511472494184649,6.351977205730442
2012-10-19T09:30:00-04:00,74.95,75.10001,73.56,73.83,14092734,11074069.35,51.63522067934594,51.4601331587574,NaN,NaN,68.64155631596361,54.37967946829283,0.04583497491967764,0.24610607104492033,0.2002710961252427,218035072,231148695.4,53.04254635164037,43.400220413413365,NaN,NaN,5.954200551704516,6.295151969441024
2012-10-22T09:30:00-04:00,73.86,74.10001,72.72,73.46001,10844297,11246763.7,49.32458854627908,51.13701639810419,NaN,NaN,-22.55310114876017,74.09059031876758,-0.0023831762937511214,0.19729212575805377,0.1996753020518049,207190775,228017985.2,48.567096711929985,44.16197266789889,NaN,NaN,4.772014888032355,6.077560957811214
2012-10-23T09:30:00-04:00,72.22,72.28999,71.23,71.75,15428453,11343525.4,40.33973234574508,50.60260007158082,NaN,NaN,-200.6613533093716,28.15747911086733,-0.143429694213151,0.02038818428536615,0.16381787849851714,191762322,219131441.4,38.60901413746078,44.112269652120744,NaN,NaN,0.5296024858809963,5.284995461821183
2012-10-24T09:30:00-04:00,72.11,72.25,71.07001,71.2,10695547,11088090.05,37.94554994630706,49.56652848551477,NaN,NaN,-195.97776393044137,-38.80091550258247,-0.2609093089708244,-0.16231875771501336,0.09859055125581104,181066775,206036550,29.130583058699557,43.24055456532083,NaN,NaN,-3.694242870503505,4.002247128631942
2012-10-25T09:30:00-04:00,71.91,72.03999,71.02,71.87,9793180,11161375.6,42.42816159888749,48.93397017571429,NaN,NaN,-150.50161533394308,-100.2104554813105,-0.2790069549128252,-0.25016814238522045,0.02883881252760473,190859955,197782979.8,24.969698436002815,42.001912114017145,NaN,NaN,-5.67427378362663,2.619886998309289
2012-10-26T09:30:00-04:00,71.73,72.39999,71.60001,71.96001,11008367,11289364.05,43.023623056989656,48.2877160189258,NaN,NaN,-103.56905703064062,-134.65257815063134,-0.2702428931946955,-0.30896480396576464,-0.03872191077106915,201868322,194549629.8,23.550533728957703,40.671472247352945,NaN,NaN,-7.041453888219857,1.2396954430908398
2012-10-31T09:30:00-04:00,72.25,72.47,71.35001,71.94009,11125738,11289574.6,42.917828201040514,47.58496841262205,NaN,NaN,-96.53655883354568,-149.44926968758847,-0.25150139767548924,-0.3530986578654307,-0.10159726018994147,190742584,191259991.6,22.169945303964155,39.23180990456073,NaN,NaN,-8.162540493168773,-0.10348111923196202
2012-11-01T09:30:00-04:00,71.66,72.395,71.53999,72.2467,9490758,11324555.25,45.153401602262875,47.70216723733417,NaN,NaN,-75.95522530721902,-124.50804408715794,-0.20607709578358074,-0.3591936299194174,-0.15311653413583665,200233342,192954195.6,24.620798272047736,37.992525022403036,NaN,NaN,-8.460937860786208,-1.2974035108825686
2012-11-02T09:30:00-04:00,72.49001,72.69,70.82001,71.06,11264871,11258981.6,38.81691184327632,47.0893237602042,NaN,NaN,-102.35049564891658,-105.78259043085298,-0.24113960892353536,-0.45454104529025585,-0.2134014363667205,188968471,194534534.8,26.932147447378284,36.98637453521578,NaN,NaN,-10.68580118788034,-2.6386031790251074
2012-11-05T09:30:00-05:00,70.92,71.78999,70.84,71.60001,7417348,11060987.85,42.75377789519027,46.93372917725652,NaN,NaN,-98.98351748423491,-95.47897086091136,-0.21406745932304377,-0.4809857605205252,-0.26691830119748144,196385819,195639707.6,28.58141021223784,36.12523470197622,NaN,NaN,-11.351626392932214,-3.883320781011837
2012-11-06T09:30:00-05:00,71.96001,73.06,71.92,72.75,10519242,10892404.25,50.115239943082415,47.110247018496025,NaN,NaN,-16.1748861762838,-78.00013669004,-0.11005427206525564,-0.404486141279051,-0.2944318692137954,206905061,196647055.4,30.129483099328553,35.35939498207018,NaN,NaN,-9.554302828633196,-4.693461073529174
2012-11-07T09:30:00-05:00,71.67999,71.84,70.35001,70.85001,19044560,11572443.4,40.783831404473176,46.08706427746699,NaN,NaN,-116.12583592987949,-81.91799210930677,-0.15766023849204214,-0.491507167328848,-0.3338469288368059,187860501,196070638.8,29.73233645876752,34.479331348198464,NaN,NaN,-11.206927263989144,-5.6239562435948836
2012-11-08T09:30:00-05:00,70.8,71.07001,69.53,69.57001,15013387,11808517.25,35.930066388071154,44.36574049074102,NaN,NaN,-162.48028160047832,-99.22300336795861,-0.25787691670674356,-0.6561930747202354,-0.3983161580134918,172847114,190593393.2,26.198502791105227,32.744148906881456,NaN,NaN,-14.359798961704337,-6.871933774753376
2012-11-09T09:30:00-05:00,69.35001,70.37,69.14999,69.55,12227699,11660249.65,35.858220608502435,42.64472528996098,NaN,NaN,-158.85380600946155,-110.52366544006762,-0.30481807406909645,-0.7793387505998624,-0.4745206765307659,160619415,184923582,23.133384078962024,30.669105720605923,NaN,NaN,-16.758935602701307,-8.284362607317366
2012-11-12T09:30:00-05:00,69.82001,69.89999,69.4001,69.69,5583578,11525792.4,36.810261128591314,41.585799607764216,NaN,NaN,-142.54872147336948,-119.23670623789454,-0.3050002276074165,-0.8557709610400366,-0.5507707334326201,166202993,178887016.8,20.39718860587601,28.337294453051328,NaN,NaN,-18.34722024435655,-9.721913698322963
2012-11-13T09:30:00-05:00,69.07001,70.31,69,69.3998,11300699,11552738.5,35.62972059881112,40.60759475437366,NaN,NaN,-131.48206071155434,-142.29814114494863,-0.30262439639222505,-0.9290512289229014,-0.6264268325306763,154902294,168486463.4,16.72638412163495,26.062957839458825,NaN,NaN,-19.997488287408576,-11.189852925335193
2012-11-14T09:30:00-05:00,69.62,69.75,68.38,68.55499,19242048,12110141.9,32.37462960829755,40.038658844555975,NaN,NaN,-146.54611667353137,-148.382197293679,-0.3334739872040299,-1.0432693165357136,-0.7097953293316838,135660246,158046412.4,14.002296530552456,24.305335153251093,NaN,NaN,-22.431966271241684,-12.795869117607548
2012-11-15T09:30:00-05:00,68.59,69.265,68.19,68.64999,14652016,12175206.95,33.11462855619155,39.693593030976295,NaN,NaN,-140.27773538687634,-143.94168805095862,-0.3227949090279023,-1.1132889656165617,-0.7904940565886593,150312262,153539442,13.016726370004491,23.154345389772875,NaN,NaN,-24.17828073277407,-14.421927919774195
2012-11-16T09:30:00-05:00,68.75,69.02,67.77,68.92,21477872,12731791,35.28226131854839,39.183171582380645,NaN,NaN,-128.9921742325961,-137.96936169558552,-0.27474183636139493,-1.133921352040403,-0.8591795156790081,171790134,155773585.8,16.166763053846537,22.525564291047424,NaN,NaN,-25.020067720055156,-15.935947891242904
2012-11-19T09:30:00-05:00,69.86,70.62,69.81,70.51109,11458070,12584023.2,46.32182451076836,39.418757400507694,NaN,NaN,-37.120105199277845,-116.88363844076721,-0.12084805794015241,-1.0102395881041986,-0.8893915301640462,183248204,159182628,20.875421718403274,22.33448486172211,NaN,NaN,-22.320661612297787,-16.8480498513936
2012-11-20T09:30:00-05:00,70.32001,70.59,69.74001,70.23,7712469,12265009.95,44.86576551892966,39.55789578035693,NaN,NaN,-36.089010193545214,-97.80502833716538,-0.027885458466381574,-0.9242483532470231,-0.8963628947806416,175535735,163309316.2,26.273724396207896,22.627611939739516,NaN,NaN,-20.562574175129413,-17.37869618335586
2012-11-21T09:30:00-05:00,70.45,70.7,70.16,70.61,5868410,12016215.6,47.278470385475735,39.70968640772927,NaN,NaN,-11.709681674518192,-70.83774133736274,0.0642661813721056,-0.8160301680655095,-0.8802963494376151,181404145,172458096,36.600768231469566,23.483324079698217,NaN,NaN,-18.37727197102698,-17.521349867308878
2012-11-23T09:30:00-05:00,70.94,71.61,70.77,71.61,4502316,11469908.75,53.09546632438251,40.72958315637971,NaN,NaN,43.17508215221458,-34.14717782954457,0.19049926212829926,-0.6421722717772411,-0.8326715339055404,185906461,179576935.8,43.26068143431674,24.64964793590811,NaN,NaN,-14.619361740838649,-17.106780134955986
2012-11-26T09:30:00-05:00,70.99001,71.03999,70.41499,70.90981,9398520,11405057.4,49.01733643320166,41.1769801948091,NaN,NaN,11.189111788209454,-6.110920625383462,0.2225402429023694,-0.5544962302775787,-0.7770364731799481,176507941,180520497.2,44.09888722436993,25.758039151060398,NaN,NaN,-12.673580185916913,-16.473465856521834
2012-11-27T09:30:00-05:00,70.7,71.00999,70.19,70.32001,7787988,11304797.8,45.82451218632087,40.870499640754694,NaN,NaN,-3.908408036123654,0.5314188072473824,0.20040141673447398,-0.5265347022618556,-0.7269361189963296,168719953,177614847,42.03930146982364,26.60874046323862,NaN,NaN,-12.014678393851277,-15.83649621899747
2012-11-28T09:30:00-05:00,69.64999,71.07001,69.42999,70.96001,11587898,11333774.35,49.65653673247062,41.50426430704022,NaN,NaN,-0.07295055642704225,7.734630734671017,0.22349049866022175,-0.44757299567105235,-0.6710634943312741,180307851,178569270.2,42.98130357538634,27.555095257282822,NaN,NaN,-10.27380272950644,-15.041825720498752
2012-11-29T09:30:00-05:00,71.42999,71.71001,70.87,71.12,10951031,11325039,50.59728582738607,42.551922838419856,NaN,NaN,61.668743156586736,22.410315700892017,0.2425746924783846,-0.36784512873329334,-0.6104198212116779,191258882,180540217.6,44.97030059836428,28.895937957801326,NaN,NaN,-8.58313537565032,-14.11915567123469
2012-11-30T09:30:00-05:00,71.2,71.45,70.8,71.06,8365605,11268781.35,50.21828886735353,43.577641999766364,NaN,NaN,58.14492169943767,25.404283610336634,0.24355615038798484,-0.3059746332266968,-0.5495307836146817,182893277,179937580.8,44.4596217038208,30.41924064529124,NaN,NaN,-7.3079622471141485,-13.14612803921747
2012-12-03T09:30:00-05:00,71.60001,71.7,70.59,70.6703,9766477,11193861.65,47.71819479608918,44.35678011887335,NaN,NaN,52.244988902628904,33.615459033220525,0.21154391699921876,-0.2851008873656582,-0.49664480436487696,173126800,179261352.6,43.857767972457,32.09499631433273,NaN,NaN,-6.9052755799753855,-12.254577687897172
2012-12-04T09:30:00-05:00,70.7,71.03,70.37,70.4099,11395707,11392779.6,46.0678024789725,45.10235739602774,NaN,NaN,23.88522760903407,39.17418616225207,0.16829948382443277,-0.286270449584336,-0.4545699334087688,161731093,177863580.6,42.574829428182674,33.94131383622901,NaN,NaN,-7.013481333931961,-11.505849637330712
2012-12-05T09:30:00-05:00,70.63,71.28999,70.44,70.89999,12531984,11493416.7,49.60082312721067,46.33279979023582,NaN,NaN,62.09560611730581,51.60789749699863,0.1677928000241128,-0.24482893337862777,-0.41262173340274055,174263077,176654625.8,41.44556460837114,35.90154727035891,NaN,NaN,-6.134489395545352,-10.738512459932803
2012-12-06T09:30:00-05:00,70.75,71.13,70.63,71.1299,8107340,10946555.7,51.215359638615375,47.625709153266094,NaN,NaN,71.18785073255673,53.511719012192636,0.1771133572616546,-0.1912300368256723,-0.3683433940873269,182370417,174876932.8,39.774921826844405,37.812846945847475,NaN,NaN,-4.949829497156626,-9.911557750964779
2012-12-07T09:30:00-05:00,71.37,71.57001,71.02,71.56,10384340,10715103.35,54.172979241485024,48.975046147761574,NaN,NaN,102.3292243187203,62.34857953604917,0.20447682073665396,-0.11274736816650943,-0.3172241889031634,192754757,176849228.8,42.542210509957386,39.69680747842682,NaN,NaN,-3.1024371635708947,-8.938826238479939
2012-12-10T09:30:00-05:00,71.53,71.81,71.33,71.48,5835777,10395507.25,53.522992019034334,49.489415255494855,NaN,NaN,108.16943101918073,73.53346795935953,0.20869535597150463,-0.05635499393878263,-0.26505034991028725,186918980,179607664.8,46.26132501853086,41.51008628557879,NaN,NaN,-1.7238679864064415,-7.908117916755153
2012-12-11T09:30:00-05:00,71.77,72.17,71.63,71.89999,7875055,10510081.1,56.475490169172154,50.31868130194074,NaN,NaN,131.80863462891088,95.1181493633349,0.22961849079060054,0.021972763577963406,-0.20764572721263713,194794035,186220253.2,53.9554939425003,43.48735553888539,NaN,NaN,0.28841551862893683,-6.737184568843141
2012-12-12T09:30:00-05:00,72.12,72.825,71.92,72.16,9193246,10404708.45,58.24399479434994,51.10193304543176,NaN,NaN,152.8589978357318,113.27082770702009,0.2491820228610671,0.10383180136369674,-0.14535022149737037,203987281,192165094,59.56115604701457,45.127383239995744,NaN,NaN,2.499571402445613,-5.417648001516176
2012-12-13T09:30:00-05:00,72.07001,72.08009,71.2,71.49001,10767230,9980967.55,52.34216175755651,51.048125576372755,NaN,NaN,81.9222713969002,115.41771183988878,0.2069494660053835,0.11333661100935899,-0.0936128549960245,193220051,194335020.8,61.40802321389357,46.42362193853695,NaN,NaN,2.8738707690224867,-4.233145320010653
2012-12-14T09:30:00-05:00,71.00999,71.36,70.91,71.22,9442613,9720497.4,50.137243811872665,51.12811896056355,NaN,NaN,30.43643216071985,101.0391534082887,0.15325232769550895,0.09795255462336172,-0.05529977307214724,183777438,192539557,59.006679333757255,47.48846423206461,NaN,NaN,2.582483337887671,-3.259484083168035
2012-12-17T09:30:00-05:00,71.46001,71.89999,71.33,71.87,9494410,9121324.3,55.04656912271619,51.78683731316322,NaN,NaN,92.54193771612317,97.91365474767717,0.15354790039085403,0.1366351024164203,-0.016912797974433735,193271848,193810130.6,60.19298527768263,48.78515593262597,NaN,NaN,3.7264648686967474,-2.2614913757587805
2012-12-18T09:30:00-05:00,71.86,73.35001,71.72,73.19,11188273,9107834.45,63.011130243421874,52.74073684965973,NaN,NaN,208.58868891562932,113.26966560502088,0.23007743195579952,0.2706839919703157,0.04060656001451615,204460121,195743347.8,61.995124850219845,50.143286023685505,NaN,NaN,7.388087492466518,-0.8829801088694522
2012-12-19T09:30:00-05:00,73.31,73.39011,72.64999,72.68871,8091539,9126787.95,58.75382357895524,53.32334668905754,NaN,NaN,193.72905854090166,121.44367774605485,0.23362226159756064,0.33263438701146697,0.09901212541390633,196368582,194219608,59.700958212146,51.19547585324134,NaN,NaN,9.08674319190856,0.5412660769559781
2012-12-20T09:30:00-05:00,72.7,73.24001,72.55,73.17999,9008047,9283769.8,61.49926045821382,54.129130374118986,NaN,NaN,169.35082478128848,138.92938842293248,0.2540468943795195,0.4165707433883057,0.1625238490087862,205376629,196650923.6,62.11032807852331,52.456240594291515,NaN,NaN,11.374382190770307,2.0888540932151676
2012-12-21T09:30:00-05:00,71.92,72.28,71.64,72.07001,15210398,9819173.9,52.92733224888034,54.50121162074692,NaN,NaN,53.895571331243346,143.6212162570372,0.18121307112772267,0.38904018791843953,0.20782711679071686,190166231,197928682.2,63.35046429627397,53.84857604599273,NaN,NaN,10.540238197478825,3.296194679538547
2012-12-24T09:30:00-05:00,71.92,71.99001,71.405,71.52,3592186,9528857.2,49.26319822479104,54.72945417401968,NaN,NaN,11.878250141997327,127.48847874221201,0.08906767968079005,0.31916171639170443,0.23009403671091438,186574045,196589121.6,61.09291305744873,55.17129630522602,NaN,NaN,8.633523213216353,4.058670184349662
2012-12-26T09:30:00-05:00,71.95,71.98,71.10001,71.2,6520301,9465472.85,47.21516528853313,54.55905004268557,NaN,NaN,-17.986289504674357,82.17348305815128,0.004124282695234294,0.23524939007995727,0.23112510738472297,180053744,191707846.2,53.59761499644897,56.03929990437444,NaN,NaN,6.4340823971407906,4.398014786176966
2012-12-27T09:30:00-05:00,71.21001,71.28999,70.19,71.07001,11660762,9469116.05,46.37180531356293,54.21308187661039,NaN,NaN,-91.59848953620924,25.107973442729097,-0.059735576227975484,0.15645563709975363,0.21619121332772911,168392982,186112726.2,46.54807784515179,56.52309676282497,NaN,NaN,4.410676530350019,4.399823606773117
2012-12-28T09:30:00-05:00,70.64,70.67999,69.77,69.83,11802598,9511694.4,39.18198785305212,53.14229677743662,NaN,NaN,-162.3365328206534,-41.22949807765929,-0.17773577635093435,-0.0059785071109388355,0.1717572692399955,156590384,176355477.2,37.32769459443365,56.15063134028755,NaN,NaN,0.16564892758509886,3.794941509746257
2012-12-31T09:30:00-05:00,69.71001,71.44,69.57001,71.42,16385133,9912670.8,49.90699450247854,52.88401124053978,NaN,NaN,-78.25012337112352,-67.65863701813264,-0.1424746054214825,-0.006335987536857601,0.1361386178846249,172975517,172917334.4,34.71803666303482,55.326110743466415,NaN,NaN,0.10627371096610792,3.2679889670633786
2013-01-02T09:30:00-05:00,72.95,73.02,72,72.995,14545781,10151636,57.83840608616797,52.98136237746805,NaN,NaN,110.98784979167564,-47.836717088197,-0.013633161640836111,0.11909716583357977,0.13273032747441588,187521298,173106785,34.98775120516635,53.97127197651399,NaN,NaN,3.062382930559273,3.2386166761342206
2013-01-03T09:30:00-05:00,72.89,73.63,72.56,72.98,9786676,10071184.45,57.744632526107615,52.94569364402217,NaN,NaN,131.27242884596942,-17.98497341806824,0.06566949009138923,0.2148171900886524,0.14914769999726318,177734622,172642960.6,34.61073135045295,52.18909878390245,NaN,NaN,5.223812889258829,3.522216135152022
2013-01-04T09:30:00-05:00,73.09,73.89,73.05,73.78999,9297754,9909472.95,61.38536757375878,53.591636916608046,NaN,NaN,154.87699238738028,31.31012296664967,0.16226427106979155,0.3519780388345026,0.18971376776471108,187032376,176370839.4,40.189266768912525,50.673473323546666,NaN,NaN,8.261162634640138,4.199208492221753
2013-01-07T09:30:00-05:00,73.45,73.45,72.94,73.22,7973395,9902775.7,57.622885362830736,54.126325598819335,NaN,NaN,106.66652915609532,85.1107353619994,0.17619683280972012,0.4099598087768612,0.2337629759671411,179058981,180864558.8,46.15282529406461,49.75534089214005,NaN,NaN,9.467781376484874,4.951861761402198
2013-01-08T09:30:00-05:00,73.02,73.03999,72.52,72.98,7375844,9752350.9,56.06466975016441,54.19904707220849,NaN,NaN,67.56785031177512,114.27433009857914,0.158245551715684,0.43156991561174607,0.2733243638960621,171683137,180606082.8,45.86952335725683,48.73223646925249,NaN,NaN,9.932743006766401,5.663416225025656
2013-01-09T09:30:00-05:00,73.19,73.28,72.55,72.86,7372477,9829185.9,55.26003571384438,53.64539746295295,NaN,NaN,64.67471801338314,105.01170374292064,0.1285485774799925,0.4340100857460527,0.3054615082660602,164310660,175963955.2,41.00170162169746,47.23270623864375,NaN,NaN,10.063530630141422,6.29200399718505
2013-01-10T09:30:00-05:00,73.46001,73.64999,73.06,73.52,8367340,9853800.15,58.76528940162152,53.64621645028627,NaN,NaN,95.58222937008738,97.87366384774423,0.14253118436337459,0.48362548872027844,0.34109430435690385,172678000,174952630.8,40.00563205862164,45.82589722767772,NaN,NaN,11.234268679862138,6.998041808996063
2013-01-11T09:30:00-05:00,73.60001,73.72,73.34,73.61,6366465,9712461.1,59.23432063443653,53.48443503430217,NaN,NaN,95.79966655720115,86.0581986817084,0.14645738934376334,0.524166041036608,0.3777086516928447,179044465,173355048.6,38.41789435646625,44.13358053324508,NaN,NaN,12.318700692904608,7.758135935268712
2013-01-14T09:30:00-05:00,73.57001,73.83,73.36,73.62,8397875,9593993.35,59.28973022827756,53.93889203283055,NaN,NaN,90.43587267025417,82.81206738454019,0.13843539916241315,0.5507529006458611,0.412317501483448,187442340,175031720.4,41.06167221649497,42.541523956118006,NaN,NaN,13.220406874431125,8.538460355149056
2013-01-15T09:30:00-05:00,73.34,74.00999,73.19,73.95,9639406,9603833,61.16561162005399,54.78906441820647,NaN,NaN,92.42093538528002,87.78268439924116,0.14345116785404632,0.5916314613010059,0.44818029344695953,197081746,180111442.2,48.302913906169785,41.627952588169514,NaN,NaN,14.506224886494213,9.390998145341221
2013-01-16T09:30:00-05:00,73.83,74.295,73.72,74.28,8585539,9558389.45,63.00159634922106,55.91666663682703,NaN,NaN,112.90383663653793,97.4285081238721,0.1560488621122036,0.643241371087214,0.48719250897501043,205667285,188382767.2,57.46651269456306,41.90430242374909,NaN,NaN,16.114437764483437,10.351489519504396
2013-01-17T09:30:00-05:00,74.64999,75.22501,74.44,74.752,10502094,9524080.5,65.51302281628298,57.283896458449895,NaN,NaN,147.70930271700283,107.8539227932552,0.18144480981935907,0.7139985212492093,0.5325537114298502,216169379,197081043,64.5773919834412,43.19211057648405,NaN,NaN,18.22226855193966,11.475886524138005
2013-01-18T09:30:00-05:00,74.81,75.49001,74.64999,75.49001,13406719,9789839.5,69.05051755618918,59.41736286581682,NaN,NaN,154.90740180291243,119.67546984239746,0.2300937446293958,0.8201708922165949,0.5900771475871991,229576098,207187369.6,70.70546301995518,45.576236892592725,NaN,NaN,21.1495109255544,12.857832867197489
2013-01-22T09:30:00-05:00,75.36,76.3071,75.14999,76.21001,10149758,9846925.05,72.06144034690959,60.99982328327619,NaN,NaN,169.6354978265605,135.51539487365872,0.28909315740646324,0.9514435943452781,0.6623504369388149,239725856,217644072.8,75.43981942700701,48.484935661447885,NaN,NaN,24.649972803822045,14.542424286715283
2013-01-23T09:30:00-05:00,76.03,76.16,75.66,75.95,7169211,9444865.7,69.43442092119666,61.82811005720681,NaN,NaN,150.93130857644815,147.21746951189235,0.28828635204028574,1.022708376989172,0.7344220249488863,232556645,224739052.6,78.03381918074258,51.55965480256047,NaN,NaN,26.808488247341682,16.29471913823334
2013-01-24T09:30:00-05:00,76.03999,76.7943,75.96001,76.17,8820789,9706295.85,70.41711465992036,62.733287352479145,NaN,NaN,152.49492987048524,155.13568815868183,0.28001251574986386,1.0844376696362161,0.8044251538863523,241377434,231881082.4,80.29049544205517,54.822495094817775,NaN,NaN,28.893595981691128,18.09455868729874
2013-01-25T09:30:00-05:00,76.53999,77.05,76.41,76.89,7795754,9770068.5,73.42806281110236,63.593479869432265,NaN,NaN,154.9937963245755,156.59258688019636,0.29876284405150133,1.177878708950729,0.8791158648992277,249173188,238481844.2,82.11887604841073,57.8174671862105,NaN,NaN,31.64787631757947,20.030746920195988
2013-01-28T09:30:00-05:00,77.17999,77.17999,76.31,76.75999,7451145,9559587.65,72.00297336767711,64.62062901263558,NaN,NaN,132.04186342432197,152.01947920447827,0.27854187860459,1.2272932131549652,0.9487513345503752,241722043,240911033.2,82.75297497864747,60.43176359225214,NaN,NaN,33.51691081832311,21.95734176278558
2013-01-29T09:30:00-05:00,76.97,78.14999,76.94,78,11646504,9551782.95,76.65647260356596,66.09147207359283,NaN,NaN,152.81378139812966,148.65513591879207,0.32175110015670416,1.3509402097462555,1.0291891095895513,253368547,243639571.4,83.46237118660677,63.11696700863428,NaN,NaN,36.7487878874685,24.07040549488314
2013-01-30T09:30:00-05:00,78.16,78.59,77.48,77.61,9942906,9229671.6,72.57088739043334,67.32796147906348,NaN,NaN,142.09791657105805,146.88845751771404,0.2976952692390349,1.401308196138345,1.10361292689931,243425641,245813370.6,84.02608679406106,66.19013737808882,NaN,NaN,38.17507064725001,26.08535765950698
2013-01-31T09:30:00-05:00,77.36,77.74001,77.0699,77.35001,10515270,9028146.05,69.89642125901075,68.12304232601984,NaN,NaN,105.87411209400017,137.56429396241703,0.2403584797177638,1.4040610265465148,1.163702546828751,232910371,244119958,81.69002726345575,69.16759417843411,NaN,NaN,38.54944463581887,27.86594151326582
2013-02-01T09:30:00-05:00,77.75999,78.17,77.16,78.07001,11818289,9129726.7,72.8774472784502,69.09755137202083,NaN,NaN,109.93107943761679,128.55175058502527,0.22716036612420742,1.4476530044840104,1.220492638359803,244728660,243231052.4,80.42603629227759,72.16817574527778,NaN,NaN,39.78467577772514,29.56861783676001
2013-02-04T09:30:00-05:00,77.39999,77.675,77.28,77.33,10673973,9198537.65,65.67862478593162,69.55390098328182,NaN,NaN,84.81233409258736,119.10584471867837,0.14862721464266815,1.4062766566631382,1.25764944202047,234054687,241697581.2,78.17870012559834,74.81939202449946,NaN,NaN,38.576402000433994,30.855444145856293
2013-02-05T09:30:00-05:00,77.86,78.21001,77.56,78,11685039,9384119.85,68.69385073571277,70.09163234868602,NaN,NaN,95.62832129394819,107.6687526978421,0.12290495740669116,1.411280638778834,1.2883756813721428,245739726,240171817,75.905990724008,76.79104036863076,NaN,NaN,38.493119329113284,31.946540600607293
2013-02-06T09:30:00-05:00,77.58,78.08501,77.35001,78.05,11386395,9584647.4,68.91333791554719,70.5138996034236,NaN,NaN,85.47693341704033,96.34455606703855,0.09178487196911811,1.4031067713335403,1.3113218993644222,257126121,242911913,77.18853308646567,78.19975611090952,NaN,NaN,38.49208345656832,32.881618151458866
2013-02-07T09:30:00-05:00,77.99001,78.17,77.33,77.85001,11930852,9812566.15,66.8931845657848,70.61248258553087,NaN,NaN,77.36328729858113,90.64239110795472,0.04274992462306404,1.3647593051432523,1.3220093805201882,245195269,245368892.6,78.30377058900471,79.18021172559261,NaN,NaN,37.90208167986337,33.598827226945225
2013-02-08T09:30:00-05:00,77.96001,78.61,77.96001,78.58,9448133,9866605.8,70.31397461483337,70.70272951829118,NaN,NaN,97.83711437102146,88.22359809463566,0.04430849713913654,1.3773950019441088,1.3330865048049723,254643402,247351841,79.18811242025157,79.78611525418522,NaN,NaN,38.396494321417855,34.284208240441316
2013-02-11T09:30:00-05:00,78.59,78.59,78.08,78.19,6961375,9896351.3,66.36846449244703,70.29608838582956,NaN,NaN,87.48302325627405,88.757735927373,0.00592027147188956,1.3404868441448343,1.3345665726729448,247682027,250077309,80.37229786907325,80.13843514290423,NaN,NaN,37.632210445114254,34.76249426968031
2013-02-12T09:30:00-05:00,78.37,78.53999,77.95,78.39999,7202625,9836588.8,67.42825784739861,70.15279102341542,NaN,NaN,84.00625069303075,86.43332180718951,-0.01721699255782916,1.3130453319756583,1.3302623245334875,254884652,251906294.2,81.14752747966801,80.36084287854177,NaN,NaN,37.301650303494434,35.12523084593947
2013-02-13T09:30:00-05:00,78.48,78.75,78.42999,78.67999,5692887,9639262.85,68.83832374180902,70.04002024355032,NaN,NaN,97.79910144122206,88.89775541202586,-0.02507524002785,1.298918274498675,1.323993514526525,260577539,252596577.8,81.44538926562052,80.44333529451072,NaN,NaN,37.42007810779792,35.453066169062105
2013-02-14T09:30:00-05:00,78.52,79.5099,78.28999,79.36,7310832,9575527.5,72.00773379525518,69.93856817098981,NaN,NaN,123.54352771772753,98.13380349585513,0.00263990164343908,1.3272933915808238,1.3246534899373847,267888371,257135198.2,83.31230151730954,80.52857997086063,NaN,NaN,38.45946669516678,35.88255195850563
2013-02-15T09:30:00-05:00,79.25999,79.28999,78.02499,78.45,14337922,9767318.9,62.80230579734233,69.28137763025161,NaN,NaN,88.58058693856559,96.28249800936396,-0.050277859582645856,1.2618061654590775,1.3120840250417234,253550449,256916607.6,82.87977481371837,80.53763710193712,NaN,NaN,36.50052584338916,35.97083394206042
2013-02-19T09:30:00-05:00,78.74001,79.435,78.72,79.36,7697918,9481878.85,67.3037099113846,68.61332315223866,NaN,NaN,134.25492753469894,105.63687886504894,-0.034697984179669294,1.2687115448171369,1.3034095289968062,261248367,259629875.6,83.99078902763222,80.57538123343896,NaN,NaN,36.23615267009868,36.00873661749446
2013-02-20T09:30:00-05:00,79.33,79.34,77.63,77.7,12768121,9612797,54.3767450020845,67.31374155307088,NaN,NaN,43.444834530655456,97.52459563257389,-0.1409341522572365,1.1272418386752605,1.268175990932497,248480246,258348994.4,81.30825269642428,80.3812502264649,NaN,NaN,31.263184903832503,35.330800658399895
2013-02-21T09:30:00-05:00,77.31,77.45,76.58,77.16,12262379,9867455.4,50.94859265980992,65.96032522455654,NaN,NaN,-91.86785208201142,59.591204927927194,-0.24615618002508688,0.9604807659011385,1.2066369459262254,236217867,253477060,71.90170227387196,79.68208415578034,NaN,NaN,26.10270947809091,34.01250191835575
2013-02-22T09:30:00-05:00,77.64999,78,77.03,77.97,6564551,9754643.5,55.4823197521248,64.7178161155333,NaN,NaN,-34.110610643377754,28.060377255706147,-0.2585117658468259,0.8834972386176929,1.1420090044645188,242782418,248455869.4,63.71970259285479,78.48877460582158,NaN,NaN,23.427333951888507,32.50033506600329
2013-02-25T09:30:00-05:00,78.48,78.72,75.88,75.92999,13808980,10055304.8,44.36139182263643,63.19515661815507,NaN,NaN,-141.266904450958,-17.909121022198565,-0.39330454420434613,0.6503783242090861,1.0436828684134323,228973438,243540467.2,56.89433077485093,76.96846250933962,NaN,NaN,16.662046026285584,30.237722346043615
2013-02-26T09:30:00-05:00,76.35001,76.87,75.46001,76.67999,16851456,10525320.35,48.452209470492804,61.749325099210786,NaN,NaN,-197.48318579404983,-84.25674368794833,-0.41882418182320147,0.5201526411344304,0.9389768229576319,245824894,240455772.6,53.05367120696795,75.33615397240818,NaN,NaN,12.911201377447268,27.762505064815564
2013-02-27T09:30:00-05:00,76.45,78.06,76.45,77.85001,10994578,10492724.05,54.1195375630167,60.69262507403003,NaN,NaN,-54.99088194393651,-103.9438869828667,-0.34675647003990995,0.5055312354077444,0.8522877054476543,256819472,242123617.8,54.82918085260389,73.73905738427518,NaN,NaN,11.966405940818023,25.505919475673057
2013-02-28T09:30:00-05:00,77.77,78.47,77.64999,77.69,9941164,10492636.95,53.25718466316493,59.71862508098576,NaN,NaN,4.039182518419943,-84.76248006278044,-0.30138988604096806,0.47555034789644424,0.7769402339374123,246878308,244255706,57.06465899081314,72.22197798440438,NaN,NaN,10.957487292565858,23.427572020943458
2013-03-01T09:30:00-05:00,77.38,77.92999,77.03,77.78999,13262676,10630007.25,53.75310018601298,58.53570547892716,NaN,NaN,-41.15585565764816,-86.17152906563452,-0.25785772184061884,0.45461808163663875,0.7124758034772576,260140984,247727419.2,60.493187822197996,70.88662622740055,NaN,NaN,10.336019959137923,21.557350297828382
2013-03-04T09:30:00-05:00,77.52,77.73,76.85001,77.62,10421875,10560186.55,52.72888106278033,57.56144951966525,NaN,NaN,-59.29672594604622,-69.77749336465214,-0.23439914738245027,0.4194768692491948,0.6538760166316451,249719109,251876553.4,64.17512133652126,69.72968504650397,NaN,NaN,9.528360171086504,19.838923136865258
2013-03-05T09:30:00-05:00,78.14,78.42,77.81,78.12,9984867,10525731.25,55.419578396704956,56.703686701758556,NaN,NaN,23.313694490423778,-25.618117307757434,-0.18146060766903482,0.4270502570453516,0.6085108647143864,259703976,254652369.8,66.42927060051797,68.67838098370753,NaN,NaN,9.66018943884342,18.384818322862138
2013-03-06T09:30:00-05:00,78.45,78.60001,77.92,78.21001,8200305,10351494.55,55.90615628045402,55.77996045451892,NaN,NaN,36.00503233894349,-7.41893445118143,-0.13857074114202717,0.4352974382868524,0.5738681794288796,267904281,256869331.6,68.15281000601713,67.72891103659302,NaN,NaN,9.906917667826253,17.17368965785701
2013-03-07T09:30:00-05:00,78.39,78.74001,78.03999,78.61,8466980,10205523.8,58.09501120681516,54.78619455534463,NaN,NaN,56.894452824149035,3.1521196099643887,-0.08412951578937522,0.4687062846921606,0.5528358004815358,276371261,262767922.2,72.23696412273725,66.93781550840927,NaN,NaN,10.739927835079252,16.254580826031617
2013-03-08T09:30:00-05:00,78.92999,79.12,78.49001,78.99001,7817031,9999832.75,60.120453194945384,54.59463365517341,NaN,NaN,93.6800648801646,30.11930371752694,-0.026385350243598227,0.519854112677038,0.5462394629206362,284188292,267577383.8,75.0468534276682,66.3783211236914,NaN,NaN,12.023413526239805,15.650128354632788
2013-03-11T09:30:00-04:00,78.73,79.16,78.39,79.03,8167133,9935782.75,60.33770977077976,54.097062216558776,NaN,NaN,87.4647556815781,59.47160004305181,0.00876284515016068,0.557193019358337,0.5484301742081763,292355425,276104647,79.08808667257017,66.02812809832984,NaN,NaN,13.142808910306481,15.291939862586172
2013-03-12T09:30:00-04:00,79.10001,79.53999,78.87,79.12,8523234,10013875.7,60.854577584372805,54.559764543865086,NaN,NaN,110.58154066720519,76.92516927840809,0.031077346798009997,0.5872768577056888,0.5561995109076788,300878659,284339583.6,82.10257986726877,66.08486575339016,NaN,NaN,14.22141578855585,15.139007852010412
2013-03-13T09:30:00-04:00,79,79.24001,78.74001,78.94,7782652,10042877.05,59.19312613017886,55.14865979174858,NaN,NaN,82.63046599076135,86.25025600877166,0.026876573996124864,0.5897952284028349,0.5629186544067101,293096007,289377928.8,83.65502787684136,66.92438901074512,NaN,NaN,14.728643805810862,15.080384416839047
2013-03-14T09:30:00-04:00,79.07001,80.14,79.07001,80.02,10991082,10307786.8,65.31245628917378,55.850812401537794,NaN,NaN,142.1515008389121,103.30166561172427,0.08662575156865127,0.6712008438675241,0.5845750922988728,304087089,294921094.4,85.17830563926692,68.45714637120314,NaN,NaN,16.956530200595473,15.348405243089966
2013-03-15T09:30:00-04:00,79.64,79.95,79.25999,79.60001,11246578,10504574.1,61.453105353901805,57.07164908234247,NaN,NaN,122.67732436123977,109.1011175079393,0.08740207333997085,0.6938276839738364,0.6064256106338656,292840511,296651538.2,85.62858171968118,70.50959286726244,NaN,NaN,17.79332451067342,15.697679424173316
2013-03-18T09:30:00-04:00,78.59,79.44,78.53,78.96001,8047004,10190028.2,56.020696303278285,57.61225528468429,NaN,NaN,63.97794835151845,104.40375604192738,0.036934924297836846,0.6525942660061617,0.6156593417083248,284793507,295139154.6,83.24820845883512,72.6663455281101,NaN,NaN,16.955066285440022,15.877306118639988
2013-03-19T09:30:00-04:00,79.09,79.09,77.39,78.09,12352016,10422733.1,49.60160812887474,57.28954603938844,NaN,NaN,0.366525421873821,82.36075299286111,-0.057767951171730725,0.5434494027436614,0.6012173539153921,272441491,289451721,74.82439763774696,74.09457529847747,NaN,NaN,14.234141203844967,15.642568273669271
2013-03-20T09:30:00-04:00,78.66,78.78999,78.08,78.53,6823734,10125513.75,52.562097025857796,57.23989692243793,NaN,NaN,24.216055529101922,70.67787090052921,-0.0914989991326286,0.4868436049996063,0.5783426041322349,279265225,286685564.6,71.05828334138066,75.09411989494656,NaN,NaN,12.834128066534909,15.241362529792934
2013-03-21T09:30:00-04:00,78.14999,78.75999,78.07001,78.13,8277473,9926268.45,49.70366935517898,56.95065186309264,NaN,NaN,5.750416747486152,43.39765408224402,-0.13864414243912782,0.40503742608332516,0.543681568522453,270987752,280065697.2,62.89901272432632,75.26596453081287,NaN,NaN,10.799407603185648,14.606797540277608
2013-03-22T09:30:00-04:00,78.35001,78.875,78.3,78.75,7904758,9993278.8,53.88940354316621,57.03354632597734,NaN,NaN,33.10343231836673,25.48287567366942,-0.1263155393787837,0.3857871442989733,0.512102683677757,278892510,277276097,59.78373323311232,74.95229395199794,NaN,NaN,10.30335018191531,13.99201934622585
2013-03-25T09:30:00-04:00,79.06,79.39,78.12,78.45,9839496,9794804.6,51.64956724413541,56.76425981507952,NaN,NaN,28.016364304344254,18.290558864234583,-0.1357805820851158,0.3423769560713623,0.4781575381564781,269053014,274127998.4,56.38949414832063,74.23516706255528,NaN,NaN,9.227803969417565,13.311417149538952
2013-03-26T09:30:00-04:00,78.87,79.38,78.75,79.28,6932637,9298863.65,56.97740537028647,56.840777607210406,NaN,NaN,76.03695717882435,33.424645215624686,-0.0859858550399033,0.370675219356599,0.4566610743965023,275985651,274836830.4,56.98172639226659,73.43723251871594,NaN,NaN,9.916855187757735,12.82647972642735
2013-03-27T09:30:00-04:00,78.84,79.67,78.63,79.53999,5694668,9033868.15,58.5193180453762,56.8710852385362,NaN,NaN,87.07751223549653,45.996936556903606,-0.03783930163644589,0.4093619473509449,0.4472012489873908,281680319,275319849.2,57.4062019567201,72.37789236400043,NaN,NaN,10.947782026052414,12.558094340659501
2013-03-28T09:30:00-04:00,79.53999,79.87,79.27,79.31,6895297,8881574.8,56.58726572896619,56.618714705251975,NaN,NaN,103.03209308885613,65.45327182517761,-0.024432848923874206,0.416660187832548,0.4410930367564222,274785022,276079303.2,58.106160001493045,71.16784283355935,NaN,NaN,11.244622842866466,12.370455555260497
2013-04-01T09:30:00-04:00,79.31,79.53999,78.61,79.14999,7407742,8588828.1,55.2212714423503,56.25325482464988,NaN,NaN,46.009919205534786,68.03456920261121,-0.02898195918215396,0.4048655877787297,0.4338475469608837,267377280,273776257.2,55.14658023236517,69.45773523068756,NaN,NaN,11.108766491468069,12.190214260433008
2013-04-02T09:30:00-04:00,79.28,79.34,78.45,78.7,8408012,8488134.95,51.45914683664209,55.582152628383405,NaN,NaN,-4.628185899836483,61.505659161775064,-0.0629865869831348,0.3551143132319652,0.4181009002151,258969268,271759508,52.61911395714852,67.35177337996468,NaN,NaN,9.923395986633482,11.866383078461647
2013-04-03T09:30:00-04:00,78.73,78.78,76.99001,77.23,15743660,8776074.6,41.5101326418009,54.31908166492783,NaN,NaN,-193.12538790642554,7.673190144725078,-0.17862187985040684,0.19482355040209143,0.37344543025249827,243225608,265207499.4,45.34754953521942,64.61552492699168,NaN,NaN,5.538935748424775,10.962462031313523
2013-04-04T09:30:00-04:00,77.17,77.60001,76.64,77.13,13752879,9053703.3,40.930395982216645,52.577505928716604,NaN,NaN,-234.81847966997796,-56.706008236369826,-0.2515225841762312,0.05904220003220928,0.31056478420844047,229472729,254765981.4,36.65428421877321,61.14952339695642,NaN,NaN,1.8700283725250133,9.663542937200878
2013-04-05T09:30:00-04:00,76.13,77.39,75.98981,77.3,16619754,9461342,42.40307978126444,51.21678981638536,NaN,NaN,-213.5088904436544,-120.01420494287193,-0.2760124608494626,-0.03445079185338784,0.24156166899607479,246092483,249027473.6,32.91921542924298,57.38456866192512,NaN,NaN,-0.7044538760896513,8.182400535302232
2013-04-08T09:30:00-04:00,77.42,77.86,77.14999,77.82001,8903559,9515668.4,46.77440791753084,50.55634064597483,NaN,NaN,-110.6355186126241,-151.3432925065037,-0.2459096600781474,-0.06582540610160947,0.18008425397653793,254996042,246551226,31.43084938349098,53.68332872797197,NaN,NaN,-1.638573184635644,6.779404289596822
2013-04-09T09:30:00-04:00,78,78.81,77.63,78.48,9579930,9586308.25,51.77682908957989,50.71171357173949,NaN,NaN,-31.999852260727668,-156.81762577868193,-0.17367359084052475,-0.03700773457411799,0.13666585626640676,264575972,247672566.8,32.910113008668205,50.68945125446635,NaN,NaN,-0.9275986988540678,5.678403862675266
2013-04-10T09:30:00-04:00,78.67999,79.215,78.56,78.89999,9191926,9619742.85,54.69488284681728,50.864055416093734,NaN,NaN,32.060049853346825,-111.78053822672746,-0.09373634137132485,0.019495429552250698,0.11323177092357554,273767898,253781024.8,40.447109378100215,48.50293882851774,NaN,NaN,0.5618053523038606,4.947461218336493
2013-04-11T09:30:00-04:00,79.25999,79.62,78.73,79.24001,11311230,9796171.75,56.96530417806202,51.38274361772824,NaN,NaN,62.852624871160735,-52.24631731849972,-0.018052438529445464,0.09066622276176872,0.10871866129121419,285079128,264902304.6,51.196829174753766,47.66706857497684,NaN,NaN,2.493497610903351,4.596894988703188
2013-04-12T09:30:00-04:00,78.71001,78.86,77.57001,78,19437024,10218468.85,47.59730269515557,50.93330784287034,NaN,NaN,-42.40282169512626,-18.02510356879409,-0.04979460440402536,0.04647540578618248,0.09627001019020784,265642104,268812228.8,54.31880817732095,47.276716785277465,NaN,NaN,1.2581090004860502,4.119925561815025
2013-04-15T09:30:00-04:00,77.13,77.17,74.75999,74.82001,24793184,10895799.15,32.73151590788997,49.58201846170994,NaN,NaN,-257.93381244186344,-47.48476233464195,-0.27089687165183524,-0.24235107937458622,0.028545792277249016,240848920,265982804.4,51.73941304794513,46.944568135250634,NaN,NaN,-6.195583750129939,2.6462813743943157
2013-04-16T09:30:00-04:00,75.57001,75.85001,74.7,75.74001,16460449,11316471.4,38.696854169335886,48.27626480449919,NaN,NaN,-211.10282312056577,-83.30535650660957,-0.3368266234792199,-0.39248748707177583,-0.055660863592555954,257309369,264529483.8,50.41514267778724,46.47552644135926,NaN,NaN,-9.546064673317371,0.904517653292646
2013-04-17T09:30:00-04:00,75.07001,75.14999,73.515,74.08,20626672,11730204.2,33.008833435952155,46.45408733239747,NaN,NaN,-222.40184054173352,-134.19773458562562,-0.46592361711599983,-0.6380653849875557,-0.1721417678715559,236682697,257112443.6,44.197738517850354,45.532064767154274,NaN,NaN,-14.61832310802298,-1.3130310268953003
2013-04-18T09:30:00-04:00,74.28999,75.179,73.61,74.71001,20535568,12415795.9,36.80536604638124,45.04109449792712,NaN,NaN,-167.28839902896334,-180.22593936565045,-0.4806394757711776,-0.7729411125855279,-0.2923016368143503,257218265,251540271,40.187940806610705,44.25219196751982,NaN,NaN,-16.97283250579463,-3.5501455238809188
2013-04-19T09:30:00-04:00,75.28,75.42999,74.11,74.56,13416430,12672743.75,36.27816967400376,43.688015800188076,NaN,NaN,-131.82871642441907,-198.11111831150902,-0.471575604865615,-0.881771142896369,-0.41019553803075404,243801835,247172217.2,37.32892839965618,42.979502550897756,NaN,NaN,-18.91194261043046,-5.744687964816568
2013-04-22T09:30:00-04:00,74.92999,75.67,74.28,75.36,13348059,12944908.8,41.12179243601984,42.94963334300077,NaN,NaN,-98.07594662904161,-166.13954514894465,-0.38637996825463716,-0.8931704983490505,-0.5067905300944133,257149894,250432412,40.718757758971016,42.12947710817078,NaN,NaN,-18.80992628976299,-7.611150582666057
2013-04-23T09:30:00-04:00,75.66,76.3,75.3,76.23,13953270,13150597.5,45.93477240441658,43.26567904033046,NaN,NaN,-55.48541899645011,-135.0160643241215,-0.2525846372956664,-0.8225213267139964,-0.56993668941833,271103164,253191171,43.50351315866251,41.997760224131014,NaN,NaN,-17.073381465976826,-8.962897851710453
2013-04-24T09:30:00-04:00,76.50999,77.61501,76.42999,77.25,13715066,13489718.95,50.9928398211021,43.98442502882229,NaN,NaN,-2.5979401006377576,-91.05528423590235,-0.08519339073339771,-0.6764284278350772,-0.5912350371016795,284818230,262818277.6,51.98070878720416,43.0925048361618,NaN,NaN,-13.882188699529783,-9.665653687113215
2013-04-25T09:30:00-04:00,77.44,78.24001,76.94,77.31,13640641,13887017.6,51.28157227639682,44.61860306418889,NaN,NaN,20.242162543205385,-53.549171921468634,0.0334094148276195,-0.5494732685671551,-0.5828826833947746,298458871,271066398.8,57.82024968060961,44.87115013983084,NaN,NaN,-11.32287108436001,-9.902399029577042
2013-04-26T09:30:00-04:00,77.14,77.37,76.57001,77.17999,11162840,14100394.75,50.58610373760348,44.89086705133693,NaN,NaN,4.8006694204159714,-26.22329475250163,0.10301307459245901,-0.45411634015420077,-0.5571294147466598,287296031,279765238,62.939073510698,47.12173757748849,NaN,NaN,-9.485773771943597,-9.842881135629407
2013-04-29T09:30:00-04:00,77.64999,78.28,77.3,77.96001,12214648,14340740.05,54.56717171343255,45.090177238754976,NaN,NaN,50.729252522989,3.537745077904481,0.19609748115357628,-0.3120075633046895,-0.5081050444582658,299510679,288237395,67.12378367271663,49.56557119634909,NaN,NaN,-6.686860003289502,-9.392020973866563
2013-04-30T09:30:00-04:00,78.05,78.3,77.35001,78.27,10036227,14422150.8,56.08151546171693,45.18922242553352,NaN,NaN,61.0937592573022,26.853580728654954,0.26857636415211683,-0.17238458926811973,-0.44096095342023656,309546906,295926143.4,70.39127982571672,51.70444051403598,NaN,NaN,-3.9307074771988817,-8.611833331485466
2013-05-01T09:30:00-04:00,77.60001,77.81,76.96001,77.05,15324863,14401210.95,49.139546470372686,44.63023973212715,NaN,NaN,24.703256486002026,32.313820045982915,0.2260881140387987,-0.1583508108717382,-0.3844389249105369,294222043,297806906,71.1467053929325,53.12943167247732,NaN,NaN,-3.585031456211113,-7.893718777874843
2013-05-02T09:30:00-04:00,77.36,78.28,77.0899,78.06,13598012,14393467.6,54.194600799176555,45.10147531098579,NaN,NaN,51.07502251003692,38.48039203934921,0.25556608622246985,-0.06498131713244959,-0.32054740335491944,307820055,299679142.8,71.91487976126241,54.38629392847314,NaN,NaN,-1.6777713098032814,-7.005726282436049
2013-05-03T09:30:00-04:00,78.61,79.67999,78.59,79.47,14048953,14264927.55,60.149349474440896,47.05989199431085,NaN,NaN,114.04528862919604,60.32931588110523,0.3535503870334401,0.12139058043688067,-0.2321598065965594,321869008,306593738.2,74.60405698727001,56.019482781282065,NaN,NaN,2.0027138007583947,-5.718806270551129
2013-05-06T09:30:00-04:00,79.50999,80.33,79.50999,80.00999,12007570,14420128.1,62.17726997151753,48.73706455160954,NaN,NaN,134.6522954857655,77.11392447366053,0.43300880993403146,0.3091012058209799,-0.12390760411305154,333876578,313466918,76.96510584265167,57.91590872162952,NaN,NaN,5.644987964280813,-4.095407094146566
2013-05-07T09:30:00-04:00,80.37,80.98,80.07001,80.63,9700680,14426165.6,64.41632112782096,50.980456529600175,NaN,NaN,147.59112637551573,94.41339789730323,0.5008100044312026,0.5021049014259518,0.001294896994749134,343577258,320272988.4,79.04286826926207,60.40484656101608,NaN,NaN,9.365282526545753,-2.1724514340476633
2013-05-08T09:30:00-04:00,80.57001,80.908,80.25999,80.75999,7170559,14325097.25,64.8856653970748,52.98619219750685,NaN,NaN,139.95895959702133,117.4645385195071,0.5253370444239644,0.6579662025247046,0.13262915810074022,350747817,331578143.2,81.95453985250758,63.38817506429443,NaN,NaN,12.480929700642589,-0.07911127194905587
2013-05-09T09:30:00-04:00,80.78999,81.08,80.25,80.69,8135531,14166312.3,64.39318233893826,54.99440738785932,NaN,NaN,132.05365413476338,133.66026484445237,0.5074953289683669,0.7669983193111989,0.259502990342832,342612286,338536589.4,83.47627459983201,66.68441407859271,NaN,NaN,14.867595921886153,2.056132612884545
2013-05-10T09:30:00-04:00,80.24001,80.39999,79.57001,80.27,13221414,13855531.8,61.38236684048046,56.44159127389222,NaN,NaN,98.79635784204783,130.61047868702275,0.4405394855998616,0.810177347342659,0.3696378617427974,329390872,340040962.2,83.79444716537233,69.76124903619281,NaN,NaN,16.055975267859395,4.056110135023809
2013-05-13T09:30:00-04:00,80.07001,80.3,79.81,80.25999,7423023,12987023.75,61.30879078935596,57.53973544424503,NaN,NaN,90.05388217677036,121.69079602522372,0.3714703196919158,0.8339757613576921,0.46250544166577634,321967849,337659216.4,81.130868635523,72.44891728453997,NaN,NaN,17.01436480186579,5.907289373144092
2013-05-14T09:30:00-04:00,80.33,81.405,80.28,81.39999,9600293,12644015.95,66.26778062552236,58.63080264456077,NaN,NaN,109.87248806845948,114.14706836381247,0.37724157953405757,0.9340574160833484,0.5568158365492908,331568142,335257393.2,78.42362410893845,74.33769695037813,NaN,NaN,19.33025399470873,7.824855747653326
2013-05-15T09:30:00-04:00,81.02,81.42999,80.49001,81.17,13049055,12265135.1,64.47245227128695,59.57300835848149,NaN,NaN,97.7372605644295,105.70272855729411,0.34132945823743044,0.9834776593460788,0.6421482011086483,318519087,328811647.2,71.5256724905044,75.31665572251349,NaN,NaN,20.7627608280375,9.673127901993922
2013-05-16T09:30:00-04:00,80.94,81.39,80.59,80.77,12055391,11841126.25,61.358909623314474,60.342494493175124,NaN,NaN,84.89012293492141,96.27002231732573,0.2695459740198475,0.9790806686334577,0.7095346946136102,306463696,321581929.2,64.65630184693003,75.4393148893872,NaN,NaN,21.126661983493282,11.30934705649383
2013-05-17T09:30:00-04:00,81.21001,82.21001,81.12199,82.12,14658824,11903245.95,67.12865405938959,61.23974323217207,NaN,NaN,109.49527157544311,98.40980506400477,0.2901085852090308,1.0721704261248988,0.782061840915868,321122520,319928258.8,63.16205102748024,75.15633398615603,NaN,NaN,23.207862390386907,13.009134961335699
2013-05-20T09:30:00-04:00,82.08,83.46001,82.08,83.28,10192277,11745456.85,71.11914358871533,62.313859526957664,NaN,NaN,142.83010836562022,108.96505030177475,0.35468744162739463,1.2254211429501112,0.8707337013227165,331314797,321797648.4,64.17012745208436,74.71196595946795,NaN,NaN,26.33364117743482,14.912635849349858
2013-05-21T09:30:00-04:00,83.48,83.83,82.83,83.11,10838836,11589735.15,69.78215203747058,63.78833135317894,NaN,NaN,145.28289965319038,116.04713261872094,0.35778360015121125,1.3179632015117306,0.9601796013605194,320475961,319579212.2,62.00175537524244,74.05875524391865,NaN,NaN,28.4390186058989,16.84497624314258
2013-05-22T09:30:00-04:00,83.23,83.95,81.75,82.14999,19839312,11895947.45,62.622616148331204,64.39033244954713,NaN,NaN,111.91064850143707,118.88181020612244,0.27094923521703107,1.2988661453818082,1.0279169101647772,300636649,316002724.6,58.56586028447942,73.10525385271987,NaN,NaN,28.0482109972391,18.445438350870653
2013-05-23T09:30:00-04:00,81.12,82.19,80.85001,82.19,12791695,11853500.15,62.79394543560768,64.57923216105904,NaN,NaN,68.64587521494856,115.63296066212789,0.19550155337647057,1.2722938518853653,1.0767922985088947,313428344,317395654.2,59.50704000537364,72.02689549687013,NaN,NaN,27.78569233335601,19.779760348368562
2013-05-24T09:30:00-04:00,81.46001,81.72,81,81.71001,8664934,11728604.85,59.28317460690176,64.37251106358649,NaN,NaN,51.45478921823178,104.02486419068562,0.0975151432845085,1.1986862276145303,1.1011710843300218,304763410,314123832.2,56.273604849176145,70.5489311401933,NaN,NaN,26.532538904576224,20.74444299925537
2013-05-28T09:30:00-04:00,82.86,83.23,82.14999,82.57001,10708387,11653291.8,63.24793874674316,64.28905517922378,NaN,NaN,103.91662072951307,96.24216666346419,0.075831279106374,1.1959601832129891,1.1201289041066151,315471797,310955232.2,53.25557639358876,68.70698172050234,NaN,NaN,26.60490936767243,21.581652480457805
2013-05-29T09:30:00-04:00,81.95,82.7,81.78999,82.39,12752945,11789127.7,61.88949013001319,64.07504266014796,NaN,NaN,78.36716223396832,82.85901917961976,0.03656523310100357,1.1658354454828697,1.129270212381866,302718852,307403810.4,50.01768902618397,66.42577809005067,NaN,NaN,26.270093394108063,22.251429753836412
2013-05-30T09:30:00-04:00,82.16,82.608,81.63,82.2,12074738,11626621.45,60.41453128581761,63.79085329921077,NaN,NaN,62.70018212092387,73.01692590351713,-0.012383470858717605,1.113790873808469,1.1261743446671866,290644114,305405303.4,48.240251629648405,63.908919306466125,NaN,NaN,25.577088588009417,22.726523873003984
2013-05-31T09:30:00-04:00,81.86,82.12,80.49001,80.5,15007973,11697119.5,49.13198102672009,62.91582574108503,NaN,NaN,-20.04274567166761,55.279201726193904,-0.1611715532241722,0.9247099031369714,1.0858814563611436,275636141,297846862.8,42.140874966124244,60.93366414937697,NaN,NaN,21.30022552841915,22.522766966634723
2013-06-03T09:30:00-04:00,80.8,81.3,80.42999,81.28,18365424,11912943.05,53.429403328204515,62.35301235100279,NaN,NaN,-31.618800042075048,38.66448387413254,-0.2061021577866602,0.8282537591278185,1.0343559169144787,294001565,295694493.8,40.56787973239647,58.03630779915365,NaN,NaN,19.020974828847173,22.02251094695079
2013-06-04T09:30:00-04:00,80.88,81.39,80.03999,80.64,15981000,12111614.55,49.717930334345745,61.170880187347315,NaN,NaN,-62.07587679208635,5.465984369812634,-0.2737329048937799,0.6921897857972539,0.9659226906910338,278020565,288204247.4,35.58928092361961,54.97671185734516,NaN,NaN,15.928114636066931,21.15188290253881
2013-06-05T09:30:00-04:00,80.39999,80.69,79.655,79.7,17796384,12516399.75,44.79597633873279,59.765417620736294,NaN,NaN,-112.516752813229,-32.71079863962683,-0.3705677525397417,0.5027130000163567,0.8732807525560984,260224181,279705313.2,30.94825463889744,52.078324867944666,NaN,NaN,11.658697462978768,19.795713554030232
2013-06-06T09:30:00-04:00,79.75,80.34,79.10001,80.3,18325472,13074145.4,48.31329287384814,58.833587852917276,NaN,NaN,-113.27800837660145,-67.90643673913189,-0.3815071207550089,0.3963968516123373,0.7779039723673462,278549653,277286421,29.75880243431061,49.58564633847185,NaN,NaN,9.233176653316445,18.28677971107112
2013-06-07T09:30:00-04:00,80.83,81.38,80.36,81.31,10581977,13196467.7,53.66513649597318,57.87190802695896,NaN,NaN,-29.4873014388239,-69.79534789256316,-0.3110006327123914,0.38915318147685696,0.7001538141892484,289131630,279985518.8,32.859655515257586,47.42118951617023,NaN,NaN,8.884225689934443,16.943557708051593
2013-06-10T09:30:00-04:00,81.66,81.67999,80.81,81.08,7944000,12932597,52.33615925342508,56.53026628872395,NaN,NaN,-21.442361544020137,-67.76006019295217,-0.2715665962284096,0.36069556890373633,0.632262165132146,281187630,277422731.8,31.44041460531045,45.083352884257806,NaN,NaN,8.192952817981546,15.693471295184443
2013-06-11T09:30:00-04:00,80.09,80.62,79.75,79.85001,10595875,13091239.6,45.803600139301636,54.81751258171188,NaN,NaN,-114.74186578604625,-78.29325799174414,-0.31687343819804625,0.23617036738458808,0.5530438055826343,270591755,275936969.8,30.614858137706747,42.84143165300526,NaN,NaN,5.451780659243086,14.230372632907105
2013-06-12T09:30:00-04:00,80.64999,80.78999,79.17999,79.36,9344996,13078474.75,43.47543652625314,53.44985689442059,NaN,NaN,-125.47444567514187,-80.88479656412672,-0.36497314802238795,0.0968273705546494,0.46180051857703736,261246759,276141485.4,30.88388751095445,40.86414788346776,NaN,NaN,2.468919526635638,12.550165046296897
2013-06-13T09:30:00-04:00,79.3394,80.905,79.24001,80.69,12392957,13045669.85,50.787217664585675,52.59223348220473,NaN,NaN,-80.09505562954543,-74.24820601471552,-0.29532127308559797,0.09264892722003992,0.3879702003056379,273639716,275159498,30.276860224778034,38.776277899139494,NaN,NaN,2.2588830543243903,11.079981904586539
2013-06-14T09:30:00-04:00,80.74001,80.82001,79.72,79.91,10399234,12962862,46.951365680531865,51.711389987464024,NaN,NaN,-83.61229883663403,-85.07320549427754,-0.2894984261628394,0.02609716760208869,0.3155955937649281,263240482,269981268.4,27.236735662578027,36.702215814382484,NaN,NaN,0.8228816836008293,9.614681873017153
2013-06-17T09:30:00-04:00,80.45,81.26801,80.41,81.06,11097531,12784797.35,52.63180793755135,50.95309492966461,NaN,NaN,-25.504068791070278,-85.88554694368756,-0.20015970404216654,0.0653959637122199,0.26555566775438644,274338013,268611345,26.479230551014055,34.78961968277,NaN,NaN,1.5120585371154163,8.457164253602619
2013-06-18T09:30:00-04:00,80.95,81.77,80.92,81.52,7741617,12662264.35,54.72040723926253,50.44101758032527,NaN,NaN,18.125482713037414,-59.31207724387084,-0.10673611633815377,0.13213552233169423,0.238871638669848,282079630,270908920,29.99574993482136,33.3594811762441,NaN,NaN,2.74615282203955,7.641305477665037
2013-06-19T09:30:00-04:00,81.45,81.89999,80.69,80.77,15053664,12873005.75,50.78834405812303,49.75343277834708,NaN,NaN,4.2832970566564414,-33.36052869751118,-0.0926257328858347,0.12308947256255465,0.21571520544838935,267025966,272064761.4,31.763944765175793,32.182602114496056,NaN,NaN,2.5173812011467342,6.909316295305279
2013-06-20T09:30:00-04:00,79.71001,79.75,78.17,78.41,25490816,13155580.95,40.84291875022252,49.161356901454404,NaN,NaN,-189.96868453745304,-55.33525447909269,-0.23150234488818958,-0.07366272566184762,0.15783961922634196,241535150,265643848.2,27.59422267896909,31.1435555225564,NaN,NaN,-1.2669881922259498,5.741272797086532
2013-06-21T09:30:00-04:00,78.69,78.765,77.25011,78.17,20554240,13543708.2,39.985397971893306,48.201070804575025,NaN,NaN,-205.46832959141545,-79.70646063004897,-0.3231670123414614,-0.2461191462004848,0.07704786614097661,220980910,257191933.8,23.264926173369687,29.907630268340203,NaN,NaN,-4.466278857777152,4.283051132106006
2013-06-24T09:30:00-04:00,77.32001,77.87,76.02,77.00999,18905424,14055732.7,36.04607949873051,47.22451003060252,NaN,NaN,-228.06654423312148,-120.21895571845921,-0.43841126015994725,-0.4709662090589575,-0.0325549488990102,202075486,242739428.4,18.049991227287933,28.654823861459366,NaN,NaN,-8.501872805393958,2.456633426748868
2013-06-25T09:30:00-04:00,77.86,78.245,77.34,78,12540219,14147324.3,41.35619920199235,46.978811663692476,NaN,NaN,-150.44969455659148,-153.933991172385,-0.42418495673159246,-0.5627861448135008,-0.1386011880819083,214615705,229246643.4,14.730273421153044,27.496396631620485,NaN,NaN,-10.059608256399159,0.6685989005848643
2013-06-26T09:30:00-04:00,78.38,78.72,77.81,78.48,11202730,14069813.55,43.7929669563208,46.655931241011956,NaN,NaN,-107.07421306788056,-176.20549319729238,-0.361135629780141,-0.5900207253070846,-0.22888509552694358,225818435,221005137.2,13.140531008123347,26.309377244035677,NaN,NaN,-10.518767434707703,-0.9295962901712167
2013-06-27T09:30:00-04:00,78.88,79.34,78.59,78.63,8163547,13874254,44.568118038600026,46.00614420834245,NaN,NaN,-64.85457705164427,-151.18267170013064,-0.291026855355748,-0.5926686647216286,-0.3016418093658806,233981982,219494503.6,12.866429619711468,24.881289680068097,NaN,NaN,-10.646647392712108,-2.317746447677058
2013-06-28T09:30:00-04:00,78.33,78.92,78.05,78.3,10818641,13664787.4,43.15797200627763,45.350559404974774,NaN,NaN,-80.54102876379002,-126.19721153460554,-0.25013774338456934,-0.6143139885965923,-0.3641762452120229,223163341,219930989.8,13.428343947642162,23.59471320452036,NaN,NaN,-11.16458331465935,-3.5815802858173855
2013-07-01T09:30:00-04:00,78.78999,79.52,78.63,78.86,11960621,13344547.25,46.26507203928557,45.383521683545055,NaN,NaN,-39.20453160091363,-88.42480900816398,-0.1723385892631646,-0.5795994817909786,-0.40726089252781406,235123962,226540685,21.666460727510298,22.955541960934905,NaN,NaN,-10.695110563494858,-4.597798896914167
2013-07-02T09:30:00-04:00,78.88,79.7,78.64,79.03,8694520,12980223.25,47.20847120557567,45.65016701778239,NaN,NaN,-27.48778406450866,-63.83242690974741,-0.09997939038783149,-0.5322351305126034,-0.4322557401247719,243818482,232381240.4,28.17090245129667,22.761757313816492,NaN,NaN,-10.042381505531676,-5.375596412430954
2013-07-03T09:30:00-04:00,78.82001,79.105,78.345,78.98,5256898,12353248.95,46.947401701165106,45.375894448966626,NaN,NaN,-42.715235651466685,-50.96063142646463,-0.04863505162968651,-0.49304955466188005,-0.44441450303219354,238561584,234929870.2,30.86849038733311,22.804016611141854,NaN,NaN,-9.572050424094845,-5.975089842668653
2013-07-05T09:30:00-04:00,79.44,79.99001,78.84,79.96001,10308465,11952398.6,52.49289243607769,45.77171778864847,NaN,NaN,6.8826067207361925,-36.61319467198852,0.05268970588165428,-0.3785523706801257,-0.43124207656178,248870049,237907483.6,33.98771194413406,23.28622920268157,NaN,NaN,-7.572777236830729,-6.203330898977521
2013-07-08T09:30:00-04:00,80.35001,80.96001,80.3,80.48,11579109,12002255.2,55.17049687019176,45.95305271240851,NaN,NaN,71.26158390944887,-6.252672137340783,0.15055211815876518,-0.2430519288633235,-0.3936040470220887,260449158,245364647,41.1493369329367,24.334093944247474,NaN,NaN,-5.08912117671779,-6.044158081511846
2013-07-09T09:30:00-04:00,80.92999,81.41,80.7701,81.3,9258359,12067973.15,59.08662324495621,46.264925284243766,NaN,NaN,108.58006266575114,23.30424671599217,0.259917088749405,-0.0687076860853324,-0.3286247748347374,269707517,252281358,46.903274945052694,25.541774302121144,NaN,NaN,-1.743832986127668,-5.429825925028392
2013-07-10T09:30:00-04:00,81.60001,81.60001,80.63,80.8,10808523,12078605.55,55.881102624137185,46.628693753244775,NaN,NaN,91.85195891458498,47.1721953118109,0.2859268277135706,0.028783759807225806,-0.2571430679063448,258898994,255297460.4,49.234137798702264,26.789645233087324,NaN,NaN,0.19725971858667513,-4.625956547369096
2013-07-11T09:30:00-04:00,81.82001,81.88,81.00999,81.45,14486145,12335663,58.99546624475609,47.9253042885686,NaN,NaN,105.39602591184531,76.79444762447329,0.3310662771708082,0.15668977855716548,-0.17437649861364274,273385139,262262171.4,54.230634226844536,28.692246057935566,NaN,NaN,2.7901654076068674,-3.5665105538011015
2013-07-12T09:30:00-04:00,81.35001,81.96001,81.33,81.91,8778215,12154925.9,61.08884562153282,49.4326934064,NaN,NaN,110.07604478784535,97.43313523789513,0.3729496508922149,0.29181056500162583,-0.08113908589058902,282163354,268920832.4,58.44194698254074,31.204890401447788,NaN,NaN,5.601618081370671,-2.2567778916337056
2013-07-15T09:30:00-04:00,81.96001,82.12,81.69,81.84,10395035,12154715.95,60.581989742712885,51.1852584238273,NaN,NaN,105.42025008925334,104.26486847385601,0.3759231942458924,0.38876490691677645,0.01284171267088409,271768319,271184664.6,59.79635658728826,34.18677364144781,NaN,NaN,7.7775070175155765,-0.823308618898094
2013-07-16T09:30:00-04:00,81.89,82.05,80.82001,81.34,6723742,11936026.5,56.94741792601056,52.29891690411432,NaN,NaN,78.87177191225203,98.3232103231562,0.32605453123488237,0.42040987671448704,0.09435534547960468,265044577,270252076.6,58.94410951772905,37.34490479120324,NaN,NaN,8.673143225239713,0.5333273588358785
2013-07-17T09:30:00-04:00,81.58,81.94,81.45,81.7,7924945,11945192.9,58.86114121186744,53.37521506522479,NaN,NaN,91.31938453578623,98.21669544739646,0.29981964136970407,0.4691298971917348,0.16931025582203071,272969522,273066182.2,60.76146077371837,40.74639977446002,NaN,NaN,9.966071765439317,1.880862274064941
2013-07-18T09:30:00-04:00,81.98,82.798,81.94,82.57001,9419742,11663496.8,63.12689755351837,54.70084217343325,NaN,NaN,117.5003790207633,100.63756606918005,0.32163751604158136,0.5713571508740074,0.24971963483242604,282389264,274867007.2,61.92302088363997,44.250442007597776,NaN,NaN,12.364720390896368,3.378556290755145
2013-07-19T09:30:00-04:00,82.87,83.72,82.675,83.72,10685328,10923222.4,67.8694911575962,56.46595068424172,NaN,NaN,138.18725591254233,106.25980829411944,0.3895647961019374,0.7366756299598478,0.3471108338579104,293074592,277049254.8,63.33929358423696,47.815509838783115,NaN,NaN,16.017122776564726,5.184065788727942
2013-07-22T09:30:00-04:00,83.60001,83.83,83.37,83.45,6802262,10235623.5,65.73184204961338,57.85643425640799,NaN,NaN,130.49050182667767,111.27385864160433,0.3913233564912738,0.8362650294720027,0.44494167298072884,286272330,279950057,65.19263050145165,50.92452196549321,NaN,NaN,18.390713027224052,7.070729679941672
2013-07-23T09:30:00-04:00,83.66,83.96001,83.49001,83.59,6009660,9590835.3,66.32412558616626,59.22183814073589,NaN,NaN,126.67916039606715,120.83533633836734,0.37678979572966975,0.915928917642816,0.5391391219131463,292281990,285397539.6,68.42120977765481,53.79954391737594,NaN,NaN,20.510551343320213,8.990704203281464
2013-07-24T09:30:00-04:00,83.67999,83.74001,82.24001,82.66,9338746,9430761.65,59.02584269405934,60.084583925942624,NaN,NaN,86.61041749592172,119.89354293039443,0.28366284188608015,0.8937176742707464,0.6100548323846663,282943244,287392284,69.53552988199388,56.5614753098517,NaN,NaN,20.246082355819567,10.598615367929764
2013-07-25T09:30:00-04:00,82.59,83.325,82.35001,83.21001,9622234,9351736.85,61.709416044633045,60.74290704083943,NaN,NaN,84.46590925783963,113.2866489778097,0.23996119630224633,0.9100063277624741,0.6700451314602278,292565478,289427526.8,70.67263642093428,59.18182705819458,NaN,NaN,20.812840554135285,12.057790394530553
2013-07-26T09:30:00-04:00,82.83,83.06,82.28,83,6830047,9285061.85,60.0910842998119,61.094377571526586,NaN,NaN,70.32566516685314,99.71433082867186,0.18047966792311154,0.8956447163641172,0.7151650484410057,285735431,287959694.6,68.68153942939476,61.14841295079873,NaN,NaN,20.81372906916186,13.30863877662074
2013-07-29T09:30:00-04:00,82.74001,82.81,81.98,82.31,8293699,9158814.75,54.98859030898808,60.801660933243134,NaN,NaN,43.94969907728737,82.4061702787938,0.08318254459489016,0.8191432291846183,0.7359606845897282,277441732,286193575,66.26253022076597,62.53121689906396,NaN,NaN,19.303638142024425,14.165067257392694
2013-07-30T09:30:00-04:00,82.33,82.5,81.67999,82.14999,7936043,8957585.85,53.846726043734265,60.65634832035722,NaN,NaN,23.664538955337242,61.80324599064782,0.0009169487446223368,0.7371068705205062,0.7361899217758838,269505689,281638314.8,60.357693433568095,63.32575658726866,NaN,NaN,17.729446079876723,14.67426423203327
2013-07-31T09:30:00-04:00,82.3,83.02,82.24001,82.42,11247469,9085233.3,55.52504619213609,60.4084611737415,NaN,NaN,45.36201857822587,53.55356620710866,-0.04017389653641479,0.6859725511053654,0.7261464476417802,280753158,281200297.6,59.80581181238958,63.72398355766473,NaN,NaN,16.858269407469038,14.986264971381237
2013-08-01T09:30:00-04:00,83.09,83.85001,83.06,83.75999,10646609,9354718.85,62.76212882688267,60.52798140269506,NaN,NaN,107.93875989711229,58.24813633496319,0.01507203252908862,0.744986488303141,0.7299144557740523,291399767,280967155.4,59.49399406393978,63.79912977776467,NaN,NaN,18.24367445476944,15.451609183293838
2013-08-02T09:30:00-04:00,83.45,83.5,82.85001,83.39,8185473,9248569.25,59.8654688024424,60.47680133553289,NaN,NaN,78.5203877150836,59.88708084460927,0.01864262152451901,0.7532177326797012,0.7345751111551821,283214294,280462928,58.78019057556328,63.72654649121288,NaN,NaN,18.521634447582496,15.890184221049362
2013-08-05T09:30:00-04:00,83.09,83.25,82.77,83.19,5191023,8929164.95,58.299126769422955,60.5733519672052,NaN,NaN,57.814945745014015,62.66013017815461,0.00044280667337814883,0.7351286194969049,0.7346858128235267,278023271,280579235.8,58.902676493674896,63.72358698949473,NaN,NaN,18.29401767949994,16.233589000828015
2013-08-06T09:30:00-04:00,82.99001,83.39999,82.45,82.67999,6494355,8790964.75,54.390983251931566,60.254054970066925,NaN,NaN,31.35063100376316,64.1973485878398,-0.05023333438382327,0.6718941448437477,0.7221274792275709,271528916,280983881.2,59.35519431141211,63.623139385044276,NaN,NaN,16.951295482637843,16.336118498229418
2013-08-07T09:30:00-04:00,82.45,82.7,82.05,82.39,7033934,8602235.3,52.24634815988316,59.47687287052156,NaN,NaN,-24.354328128893982,50.25407924641582,-0.10445282616003981,0.5915614465275212,0.696014272687561,264494982,277732246,54.19144914228635,63.07088426066188,NaN,NaN,15.203786960329241,16.174356849957963
2013-08-08T09:30:00-04:00,82.78999,83.02,82.12,82.84,6743305,8215093.3,55.19846516105138,58.571799585054066,NaN,NaN,0.1906793237696131,28.704463131747282,-0.11058844400055079,0.5577787176868725,0.6683671616874233,271238287,273699950,48.550699388237405,62.01455610380476,NaN,NaN,14.536820921476792,15.940423145889225
2013-08-09T09:30:00-04:00,82.82001,83.00999,82.19,82.59,9815043,8266934.7,53.229703242233114,57.678789670241194,NaN,NaN,-14.213073680846328,10.157770852561296,-0.13068469321053366,0.5050112951742562,0.6356959883847899,261423244,269341740,43.30412572729925,60.45109147707959,NaN,NaN,13.41928088866392,15.58025996628561
2013-08-12T09:30:00-04:00,82.03,82.56,81.995,82.24001,6313926,8062879.25,50.51343051835914,56.54945430825497,NaN,NaN,-64.19180778465902,-14.243579853373308,-0.16456098846395606,0.4299947528048449,0.594555741268801,255109318,264758949.4,38.582639148623024,58.319765003577324,NaN,NaN,11.694993832748986,15.02522194720895
2013-08-13T09:30:00-04:00,82.32001,82.58,81.86,82.39,6916250,8072504.65,51.65207595894857,56.02275668431849,NaN,NaN,-75.68243844815251,-35.65019374375645,-0.1730158749029288,0.37828589764014,0.5513017725430688,262025568,262858279.8,36.790992794808595,55.98086949734981,NaN,NaN,10.552285070827747,14.386230964868778
2013-08-14T09:30:00-04:00,82.2,82.55,81.95,82.00999,6212641,7986889.45,48.600928925999774,55.086436175844675,NaN,NaN,-101.29805890212918,-51.038939898403484,-0.19852291932030441,0.30314812339268826,0.5016710427129927,255812927,261121868.8,35.18356743847896,53.44593599860299,NaN,NaN,8.714204886424696,13.575941525091052
2013-08-15T09:30:00-04:00,81.505,81.92,81.2,81.56,10819000,8056852.35,45.19629289655554,54.022522504183506,NaN,NaN,-175.54158651431948,-86.1853930660213,-0.23739429081036328,0.20492817920003858,0.44232247001040187,244993927,255872996.8,30.802557648622084,50.74029444283351,NaN,NaN,6.141233265147146,12.513840345099066
2013-08-16T09:30:00-04:00,81.39999,81.53,80.905,81.23,8950395,7970105.7,42.82689256372185,53.153829808093064,NaN,NaN,-194.07926445344395,-122.15863122054084,-0.27440591098397166,0.09931508128043731,0.37372099226440897,236043532,250797054.4,27.266645621876364,47.9548741143414,NaN,NaN,3.255449080507978,11.191213021586053
2013-08-19T09:30:00-04:00,81.03,81.12,79.88499,79.94,10848281,8172406.65,35.08397146776714,51.81363305266684,NaN,NaN,-256.68433289627393,-160.65713624286383,-0.36895119546070354,-0.08746800206147043,0.2814831933992331,225195251,244814241,23.798915471037915,45.34353283130353,NaN,NaN,-1.9987285823284997,9.30693564959826
2013-08-20T09:30:00-04:00,79.98,83,79.85001,80.42999,9037238,8323785.55,39.554265778683174,50.67286302313449,NaN,NaN,-145.10528436985558,-174.54170542720445,-0.3801655282449764,-0.19372371690698742,0.18644181133798898,234232489,239255625.2,21.112357615415277,42.579714674376795,NaN,NaN,-5.037980017188945,7.2576619829143745
2013-08-21T09:30:00-04:00,80.21001,80.69501,79.83,79.99001,9488426,8331269.55,37.08475998811631,48.838765248936895,NaN,NaN,-198.9799711440236,-194.07808787558332,-0.3970437997239428,-0.30986293831693956,0.08718086140700326,224744063,233041852.4,18.586493971893944,39.657750382087805,NaN,NaN,-8.356078245504039,5.027127664568887
2013-08-22T09:30:00-04:00,80.35001,81.5,80.17999,81.17999,8337191,8267017.4,46.7653633406043,47.90304343023417,NaN,NaN,-104.984214323183,-179.96661343735602,-0.3116621489175349,-0.30239682473991536,0.009265324177619536,233081254,230659317.8,17.711515396236507,36.72427358356447,NaN,NaN,-8.149503444547616,3.144751791837958
2013-08-23T09:30:00-04:00,81.44,81.89,80.95,81.75999,7392465,8295138.3,50.74352910343258,47.363357882663436,NaN,NaN,-45.8006110157781,-150.31088274982284,-0.20487896464368344,-0.24683338162698476,-0.04195441698330133,240473719,231545355.2,19.234251646138503,33.8908146658833,NaN,NaN,-6.650667471651868,1.745406182767983
2013-08-26T09:30:00-04:00,81.99001,82.31,81.46001,81.62,7268891,8243897.9,49.776659226297,47.033763309403824,NaN,NaN,-19.74418476673857,-102.92285312391576,-0.13576058394841115,-0.21165514691881526,-0.07589456297040412,233204828,233147270.6,22.04300071696781,31.225657980565845,NaN,NaN,-5.762016963115975,0.6729171619274175
2013-08-27T09:30:00-04:00,81.02,81.7,80.95,81.11,10200559,8357123.7,46.31438762258711,46.6100518424541,NaN,NaN,-61.097814546928326,-86.1213591593303,-0.11717682013327273,-0.22236558813699503,-0.1051887680037223,223004269,230901626.6,20.943438707472126,28.850800092364835,NaN,NaN,-6.084192475667413,-0.29238421487184396
2013-08-28T09:30:00-04:00,81.37,82.78,81.3401,82.46001,11898199,8389660.2,55.1979092250916,46.61001213274269,NaN,NaN,20.334091524335076,-42.25854662565856,-0.012272804214767535,-0.12052977327218173,-0.10825696905741419,234902468,232933307.6,24.60761038756671,27.140579449459782,NaN,NaN,-3.3453499716854274,-0.7285221801309273
2013-08-29T09:30:00-04:00,82.31,82.36,81.46001,81.60001,11411094,8427884.45,49.57063728823176,46.34865027888545,NaN,NaN,-6.064448237931162,-22.474593408608197,0.00022612855049677916,-0.10797430836929323,-0.10820043691979,223491374,231015331.6,23.500265279906344,25.72601798893172,NaN,NaN,-2.9621263079703946,-1.047608484107994
2013-08-30T09:30:00-04:00,81.91,82.00999,81.37,81.57001,8541809,8445701.25,49.381513066217,46.26779903230386,NaN,NaN,-14.721015762290763,-16.25867435791075,0.007120276246134538,-0.09930009161212183,-0.10642036785825637,214949565,225910500.8,20.815407237291495,24.456929995265178,NaN,NaN,-2.7263997219734026,-1.2874358038030524
2013-09-03T09:30:00-04:00,82.39,82.67751,81.77,82.17,8634414,8617870.8,53.22515113270641,46.380161544715136,NaN,NaN,51.17117157331607,-2.0756030898998206,0.05032831210726885,-0.04350997772417031,-0.09383828983143916,223583979,223986331,19.89285207780921,23.249919944050937,NaN,NaN,-1.2997456024848637,-1.2891943464718827
2013-09-04T09:30:00-04:00,82.07001,82.86,81.89,82.61501,7490051,8667655.6,55.899901917274406,46.90151675837762,NaN,NaN,83.58875258067,26.861710335619847,0.10402698297375572,0.03619543888575549,-0.06783154408800023,231074030,225600283.2,22.97648532621858,22.37798550746091,NaN,NaN,0.7246979280096044,-1.0014954501173845
2013-09-05T09:30:00-04:00,82.77,83.265,82.73,82.89,6115148,8621716.3,57.51657521313532,47.781536923847604,NaN,NaN,132.5094041148685,49.29677285372652,0.1503986298255816,0.1201667431939768,-0.030231886631604817,237189178,226057625.2,23.870774479837877,21.882858138262037,NaN,NaN,2.8771579605480535,-0.44740210573660766
2013-09-06T09:30:00-04:00,83.22,83.53011,82.30701,82.88,8025855,8685843.8,57.43411955554492,48.82491028040639,NaN,NaN,122.76336554790124,75.062335610893,0.17121677670830354,0.1837890842537746,0.012572307545471069,229163323,227192015,26.160836831318164,21.80387179607931,NaN,NaN,4.587480281133237,0.27186680667337004
2013-09-09T09:30:00-04:00,83.17999,83.91,83.06,83.80499,8438043,8616993.8,62.75321683285933,50.80128494934154,NaN,NaN,177.60551031023044,113.52764082539724,0.23420580302914495,0.30532956133190226,0.0711237583027573,237601366,231722375.2,34.619456979459784,22.57676761810944,NaN,NaN,7.770971541990253,1.3431674831472105
2013-09-10T09:30:00-04:00,83.89999,83.96001,83.12,83.84,9153676,8758981.3,62.941971794355126,52.471835379032406,NaN,NaN,157.64372558054052,134.82215162684216,0.26299448390743996,0.3998668631870572,0.1368723792796173,246755042,236356587.8,41.945606117462965,24.064856796827137,NaN,NaN,10.395448585536673,2.636350497774276
2013-09-11T09:30:00-04:00,83.83,84.48,83.455,84.48,10700156,8948176.6,66.30371245827428,54.55890341261511,NaN,NaN,170.53783174245896,152.2119674591999,0.30684753141636534,0.520431793550074,0.21358426213370862,257455198,241632821.4,48.958303209053895,26.234271742338557,NaN,NaN,13.713367481525463,4.218781495453017
2013-09-12T09:30:00-04:00,84.31,84.565,83.92,83.98,10702367,9172662.9,61.60204666563455,55.61866650726013,NaN,NaN,145.2130399903804,154.75269463430232,0.28439227852484156,0.5690746102897606,0.284682331764919,246752831,243545552,51.256974852621816,28.63037598922322,NaN,NaN,15.179820540713568,5.784644216204525
2013-09-13T09:30:00-04:00,84.05,84.28,83.8,83.95,5979004,8930663.1,61.32107688275007,56.37420563435423,NaN,NaN,117.6706239802932,153.7341463207807,0.2508995234745901,0.5983067361081567,0.34740721263356655,240773827,245867652.8,53.96735207068042,31.11131173383336,NaN,NaN,16.292551666907883,7.28577385201929
2013-09-16T09:30:00-04:00,84.60001,84.66,83.81,83.92999,8068703,8886578.5,61.12083070278287,57.18450359696037,NaN,NaN,109.61452541709396,140.13594934215342,0.2123101091628568,0.6127948490871375,0.40048473992428074,232705124,244888404.4,52.638080284662706,33.29667456009728,NaN,NaN,17.157211272457822,8.695979197796223
2013-09-17T09:30:00-04:00,83.95,84.55,83.84,84.31,5422102,8615269.55,63.554864772602286,58.41596625053288,NaN,NaN,103.58130160964204,129.3234645479737,0.19759357262457783,0.647476705705003,0.4498831330804252,238127226,243162841.2,50.28755007008912,35.39268251456992,NaN,NaN,18.57705975380851,10.107562134369406
2013-09-18T09:30:00-04:00,84.28999,85.67999,84.03999,85.33,11156559,8721235.6,69.1395833241798,59.41180011475347,NaN,NaN,133.3196484968748,121.87982789885686,0.23900386948905172,0.7486379699417398,0.5096341004526881,249283785,241528558.6,48.09694418279758,37.07049207137213,NaN,NaN,21.599370923318656,11.749249104219299
2013-09-19T09:30:00-04:00,85.46001,85.74001,84.97,85.12,9138539,8703741.25,66.86772077786826,60.64730607829893,NaN,NaN,135.35476129208897,119.9081721591986,0.2343821173241949,0.8026117471079317,0.5682296297837368,240145246,240207041.6,46.33909504026455,38.70183705425485,NaN,NaN,23.44916586169873,13.420665783859217
2013-09-20T09:30:00-04:00,84.78,84.99001,83.88,84.03999,13973953,8985579.35,56.57213565964402,61.16092197782943,NaN,NaN,69.9484022517332,110.36372781348659,0.14509443854830695,0.7495976779691205,0.6045032394208135,226171293,237286534.8,42.630929846199535,40.26008866917686,NaN,NaN,21.905278502786484,14.63275331513454
2013-09-23T09:30:00-04:00,83.82001,84.009,83.39,83.63,8520098,9041961,53.22204730994966,61.16070027620395,NaN,NaN,26.54024525946499,93.7488717819608,0.049848816422577324,0.6668142599490352,0.6169654435264579,217651195,234275749,39.152543435515454,41.63578090901302,NaN,NaN,19.564691178436714,15.337315867034851
2013-09-24T09:30:00-04:00,83.61,84.33,83.37,83.71001,5540652,8955549.05,53.79706203803691,61.010497427686985,NaN,NaN,30.273200662239475,79.08725159248031,-0.012981156537879568,0.6007389978541084,0.613720154391988,223191847,231288673.2,36.0130206585271,42.56696200417791,NaN,NaN,17.849549056400285,15.696206322658485
2013-09-25T09:30:00-04:00,83.95,84.21001,83.67101,83.69,11193738,9005208,53.61954160169317,60.73213788401255,NaN,NaN,28.531285001270646,58.12957889335947,-0.05855343364630994,0.5405283623341006,0.5990817959804106,211998109,223831538,29.626135345998478,42.97805920890367,NaN,NaN,16.405062559615942,15.797471499366694
2013-09-26T09:30:00-04:00,83.89999,84.03,83.44,83.84,7720340,8796315.05,54.823013382220324,60.545630300203655,NaN,NaN,16.951722487759366,34.44897113249355,-0.07993685111611071,0.49916073208527223,0.5790975832013829,219718449,219746178.6,26.819867439950954,43.02513282380601,NaN,NaN,15.51447296423002,15.757043137204311
2013-09-27T09:30:00-04:00,83.49001,83.66,83.22,83.55,7171004,8584310.55,52.013025706630614,59.77847379118732,NaN,NaN,-19.356469020195036,16.587996878107898,-0.11293578572883245,0.4379278510403424,0.5508636367691748,212547445,217021409,25.111390620373157,42.34598522672839,NaN,NaN,13.971914718254713,15.502024791640084
2013-09-30T09:30:00-04:00,82.53999,83.2,82.39,82.909,10433219,8678881.05,46.35711403943373,58.59384109440722,NaN,NaN,-103.02794430923133,-9.32564103563136,-0.17362783927597647,0.33382883767420424,0.5074566769501807,202114226,213914015.2,23.289338445569612,41.013394678736006,NaN,NaN,10.926227960467937,14.848339530044063
2013-10-01T09:30:00-04:00,82.67999,83.66,82.64,83.44,10852688,8789794.75,51.100775092436024,57.50791699684736,NaN,NaN,-67.82437526678733,-28.94515622143672,-0.1733057905692334,0.29082443873863895,0.46413022930787234,212966914,211869028.6,22.150274731043552,39.09853550173527,NaN,NaN,9.630467988590375,14.102929309836393
2013-10-02T09:30:00-04:00,83.09,83.73,82.64999,83.63,7716430,8801113.7,52.71214372388425,56.87292392957947,NaN,NaN,-67.46237583065756,-48.14388838782236,-0.15612499134367908,0.2689739901282735,0.4250989814719526,220683344,213606075.6,25.48412034335078,37.25761732250162,NaN,NaN,9.011699831258682,13.375610812896719
2013-10-03T09:30:00-04:00,83.55,83.60001,82.5,82.89999,10143496,9002531.1,46.387272867940744,55.806223642807375,NaN,NaN,-115.30796625182921,-74.59582613574007,-0.18763514823930744,0.19055504617281827,0.3781901944121257,210539848,211770355.4,24.29979607254309,35.13850617977753,NaN,NaN,6.525000293836578,12.396952167316698
2013-10-04T09:30:00-04:00,83.08,83.96001,82.72,83.74001,9313121,9066894.4,53.32713641768123,55.24953119387154,NaN,NaN,-55.75566333580709,-81.87566499886249,-0.14738873345740883,0.19395427759036465,0.3413430110477735,219852969,213231460.2,27.199764890415437,33.32148365161701,NaN,NaN,6.514658827809283,11.556624547387067
2013-10-07T09:30:00-04:00,82.87,83.58,82.77,83.05,7928742,9041429.35,47.848168096354925,54.1276242884253,NaN,NaN,-98.35142796810676,-80.94036173063758,-0.16158348470446876,0.13936365516718752,0.3009471398716563,211924227,215193460.4,31.021098180725545,31.94530851666247,NaN,NaN,4.705209141814632,10.577850918019577
2013-10-08T09:30:00-04:00,83.08,83.25999,82.08,82.16,10577957,9112643.4,41.872352437350564,52.17996493936607,NaN,NaN,-161.34928660225992,-99.6453439977321,-0.22155140494202494,0.0240078836941251,0.24555928863615004,201346270,212869331.6,29.074231517042634,30.586543326251405,NaN,NaN,1.0803342703822711,9.221062825499962
2013-10-09T09:30:00-04:00,82.16,82.23,81.31,81.87,13109715,9233121.35,40.11433123804264,50.26900854366425,NaN,NaN,-203.2251420740351,-126.79789724640759,-0.2682698845003233,-0.08977806698925406,0.1784918175110692,188236555,206379973.8,24.458548893832244,29.023647172934812,NaN,NaN,-2.393969399549024,7.561772507635821
2013-10-10T09:30:00-04:00,82.44,83.39999,82.42,83.39,12827625,9339384.25,51.587524531163936,49.912964891629954,NaN,NaN,-57.63393082260625,-115.263090160563,-0.18811339858594597,-0.05664993072136326,0.1314634678645827,201064180,204484840.2,23.29543737202968,27.642540567636967,NaN,NaN,-1.447979333696512,6.274665101731202
2013-10-11T09:30:00-04:00,83.02,84.5499,82.94,84.28999,11925500,9636709.05,56.85789903738854,50.17266858644702,NaN,NaN,36.639006282770715,-96.78415623684745,-0.07177491899057456,0.04174481912636452,0.11351973811693908,212989680,203112182.4,22.462234493716508,26.450375643222763,NaN,NaN,1.2739778273015618,5.56028120538411
2013-10-14T09:30:00-04:00,83.78999,84.9101,83.60001,84.86,8369910,9651769.4,59.83990426516404,50.60430017409895,NaN,NaN,90.73699002589898,-58.9664726380463,0.04024811479414099,0.1638298816096153,0.12358176681547432,221359590,204999255,26.361611091946585,25.76098924560987,NaN,NaN,4.506178338016678,5.409695081474477
2013-10-15T09:30:00-04:00,84.55,85.10001,84.23,84.55,11393180,9950323.3,57.511668381507384,50.882309229799965,NaN,NaN,103.56449358584501,-5.983716600425316,0.08744196227736623,0.2328842196621821,0.14544225738481587,209966410,206723283,29.83339551134084,25.77579354313433,NaN,NaN,6.261970306002794,5.531448684978522
2013-10-16T09:30:00-04:00,85.12,86.08,85.08,85.82001,12608148,10022902.75,63.736601883340356,51.51899412273711,NaN,NaN,197.6233673588051,74.18598528614272,0.19216140135649687,0.38564400908043694,0.19348260772394008,222574558,213590883.6,41.637380444175776,26.83418732915039,NaN,NaN,10.032217771992753,6.174415697409127
2013-10-17T09:30:00-04:00,85.73,86.03999,85.49001,86,12290090,10180480.3,64.52975162599537,52.4130459741203,NaN,NaN,203.97024396024054,126.50682024271207,0.25744669613637533,0.5152909778944093,0.2578442817580339,234864648,220350977.2,50.47016141427511,28.645528100143384,NaN,NaN,13.211486822798824,7.1797115724647975
2013-10-18T09:30:00-04:00,86.67,86.99001,86.28,86.94,12950563,10129310.8,68.41510311286228,53.98861662222235,NaN,NaN,231.42400549791995,165.46382008574193,0.3425083597860452,0.6859797314905904,0.3434713717045452,247815211,227316083.4,57.591692042192676,31.095696214187885,NaN,NaN,17.25615422018851,8.619203379282471
2013-10-21T09:30:00-04:00,86.89999,87.24001,86.36,86.55,7853539,10095982.85,65.22292026112342,54.9973412771286,NaN,NaN,178.91004269014076,183.09843061859027,0.34984825663337366,0.7807816924962623,0.4309334358628886,239961672,231036499.8,60.83131119659549,33.85862739029874,NaN,NaN,19.459035098149744,10.16775076769208
2013-10-22T09:30:00-04:00,86.97,87.59,86.645,87.03,14297555,10533828,67.24840749371722,56.035645832116664,NaN,NaN,161.32917256802105,194.6513664150255,0.36281287882596436,0.884449534395344,0.5216366555693797,254259227,239895063.2,67.24708942631814,36.8416966105107,NaN,NaN,21.91752006244652,11.846289238371286
2013-10-23T09:30:00-04:00,86.31,86.39,85.42,85.66901,16835296,10815905.9,57.09458236527016,56.80045365335449,NaN,NaN,81.15235732721492,171.35716440870743,0.260308738125526,0.8470225782262872,0.5867138401007612,237423931,242864937.8,69.07589265535286,40.03998922356853,NaN,NaN,20.6521179613788,13.104264770229502
2013-10-24T09:30:00-04:00,85.75999,86.23,85.21001,86.08,7873711,10823574.45,59.10276243997138,57.21299836923235,NaN,NaN,72.81679793810073,145.1264752042795,0.2032947779433888,0.8408323125299972,0.6375375345866084,245297642,244951536.6,70.3294056793181,43.1206778513473,NaN,NaN,20.296990660280585,14.1317970402368
2013-10-25T09:30:00-04:00,86.27,86.83,86.02,86.60001,8752336,10902641.05,61.55464422872657,58.192032378687465,NaN,NaN,92.0993864295574,117.26155139060697,0.18427599941090123,0.867882533850235,0.6836065344393337,254049978,246198490,71.08374996307775,45.98229583580103,NaN,NaN,20.79221334959628,15.083285084431012
2013-10-28T09:30:00-04:00,86.65,86.86,86.2,86.67,7661226,10764041.4,61.88585217618497,59.62156807431849,NaN,NaN,86.20708557661716,98.72095996790225,0.16092963309604413,0.8847685758093888,0.7238389427133447,261711204,250548396.4,73.60480647180809,49.16305118971285,NaN,NaN,21.284447370620295,15.969165411029481
2013-10-29T09:30:00-04:00,86.89,87.34,86.82,87.28,6467148,10544764.4,64.73721206145244,61.38034527599063,NaN,NaN,99.56767013830942,86.36865948195995,0.17019005915040974,0.9365765166513569,0.7663864575009471,268178352,253332221.4,75.10093969832576,52.78036481860524,NaN,NaN,22.570496566591853,16.912212718966963
2013-10-30T09:30:00-04:00,87.25,87.62,86.01,86.69,11397664,10728826.1,60.0572920767446,61.985328672103535,NaN,NaN,75.70281856263631,85.27875172904422,0.12243324997545746,0.9194280199702689,0.7969947699948114,256780688,257203572.8,77.04920666123883,56.61991976783447,NaN,NaN,22.240963872063286,17.67346288369501
2013-10-31T09:30:00-04:00,86.76,87.18,86.11,86.39,9088138,10676058.2,57.77040979312819,62.05050801179922,NaN,NaN,61.10352844245792,82.93609782991567,0.05967070558223164,0.871583151972601,0.8119124463903693,247692550,257682554.4,77.28601649626566,60.53590419658798,NaN,NaN,21.28953408530222,18.19004448392461
2013-11-01T09:30:00-04:00,86.36,86.44,85.04,86.08,12347560,10827780.15,55.421940355551705,61.73493916111262,NaN,NaN,25.22875419965947,69.56197138393608,-0.009981204895464502,0.7994359402710387,0.8094171451665032,235344990,253941556.8,71.11421779222925,63.73251896089389,NaN,NaN,19.81078371143859,18.42157865928375
2013-11-04T09:30:00-05:00,86.5,87.22,86.31,87.15,7238758,10793280.95,61.27376739609232,62.00366051929726,NaN,NaN,71.96385397322919,66.71332506325847,0.007791156929172427,0.8191560913279687,0.8113649343987963,242583748,250116065.6,65.36582984947256,66.27054998504615,NaN,NaN,20.25628054381939,18.683678928503127
2013-11-05T09:30:00-05:00,86.77,87.01,86.28,86.36,8027250,10665745.6,55.4827327749015,61.41409844012305,NaN,NaN,51.20384499248969,57.040560034094526,-0.03929090995444573,0.7622512969557391,0.8015422069101849,234556498,243391694.8,56.69114006714788,67.34581852954416,NaN,NaN,18.81496186224755,18.70243363332376
2013-11-06T09:30:00-05:00,86.88,87.27,86.32,86.615,9093291,10464924.4,56.89875214481395,60.869027048610086,NaN,NaN,59.37420964779577,53.77483825112641,-0.05777534594687972,0.7293230244765851,0.7870983704234649,243649789,240765515,53.69413478328674,67.57610234161642,NaN,NaN,18.06886437912283,18.611923739866484
2013-11-07T09:30:00-05:00,86.85,86.97,85,85.28,20888544,10867970.35,48.24644742198904,59.428408784976284,NaN,NaN,-32.89742482554655,34.97464759752553,-0.1587047600160192,0.5887174204034409,0.7474221804194601,222761245,235779254,48.4562346283846,66.92356966920156,NaN,NaN,14.541504924257467,18.030435337636625
2013-11-08T09:30:00-05:00,85.32,86.63,85.2,86.55,13242894,10933840.05,55.222309608302396,58.71407945263193,NaN,NaN,-9.616561639084582,28.005584429776718,-0.13941146795977843,0.573157845469737,0.7125693134295155,236004139,235911083.8,48.599000761939685,66.04983320958328,NaN,NaN,13.827263175447463,17.429982171609602
2013-11-11T09:30:00-05:00,86.7,86.99,86.4301,86.71,5179725,10774330.8,56.026483314622595,57.91251343983946,NaN,NaN,50.63064344260261,23.73894232365139,-0.11629615895733703,0.5671991147328441,0.6834952736901811,241183864,235631107,48.293067299213014,64.69597448621863,NaN,NaN,13.529094035779321,16.87271243791956
2013-11-12T09:30:00-05:00,86.55,86.69,85.66,85.91,8680677,10638705.65,51.086255891911506,57.48334726317098,NaN,NaN,-49.43390468999877,3.611392387153694,-0.1529969212663309,0.49224912210726757,0.6452460433735985,232503187,235220444.8,47.817584681027334,63.177523916623954,NaN,NaN,11.672057917724937,16.129761792177472
2013-11-13T09:30:00-05:00,85.53,86.67,85.52,86.66,10903381,10553467.3,55.08480832921623,57.19635054097419,NaN,NaN,-25.404564894328615,-13.344362521271183,-0.12599923378904399,0.4877470011372935,0.6137462349263375,243406568,235171800.6,47.75760234304203,61.56525224974708,NaN,NaN,11.407120369722776,15.455098731826801
2013-11-14T09:30:00-05:00,86.62,87.24,86.565,87.18,9668061,10422365.85,57.66862125193624,56.91877747120345,NaN,NaN,93.04566690122536,11.8442558240832,-0.07488274035610987,0.5201428094812002,0.59502554983731,253074629,241234477.4,55.28592226006827,60.43683598524642,NaN,NaN,12.011472507613565,14.963152128367767
2013-11-15T09:30:00-05:00,87.51,87.68,87.0097,87.66,7369837,10143329.55,59.958441336348685,56.781105268358,NaN,NaN,157.43881556568545,45.255331265037206,-0.01371069130107716,0.5778871857109635,0.5915978770120407,260444466,246122542.8,60.258448240394294,59.483524683002564,NaN,NaN,13.226022220254588,14.714990712923028
2013-11-18T09:30:00-05:00,88.03,88.11,86.705,86.99,10466208,10273963,55.44968967696594,56.117710812323246,NaN,NaN,115.45725859362277,58.22065429524123,-0.022801818635530546,0.5630956037176276,0.5858974223531581,249978258,247881421.6,61.900314448044774,58.54062287941107,NaN,NaN,12.854697247244387,14.449234503540364
2013-11-19T09:30:00-05:00,86.82,87.425,86.4,87.14,9456394,10031904.95,56.24302072911596,55.8452628589212,NaN,NaN,71.96194021629655,82.4998232765003,-0.02307351750224762,0.5570555254753486,0.5801290429775963,259434652,253267714.6,66.46887894570712,57.78488518544452,NaN,NaN,12.790001156261322,14.212201168214786
2013-11-20T09:30:00-05:00,87.5,87.79,86.67,86.93,13262852,9853282.75,54.77247410740092,55.63112459565497,NaN,NaN,86.88517605425537,104.95777146621711,-0.040724896323223625,0.5292229225735667,0.5699478188967904,246171800,253820761,66.90765427512088,57.0435735982199,NaN,NaN,12.31594909718886,13.941308015211083
2013-11-21T09:30:00-05:00,87.23,87.9,87.1201,87.76,7122782,9815736.3,59.301755633903966,55.90825425839442,NaN,NaN,148.94907474252565,116.13845303447715,-0.0018810167469702765,0.5675965479630776,0.5694775647100478,253294582,253864751.6,66.94470682835446,56.745751386514556,NaN,NaN,13.238123649025782,13.84085310575604
2013-11-22T09:30:00-05:00,88.06,88.24,87.28,88.23,7559526,9756095.8,61.64416286382453,55.934711077518145,NaN,NaN,171.43785698009992,118.93826131736004,0.04736666418705848,0.628685894943871,0.5813192307568125,260854108,253946680,67.01877245034402,56.86381871514823,NaN,NaN,14.713520985605241,13.965519945734497
2013-11-25T09:30:00-05:00,88.14,88.14,86.99,87.43,9752553,9860662.15,55.76120561682244,55.95460199479821,NaN,NaN,99.01605810993249,115.650021220622,0.01939721018713314,0.6055657434907289,0.5861685333035958,251101555,254171339.4,67.23556936186279,57.616992236199295,NaN,NaN,14.231803964500955,14.003560519843992
2013-11-26T09:30:00-05:00,87.34,87.76,86.86,87.21,6774847,9876047.1,54.22853448255794,55.76387216177993,NaN,NaN,62.988275939474505,113.85528836525759,-0.01853420820033591,0.5630007730531759,0.5815349812535118,244326708,251149750.6,61.39058322909069,58.16673855375672,NaN,NaN,13.387599767663213,13.915566126675309
2013-11-27T09:30:00-05:00,86.97,87.37,86.12,86.62,9319346,9772131.2,50.24027977539538,55.9062887584518,NaN,NaN,-16.01188158388504,93.27587683762951,-0.08429145764298485,0.47617065919978074,0.5604621168427656,235007362,248916863,57.418208422228595,58.80687953903129,NaN,NaN,11.478552961943217,13.567421388856438
2013-11-29T09:30:00-05:00,86.61,87.19,86.2,86.44,4976682,9566558.4,49.05493976975214,55.46576234141249,NaN,NaN,-29.373125918632294,57.61143670539792,-0.1376849357929768,0.38835594710154453,0.5260408828945213,230030680,244264082.6,50.13797029042704,58.91680593392324,NaN,NaN,9.562144965213855,12.995239042621783
2013-12-02T09:30:00-05:00,86.53,87.09,86.01,86.5,9619434,9430152.1,49.482791864554436,54.998355809264766,NaN,NaN,-48.10564411826586,13.70273648572476,-0.16490001613391403,0.3199158627271288,0.4848158788610428,239650114,240023283.8,44.5886468665816,58.65220447444957,NaN,NaN,8.095929240924939,12.295337642379376
2013-12-03T09:30:00-05:00,86.3,86.98,86.12,86.71,10845101,9610469.25,51.03285398327864,54.99454138721956,NaN,NaN,-34.78297063495467,-13.05706926325268,-0.16433183434045373,0.27940108593547563,0.44373292027592937,250495215,239902015.8,44.43718508575619,58.410747360501624,NaN,NaN,7.258839249929482,11.57583787202939
2013-12-04T09:30:00-05:00,86.6,86.89,85.74,86.43,10035006,9710857.05,48.87928861602748,54.55128997913465,NaN,NaN,-68.52965296772645,-39.36065504469288,-0.17727553690017028,0.22213849915071648,0.39941403605088677,240460209,239128716,43.42421388800048,58.10121961371295,NaN,NaN,5.962846129966602,10.773981908877564
2013-12-05T09:30:00-05:00,86.21,86.58,85.97,86.14,10071974,9759791.2,46.68202319203853,53.766532974856254,NaN,NaN,-78.73664037285205,-51.905606802486275,-0.1982438263575445,0.15160925310395612,0.3498530794615006,230388235,238204890.6,42.1869692859681,57.16558011556293,NaN,NaN,4.2539365388748855,9.84254685602004
2013-12-06T09:30:00-05:00,86.89,87.04,86.139,86.41,11673027,9299015.35,48.9815341819933,52.982468178116584,NaN,NaN,-46.46855855825622,-55.32469333041106,-0.18695284951969932,0.1161620175618765,0.3031148670815758,242061262,240611007,46.46526388876942,56.18035266187544,NaN,NaN,3.374135237786438,8.918488053415238
2013-12-09T09:30:00-05:00,86.6,86.86,86.14,86.53,13075638,9290652.55,50.01338688257605,52.594160835660155,NaN,NaN,-54.24989930417306,-56.553544367592494,-0.1651808274090858,0.09663883282021857,0.26181966022930436,255136900,243708364.2,51.44637212054893,55.43364249562573,NaN,NaN,2.8892929954846975,8.057174473710875
2013-12-10T09:30:00-05:00,86.33,86.79,86.16,86.27,10566032,9559967.9,47.7595260125855,51.98819692733655,NaN,NaN,-65.68163256828645,-62.73327675425885,-0.16185504628108252,0.05950085237795122,0.22135589865903374,244570868,242523494.8,49.54716219326172,54.22494844187963,NaN,NaN,1.8839792405762599,7.17528944040593
2013-12-11T09:30:00-05:00,86.36,86.36,84.87,85.05,14682665,9860067.3,38.90081217912478,50.854506789602546,NaN,NaN,-193.3928885777884,-87.70592387627123,-0.2311614114548145,-0.06759586565948439,0.16356554579533011,229888203,240409093.6,46.26491290954396,52.750466915767,NaN,NaN,-1.7422654915355402,5.901353021557148
2013-12-12T09:30:00-05:00,85.04,85.79,84.88,85.41,10983900,9864093.25,42.30176454957509,49.640221712150485,NaN,NaN,-180.5835225843025,-108.07530031856132,-0.24100027217844594,-0.1376847944277273,0.10331547775071863,240872103,242505867.2,49.81527885167265,51.52693634600401,NaN,NaN,-3.8273447164690633,4.511539058981976
2013-12-13T09:30:00-05:00,85.21,85.26,84.7401,85.13,12165257,9988953.05,40.41736362752181,48.12402176670029,NaN,NaN,-187.5076544237114,-136.28311949165237,-0.253344300326358,-0.21336489765722888,0.039979402669129124,228706846,239834984,45.67541810341407,50.00241103550901,NaN,NaN,-6.131579942229035,2.991093487380403
2013-12-16T09:30:00-05:00,85.59,86.15,85.35,85.87,12161283,10228525.35,47.121629921684786,47.5069092170476,NaN,NaN,-93.3057184251701,-144.09428331585178,-0.20093998452885858,-0.2111955779919441,-0.010255593463085529,240868129,236981229.8,41.68893172435251,48.17765120425828,NaN,NaN,-6.169792995185288,1.6823954184424472
2013-12-17T09:30:00-05:00,85.8,85.95,85.1,85.3799,9856228,10198026.35,43.62086103465419,46.74921825648305,NaN,NaN,-115.37095781449466,-154.0321483650934,-0.18874390734976043,-0.2461854776502861,-0.05744157030052564,231011901,234269436.4,38.27071894842581,46.52623232706794,NaN,NaN,-7.264404272593598,0.4042811768658694
2013-12-18T09:30:00-05:00,85.63,86.7,84.81,86.67,15264422,10488427.75,53.42891503534476,46.976977917908,NaN,NaN,-44.20917727273343,-124.19540610408242,-0.08835052302042651,-0.16787972407605878,-0.07952920105563227,246276323,237547060.4,44.223461495703674,45.58375040374473,NaN,NaN,-4.96909092727426,-0.3633434094398633
2013-12-19T09:30:00-05:00,86.37,86.96,86.18,86.92,11214069,10385988.6,55.060442967601546,47.4059424320401,NaN,NaN,29.65488181984893,-82.14772522325214,-0.004114945757148769,-0.08467288325206823,-0.08055793749491946,257490392,240870718.2,49.537630651972215,45.54086900099795,NaN,NaN,-2.604802731475457,-0.6835518840163767
2013-12-20T09:30:00-05:00,86.49,87.01,86.44,86.67,15694303,10814564.65,53.05865054366501,47.66136090911943,NaN,NaN,39.76164994980875,-36.693864348548104,0.03367800979794122,-0.038460425247492935,-0.07213843504543416,241796089,243488566.8,53.31085512210088,46.163883876392184,NaN,NaN,-1.2996576809403648,-0.7715669978626607
2013-12-23T09:30:00-05:00,86.99,87.335,86.65,86.76,9769928,10925084.75,53.71109483161279,47.85266382685758,NaN,NaN,77.47926497926699,-2.5368676676606867,0.06200170733065065,0.0053636991178791504,-0.0566380082127715,251566017,245628144.4,56.19387752467929,47.003647622029554,NaN,NaN,-0.05189315070537002,-0.668756448268762
2013-12-24T09:30:00-05:00,86.83,87.3151,86.72,87.24,5594384,10717176.3,57.13319260592304,48.442228397564406,NaN,NaN,107.27282172959598,41.99188824115744,0.1076530568138304,0.07792831280451651,-0.029724744009313898,257160401,250857844.4,62.318674363125155,48.353251941681314,NaN,NaN,2.0500525648666406,-0.28035516067799027
2013-12-26T09:30:00-05:00,87.48,87.975,87.34,87.86,8857744,10821321.15,61.13043363065501,49.474257714608434,NaN,NaN,185.67391158590408,87.96850601288494,0.17046103351398142,0.18335154788316288,0.012890514369181465,266018145,254806208.8,66.1650170196784,50.06596963694634,NaN,NaN,5.1214843900078995,0.4913362037057082
2013-12-27T09:30:00-05:00,88.16,88.41,87.87,88.29,5866313,10648669.5,63.66130445428783,50.52281273405805,NaN,NaN,212.95176245521566,124.6278821399583,0.22821608254929024,0.29816061755579426,0.06994453500650402,271884458,257685022,68.67565844521728,51.652426390978334,NaN,NaN,8.502464120793663,1.635783049003987
2013-12-30T09:30:00-05:00,88.4,88.49,87.57,87.66,7045703,10752120.55,57.73039133424188,51.07402733774847,NaN,NaN,154.99104697327965,147.67376154465248,0.21160956504740686,0.3344564913157626,0.12284692626835575,264838755,262293555.2,72.22832698214697,53.13685173823533,NaN,NaN,9.610532571362272,2.7750329807694563
2013-12-31T09:30:00-05:00,87.87,88.535,87.5501,88.51,8075555,10674926.6,62.77005427940535,52.14620792823559,NaN,NaN,156.45749689784623,163.46940792836833,0.2432330407985742,0.4268882272665735,0.1836551864679993,272914310,266563213.8,75.05146961551299,54.95858798268184,NaN,NaN,12.22689246226957,4.125298620983758
2014-01-02T09:30:00-05:00,87.98,88.24,86.9,87.25,11133534,10689348.25,52.73327620992173,53.134241073292515,NaN,NaN,76.9229163516877,157.3994268527867,0.16821873914006094,0.3939286103930755,0.22570987125301453,261780776,267487288.8,75.6289065331496,57.05601609865367,NaN,NaN,11.086950940600786,5.119820380929047
2014-01-03T09:30:00-05:00,87.34,87.69,86.7501,86.93,9714236,10673309.75,50.52373852792666,53.72152492888905,NaN,NaN,42.29917276820524,128.72447908924693,0.08990351762138452,0.33808926827974517,0.24818575065836065,252066540,264696967.8,70.33515382468647,58.52172145386895,NaN,NaN,9.443388519300937,5.7374729721250315
2014-01-06T09:30:00-05:00,87.19,87.34,86.56,87.05,9256595,10632540.8,51.3470082819577,54.50221383277733,NaN,NaN,26.94371191269309,91.5228689807424,0.04149962058305978,0.30006027638718535,0.25856065580412557,261323135,262584703.2,66.53827942036975,60.0119258336515,NaN,NaN,8.404422736687,6.118465795633884
2014-01-07T09:30:00-05:00,87.3,87.77,86.8501,87.71,6650943,10381436.6,55.71195701337458,55.115808625040884,NaN,NaN,61.47435952317586,72.81953149072163,0.04874792694849306,0.3194955644897419,0.27074763754124886,267974078,263211767.8,67.10598006568082,61.827429286603525,NaN,NaN,8.899211662149252,6.515715205136079
2014-01-08T09:30:00-05:00,87.72,87.75,86.77,87.1,10941435,10274726.45,51.144841304537785,55.65323578717543,NaN,NaN,37.75095104506368,49.078222320165125,0.009338448613481876,0.28242069830810124,0.27308224969461936,257032643,260035434.4,61.42150873675208,63.48105712862682,NaN,NaN,7.857799202803056,6.707441490517076
2014-01-09T09:30:00-05:00,87.19,87.34,86.11,86.83,12222695,10357559.6,49.22145439919772,55.3527028845935,NaN,NaN,-1.5464846946565467,33.38434211089628,-0.035572593800232366,0.22861650744432893,0.2641891012445613,244809948,256641268.8,55.96589127377952,64.3198021127751,NaN,NaN,6.414543631883507,6.665598939283709
2014-01-10T09:30:00-05:00,86.89,87.01,86.33,86.9,10470041,10146928.4,49.74908232811929,54.97331998177334,NaN,NaN,-9.30169633433125,23.064168290388967,-0.05979851610529191,0.18944095611294642,0.24923947221823833,255279989,257283958.6,56.74926674446888,64.83491897652486,NaN,NaN,5.404693379089142,6.485469573541628
2014-01-13T09:30:00-05:00,86.66,86.79,85.09,85.17,16717570,10433611.9,38.971382625046765,53.96708655901489,NaN,NaN,-115.5857495693402,-5.441724006017691,-0.18452494494254332,0.01858329104005918,0.2031082359826025,238562419,252731815.4,49.96853495680954,64.59618182186118,NaN,NaN,0.7350930338633866,5.6639872107304505
2014-01-14T09:30:00-05:00,85.51,86.32,85.51,86.28,13222025,10486450.3,46.917483388267904,53.48182859877597,NaN,NaN,-93.26361214951837,-36.389318340556535,-0.18404204383826214,-0.026944318815225188,0.15709772502303695,251784444,249493888.6,45.77853519567337,63.85222879836077,NaN,NaN,-0.5118788975918935,4.781720623827258
2014-01-15T09:30:00-05:00,86.4,86.48,85.9,86.03,11667843,10461778.3,45.481155028150496,52.64954020036365,NaN,NaN,-86.92081036371276,-61.32367062231183,-0.1914782286545243,-0.08225006079511843,0.10922816785940587,240116601,246110680.2,41.831531325280245,62.3888614385147,NaN,NaN,-1.9644854352505563,3.817976901101856
2014-01-16T09:30:00-05:00,85.87,86.17,85.47,86.15,11297021,10533817.95,46.330477622860634,51.59240048552119,NaN,NaN,-116.49947825027361,-84.31426933343523,-0.17943917278410565,-0.11507079812072618,0.06436837466337945,251413622,247431415,43.866235980974245,60.79609136432155,NaN,NaN,-2.8438968546287207,2.866280650283202
2014-01-17T09:30:00-05:00,86.36,86.83,85.9,86.01,12632805,10402237.1,45.44105954242697,50.290954420388275,NaN,NaN,-82.7090541764406,-98.9957409018571,-0.1720081349727181,-0.1506417940525182,0.021366340920199914,238780817,244131580.6,40.09276539934434,58.75445614675919,NaN,NaN,-3.8188944586680402,1.911255634718739
2014-01-21T09:30:00-05:00,86.62,86.92,85.99,86.72,12725743,10477820.8,50.618536012360984,49.78296475453964,NaN,NaN,-46.846557570058614,-85.2479025020008,-0.11321780531158426,-0.12015591571928042,-0.006938110407696152,251506560,246720408.8,44.15173720769111,56.748985448583774,NaN,NaN,-3.088360932195131,1.197024696588186
2014-01-22T09:30:00-05:00,86.93,87.22,86.57,87.12,10557535,10220982.4,53.30691856138342,49.10702648896665,NaN,NaN,0.5853787396518924,-66.47810432416674,-0.04484378224466856,-0.06299283821353185,-0.018149055968863292,262064095,248776339,47.21068861458955,54.7603582342321,NaN,NaN,-1.6620688363525882,0.7885827633109327
2014-01-23T09:30:00-05:00,86.65,86.83,85.72,86.13,14900729,10477522.45,46.551929098637,48.66550169530346,NaN,NaN,-77.37151476548027,-64.56824520452025,-0.06265150974573945,-0.09646344315103761,-0.03381193340529816,247163366,250185692,49.26227587610713,52.87702747301478,NaN,NaN,-2.5209780504051214,0.31578836135149646
2014-01-24T09:30:00-05:00,85.61,85.61,84.28,84.3299,17426067,11069106.6,37.29720449684684,47.720749264512044,NaN,NaN,-195.19935468278743,-80.308220491023,-0.18509867237826666,-0.2651852738781315,-0.08008660149986484,229737299,245850427.4,43.64347285670088,50.97047883244437,NaN,NaN,-6.644591097836786,-0.6785515613896868
2014-01-27T09:30:00-05:00,84.48,84.65,83.44,84.03,16054469,11428942.85,36.012670332232155,46.625439410960226,NaN,NaN,-213.7130617072356,-106.509021997182,-0.27055178657370205,-0.41827633471699244,-0.14772454814329036,213682830,240830830,38.209267933103675,48.94697801192537,NaN,NaN,-10.294961990480209,-2.05232447983119
2014-01-28T09:30:00-05:00,84.23,84.8,84,84.67,9112707,11591262.55,40.70587239767614,45.553576224124626,NaN,NaN,-153.890707524529,-127.91785198807608,-0.2677392899810547,-0.4823986606196087,-0.214659370638554,222795537,235088625.4,33.127652124597304,46.51995458756226,NaN,NaN,-11.73753425379541,-3.4359258761117926
2014-01-29T09:30:00-05:00,83.93,84.78,83.49,84.2,20124809,12245217.85,38.4741174784528,44.64852452226141,NaN,NaN,-157.69943830422258,-159.57481539685097,-0.279978429091946,-0.5646324070034865,-0.2846539779115405,202670728,223209952,25.555874918184955,43.958123600521745,NaN,NaN,-13.633803072757427,-4.892765475632597
2014-01-30T09:30:00-05:00,84.77,84.91,83.99,84.47,12265606,12454720.4,40.49253709349821,44.02503042899715,NaN,NaN,-119.17910747443739,-167.9363339386424,-0.25314684726798065,-0.6010875369965163,-0.34794068972853565,214936334,216764545.6,22.544805853193978,41.57090321333707,NaN,NaN,-14.536652401082048,-6.270463607839662
2014-01-31T09:30:00-05:00,83.49,84.12,83.03,83.38,15983149,12697201.15,35.43811368116579,43.00281838278619,NaN,NaN,-157.0584151255265,-160.3081460271902,-0.28944810026474344,-0.7097508150594649,-0.4203027147947215,198953185,210607722.8,20.107654958072317,38.95364522859445,NaN,NaN,-16.978980073213275,-7.800251674321606
2014-02-03T09:30:00-05:00,83.3,83.65,81.775,81.89,25172753,13470127,29.937013451197842,42.35750629893983,NaN,NaN,-183.38547735305983,-154.24262915635504,-0.38828417413105365,-0.9056579324585385,-0.5173737583274849,173780432,202627243.2,17.471224688197765,36.632408780836464,NaN,NaN,-21.091449148602017,-9.698994170647378
2014-02-04T09:30:00-05:00,82.35,82.94,82.05,82.73,20339787,14024286.6,35.97136877911552,41.57564096971466,NaN,NaN,-146.61661566173584,-152.78781078379643,-0.3715545770368255,-0.9818169796235168,-0.6102624025866913,194120219,196892179.6,15.861697025426167,34.495491768675954,NaN,NaN,-22.382923162450385,-11.510984026619235
2014-02-05T09:30:00-05:00,82.73,82.75,81.805,81.92,27270856,15055282.25,33.01821388528427,40.68543088808137,NaN,NaN,-144.5494429975403,-150.15781172245997,-0.3877199466479797,-1.094912335896666,-0.7071923892486862,166849363,189727906.6,14.112647303386709,32.51557148139784,NaN,NaN,-24.45160446194461,-13.359644088808574
2014-02-06T09:30:00-05:00,82.14,83.34,82.11,83.14,13028205,15159620.75,40.889623026222154,40.2967984168929,NaN,NaN,-99.18601501593837,-146.1591932307602,-0.2932222789856862,-1.073720237980794,-0.7804979589951078,179877568,182716153.4,12.643216139538296,30.285355778438134,NaN,NaN,-23.442500580115112,-14.800052158995221
2014-02-07T09:30:00-05:00,83.65,84.17,83.14,84.04,12402216,15168596.8,45.936973681855825,40.332220855423536,NaN,NaN,-49.75456015684655,-124.69842223702419,-0.1540702268836227,-0.9730857425996362,-0.8190155157160135,192279784,181381473.2,12.378998654939267,28.305801010980627,NaN,NaN,-20.851450486585325,-15.664537634365237
2014-02-10T09:30:00-05:00,84.02,84.13,83.28,83.63,7960915,15043140.5,44.089978892937765,39.865895346893296,NaN,NaN,-49.58661778054022,-97.93865032252027,-0.07747423461181935,-0.9158583089807877,-0.8383840743689683,184318869,183489160.6,15.386175585942254,26.25111803799857,NaN,NaN,-19.40918597165967,-16.19948739683587
2014-02-11T09:30:00-05:00,83.72,85.01,83.63,84.72,10869613,14750742.65,49.86163899446135,39.619803949256,NaN,NaN,-6.4363263397581285,-69.90259245812474,0.0518006179654954,-0.7736333019120991,-0.8254339198775945,195188482,183702813.2,15.702006525826235,24.000497888801192,NaN,NaN,-16.22920778973488,-16.203733167250014
2014-02-12T09:30:00-05:00,84.98,85.15,84.43,84.52,6812376,14430260.2,48.8648666274118,39.78501377273992,NaN,NaN,11.358903160309477,-38.720923226554774,0.12487390782318752,-0.66934153509861,-0.7942154429217976,188376106,188008161.8,22.01868437561781,22.054527067337666,NaN,NaN,-14.040972941003393,-15.894767420643355
2014-02-13T09:30:00-05:00,84.12,85.14,83.89,84.92,9798927,14336814.4,50.97570730751622,40.76204968778774,NaN,NaN,13.71308824159462,-16.141102575048173,0.1968965097664872,-0.5480948057136885,-0.7449913154801757,198175033,191667654.8,27.024187239958906,20.86743523757038,NaN,NaN,-11.599515986660357,-15.281160072931497
2014-02-14T09:30:00-05:00,84.99,86.2,84.86,86.03,12618276,14402877.15,56.35933582198706,42.21538293705594,NaN,NaN,80.624434219271,9.93469630017535,0.30934679141138144,-0.3583078262159489,-0.6676546176273304,210793309,195370359.8,31.794629091760456,20.409246748903005,NaN,NaN,-7.73406389361318,-14.203003475886023
2014-02-18T09:30:00-05:00,86.16,86.53,86.01,86.42,8853964,14213935.1,58.100342868649484,43.457845113554036,NaN,NaN,119.34927915876739,43.72187568803687,0.3945877480390514,-0.17441993257851607,-0.5690076806175675,219647273,202436040.6,39.87209810000991,20.890992890003904,NaN,NaN,-4.038763729452195,-12.750969226395476
2014-02-19T09:30:00-05:00,86.15,87.41,86.15,86.53,23821902,14768743.05,58.6019935046168,44.89555054399432,NaN,NaN,141.63663569129187,73.33646809424687,0.4395376639141153,-0.019585600724923324,-0.45912326463903863,243469175,212092179.2,48.79669973459657,22.551051805461874,NaN,NaN,-0.9098449656056878,-11.05938004628265
2014-02-20T09:30:00-05:00,86.5,87.27,86.38,87.1,9436884,14712710.5,61.194674490619015,46.37427464378867,NaN,NaN,155.90209605452117,102.24510667308921,0.4852319172569587,0.1474166319321597,-0.337815285324799,252906059,224998169.8,57.81018833099238,25.070007696733192,NaN,NaN,2.5302310745409886,-9.118007029022131
2014-02-21T09:30:00-05:00,87.29,87.31,86.36,86.41,11582800,14546814.05,56.575572711395175,47.884093145947894,NaN,NaN,137.7354174718503,127.04957251914034,0.44748114053598276,0.22153614034517943,-0.2259450001908033,241323259,233627815,62.55651380520763,28.102069042957144,NaN,NaN,4.156171590988266,-7.221695797592075
2014-02-24T09:30:00-05:00,86.67,88.48,86.62,87.71,18613814,14606201.4,62.342843820100896,50.198795315155266,NaN,NaN,160.18168591756665,142.96102285879948,0.4853848446275365,0.38078605559361733,-0.10459878903391916,259937073,243456567.8,67.0967540003122,31.646749708108196,NaN,NaN,7.44510387016685,-5.126438702197943
2014-02-25T09:30:00-05:00,87.54,87.84,86.96,87.67,9583205,14282638.2,62.06968380798379,52.062960674360134,NaN,NaN,129.21821438314697,144.9348099036754,0.48209837706030273,0.4980241822914593,0.01592580523115654,250353868,249597886.8,69.57888980296295,35.48369204936082,NaN,NaN,9.98478978791911,-2.967691775038364
2014-02-26T09:30:00-05:00,87.71,87.81,86.85,87.12,10048251,14329415.4,58.287903217582326,53.86793848380999,NaN,NaN,101.70589505506311,136.94866177642965,0.4195211816772876,0.5403272823277661,0.12080610065047846,240305617,248965175.2,69.00136149270116,39.40431449145472,NaN,NaN,11.0390488459048,-0.9667288291893406
2014-02-27T09:30:00-05:00,87.15,87.35,86.58,87.21,9333381,13789844,58.731006710690316,55.142323032700574,NaN,NaN,81.79494267937672,122.12723110140075,0.3629492379473544,0.5744926480846715,0.2115434101373171,249638998,248311763,68.37021689901952,43.38481454570337,NaN,NaN,12.025335771761414,0.8892803995179102
2014-02-28T09:30:00-05:00,87.27,87.985,87.13,87.65,10474434,13700285.4,60.916890703674355,56.21231710568761,NaN,NaN,92.06318535336396,112.99278467770348,0.3346158119893571,0.6298131751240135,0.2951973631346564,260113432,252069797.6,70.06608823324854,47.505320944154036,NaN,NaN,13.481890809601035,2.6882247438154994
2014-03-03T09:30:00-05:00,87.12,88.09,86.81,87.09,12463575,13524306.7,56.79378842607826,57.119732072340504,NaN,NaN,74.5993841007953,95.87632431434922,0.26088670596829366,0.6213057455950235,0.36041903962672983,247649857,249612354.4,67.51681701348977,51.22893818897886,NaN,NaN,13.586592600937951,4.245134437690135
2014-03-04T09:30:00-05:00,87.85,88.3,87.51,88.04,10524448,12791891.45,61.54845859726096,57.954504901111896,NaN,NaN,91.90392596030354,88.41346662978053,0.2583395275031797,0.6833434490057044,0.42500392150252475,258174305,251176441.8,68.30718829924297,54.98645117279434,NaN,NaN,15.081001347614343,5.793115424822164
2014-03-05T09:30:00-05:00,87.77,87.85,86.99,87.22,10865326,12318168.4,55.83671148803924,58.45249381972815,NaN,NaN,62.78352386136738,80.62899239104138,0.18699525651402205,0.6587479921450523,0.47175273563103026,247308979,252577114.2,69.03382998079685,58.34467585887855,NaN,NaN,14.649708014962082,7.058342937699296
2014-03-06T09:30:00-05:00,87.28,87.94,87.23,87.85,7788265,11344038.85,58.985884494098926,59.024649333055486,NaN,NaN,73.45886143090499,78.96177614134703,0.16837969784879614,0.6822273579420255,0.5138476600932294,255097244,253668763.4,69.61848565136968,61.3871257454079,NaN,NaN,15.234176511032866,8.226319162461234
2014-03-07T09:30:00-05:00,88.21,88.27,87.68,88.02,9852702,11185263.7,59.818518447331456,59.27173380629437,NaN,NaN,87.18942731277532,77.9870245332293,0.15404943614205757,0.7064094552708013,0.5523600191287438,264949946,254636066.2,70.15617469721704,64.12723614579765,NaN,NaN,15.952738154963406,9.330093304247258
2014-03-10T09:30:00-04:00,87.93,88.22,87.42,88.16,8864421,11008373.95,60.529176612527145,59.445221930857066,NaN,NaN,82.12560386473405,79.49226848601707,0.14089069180671276,0.7284733838871347,0.5875826920804219,273814367,259868968.2,72.94565695864958,66.48963320712906,NaN,NaN,16.744324574442686,10.389269199989462
2014-03-11T09:30:00-04:00,88.27,88.33,86.87,87.16,12267991,11223727.75,53.28048502855123,59.06511418256667,NaN,NaN,47.170929737039536,70.54566924136427,0.05608277984751653,0.6576861668898175,0.601603387042301,261546376,260543382.4,73.29213607066086,68.23930723113365,NaN,NaN,15.30641758701394,11.091718969564388
2014-03-12T09:30:00-04:00,86.55,87.39,86.46,87.17,9368623,11148678.25,53.340660309630316,58.504113169638906,NaN,NaN,3.66992577985963,58.72294962506271,-0.004859654963739302,0.5955288183376268,0.6003884733013661,270914999,265264586.4,75.64372633822987,69.51313137450775,NaN,NaN,14.158468272217931,11.529826012800608
2014-03-13T09:30:00-04:00,87.3,87.33,85.968,86.3,11272755,11371697.2,47.59682803743017,57.862774264355686,NaN,NaN,-58.7639537187118,32.27838659513935,-0.10379743593727064,0.4706416783797778,0.5744391143170484,259642244,266173586.4,76.08041502354058,70.4791243186744,NaN,NaN,11.41711142299595,11.5137239285428
2014-03-14T09:30:00-04:00,86.2,86.7199,86.08,86.38,10653337,11414417.7,48.149732104074445,56.848980570353795,NaN,NaN,-100.11451654839966,-5.1824021770956445,-0.16050012584821916,0.37381395700677444,0.5343140828549936,270295581,267242713.4,76.61155924563482,71.15875326476886,NaN,NaN,9.326746392450492,11.2012985662439
2014-03-17T09:30:00-04:00,86.72,87.11,86.5,86.84,10419160,11304461.9,51.32960394580664,56.08183200876972,NaN,NaN,-58.457587502047474,-33.29904045045195,-0.16314170570559794,0.3303869507229962,0.4935286564285941,280714741,268622788.2,77.31190869949589,71.71111175737836,NaN,NaN,8.404961780373403,10.801821882548115
2014-03-18T09:30:00-04:00,87.16,87.84,86.89,87.57,6995115,11211519.45,55.94687187541216,55.91461548432899,NaN,NaN,29.496199494164014,-36.833986499027056,-0.11415775095975922,0.35083146772889506,0.4649892186886543,287709856,273855484.2,79.78375558996792,72.48128276432598,NaN,NaN,8.927447434983236,10.53405410432456
2014-03-19T09:30:00-04:00,87.6,87.625,86.37,86.91,9322526,10486550.65,51.216095478780666,55.37783611062116,NaN,NaN,-53.06521227878203,-48.181014110755385,-0.12383009522774013,0.3102015996539791,0.4340316948817192,278387330,275349950.4,80.43922866590052,73.3433550333889,NaN,NaN,7.973349216937884,10.168239120412178
2014-03-20T09:30:00-04:00,86.48,87.39,86.19,87.25,8713363,10450374.6,53.40205945177888,54.841062449771485,NaN,NaN,-57.895350799500136,-48.00729352691305,-0.10566013343396452,0.30195652808926354,0.40761666152322806,287100693,280841640.2,82.66364807866302,74.2431807366328,NaN,NaN,7.810351681054173,9.831398057646748
2014-03-21T09:30:00-04:00,87.12,87.71,87.04,87.06,14130162,10577742.7,51.999802805885636,54.49863490547201,NaN,NaN,-6.094171057461616,-29.20322442872544,-0.10457419402387691,0.2768989189933819,0.38147311301725884,272970531,281376630.2,82.86803924452923,75.33969661027848,NaN,NaN,7.27715592088584,9.466506323823761
2014-03-24T09:30:00-04:00,87.33,87.73,86.72,86.88,10043960,10149250,50.64307369029787,53.719678840688935,NaN,NaN,-32.54422219084406,-24.02055136648476,-0.11337659323014115,0.2397523714795824,0.35312896470972355,262926571,277818996.2,76.41610969208561,75.91890528119582,NaN,NaN,6.45501578637054,9.036293389901873
2014-03-25T09:30:00-04:00,87.325,87.73,87.3,87.66,7176575,10028918.5,56.000387442428206,53.73136998028815,NaN,NaN,54.43283675543899,-19.033223914229765,-0.0663920097458558,0.27013895252740383,0.3365309622732596,270103146,274297654.2,70.5602048636691,76.02793205854383,NaN,NaN,7.257313520266309,8.782153408525364
2014-03-26T09:30:00-04:00,87.96,88.19,87.19,87.25,8571278,9955069.85,52.75872911379463,53.286573167409266,NaN,NaN,46.41897689237458,0.8636139200015563,-0.06269593491225695,0.25816104363293846,0.3208569785451954,261531868,270926561.8,65.39375196333637,75.72616536654144,NaN,NaN,7.008549736780374,8.528781455418937
2014-03-27T09:30:00-04:00,87.28,88.23,87.07,87.96,11396193,10058210.45,57.361671634936535,53.11108410938106,NaN,NaN,78.30243990021658,28.1031720599449,-0.01470733281985398,0.30247281252037794,0.3171801453402319,272928061,268092035.4,61.327604052079444,75.09555317760305,NaN,NaN,8.164373589925864,8.476723188919927
2014-03-28T09:30:00-04:00,88.25,89.25,88.2,89.06,9955632,10032270.35,63.32398904944782,53.31071356916111,NaN,NaN,229.04325503990125,75.13065727941748,0.08344973532580224,0.4214923144974847,0.33804257917168246,282883693,270074667.8,63.05787899911062,74.38928332335026,NaN,NaN,11.137948036471297,8.856898167141551
2014-03-31T09:30:00-04:00,89.5,89.59,88.79,89.06,8451765,9831679.85,63.32398904944782,54.02810671351086,NaN,NaN,220.07369010831837,125.65423973924996,0.13751624133349366,0.5099378808385495,0.37242163950505586,282883693,274066092.2,66.32449818310783,73.89159490281077,NaN,NaN,13.486917948052602,9.51832956441456
2014-04-01T09:30:00-04:00,89.09,89.6,89.05,89.59,10247284,9817821.65,65.98211061382338,54.93106744952463,NaN,NaN,211.3535479102082,157.0383819702038,0.1946233160763372,0.6157007846004774,0.4210774685241402,293130977,278671658.4,69.65841493540474,73.46407265975184,NaN,NaN,16.308402275556354,10.48833995172053
2014-04-02T09:30:00-04:00,89.4,90.07,89.33,89.91,10008616,9774986.15,67.51305835194555,56.35365532913288,NaN,NaN,196.46063799464733,187.04671419065835,0.23679721786649466,0.7170739908572585,0.4802767729907639,303139593,286993203.4,74.55930789694821,73.35542215070951,NaN,NaN,19.124726543531626,11.7221094648364
2014-04-03T09:30:00-04:00,90.11,90.86,89.96,90.49,10798364,9925491.1,70.13641668704173,57.924132799344825,NaN,NaN,198.18171289448392,211.0225687895118,0.2834533543665535,0.8345934659489558,0.5511401115824023,313937957,295195182.6,78.2827248159845,73.4747911200202,NaN,NaN,22.361829510145075,13.242069471309067
2014-04-04T09:30:00-04:00,91.17,91.3,90,90.16,14003166,10133014.3,66.82975845645902,59.03128669296286,NaN,NaN,162.4829465183066,197.7105070851929,0.2717529553711272,0.8908313057963113,0.6190783504251841,299934791,298605402.2,79.61839575349372,73.63954019530577,NaN,NaN,24.108282039452753,14.79438555247245
2014-04-07T09:30:00-04:00,89.95,90.13,88.65,88.65,11244805,10252033.5,54.230687151087096,58.90870206979678,NaN,NaN,67.83570929199122,167.26291092192744,0.14816494147032688,0.8042845272630927,0.6561195857927659,288689986,299766660.8,80.06794522805856,73.65983945516939,NaN,NaN,21.592972266016787,15.765612225835927
2014-04-08T09:30:00-04:00,88.87,89.73,88.7,89.54,11644444,10220856.15,59.12230764628217,59.4734315103326,NaN,NaN,69.42123407241384,138.87644815436857,0.11375132136843136,0.7983087375033051,0.6845574161348738,300334430,301207351.4,80.63850925336698,73.67407378284557,NaN,NaN,21.088208756331046,16.5259831587638
2014-04-09T09:30:00-04:00,89.82,90.01,89.04,89.95,7231166,10113983.3,61.18059394655531,60.029041117102345,NaN,NaN,78.79924713391887,115.34416998222291,0.10614276163272951,0.8172358681757856,0.7110931065430561,307565596,302092552,80.99842233741597,73.55512908704222,NaN,NaN,21.352217859890025,17.21544525892469
2014-04-10T09:30:00-04:00,89.61,90.19,88.511,88.7,12298325,10165261.8,52.50102710374641,60.06484285266384,NaN,NaN,43.91631923862574,84.49109125105126,0.009554704946587167,0.72303648772629,0.7134817827797029,295267271,298358414.8,74.69088671510954,72.97104676351223,NaN,NaN,18.568973446361444,17.40880642855851
2014-04-11T09:30:00-04:00,88.26,88.97,88.2204,88.45,13455858,10305387.85,50.94436206883294,60.08636345113062,NaN,NaN,5.039138933170106,53.00232973402397,-0.07394478436071439,0.6210508023288099,0.6949955866895243,281811413,294733739.2,69.06842793669148,72.44621235241264,NaN,NaN,15.866324409203433,17.188451854364928
2014-04-14T09:30:00-04:00,89.13,89.84,88.71,89.66,9961407,10282500.2,57.510880231968315,60.194255793240636,NaN,NaN,52.756266951261786,49.98644126587807,-0.05152110770195173,0.6305942020620847,0.6821153097640364,291772820,295350306,69.48916276535039,72.3697093453899,NaN,NaN,15.735702219790074,16.980916192282805
2014-04-15T09:30:00-04:00,89.6,90.89,89.32,90.86,22442865,11054887.7,62.82549698690895,60.91331064132022,NaN,NaN,105.32769984143356,57.167734419682006,0.03559692151571292,0.7266114616586776,0.6910145401429647,314215685,298126557,71.37708298820925,72.79709013288081,NaN,NaN,17.507494989387656,17.056141734726356
2014-04-16T09:30:00-04:00,91.39,91.97,91.26,91.95,13036671,11240594.95,66.87814433318235,61.593058691194926,NaN,NaN,178.50866480274672,77.10961795344758,0.15159617092750277,0.8805097538023432,0.7289135828748404,327252356,302063909,73.84855346898759,73.69144366265995,NaN,NaN,20.44110424584943,17.539707807743937
2014-04-17T09:30:00-04:00,92.07,93.07,91.91,92.79,18549532,11732403.4,69.62622737300539,62.04321857144904,NaN,NaN,210.10099097592285,110.346552300907,0.2633168030082046,1.0580595866350961,0.7947427836268915,345801888,312170832.4,78.88788278160766,74.82215821855259,NaN,NaN,23.795779393525233,18.43343231999841
2014-04-21T09:30:00-04:00,92.875,93.49,92.71,93.42,8506426,11451216.6,71.53383932419241,62.629636448216516,NaN,NaN,206.54748292172778,150.64822109861854,0.3524972388338449,1.2353643321691976,0.8828670933353527,354308314,326670212.6,83.7312410463801,76.06549699450063,NaN,NaN,27.14241203779354,19.677572279683428
2014-04-22T09:30:00-04:00,93.16,93.53,92.71,93.27,6345247,11266280.95,70.40013402670417,62.94520954913657,NaN,NaN,170.38991202223266,174.17495011281272,0.3722937402253679,1.3482342686170625,0.9759405283916947,347963067,337908262,86.34584451430464,77.25745625013633,NaN,NaN,29.389909318923955,21.06504899957493
2014-04-23T09:30:00-04:00,93.26,94.0151,93.26,93.76,8561746,11335539.5,71.9632998199992,63.26308393971184,NaN,NaN,163.50300109801012,185.81001036412803,0.3875587424907123,1.460388956505085,1.0728302140143726,356524813,346370087.6,87.92009149821176,78.21179793594088,NaN,NaN,31.730290620059815,22.588654945358485
2014-04-24T09:30:00-04:00,94.03,94.2499,93.62,93.79,8876542,11350802.7,72.06058405753848,63.400524466175895,NaN,NaN,147.70716749978754,179.6497109035362,0.36894382212517596,1.5340099916708425,1.1650661695456666,365401355,353999887.4,89.13632898981444,78.98705537692874,NaN,NaN,33.623594175631645,24.16507483539751
2014-04-25T09:30:00-04:00,93.53,93.8199,92.94,93.23,8872330,11224609.55,67.36184819454016,63.43853087603883,NaN,NaN,105.3272368107118,158.694960070494,0.29157612825034773,1.529536329858601,1.2379602016082534,356529025,356145314.8,89.45774939304953,79.68986635118272,NaN,NaN,33.863004619173466,25.55049337593693
2014-04-28T09:30:00-04:00,93.55,93.63,92.61,93.39,11167069,11285181.4,68.0037940174521,64.42232422363632,NaN,NaN,87.66862073382903,134.91918763291423,0.22672323349987056,1.5213642434830916,1.294641009983221,367696094,358822870.8,89.86093423817067,80.38936556619072,NaN,NaN,34.240354951951446,26.791902172510433
2014-04-29T09:30:00-04:00,93.84,94.66,93.79,93.82,8278002,11276493.25,69.72709101258357,65.17980874980073,NaN,NaN,106.98013682308294,122.23723259308429,0.1898280894159845,1.5319261217532016,1.3420980323372171,375974096,364425076.6,90.66533893333234,81.10556768618825,NaN,NaN,35.046268432329576,27.971097352484595
2014-04-30T09:30:00-04:00,93.61,93.88,93.1399,93.74,10821563,11305207.2,68.98268824977609,65.73710120003078,NaN,NaN,79.15532012439364,105.36769639836098,0.1394107610764097,1.5163614836827293,1.3769507226063196,365152533,366150620.6,90.90469561600625,81.81315863465899,NaN,NaN,35.513147160096764,29.048533039286333
2014-05-01T09:30:00-04:00,93.61,93.86,93.26,93.53,10715592,11340556,66.96177632603099,66.7700118587654,NaN,NaN,70.71408955283496,89.96908080897046,0.07454690765518213,1.4701343571752972,1.395587449520115,354436941,363957737.8,87.82272853256144,82.75114733590556,NaN,NaN,35.37454379576634,29.95224886164062
2014-05-02T09:30:00-04:00,93.36,94.42,93.23,93.72,8713048,11236290.2,67.87867165017114,67.97960540028956,NaN,NaN,72.49739832966551,83.40311311276122,0.029385680612465936,1.4323195502856976,1.4029338696732316,363149989,365281930.6,88.08541700215115,84.10950369772411,NaN,NaN,35.492149937331504,30.74366330102503
2014-05-05T09:30:00-04:00,93.37,94.32,93.2,94.16,8037308,10937997.3,69.95796684025302,68.86868301516702,NaN,NaN,69.85271487920767,79.83993194183692,0.014828544271678679,1.42146955001283,1.4066410057411514,371187297,365980171.2,88.22960221460725,85.44810651552815,NaN,NaN,36.1431654449062,31.515020750150914
2014-05-06T09:30:00-04:00,94.25,94.8,94.17,94.3,7476684,10749591.25,70.60987163835156,69.42470977598437,NaN,NaN,83.91749270864013,75.22740311894837,0.0010374718273842287,1.4079378455253817,1.4069003736979975,378663981,366518148.2,88.3466160527192,86.660216020136,NaN,NaN,36.86620663200591,32.2794758761302
2014-05-07T09:30:00-04:00,94.72,95.25,94.19,95.12,9630871,10648912.6,74.14832907144064,69.94400868585996,NaN,NaN,96.69244193155205,78.73482748038005,0.031843150986364144,1.4467043124309527,1.4148611614445885,388294852,371146612,89.32947193826348,87.76599591079858,NaN,NaN,38.5225568459575,33.171344586105526
2014-05-08T09:30:00-04:00,94.93,95.09,93.6801,93.76,10967844,10835746.5,61.025348142399,69.32966016938806,NaN,NaN,65.94843139431549,77.78169584867615,-0.05020875864268892,1.3521002131412274,1.4023089717839163,377327008,375724625.4,90.20907434972104,88.57465245137811,NaN,NaN,36.01714978164161,33.57788818546783
2014-05-09T09:30:00-04:00,93.88,94.05,93.31,93.67,8710770,10656368.75,60.26522112704029,68.52475886959148,NaN,NaN,39.432322259274,71.16868063459785,-0.11753345285657657,1.2553921557131957,1.3729256085697723,368616238,376817875.2,90.41232907409093,89.05187302478602,NaN,NaN,33.77423314814709,33.60593746585058
2014-05-12T09:30:00-04:00,94.1,94.38,93.81,94.33,5221746,10244663.15,63.82386237899158,68.05502518046914,NaN,NaN,69.18906209048814,71.03595007685395,-0.1239670116654561,1.217966843987952,1.3419338556534082,373837984,377348012.6,90.51515458451648,89.34968088694401,NaN,NaN,32.88041063041698,33.50229077507435
2014-05-13T09:30:00-04:00,94.51,94.82,94.37,94.68,4988803,9996032.95,65.58413868594766,67.59937081375118,NaN,NaN,108.46335444122867,75.94512242337166,-0.11139885856404108,1.202685282448357,1.314084141012398,378826787,377380573.8,90.52187825898537,89.53552279842783,NaN,NaN,32.65291033796313,33.38095071262989
2014-05-14T09:30:00-04:00,94.78,95.02,94.59,94.72,4988984,9123338.9,65.78901926883245,67.15140190027218,NaN,NaN,128.4575689293966,82.29814782294058,-0.107109219166168,1.180197617054688,1.287306836220856,383815771,376484757.6,88.65976458692673,89.50148248393586,NaN,NaN,32.52561615130751,33.25876006101241
2014-05-15T09:30:00-04:00,94.53,94.56,92.95,93.64,11448846,9043947.65,56.081462550427005,66.3456600685498,NaN,NaN,-15.266691000269576,66.05512334402356,-0.17946492166109262,1.0629756841444902,1.2424406058055828,372366925,375492741,86.53682182894644,89.29284480078563,NaN,NaN,29.412045918272927,32.709229469192486
2014-05-16T09:30:00-04:00,93.47,93.74,92.93,93.4,14811000,8857021.05,54.16863173460462,65.35743419120357,NaN,NaN,-80.19764302592871,42.12913028698301,-0.24205155963516,0.9398761562616329,1.181927715896793,357555925,373280678.4,81.8314380543456,88.71930935908384,NaN,NaN,26.274051209122884,31.789918289182545
2014-05-19T09:30:00-04:00,93.14,93.935,93.14,93.69,5037308,8683565.15,56.11637264663067,64.38524002220693,NaN,NaN,-48.20402840748034,18.650512187389317,-0.26085919595389173,0.8558537209544284,1.11671291690832,362593233,371031728.2,77.23346184218973,87.75988956685937,NaN,NaN,24.207687591936665,30.706742475290277
2014-05-20T09:30:00-04:00,93.49,93.86,93.24,93.42,4675647,8600085.15,53.82293878580863,63.30240077478068,NaN,NaN,-67.01711061371485,-16.445580823599386,-0.2863844156652309,0.7587323973267814,1.0451168129920123,357917586,366849888,69.42226481275132,86.22543022376973,NaN,NaN,21.807812043721086,29.43546669935182
2014-05-21T09:30:00-04:00,93.85,94.5551,93.72,94.43,5857432,8464869.45,60.350831480585384,62.830190428677426,NaN,NaN,52.48042198820825,-31.641010211837056,-0.23244267461060897,0.7545634697287511,0.9870061443393601,363775018,362841737.4,62.860082131702455,84.44238405227979,NaN,NaN,21.59510694890348,28.31541530643063
2014-05-22T09:30:00-04:00,94.43,94.84,94.22,94.34,6869162,8364500.45,59.54306886371818,62.234790229645064,NaN,NaN,80.71271440537807,-12.445129130707524,-0.20118994360501508,0.7355187148330913,0.9367086584381064,356905856,359749523.6,58.282873969514604,82.31363097852004,NaN,NaN,21.186263382639,27.296965031603253
2014-05-23T09:30:00-04:00,94.32,94.68,94.13,94.15,5280722,8184920.05,57.784703358831074,61.365271409543496,NaN,NaN,51.52526055217881,13.899451584913985,-0.1917197781447152,0.6970589357572123,0.8887787139019275,351625134,358563365.4,56.58089831790609,80.05300927161282,NaN,NaN,20.345180367290627,26.30385293670145
2014-05-27T09:30:00-04:00,94.42,94.6299,94.06,94.41,5062183,7879675.75,59.545266928922054,60.5749425017271,NaN,NaN,53.197060465332264,34.179669359476506,-0.16724402761867574,0.6797236793785828,0.8469677069972585,356687317,357382182.2,54.862793597638294,77.66130766767847,NaN,NaN,20.1256908294945,25.4212583499576
2014-05-28T09:30:00-04:00,94.4,94.89,94.2,94.57,7535450,7842548.15,60.63330023983882,59.609583299469826,NaN,NaN,77.25844451178105,63.03478038457568,-0.14064670977957994,0.6711593197727836,0.8118060295523636,364222767,358643218.4,56.385464403301555,75.30816427232403,NaN,NaN,20.239342278012938,24.68098462539408
2014-05-29T09:30:00-04:00,94.75,95.43,94.49,95.38,7281975,7665568.75,65.66747528825056,59.941163809887804,NaN,NaN,150.33282726153504,82.60526143924105,-0.07231186621839258,0.7214161967793729,0.7937280629977654,371504742,360189163.2,58.24510842009363,73.02502384877924,NaN,NaN,21.8310435740659,24.27385018949005
2014-05-30T09:30:00-04:00,95.12,95.42,94.85,95.31,5957964,7427687.35,64.89513419224937,60.271871885974164,NaN,NaN,148.5158124332558,96.16588104481659,-0.0373937063315285,0.7469859300833548,0.7843796364148833,365546778,361917347.6,60.28377993199976,70.87298462434414,NaN,NaN,22.921857161584185,24.080708328360643
2014-06-02T09:30:00-04:00,95.4,95.74,94.92,95.19,5075751,7245822.5,63.51598965513042,60.24988097712694,NaN,NaN,143.4488240198127,114.55059373834338,-0.02835659939397628,0.7489338871724129,0.7772904865663892,360471027,363686526.2,62.31241745802786,68.85850340102353,NaN,NaN,23.462980587400306,23.992461508223453
2014-06-03T09:30:00-04:00,94.97,95.64,94.96,95.52,5998620,7143888.1,65.67626713904588,60.25646158091967,NaN,NaN,137.833990325254,131.4779797103277,-0.007232395980591,0.7682499915906504,0.7754823875712414,366469647,365642992.2,64.47351372560271,66.99790593435334,NaN,NaN,24.531156290243608,24.069417905654905
2014-06-04T09:30:00-04:00,95.355,95.57,95.0729,95.47,3690337,6954570.75,65.0478032175908,60.203517577259554,NaN,NaN,119.03701441381676,139.83369369073483,-0.0038738284684515234,0.770640101985677,0.7745139304541285,362779310,365354300.8,63.891324785434406,65.22873166281818,NaN,NaN,25.25971953700759,24.239460995848145
2014-06-05T09:30:00-04:00,95.37,96.175,95.18,96.02,6178615,6781957.95,68.60648535525645,61.098162063318796,NaN,NaN,152.4869986547302,140.2645279693739,0.026472948508858063,0.8076051160902011,0.7811321675813431,368957925,364844937.4,62.81358292733386,63.53421459841728,NaN,NaN,26.921047310182704,24.622544755038795
2014-06-06T09:30:00-04:00,96.24,96.95,96.24,96.81,5420002,6504565.85,72.87803074981652,62.4345477072625,NaN,NaN,204.4384625952868,151.4490580017801,0.0874004862472737,0.8903827753904352,0.8029822891431615,374377927,366611167.2,65.01717828898067,62.333196043748345,NaN,NaN,29.76193035614517,25.356742698053992
2014-06-09T09:30:00-04:00,96.94,97.47,96.72,96.96,5652005,6351627.6,73.6122015307693,63.68424977041526,NaN,NaN,198.8445308431948,162.5281993664565,0.12325902194597627,0.9570560665756318,0.8337970446296555,380029932,370522948.2,69.34929361767611,61.770041170568796,NaN,NaN,32.32407231807332,26.352075500913895
2014-06-10T09:30:00-04:00,96.97,97.05,96.555,96.8,3766080,6278844.3,71.3922655620087,64.93920168300099,NaN,NaN,149.16730620106642,164.794862541619,0.12146062111148104,0.9856228210190068,0.8641621999075257,376263852,372481789.2,71.2680490626322,61.90188290270315,NaN,NaN,33.84461207324965,27.422437868390432
2014-06-11T09:30:00-04:00,96.51,97.3,96.3,97.17,5651668,6311987.55,73.390702615719,65.87062104979624,NaN,NaN,135.79903897833765,168.14726745452316,0.12970038563641972,1.0262876819530504,0.8965872963166307,381915520,376309031.2,74.61213030487032,62.74131491507228,NaN,NaN,35.74512686095755,28.611393438757162
2014-06-12T09:30:00-04:00,97.6,98.14,97.31,97.49,11869815,6656029.1,75.01624275136055,66.97584775605641,NaN,NaN,158.353504199315,169.32056856344016,0.1403134390596914,1.071979095141245,0.9316656560815535,393785335,381274513.2,78.16321178288422,64.16133904459868,NaN,NaN,37.8536785610259,29.93171988479555
2014-06-13T09:30:00-04:00,97.75,98.43,97.17,98.42,9737216,6570447.6,79.02634978275974,68.49310821490846,NaN,NaN,155.97966110518564,159.6288082654199,0.1904666424071555,1.169748959090498,0.9792823166833424,403522551,387103438,81.44433553789003,65.9372988460261,NaN,NaN,41.114551047719345,31.529267193784666
2014-06-16T09:30:00-04:00,98.77,99.23,98.59,99.01,13386921,6499243.65,81.09904612733705,70.0326638719381,NaN,NaN,174.37757158488645,154.73541641375826,0.24064161420990038,1.2800843344457178,1.0394427202358174,416909472,394479346,84.59804343308392,68.06124526284364,NaN,NaN,44.60493719140505,33.39722005058758
2014-06-17T09:30:00-04:00,98.81,98.96,98.31,98.94,10045494,6749652.95,80.0877957122122,71.42227069139334,NaN,NaN,139.86803842946324,152.8755628594376,0.24553184609133716,1.3463575278499889,1.1008256817586517,406863978,400599371.2,86.62871830837427,70.22147768463455,NaN,NaN,47.07823418484299,35.35165064119549
2014-06-18T09:30:00-04:00,98.98,99.78,98.65,99.69,14863564,7259048.8,82.59235287323375,72.63119051889214,NaN,NaN,147.91184476777207,155.29812401732448,0.2735529938526142,1.4427669240744194,1.1692139302218052,421727542,408561775.6,88.71365765197375,72.39780262976885,NaN,NaN,50.09614574547666,37.45800708466423
2014-06-19T09:30:00-04:00,99.75,100.42,99.47,100.4,8677236,7400039,84.57084981718135,74.03659877781585,NaN,NaN,157.4743017241241,155.1222835222863,0.31142704753889006,1.5584977396454178,1.2470706921065278,430404778,415885664.2,90.22366374391365,74.53636575919127,NaN,NaN,53.37667777317361,39.73210289730843
2014-06-20T09:30:00-04:00,100.45,100.99,100.12,100.93,9096156,7511388.7,85.86256873484986,75.63278299779581,NaN,NaN,159.77273798001625,155.88089889725242,0.3412943065745748,1.6736885753247464,1.3323942687501715,439500934,423081340.8,91.43598443541927,76.61662054329065,NaN,NaN,56.5501067928404,42.134674882384424
2014-06-23T09:30:00-04:00,101.24,101.52,100.98,101.29,7959180,7645311.6,86.67838826882753,77.13293450706593,NaN,NaN,156.65092375072314,152.33556933041976,0.3529504891582802,1.7735823801980217,1.4206318910397415,447460114,429191469.2,92.3082160931513,78.60481356954413,NaN,NaN,59.41050859819307,44.602651127499946
2014-06-24T09:30:00-04:00,101.2,101.275,98.94,99.16,17748459,8279625.4,63.37561670134885,77.01349261304865,NaN,NaN,89.12871519834499,142.18770468419612,0.19287085701176232,1.6617204623044444,1.468849605292682,429711655,433761004.6,92.89132471991813,80.67624213629297,NaN,NaN,53.15668218707232,45.82465556458171
2014-06-25T09:30:00-04:00,98.75,100.01,98.64,99.91,13860340,8595869.9,66.76385352578633,76.88187605380078,NaN,NaN,70.93872822508916,126.79308137565954,0.1168974622021155,1.6149714330453264,1.498073970843211,443571995,438129895.2,93.40602400035527,82.86141649865165,NaN,NaN,49.48877656532373,46.34810142183057
2014-06-26T09:30:00-04:00,99.97,100.1,99.105,100.02,8080008,8635771.55,67.24251675932695,76.47933934019439,NaN,NaN,71.61329625318814,109.62088028147234,0.056513140637046266,1.5687153966395186,1.5122022560024724,451652003,442379340.2,93.87087034414797,84.92239450259217,NaN,NaN,46.91487637881784,46.42906927282875
2014-06-27T09:30:00-04:00,99.78,100.07,99.44,100.02,8229289,8749337.8,67.24251675932695,76.02436185651993,NaN,NaN,68.45381285287189,91.35709525604348,0.0019164461890643913,1.5145978137388028,1.5126813675497384,451652003,444809554,94.12590543751487,86.69215248972351,NaN,NaN,44.949953191884894,46.21776697555106
2014-06-30T09:30:00-04:00,99.95,100.2199,99.56,100.1,6312791,8811189.8,67.63566180337918,75.75603301661782,NaN,NaN,66.78811086120025,73.38453267813891,-0.04108958163029075,1.4613193905118749,1.5024089721421656,457964794,446910490,94.34497822824981,88.3405045729819,NaN,NaN,43.507839781633336,45.8306345192771
2014-07-01T09:30:00-04:00,100.35,100.66,99.91,100.16,6894105,8855964.05,67.94637902285992,75.36715275998503,NaN,NaN,73.39153204121217,70.23709604671234,-0.07575905892123469,1.4077101484906223,1.483469207411857,464858899,453939938.8,95.0148869759181,89.7978443351996,NaN,NaN,42.43041303386995,45.34488859279036
2014-07-02T09:30:00-04:00,100.08,100.37,99.795,100.01,5926355,8967764.95,66.23436752632543,74.7398759581968,NaN,NaN,60.53101289568642,68.15555298083179,-0.11661495574053271,1.3377005127361912,1.4543154684767239,458932544,457012048.6,95.27815220113021,91.02034007936004,NaN,NaN,41.05321999398217,44.731793078674905
2014-07-03T09:30:00-04:00,100.49,100.49,99.83,100.39,3668829,8842275.65,68.40616688269394,73.98129146533496,NaN,NaN,65.07395463925478,66.84768465804511,-0.12511749595062338,1.2979185985384447,1.423036094489068,462601373,459201922.6,95.46211868083603,92.02161030385618,NaN,NaN,40.461808403270076,44.12179526790278
2014-07-07T09:30:00-04:00,100.29,100.3,99.44,99.62,6932367,8917893.9,59.98658097801207,72.47325824038317,NaN,NaN,34.890301753803726,60.13498243823149,-0.18600100712754197,1.1905348355796406,1.3765358427071825,455669006,460005323.2,95.53091154198229,92.80252945449179,NaN,NaN,37.396438165197296,43.161029967516285
2014-07-08T09:30:00-04:00,99.47,99.71,99.07,99.46,10392325,9154909.9,58.378664185070406,70.92260598844449,NaN,NaN,4.414326494869983,47.66022556496543,-0.23717157300912795,1.0800713764457726,1.3172429494549005,445276681,457467700.6,90.84626446663785,93.10378275151061,NaN,NaN,34.400224016709,41.9094862602581
2014-07-09T09:30:00-04:00,99.62,100.175,99.46,100.12,6415671,9287389.45,62.80735318840941,69.50939172524275,NaN,NaN,36.26982542318098,40.23588424135917,-0.22670076101151704,1.0338669981905042,1.2605677592020212,451692352,454834391.2,86.12640759841537,92.91897917625644,NaN,NaN,33.04548704939389,40.64320065870607
2014-07-10T09:30:00-04:00,99.21,99.53,98.65,99.16,14908658,9750238.95,53.834477475100606,67.31393655795127,NaN,NaN,-54.37193394720885,17.255294872780116,-0.2810111433116753,0.9093038300624272,1.1903149733741025,436783694,450404621.2,78.71745571071037,92.09710717388478,NaN,NaN,28.905802524613218,38.966429496692804
2014-07-11T09:30:00-04:00,99.04,99.06,98.14,98.4,10805839,9697040.15,47.98936099543769,64.60870743370754,NaN,NaN,-132.96464916348773,-22.352425887768394,-0.35967406919172795,0.7407223868844426,1.1003964560761705,425977855,443079917.6,68.26095517857112,90.44174794125276,NaN,NaN,23.38350839215767,36.74029791033064
2014-07-14T09:30:00-04:00,98.88,99.37,98.74,99.25,6870266,9553692.65,54.00440643529789,62.27485158845542,NaN,NaN,-79.88612192720217,-45.30771062396957,-0.34591084833682695,0.668007895655137,1.013918743991964,432848121,438515740.6,62.674181332117975,88.32503117260752,NaN,NaN,20.67720754871093,34.44557071581354
2014-07-15T09:30:00-04:00,98.98,99.23,98.18,98.82,9997254,9384209.3,50.80348897782172,61.376842465346336,NaN,NaN,-125.79283066501284,-71.34914205594615,-0.3558364089730037,0.5691232327757092,0.9249596417487129,422850867,434030577.8,57.67841131967852,85.80982307259042,NaN,NaN,17.42162823381358,32.01357893267069
2014-07-16T09:30:00-04:00,99.23,100.36,99.2,100.32,8177015,9290785.35,59.762899602454766,60.876774327965514,NaN,NaN,27.558710891605497,-73.09136496226122,-0.2561102103076214,0.6048218788641861,0.8609320891718075,431027882,429897683.8,53.45049631619882,82.95585680943638,NaN,NaN,17.710068638286465,29.97022031918723
2014-07-17T09:30:00-04:00,100.24,100.55,98.629,98.7,11017817,9098498,49.3169130823413,59.59637406532368,NaN,NaN,-67.80867889134824,-75.77871395108912,-0.291411609479425,0.4966675773225262,0.7880791868019512,420010065,426542958,50.231805980414904,79.83878078345546,NaN,NaN,13.907750428777335,27.67558176341439
2014-07-18T09:30:00-04:00,98.95,99.235,98.5,98.9899,8318482,9080560.3,50.96853469382025,58.43394677493034,NaN,NaN,-106.27388265038269,-70.44056064846811,-0.2869455912490706,0.429397197740613,0.7163427889896836,428328547,427013096.4,50.680038705222586,76.73550458829172,NaN,NaN,11.648729842538366,25.38603148900353
2014-07-21T09:30:00-04:00,98.74,99.21,98.59,99.14,9398231,9095664.05,51.84355687270787,57.305939279882395,NaN,NaN,-86.07150341646643,-71.67763694632096,-0.26605594462543414,0.383772858207891,0.6498288028333251,437726778,427988827.8,51.653252335394654,73.68609559594493,NaN,NaN,10.215742745811264,23.218847382833204
2014-07-22T09:30:00-04:00,99.58,100.1644,99.48,99.85,5978016,8996605.85,55.85658714012901,56.44238271683019,NaN,NaN,43.43040529271216,-37.83298975477595,-0.19962945041107694,0.400291989819479,0.5999214402305559,443704794,432159613.2,55.679175935922004,70.87640195023091,NaN,NaN,10.37350649661088,21.383798684801445
2014-07-23T09:30:00-04:00,100.1,100.5,99.67,100.49,6701314,8444248.6,59.16033231181804,55.93709448722252,NaN,NaN,95.7676706246352,-24.19119780817,-0.11215576948235062,0.45972672837761763,0.5718824978599683,450406108,436035258.4,59.08840025652474,68.29141966847338,NaN,NaN,11.60490357839425,19.986813669600416
2014-07-24T09:30:00-04:00,100.65,100.97,100.24,100.58,5747232,8038593.2,59.61802649500125,55.309370173815886,NaN,NaN,132.30587529338982,15.831713028777614,-0.050919723984788834,0.5082328428789822,0.559152566863771,456153340,443263913.4,64.56355138378635,66.08437914725555,NaN,NaN,12.716131386765287,18.94814477205254
2014-07-25T09:30:00-04:00,100.22,100.31,99.71,99.84,4803461,7874765.85,54.235899574474274,54.89860721642033,NaN,NaN,42.525746171592104,45.59163879317257,-0.06219161937845985,0.4814130426406962,0.543604662019156,451349879,447868179.8,67.54306129271441,64.08524698659356,NaN,NaN,11.986139964010984,17.953572656618032
2014-07-28T09:30:00-04:00,99.76,99.93,98.9928,99.6,7478201,7837211.45,52.57805037898403,54.484277658842736,NaN,NaN,-14.96074904604767,59.81378966725632,-0.08626861683858911,0.43576889097091964,0.5220375078095087,443871678,449097159.8,68.30900968472321,62.475443073599656,NaN,NaN,10.892715817818049,16.94487882250375
2014-07-29T09:30:00-04:00,99.42,99.9177,99.3,99.35,6832820,7863212.9,50.834904873335155,53.629102779194575,NaN,NaN,-10.26036998736541,49.0756346112408,-0.11755100121576556,0.3750987562898018,0.4926497575055674,437038858,447763972.6,66.47631593021183,61.0718650972994,NaN,NaN,9.48051913585294,15.878541724410777
2014-07-30T09:30:00-04:00,99.82,100.13,98.44,98.76,10780805,8057547.9,46.88438649893746,53.132667709468635,NaN,NaN,-61.05493260234587,17.711113965844593,-0.17313979142837155,0.2762250182201029,0.4493648096484745,426258053,442934361.6,60.17759406937877,59.747589265775716,NaN,NaN,7.0862564927937575,14.622500977036918
2014-07-31T09:30:00-04:00,98.13,98.18,96.56,96.63,17285161,8625488.2,36.00571648205315,52.276693101369744,NaN,NaN,-269.42656526019954,-62.635374144873275,-0.3389338913581944,0.025697445450731493,0.3646313368089259,408972892,433498272,50.17452350881555,58.45570128936459,NaN,NaN,0.887482337656054,12.660355457125366
2014-08-01T09:30:00-04:00,96.36,96.67,95.015,95.85,17833264,9333709.95,32.98720540843888,50.775464456594094,NaN,NaN,-313.0570690761001,-133.7519371944117,-0.4781849986555124,-0.2330999115104646,0.2450850871450478,391139628,421456221.8,40.84375814888749,56.89638534770527,NaN,NaN,-5.244744930333105,10.102483973202727
2014-08-04T09:30:00-04:00,95.83,97.695,95.5401,97.46,12896457,9631914.45,43.51363113435771,50.254760324918095,NaN,NaN,-173.79189955855819,-165.51816729691382,-0.4398856023848947,-0.30477191583607066,0.13511368654882408,404036085,413489103.2,36.06509299433757,55.3525768958952,NaN,NaN,-6.776484387584494,7.691202778804552
2014-08-05T09:30:00-04:00,97.05,97.25,94.77,95.33,16440170,9934306.7,35.55613916297317,48.52570600781227,NaN,NaN,-201.06443361729015,-203.67898002289877,-0.5299841822525342,-0.5273665412668436,0.0026176409856905614,387595915,403600514.6,31.18775620769462,53.762381173859175,NaN,NaN,-11.253829209760921,4.9847696375809125
2014-08-06T09:30:00-04:00,95.13,96.72,94.96,95.61,11548041,10190925.2,37.18241872757914,47.65895641104354,NaN,NaN,-161.24061723922125,-223.71611695027386,-0.5408284986872448,-0.6734179823733655,-0.13258948368612067,399143956,398177695.2,28.881089848542985,52.2373300215826,NaN,NaN,-13.983815489478069,2.2749717622867727
2014-08-07T09:30:00-04:00,96.1,96.27,94.49,95.01,13256982,10108341.4,35.13622541608903,46.528077176919886,NaN,NaN,-151.78250128375885,-200.18730415498572,-0.5563561878382395,-0.8280347184839201,-0.2716785306456806,385886974,393560511.6,27.04685828184938,50.54924570562738,NaN,NaN,-16.841610002253184,-0.45596848979036375
2014-08-08T09:30:00-04:00,95.3,96.7,95.07,96.6,11586395,10147369.2,43.94041628447939,45.96356713490356,NaN,NaN,-94.80806781637004,-156.5375039030397,-0.43297660510013947,-0.8128992870208549,-0.37992268192071543,397473369,394827259.8,28.390577692065506,48.88762608824673,NaN,NaN,-16.102518497348843,-2.691189919441575
2014-08-11T09:30:00-04:00,97.23,97.575,96.54,96.61,11203566,10364034.2,43.991906603111154,45.116089953688,NaN,NaN,-54.402449153081626,-132.6596138219444,-0.32884546459195196,-0.7909795126606554,-0.4621340480687034,408676935,395755429.8,29.416442308530605,47.01171654343306,NaN,NaN,-15.528186779329053,-4.525046613711215
2014-08-12T09:30:00-04:00,96.47,96.47,95.495,95.9,9998142,10364078.6,41.10512011072246,43.826431939324024,NaN,NaN,-83.03846174290453,-109.05441944706726,-0.2874368138394986,-0.8214300653680766,-0.533993251528578,398678793,397972005.4,31.924571865960317,45.07144308696417,NaN,NaN,-15.987494538582528,-6.162539174407117
2014-08-13T09:30:00-04:00,96.42,96.73,95.86,96.21,6488951,10279675.4,42.867947284934836,42.62999771003357,NaN,NaN,-63.751727554698554,-89.5566415101627,-0.22176297069112827,-0.8111969648924884,-0.5894339942013601,405167744,399176763,33.31164148342211,42.83916380836673,NaN,NaN,-15.806687735094052,-7.540274683076679
2014-08-14T09:30:00-04:00,96.35,96.5,95.515,95.66,7617630,10109666.05,40.548963900651955,41.65235944761769,NaN,NaN,-71.24397371336023,-73.44893599608301,-0.19870065463755737,-0.8378098124983069,-0.6391091578607495,397550114,401509391,36.02944760031834,40.588191401767006,NaN,NaN,-16.35827745683605,-8.799989365042304
2014-08-15T09:30:00-04:00,95.85,96.51,95.6,96.37,11075331,10247508.5,44.70724212149926,41.09015885779735,NaN,NaN,-55.73494964035353,-65.6343123608797,-0.12269224756556285,-0.7924744673177031,-0.6697822197521403,408625445,403739806.2,38.605887890428185,38.46653984503165,NaN,NaN,-15.555691279968563,-9.765089638603198
2014-08-18T09:30:00-04:00,96.72,96.92,96.22,96.63,8597847,10207489.3,46.1914844386412,40.75848596960492,NaN,NaN,-35.400687657684614,-61.833960061800305,-0.045921050943760644,-0.7271835334318411,-0.6812624824880804,417223292,405449077.6,40.58092764444882,36.61686925319144,NaN,NaN,-14.461163580819104,-10.435957344634042
2014-08-19T09:30:00-04:00,96.83,97.55,96.76,97.37,5998042,10208490.6,50.28213240064803,41.00118210544139,NaN,NaN,-4.851433065421386,-46.19655432630366,0.058040916401319365,-0.6087113369864312,-0.6667522533877506,423221334,410357585.8,45.95752514857718,35.60115004456274,NaN,NaN,-12.295272406304838,-10.701573782015585
2014-08-20T09:30:00-04:00,97.25,97.71,96.85,97.58,5947976,10170823.7,51.41102110034609,42.10156100674802,NaN,NaN,9.62554745816117,-31.52109932373171,0.13964002513343554,-0.4922022219709561,-0.6318422471043916,429169310,415157899,50.659595285963,35.63579802864471,NaN,NaN,-10.18656505254927,-10.628001106377539
2014-08-21T09:30:00-04:00,97.71,97.76,97.22,97.66,5567212,10161822.7,51.859461726017166,43.44957931514647,NaN,NaN,30.544988078516848,-11.163306965356295,0.1943304030518027,-0.3889292432896383,-0.583259646341441,434736522,422595180.6,56.91442010967866,36.783702454415504,NaN,NaN,-8.324559166715797,-10.298937972140147
2014-08-22T09:30:00-04:00,97.52,97.52,96.61,97.01,7383394,10290819.35,47.98442745621854,43.7689219095651,NaN,NaN,10.833023286873527,2.1502876200891166,0.18225813693835158,-0.3554369751685016,-0.5376951121068532,427353128,426340717.2,59.68615189205379,38.47092094710952,NaN,NaN,-7.7481378384079145,-9.934537953035543
2014-08-25T09:30:00-04:00,97.28,97.94,97.25,97.87,4380363,10135927.45,52.98951890134666,45.014163319448926,NaN,NaN,69.9765543017698,23.225736011980004,0.22492245629480878,-0.25654204173834216,-0.48146449803315094,431733491,429242757,61.73986493157227,40.653214427386494,NaN,NaN,-5.782824018972927,-9.341435962455169
2014-08-26T09:30:00-04:00,98.15,98.87,97.96,98.37,5597183,10074145.6,55.66081816809505,46.33404899377149,NaN,NaN,140.36422652314982,52.26886792969425,0.27617107013043335,-0.13625066037010924,-0.4124217305005426,437330674,432064625,63.67753077462975,43.138674493535554,NaN,NaN,-3.3287067673287556,-8.482474648865681
2014-08-27T09:30:00-04:00,98.46,98.57,97.91,98.17,3860063,9728108.5,54.33091642735552,47.705098351719094,NaN,NaN,136.3437256213685,77.6125035623357,0.2848118020137368,-0.056406977983371576,-0.34121877999710837,433470611,432924885.2,64.27158212761304,45.79758333966153,NaN,NaN,-1.6519761394987085,-7.506689147527542
2014-08-28T09:30:00-04:00,97.87,98.289,97.71,98.19,3104519,9019076.4,54.448125412642916,48.455649003730784,NaN,NaN,111.20392707545501,93.74429136172334,0.2796845198293014,0.008386869789518414,-0.271297650039783,436575130,433292606.8,64.5385622686226,48.37958223798704,NaN,NaN,-0.23434459137279523,-6.467782782362578
2014-08-29T09:30:00-04:00,98.41,98.79,98.055,98.74,5367707,8395798.55,57.66583596500621,49.43235824386614,NaN,NaN,134.11184805664033,118.4000563156767,0.2993823979908246,0.10293034744874774,-0.19645205054207687,441942837,436210548.6,66.66709579348284,51.040343201197906,NaN,NaN,1.8995294194433714,-5.272452467818871
2014-09-02T09:30:00-04:00,98.6,98.69,97.07,97.49,8648420,8183396.7,49.165548448563186,50.00810312514047,NaN,NaN,63.98646941036861,117.20203933739647,0.21805346247582436,0.07611477755270357,-0.14193868492312078,433294417,436522733.8,66.89603728496843,53.53830501684134,NaN,NaN,1.4048911782307578,-4.318546232668925
2014-09-03T09:30:00-04:00,98.14,98.44,97.69,97.75,7190860,7720931.2,50.79039705634644,50.57399239452702,NaN,NaN,73.25747410301133,103.78068885336877,0.17353395896841609,0.07497876378739932,-0.09855519518101677,440485277,437153654.4,67.3836043936279,55.97201665328462,NaN,NaN,1.4606151304844672,-3.49295175221844
2014-09-04T09:30:00-04:00,97.98,98.02,95.975,96.43,12292306,7758144.45,43.234730507379325,50.76583286643612,NaN,NaN,-23.69323231895696,71.77329726530368,0.05319225243830161,-0.03206487963313975,-0.08525713207144137,428192971,436098126.4,65.6417404171277,58.08718042591386,NaN,NaN,-0.8606610359736785,-3.1169102213263313
2014-09-05T09:30:00-04:00,96.48,97.11,95.82,97.08,8775410,7534065.85,47.38543015471584,50.95713201166587,NaN,NaN,-45.464267447807856,40.439658360651094,0.017234730903084833,-0.06371371844258533,-0.08094844934567016,436968381,436176776.6,65.71286274811948,60.02339291574895,NaN,NaN,-1.5314810861285135,-2.8904203448695003
2014-09-08T09:30:00-04:00,96.6,96.68,95.1301,95.57,10978153,7503653.75,40.05765122023712,50.51900106749415,NaN,NaN,-122.62867609462161,-10.908446469601282,-0.10183290085890284,-0.20823957541929872,-0.10640667456039588,425990228,432986254.8,60.263154473708546,61.42926626069607,NaN,NaN,-4.623862141502558,-3.1380548872456515
2014-09-09T09:30:00-04:00,95.52,96.11,94.59,95.15,10003697,7443660.3,38.28425898125903,49.66201010896636,NaN,NaN,-145.48758939610588,-52.803258230896176,-0.19695726625275886,-0.35260325737634446,-0.1556459911235856,415986531,429524677.6,54.939559245712836,62.070840124777185,NaN,NaN,-7.689165426157856,-3.7882135356616806
2014-09-10T09:30:00-04:00,95.06,95.06,93.81,94.92,10433270,7465416.7,37.31014563005041,48.654804718230956,NaN,NaN,-179.94115632704066,-103.44298431690659,-0.25951361815019075,-0.48003801381132405,-0.2205243956611333,405553261,422538274.4,46.08995656577781,61.74443735904968,NaN,NaN,-10.450879995125796,-4.74002302987084
2014-09-11T09:30:00-04:00,94.16,95.12,93.76,94.98,12505767,7766257.5,37.75508539758893,47.64734926620037,NaN,NaN,-156.0865671501124,-129.9216512831377,-0.27927905626232535,-0.56962321598904,-0.2903441597267146,418059028,420511485.8,43.88164187975834,60.813524628341085,NaN,NaN,-12.539716272560236,-5.854264921683611
2014-09-12T09:30:00-04:00,94.7,94.79,93.27,93.56,15440306,8157391.3,31.97159472892767,46.5035754999653,NaN,NaN,-179.69692765127232,-156.76818332383056,-0.3650014506734806,-0.7465959730685654,-0.3815945223950848,402618722,413641554,37.34933996065889,59.21803806181287,NaN,NaN,-16.32903798447021,-7.350661073510268
2014-09-15T09:30:00-04:00,93.46,94.47,92.99,94.22,13391313,8273190.4,36.81622280538941,45.348340064539784,NaN,NaN,-152.52194849736168,-162.74683780437857,-0.3539980250506733,-0.8240920537084264,-0.4700940286577531,416010035,411645515.4,35.68709227274218,57.35712572903929,NaN,NaN,-17.982448745717907,-8.869487883825645
2014-09-16T09:30:00-04:00,94.09,95.96,93.95,95.36,13455648,8516080.45,44.20708046670403,44.530215943011854,NaN,NaN,-77.34718930480877,-149.11875778611915,-0.2515062353365707,-0.7844768228284664,-0.5329705874918957,429465683,414341345.8,39.59711094810034,55.63709574143005,NaN,NaN,-16.999767745832266,-10.030956435540876
2014-09-17T09:30:00-04:00,95.59,95.77,94.5601,94.84,11069342,8769645.45,41.80493145260971,43.63550273053001,NaN,NaN,-69.86144941050368,-127.10281640281175,-0.20240818876314393,-0.7859808234458256,-0.5835726346826817,418396341,416909961.8,43.14400526874794,54.127983108653964,NaN,NaN,-16.95998539137303,-11.02081771494547
2014-09-18T09:30:00-04:00,95.15,95.2,94.1,94.35,12284681,9086480.7,39.62018029583422,42.5763637936151,NaN,NaN,-83.24810432092114,-112.5351238369735,-0.18697424759398018,-0.817290444175157,-0.6303161965811768,406111660,414520488.2,40.746974328622834,52.42858397008256,NaN,NaN,-17.607624725052716,-11.96179014496079
2014-09-19T09:30:00-04:00,94.06,94.4899,93.75,93.79,9474841,9281862.15,37.225789626942124,41.11636048375339,NaN,NaN,-95.9437062766891,-95.78447956205687,-0.197490472545519,-0.8771792872630755,-0.6796888147175565,396636819,413324107.6,39.561803191343586,50.49249164135832,NaN,NaN,-18.887015616026005,-12.951108069398678
2014-09-22T09:30:00-04:00,93.64,93.69,92.05,92.41,10630668,9444225.85,32.0806469293247,39.89601037523635,NaN,NaN,-133.58007194586247,-91.99610425175703,-0.27560084458941225,-1.0241898704543217,-0.7485890258649095,386006151,407323330.8,34.19013358155334,48.156355662542964,NaN,NaN,-21.728048427567405,-14.20495669199421
2014-09-23T09:30:00-04:00,92.27,93.06,92.115,92.14,9140463,9682230.85,31.172828333689225,38.49475546647512,NaN,NaN,-130.47708267420245,-102.62208292563575,-0.32051748682999326,-1.149235884402401,-0.8287183975724078,376865688,396803331.8,27.213952490133366,45.28709481229335,NaN,NaN,-24.28692714771572,-15.645238185668711
2014-09-24T09:30:00-04:00,92.08,92.75,90.76,92.22,24743541,10639548.75,31.7887463313847,37.677185168189794,NaN,NaN,-139.324447105306,-116.51468246459622,-0.3192076311690992,-1.2277279365337819,-0.9085203053646826,401609229,393445909.4,25.430556520114038,42.41486739107808,NaN,NaN,-26.154743571983563,-17.146596097999403
2014-09-25T09:30:00-04:00,92.17,92.21,90.76,90.81,13436425,11118366.85,27.173250410933022,36.23345804363388,NaN,NaN,-152.24968470512283,-130.31499854143652,-0.38335334730563164,-1.3877119894967223,-1.0043586421910906,388172804,389858138.2,23.6471956152741,39.41017688158913,NaN,NaN,-29.341652612633183,-18.88874702866137
2014-09-26T09:30:00-04:00,90.82,92.37,90.5,91.981,11484758,11537378.8,35.543427465445944,35.911013489720226,NaN,NaN,-125.81652673793961,-136.28956263368664,-0.31957559318768936,-1.4038281336757024,-1.084252540488013,399657562,390462286.8,24.60598663369862,36.86323632158843,NaN,NaN,-29.36077908070936,-20.38475160752537
2014-09-29T09:30:00-04:00,90.81,91.94,90.59,91.77,15454328,12041709.85,34.76801311488977,35.65985307069385,NaN,NaN,-121.1056667002824,-133.79468158457064,-0.2664288554379337,-1.4172886097854303,-1.1508597543474965,384203234,390101703.4,24.408973526829072,34.682480198811014,NaN,NaN,-29.61627124548418,-21.703540127233772
2014-09-30T09:30:00-04:00,91.68,91.9,90.06,90.62,21741488,12696363.25,30.821380625449464,35.1963698560795,NaN,NaN,-130.0582454920841,-133.71091414814697,-0.2820490136746432,-1.5034210214408006,-1.2213720077661574,362461746,387220915,22.835853371736434,33.02147282780806,NaN,NaN,-31.10962450984922,-23.047266467607407
2014-10-01T09:30:00-04:00,90.61,91.06,88.49,88.77,18978821,13285761.3,25.75627565863303,34.33931201758264,NaN,NaN,-162.09612980946207,-138.26525068897817,-0.383981613491192,-1.7013490246301473,-1.3173674111389553,343482925,375595654.2,17.839338776573214,31.161308320437694,NaN,NaN,-34.23438372125459,-24.645426075271292
2014-10-02T09:30:00-04:00,88.25,88.89,86.7801,88.31,29246461,14133469.05,24.67063170549315,33.81781465876589,NaN,NaN,-183.74277854872733,-144.5638694576991,-0.4450879797469196,-1.8737273858226047,-1.428639406075685,314236464,360808386.2,13.725494577659418,29.47389079308059,NaN,NaN,-37.067674967672545,-26.420033059900042
2014-10-03T09:30:00-04:00,88.75,88.8,87.42,88.17,20098867,14699641.9,24.33444488469877,32.92625909300227,NaN,NaN,-157.33490727434565,-150.8675455649803,-0.4559658590901481,-1.9985967299383702,-1.5426308708482221,294137597,339704393.2,10.13377929892225,27.648654152093453,NaN,NaN,-39.39872569478302,-28.274132007740466
2014-10-06T09:30:00-04:00,88.62,89.17,87.62,88.27,20125051,15156986.8,25.119367006048464,31.56285098866973,NaN,NaN,-132.0487374304468,-153.05615971101318,-0.418435781772603,-2.065675598063976,-1.6472398162913728,314262648,325716276,8.538815466968401,25.430204474869736,NaN,NaN,-41.033345891397,-30.096876848262827
2014-10-07T09:30:00-04:00,87.8,88.93,87.09,87.12,17899289,15551766.4,22.259614152238683,30.166756895786087,NaN,NaN,-134.94631099198793,-154.03377281099395,-0.43135030369109173,-2.1864276959052376,-1.7550773922141458,296363359,312496598.6,7.359865081403967,22.874194461488024,NaN,NaN,-43.37246737965232,-31.99338978131847
2014-10-08T09:30:00-04:00,86.87,88.05,85.47,87.97,35989957,16829600.75,28.719110951177328,29.388109085453458,NaN,NaN,-133.97036149483657,-148.40861914806885,-0.34658706032660236,-2.188311217622399,-1.8417241572957965,332353316,310270676.8,7.180101297496023,20.4765606735504,NaN,NaN,-43.35175267882112,-33.61601305239028
2014-10-09T09:30:00-04:00,87.3,87.45,84.5,84.74,36670419,18037833.35,21.4316544698312,28.259956574231246,NaN,NaN,-155.21487792166354,-142.7030390226561,-0.46463084165554025,-2.422512709365222,-1.9578818677096816,295682897,306559963.4,6.878483315910017,18.14203782530514,NaN,NaN,-46.02198945092116,-35.388295395037545
2014-10-10T09:30:00-04:00,84.49,85.41,82.64,83.55,60474277,20289531.9,19.471322776269943,27.359290563298764,NaN,NaN,-167.56147772548528,-144.748353112884,-0.572355065100651,-2.6733256990854954,-2.1009706339848444,235208620,294774168,6.014313855702952,16.129479273458685,NaN,NaN,-48.88656561704429,-37.31661971246708
2014-10-13T09:30:00-04:00,83.37,84.39,80.86,80.97,47549252,21997428.85,16.044722141096685,26.27871154954215,NaN,NaN,-175.99499696039754,-153.53760501887416,-0.7553661475260576,-3.0451783183924164,-2.289812170866359,187659368,269453512,4.659822255304519,14.518469970970907,NaN,NaN,-52.72813174474011,-39.51826428850608
2014-10-14T09:30:00-04:00,81.65,82.29,79.515,79.95,55995552,24124424.05,14.926348886348748,25.07425458918244,NaN,NaN,-179.0344119204965,-162.35522520457587,-0.8746946434586533,-3.3831804751896755,-2.508485831731022,131663816,236513603.4,3.5421992454184874,12.955015879921223,NaN,NaN,-56.11155412360943,-41.88873426494942
2014-10-15T09:30:00-04:00,78.91,80.77,77.51,80.56,69469609,27044437.4,18.581392706338832,24.460550467425715,NaN,NaN,-172.51900991676547,-170.06495488896167,-0.8418363329287102,-3.56078124789191,-2.7189449149632,201133425,210269625.2,2.9376658004598113,11.475763750291634,NaN,NaN,-57.41372963873137,-44.10659074691827
2014-10-16T09:30:00-04:00,78.83,82.82,78.5,82,59798230,29420114.85,26.5985348799812,23.821629568463948,NaN,NaN,-127.59672838705322,-164.5413249820396,-0.6604253911328235,-3.5444766538792294,-2.884051262746406,260931655,203319376.8,2.801312921408183,9.918287056556602,NaN,NaN,-55.63623076756189,-45.75368217843879
2014-10-17T09:30:00-04:00,83.51,85.9,82,82.7,37999980,30846371.8,30.19678676978029,23.495113400956125,NaN,NaN,-72.13778234889634,-145.4565859067218,-0.44113422750681774,-3.435469047129928,-2.99433481962311,298931635,216063979.8,10.962366034584036,8.957815092824813,NaN,NaN,-53.00321875315568,-46.7893302605412
2014-10-20T09:30:00-04:00,82.63,83.665,82.22,83.42,26502575,31639967.15,33.79193552841774,23.707295894025293,NaN,NaN,-70.7838411273863,-124.41435474011955,-0.20731429244516075,-3.2534776851795613,-3.0461633927344005,325434210,243618948.2,25.52260696002685,9.149726063416983,NaN,NaN,-49.696814105247526,-47.204685095499244
2014-10-21T09:30:00-04:00,84.37,86.15,84.34,85.96,31358161,32750852.05,44.62687287424378,25.055195695140345,NaN,NaN,-20.759918701770882,-92.75945609637442,0.1399754270742286,-2.871194108891615,-3.0111695359658435,356792371,288644659.2,42.16545414835985,10.887305732830315,NaN,NaN,-42.85657851597852,-46.58352701271057
2014-10-22T09:30:00-04:00,86.18,86.71,84.28,84.33,36142523,33320801.15,40.09250008503901,26.156757722250763,NaN,NaN,-22.799493824270677,-62.81555287787546,0.2737416178183554,-2.668992513692899,-2.9427341315112545,320649848,312547943.8,48.717193743147924,13.386712816079495,NaN,NaN,-38.782273494391816,-45.46906222437932
2014-10-23T09:30:00-04:00,85.52,86.81,85.07,85.9,26558031,33976881.45,45.80441115712161,27.690326741709537,NaN,NaN,-0.14828699421699404,-37.325864599308204,0.47025576430464433,-2.354914426130449,-2.8251701904350934,347207879,329803188.6,52.868008172158106,16.439157735596346,NaN,NaN,-33.40140423697903,-43.745111083322136
2014-10-24T09:30:00-04:00,85.94,86.09,84.47,85.6,25255115,34665399.3,44.92300649933899,29.10487241980172,NaN,NaN,-5.930263165338901,-24.084360762596752,0.5753866781883219,-2.105936842699691,-2.681323520888013,321952764,334407414.4,53.93931072697582,19.682050254168303,NaN,NaN,-29.538153204886893,-41.7155456721171
2014-10-27T09:30:00-04:00,84.24,84.29,82.94,83.8,23501413,35067753.55,39.95507172523092,30.36883367501545,NaN,NaN,-42.47389657260446,-18.422371851640385,0.5206912976828666,-2.03045939878443,-2.5511506964672965,298451351,329010842.6,52.43491212794967,22.901696471778713,NaN,NaN,-27.9012820117751,-39.74207943492539
2014-10-28T09:30:00-04:00,84.24,85.94,83.68,85.71,23624954,35161926.85,46.6917670125954,31.652594822259598,NaN,NaN,4.956388385337004,-13.279110434218808,0.6042638864011853,-1.795820838465815,-2.4000847248670003,322076305,322067629.4,50.483996530664015,25.994831845576424,NaN,NaN,-24.184508783958382,-37.5195693419301
2014-10-29T09:30:00-04:00,86.65,87.37,85.17,85.99,26722489,35549110.25,47.61955575458996,33.523159199742366,NaN,NaN,44.86036236442336,0.2528608035200065,0.6647191146855791,-1.5691858315100262,-2.2339049461956053,348798794,327697418.6,52.04209345162676,29.22080399812762,NaN,NaN,-20.993919248175498,-35.15876218567944
2014-10-30T09:30:00-04:00,85.33,86.06,84.69,85.68,18795990,35026586.7,46.6514816600307,35.46459912001099,NaN,NaN,27.72420171668937,5.82735854570128,0.6683482153698583,-1.3984696769832823,-2.0668178923531406,330002804,324256403.6,50.98605576545282,32.43307127739547,NaN,NaN,-18.742118842307608,-32.81352742234061
2014-10-31T09:30:00-04:00,85.86,87.52,85.06,87.42,20268471,35035066.9,52.48973515930361,38.0678143355972,NaN,NaN,72.62423714036575,21.53825860684221,0.7654724667751662,-1.109977308884183,-1.8754497756593491,350271275,329920105.8,52.68780772082483,35.86364166778978,NaN,NaN,-14.91458693106344,-30.256535923586732
2014-11-03T09:30:00-05:00,87.48,88.41,85.78,86.04,26610977,35359363.2,48.00287667770528,40.430423463551236,NaN,NaN,80.82813045099593,46.198664011562286,0.7152504758994278,-0.9813866807850644,-1.6966371566844922,323660298,334961895.2,54.211855644669335,39.482902839164844,NaN,NaN,-13.090851421510916,-27.804295280433045
2014-11-04T09:30:00-05:00,85,85.05,83.53,84.27,23439130,35636355.25,42.93361916689421,42.16986821073376,NaN,NaN,-1.8983384679200115,44.82771864091088,0.5487883452788567,-1.0106517250859213,-1.559440070364778,300221168,330590867.8,52.62902522159683,43.03228565496034,NaN,NaN,-13.17857133511893,-25.71490614538817
2014-11-05T09:30:00-05:00,85.12,86.12,84.46,85.75,27445052,35209110,47.88902700795228,43.690617648445986,NaN,NaN,48.627753632016976,45.5811968944296,0.5243519747247594,-0.9040001019588289,-1.4283520766835882,327666220,326364353,51.076131754061066,46.48048700014983,NaN,NaN,-11.633403453227146,-23.70326290365088
2014-11-06T09:30:00-05:00,85.21,86.85,84.93,86.83,23026298,34526903.95,51.21796503320534,45.19213038154777,NaN,NaN,76.99742697542891,55.43584194617752,0.5634934242647833,-0.723985296352609,-1.2874787206173923,350692518,330502295.8,52.552242033983795,49.45119242867838,NaN,NaN,-9.289516549464448,-21.644156281624248
2014-11-07T09:30:00-05:00,87.03,88.48,86.86,87.79,18042038,32405292,54.0291609856521,46.63764648563595,NaN,NaN,121.40858442012615,65.19271140212959,0.6314899251146633,-0.4981163142240632,-1.1296062393387265,368734556,334194952,53.88926580781044,51.47738234637721,NaN,NaN,-6.4697049603051155,-19.4763775214358
2014-11-10T09:30:00-05:00,88.55,88.96,86.74,87,22953375,31175498.15,51.40392684136886,47.12172176900202,NaN,NaN,108.6405492989372,70.75519517171784,0.6008875192193492,-0.3784968403145399,-0.9793843595338891,345781181,338619128.6,55.50695047660151,52.43034636982304,NaN,NaN,-4.953858723002283,-17.40173197880244
2014-11-11T09:30:00-05:00,87.08,87.47,86.225,87.26,17380928,29244766.95,52.22665509285959,47.98844712670349,NaN,NaN,84.90878938640077,88.116620742582,0.5757284602447333,-0.2597237842279725,-0.8354522444727058,363162109,351207316.8,59.82567836104681,53.22380955681582,NaN,NaN,-3.486423772684514,-15.413830806499881
2014-11-12T09:30:00-05:00,86.71,87.61,86.3875,86.49,17624629,26652517.95,49.55111931204202,48.256069137769224,NaN,NaN,77.3124173644764,93.85355348907387,0.4882556697586783,-0.22513265727435794,-0.7133883270330362,345537480,354781568.8,60.98369922296106,53.80350177473032,NaN,NaN,-3.02085312775616,-13.643405423822207
2014-11-13T09:30:00-05:00,86.03,86.14,83.95,85.34,31588333,25242023.1,45.77907036859743,48.31721655700198,NaN,NaN,-31.781187494790167,72.09783059503006,0.34094776211199396,-0.2872036243930438,-0.6281513865050378,313949147,347432894.6,57.32504993383869,54.045340289506235,NaN,NaN,-3.7285806845617246,-12.227001889642139
2014-11-14T09:30:00-05:00,85.76,86.3099,85.18,86.21,17962320,24240140.1,48.945459714706665,48.959387127678816,NaN,NaN,11.102340351141713,50.03658178123318,0.2919930781566671,-0.2631600388092039,-0.555153116965871,331911467,340068276.8,53.83902789112901,54.14563427259048,NaN,NaN,-3.41415368436609,-10.968023574602704
2014-11-17T09:30:00-05:00,85.68,86.27,85.36,85.76,12215069,23525764.8,47.403456390872094,49.010222083270016,NaN,NaN,-7.091624052791906,26.89014711088735,0.2223457472906734,-0.27722093285252924,-0.49956668014320266,319696398,334851320.2,51.45209376556362,54.21478407508331,NaN,NaN,-3.5911756435160083,-9.914188155876033
2014-11-18T09:30:00-05:00,85.73,86.54,85.42,85.83,19680322,22941872.85,47.67958682297843,49.01451001672633,NaN,NaN,2.3320488034832203,10.374798994303841,0.17605810864621307,-0.27949404433543634,-0.4555521529816494,339376720,330094242.4,49.30551685657671,54.019314318294015,NaN,NaN,-3.662688053866725,-9.021116712731846
2014-11-19T09:30:00-05:00,85.99,86.58,85.23,86.28,14746194,21872056.4,49.51453003296758,49.2190134719361,NaN,NaN,7.310317204669365,-3.625621037657555,0.17068778724641043,-0.2421924189236364,-0.41288020617004684,354122914,331811329.2,50.11452737990928,53.95706229075519,NaN,NaN,-3.237499584990801,-8.194885694483125
2014-11-20T09:30:00-05:00,86.45,87.49,86.22,87.36,16917292,21390019.45,53.71047791154718,49.30620938281065,NaN,NaN,86.08423805562376,19.94746407242523,0.23106126492861218,-0.12405362500928163,-0.3551148899378938,371040206,343229541,55.23090208511241,54.1387118882043,NaN,NaN,-1.706447995228713,-7.267966023161065
2014-11-21T09:30:00-05:00,88.87,89.215,87.86,88.5,28685220,21561524.7,57.70629157424604,49.99931044684927,NaN,NaN,178.69618677591595,53.46623335738008,0.33277922921122305,0.060859146576135004,-0.27192008263508805,399725426,356792332.8,60.42325294420955,54.58238312388575,NaN,NaN,0.7903650347774359,-6.116775872026994
2014-11-24T09:30:00-05:00,88.21,88.69,87.4447,87.82,16678075,21220357.8,54.674521471506935,50.83794632575018,NaN,NaN,124.01818460663948,79.68819508926636,0.3381722736246703,0.15079525939574978,-0.18737701422892047,383047351,369462523.4,64.55862839246237,55.434497636090434,NaN,NaN,2.077730238731272,-4.946132141918671
2014-11-25T09:30:00-05:00,88.3,88.3657,86.27,86.39,22554039,21166812.05,48.86090455369925,50.907366150446386,NaN,NaN,43.00052022889797,87.8218893743493,0.23427400120814823,0.10546548728126481,-0.12880851392688342,360493312,373685841.8,65.83992314833705,56.489054164253,NaN,NaN,1.5169164727111824,-4.022839482685835
2014-11-26T09:30:00-05:00,85.99,86.21,85.15,85.3,20873228,20874349,44.938477141747065,50.45883130105652,NaN,NaN,-68.4151108368054,72.67680376605435,0.08848461571156951,-0.018202744287421524,-0.10668735999899104,339620084,370785275.8,64.12525052777532,57.31569762809524,NaN,NaN,-0.15332744756257677,-3.4700520490967977
2014-11-28T09:30:00-05:00,81.74,82,79.575,79.82,42538338,22061466.4,31.32381634638878,48.837020969680566,NaN,NaN,-341.9389303462557,-12.92782991432154,-0.3562800059019498,-0.5520373673764283,-0.19575736147447848,297081746,355993583.8,56.101358720556355,57.47370426471996,NaN,NaN,-7.19808959678714,-4.00262884162399
2014-12-01T09:30:00-05:00,79.39,80.35,78.67,80.1,51594498,23627767.75,32.449915232696284,47.483162997632526,NaN,NaN,-282.0797894498737,-105.08302515947949,-0.5967194392058209,-0.9416566604817547,-0.34493722127593374,348676244,345783747.4,51.32727723531857,57.17515617605689,NaN,NaN,-12.083386050206592,-5.157022728564361
2014-12-02T09:30:00-05:00,79.53,81.75,79.5,80.97,33234913,23958964.55,35.96344962397288,46.321505464140614,NaN,NaN,-183.25933819645397,-166.53852972009815,-0.657475104554482,-1.1667811019690362,-0.5093059974145542,381911157,345556508.6,51.22279844471751,56.56066475346194,NaN,NaN,-14.796841783126668,-6.534139736358976
2014-12-03T09:30:00-05:00,81.49,82.61,81.21,81.96,31549216,24364468.85,39.80061893155103,45.6250411512484,NaN,NaN,-121.82510512435613,-199.50365479074898,-0.5932669144153833,-1.2508896404337833,-0.6576227260184,413460373,356149920.8,55.74528728055848,56.186492471861754,NaN,NaN,-15.745061391212934,-7.849985687052399
2014-12-04T09:30:00-05:00,81.17,81.77,80.52,81.25,23579548,24171193.65,38.04013168765034,45.07225981689504,NaN,NaN,-121.57671642295392,-210.13597590797866,-0.5612375532213626,-1.3591696675451033,-0.7979321143237407,389880825,366202069,59.5754200894832,56.34723319726493,NaN,NaN,-17.073071687712556,-9.167569401432422
2014-12-05T09:30:00-05:00,81.07,81.31,79.96,80.28,23443298,24192043.65,35.715782889265526,44.1272829007921,NaN,NaN,-117.48346474147925,-165.2448827870234,-0.5663697093245121,-1.505894250979381,-0.9395245416548688,366437527,380073225.2,64.18214561071099,57.086027320092214,NaN,NaN,-18.906819223532125,-10.558890804589522
2014-12-08T09:30:00-05:00,79.2,79.5,76.86,77.03,41192683,25349575.9,29.263883849923204,42.83159914786717,NaN,NaN,-154.19534128951258,-139.66799315495118,-0.7387383507997982,-1.8629474801546166,-1.1242091293548184,325244844,375386945.2,61.62698616776826,57.81280534882112,NaN,NaN,-22.857690086994275,-12.315862130647343
2014-12-09T09:30:00-05:00,76.86,78.19,76.6,77.87,33668861,25885350.2,32.65032476656833,41.75808042955217,NaN,NaN,-134.72441666916754,-129.96100884949388,-0.7441937532382941,-2.054451320902686,-1.310257567664392,358913705,370787454.8,59.13847242895708,58.51515931827686,NaN,NaN,-24.884576916820116,-14.11139281438631
2014-12-10T09:30:00-05:00,76.65,76.74,74.97,75.47,44533835,27242995.55,28.458265971272965,40.254061568002555,NaN,NaN,-146.82885341588974,-134.9617585078006,-0.8498182525555549,-2.3725303833588356,-1.5227121308032807,314379870,350971354.2,49.806955029244065,58.49318986465791,NaN,NaN,-28.096796167041543,-16.109307579051343
2014-12-11T09:30:00-05:00,75.37,77.34,75.25,75.42,35551690,28139348.6,28.37652448907862,38.44449346639766,NaN,NaN,-124.12959164751298,-135.47233355271243,-0.8607813727384757,-2.5986888467263753,-1.7379074739878997,278828180,328760825.2,41.83835303788621,57.53657921842746,NaN,NaN,-30.592291442714963,-18.17830527386043
2014-12-12T09:30:00-05:00,74.52,75.38,73.89,74.02,50054263,29062645.1,26.11468596476304,36.18795020857745,NaN,NaN,-133.8646130572434,-138.74856321586526,-0.8960298207871715,-2.857944749971864,-1.9619149291846925,228773917,301228103.2,34.47505971196702,55.68313684469585,NaN,NaN,-33.42117794742287,-20.355858512940777
2014-12-15T09:30:00-05:00,74.63,75.33,73.2,73.36,47481113,30538584.75,25.099000124214044,34.07541296948509,NaN,NaN,-127.1074681232629,-133.3309885826153,-0.895384755530308,-3.0811458735975776,-2.1857611180672696,181292804,272437695.2,28.772624581164834,53.126993715317454,NaN,NaN,-36.038241270494886,-22.596198906877078
2014-12-16T09:30:00-05:00,72.69,76.29,72.51,74.01,57284422,32792052.4,28.06629774147474,32.59008391146906,NaN,NaN,-111.02543674602195,-128.5911925979862,-0.7866342443163883,-3.169053923462755,-2.3824196791463668,238577226,248370399.4,25.04344306339935,50.21295942353619,NaN,NaN,-37.30596648562007,-24.697594275268933
2014-12-17T09:30:00-05:00,74.43,77.83,74.29,77.08,62470246,34931548.6,40.13027380328242,32.24664081586444,NaN,NaN,-70.3000584483516,-113.28543360447858,-0.45959457042536034,-2.9569128921780674,-2.497318321752707,301047472,245703919.8,24.662062037225297,47.39416024563976,NaN,NaN,-34.499350897880994,-26.09784522135637
2014-12-18T09:30:00-05:00,79.06,79.35,76.57,78.56,52263460,36807411.9,44.92557660431417,33.218195120001965,NaN,NaN,-36.17352372334193,-95.69422001964436,-0.11330201492261915,-2.638945840405981,-2.5256438254833617,353310932,260600470.2,30.98529003288415,45.600155339377466,NaN,NaN,-30.566862761798202,-26.736276298562345
2014-12-19T09:30:00-05:00,78.96,80.67,78.09,80.57,46742769,38298685.75,50.70078658655468,34.521828788134705,NaN,NaN,-2.0543794272560274,-69.33217329364689,0.26098624583727714,-2.1994110181867654,-2.4603972640240426,400053701,294856427,42.86175256451073,44.99547500574833,NaN,NaN,-25.252717726291007,-26.52433935966644
2014-12-22T09:30:00-05:00,79.97,80.17,78.92,79.75,33238091,38526329.3,48.4678614800909,35.415001063571715,NaN,NaN,3.7977691034261984,-43.15112584830908,0.4520020341240327,-1.8953947213690014,-2.347396755493034,366815610,331960988.2,52.41390755875684,45.080554228179714,NaN,NaN,-21.689484848148062,-25.833645858020954
2014-12-23T09:30:00-05:00,80.33,80.99,79.7639,80.72,26529229,39018887,51.205480864703496,36.22963405879689,NaN,NaN,34.886876369900854,-13.968663225124505,0.6313362381490473,-1.5582264578067253,-2.1895626959557726,393344839,362914510.8,58.627635708020534,45.28643625871272,NaN,NaN,-17.893055901811696,-24.699275864276775
2014-12-24T09:30:00-05:00,80.25,80.44,79.2,80.13,14047829,38593576.5,49.48353083902082,37.047019712466216,NaN,NaN,33.58987611538641,6.809323687623099,0.692953157609498,-1.3233712489439,-2.016324406553398,379297010,378564418.4,61.373882976168524,45.414897893475946,NaN,NaN,-15.316374033802044,-23.3588613170661
2014-12-26T09:30:00-05:00,80.44,80.81,79.76,80.11,14464599,38273145.05,49.4228579580525,38.026096503093854,NaN,NaN,54.81325657711941,25.006679747715364,0.7123537908922828,-1.1258821679380446,-1.8382359588303274,364832411,380868714.2,61.77620539205098,45.24304502071452,NaN,NaN,-13.262645289935815,-21.916544741761776
2014-12-29T09:30:00-05:00,80.29,81,79.92,80.4,18224110,37057433.65,50.37303458270918,39.53389298400714,NaN,NaN,61.441196358012945,37.70579490476916,0.7224369380092435,-0.935189786318773,-1.6576267243280165,383056521,377469278.2,60.77057167781013,45.181872557146086,NaN,NaN,-11.29372662363431,-20.398999296314994
2014-12-30T09:30:00-05:00,80.3,80.475,79.505,79.76,19148116,35435114.55,48.22003361368119,40.646015044515195,NaN,NaN,44.73388444971034,45.89301797402599,0.6651544828075584,-0.8261836208185684,-1.4913381036261268,363908405,376887837.2,60.58889670347898,45.2854742910405,NaN,NaN,-10.190377576886805,-18.94062476496811
2014-12-31T09:30:00-05:00,79.29,80,78.69,79.16,21541918,34850464.8,46.22531363692901,41.91508987777634,NaN,NaN,28.530545179686154,44.62175173598305,0.569688099057049,-0.7792279798048156,-1.3489160788618646,342366487,366692166.8,57.35117918143194,45.8243474447682,NaN,NaN,-9.780579002307299,-17.63204679887371
2015-01-02T09:30:00-05:00,78.73,79.785,78.38,79.53,27749102,34660459.1,47.66311037613569,43.292703155423276,NaN,NaN,33.05227972328029,44.514232457561825,0.5158979737140179,-0.7040436117193423,-1.2199415854333602,370115589,364855882.6,56.76285200128445,46.89038308501093,NaN,NaN,-9.053207363173943,-16.406498308059458
2015-01-05T09:30:00-05:00,78.42,78.45,75.85,76.24,45395242,35751243.8,37.94729436895049,44.13788947000809,NaN,NaN,-40.8913730927647,25.373306523585,0.2563010015817775,-0.8995653334561382,-1.1558663350379157,324720347,356833469.8,54.14936858236449,48.2956908614679,NaN,NaN,-11.316383850410391,-15.679339099823878
2015-01-06T09:30:00-05:00,76.11,76.73,74.5899,75.12,41876639,36672910.85,35.30862760145577,44.867148575525356,NaN,NaN,-79.2651982182209,-2.767972391661769,0.01921695592344763,-1.1318451401336063,-1.151062096057054,282843708,336790907.2,48.180894326595165,49.681995843284355,NaN,NaN,-14.055282259278398,-15.447330979745953
2015-01-07T09:30:00-05:00,76.03,76.36,74.78,75.28,31192369,36172895.15,35.99335146224901,45.4333666984378,NaN,NaN,-71.27253766121666,-25.96925681384717,-0.10968527577581955,-1.2881686907768284,-1.1784834150010088,314036077,326816441.6,45.4934476842202,51.14271045905728,NaN,NaN,-16.06855560083354,-15.536077354187038
2015-01-08T09:30:00-05:00,75.89,77.145,75.58,76.97,28186863,35898795.25,42.87152507007843,45.6291703603518,NaN,NaN,-33.28125331466548,-38.331616512717495,-0.06613295375747352,-1.2611496071978507,-1.1950166534403772,342222940,326787732.2,45.48558342309072,52.63010484376195,NaN,NaN,-15.78669986335085,-15.571880569781868
2015-01-09T09:30:00-05:00,77.02,77.15,75.665,76.36,24952127,34919709.85,41.1525384782326,45.35966763706026,NaN,NaN,-40.497619413300725,-53.0415963400337,-0.06340243955752323,-1.2742697028872811,-1.210867263329758,317270813,316218777,42.56824102337418,53.45745848593981,NaN,NaN,-16.06119998713702,-15.641783343689747
2015-01-12T09:30:00-05:00,75.39,75.39,73.76,74.16,28940640,34589157.35,35.60730109491536,44.281561530514594,NaN,NaN,-97.47437225324298,-64.35819617212935,-0.18772696019996316,-1.445525963579712,-1.2577990033797488,288330173,308940742.2,40.63544761163829,53.29843670359178,NaN,NaN,-18.066505699661732,-15.988172251685745
2015-01-13T09:30:00-05:00,74.46,75.04,72.88,73.57,34051424,33789015.4,34.27348547329514,43.26767753002918,NaN,NaN,-113.84200272894616,-71.27355707427441,-0.2819955119459532,-1.6102933933121903,-1.3282978813662372,254278749,303227750.4,39.1334074246704,52.34982955115703,NaN,NaN,-20.11663548174692,-16.577952713123054
2015-01-14T09:30:00-05:00,72.87,73.91,71.7,73.8,52152464,34022582.95,35.291095316040085,42.13093570512466,NaN,NaN,-131.36924186129446,-83.29289791428997,-0.2995106422705722,-1.7026861842044525,-1.4031755419338803,306431213,301706777.6,38.72302541330134,50.92807167296281,NaN,NaN,-21.486985081119887,-17.279243051408315
2015-01-15T09:30:00-05:00,74.67,74.86,72.8,72.86,41346002,33225661.95,33.039652753804134,40.95637298475203,NaN,NaN,-117.04477486621373,-100.0456022245996,-0.3419840642633032,-1.8306556222630093,-1.488671557999706,265085211,286279231.8,34.743146334392605,49.02587619855024,NaN,NaN,-23.322721023778463,-18.142597047461194
2015-01-16T09:30:00-05:00,73.29,75.33,73.23,75.23,42741856,32239242.45,42.92606520521195,40.492316359549136,NaN,NaN,-78.90874641175557,-107.72782762429058,-0.1858584148910971,-1.7209945766135775,-1.5351361617224804,307827067,284390482.6,34.278645624011304,47.06176478654741,NaN,NaN,-21.90580374725628,-18.680198004574777
2015-01-20T09:30:00-05:00,74.84,75.36,73.93,75.32,28085839,31030361.4,43.26861464643799,39.98485779267262,NaN,NaN,-64.53988617631445,-101.1409304089049,-0.058519744197675916,-1.6082858419695754,-1.5497660977718994,335912906,293907029.2,38.72391434934183,45.48700354879967,NaN,NaN,-20.674014650808953,-18.965028954036804
2015-01-21T09:30:00-05:00,75.87,76.87,75.32,76.85,28330815,30109763.7,48.885122584600616,40.03236414773829,NaN,NaN,-19.91335760687764,-82.35520138449117,0.13613131665320455,-1.3796019519553937,-1.5157332686085982,364243721,315900023.6,47.55275822661728,44.5558508004524,NaN,NaN,-17.86133956188349,-18.807359040872043
2015-01-22T09:30:00-05:00,77.34,77.45,75.8,77.21,33018833,30098800.8,50.136031199690684,40.31170111650699,NaN,NaN,-2.208406798057788,-56.52303437184385,0.287791611867805,-1.155993753773842,-1.443785365641647,397262554,334066291.8,53.511133117680224,44.2815617958987,NaN,NaN,-15.191234751631288,-18.290769856694794
2015-01-23T09:30:00-05:00,76.86,77.76,76.54,76.66,21147428,29829710.75,48.195461374014094,40.349726187784015,NaN,NaN,9.407377285242701,-31.23260394155256,0.34582583539742173,-1.0115030713948698,-1.3573289067922916,376115126,356272274.8,59.5591671607668,44.48129859300458,NaN,NaN,-13.507336405430312,-17.60742222079987
2015-01-26T09:30:00-05:00,76.92,77.9599,76.24,77.76,18362051,30045421.85,52.18191046333741,41.366484480240224,NaN,NaN,27.51985636039522,-9.946883387122403,0.4466457394058023,-0.7990217325350386,-1.245667471940841,394477177,373602296.8,63.545141326188165,45.15242521756342,NaN,NaN,-10.870346302507027,-16.64498280390089
2015-01-27T09:30:00-05:00,77.15,78.085,76.96,77.71,21602283,30402306.05,51.9860857348103,42.55773148976555,NaN,NaN,45.84401471431874,12.129896791004239,0.4945894236992159,-0.6274306923168211,-1.122020116016037,372874894,380994694.4,65.12423891101182,46.36266411645037,NaN,NaN,-8.771627153191615,-15.520217710942424
2015-01-28T09:30:00-05:00,77.5,77.5,74.5,74.65,38833378,31432769.45,41.67776191425402,42.963760807765915,NaN,NaN,-29.273342459905844,10.257899820398602,0.31365959327110193,-0.7299456244271596,-1.0436052176982615,334041516,374954253.4,62.73302837140513,47.59406273696357,NaN,NaN,-9.977343772106838,-14.728378576823054
2015-01-29T09:30:00-05:00,75.25,75.35,73.2077,74.9,30123662,31981546.75,42.677823785568535,42.94992500172949,NaN,NaN,-69.07938971086159,-3.116296762162156,0.2092824920923626,-0.7820021025828083,-0.9912845946751709,364165178,368334778.2,60.12754547320327,48.639917169114476,NaN,NaN,-10.643377459803412,-14.144806988677392
2015-01-30T09:30:00-05:00,74.34,76.41,73.84,75.55,43848129,33096857.3,45.30389858195232,43.246450723423756,NaN,NaN,-25.113619576458646,-10.020496134502423,0.1834088470471722,-0.7620235358662057,-0.9454323829133779,408013307,374714414.4,61.77530212268012,50.011850104779185,NaN,NaN,-10.424524623635191,-13.613338079385649
2015-02-02T09:30:00-05:00,76.48,77.89,75.955,77.86,35465708,33482687.6,53.463380119819305,44.52188493948832,NaN,NaN,93.7409212534712,3.2237168441127713,0.31361528274436257,-0.5534132794829247,-0.8670285622272873,443479015,384514782,64.22140394907993,51.696561271739306,NaN,NaN,-7.6065584495899285,-12.755226703700545
2015-02-03T09:30:00-05:00,78.76,80.4,78.73,79.99,47027876,33564319.3,59.46765094303288,46.32146818732673,NaN,NaN,202.3055444121121,34.516022783671445,0.5226220806076392,-0.21375096146773842,-0.7363730420753776,490506891,408041181.4,69.30023036898326,53.85133433919022,NaN,NaN,-3.0941041895793235,-11.375066344540372
2015-02-04T09:30:00-05:00,78.95,79.4,78.01,78.67,41132220,33527098.35,54.752971777793995,47.71160222030915,NaN,NaN,128.81674195618652,66.13403966688992,0.5487008355403583,-0.050496997649929654,-0.599197833190288,449374671,431107812.4,73.30184058469658,56.32124970857559,NaN,NaN,-0.9219468775945316,-9.881763563548109
2015-02-05T09:30:00-05:00,79.6,80.25,79.12,79.8,31786152,33556787.5,57.834841614940174,49.48268713896173,NaN,NaN,151.67640049540663,110.28519770814356,0.6138594218009412,0.1681264440608885,-0.44573297774005266,481160823,454506941.4,76.62969456313559,59.313146010628664,NaN,NaN,1.8793989708126222,-8.201597487210861
2015-02-06T09:30:00-05:00,80.43,80.5701,79.42,79.82,26134634,33454176.05,57.88951182511686,50.55150475466922,NaN,NaN,140.04017751649033,143.31595712673337,0.6278600518435629,0.33909208706440097,-0.2887679647791619,507295457,474363371.4,79.01961060843134,62.50892922380153,NaN,NaN,4.089780009667652,-6.445686416228217
2015-02-09T09:30:00-05:00,80.16,80.82,79.72,79.9,20203839,33216761.65,58.12340258725432,51.612561036156094,NaN,NaN,127.21216481920663,150.01020583988046,0.6114599696291695,0.47555699725729994,-0.13590297237186952,527499296,491167427.6,80.80827894427507,65.51495526629675,NaN,NaN,5.936626619331283,-4.676784554005431
2015-02-10T09:30:00-05:00,80.04,80.11,78.41,79.86,21971258,32868292.55,57.950089407215096,52.26005866634284,NaN,NaN,93.49271597966559,128.24764015339116,0.5678132687267432,0.5738636135365596,0.00605034480981631,505528038,494171657,81.11820859018339,67.91248743512291,NaN,NaN,7.399819036575067,-2.951555469636789
2015-02-11T09:30:00-05:00,78.84,79.66,78.44,79.3,26196626,32475552.65,55.456935182656366,52.64012323655468,NaN,NaN,75.20496220050165,117.52528420225417,0.4748976007879989,0.599672345794815,0.12477474500681604,479331412,500163005.2,81.75114625397835,69.92963123057277,NaN,NaN,7.977170100686595,-1.3903089595905915
2015-02-12T09:30:00-05:00,80.38,80.71,79.8,80.34,26422317,31189045.3,58.98598145815686,53.410874671136305,NaN,NaN,106.1088575063872,108.41177560445028,0.4569977660727671,0.6960219525977749,0.23902418652500781,505753729,505081586.4,82.27640058056369,71.55229076055826,NaN,NaN,9.468860911670046,0.16100102201807065
2015-02-13T09:30:00-05:00,81.13,82.13,80.92,82.04,31187851,30681137.75,64.00602347425473,54.25545417191611,NaN,NaN,139.56584290742822,108.31690868263786,0.5281328090073257,0.899190197784165,0.37105738877683925,536941580,511010811,82.91480619409639,72.93583825112314,NaN,NaN,12.323913763699442,1.8985599851154094
2015-02-17T09:30:00-05:00,81.65,82.43,81.17,82.29,22125880,29650338.95,64.69047496697851,55.16291054564241,NaN,NaN,132.4667377847447,109.36782327574547,0.5576048378272229,1.0680634360608678,0.5104585982336449,559067460,517324443.8,83.5925296261529,74.2550018736332,NaN,NaN,14.866829309106533,3.7511698885427123
2015-02-18T09:30:00-05:00,81.62,81.95,81.09,81.31,19381380,29215116,59.88330623070067,56.46330656824574,NaN,NaN,104.93178621354251,111.65563732252085,0.4796517033828044,1.1100232274621504,0.630371524079346,539686080,524156052.2,84.31742972930796,75.79674482776912,NaN,NaN,15.694951265095108,5.45742437090734
2015-02-19T09:30:00-05:00,79.62,81.39,79.26,80.93,23871981,28992174.3,58.08101315345527,57.56353438023765,NaN,NaN,66.44289527340646,109.9032239371018,0.37565036492962167,1.099934480241373,0.7242841153117514,515814099,531452589.6,85.07584125612097,77.57876595512039,NaN,NaN,15.878300722792765,6.946120992605258
2015-02-20T09:30:00-05:00,80.71,81.12,79.87,80.54,25641812,28623323.25,56.21115839722718,58.34262436704301,NaN,NaN,60.45831051181872,100.77311453818812,0.25928007905096906,1.0483842141254627,0.7891041350744936,490172287,528336301.2,83.22467550403879,79.11086405378887,NaN,NaN,15.515010739677892,8.170248099329921
2015-02-23T09:30:00-05:00,79.75,80.86,79.55,80.21,19679470,28549925.35,54.60912013149598,58.42446293930563,NaN,NaN,45.13992316307286,81.88793058931705,0.14449560731285538,0.9697236442155628,0.8252280369027074,470492817,515046548.6,75.66349842760405,79.9281565165406,NaN,NaN,14.771687844640557,9.113310920088583
2015-02-24T09:30:00-05:00,80.7,80.77,79.91,80.43,15430683,28403356.95,55.519275688102645,58.142436135382034,NaN,NaN,47.62920379189932,64.92042379074798,0.07149266521875597,0.9145938684261523,0.8431012032073963,485923500,500417756.6,68.30688353703204,79.85720317140122,NaN,NaN,14.377256881796907,9.86530320033263
2015-02-25T09:30:00-05:00,80.49,81,80.09,80.87,16025667,28124526.15,57.36077274060341,58.32870763272557,NaN,NaN,55.22505953094626,54.97907845422873,0.042381451113363,0.8960780170991001,0.8536965659857371,501949167,492870374,64.80598667834272,79.25035646380452,NaN,NaN,14.510520706865865,10.528905701265948
2015-02-26T09:30:00-05:00,80.39,80.43,78.95,79.37,19349080,27150311.25,49.7926573078303,57.75426589650343,NaN,NaN,1.6257027422309043,42.01563994799361,-0.08159608397160789,0.7517014610212271,0.833297544992835,482600087,486227571.6,61.80358915908671,78.19134893494389,NaN,NaN,12.477009318959018,10.807206218079244
2015-02-27T09:30:00-05:00,79.68,79.74,78.94,79.02,13362187,26312237.5,48.19481277743363,57.06178739309748,NaN,NaN,-36.79883242020901,22.56421136158807,-0.1849585965573427,0.6020992992961567,0.7870578958534994,469237900,482040694.2,59.919317496402954,76.82704228408473,NaN,NaN,10.311735748588415,10.736424722437697
2015-03-02T09:30:00-05:00,78.86,78.93,77.71,78.47,17978513,25018756.7,45.71235353635536,56.17528388946185,NaN,NaN,-125.43784328686822,-11.551341928400143,-0.28232355342042204,0.4341534540779719,0.7164770074983939,451259387,478194008.2,58.16474693247462,75.20964714038469,NaN,NaN,7.745367123655187,10.309130779754481
2015-03-03T09:30:00-05:00,78.52,79.23,78.17,78.76,12349713,23862956.95,47.255057668369794,55.4113530509729,NaN,NaN,-113.54069422976357,-43.78532153273272,-0.3165750165284946,0.3207582368377757,0.6373332533662703,463609100,473731128.2,56.11182911966131,73.42347717820454,NaN,NaN,5.982350981115284,9.691019379948882
2015-03-04T09:30:00-05:00,78.78,78.84,77.78,78.65,16602822,22341704.25,46.71281086515738,54.78677274258012,NaN,NaN,-123.47957951115099,-79.52624934115218,-0.3342781731963713,0.21948553687080619,0.5537637100671775,447006278,462742550.4,51.30981805858116,71.24909659281903,NaN,NaN,4.35523391293966,8.928764313233279
2015-03-05T09:30:00-05:00,78.45,78.55,78.06,78.18,11244537,20847320.1,44.370047354078054,53.74277744943163,NaN,NaN,-131.1749213078951,-106.08637415117737,-0.36289361465601716,0.10014669174715607,0.46304030640317323,435761741,453374881.2,47.572185726079674,68.77022410321302,NaN,NaN,2.3059580254226324,7.982649129260329
2015-03-06T09:30:00-05:00,77.63,78.03,76.59,76.78,19176277,20216826.35,38.22098146972692,51.90098873482251,NaN,NaN,-179.6323667068165,-134.65308100849887,-0.45537191548776323,-0.10617458795653079,0.34919732753123245,416585464,442844394,43.71697755486077,65.97037920041048,NaN,NaN,-1.4201289031882118,6.639395124624823
2015-03-09T09:30:00-04:00,76.65,77.53,76.23,76.23,17441096,19782149.45,36.1041065685195,49.859105277789716,NaN,NaN,-173.86690034564938,-144.33889242025512,-0.527747455049328,-0.31048699128042756,0.21726046376890043,399144368,432421390.2,40.240884743283964,62.87383313734842,NaN,NaN,-5.232854944298406,4.943359400492933
2015-03-10T09:30:00-04:00,75.62,76.06,75.13,75.17,19030646,19723489.8,32.381722624865205,47.894706448801465,NaN,NaN,-198.8151092439085,-161.3937754230841,-0.6150730932678401,-0.5515809028158998,0.06349219045194038,380113722,415722314.6,35.38621623705065,59.37874645933004,NaN,NaN,-9.77237847870676,2.841111132035834
2015-03-11T09:30:00-04:00,75.3,75.7001,74.85,75.39,13050999,19277476.85,33.90484805110914,46.167837512919604,NaN,NaN,-169.1974801167749,-170.53735554420888,-0.6241029237561305,-0.7166364642432228,-0.09253354048709225,393164721,404954003.2,32.65078649223014,55.63409969048069,NaN,NaN,-13.082576976761962,0.5662985450647202
2015-03-12T09:30:00-04:00,75.51,75.87,74.88,74.91,19244978,18929894.45,32.20057777465071,44.45279603987843,NaN,NaN,-144.42906545983053,-173.18818437459595,-0.6268350080317678,-0.8760773005268021,-0.24924229249503424,373919743,392585603.6,29.80123633951976,51.8181397501579,NaN,NaN,-16.399431512209944,-1.8573771774030887
2015-03-13T09:30:00-04:00,74.42,74.72,73.8201,74.63,21011873,18659372.25,31.21488871642407,42.781779510230436,NaN,NaN,-150.41399703629514,-167.3445104404917,-0.6112843500741454,-1.013347730087716,-0.4020633800135706,352907870,379850084.8,27.1716552365085,48.35443666507964,NaN,NaN,-19.469151983058765,-4.373345006782471
2015-03-16T09:30:00-04:00,74.22,75.7,73.99,75.64,16948529,17947406.15,38.52498264265989,41.56790143555595,NaN,NaN,-111.81382227750834,-154.93389482686348,-0.501371587657947,-1.0287778645860044,-0.5274062769280574,369856399,373992491,26.03382476625343,45.33493246716689,NaN,NaN,-20.114460781536646,-6.6220758317473525
2015-03-17T09:30:00-04:00,75.18,75.63,74.8,75.35,13936304,17537927.35,37.29926593705713,40.13493666387408,NaN,NaN,-93.70224676347172,-133.91132233077613,-0.4198965305905894,-1.0522769401662941,-0.6323804095757047,355920095,369153765.6,25.098825497549186,42.49870666853877,NaN,NaN,-21.00004142841936,-8.67607091698621
2015-03-18T09:30:00-04:00,74.86,77.95,74.74,77.54,27753735,17956545.1,50.188051171693935,40.16317908272148,NaN,NaN,-37.374175029434085,-107.54666131330796,-0.20129189803126168,-0.8839952821147818,-0.6827033840835202,383673830,367255587.4,24.72369926575142,39.850143104729106,NaN,NaN,-17.611846520394934,-9.952610288901742
2015-03-19T09:30:00-04:00,76.6,76.93,76.09,76.31,23240900,17924991.05,44.63808203800455,39.909126887047975,NaN,NaN,-42.248931030442236,-87.11063442743031,-0.12599434556431421,-0.840196316038913,-0.7142019704745988,360432930,364558224.8,24.17085466060152,37.29668147360043,NaN,NaN,-16.543335990990908,-10.894142532057337
2015-03-20T09:30:00-04:00,76.63,77.36,76.3301,76.91,22610621,17773431.5,47.6776264608482,40.04950352451175,NaN,NaN,-21.69369564700584,-61.36657414957244,-0.027392625317502528,-0.7484427521214769,-0.7210501268039744,383043551,370585361,28.04272402091634,35.14510840848912,NaN,NaN,-14.670808378291762,-11.433666224376541
2015-03-23T09:30:00-04:00,77.08,77.6,76.64,76.64,12160133,17397464.65,46.441949341420916,39.99142435830112,NaN,NaN,-12.807016641125008,-41.56521302229579,0.025187896522698594,-0.6895652561506012,-0.7147531526732998,370883418,370790764.8,28.177318826466745,33.14978624468951,NaN,NaN,-13.553619043684979,-11.73651662713489
2015-03-24T09:30:00-04:00,76.84,76.955,76.075,76.13,14780917,17364976.35,44.116115228348995,39.80594609852909,NaN,NaN,-32.26123269118203,-29.27701020783784,0.030793217312955812,-0.676261631032105,-0.7070548483450608,356102501,370827246,28.203005340870547,31.499299621995902,NaN,NaN,-13.331808236661455,-11.964415428495828
2015-03-25T09:30:00-04:00,76.61,77.7,76.53,77.12,15898508,17358618.4,49.412297832759954,40.16610684700637,NaN,NaN,13.153965253396027,-19.17138215127182,0.10231786372322182,-0.5791575186910336,-0.6814753824142554,372001009,368492681.8,27.52460501644893,30.067329571307994,NaN,NaN,-11.475021418625714,-11.894501998514382
2015-03-26T09:30:00-04:00,78.01,78.25,76.75,77.03,15318568,17157092.8,48.95805040644148,40.93304034248598,NaN,NaN,35.60227272138513,-3.6011414009063474,0.1422537461775788,-0.503658199692282,-0.6459119458698608,356682441,367742584,27.297404784329686,28.89450294484149,NaN,NaN,-10.118204819382456,-11.640745258638393
2015-03-27T09:30:00-04:00,76.74,76.89,76.24,76.4,11967257,17087346.3,45.78509295389069,41.62453937001249,NaN,NaN,-8.624787787652341,-0.9873598290356476,0.1255111348871809,-0.48902302726088465,-0.6145341621480656,344715184,360076910.6,25.024073224641825,27.807587836367052,NaN,NaN,-9.88972930629537,-11.39060012258939
2015-03-30T09:30:00-04:00,77.14,78.19,77.11,78.04,18187845,17097812.9,54.12082450404524,43.17733236138249,NaN,NaN,83.70420091800804,18.31488368279096,0.21870124871357244,-0.34115760125609995,-0.5598588499696724,362903029,358480832.8,24.565347845992903,27.03466866557721,NaN,NaN,-6.987405537191346,-10.761572324675384
2015-03-31T09:30:00-04:00,77.45,78,77,77.58,9403722,16950513.35,51.71882814185585,44.44975951072155,NaN,NaN,74.16344797803671,39.59981981663471,0.24139432673459904,-0.2581159415514236,-0.49951026828602263,353499307,357960194,24.408167911095276,26.445910195496147,NaN,NaN,-5.358526691257344,-9.989708662758522
2015-04-01T09:30:00-04:00,77.83,78.23,77.4,77.56,13293323,16785038.4,51.6115745372613,45.83625927947944,NaN,NaN,95.52894374992128,56.07481551593976,0.2462412053990583,-0.19170876153719973,-0.43794996693625804,340205984,351601189,22.513413792874346,25.92535144216433,NaN,NaN,-4.089555153447468,-9.1468295899998
2015-04-02T09:30:00-04:00,77.2,78.173,77.02,77.72,13857667,16915694.9,52.46092824849176,47.353833531769986,NaN,NaN,93.50334798243775,67.65503056815028,0.2505742966270753,-0.12473209615241387,-0.3753063927794892,354063651,351077431,22.359454795738515,25.58162283925219,NaN,NaN,-2.802876981612983,-8.240550645944541
2015-04-06T09:30:00-04:00,78.17,79.55,77.81,79.12,15543251,16734043.6,59.20799339932819,48.83119144296058,NaN,NaN,167.7917428412848,102.93833669393771,0.3329210016673046,0.040844859304641545,-0.29207614236266305,369606902,356055774.6,27.43879265876916,25.6819776887176,NaN,NaN,0.46167044938206564,-6.997376203755026
2015-04-07T09:30:00-04:00,79.05,79.71,78.83,79.17,14142063,16569091.95,59.4294566562144,50.411919351471816,NaN,NaN,167.12683930134315,119.62286437060473,0.3729357376608414,0.17409352971338876,-0.19884220794745266,383748965,360224961.8,31.48154641539911,26.137886325706877,NaN,NaN,3.158766926261692,-5.546498613752638
2015-04-08T09:30:00-04:00,79.54,79.73,78.5,78.53,12045736,16219846.45,55.29155583736322,50.77645539901962,NaN,NaN,131.4386631677279,131.07790740854298,0.339435792962981,0.22545253325627357,-0.11398325970670742,371703229,363865746.2,34.89291980650549,26.86425922147502,NaN,NaN,4.295785770833968,-4.140457987383122
2015-04-09T09:30:00-04:00,78.74,79.97,78.67,79.79,13875097,16261051.35,61.042563464292115,51.94820407232588,NaN,NaN,147.58675201598842,141.48946906175638,0.3820943115014817,0.3636346296701447,-0.01845968183133699,385578326,372940214.6,42.568056709313055,28.178345082097277,NaN,NaN,7.112200402442494,-2.5329353602651774
2015-04-10T09:30:00-04:00,80,80.27,79.66,80.14,8850492,15741327.05,62.486103218040626,53.00595241212534,NaN,NaN,159.0158705933209,154.59197358393303,0.4113063050305462,0.49567319945684574,0.08436689442629955,394428818,381013248,48.3963159272009,29.63217307540332,NaN,NaN,9.867216825343812,-0.7614850480353219
2015-04-13T09:30:00-04:00,80.49,80.598,79.21,79.34,9940267,15187746.75,57.26310479945748,53.778892087699376,NaN,NaN,128.00687478353166,146.63499997238242,0.35623117255666714,0.5296558601221335,0.17342468756546636,384488551,383989577.8,50.394980697884364,31.219148923361722,NaN,NaN,10.662080239383073,0.8704528501673059
2015-04-14T09:30:00-04:00,79.86,80.96,79.76,80.77,13720118,15026326.2,63.186542138484654,55.14106543842335,NaN,NaN,150.21722289282675,143.25307669067914,0.3927150992817291,0.6643185616676277,0.2716034623858986,398208669,386881518.6,52.32705686426123,32.94229546074677,NaN,NaN,13.301696126655656,2.6463447468084986
2015-04-15T09:30:00-04:00,81.23,82.865,81.07,82.7,20006910,15329856.5,69.35925536738407,56.56584811946793,NaN,NaN,200.80083920785228,157.125511898704,0.5156876775526474,0.9162130593267079,0.4005253817740605,418215579,396183988.6,57.99462844461953,35.11872570561609,NaN,NaN,17.884136814708558,4.823172185079935
2015-04-16T09:30:00-04:00,82.39,83.23,81.857,82.51,21277482,15006043.85,68.14781401679373,57.93654552020737,NaN,NaN,179.1152110657873,163.43120370866376,0.549954437469909,1.0879684286114468,0.5380139911415378,396938097,398455942.8,59.26826051010055,37.40235825745687,NaN,NaN,21.028567911962746,7.138228717491765
2015-04-17T09:30:00-04:00,82.12,82.23,81.26,81.91,16917429,14689870.3,64.32685297610251,59.26095695036536,NaN,NaN,129.37717545665208,157.50346468133,0.4994070892097868,1.1622728526537713,0.6628657634439845,380020668,395574312.8,56.91125475603565,39.680014081127865,NaN,NaN,22.3725880542348,9.314565765597912
2015-04-20T09:30:00-04:00,82,83.12,81.97,82.22,12710449,14194861.7,65.40608668027879,60.067047105810616,NaN,NaN,136.4351744668699,159.18912461799766,0.45528550088583086,1.2319726395512731,0.7766871386654423,392731117,397222826,57.94170961708682,42.06403992192029,NaN,NaN,23.78894584798011,11.382334348795368
2015-04-21T09:30:00-04:00,82.43,82.48,81.01,81.35,11820391,14177874.6,59.92664530514875,60.65331976033154,NaN,NaN,92.52811659158847,147.65130335775,0.3411618499134721,1.2031394510572824,0.8619776011438103,380910726,393763237.4,54.970641287025586,44.24707373448673,NaN,NaN,23.291341441587573,13.083621076337112
2015-04-22T09:30:00-04:00,81.56,82.2,81.02,81.89,10129467,13945302.1,62.051697787606464,61.3990428496419,NaN,NaN,86.4445357853379,124.78004267324714,0.27835014171976946,1.209915278293522,0.9315651365737526,391040193,388328160.2,50.58243523445529,46.252003837456805,NaN,NaN,23.520167006078633,14.574556209157329
2015-04-23T09:30:00-04:00,82.07,82.98,81.98,82.45,12575757,13779164.55,64.17346492347626,62.23565261214081,NaN,NaN,104.16359900651703,109.78972026139309,0.2516343957160868,1.246108131218861,0.9944737355027743,403615950,389663730.8,51.60479640463845,48.34095680952108,NaN,NaN,24.347548244889246,15.970697928547603
2015-04-24T09:30:00-04:00,82.2,82.28,81.59,81.98,11507638,13588618.05,61.086409130611216,62.36982516437531,NaN,NaN,75.54287404155028,99.02285997837274,0.18263766364886336,1.2227708150638534,1.04013315141499,392108312,392081259.6,53.48084595282753,50.201103473382396,NaN,NaN,24.122142011901605,17.135189940455316
2015-04-27T09:30:00-04:00,82.32,82.57,81.7525,81.89,11325603,13556535.35,60.486375098381174,62.4453193388158,NaN,NaN,72.52267308420718,86.2403597018402,0.11459139541393726,1.1833723956824116,1.0687810002684743,380782709,389691578,51.361355210599186,51.62108981589669,NaN,NaN,23.767812079870897,18.082707388943255
2015-04-28T09:30:00-04:00,81.87,82.445,81.61,82.3,11125407,13203413.45,62.30299538555126,62.94613644940066,NaN,NaN,67.84532660624342,81.30380170477119,0.0823556122567981,1.171725515589472,1.0893699033326738,391908116,391891056,53.19977816299343,52.92872255564583,NaN,NaN,23.967967036150103,18.92345876711566
2015-04-29T09:30:00-04:00,82.01,83.06,81.746,82.94,15903097,13528382.2,65.00741521274472,63.2293401457187,NaN,NaN,80.54524376405448,80.12394330051451,0.08874535798112815,1.2003016008090839,1.1115562428279557,407811213,395245260,55.935116945635095,53.883512572525966,NaN,NaN,24.904706459107977,19.777922723114564
2015-04-30T09:30:00-04:00,83.25,83.38,82.21,82.68,16552143,13691323.2,63.029140009367204,63.26812848795631,NaN,NaN,82.87722815971674,75.86666913115445,0.06137170982001661,1.1882708801029764,1.1268991702829598,391259070,392773884,53.456018048976325,54.2449198669385,NaN,NaN,25.144983512552187,20.544645693034223
2015-05-01T09:30:00-04:00,82.76,83.01,82.21,82.87,11354599,13566169.8,63.89384893217377,63.741753068864625,NaN,NaN,76.82371651069816,76.12283762498403,0.04284886252361941,1.180460248437484,1.1376113859138646,402613669,394874955.4,55.2710516069107,54.59321064615467,NaN,NaN,25.57879177823853,21.26380941949198
2015-05-04T09:30:00-04:00,83.07,83.35,82.24,82.66,14434247,13510719.6,62.163257578376616,63.66866131457119,NaN,NaN,77.09426549746989,77.03715610763656,0.005219797251339475,1.1441361324780388,1.1389163352266993,388179422,396354298,56.55564910608124,54.89525294914181,NaN,NaN,25.490827415518318,21.86766913321003
2015-05-05T09:30:00-04:00,83.28,83.66,81.61,81.6395,16076343,13607433.6,54.44573759928784,62.60341004542147,NaN,NaN,46.93371153239182,72.85483309286624,-0.09414821101661586,1.0212310714559294,1.1153792824725453,372103079,392393290.6,52.23028792821737,54.48351434082737,NaN,NaN,23.20770707002811,22.05910312418404
2015-05-06T09:30:00-04:00,82.37,82.7,80.94,81.32,16388582,13824575.9,52.25827032054058,61.46844263854624,NaN,NaN,-9.940333448148646,54.75771765042562,-0.182053192327589,0.887812792063059,1.069865984390648,355714497,381973947.4,42.929467471091556,53.31645769518387,NaN,NaN,20.650682979086643,21.857900246312983
2015-05-07T09:30:00-04:00,81.16,81.18,79.84,80.44,17396581,14000650.1,46.69369054027931,60.20893103598744,NaN,NaN,-125.84407322020277,13.01345737444171,-0.2935201105601797,0.7029658461904233,0.996485956750603,338317916,371385716.6,35.92785769806552,51.81764361961457,NaN,NaN,16.689677197427606,21.119582667900787
2015-05-08T09:30:00-04:00,81.08,81.85,80.16,81.76,14515224,14283886.7,54.51718256147165,59.43115217035835,NaN,NaN,-65.81975173112748,-15.515236273923417,-0.2728440622367081,0.6554308789547179,0.928274941191426,352833140,361429610.8,30.835245575016316,49.88146761660954,NaN,NaN,15.481769792025021,20.314180828489963
2015-05-11T09:30:00-04:00,81.84,81.88,80.14,80.22,18144426,14694094.65,46.02948961214157,58.43849819228641,NaN,NaN,-138.6711131913592,-58.66831201168924,-0.3523238868392531,0.48787008264235965,0.8401939694816127,334688714,350731469.2,26.490168190028285,47.84714810968116,NaN,NaN,11.472745610534222,19.051118654496285
2015-05-12T09:30:00-04:00,80.1,81.01,79.96,80.59,9851538,14500665.65,48.11939661712335,57.44333382296619,NaN,NaN,-165.73802541544583,-101.20265940125677,-0.3677182532126453,0.3805461529658061,0.7482644061784514,344540252,345218903.8,24.568990589905425,45.98904492078474,NaN,NaN,8.957253512962717,17.60913791999149
2015-05-13T09:30:00-04:00,81.29,81.39,80.08,80.38,12534739,14127057.1,47.00681090400352,56.21714425014671,NaN,NaN,-131.2249608659915,-125.45958488482533,-0.3783142385197733,0.2753716080287347,0.653685846548508,332005513,340477107,23.022293552759322,43.947437574221944,NaN,NaN,6.599742914986176,16.036367204990732
2015-05-14T09:30:00-04:00,80.61,81.15,80.3,80.35,9617871,13544076.55,46.84019416286172,55.19955746673603,NaN,NaN,-116.60621520049888,-123.61201328088457,-0.3729977983139712,0.18743859865604406,0.5604363969700152,322387642,337291052.2,22.019259594165618,41.70018140574609,NaN,NaN,4.663494601690592,14.411671118804998
2015-05-15T09:30:00-04:00,80.01,80.99,79.81,80.67,9780592,13187234.7,48.91999701095837,54.37338760334869,NaN,NaN,-110.65327397061442,-132.57871772878195,-0.3348001348839233,0.1419362283651111,0.4767363632490344,332168234,333158071,20.7559644154086,39.51408206323248,NaN,NaN,3.6296878928179934,12.871387800806854
2015-05-18T09:30:00-04:00,80.51,80.84,80.17,80.74,7229827,12913203.6,49.38648240373278,53.45077953321879,NaN,NaN,-90.38252631204209,-122.92100035291853,-0.2931868811116169,0.11025276185951327,0.40343964297113016,339398061,334099940.4,21.856257229381697,37.27525913940307,NaN,NaN,2.904136234433192,11.447494719896332
2015-05-19T09:30:00-04:00,80.2,80.28,79.47,79.59,13919849,13018176.5,42.516860877035086,51.84431136638239,NaN,NaN,-135.74096238341733,-116.92158774651281,-0.32880355465903854,-0.007564800352668044,0.3212387543063705,325478212,330287532.4,20.608902643774826,34.75195811784162,NaN,NaN,0.18754117419588504,9.83892992765341
2015-05-20T09:30:00-04:00,79.87,80,79.28,79.74,12623812,13142893.75,43.61850023309105,50.45783709664839,NaN,NaN,-124.16491913561507,-115.50957940043754,-0.3272469928028777,-0.08781998669722668,0.23942700610565104,338102024,331506834.6,22.139386056509423,32.51505583266542,NaN,NaN,-1.7339649404465647,8.185659232210558
2015-05-21T09:30:00-04:00,80.19,80.61,79.9,80.49,10087322,13018472,48.89248001797844,49.38631074563443,NaN,NaN,-69.96500118716882,-106.18133659777152,-0.26343610432313147,-0.0898681242982633,0.17356798002486817,348189346,336667175.4,28.42795676036299,30.597691915054863,NaN,NaN,-1.8864644102758363,6.7467844261410725
2015-05-22T09:30:00-04:00,79.94,80.56,79.79,80.2,6360710,12761125.6,47.05944786861895,48.30746719493745,NaN,NaN,-73.62179481433763,-98.77504076651616,-0.22972042840003545,-0.11358255547517615,0.1161378729248593,341828636,338599255.8,30.685266603349177,28.749807450574004,NaN,NaN,-2.538968496634261,5.420248294316025
2015-05-26T09:30:00-04:00,79.55,79.72,78.6301,78.93,13183580,12854024.45,39.98883342019167,47.27483118214487,NaN,NaN,-136.26426740843755,-107.95138898579523,-0.2786530113279977,-0.23217839123513784,0.04647462009285987,328645056,336448654.8,29.567424190138468,27.13103146928265,NaN,NaN,-5.356474263958291,3.8807165002768373
2015-05-27T09:30:00-04:00,78.88,79.52,78.36,78.79,11374967,12866502.45,39.288056369035864,46.34838732846596,NaN,NaN,-138.12527190217105,-108.42825088954598,-0.30407372819412987,-0.3336175401498025,-0.029543811955672614,317270089,334807030.2,28.707721859840518,26.115192497050433,NaN,NaN,-7.840774315900314,2.20621781225153
2015-05-28T09:30:00-04:00,78.52,78.62,77.98,78.48,12164179,12679556.55,37.71211391521575,45.706846140961424,NaN,NaN,-166.16882477440078,-116.82903201730312,-0.32358102424404095,-0.4340200922607238,-0.11043906801668285,305105910,328207807.4,25.498151293419667,25.37021346814716,NaN,NaN,-10.37769570537713,0.40851588116172155
2015-05-29T09:30:00-04:00,78.46,78.8904,78.2,78.39,12978090,12500853.9,37.245010108933506,44.473119537208696,NaN,NaN,-146.86351876208147,-132.20873553228566,-0.32358190534728704,-0.5149164497007916,-0.1913345443535046,292127820,316995502.2,21.167902673785832,24.67968897520213,NaN,NaN,-12.596210078111836,-1.449302113020215
2015-06-01T09:30:00-04:00,78.59,78.6,78.09,78.19,8487184,12357483.15,36.172783386940274,43.76906909255147,NaN,NaN,-141.01158925523427,-145.686694420465,-0.31763893167888374,-0.5883832089521093,-0.27074427727322553,283640636,305357902.2,17.79074412471553,24.058301541965502,NaN,NaN,-14.763971585482944,-3.3513977519434617
2015-06-02T09:30:00-04:00,78.43,79.11,78.01,78.73,10183010,12144921.3,41.10293872708811,43.267893528977524,NaN,NaN,-103.89045071188981,-139.21193108115543,-0.26033297088909946,-0.5961604908845999,-0.3358275199955004,293823646,298393620.2,16.13206911986586,23.455664294105535,NaN,NaN,-15.310635944330924,-5.059860350855956
2015-06-03T09:30:00-04:00,78.49,79.07,78.08,78.19,8640272,11773117.75,37.94640779022406,42.62072187799327,NaN,NaN,-103.74081268882082,-132.3350392384854,-0.24216748341873756,-0.6385368742689224,-0.3963693908501848,285183374,291976277.2,14.765939640573336,22.86592472894939,NaN,NaN,-16.683184304793418,-6.72033520141845
2015-06-04T09:30:00-04:00,77.78,77.93,77.07,77.13,15946084,11750992.85,32.64647606733696,41.606884871170074,NaN,NaN,-157.87618287644506,-130.67651085889423,-0.2821199877232838,-0.7490193755042895,-0.46689938778100576,269237290,284802553.2,13.399859641714656,22.250253303774326,NaN,NaN,-19.575953704206476,-8.556852130388169
2015-06-05T09:30:00-04:00,76.78,78.365,76.75,77.67,18956004,11828964,37.44014376731205,40.78689535376676,NaN,NaN,-122.99508889210244,-125.90282488489842,-0.2536540764184163,-0.7839669833040261,-0.5303129068856098,288193294,284015648,13.254996765121248,21.714469900182372,NaN,NaN,-20.559218836635118,-10.271475945566305
2015-06-08T09:30:00-04:00,77.37,77.82,77.05,77.23,9707330,11588569.3,35.239351221177316,39.776385983584234,NaN,NaN,-122.96729089432056,-122.29396521271569,-0.24576023939504432,-0.8375132061294153,-0.5917529667343709,278485964,282984713.6,13.055858106931154,21.08586996286448,NaN,NaN,-22.050945518089133,-11.954257313069565
2015-06-09T09:30:00-04:00,77.7,78.19,77.19,77.22,11033127,11233004.35,35.18872481087668,39.25294769314434,NaN,NaN,-102.15713026038128,-121.94730112241398,-0.22317265522536145,-0.8707187857660728,-0.6475461305407113,267452837,277710551.8,12.057809973770318,20.47507762929273,NaN,NaN,-23.266046292271835,-13.570227167241317
2015-06-10T09:30:00-04:00,78.17,78.39,77.9,78.17,9785399,11229697.4,43.49396760625697,39.244052505513345,NaN,NaN,-57.24916739617907,-112.64897206388564,-0.13078578060653245,-0.8110283562988769,-0.6802425756923445,277238236,276121524.2,11.76597544286534,19.734119728318152,NaN,NaN,-21.824337636577162,-14.749385805717866
2015-06-11T09:30:00-04:00,78.31,78.445,77.75,77.82,8416545,11023787.7,41.38959764580356,38.708132336072275,NaN,NaN,-61.754936003716786,-93.42472268933997,-0.0821580113144611,-0.7829400898354208,-0.7007820785209598,268821691,276038404.4,11.749955454545642,18.54283392075977,NaN,NaN,-21.243430266228632,-15.67710644293369
2015-06-12T09:30:00-04:00,77.38,77.44,76.82,76.95,10504524,11068120.35,36.64360412206766,37.9641434970329,NaN,NaN,-118.15522847094992,-92.45675060510948,-0.0965046799648569,-0.8214129284770308,-0.724908248512174,258317167,270063179,10.629530375752452,17.11028133307429,NaN,NaN,-22.200474871411082,-16.60901621843046
2015-06-15T09:30:00-04:00,76.42,77.18,76.19,76.77,8075548,10982868.15,35.73072002710694,37.65999254038399,NaN,NaN,-135.48467778362695,-94.96022798297074,-0.10531628850188046,-0.8565536091395245,-0.751237320637644,250241619,264414310,9.688911905566428,15.690387598462005,NaN,NaN,-23.250425958807313,-17.557789038484298
2015-06-16T09:30:00-04:00,76.91,77.39,76.54,77.37,9017622,11072257.9,41.00648187566082,37.782737219428626,NaN,NaN,-100.32639534844904,-94.59408100058428,-0.060178894609212885,-0.8264609388991602,-0.7662820442899473,259259241,262775590.8,9.428261288761036,14.313283271956326,NaN,NaN,-22.545855788979146,-18.270370002840703
2015-06-17T09:30:00-04:00,77.78,78.12,76.79,77.18,10413739,10896952.4,39.88979706360208,37.938286015741944,NaN,NaN,-71.99221862356457,-97.5426912460614,-0.03387228247551444,-0.8086223973843403,-0.7747501149088258,248845502,257097044,8.568089680014225,13.103993156713083,NaN,NaN,-22.29150361408828,-18.84481766159036
2015-06-18T09:30:00-04:00,77.42,77.77,77.06,77.13,12672578,10899390.7,39.58430341034392,38.10537839441412,NaN,NaN,-68.77069350021478,-98.94584274536098,-0.011735800895258386,-0.7894198660278988,-0.7776840651326404,236172924,250567290.6,7.698338994812005,12.141881465357809,NaN,NaN,-22.16804978888042,-19.319565108346083
2015-06-19T09:30:00-04:00,76.29,76.6,75.875,75.91,17234878,11256768.5,32.95286101390924,37.87538393919761,NaN,NaN,-158.26643358460154,-106.9680837680913,-0.068013425702798,-0.8627008472611379,-0.7946874215583399,218938046,242691466.4,6.8015275275386955,11.35693742270232,NaN,NaN,-24.09802672146813,-20.00220248164923
2015-06-22T09:30:00-04:00,76.6,76.909,76.26,76.84,10577416,11467603.8,41.058938469373345,37.87224106364656,NaN,NaN,-104.09281907785696,-100.68971202693731,-0.033126333610889014,-0.8360953385719512,-0.8029690049610622,229515462,238546235,6.380240014143098,10.660378200864981,NaN,NaN,-23.165880730750334,-20.454156517235102
2015-06-23T09:30:00-04:00,76.73,77.23,76.65,77.09,7117715,11164310.55,43.05213307755847,38.23693572702759,NaN,NaN,-67.49517389925578,-94.12346773709865,0.013751688082952573,-0.7857793948573715,-0.799531082940324,236633177,234021022.2,5.947170672053602,10.030466131685,NaN,NaN,-21.786988691508768,-20.644561113559913
2015-06-24T09:30:00-04:00,76.92,77.36,76.58,76.61,6798255,10935474.95,40.23854853603162,38.77922661764864,NaN,NaN,-77.31375417483079,-95.1877748473519,0.01906973132319445,-0.775693918786331,-0.7947636501095254,229834922,230218906.2,5.603046119162059,9.473550880074098,NaN,NaN,-21.491238196706504,-20.765514982580854
2015-06-25T09:30:00-04:00,76.59,76.68,75.81,75.83,8685674,10761549.7,36.10886150873289,38.68413502775012,NaN,NaN,-148.2206184378566,-111.07775983488027,-0.02112875831538008,-0.8211745980037506,-0.8000458396883705,221149248,227214171,5.340069179738464,8.908198909689613,NaN,NaN,-22.54300045621446,-21.019441478814226
2015-06-26T09:30:00-04:00,75.76,76.1,75.34,76.08,11772332,10701261.8,38.29474530815037,38.90237746253391,NaN,NaN,-159.01683792322888,-111.22784070260573,-0.021968507262632442,-0.8275064737666611,-0.8055379665040286,232921580,230010877.8,9.593305156380467,8.66087369893599,NaN,NaN,-22.727848731782068,-21.263499657809632
2015-06-29T09:30:00-04:00,75.12,75.6,74.58,74.64,13897203,10971762.75,31.590497272680608,38.64536120980562,NaN,NaN,-216.35000581791417,-133.67927805061717,-0.10589672020264895,-0.9379088667573399,-0.8320121465546909,219024377,227912660.8,9.257240389015678,8.46083301431066,NaN,NaN,-25.16480457734323,-21.820828932028718
2015-06-30T09:30:00-04:00,75.33,75.45,74.68,75.16,15170577,11221141.1,35.95111481728216,38.10658601059314,NaN,NaN,-171.93419336316592,-154.56708194339922,-0.11217953594652808,-0.972236566487851,-0.8600570305413229,234194954,227425016.2,9.176779886462498,8.2758904745676,NaN,NaN,-25.708917590100683,-22.37627016889614
2015-07-01T09:30:00-04:00,75.31,75.34,73.9,74.2,13910120,11484633.5,31.907441033699243,37.42928910972854,NaN,NaN,-190.17778827339436,-177.1398887631119,-0.16366082798215642,-1.0646330655190184,-0.900972237536862,220284834,225514998.6,8.85223644439246,8.068910545270944,NaN,NaN,-27.54698754211338,-23.114944079355748
2015-07-02T09:30:00-04:00,74.4,74.93,74.34,74.53,9700239,11172341.25,34.62935209144965,37.2854139646844,NaN,NaN,-148.17289229368131,-177.13034353427685,-0.15807511246321204,-1.098566128115877,-0.9404910156526649,229985073,227282163.6,11.954744355198756,8.163568686659966,NaN,NaN,-28.12818542168728,-23.83112141397454
2015-07-06T09:30:00-04:00,73.55,74.26,73.24,73.55,13509147,10899998.4,30.704100707585823,36.926369727575754,NaN,NaN,-175.37580760715815,-180.40213747106273,-0.20025456906270434,-1.1908092269810453,-0.990554657918341,216475926,223993032.8,11.191203302625624,8.270875215021336,NaN,NaN,-29.94190565760022,-24.70409059163535
2015-07-07T09:30:00-04:00,73.26,74.4776,72.43,74.22,20686087,11448936.25,36.04178467395423,36.57174849888242,NaN,NaN,-147.0222170643908,-166.53657972035802,-0.1644056273982959,-1.1960616921662108,-1.031656064767915,237162013,227620560,17.4531158772527,8.844079114199314,NaN,NaN,-29.668656478615684,-25.413314289775396
2015-07-08T09:30:00-04:00,73.71,74.22,72.42,72.72,16521292,11723344.5,30.396673276941627,35.89366822840667,NaN,NaN,-153.35911224452124,-162.82156349662912,-0.21963887492662515,-1.3062046584261964,-1.0865657834995712,220640721,224909713.4,16.515915172842455,9.411780935115615,NaN,NaN,-31.420233135066617,-26.27144555338843
2015-07-09T09:30:00-04:00,73.72,74.033,73.09,73.09,11956038,11831876.45,33.1769478341279,35.43599997296267,NaN,NaN,-120.38467318420594,-148.86294047879144,-0.2092256232183174,-1.348097812522468,-1.1388721893041507,232596759,227372098.4,20.68235526488182,10.339210668692031,NaN,NaN,-31.85577205610986,-27.069206482348633
2015-07-10T09:30:00-04:00,73.53,73.99,73.13,73.49,13250366,12073567.5,36.146463325784055,35.66411442381087,NaN,NaN,-100.56516697360664,-139.3413954147765,-0.15582090000232363,-1.3336483143070552,-1.1778274143047316,245847125,230544508.8,25.81891920829466,11.697595788746026,NaN,NaN,-31.239321449718105,-27.664937191972843
2015-07-13T09:30:00-04:00,73.74,74.19,73.54,74.01,14358752,12266278.9,39.886366040820306,35.580359250342795,NaN,NaN,-73.43514626523014,-118.9532631463909,-0.07025625215804743,-1.265647729502291,-1.1953914773442436,260205877,239290499,37.781542664641236,13.940545978067322,NaN,NaN,-29.537350433712543,-27.932424797935656
2015-07-14T09:30:00-04:00,73.8,74.84,73.77,74.54,12654247,12495213.85,43.517532977232875,35.61360210031954,NaN,NaN,-45.00405129194272,-98.5496299919013,0.03177847802129352,-1.1556683798176266,-1.1874468578389201,272860124,246430121.2,45.50701127720515,16.766248878435288,NaN,NaN,-26.979495960408485,-27.796292106860346
2015-07-15T09:30:00-04:00,74.16,74.525,72.975,73.23,12708285,12679747,37.48965100932407,35.417252276983284,NaN,NaN,-79.87152039928621,-83.85211162285428,0.021290576565308195,-1.160833637132285,-1.1821242136975931,260151839,254332344.8,52.53227705118929,20.11833680215152,NaN,NaN,-26.675241306658027,-27.636141992545728
2015-07-16T09:30:00-04:00,73.65,73.87,73.191,73.33,7860701,12552095.1,38.193449556134766,35.56615142322628,NaN,NaN,-79.76563610727395,-75.72830420746789,0.03075984310294344,-1.1436744098189138,-1.1744342529218572,268012540,261415501,57.78571661394814,23.864454476023642,NaN,NaN,-26.216766705234377,-27.433374094358392
2015-07-17T09:30:00-04:00,73.26,73.33,72.2,72.44,14096029,12623267.65,34.47334954814659,35.293194583226004,NaN,NaN,-117.39565143919407,-79.09440110058537,-0.011008113778710804,-1.1881943951452456,-1.1771862813665348,253916511,263029378.2,58.9017996243503,27.386489795164344,NaN,NaN,-27.000745756423424,-27.371570046081967
2015-07-20T09:30:00-04:00,72.57,72.58,71.39,71.48,13833374,12453192.45,30.969352254004548,35.248827081892,NaN,NaN,-150.9189290287072,-94.59115765328077,-0.08714317110082814,-1.28611524524257,-1.1989720741417418,240083137,259004830.2,54.99692753481104,30.653610305578297,NaN,NaN,-28.81688726299434,-27.578043934212307
2015-07-21T09:30:00-04:00,71.65,72.215,71.29,71.51,10619013,12455272.3,31.204680401880367,34.90979605222044,NaN,NaN,-145.3550276889197,-114.66135293267618,-0.11744963157193045,-1.3457841136066548,-1.2283344820347244,250702150,254573235.4,50.98846522758666,33.64015925851574,NaN,NaN,-30.174041875150188,-27.94890078291772
2015-07-22T09:30:00-04:00,71.22,71.65,70.78,70.93,15209285,12859850.8,29.136623106826974,34.71188048601529,NaN,NaN,-166.51329471616415,-131.98970779605176,-0.15610398410813175,-1.423464462169889,-1.2673604780617573,235492865,249641440.6,46.892360004844186,36.357310941405146,NaN,NaN,-31.952772991481655,-28.52088252699828
2015-07-23T09:30:00-04:00,71,71.45,70.33,70.87,11284564,13084166.25,28.923075241107483,34.30428928241942,NaN,NaN,-168.45981259346257,-149.7285430932895,-0.16442333089040906,-1.4728896416747688,-1.3084663107843597,224208301,240880592.8,40.64580317998153,38.40667228603248,NaN,NaN,-33.45195126026623,-29.22532091746513
2015-07-24T09:30:00-04:00,70.87,70.9,69.25,69.51,12554077,13277586.4,24.533796864970725,33.8635532936612,NaN,NaN,-191.1146273418022,-164.4723382738111,-0.23588137877988613,-1.6033180342592175,-1.3674366554793314,211654224,232428135.4,35.70408423723748,40.15759235279047,NaN,NaN,-36.22715302815683,-30.225582647563943
2015-07-27T09:30:00-04:00,68.62,69.32,68.21,68.51,17196710,13548805.3,21.90186019216239,32.853558687818925,NaN,NaN,-205.32641877922765,-175.3538362239152,-0.3196556120237628,-1.7670061705090347,-1.447350558485272,194457514,223303010.8,31.282264699376185,41.14538869722787,NaN,NaN,-39.498473876051705,-31.550281394490767
2015-07-28T09:30:00-04:00,68.61,70.85,68.56,70.47,18938605,13800875.4,36.32122488581913,33.27674094559588,NaN,NaN,-122.76787526349902,-170.83640573883108,-0.21712896320684405,-1.718761762493827,-1.501632799286983,213396119,215841804.6,28.20628204194459,41.98041490216373,NaN,NaN,-37.39993576924059,-32.38594630516931
2015-07-29T09:30:00-04:00,70.29,71.5,70.07,71.43,23427257,14213709.4,41.972413340608966,33.90498848177311,NaN,NaN,-66.54453354426678,-150.8426535044516,-0.06652993010015762,-1.58479521191218,-1.5182652818120224,236823376,216107906.8,28.47640353792339,42.537132635952425,NaN,NaN,-33.67890947170596,-32.570655328960264
2015-07-30T09:30:00-04:00,71.28,71.49,70.62,70.93,12627235,14149565.15,39.98221921514596,34.17897104529896,NaN,NaN,-58.51584633203183,-128.85386025216545,0.01328313798848213,-1.5016613593264196,-1.5149444973149018,224196141,216105474.8,28.475349050153966,42.72687762465666,NaN,NaN,-31.39971425919209,-32.4033780332791
2015-07-31T09:30:00-04:00,70.32,70.42,69.27,69.38,21789434,14754024.9,34.518050115134685,33.795519907749984,NaN,NaN,-106.23609033460997,-111.87815285072699,-0.022493820325131475,-1.543061772721316,-1.5205679523961846,202406707,214255971.4,27.637189811718628,42.00228099230504,NaN,NaN,-31.335191066104258,-32.250779895111265
2015-08-03T09:30:00-04:00,68.64,69.07,67.78,67.92,16926625,14924898.8,30.315373280201328,32.85250850081916,NaN,NaN,-149.82264725582513,-100.7773985460465,-0.12305002285318678,-1.6743804809626681,-1.5513304581094813,185480082,212460485,26.812102294266197,40.66693035066654,NaN,NaN,-32.79801655910607,-32.32895656139624
2015-08-04T09:30:00-04:00,68.22,68.75,67.4,67.69,12762505,14528719.7,29.70186126837909,32.29623780503737,NaN,NaN,-143.06695261396732,-104.83721401614017,-0.18016109598630248,-1.7765318280923594,-1.596370732106057,172717577,204324776.6,23.4027562587233,38.58625029406183,NaN,NaN,-34.12642261568769,-32.58573742629502
2015-08-05T09:30:00-04:00,68.22,68.97,67.11,67.18,18473784,14626344.3,28.33263825476746,31.591894140654,NaN,NaN,-133.6364250675823,-118.25559232080327,-0.22450606914983018,-1.8770033185433448,-1.6524972493935146,154243793,187808860,18.312131332080043,35.76670848821411,NaN,NaN,-35.63962291036287,-33.022006781161856
2015-08-06T09:30:00-04:00,66.78,68.43,66.29,68.25,23259648,15191524.8,35.0931467712758,31.636165370877514,NaN,NaN,-123.25936371375715,-131.20429579714832,-0.15718125782663428,-1.8489738216768075,-1.6917925638501732,177503441,178470320,16.17030920768383,32.71445917273793,NaN,NaN,-34.71104924527547,-33.263298561749515
2015-08-07T09:30:00-04:00,67.97,68.51,66.79,67.03,17081652,15383089.1,31.45028066688465,31.670517400368947,NaN,NaN,-115.30638143800387,-133.0183540178271,-0.1691774691102963,-1.9032644002380437,-1.7340869311277474,160421789,170073336.4,14.525196941486499,29.823621273214748,NaN,NaN,-35.130095720719666,-33.52998387017382
2015-08-10T09:30:00-04:00,67.17,69.22,67.17,69.17,19444368,15637369.9,42.68858207176806,32.49079609107521,NaN,NaN,-68.87696816172456,-116.829218199007,-0.015448759341553542,-1.7533978803046892,-1.7379491209631357,179866157,168950551.4,14.31547638507682,27.20412207017833,NaN,NaN,-31.464913528443773,-33.23497382135525
2015-08-11T09:30:00-04:00,67.79,69.37,67.66,69.3,21053854,16057350.25,43.296741263852,33.502233102291285,NaN,NaN,-53.31566891129489,-98.87896145847252,0.10585611390088068,-1.6056289785870348,-1.7114850924879155,200920011,174591038.2,20.523619508008196,25.320640606118616,NaN,NaN,-28.468315230806358,-32.554022594133976
2015-08-12T09:30:00-04:00,69.06,70.74,68.66,70.56,23483011,16596086.55,48.95099483704745,34.93279878771557,NaN,NaN,3.5709627174306307,-71.43748390146993,0.2723520452784298,-1.3710450358898782,-1.643397081168308,224403022,188622884,33.44285757883982,24.806144491751354,NaN,NaN,-24.021893402620904,-31.335146995346395
2015-08-13T09:30:00-04:00,70.1,70.36,69.4,69.49,19813575,17193730.25,44.860038704835844,36.384673204848795,NaN,NaN,1.3859110627411344,-46.50842894617026,0.3091289624569913,-1.256985878097069,-1.5661148405540604,204589447,194040085.2,37.656292520028465,24.945587940522138,NaN,NaN,-21.690035583410285,-29.957273936498378
2015-08-14T09:30:00-04:00,69.64,70.12,69.18,69.34,12121178,17094987.7,44.30109264041047,37.984618379723656,NaN,NaN,-1.2285456187892247,-23.692861782327334,0.32068029111752283,-1.165264476657157,-1.4859447677746798,192468269,200449381.2,42.30963441253721,25.733257205747925,NaN,NaN,-20.038020305965834,-28.540237703565158
2015-08-17T09:30:00-04:00,69,69.83,68.77,69.49,9532053,16879921.65,45.03857716114022,38.60728639938945,NaN,NaN,-5.1468528539380785,-10.946838720770039,0.33422957375465545,-1.0681578005813606,-1.402387374336016,202000322,204876214.2,45.3440646736631,26.95738453658496,NaN,NaN,-18.49409450109134,-27.10507438892604
2015-08-18T09:30:00-04:00,69.36,69.54,68.89,69.23,11063398,16902140.9,43.952265915658735,38.74870444046443,NaN,NaN,-7.092198581559135,-1.7021446548228873,0.32139384048103947,-1.0006450737347166,-1.322038914215756,190936924,202879596.8,44.214464792173324,28.08153176903139,NaN,NaN,-17.5318366643495,-25.73746899970082
2015-08-19T09:30:00-04:00,68.85,68.96,67,67.32,20183041,17150828.7,36.90937438244601,38.529215523843,NaN,NaN,-96.86530536648583,-21.789398271606174,0.18666169387261355,-1.088711796874989,-1.2753734907476026,170753883,192149769,38.64313209379925,28.807801986434622,NaN,NaN,-18.841904881555173,-24.7523884113943
2015-08-20T09:30:00-04:00,67.14,67.595,65.79,65.8,25336591,17853430.05,32.45265881057756,38.38168757351749,NaN,NaN,-167.10884073494287,-55.48834863114298,0.007053567802192573,-1.2665565309948619,-1.2736100987970544,145417292,180315338,33.61237614597124,29.23460101030981,NaN,NaN,-21.46642139207724,-24.28296455149186
2015-08-21T09:30:00-04:00,65.14,65.85,63.46,63.5,25420233,18496737.85,27.116992237983013,38.153231784787614,NaN,NaN,-246.52457716763928,-104.54755494091299,-0.24106045233142703,-1.5749356642113383,-1.3338752118799113,119997059,165821096,28.686617946750587,29.368494985487267,NaN,NaN,-25.74425167060867,-24.491719854222833
2015-08-24T09:30:00-04:00,59.79,62.58,58.74,60.09,43001115,19786958.1,21.47859680546709,37.565855751722474,NaN,NaN,-319.3864896160928,-167.39548229334392,-0.5893942740650022,-2.070618054461164,-1.4812237803961619,76995944,140820220.4,22.54849227379198,29.30747612942074,NaN,NaN,-31.902086611243718,-25.55034367665439
2015-08-25T09:30:00-04:00,62.73,62.73,59.17,59.22,27696557,20224855.7,20.317840333262353,36.99337018590067,NaN,NaN,-246.75839893094974,-215.32872236322206,-0.8188434764619288,-2.504778125973573,-1.685934649511644,49299387,112492713,17.88012681401578,29.276618663844722,NaN,NaN,-37.02708717853066,-27.189878462636713
2015-08-26T09:30:00-04:00,60.72,61.325,59.54,61.26,39732247,21040105.2,29.8861383573217,36.621441013475376,NaN,NaN,-181.51104940414226,-232.25787117075333,-0.7741742846727164,-2.6536525053525395,-1.879478220679823,89031634,96148263.2,15.842113207467833,29.253176092400725,NaN,NaN,-37.67287149356886,-28.68744889562702
2015-08-27T09:30:00-04:00,62.68,64.44,62.45,64.29,32241447,22020815.8,41.1833448017577,37.316659880252026,NaN,NaN,-82.97598063718411,-215.43129915120159,-0.49509063983572776,-2.498341520474483,-2.0032508806387552,121273081,91319421,15.287696969754563,29.307640380134156,NaN,NaN,-33.76629263023879,-29.41299800057156
2015-08-28T09:30:00-04:00,64.07,66.42,64.04,65.75,31463423,22504515.25,45.721602043190735,37.53330416392508,NaN,NaN,-33.257409187260706,-172.77786555512586,-0.1827759034962506,-2.2317207600090683,-2.0489448565128177,152736504,97867310,19.40645308668276,29.671281573106008,NaN,NaN,-29.00863497345473,-29.355231853840582
2015-08-31T09:30:00-04:00,65.25,66.86,64.08,66.43,36193519,23467859.95,47.743995837388056,37.85096520489194,NaN,NaN,-19.9148395969427,-112.88353555129584,0.08463418812726697,-1.9431521213537337,-2.0277863094810007,188930023,120254125.8,31.643463710222264,30.465556158978444,NaN,NaN,-24.662338278339423,-28.684818485911844
2015-09-01T09:30:00-04:00,64.52,65.28,63.54,64.09,28712604,24265364.9,41.95135825425393,37.35099116326383,NaN,NaN,-53.07965172525003,-74.1477861101559,0.11695859634941064,-1.8815880640442373,-1.998546660393648,160217419,142437732.2,41.17497367683392,31.01785016597802,NaN,NaN,-23.094299709220376,-27.88617294638449
2015-09-02T09:30:00-04:00,65,65.1,63.18,64.68,25528924,24618121.9,43.80273007704523,37.27546911842164,NaN,NaN,-47.31318884142782,-47.30821399761302,0.18696053637591303,-1.7648459899237565,-1.9518065262996696,185746343,161780674,47.98550648451279,31.755651163441183,NaN,NaN,-21.252984705487208,-26.938574626256308
2015-09-03T09:30:00-04:00,65.11,66.25,64.46,64.86,21895034,24549891.2,44.38549690809537,37.28149799468485,NaN,NaN,-22.368365044906984,-35.186690879157595,0.2503170429875179,-1.638910222565272,-1.88922726555279,207641377,179054333.2,53.196751166479416,32.533302360151346,NaN,NaN,-19.63764641828187,-25.89558488225996
2015-09-04T09:30:00-04:00,63.93,64.25,63.52,63.79,16684209,24530019.05,41.62236083138822,37.0374825425597,NaN,NaN,-51.45272322332478,-38.82575368637046,0.2258444649628697,-1.606921684349203,-1.8327661493120726,190957168,186698466,55.32962538816536,33.24655669690151,NaN,NaN,-19.156019667439374,-24.932789851571304
2015-09-08T09:30:00-04:00,64.48,64.88,63.69,64.79,15627575,24339179.4,45.06440116907379,37.11692077494649,NaN,NaN,-32.22228045350541,-41.28724185768301,0.2791930300827128,-1.4837748617086817,-1.7629678917913945,206584743,190229410,56.31982088100799,34.111224988961126,NaN,NaN,-17.695944023287673,-23.89895473324507
2015-09-09T09:30:00-04:00,65.24,66.02,63.47,63.57,18477687,24210371.05,41.82441042554263,37.467994778024824,NaN,NaN,-30.64228552473339,-36.79976861757967,0.2362102090757987,-1.467705130446646,-1.7039153395224447,188107056,195807337.4,57.90718314366862,35.48722863538037,NaN,NaN,-17.4541369297731,-22.978266475606215
2015-09-10T09:30:00-04:00,63.84,64.3,62.96,63.94,18492803,23960860.65,43.15915230702893,38.23274431348564,NaN,NaN,-42.75665949441986,-35.888462748178085,0.2360336866198327,-1.4088732312476537,-1.6449069178674864,206599859,199978040.6,59.10390866808041,37.3080523869596,NaN,NaN,-16.865381284477174,-22.104997162587782
2015-09-11T09:30:00-04:00,63.3,63.45,62.49,63.37,13344252,23637394.5,41.57658171969419,39.26557213360786,NaN,NaN,-56.73747123392007,-42.76228398598071,0.20217000389350148,-1.3921944130006096,-1.5943644168941111,193255607,197100886.6,57.88136650431353,39.39339156964267,NaN,NaN,-16.828344887368484,-21.35118969469931
2015-09-14T09:30:00-04:00,62.93,63.21,62.5042,62.82,12481263,23655398.75,40.05052419139179,40.592138375459626,NaN,NaN,-61.48539061391303,-44.768817464098355,0.14978261888674238,-1.4071361432856833,-1.5569187621724256,180774344,195064321.8,56.982879411153434,41.85299065088277,NaN,NaN,-17.226516990035083,-20.761950736890135
2015-09-15T09:30:00-04:00,63.02,63.73,63.01,63.52,14816578,23919625,42.922036163016024,42.2067237918706,NaN,NaN,-33.03806332140621,-44.931974037678515,0.1679618643281937,-1.3469664317621834,-1.5149282960903772,195590922,192865557.6,55.97266362863167,44.57388613764105,NaN,NaN,-16.770643469739106,-20.191763984439987
2015-09-16T09:30:00-04:00,64.03,65.41,63.93,65.32,17216657,24227287.95,49.60639583006058,43.61531361135195,NaN,NaN,45.444873921467824,-29.714542148438273,0.2992345316813858,-1.1408851314886448,-1.4401196631700306,212807579,197805662.2,57.78355975288738,47.569703748028154,NaN,NaN,-14.387224701313118,-19.362544086850434
2015-09-17T09:30:00-04:00,65.37,66.44,64.86,65.28,19822670,24209269.4,49.46775673209123,44.207057320661484,NaN,NaN,89.28199675086508,-3.306810899381284,0.37640391731360445,-0.969614766528025,-1.3460186838416295,192984909,195082672.2,56.406369746331364,50.506751803497934,NaN,NaN,-12.490485134382528,-18.38082137935502
2015-09-18T09:30:00-04:00,63.58,64.05,62.72,63.1,21236946,24004287.15,42.49689545989703,43.976721136140505,NaN,NaN,-23.423702744519556,3.355942798498817,0.27818936617062073,-0.9982819761283537,-1.2764713422989744,171747963,190781143.4,54.2084198435038,52.992606571842295,NaN,NaN,-12.824186435410805,-17.58701638736299
2015-09-21T09:30:00-04:00,63.77,63.93,63.0601,63.46,15689677,23517759.35,43.902737677904675,43.702345553320264,NaN,NaN,-10.246332276066449,13.603754466068134,0.2366589465306208,-0.9806476591356983,-1.217306605666319,187437640,192113802.6,54.79610730510555,54.64636682861967,NaN,NaN,-12.690961000816065,-16.887579903570572
2015-09-22T09:30:00-04:00,62.48,63.45,62.35,62.79,17050396,22220223.4,41.851962277875934,43.69524584072184,NaN,NaN,-59.60895466014718,8.289576198319942,0.16656254824335082,-1.0091034203621305,-1.1756659686054813,170387244,187073067,52.073785603531476,55.42485339481235,NaN,NaN,-13.167163364673359,-16.356091826585256
2015-09-23T09:30:00-04:00,63.03,63.32,61.95,61.98,13984709,21534631,39.45259375739681,43.38452181788981,NaN,NaN,-105.42883769382244,-21.885166124738113,0.07292201430790524,-1.0845134507205998,-1.157435465028505,156402535,175792058.2,46.50537110760206,55.31912943931873,NaN,NaN,-14.264456031299597,-16.05728671297302
2015-09-24T09:30:00-04:00,61.5,62.685,61.09,62.25,18911999,20493618.6,40.67353022721119,43.119381340683795,NaN,NaN,-148.83731099315406,-69.50902767354194,0.03819013669830085,-1.109697794155629,-1.1478879308539298,175314534,172257983.2,44.886038037853965,54.72550707298834,NaN,NaN,-14.84241002008752,-15.883732899703663
2015-09-25T09:30:00-04:00,62.94,62.94,61.81,62.37,15833436,19673218.05,41.240652434041934,43.09211645515906,NaN,NaN,-108.0721435233068,-86.4387158292994,0.032542073420157136,-1.1072103390787333,-1.1397524124988905,191147970,176137984.6,47.06532357775559,54.13519980081622,NaN,NaN,-15.174458617455747,-15.782408002239675
2015-09-28T09:30:00-04:00,61.72,61.72,59.83,59.88,16351433,18917618.55,33.981671322370445,42.30049289468025,NaN,NaN,-209.15946771053555,-126.22134291619321,-0.12121901020413706,-1.2912761752540618,-1.1700571650499247,174796537,173609764,45.79464710598736,53.383401674029024,NaN,NaN,-17.685232366646396,-16.05424005429778
2015-09-29T09:30:00-04:00,60.17,60.66,59.39,59.79,18881223,18052003.75,33.7504343094498,41.723780314959335,NaN,NaN,-210.43001708678233,-156.38555540152024,-0.20631537966689928,-1.4279513896335487,-1.2216360099666494,155915314,170715378,44.3194354807402,52.41284826953414,NaN,NaN,-19.78833097705816,-16.58768161469212
2015-09-30T09:30:00-04:00,60.34,61.43,60.27,61.2,16128089,17422778,40.57314067867949,41.53906519864865,NaN,NaN,-127.16673596921005,-160.73313505659775,-0.147716414037389,-1.4062815275133858,-1.2585651134759968,172043403,173843551.6,46.3316618590558,51.50054492603238,NaN,NaN,-19.65825783580558,-17.026335360565472
2015-10-01T09:30:00-04:00,61.98,62.66,60.77,61.32,17445508,17018607.2,41.12881869103284,41.50708212517285,NaN,NaN,-81.74934515506524,-147.31554188898,-0.08411196155903355,-1.3637050654247886,-1.279593103865755,189488911,176678427,48.16003860758693,50.806164361980485,NaN,NaN,-19.395193333059275,-17.3647436423503
2015-10-02T09:30:00-04:00,60.62,63.89,60.51,63.85,19929759,16920343.45,51.43872019362781,42.32052469676113,NaN,NaN,-10.158653721604297,-127.7328439286395,0.1332878605785579,-1.1129832781425577,-1.2462711387211156,209418670,180332567,50.50092592068856,50.34316768409013,NaN,NaN,-15.879556155029753,-17.152574001304508
2015-10-05T09:30:00-04:00,64.65,66,64.59,65.78,23806985,17276482.25,57.54654138250635,43.36513221243901,NaN,NaN,139.70260212491976,-57.960429961548435,0.3970927947082792,-0.7499051453357666,-1.1469979400440458,233225655,192018390.6,57.1627910022746,50.428176782207494,NaN,NaN,-10.734814210780646,-16.235751174086815
2015-10-06T09:30:00-04:00,66.01,67.74,65.66,67.24,27466390,17868423,61.492246323607226,44.214121533406626,NaN,NaN,193.41147660605404,22.807868777018832,0.6452551066571294,-0.340429056722634,-0.9856841633797634,260692045,212973736.8,65.9997213411082,51.01504546708041,NaN,NaN,-5.0629894023855595,-14.639642349558065
2015-10-07T09:30:00-04:00,68.1,68.94,66.7,68.09,40003076,18944692.45,63.61262306286775,45.2244691284621,NaN,NaN,206.04530514261944,89.45027699938473,0.8302044057712957,0.0520713438343563,-0.7781330619369394,300695121,238704080.4,73.28664380336559,52.220779328297134,NaN,NaN,0.2509910979007873,-12.512408999921085
2015-10-08T09:30:00-04:00,67.96,69.67,67.54,69.39,27071722,19373638.4,66.63829727893182,46.948854972678866,NaN,NaN,194.53767902366275,144.70768183513033,0.9926634101505654,0.4626962007512674,-0.529967209399298,327766843,266359666.8,78.59635970658387,53.96277503280286,NaN,NaN,5.719229781898832,-9.907889173946812
2015-10-09T09:30:00-04:00,69.54,69.62,68.51,68.94,25985668,20005709.2,64.63478697058339,48.429715636441635,NaN,NaN,159.64270923370862,178.66795442619292,1.0185661716512606,0.7432405051647777,-0.2753256664864828,301781175,284832167.8,81.27380109371163,55.85403887484615,NaN,NaN,9.497259496237607,-7.13572507820618
2015-10-12T09:30:00-04:00,69.05,69.06,67.43,68.05,21746249,20468958.5,60.74487722752324,49.779209561416444,NaN,NaN,113.82200904807749,173.49183581082443,0.9271189696698587,0.8835730456008406,-0.04354592406901811,280034926,294194022,82.47059755986197,58.02523972886976,NaN,NaN,11.468261740254814,-4.478012675568895
2015-10-13T09:30:00-04:00,67.53,68.35,67.15,67.34,20837816,20770020.4,57.75851654833377,51.0867754750548,NaN,NaN,86.2460769970935,152.05875588903234,0.7762869852800772,0.9268128075310784,0.15052582225100122,259197110,293895035,82.28971722566817,60.58126445158877,NaN,NaN,12.208389191557506,-2.0942409802651234
2015-10-14T09:30:00-04:00,67.19,68.17,67.04,67.92,15176740,20668024.55,59.509724266053894,52.4322179064007,NaN,NaN,80.1804480191171,126.88578446433186,0.6766961028695138,0.9963959508378935,0.3196998479683797,274373850,288630780.8,79.00414282588173,63.018271936447896,NaN,NaN,13.336123297869568,0.11009677375411808
2015-10-15T09:30:00-04:00,67.61,69.17,67.38,69.14,19508207,20652301.4,62.985757261560984,53.98543967979492,NaN,NaN,91.83356716055215,106.34496209170975,0.6537438466398159,1.1368796562681496,0.4831358096283337,293882057,281853823.6,74.86033075141404,65.00362959170921,NaN,NaN,15.355964610927138,2.2880778933502635
2015-10-16T09:30:00-04:00,69.38,69.56,68.28,69.23,20031249,20592016.55,63.23649369468247,56.075069849245786,NaN,NaN,90.98073044174888,92.61256633331782,0.606426417182504,1.2411688311064637,0.6347424139239597,313913306,284280249.8,75.35867704668381,67.11534601604468,NaN,NaN,17.064898197739357,4.399052222548706
2015-10-19T09:30:00-04:00,68.54,68.58,67.5,67.86,19500234,20782544.4,56.916069631667106,57.72975808654702,NaN,NaN,61.734912577552365,82.19514703921278,0.45176186937246676,1.1994447506395431,0.7476828812670764,294413072,287155879,75.9667212870234,69.3758664307792,NaN,NaN,16.716311823334618,6.158660736946693
2015-10-20T09:30:00-04:00,67.72,68.37,67.36,68.05,13756519,20617850.55,57.5497588461111,58.94237366993499,NaN,NaN,55.53130104815874,76.05219184942584,0.33644789747868775,1.168242753115436,0.8317948556367483,308169591,296950375.2,77.96146784527646,71.63513828693782,NaN,NaN,16.607525504468292,7.651355703735493
2015-10-21T09:30:00-04:00,67.75,68.08,67.14,67.21,14662111,20651720.65,53.78341680843099,59.84627353546343,NaN,NaN,41.56834851854792,68.329771949312,0.18534402662889649,1.063474888922869,0.8781308622939724,293507480,300777101.2,78.70513655604294,73.81693099754182,NaN,NaN,15.43228230416753,8.762916646654356
2015-10-22T09:30:00-04:00,67.58,68.5851,67.55,68.42,18740747,20643158.05,58.043038646539,60.31801056781423,NaN,NaN,53.23229299875449,60.609517116952475,0.1501326293745815,1.0657966490121993,0.9156640196376178,312248227,304450335.2,79.42290892404633,75.88278692635308,NaN,NaN,15.626485799614775,9.743426525648701
2015-10-23T09:30:00-04:00,68.1,68.895,67.66,68.26,15631001,20633036.3,57.29110468197327,60.29976508920472,NaN,NaN,51.59676089039341,52.732723206681385,0.10163384692648347,1.042706328295722,0.9410724813692386,296617226,300991119.2,76.79764162897098,77.2852762568314,NaN,NaN,15.573611017710364,10.576310024514653
2015-10-26T09:30:00-04:00,68.13,68.13,66.57,66.59,11836061,20407267.7,50.00897092847015,59.479531132409214,NaN,NaN,15.83700822566394,43.553142336303694,-0.04924714128551866,0.8795135547623403,0.9287606960478589,284781165,299064737.8,75.30484739035086,77.94992811749158,NaN,NaN,13.325649684591879,10.969072833097114
2015-10-27T09:30:00-04:00,65.67,66.01,65.11,65.79,21107334,20518573.25,46.93149913240935,58.28802228023361,NaN,NaN,-45.42210577774837,23.362460971122275,-0.20075627015827346,0.677815358350017,0.8785716285082905,263673831,290165585.8,68.66471525182683,77.61979036381024,NaN,NaN,10.48639853629207,10.900119362124965
2015-10-28T09:30:00-04:00,66.25,67.7,65.72,67.25,19756479,20699992.75,52.65742347854593,57.28938843734891,NaN,NaN,-12.64905069561046,12.518981128290603,-0.2000312621591951,0.6285325508092967,0.8285638129684918,283430310,288150151.8,67.21910521235912,76.80712932850848,NaN,NaN,9.729818562145619,10.732933533556487
2015-10-29T09:30:00-04:00,67,68.22,66.9,67.59,9753598,20315397.25,53.90473755287823,56.52295633608425,NaN,NaN,7.972128073079064,3.466948143155521,-0.17494672431866598,0.6098804075701594,0.7848271318888254,293183908,284337288,64.45446918628303,75.60574847797785,NaN,NaN,9.482691356733502,10.55432750829606
2015-10-30T09:30:00-04:00,67.95,68.755,67.15,68.03,14257248,20031771.7,55.53733047694647,56.150988711043055,NaN,NaN,25.09585270581305,-1.8332334937605559,-0.12912857266528044,0.6234164160572249,0.7525449887225053,307441156,286502074,65.32642057756374,74.3811644078137,NaN,NaN,9.7487108565965,10.439239415196123
2015-11-02T09:30:00-05:00,67.62,69.98,67.52,69.62,15386861,19610765.5,60.92335164362799,56.37704836070692,NaN,NaN,122.44618470385903,19.488601801878467,0.0009677667560138437,0.7537546971675226,0.7527869304115088,322828017,294111444.4,68.27260621007667,73.37994219241432,NaN,NaN,11.638422086209008,10.61055122534082
2015-11-03T09:30:00-05:00,70.11,71.93,70.08,71.4,21327171,19303804.55,65.90297575917204,56.83370918164393,NaN,NaN,274.90087118840626,83.55319719510939,0.18919132683310624,0.9892760889528915,0.8000847621197853,344155188,310207715.8,73.41791771800689,72.98092611328039,NaN,NaN,14.943197741313789,11.229500727622673
2015-11-04T09:30:00-05:00,71.47,71.67,70.23,70.76,17718800,18189590.75,62.80404735845959,56.82072990285098,NaN,NaN,199.7739008288536,126.0377875000022,0.24911096091985507,1.1114734632696042,0.8623625023497491,326436388,318808931.4,75.68692741483926,73.03996873209648,NaN,NaN,16.676747784687603,12.007678878631948
2015-11-05T09:30:00-05:00,70.41,71.19,69.84,70.16,16233508,17647680.05,59.957577718743195,56.586521618855315,NaN,NaN,141.14111910223053,152.67158570583248,0.22745602590742164,1.1466825347340261,0.9192265088266045,310202880,322212725.8,76.54033657445032,73.12437298407981,NaN,NaN,17.236450064184623,12.754646190853759
2015-11-06T09:30:00-05:00,69.54,70.08,68.77,69.8,13761216,17036457.45,58.25164060086171,56.681919545226364,NaN,NaN,78.78021476638827,163.40845811794753,0.17060473984567426,1.1324824336336974,0.9618776937880231,296441664,320012827.4,74.71497421047006,73.03496247861172,NaN,NaN,17.19181959397789,13.388528105585777
2015-11-09T09:30:00-05:00,69.64,70.4099,68.82,69.11,12686994,16583494.7,55.020367257134104,56.501248717442294,NaN,NaN,64.08030120225332,151.7352814176264,0.07322462939875063,1.0534084805364614,0.9801838511377108,283754670,312198158,68.46840436319617,72.35688651560598,NaN,NaN,16.205274544359586,13.790920453982036
2015-11-10T09:30:00-05:00,68.82,69.87,68.56,69.26,12685449,16175876.35,55.597007081059196,56.630790879772874,NaN,NaN,45.1794417299657,105.79099552593827,0.008986607168264271,0.9914171100980411,0.9824305029297768,296440119,302655144.2,61.68604916254609,71.14123741607048,NaN,NaN,15.554392816863402,14.042845077250803
2015-11-11T09:30:00-05:00,69.25,69.345,67.63,67.79,14369715,16135525.1,48.97118057085155,55.98280101722377,NaN,NaN,-17.220148840331834,62.39218559210119,-0.13451623064363782,0.8142852146252295,0.9488014452688673,282070404,293781947.4,56.119531330925184,69.47671044513325,NaN,NaN,12.982645929801627,13.891388056186635
2015-11-12T09:30:00-05:00,66.84,67.31,66.13,66.25,19311471,16125688.3,43.167145268003274,54.97394677336877,NaN,NaN,-110.009572465928,12.162047278469492,-0.32433871012977755,0.5433780576066454,0.8677167677364229,262758933,284293158,50.836450605901454,67.62233965777115,NaN,NaN,8.848686457461941,13.171002113511678
2015-11-13T09:30:00-05:00,66.03,66.58,65.2,65.98,17779635,16013107.6,42.22230341965192,54.41775623702461,NaN,NaN,-133.05460792689013,-30.204917260186193,-0.45145496903951243,0.30339805643703244,0.7548530254765449,244979298,274000684.8,45.79991922974994,65.5148447891568,NaN,NaN,5.209905102337912,12.033702540486853
2015-11-16T09:30:00-05:00,65.89,68.25,65.84,68.18,17363094,15906250.6,51.53144191714437,54.746323578791404,NaN,NaN,-45.52695789496079,-52.12636907962902,-0.3739459525476112,0.2874205847920308,0.661366537339642,262342392,269718229.2,43.85314806010915,63.742589989748396,NaN,NaN,4.837191883998831,11.005629589559993
2015-11-17T09:30:00-05:00,68,68.28,67.18,67.43,15228861,15979867.7,48.653471240409225,54.46032699035307,NaN,NaN,-32.87392142446927,-67.73704171051602,-0.35965473820114924,0.21179811458820552,0.5714528527893548,247113531,259852911.6,39.66989505933613,61.774789264532465,NaN,NaN,3.613344253897205,9.94958882732245
2015-11-18T09:30:00-05:00,67.9,68.63,67.255,68.54,20951510,16294337.65,52.85046108806609,54.385021528580765,NaN,NaN,-6.788112511208173,-65.65063444469129,-0.26621580597837224,0.23868309531638943,0.5048989012947617,268065041,257051839,38.54558530624248,59.92415470167242,NaN,NaN,3.9198183103366957,9.088193039181629
2015-11-19T09:30:00-05:00,68.14,68.51,67.06,67.62,18912499,16302925.25,49.25675805502531,53.93640921272925,NaN,NaN,-28.18246426596144,-49.28521280469797,-0.2570099386425535,0.1836364779915698,0.4406464166341233,249152542,254330560.8,37.43553606682114,57.93194866519081,NaN,NaN,3.0379831515701583,8.223877340951418
2015-11-20T09:30:00-05:00,67.64,67.95,66.83,66.9,14213981,16232074.25,46.58690931415219,52.912377617766694,NaN,NaN,-51.477476232090844,-32.9697864657381,-0.2877330008884993,0.08098016552349918,0.36871316641199847,234938561,252322413.4,36.59794577248688,55.669472919648676,NaN,NaN,1.4769031187895088,7.260023880642574
2015-11-23T09:30:00-05:00,66.84,67.755,66.41,67.38,16407325,16460637.45,48.58760968757906,51.67556575551005,NaN,NaN,-54.26460503809302,-34.717315894364546,-0.2646351906613674,0.03791917808528922,0.30255436874665664,251345886,250123112.2,35.65699663796153,52.97226427107402,NaN,NaN,0.7949363854241651,6.3364399527542306
2015-11-24T09:30:00-05:00,67.7,69.125,67.57,68.82,18943055,16352423.5,54.13765512290226,51.05653773868453,NaN,NaN,9.840942203779862,-26.174343168714728,-0.14714621123644178,0.11862160470110439,0.26576781593754617,270288941,254758194.2,39.20461925058412,50.36638511648436,NaN,NaN,1.9289769374585815,5.706802379140567
2015-11-25T09:30:00-05:00,68.24,68.8308,67.84,68.26,11100621,15919630.6,51.79593680530418,50.4735633877246,NaN,NaN,-5.838096961331784,-25.984340058739452,-0.10395359371726362,0.13582582379096664,0.23977941750823026,259188320,252982850,38.33281962423264,47.63727676289738,NaN,NaN,2.155257523856062,5.199438828385637
2015-11-27T09:30:00-05:00,67.71,68.05,67.5269,67.77,8376368,15850769.1,49.767444838581135,49.86754940470456,NaN,NaN,-38.95209226048213,-28.138265657643593,-0.10488855712868533,0.10866872109737358,0.2135572782260589,250811952,253314732,38.60765931191807,45.05818284157224,NaN,NaN,1.74387167427318,4.705786377798144
2015-11-30T09:30:00-05:00,68.05,68.68,67.77,68.02,17605334,16018173.4,50.82559028468218,49.567922478100854,NaN,NaN,-16.623063264181873,-21.167383064061802,-0.08596868758357634,0.10609641874658848,0.19206510633016483,268417286,260010477,44.02765279965501,43.312414872747866,NaN,NaN,1.7061281910989583,4.27726377969826
2015-12-01T09:30:00-05:00,68.08,68.62,67.91,68.56,13797038,15938682.25,53.12259604656067,49.39117883277954,NaN,NaN,-1.8227675580703144,-10.67901556805726,-0.036892941682699576,0.14594892922679037,0.18284187090948995,282214324,266184164.6,48.53887554866457,42.373331043184905,NaN,NaN,2.321834014223305,3.9979166703446953
2015-12-02T09:30:00-05:00,68.11,68.37,66.22,66.44,25428080,16143727.7,44.36154220325372,49.06191894937969,NaN,NaN,-84.49471090396433,-29.546146189606084,-0.14115960767061736,0.006392361321218232,0.1475519689918356,256786244,263483625.2,46.76338941370976,41.705035191955226,NaN,NaN,0.17990585656516805,3.452486554090477
2015-12-03T09:30:00-05:00,66.76,66.98,64.79,65.11,24219152,16468745.3,39.91415942442582,48.82956281769559,NaN,NaN,-167.62570930336128,-61.90366865801197,-0.2853348100551681,-0.2091165435771245,0.07621826647804357,232567092,258159379.6,43.39329225618862,41.17338102411859,NaN,NaN,-3.106163496728188,2.515536546830668
2015-12-04T09:30:00-05:00,64.5,65.085,63.48,64.7,32839278,17299033.8,38.62850951196804,48.57286325286102,NaN,NaN,-221.98612732579036,-98.51047567107364,-0.38760342108740214,-0.4082860098812091,-0.02068258879380698,199727814,247942552,37.76847342096701,40.59970632349124,NaN,NaN,-6.168506411995493,1.2749589812840734
2015-12-07T09:30:00-05:00,63.1,63.19,61.35,62.24,32800384,18250992.2,31.973840305458438,47.17589170916917,NaN,NaN,-280.9251991512498,-151.37090284848722,-0.5881874871698616,-0.755916947756134,-0.16772946058627242,166927430,227644580.8,29.568144685870735,39.579348939617056,NaN,NaN,-11.284778484369399,-0.5192892280949941
2015-12-08T09:30:00-05:00,60.87,62.44,60.25,61.6,27336929,18983488.95,30.5016259045653,45.87933132803746,NaN,NaN,-242.41510127129294,-199.48936959113172,-0.7223900811879164,-1.070717062071168,-0.34832698088325154,139590501,199119816.2,22.255261278961186,38.33544652673313,NaN,NaN,-15.88305494652841,-2.7141129021569106
2015-12-09T09:30:00-05:00,61.88,63.73,61.533,62.41,28756918,19787062.4,34.60561722288064,44.576128194809925,NaN,NaN,-156.19188345301686,-213.82880410094222,-0.7137688471460071,-1.2405380398157604,-0.5267691926697533,168347419,181432051.2,19.10063476777644,36.94652148827127,NaN,NaN,-18.364296268612517,-4.94985338307914
2015-12-10T09:30:00-05:00,62.44,63.74,62.01,62.81,38914867,21014320,36.596762194074145,43.67184277617055,NaN,NaN,-121.17314414997884,-204.53829107026576,-0.6406187625498493,-1.327542645857065,-0.6869238833072157,207262286,176371090,18.301276686379566,35.579788675382595,NaN,NaN,-19.763730674088087,-7.06612156750899
2015-12-11T09:30:00-05:00,61.73,61.96,60.4,60.46,29003987,21498945.8,30.685409019636722,42.536021326562306,NaN,NaN,-154.0801425078597,-190.95709410667962,-0.7048963686220648,-1.5680443440847966,-0.8631479754627318,178258299,172077187,17.627242605005435,34.224738449133916,NaN,NaN,-23.018043371471485,-9.344967539503632
2015-12-14T09:30:00-05:00,60.17,61.1,59.52,60.78,39116610,22565794.55,32.28927655421862,41.37185467417942,NaN,NaN,-139.29526378530028,-162.6311070334897,-0.6799416866612651,-1.7130750837893132,-1.033133397128048,217374909,182166682.8,24.649674264389873,33.438501136735944,NaN,NaN,-25.091116207986797,-11.59441734928694
2015-12-15T09:30:00-05:00,61.64,62.6,61.56,62.31,29070331,23151156.4,39.49772316121594,40.32614524834468,NaN,NaN,-82.8054165024034,-130.7091700797118,-0.5215970030807675,-1.6851296509790075,-1.16353264789824,246445240,203537630.6,36.917126794133964,33.275108818418076,NaN,NaN,-24.54392986970726,-13.444347709346985
2015-12-16T09:30:00-05:00,62.07,62.72,61.24,61.9,28751201,23827273.4,38.32041134317139,39.3636077153352,NaN,NaN,-78.02739722019632,-115.07627283314771,-0.4105641833723126,-1.6767378771136308,-1.2661736937413182,217694039,213406954.6,41.64227979927105,33.511498830920814,NaN,NaN,-24.465145952613465,-15.018747458385054
2015-12-17T09:30:00-05:00,61.94,62.06,60.38,60.38,29074782,24233437,34.245087403989245,38.25486789857864,NaN,NaN,-91.89464390362039,-109.22057278387601,-0.4049078952529874,-1.7723085628075523,-1.367400667554565,188619257,209678348.8,40.41074960477094,33.640290994696024,NaN,NaN,-25.688738819013203,-16.54303193847479
2015-12-18T09:30:00-05:00,59.9,59.94,58.77,58.79,27139177,24644770.9,30.58133110591463,36.80884938580952,NaN,NaN,-119.80114418141538,-102.36477311858715,-0.46914045709036545,-1.9538262389175216,-1.4846857818271562,161480080,206322705,39.28472381445332,33.3015103528959,NaN,NaN,-27.943645574717262,-18.17169102936657
2015-12-21T09:30:00-05:00,58.8,59.32,58.21,58.85,24015013,25134822.5,30.881841341011636,35.22022404969887,NaN,NaN,-114.97629387848181,-97.50097913722345,-0.46744240777957513,-2.068988791551625,-1.60154638377205,185495093,199946741.8,37.16564210813662,32.48913653571534,NaN,NaN,-29.621074133821836,-19.807317187145895
2015-12-22T09:30:00-05:00,59.06,59.915,58.77,59.54,25291533,25579032.9,34.398877096182105,34.50860511347947,NaN,NaN,-92.97106984456093,-99.53410980565498,-0.3832388192337386,-2.0805949078142234,-1.6973560885804848,210786626,192815019,34.898081584559066,31.641614547918863,NaN,NaN,-29.960952911941362,-21.25783657640239
2015-12-23T09:30:00-05:00,60.735,62.17,60.53,62.13,30210492,26142404.75,45.590535200937424,34.91406052608743,NaN,NaN,-39.22632700559183,-91.77389576273407,-0.12960940830085366,-1.859367848956552,-1.7297584406556983,240997118,197475634.8,37.57839577139122,31.22626479900476,NaN,NaN,-26.545658667618472,-22.0132397322904
2015-12-24T09:30:00-05:00,62.21,62.29,61.35,61.57,7215631,25948155.25,43.848677755523674,35.286929686341416,NaN,NaN,-31.712165381353515,-79.7374000582807,0.016186917989936322,-1.7095247931682778,-1.725711711158214,233781487,206508080.8,42.51777365795676,31.565500530218316,NaN,NaN,-24.347637704129777,-22.346725156838882
2015-12-28T09:30:00-05:00,60.5,60.82,60.14,60.45,12553910,26157032.35,40.51468207381436,35.89698981265255,NaN,NaN,-63.80850431811865,-68.53887208562135,0.05097788656163016,-1.6619893529561764,-1.7129672395178066,221227577,218457580.2,48.341586537583574,32.906460662483525,NaN,NaN,-23.545807394531664,-22.518022619366423
2015-12-29T09:30:00-05:00,61.49,61.665,60.54,60.87,15106314,26032081.35,42.28682778587731,36.73878994703198,NaN,NaN,-42.07244560151862,-53.95810243022871,0.11253206074822897,-1.5723021635825205,-1.6848342243307495,236333891,228625339.8,52.730112221933794,35.083235729838705,NaN,NaN,-22.353730334389528,-22.49455229294115
2015-12-30T09:30:00-05:00,60.03,60.89,59.99,60.05,15051209,26094789.9,39.794193340568036,37.109402526866795,NaN,NaN,-65.2375842073476,-48.411405302786044,0.10824373573723811,-1.5495295546592018,-1.65777329039644,221282682,230724551,53.60640880946453,37.547933875673564,NaN,NaN,-22.096615707549606,-22.437704209313786
2015-12-31T09:30:00-05:00,59.77,60.64,59.58,60.32,19202410,25783506.4,41.02685077783938,37.425837425707165,NaN,NaN,-66.13132043149143,-53.79240398796596,0.1322259530856329,-1.4924908490393989,-1.6247168021250318,240485092,230622145.8,53.554251994142426,40.06600354051377,NaN,NaN,-21.52902681292453,-22.30789315268675
2016-01-04T09:30:00-05:00,60.16,60.78,59.3,60.3,21808669,25662982.25,40.95995258579796,38.15973339471868,NaN,NaN,-63.05670209446301,-60.06131133058786,0.153861919030569,-1.4323894033368205,-1.5862513223673895,218676423,227601133,51.948485179760425,42.51752086728199,NaN,NaN,-21.083752195052067,-22.13301587302465
2016-01-05T09:30:00-05:00,60.26,60.5999,59.585,60.53,15529203,24797478.5,42.12862429062872,38.8625439473194,NaN,NaN,-50.095101989937085,-57.318630864951544,0.18849684048156012,-1.3506302717654393,-1.5391271122469994,234205626,230196742.8,53.24561194521121,44.56008784448351,NaN,NaN,-20.39684903498377,-21.88499203901881
2016-01-06T09:30:00-05:00,59.1,59.22,57.71,58.2,26962077,24505563.15,34.64659846458454,38.51603504041715,NaN,NaN,-160.0253793483782,-80.90921761432347,0.06566079379651169,-1.4570511200013598,-1.5227119137978715,207243549,224378674.4,49.98824047146681,45.493738821435855,NaN,NaN,-21.969510763310463,-21.89706614248905
2016-01-07T09:30:00-05:00,57.07,58.38,56.54,56.78,28081892,24542811.3,31.029697823771073,37.99526978903141,NaN,NaN,-199.1086009774615,-107.68342096834627,-0.0915113166092274,-1.6371010595594058,-1.5455897429501784,179161657,215954469.4,45.63496659779006,45.77893073561579,NaN,NaN,-24.48592099235167,-22.26690254961228
2016-01-08T09:30:00-05:00,57.26,57.39,55.8435,56.05,19227115,24066321.15,29.33430264766693,37.644499449294095,NaN,NaN,-209.79734781542072,-136.41662644513212,-0.2177226239773511,-1.8177430229218672,-1.600020398944516,159934542,199844359.4,38.69500171657087,45.65637731503007,NaN,NaN,-27.106221327165393,-22.95823380354844
2016-01-11T09:30:00-05:00,56.28,56.35,54.16,54.85,28444737,23542814.65,26.747193857888618,37.370632503006526,NaN,NaN,-219.5868135990613,-167.7226487460518,-0.34741016261889346,-2.034283102218133,-1.6868729395992395,131489805,182407035.8,32.868527957137914,45.19807761093612,NaN,NaN,-30.17792588444997,-23.98961838653437
2016-01-12T09:30:00-05:00,55.7,55.88,53.46,54.98,35594136,23872322.1,27.493237488140053,37.12858937065856,NaN,NaN,-187.40539799454237,-195.18470794697282,-0.38680878969078725,-2.1703839267127236,-1.7835751370219364,167083941,168982698.8,29.220663449039122,44.63057913528629,NaN,NaN,-32.42671967368321,-25.194918570412778
2016-01-13T09:30:00-05:00,55.65,56.0458,53.08,53.66,33958440,23614413.6,24.738223936914338,36.43854271642515,NaN,NaN,-168.74256306977009,-196.9281446912512,-0.4592047321039938,-2.3575810521519287,-1.8983763200479349,133125501,154159089.2,25.81378984863133,43.981701154148595,NaN,NaN,-35.254674723603166,-26.63202659229712
2016-01-14T09:30:00-05:00,54.21,56.46,53.36,55.97,38074323,24064613.2,36.693714938082884,35.803055554792685,NaN,NaN,-116.09001983103727,-180.32442846196636,-0.31578289744883437,-2.293104941858978,-1.9773220444101436,171199824,152566722.6,25.470253269690758,43.116833832598566,NaN,NaN,-33.9035201173418,-27.670811381589218
2016-01-15T09:30:00-05:00,53.63,54.8675,53.32,54.35,36880246,24471065.45,32.763058308018756,35.01122559425662,NaN,NaN,-129.09511902954915,-164.18398270479204,-0.29469275648215243,-2.3456879900128342,-2.050995233530682,134319578,147443729.8,24.347607170375497,41.81896479777133,NaN,NaN,-34.067025143325665,-28.584556204694426
2016-01-19T09:30:00-05:00,54.76,55.015,52.33,53.18,35872301,24810941.4,30.243304036207448,34.27755573442755,NaN,NaN,-127.2199836864582,-145.71061672227142,-0.3219937180797583,-2.4534873811303797,-2.1314936630506214,98447277,140835224.2,22.942789293957944,40.00476499465521,NaN,NaN,-35.041361454908184,-29.506956954724963
2016-01-20T09:30:00-05:00,52.13,52.55,49.93,51.77,51307352,26019350.15,27.49856119771289,33.221250978130094,NaN,NaN,-153.87224917355405,-139.00398695807377,-0.39277647425367235,-2.622464255867712,-2.2296877816140395,47139925,116846421,18.72031595699434,37.575493832873825,NaN,NaN,-36.778059617743395,-30.54568590658474
2016-01-21T09:30:00-05:00,51.71,54.03,51.37,53.38,43670722,27002135.6,34.77739815513043,32.86290846488455,NaN,NaN,-102.85798149881585,-125.82707064388289,-0.2934776660793945,-2.5965348642132824,-2.303057198133888,90810647,108383450.2,17.496882589671657,34.996241960031476,NaN,NaN,-35.765595589441425,-31.291387289849983
2016-01-22T09:30:00-05:00,55.33,56.12,54.45,55.74,38622508,27668684.35,43.70005422410701,33.05385156818938,NaN,NaN,-41.25488591188764,-110.86004386005295,-0.04424829317845047,-2.358367564606951,-2.3141192714285004,129433155,100030116.4,16.36035117277477,32.339534758505216,NaN,NaN,-31.70042182476813,-31.34982079483829
2016-01-25T09:30:00-05:00,54.68,56.08,53.1,53.14,29120008,27614160.15,37.59762835381652,32.81368555161928,NaN,NaN,-65.47133787047775,-98.13528762823869,-0.030545124228986698,-2.3523006767147336,-2.321755552485747,100313147,93228830.2,15.478749246939827,29.734553620446597,NaN,NaN,-30.454479113646283,-31.22191484038229
2016-01-26T09:30:00-05:00,54.1,55.22,53.4,55.15,25354906,28521123.9,44.09688835908516,32.95427584222331,NaN,NaN,-48.98987215420545,-82.48926532178814,0.12908548894095562,-2.1603986913095525,-2.289484180250508,125668053,98672985.4,19.230644098792297,27.304913059988106,NaN,NaN,-27.03388026465769,-30.623624186707346
2016-01-27T09:30:00-05:00,54.77,56.42,54.2,54.89,36494474,29718152.1,43.466254895547756,33.58425130157782,NaN,NaN,-29.481557907982356,-57.61112706867381,0.22665218773774765,-2.006168945578324,-2.2328211333160715,89173579,107079716.2,24.78305692992288,25.504542807020677,NaN,NaN,-24.657751768735338,-29.77135669842563
2016-01-28T09:30:00-05:00,56.97,57.19,55.43,56.56,38171909,30871431.85,48.555312929091805,34.836080951957875,NaN,NaN,12.266973318796767,-34.58613610515129,0.40285532479624564,-1.7292519773207644,-2.13210730211701,127345488,114386684.4,29.330447243715497,24.339934281729636,NaN,NaN,-20.943081771071615,-28.510174565946485
2016-01-29T09:30:00-05:00,56.66,58.27,56.49,58.21,31498155,31693779.15,53.052058902397434,36.53020639872434,NaN,NaN,60.55277494145092,-14.224603934483572,0.6169148562589015,-1.3609637317933831,-1.9778785880522847,158843643,120268782,32.84988282632514,23.922425789569225,NaN,NaN,-16.325773712447127,-26.769545872589433
2016-02-01T09:30:00-05:00,57.24,57.67,56.39,57.235,27685093,32117913.3,50.256580660545055,38.2094483131998,NaN,NaN,51.717009991387044,9.21306563788939,0.6745532467101498,-1.1346870296645974,-1.8092402763747473,131158550,126437862.6,36.425854817657104,24.176520565320594,NaN,NaN,-13.516232917967413,-24.876215450500574
2016-02-02T09:30:00-05:00,55.84,56.095,55.045,55.33,25231222,32289040.95,45.240585198774724,39.47711600681656,NaN,NaN,0.2941042690056662,19.069860922531614,0.5702405260383752,-1.0964396188267784,-1.6666801448651536,105927328,122489717.6,35.13624017958061,24.599061760359266,NaN,NaN,-12.796636545603835,-23.15056132122961
2016-02-03T09:30:00-05:00,56.125,57.35,54.11,57.3,36440662,33334613.9,50.71837254977915,41.33284090773547,NaN,NaN,50.4441617760602,35.05500485934012,0.6158819854021143,-0.8968276631125107,-1.512709648514625,142367990,133128599.8,41.179439890822444,25.696608191944343,NaN,NaN,-10.342885079833373,-21.320893286744433
2016-02-04T09:30:00-05:00,57.42,58.5,57,57.27,37056132,33839316.65,50.63530345087655,42.328668658649306,NaN,NaN,126.13761963796966,57.82913412317471,0.6240801717379232,-0.7326094338422209,-1.356689605580144,105311858,128721873.8,39.5363325351525,26.70132813947732,NaN,NaN,-8.468171435889605,-19.484790165193743
2016-02-05T09:30:00-05:00,56.5,56.74,55.47,55.94,30240956,33947269.85,46.9629487821273,43.342946549657064,NaN,NaN,48.821475605354934,55.48287425595551,0.523994509549198,-0.7016964686436467,-1.2256909781928447,75070902,111967325.6,33.98415508102937,27.38965299023831,NaN,NaN,-8.031291953254382,-17.84857613491669
2016-02-08T09:30:00-05:00,54.83,56,54,55.65,34806733,34726250.75,46.17654841334723,44.48103543373848,NaN,NaN,5.432350816778005,46.2259424210337,0.4264613655976066,-0.6926142711958363,-1.119075636793443,40264169,93788449.4,29.193715917562272,27.83614774906719,NaN,NaN,-7.91298339781294,-16.429205743901868
2016-02-09T09:30:00-05:00,54.82,55.49,53.44,54.31,37411318,35174579.8,42.62480005132271,45.561481066139166,NaN,NaN,-38.76796855025618,38.41352785718133,0.2676604004733716,-0.7845001362017285,-1.0521605366751001,2852851,73173554,24.90620534868387,28.277996991330728,NaN,NaN,-8.878289036578932,-15.350503357141449
2016-02-10T09:30:00-05:00,54.15,55.32,53.51,54.09,30215826,34905664.3,42.05290116629751,46.08115985265111,NaN,NaN,-42.60417932818259,19.80385963633277,0.14964829227200527,-0.8651001713350936,-1.014748463607099,-27362975,39227361,19.75990337122093,28.439641332869964,NaN,NaN,-9.82912392894044,-14.561734867398448
2016-02-11T09:30:00-05:00,53.15,54.27,52.37,53.861,47986947,35607089.65,41.429787769589154,45.918997963042685,NaN,NaN,-82.77036062981139,-21.97773641722344,0.062472801392909005,-0.9366574618659627,-0.9991302632588717,-75349922,3095005,15.975960521818905,28.412184857801687,NaN,NaN,-10.788550429662601,-14.02270851915047
2016-02-12T09:30:00-05:00,54.6,55.52,54.11,55.28,25782048,34992475.9,46.70002017630629,46.569168807506244,NaN,NaN,-2.38116348276841,-32.218264234848114,0.10422410994959397,-0.8688501258218793,-0.9730742357714732,-49567874,-21832750.2,13.98607866421159,28.305565530463955,NaN,NaN,-10.16021907811394,-13.470924313288108
2016-02-16T09:30:00-05:00,56.21,56.38,55.02,55.83,33800213,34838474.25,48.62946359556241,46.89292418154033,NaN,NaN,35.93008115956909,-26.11871816628989,0.16890046839365824,-0.7619486502794004,-0.9308491186730586,-15767661,-33039116.2,13.190664530274105,27.87413841842694,NaN,NaN,-9.093588466382316,-12.845590620872995
2016-02-17T09:30:00-05:00,56.5,57.91,56.2758,57.66,29280045,34508861.45,54.527734053054004,47.68302983564792,NaN,NaN,109.47128712690346,3.5291329691420303,0.32585701374694576,-0.5235278514893764,-0.8493848652363222,13512384,-30907209.6,14.190482304721513,27.117525945198274,NaN,NaN,-6.388479281455392,-11.923146143813337
2016-02-18T09:30:00-05:00,58.15,58.235,56.6599,56.94,28832298,33385108.75,51.998064183912305,47.92894063956367,NaN,NaN,101.626262841537,32.375221403085945,0.3689473342413506,-0.3882006974346339,-0.7571480316759845,-15319914,-28498597.4,15.376332032668088,26.120803430123456,NaN,NaN,-4.835549437676737,-10.910632328650966
2016-02-19T09:30:00-05:00,56.18,56.83,55.7,56.81,25128752,32458010.25,51.5331968587862,47.820450493591444,NaN,NaN,45.10779962003871,57.95085345305597,0.3752211611931806,-0.28812158018450873,-0.6633427413776893,-40448666,-21518346.2,18.87527055849786,25.122616839564365,NaN,NaN,-3.6877881148925233,-9.878797440971189
2016-02-22T09:30:00-05:00,57.89,58.52,57.64,58.26,24708265,31762298.1,56.2331787452772,48.24735035678659,NaN,NaN,132.57295082006894,84.94167631362345,0.45806694277681514,-0.09075906290667035,-0.5488260056834855,-15740401,-14752851.6,22.231572078281502,24.108739501037537,NaN,NaN,-1.3075792932910912,-8.654337705588318
2016-02-23T09:30:00-05:00,57.7,57.98,56.1699,56.27,21455029,31379049.15,49.18390218771471,48.52901585599659,NaN,NaN,48.672093325581066,87.49007874682584,0.3639868385588484,-0.09384245748492503,-0.4578292960437734,-37195430,-19038405.4,21.621357267492144,23.143390721602646,NaN,NaN,-1.2875968631771033,-7.6019461566724305
2016-02-24T09:30:00-05:00,55.22,56.9675,55.07,56.84,25279831,31375295.4,51.07573472331096,48.55454172553458,NaN,NaN,12.402644135873697,68.0763501486199,0.326488471008722,-0.049718707282870866,-0.3762071782915929,-11915599,-24124002,20.88863030368138,21.694047179664,NaN,NaN,-0.7126292978445107,-6.617758033982728
2016-02-25T09:30:00-05:00,56.67,57.04,55.78,56.89,18588937,30480018.55,51.247193936818576,48.59824818881615,NaN,NaN,27.129688376913013,53.1770352556951,0.29249084776924894,-0.010593618580031716,-0.30308446634928066,6673338,-19725351.6,23.309454593513422,20.53498446954692,NaN,NaN,-0.19773844280927985,-5.700612378100807
2016-02-26T09:30:00-05:00,57.84,58,57.04,57.23,21155074,29629176.8,52.467094612358,48.991401462404056,NaN,NaN,78.84239754294165,59.92395484027569,0.28031011153187074,0.04730317306555776,-0.23300693846631299,27828412,-6069936,30.427074463424006,20.280907282575107,NaN,NaN,0.5669496444134892,-4.805246374884479
2016-02-29T09:30:00-05:00,57.46,57.62,56.53,56.58,22983290,29203433.55,49.896609947096735,49.25712014338616,NaN,NaN,48.93205785706268,43.19577624767443,0.2186239411007668,0.04027298790964551,-0.1783509531911213,4845122,-1952831.4,32.4622924889039,20.514377037670936,NaN,NaN,0.5272222349894232,-4.043465144902493
2016-03-01T09:30:00-05:00,56.98,58.15,56.395,58.06,23642993,29001328.55,55.270127855904775,50.16035784371345,NaN,NaN,88.30077206310291,51.1215119951788,0.2645757503290104,0.15236873472014167,-0.1122070156088687,28488115,11183877.6,38.63106330285493,21.494724034397443,NaN,NaN,2.0242721298935367,-3.176645534217346
2016-03-02T09:30:00-05:00,57.7,59.52,57.42,59.48,26794967,29079515.8,59.732423991362175,51.42318090264665,NaN,NaN,152.18773145541851,79.07852945908776,0.3711520086598015,0.3517329952158832,-0.019419013443918318,55283082,24623613.8,44.242152448479835,23.243456111344504,NaN,NaN,4.686558760944557,-2.0533306349085025
2016-03-03T09:30:00-05:00,59.24,60.49,59.21,60.38,24395607,28477263.05,62.29954406369297,52.913877780796916,NaN,NaN,189.93235309732225,111.6390624031696,0.47610847793745514,0.5757165839779006,0.09960810604044547,79678689,39224684,49.63037937525449,25.647343172304186,NaN,NaN,7.723920335311845,-0.6565804963055959
2016-03-04T09:30:00-05:00,60.72,61.831,60.07,60.96,30551608,28152036.85,63.896912880973254,54.142227259701706,NaN,NaN,203.48015042131433,136.56661297884415,0.5530409033155281,0.7909092351848557,0.23786833186932754,110230297,55705061,54.925086217765994,28.571557997558074,NaN,NaN,10.737486643621109,0.9711433808267904
2016-03-07T09:30:00-05:00,60.93,62.46,60.64,62.39,33360502,28308014.15,67.54777782618672,55.493535419032014,NaN,NaN,199.40786327948362,166.66177406332832,0.6613599981878577,1.0645683296041497,0.403208331416292,143590799,83454196.4,62.1412517487554,32.06802851316388,NaN,NaN,14.518975085568,2.9065479100755347
2016-03-08T09:30:00-05:00,61.88,61.92,59.67,59.77,29817592,28058557.1,56.31201780005459,55.62098425810348,NaN,NaN,125.05593927066744,174.01280750484125,0.5237044718195498,1.0578389211907293,0.5341344493711795,113773207,100511214.8,65.76894239196918,35.75220423368158,NaN,NaN,14.321687334331731,4.537282113540705
2016-03-09T09:30:00-05:00,60.58,61.52,59.84,60.74,25467590,27461370.7,59.029212897930265,56.12320916624761,NaN,NaN,116.68212239235059,166.91168569222765,0.4670047330147218,1.1178903656395818,0.65088563262486,139240797,117302757.8,68.92567548123162,39.5771573371504,NaN,NaN,15.03585073738877,6.037077631233286
2016-03-10T09:30:00-05:00,60.48,60.86,59.69,60.79,28773815,27389270.15,59.17018047963121,56.66870799630798,NaN,NaN,93.53125616568342,147.6314663058999,0.4042421585163337,1.1561883307702772,0.7519461722539434,168014612,134969942.4,71.86548016272368,43.362172308880815,NaN,NaN,15.641159805961246,7.409089370480137
2016-03-11T09:30:00-05:00,61.59,62.565,61.52,62.36,24783649,26229105.25,63.42554823554888,57.18244867418452,NaN,NaN,136.12565787953423,134.16056779754388,0.43705113328112577,1.2982600888553506,0.8612089555742248,192798261,151483535.2,74.31178007013251,47.0821871654416,NaN,NaN,17.499729099782733,8.850609331809078
2016-03-14T09:30:00-04:00,61.575,62.165,61.34,61.95,21766057,26028305.7,61.61942989873127,58.07070065354285,NaN,NaN,109.75877757762173,116.23075065717148,0.40068750062598235,1.3620683313567028,0.9613808307307204,171032204,156971816.2,75.08708784495235,50.90116792097448,NaN,NaN,18.467296391619765,10.224421768924891
2016-03-15T09:30:00-04:00,61.1,61.839,60.66,61.83,21719596,25424274.85,61.07127783709389,58.784668018813065,NaN,NaN,86.33712495675984,108.48698779438996,0.3404679340904049,1.3869657483437265,1.0464978142533217,149312608,164079696.4,76.0934303927171,54.84436792733417,NaN,NaN,19.09538391356022,11.491702075301367
2016-03-16T09:30:00-04:00,62.2,63.04,61.77,62.9,26970370,25308791.1,64.13494831714226,59.70522190312193,NaN,NaN,110.8335884296583,107.31728100185151,0.34361976420236684,1.4760225195062802,1.1324027553039133,176282978,171488132.6,77.13036575734992,58.68871872475107,NaN,NaN,20.5308526622324,12.7830093020058
2016-03-17T09:30:00-04:00,63.41,64.2775,62.84,63.7605,28160813,25275216.85,66.42349202251424,60.702107432418806,NaN,NaN,129.51050221176766,114.51313021106834,0.3721733543628667,1.5976194482574968,1.22544609389463,204443791,178773968.4,78.13480859076606,62.09641401956121,NaN,NaN,22.42891022467169,14.160995148100927
2016-03-18T09:30:00-04:00,63.79,63.85,62.9,63.49,30474007,25542479.6,65.01896886028402,61.7822759262179,NaN,NaN,113.39286980672861,109.96657259650722,0.3421254130938354,1.6531028602619244,1.310977447168089,173969784,175008273,76.27026830392491,65.22555514920556,NaN,NaN,23.606150630525995,15.510303074161651
2016-03-21T09:30:00-04:00,63.24,63.689,62.57,63.27,16698510,25141991.85,63.83669605981976,62.39417365506897,NaN,NaN,97.03576551477738,107.42197018393836,0.2793653489597854,1.660184133367821,1.3808187844080355,157271274,172256087,74.86416102074315,67.81363355762616,NaN,NaN,24.267977264185387,16.761399387022184
2016-03-22T09:30:00-04:00,62.53,63.49,62.49,62.92,14180119,24778246.35,61.908040276391795,62.549574818285365,NaN,NaN,85.26074056406037,107.20669330539847,0.1904589197846971,1.6188924341389068,1.4284335143542097,143091155,171011796.4,74.19814457805667,69.95334728116735,NaN,NaN,24.31588879338924,17.840612159360337
2016-03-23T09:30:00-04:00,62.47,62.7,61.42,61.54,18873756,24457942.6,54.86909132165467,62.01882819385406,NaN,NaN,43.25943513777015,93.69186264702083,0.02365878933315546,1.458007001020654,1.4343482116874986,124217399,160598680.6,68.69067232817015,71.31479677780419,NaN,NaN,22.35147069342533,18.48502052136962
2016-03-24T09:30:00-04:00,60.69,61.84,60.4,61.84,15516028,24304297.15,56.03927085552218,61.45756804917898,NaN,NaN,16.553922695370126,71.10054674374132,-0.07605991351718377,1.339273319791019,1.4153332333082027,139733427,147656607.8,62.48299760006515,71.85464759082556,NaN,NaN,21.020073501809154,18.847170947146697
2016-03-28T09:30:00-04:00,61.86,62.03,61.08,61.51,11564874,23824787.15,54.369297617876406,60.51624803429968,NaN,NaN,17.60503598061663,51.94297997851892,-0.16853763022642676,1.2046611955251691,1.373198825751596,128168553,138496361.6,58.4562871276294,71.5914358321737,NaN,NaN,19.43410251940299,18.931018314611883
2016-03-29T09:30:00-04:00,60.82,61.845,60.46,61.8,14366942,23393969.75,55.620894075782886,60.46688205399455,NaN,NaN,-2.1320203245205813,32.10942281065933,-0.21167791946367243,1.1086014264220054,1.3202793458856779,142535495,135549205.8,57.17952577233971,70.97790607362874,NaN,NaN,18.40837588984851,18.856355111074258
2016-03-30T09:30:00-04:00,62.36,62.62,61.56,61.9192,15744847,22999062.45,56.15325657538758,60.26145660238437,NaN,NaN,29.37430746079088,20.93213619000544,-0.23205057992206912,1.0302161209830913,1.2622667009051605,158280342,138587043.2,58.193138784196094,70.21129630955478,NaN,NaN,17.674601599469884,18.68753318084506
2016-03-31T09:30:00-04:00,61.68,62.365,61.58,61.89,14046407,22361634.45,55.976114009184656,60.03330899735248,NaN,NaN,13.694689781791872,15.019187118809791,-0.2460266143185852,0.954733433006929,1.2007600473255142,144233935,142590350.4,59.55194469328975,69.33175806173806,NaN,NaN,17.007769939006963,18.44756700343962
2016-04-01T09:30:00-04:00,60.82,61.24,60.6101,61.06,14804794,21882093.8,51.04669705195901,59.14910534138177,NaN,NaN,-79.04588213808913,-4.10077384788206,-0.30580516137047,0.8185035956124267,1.1243087569828967,129429141,140529493.2,58.49788860558212,68.20219438569875,NaN,NaN,15.106212599267291,17.97023065998643
2016-04-04T09:30:00-04:00,60.95,61.5899,60.43,60.6092,15809530,21144989.9,48.54613318869341,58.21529843352192,NaN,NaN,-86.84451335370633,-24.990683714746652,-0.3662614958563535,0.6664818871624547,1.0327433830188082,113619611,137619704.8,56.964781830514035,66.90774395609601,NaN,NaN,12.775541125066772,17.22813215499791
2016-04-05T09:30:00-04:00,60.1,60.63,59.94,60.2,16048846,20279407.1,46.32769468186859,57.162185351005824,NaN,NaN,-123.13350375196282,-49.19098040023509,-0.4204838345708797,0.5071385898052085,0.9276224243760882,97570765,128626758.8,52.39449815434222,65.21496308192637,NaN,NaN,10.14872051287445,16.21678763469456
2016-04-06T09:30:00-04:00,60.69,61.51,60.2381,61.5,18218791,19699467.05,53.58453935478857,56.40858471083771,NaN,NaN,-59.946503531758104,-67.0551425987449,-0.3579208822036255,0.4802213216215563,0.8381422038251818,115789556,120128601.6,48.4395206800781,63.16561700497839,NaN,NaN,9.708002140047887,15.28696113545932
2016-04-07T09:30:00-04:00,61.02,61.59,60.63,61.14,13927061,19122440.6,51.50765098596728,55.34316749394149,NaN,NaN,-60.174294916879155,-81.82893953847909,-0.3305603730836735,0.42494173747058994,0.7555021105542634,101862495,111654313.6,44.807315318298855,60.78508177123073,NaN,NaN,8.75170981258008,14.353353803619429
2016-04-08T09:30:00-04:00,62.29,62.71,62.06,62.37,17666506,18567075.15,57.56015072559302,54.81039477003499,NaN,NaN,44.73599253404966,-57.072564604051344,-0.22447485707981163,0.47490853920449894,0.6993833962843106,119529001,109674285.6,43.97755167615186,58.47845915496122,NaN,NaN,9.680943444668248,13.685866609483545
2016-04-11T09:30:00-04:00,62.87,63.06,62.11,62.11,16235725,18139678.95,55.969887874086574,54.24847989962548,NaN,NaN,46.78299996318872,-30.34706194067233,-0.16918390544731154,0.4879035144751711,0.6570874199224827,103293276,107609018.6,43.081393285279304,56.20826145957095,NaN,NaN,9.991855991225153,13.158150806875204
2016-04-12T09:30:00-04:00,62.35,64.325,62.22,63.96,27630418,18432897,63.66266467413439,54.37381021374995,NaN,NaN,123.53154691711119,18.98594819314247,-0.013587570758914591,0.6401029564738394,0.653690527232754,130923694,114279604.4,46.84877364726368,54.254734964514306,NaN,NaN,12.780975808720457,13.104268664281669
2016-04-13T09:30:00-04:00,63.93,64.45,63.48,64.26,18702915,18282062.95,64.73855416640947,55.07877184551815,NaN,NaN,143.81533017429285,59.73831493435266,0.09783520772047649,0.7759845368833496,0.6781493291628731,149626609,121047015,50.43319742511309,52.95062961429595,NaN,NaN,15.371999715958495,13.428230243092644
2016-04-14T09:30:00-04:00,64.53,64.54,64.025,64.41,17435536,17805321.25,65.29190435539283,55.73967423836606,NaN,NaN,141.51326087497446,100.07582609272339,0.1659342549856868,0.8855671478949816,0.7196328929092948,167062145,134086945,56.51807984416455,52.52456406030304,NaN,NaN,17.637552228781544,14.029561955333916
2016-04-15T09:30:00-04:00,64.05,64.16,63.455,63.5392,14221157,17108338.45,59.45845524734739,56.103185497613985,NaN,NaN,99.97195689940699,111.12301896579486,0.13778569330278356,0.8918650095377743,0.7540793162349907,152840988,140749342.4,59.26928678320608,52.58263546427281,NaN,NaN,17.86874930805688,14.578017291437197
2016-04-18T09:30:00-04:00,62.23,64.75,62.08,64.59,20685801,16618928.15,63.67588142527085,56.678541736863124,NaN,NaN,102.35639481215179,122.23769793558748,0.1731045703997569,0.9704600292346868,0.7973554588349299,173526789,154796045,64.38571938064217,53.09736357915155,NaN,NaN,19.387025583987043,15.265018476087175
2016-04-19T09:30:00-04:00,64.96,65.95,64.66,65.88,17341382,16651071.75,68.06758741973394,57.52956536860214,NaN,NaN,182.3883162634639,134.00905180485802,0.2612227795100287,1.1238839332224657,0.862661153712437,190868171,166784940.4,68.07213720845633,53.80300632374157,NaN,NaN,22.166749375295886,16.250980033116992
2016-04-20T09:30:00-04:00,65.53,66.98,65.32,66.47,21088333,16996482.45,69.8623013912532,58.52143589589275,NaN,NaN,184.1751282856166,142.08101142712275,0.3325475406763989,1.2783455795579357,0.9457980388815368,211956504,179250919.4,71.38843757575971,54.64847010106086,NaN,NaN,25.030127217714515,17.505143916630924
2016-04-21T09:30:00-04:00,66.56,66.84,65.94,66.08,19335063,17019547.8,67.17469006935033,59.67343539713499,NaN,NaN,152.22780211408178,144.22391967494423,0.32630827852180255,1.35368338703379,1.0273751085119875,192621441,184362778.6,72.64326900055865,55.65885441498775,NaN,NaN,26.54063077250541,18.795927753184422
2016-04-22T09:30:00-04:00,66.24,67.29,66.19,67.04,15764509,17031971.85,70.21242599681491,61.22102774057224,NaN,NaN,148.5911362125942,153.94775553758168,0.3571905852282118,1.4738633400472523,1.1166727548190405,208385950,195471771,75.18982967074172,56.96064354643259,NaN,NaN,28.80237599505684,20.225420359166197
2016-04-25T09:30:00-04:00,66.81,66.82,65.79,66.29,17234253,17315440.8,65.14056419027514,62.56480413402985,NaN,NaN,112.43930704799325,155.96433798474996,0.29977875586008773,1.49139619964415,1.1916174437840623,191151697,198996752.6,75.9546984317891,58.64351499482165,NaN,NaN,29.119040350986086,21.49593750085475
2016-04-26T09:30:00-04:00,66.67,67.3778,66.51,67.35,13585695,17276378.45,68.5935985195233,63.63687978865376,NaN,NaN,125.63512372808962,144.6136994776751,0.3048622105925052,1.5726952070246938,1.2678329964321886,204737392,201770596.8,76.56690326841608,60.65261375113151,NaN,NaN,30.495324284882493,22.781564184287287
2016-04-27T09:30:00-04:00,67.7,68.78,67.65,68.63,21962444,17587258.3,72.17756885373163,65.11330249349407,NaN,NaN,147.66050910620964,137.3107756417937,0.3621950589618692,1.720576820134525,1.3583817611726559,226699836,204719263.2,77.23056539601538,62.96856018525411,NaN,NaN,32.878740240133986,24.2240179065511
2016-04-28T09:30:00-04:00,68.32,68.815,67.35,67.61,15555187,17662697.3,65.73960945802585,65.6975495458107,NaN,NaN,117.0439195081887,130.2739991206151,0.30166518978981793,1.7354632484099284,1.4337980586201104,211144649,208423904.8,78.07088351085133,65.40379817344694,NaN,NaN,32.73335168610276,25.439637017915622
2016-04-29T09:30:00-04:00,67.76,68.42,66.47,67.5,24107385,18127826.85,65.06558674605235,66.3472423223797,NaN,NaN,91.71911081836247,118.89959404176872,0.22782084649189938,1.7185741167349846,1.4907532702430852,187037264,204154167.6,74.65133561642905,67.65879405424336,NaN,NaN,32.407795291167766,26.435088199808785
2016-05-02T09:30:00-04:00,67.38,67.6648,66.6,67.43,15065966,18090648.65,64.61159504733475,66.41502306332258,NaN,NaN,76.32851906658092,111.67743644548628,0.15153574801392233,1.6801729552604883,1.528637207246566,171971298,200318087.8,71.61630767228058,69.42790362745885,NaN,NaN,32.01273030128565,27.23189421430548
2016-05-03T09:30:00-04:00,66.52,66.64,65.43,65.84,16158058,18096109.25,55.191551105622366,65.73309427326636,NaN,NaN,30.6841249342209,92.68723668671251,-0.019628407233373668,1.504101698204849,1.5237301054382226,155813240,190533257.4,64.42169211372467,70.42708181950253,NaN,NaN,28.637591234203242,27.432708074290876
2016-05-04T09:30:00-04:00,65.88,66.34,64.5,64.89,18605357,18115437.55,50.458033953085064,64.67353210167296,NaN,NaN,-1.8030259734825933,62.79452967077407,-0.20040016734367638,1.273229896258627,1.4736300636023034,137207883,172634866.8,53.77895391684153,70.2314299675509,NaN,NaN,24.233179100296525,26.975632506577398
2016-05-05T09:30:00-04:00,65.99,66.35,64.88,65.42,14352026,18136685.8,52.885764333912135,64.20405417928473,NaN,NaN,1.7826217232229247,39.74227011378092,-0.28281053870739714,1.120116890218057,1.402927428925454,151559909,160717918.8,48.08321005463147,69.43242448693842,NaN,NaN,21.36311022470813,26.173843609167502
2016-05-06T09:30:00-04:00,65,66.07,64.83,65.27,12545475,17880634.25,52.10749929786568,63.37774117018436,NaN,NaN,-13.818031216131278,18.634841706882174,-0.3420012383095714,0.9754258810384897,1.3174271193480611,139014434,151113352.8,44.03525227956101,67.97881969400406,NaN,NaN,18.817935988794897,25.122999663399987
2016-05-09T09:30:00-04:00,64.9,65.04,63.5,64.32,16020841,17869890.05,47.35450726586669,61.89823544490812,NaN,NaN,-80.4510502000249,-12.721072146438985,-0.4338100642625651,0.7751645390198547,1.2089746032824198,122993593,141317811.8,40.30815439874555,65.99567806473901,NaN,NaN,15.13964247126783,23.69680577880968
2016-05-10T09:30:00-04:00,64.65,65.47,64.62,65.45,10351379,17005938.1,52.86226792968936,60.683947340510706,NaN,NaN,-38.75746264262695,-26.609389661808553,-0.40752104790281485,0.6995732934039012,1.107094341306716,133344972,136824158.2,38.690339974466276,63.66009966464662,NaN,NaN,13.624902093245147,22.2579623951576
2016-05-11T09:30:00-04:00,65.29,66.23,64.76,65.65,14214778,16781531.25,53.78387048937359,59.72746022765522,NaN,NaN,-23.045469723600394,-30.857878411832115,-0.36701031004419904,0.6483314537514673,1.0153417637956663,147559750,138894531.6,39.887451742228905,61.32039843190878,NaN,NaN,12.676397769158676,20.889167448586328
2016-05-12T09:30:00-04:00,66.24,66.74,65.34,65.8308,12477167,16533612.8,54.64711343170033,58.61565218728989,NaN,NaN,-1.665620117545753,-31.54752677998585,-0.3200981209001428,0.6152191126704878,0.9353172335706306,160036917,140589933.2,40.905023279724084,58.87148368969323,NaN,NaN,12.14578618172373,19.640112981891672
2016-05-13T09:30:00-04:00,65.54,66.04,64.85,64.99,12371851,16441147.5,49.97246260549897,57.53221635980588,NaN,NaN,-57.313044238461906,-40.24652938445198,-0.3360993975701503,0.5151929866079428,0.851292384178093,147665066,142320059.6,41.98430601885789,56.44502708876957,NaN,NaN,10.309789417245044,18.30720961551358
2016-05-16T09:30:00-04:00,65.84,66.3,65.65,66.09,13727687,16093241.8,55.35336757785146,56.58648557825789,NaN,NaN,-14.062660257597742,-26.96885139596655,-0.26607144196183175,0.5187030817258034,0.7847745236876351,161392753,149999891.6,46.64270853153725,54.307584607563946,NaN,NaN,10.316696057647672,17.165707678675595
2016-05-17T09:30:00-04:00,66.1,66.91,65.89,66.4,15837339,16018039.65,56.76472847233688,55.485568408158265,NaN,NaN,14.5317155513293,-16.3110157571753,-0.19560253515234438,0.5402713547472047,0.735873889899549,177230092,158776915.6,51.44155182674021,52.46551220975857,NaN,NaN,10.740862355554617,16.247872632515456
2016-05-18T09:30:00-04:00,66.39,66.605,65.34,65.76,22951773,16111211.65,53.03710412351835,54.578246598550585,NaN,NaN,-25.866908548317472,-16.875303522118713,-0.18873230809476638,0.49995850478109105,0.6886908128758574,154278319,160120629.4,52.151063036303306,50.61409646157658,NaN,NaN,10.006354803066925,15.356227228308523
2016-05-19T09:30:00-04:00,65.1,65.92,64.49,65.77,16854850,15987201,53.08894036775007,53.72277185724328,NaN,NaN,-62.406444274415506,-29.023468353492667,-0.18017300946113068,0.463474551049444,0.6436475605105747,171133169,162339879.8,53.363079558047545,49.093506743120756,NaN,NaN,9.424834136997267,14.508885358121201
2016-05-20T09:30:00-04:00,65.97,66.3,65.57,66.16,9833512,15690651.15,55.167309809542424,53.04818005454383,NaN,NaN,-9.737604879831286,-19.508380481766544,-0.14634236307978354,0.4607196066608452,0.6070619697406288,180966681,169000202.8,56.89219469080359,48.04178438730097,NaN,NaN,9.503336253205623,13.793806914561832
2016-05-23T09:30:00-04:00,65.77,66.28,65.54,65.99,10272532,15342565.1,54.04332976063745,52.966164244187766,NaN,NaN,-14.528154326681026,-19.601479295583196,-0.13384993179376026,0.4397495549984285,0.5735994867921888,170694149,170860482,57.851562114368,47.57248938734692,NaN,NaN,9.268591069856951,13.147347508175422
2016-05-24T09:30:00-04:00,66.33,66.71,65.91,66.32,11302905,15228425.6,55.92074667825044,53.356358010271,NaN,NaN,22.42736809694594,-18.022348786459872,-0.10317285125189402,0.4446334227273212,0.5478062739792152,181997054,171813874.4,58.362992819844024,47.89992073756138,NaN,NaN,9.567512905822646,12.635942564982168
2016-05-25T09:30:00-04:00,66.72,67.47,66.66,67.37,14268102,14843708.5,61.33337801525803,53.95975898750999,NaN,NaN,119.6436828899037,11.079769501184364,-0.016522258358699138,0.5271534510308413,0.5436757093895405,196265156,180211241.8,62.66061851601328,48.941164199088654,NaN,NaN,11.400750426580379,12.459486545210483
2016-05-26T09:30:00-04:00,67.63,67.92,66.88,67.09,10716801,14601789.2,59.24420917062591,54.46952397842144,NaN,NaN,144.79389449307263,52.51983725468199,0.015829245117816138,0.5634622657868107,0.5476330206689946,185548355,183094279,64.03321376350151,50.3695900193701,NaN,NaN,12.366108896566457,12.44614688111848
2016-05-27T09:30:00-04:00,66.85,67.175,66.48,67.13,9258701,13859355,59.45667187032521,55.33396430731134,NaN,NaN,112.53469063439336,76.97429635752692,0.03283678639566168,0.5886790036635716,0.5558422172679099,194807056,185862354,65.3502209096221,52.158309055861274,NaN,NaN,13.223505396757506,12.557198097638341
2016-05-31T09:30:00-04:00,67.29,67.82,66.57,66.87,15406124,13876362.9,57.36339693915082,55.65547352227287,NaN,NaN,133.27036104114362,106.53399943109184,0.02011532518822512,0.5809863737531913,0.5608710485649662,179400932,187603710.6,66.18898391416646,54.122497908697014,NaN,NaN,13.41039217072356,12.679082965221944
2016-06-01T09:30:00-04:00,66.22,67.09,66.05,66.89,16695658,13903242.9,57.48738641189285,55.92001037388139,NaN,NaN,76.49079479202092,117.34668477010685,0.007250280161141931,0.5699338987663936,0.5626836186052516,196096590,190423617.8,67.55851321907899,56.09900229990058,NaN,NaN,13.599188755095575,12.810526649489606
2016-06-02T09:30:00-04:00,66.38,66.84,66.13,66.8,12849991,13615474.6,56.688483048253424,56.065822489349465,NaN,NaN,59.53186831322807,105.32432185477171,-0.01206682137864401,0.5476000918819466,0.5596669132605906,183246599,187819906.4,64.94281910077699,57.81598771569008,NaN,NaN,13.563240562182141,12.918057208445683
2016-06-03T09:30:00-04:00,66.8,67.15,66.145,66.54,12157730,13505759.8,54.33912168877346,56.377726709583364,NaN,NaN,55.29647873293601,87.42483870274438,-0.04523681268297386,0.5031208974068733,0.5483577100898471,171088869,184928009.2,62.06838720843883,59.25056494351729,NaN,NaN,12.946569059577401,12.922130330035928
2016-06-06T09:30:00-04:00,67.19,68.07,67.07,68.0108,18223802,13789676.15,63.54350768253514,56.962736717060764,NaN,NaN,150.9860430026409,95.1151091763939,0.025208015220526958,0.5798677291155059,0.5546597138949789,189312671,183829132.2,60.96419008740941,60.27352791179387,NaN,NaN,15.004109487636983,13.219555923978936
2016-06-07T09:30:00-04:00,68.23,69.73,68.21,69.55,15618287,13769548.45,70.29254876205638,57.92900959489788,NaN,NaN,253.89287200646217,119.2396113694576,0.16121144420699152,0.7561740191537183,0.5949625749467268,204930958,188935137.4,64.15513934936621,61.18164130626716,NaN,NaN,19.224840933334857,14.077453782458353
2016-06-08T09:30:00-04:00,69.97,70.26,69.2,69.39,18129711,14158465.05,68.86537221059066,59.059600172545906,NaN,NaN,238.50624566861023,151.64270154477546,0.22236980193856126,0.8729248273699284,0.6505550254313671,186801247,187076068.8,62.16269862296056,61.896758133885534,NaN,NaN,22.14435465931041,15.229868193437218
2016-06-09T09:30:00-04:00,68.59,69.21,68.52,68.86,12340597,14064756,64.21442331250404,59.85427752574261,NaN,NaN,148.35177774278256,169.40668343068637,0.20929133545393408,0.9121691947487847,0.7028778592948506,174460650,185318879,60.257785956902204,62.38923716237515,NaN,NaN,23.168782019608265,16.363998740033082
2016-06-10T09:30:00-04:00,68.15,68.59,67.28,67.37,14490191,14165407.2,53.31329866930388,59.721848158582716,NaN,NaN,58.93739551697575,170.13486678749433,0.08862628602740352,0.813660716829105,0.7250344308017015,159970459,183095197,57.84216686220421,62.457092317475194,NaN,NaN,20.39796008431514,16.940278932073376
2016-06-13T09:30:00-04:00,67.04,68.08,66.97,67.17,11587863,14126207.8,52.03634852031427,59.578492355702494,NaN,NaN,27.993476776206826,145.5363535422075,-0.01102369891649646,0.7112548071560809,0.7222785060725774,148382596,174909182,49.910070119396465,61.889842889262944,NaN,NaN,17.79805378677809,17.06281819703119
2016-06-14T09:30:00-04:00,66.89,67.47,66.37,67.13,12202474,14049947.15,51.769278475252854,59.28195891263123,NaN,NaN,-8.14167577013155,93.12944398688876,-0.08204208024704407,0.6197259057637723,0.7017679860108164,136180122,161159014.8,39.9899956622352,60.57748594943375,NaN,NaN,15.656377891859123,16.86189815343518
2016-06-15T09:30:00-04:00,66.88,67.775,66.495,66.9708,16829530,14099556.7,50.6549630955641,58.519214989795955,NaN,NaN,-3.7190593645742793,44.68438298025187,-0.1388119012482164,0.5282531094505458,0.6670650106987622,119350592,147668883.8,33.049578855130406,58.46241168794211,NaN,NaN,13.574423579796271,16.392258928629623
2016-06-16T09:30:00-04:00,66.25,66.75,65.34,66.65,19993692,13951652.65,48.39444739785728,57.74423200602676,NaN,NaN,-76.12906297720818,-0.21178516374628203,-0.19367158692208364,0.4249755270461577,0.6186471139682413,99356900,132648133.8,27.35641684428174,55.842640479426414,NaN,NaN,11.161398644957545,15.644993173819326
2016-06-17T09:30:00-04:00,66.9,67.02,66.5,66.89,17435936,13980706.95,50.18547820057338,57.08200388675878,NaN,NaN,-37.25402188238958,-19.45006864361934,-0.20822783881263063,0.3583623154524531,0.5665901542650837,116792836,124012609.2,24.719979194142894,52.94048035689218,NaN,NaN,9.622508012139676,14.784638150722234
2016-06-20T09:30:00-04:00,67.85,68,67.41,67.47,10913235,14034693.1,54.31222711421545,56.864063184977674,NaN,NaN,31.340306482573503,-18.780702702346,-0.17458701737507298,0.34835638254624257,0.5229433999213156,127706071,119877304.2,23.549551891123826,49.89480664096057,NaN,NaN,9.440611792482247,14.021205813830807
2016-06-21T09:30:00-04:00,67.32,68.41,67.12,68.27,11222301,14082181.55,59.31830699235576,56.99484322643931,NaN,NaN,51.97612027621261,-6.757143493077175,-0.09806290638870097,0.4003647669354393,0.4984276733241403,138928372,120426954.2,24.064195178729875,46.78806963807849,NaN,NaN,10.785499501401386,13.55896205491232
2016-06-22T09:30:00-04:00,68.57,68.57,67.83,67.89,10258224,14029947.5,56.169976456885585,56.95780704134161,NaN,NaN,59.31272778299163,5.849213936436007,-0.07375323875361017,0.40623612488212757,0.47998936363573774,128670148,122290865.4,25.886197976317746,43.9983109863314,NaN,NaN,10.989901588820326,13.191953416899178
2016-06-23T09:30:00-04:00,68.6,69.03,68.34,69.01,9538468,13793465.8,62.48924098691632,57.53995841978038,NaN,NaN,109.53949654092538,42.98292584006272,0.012449668679869685,0.49555144948557484,0.48310178080570515,138208616,130061208.6,33.0934654798787,41.928673720005676,NaN,NaN,13.205894981893271,13.193945069041192
2016-06-24T09:30:00-04:00,66.35,67.545,66.29,66.78,26879900,14601620.75,47.73275741102734,56.410619114672684,NaN,NaN,-58.265504385191306,38.780629339502376,-0.08089038820595051,0.38198879554826703,0.46287918375421755,111328716,128968384.6,32.61311466440378,39.90359690407671,NaN,NaN,9.879441645107931,12.720444579907868
2016-06-27T09:30:00-04:00,65.87,65.93,64.11,64.64,21824749,15229923.15,38.368973145424896,54.13036371348472,NaN,NaN,-197.68369491325416,-7.024170939663174,-0.27594350148203217,0.11794980690167733,0.3938933083837095,89503967,121327963.8,29.400072510968215,37.421092129905425,NaN,NaN,3.1090322944690305,11.347385681988033
2016-06-28T09:30:00-04:00,65.85,66.45,65.475,66.44,14550432,15187138.55,47.668147667959964,52.61627624615396,NaN,NaN,-93.72373313665697,-36.164141622237096,-0.27245285498714755,0.05332723964977504,0.3257800946369226,104054399,114353169.2,26.803968584920426,34.8954685557597,NaN,NaN,1.43336257325841,9.93109666645523
2016-06-29T09:30:00-04:00,66.85,68.1,66.85,67.7,16354428,15170077.05,53.01266546353804,51.81615068551353,NaN,NaN,8.68146736541303,-46.290393705752805,-0.17854237505040116,0.10260212582392114,0.2811445008743223,120408827,112700905,26.21345393771051,32.46373055438886,NaN,NaN,2.306970810902726,8.84193582994773
2016-06-30T09:30:00-04:00,67.41,68.28,67.27,68.24,12132268,15134190.9,55.12775202237364,51.94575449644708,NaN,NaN,33.470844831285675,-61.50412404768075,-0.07842322153411735,0.1831154739566756,0.26153869549079295,132541095,111567400.8,25.79362508592159,30.174548998940104,NaN,NaN,3.7612971001278748,8.116130297116321
2016-07-01T09:30:00-04:00,68.16,68.85,68.11,68.6,12678827,15160245.75,56.53252195689928,52.266909741917445,NaN,NaN,72.9318942289406,-35.26464432485437,0.009030559731518506,0.2728268951551911,0.2637963354236726,145219922,118345642,32.73167203669284,28.947520564461268,NaN,NaN,5.364218655339234,7.723000062576737
2016-07-05T09:30:00-04:00,67.68,67.92,66.55,67.22,15069921,15002551.7,50.06256036212231,52.14500130526527,NaN,NaN,-26.842298183631673,-1.0963649789298764,-0.027101858200031304,0.22991901267363346,0.25702087087366476,130150001,126474848.8,39.979553416068015,28.946774689735037,NaN,NaN,4.400946985199832,7.248421051522894
2016-07-06T09:30:00-04:00,66.83,67.555,66.37,67.5092,15897473,15016511,51.319917167653784,52.19249802470024,NaN,NaN,-27.568796111749144,12.13462242605169,-0.032215375410445724,0.2167516516106076,0.24896702702105333,146047474,134873463.8,46.40454537037035,29.900700869395035,NaN,NaN,4.078434486679421,6.795565827973826
2016-07-07T09:30:00-04:00,67.91,68.34,66.35,66.8192,14097789,14814914.9,48.20153984863831,52.178718914041745,NaN,NaN,-17.359351120351718,6.926458728898744,-0.08003561861617142,0.14892250375083904,0.22895812236701046,131949685,137181635.4,48.05043380753934,31.378844938199155,NaN,NaN,2.796196696499486,6.224227380620349
2016-07-08T09:30:00-04:00,67.42,67.95,67.05,67.71,11567902,14776280.15,52.2366320264037,52.325229901601055,NaN,NaN,29.97568606323661,6.227426975288937,-0.05105141381358691,0.16514385510002683,0.21619526891361374,143517587,139376933.8,49.634649980402806,33.15846428007486,NaN,NaN,3.0391259525613763,5.769212890897639
2016-07-11T09:30:00-04:00,68.07,68.39,67.78,67.84,9750386,14539289.9,52.81432174754329,52.21823666112448,NaN,NaN,72.91303229992336,6.223654589485487,-0.023883190992459724,0.18634128017303908,0.2102244711654988,153267973,140986544,50.818897850501166,35.106274705744674,NaN,NaN,3.408523432974824,5.431971539765808
2016-07-12T09:30:00-04:00,68.86,69.82,68.72,69.52,15524539,14736123.7,59.612563416507804,52.23925497713533,NaN,NaN,175.99953232994142,46.792020692200104,0.09969441991118302,0.3348424960544776,0.23514807614329455,168792512,148715046.2,56.15024792640407,37.39813561629284,NaN,NaN,5.977637276991527,5.50992378794091
2016-07-13T09:30:00-04:00,69.32,69.7,68.275,68.92,12546247,14753312.35,56.48267874949001,52.261590855178504,NaN,NaN,124.11656239506486,77.1290923935629,0.13148992768547774,0.3995104857501417,0.26802055806466396,156246265,150754804.4,57.460923006820316,39.653473118471595,NaN,NaN,7.08214924611278,5.734527424822606
2016-07-14T09:30:00-04:00,69.46,69.63,69.07,69.27,10898600,14456765.85,57.8721863761421,51.93180124012321,NaN,NaN,135.03621107080122,107.6082048317935,0.16441850675990877,0.4735436915145499,0.3091251847546411,167144865,157793840.4,61.713857501345885,41.69778683429068,NaN,NaN,8.403226337292141,6.115770126603969
2016-07-15T09:30:00-04:00,69.52,69.682,68.975,69.23,9129529,13913557.7,57.64564792025512,52.639864847925196,NaN,NaN,118.83571315277287,125.38021024970074,0.17106747052279775,0.5229595229081383,0.35189205238534055,158015336,160693390.2,63.33977256728659,43.892548113068024,NaN,NaN,9.398606384152638,6.584746734825207
2016-07-18T09:30:00-04:00,69.03,69.31,68.5899,69.28,9401131,13511817.45,57.8676629074016,54.032628402352096,NaN,NaN,91.24384897409819,129.0463735845357,0.166250023236726,0.559704581431248,0.393454558194522,167416467,163523089,64.90609877667268,46.428692846332616,NaN,NaN,10.274801746972516,7.111897450846251
2016-07-19T09:30:00-04:00,69.11,69.22,68.63,68.8892,6991909,13315751.15,55.422328534348104,54.58649846423697,NaN,NaN,72.67449254915563,108.38136562837856,0.12598844655092156,0.550940116383174,0.4249516698322524,160424558,161849498.2,63.18658485750213,49.02745115151702,NaN,NaN,10.36393704001028,7.576474535012541
2016-07-20T09:30:00-04:00,68.61,69.13,68.04,68.79,11554953,13332383.75,54.78942019984516,54.71340951683033,NaN,NaN,48.90723761348786,93.33950067206315,0.08394383221795004,0.52988146010469,0.4459376278867399,148869605,160374166.2,61.63640302950443,51.55766180093087,NaN,NaN,10.272986505751119,7.961690530832338
2016-07-21T09:30:00-04:00,68.6,69.23,67.94,68.11,9256914,13282318.25,50.529667284229326,54.38497489267717,NaN,NaN,30.933757802194478,72.5190100183418,0.005729068470642196,0.45309896347504264,0.44736989500440044,139612691,154867731.4,56.10396293852617,53.72268593325977,NaN,NaN,9.042883031930357,8.11614660241777
2016-07-22T09:30:00-04:00,68.26,68.43,67.881,68.32,7990615,13204925.6,51.77659321881137,54.04526569709946,NaN,NaN,18.198141981164763,52.39149578402019,-0.03427163394611693,0.4045303525717543,0.4388019865178712,147603306,152785325.4,54.12535485627198,55.25080613465828,NaN,NaN,8.323572257288937,8.145778838827937
2016-07-25T09:30:00-04:00,67.87,68.02,66.71,66.96,12771664,12499513.8,44.03548850597011,53.61476056451716,NaN,NaN,-55.642269681033724,23.0142720529938,-0.14833922033909458,0.253377961094003,0.4017171814330976,134831642,146268360.4,48.375506032554654,55.8505170358359,NaN,NaN,5.381955295626495,7.7509469040848735
2016-07-26T09:30:00-04:00,66.57,67.41,66.53,67.35,12393898,12027971.25,46.50544569702704,53.27086974518669,NaN,NaN,-84.35533571369452,-8.391693599576229,-0.19083187655789835,0.16317733573572468,0.35400921229362303,147225540,143628556.8,46.23301601657931,55.83826493913654,NaN,NaN,3.596533104624152,7.157459218447627
2016-07-27T09:30:00-04:00,67.44,67.93,66.4,66.69,16177902,12109344.75,43.04329306013904,52.902423546008166,NaN,NaN,-101.50624201295138,-38.47438952486408,-0.2528088204861354,0.03799818668595378,0.2908070071720892,131047638,140064163.4,43.43571648305159,55.50864227310171,NaN,NaN,1.032374942820297,6.282447179072294
2016-07-28T09:30:00-04:00,66.61,67.02,66.23,66.7,10863457,11834796.2,43.112396677994184,52.250692449693204,NaN,NaN,-122.16965131109853,-69.09507134752268,-0.2804151674668088,-0.05971195216142178,0.220703215305387,141911095,140523844.2,43.9070738082384,55.09952968937568,NaN,NaN,-1.0422585095751522,5.236060652122659
2016-07-29T09:30:00-04:00,65.75,67.46,65.69,67.38,16501788,12053272.2,47.75433897648095,51.88926510890304,NaN,NaN,-94.57228181932206,-91.64915610762004,-0.2416345621771788,-0.0813399874160865,0.1602945747610923,158412883,142685759.6,46.178661357594535,54.76808422559663,NaN,NaN,-1.5790692043384438,4.262470672628216
2016-08-01T09:30:00-04:00,66.79,66.84,64.93,65.16,30648522,12951756.95,37.10841709846817,50.28182608618592,NaN,NaN,-160.84095524361754,-112.6888932201368,-0.34779733577107363,-0.2744520949527498,0.07334524081832386,127764361,141272303.4,44.89845172177745,53.96438449669473,NaN,NaN,-5.650481478130455,2.8463346510912633
2016-08-02T09:30:00-04:00,65.62,66.07,64.57,65.75,25600076,13478264.7,40.880530054333384,49.16738689367474,NaN,NaN,-152.8978433703363,-126.39739475146516,-0.35912224740379534,-0.3755575684364203,-0.016435321032624975,153364437,142500082.8,46.291310165722145,53.16655500804485,NaN,NaN,-7.76493411911235,1.330439112490747
2016-08-03T09:30:00-04:00,65.76,67.05,65.5,67.02,23905616,13878671.85,48.09694471033024,48.46915534611674,NaN,NaN,-79.1260531224902,-121.92135697337292,-0.26619643025184625,-0.3491808588474328,-0.08298442859558654,177270053,151744565.8,55.427360807891354,52.717519529940965,NaN,NaN,-7.170665954876487,0.115995531438285
2016-08-04T09:30:00-04:00,66.77,67.38,66.54,66.92,16790222,14013293.5,47.60420537780549,47.75190945022748,NaN,NaN,-51.008000468922425,-107.6890268049377,-0.19962308477728977,-0.33251328456719875,-0.13289019978990899,160479831,155458313,58.48268691871047,52.370584840756955,NaN,NaN,-6.860801708790877,-0.8806897885944525
2016-08-05T09:30:00-04:00,66.96,67.62,66.84,67.53,11426779,14006237.35,50.90808512997654,47.254796751839976,NaN,NaN,-25.887579093576456,-93.95208625978859,-0.1072913200945804,-0.2670043499081345,-0.1597130298135541,171906610,158157058.4,60.59646166441049,52.06275361845251,NaN,NaN,-5.566503264763726,-1.5500917137614914
2016-08-08T09:30:00-04:00,68,68.89,67.98,68.43,21663404,14601888.25,55.37870111907514,47.25168050789191,NaN,NaN,40.4836375093038,-53.68716770920431,0.01509680017704354,-0.14084202959224967,-0.1559388297692932,193570014,171318189,68.90970171973412,52.47154768004051,NaN,NaN,-3.0270880303973464,-1.7610911875666135
2016-08-09T09:30:00-04:00,68.62,68.73,67.8001,68.07,11128358,14382079.2,53.2882800574524,47.14445621200671,NaN,NaN,31.44683189218941,-16.818232656699177,0.0694632092703806,-0.06910981818131745,-0.13857302745169806,182441656,177133632.8,71.74622249017142,53.19367764151672,NaN,NaN,-1.5871028964434197,-1.7362357174061573
2016-08-10T09:30:00-04:00,68.21,68.36,67.19,67.33,18036793,14656606.5,49.17883528397022,47.0479682119882,NaN,NaN,-1.1740115535907145,-1.2278243429192852,0.053935917640193926,-0.07115313040145566,-0.12508904804164958,164404863,174560594.8,68.75721253464965,54.09748118409697,NaN,NaN,-1.6154466383917911,-1.7189801346898193
2016-08-11T09:30:00-04:00,67.62,68.61,67.47,68.32,17429739,14983163.45,54.26076337577949,47.22540893748593,NaN,NaN,40.18110453273622,17.009996657412454,0.10569620228553005,0.007031204815262981,-0.09866499747026707,181834602,178831549,70.92265416077949,55.29728827727608,NaN,NaN,-0.03153763552314523,-1.4779169205231515
2016-08-12T09:30:00-04:00,68.5,68.91,68.32,68.7,10189672,15036170.6,56.07634371607971,48.085470023922326,NaN,NaN,82.85838257413263,38.759188990954264,0.15774799855853516,0.0985200007279019,-0.05922799783063327,192024274,182855081.8,72.83297414000538,57.04425028495114,NaN,NaN,1.824159413527633,-1.006191729944468
2016-08-15T09:30:00-04:00,69.09,69.39,68.89,69.25,10703381,15101283.1,58.63561823835738,48.95191091973164,NaN,NaN,122.08501491351805,55.07946447179711,0.21774333075125094,0.21295116560843041,-0.004792165142820527,202727655,184686610,73.68062626332414,59.00479387400434,NaN,NaN,4.163789067784228,-0.26762304455465435
2016-08-16T09:30:00-04:00,69.13,69.58,68.71,69.36,10242759,15263825.6,59.14829456001758,50.10226816972296,NaN,NaN,121.86420711710058,73.16293951677935,0.25099640973993764,0.30895334703210153,0.0579569372921639,212970414,190792361.6,76.33187029645002,61.35451914638994,NaN,NaN,6.2131802540981305,0.6582059981100292
2016-08-17T09:30:00-04:00,69.02,69.61,68.95,69.57,14719471,15422051.5,60.16339800485339,51.3201968359272,NaN,NaN,125.977577492691,98.59325732603568,0.27155447594780985,0.3974000322269262,0.12584555627911637,227689885,203449366,80.67718333568659,63.98095554120767,NaN,NaN,8.206704451894478,1.736562920079236
2016-08-18T09:30:00-04:00,69.81,71,69.74,71,24148544,16166633,66.3036284915426,52.64514608700303,NaN,NaN,181.43336869411158,126.84371015831076,0.36031648856376297,0.5762411669838201,0.21592467842005714,251838429,217450131.4,84.14482163541851,66.69282413248081,NaN,NaN,11.980013284547132,3.1999129721460786
2016-08-19T09:30:00-04:00,70.77,70.77,70.15,70.41,11045741,16319389.3,62.0537997950444,54.42695913675847,NaN,NaN,148.38002919469687,139.9480394824236,0.3574414470110313,0.6627264871838463,0.305285040172815,240792688,227203814.2,86.02621247748212,69.63052132931685,NaN,NaN,13.881297910149504,4.7258251061465675
2016-08-22T09:30:00-04:00,69.8,69.93,69.28,69.6,14136701,16387641.15,56.68225797058109,55.55565398791902,NaN,NaN,89.50404407576615,133.43184531487321,0.2824262222384994,0.6583178179709392,0.37589159573243985,226655987,231989480.6,86.85067305558837,72.52761867859302,NaN,NaN,13.862473525181082,6.03106059458007
2016-08-23T09:30:00-04:00,69.6,70.27,69.6,70.0892,12456241,16390758.3,58.99110299405937,56.33380815104253,NaN,NaN,98.79027747495469,128.81705938644404,0.24839555259324064,0.6863860364739907,0.43799048388075,239112228,237217843.4,87.70420604969462,74.83310762443611,NaN,NaN,14.545750977840557,7.247444935045854
2016-08-24T09:30:00-04:00,69.7,70.16,69.625,69.81,16452642,16404495.3,57.11986180199272,57.01349789562733,NaN,NaN,83.74249996683619,120.37004388127309,0.19223351544767675,0.678282378190346,0.48604886274266923,222659586,236211783.6,86.54014125985526,76.83721150594646,NaN,NaN,14.557790189624972,8.2917799714143
2016-08-25T09:30:00-04:00,69.7,69.91,69.39,69.62,11895847,16456114.8,55.82216627111884,57.36450369142322,NaN,NaN,65.71981316477576,97.22733277540593,0.1303984692452853,0.6490469492992759,0.5186484800539906,210763739,227996845.6,77.4953685597546,78.04427628418532,NaN,NaN,14.19864691917197,9.135618106808254
2016-08-26T09:30:00-04:00,69.74,70.28,69.05,69.38,14575065,16359778.65,54.14870352805199,57.276646720635846,NaN,NaN,56.53615839569331,78.8585586156052,0.06476109849084499,0.5995998531675468,0.5348387546767018,196188674,219076042.8,69.05503275732167,78.05465707258442,NaN,NaN,13.431738459209608,9.749349585722733
2016-08-29T09:30:00-04:00,69.18,69.91,69.1,69.85,7393983,15197051.7,56.875216624357456,57.53285647541479,NaN,NaN,53.78012484805126,71.71377477006222,0.04534426147325543,0.5915190815182712,0.5461748200450157,203582657,214461376.8,65.10484015047871,77.58027261974924,NaN,NaN,13.517586197590811,10.287669101703887
2016-08-30T09:30:00-04:00,70.01,70.28,69.345,69.61,7132867,14273691.25,55.07426219823427,57.953958397862216,NaN,NaN,56.230340726502796,63.20178742037184,0.010501532188011642,0.5593017352800302,0.5488002030920186,196449790,205928889.2,58.447387092237406,76.8438565167198,NaN,NaN,13.099050815301835,10.68929506078931
2016-08-31T09:30:00-04:00,69.22,69.32,68.13,68.51,13232792,13740050.05,47.629930233550745,57.480327459131594,NaN,NaN,-30.833668029136984,40.28655382117721,-0.08709046007668697,0.4399371279961599,0.5270275880728469,183216998,198040371.6,53.04660283815764,75.56699570796108,NaN,NaN,10.50563928282102,10.663058521079554
2016-09-01T09:30:00-04:00,68.22,68.475,67.77,68.31,16668518,13733964.85,46.40182908514766,56.78929069977931,NaN,NaN,-80.3208081820866,11.078429551804756,-0.16126214701303576,0.3254499043065522,0.48671205131958795,166548480,189197319.8,47.722941876644455,73.77342197486387,NaN,NaN,8.001607178816169,10.282851186470499
2016-09-02T09:30:00-04:00,68.98,69.25,68.65,69.08,10794394,13702345.6,51.578363095979455,56.285201046752306,NaN,NaN,-19.26996227475019,-4.082794582283949,-0.15459555494801586,0.29346760763456814,0.448063162582584,177342874,185428159.8,45.621351607720435,71.76918807089218,NaN,NaN,7.287252665138127,9.854908540565875
2016-09-06T09:30:00-04:00,69.26,70.1775,69.2,70.12,12844055,13261378.15,57.54277953963054,56.17052140243895,NaN,NaN,59.62384479252102,-2.914050593389997,-0.08002744570276177,0.34802885545413176,0.4280563011568935,190186929,182749014.2,44.13361261503847,69.46931252221994,NaN,NaN,8.499903487948533,9.661336390191968
2016-09-07T09:30:00-04:00,70.44,70.67,70.13,70.52,15094546,13459687.55,59.60379114113931,56.13054948360222,NaN,NaN,113.5247282807948,8.544826917468402,-0.007469870571191417,0.4187189629429042,0.42618883351409564,205281475,184515351.2,45.39785468388879,66.94936047566294,NaN,NaN,10.137287193270675,9.729329362060355
2016-09-08T09:30:00-04:00,70.97,71.94,70.63,71.84,18005348,13458115.3,65.54739161276925,56.07653256368979,NaN,NaN,209.18665534254734,56.54889159180527,0.11875322880263833,0.5746303695173935,0.4558771407147552,223286823,192529316.2,50.83413555745769,64.5700257558086,NaN,NaN,13.591172827572967,10.281021285705014
2016-09-09T09:30:00-04:00,71.17,71.39,69.7,69.7,21771832,13675219.95,52.15079554203856,55.36917511704651,NaN,NaN,70.7168305063492,86.75641932949243,0.050916236215703736,0.5195224359843849,0.4686061997686811,201514991,199522618.4,55.04073288439914,62.356777213445525,NaN,NaN,11.90674925324374,10.513268138210547
2016-09-12T09:30:00-04:00,69.21,70.75,69.08,70.39,21972895,14264381.1,55.321512750254755,55.27197902988035,NaN,NaN,42.09070894429986,99.02855357330243,0.04549020500557355,0.525468956025648,0.4799787510200745,223487886,208751620.8,59.91496969284899,60.43279840182129,NaN,NaN,11.700409832924185,10.682859808883924
2016-09-13T09:30:00-04:00,69.62,69.65,68.18,68.38,24580364,14958230.25,45.80047258361281,54.329791143419875,NaN,NaN,-117.4396183122837,63.61586095234149,-0.09294477687931596,0.36379777992092954,0.4567425568002455,198907522,210495739.4,60.780330593013176,58.509664440629756,NaN,NaN,7.872469586379026,10.281375491383224
2016-09-14T09:30:00-04:00,68.3,69.12,67.397,67.57,26470159,15769600.25,42.61736996680957,53.293898869478234,NaN,NaN,-176.4149041664517,5.6279344628921875,-0.230697165203681,0.16837110029564428,0.3990682654993253,172437363,203926917,55.88681888212146,56.32014141364876,NaN,NaN,3.7022502255416088,9.341500453405851
2016-09-15T09:30:00-04:00,67.84,68.905,67.73,68.41,17233999,15895326.65,46.75046552459024,52.645920244726184,NaN,NaN,-124.70517852838859,-61.150432311295006,-0.25497555848348974,0.08034881739496313,0.3353243758784529,189671362,197203824.8,51.33160620556129,54.45130124549211,NaN,NaN,1.854902013808818,8.271986390606276
2016-09-16T09:30:00-04:00,67.01,67.7,67.01,67.45,17394405,15557619.7,42.943579546289925,51.8455542460289,NaN,NaN,-176.37405666101802,-110.56860974476845,-0.3211485905298411,-0.06611136228384851,0.2550372282459926,172276957,191356218,47.69056561647875,52.92526787828904,NaN,NaN,-0.9834704425857645,6.949778271578842
2016-09-19T09:30:00-04:00,68,68.185,67.4,67.41,11797513,15595208.3,42.78723899678058,50.83927012977341,NaN,NaN,-129.48731712733644,-144.8842149590957,-0.3506672575236821,-0.18329684365861,0.1673704138650721,160479444,178754529.6,40.949553673125585,51.19989027276382,NaN,NaN,-3.205071970108422,5.499085379909234
2016-09-20T09:30:00-04:00,67.33,67.79,66.87,66.92,14132935,15595020,40.82642879981596,49.8215677441721,NaN,NaN,-140.15654092380257,-149.42759948139945,-0.3835829684199098,-0.3121082966598152,0.07147467176009462,146346509,168242327,36.335586813842475,49.620475967164175,NaN,NaN,-5.633064070159848,3.9087783156136506
2016-09-21T09:30:00-04:00,67.5,68.5,67.42,68.47,20260887,15985252.3,48.81683301687456,49.90634651440951,NaN,NaN,-66.81019639844438,-127.50665792779799,-0.2858400873027518,-0.2858254373683451,0.000014649934406682497,166607396,167076333.6,35.85304122286621,48.392364423214794,NaN,NaN,-5.148216042110473,2.614921978795919
2016-09-22T09:30:00-04:00,69.21,69.46,68.491,68.55,13315915,15828415.95,49.19813023659573,50.106082310941524,NaN,NaN,-14.83679436499667,-105.53298109511961,-0.20448725376327825,-0.2555944172696911,-0.05110716350641288,179923311,165126723.4,35.015694551589704,47.484703899996596,NaN,NaN,-4.649794353312534,1.5771053599232827
2016-09-23T09:30:00-04:00,68.22,68.84,67.25,67.64,23075178,16387382.5,45.083852610164925,49.642188704811915,NaN,NaN,-73.86298811049302,-85.03076738501463,-0.200385453845481,-0.30158898081326413,-0.10120352696778313,156848133,162040958.6,33.6751283281764,46.631402237172026,NaN,NaN,-5.505382726796966,0.5653213475346759
2016-09-26T09:30:00-04:00,67.87,68.23,67.21,67.34,13240154,16320636.95,43.78391027653082,48.659412328876215,NaN,NaN,-87.65162803675712,-76.66362956689875,-0.2055326344182134,-0.3581193199905499,-0.1525866855723365,143607979,158666665.6,32.22238828351492,45.78060049920605,NaN,NaN,-6.591324131165385,-0.4570565779939042
2016-09-27T09:30:00-04:00,66.67,67.07,66.14,66.89,19410216,16921448.6,41.83531325881081,47.39023533728132,NaN,NaN,-133.8590174847717,-75.40412487909256,-0.22531127219278457,-0.4342257758133172,-0.20891450362053265,124197763,154236916.4,30.37011076663555,44.70719021940225,NaN,NaN,-8.071231862888187,-1.5447959044073731
2016-09-28T09:30:00-04:00,67.28,69.88,66.71,69.78,41143437,18621977.1,55.524998725488686,46.674350131047,NaN,NaN,9.046979071354087,-60.23268978513288,-0.03955926789213979,-0.2583635884857074,-0.2188043205935676,165341200,153983677.2,30.2630089314533,43.237824031830506,NaN,NaN,-4.792436189568721,-2.00874451657328
2016-09-29T09:30:00-04:00,69.73,70.45,69.03,69.66,27001560,19310415.5,54.946711144355106,46.87405838835532,NaN,NaN,66.5811346324227,-43.94910398564902,0.0732769295473456,-0.12720815865938562,-0.20048508820673122,138339640,145666943,26.907004949058816,41.22827203644906,NaN,NaN,-2.4475594075648295,-2.0714323581435012
2016-09-30T09:30:00-04:00,70.15,70.98,69.7,70.61,14714527,19212715.95,58.62091488855447,47.109729969662446,NaN,NaN,100.74658418818836,-9.027189525912737,0.2026137392774657,0.052782085890100916,-0.1498316533873648,153054167,144908149.8,26.6169872187741,38.849844716872276,NaN,NaN,0.7230898649968254,-1.6722148976948832
2016-10-03T09:30:00-04:00,70.73,70.84,69.97,70.56,13154939,19330743.2,58.351192155540474,48.006209939085856,NaN,NaN,90.40413278247685,26.583962637934054,0.2712333023223766,0.18920997451560595,-0.08202332780677063,139899228,144166399.6,26.318354866970125,36.38827502215492,NaN,NaN,3.1416952760377663,-0.9845134443045047
2016-10-04T09:30:00-04:00,70.62,70.79,69.555,69.84,11852813,19281181.1,54.46495513016014,48.85246602218232,NaN,NaN,66.01196931357313,66.55815999760303,0.25482329023158534,0.23650578498271102,-0.018317505248874294,128046415,144936130,27.230767735309414,34.34141422595406,NaN,NaN,4.027667630073245,-0.26848757653625477
2016-10-05T09:30:00-04:00,70.55,71.235,70.48,70.91,13351152,19194011.4,58.851015803004024,49.71679104206902,NaN,NaN,108.98421570498128,86.54560732432847,0.29963145210213105,0.3562218098787895,0.05659035777665847,141397567,140147403.4,25.1446280246533,32.47091578446064,NaN,NaN,6.161119001053423,0.6500276488336992
2016-10-06T09:30:00-04:00,71.12,71.35,70.38,71.02,11175779,18852532.95,59.285200742297974,50.88404969892673,NaN,NaN,116.12032899573323,96.45344619699055,0.318513183577782,0.454731837248886,0.13621865367110397,152573346,142994144.6,28.64428051031831,31.110466848306316,NaN,NaN,8.004895272958628,1.7007230237086888
2016-10-07T09:30:00-04:00,71.03,71.33,70.4,70.61,11744430,18351162.85,56.87627912999734,51.89040970844221,NaN,NaN,103.94833505749877,97.09379637085263,0.2862437780366608,0.49402337621692993,0.20777959818026917,140828916,140549094.4,27.45693141942121,30.146708115898864,NaN,NaN,8.863124165931684,2.723923186883402
2016-10-10T09:30:00-04:00,71.31,71.98,71.24,71.72,11534499,17829243.05,61.44393035498604,53.36308839095437,NaN,NaN,137.3196406004812,106.47689793445352,0.31995588786828444,0.6077244580156247,0.28776857014734025,152363415,143041931.8,30.61482888433754,29.738082549505652,NaN,NaN,10.998509255538085,3.906006910976928
2016-10-11T09:30:00-04:00,71.47,71.59,70.51,70.9,13712236,17285836.65,56.668687944775584,53.92393517151873,NaN,NaN,90.85372100771573,111.44524827328205,0.2693593534002122,0.6244677618976056,0.35510840849739334,138651179,145162884.6,33.276195111700005,29.55402211299378,NaN,NaN,11.396561642045748,4.976086158272474
2016-10-12T09:30:00-04:00,70.6,70.845,70,70.6,10439113,16484284.35,54.98503329965567,54.33728539030873,NaN,NaN,59.25961438582214,101.50032800945021,0.20114340869159292,0.6065376693618845,0.40539426067029155,128212066,142525784.4,31.650643249991035,29.313661305736733,NaN,NaN,11.232131094391427,5.869806863432324
2016-10-13T09:30:00-04:00,70.16,70.57,69.29,70.21,13543379,16299753.35,52.78927958430982,54.887673031319075,NaN,NaN,33.617970706289064,84.99985635156138,0.11925791527287422,0.5544666547613843,0.43520873948851013,114668687,134944852.6,27.492811065939165,28.872067215576937,NaN,NaN,10.464089854248403,6.526133004977479
2016-10-14T09:30:00-04:00,70.57,70.8,69.75,69.8,11372449,15998655.55,50.50586444720261,55.36781261493849,NaN,NaN,33.60406598097211,70.93100253625605,0.031549020231561975,0.4746450147779626,0.44309599454640064,103296238,127438317,24.114740953877885,28.292949549174292,NaN,NaN,9.166163785239243,6.903280259300588
2016-10-17T09:30:00-04:00,69.82,70.04,69.0782,69.46,7425014,15780030.6,48.62741268558544,55.85296257399382,NaN,NaN,-1.8559926084355687,43.0958758944727,-0.05081669505019898,0.37957512573365193,0.4303918207838509,95871224,116139878.8,20.109610089700084,27.560056643678898,NaN,NaN,7.542692702657903,6.994624894065918
2016-10-18T09:30:00-04:00,70.15,70.3,69.43,69.74,6945066,15420637.15,50.267848651484194,55.477451854422064,NaN,NaN,8.562520149427995,26.63763572281515,-0.08583288878116735,0.3231007098073917,0.40893359858855904,102816290,108972901,18.060496119742808,26.688448585699575,NaN,NaN,6.606594006919508,6.939191910187859
2016-10-19T09:30:00-04:00,70.28,71.27,70.21,70.73,14315902,15123387.9,55.65915107060628,55.52834042058287,NaN,NaN,63.08868184515495,27.403449214681707,-0.043829541153602936,0.3541466721465554,0.3979762133001583,117132192,106756926.2,17.467823715917262,26.014221354760895,NaN,NaN,7.288454619538172,6.98908658295219
2016-10-20T09:30:00-04:00,70.31,70.945,69.92,70.65,12494518,15082318.05,55.13896996687835,55.279630069034575,NaN,NaN,43.18115133842372,29.316085341108636,-0.023938725903659364,0.3680528059205841,0.39199153182424346,104637674,104750723.6,16.926270714204904,25.322027318720238,NaN,NaN,7.708941845236912,7.091923048992864
2016-10-21T09:30:00-04:00,70.19,70.31,69.78,70.19,14238481,14640483.2,52.12252131118536,54.83472500872349,NaN,NaN,6.710003447562344,23.937272834426686,-0.04314647801255461,0.3380584343085502,0.3812049123211048,90399193,102171314.6,16.229580721144004,24.60140059401837,NaN,NaN,7.247240147435001,7.1141112059131695
2016-10-24T09:30:00-04:00,70.19,70.43,69.2101,69.98,10668445,14511897.75,50.757364626878775,54.56989711563197,NaN,NaN,-25.84883156119565,19.138705043874673,-0.06980079706655329,0.2939539159879132,0.3637547130544665,79730748,98943219.4,15.376581022848455,23.75467297169973,NaN,NaN,6.489381044776363,7.024864040036483
2016-10-25T09:30:00-04:00,69.96,70.71,69.54,69.66,13227127,14202743.3,48.66568441987791,53.84237344540867,NaN,NaN,-43.504327662136006,8.72533548156187,-0.10658606945296845,0.23052212623825596,0.3371081956912244,66503621,91680685.6,13.639689919964681,22.932891678507684,NaN,NaN,5.276103879928366,6.775041160021037
2016-10-26T09:30:00-04:00,69.04,70.115,68.92,69.82,17867803,13038961.6,49.7800487351408,53.163434016326015,NaN,NaN,-105.68141874516907,-25.028684636502938,-0.1169174725107685,0.1909613550527638,0.3078788275635323,84371424,85128532,12.290808288075638,21.76478651977607,NaN,NaN,4.530248036022607,6.454356428021262
2016-10-27T09:30:00-04:00,70.12,70.22,69.535,69.56,14206305,12399198.85,47.95816755482408,52.526426046670785,NaN,NaN,-83.96315068816392,-50.45754504182046,-0.13666345378347083,0.13704951033419377,0.2737129641176646,70165119,78234021,11.052230314855066,20.5930221551642,NaN,NaN,3.4109225845653084,6.019580164670411
2016-10-28T09:30:00-04:00,69.44,70.43,68.93,69.37,18558383,12591391.65,46.61552547962542,51.46725426985931,NaN,NaN,-100.17957713263941,-71.8354611578608,-0.1564964732010147,0.07809237261639623,0.23458884581741093,51606736,70475529.6,9.849383178090491,19.109776033289414,NaN,NaN,2.100236592445734,5.459673940066886
2016-10-31T09:30:00-04:00,69.12,69.49,68.5,68.62,12973835,12582336.45,41.65776048647092,50.39504516569469,NaN,NaN,-171.05976945920156,-100.877648737462,-0.21072557141063558,-0.028818118445883556,0.18190745296475203,38632901,62255960.2,8.761470623959369,17.35872428416508,NaN,NaN,-0.4647863292494446,4.613322473021696
2016-11-01T09:30:00-04:00,69.13,69.37,67.8789,68.63,18824788,12930935.2,41.74672138192616,49.449451457285434,NaN,NaN,-173.88412137013776,-126.95360747906234,-0.2346889758027951,-0.11145376678874186,0.12323520901405324,57457689,60446773.8,8.53792999145601,15.707816194269723,NaN,NaN,-2.5839692832802363,3.585137936407134
2016-11-02T09:30:00-04:00,67.98,68.22,67,67.87,22982983,13412526.75,37.11479743309425,48.32984558934147,NaN,NaN,-235.40561785796294,-152.89844730162113,-0.28703092588925605,-0.2355534483475168,0.05147747754173923,34474706,50467430.2,7.414233397000132,14.273632075059794,NaN,NaN,-5.838668036053101,2.2388799403413864
2016-11-03T09:30:00-04:00,67.87,68.26,67.5,68.14,12748063,13491140.95,39.675548055387736,47.55625156135469,NaN,NaN,-176.92731863273704,-171.49128089053573,-0.28802975184593255,-0.30855971226567647,-0.02052996041974392,47222769,45878960.2,6.9606110456288945,13.048337081613436,NaN,NaN,-7.934542626904915,0.7855338593062005
2016-11-04T09:30:00-04:00,67.8,68.46,67.36,67.77,17554079,13781623.4,37.42639278912376,46.75617871160743,NaN,NaN,-156.6617104475563,-182.7877075535191,-0.29698216894894897,-0.3917576716059301,-0.09477550265698116,29668690,41491351,6.548052962255923,12.079654429653136,NaN,NaN,-10.381898184821397,-0.8098135755691704
2016-11-07T09:30:00-05:00,68.54,69.27,68.54,69.23,14799517,13944874.3,49.57391201202892,46.7066118087892,NaN,NaN,-49.42910991518502,-158.4615756447158,-0.1929872351754554,-0.33600954662630045,-0.14302231145084504,44468207,42658412.2,8.108197661570287,11.3687759683551,NaN,NaN,-8.972384134354996,-1.9758950839671454
2016-11-08T09:30:00-05:00,68.89,69.71,68.79,69.32,11208708,13819697.9,50.21551263921721,46.317780492261406,NaN,NaN,-18.881362118619084,-127.46102379441206,-0.11064101878217003,-0.2813235849285576,-0.17068256614638755,55676915,42302257.4,8.063953659547195,10.697070964328669,NaN,NaN,-7.645758538896335,-2.7858755775284583
2016-11-09T09:30:00-05:00,69.56,70.97,68.75,70.45,25993774,14597430.95,57.52322803272159,46.488084639821636,NaN,NaN,59.12034332154012,-68.55583155851146,0.020442019861086014,-0.14513004132003005,-0.16557206118111606,81670689,51741454,20.452923915181856,10.948974764398448,NaN,NaN,-4.0466772700592415,-2.965990105032856
2016-11-10T09:30:00-05:00,70.4,71.28,70.16,70.75,20634829,14952003.45,59.234079600915386,46.99605308908807,NaN,NaN,117.06523788943394,-9.757320254077262,0.12218551254441637,-0.012840170500595605,-0.13502568304501197,102305518,62758003.8,31.974601892268993,12.073619133764518,NaN,NaN,-0.5699890531948015,-2.6237042404845625
2016-11-11T09:30:00-05:00,70.33,70.4659,68.8901,69.46,17659713,15266366.65,49.92273614698514,46.93643676909567,NaN,NaN,14.042573516533585,24.38353653874071,0.09845741324316795,-0.011953916491052041,-0.11041132973421999,84645805,73753426.8,41.1383833030598,13.91374786806533,NaN,NaN,-0.5093722021123135,-2.3216568064313843
2016-11-14T09:30:00-05:00,69.21,69.92,68.83,69.85,12572005,15523716.2,52.36090502792,47.20038109824153,NaN,NaN,7.057446651169096,35.68084785201154,0.10431928790185377,0.01998778014309721,-0.08433150775875656,97217810,84303347.4,48.33054499784549,16.391666087913958,NaN,NaN,0.3362586240223403,-1.9419546020808522
2016-11-15T09:30:00-05:00,70.46,71.86,70.4,71.82,19228710,16137898.4,62.3363431524639,48.09725927090748,NaN,NaN,163.06559745249086,72.07023976623353,0.2290144399028421,0.20193654211979606,-0.027077897783046034,116446520,96457268.4,55.1321909360464,19.4517648484833,NaN,NaN,4.833098689786357,-0.9740898460998224
2016-11-16T09:30:00-05:00,71.66,72.14,71.1,71.32,16609103,16252558.45,58.961706766048316,48.88322635742349,NaN,NaN,166.8590918390262,93.61798946973076,0.26350366217893795,0.3023016799406264,0.03879801776168845,99837417,100090614,56.956356083453976,22.730630974811795,NaN,NaN,7.1698655913764755,0.1893323592539342
2016-11-17T09:30:00-05:00,71.92,72.39,70.664,70.84,10337975,16144731.3,55.83662939771117,49.541876637286755,NaN,NaN,137.88614020994805,97.78216993383357,0.24032134838921912,0.33919970324821236,0.09887835485899324,89499442,97529398.8,55.251082263388504,25.97360948090451,NaN,NaN,7.970324943451777,1.3009027284250545
2016-11-18T09:30:00-05:00,71.09,71.53,70.73,71.13,11962308,16030922.65,57.30884060827157,50.65981093170109,NaN,NaN,112.0465241901639,117.38296006855964,0.2307987484472076,0.38737679041800277,0.15657804197079517,101461750,100892587.8,57.06875341299541,29.42412968012137,NaN,NaN,9.082380425384784,2.4125423994193014
2016-11-21T09:30:00-05:00,72.13,72.9,72.13,72.82,16875395,16341270.15,64.69498367240573,52.2989725238782,NaN,NaN,183.01297863911543,152.5740664661489,0.31915567524784566,0.5555226360306023,0.2363669607827566,118337145,105116454.8,59.30450114373774,33.050313333855776,NaN,NaN,12.711070684667888,3.883760725883385
2016-11-22T09:30:00-05:00,72.84,73.2,71.9,72.78,16013243,16480575.95,64.41093202036919,54.24869642296927,NaN,NaN,151.4494516729924,150.2508373102492,0.3530977983164378,0.6777392086783038,0.32464141036186606,102323902,102291931.2,57.160785658048724,36.60363849535925,NaN,NaN,15.39326365923553,5.527975430647977
2016-11-23T09:30:00-05:00,72.43,73.3138,72.35,73.08,11461958,16160283.7,65.62979471442551,56.10257118432911,NaN,NaN,140.155894996567,144.91019794175736,0.3720476988090446,0.7897010338731718,0.4176533350641272,113785860,105081619.8,58.74688870660213,40.30265832828591,NaN,NaN,17.93862830797485,7.300925841694673
2016-11-25T09:30:00-05:00,72.77,72.93,72.36,72.72,8791783,15889557.6,62.848181042542066,57.91841320243042,NaN,NaN,110.32330238629824,139.3976303770274,0.3376397494588588,0.8397030218877006,0.5020632724288419,104994077,108180546.8,60.49659338503767,44.15612550134175,NaN,NaN,19.191515701612683,8.999581535968675
2016-11-28T09:30:00-05:00,73.07,73.09,71.58,71.71,18790091,15901143,55.71371549674995,58.356970594196206,NaN,NaN,76.61197418115265,132.31072037522515,0.2293408243339059,0.7887393028462242,0.5593984785123183,86203986,105128994,57.89268349127939,47.712160203463824,NaN,NaN,18.038521703368566,10.290858702740088
2016-11-29T09:30:00-05:00,70.62,71.26,70.07,70.83,18361744,16170538.45,50.35057528769629,58.36661792623043,NaN,NaN,11.557846287498982,98.01969390490186,0.08817925787672265,0.6696225508582216,0.581443292981499,67842242,95030013.4,50.192897854769114,50.721370503122536,NaN,NaN,15.307911045277317,11.007580465959693
2016-11-30T09:30:00-05:00,73.29,75.12,73.29,74.43,44854795,17472038.8,65.13611832442709,58.91039580420938,NaN,NaN,156.44836631143892,99.01947683259115,0.21952210259737925,0.855845921228223,0.6363238186308438,112697037,97104640.4,51.616534302942725,52.94734267367688,NaN,NaN,18.36001765800027,12.057928636251203
2016-12-01T09:30:00-05:00,75.81,76.06,74.55,74.61,27382379,17692008.6,65.68634884752666,59.37127217896733,NaN,NaN,172.21577319094484,105.43145247146671,0.29602347846954324,1.0063531667177728,0.7103296882482295,140079416,102363351.6,55.11840483927826,54.60047145560611,NaN,NaN,20.79525951271853,13.306118761460821
2016-12-02T09:30:00-05:00,74.57,75.18,74.36,74.83,18338849,17971547.9,66.38464791644455,60.547123019642996,NaN,NaN,143.4325556599611,112.05330312619928,0.3360189647534243,1.13035339419001,0.7943344294365856,158418265,113048189.2,61.25456811607393,56.037341799392834,NaN,NaN,22.891519773893116,14.675461763236862
2016-12-05T09:30:00-05:00,75.51,76.0968,75.19,75.49,22535118,18220599.85,68.45843294842064,61.696946442535896,NaN,NaN,155.3777817599548,127.8064646419597,0.37835055408902707,1.2672726220478694,0.8889220679588423,180953383,131998068.6,69.27713789053972,57.533527006013855,NaN,NaN,25.28162095258701,16.190627361715453
2016-12-06T09:30:00-05:00,75.03,75.65,74.575,75.35,16963504,18328799.2,67.50707457956733,62.066284401614716,NaN,NaN,123.7536958100702,150.24563454647395,0.36801080719764256,1.3489355769558955,0.9809247697582529,163989879,151227596,74.94622375562346,58.94881506455507,NaN,NaN,26.867815262919812,17.71593991903036
2016-12-07T09:30:00-05:00,75.18,76.0559,75.18,75.95,16008265,18568777.05,69.46553755649538,62.81655802950379,NaN,NaN,129.7432596724589,144.90461321867795,0.37158601394474466,1.4454072871891839,1.0738212732444392,179998144,164687817.4,78.0055930007519,60.45233198721921,NaN,NaN,28.7959451445107,19.298797808384695
2016-12-08T09:30:00-05:00,76.15,76.4599,75.56,76.36,14600157,17999096.2,70.76237612126279,63.88268279547176,NaN,NaN,127.8383199403389,136.02912256855674,0.3707231499943149,1.5372252107373328,1.1665020607430179,194598301,175591594.4,80.12306449072292,62.228902146314525,NaN,NaN,30.779602357582185,20.938912743984336
2016-12-09T09:30:00-05:00,76.76,76.76,76.16,76.6,8974831,17416096.3,71.52476238589725,64.89810577958788,NaN,NaN,122.33701420891994,131.81001427834855,0.35542986616705674,1.6107893934518387,1.255359527284782,203573132,184622567.8,81.69494203067228,63.987915619005726,NaN,NaN,32.632829211478175,22.609472239340597
2016-12-12T09:30:00-05:00,78.3,78.45,76.64,76.96,16130187,17339620,72.67571574688381,65.46815807062204,NaN,NaN,132.93596208123756,127.32165034260508,0.3387415970309231,1.6787865235734358,1.3400449265425127,219703319,192372555,82.94163039311164,65.67628199396101,NaN,NaN,34.520932201899285,24.311109376848982
2016-12-13T09:30:00-05:00,77.54,78.39,76.83,77.83,16028550,17512447.25,75.27648606853808,66.24426907406267,NaN,NaN,129.40461402804098,128.45183398619923,0.3538287526997166,1.7823308674171585,1.428502114717442,235731869,206720953,84.9810784910855,67.66344576774935,NaN,NaN,36.96115928891168,26.118259364286512
2016-12-14T09:30:00-05:00,77.46,77.77,76.055,76.27,19851365,17543580,63.58890624312118,66.09849132611237,NaN,NaN,87.43173867240075,119.98952978618763,0.23215786503693936,1.7186994460136162,1.4865415809766769,215880504,213897425,85.88974056075577,69.6022209001889,NaN,NaN,35.49493155230649,27.457783962575082
2016-12-15T09:30:00-05:00,75.95,76.725,75.52,76.44,20251775,17725713.6,64.24048347017057,66.1979414995144,NaN,NaN,65.54552276007365,107.5309703501346,0.14102329790981716,1.6628207033639484,1.5217974054541312,236132279,222204220.6,86.8792703054473,71.4866978230753,NaN,NaN,34.51545916455424,28.46602327714353
2016-12-16T09:30:00-05:00,76.58,76.58,76.12,76.51,17864897,18102059.7,64.52201363630454,66.82710565233972,NaN,NaN,66.31845143424216,96.32725779519903,0.06710254250537462,1.6056755835858496,1.538573041080475,253997176,232289029.4,87.9812462619483,73.63588087812307,NaN,NaN,33.803285356172886,29.22848928843344
2016-12-19T09:30:00-05:00,76.43,76.57,76.01,76.16,7113208,17859604.7,61.89800860824386,67.65192231809313,NaN,NaN,56.00177614900322,80.94042060875216,-0.019110240122921285,1.5146852409268234,1.5337954810497447,246883968,237725159.2,88.5399817694325,76.37495830059903,NaN,NaN,32.457509098518315,29.68977783273128
2016-12-20T09:30:00-05:00,76.55,76.65,75.78,75.99,8982113,17464940.6,60.608698845162245,67.32853521243136,NaN,NaN,47.41910629777246,64.54331906269844,-0.096977275163733,1.4125738870950784,1.5095511622588114,237901855,238159156.4,88.58560452821335,79.01560617383267,NaN,NaN,30.978221815597767,29.873841258855066
2016-12-21T09:30:00-05:00,76.15,76.46,75.73,76.11,8102704,17069413.65,61.2227083239625,67.00970374646248,NaN,NaN,41.3161534445109,55.32020201712048,-0.14680328532098952,1.3260470556075745,1.472850340928564,246004559,244183967.4,89.22678842567518,81.45191928714674,NaN,NaN,29.894942230848383,29.87685568342554
2016-12-22T09:30:00-05:00,76.16,76.62,76.01,76.42,10970367,17044834.1,62.83439667745273,66.75611437224877,NaN,NaN,48.88948832759033,51.98899513062381,-0.16398181203226536,1.2678730758882324,1.4318548879204978,256974926,248352496.8,89.65959262426065,83.48084960916006,NaN,NaN,29.37471584355928,29.8051214205875
2016-12-23T09:30:00-05:00,76.3,76.505,76.18,76.35,6398132,16925151.55,62.205680451402614,66.30948919389034,NaN,NaN,44.80461582515253,47.686228008805884,-0.18367396638107336,1.202262429944156,1.3859363963252294,250576794,247668420.4,89.02750555823329,84.89159015685246,NaN,NaN,28.774010102193976,29.65781980367414
2016-12-27T09:30:00-05:00,76.47,76.78,76.4,76.52,10008858,16486089.9,63.16951009613007,65.99966315935912,NaN,NaN,54.722658185848985,47.430404416175044,-0.18817444912628623,1.1507183349173715,1.3388927840436577,260585652,250408757.2,89.35136611374887,85.92052889671857,NaN,NaN,28.49423698206952,29.491593686302053
2016-12-28T09:30:00-05:00,76.69,76.72,75.63,75.69,8093680,15972686.7,55.700747926179744,65.01646390005085,NaN,NaN,-6.565883990257579,36.63340635856903,-0.24630593986407212,1.0310103592135675,1.2773162990776397,252491972,253326780.6,89.699992099692,86.75584311807143,NaN,NaN,26.209484933254767,29.0227210072953
2016-12-29T09:30:00-05:00,75.58,75.8,75.27,75.54,6697449,14064819.4,54.44783867345268,63.85113979663585,NaN,NaN,-78.80563882615787,12.609047904435279,-0.2910475661485745,0.9135068413919214,1.204554407540496,245794523,253284773.4,89.65448726525274,87.43665903053784,NaN,NaN,23.936119085783176,28.296063589936423
2016-12-30T09:30:00-05:00,75.47,75.89,75.08,75.32,8853288,13138364.85,52.57976775967203,62.497925894762616,NaN,NaN,-98.86138082414858,-16.9411259259125,-0.32885513500779995,0.7934854887807461,1.122340623788546,236941235,249278035.2,85.21402553715947,87.68802213814408,NaN,NaN,21.481368721338672,27.322535751565315
2017-01-03T09:30:00-05:00,76.11,76.81,75.36,76.17,24623100,13452577.4,58.50361566086059,61.485633031475246,NaN,NaN,-16.52985636901656,-29.208020364746325,-0.2913002081160929,0.7582153636434299,1.0495155717595228,261564335,251475543.4,85.63427566072505,87.8803539429736,NaN,NaN,20.82823591899837,26.39477863262718
2017-01-04T09:30:00-05:00,76.23,76.37,75.76,76.01,11185512,12885097.1,57.05868268098889,60.184361360936016,NaN,NaN,-32.36620359573532,-46.62579272106318,-0.27227012858365496,0.7091779110299541,0.981448039613609,250378823,249434177.6,83.26669788956316,87.757898185722,NaN,NaN,19.88350342230423,25.4645964597239
2017-01-05T09:30:00-05:00,76.06,76.34,75.4574,75.82,11141175,12593980.65,55.31165435598244,59.59312908328325,NaN,NaN,-72.22913251464585,-59.758442425940835,-0.267142623921801,0.6475197597113578,0.9146623836331588,239237648,246783312.8,80.16710776921526,87.34913870061197,NaN,NaN,18.60873986790942,24.485188375178975
2017-01-06T09:30:00-05:00,76.06,76.145,75.3925,75.89,7410548,12164094.8,55.848015802764834,58.99366710703998,NaN,NaN,-85.06979701567724,-61.01127406384471,-0.25379631144845827,0.597416994322586,0.8512133057710443,246648196,246954047.4,80.21818386974503,86.87334681234752,NaN,NaN,17.671469593689924,23.511799977823397
2017-01-09T09:30:00-05:00,75.39,75.46,74.68,74.79,10960921,11982133,46.419504880179424,57.70063076731676,NaN,NaN,-198.90647919073308,-81.02029373716161,-0.31008645875239493,0.4636052323305506,0.7736916910829456,235687275,246703255.4,79.89271035284912,86.29559424741186,NaN,NaN,13.98888554484399,22.151383630254912
2017-01-10T09:30:00-05:00,74.73,74.9,74.05,74.11,9660843,12016433.6,41.7294402176408,56.260018739416545,NaN,NaN,-240.40504839696027,-125.79533214275037,-0.37956239885862764,0.29923869250966106,0.6788010913682887,226026432,239595674.8,71.08949983110452,85.04913125181702,NaN,NaN,9.284787241722716,20.31329843189317
2017-01-11T09:30:00-05:00,74.37,75.05,74.06,74.91,13127044,11866276.45,48.34216279949058,55.38383759329714,NaN,NaN,-167.31700666589524,-152.78549275678233,-0.3583456529234381,0.2308690252139911,0.5892146781374292,239153476,237350605.4,68.52116676565663,83.6159571259201,NaN,NaN,7.1958577404993616,18.439378333122626
2017-01-12T09:30:00-05:00,75.33,75.41,74.3,74.6,10895604,11609629.15,46.15632118313015,54.30766708323768,NaN,NaN,-134.13630283241523,-165.16692682033622,-0.35141756987645056,0.14994271579186602,0.5013602856683166,228257872,235154650.2,66.00911723745362,81.95755204104714,NaN,NaN,4.800878092675106,16.49102115591584
2017-01-13T09:30:00-05:00,74.5,74.66,74.19,74.38,9906660,11112393.9,44.61456758004667,53.006250719137256,NaN,NaN,-148.32133100603687,-177.81723361840812,-0.3472639840020214,0.0672803056657898,0.4145442896678112,218351212,229495253.4,59.91296742603638,79.83279309831683,NaN,NaN,2.3695295026607304,14.473665205450823
2017-01-17T09:30:00-05:00,74.61,75.02,74.55,74.84,9782959,10588953.1,48.48896275007506,52.02648516904243,NaN,NaN,-90.37736010563086,-156.11140980138768,-0.30087964077958584,0.03844473869332887,0.3393243794729147,228134171,227984632.6,58.36356748381098,77.64251180728665,NaN,NaN,1.4447514990715145,12.612391818825207
2017-01-18T09:30:00-05:00,74.43,74.87,74.34,74.67,8725161,10131966.3,47.17555034985459,50.88405947287989,NaN,NaN,-96.34513765713086,-127.2994276534218,-0.2699767835574575,0.0018534000260927996,0.2718301835835503,219409010,226661148.2,56.97341322885463,75.32980088693706,NaN,NaN,0.3023397804481887,10.853812956199919
2017-01-19T09:30:00-05:00,74.67,74.7,74.08,74.26,9000920,10226351.9,44.074790755909966,50.05363396071777,NaN,NaN,-109.76066818400287,-115.78815995704335,-0.26509830829005854,-0.05954270177902288,0.20555560651103566,210408090,220912071,51.26156071646964,72.58419864527832,NaN,NaN,-1.5811617496052242,9.077387998227756
2017-01-20T09:30:00-05:00,74.74,74.99,74.29,74.54,9182221,10236357.3,46.653576649656266,49.49690095901802,NaN,NaN,-75.21573596828378,-104.00404658421705,-0.23214874848798256,-0.08463032909894252,0.14751841938904003,219590311,219178558.8,49.64535437370347,69.72640343873908,NaN,NaN,-2.436202445543799,7.432589363403249
2017-01-23T09:30:00-05:00,74.2,74.35,73.39,73.75,15207044,10591574.3,40.9203310072727,48.66408404813235,NaN,NaN,-131.09410900463843,-100.55860218393737,-0.25108783342646696,-0.16634137239404367,0.0847464610324233,204383267,216384969.8,47.06981740164645,67.00181714334528,NaN,NaN,-4.950088386042612,5.663635399196697
2017-01-24T09:30:00-05:00,74.04,74.88,73.9,74.56,11857240,10635917.95,47.97920173717829,47.912340196440766,NaN,NaN,-68.51806230229359,-96.18674262326991,-0.19887635543991525,-0.16384898326747077,0.03502737217244448,216240507,214006237,44.93227182493637,64.09453115507468,NaN,NaN,-4.930812641616413,4.150142821937681
2017-01-25T09:30:00-05:00,74.58,75.18,74.56,74.95,9410281,10786525.4,51.01402367668441,47.480578838990446,NaN,NaN,-21.390951513121124,-81.19590539446796,-0.13115623433968238,-0.12891792075215847,0.0022383135875238963,225650788,215254592.6,46.3102476759508,61.45478471124522,NaN,NaN,-3.954402357682002,2.9923506534205835
2017-01-26T09:30:00-05:00,75.19,75.31,74.8479,75.01,8651667,10718665.85,51.482968504657215,47.207101278181504,NaN,NaN,2.9702985927554924,-58.649712039116274,-0.07802649430999348,-0.09529480429996795,-0.017268309989974473,234302455,220033465.6,51.33099926984158,59.395062675575666,NaN,NaN,-3.0307139992091896,2.1319128459020447
2017-01-27T09:30:00-05:00,74.55,74.63,74.01,74.23,9950921,10811527.9,45.398538618262776,46.460710050717076,NaN,NaN,-82.61533776496962,-60.12963239845345,-0.09025587068091326,-0.13008814834111604,-0.03983227766020279,224351534,220985710.2,52.28843300848101,57.40008047119967,NaN,NaN,-4.082657860043975,1.244117030766899
2017-01-30T09:30:00-05:00,73.89,73.93,72.36,72.87,13286402,11140975.55,37.15361904875583,45.79886106275825,NaN,NaN,-209.0179510591963,-75.71440080936502,-0.17961852450588944,-0.2643554332925646,-0.08473690878667516,211065132,222322083.2,53.666022246002996,55.52674560642496,NaN,NaN,-7.909883203284912,-0.06359728838335976
2017-01-31T09:30:00-05:00,72.91,73.02,72.13,72.9,14007376,11398679.95,37.42359321077118,45.49130056226756,NaN,NaN,-215.2023776985338,-105.05126388861306,-0.22352634468385768,-0.36414483964149724,-0.14061849495763956,225072508,224088483.4,55.495172084153964,54.41286505307135,NaN,NaN,-10.776635768892689,-1.5940313570275495
2017-02-01T09:30:00-05:00,73.29,73.385,71.91,72.36,18424308,11088740.35,34.5468104116713,44.5059182488519,NaN,NaN,-197.88409794746497,-140.34989317548184,-0.27250884187219215,-0.48125454729787975,-0.2087457054256876,206648200,220287965.8,50.84434021821472,53.15023458539692,NaN,NaN,-14.111423959674854,-3.3822303002628784
2017-02-02T09:30:00-05:00,72.48,72.9,71.9,72.77,12880101,11173469.8,38.417544787896844,43.95314850633524,NaN,NaN,-170.9363761067999,-175.1312281153929,-0.2608564214551709,-0.5348162322446512,-0.27395981078948034,219528301,217333135,47.51053723465135,51.82890744233962,NaN,NaN,-15.659673234089173,-5.13615071938092
2017-02-03T09:30:00-05:00,73.06,73.78,72.63,73.4,11828580,11207840.05,43.90680833587736,43.90259427460886,NaN,NaN,-85.04256523037337,-175.61667360847366,-0.19717561791942245,-0.5204293331887584,-0.32325371526933594,231356881,218734204.4,49.21104381260268,51.064484327094355,NaN,NaN,-15.228514951174448,-6.577917038208566
2017-02-06T09:30:00-05:00,73.51,73.65,72.57,72.78,10521672,11363396.25,40.11696724662809,43.30459459579122,NaN,NaN,-94.11595400800714,-152.63627419823584,-0.18354536140532968,-0.552685417025998,-0.3691400556206684,220835209,220688219.8,51.567690022549264,50.5790645084328,NaN,NaN,-16.068544290970827,-7.933720931460318
2017-02-07T09:30:00-05:00,72.46,72.8,71.37,71.75,14157752,11523237.8,34.750586435614906,42.41709717334553,NaN,NaN,-153.91530931842735,-140.37886052221455,-0.22774724385278122,-0.6538241104366449,-0.4260768665838637,206677457,217009209.6,47.13323696563313,49.87619477534555,NaN,NaN,-18.616164069560302,-9.459784236903172
2017-02-08T09:30:00-05:00,71.42,72.08,70.65,71.92,16148412,11847616.25,36.265965166891945,41.859323916987094,NaN,NaN,-155.0098492239456,-131.80401077751068,-0.2287797762701123,-0.712051586921504,-0.48327181065139174,222825869,220244743.4,51.11467976944559,49.865703279129555,NaN,NaN,-20.14176122878103,-10.98578095002858
2017-02-09T09:30:00-05:00,72.35,72.95,72.35,72.73,9261602,11654344.15,43.052387411436,41.60209611425709,NaN,NaN,-67.92170125007584,-111.20107580616586,-0.16133572913152805,-0.6849414720658018,-0.5236057429342738,232087471,222756577.4,54.01034022373563,50.17748798270328,NaN,NaN,-19.227508879718936,-12.16317065427006
2017-02-10T09:30:00-05:00,73.31,73.69,73.06,73.28,10405367,11629832.3,47.16619264582978,42.048229088439726,NaN,NaN,-18.09027598168275,-97.81061795642775,-0.07073229276714288,-0.6120211088932024,-0.5412888161260595,242492838,224983768.8,56.47232804403201,50.849095885730826,NaN,NaN,-17.120638071940785,-12.871380285365877
2017-02-13T09:30:00-05:00,73.13,73.45,72.99,73.42,7984938,11533746.2,48.192114083268,42.06343711316042,NaN,NaN,-18.74300998139946,-82.73602915110621,0.003633389280392807,-0.5367470795255684,-0.5403804688059612,250477776,230912282.2,62.263428424749485,52.08703564286033,NaN,NaN,-15.12111113927414,-13.192770407352771
2017-02-14T09:30:00-05:00,73.63,73.69,72.74,73.66,10771687,11583182.6,49.98507055604759,41.98994046168635,NaN,NaN,-8.414129147150804,-53.635793116850905,0.07029667471593748,-0.45250962541103945,-0.5228063001269769,261249463,241826683.4,70.13981378369868,53.78914750769946,NaN,NaN,-12.937090973725773,-13.156244773977486
2017-02-15T09:30:00-05:00,73.44,73.76,73.13,73.37,8926600,11593254.55,47.8310244352747,41.72908731387332,NaN,NaN,1.015733302323894,-22.43067661159701,0.0946540654323288,-0.40448871833656597,-0.49914278376889476,252322863,247726082.2,73.37465045604606,55.36369402099978,NaN,NaN,-11.729688115975986,-12.952450965691558
2017-02-16T09:30:00-05:00,73.44,73.54,72.26,72.37,11375435,11711980.3,41.23257580604456,41.43151854157202,NaN,NaN,-55.09091363848766,-19.86451908927936,0.04569180919789251,-0.44202802227152915,-0.48771983146942166,240947428,249498073.6,74.27608751267266,56.93424077129919,NaN,NaN,-12.674810191758096,-12.912787997986777
2017-02-17T09:30:00-05:00,72,72.21,71.74,71.97,11645027,11835120.6,38.91973014671253,41.55766933428321,NaN,NaN,-112.43178352870088,-38.732820598682984,-0.008472641514684576,-0.49831063336277737,-0.4898379918480928,229302401,246859986.2,70.4518509439757,58.1332285354401,NaN,NaN,-14.174315642750097,-13.093006232952966
2017-02-21T09:30:00-05:00,72.65,72.85,72.35,72.46,11802519,11664894.35,43.128197399875226,41.96514106207636,NaN,NaN,-53.6492468824036,-45.71406797888381,-0.006241305272475239,-0.49763962343868684,-0.4913983181662116,241104920,244985415,67.78128697294758,59.01080817035393,NaN,NaN,-14.152490389662734,-13.244361112482933
2017-02-22T09:30:00-05:00,72.12,72.2,71.305,71.36,11539405,11649002.6,36.96999832077095,42.138225912726334,NaN,NaN,-128.9862003381426,-69.82848221708217,-0.07023501294076495,-0.5791920843421678,-0.5089570714014029,229565515,238648625.4,59.562037638970985,59.63350084326509,NaN,NaN,-16.149745791991922,-13.659416066698503
2017-02-23T09:30:00-05:00,72.16,72.28,71.21,71.66,17390145,12047995.8,39.506944153268854,42.21604015311004,NaN,NaN,-112.61530530287774,-92.5546899381225,-0.08287783009297534,-0.6125543590176221,-0.5296765289246468,246955660,237575184.8,58.27294907655432,60.40224454625816,NaN,NaN,-16.962873473712044,-14.131338553414723
2017-02-24T09:30:00-05:00,71.14,71.41,70.63,70.99,13997642,12315294.55,36.019993969160815,41.65269626977315,NaN,NaN,-174.40868901755266,-116.41824501393549,-0.12438638509929079,-0.6851595102987602,-0.5607731251994694,232958018,235977302.8,56.31897272393335,60.90995375421035,NaN,NaN,-18.77018556627929,-14.794030983823948
2017-02-27T09:30:00-05:00,71.06,71.91,70.94,71.6,23686442,13002070.6,41.11577743872402,41.72403985492286,NaN,NaN,-110.00793194934923,-115.93347469806517,-0.09984136690820145,-0.6855748338347212,-0.5857334669265197,256644460,241445714.6,61.123401466972766,61.592504571669174,NaN,NaN,-18.664356847264063,-15.346934678601107
2017-02-28T09:30:00-05:00,71.39,71.715,71.18,71.38,14018447,13038672.85,39.88204319934839,42.09057248090381,NaN,NaN,-100.66775967483365,-125.33717725655117,-0.08792304141726981,-0.6956372686981069,-0.6077142272808371,242626013,241749933.2,61.37790509330283,62.609980866502724,NaN,NaN,-18.95546116282554,-15.862438462061741
2017-03-01T09:30:00-05:00,72.04,73.14,71.99,72.81,18997571,13288182.6,50.31756211112316,43.09425797692033,NaN,NaN,24.759508404365697,-94.58803550804951,0.02095587908809171,-0.5815193784207224,-0.6024752575088141,261623584,248161547,66.37416545258709,63.69994412958426,NaN,NaN,-15.688987582913263,-15.837659765040529
2017-03-02T09:30:00-05:00,72.45,72.81,72.09,72.12,10770279,12905481.15,46.154423201943786,43.3158319619566,NaN,NaN,-5.674490585504973,-73.19987256457497,0.04955899920200846,-0.5405265085063036,-0.590085507708312,250853305,248941076,66.93422923668541,64.62307905908067,NaN,NaN,-14.369440107970824,-15.627914099744856
2017-03-03T09:30:00-05:00,72.24,72.51,71.825,71.99,11166488,12819800.5,45.39240827237022,43.18913307813806,NaN,NaN,-27.103240327856646,-43.738782826635756,0.06197231676443593,-0.5126201117527671,-0.574592428517203,239686817,250286835.8,67.92738806225846,65.44129763181112,NaN,NaN,-13.57234850385244,-15.334261871760226
2017-03-06T09:30:00-05:00,71.87,72.25,71.59,72.15,8374749,12647108.95,46.5618086158377,43.07268268760732,NaN,NaN,-33.49784358188069,-28.436765153142055,0.08195332817902856,-0.4721507682934174,-0.554104096472446,248061566,248570257,65.23580992952932,65.65361059643827,NaN,NaN,-12.57677558213077,-14.940335258956019
2017-03-07T09:30:00-05:00,72.41,72.43,71.42,71.51,11461751,12694112.9,42.629354828249376,42.54727442133602,NaN,NaN,-50.59454736583594,-18.422122691342516,0.0543892665876593,-0.4861175132378719,-0.5405067798255312,236599815,247365017.4,63.338135600335626,65.16777644048376,NaN,NaN,-12.913497907248242,-14.650787065854908
2017-03-08T09:30:00-05:00,71.22,71.64,69.62,69.65,25566236,13264537.1,33.716871821458724,41.53912066320631,NaN,NaN,-181.17430642501665,-59.60888565721899,-0.07951168600457359,-0.6398963873312482,-0.5603847013266746,211033579,237247016.4,50.149298717814354,63.50882274489578,NaN,NaN,-16.357054482395974,-14.894539553932203
2017-03-09T09:30:00-05:00,69.3,70.15,68.89,70.11,27770650,13845649,37.213014577458836,41.25200914687876,NaN,NaN,-203.78812430233026,-99.23161240058405,-0.12480502931956139,-0.7163909879761263,-0.5915859586565649,238804229,234837201.2,47.606671206758165,61.603864437330465,NaN,NaN,-17.932966341995353,-15.32860052365551
2017-03-10T09:30:00-05:00,70.56,70.65,69.6,70.01,17479266,14256532.2,36.75909612603156,41.09767814540155,NaN,NaN,-148.26115714566075,-123.46319576414487,-0.14763992368456313,-0.7761358632622688,-0.6284959395777057,221324963,231164830.4,43.949702168977815,59.7108538105449,NaN,NaN,-19.30962589913849,-15.897318434438793
2017-03-13T09:30:00-04:00,69.94,70.36,69.78,70.02,13078803,14390204,36.84206125923658,40.64866842107022,NaN,NaN,-133.75144775344418,-143.51391659845757,-0.14784481017418172,-0.8133019522954328,-0.6654571421212511,234403766,228433270.4,41.40213796249416,57.826628881226796,NaN,NaN,-20.378075924021744,-16.53742664723636
2017-03-14T09:30:00-04:00,69.48,69.49,68.62,69.23,26384761,15310195.15,33.14292633312692,40.37530613623851,NaN,NaN,-174.65814242585807,-168.326635610462,-0.18457206848109187,-0.8961722277226158,-0.711600159241524,208019005,222717108.4,36.618598237621164,56.18781178113038,NaN,NaN,-22.44902126640088,-17.381940164259863
2017-03-15T09:30:00-04:00,69.82,70.93,69.48,70.77,23205014,15931861.5,44.78192962464078,40.75209081276507,NaN,NaN,-73.9451467329401,-146.88080367204668,-0.0931497045434666,-0.8280372899208572,-0.7348875853773906,231224019,226755196.4,41.73961178611823,55.0068591175278,NaN,NaN,-20.47171746763434,-17.82333692188479
2017-03-16T09:30:00-04:00,70.92,70.92,70.07,70.27,16277545,16299408.75,42.21246240698854,41.19440998689562,NaN,NaN,-62.58860047905479,-118.64089890739157,-0.05617387860875378,-0.8051049336383329,-0.7489310550295791,214946474,221983645.4,37.848195130678285,53.68751786086672,NaN,NaN,-19.70110536490166,-18.091589556601484
2017-03-17T09:30:00-04:00,70.14,70.29,69.8,69.8,14243909,16442832.45,39.89520884770375,41.10722651610846,NaN,NaN,-85.31426544035516,-106.05152056633047,-0.05321986023799974,-0.8154558803270788,-0.7622360200890791,200702565,217859165.8,34.82577783194809,51.80911617265067,NaN,NaN,-19.807577583896673,-18.33673070335794
2017-03-20T09:30:00-04:00,69.57,69.85,69.15,69.746,12218665,16471514.35,39.62605887706759,41.08894192165983,NaN,NaN,-100.44067776824508,-99.38936656929063,-0.04507545928577017,-0.8185803441962918,-0.7735048849105216,188483900,208675192.6,29.228661742645016,49.51274164760368,NaN,NaN,-19.972659579441082,-18.570434828512674
2017-03-21T09:30:00-04:00,70.03,70.08,68.95,69.21,16717185,16717247.65,36.96062099061928,40.134874698766694,NaN,NaN,-100.97493117277051,-84.65272431867312,-0.0647621479123821,-0.8544575698009993,-0.7896954218886172,171766715,201424734.6,25.71493177446861,46.60851067059523,NaN,NaN,-20.911357422596105,-18.904852341953163
2017-03-22T09:30:00-04:00,69,69.43,68.72,69.11,12419612,16761258,36.4677687090693,39.44297080641852,NaN,NaN,-110.55870575905067,-91.97543612389524,-0.07288870810105497,-0.8808063070149359,-0.8079175989138809,159347103,187049351.4,20.46253467945793,43.28910391650755,NaN,NaN,-21.81721887950225,-19.320904704460176
2017-03-23T09:30:00-04:00,68.91,69.42,68.76,68.83,11800443,16481772.9,35.05812639054476,38.704807814859564,NaN,NaN,-105.96487494291459,-100.6506910166672,-0.0846646474056747,-0.9137484081709744,-0.8290837607652997,147546660,173569388.6,16.963544489338105,39.64882937558467,NaN,NaN,-22.978106745821357,-19.843362138940346
2017-03-24T09:30:00-04:00,68.93,69.08,68.43,68.56,10442476,16304014.6,33.70516138249408,37.78647586962073,NaN,NaN,-114.53462711962013,-106.49476335252018,-0.0972794881472856,-0.9506831209494067,-0.8534036328021211,137104184,160849712.4,14.452283678036636,36.02143464333518,NaN,NaN,-24.338525120322025,-20.48552827913773
2017-03-27T09:30:00-04:00,67.91,68.43,67.86,68.24,11491252,15694255.1,32.1228816775224,37.03601350171166,NaN,NaN,-134.57254684806009,-113.32113716848319,-0.11272800882043654,-0.9943136438276667,-0.8815856350072302,125612932,148275518.8,12.48466521696892,32.389043901666135,NaN,NaN,-25.943453189248817,-21.265231837725025
2017-03-28T09:30:00-04:00,68.34,69.38,68.1832,69.21,27922593,16389462.4,41.14262493064558,37.56642443808215,NaN,NaN,-80.57696135159406,-109.2415432042479,-0.04656107193660264,-0.9397869749279835,-0.8932259029913808,153535525,144629280.8,11.975512491733824,29.66234488551753,NaN,NaN,-24.77408202857144,-21.766496150703084
2017-03-29T09:30:00-04:00,69.2,70.28,69.01,70.16,18059554,16342561.55,48.37772399684236,38.36390368232383,NaN,NaN,-17.095956368367666,-90.5489933261113,0.06612204124757448,-0.8105733514319127,-0.8766953926794872,171595079,147078876,14.498295725237469,27.297460922551767,NaN,NaN,-21.45037403933583,-21.72133584907919
2017-03-30T09:30:00-04:00,70.6,70.77,69.96,70.14,15912323,16599663.75,48.24327071415748,39.18420186718998,NaN,NaN,28.865964953527783,-63.58282534682282,0.1399997181653534,-0.7016957449727954,-0.8416954631381488,155682756,148706095.2,16.216099010810467,25.316489268396957,NaN,NaN,-18.836559811863356,-21.309224986619785
2017-03-31T09:30:00-04:00,69.91,70.34,69.58,69.9,19861199,17034399.3,46.570624957971745,39.879099274242485,NaN,NaN,9.937078782809003,-38.688484166337005,0.17132313579986447,-0.6275415433883182,-0.7988646791881827,135821557,148449569.8,16.160975707904086,23.513549107354805,NaN,NaN,-17.125258887457566,-20.711515543882324
2017-04-03T09:30:00-04:00,70.01,70.06,69.08,69.78,13133305,17272327.1,45.71713016228834,40.777256690611146,NaN,NaN,-9.109891194585396,-13.595953035642065,0.18159998239324127,-0.5718647011966311,-0.7534646835898724,122688252,147864633.8,16.027190253602882,22.0427342513535,NaN,NaN,-15.936296867963684,-20.02934144732252
2017-04-04T09:30:00-04:00,69.93,70.345,69.26,70.29,12973967,17347937.9,49.91804340140013,41.14412196037967,NaN,NaN,44.444062429473874,11.408251720571522,0.21793774182912418,-0.4810425063034671,-0.6989802481325913,135662219,144289972.6,15.199113130574617,20.146984347386105,NaN,NaN,-13.698888640040135,-19.12499104628218
2017-04-05T09:30:00-04:00,70.88,71.49,69.965,70.07,22733722,17206312.2,48.185691195541075,41.570781159561996,NaN,NaN,113.09731381192607,37.44690575663027,0.2216214723711849,-0.4219534076686102,-0.6435748800397951,112928497,132556656.2,12.851905552594403,18.361535091808683,NaN,NaN,-12.279883463922745,-18.147118534516547
2017-04-06T09:30:00-04:00,70.35,70.83,70.16,70.63,13124705,16474014.95,52.68671936636777,42.48446048232371,NaN,NaN,104.33364240532266,52.540441246989246,0.25391784058699773,-0.32617757930604796,-0.5800954198930457,126053202,126630745.4,11.856058598148579,16.720840860823007,NaN,NaN,-9.73100356073729,-16.944816395405226
2017-04-07T09:30:00-04:00,70.67,70.86,70.2533,70.36,12580298,16229066.55,50.41285910871512,43.254946213155684,NaN,NaN,92.8679705009784,69.12661959062311,0.24890763569906438,-0.2689608752692152,-0.5178685109682796,113472904,122161014.8,11.154010230024284,15.429794324207242,NaN,NaN,-8.199323878863412,-15.695460321613538
2017-04-10T09:30:00-04:00,70.75,71.21,70.6,70.89,10820941,16116173.45,54.558678298482675,44.51195030657449,NaN,NaN,127.3775795095026,96.42411373144071,0.27126385696086175,-0.1787886897672024,-0.45005254672806416,124293845,122482133.4,11.559190419785452,14.418669941729876,NaN,NaN,-5.6493805661405725,-14.260306070831685
2017-04-11T09:30:00-04:00,71,71.03,70.14,70.9,13891468,15491508.8,54.63574448882182,45.809662862271104,NaN,NaN,95.48526390983105,106.63235402751215,0.27579742351084996,-0.1053057673395017,-0.38110319085035166,138185313,122986752.2,12.236530547199706,13.831098217997146,NaN,NaN,-3.539953369802916,-12.728827113541861
2017-04-12T09:30:00-04:00,70.97,71.415,70.38,70.6,11453569,14903936.55,51.79763711008267,47.00534219938095,NaN,NaN,102.10223034188095,104.43333733350315,0.24851036442001778,-0.07046523532532945,-0.3189755997453472,126731744,125747401.6,16.0256079415566,13.764102750298466,NaN,NaN,-2.485701926131069,-11.26552351534032
2017-04-13T09:30:00-04:00,70.54,70.59,69.15,69.31,17655959,14972857.25,41.7537731121847,47.58024303721599,NaN,NaN,-13.428578385367068,80.88089317536517,0.13896329380427558,-0.14527148249000277,-0.28423477629427835,109075785,122351918.2,15.158730758880893,13.814563256073058,NaN,NaN,-4.607058481616282,-10.314314224808314
2017-04-17T09:30:00-04:00,69.29,69.5305,69.12,69.46,8012191,14661271.35,43.13455645042184,48.36679123528024,NaN,NaN,-43.68798607331167,53.569701860507166,0.07518059050706405,-0.1902590381604483,-0.26543962866751236,117087976,123074932.6,16.198234945839374,14.07981823670666,NaN,NaN,-5.916711922653094,-9.686085324500425
2017-04-18T09:30:00-04:00,69.15,69.61,68.665,68.81,14750282,14787852.2,38.83799237117357,48.202174623889384,NaN,NaN,-74.2282613181483,13.248533694976993,-0.007799782082619167,-0.27518935627078633,-0.26738957418816717,102337694,118683702.4,14.996437879168809,14.295598621523448,NaN,NaN,-8.408832314279023,-9.50362060875451
2017-04-19T09:30:00-04:00,68.98,69.1099,67.62,67.8,18125404,14858263.15,33.2892707306562,47.12442796201894,NaN,NaN,-142.12106017698076,-34.272731122385366,-0.12141949530770668,-0.4191639433228005,-0.2977444480150938,84212290,107889097.8,12.53450669088555,14.155327976212595,NaN,NaN,-12.52019891861684,-9.934560367306272
2017-04-20T09:30:00-04:00,68,68.63,67.93,68.13,16234971,15049031.1,36.4823369611219,46.28436126537355,NaN,NaN,-124.80313422023644,-79.65380403480886,-0.16249481143936562,-0.5008629623143008,-0.3383681508749352,100447261,102632201.2,11.540857138070876,13.821382128159769,NaN,NaN,-14.844579593303536,-10.63599168530588
2017-04-21T09:30:00-04:00,67.84,68.13,67.45,67.79,14116058,15164811.85,34.64253304521206,45.43235470017642,NaN,NaN,-144.43487337175588,-105.85506303208663,-0.19833494515924566,-0.5862868323239923,-0.3879518871647466,86331203,98083284.8,10.746941964242893,13.434665432183968,NaN,NaN,-17.33764216130021,-11.593370324733641
2017-04-24T09:30:00-04:00,68.29,68.47,67.98,68.19,13350678,15310221.95,38.56764297815535,44.92167704416693,NaN,NaN,-104.78022308971325,-118.07351043536694,-0.18133785224904359,-0.6146242024760511,-0.4332863502270075,99681881,94602065.8,10.170335646429422,13.01631867452872,NaN,NaN,-18.216484029624734,-12.539529425432368
2017-04-25T09:30:00-04:00,68.36,68.93,68.15,68.77,14413097,15456314.2,43.83480379890598,44.487159929703054,NaN,NaN,-77.46862781026346,-118.72158373378997,-0.12021393987765783,-0.5835537750740798,-0.46333983519642197,114094978,96953522.6,13.544583969053733,12.898138020134368,NaN,NaN,-17.32420408487582,-13.223054376781432
2017-04-26T09:30:00-04:00,68.45,69.47,68.42,68.54,18737578,14997063.45,42.28646737119373,44.06578679939253,NaN,NaN,-60.96704617552708,-102.49078093349924,-0.08605472424210331,-0.5709082404990511,-0.4848535162569478,95357400,99182544.6,16.73736722167898,13.175670996497553,NaN,NaN,-17.058890582417234,-13.771030977586546
2017-04-27T09:30:00-04:00,68.01,68.08,67.115,67.79,20547721,15121471.8,37.620048436393596,42.98959601868008,NaN,NaN,-129.32060978986604,-103.39427604742514,-0.10357618971817129,-0.6143237534046619,-0.5107475636864907,74809679,94055028.2,15.33447730001184,13.424129475202069,NaN,NaN,-18.2875036103433,-14.416241353694653
2017-04-28T09:30:00-04:00,68.37,68.49,67.735,67.84,14425964,15047153.85,38.1103841558573,42.11084780776167,NaN,NaN,-92.16581305955337,-92.94046398498463,-0.10128139857892149,-0.6373493119101425,-0.5360679133312211,89235643,94635916.2,16.191504342761505,13.783950483254728,NaN,NaN,-19.125221386566267,-15.088952786962027
2017-05-01T09:30:00-04:00,67.82,68.005,67.5,67.65,9419426,14525065.2,36.92267544674376,40.85113331835175,NaN,NaN,-100.02225543221257,-91.9888704534845,-0.1017718569631273,-0.6632827345351302,-0.5615108775720029,79816217,90662783.4,15.068014088582885,14.034580745311686,NaN,NaN,-20.16317476826711,-15.813841641434182
2017-05-02T09:30:00-04:00,67.79,68.01,67.03,67.31,16435642,14690182.05,34.83078072930722,39.436493049815,NaN,NaN,-104.40088097324549,-97.3753210860809,-0.11332303607472471,-0.7031646726654088,-0.5898416365906841,63380575,80519902.8,12.654079104089178,14.064405642232364,NaN,NaN,-21.653372999558613,-16.64806040688053
2017-05-03T09:30:00-04:00,67.16,67.82,66.97,67.5,16934781,14888222.75,36.97953920148321,38.37805748491503,NaN,NaN,-95.95742165047896,-104.37339618107129,-0.09711968081457478,-0.7112412376089026,-0.6141215567943278,80315356,77511494,12.038070667114894,13.779581551200815,NaN,NaN,-22.306539677706287,-17.456414588427066
2017-05-04T09:30:00-04:00,67.03,67.11,65.83,66.26,33944538,15448763.55,30.022236578083252,37.54009058962207,NaN,NaN,-144.1709298603508,-107.34346019516822,-0.15540763162379334,-0.8083810963240694,-0.6529734647002761,46370818,71823721.8,10.952497033162587,13.479136285078079,NaN,NaN,-25.15506571068219,-18.55622189160637
2017-05-05T09:30:00-04:00,66.3,67.42,66.265,67.31,18743753,15729715.95,40.26990172206946,37.33547239473976,NaN,NaN,-100.52848374207042,-109.01599433167164,-0.1108330836725413,-0.7915148192909527,-0.6806817356184114,65114571,66999507.4,10.118991088490432,13.044904580981726,NaN,NaN,-24.24046982013449,-19.36825730996753
2017-05-08T09:30:00-04:00,67.3,67.91,67.24,67.79,18948732,16048137.65,44.286530489304305,37.72465368889196,NaN,NaN,-55.42630230303957,-100.09680370583705,-0.04024644309467573,-0.7309897894867561,-0.6907433463920803,84063303,67848924.6,11.397549066554035,12.787841094366383,NaN,NaN,-22.14856994793698,-19.76544482967745
2017-05-09T09:30:00-04:00,67.93,67.93,67.025,67.23,10719714,16043076.3,40.8363130757246,38.26372814211113,NaN,NaN,-68.64262077454376,-92.9451516660967,-0.023334835719960534,-0.719911891042031,-0.6965770553220705,73343589,69841527.4,14.471163730538677,12.926173740055892,NaN,NaN,-21.544090904633702,-20.01953712609977
2017-05-10T09:30:00-04:00,67.62,68.44,67.56,68.12,18259170,16261461.4,47.79706829036834,39.071923237057305,NaN,NaN,-12.128281397139455,-76.1793236154288,0.051636563643902234,-0.6320313507671926,-0.6836679144110949,91602759,72099008,17.944135731217656,13.383550782423521,NaN,NaN,-18.640295704721947,-19.82250263733151
2017-05-11T09:30:00-04:00,68.36,68.48,67.88,67.98,11968679,16287216.9,46.86305208082252,39.94481745388663,NaN,NaN,8.344283837056919,-45.67628087594726,0.09321870727671266,-0.5671445303152041,-0.6603632375919167,79634080,78751660.4,27.31135680900566,14.566723271335146,NaN,NaN,-16.661169394751045,-19.370883602677157
2017-05-12T09:30:00-04:00,67.93,68.06,67.55,67.75,10708604,15939849.15,45.296996944339476,40.42548559432834,NaN,NaN,-20.389467532914487,-29.648477634116073,0.10573725356053432,-0.5281916706412488,-0.6339289242017832,68925476,79513841.4,28.320938408363546,15.863194897187585,NaN,NaN,-15.53716497337136,-18.82320951277633
2017-05-15T09:30:00-04:00,68.76,68.87,68.06,68.28,13206867,16199582.95,49.48609154824298,40.82914900499527,NaN,NaN,72.07064369229818,-4.149088435048521,0.14764348511145076,-0.44937456781246965,-0.5970180529239204,82132343,79127649.4,28.10791207676924,16.903432619167265,NaN,NaN,-13.28009063518802,-18.03133538740657
2017-05-16T09:30:00-04:00,68.6,68.6,67.7,67.94,11693390,16046738.35,46.99957876634723,41.165799818934815,NaN,NaN,36.53063027076567,16.885561774013365,0.14991467765990385,-0.40962470584904054,-0.5595393835089444,70438953,78546722.2,27.769537737154693,17.6914447988441,NaN,NaN,-12.15279239447558,-17.191543531273574
2017-05-17T09:30:00-04:00,67.54,68.1195,67.24,67.27,15606751,15920805.7,42.47082405846909,41.512283791940206,NaN,NaN,-43.82616292348667,10.545985468743917,0.10582282101873641,-0.42726085723552387,-0.5330836782542603,54832202,71192610.8,23.8545280593779,18.300019853084535,NaN,NaN,-12.576994521880462,-16.532322244217415
2017-05-18T09:30:00-04:00,66.97,67.585,66.72,67.25,14114950,15814804.65,42.339672876920716,41.814375843444736,NaN,NaN,-91.57804042277638,-9.438479383222745,0.07622316119710815,-0.4378047267578751,-0.5140278879549832,40717252,63409245.2,20.55204144287815,18.611486788807152,NaN,NaN,-12.954404030113711,-16.02119107077403
2017-05-19T09:30:00-04:00,67.58,68.22,67.42,68.08,15624505,15890227,49.33237244058953,42.70078277157658,NaN,NaN,21.124540199681203,-1.1356778367036064,0.11132987890272428,-0.37486553932657785,-0.4861954182293021,56341757,60892501.4,19.606819804500745,18.935687197087,NaN,NaN,-11.141005346846569,-15.324021681641536
2017-05-22T09:30:00-04:00,68.44,68.48,67.69,67.93,10339245,15739655.35,48.194833936646916,43.655358000672265,NaN,NaN,43.15487432324135,-6.918831710514972,0.12235789446329043,-0.3332480501501891,-0.45560594461347953,46002512,53666535.2,17.165735854779513,19.257948393564877,NaN,NaN,-9.999644375989144,-14.563396352262624
2017-05-23T09:30:00-04:00,68.11,68.18,67.7343,68.09,9086831,15473342.05,49.53163489246885,44.5519362643141,NaN,NaN,46.37728422184722,-4.949500920298663,0.13722033659424704,-0.28408052387067073,-0.42130086046491777,55089343,50596613.2,16.24062375417546,19.558130756926346,NaN,NaN,-8.67306440464723,-13.72192035974614
2017-05-24T09:30:00-04:00,68.01,68.22,67.42,67.73,13591535,15216039.9,46.61686710024915,45.73726701589737,NaN,NaN,21.44634360062893,8.105000384524459,0.12020907114969664,-0.271039521527797,-0.3912485926774936,41497808,47929734.4,15.461093860688791,19.880173387463934,NaN,NaN,-8.362221791260742,-12.956249135676797
2017-05-25T09:30:00-04:00,67.56,68.23,66.26,66.5,23329248,15355116.25,38.31968654442667,45.59796593178003,NaN,NaN,-114.7548312034526,3.4696422283892163,0.02831639362722871,-0.35585310064345776,-0.3841694942706865,18168560,43419996,14.218270005263406,20.172979024376286,NaN,NaN,-10.724766984720928,-12.63746597125453
2017-05-26T09:30:00-04:00,66.5,66.67,66.18,66.61,13199144,15293775.25,39.35918710800308,45.246012833115664,NaN,NaN,-170.08130515187193,-34.771526841921414,-0.020242205563698767,-0.40947225122530995,-0.3892300456616112,31367704,38425185.4,12.97431111091666,20.285604884687903,NaN,NaN,-12.303152476577461,-12.589706900586377
2017-05-30T09:30:00-04:00,66.26,66.26,65.69,65.72,14529107,15549259.3,34.31952489109746,44.78052796278515,NaN,NaN,-208.60204889047333,-85.12291148466434,-0.10286584970477414,-0.5178123577925788,-0.4149465080878047,16838597,32592402.4,11.688280313500314,20.08682749775659,NaN,NaN,-15.345277579132205,-12.983359854664352
2017-05-31T09:30:00-04:00,65.2,65.64,65.095,65.44,16093028,15532128.6,32.8925839193942,43.715921936286996,NaN,NaN,-210.5414500528671,-136.5066583396072,-0.16334630910816128,-0.6191293944730063,-0.455783085364845,745569,21723647.6,9.74909237252973,19.501467257850315,NaN,NaN,-18.276954767918475,-13.73958769941494
2017-06-01T09:30:00-04:00,65.47,66.09,65.26,65.85,17983673,15584573.2,37.02178111565423,43.01297401020355,NaN,NaN,-143.3020001361502,-169.45632708696303,-0.16237087636737702,-0.6587466808240663,-0.4963758044566893,18729242,17169934.4,9.0701188656289,18.198521690466258,NaN,NaN,-19.477814075456887,-14.55933432456379
2017-06-02T09:30:00-04:00,65.55,65.57,64.81,65.09,16542548,14714473.7,32.97180677369667,42.13260328372906,NaN,NaN,-172.8405256037474,-181.073465967022,-0.19722380542039064,-0.7429055612321775,-0.5456817558117869,2186694,13973561.2,8.616495121069875,16.791061455659566,NaN,NaN,-21.82354663860723,-15.59707894085571
2017-06-05T09:30:00-04:00,64.89,65.45,64.87,65.21,12552466,14404909.35,34.195860594590215,41.04044392989672,NaN,NaN,-143.15419836481237,-175.6880446096101,-0.19609715229597502,-0.7908031961817557,-0.5947060438857806,14739160,10647852.4,8.159254603036615,15.366157350392951,NaN,NaN,-23.3388111701949,-16.703040687904167
2017-06-06T09:30:00-04:00,65.17,66.09,65.02,65.98,14835282,14199236.85,41.569422671283256,40.65257563739215,NaN,NaN,-91.45891275946758,-152.25941738340893,-0.1305498285636404,-0.7578933295903312,-0.6273435010266908,29574442,13195021.4,12.010516512680383,14.240512977216216,NaN,NaN,-22.364185127937695,-17.511775607908955
2017-06-07T09:30:00-04:00,65.71,66.03,64.6,65.05,22942134,14810357.85,36.2814875422633,40.21048017194887,NaN,NaN,-106.27624606893258,-131.40637658662203,-0.1362534545751226,-0.797660319245594,-0.6614068646704714,6632308,14372369.2,13.809628131819068,13.523020125247728,NaN,NaN,-23.236339523731175,-18.329570453026417
2017-06-08T09:30:00-04:00,64.74,65.34,64.72,64.86,19569341,14875866.4,35.29369755134104,39.70719622012176,NaN,NaN,-106.73557575619587,-124.09309171063117,-0.1387811816161475,-0.8348833416906558,-0.6961021600745083,-12937033,8039114.2,12.347115179699003,12.936953963592076,NaN,NaN,-24.242745920285554,-19.17430980549201
2017-06-09T09:30:00-04:00,65.01,66.64,65,66.42,23184200,15436642.45,47.848316820878864,39.601192247285276,NaN,NaN,-39.67590865008889,-97.46016831989947,-0.027188587015139154,-0.7300878938434323,-0.7028993068282932,10247167,9651208.8,14.819998428219478,12.595038151000557,NaN,NaN,-20.77068789443615,-19.402363818198314
2017-06-12T09:30:00-04:00,67.01,67.5539,66.745,66.89,22924386,16047431.55,50.93697085184512,39.79705916979943,NaN,NaN,26.68153662511505,-63.493021321913986,0.08058326083428846,-0.6021702307854326,-0.6827534916197211,33171553,13337687.4,20.353618351713237,12.82274404363868,NaN,NaN,-16.93036489435869,-19.049221114792655
2017-06-13T09:30:00-04:00,67.09,67.48,66.77,67.39,15807855,16177480.95,54.054434283067884,40.12011626912794,NaN,NaN,42.212906145231074,-36.758657540974255,0.1820416246539709,-0.45520146080225743,-0.6372430854562283,48979408,17218680.6,25.8173560136609,13.506796347887642,NaN,NaN,-12.761008658276355,-18.15090504957604
2017-06-14T09:30:00-04:00,67.21,67.21,65.66,66.17,30280222,17106822.55,46.3205872769297,40.09895342460512,NaN,NaN,-10.37587990778654,-17.57858430874505,0.16404291246069092,-0.4321894448803647,-0.5962323573410556,18699186,19632056.2,29.07561847403133,14.479262391697825,NaN,NaN,-11.788278294194862,-17.24195837023587
2017-06-15T09:30:00-04:00,65.87,66.2,65.38,65.67,19258894,17289429.7,43.56927765679093,40.473924218345424,NaN,NaN,-47.97294993437034,-5.826059144379956,0.11768917249400246,-0.4491208917235525,-0.566810064217555,-559708,22107521.2,32.357478838500484,15.774920165500474,NaN,NaN,-11.943742449085168,-16.485070381500055
2017-06-16T09:30:00-04:00,65.61,66.33,65.19,66.3,24621013,17814732.85,47.7782140136496,41.075283283034466,NaN,NaN,-30.34100254045983,-3.959077922454143,0.12783871277586545,-0.40701167324772314,-0.5348503860235886,24061305,24870348.8,35.921331176702466,17.41399302734232,NaN,NaN,-10.662707878276857,-15.653304309611027
2017-06-19T09:30:00-04:00,66.15,66.29,65.71,65.88,15678381,17817426.65,45.3497850364162,41.863159007700084,NaN,NaN,-23.546940963465097,-14.004773440170178,0.10557144150011188,-0.40288608414844873,-0.5084575256485606,8382924,19912623,32.6019516211947,18.907826692177633,NaN,NaN,-10.413590727556956,-14.904773797889018
2017-06-20T09:30:00-04:00,65.12,65.22,64.31,65.04,16063425,18103635.65,40.875039352499755,42.433334395779056,NaN,NaN,-111.83089163502389,-44.81353299622115,0.037109190439737094,-0.46207103759888923,-0.49918022803862633,-7680501,8580641.2,26.560415170804518,20.108635463482976,NaN,NaN,-11.678568869830976,-14.443887379595012
2017-06-21T09:30:00-04:00,64.84,65.22,63.64,63.99,27305459,19014567.05,36.08231730687886,42.36622983800938,NaN,NaN,-159.70912837367732,-74.6801826893993,-0.07020456342821635,-0.5869359323238967,-0.5167313688956804,-34985960,-2156388,22.336772477363112,21.05625357860685,NaN,NaN,-14.406545941085472,-14.438552888379363
2017-06-22T09:30:00-04:00,64.02,64.5,63.69,63.95,15431612,19106570.9,35.90957856866346,42.57607068050702,NaN,NaN,-168.43007687295838,-98.77160807711691,-0.13162827141512412,-0.6812667081645856,-0.5496384367494614,-50417572,-12127960.8,19.271725553786467,21.817341466658036,NaN,NaN,-16.57543550308455,-14.743821833337247
2017-06-23T09:30:00-04:00,63.96,64.45,63.78,64.38,14555496,18667883.3,39.27512141827766,42.93887502505612,NaN,NaN,-133.63446895243328,-119.4303013595116,-0.13077474596066163,-0.7131068692002884,-0.5823321232396268,-35862076,-24112637,16.365136332611257,22.403475875913365,NaN,NaN,-17.334748309271177,-15.113954187042093
2017-06-26T09:30:00-04:00,64.58,64.7,63.98,64.24,13603363,18688094.25,38.56505300636059,42.72427719184736,NaN,NaN,-110.07459397387387,-136.73583196159336,-0.12700980658737304,-0.7410943814738431,-0.6140845748864701,-49465439,-35682309.6,14.146917777798322,22.556075966278936,NaN,NaN,-18.158841433687055,-15.548938079419946
2017-06-27T09:30:00-04:00,64.47,64.76,64.13,64.14,14227469,18673012.35,38.036078142591705,42.84960509187081,NaN,NaN,-95.45822358844752,-133.46129835227808,-0.11877522612307345,-0.7625536075403119,-0.6437783814172384,-63692908,-46884791,12.39501638897596,22.455032270361567,NaN,NaN,-18.983302748350038,-16.039561603552816
2017-06-28T09:30:00-04:00,64.22,64.88,64.18,64.49,16859906,18711356.25,41.082153845957045,43.26306625577195,NaN,NaN,-71.73980219021806,-115.86743311558624,-0.07918217004516637,-0.7427560939736964,-0.66357392392853,-46833002,-49254199.4,12.054980531658359,22.43416550978724,NaN,NaN,-18.840362188411774,-16.43967597281838
2017-06-29T09:30:00-04:00,64.68,65.34,64.49,64.63,19022428,18763294,42.303932912103875,42.8670388337166,NaN,NaN,-41.502434466583885,-90.48190463431133,-0.03523099961057141,-0.7076126734417443,-0.6723816738311729,-27810574,-44732799.8,16.748384457627708,22.57190736903068,NaN,NaN,-18.389826223426336,-16.718268865762376
2017-06-30T09:30:00-04:00,65.1,65.22,64.5,64.92,19643151,18918324.15,44.85491423955839,42.43260621855325,NaN,NaN,-34.54997285542858,-70.66500541491038,0.018800707639290093,-0.6488807892820603,-0.6676814969213504,-8167423,-39193869.2,22.224318679560994,22.705528821019808,NaN,NaN,-17.31421526414233,-16.80340406553094
2017-07-03T09:30:00-04:00,65.15,66.48,65.08,66.17,18402800,19210840.85,54.24548024134476,42.44625235843018,NaN,NaN,49.107519540988136,-38.82858271193798,0.13754037534457964,-0.4957560277406259,-0.6332964030852055,10235377,-27253706,32.52729489738334,23.184810169857123,NaN,NaN,-13.427198607426899,-16.321089000087508
2017-07-05T09:30:00-04:00,65.84,65.9,64.585,64.83,20988215,19518487.5,45.33333781643208,42.375734539823206,NaN,NaN,-15.468240012314297,-22.830585996711342,0.12501197784798257,-0.47703143077522725,-0.6020434086232098,-10752838,-16665692,40.10439084488425,23.972579624918044,NaN,NaN,-12.734437612634188,-15.80871023045132
2017-07-06T09:30:00-04:00,64.94,65.13,63.97,64.11,20788943,19410827.95,41.39776595929103,42.22062656143036,NaN,NaN,-68.37554542922808,-22.157734644513347,0.07014608344895223,-0.5143608043120196,-0.5845068877609718,-31541781,-13607447.8,42.12601487011181,24.67033219860457,NaN,NaN,-13.4570114190902,-15.47275325739973
2017-07-07T09:30:00-04:00,63.9,64.1,63.29,64.01,16036745,19234198.15,40.86710611873273,41.72697599750773,NaN,NaN,-106.44230752030259,-35.145709255257096,0.031027101504757737,-0.5457230108800246,-0.5767501123847824,-47578526,-17561038.2,40.2353382374838,24.978475560088953,NaN,NaN,-14.191948794755458,-15.289781191307691
2017-07-10T09:30:00-04:00,63.92,64.37,63.78,64.22,14153837,18782680,42.53305400984687,41.52578092418135,NaN,NaN,-75.74508470624261,-43.384731625419896,0.02354141963645262,-0.5473233378392166,-0.5708647574756692,-33424689,-22612491.4,37.895104009685795,25.3565578735526,NaN,NaN,-14.294518708811932,-15.14760083666544
2017-07-11T09:30:00-04:00,64.33,64.8,63.93,64.57,11899827,18231452.05,45.29910477693011,41.84178559735494,NaN,NaN,-47.06013239139021,-62.61826201189557,0.045156106507051486,-0.5144196243418548,-0.5595757308489063,-21524862,-28964539.2,35.128226094431284,25.968544368097373,NaN,NaN,-13.568578882192936,-14.922026271740796
2017-07-12T09:30:00-04:00,65.21,65.37,64.47,64.75,14818635,18181991.05,46.71946897785514,42.601582145281824,NaN,NaN,2.0797227036376107,-59.108669468705195,0.07292534038317688,-0.4684190553699352,-0.5413443957531121,-6706227,-28155217,35.7716923132766,26.92818149923405,NaN,NaN,-12.56277932683068,-14.584990993896493
2017-07-13T09:30:00-04:00,64.8,65.06,64.44,65.01,10056779,17170818.9,48.788002327318615,43.52146955661433,NaN,NaN,8.613456534437658,-43.71086907597204,0.1080356174660988,-0.4062998739204886,-0.5143354913865874,3350552,-21176750.4,41.18863763984729,28.49367521966696,NaN,NaN,-11.132561152558353,-14.091786730848188
2017-07-14T09:30:00-04:00,65.05,65.52,64.99,65.4,10272535,16721500.95,51.810214288242605,44.4168333330404,NaN,NaN,74.09996116935547,-7.60241533804043,0.15395664074046495,-0.32188969046100624,-0.4758463312014712,13623087,-8936427.8,49.270414094239094,30.84405220264038,NaN,NaN,-9.044904947128012,-13.370803618888162
2017-07-17T09:30:00-04:00,65.28,65.765,65.22,65.32,12214943,16101197.45,51.14347886062038,45.315292322630384,NaN,NaN,100.03505082369172,27.55361176794644,0.1739011740469698,-0.2584698636427589,-0.43237103768972873,1408144,-1969861.2,53.21132781409795,33.63436720523321,NaN,NaN,-7.484941622761415,-12.529966190870056
2017-07-18T09:30:00-04:00,65.65,65.67,64.735,65.01,14956758,16065116.3,48.53692449138473,46.0653527761156,NaN,NaN,70.27303536031633,51.02024531828774,0.1614442026668444,-0.23056578435617325,-0.39200998702301765,-13548614,-374611.6,54.090815418910566,36.612638564514256,NaN,NaN,-6.828956211589617,-11.715536193829992
2017-07-19T09:30:00-04:00,64.94,66.02,64.89,65.96,24802698,16502079.95,55.94664907263511,47.12710243516403,NaN,NaN,127.5633115929235,76.11696309614493,0.20937390331007594,-0.13029260788542274,-0.3396665111954987,11254084,3217450.6,56.09220007707627,39.758154246329816,NaN,NaN,-4.026732335947327,-10.617135642703897
2017-07-20T09:30:00-04:00,66.33,66.565,65.58,65.76,17159291,15994771.55,54.17808399630017,47.975256084035195,NaN,NaN,153.82923019382332,105.16011782802207,0.218772727117581,-0.06620060229852243,-0.2849733294161034,-5905207,1366298.8,54.767144918521794,42.47377999353654,NaN,NaN,-2.1966109090527013,-9.414203537896583
2017-07-21T09:30:00-04:00,65.54,65.85,65.02,65.11,13861342,15916258.05,48.78092691743757,48.25568556102657,NaN,NaN,62.7060455175855,102.88133469766808,0.1743118659005285,-0.06708349704044281,-0.2413953629409713,-19766549,-5311628.4,50.163482288516214,44.46943453703334,NaN,NaN,-2.1681002714794966,-8.379045928408427
2017-07-24T09:30:00-04:00,65.25,65.35,64.84,64.99,10433371,15710151.8,47.83354186510325,47.7976899627236,NaN,NaN,21.38440908065759,87.15120634906125,0.13184957917999968,-0.07658338896597172,-0.2084329681459714,-30199920,-11633241.2,46.204038175109766,45.44634477115665,NaN,NaN,-2.4162212784347004,-7.527213835555037
2017-07-25T09:30:00-04:00,65.77,66.28,65.62,65.81,15479286,15803947.95,54.35686951963189,48.44222794152359,NaN,NaN,124.9031670084279,98.07723267868356,0.1525539955977712,-0.017740473648757416,-0.1702944692465286,-14720634,-11867645.2,46.058866597236346,45.871664467753234,NaN,NaN,-0.6704946272730034,-6.547682520086175
2017-07-26T09:30:00-04:00,66.18,66.64,65.7,65.88,21211410,16153145,54.87561934899816,49.404931755074095,NaN,NaN,132.29408512990406,99.02338738607968,0.16355376880147834,0.034147741755319316,-0.12940602704615903,6490776,-12820306.8,45.43406577766576,46.1079538182928,NaN,NaN,0.8963508657047493,-5.4842491792589
2017-07-27T09:30:00-04:00,65.9,66.58,65.6,66.55,15815914,16100945.4,59.60760670978427,50.74353894014921,NaN,NaN,135.33677675170748,95.3248966976565,0.2058120595291488,0.12785904736527698,-0.07795301216387182,22306690,-7177927.4,49.779357304447956,46.789669465933095,NaN,NaN,3.7200970603351093,-4.169342573602613
2017-07-28T09:30:00-04:00,66.33,67.1254,66.22,66.47,14765006,15888074.3,58.81452707353117,51.90650130184095,NaN,NaN,153.59470077418823,113.50262774897706,0.2171149988558662,0.19344073640596093,-0.02367426244990526,7541684,-1716280.8,53.628749199522176,47.913501265207124,NaN,NaN,5.795878821626364,-2.7457395171413306
2017-07-31T09:30:00-04:00,66.49,67,66.31,66.62,13519501,15581891.8,59.89206211640862,52.94885539751798,NaN,NaN,136.93101026554245,136.61194798595403,0.22260641855035895,0.25458376073804345,0.03197734218768449,21061185,8535940.2,59.849959673821544,49.679339378020714,NaN,NaN,7.832583919733222,-1.2345504547306805
2017-08-01T09:30:00-04:00,66.66,66.99,66.32,66.61,12668684,15295186,59.77977367947889,53.88173430477682,NaN,NaN,124.84720278378657,136.60075514102573,0.2134492297653447,0.2987888793943654,0.08533964962902067,8392501,13158567.2,62.30556675681671,51.574616123987866,NaN,NaN,9.488196148171378,0.297270488541042
2017-08-02T09:30:00-04:00,66.27,66.63,65.678,66.36,15118528,15001701.65,56.907284983572495,54.461683065937805,NaN,NaN,74.90073066024681,125.12208424709429,0.17978787865652027,0.310074497949671,0.13028661929315075,-6726027,10515206.6,60.04407356748248,52.92143297596181,NaN,NaN,10.167018588917918,1.7072345028805958
2017-08-03T09:30:00-04:00,66.25,66.36,65.14,65.43,15327803,14728644.65,47.72097682504038,54.169594675709085,NaN,NaN,15.000771713673108,101.05488323948741,0.08872659263668733,0.24119486008900992,0.1524682674523226,-22053830,1643102.6,53.080129107813256,53.19355547693139,NaN,NaN,8.085176776473752,2.6183691133939035
2017-08-04T09:30:00-04:00,65.46,65.82,65.31,65.64,9370985,14395356.65,49.6956696378211,54.066179731223414,NaN,NaN,0.720038660415864,70.47995081673295,0.03901163342095354,0.2012328092285145,0.16222117580756096,-12682845,-2401803.2,50.22035705415512,52.97991470836404,NaN,NaN,6.908610349807945,3.2312607185959092
2017-08-07T09:30:00-04:00,65.36,65.48,64.94,65.14,11437264,14259528,45.30755375003493,53.83551039255557,NaN,NaN,-57.620372289740835,31.5696743056763,-0.027581565567630972,0.12774421884802223,0.1553257844156532,-24120109,-11438062,44.45783396006968,52.29184460416112,NaN,NaN,4.5578047982267105,3.4207670156860237
2017-08-08T09:30:00-04:00,64.95,65.5599,64.8,64.99,10429131,14185993.2,44.050886963314035,52.98581309903263,NaN,NaN,-74.9782977307967,-8.395425797240355,-0.07886374642568045,0.05674610138355263,0.13560984780923308,-34549240,-20026410.2,39.785216042085,51.127060030233174,NaN,NaN,2.243140093308958,3.2525345982035856
2017-08-09T09:30:00-04:00,65.09,65.455,64.81,65.05,10437867,13966954.8,44.71147274070496,52.309626580775834,NaN,NaN,-79.74877273508774,-39.32532647630727,-0.1042795252505456,0.005260441246051073,0.10953996649659667,-24111373,-23503479.4,38.0419521337885,49.93240340275223,NaN,NaN,0.5096664870190512,2.860696296605795
2017-08-10T09:30:00-04:00,65.16,65.27,64.25,64.36,15262091,14227220.4,39.007623606202706,51.611533487116205,NaN,NaN,-141.80835459443009,-70.6871517379279,-0.1597759810045306,-0.09018000975906659,0.06959597124546402,-39373464,-26967406.2,36.33392866944589,48.9445781442472,NaN,NaN,-2.796158977268129,2.052574114623806
2017-08-11T09:30:00-04:00,64.16,64.52,63.88,63.94,15990942,14513140.75,35.997359609213376,50.76609189740979,NaN,NaN,-184.01562204466768,-107.6342838789446,-0.2136222753731217,-0.19743187297093812,0.016190402402183585,-55364406,-35503718.4,32.4654617319968,47.96325125545342,NaN,NaN,-6.571755194938228,0.8205270704006582
2017-08-14T09:30:00-04:00,64.06,64.34,63.67,63.75,11406699,14472728.55,34.693033000189615,49.36153214602105,NaN,NaN,-172.6976205659154,-130.64973353417952,-0.24844661777172738,-0.29436786981247565,-0.04592125204074827,-66771105,-44033917.6,29.128038144365703,46.753906365962656,NaN,NaN,-10.10252508154403,-0.7399089513057258
2017-08-15T09:30:00-04:00,63.85,63.85,63.14,63.51,12725622,14361171.75,33.06334373835708,47.803512459546695,NaN,NaN,-182.46300399555273,-152.14667478713073,-0.272147442712373,-0.3861055554312145,-0.11395811271884151,-79496727,-53023415,26.084785937259994,45.37181494879082,NaN,NaN,-13.569729599645319,-2.572740472497096
2017-08-16T09:30:00-04:00,63.53,63.705,62.77,62.9,16583330,13950203.35,29.296469674121624,45.638431242713644,NaN,NaN,-178.74435676394765,-171.9457915929027,-0.31062608254239243,-0.5022407158968321,-0.19161463335443962,-96080057,-67417151.8,22.102822435348372,43.394919600997994,NaN,NaN,-17.84980272984579,-4.755177937832624
2017-08-17T09:30:00-04:00,62.65,62.89,61.99,62.01,14796925,13832085.05,24.84834760065081,43.212275566079335,NaN,NaN,-200.8688921199708,-183.75789909801085,-0.3735110227620061,-0.6585034118069473,-0.2849923890449412,-110876982,-81717855.4,18.999538078919457,40.921404520954944,NaN,NaN,-23.257120581346413,-7.398312601191737
2017-08-18T09:30:00-04:00,61.85,62.74,61.81,62.32,18632664,14070651.15,28.897839864192065,40.99840254806386,NaN,NaN,-162.55068088683296,-179.46491086644392,-0.3709643230028944,-0.7486977927985592,-0.3777334697956648,-92244318,-89093837.8,17.62501956220281,37.90533737012503,NaN,NaN,-26.40134511705461,-10.11303153202929
2017-08-21T09:30:00-04:00,62.23,62.255,61.8,62,10375176,14067741.4,27.26465617939472,38.6758941552007,NaN,NaN,-146.49457076979877,-174.2243009072206,-0.3668994666108573,-0.8363578030592365,-0.46945833644837914,-102619494,-96263515.6,16.384230245183318,34.625241905008366,NaN,NaN,-29.519200350390705,-12.885341363223777
2017-08-22T09:30:00-04:00,62.17,62.55,62.13,62.41,15171824,14052368.3,32.52631454832651,36.93439626696885,NaN,NaN,-111.71686811648111,-160.07507373140623,-0.31467301285438554,-0.8627996025163611,-0.5481265896619756,-87447670,-97853704.2,16.11328213318569,31.48732823113002,NaN,NaN,-30.50545464893671,-15.402500404039909
2017-08-23T09:30:00-04:00,62.28,63,62.22,62.68,11525968,13568096.2,35.818985404054715,36.08425402261273,NaN,NaN,-87.44027939650447,-141.8142582579176,-0.24321486940748438,-0.852145176421331,-0.6089303070138467,-75921702,-93822033.2,19.73733715941013,29.105700234815515,NaN,NaN,-30.309811372899237,-17.5321162567341
2017-08-24T09:30:00-04:00,62.46,62.87,62.44,62.72,10390508,13296825.9,36.31481586840777,35.12847875336892,NaN,NaN,-76.83914168374756,-117.00830817067295,-0.17757235619420986,-0.8308957522566089,-0.6533233960623991,-65531194,-84752875.6,27.341549887648256,27.471499722922168,NaN,NaN,-30.007192654166236,-19.314270027795832
2017-08-25T09:30:00-04:00,62.84,63.25,62.82,63,8220210,12969586.1,39.81962400691085,34.7364837717172,NaN,NaN,-54.80373914273671,-95.4589198218537,-0.10329509372044055,-0.7824422632129497,-0.6791471694925092,-57310984,-77766208.8,32.63640088045139,26.627111645806572,NaN,NaN,-28.731117800000877,-20.659533995253696
2017-08-28T09:30:00-04:00,63.03,63.24,62.38,62.72,9956048,12791413.45,37.59168975175089,34.275112542319825,NaN,NaN,-60.827845571302895,-78.32557478215452,-0.06300193585416314,-0.7578995893102132,-0.69489765345605,-67267032,-70695716.4,37.59280371029409,26.470510764964367,NaN,NaN,-28.268546193854093,-21.746535737910897
2017-08-29T09:30:00-04:00,62.42,62.72,62.18,62.64,8727081,12594333.3,36.95547945139681,33.72111302165496,NaN,NaN,-68.62613025263418,-69.70742720938512,-0.03321446337166889,-0.7364157326706362,-0.7032012692989673,-75994113,-68405005,39.15477559184664,26.549998154825662,NaN,NaN,-28.058518856669135,-22.648247612019215
2017-08-30T09:30:00-04:00,62.4,62.8563,62.215,62.67,8664419,12271627.85,37.38345005043603,33.60510062481448,NaN,NaN,-59.82796857937453,-64.18496504595912,-0.004477613987209694,-0.7087982867829794,-0.7043206727957697,-67329694,-66686603.4,40.360672691128016,26.837622727802955,NaN,NaN,-27.76951181176086,-23.37985678341088
2017-08-31T09:30:00-04:00,62.94,63.13,62.73,62.97,10333681,12021921.75,41.649224641084366,34.00880526994813,NaN,NaN,-32.44169755331498,-55.3054762198726,0.039335266681993164,-0.6551515894432782,-0.6944868561252714,-56996013,-64979567.2,41.598919958140456,27.49001260109893,NaN,NaN,-26.353179516234004,-23.804617173814183
2017-09-01T09:30:00-04:00,63.07,63.79,62.91,63.58,11595543,12133149.65,49.2238597481961,35.0467214662343,NaN,NaN,8.998988956961849,-42.5449305999329,0.10999459084118679,-0.556993617573788,-0.6669882084149747,-45400470,-62597464.4,43.36599253652119,28.507009343395755,NaN,NaN,-22.80408612938422,-23.661684167467044
2017-09-05T09:30:00-04:00,63.84,64.24,63.48,63.93,18114752,12467024.05,52.994271381647465,36.470359155040754,NaN,NaN,54.98892412398606,-19.381576660875105,0.17693337463170788,-0.4458214901253399,-0.6227548647570478,-27285718,-54601201.6,48.949936345275816,30.14023437253974,NaN,NaN,-18.597210367330398,-22.938187910304666
2017-09-06T09:30:00-04:00,64.25,65.15,64.22,64.97,17052125,12798173.75,62.01918980368871,38.80769630715269,NaN,NaN,137.4992164334873,21.843492676349143,0.2816620752240617,-0.2706772707269707,-0.5523393459510324,-10233593,-41449097.6,56.54001351375498,32.60003373528307,NaN,NaN,-11.486449318247995,-21.30222525429657
2017-09-07T09:30:00-04:00,65,65.25,64.66,65.09,8640332,12708297,62.9042030915176,41.525971699357456,NaN,NaN,158.8114283601417,65.57137206425239,0.34523249645835624,-0.12079872537808711,-0.46603122183644335,-1593261,-28301811,62.536344938692785,35.70980565383831,NaN,NaN,-5.554486422392272,-19.05254827831024
2017-09-08T09:30:00-04:00,64.95,64.99,64.1,64.4,10264742,12458429.55,54.9722265312785,43.38842788986363,NaN,NaN,115.57660307811528,95.17503219053845,0.32719407664806527,-0.05703862602636178,-0.38423270267442705,-11858003,-19274209,66.00478932979536,39.16550349438063,NaN,NaN,-2.916841722256839,-16.747447341731185
2017-09-11T09:30:00-04:00,64.65,65.1,64.5,65.01,13551055,12336435.2,59.79847535734036,45.71227211685975,NaN,NaN,137.44478148484328,120.86419069611472,0.34116764154826107,0.04222684926089926,-0.2989407922873618,1693052,-9855504.6,69.20786927309805,42.93862056780311,NaN,NaN,0.9737382140618657,-14.21584940518932
2017-09-12T09:30:00-04:00,65.2,65.55,65.03,65.41,9409697,12236585.1,62.627254732644936,47.86233927288249,NaN,NaN,153.97466698022842,140.6613392673632,0.36029388145958086,0.15142655953711426,-0.2088673219224666,11102749,-2177811.2,71.56021240152317,46.899115586970076,NaN,NaN,5.114261949595074,-11.454404925934409
2017-09-13T09:30:00-04:00,65.55,66.27,65.48,66.23,15893275,12394967.75,67.65228523445666,50.13614640362549,NaN,NaN,166.23451101673825,146.40839818401338,0.4076293253108229,0.30066933471606205,-0.10695999059476086,26996024,5268112.2,73.66167454760458,50.7508539718411,NaN,NaN,10.490393496249418,-8.319433722765291
2017-09-14T09:30:00-04:00,66.36,67,66.35,66.55,14583401,12294971.3,69.38240280234669,52.49811689890684,NaN,NaN,167.40559316226938,148.12723114443892,0.4373264479075723,0.43969806928970456,0.002371621382132247,41579425,13902649.4,75.88680353597293,54.21837208957859,NaN,NaN,15.376877098933834,-4.934246462522559
2017-09-15T09:30:00-04:00,65.82,65.84,65.4,65.84,13068128,12208531.45,61.52022309134858,54.04815969065238,NaN,NaN,101.07026117345679,145.22596276350723,0.38768249104536445,0.4869747351888378,0.09929224414347336,28511297,21976509.4,77.7773594505489,57.442726273156985,NaN,NaN,16.840903540990134,-1.8235107477350314
2017-09-18T09:30:00-04:00,65.69,66.16,65.64,66.12,12583545,11906075.5,63.28706270996164,55.88354347338173,NaN,NaN,102.62890887755923,138.26278824205042,0.35320738128416185,0.5408014707486757,0.18759408946451384,41094842,29856867.4,79.46931013710045,60.43390530364315,NaN,NaN,18.589912327826042,1.0926925487736932
2017-09-19T09:30:00-04:00,66.26,66.485,66.13,66.39,10504257,11912529.55,64.95794026576989,57.88371924583695,NaN,NaN,108.49626116819208,129.16710707964313,0.32860384553094735,0.598348896378198,0.26974505084725064,51599099,37956137.4,81.06497789072122,63.42749118213419,NaN,NaN,20.5367318072559,3.8704124428425795
2017-09-20T09:30:00-04:00,66.58,67.02,66.521,66.84,18273771,12067626.9,67.60428543525066,60.04235034475228,NaN,NaN,119.07289133601546,119.73478314349859,0.32221560397484666,0.672514555815809,0.3502989518409623,69872870,46531506.6,82.60639495908507,66.44504277270255,NaN,NaN,23.01205302149089,6.604932525506624
2017-09-21T09:30:00-04:00,66.75,67.025,66.56,66.86,8874083,11935032.65,67.72096092349878,61.90461722206759,NaN,NaN,109.51105767820991,108.1558760466867,0.2994032481304939,0.7245530120040797,0.42514976387358583,78746953,53965012.2,83.8348509162197,69.46189498399393,NaN,NaN,25.00852757879165,9.23401753311877
2017-09-22T09:30:00-04:00,66.8,67.39,66.73,67.2,14647937,12147904.1,69.71767070572344,63.36846086189097,NaN,NaN,113.96275165711972,110.73437414341927,0.28723168888332545,0.7841893749777427,0.4969576860944172,93394890,66941730.8,85.7296397656227,72.4878697860726,NaN,NaN,27.295160807695023,11.814180858058235
2017-09-25T09:30:00-04:00,67.51,68.37,67.445,68.17,14833769,12478582.05,74.55377082102154,64.90842510756055,NaN,NaN,141.04222967697498,118.4170383033024,0.32191809713025465,0.8993553075072356,0.5774372103769809,108228659,80368494.2,87.37816210438326,75.23274305458027,NaN,NaN,30.983405853523305,14.552641571696102
2017-09-26T09:30:00-04:00,68,68.265,67.81,68.14,10710700,12516314.65,74.15930817946204,65.7755764201158,NaN,NaN,130.97977236102383,122.91374054186876,0.3196044724975341,0.9769428009988985,0.6573383285013644,97517959,89552266.2,88.3679677745976,77.50616835892617,NaN,NaN,33.77124113199653,17.298155794596163
2017-09-27T09:30:00-04:00,68.2,68.45,67.82,68.43,10918244,12625872.8,75.5083215080504,66.67587059272527,NaN,NaN,127.50673018098377,124.60050831086241,0.31391443727145796,1.049731375090687,0.735816937819229,108436203,97264932.8,89.13832521725102,79.40630980739463,NaN,NaN,36.50917131714464,20.04258658353166
2017-09-28T09:30:00-04:00,68.58,68.9,68.3,68.49,11799895,12782646.6,75.78993021671636,68.16284942739942,NaN,NaN,133.17148047437757,129.33259287009597,0.29101287716731095,1.0995830342783677,0.8085701571110567,120236098,105562761.8,89.91237719845695,81.11399465515616,NaN,NaN,38.81870278790673,22.724888898442384
2017-09-29T09:30:00-04:00,68.25,68.49,68.03,68.48,14287467,12980335.9,75.6338394866428,69.29394686520673,NaN,NaN,110.9806337182121,128.73616928231442,0.2533934906557813,1.1253120204307834,0.8719185297750021,105948631,108073510,90.14131406057206,82.6092407114043,NaN,NaN,40.67181493358271,25.288735474891002
2017-10-02T09:30:00-04:00,67.75,68.48,67.49,68.46,12416792,13021398.35,75.29981814881867,70.199129966362,NaN,NaN,92.6644840481627,119.06062015655198,0.20730561442819595,1.131050547810247,0.9237449333820511,93531839,105134146,87.63385583549076,83.75735809954485,NaN,NaN,42.13166677600913,27.694868517907878
2017-10-03T09:30:00-04:00,68.37,68.62,68.24,68.39,7239789,12477650.2,74.06689800670246,70.65731659295098,NaN,NaN,99.16073474938509,112.69681263422422,0.15466248091717227,1.1170730345285165,0.9624105536113442,86292050,102888964.2,85.67348125980855,84.6153442932737,NaN,NaN,43.063420024252636,29.89037587595713
2017-10-04T09:30:00-04:00,68.39,68.59,68.1,68.34,10197587,12134923.3,73.14562986731133,70.92611852616274,NaN,NaN,86.21188853812666,104.43784430565279,0.10159412538196577,1.0894032103388014,0.9878090849568356,76094463,96420616.2,80.11318794398889,84.91722889384629,NaN,NaN,43.63275949980306,31.85357353650655
2017-10-05T09:30:00-04:00,68.39,68.76,68.35,68.65,10161797,12210996.55,75.2048597753478,71.90359257501983,NaN,NaN,90.4251544447519,95.88857909972765,0.07378398522061014,1.0800390664825983,1.0062550812619881,86256260,89624648.6,74.63265508812924,84.69260715367344,NaN,NaN,44.66740954807181,33.68412153815873
2017-10-06T09:30:00-04:00,68,68.375,67.84,68.07,11963273,12295923.1,65.14038389207843,72.03597265945675,NaN,NaN,55.167362484434555,84.72592485297216,0.006297169198974828,1.0141265427607067,1.0078293735617319,74292987,83293519.8,69.83936631025426,84.00475402318443,NaN,NaN,42.823463018173,34.989741749589335
2017-10-09T09:30:00-04:00,68.15,68.415,68.07,68.21,5764084,11906574.55,66.3123125704218,72.13271353836045,NaN,NaN,57.726098807359776,77.73824780481155,-0.03658608274808872,0.962096770126621,0.9986828528747097,80057071,80598566.2,67.84199798410864,83.06025545842638,NaN,NaN,41.57094250818313,35.9299132865313
2017-10-10T09:30:00-04:00,68.69,68.93,68.2,68.27,7763702,11824274.8,66.8270322888503,72.07719545647471,NaN,NaN,68.66265539950504,71.63863193483556,-0.06682231247739423,0.9151549622779669,0.9819772747553611,87820773,80904310.8,67.95397380075592,82.01365394711716,NaN,NaN,40.651016303847676,36.604356574719354
2017-10-11T09:30:00-04:00,68.19,68.465,67.91,68.43,10287024,11543962.25,68.2214321902744,72.11294340410154,NaN,NaN,49.66278853238024,64.32881193368627,-0.08101253262007824,0.8807116089802633,0.9617241416003416,98107797,85306977.6,69.59574005252145,80.99657459971014,NaN,NaN,40.21303828331591,37.11988253309029
2017-10-12T09:30:00-04:00,67.91,68.265,67.8,68.18,10181097,11323847.05,63.714839380814205,71.6841697380366,NaN,NaN,30.888978973871573,52.4215768395102,-0.11038214824487735,0.8237464562942449,0.9341286045391223,87926700,85641065.6,69.7225014080098,79.85320757416638,NaN,NaN,38.60385751283516,37.33187895876813
2017-10-13T09:30:00-04:00,68.58,68.78,68.1,68.14,8893702,11115125.75,62.997776283204786,70.85874155676397,NaN,NaN,51.03169227636123,51.59444279789553,-0.13407301845647634,0.7665373314685269,0.9006103499250032,79032998,86589067.8,70.10339828797699,78.6192958729945,NaN,NaN,37.05836025405873,37.29280485809536
2017-10-16T09:30:00-04:00,68.35,68.6863,68.15,68.29,7666914,10869294.2,64.60641063711415,70.17639173231053,NaN,NaN,54.17397507678035,50.88401805177965,-0.1405317108402756,0.7249457113746587,0.8654774222149343,86699912,87917636,70.66045572632922,77.35447358383247,NaN,NaN,36.117200078419586,37.124861318141676
2017-10-17T09:30:00-04:00,68.27,68.475,67.961,68.33,8377136,10762938.15,65.04284507228917,69.42885770118474,NaN,NaN,33.27348449219435,43.80618387031751,-0.14255067550143175,0.6872890778381446,0.8298397533395764,95077048,89368891,71.28975837371546,76.07957595215136,NaN,NaN,35.42359475831235,36.88182323816606
2017-10-18T09:30:00-04:00,68.28,68.56,67.77,67.85,7706312,10234565.2,56.10270838829782,68.02262757058342,NaN,NaN,-19.189022971821686,30.03582156947713,-0.17454135073480126,0.6116630649210748,0.7862044156558761,87370736,87221478.8,68.93365746228011,74.58109597099588,NaN,NaN,32.26371072784531,36.2220928795488
2017-10-19T09:30:00-04:00,67.38,67.92,67.35,67.64,7591879,10170455,52.690469426852715,66.38381542345556,NaN,NaN,-160.931094175323,-8.328193060361787,-0.2060121251733239,0.5286892591892212,0.7347013843625451,79778857,85591910.2,67.12079136291767,72.93677292116341,NaN,NaN,28.54330610923518,35.125123340932575
2017-10-20T09:30:00-04:00,67.79,67.81,67.32,67.77,9820249,9929070.6,54.53400307647767,64.90054291828834,NaN,NaN,-197.42135245535258,-58.01880200670455,-0.21333973686348062,0.46802671328319434,0.681366450146675,89599106,87705131.8,68.28558292535783,71.55475342758248,NaN,NaN,25.86581610703907,33.80236516466208
2017-10-23T09:30:00-04:00,67.82,68.04,67.36,67.42,8655313,9620147.8,48.998070593312065,63.109912388760456,NaN,NaN,-178.43902169102034,-104.5414013602647,-0.2352969905786202,0.3872452119233998,0.62254220250202,80943793,86553908,66.89524142212423,70.21345058203362,NaN,NaN,21.83137454624208,32.09222364774494
2017-10-24T09:30:00-04:00,67.66,67.85,67.405,67.55,9820238,9575624.7,50.98821203707494,61.52723968660071,NaN,NaN,-152.87299100099565,-141.7706964589027,-0.2341040168996772,0.3299121813774235,0.5640161982771007,90764031,85691304.6,65.81394080284369,69.19207578623752,NaN,NaN,18.976438910583905,30.21854011386479
2017-10-25T09:30:00-04:00,67.43,67.625,66.87,67.08,13522747,9705849.85,44.263384578532936,59.31713431539965,NaN,NaN,-205.39910296546316,-179.01271245763098,-0.25622049471780783,0.24374057987984088,0.4999610745976487,77241284,83665414.2,63.228963391754895,68.37752637935364,NaN,NaN,14.284902106525399,27.942306112816304
2017-10-26T09:30:00-04:00,67.11,67.44,66.82,67.22,9362173,9583963.75,46.52579084123621,57.98752052605378,NaN,NaN,-171.89630630798666,-181.2057548841637,-0.2522747495779064,0.18461763762526573,0.43689238720317214,86603457,85030334.2,64.24782969900377,67.97813090712147,NaN,NaN,11.04439662193213,25.528319042689994
2017-10-27T09:30:00-04:00,66.87,67.7,66.34,67.34,16187992,9678990,48.4570354699405,56.71214359030511,NaN,NaN,-145.65050589686757,-170.85158557246672,-0.23290191856947268,0.14576498899133128,0.37866690756080396,102791449,87668802.8,66.19762049927057,67.86067537249016,NaN,NaN,8.89246969826983,23.151769136344257
2017-10-30T09:30:00-04:00,67.44,67.88,67.3101,67.69,11614807,9638890.75,53.70833946242147,55.77509410270305,NaN,NaN,-53.9647546939684,-145.9567321730563,-0.18966635156280465,0.14158396810729812,0.33125031967010277,114406256,94361295.4,70.58034204339754,68.04827310410742,NaN,NaN,8.556121825495712,21.066676663365893
2017-10-31T09:30:00-04:00,67.72,68.16,67.42,67.91,9648980,9759350.3,56.69493094042611,54.95177258485675,NaN,NaN,-16.307096382076484,-118.64355324927251,-0.14160457211187216,0.15424460453026256,0.2958491766421347,124055236,101019536.4,74.16872469151467,68.3749148640355,NaN,NaN,9.173524543833109,19.367654932004065
2017-11-01T09:30:00-04:00,68.32,68.995,68.29,68.68,17306253,10114783.6,65.16585745458273,55.05541673298307,NaN,NaN,117.17380053309415,-54.128972549561034,-0.05761483353406793,0.22383063472454978,0.2814454682586177,141361489,113843577.4,79.38436770899708,69.06504817124888,NaN,NaN,12.682595500096767,18.412646441731592
2017-11-02T09:30:00-04:00,68.68,68.87,68.065,68.48,11328296,10173108.55,61.78520427076809,54.968804446380446,NaN,NaN,89.14851821110898,-1.9200076457419186,-0.01728084514171002,0.2598444118314802,0.27712525697319024,130033193,122529524.6,82.03083684284121,69.9170080680249,NaN,NaN,14.413106557793492,17.841283601169007
2017-11-03T09:30:00-04:00,68.45,68.95,68.38,68.68,11111879,10130538.85,63.80723147360038,54.91172022041518,NaN,NaN,110.23916497333671,49.257926528298945,0.01914264253523673,0.30105356014223617,0.28191091760699943,141145072,130200249.2,83.98596341833695,70.86883004602545,NaN,NaN,16.483994265262993,17.647385124611006
2017-11-06T09:30:00-05:00,68.99,70.34,68.87,70.25,19099969,10797333.1,74.99309890538095,55.6224526370646,NaN,NaN,237.6966835469235,107.59021417647736,0.1385922941874872,0.4551512853413584,0.3165589911538712,160245041,139368006.2,85.95311743794146,71.9162128363273,NaN,NaN,23.266177602042653,18.4500697642441
2017-11-07T09:30:00-05:00,70.37,70.4651,69.79,70.16,13410298,11079662.9,73.5890298095859,56.87147559572803,NaN,NaN,229.28059601229762,156.70775265535218,0.19756618700443862,0.5635167249094195,0.3659505379049809,146834743,143923907.6,86.81960415272152,73.19378045707312,NaN,NaN,27.709606787641995,19.772860767586653
2017-11-08T09:30:00-05:00,69.99,70.17,69.4301,69.82,14246622,11277642.8,68.38043994053763,57.992187775276946,NaN,NaN,159.59928277818784,165.1928491043709,0.1991388276242545,0.614874072435299,0.4157352448110445,132588121,142169234,84.6537224826595,74.44613267991181,NaN,NaN,29.370000292004562,21.143880699646356
2017-11-09T09:30:00-05:00,69.55,70.15,69.45,70.03,12988863,11418031.1,69.80214103624577,59.08276905811753,NaN,NaN,140.54479380179532,175.4721042225082,0.19929687242390737,0.6648563353409287,0.4655594629170213,145576984,145277992.2,85.35099161138322,75.66509044319935,NaN,NaN,31.16125370576096,22.574933986234157
2017-11-10T09:30:00-05:00,69.91,69.97,69.1301,69.66,10534238,11500057.9,64.31516601900788,60.17684730281009,NaN,NaN,100.11242834718365,173.44675689727757,0.16109150809908757,0.6669238480408808,0.5058323399417932,135042746,144057527,83.74232683015975,76.86845368663046,NaN,NaN,30.77923193880143,23.746976550886625
2017-11-13T09:30:00-05:00,69.47,69.73,69.18,69.26,7489798,11491202.1,58.922672565760934,60.74359448343051,NaN,NaN,74.87742451097986,140.88290509008885,0.09856180044011786,0.6290345904919405,0.5304727900518227,127552948,137519108.4,75.52927944710073,77.56240644693455,NaN,NaN,28.639948144510214,24.44597249283285
2017-11-14T09:30:00-05:00,69,69,68.06,68.14,16527694,11898730,47.03186945832677,60.941343403415786,NaN,NaN,-1.1071081743475588,94.8053642527598,-0.022109384007858113,0.5028360600420001,0.5249454440498582,111025254,130357210.6,67.69731301718649,77.88157427732251,NaN,NaN,22.16316078625659,24.11985653475053
2017-11-15T09:30:00-05:00,67.53,67.67,67.09,67.37,17693128,12398070.8,40.91819138840252,60.54080058535624,NaN,NaN,-74.23661863479327,48.03818397016357,-0.15051016273654005,0.33680774062918317,0.4873179033657232,93332126,122506011.6,60.3137746779352,77.60057034724618,NaN,NaN,14.426690873484615,22.735118583141112
2017-11-16T09:30:00-05:00,67.16,67.4,66.91,67.1,12513950,12644174.35,39.0036141214719,59.86555620332276,NaN,NaN,-87.70746663979854,2.387731881844812,-0.24477284540527267,0.1813518466091324,0.42612469201440506,80818176,109554250,50.5240817037139,76.48103186184927,NaN,NaN,7.804742706411506,20.60220774360831
2017-11-17T09:30:00-05:00,67.23,67.57,67.06,67.43,9172427,12611783.25,42.54228121168245,59.06798061398426,NaN,NaN,-70.04660682464085,-31.644075152520088,-0.27384854012354404,0.08381401685997503,0.35766255698351906,89990603,100543821.4,45.04620714207844,74.65716508318361,NaN,NaN,3.7880728026976738,18.200188466335362
2017-11-20T09:30:00-05:00,67.35,67.41,66.975,67.27,7785255,12568280.35,41.29148423158663,57.96773442049573,NaN,NaN,-76.65875885576752,-61.95131182586955,-0.29118859676768155,-0.006323188976082861,0.2848654077915987,82205348,91474301.4,40.308835629915485,72.23860157878367,NaN,NaN,0.2274224137982212,15.632650458830057
2017-11-21T09:30:00-05:00,67.53,67.8,67.28,67.42,8464364,12500486.65,42.98394713476082,56.38331225479417,NaN,NaN,-56.439757773433634,-73.01784174568677,-0.27981683490477216,-0.06490563583936648,0.21491119906540565,90669712,87403193,38.35873707096225,69.30819939035261,NaN,NaN,-2.093123138093453,13.100397087840983
2017-11-22T09:30:00-05:00,67.82,67.955,67.65,67.69,9307472,12289722.9,46.001513518364554,55.25590577247963,NaN,NaN,-41.33686576979028,-66.43789117268616,-0.24274930916380472,-0.08852543738935026,0.15422387177445446,99977184,88732204.6,39.389607759878125,66.2623973129981,NaN,NaN,-3.0943456198694586,10.786862415310921
2017-11-24T09:30:00-05:00,67.96,68.1,67.87,67.88,4990724,12071150.45,48.083784427422785,54.132802412038366,NaN,NaN,-32.339192592154866,-55.36423636315743,-0.19607145571096046,-0.09086544786424611,0.10520600784671434,104967908,93562151,43.113041266222204,63.34290287356134,NaN,NaN,-3.299417591717141,8.774536700021198
2017-11-27T09:30:00-05:00,67.59,67.67,67.045,67.19,10595899,11791545.8,41.78248542154937,51.76061573462182,NaN,NaN,-81.99756461711718,-57.75442792165269,-0.20152962289159576,-0.1467060207677804,0.05482360212381539,94372009,94438432.2,43.787745412398564,60.33109058602256,NaN,NaN,-5.463670706978982,6.740507070449744
2017-11-28T09:30:00-05:00,67.26,67.81,67.18,67.71,12113321,11816471.5,47.379137916138156,49.888480599375555,NaN,NaN,-61.665135649380915,-54.75570328037536,-0.16170081162473254,-0.1473024124071003,0.014398399217632252,106485330,99294428.6,47.5035282428451,57.522799449602815,NaN,NaN,-5.520248061208762,4.9889706230699575
2017-11-29T09:30:00-05:00,67.68,68.205,67.54,68.08,13599337,12013989.35,50.98946994633108,48.646268456932226,NaN,NaN,-34.23407819090627,-50.31456736386989,-0.10477899243639333,-0.1165753413278594,-0.01179634889146608,120084667,105177419.6,51.671521017272475,55.16692791636088,NaN,NaN,-4.411626507180972,3.6460281758912534
2017-11-30T09:30:00-05:00,68.24,69.23,68.24,69.1,22303582,12263855.8,59.283137484634494,47.894911060388566,NaN,NaN,33.50761330073313,-35.34567154976521,0.0015927511497016763,-0.009805409954338984,-0.01139816110404066,142388249,113659632.6,56.97557124186617,53.1401121756811,NaN,NaN,-0.49344119608746245,3.0546754084657226
2017-12-01T09:30:00-05:00,69.59,70.16,68.94,69.68,21188342,12756858.1,63.1062934624137,47.80856302063184,NaN,NaN,78.72711538942096,-13.132409953450042,0.10529916449248773,0.120225794511569,0.014926630019081273,163576591,125381369.2,63.01621619124645,51.659675701473006,NaN,NaN,4.097061834075911,3.2035877549814638
2017-12-04T09:30:00-05:00,69.75,70.75,69.43,69.65,13575949,12880061.6,62.777946681676056,48.083939743197206,NaN,NaN,91.93661621784321,21.654426213542035,0.16272976589616098,0.2183388373892825,0.055609071493121526,150000642,136507095.8,67.65773147176269,51.09742227466311,NaN,NaN,7.522411781418324,3.8205626159010153
2017-12-05T09:30:00-05:00,69.65,69.9,69.27,69.35,10683240,12459225.15,59.44694890518453,48.97073113225847,NaN,NaN,65.7285606296625,47.133165469350715,0.17054331457861854,0.2687882147163947,0.09824490013777616,139317402,143073510.2,70.04704276720864,51.26526011395041,NaN,NaN,9.301729987837337,4.603586526177633
2017-12-06T09:30:00-05:00,69.15,69.27,68.351,68.45,12061155,12391768,50.7475669529727,49.672829386870625,NaN,NaN,18.0710048633218,57.59418208019633,0.10816895572235902,0.23345609479072493,0.12528713906836592,127256247,144507826.2,70.55867841727775,51.997038952474874,NaN,NaN,7.997505959522585,5.088432159512626
2017-12-07T09:30:00-05:00,68.38,68.77,68.32,68.65,8639978,12111435.8,52.41408278580474,50.63072000575154,NaN,NaN,15.657350344907963,54.024129489031296,0.07502483441555508,0.21906818208780976,0.14404334767225468,135896225,143209421.4,69.40296784405362,53.345530819641986,NaN,NaN,7.489032144555312,5.431375014518724
2017-12-08T09:30:00-05:00,69,69.31,66.6863,69.28,10696685,11996826.9,57.31373392677553,51.68582377111534,NaN,NaN,10.19681680444772,40.31806977203665,0.08920972799591934,0.25555550766715385,0.1663457796712345,146592910,139812685.2,66.34156317758658,54.86662767932114,NaN,NaN,8.651701676748973,5.891421680551617
2017-12-11T09:30:00-05:00,69.41,70.135,69.37,69.78,11316715,12035950.75,60.76643240845467,53.07689149803449,NaN,NaN,120.45111125429354,46.02096877932671,0.12381631231957996,0.3211161700707095,0.19729985775112951,157909625,141394481.8,67.07002631928006,56.77814129999005,NaN,NaN,10.755159008434068,6.586241298820538
2017-12-12T09:30:00-05:00,70.05,70.13,69.495,69.59,11758230,12249372.35,58.819459987768155,54.207999558963586,NaN,NaN,114.57464099940154,55.79018485327451,0.12509229197690125,0.3536652227222561,0.22857293074535484,146151395,142761280.4,67.72013200021652,58.87538379493677,NaN,NaN,11.840463464846447,7.336844465395668
2017-12-13T09:30:00-05:00,69.59,69.75,69.285,69.49,9216049,11883790.1,57.77032361785048,55.04862885178401,NaN,NaN,85.56243406507016,69.28847069362419,0.11086888449500765,0.3671590363641144,0.25629015186910675,136935346,144697100.2,68.6637256806709,60.96639221785055,NaN,NaN,12.405220628026955,8.060898202914423
2017-12-14T09:30:00-05:00,69.23,69.73,69.21,69.24,11782846,11588276,55.12322442593451,55.55144599453485,NaN,NaN,69.43340026837626,80.04368067831783,0.07785103376364955,0.3536039440736687,0.27575291031001914,125152500,142548355.2,66.34542950733109,62.62584852078688,NaN,NaN,12.108561865585433,8.639135869010282
2017-12-15T09:30:00-05:00,69.27,69.27,68.625,68.72,10153405,11470248.75,49.992075701384195,56.13784530023734,NaN,NaN,24.444732548391073,82.89326382710651,0.017375832922788714,0.297472701463505,0.2800968685407163,114999095,136229592.2,59.936775845086665,63.779350694550324,NaN,NaN,10.308186469284042,8.87757166904939
2017-12-18T09:30:00-05:00,68.89,69.595,68.87,69.25,9660685,11494661.65,54.62789139502331,56.65561340587199,NaN,NaN,49.04319606688596,68.611680789625,0.009830050899706178,0.29238443216534904,0.28255438126564286,124659780,129579623.2,54.02248611169136,64.24499054232506,NaN,NaN,10.151857068218204,9.05961244035922
2017-12-19T09:30:00-05:00,69.57,69.75,69.19,69.35,6764247,11443611.25,55.46673440417443,56.97541801000365,NaN,NaN,59.67673189992268,57.63209896972923,0.008390965424835473,0.2930430880466872,0.28465212262185174,131424027,126634149.6,51.594037429763205,64.23945600036011,NaN,NaN,10.26999927305028,9.232524845029372
2017-12-20T09:30:00-05:00,69.58,70.45,69.37,70.33,12254496,11633117.85,62.7374205893475,57.22215251748316,NaN,NaN,107.34576687998846,61.988765532712875,0.06699529773058965,0.3683962447850888,0.30140094705449916,143678523,127982785,52.643715416730714,63.930037727136146,NaN,NaN,12.719921104778715,9.73072431070785
2017-12-21T09:30:00-05:00,70.36,72.03,70.29,71.82,16803132,12007900.85,70.59740086751148,57.757231617847296,NaN,NaN,201.37445262934975,88.37697600490758,0.19255585784013984,0.542095769354674,0.3495399115145341,160481655,135048616,57.80620503291718,63.557894072969766,NaN,NaN,17.93930666808125,10.903378933189764
2017-12-22T09:30:00-05:00,71.9,72.26,71.6001,71.97,10660816,12291405.45,71.25476215154819,58.362718437123874,NaN,NaN,218.6580037066617,127.21963023656171,0.2675466490737385,0.6839732228567073,0.41642657378296877,171142471,146277291.2,64.44040210037197,63.328084832156144,NaN,NaN,22.158939042666574,12.511316091686451
2017-12-26T09:30:00-05:00,72.23,72.72,72.08,72.6,8631105,12193165.75,73.89463021790893,59.394695673747044,NaN,NaN,228.60411189258042,163.13181340170058,0.3369328333823677,0.8375926155109283,0.5006597821285607,179773576,157300050.4,69.50870071098825,63.289631828140394,NaN,NaN,26.583097357164036,14.52157055818325
2017-12-27T09:30:00-05:00,72.61,72.64,72.214,72.36,10855316,12130265.5,71.21161862650658,60.85641365042803,NaN,NaN,184.31747140126575,188.0599613019692,0.34287951460986865,0.9292591753908965,0.5863796607810279,168918260,164798897,72.39163578306666,63.420557354268176,NaN,NaN,29.22865831932574,16.62258309548932
2017-12-28T09:30:00-05:00,72.35,72.47,72.225,72.47,7966785,11848637.9,71.71846778549791,62.23529829326326,NaN,NaN,149.92969122097762,196.57674617016704,0.33030650004214357,0.9992627858337073,0.6689562857915637,176885045,171440201.4,74.67537038990528,63.79715753611472,NaN,NaN,31.489543127737406,18.746434528667617
2017-12-29T09:30:00-05:00,72.66,72.7,72.1401,72.26,7356372,11101277.4,69.21315796439403,63.08525715309315,NaN,NaN,122.84043982637465,180.86994360957203,0.2856103093862903,1.0259691725244267,0.7403588631381364,169528673,173249605,75.2754381697441,64.43529146412597,NaN,NaN,32.6057222092972,20.72633276875756
2018-01-02T09:30:00-05:00,72.62,73.53,72.39,73.45,14891354,10786428,74.6229844328156,64.07501086911893,NaN,NaN,135.93763229632305,164.3258693275043,0.3118167481354627,1.1301297983074647,0.8183130501720021,184420027,175905116.2,76.16795395547938,65.08514343814021,NaN,NaN,35.435186504740884,22.827597588183746
2018-01-03T09:30:00-05:00,73.6,74.74,73.52,74.55,19299630,11072612.05,78.40113697470152,65.4737020824713,NaN,NaN,156.54012820567047,149.9130725901223,0.3746355133735786,1.2866074418889752,0.9119719285153967,203719657,180694332.4,77.72937724415583,65.80008952699302,NaN,NaN,39.270622512028176,25.17660114873295
2018-01-04T09:30:00-05:00,74.5,75.05,74.23,75,14306843,11253792.2,79.7306232243828,67.04229491150934,NaN,NaN,148.94848744895324,142.8392757996598,0.4147737604820141,1.4304391291179144,1.0156653686359003,218026500,190515980.4,80.54455089802053,66.64871989966085,NaN,NaN,42.80306267617583,27.69466708122479
2018-01-05T09:30:00-05:00,74.9,75.03,74.35,74.97,14204426,11360955.75,79.37982569588083,68.77490928793408,NaN,NaN,131.534377478323,139.1602130511289,0.407014353049971,1.524433309948364,1.117418956898393,203822074,195903386.2,81.89636977285792,67.75950134719848,NaN,NaN,45.428536329375525,30.22807697381775
2018-01-08T09:30:00-05:00,74.94,75.46,74.7353,75.42,9779217,11417917.7,80.74812275161663,70.9717697915221,NaN,NaN,131.1610716069174,140.82433940723743,0.3993451952344551,1.616600450941462,1.2172552557070069,213601291,204717909.8,83.87101112171636,69.46908958124347,NaN,NaN,48.05290008204229,32.77448027499268
2018-01-09T09:30:00-05:00,75.57,75.59,75.11,75.23,9234491,11344808,78.38309501284688,72.66857004993808,NaN,NaN,122.4342444408289,138.1236618361386,0.3503811407330619,1.6552316816233343,1.3048505408902724,204366800,208707264.4,84.68519501543973,71.65928307436835,NaN,NaN,49.47873152457899,35.16080188207644
2018-01-10T09:30:00-05:00,75.45,75.5,75.08,75.14,10821983,11320071.4,77.22921927778324,74.22303325519583,NaN,NaN,108.74786199423856,128.56520859385222,0.28368419853750226,1.6594557890621502,1.375771590524648,193544817,206672296.4,82.40021023926111,73.85972398933248,NaN,NaN,50.30973316742846,37.32493492284102
2018-01-11T09:30:00-05:00,75.4,76.95,75.13,76.68,18089532,11636636.5,82.08814352387687,75.60522775051938,NaN,NaN,130.15715265156263,124.80694163437411,0.312745208150615,1.7667031007129168,1.4539578925623018,211634349,205393866.2,80.92296791588986,75.87967059641528,NaN,NaN,52.72858598882672,39.52545650369612
2018-01-12T09:30:00-05:00,76.7,77.62,76.7,77.42,19819205,12166794.3,83.86933334915705,76.55322292777977,NaN,NaN,141.39955442704976,126.77997702411945,0.3485350800273057,1.889626742596434,1.5410916625691282,231453554,210920162.2,82.39244956845111,77.63583092038199,NaN,NaN,55.371192924171034,41.789133135192536
2018-01-16T09:30:00-05:00,77.6,77.65,76.3,76.44,16894935,12422398.75,73.4520901579402,76.71017492823634,NaN,NaN,113.43034016360286,123.23383073545656,0.27610554447217206,1.8862235931593432,1.6101180486871711,214558619,211111627.8,82.44290956326714,78.9217243105888,NaN,NaN,54.012495522984025,43.53532776201989
2018-01-17T09:30:00-05:00,76.66,77.44,76.16,77.11,14007382,12615097.6,75.67647316576384,76.83744942451169,NaN,NaN,105.6241600896568,119.87181386522211,0.24431290174791132,1.9155091758720602,1.6711962741241488,228566001,215951468,83.71348749112406,79.93635193774135,NaN,NaN,53.65265907289398,44.98066080643047
2018-01-18T09:30:00-05:00,76.82,77.01,76.34,76.48,11514622,12707794.45,69.75782409670677,76.73360695809743,NaN,NaN,88.93153523074324,115.90854851252307,0.1561374975635832,1.8663681460786279,1.7102306485150447,217051379,220652780.4,84.85967759733231,80.82692635304603,NaN,NaN,51.33408695424426,45.888293113261014
2018-01-19T09:30:00-05:00,76.31,76.41,75.88,76.38,12962747,13017719.45,68.83752062583662,76.5278250181216,NaN,NaN,71.02165486618432,104.0814489554474,0.07071226408503906,1.7986209786213436,1.7279087145363046,204088632,219143637,82.84416025398765,81.41041134333763,NaN,NaN,49.23188454690935,46.36594903235363
2018-01-22T09:30:00-05:00,76.48,78.06,76.46,78.03,17016724,13255830.85,74.75550097341102,76.92370666162283,NaN,NaN,112.48259534992353,98.29805714002215,0.10300866035011635,1.8566695399739501,1.7536608796238338,221105356,217073997.4,80.03663992171535,81.75049718276416,NaN,NaN,49.33532948152023,46.790146239377435
2018-01-23T09:30:00-05:00,78.18,78.26,77.519,77.91,10184938,12924921.15,73.6598944934441,76.8549145230963,NaN,NaN,118.60487423105286,99.33296395351215,0.09420562050132975,1.871417905250496,1.7772122847491663,210920418,216346357.2,79.02268318642096,81.9544064135457,NaN,NaN,49.0533881196043,47.11346650798127
2018-01-24T09:30:00-05:00,78,78.39,77.43,77.7,12919670,13037863.85,71.68004384423782,76.37483644234888,NaN,NaN,108.04780125349134,99.81769218627906,0.05414541681143614,1.8448940557634614,1.7907486389520253,198000748,210233306.6,70.89658807772031,81.46635004451458,NaN,NaN,48.20740376178846,47.26974325852515
2018-01-25T09:30:00-05:00,78.09,78.09,76.95,77.09,11718449,13192231.05,66.12057638854118,75.40269023978875,NaN,NaN,80.09742383624088,98.0508699073786,-0.029056623432882844,1.7544278596609217,1.7834844830938046,186282299,204079490.6,63.78568804732933,80.26928841232235,NaN,NaN,45.741216807926634,47.05138233701108
2018-01-26T09:30:00-05:00,77.26,77.64,77.1,77.51,7785306,13038730.55,67.9630056937416,74.58720309677882,NaN,NaN,75.21003776602946,98.88854648734761,-0.06913912294423019,1.6970605794135167,1.766199702357747,194067605,202075285.2,61.61803636665295,78.82083602616487,NaN,NaN,44.254335806454776,46.65180426121732
2018-01-29T09:30:00-05:00,77.2,77.47,76.22,76.34,12647167,13272749.65,58.430337639950835,72.99307558880268,NaN,NaN,35.5380690023439,83.49964121783168,-0.18140644225439462,1.5394416495397536,1.7208480917941482,181420438,194138301.6,53.81807659094446,76.67419784539543,NaN,NaN,39.77525721709534,45.669440397771325
2018-01-30T09:30:00-05:00,75.7,75.91,74.735,74.8,22751839,14042523,48.739850156286785,70.87570095619125,NaN,NaN,-58.429889153542135,48.09268854091268,-0.35623164340681424,1.2755585375356304,1.6317901809424447,158668599,183687937.8,45.62818245124025,73.88441123366691,NaN,NaN,32.265552147434875,43.754599219151835
2018-01-31T09:30:00-05:00,75,75.1342,74.33,74.85,15765547,14086232.65,49.03538584702306,68.86185571113695,NaN,NaN,-94.08271273209436,7.666585743795537,-0.4588202775773531,1.0582648339707532,1.5170851115481063,174434146,178974617.4,42.48771882852137,71.03351899004264,NaN,NaN,26.629706089748318,41.30818591495133
2018-02-01T09:30:00-05:00,74.95,75.67,74.531,75.62,18011557,14021829,53.483187547395886,66.81864456995973,NaN,NaN,-68.26735251049351,-22.006369525551335,-0.4637601031245089,0.9373849826424703,1.4011450857669792,192445703,180207298.2,43.58140128270854,68.36626423052968,NaN,NaN,23.335917506977953,38.740718999526564
2018-02-02T09:30:00-05:00,74.23,74.41,72.06,72.46,31005405,14856757.1,38.59631280418076,63.58485738817571,NaN,NaN,-199.58448191356837,-76.9652734614709,-0.6569830090998225,0.579916324392201,1.2368993334920235,161440298,173681836.8,39.3187869709242,65.28957404499205,NaN,NaN,14.050961178863927,35.2136107394319
2018-02-05T09:30:00-05:00,71.49,72.4,68.28,69.42,34767640,15884917.8,29.957361964937633,60.478091088675534,NaN,NaN,-290.8858459640452,-142.25005645474872,-0.9489335213913058,0.050732431752891216,0.999665953144197,126672658,162732280.8,33.413202119240964,61.787452084704455,NaN,NaN,2.0443081558348837,30.475138941775185
2018-02-06T09:30:00-05:00,68.23,70.4699,67.9,69.97,32815176,17036715.75,32.8842972247008,57.421507092885314,NaN,NaN,-243.43412851729443,-179.25090432749917,-1.0561918318203272,-0.32057383663121186,0.7356179951891153,159487834,162896127.8,33.57398051824791,58.20605872949903,NaN,NaN,-5.3801935157377985,25.352948590701903
2018-02-07T09:30:00-05:00,70.19,71.065,68.79,68.8,24603696,17805176,30.011251222968312,54.58246617333257,NaN,NaN,-189.46319953471198,-198.3270016880227,-1.1494250972718865,-0.7011633764007428,0.4482617208711437,134884138,154986126.2,29.829371851443355,54.27532260479266,NaN,NaN,-12.251275412751573,19.98091659020855
2018-02-08T09:30:00-05:00,68.87,69.15,66.6899,66.72,27771124,18652633.05,25.710649544741344,51.501975381825766,NaN,NaN,-194.54043087758888,-223.58161736144174,-1.2844345961788002,-1.1572815243523564,0.12715307182644364,107113014,137919588.4,23.690019477469207,50.05002683504134,NaN,NaN,-19.636385890613784,14.321301950091076
2018-02-09T09:30:00-05:00,67.51,67.58,64.45,66.67,35174085,19506860.7,25.61562377276411,47.99198415320813,NaN,NaN,-176.76276859950383,-219.01727469862885,-1.3060738640411176,-1.5054392582249534,-0.1993653941838358,71938929,120019314.6,19.22149162007331,45.70608767063834,NaN,NaN,-25.032495465177846,8.699330890766944
2018-02-12T09:30:00-05:00,67.53,68.51,67.21,67.76,24956856,19763743.25,31.554627856542893,44.98446510771519,NaN,NaN,-119.58803880767668,-184.75771326735517,-1.1797915579726408,-1.674104841649637,-0.49431328367699606,96895785,114063940,18.004692586079514,41.34765977061396,NaN,NaN,-27.29017503476079,3.557972901405839
2018-02-13T09:30:00-05:00,67.41,67.77,67.01,67.48,12284954,19533244.2,30.8727241244721,42.06965655630335,NaN,NaN,-109.38771225362844,-157.94843001462198,-1.0521560180594567,-1.8095083062513169,-0.7573522881918602,84610831,99088539.4,15.369845999502886,37.38146390788415,NaN,NaN,-29.259303520614182,-1.1302094445970212
2018-02-14T09:30:00-05:00,66.82,68.66,66.66,68.46,19756920,19820721.1,36.079322758881666,39.92385272561338,NaN,NaN,-88.56510359650699,-137.768810826981,-0.8475548304941928,-1.8167958263096011,-0.9692409958154083,104367751,92985262,14.44221997816669,33.85693047437252,NaN,NaN,-29.185726890867564,-5.138140508349956
2018-02-15T09:30:00-05:00,68.6,68.65,67.19,68.29,16469372,20068458.6,35.57870946592597,37.610688709340835,NaN,NaN,-77.06588585502914,-114.27390182246904,-0.676897162881485,-1.8153624494172647,-1.1384652865357796,87898379,89142335,13.874411734263163,30.44667157205896,NaN,NaN,-29.279129969944034,-8.58685328857768
2018-02-16T09:30:00-05:00,68,68.76,67.71,68.12,13791074,20109874.95,35.05489515856348,35.9410142463846,NaN,NaN,-67.04934312165494,-92.33121672689929,-0.5349180073580417,-1.8071127957333317,-1.27219478837529,74107305,89576010.2,14.283971151538665,27.62280689781569,NaN,NaN,-29.50527644463871,-11.575199453729256
2018-02-20T09:30:00-05:00,68.26,68.76,67.44,67.75,17811296,20149603.55,33.885559190741304,34.879993463131356,NaN,NaN,-64.24614189888364,-81.26283734514068,-0.429901115980986,-1.8095711833515224,-1.3796700673705364,56296009,81456055,13.034167624204429,25.29466298159885,NaN,NaN,-30.021330734370554,-14.210361065249442
2018-02-21T09:30:00-05:00,67.55,68.18,66.61,66.61,12545399,20267626.6,30.508775625545724,33.55666416159726,NaN,NaN,-72.88233460116079,-73.96176181464716,-0.4017163842072393,-1.8818155476295857,-1.4800991634223464,43750610,73284010.8,11.905176857144042,23.110195697929043,NaN,NaN,-31.463938634121774,-16.67515786080263
2018-02-22T09:30:00-05:00,67.09,68.33,66.918,67.34,15330257,20388155.95,34.9772242187278,32.23480963812097,NaN,NaN,-61.6108862087015,-68.57091833708608,-0.302911427561678,-1.858738447874444,-1.555827020312766,59080867,64226634,10.78967135481156,20.76792927450783,NaN,NaN,-31.3773761148686,-18.775474754240626
2018-02-23T09:30:00-05:00,67.67,68.85,67.55,68.8,15684833,20586475.15,42.88719647952981,32.54130132921733,NaN,NaN,-40.84320901749901,-61.32638296958005,-0.11774531019940149,-1.7030086580620178,-1.5852633478626164,74765700,61600098.2,10.482921907743503,18.70822462713778,NaN,NaN,-28.8302723579904,-20.211874411919165
2018-02-26T09:30:00-05:00,69.15,69.35,68.805,69.21,12156413,20805030.5,44.91379622514898,33.60961806208957,NaN,NaN,-19.156919269429185,-51.74789819913491,0.045103414132593445,-1.5288840801968746,-1.573987494329468,86922113,64163059.8,13.079731398392866,17.25583386136292,NaN,NaN,-26.127740165324358,-21.05699809097705
2018-02-27T09:30:00-05:00,69.35,69.9,68.3,68.31,13465707,20845957.5,41.43783518907717,34.22058505954502,NaN,NaN,-20.11678110281015,-42.922026039920205,0.10172329024328186,-1.4468333815253658,-1.5485566717686476,73456406,67595139.2,16.569980680262887,16.041262444363987,NaN,NaN,-24.8409214771847,-21.597558574721
2018-02-28T09:30:00-05:00,68.67,68.92,66.71,66.74,17621961,20589463.6,36.17790081783296,34.66106003060678,NaN,NaN,-61.68998449900399,-40.68355601948885,0.045803192105208446,-1.491302681637137,-1.5371058737423455,55834445,70011906.2,19.03541049706635,15.270265204765632,NaN,NaN,-25.35028077009066,-22.133661745488094
2018-03-01T09:30:00-05:00,66.67,67.685,66.16,66.64,22974984,20949935.45,35.865619050227366,35.386414995284355,NaN,NaN,-85.85367370910762,-45.53211351957,0.015984213389717894,-1.5171256070051982,-1.533109820394916,32859461,64767625,17.8057997335616,14.849963794486522,NaN,NaN,-25.84835990449755,-22.664332911060875
2018-03-02T09:30:00-05:00,66.18,67.19,65.65,66.95,14578875,20778301.35,37.66201634784816,36.246871607790354,NaN,NaN,-104.22098841247906,-58.20766939856601,0.030216881713036603,-1.4953387182536204,-1.525555599966657,47438336,59302152.2,16.602160158984205,14.66286869012301,NaN,NaN,-25.737729557255168,-23.103389574802918
2018-03-05T09:30:00-05:00,66.64,67.8701,66.52,67.66,12831534,19869607.8,41.69041788662916,36.97085660993937,NaN,NaN,-52.676862712367345,-64.91165808715364,0.09677236412757573,-1.4045901448071874,-1.501362508934763,60269870,53971703.6,15.501556416410367,14.484073249432358,NaN,NaN,-24.46977160753196,-23.298587008049925
2018-03-06T09:30:00-05:00,68.08,68.3333,67.36,67.7,15677944,18915123,41.91814085578048,37.75981494788998,NaN,NaN,-6.124637405604257,-62.113229347712455,0.14965542583653502,-1.3142932266390943,-1.4639486524756293,75947814,54469985.2,16.061729422383706,14.533493493923848,NaN,NaN,-23.371127854468185,-23.308949986109678
2018-03-07T09:30:00-05:00,66.97,67.68,66.56,67.19,12362602,17892494.3,39.78471278997274,38.02448566439648,NaN,NaN,-64.29006002980559,-62.633244453872784,0.15575585155875737,-1.2692538380271827,-1.42500968958594,63585212,56020138.6,17.885531326069938,14.779444304488365,NaN,NaN,-23.00445031643004,-23.2654500332983
2018-03-08T09:30:00-05:00,67.34,67.54,66.69,67.17,8013317,17062975.35,39.699382299142634,38.31881943819767,NaN,NaN,-59.26244967419666,-57.31499964689059,0.16312968915670356,-1.2210975781400606,-1.3842272672967642,55571895,60562625.4,23.154660681213485,15.44231922927053,NaN,NaN,-22.722606940646838,-23.187901020062377
2018-03-09T09:30:00-05:00,67.69,68.51,67.63,68.45,11393053,16244071.8,47.46539575788546,39.20528376672066,NaN,NaN,62.46252858643807,-23.97829624710716,0.2535062853003516,-1.0673444106713248,-1.3208506959716764,66964948,64467947.8,27.46409353172116,16.38375654214071,NaN,NaN,-20.24932316025127,-22.768104182946505
2018-03-12T09:30:00-04:00,68.49,68.93,68.09,68.43,9486031,14959669.1,47.36275542598152,40.167940640666394,NaN,NaN,89.0203467766988,4.361145650706064,0.30762895689346514,-0.9363144998548449,-1.24394345674831,57478917,63909757.2,27.229051566698928,17.397676823747457,NaN,NaN,-18.24352147657394,-22.121735224893282
2018-03-13T09:30:00-04:00,68.64,68.95,67.66,67.94,10730854,14248369,44.806341393651856,41.18919533838827,NaN,NaN,47.90611463123455,15.167296058073822,0.3054957204411479,-0.8620738061968751,-1.167569526638023,46748063,58069807,24.83438597043886,18.321191760411374,NaN,NaN,-17.182424267960254,-21.41611937390285
2018-03-14T09:30:00-04:00,68.2,68.39,67.4,67.54,11348152,14201528.9,42.776562603824836,41.746290937323764,NaN,NaN,-3.66264516007425,27.292779032020093,0.2732615016651301,-0.8259926495566106,-1.0992541512217406,35399911,52432746.8,22.754200083667342,19.175800955329642,NaN,NaN,-16.809861465442797,-20.758082529837125
2018-03-15T09:30:00-04:00,67.79,68.08,66.68,67.19,12408513,13834108.55,41.025290507699744,41.613297653621615,NaN,NaN,-55.69488687450451,28.00629159195853,0.22641840628776722,-0.8162311433620317,-1.042649549649799,22991398,45916647.4,20.60560848166,19.89884999632368,NaN,NaN,-16.95584099766789,-20.214905168098664
2018-03-16T09:30:00-04:00,66.75,67.61,66.62,67.31,14342576,13727768.75,41.90349496467102,41.39827613501605,NaN,NaN,-65.10676429320927,2.492433016029062,0.20235259118851767,-0.7897088106641519,-0.9920614018526696,37333974,39990452.6,18.8612502302758,20.31181562717246,NaN,NaN,-16.851941077730018,-19.734481726617428
2018-03-19T09:30:00-04:00,67.1,67.19,65.89,66.27,14524982,13764464.15,36.79022164669818,41.06630373913184,NaN,NaN,-133.30120333177842,-41.971877005666386,0.11933501137719105,-0.8428926376311807,-0.9622276490083718,22808992,33056467.6,17.04324856654371,20.34562047619252,NaN,NaN,-18.18101473840146,-19.512557871158005
2018-03-20T09:30:00-04:00,66.63,67.28,66.54,66.83,11259109,13436854.8,40.96737327187592,41.40840891442061,NaN,NaN,-77.50476184207724,-67.05405230032875,0.10555579972191453,-0.8302828993559785,-0.9358386990778931,34068101,30520475.2,16.419881918762187,20.158797006313648,NaN,NaN,-18.167937621880718,-19.320469264118394
2018-03-21T09:30:00-04:00,67.23,69.02,67.02,68.58,16456550,13632412.35,51.70751942348371,42.53997322679607,NaN,NaN,60.44525256124894,-54.2324727560641,0.21159862182448863,-0.6713404217972823,-0.8829390436217709,50524651,33545423.2,20.170552787664363,20.327707938749562,NaN,NaN,-14.737052356096427,-18.665695420115256
2018-03-22T09:30:00-04:00,67.82,68.18,67.05,67.18,18483779,13790088.45,44.70089313705474,43.04275014031083,NaN,NaN,-18.22841936942667,-46.73917925504854,0.18567671629909577,-0.6508431482479011,-0.8365198645469969,32040872,35355318,22.41396778924438,20.74283705519672,NaN,NaN,-14.023083554595871,-18.002465153612487
2018-03-23T09:30:00-04:00,67.52,68.3,66.62,66.77,19214283,13966560.95,42.86884234294178,43.12692331576172,NaN,NaN,-39.470581398521276,-41.611942676110935,0.14115703758415932,-0.6600735675667977,-0.801230605150957,12826589,30453841,20.716067669936805,21.115302144734322,NaN,NaN,-14.040796402632127,-17.436512474901008
2018-03-26T09:30:00-04:00,67.54,68.07,66.76,67.97,15953442,14156412.4,49.404846242538056,43.66168798624442,NaN,NaN,12.453912620401127,-12.460919485675026,0.18973914336094833,-0.5640566759497716,-0.7537958193107199,28780031,31648048.8,22.26121104400835,21.558122260564655,NaN,NaN,-11.878755043221059,-16.642547127518156
2018-03-27T09:30:00-04:00,68.26,68.54,66.94,67.33,13923130,14179283.55,46.358679011675854,44.131257002080346,NaN,NaN,24.47674970435223,7.935382823610863,0.17627193440038913,-0.5334559013102336,-0.7097278357106227,14856901,27805808.8,20.853079979511165,21.77009002152474,NaN,NaN,-11.09855085845708,-15.85054766050943
2018-03-28T09:30:00-04:00,67.37,67.6,65.91,66.02,18228748,14209622.9,40.811830904490975,44.210717616748084,NaN,NaN,-124.61848783259032,-29.077365255156984,0.08145979625219246,-0.6079030903953822,-0.6893628866475746,-3371847,17026509.2,17.507255853244203,21.366703962384076,NaN,NaN,-12.297809228515495,-15.343013598796011
2018-03-29T09:30:00-04:00,66.31,67.675,66.3,67.41,13997923,13760769.85,47.93090392500108,44.24396820011349,NaN,NaN,-41.01801732752431,-33.635284846776514,0.11275447030812036,-0.5484197987624242,-0.6611742690705446,10626076,12743550,16.382517225759628,20.57516279767254,NaN,NaN,-10.853972029596614,-14.70172194605324
2018-04-02T09:30:00-04:00,67.15,67.27,64.925,66.06,18993110,13981481.6,42.574845848929286,43.90197465889547,NaN,NaN,-179.2453155032415,-61.59023166772056,0.04633254352652483,-0.6032585896623885,-0.6495911331889134,-8367034,8504825.4,15.332667370867284,19.725421069398852,NaN,NaN,-11.534207850332796,-14.24921993237889
2018-04-03T09:30:00-04:00,66.31,67.53,65.68,67.47,14114315,14045620.65,48.9866930371408,44.20057120485897,NaN,NaN,-62.12748650162475,-76.50651149212572,0.09817684248199054,-0.5268700800864252,-0.6250469225684158,5747281,3898275.4,14.262922176322476,18.970316512676252,NaN,NaN,-9.806257081275984,-13.614510953649903
2018-04-04T09:30:00-04:00,66.44,67.5261,65.98,67.38,12490776,13886262.25,48.61357466775586,44.6175006379969,NaN,NaN,-48.48977864284938,-91.09981716156605,0.12548009610236488,-0.4681968024404597,-0.5936768985428246,-6743495,-421803.8,13.324064100628789,18.29673537103064,NaN,NaN,-8.613434866370039,-12.900071512609923
2018-04-05T09:30:00-04:00,67.55,69.02,67.55,68.59,13528407,13944552.5,53.71759050414002,45.52409349488549,NaN,NaN,122.63014416770413,-41.65009076150717,0.21864718471642852,-0.3203679176472889,-0.5390151023637174,6784912,1609548,16.120004753368747,17.976335104724118,NaN,NaN,-5.888605998951606,-11.898433582087307
2018-04-06T09:30:00-04:00,68.16,68.49,66.46,67.35,18883891,14488081.2,48.4108559381362,45.98890499299015,NaN,NaN,4.285875963146418,-32.58931210337302,0.1913608588585226,-0.2998140287905642,-0.4911748876490868,-12098979,-2935463,14.957430051478113,17.69749080623857,NaN,NaN,-5.38644377331047,-10.968149323690616
2018-04-09T09:30:00-04:00,67.67,68.53,67.4,67.67,10819833,14459420.2,49.78939560392494,46.91741741850634,NaN,NaN,62.252776626095795,15.710306322494437,0.18912646611989253,-0.2547668049992211,-0.44389327111911364,-1279146,-1517885.4,16.968807447259238,17.692173583432538,NaN,NaN,-4.548180551753974,-10.051010927699668
2018-04-10T09:30:00-04:00,68.74,70.455,68.72,69.91,22621829,15116210.1,58.20794710181463,48.148886977787676,NaN,NaN,258.79633633186705,79.8950708891928,0.3248101273406218,-0.03788061194333636,-0.3626907392839582,21342683,1601195,21.375180490310328,18.04612348140026,NaN,NaN,-0.8479077417945837,-8.7362819011418
2018-04-11T09:30:00-04:00,69.8,70.8,69.71,70.64,21190947,15639214.75,60.53048716891367,48.7790989596041,NaN,NaN,265.97505187345826,142.78803699245432,0.44272041079132896,0.19070977420520308,-0.2520106365861259,42533630,11456620,33.40162119676303,18.99119979633588,NaN,NaN,2.899437455516346,-7.0740362787620645
2018-04-12T09:30:00-04:00,70.88,71.19,70.38,70.63,14316717,15787643,60.48090225146495,49.906242467776266,NaN,NaN,222.9792984008016,162.85786783907383,0.49507551289296253,0.36683375453007727,-0.12824175836288526,28216913,15743020.2,37.85400545045672,20.09405962927962,NaN,NaN,5.787974979878056,-5.236606098956333
2018-04-13T09:30:00-04:00,71.01,71.7,70.9101,71.41,13330421,15833738.4,63.02515950043753,51.34597940759738,NaN,NaN,202.24357334026718,202.44940731449796,0.5528849335536128,0.5628644085791308,0.009979475025517937,41547334,26472282.8,47.34349501305252,21.996018725216455,NaN,NaN,8.999791785161069,-3.202834972653847
2018-04-16T09:30:00-04:00,71.57,72.465,71.19,72.14,14024342,15817826.7,65.27820084445602,52.47979045059152,NaN,NaN,184.5356785324086,226.90598769576053,0.6066315302712149,0.7682688878645365,0.16163735759332165,55571676,37842447.2,55.15791977122692,24.345783634303498,NaN,NaN,12.385867314858233,-0.9758775030092641
2018-04-17T09:30:00-04:00,72.33,72.75,71.92,72.42,16105269,15896841.05,66.13069036883823,53.89207697610313,NaN,NaN,165.37389699887277,208.22149982916167,0.6249135575549298,0.9427793045369839,0.3178657469820541,71676945,47909299.6,60.71653274700745,27.193173117696087,NaN,NaN,15.402378798875823,1.363873397260034
2018-04-18T09:30:00-04:00,73.05,74.22,73.03,73.56,17311471,16199459.15,69.42240144169587,55.93568915733204,NaN,NaN,172.71732343605603,189.56995414168122,0.6734675921790398,1.159700237205854,0.4862326450268141,88988416,57200256.8,65.02559229462648,30.587340006366258,NaN,NaN,19.057450310601364,3.8915272420230815
2018-04-19T09:30:00-04:00,73.62,74.2,73.201,73.65,18150344,16284148.85,69.6729934693823,57.48869555335928,NaN,NaN,144.68731872677282,173.91155820687544,0.6699067359315359,1.323616064941234,0.6537093290096981,107138760,72984626.2,70.87139136166178,34.47940244464498,NaN,NaN,22.086160092379664,6.490760506359736
2018-04-20T09:30:00-04:00,73.5,73.555,72.83,73.3,13690420,16044480.9,67.3610205017091,59.259136599986405,NaN,NaN,113.08068764272194,156.0789810673664,0.6042613166482756,1.4090359748200427,0.8047746581717671,93448340,83364827.4,73.95450384052683,38.666676478192095,NaN,NaN,23.983439323113576,8.989714623038855
2018-04-23T09:30:00-04:00,73.07,73.76,72.67,73.75,14844633,15825998.4,68.79477487159461,60.67399958816168,NaN,NaN,104.47250452457168,140.06634626579904,0.5528206346687958,1.4958004515077619,0.942979816838966,108292973,93909086.8,76.65731348220972,43.123418714326895,NaN,NaN,25.99822781879782,11.419502222432993
2018-04-24T09:30:00-04:00,73.95,74.46,72.56,72.96,22790505,16167851.55,63.51950649296229,61.738709004247845,NaN,NaN,91.70108585688233,125.33178403740094,0.43258591920647804,1.4837122158470635,1.0511262966405854,85502468,96674191.4,77.32192695495638,47.69469463249315,NaN,NaN,26.281345246444786,13.542622654434677
2018-04-25T09:30:00-04:00,72.73,73.64,72.27,73.54,13163311,16129860.6,65.60482417129433,62.58779712333033,NaN,NaN,78.90461121502491,106.56924159319472,0.361979587399188,1.5036007808895704,1.1416211934903824,98665779,98609664,77.79842619331062,52.10029616391757,NaN,NaN,27.10676643345076,15.480357480008403
2018-04-26T09:30:00-04:00,73.81,74.67,73.58,74.61,12216888,15829267.6,69.11261094424341,64.06649390948084,NaN,NaN,100.44931545500894,97.72164093884194,0.356626296160105,1.5874040636905136,1.2307777675304086,110882667,99358445.4,77.99109314980814,56.60270067094115,NaN,NaN,28.868513448923522,17.39295118985342
2018-04-27T09:30:00-04:00,73.85,74.19,73.53,73.82,10539303,15656336.6,63.92867802588713,65.07644265390671,NaN,NaN,81.27330034160016,91.36016347861758,0.2729392967924613,1.571951888520985,1.2990125917285238,100343364,100737450.2,78.36349008408853,60.98803514500038,NaN,NaN,28.846151216503124,19.02912262223195
2018-04-30T09:30:00-04:00,73.7,74.64,73.68,73.81,12963191,15354840.65,63.863378270671895,65.48040202311081,NaN,NaN,81.31154523762397,86.72797162122805,0.1936969514494673,1.541133781040358,1.3474368295908907,87380173,96554890.2,74.25937079749856,64.76547730979954,NaN,NaN,28.809587781070135,20.426331930637403
2018-05-01T09:30:00-04:00,73.44,73.49,72.43,73.36,13800927,15339171.25,60.85119007123986,65.50330937327696,NaN,NaN,47.80966555708246,77.94968756126808,0.09287319721350928,1.4635283261077774,1.370655128894268,73579246,94170245.8,71.94582587398291,67.51863478674382,NaN,NaN,27.934076296105715,21.49886683999002
2018-05-02T09:30:00-04:00,73.14,74.241,73.04,73.66,13434737,15386369.3,62.13345944374721,65.6213491727257,NaN,NaN,62.03036542860098,74.57483840398329,0.03145955284569668,1.409979569951389,1.3785200171056924,87013983,91839886.6,69.66177825633957,69.7906185585926,NaN,NaN,27.536416050870976,22.36137387011587
2018-05-03T09:30:00-04:00,73.32,73.61,72.5,73.49,15329576,15476427.75,60.91586276690261,65.47068512033034,NaN,NaN,40.8826339105507,62.66150209509165,-0.032099198117310435,1.3383960194590543,1.3704952175763647,71684407,84000234.6,62.476036256667854,70.87151436170798,NaN,NaN,26.875729415289545,23.00628180514068
2018-05-04T09:30:00-04:00,73.29,74.11,72.99,73.85,13585489,15211507.65,62.58783486162475,65.27851612155668,NaN,NaN,56.26698471130923,57.66023896903346,-0.059774083196364014,1.2957776135809098,1.3555516967772738,85269896,80985541,59.91653791742441,71.21141565786495,NaN,NaN,26.738162762585045,23.539407656204162
2018-05-07T09:30:00-04:00,74.43,75.57,73.8,73.95,17973699,15569200.95,63.060551711153764,65.05922050315066,NaN,NaN,99.26843846268162,61.251617614044996,-0.07996324848487957,1.2555976361711743,1.3355608846560538,103243595,84158225.4,61.69508068665822,71.28131193926858,NaN,NaN,26.741417304543546,23.99683760596693
2018-05-08T09:30:00-04:00,73.98,74.57,72.64,74.53,28774057,15876812.35,65.76264952109841,64.7978096516794,NaN,NaN,66.21515751077516,64.93271600478354,-0.06358742917505511,1.256076598187235,1.3196640273622902,132017652,95845906.6,67.42860450657113,71.45295566869319,NaN,NaN,27.449947533002227,24.490139024114832
2018-05-09T09:30:00-04:00,75.44,76.89,75.43,76.05,24903938,16062461.9,71.62136537108577,64.93697907322965,NaN,NaN,237.59307934496758,100.04525878805684,0.03498169919368155,1.3633911513543922,1.3284094521607106,156921590,109827428,72.69404996546686,71.58314556896498,NaN,NaN,29.874991057216633,25.259403600272233
2018-05-10T09:30:00-04:00,76.35,76.8,76,76.62,13890093,16041130.7,73.45574325968585,65.37231641308513,NaN,NaN,244.35485086761386,140.73970217946948,0.11919433374935329,1.477402369347402,1.3582080355980488,170811683,129652883.2,78.10024219340468,71.87926973702768,NaN,NaN,32.49521522563746,26.293090975324407
2018-05-11T09:30:00-04:00,76.79,77.25,76.56,76.73,12010656,15975142.45,73.80760738900732,65.7303758786146,NaN,NaN,223.8017881974886,174.24666287670536,0.16036623730305277,1.5586658322268647,1.398299594923812,182822339,149163371.8,81.89845647752371,72.25363709383582,NaN,NaN,34.741893237906154,27.5000627271218
2018-05-14T09:30:00-04:00,76.97,77.61,76.97,77.26,10226324,15785241.55,75.49322281042913,66.58564132986224,NaN,NaN,199.2732780793267,194.2476308000344,0.19884065699445808,1.6468504161668847,1.4480097591724266,193048663,167124385.4,84.55426160598425,72.7702324260521,NaN,NaN,37.171642190575405,28.881716936186603
2018-05-15T09:30:00-04:00,77.09,77.4,76.69,77.28,10482690,15504112.6,75.55714829169757,67.29652162417675,NaN,NaN,153.112317702659,211.62706283841118,0.20060724677809572,1.6987688176450462,1.4981615708669505,203531353,181427125.6,86.28046893248253,73.37609262170724,NaN,NaN,39.186746858424925,30.353864067934936
2018-05-16T09:30:00-04:00,77.17,77.6,76.78,77.55,11997162,15238397.15,76.45023343038125,67.82063751604375,NaN,NaN,133.29673116362835,190.7677932021433,0.1947706638291189,1.741624900653349,1.5468542368242302,215528515,193148510.6,87.51219660267154,74.05617143976892,NaN,NaN,41.154590093220584,31.896824928690027
2018-05-17T09:30:00-04:00,77.8,78.825,77.76,78.72,16271320,15144445.95,79.88075024569315,68.9600712460299,NaN,NaN,152.55376843225068,172.40757671507066,0.2414664985269277,1.8486873599828897,1.607220861455962,231799835,205346141,88.65378049802645,74.79119218362163,NaN,NaN,44.02612153091953,33.62958158615138
2018-05-18T09:30:00-04:00,78.58,78.66,78.05,78.11,14092682,15164559.05,73.84125464003333,69.67277670098429,NaN,NaN,123.83310686554216,152.41384044868138,0.20449496947839707,1.8628395733039582,1.6583446038255611,217707153,212323103.8,89.25864285661739,75.86256875927297,NaN,NaN,44.71313958677398,35.21294701481175
2018-05-21T09:30:00-04:00,78.55,78.91,78.1545,78.91,11513109,14997982.85,76.36507058312274,70.78091102326162,NaN,NaN,120.17183651603307,136.59355213602265,0.20653728696750617,1.916516212534944,1.7099789255674378,229220262,219557423.6,89.86213006851261,77.14230477316794,NaN,NaN,46.07951985898076,36.765314563978755
2018-05-22T09:30:00-04:00,78.9,79.4167,77.64,77.86,16583398,14687627.5,67.20077578167007,71.14286219025612,NaN,NaN,95.87250196434786,125.14558898836044,0.11439224766717437,1.8529692351514058,1.7385769874842314,212636864,221378525.8,90.0142240509175,78.59605090135209,NaN,NaN,44.33810257533912,37.84714142274452
2018-05-23T09:30:00-04:00,77.41,77.91,76.765,77.85,16605788,14859751.35,67.1181644260432,71.58588373733758,NaN,NaN,61.44991534578066,110.77622582479088,0.03415244036490739,1.7812675379403657,1.7471150975754584,196031076,217479038,87.00424354903063,80.34806570794943,NaN,NaN,42.935896040256615,38.57410636810339
2018-05-24T09:30:00-04:00,76.95,77.07,76.22,76.57,19154752,15206644.55,57.39257702762745,71.21479389205207,NaN,NaN,25.65468528933943,85.39640919620865,-0.1155453682432257,1.6026833872714263,1.718228755514652,176876324,206494335.8,78.99121417804989,81.71054258370839,NaN,NaN,38.48003228166195,38.56066721289747
2018-05-25T09:30:00-04:00,75.22,75.32,73.84,74.58,32453517,16302355.25,46.18722654840096,70.00955638042686,NaN,NaN,-53.98262342602668,49.83326313789487,-0.3459778899975223,1.2857563930177491,1.6317342830152715,144422807,191837466.6,69.75921997681752,82.28655253300549,NaN,NaN,30.203671280454902,37.36681065111996
2018-05-29T09:30:00-04:00,74,74.8064,73.655,74.35,19327458,16620568.6,45.091446645873695,68.53304188933939,NaN,NaN,-66.91837311583919,12.415221211520418,-0.5018260703839659,1.0044516950353142,1.50627776541928,125095349,171012484,59.17656568114412,81.69712118833213,NaN,NaN,23.446802941613655,35.37823812119049
2018-05-30T09:30:00-04:00,74.99,76.94,74.96,76.6,23022169,17081630.7,56.07115079539975,67.42231227679038,NaN,NaN,1.1080853643877389,-6.537662108471606,-0.44334484200588475,0.9520967129119242,1.395441554917809,148117518,158108614.8,53.736747794816864,80.34302817614284,NaN,NaN,21.286835822011007,33.365180649879136
2018-05-31T09:30:00-04:00,76.04,76.925,75.86,76.02,13264917,17073139.7,53.122268694570366,65.969921236425,NaN,NaN,-0.19077202935222293,-18.865799583498177,-0.433185291121708,0.853959941015674,1.287145232137382,134852601,145872919.8,49.12533983261781,78.27339229322948,NaN,NaN,18.55335394748681,31.249205406680232
2018-06-01T09:30:00-04:00,76.28,76.885,75.97,76.38,14102548,17011788.3,54.714252590576606,64.60611017939422,NaN,NaN,-1.17129676799859,-24.230995994965788,-0.3928694910980126,0.7960583682648661,1.1889278593628787,148955149,140288684.8,47.13720549973852,75.79044579481625,NaN,NaN,16.9599870509768,29.2078884987226
2018-06-04T09:30:00-04:00,76.64,77.2,75.515,75.72,13689210,17016974.35,51.276188722000775,62.87632203022077,NaN,NaN,-25.50825698660179,-18.53612270708081,-0.39996434724770435,0.6889724253032483,1.0889367725509527,135265939,138457311.2,46.4729451949959,73.07035176545995,NaN,NaN,14.524950190766564,27.11032588330031
2018-06-05T09:30:00-04:00,75.35,76.12,75.18,75.54,13707928,16803685.8,50.347007584086334,61.07559769396283,NaN,NaN,-65.56922634379701,-18.266293352672374,-0.40485928182245146,0.5828626702728883,0.9877219520953398,121558011,137749843.6,46.2020818095366,70.20760982810667,NaN,NaN,12.306104186159583,24.995437069423062
2018-06-06T09:30:00-04:00,75.82,76.1,75.23,75.9,13479246,16038945.25,52.212169923127796,59.34430744344473,NaN,NaN,-68.61851574378336,-32.21161357430659,-0.37273445295526086,0.5218038859012637,0.8945383388565246,135037257,135133791.4,45.154057347370376,67.182028452728,NaN,NaN,11.046077150442649,23.002671366711574
2018-06-07T09:30:00-04:00,76.3,77.49,76.28,77.05,15178860,15552691.35,57.68091302886297,57.758604785099706,NaN,NaN,13.876481621130216,-29.398162844210106,-0.26782489853697244,0.559757215685309,0.8275821142222815,150216117,138206494.6,46.68383279640502,64.18417504546933,NaN,NaN,11.652879503371642,21.381272529091582
2018-06-08T09:30:00-04:00,77.14,77.35,76.42,76.9,11236625,15420017.95,56.76836713206211,56.53911282024462,NaN,NaN,8.82462108816533,-27.39897927297732,-0.20514735625894254,0.5711479188986033,0.7762952751575458,138979492,136211363.2,45.79074033981917,61.079324865698034,NaN,NaN,11.869574658349315,20.022458547556973
2018-06-11T09:30:00-04:00,76.88,77.645,76.72,77.3,10717777,15355374,58.64717011467131,55.27354850106952,NaN,NaN,31.155612625982425,-16.06620535046048,-0.13665839393464263,0.6054722827392425,0.7421306766738851,149697269,139097629.2,47.359650983755515,58.043433502501095,NaN,NaN,12.603410675927702,18.96259456589565
2018-06-12T09:30:00-04:00,77.3,77.48,76.5,76.71,15707225,15629419.05,54.86002206360383,54.39206609263622,NaN,NaN,9.34703443989253,-1.0829531937225698,-0.13098526574550873,0.5783990944919992,0.709384360237508,133990044,141584035.8,48.7360898956533,55.09499534855365,NaN,NaN,12.12973440140579,17.98647168525424
2018-06-13T09:30:00-04:00,76.47,76.87,76.105,76.42,12502106,15730389.85,53.04678349820796,53.386967454933696,NaN,NaN,-19.912065529784073,8.658336849077289,-0.14553743913991224,0.5274625613126176,0.6730000004525298,121487938,138874172,47.28491164681561,52.25790021268115,NaN,NaN,11.218649671101247,17.01963996894667
2018-06-14T09:30:00-04:00,76.64,76.865,76.125,76.31,10291137,15645088.6,52.34011936561192,53.026077621932586,NaN,NaN,-19.401909322896262,2.0026586602719947,-0.16018470201181378,0.47276912293776263,0.6329538249495764,111196801,131070308.8,43.28749514411384,49.70763456740001,NaN,NaN,10.270737575001492,16.05551105552593
2018-06-15T09:30:00-04:00,75.36,75.51,74.01,74.17,16108263,15636935.75,40.91949124234549,52.649810814357195,NaN,NaN,-146.19840411622673,-29.001946380606416,-0.30330849561477935,0.25381820543110223,0.5571267010458816,95088538,122292118,39.26628570462497,47.529567833671955,NaN,NaN,5.6358972601650725,14.566994799045808
2018-06-18T09:30:00-04:00,73.98,75.41,73.98,74.91,13184372,15591520.25,45.359393624730906,52.66894988427556,NaN,NaN,-118.02301536366741,-58.83767197853638,-0.33496993070505743,0.13841428766455977,0.4733842183696172,108272910,114007246.2,35.87865649204994,45.865431463022375,NaN,NaN,3.1659530954446566,12.938274555674216
2018-06-19T09:30:00-04:00,74.01,75.02,73.8,74.74,12607644,15646247,44.531455333449955,51.84468592270772,NaN,NaN,-121.52256239446082,-85.01159134540706,-0.352419783963376,0.03285948841539721,0.3852792723787732,95665266,106342290.6,33.038725019167615,44.38700126476171,NaN,NaN,0.9364111059403801,11.223722634283668
2018-06-20T09:30:00-04:00,75.19,75.35,74.47,75.07,11655932,15399873.7,46.570205159564296,51.376681384493004,NaN,NaN,-76.66424602057694,-96.36202744356562,-0.3273352750275355,-0.023889821405646217,0.3034454536218893,107321198,103508942.6,32.02948017860561,43.16586843233226,NaN,NaN,-0.3063827924773605,9.57656471617495
2018-06-21T09:30:00-04:00,74.54,74.58,73.33,73.68,15009796,15320074.1,39.915296894422944,50.319613120482025,NaN,NaN,-140.70506756224057,-120.62265909143449,-0.385926341765991,-0.17896247358559947,0.20696386818039153,92311402,99731862.8,30.683854999263957,41.99062911086979,NaN,NaN,-3.5567610203275453,7.700375325246022
2018-06-22T09:30:00-04:00,75.5,75.97,75.14,75.15,28310942,15777883.6,48.325349093860396,50.10883886132914,NaN,NaN,-21.741874185298673,-95.73135310524887,-0.3104940750199574,-0.18115372559455523,0.12934034942540218,120622344,104838624,34.67959443766476,41.14824691391756,NaN,NaN,-3.622542428059969,6.0828156462023095
2018-06-25T09:30:00-04:00,74.93,75.035,73.14,73.64,18380345,15074225,41.84597882579196,49.501622521450976,NaN,NaN,-126.44620908558484,-97.41599184963236,-0.34448182275119504,-0.3012619290135916,0.04321989373760342,102241999,103632441.8,34.17844515954137,40.28941572463219,NaN,NaN,-5.948458299781243,4.364062225347516
2018-06-26T09:30:00-04:00,73.83,74.86,73.57,74.57,13529149,14784309.55,46.5952640803613,49.10041496125337,NaN,NaN,-98.28677227409254,-92.7688338255587,-0.28876997837003543,-0.31774257922494087,-0.02897260085490544,115771148,107653618.2,37.42497233615473,39.73733822383108,NaN,NaN,-6.1930576531636214,2.8559022427030683
2018-06-27T09:30:00-04:00,75.19,76.51,75.16,75.57,20583866,14662394.4,51.209361321504666,48.638161267870636,NaN,NaN,6.679478329009967,-76.10008895564133,-0.17463127270450046,-0.24726169173553103,-0.07263041903103057,136355014,113460381.4,41.88278081287001,39.39440593929287,NaN,NaN,-4.793174190007311,1.763177038030157
2018-06-28T09:30:00-04:00,75.68,75.96,74.89,75.47,14285368,14713416.95,50.73727782632357,48.20736917460359,NaN,NaN,-13.41219116665242,-50.64151367652371,-0.09965649206326214,-0.19720103411010825,-0.09754454204684611,122069646,119412030.2,46.11959186023846,39.417895333608534,NaN,NaN,-3.860571082224336,0.9597844494223723
2018-06-29T09:30:00-04:00,75.68,76.74,75.68,75.94,13167937,14666686.4,52.93344023994676,47.79924561212327,NaN,NaN,40.20950794050582,-38.25123725136281,-0.016555997107174064,-0.1182395384308137,-0.10168354132363963,135237583,122335078,48.11999524999379,39.47220563833984,NaN,NaN,-2.410300753157084,0.4783437061967357
2018-07-02T09:30:00-04:00,75.41,75.43,74.41,74.82,15296553,14747053.55,47.49921844604384,47.2734739251547,NaN,NaN,-50.00159872102313,-22.962315178450474,-0.03415107810618426,-0.14437238895636995,-0.11022131085018569,119941030,125874884.2,50.51595832442102,39.59933909753754,NaN,NaN,-2.875365742234655,-0.0007576435791772362
2018-07-03T09:30:00-04:00,75.6,76.46,75.115,75.29,9308177,14527066,49.826997977977555,47.04348924513824,NaN,NaN,6.366251198465824,-2.0317104839387965,-0.012389909410768521,-0.12570869761364634,-0.11331878820287782,129249207,128570496,52.32173125038486,39.95911192636391,NaN,NaN,-2.5329635638028223,-0.36250134646826937
2018-07-05T09:30:00-04:00,75.75,75.99,74.99,75.21,9969537,14351580.55,49.425297653610194,46.83528769428097,NaN,NaN,-9.616002673968868,-5.290806684534554,-0.002173238275722744,-0.11603533604753125,-0.1138620977718085,119279670,125155427.2,49.840282769465404,40.42716818531759,NaN,NaN,-2.3752327636835626,-0.6500344060704542
2018-07-06T09:30:00-04:00,74.98,75.91,74.63,75.67,9310429,14058159,51.83002799039652,47.614611747713184,NaN,NaN,-3.501013451263595,-3.3085711414567895,0.034738482370580165,-0.07043899480858329,-0.10517747717916345,128590099,126459517.8,50.799865530864864,41.2509953157633,NaN,NaN,-1.5460251807346175,-0.7780330881653346
2018-07-09T09:30:00-04:00,76.13,76.91,76.09,76.8,11059160,14049285.75,57.21220798965266,48.461241345207604,NaN,NaN,101.62866449511353,8.975260169464752,0.12912582822112478,0.05622980809724254,-0.07289602012388224,139649259,127341853,51.47624786753514,42.36510898544081,NaN,NaN,0.834494640922192,-0.5476719840099736
2018-07-10T09:30:00-04:00,77.27,78,77.18,77.37,11003761,14063584.95,59.66066059379302,49.54189886380353,NaN,NaN,176.13845674289178,54.20327126224773,0.21855764620474152,0.20030103763204465,-0.018256608572696863,150653020,133484251,56.010105888311124,44.00592190466534,NaN,NaN,3.5813260205291177,0.04218487378132507
2018-07-11T09:30:00-04:00,76.65,77.12,75.23,75.73,19362770,14246362.2,50.67554041886788,49.835137096610936,NaN,NaN,56.49972709992009,64.22996644253858,0.1586600975257153,0.1800685133344473,0.02140841580873197,131290250,133892459.6,56.30231974279721,45.73969615925046,NaN,NaN,3.217100098387516,0.49574419158220945
2018-07-12T09:30:00-04:00,75.93,76.35,75.32,75.86,12568031,14249658.45,51.30162710827688,50.6484463976005,NaN,NaN,44.26462104557212,75.00609118644678,0.12090136979224192,0.17253512804903437,0.05163375825679245,143858281,138808181.8,59.768153424056145,47.817146046735616,NaN,NaN,3.118739437805549,0.8704577981855437
2018-07-13T09:30:00-04:00,75.93,76.72,75.73,76.26,11423091,14306256.15,53.2672265208259,51.00143764238375,NaN,NaN,82.89583628939438,92.28546113457837,0.11595341158152253,0.1965755227336956,0.08062211115217308,155281372,144146436.4,63.18316673343799,49.8531154964337,NaN,NaN,3.62097901669549,1.2633894008298217
2018-07-16T09:30:00-04:00,75.51,75.88,74.735,75.38,11390744,14070380.2,48.617957889046934,51.48515043261625,NaN,NaN,-6.78766415818309,70.60219540391905,0.04987909723637973,0.14297098269764774,0.09309188546126801,143890628,144994710.2,63.710308184941596,51.962534283962285,NaN,NaN,2.6519507177799277,1.4617553032512653
2018-07-17T09:30:00-04:00,75.13,75.5,74.66,75.08,9753183,13898820.75,47.108412114086924,51.52180386359665,NaN,NaN,-34.686027918233414,28.437298471694014,-0.014143747716768379,0.07541220081530753,0.08955594853207591,134137445,141691595.2,60.10169931044394,53.58230049641152,NaN,NaN,1.4099309978190346,1.454351831046661
2018-07-18T09:30:00-04:00,74.72,75.24,73.98,75.13,15351520,14036014.55,47.401539261597996,51.249816573603326,NaN,NaN,-68.1376502161523,3.5098230084795405,-0.05115616927519902,0.02561073693807714,0.07676690621327616,149488965,145331338.2,62.61453776869761,55.063140278970636,NaN,NaN,0.4775119984358745,1.3148032835308343
2018-07-19T09:30:00-04:00,74.93,75.47,74.85,75.15,16231809,14264808.4,47.526810558483064,51.020497483043286,NaN,NaN,-30.090575581680202,-11.36121631697092,-0.07109666308736853,-0.012103922645934517,0.058992740441434016,165720774,149703836.8,65.43122007666511,56.4425422944297,NaN,NaN,-0.26037829586119726,1.089777343617687
2018-07-20T09:30:00-04:00,75.15,75.32,74.65,74.89,10861317,14057384.45,45.99325087887685,50.524769671538294,NaN,NaN,-62.126194734513525,-40.365622521752506,-0.09699839188304626,-0.062255249412373814,0.03474314247067245,154859457,149619453.8,65.32892597439263,57.671751631886764,NaN,NaN,-1.2962491038140722,0.748916422556007
2018-07-23T09:30:00-04:00,75.1,75.15,74.425,74.56,7623849,13023029.8,44.050409963704084,50.27842620851403,NaN,NaN,-81.90800931272847,-55.38969155266159,-0.12952485336540898,-0.12716292423608877,0.002361929129320206,147235608,150288449.8,65.78562224573665,58.76244191198073,NaN,NaN,-2.705648344196871,0.25540717016273873
2018-07-24T09:30:00-04:00,74.89,75.94,74.7901,75.5,10168500,12612437.55,50.468727720663956,50.32426404727734,NaN,NaN,-14.60501822505459,-51.37348961402582,-0.0831548317056093,-0.10158161050269143,-0.018426778797082124,157404108,154941782.4,68.85836908905097,59.943630329028316,NaN,NaN,-2.232363115420178,-0.09998858492053508
2018-07-25T09:30:00-04:00,75.6,76.315,75.23,76.13,11037546,12487857.4,54.25623593084645,50.66933106707993,NaN,NaN,36.864953875784316,-30.372968795638503,-0.009358765150929284,-0.03012523523574373,-0.020766470084814446,168441654,158732320.2,71.13266148983229,61.464514523340235,NaN,NaN,-0.7354421597956096,-0.1907676670455457
2018-07-26T09:30:00-04:00,76.29,77.095,76.14,76.96,12187385,12068033.35,58.733325639809856,51.16242375632374,NaN,NaN,125.46225054427117,0.7375964295517846,0.09054376654444718,0.09241323809574453,0.001869471551297349,180629039,161713973.2,72.81449609984543,63.036988135410276,NaN,NaN,1.9294395409206375,0.11211907694962331
2018-07-27T09:30:00-04:00,76.1,77.03,76,76.63,12642806,11985905.25,56.37099788652199,51.102337320385836,NaN,NaN,91.78807658964405,31.520450694383307,0.12733741144359484,0.1610412358557909,0.03370382441219606,167986233,164339328.4,74.23773013086561,64.66280829707674,NaN,NaN,3.4892623774045526,0.5945681198717561
2018-07-30T09:30:00-04:00,77.24,77.56,76.98,77.26,11394997,11897258.25,59.70324306612537,51.10537892555243,NaN,NaN,148.1199044291936,77.52603344276773,0.18362157460350395,0.263230792666576,0.07960921806307206,179381230,170768452.8,77.36311837755552,66.1880234748799,NaN,NaN,5.829563633100103,1.3424246217615199
2018-07-31T09:30:00-04:00,77.4,77.61,76.9442,77.12,11290711,11696966.15,58.631562619031016,51.673666225564084,NaN,NaN,126.22906308244852,105.69284970426834,0.19961339632622882,0.3291259634708581,0.12951256714462928,168090519,172905735,78.30536984622998,67.75966991083939,NaN,NaN,7.461804597989316,2.2166217612226333
2018-08-01T09:30:00-04:00,76.45,76.48,75.64,76.05,11172625,11790188.55,51.08421226607296,51.658136593978085,NaN,NaN,14.01947360594099,101.12375365029968,0.12970705465026017,0.29164638545745447,0.1619393308071943,156917894,170600983,74.6947059746154,68.82585223587934,NaN,NaN,6.695992511317065,2.8565318683789807
2018-08-02T09:30:00-04:00,75.49,75.775,75,75.63,9689758,11776199.6,48.447949829203395,51.313902544576486,NaN,NaN,-42.27148894838907,67.57700575176762,0.050811867092243584,0.2254541646724988,0.1746422975802552,147228136,163920802.4,65.29670532585632,68.97681927819494,NaN,NaN,5.2650307332531465,3.2006031347895756
2018-08-03T09:30:00-04:00,75.49,75.625,74.86,75.24,7663337,11693845,46.07042969401602,51.13193624493142,NaN,NaN,-62.433828281883166,36.73262477746217,-0.027782819430597627,0.13991377329200816,0.1676965927226058,139564799,158236515.6,58.54647123160345,68.60797378152792,NaN,NaN,3.357492642077268,3.22301592154496
2018-08-06T09:30:00-04:00,75.46,75.88,75.01,75.52,8200093,11550891.65,48.041855954066406,51.198610804929956,NaN,NaN,-36.62870109386389,-0.2170963271493335,-0.05924793696396996,0.09363667151764332,0.15288460848161328,147764892,151913248,52.09480032860495,68.03605242568229,NaN,NaN,2.318619556388138,3.093816440808271
2018-08-07T09:30:00-04:00,76.29,76.5,75.84,76.08,11798340,11590620.6,51.83419436684344,51.5152290267332,NaN,NaN,38.938267810782946,-17.675255381482444,-0.04151971634956869,0.10098496304465243,0.14250467939422112,159563232,150207790.6,50.47907739826163,67.16923382779399,NaN,NaN,2.5093464804839227,3.010320732190507
2018-08-08T09:30:00-04:00,75.55,75.81,75.075,75.53,9401055,11092534.85,48.11941408266323,51.55755784988893,NaN,NaN,-30.128616112620676,-26.504873325194772,-0.06463038204204818,0.06171670184166089,0.12634708388370908,150162177,148856647.2,49.17775045608479,66.00827171203825,NaN,NaN,1.5881086629985417,2.807147579448798
2018-08-09T09:30:00-04:00,75.59,75.73,74.71,74.83,15232467,11225756.65,43.81549105018164,51.402003576410706,NaN,NaN,-65.01279773325294,-31.053135082167547,-0.12155191506541971,-0.025592809948065565,0.09595910511735414,134929710,146396962,46.811864952352195,64.68562449617824,NaN,NaN,-0.5153276834988347,2.3325082561705646
2018-08-10T09:30:00-04:00,74.66,75.29,74.51,75.29,16977728,11503488.5,47.160138243060636,51.624127024936165,NaN,NaN,-66.01936810388973,-31.77024304656886,-0.12237599245662138,-0.05701088545342259,0.0653651070031988,151907438,148865489.8,49.44073428562504,63.5181324990274,NaN,NaN,-1.3069393234027455,1.8125871733743775
2018-08-13T09:30:00-04:00,75.15,75.41,74.29,74.33,9817144,11424808.5,41.59503413051144,50.9902917684967,NaN,NaN,-96.46867472209365,-43.738237772214816,-0.17833823492748851,-0.15755768665616188,0.02078054827132665,142090294,147730570.2,48.25973156908694,62.0468012476014,NaN,NaN,-3.7597000275100774,1.0165461446765982
2018-08-14T09:30:00-04:00,74.9,75.01,74.201,74.51,10437874,11459043.05,42.95430819601506,50.183011216008744,NaN,NaN,-101.6474232458731,-71.85537598354601,-0.19276777217931548,-0.2201791669528177,-0.02741139477350222,152528168,146323557.4,46.76819392547266,60.306482135861415,NaN,NaN,-5.344924276002961,0.10776465600808982
2018-08-15T09:30:00-04:00,73.8,73.92,71.7,71.91,26375478,12010240.95,31.537010882230177,48.24041730475305,NaN,NaN,-264.3102715837759,-118.69170707777707,-0.3573827429030355,-0.47413982340229666,-0.11675708049926112,126152690,141521660,41.99759161390985,58.10527467258031,NaN,NaN,-11.16740867791787,-1.5029743916956186
2018-08-16T09:30:00-04:00,72.26,72.84,72.22,72.43,25013734,12449337.2,35.24424192106433,46.73136330722036,NaN,NaN,-214.76981900962815,-148.6431113330521,-0.4075759862996344,-0.6262270633738041,-0.2186510770741697,151166424,144769002.8,46.0085447890497,56.088904291022025,NaN,NaN,-14.453969904518182,-3.353116607813128
2018-08-17T09:30:00-04:00,72.62,72.8,72.345,72.61,11532984,12482920.55,36.52552982230267,45.075812361233034,NaN,NaN,-173.44795521969263,-170.12882875621267,-0.40418975254665446,-0.7238882677574878,-0.31969851521083337,162699408,146927396.8,48.55497746654459,54.03117994023553,NaN,NaN,-16.588620945564212,-5.243902941777568
2018-08-20T09:30:00-04:00,72.63,73.355,72.6,73.1,8345742,12519015.2,40.00559472976532,43.74538608342834,NaN,NaN,-126.807010557092,-176.19649592321235,-0.3466937465033748,-0.7530656983400519,-0.40637195183667707,171045150,152718368,54.72480292969509,52.346853731911615,NaN,NaN,-17.223244017395736,-6.955237381151592
2018-08-21T09:30:00-04:00,73.71,74.06,73.3899,73.47,9509139,12486047.15,42.5662197753913,43.136958048379654,NaN,NaN,-79.21408818646303,-171.70982891133033,-0.2651647535943752,-0.7378278938296461,-0.4726631402352709,180554289,158323592.2,59.755851666913856,51.27979270993293,NaN,NaN,-16.945772885992508,-8.382456738986008
2018-08-22T09:30:00-04:00,73.93,74.585,73.88,74.35,9345383,12401439,48.22615295904006,43.121115414796556,NaN,NaN,-39.00762257920242,-126.64929911041565,-0.13969486198505932,-0.647281717716595,-0.5075868557315357,189899672,171072988.6,68.36635798883921,51.49905361443171,NaN,NaN,-14.898424658245215,-9.31330929888018
2018-08-23T09:30:00-04:00,74,74.13,73.72,74,6468894,12115514.45,46.27297687558883,43.135583070623184,NaN,NaN,-50.06163718699965,-93.70766274588993,-0.07143833904227359,-0.5968847795343777,-0.5254464404921041,183430778,177525859.4,71.67018783853503,52.43646194349825,NaN,NaN,-13.816962832337879,-9.956688375088422
2018-08-24T09:30:00-04:00,74.46,74.98,74.39,74.54,7753284,11871038.35,49.66046935182641,43.25119831332032,NaN,NaN,-6.289380267146278,-60.27594775538067,0.014340376329130544,-0.5075209700806909,-0.5218613464098214,191184062,183222790.2,74.2291822347184,54.017489222506356,NaN,NaN,-11.865183742953052,-10.229330570497655
2018-08-27T09:30:00-04:00,74.79,75.185,74.68,75.09,6984879,11650532.45,52.916636247035065,43.32851559047687,NaN,NaN,23.95100464288315,-30.124344715385643,0.1072104924709153,-0.38784823082117725,-0.49505872329209255,198168941,188647548.4,76.41394861619645,55.86998002378742,NaN,NaN,-9.216270570038043,-10.08460771328914
2018-08-28T09:30:00-04:00,75.23,75.54,74.72,74.77,8393479,11505670.85,50.855496832223764,43.523950072588335,NaN,NaN,36.02076322456922,-7.077374433179199,0.14389123436340256,-0.3151946803378394,-0.45908591470124194,189775462,190491783,77.12398030269509,57.8661392985453,NaN,NaN,-7.622382922328738,-9.73286131458051
2018-08-29T09:30:00-04:00,75.01,75.54,74.78,75.23,7760446,11335061.9,53.650320490823134,44.22643788977701,NaN,NaN,53.640476973312516,11.452245477323789,0.19288052049190096,-0.21798526408636576,-0.4108657845782667,197535908,192019030.2,77.72208188136567,60.074011936331964,NaN,NaN,-5.44341025932718,-9.120082592401463
2018-08-30T09:30:00-04:00,75.2,75.35,74.625,75.02,9250541,11313101.05,52.191096276077715,44.585792034992515,NaN,NaN,42.24109038167895,29.912790991059506,0.20381901588183676,-0.15609201472597078,-0.35991103060780755,188285367,192989948,78.11384342098533,62.12209116028628,NaN,NaN,-4.045284439346199,-8.395111427679282
2018-08-31T09:30:00-04:00,74.79,74.81,74.13,74.44,8909659,11375417.15,48.284896970822096,45.06363938072899,NaN,NaN,3.9815684251594705,31.966980729520657,0.16625751842174402,-0.1520891325806275,-0.31834665100237153,179375708,190628277.2,74.67400366665841,64.00882488154137,NaN,NaN,-3.9458944155057587,-7.759508997368779
2018-09-04T09:30:00-04:00,74.78,74.84,73.98,74.28,15094743,11720149.65,47.234640736781536,45.36937741935517,NaN,NaN,0.9973613820575682,27.37625207735554,0.1266906850970368,-0.15998329463107552,-0.2866739797281123,164280965,183850682,65.72849859190733,65.36313235771529,NaN,NaN,-4.1559150283274615,-7.244709858934305
2018-09-05T09:30:00-04:00,73.94,74.22,73.19,74.18,9598117,11610138.5,46.553091576003055,46.44195461176752,NaN,NaN,-33.01700220593081,13.568698991255536,0.09148141101700696,-0.1723222159568536,-0.26380362697386056,154682848,176832159.2,57.98234699369553,66.50490059912855,NaN,NaN,-4.51469352634317,-6.854707525707
2018-09-06T09:30:00-04:00,73.9,74.15,72.6149,72.81,14406402,11860405.85,38.38216528633856,46.66609199500139,NaN,NaN,-80.34644471478292,-13.228685346363552,-0.020407838709508075,-0.28931342536074567,-0.2689055866512376,140276446,165380266.8,48.03501831758627,66.64964870830973,NaN,NaN,-7.34871134712405,-6.92527950019515
2018-09-07T09:30:00-04:00,72.54,72.93,71.78,72.8,10134371,11605501.05,38.329282105856606,46.79493144382667,NaN,NaN,-121.19201591690646,-45.915306606080634,-0.0876546558898258,-0.37847390651351986,-0.29081925062369407,130142075,153751608.4,40.446916739429206,66.07050151351578,NaN,NaN,-9.646186207509661,-7.313980458382937
2018-09-10T09:30:00-04:00,73.17,73.47,72.745,72.77,8911663,11202197.8,38.159420274765736,46.66306183989813,NaN,NaN,-72.71312892158501,-61.25424607542952,-0.12447184252601257,-0.44640905378120976,-0.3219372112551972,121230412,142122549.2,34.56624392120264,64.6306044414806,NaN,NaN,-11.582313265444135,-7.923742287963108
2018-09-11T09:30:00-04:00,72.7,73.88,72.5,73.46,14281571,11425419.15,44.27614313460867,46.78519922269936,NaN,NaN,-44.311942503972425,-70.31610685263551,-0.0940538940401604,-0.4395045788053977,-0.3454506847652373,135511983,136368752.8,32.08091998514978,62.65382360706889,NaN,NaN,-11.598267433499451,-8.448674451611158
2018-09-12T09:30:00-04:00,74.06,74.57,73.82,73.84,12689419,11537996.4,47.363933901953835,46.72361214719321,NaN,NaN,22.994912393710607,-59.11372393270724,-0.0426579324775635,-0.3987731003621917,-0.3561151678846282,148201402,135072463.6,31.530874101858515,60.022717615141694,NaN,NaN,-10.733145873336394,-8.77502751185762
2018-09-13T09:30:00-04:00,73.72,74.01,73.23,73.87,11037449,10771094.95,47.61074871979279,46.819167278922066,NaN,NaN,-14.310068865541526,-45.906448762858965,-0.003046576242260568,-0.35992338818745395,-0.3568768119451934,159238851,138864944.6,35.04004113037111,57.40627856455855,NaN,NaN,-9.952584844286875,-8.943249987918943
2018-09-14T09:30:00-04:00,73.88,74.54,73.85,74.26,9494340,9995125.25,50.838087880457856,46.90328288811003,NaN,NaN,26.695202735979894,-16.329005032281692,0.05008322766900186,-0.2942727773589411,-0.34435600502794295,168733191,146583167.8,41.59999444067619,55.07562229355553,NaN,NaN,-8.380851744531862,-8.862907381720788
2018-09-17T09:30:00-04:00,74.45,74.88,74.2026,74.38,14728899,10154921,51.82154761534266,46.825062271560576,NaN,NaN,47.67492985047867,7.748606722131042,0.09155606153639945,-0.22991092810744362,-0.32146698964384307,183462090,159029503.4,50.31365971973736,53.21131594380846,NaN,NaN,-6.790277719636399,-8.566817429994448
2018-09-18T09:30:00-04:00,74.91,75.375,74.855,74.87,10223473,10248807.55,55.7170533379228,47.17231630768193,NaN,NaN,97.66005538064485,36.14300629905449,0.1469523187598083,-0.1377765911940827,-0.284728909953891,193685563,170664219.4,56.80222042233233,51.75976166663969,NaN,NaN,-4.28829127219284,-7.955599407451361
2018-09-19T09:30:00-04:00,74.89,75.41,74.82,75.1,10911537,10318927.45,57.45592113962709,47.44414492545364,NaN,NaN,96.650285720464,50.874080964405174,0.19124401800716537,-0.04567388744493428,-0.23691790545209965,204597100,181943359,61.98508913271678,50.635690756021916,NaN,NaN,-1.6661644063816266,-7.057108693012827
2018-09-20T09:30:00-04:00,75.42,75.71,75.03,75.12,12512374,10477277,57.61179093477716,47.831337401075025,NaN,NaN,102.66845701998547,74.26978614151058,0.21241615817961912,0.02860229227242428,-0.18381386590719484,217109474,193517483.6,66.43537082716311,49.801514142177474,NaN,NaN,0.5665432615073226,-5.968015556652806
2018-09-21T09:30:00-04:00,75.01,75.35,74.5,75.1,13725128,10840088.7,57.3853740868257,48.48137148078957,NaN,NaN,65.96758802155877,82.12426319862635,0.21495068210651685,0.08487448672595121,-0.13007619538056564,203384346,200447714.6,68.79125568755876,49.38131785795607,NaN,NaN,2.3989289060905565,-4.772737776260897
2018-09-24T09:30:00-04:00,75.76,76.53,75.7,76.2,12784505,11091649.75,65.4320778344109,49.78118841633453,NaN,NaN,158.7189981579104,104.3330768601127,0.2766565127001725,0.21574444549465,-0.060912067205522516,216168851,206989066.8,70.86962530177925,49.7485411943755,NaN,NaN,6.595413176224274,-3.148716211620158
2018-09-25T09:30:00-04:00,76.68,77.0133,76.58,76.69,13027001,11393755.85,68.30326763795753,51.33477242075985,NaN,NaN,185.91379204830625,121.98382419364498,0.3326557192870051,0.3549075819032339,0.022251862616228774,229195852,214091124.6,72.97402941404873,50.819375652972155,NaN,NaN,11.132416520300275,-1.1085543927743822
2018-09-26T09:30:00-04:00,76.22,76.62,75.815,75.95,12728563,11610510.05,60.174553893947994,52.89137160701767,NaN,NaN,120.70348125249059,126.79446330005028,0.3028886373891404,0.4008626593526543,0.09797402196351387,216467289,216465162.4,73.65904845102648,52.64966351964646,NaN,NaN,12.68078533248175,0.861351282262208
2018-09-27T09:30:00-04:00,76.25,76.35,75.745,75.95,10672146,11756095.05,60.174553893947994,54.45174816330991,NaN,NaN,103.54687112101435,126.97014612025608,0.2674600738114425,0.43229911422781697,0.16483904041637448,216467289,216336725.4,73.55043245768499,55.01420035666472,NaN,NaN,13.916674557464223,2.7263974644339246
2018-09-28T09:30:00-04:00,75.59,76.54,75.55,75.74,14833073,12035221.65,57.90644352888537,55.86224982431845,NaN,NaN,89.90655340068307,131.75793919608094,0.21632892203207948,0.4352501929564738,0.21892127092439434,201634216,215986699.4,73.23349594410374,57.77614692972908,NaN,NaN,14.302710448346758,4.380156462135758
2018-10-01T09:30:00-04:00,76.02,77.11,76.02,76.79,12712910,12225384.2,65.00828835082373,57.34311733976238,NaN,NaN,118.8231108225855,123.77876172901594,0.23795327068219446,0.5163628592771374,0.27840958859494297,214347126,215622354.4,72.88144846949938,60.69047039289692,NaN,NaN,16.91368980080397,6.170661224802645
2018-10-02T09:30:00-04:00,76.98,77.13,76.34,76.87,9468650,11944079.55,65.48607637824479,58.63755608806888,NaN,NaN,112.48630533718689,109.09326438679207,0.2416002958644501,0.5804099584255056,0.3388096625610555,223815776,214546339.2,71.7839371281113,63.5656891804864,NaN,NaN,19.15027232288439,8.024891381671466
2018-10-03T09:30:00-04:00,77.2,77.72,76.98,77.49,13244803,12126413.85,69.01693873343159,60.166569660471644,NaN,NaN,132.7458867503363,111.50174548636123,0.267699182405743,0.6734336405682342,0.4057344581624912,237060579,218664997.2,73.43306911526204,66.30804832226433,NaN,NaN,22.214799785649834,10.052021153668376
2018-10-04T09:30:00-04:00,77.24,77.71,76.7199,77.17,15192738,12165730.65,65.30358396669573,61.19981938091721,NaN,NaN,109.64346204544945,112.72106367124825,0.24590356934790564,0.7131139198473733,0.46721035049946763,221867841,219745107.6,73.86447623591368,68.61265416478129,NaN,NaN,23.63493950483325,11.992438060977642
2018-10-05T09:30:00-04:00,77.09,77.4095,76.685,77.16,11983237,12258173.95,65.18555277051857,62.15439117771549,NaN,NaN,94.33251745319357,113.60625648175036,0.21445418567177776,0.7352780825891898,0.520823896917412,209884604,221395185.2,74.54453716647399,70.34343112526247,NaN,NaN,24.742549272430043,13.813882519756557
2018-10-08T09:30:00-04:00,76.59,77.22,76.29,77.1,11578674,12391524.5,64.43305631665511,62.776962819053516,NaN,NaN,75.32601690930079,104.90683769909342,0.1749229665969959,0.7394776051636569,0.564554638566661,198305930,218186946,70.69294960349141,71.33562606677384,NaN,NaN,25.448316896035394,15.475944573510677
2018-10-09T09:30:00-04:00,77.37,78.36,77.04,77.79,16817008,12518296.35,68.88191393104036,63.593105161297316,NaN,NaN,121.68097076755623,106.7457707851673,0.17986306453076473,0.7893834692301169,0.6095204046993522,215122938,216448378.4,68.62372438857494,71.80981429933514,NaN,NaN,27.40079398044019,17.17949448878632
2018-10-10T09:30:00-04:00,77.92,78.046,75,75.35,26405265,13204088.65,46.65685784812695,62.8106099408223,NaN,NaN,10.976378006630673,82.39186903642617,0.012258722260174326,0.6248438075245701,0.6125850852643958,188717673,206779797.2,58.3881498812607,71.23501280319927,NaN,NaN,20.93796919649023,17.716419447029736
2018-10-11T09:30:00-04:00,74.62,74.67,72.25,72.8,35592112,14431821.8,34.22751711998315,61.15647730033355,NaN,NaN,-193.42102268038806,21.778972091258645,-0.2617549189420033,0.2853914365868917,0.547146355528895,153125561,193031341.2,47.53151038945919,69.71645956762072,NaN,NaN,9.229745452218692,16.504037447771015
2018-10-12T09:30:00-04:00,73.52,73.74,71.89,73,23578960,15136052.8,35.6749135049525,59.030965562515085,NaN,NaN,-196.56327192357418,-36.40018578409491,-0.4120044314594907,0.032140816204531575,0.4441452476640223,176704521,186395324.6,43.3423993612158,67.75022914329476,NaN,NaN,1.611050017497716,14.376467814874829
2018-10-15T09:30:00-04:00,72.99,73.29,72.37,72.39,11590374,14979126.55,33.27009755327359,56.528596270751954,NaN,NaN,-182.3731204626622,-87.9400132584875,-0.5275579243584025,-0.21530215778398087,0.31225576657442167,165114147,179756968,39.58404104888,65.36522997435414,NaN,NaN,-5.1363225388256915,11.588926335774755
2018-10-16T09:30:00-04:00,72.59,73.12,72.2903,72.99,14571389,15196522.35,37.71735299973948,54.924510492594194,NaN,NaN,-149.92417679516055,-142.26104277103087,-0.5368853348501471,-0.3588509019882622,0.1780344328618849,179685536,172669487.6,35.995263299442826,62.67495960638387,NaN,NaN,-8.76745815465875,8.680871408569969
2018-10-17T09:30:00-04:00,72.85,73.07,71.905,72.53,15804298,15441160.4,35.75018631863682,53.1799128086434,NaN,NaN,-140.15079907930414,-172.48647818821783,-0.5455663899273472,-0.5039235545472991,0.04164283538004809,163881238,167702200.6,33.68990572354319,59.827779125373745,NaN,NaN,-12.299490274837527,5.683676882368898
2018-10-18T09:30:00-04:00,71.86,72.84,71.71,72.17,16587091,15644896.25,34.24487976731737,51.489801111388545,NaN,NaN,-127.7678559123288,-159.355844834606,-0.5457620241596508,-0.6405596948195154,-0.09479767065986461,147294147,166535917.8,33.15301576298522,56.96488768386528,NaN,NaN,-15.593598449601838,2.644066120658793
2018-10-19T09:30:00-04:00,71.81,72.58,71.48,71.53,13568442,15637061.95,31.690214640893515,49.109938703536386,NaN,NaN,-121.73172600436422,-144.38953565076397,-0.5572539493461425,-0.7913651073425427,-0.23411115799640025,133725705,157940154.6,29.430409925415518,53.86124207357358,NaN,NaN,-19.160751393890727,-0.4709078099911381
2018-10-22T09:30:00-04:00,71.48,71.63,70.31,70.74,12294486,15612561,28.831101333102794,46.49172620031196,NaN,NaN,-131.18610897128977,-134.1521333524895,-0.5835263002506239,-0.9635190333096801,-0.37999273305905623,121431219,149203569,26.20919519669853,50.60590336418694,NaN,NaN,-23.111209056863377,-3.7052365595443146
2018-10-23T09:30:00-04:00,69.7,69.72,67.91,68.89,26477733,16285097.6,23.487116582183546,43.239596046651386,NaN,NaN,-163.9156507229196,-136.9504281380413,-0.6840022447765012,-1.2349955390296827,-0.5509932942531816,94953486,132257159,21.331950103048683,46.88439486331457,NaN,NaN,-28.6846898381172,-7.273729885054727
2018-10-24T09:30:00-04:00,69.22,69.24,66.15,66.17,28100195,17053679.2,18.15801302243581,39.87205526491853,NaN,NaN,-176.1816184504528,-144.15659201227103,-0.8796828372272048,-1.6505968407871876,-0.7709140035599829,66853291,112851569.6,17.35031041848852,42.84766873349849,NaN,NaN,-36.004125313914685,-11.378072089177579
2018-10-25T09:30:00-04:00,66.98,67.67,66.53,66.98,25333570,17786750.4,23.709337835154244,36.90946848382107,NaN,NaN,-155.31007260197467,-149.66503535020018,-0.8974966301696078,-1.8927847912719926,-0.9952881611023848,92186861,101830112.4,15.572495761466698,38.63538006171225,NaN,NaN,-39.36836305161771,-15.376685083811884
2018-10-26T09:30:00-04:00,66.43,67.3,65.38,66.48,25579939,18324093.7,22.68638538137668,33.92756341701547,NaN,NaN,-151.39786294590763,-155.5982627385089,-0.8844486938068672,-2.100849028360969,-1.2164003345541017,66606922,88406355.8,13.727518550388169,34.56642070077631,NaN,NaN,-42.28628071655728,-19.22091303134694
2018-10-29T09:30:00-04:00,66.97,67.06,64.37,65.24,24459846,18911440.5,20.342304762224387,30.460448476385757,NaN,NaN,-150.62417572227892,-159.4858760887067,-0.8979504515378554,-2.3388383989764208,-1.4408879474385654,42147076,72549527.2,11.92954387666515,30.516836378497036,NaN,NaN,-45.522455906710185,-22.978276299255974
2018-10-30T09:30:00-04:00,65.2,66.91,64.9,66.75,26397352,19757875.6,29.84806467303804,29.259820392450838,NaN,NaN,-119.76860315764272,-150.65646657565134,-0.7498400725085641,-2.3781880380742706,-1.6283479655657065,68544428,67267715.6,11.394207314827739,27.160126195180396,NaN,NaN,-44.68951158143784,-26.07988133956767
2018-10-31T09:30:00-04:00,67.4,68.29,67.07,67.16,17287796,19960025.25,32.21340963279066,29.115955571937086,NaN,NaN,-82.24770579553395,-131.8696840446676,-0.5766889209119446,-2.3492091167056373,-1.7725201957936927,85832224,71063502.2,14.368211973707375,24.791319165483834,NaN,NaN,-43.226062786561485,-28.529335831995358
2018-11-01T09:30:00-04:00,67.3,68.05,66.61,67.73,21475811,20274178.9,35.47092127979286,29.101384698711396,NaN,NaN,-73.87396923915122,-115.5824633721029,-0.3853943507621549,-2.2542631342463864,-1.8688687834842315,107308035,74087737,16.765291238451866,22.892954299572132,NaN,NaN,-40.97093106370318,-30.30670657938219
2018-11-02T09:30:00-04:00,68.48,68.98,66.88,67.56,21212484,20735641.25,34.93175668829686,29.22007463692734,NaN,NaN,-59.67024121721565,-97.23693902636448,-0.23910249436862596,-2.167746901445014,-1.928644407076388,86095551,77985462.8,19.878283826107534,21.485400212231244,NaN,NaN,-39.36327834308522,-31.60050254562548
2018-11-05T09:30:00-05:00,68.38,68.96,68.225,68.69,13231630,20818289.05,41.316972910932726,29.477190344869715,NaN,NaN,-36.54581314059544,-74.42126651002778,-0.04517840204498702,-1.9851174096326218,-1.9399390075876348,99327181,89421483.8,28.34593221927618,20.93901942079077,NaN,NaN,-35.927237133316346,-32.218607486724174
2018-11-06T09:30:00-05:00,68.86,69.16,68.19,69.01,13072117,20631044.5,43.022147382433545,29.996616135140915,NaN,NaN,-26.05159829505039,-55.67786553750932,0.1168454946305435,-1.7938821392994555,-1.910727633929999,112399298,98192457.8,34.098544967903365,20.96820793824507,NaN,NaN,-32.62805924698431,-32.27710059533276
2018-11-07T09:30:00-05:00,69.9,70.36,69.1,70.14,16897206,20155641.55,48.69179754375734,31.028538833458047,NaN,NaN,9.96232503594194,-37.23585937121415,0.30180739946243107,-1.53346838460196,-1.8352757840643912,129296504,106885313.8,39.29986185676218,21.407268373514853,NaN,NaN,-27.96373759508534,-31.6609058810117
2018-11-08T09:30:00-05:00,69.82,70.37,68.3679,68.62,15145350,19133303.45,42.5573607109249,31.804763552746003,NaN,NaN,-6.067276189686321,-23.674520761321165,0.32164570550776106,-1.43321865217969,-1.754864357687451,114151154,108253937.6,40.101431096314755,22.16948417143622,NaN,NaN,-25.827786937135144,-30.827603174743622
2018-11-09T09:30:00-05:00,67.71,68.94,67.34,68.5,22917818,19100246.35,42.106347972873714,32.75299545558678,NaN,NaN,-28.359719765824032,-17.412416471042842,0.32555941574488423,-1.3479150880063457,-1.67347450375123,91233336,109281494.6,40.734224368689254,23.206986255149847,NaN,NaN,-24.2832423683205,-29.892694488111747
2018-11-12T09:30:00-05:00,68.97,69.26,66.94,67.08,18041630,19422809.15,37.09635474091527,33.725083895496184,NaN,NaN,-41.109729918168554,-18.325199826557462,0.23558175595704278,-1.3789973088049265,-1.6145790647619693,73191706,104054399.6,38.50573784972617,24.43368537991253,NaN,NaN,-24.520631656533098,-29.12525694074337
2018-11-13T09:30:00-05:00,66.89,67.25,65.19,65.54,32732140,20330846.7,32.570221488659726,34.75452735736932,NaN,NaN,-102.4501181714595,-33.604903801839285,0.08327652388952655,-1.5104834099000612,-1.5937599337895878,40459566,89666453.2,33.13258726683502,25.560990869080133,NaN,NaN,-26.241648186798255,-28.713312833036923
2018-11-14T09:30:00-05:00,66.56,66.81,64.83,65.43,22542111,20667737.35,32.267379254765075,35.365816030198665,NaN,NaN,-108.78583826996345,-57.35453646302036,-0.00904087584351343,-1.6050610285939797,-1.5960201527504663,17917455,67390643.4,26.878920239070013,26.368592617480363,NaN,NaN,-27.682645267219446,-28.56607460934871
2018-11-15T09:30:00-05:00,65.01,66.475,65.01,66.39,15674240,20622094.8,37.71079780339214,36.43898834605692,NaN,NaN,-92.73471236594825,-74.68802369827274,0.009385872484287905,-1.5842878121451065,-1.5936736846293944,33591695,51278751.6,23.433693096096334,27.06189079931666,NaN,NaN,-27.20485174221666,-28.37161419975842
2018-11-16T09:30:00-05:00,66.8,67.405,66.47,67.18,19755466,20931446,41.85220239530706,37.975409605562824,NaN,NaN,-33.40226837124112,-75.69653341935616,0.0853885515988626,-1.4869379951308161,-1.5723265467296788,53347161,43701516.6,22.005193454347364,27.78158005486539,NaN,NaN,-25.514790480607786,-27.963496525594042
2018-11-19T09:30:00-05:00,66.77,67.43,66.56,67.16,15583829,21095913.15,41.77647478187389,38.827438899051096,NaN,NaN,-23.798868927364687,-72.23436122119539,0.14160759719806748,-1.3953170502320944,-1.5369246474301619,37763332,36615841.8,20.732438139453564,28.44859654233866,NaN,NaN,-24.189955025536655,-27.424419168442988
2018-11-20T09:30:00-05:00,66.28,66.44,64.46,64.96,26324382,21088245.6,34.40247654731293,38.983800821516965,NaN,NaN,-127.6747117815144,-77.27927994320638,0.043034289833855155,-1.483131785137843,-1.526166074971698,11438950,30811718.6,19.725974069254832,28.831293834877766,NaN,NaN,-25.32070077977065,-27.123887970061226
2018-11-21T09:30:00-05:00,65.47,66.68,65.32,65.98,17330943,20549783,39.71547013543222,39.286982882634064,NaN,NaN,-73.39805980852854,-70.2017242509194,0.05800230375647297,-1.453663195276107,-1.51166549903258,28769893,32982206.2,21.26526126984514,29.152720265691574,NaN,NaN,-24.546263088517726,-26.75565584412644
2018-11-23T09:30:00-05:00,64.34,64.57,63.44,63.91,14421770,20004193,33.74257456493628,39.20204130239402,NaN,NaN,-167.48948261984603,-85.15267830169896,-0.053977610002045706,-1.5791375115351372,-1.5251599015330914,14348123,29133491.8,20.51408839765969,29.1981348779453,NaN,NaN,-25.92181773599666,-26.636536114393614
2018-11-26T09:30:00-05:00,64.38,65.3,64.37,64.87,16682750,19559333.55,38.371620921556236,38.99165901743856,NaN,NaN,-107.61819057116003,-99.99586274168273,-0.04616530606452529,-1.582866534113748,-1.5367012280492227,31030873,24670234.2,19.64733839901291,28.576806747926494,NaN,NaN,-25.470774094399403,-26.46999868296587
2018-11-27T09:30:00-05:00,64.54,65.16,64.32,64.69,22278439,19450263.2,37.83783246363567,38.62135080895299,NaN,NaN,-107.99996006228118,-116.83608096866604,-0.036326011398991165,-1.5821087422979616,-1.5457827308989704,8752434,18868054.6,18.55007427954476,27.46620169875802,NaN,NaN,-25.28777687911029,-26.301109853843645
2018-11-28T09:30:00-05:00,64.63,65.85,64.22,65.8,21148228,19187807,43.09492022364059,38.221573857516084,NaN,NaN,-74.84662611008198,-106.27046383437956,0.0566755503532419,-1.4749382929574182,-1.53161384331066,29900662,22560397,21.55256506545858,26.19853764223634,NaN,NaN,-23.452964690420412,-25.89423197335461
2018-11-29T09:30:00-05:00,65.85,66.76,65.755,66.23,14414463,19044140.35,45.03420570431175,38.39849135704372,NaN,NaN,-25.925788023318624,-96.77600947733757,0.1534011280101777,-1.339862433297938,-1.4932635613081158,44315125,25669443.4,24.09002819445793,25.05486600638942,NaN,NaN,-21.367740049137087,-25.247590269894964
2018-11-30T09:30:00-05:00,65.65,66.3,65.32,66.11,18129018,18876800.7,44.57763794972348,38.57501206967584,NaN,NaN,-38.383755782944355,-70.95486410995724,0.21194098477748513,-1.2283373303362595,-1.4402783151137446,26186107,28037040.2,26.051647467363452,24.00611051343758,NaN,NaN,-19.819241668251603,-24.472111898231628
2018-12-03T09:30:00-05:00,67.62,67.99,66.79,67.58,21994116,18915882.3,51.11575130056546,39.57639753822229,NaN,NaN,37.00194733650708,-42.03083652842382,0.3444650445417783,-1.0096970094365219,-1.3541620539783001,48180223,31466910.2,28.917368971359977,23.321227022125708,NaN,NaN,-16.419945012331066,-23.321802343102977
2018-12-04T09:30:00-05:00,67.61,67.83,65.52,65.64,18296515,19169126.55,43.77612701621732,40.37681936161926,NaN,NaN,-13.021135652377286,-23.035071646443036,0.2980105001010547,-0.9816489288519819,-1.2796594289530365,29883708,35693165,32.39396055836811,23.26846797152093,NaN,NaN,-15.72913409717721,-22.237135450827868
2018-12-06T09:30:00-05:00,64.2,64.53,63.07,64.43,35356073,20283324.35,39.92544893866433,40.92382433904063,NaN,NaN,-127.74898822917234,-33.61554407026111,0.1877185262943024,-1.0450112710851585,-1.2327297973794609,-5472365,28618559.6,29.76920621688808,23.47491696993651,NaN,NaN,-16.41635303713071,-21.405595106013987
2018-12-07T09:30:00-05:00,65.66,66.63,63.96,64.07,27445717,20810749.9,38.83103734998597,41.003841449511626,NaN,NaN,-76.26780628586225,-43.68394772276984,0.09701334176528298,-1.111463120172857,-1.20847646193814,-32918082,13171918.2,25.005207803275454,23.5871680204493,NaN,NaN,-17.309291987020618,-20.82040894615779
2018-12-10T09:30:00-05:00,63.62,63.93,61.62,63.07,23382779,21222621.35,35.888209552867096,40.57784196076591,NaN,NaN,-185.82766167880933,-73.17272890194283,-0.017724724920361812,-1.2306323680885924,-1.2129076431682306,-56300861,-3325475.4,21.11811084355216,23.523804976821076,NaN,NaN,-18.991671136123514,-20.559160687581464
2018-12-11T09:30:00-05:00,64.04,64.16,62.43,63.09,17241615,20938811.2,35.9926888205147,40.164714392097395,NaN,NaN,-144.37110694282023,-109.4473397578083,-0.0763769621687107,-1.308378845879119,-1.2320018837104083,-39059246,-20773369.2,17.941487586544,23.324451365898963,NaN,NaN,-20.299186970897146,-20.52202158519799
2018-12-12T09:30:00-05:00,64.12,64.55,63.3,63.34,19267357,21000097.55,37.366706001224856,40.37644506737683,NaN,NaN,-102.22507145337535,-127.2881269180079,-0.0819488996697273,-1.3344380082975675,-1.2524891086278402,-19791889,-30708488.6,16.426303967931347,23.088760644375856,NaN,NaN,-20.991691649452672,-20.589117308662946
2018-12-13T09:30:00-05:00,63.19,63.94,62.91,63.54,15298973,20128439.2,38.504029235518594,40.28991357452585,NaN,NaN,-104.6661588469989,-122.67156104157323,-0.05696314852640505,-1.3236930442858466,-1.2667298957594415,-4492916,-30512598.8,16.57590058057629,22.753806309428082,NaN,NaN,-21.259204942058936,-20.6848441134338
2018-12-14T09:30:00-05:00,63.15,63.41,61.79,62.09,22893814,20146024.35,33.72294068469215,40.28851115450841,NaN,NaN,-142.50028490028575,-135.91805676445793,-0.1193035392647388,-1.415859319840365,-1.2965557805756263,-27386730,-29406328.4,17.474312396263855,22.53667945218552,NaN,NaN,-22.903032574385403,-21.00172817928403
2018-12-17T09:30:00-05:00,61.93,62.45,60.52,60.96,20732300,20398927.35,30.540290561195164,39.72913041448262,NaN,NaN,-172.6820264346228,-133.2889297156206,-0.21241670833059967,-1.5620766659888758,-1.3496599576582762,-48119030,-27769962.2,18.866154216919995,22.48088058203603,NaN,NaN,-25.313487709035048,-21.617693826391317
2018-12-18T09:30:00-05:00,60.85,61.0661,59.191,59.52,26616985,20742003.3,27.03832425316925,38.95773697087788,NaN,NaN,-199.79458732407846,-144.37362579187226,-0.3392358476374391,-1.773704767205075,-1.434468919567636,-74736015,-34905316,17.48162470396099,22.404562755208616,NaN,NaN,-28.564898209018168,-22.61015159533801
2018-12-19T09:30:00-05:00,59.83,60.96,58.33,58.82,45548907,22240257.2,25.507162144939088,37.701468536684914,NaN,NaN,-191.6560424383913,-162.25981998887545,-0.4325349089148227,-1.9751375557111643,-1.5426026467963416,-120284922,-55003922.6,14.298555241917384,21.886419196384246,NaN,NaN,-31.75001955493742,-23.915847018137924
2018-12-20T09:30:00-05:00,58.1,58.99,56.84,57.19,38504384,22849257.3,22.335343902104412,36.080121265098676,NaN,NaN,-208.74069659247613,-183.0747275379709,-0.5582979365138028,-2.240475067438595,-1.6821771309247924,-158789306,-85863200.6,10.989835340852096,20.950691135412402,NaN,NaN,-35.61849292648605,-25.58765357647337
2018-12-21T09:30:00-05:00,56.67,57.61,55.64,56.11,37403130,23852866.65,20.515057508080787,34.36136551926706,NaN,NaN,-200.9035555624646,-194.75538167040665,-0.6614438545222412,-2.5089819490775938,-1.8475380945553526,-196192436,-119624341.8,8.63548699298191,19.70667967295658,NaN,NaN,-39.469439268042464,-27.570765818126098
2018-12-24T09:30:00-05:00,55.45,55.72,53.79,53.84,15605923,23912074.3,17.319980916817087,31.94738192042789,NaN,NaN,-200.73913273877164,-200.3668029312364,-0.8194421825452318,-2.8718408227368926,-2.0523986401916607,-211798359,-152360207.6,7.056851357528416,18.14521412911147,NaN,NaN,-44.05359699560217,-29.925455986336964
2018-12-26T09:30:00-05:00,54.36,57.2,53.36,57.19,29096971,24532785.35,33.72455079604073,31.229412190415275,NaN,NaN,-137.42696669410935,-187.8932788052426,-0.6430154599173483,-2.8561679650883463,-2.213152505170998,-182701388,-173953282.2,6.245783268615554,16.27748717984343,NaN,NaN,-41.93268601529561,-31.640774561902486
2018-12-27T09:30:00-05:00,56.04,57.56,55.28,57.49,24377297,24637728.25,34.96891191084838,30.87537383128556,NaN,NaN,-102.55735301211405,-170.07354091998715,-0.4594044871049259,-2.7874081140521554,-2.3280036269472295,-158324091,-181561116,5.984791630086107,14.578600423643286,NaN,NaN,-39.90484781643902,-32.8213564554077
2018-12-28T09:30:00-05:00,57.75,58.01,56.7001,57.05,19437424,24552188.05,33.961748594439,30.527567491603634,NaN,NaN,-82.40241592384646,-144.80588478626123,-0.32709375152745057,-2.736870816356543,-2.4097770648290924,-177761515,-185355557.8,5.8534142765298895,13.210615171732888,NaN,NaN,-38.65801535053814,-33.655164868997765
2018-12-31T09:30:00-05:00,57.56,57.77,56.6799,57.35,18705301,24766729.95,35.32940775877398,30.487653077739843,NaN,NaN,-73.39464161806933,-119.30410199738219,-0.1859023741411141,-2.6421550325054852,-2.456252658364371,-159056214,-177928313.4,10.01726513970263,12.41769762145792,NaN,NaN,-37.24035298364408,-34.16733459966152
2019-01-02T09:30:00-05:00,56.44,58.87,56.1511,58.48,24912627,25105910.4,40.3412600516749,30.798265308536998,NaN,NaN,-55.852111652189706,-90.32669778006581,0.00684610225762361,-2.4476950305423415,-2.454541132799965,-134143587,-162397359,18.16752388792716,12.43384307155672,NaN,NaN,-34.45550205020493,-34.20850137831058
2019-01-03T09:30:00-05:00,58.65,58.86,57.24,57.9,18024052,24907407.2,38.68412305038803,30.89236652633437,NaN,NaN,-46.68658496725186,-72.17862143469432,0.11266156707569452,-2.313714173955347,-2.4263757410310416,-152167639,-156290609.2,21.1901831434364,12.774120155521365,NaN,NaN,-32.67201955939776,-33.989003975608746
2019-01-04T09:30:00-05:00,58.9,60.05,58.56,59.87,21351479,25060155.4,46.693713345308325,31.47734396274792,NaN,NaN,-7.849358193903855,-53.23702247105227,0.32092034712435735,-2.025225307125595,-2.3461456542499524,-130816160,-150789023,23.916743227298554,13.298466058858669,NaN,NaN,-28.476822241465456,-33.2015494421597
2019-01-07T09:30:00-05:00,60.32,61.1998,59.52,60.76,18071638,24195933.65,49.879117421322114,32.631356586792926,NaN,NaN,22.215037109081003,-32.31353186446675,0.5128168238115909,-1.7051246244854639,-2.2179414482970548,-112744522,-137785624.4,30.07451877685915,14.19848080032976,NaN,NaN,-23.99327244037161,-31.886081299047117
2019-01-08T09:30:00-05:00,61.61,61.75,60.9,61.23,18692311,23758263.35,51.526457979370065,34.13036854523399,NaN,NaN,51.6933618746986,-7.295931165913153,0.6564259632634619,-1.3974089942177272,-2.053834957481189,-94052211,-124784823.8,35.67959396837894,15.399440782576828,NaN,NaN,-19.842707817723753,-30.165599373143777
2019-01-09T09:30:00-05:00,62.05,62.41,61.41,62.2,18756783,23526963.55,54.826411566031105,36.11523192472412,NaN,NaN,74.41267212799731,18.75702559012425,0.79265401118171,-1.0630174435040516,-1.8556714546857616,-75295428,-113015192,40.341821165147074,17.032311958375832,NaN,NaN,-15.309864775325439,-28.043351573455443
2019-01-10T09:30:00-05:00,61.73,62.46,61.38,62.38,19167596,23623262.6,55.43273522032869,38.25277285868052,NaN,NaN,79.9428285150143,44.08290828657748,0.8648918612992755,-0.7745566280616671,-1.6394484893609427,-56127832,-93807230.6,47.083097804259594,19.374064998543133,NaN,NaN,-11.456503194959858,-25.673801805098933
2019-01-11T09:30:00-05:00,62.06,62.4084,61.46,62.01,14105948,23365192.15,53.83323500891986,40.50262222345305,NaN,NaN,82.08714733906126,62.070209393170515,0.8561640890597104,-0.5692433780363046,-1.425407467096015,-70233780,-81690754.6,50.85557119389059,22.221617559474456,NaN,NaN,-8.68657767783776,-23.24705550120448
2019-01-14T09:30:00-05:00,61.42,62.11,61.33,61.86,13171739,23258830.45,53.16349577358884,42.8346535281322,NaN,NaN,81.64538744889077,73.95627946113247,0.8092346724309436,-0.4138641265573355,-1.2230987989882791,-83405519,-75822954,52.61728523864038,25.363174577021486,NaN,NaN,-6.565038395216158,-20.863910200349004
2019-01-15T09:30:00-05:00,62.2,62.67,61.77,62.08,9821467,22605213.1,54.06611493289581,45.45937738642353,NaN,NaN,95.44721693620757,82.70705047343426,0.7625894488574578,-0.26986198791645677,-1.0324514367739146,-73584052,-71729322.2,53.85995924067017,28.706253711531613,NaN,NaN,-4.534346275992171,-18.531115354012314
2019-01-16T09:30:00-05:00,62.01,62.51,61.79,62,12541129,22195654.55,53.66113646721439,46.88341922007879,NaN,NaN,90.32305311861502,85.8891266715578,0.6976841769273532,-0.16034621561472306,-0.8580303925420762,-86125181,-73895272.8,53.0669363174563,32.05062178644881,NaN,NaN,-2.9221463830547543,-16.30126264387552
2019-01-17T09:30:00-05:00,61.53,62.84,61.39,62.57,10174827,21373546.65,56.17969317317819,48.398475024530924,NaN,NaN,87.54649149286722,87.40985926712838,0.6646276201639522,-0.027245867337136076,-0.6918734875010882,-75950354,-77859777.2,51.57020575989165,35.30672279572063,NaN,NaN,-0.8485079960987771,-14.0937262656217
2019-01-18T09:30:00-05:00,63.31,63.89,62.94,63.84,14534878,19822845.2,61.23512534407145,50.34657336379038,NaN,NaN,110.25047849566008,93.04252549844814,0.6964236442694788,0.17865606783576027,-0.5177675764337185,-61415476,-76096116.4,52.215880856022984,38.61832755139871,NaN,NaN,2.472435272296202,-11.727131760204857
2019-01-22T09:30:00-05:00,63.14,63.28,62.28,62.45,19863168,18890784.4,53.90505518723478,51.673405322966154,NaN,NaN,77.83040396221276,92.27952880111255,0.5958589334240165,0.22705609034630214,-0.3688028430777144,-81278644,-75670741.4,52.380782600101554,41.64429308428435,NaN,NaN,3.386578578152053,-9.568030283296727
2019-01-23T09:30:00-05:00,62.67,62.75,61.3,61.81,23367653,18189010.55,50.884788115947785,52.426514470414226,NaN,NaN,53.49506317610324,83.88909804909169,0.4641100113067676,0.2113346710557451,-0.2527753402510225,-104646297,-81883190.4,49.68407163279157,43.89547506606038,NaN,NaN,3.2832401733407277,-7.7321345037770906
2019-01-24T09:30:00-05:00,61.68,62.7,61.43,62.14,13049182,18061173.5,52.36677542462795,53.40384678285993,NaN,NaN,53.19305404129224,76.46309823362712,0.38056725921265044,0.22293373376479053,-0.15763352544785988,-91597115,-82977577.2,49.203507696566,45.89642681985536,NaN,NaN,3.6114754935554374,-6.111618789872444
2019-01-25T09:30:00-05:00,62.67,63.3222,62.5715,62.93,10233586,17118004.25,55.80474435617318,54.05463471220742,NaN,NaN,77.33805647011671,74.42141122907702,0.3601073852844847,0.29250070615774604,-0.06760667912673869,-81363529,-84060212.2,48.70165802523035,47.666777876850475,NaN,NaN,4.875000381573432,-4.542101765380176
2019-01-28T09:30:00-05:00,62.1,62.33,61.62,62.3,12022744,16500276.6,52.54755773127238,54.24523759148958,NaN,NaN,42.37279917992997,60.84587536593101,0.28881733747758054,0.29341499272023697,0.004597655242656443,-93386273,-90454371.6,45.7347122481564,48.78536312480028,NaN,NaN,5.0254278083465564,-3.1753118262763573
2019-01-29T09:30:00-05:00,62.66,62.91,62.44,62.49,11884145,16122612.65,53.43037734548589,54.38123183192642,NaN,NaN,62.77815998519378,57.83542657052722,0.2410772747314685,0.3059442486569921,0.06486697392552358,-81502128,-90499068.4,45.713747466497885,49.50208837466592,NaN,NaN,5.392294181301041,-1.9513681109081575
2019-01-30T09:30:00-05:00,62.88,63.57,62.54,63.37,12117618,15793228.5,57.38487169272764,54.563978983833316,NaN,NaN,92.79223270815974,65.69486047693852,0.2540852235184631,0.3824735033236024,0.12838827980513934,-69384510,-83446711,49.63660014016957,50.166001158596096,NaN,NaN,6.834390991218134,-0.6962596677472588
2019-01-31T09:30:00-05:00,63.47,64.075,63.3,63.78,17844177,15439806,59.1263479262307,54.82780846282632,NaN,NaN,140.06689540831832,83.06962875034372,0.2739135372649719,0.47078020138635424,0.19686666412138232,-51540333,-75435354.6,53.72726350833099,50.64058442317263,NaN,NaN,8.545067964512446,0.6239299940041274
2019-02-01T09:30:00-05:00,64.47,65.27,64.26,64.89,14772410,15277223.9,63.477802531017375,55.51670614297614,NaN,NaN,221.98508832280714,111.99903512088181,0.3410253509782688,0.6231483528442183,0.2821230018659495,-36767923,-66516233.4,57.83352579493344,51.13900975181855,NaN,NaN,11.364124574569308,2.158243505513439
2019-02-04T09:30:00-05:00,64.45,65.06,63.97,65.04,10108051,14715052.5,64.03501883375455,56.29324350441654,NaN,NaN,180.9948905448491,139.72345339386567,0.37221321124309126,0.7473895159198136,0.37517630467672236,-26659872,-53170953.2,63.10868906057014,51.888395739099245,NaN,NaN,13.842580882573857,3.827434559379213
2019-02-05T09:30:00-05:00,64.99,65.25,64.78,65.14,7852677,14204104.45,64.42469955008336,57.03314240564422,NaN,NaN,177.1029689707263,162.58841519097217,0.3752104818881764,0.8441894070369429,0.4689789251487665,-18807195,-40631966.6,67.25390838767001,52.84510639245638,NaN,NaN,16.008064425850904,5.56752454030374
2019-02-06T09:30:00-05:00,64.83,65.01,64.6,64.66,6803809,13609679.35,61.00773927088402,57.55789974876348,NaN,NaN,131.37765180241553,170.30549900982334,0.32251188962236044,0.8721187871767171,0.5496068975543567,-25611004,-31877265.4,69.80497821744201,54.040680813883924,NaN,NaN,16.96691675682921,7.196009142664521
2019-02-07T09:30:00-05:00,64.26,64.48,62.64,63.23,14600475,13401863.95,52.13607070273202,57.269069572303046,NaN,NaN,32.87730826169262,148.86758158049818,0.17630490631836315,0.7699880304523106,0.5936831241339474,-40211479,-29611494.6,70.4466731097967,55.388999910305714,NaN,NaN,15.22459181202081,8.342949524001135
2019-02-08T09:30:00-05:00,63.06,63.21,61.87,62.94,10634406,12975204.45,50.53124805124233,56.504506908529535,NaN,NaN,-25.994340205870973,99.27169587476256,0.051503388938401895,0.6580623603069498,0.6065589713685479,-50845885,-32427087,68.4985643612338,56.55204873210649,NaN,NaN,13.30701309333546,9.052101462477466
2019-02-11T09:30:00-05:00,62.64,63.34,62.46,63.24,12497386,12894776.35,52.171400998001694,56.380674466441455,NaN,NaN,-4.945697953804477,62.083578175031846,-0.015804260316404806,0.5868036459730419,0.6026079062894467,-38348499,-34764812.4,66.84570979300028,57.58525781731355,NaN,NaN,12.148726873709165,9.494476521224852
2019-02-12T09:30:00-05:00,64.09,64.405,63.2996,64.04,10677292,12770054,56.32950130671558,56.7695825514963,NaN,NaN,57.4630497566353,38.155594332213596,-0.011602635662163685,0.5881046117117421,0.5997072473739058,-27671207,-36537614.8,65.5538864252402,58.71881601677416,NaN,NaN,12.311053321683463,9.896844635576082
2019-02-13T09:30:00-05:00,64.3,65.35,64.23,64.84,13061653,12932063.3,60.06812448516408,57.31967891296317,NaN,NaN,111.5054798849161,34.18115994871371,0.037225805159830094,0.6462395038236934,0.6090136986638633,-14609554,-34337324.8,66.42124458698456,59.94865436608978,NaN,NaN,13.554184741313472,10.419321793538566
2019-02-14T09:30:00-05:00,64.61,65.5599,64.49,65.07,10213409,12815677.3,61.09923269068895,57.697856651142864,NaN,NaN,114.53026091625783,50.511750479626755,0.07500488872157285,0.7027698095658295,0.6277649208442566,-4396145,-27174258,69.14511205899692,61.40890108278739,NaN,NaN,14.878877764967719,11.056401218028446
2019-02-15T09:30:00-05:00,65.75,66.17,65.6,66.12,10183838,12816127.85,65.48135433188321,58.62169926547221,NaN,NaN,155.5736817869899,86.82535487819891,0.156037540244097,0.8228118461493779,0.6667743059052809,5787693,-15847542.4,72.89001323850626,63.34856543924094,NaN,NaN,17.39071497405992,11.961303183175799
2019-02-19T09:30:00-05:00,65.79,66.57,65.695,66.32,8719631,12525365.5,66.26097644766367,59.53817062991347,NaN,NaN,143.61292165269623,116.53707879949907,0.2053321693482737,0.9234395175906229,0.7181073482423492,14507324,-5276377.8,75.83755997515527,65.50026633271648,NaN,NaN,19.682104943999377,13.064274863293452
2019-02-20T09:30:00-05:00,66.22,66.93,66.21,66.6,9935693,12028991.75,67.37202550606366,60.25153875943748,NaN,NaN,143.30531722808485,133.70553229378896,0.23678733451219447,1.0140915163825923,0.7773041818703978,24443017,5146467,78.33831809627395,67.55038904386679,NaN,NaN,21.9197681518057,14.329345333080916
2019-02-21T09:30:00-05:00,66.39,66.56,65.33,65.57,11866116,11453914.9,59.59720303464778,60.28517126718156,NaN,NaN,91.52427455305619,129.70929122741697,0.1712713117174708,0.9913933215172364,0.8201220097997656,12576901,10583758,79.52862486866968,69.39334342674812,NaN,NaN,21.63097318593266,15.37243502634545
2019-02-22T09:30:00-05:00,66.06,66.26,65.43,65.76,9948258,11298868.7,60.50268439919526,60.07266282919426,NaN,NaN,83.81074374344702,123.5653877928548,0.12587727302288443,0.9774686010783711,0.8515913280554867,22525159,15968018.8,80.66183435381194,71.02393689523943,NaN,NaN,21.6501784163718,16.269255510634927
2019-02-25T09:30:00-05:00,65.55,66.09,65.49,65.87,15904458,11582412.3,61.04697772921469,59.85923132172712,NaN,NaN,77.31987492006579,107.91462641947001,0.09008262178013315,0.9641946052806531,0.87411198350052,38429617,22496403.6,81.96540316985264,72.37084504590247,NaN,NaN,21.814822481803322,17.061479363658982
2019-02-26T09:30:00-05:00,65.81,66.26,65.64,65.66,10550682,11508809.2,59.36504912494115,59.49782771993125,NaN,NaN,75.71415392215617,94.33487287336199,0.04155412644861889,0.9260546415612936,0.8845005151126747,27878935,25170725.8,82.48622726093772,73.45886782256444,NaN,NaN,21.498279145549773,17.695307903929095
2019-02-27T09:30:00-05:00,65.98,66.59,65.6,65.91,10294013,11429302.6,60.75139936797162,59.47951772686607,NaN,NaN,81.66696493053988,82.007202413853,0.01684966334904814,0.9055625942989849,0.8887129309499368,38172948,27916712,83.02820531362451,74.40338404372035,NaN,NaN,21.591449427409927,18.251899550140642
2019-02-28T09:30:00-05:00,65.92,66.01,64.84,65.25,11249407,11385892.05,55.37969172563511,59.711204942787724,NaN,NaN,29.862184869748678,69.67478447719148,-0.04973978698306003,0.8265381972211117,0.8762779842041717,26923541,30786040,83.59932895446883,75.34285946119692,NaN,NaN,20.182804780070295,18.527743154416306
2019-03-01T09:30:00-05:00,65.6,66.46,65.6,66.45,20327998,11510083.1,61.9648111136417,60.5278880186734,NaN,NaN,82.6374061272252,69.44011695394714,-0.020276985108494627,0.8509317528185534,0.871208737927048,47251539,35731316,84.56348358057384,76.49035369114979,NaN,NaN,20.82225842687702,18.855531050482124
2019-03-04T09:30:00-05:00,66.69,66.85,65.57,66.57,19780305,11760477.85,62.55986079215905,61.269920861113214,NaN,NaN,85.13625700323516,71.00339337058101,-0.001031842723772991,0.8699189345223317,0.8709507772461047,67031844,41451761.4,85.61681294883712,77.83114677370955,NaN,NaN,21.515846330153366,19.23557609043516
2019-03-05T09:30:00-05:00,66.66,66.69,65.88,66.35,15807549,12045452.75,60.685393201458346,61.58105599645198,NaN,NaN,76.09337689707851,71.07923796556548,-0.010895447442962558,0.8573314679424016,0.8682269153853641,51224295,46120833.4,86.43068870057681,79.32234693623359,NaN,NaN,21.568924334085224,19.56891155381374
2019-03-06T09:30:00-05:00,65.81,65.95,65.18,65.51,22690923,12787365.05,54.02884427367868,61.14967883848874,NaN,NaN,19.740292175056776,58.69390341446886,-0.07802890309681076,0.7706907865143506,0.8487196896111614,28533372,44192918.2,84.3092987947277,80.60006509392953,NaN,NaN,19.639418405518093,19.578983961200077
2019-03-07T09:30:00-05:00,65.55,65.6,64.86,65.12,23446166,13619482.9,51.219712579340396,60.44399883053527,NaN,NaN,-7.518319671964838,51.21780250612617,-0.1486429527652514,0.6629159986545972,0.8115589514198486,5087206,39825651.2,79.5463151425171,81.34300817132385,NaN,NaN,17.173490004063442,19.235341967323414
2019-03-08T09:30:00-05:00,64.07,64.2,63.305,63.9,15672992,13673108.75,43.58543848254996,58.880004841297186,NaN,NaN,-115.19249646237492,11.651821988206137,-0.2703667397758587,0.47360052670002517,0.7439672664758838,-10585786,28258186.2,68.50679060038217,81.02992084002926,NaN,NaN,12.43498137890793,18.26386188326406
2019-03-11T09:30:00-04:00,64.37,65.05,64.31,64.9,13212089,13801992.9,50.14485818697063,57.72885353696197,NaN,NaN,-59.39529999746059,-17.254489411933015,-0.2754527237735198,0.3996513617589841,0.6751040855325039,2626303,15377078,58.73205117297942,79.808098782731,NaN,NaN,10.428549759015501,17.14453157979998
2019-03-12T09:30:00-04:00,65.01,65.65,64.99,65.32,11013139,13727780.55,52.635771667726104,56.676263977080716,NaN,NaN,-23.277344387985067,-37.128633668945724,-0.24355220934547295,0.37066382385066277,0.6142160331961357,13639442,7860107.4,53.8989470198553,78.06242942012966,NaN,NaN,9.587549142651078,16.064962660207282
2019-03-13T09:30:00-04:00,65.73,66.01,65.46,65.98,13206790,13854255.45,56.32833353192972,56.442773298315146,NaN,NaN,24.457282440339473,-36.185235615889184,-0.17427020786427028,0.3963782733657979,0.5706484812300682,26846232,7522679.4,53.6853820673354,76.21648350574864,NaN,NaN,10.060975994823814,15.207250279438215
2019-03-14T09:30:00-04:00,66.04,66.38,65.965,66.05,12320420,13817193.8,56.713781489988925,56.172137376228974,NaN,NaN,60.6122957910218,-22.55911252329185,-0.12244531609609521,0.4175918361099491,0.5400371522060443,39166652,14338568.6,57.36062943505688,74.55211172583756,NaN,NaN,10.554423363738763,14.54256072005258
2019-03-15T09:30:00-04:00,65.48,65.71,65.26,65.51,12427359,13927891.3,52.83938433836114,55.585880705453725,NaN,NaN,-32.662315776572456,-6.053076386131357,-0.12292864624393274,0.38637634440112834,0.5093049906450611,26739293,21803584.4,61.00997427952439,73.05529537652839,NaN,NaN,9.8078991685709,13.866180498412339
2019-03-18T09:30:00-04:00,65.59,66.53,65.56,66.42,10067909,13922094.85,58.04136995461644,55.491332193287676,NaN,NaN,64.31065993522041,18.688115600404842,-0.06335662775875173,0.4301092059466214,0.4934658337053731,36807202,28639764.2,64.04479678037123,71.7380503422022,NaN,NaN,10.77946598820969,13.425221282669103
2019-03-19T09:30:00-04:00,66.75,67.09,65.97,66.24,12525956,14112411.1,56.70890217228808,55.202582393595996,NaN,NaN,98.91464050429008,43.126512578859874,-0.03868279485378806,0.44511234013813805,0.4837951349919261,24281246,30768125,64.95926668673245,70.44741186885277,NaN,NaN,11.168114992888189,13.102777526986115
2019-03-20T09:30:00-04:00,66.18,67.419,65.98,66.82,13662863,14298769.6,59.90315600890423,55.525686985258076,NaN,NaN,139.67136562535538,66.16932921586306,0.011413678742868916,0.49806223342051226,0.48664855467764334,37944109,32987700.4,65.93236994692806,69.185486225457,NaN,NaN,12.468548147771532,13.012173329955461
2019-03-21T09:30:00-04:00,66.62,67.4,66.48,67.29,17878046,14599366.1,62.32884076137474,55.55168910295329,NaN,NaN,160.8513094881702,86.21713195529273,0.06777247397770891,0.5713641471497795,0.5035916731720705,55822155,36318801,67.39576726609852,67.95922077442306,NaN,NaN,14.301527615816385,13.196366799364164
2019-03-22T09:30:00-04:00,66.68,66.79,65.22,65.47,19974975,15100701.95,49.772298146873794,54.6382917711472,NaN,NaN,2.4041374325907605,93.23042259712537,-0.021194967400290476,0.47709796392170745,0.4982929313219979,35847180,38140378.4,68.20019918833245,66.715176934387,NaN,NaN,11.79145682305723,12.99566537417746
2019-03-25T09:30:00-04:00,65.19,65.61,64.87,65.5,12346537,14922805.9,49.95127981515997,53.8715693864116,NaN,NaN,-55.714105675688145,69.22546947494365,-0.07847527248070457,0.4001988407211172,0.4786741132018218,48193717,40417681.4,69.22256337946312,65.48602512573602,NaN,NaN,9.904453729708743,12.554063710681929
2019-03-26T09:30:00-04:00,66.26,66.89,66.08,66.44,11516543,14971098.95,55.32329975147759,53.96403049196867,NaN,NaN,76.515390210791,64.74561941624384,-0.05463903107411372,0.41037532435917967,0.4650143554332934,59710260,47503484.2,72.21574402426239,64.6221997849885,NaN,NaN,10.013319731143707,12.191100285033611
2019-03-27T09:30:00-04:00,66.39,66.69,65.465,65.97,9582647,14935530.65,52.300527701801876,54.04123157214449,NaN,NaN,26.466689214667387,42.10468413410624,-0.071068417558942,0.3761788334846159,0.4472472510435579,50127613,49940185,73.1816403646343,64.16758015799687,NaN,NaN,9.140317390422528,11.755274157232028
2019-03-28T09:30:00-04:00,65.69,66.3,65.56,66.22,9149159,14830518.25,53.748143538112046,54.76713907611321,NaN,NaN,21.488589190855347,14.232140074643274,-0.06576356669546152,0.365042792674231,0.4308063593696925,59276772,50631108.4,73.46334263365924,64.52161958894523,NaN,NaN,8.874184638626282,11.34368994028835
2019-03-29T09:30:00-04:00,66.86,67.02,65.9,66.12,10037621,14315999.4,53.05454681143397,54.97497397786059,NaN,NaN,58.026438081255854,25.356600204376292,-0.0693004998373985,0.3441807345729444,0.4134812344103429,49239151,53309502.6,74.57813705184734,65.65348286600722,NaN,NaN,8.457058651000882,10.93131404181871
2019-04-01T09:30:00-04:00,66.56,67.13,66.47,66.99,12411747,13947571.5,58.118292453463326,55.36658260541325,NaN,NaN,111.29721842121624,58.758865023757174,-0.016132796259991422,0.3933152390853536,0.409448035345345,61650898,56000938.8,75.68359496833871,67.20952914804175,NaN,NaN,9.619654180412056,10.74393406161776
2019-04-02T09:30:00-04:00,67.16,67.215,66.37,66.53,11152432,13714815.65,54.75528629182408,55.25422208826284,NaN,NaN,88.35788331161493,61.12736364392195,-0.015051586786747895,0.3906335518619102,0.4056851386486581,50498466,54158580,73.33283585697198,68.61291870444437,NaN,NaN,9.594242642044366,10.579692430250132
2019-04-03T09:30:00-04:00,66.72,66.85,65.655,65.89,11989787,13179758.85,50.386731103069046,54.80228991776857,NaN,NaN,22.411420902079495,60.31630998140438,-0.05812673539839547,0.33302671940066375,0.3911534547990592,38508679,51834793.2,70.36414784739799,69.541741448183,NaN,NaN,8.245929134390915,10.246297673698816
2019-04-04T09:30:00-04:00,65.93,66.49,65.61,66.44,10504382,12532669.65,53.79817550304696,54.87077500096041,NaN,NaN,23.88553575802706,60.79569929483872,-0.0505446608074801,0.3279726287897091,0.3785172895971892,49013061,49782051,67.75481746235089,70.02351596124205,NaN,NaN,8.13155934021526,9.94419219748688
2019-04-05T09:30:00-04:00,66.62,67.685,66.59,67.61,17269238,12612481.95,60.08566419932039,55.016796018439265,NaN,NaN,161.65258749201138,81.52092917698982,0.02807306808753801,0.41360862470661175,0.38553555661907374,66282299,53190680.6,69.76015413522644,70.43175577230313,NaN,NaN,10.063763618456004,9.961273829053898
2019-04-08T09:30:00-04:00,67.71,68.25,67.63,67.91,10602138,12481984.4,61.531257598179664,55.36124997743152,NaN,NaN,215.1917571202315,102.29983691679288,0.09150794593058553,0.4999204890323057,0.40841254310172015,76884437,56237388.4,71.46815463965962,70.89667634036935,NaN,NaN,12.082643607457996,10.264326654540197
2019-04-09T09:30:00-04:00,67.71,67.71,66.87,67.08,14541926,12658423.75,55.5381736048983,55.04946552000253,NaN,NaN,107.51945755629895,106.13215176572969,0.06977862052437878,0.49563581875719365,0.42585719823281487,62342511,58606197.4,72.756565003661,71.3841188444217,NaN,NaN,11.931060910386071,10.502431548232465
2019-04-10T09:30:00-04:00,67.23,67.64,67.15,67.33,9375986,12466883.55,56.899868373853074,54.66168177803669,NaN,NaN,111.80856393481058,124.0115803722759,0.06457314690226557,0.5065736318606469,0.4420004849583813,71718497,65248161,76.02562421331082,72.00053719779402,NaN,NaN,12.22328810155487,10.748268198707095
2019-04-11T09:30:00-04:00,67.27,67.845,66.855,67.38,10914234,12396574.25,57.18231108530166,55.19096841649582,NaN,NaN,96.53058773671609,138.54059076801371,0.05708667496002412,0.5133588286584114,0.4562721536983873,82632731,71972095,78.79911397582347,72.75760253975767,NaN,NaN,12.540507293568822,11.004302355115913
2019-04-12T09:30:00-04:00,68.35,68.4,67.39,67.56,15426841,12546548.35,58.24319108492543,55.78324779290764,NaN,NaN,131.22893402503,132.45586007461742,0.05672915490761621,0.5271835973329075,0.47045444242529133,98059572,78327549.6,81.03265376204014,73.60118042422745,NaN,NaN,13.101384055795092,11.303885455212939
2019-04-15T09:30:00-04:00,67.48,67.64,67.05,67.16,8300980,12458201.9,54.98299584918042,55.75894037131498,NaN,NaN,65.83355231782564,102.58421911413625,0.02371512334751874,0.5000983466096898,0.47638322326217103,89758592,80902380.6,81.8661735758312,74.29049682076808,NaN,NaN,12.675603016716877,11.499845106856359
2019-04-16T09:30:00-04:00,67.4,67.7,67.155,67.6,8130337,12238420.95,57.78242269308413,56.150504299263716,NaN,NaN,80.16270220622545,97.11286804412154,0.02551605916731081,0.5082782972213096,0.48276223805399876,97888929,88011664.2,83.96185508968044,75.06051215827138,NaN,NaN,13.090958031619952,11.727146953251157
2019-04-17T09:30:00-04:00,68.01,68.16,67.415,67.51,10934622,12102008.9,57.001597039985995,56.38289383511186,NaN,NaN,92.22661396574188,93.19647805030782,0.015162415947664099,0.5017152579885789,0.48655284204091476,86954307,91058826.2,84.77407548091651,75.86842164736119,NaN,NaN,13.22557883065043,11.941208650022482
2019-04-18T09:30:00-04:00,67.7,67.79,67.02,67.19,9759653,11696089.25,54.19727472815433,56.46451725773473,NaN,NaN,51.63190945034214,84.21674239303303,-0.016979347745478823,0.46532865735906626,0.4823080051045451,77194654,89971210.8,83.15534548130275,76.48107939232229,NaN,NaN,12.584178630852655,12.033061504426792
2019-04-22T09:30:00-04:00,67.81,68.655,67.62,68.61,14164657,11405573.35,62.91595988982604,56.8072077889035,NaN,NaN,136.70911947676814,85.31277948338065,0.04998887553000264,0.5447940995170484,0.49480522398704574,91359311,88631158.6,81.10056106583042,76.86800554214312,NaN,NaN,14.64303395603791,12.40591471179981
2019-04-23T09:30:00-04:00,68.66,68.81,68.0536,68.5,10212221,11298857.55,61.9324762390251,57.31986421370357,NaN,NaN,145.49240361015592,101.24454974184673,0.07781177323397337,0.5920699405295125,0.5142581672955391,81147090,86908858.2,78.41851295971463,77.23126819233902,NaN,NaN,16.020676247223914,12.922309216860397
2019-04-24T09:30:00-04:00,68.56,68.6,67.27,67.3,11019051,11273982.95,52.32351440211961,57.458205877921465,NaN,NaN,61.402893370995415,97.49258797480073,0.009902014635746026,0.5266356855902217,0.5167336709544756,70128039,81356680.2,70.34245565598013,77.22971875009489,NaN,NaN,14.218208090899395,13.107437627437397
2019-04-25T09:30:00-04:00,67.29,67.64,66.94,67.09,12060913,11397896.25,50.837028105397685,57.24669534951795,NaN,NaN,-1.5501843254060659,78.73722831657113,-0.051294258036508666,0.45261584840883984,0.5039101064453485,58067126,75579244,63.0643076624897,76.89468233581908,NaN,NaN,12.302916155922377,12.992505988649537
2019-04-26T09:30:00-04:00,66.6,66.62,65.64,66.22,16838386,11782357.6,45.11827751822941,56.17759630086859,NaN,NaN,-141.26626038550393,40.15759434940192,-0.14707738618650595,0.32006337371221605,0.467140759898722,41228740,68386061.2,55.381208981449056,75.86761482483499,NaN,NaN,8.777611362834508,12.390378184961676
2019-04-29T09:30:00-04:00,66.24,66.515,66.03,66.16,12974541,11929203.6,44.744445228488345,54.978538274462075,NaN,NaN,-129.05261276957523,-12.994752099866753,-0.20749024863334548,0.20777794910704017,0.41526819774038565,28254199,55765038.8,45.01794484525689,73.97831412523479,NaN,NaN,5.858193443990865,11.457208936251561
2019-04-30T09:30:00-04:00,66.8,66.845,66.03,66.11,14327153,12024973.9,44.414190165237656,54.18396802877202,NaN,NaN,-106.48010560304208,-63.38925394250636,-0.24145568281061042,0.11344859422712261,0.35490427703773303,13927046,42321030,37.06214844563542,71.42871294251869,NaN,NaN,3.394229989229,10.305354800962624
2019-05-01T09:30:00-04:00,66.13,66.33,64.74,64.79,22155991,12575151.85,36.71063988278881,52.74188027941029,NaN,NaN,-189.63685441515875,-113.59720349973718,-0.3375619638413926,-0.06704817776400773,0.27051378607738485,-8228945,26649633.2,30.332786266573677,68.16493880346603,NaN,NaN,-1.4259119064534664,8.62945955704604
2019-05-02T09:30:00-04:00,64.38,64.77,63.63,63.66,28033012,13377313.1,31.64973226142415,50.918124649133325,NaN,NaN,-251.43663294404647,-163.57449322346525,-0.4546841456292534,-0.2978413959591819,0.1568427496700715,-36261957,7783816.6,24.553121930130104,64.2902250859165,NaN,NaN,-7.443805222312548,6.333278874280527
2019-05-03T09:30:00-04:00,64.26,64.755,64.11,64.25,19624559,13833321.95,36.56685397185151,49.36981485534233,NaN,NaN,-185.2036466253116,-172.3619704714268,-0.4680362496540244,-0.428202562397459,0.03983368725656539,-16637398,-3789411,21.807954635615204,60.05988943402901,NaN,NaN,-10.77218952587505,3.889640531401159
2019-05-06T09:30:00-04:00,63.76,64.515,63.7,64.31,20344657,13987092.9,37.06271804507013,48.089795012191594,NaN,NaN,-159.29065370943727,-178.4095786593992,-0.44840395247748943,-0.5206712533402964,-0.07226730086280699,3707259,-8698799,20.74821220605051,55.69432076475896,NaN,NaN,-13.22916644360209,1.4440966778292665
2019-05-07T09:30:00-04:00,63.55,63.8,62.935,63.75,15064718,14210221.9,34.36276648121522,46.41696242562953,NaN,NaN,-164.40978042351898,-189.99551362349456,-0.4476717773573098,-0.6318570225594442,-0.18418524520213442,-11357459,-13755700,19.686989634848928,51.10325894655671,NaN,NaN,-16.148764582506423,-1.0691692165044029
2019-05-08T09:30:00-04:00,63.72,64.28,63.58,63.75,9823707,13974310.95,34.36276648121522,44.79990310000305,NaN,NaN,-123.56951212834906,-176.78204516613263,-0.4220659881423181,-0.711767730380032,-0.28970174223771394,-11357459,-14381402.8,19.553722343227577,46.444662293864646,NaN,NaN,-18.47772234552264,-3.5561053777927225
2019-05-09T09:30:00-04:00,63.45,63.99,62.9132,63.75,14409544,14225988.85,34.36276648121522,43.383152510935965,NaN,NaN,-120.24402194241597,-150.54352296580655,-0.3812502235147434,-0.7662645216311432,-0.3850142981163998,-11357459,-9400503.2,23.966130942192507,42.21686125535677,NaN,NaN,-20.37407599208763,-5.95867260840628
2019-05-10T09:30:00-04:00,63.75,64.21,62.85,64.05,13074954,14334024.85,37.413381961025884,41.561539801735954,NaN,NaN,-98.42429836610117,-133.18765331396446,-0.31302652526770997,-0.7762974547010373,-0.4632709294333273,1717495,-5729524.6,27.13810046867114,38.36239978413111,NaN,NaN,-21.168036871829425,-8.131438931752443
2019-05-13T09:30:00-04:00,63.47,63.775,62.65,62.95,14070022,14266183.9,31.611843918918268,39.39578035029975,NaN,NaN,-107.58405220586444,-122.84633301324989,-0.319831742779224,-0.8630606079073573,-0.5432288651281333,-12352527,-8941481.8,26.11167088861106,34.62619677905228,NaN,NaN,-23.65787535341196,-10.349501277703803
2019-05-14T09:30:00-04:00,63.29,64.255,63.23,63.72,9241956,14313232.7,38.76943918598669,38.42763212057598,NaN,NaN,-74.5346248626019,-104.87130190106647,-0.25323889781336273,-0.8597774873948367,-0.606538589581474,-3110571,-7292104.2,27.625477681035804,31.57498406655625,NaN,NaN,-23.607726228056933,-12.243533413468535
2019-05-15T09:30:00-04:00,63.36,64.19,63.19,64.05,10092343,14411333,41.59090392004841,37.767194678765314,NaN,NaN,-65.1115892260523,-93.17971732060712,-0.17163506562273045,-0.8210824216098871,-0.6494473559871566,6981772,-3624258,31.010438872710708,29.28542201014346,NaN,NaN,-22.699842718939685,-13.7372918856787
2019-05-16T09:30:00-04:00,64.21,64.64,64.21,64.4,9376619,14333432.85,44.511350917089224,37.723842778683874,NaN,NaN,-36.166142387963816,-76.3641414097167,-0.08323290086901225,-0.753488482073422,-0.6702555812044098,16358391,1918912,35.89046738012584,27.89322618147752,NaN,NaN,-21.05752554688025,-14.783039551564634
2019-05-17T09:30:00-04:00,63.97,64.32,63.67,63.75,10555799,14373240.15,40.464874303777556,37.418159141204534,NaN,NaN,-52.679413162898314,-67.21516436907612,-0.05883181972466667,-0.743795355860243,-0.6849635361355764,5802592,2735931.4,36.602289379977506,27.292107933957563,NaN,NaN,-20.848975732672717,-15.649601863151503
2019-05-20T09:30:00-04:00,63.76,64.08,63.65,63.78,8186324,14074323.5,40.732676513263115,37.15519388034921,NaN,NaN,-51.84485963098262,-56.067325854099764,-0.03229442186050746,-0.7253315634612107,-0.6930371416007033,13988916,8004220,41.14052511432896,27.58342055314996,NaN,NaN,-20.60334657147332,-16.35727967862605
2019-05-21T09:30:00-04:00,64.05,64.7,63.97,64.52,18380450,14482734.95,47.05869779747224,37.89434087425517,NaN,NaN,-16.577758257256267,-44.47595253303064,0.03957499051976343,-0.643568403450999,-0.6831433939707624,32369366,15100207.4,46.67726191726134,28.750883099627654,NaN,NaN,-18.464786373281356,-16.658352063576807
2019-05-22T09:30:00-04:00,64.13,64.28,63.31,63.52,9637121,14413638.45,40.731660271307355,38.54305001781825,NaN,NaN,-57.300261028111166,-42.91368689344241,0.024957183564785157,-0.6519469145147809,-0.6769040980795661,22732245,18250302,48.972042290406634,30.495091696790265,NaN,NaN,-18.538895402073006,-16.927001111933407
2019-05-23T09:30:00-04:00,62.46,62.51,61.02,61.39,23963613,15008773.45,31.130716802676886,38.154754505734346,NaN,NaN,-215.77011379425278,-78.8344811747002,-0.115273689921925,-0.8209962104819724,-0.7057225205600474,-1231368,14732350.2,46.56207059605532,32.263242836821696,NaN,NaN,-22.193047233716676,-17.679293415045304
2019-05-24T09:30:00-04:00,61.88,62.12,61.085,61.62,10153381,14674523.2,32.968085606939724,37.86228076015361,NaN,NaN,-207.9778224879717,-109.89416303971488,-0.17601284720602517,-0.9257385795675788,-0.7497257323615536,8922013,15356234.4,47.05963515857018,34.14263019057311,NaN,NaN,-24.3343193732012,-18.630011409067574
2019-05-28T09:30:00-04:00,61.66,61.77,60.89,60.98,12930642,14672328.25,30.52747506848044,37.5883313735297,NaN,NaN,-217.84633766530743,-143.09445864657982,-0.2388642884321035,-1.048306092901683,-0.8094418044695795,-4008629,11756725.4,44.485999124586165,35.913988011268614,NaN,NaN,-26.912530501951277,-19.813228422336675
2019-05-29T09:30:00-04:00,60.14,60.625,59.78,60.59,16951585,14803549.85,29.11310643156837,37.21335565569778,NaN,NaN,-224.73003480302773,-184.72491395573414,-0.28324605592009033,-1.1634993743696924,-0.8802533184496021,-20960214,1090809.4,37.875988891257585,37.222721336127904,NaN,NaN,-29.441597546328353,-21.188709725764056
2019-05-30T09:30:00-04:00,60.49,60.6,59.63,59.82,15173861,14454443.35,26.50234692271748,36.651897115805085,NaN,NaN,-190.6515289120079,-211.39516753251345,-0.337329961331456,-1.3019157701139221,-0.9645858087824661,-36134075,-10682454.6,32.190254140560455,37.810158707439896,NaN,NaN,-32.43617463548716,-22.795490427153073
2019-05-31T09:30:00-04:00,59,59.54,58.77,58.77,21898542,14147719.85,23.418325314112025,35.6522502124541,NaN,NaN,-190.48896374414994,-206.33893752249293,-0.4117599137927017,-1.4792857010233433,-1.0675257872306416,-58032617,-22042704.4,27.846468180299453,37.86075640112763,NaN,NaN,-36.0655569812865,-24.691214220600706
2019-06-03T09:30:00-04:00,59.17,59.81,59.08,59.52,18024661,14067724.95,29.7102261775605,35.51642037378569,NaN,NaN,-139.03924335254442,-192.55122169540746,-0.37923035427289853,-1.5415637300717648,-1.1623333757988663,-40007956,-31828698.2,24.7483879168272,37.76337904600022,NaN,NaN,-36.93499962871877,-26.440326421760428
2019-06-04T09:30:00-04:00,60.08,60.69,59.92,60.55,14743427,13787663.45,37.325859781109514,35.413307559151605,NaN,NaN,-86.4570786289751,-166.273369888141,-0.262632609499303,-1.4906241376729952,-1.2279915281736922,-25264529,-36079878.2,23.523989492140984,37.4704156039363,NaN,NaN,-35.03842461654333,-27.668626163872272
2019-06-05T09:30:00-04:00,60.67,60.69,59.52,59.88,15882054,13828530.25,34.692716654725416,34.92057989734282,NaN,NaN,-89.22856600079099,-139.17307612769363,-0.2073462369775516,-1.4871743243956317,-1.27982808741808,-41146583,-40117152,22.39103265743539,36.85474373141664,NaN,NaN,-34.37287851296874,-28.626376499457482
2019-06-06T09:30:00-04:00,60,61.22,60,60.99,32393915,14957040.65,41.99357027343627,34.74073842279618,NaN,NaN,-55.17709358600006,-112.07818906249206,-0.07931882217723829,-1.3789766151396279,-1.2996577929623896,-8752668,-34640870.6,27.49219759392446,36.25486731811654,NaN,NaN,-31.275024242553812,-29.004754748471242
2019-06-07T09:30:00-04:00,61.18,61.655,61.03,61.27,15774071,15025267,43.70325122473699,34.972051060007566,NaN,NaN,-28.470459913924888,-79.67448829644707,0.03480198272763224,-1.2561553145528492,-1.2909572972804815,7021403,-21630066.6,37.93068301515441,36.34975257777203,NaN,NaN,-28.276944513125567,-28.900781857707575
2019-06-10T09:30:00-04:00,61.6,62,61.36,61.45,9837825,14863410.55,44.82901896887151,35.264646949693876,NaN,NaN,-13.350274764388141,-54.53669457881582,0.12776290565692228,-1.1312536652093286,-1.2590165708662509,16859228,-10256629.8,45.33874507679166,36.649625432233655,NaN,NaN,-25.54026457192252,-28.42070795973828
2019-06-11T09:30:00-04:00,61.99,62.19,61.55,61.57,9522629,14636040.9,45.60988917826326,35.16116061975038,NaN,NaN,-3.5033857347231834,-37.94595599996543,0.19846780197352687,-1.0109318183993423,-1.2093996203728692,26381857,72647.4,51.05249351253887,36.96214197475347,NaN,NaN,-23.10076930264498,-27.660716723010665
2019-06-12T09:30:00-04:00,61.17,61.31,60.505,60.7,13816452,14864765.7,41.07122081665132,35.18541494441781,NaN,NaN,-41.41728513287279,-28.383699826381815,0.18788474903487207,-0.9745436840792792,-1.1624284331141512,12565405,10815045,56.18236435246284,37.47716497918606,NaN,NaN,-22.310356065049668,-26.896379486159095
2019-06-13T09:30:00-04:00,61.4,61.69,60.6838,61.41,12191939,14969745.5,45.810460497283756,36.233968065461156,NaN,NaN,-16.509168509956456,-20.650114811173093,0.22731044691868774,-0.8782903744657915,-1.1056008213844792,24757344,17517047.4,59.0648074049463,38.37021760839256,NaN,NaN,-20.178322834378495,-25.936657107333296
2019-06-14T09:30:00-04:00,61.56,61.57,60.8645,61.01,7916416,14896735.35,43.67917335142199,36.99904576149561,NaN,NaN,-15.772020737759021,-18.110426975939923,0.2246582074302763,-0.8247780620966338,-1.0494362695269102,16840928,19480952.4,59.897310535918606,39.2871944210603,NaN,NaN,-19.039168212664322,-24.951301550952014
2019-06-17T09:30:00-04:00,60.88,61.69,60.69,61.52,8795248,14808707.8,47.06097487784777,38.18001003359327,NaN,NaN,1.2582437178974561,-15.1887232794828,0.253333399334317,-0.7327695203590139,-0.9861029196933309,25636176,21236342,60.66729259746306,40.44300109769436,NaN,NaN,-17.06609275215145,-23.82484315112336
2019-06-18T09:30:00-04:00,61.92,62.74,61.81,62.37,17222144,15260498.8,52.21133318016901,39.82988337277903,NaN,NaN,82.844232090517,2.0808002855652377,0.32126142501567245,-0.5845261384237403,-0.9057875634394128,42858320,24531634.6,62.13698825100682,42.175929623390736,NaN,NaN,-13.752528875001325,-22.385941111677354
2019-06-19T09:30:00-04:00,62.28,62.66,61.97,62.3,8827665,14782859.55,51.764691823194966,41.63433657995599,NaN,NaN,101.11756404658958,30.58777012145771,0.35078699661857105,-0.467303817666199,-0.81809081428477,34030655,28824684.6,64.02304443185054,44.44970035848289,NaN,NaN,-11.20916499783746,-20.789258809700225
2019-06-20T09:30:00-04:00,63.3,63.78,63.23,63.68,25953969,15598701.95,59.178608285702,44.188642506498134,NaN,NaN,207.98723004504816,75.48704983245864,0.4464309727455408,-0.26005209835284404,-0.7064830710983848,59984624,35870140.6,66.93408253504076,47.241672812392984,NaN,NaN,-6.485372943155429,-18.74584654305097
2019-06-21T09:30:00-04:00,63.2,63.785,63.2,63.56,16357327,15218387.65,58.338901389115726,46.23354787875208,NaN,NaN,178.23999924433625,114.28945382887768,0.48175886641200405,-0.10428448808337976,-0.5860433544953838,43627297,41227414.4,68.98884152767194,50.4017052131676,NaN,NaN,-2.948311634612608,-16.48905584184549
2019-06-24T09:30:00-04:00,63.54,63.72,62.89,62.99,10396671,15230552.15,54.39098294109023,47.45248524732214,NaN,NaN,135.9006411648042,141.21793331825904,0.44761388692205306,-0.02652599584281745,-0.4741398827648705,33230626,42746304.4,69.5662758253421,53.690439951253396,NaN,NaN,-1.1062579697262178,-14.291513288685596
2019-06-25T09:30:00-04:00,62.95,63.01,62.415,62.49,11887333,15178386.7,51.12281392083145,48.62606362347257,NaN,NaN,84.96760438960357,141.64260777807635,0.3751616265736035,-0.005187849547866108,-0.38034947612146963,21343293,38443299,65.82674418195859,56.792990774433626,NaN,NaN,-0.5171627746261603,-12.323748929534249
2019-06-26T09:30:00-04:00,63.12,63.93,62.96,63.45,14326784,15047146.65,56.52426499425586,49.66397038924539,NaN,NaN,119.36025502821842,145.29114597440213,0.3748158918669812,0.08817038871225691,-0.2866455031547243,35670077,38771183.4,65.97682556961014,59.54189277269689,NaN,NaN,1.6729127742090277,-10.324225828999495
2019-06-27T09:30:00-04:00,63.45,63.64,62.85,62.98,10608998,14818903.5,53.41215011009799,50.35746316677118,NaN,NaN,90.86297528692955,121.8662950227784,0.3275697139874475,0.12281663932958509,-0.2047530746578624,25061079,31786474.4,59.93796858363699,61.113841741874225,NaN,NaN,2.551518561022673,-8.484833773282043
2019-06-28T09:30:00-04:00,63.13,63.77,63.13,63.71,17369740,14592463.4,57.340798026464064,51.25116167088493,NaN,NaN,102.63080863689298,106.74445690128975,0.3292385685972449,0.2067951360886937,-0.12244343250855118,42430819,31547178.8,59.73623775379385,62.1422340759458,NaN,NaN,4.516954677594153,-6.627435423156872
2019-07-01T09:30:00-04:00,64.5,64.71,63.61,63.77,14913860,14436923.35,57.65685590298658,52.11165929407946,NaN,NaN,120.45323368532368,103.65497540539363,0.31797069775962317,0.2750199396909778,-0.04295075806864537,57344679,36369989.4,62.47727421059397,62.9582898400926,NaN,NaN,6.1881144504982615,-4.796642584063282
2019-07-02T09:30:00-04:00,63.58,63.71,62.47,62.75,12100515,14304777.75,50.77036774556853,52.80445550328783,NaN,NaN,48.98794105680075,96.45904273883306,0.2295372219840231,0.24397076941138351,0.014433547427360402,45244164,41150163.6,65.0191756050366,63.58949064384786,NaN,NaN,5.571106591502427,-3.315535558982466
2019-07-03T09:30:00-04:00,62.84,63.05,62.46,63,6987346,13860042.35,52.27495613245619,53.26620519151443,NaN,NaN,33.64996592118085,79.31698491742557,0.17789894019796743,0.23680722267481968,0.05890828247685226,52231510,44462450.2,66.70241513481605,64.13503405312427,NaN,NaN,5.507866815509473,-2.055049505483618
2019-07-05T09:30:00-04:00,62.77,63.15,62.63,63.09,7363356,12608514.4,52.833823777274546,53.920108793361045,NaN,NaN,36.879856868829606,68.52036123380557,0.14141384334184087,0.23567558665415334,0.09426174331231248,59594866,51369207.6,69.94953321089955,64.85304995848006,NaN,NaN,5.613238009789913,-0.9595798604445422
2019-07-08T09:30:00-04:00,62.99,63.53,62.81,63.18,8628482,12251234.95,53.42122570890177,54.37441242415061,NaN,NaN,49.03119413944848,57.80043833431669,0.11601676754572454,0.23928270274446817,0.12326593519874363,68223348,56527713.4,72.135161401102,65.67218344445426,NaN,NaN,5.85928412020272,0.014543565362209465
2019-07-09T09:30:00-04:00,63.08,63.27,62.66,63.23,7488131,12133750.25,53.76571917239561,54.48543999502395,NaN,NaN,35.14340030266807,40.73847165778555,0.09608367298554416,0.2433705264306738,0.14728685344512965,75711479,60201073.4,73.60725002776576,66.49148785707992,NaN,NaN,6.154549229020838,0.8916872315991564
2019-07-10T09:30:00-04:00,63.63,64.26,63.2093,64.04,11767381,12245987.85,59.04957588412506,55.005788856518954,NaN,NaN,96.49737191064432,50.240357828554274,0.12890265213882893,0.3084151686186658,0.17951251647983688,87478860,68648012.6,76.66066892567761,67.39417532092469,NaN,NaN,7.892830579791594,1.8918505670552188
2019-07-11T09:30:00-04:00,64.23,64.24,63.77,64.17,12681342,12189232.35,59.84279544410979,55.05323079640522,NaN,NaN,115.5227321887095,66.61491108206,0.14937537738564022,0.36623173821188715,0.21685636082624693,100160202,78233751,79.55179962741997,68.29544082752321,NaN,NaN,9.565072508862029,2.9880251301704774
2019-07-12T09:30:00-04:00,64.21,64.66,64.21,64.44,8081374,11983704.1,61.51036478283688,55.27976389595673,NaN,NaN,147.94655797445665,88.82825130318541,0.16963051201743307,0.42889450084803826,0.2592639888306052,108241576,87963093,81.99032746446132,69.22411839443673,NaN,NaN,11.453946261133172,4.19744243459372
2019-07-15T09:30:00-04:00,64.55,64.59,63.72,63.86,9538946,12064830.6,56.11922031656993,55.403209422776705,NaN,NaN,101.36487526976791,99.29498752924931,0.13405582094511492,0.4268337650119989,0.29277794406688396,98702630,94058949.4,83.33155840802578,70.20735286462842,NaN,NaN,11.65734920175682,5.263143401331305
2019-07-16T09:30:00-04:00,63.73,63.84,62.925,63.18,10587053,12154420.85,50.52772443339873,55.36070303081724,NaN,NaN,-0.759296214789478,92.1144482257578,0.05866565410091795,0.36611001169303137,0.3074443575921134,88115577,96539769,83.85841106143263,71.49532907030513,NaN,NaN,10.212464707019873,5.970189302143957
2019-07-17T09:30:00-04:00,63.13,63.33,62.42,62.46,13664662,11976546.75,45.37282211126932,54.5641713963182,NaN,NaN,-91.55707914045799,54.503558015537315,-0.040414421926080635,0.2569263301845126,0.29734075211059324,74450915,93934180,80.96386273359963,72.56583172487582,NaN,NaN,7.358877866489396,6.168573382764734
2019-07-18T09:30:00-04:00,62.16,62.47,61.795,62.47,12755565,12172941.75,45.45605394098473,53.99587881281011,NaN,NaN,-164.37112093105932,-1.47521260841645,-0.10246992554218698,0.1692533451828595,0.2717232707250465,87206480,91343435.6,78.07806071373423,73.86155259131134,NaN,NaN,5.076472293122641,6.012558941387292
2019-07-19T09:30:00-04:00,62.53,62.965,62.24,62.76,9965289,11373507.75,47.93359549039076,53.32393577451916,NaN,NaN,-92.56561344004193,-49.57764689131617,-0.11996359685810415,0.12176877465241631,0.24173237151052046,97171769,89129474.2,75.59825727845812,74.99455398593021,NaN,NaN,3.8186242501920646,5.699139699787974
2019-07-22T09:30:00-04:00,63,63.26,62.55,63.05,7844184,10947850.6,50.36174583690735,52.80285648408493,NaN,NaN,-45.18513793098285,-78.88764953146632,-0.1083363065337363,0.1063119883433501,0.2146482948770864,105015953,90392138.8,76.06515473383718,75.96511688044758,NaN,NaN,3.413017737615177,5.372550848049003
2019-07-23T09:30:00-04:00,63.05,63.39,62.86,63.22,7268818,10791457.95,51.78135436742054,52.87506981421721,NaN,NaN,-15.333028083470145,-81.80239590520246,-0.0864772826933515,0.106551691510397,0.1930289742037485,112284771,95225977.6,77.81518409183815,76.87911748664769,NaN,NaN,3.45489281148856,5.09859969996894
2019-07-24T09:30:00-04:00,63.14,63.9,63.07,63.49,9907734,10692478,54.03002523486768,53.00043189296088,NaN,NaN,27.13380166977593,-58.064219743155675,-0.0527722270552031,0.12706369038474463,0.17983591743994773,122192505,104774295.6,80.80129563130902,77.88618037925434,NaN,NaN,4.099745037924352,4.955906176819713
2019-07-25T09:30:00-04:00,63.73,63.81,62.58,62.77,10070354,10479656.5,47.64864197444893,52.63006176418763,NaN,NaN,-34.60928414916826,-32.11185238677746,-0.0764683914928092,0.08425042807393623,0.16071881956674544,112122151,109757429.8,82.15153700641817,78.75775207893423,NaN,NaN,2.8518371723201046,4.6553248904626265
2019-07-26T09:30:00-04:00,62.77,62.78,62.1801,62.45,9653823,10431897.75,45.099169274224984,52.03562916171071,NaN,NaN,-109.6850676352715,-35.535743225823374,-0.10919898407234369,0.02422008947631582,0.1334190735486595,102468328,110816741.6,82.43435658005927,79.49340887743118,NaN,NaN,1.0487534966158718,4.140100405627376
2019-07-29T09:30:00-04:00,62.4,62.45,61.74,62.2,8284938,9977657.65,43.15640626827568,51.27782109713072,NaN,NaN,-141.39095672281138,-54.77690698418907,-0.14116026639691265,-0.04303125944748132,0.09812900694943133,94183390,108650229,79.65438459604965,79.92534706088004,NaN,NaN,-1.035767673349387,3.4006906800592667
2019-07-30T09:30:00-04:00,61.95,63.05,61.825,62.9,10801348,9772032.05,49.691280862964454,50.60937145276211,NaN,NaN,-74.17598305390028,-66.54549797827511,-0.11001538329702779,-0.039390222171853395,0.07062516112517439,104984738,107190222.4,77.75147102073547,80.00326149624131,NaN,NaN,-0.9857005658973829,2.774063359208317
2019-07-31T09:30:00-04:00,62.9,63.435,62.18,62.7,15278042,9930908.4,47.9936013422915,49.763000445489375,NaN,NaN,-46.08438643778967,-81.18913559978822,-0.09813459463879551,-0.05204308217331999,0.04609151246547551,89706696,100693060.6,69.76424749688388,79.30415062977445,NaN,NaN,-1.436972389613923,2.1724868236622825
2019-08-01T09:30:00-04:00,62.01,62.3,60.885,61.28,25190596,10841070.9,38.05309447412286,48.08748113772409,NaN,NaN,-193.5438957389959,-112.97605791775375,-0.1765848590083767,-0.17463956129499536,0.0019452977133813318,64516100,91171850.4,60.03180628079975,77.73568483094148,NaN,NaN,-5.214514432071682,1.117200929986002
2019-08-02T09:30:00-04:00,61.53,61.89,59.78,60.4,21699934,11557899.8,33.43179702679923,46.466950902740464,NaN,NaN,-229.09180833731295,-136.85740605816204,-0.2726763738466596,-0.3389001695949432,-0.06622379574828358,42816166,79241418,50.52114390062087,75.39208379469827,NaN,NaN,-10.088027335744288,-0.4835459651183249
2019-08-05T09:30:00-04:00,59.28,59.44,58.18,58.6,27576891,12505320.25,26.37585497058707,44.741817369682494,NaN,NaN,-308.1049537555836,-170.20020546471648,-0.4328785728188809,-0.6073220117718847,-0.1744434389530038,15239275,63452595,41.21511975114511,72.34613441539202,NaN,NaN,-17.36917926192959,-2.89577929323422
2019-08-06T09:30:00-04:00,58.75,59.09,57.9,58.53,16997506,12980789,26.144760175011896,43.36838437423553,NaN,NaN,-239.83686935727448,-203.33238272539134,-0.5134748663498571,-0.8162870218903251,-0.30281215554046803,-1758231,42104001.2,32.498335150639264,68.88431101660913,NaN,NaN,-22.837981271842665,-5.7446652901782835
2019-08-07T09:30:00-04:00,57.46,58.37,57.16,58.09,24802188,13632529.35,24.68094984334863,41.88444836726153,NaN,NaN,-210.71333689465965,-236.25817281676532,-0.5623929522138076,-1.0058033458077276,-0.44341039359392,-26560419,18850578.2,26.038540800702947,65.16720245139261,NaN,NaN,-27.701796011584324,-8.881398250379146
2019-08-08T09:30:00-04:00,58.48,59.79,58.21,59.76,23267835,14161854,38.707633790550844,41.22545110298724,NaN,NaN,-118.73715138493138,-221.29682394595244,-0.45295430637288114,-1.0096032765600214,-0.5566489701871402,-3292584,5288841.4,23.148561747312357,61.42079562773934,NaN,NaN,-26.874009924061614,-11.451771346619498
2019-08-09T09:30:00-04:00,59.81,59.94,58.85,59.1,14593219,14487446.25,35.86492573255167,40.189963952676116,NaN,NaN,-99.8700905395506,-195.45248038639994,-0.3976604658405053,-1.0537245524877719,-0.6560640866472666,-17885803,-6851552.4,20.911093214033087,57.48121980489619,NaN,NaN,-27.239795726318732,-13.707203400862246
2019-08-12T09:30:00-04:00,58.96,59.05,58.135,58.4,21576736,15089335.75,33.0892935167502,38.85481674905681,NaN,NaN,-113.22429010055778,-156.47634765539482,-0.38084849271840215,-1.1321247025452692,-0.751276209826867,-39462539,-17791915.2,19.117788049630192,53.28854865902419,NaN,NaN,-28.510887262682804,-15.822015381122325
2019-08-13T09:30:00-04:00,58.14,59.4908,57.83,58.94,14397726,15279869.4,37.1313862354005,37.64777110623772,NaN,NaN,-90.92375461504578,-126.69372470694907,-0.30903558609639015,-1.1375706924473548,-0.8285351063509646,-25064813,-22453231.6,18.39399394320462,48.83088425273102,NaN,NaN,-28.1351137616736,-17.581029435486794
2019-08-14T09:30:00-04:00,57.68,57.82,56.54,56.63,23649726,15779122.6,29.04746903396432,36.31911589620311,NaN,NaN,-134.2121570401675,-111.39348873605061,-0.3876896984002637,-1.3131472293512942,-0.9254575309510306,-48714539,-26884055.6,17.70771522871894,44.227754125752504,NaN,NaN,-30.891734751170457,-19.482558766298745
2019-08-15T09:30:00-04:00,56.33,56.6,55.67,56.28,14306088,15856648.75,28.050986744663305,35.10138857266299,NaN,NaN,-139.02344134332202,-115.45074672772876,-0.4305642002727481,-1.4636627812919656,-1.0330985810192175,-63020627,-38829664.2,15.976990741677696,39.48079942301097,NaN,NaN,-33.32893004097605,-21.46061180553836
2019-08-16T09:30:00-04:00,56.58,57.19,56.39,57.02,21450306,16430899.6,33.26378834016616,34.394773006369455,NaN,NaN,-104.21271336758002,-116.31927129333462,-0.37822258679032084,-1.5058768145071184,-1.1276542277167976,-41570321,-43566567.8,15.336854160520758,34.88669010618749,NaN,NaN,-33.44699955500818,-23.172952912605478
2019-08-19T09:30:00-04:00,57.82,58.49,57.71,58.28,13881866,16732783.7,41.09011605441105,33.78040409147278,NaN,NaN,-58.90204274288663,-105.4548218218004,-0.2348979597482459,-1.4212766774021048,-1.186378717653859,-27688455,-41211751,17.114733419756234,30.5554945632604,NaN,NaN,-30.731228842529497,-24.25270661688034
2019-08-20T09:30:00-04:00,58,58.07,57.57,57.79,9521878,16845436.7,39.166487045073254,33.149895927385764,NaN,NaN,-64.39315665095418,-100.14870222898207,-0.1532057879387938,-1.3778859525773512,-1.2246801646385574,-37210333,-43640855,16.724578831355757,26.766946801436955,NaN,NaN,-29.247234313982162,-24.96621057360917
2019-08-21T09:30:00-04:00,58.39,58.49,57.945,58.16,12037401,16951920.05,41.39744224339647,33.38877791090531,NaN,NaN,-47.38404706145478,-82.78308023323953,-0.05919370582199601,-1.2986722969160525,-1.2394785910940564,-25172932,-38932533.6,20.507251556644007,23.94376432114012,NaN,NaN,-27.340097661053125,-25.305337300386878
2019-08-22T09:30:00-04:00,58.36,58.59,57.87,57.9,9353521,16916078.4,40.279577732241556,33.87790510415119,NaN,NaN,-46.4146268028091,-64.26131732513694,-0.0024582250689371143,-1.2425513724302277,-1.2400931473612906,-34526453,-33233698.8,24.95082635312852,22.117313067747805,NaN,NaN,-26.15647297866178,-25.426928111569005
2019-08-23T09:30:00-04:00,57.21,57.75,55.635,55.96,24409141,17653844.3,33.09785581345197,34.35804802149868,NaN,NaN,-108.971162689946,-65.21300718961014,-0.07926923595641311,-1.3391796923068071,-1.259910456350394,-58935594,-36706753.4,24.067843269653736,20.892507604784136,NaN,NaN,-27.497616622505273,-25.72274075598847
2019-08-26T09:30:00-04:00,56.45,56.75,55.96,56.2,10806578,17779926.3,34.650179450269036,34.965577969731335,NaN,NaN,-111.90339589651086,-75.81327782033499,-0.0964548627180275,-1.3804790347479283,-1.2840241720299008,-48129016,-40794865.6,23.03450568577408,20.2165197858652,NaN,NaN,-28.048557082573044,-26.05500023121484
2019-08-27T09:30:00-04:00,56.5,56.73,55.55,55.85,11833743,17831546.05,33.43190579227979,35.59064625179784,NaN,NaN,-119.62179020603872,-86.85900453135189,-0.11280013640192221,-1.4250243425323035,-1.3122242061303813,-59962759,-45345350.8,21.90702765016843,19.92141170368416,NaN,NaN,-28.870817838126296,-26.45725988934505
2019-08-28T09:30:00-04:00,56.14,56.9295,55.8552,56.65,15696538,17852470.85,38.7342031331447,35.592544061983126,NaN,NaN,-91.72207343287559,-95.72660980563606,-0.05411443908295688,-1.3798672549840774,-1.3257528159011205,-44266221,-49164008.6,20.97901886862674,19.766444355206623,NaN,NaN,-27.919743522968215,-26.666186122719786
2019-08-29T09:30:00-04:00,57.09,57.72,57.03,57.48,12332306,17209556.35,43.74102943061714,36.15512289755923,NaN,NaN,-28.321843851850755,-92.10805321544439,0.05056068370958111,-1.262551961264144,-1.3131126449737252,-31933915,-48645501,21.46549129443565,19.80604421809252,NaN,NaN,-25.534464390439688,-26.504511589536914
2019-08-30T09:30:00-04:00,57.7,58.2,57.14,57.48,13022340,16775676.65,43.74102943061714,36.915961177121154,NaN,NaN,-5.484625665274015,-71.41074581051,0.1254899455272982,-1.1562502130646024,-1.2817401585919006,-31933915,-43245165.2,26.538066431968076,20.33606410254523,NaN,NaN,-23.641341690379132,-26.09548731822866
2019-09-03T09:30:00-04:00,56.55,57.32,56.38,57.2,13964802,16095072.2,42.38579605726651,37.291276164397296,NaN,NaN,-48.249775988478916,-58.680021828903605,0.15969219940105783,-1.0821249093405783,-1.241817108741636,-45898717,-42799105.4,26.95772803374294,20.947759394726535,NaN,NaN,-22.449584697354442,-25.5746440866752
2019-09-04T09:30:00-04:00,58,58.25,57.83,58,11191118,15804752.8,47.40026855662302,38.60219041601578,NaN,NaN,36.55127275276953,-27.445409237141956,0.23513372114242714,-0.9478999573136022,-1.1830336784560294,-34707599,-37748073.4,31.714753519659467,21.94826212979371,NaN,NaN,-19.93056548360834,-24.768347143379934
2019-09-05T09:30:00-04:00,58.51,59.365,58.42,58.72,14538515,15291569.15,51.49225309454151,40.27656658386422,NaN,NaN,92.06873557193558,9.312752563820286,0.32682711739638703,-0.7744997817105457,-1.1013268991069327,-20169084,-32928646,35.99783074220882,23.37832212983165,NaN,NaN,-16.527387382286808,-23.591067177509487
2019-09-06T09:30:00-04:00,58.6,59.1,58.27,59.03,12234331,14739893.95,53.181082214568356,41.699230432035804,NaN,NaN,93.37368113836789,33.65185756186402,0.39699000711980514,-0.6050893902071763,-1.0020793973269815,-7934753,-28128813.6,40.03208517836541,25.14226720253484,NaN,NaN,-13.203379566656523,-22.107111804530494
2019-09-09T09:30:00-04:00,59.51,60.35,59.39,60.21,24757225,15248094.25,59.02846868754447,42.980541334402474,NaN,NaN,175.48041881218455,69.84486645735572,0.5045964848394429,-0.37133379127767796,-0.8759302761171208,16822472,-18377536.2,47.29984556901056,27.298346641767292,NaN,NaN,-8.381124025231244,-20.146256407487744
2019-09-10T09:30:00-04:00,60.58,61.8,60.46,60.92,25718030,15455158.95,62.09598360857537,44.618362517509766,NaN,NaN,215.71383305805213,122.63758826666194,0.5988865892863119,-0.12732203950923093,-0.7262086287955428,42540502,-689692.4,57.38799841661598,30.202876612143022,NaN,NaN,-3.3173973648408595,-17.742133687109618
2019-09-11T09:30:00-04:00,61.26,61.74,60.65,60.98,22752016,15872873.45,62.352501814570886,46.115152486879374,NaN,NaN,189.07220713073727,153.14177514225548,0.6370409407039428,0.07009254708438561,-0.5669483936195572,65292518,19310331,65.44315735580793,33.41258416922617,NaN,NaN,0.831809475585166,-15.088713235296078
2019-09-12T09:30:00-04:00,60.21,61.0445,59.71,60.6,19059516,15643362.95,59.6014012704469,47.49528273960833,NaN,NaN,130.10151311008838,160.74833064988604,0.608478658260943,0.1936499292066216,-0.41482872905432144,46233002,32590748.2,69.5582339371018,36.598827568081404,NaN,NaN,3.5571053332887383,-12.42502486835539
2019-09-13T09:30:00-04:00,61,61.4,60.74,61.08,14061580,15631137.55,61.88882807941579,49.551780758605744,NaN,NaN,139.51108031009414,169.97581048423132,0.5930933092111279,0.32653790745958844,-0.26655540175153947,60294582,46236615.2,73.10252570864475,40.10130488515218,NaN,NaN,6.5478274230018005,-9.714617398161506
2019-09-16T09:30:00-04:00,63.64,63.65,62.401,63.13,30677809,16092512.7,69.76317290316977,52.059851719527224,NaN,NaN,190.6589743622619,173.01152159424674,0.685615484724406,0.590463954153968,-0.09515153057043796,90972391,61066599,76.32816482080796,43.907994823368895,NaN,NaN,12.09037203552619,-6.599618907634692
2019-09-17T09:30:00-04:00,63.17,63.19,61.83,62.25,26473181,16722078.45,63.680658250396895,54.22047689510702,NaN,NaN,137.44075047976082,157.35690507858848,0.6523734294304384,0.7203152562176101,0.06794182678717167,64499210,65458340.6,77.20016536999165,47.85750466049912,NaN,NaN,14.750326642630245,-3.549626686168273
2019-09-18T09:30:00-04:00,61.8,62.2041,61.52,61.95,11617589,16826864,61.7054903762682,55.8612831267587,NaN,NaN,101.21112461588271,139.7846885756176,0.5775747481999174,0.7899102620370684,0.21233551383715102,52881621,62976161.2,75.5071763897625,51.75237305486597,NaN,NaN,16.25731133815225,-0.7200641112653412
2019-09-19T09:30:00-04:00,62.32,62.46,61.6,61.79,14029442,16926466.05,60.62546254813926,57.06731406372457,NaN,NaN,90.70512611513797,131.90541117662752,0.48826831263902687,0.8226709046359346,0.33440259199690775,38852179,61499996.6,74.46136540559907,55.53779263423478,NaN,NaN,17.145924878932096,1.8322200301914355
2019-09-20T09:30:00-04:00,61.27,61.515,60.98,61.28,20164618,17467020.9,57.189396314449226,58.027911698284,NaN,NaN,61.21318170912825,116.2458314564343,0.3711012440625535,0.7982791470750996,0.4271779030125461,18687561,53178592.4,68.6859970295598,58.54835910549133,NaN,NaN,16.87352686429005,3.9809781493483802
2019-09-23T09:30:00-04:00,60.87,61.459,60.8,61.3,9337060,16713416.85,57.29162294180118,59.092613618607906,NaN,NaN,53.26132782532207,88.76630214904635,0.2755913088283214,0.7716670390479479,0.4960757302196265,28024621,40589038.4,60.979910393287014,60.97851498831591,NaN,NaN,16.68090598474876,5.795253554405577
2019-09-24T09:30:00-04:00,61.11,61.17,59.965,60.33,20574893,17201832.6,50.938526074934536,59.3453462984873,NaN,NaN,24.89179660009862,66.25651137311392,0.13485481831357604,0.6646442531115966,0.5297894347980205,7449728,29179142,54.9615187582779,62.63899821964579,NaN,NaN,14.617305199458205,7.055546646555952
2019-09-25T09:30:00-04:00,60.05,60.5,59.9104,60.43,10143268,17117308.85,51.53519547618059,59.348413611461524,NaN,NaN,10.913418169356248,48.19697008380862,0.04112637739743141,0.5811974065448098,0.5400710291473784,17592996,22121417,51.570994291984725,63.75136704462979,NaN,NaN,13.0928201846044,7.918014294848588
2019-09-26T09:30:00-04:00,60.16,60.3,59.335,59.64,14088335,17036898.7,46.70294722137537,58.885689683376306,NaN,NaN,-20.062591430566357,26.043426574667762,-0.07511638510666319,0.44617554776404944,0.5212919328707126,3504661,15051913.4,48.35331134101334,64.34574034196179,NaN,NaN,10.311599725809499,8.259955070700146
2019-09-27T09:30:00-04:00,59.31,60.085,59.2,59.63,15632625,17201914.65,46.64332715925478,58.0010367170699,NaN,NaN,-34.25466201380816,6.9498578300804805,-0.14942806730074576,0.3345068487447804,0.4839349160455262,-12127964,8888808.4,45.67761692168877,64.22986686715309,NaN,NaN,8.027846466383025,8.226796698654843
2019-09-30T09:30:00-04:00,59.35,59.59,59.14,59.2,19819471,17541771.2,44.03988772740037,56.71131558270026,NaN,NaN,-60.323367281344034,-15.767081191252739,-0.2200254615335432,0.20890308912859723,0.4289285506621404,-31947435,-3105602.8,40.930583612006515,63.05433723825241,NaN,NaN,5.318649541906032,7.811347104833584
2019-10-01T09:30:00-04:00,59.4,59.62,57.82,57.83,16468129,17666937.55,36.96136332896921,54.89766283372871,NaN,NaN,-122.8430475705816,-45.31405002538878,-0.344081101422766,-0.0011728261163170828,0.3429082753064489,-48415564,-14278661.2,37.0662443760045,61.02741488255216,NaN,NaN,0.5400336081311964,6.7725880338761
2019-10-02T09:30:00-04:00,57.49,57.63,56.245,56.41,19280673,18071415.3,31.338832954633332,52.87890795402774,NaN,NaN,-206.61440742550258,-88.81961514436054,-0.49754678515618567,-0.27902520613878323,0.21852157901740246,-67696237,-31336507.8,32.08571160375806,58.35080614445618,NaN,NaN,-5.725639474295888,4.987126961280102
2019-10-03T09:30:00-04:00,56.1,57.08,55.6436,57.02,21186885,18403833.8,35.85308474456252,51.01921200153822,NaN,NaN,-190.23972879056,-122.85504261635928,-0.5307173225559982,-0.4448750741775953,0.0858422483784029,-46509352,-41339310.4,29.57602656189563,55.24177049111696,NaN,NaN,-9.435246966311876,2.926787828766962
2019-10-04T09:30:00-04:00,57.26,57.455,56.68,57.38,11061469,18345190.7,38.42602179426433,48.78084406518783,NaN,NaN,-144.71502435187185,-144.94711508397202,-0.5014951421791843,-0.5410266793455776,-0.03953153716639321,-35447883,-46003294.2,28.45829765614421,51.82249426506956,NaN,NaN,-11.641384050531991,0.8456204174385404
2019-10-07T09:30:00-04:00,57.47,57.69,56.84,56.87,12304397,17722549.3,36.210191168742924,46.81866784506969,NaN,NaN,-124.44180784599276,-157.77080319690177,-0.48907664868081335,-0.6508773480174099,-0.16180069933659655,-47752280,-49164263.2,27.694397732456295,48.2863680052456,NaN,NaN,-14.167047952882783,-1.2990464926073626
2019-10-08T09:30:00-04:00,56.29,56.73,55.82,55.9,20802273,17476761.45,32.38509346958226,44.72435378030641,NaN,NaN,-140.6838524187812,-161.33896416654167,-0.5160827992698604,-0.806904198423922,-0.29082139915406163,-68554553,-53192061,26.710518104363047,44.800892413431356,NaN,NaN,-17.596478080604356,-3.6272510051783615
2019-10-09T09:30:00-04:00,56.4,56.72,56.3,56.41,8934940,16785907.65,36.201091057076766,42.97975581665908,NaN,NaN,-111.11776931269084,-142.23963654397932,-0.47075744640869205,-0.8792682071649267,-0.40851076075623466,-59619613,-51576736.2,27.818048229883047,41.46922690088021,NaN,NaN,-19.246462176398847,-5.858566886781288
2019-10-10T09:30:00-04:00,56.6,57.27,56.51,57.12,10375027,16351683.2,41.17819639265209,41.83609867938786,NaN,NaN,-82.66244621100944,-120.72418002806921,-0.36863565416425814,-0.8693053284615573,-0.5006696742972991,-49244586,-52123783,27.6655717521339,38.53919652392121,NaN,NaN,-19.08333837646017,-7.747819956735414
2019-10-11T09:30:00-04:00,57.71,58.425,57.61,57.89,24195751,16858391.75,46.09009306675097,41.03598940259855,NaN,NaN,-43.26244404338502,-100.43366396637184,-0.23159909208976048,-0.7901685394094997,-0.5585694473197392,-25048835,-50043973.4,29.253264210431283,36.2730075108601,NaN,NaN,-17.382232344802535,-9.124164583602145
2019-10-14T09:30:00-04:00,57.47,58.065,57.25,57.86,12166831,15932842.85,45.92917133098695,40.678178349459436,NaN,NaN,-45.35407570228296,-84.61611753762989,-0.13038858159897704,-0.7215551743184605,-0.5911665927194835,-37215666,-47936650.6,30.90804690030012,34.554902378147396,NaN,NaN,-16.07734706648403,-10.117476366870985
2019-10-15T09:30:00-04:00,57.74,58.68,57.67,58.1,11267326,15172550.1,47.5081408577661,40.39053159100126,NaN,NaN,-24.230919436441138,-61.325530941161865,-0.03941081719414552,-0.6404301142121653,-0.6010192970180198,-25948340,-39415408,37.29499406047278,33.53518807589654,NaN,NaN,-14.53879572216067,-10.749093417626653
2019-10-16T09:30:00-04:00,57.9,58.31,57.27,57.29,12005526,15191946.95,42.949576700631674,40.122433696662426,NaN,NaN,-39.958879487587375,-47.09375297614118,-0.026534666322652445,-0.6341876299213354,-0.6076529635986829,-37953866,-35082258.6,40.31638147676984,32.96112165702201,NaN,NaN,-14.5163900740978,-11.28727865426539
2019-10-17T09:30:00-04:00,57.53,57.71,57.15,57.33,12289357,15104942.7,43.23922302623616,39.87928340144681,NaN,NaN,-44.862199097958964,-39.53370355353108,-0.008980590722710624,-0.6188787020020712,-0.6098981112793606,-25664509,-30366243.2,43.50686227053101,32.806067753367884,NaN,NaN,-14.416440159508939,-11.73430172644304
2019-10-18T09:30:00-04:00,57.18,57.64,57.02,57.03,10278156,14610619.6,41.535968918721075,39.70043205796973,NaN,NaN,-48.44916995531693,-40.571048735917465,-0.01109223329428033,-0.623763402897211,-0.6126711696029307,-35942665,-32545009.2,42.3797190070264,32.909577424440734,NaN,NaN,-14.801717612727685,-12.172503995912274
2019-10-21T09:30:00-04:00,57.14,58.1,57.07,58.05,10503489,14668941.05,48.905492031437085,40.553584108146005,NaN,NaN,-13.355786477837121,-34.171390891028295,0.05884532644816798,-0.5391145115427207,-0.5979598379908887,-25439176,-30189711.2,44.06670591075356,33.40961039120852,NaN,NaN,-12.96925824274317,-12.28632603117383
2019-10-22T09:30:00-04:00,58.23,59.47,58.0533,58.8,21108485,14695620.65,53.5426397701327,42.139570309253095,NaN,NaN,64.59780969578965,-16.405645064582135,0.1529107982950706,-0.4068213401220504,-0.559732138417121,-4330691,-25866181.4,47.12689612558286,34.48398071419601,NaN,NaN,-9.94883637355193,-11.952398937227844
2019-10-23T09:30:00-04:00,58.7,59.41,58.45,59.29,12213623,14799138.4,56.33112419512787,43.602287412864904,NaN,NaN,96.03326827089478,10.792784487114297,0.24022700331109037,-0.259448384278258,-0.4996753875893484,7882932,-16698821.8,52.99878230676199,36.15703469597218,NaN,NaN,-6.548513278174914,-11.180415271648855
2019-10-24T09:30:00-04:00,59.63,59.67,58.73,59.04,13205551,14754999.2,54.53267125553518,44.752762374384254,NaN,NaN,110.50361511667978,41.86594733004205,0.2709630417238709,-0.16097158543450973,-0.43193462715838066,-5322619,-12630443.8,55.36771984750203,38.07913628106917,NaN,NaN,-4.255543992194277,-10.191147946012487
2019-10-25T09:30:00-04:00,59.06,59.69,58.98,59.52,11874984,14567117.15,57.348284961391585,46.2626262167163,NaN,NaN,133.8988113976563,78.33554360063668,0.310593808931853,-0.04369236599356441,-0.3542861749254174,6552365,-4131437.8,59.913177873243306,40.380477719696806,NaN,NaN,-1.464017091849928,-8.944414966846407
2019-10-28T09:30:00-04:00,59.72,60.059,59.08,59.18,11756551,14163971.15,54.76143742341829,47.86093649913316,NaN,NaN,135.59084769439133,108.12487043508239,0.30068371907764024,0.021568473921632858,-0.2791152451560074,-5204186,-84439.8,61.9028024830251,42.89421231817266,NaN,NaN,0.15642350661876805,-7.644295184922811
2019-10-29T09:30:00-04:00,58.96,59.92,58.76,59.42,13468418,14013985.6,56.26123925866259,49.29380422781786,NaN,NaN,117.76023640436475,118.75735577679741,0.29657080906494065,0.09159826617516842,-0.20497254288977224,8264232,2434544.8,63.129467913131755,45.41645658126186,NaN,NaN,1.9403164287108945,-6.27506495440371
2019-10-30T09:30:00-04:00,59.56,59.59,57.98,58.21,15506686,13825286.25,47.67882556412822,49.758134882923294,NaN,NaN,52.474314920149716,110.04556510664838,0.2030955072064176,0.04889684111824977,-0.15419866608816785,-7242454,-590532.4,60.60574023931808,47.76932575891787,NaN,NaN,0.9858481309630259,-5.237791656494177
2019-10-31T09:30:00-04:00,57.97,58.06,57.39,57.96,15032442,13517564.1,46.11362939115443,49.75981604895212,NaN,NaN,-13.175259476001376,85.30979018811215,0.1193117806822308,-0.005058940235379339,-0.12437072091761014,-22274896,-3980987.8,57.81599452852926,49.80952078163916,NaN,NaN,-0.26757309348479624,-4.527760433207122
2019-11-01T09:30:00-04:00,58.25,59.385,58.2,59.28,13310097,13629995.5,54.590055904964345,50.37845066137907,NaN,NaN,71.62197841650753,72.85442359188241,0.14591642372229163,0.058024808735254396,-0.08789161498703724,-8964799,-7084420.6,55.30644597161291,51.55226357244721,NaN,NaN,1.301537523622195,-3.6950035822315055
2019-11-04T09:30:00-05:00,59.96,61.39,59.95,61.21,21530212,14091286.25,63.60467749386004,51.52820327824293,NaN,NaN,184.91008773600507,82.71827160020514,0.2789119007601307,0.2607482609631262,-0.01816363979700454,12565413,-3530500.8,57.577333007634614,53.00100206867306,NaN,NaN,6.053252576793771,-2.302395559513609
2019-11-05T09:30:00-05:00,61.38,61.83,61.09,61.29,17555060,13928925.6,63.924366616514966,53.02640255794888,NaN,NaN,194.4255340306459,98.05133112546137,0.3529208740412929,0.4229874527546116,0.07006657871331869,30120473,840747.4,60.25245433469508,54.42500727281057,NaN,NaN,9.770264646527533,-0.5777298157934458
2019-11-06T09:30:00-05:00,61.2,61.33,59.87,60.04,17827895,14373573.35,55.692741332045635,53.91593957979241,NaN,NaN,116.60136367838275,110.87674087710798,0.30039670591483875,0.44556246110686715,0.1451657551920284,12292578,4747753.8,62.52696374817587,55.783585949785206,NaN,NaN,10.130573386725409,0.9520277845663907
2019-11-07T09:30:00-05:00,60.65,61.13,60.49,60.94,13241711,14516907.55,59.715081770446716,55.21444764062995,NaN,NaN,131.50004950437065,139.8118026731824,0.30784073214484525,0.529966670373085,0.22212593822823973,25534289,14309590.8,67.43797298187557,57.57346123370301,NaN,NaN,11.820109081040995,2.5046108269199054
2019-11-08T09:30:00-05:00,60.57,60.77,60,60.69,10389848,13826612.4,58.136259609631615,55.87378818192956,NaN,NaN,95.79741924739379,144.64689083935963,0.27838948797620333,0.5701127981984939,0.2917233102222906,15144441,19131438.8,69.60149331119909,59.39737461944911,NaN,NaN,12.625421913950321,3.9504409822099644
2019-11-11T09:30:00-05:00,60.12,60.63,59.89,60.35,14480473,13942294.5,55.96895491541288,56.04709640659242,NaN,NaN,74.8779674389332,122.64046677994527,0.22097879028795342,0.5679467980822324,0.34696800779427894,663968,16751149.8,67.22687755340573,60.83308757857931,NaN,NaN,12.5918581484186,5.184929148811198
2019-11-12T09:30:00-05:00,60.53,60.86,59.73,60.04,12541246,14005990.5,53.9925576429418,55.88005593857913,NaN,NaN,62.681311593648545,96.29162229254581,0.15046408698979297,0.5350481165315202,0.3845840295417272,-11877278,8351599.6,59.51103565941953,61.298248532340565,NaN,NaN,11.962117327417419,6.153098888612087
2019-11-13T09:30:00-05:00,59.73,59.985,59.53,59.78,10793945,13945411.45,52.32369053857395,55.72227160165333,NaN,NaN,28.44398544430587,78.66014664573044,0.07828048920990255,0.4824346410541054,0.40415415184420284,-22671223,1358839.4,53.95866020152926,61.197601414771086,NaN,NaN,10.95132138360794,6.838559245040066
2019-11-14T09:30:00-05:00,59.76,60.09,59.34,59.62,8116977,13736792.45,51.27339565032865,55.2883509365774,NaN,NaN,16.148873468700856,55.58991143859648,0.015038193486424434,0.4229518937022334,0.40791370021580897,-30788200,-9905658.4,46.44177362187759,60.23535825395925,NaN,NaN,9.818835048214883,7.264312931207897
2019-11-15T09:30:00-05:00,59.87,60.31,59.8,60.08,9183463,13682057.8,54.12451924573562,55.24285678102864,NaN,NaN,38.015251130153445,44.033477815148416,0.0002480747969504371,0.408223793711997,0.4079757189150466,-21604737,-17255494,42.30103074457382,58.83523170121272,NaN,NaN,9.640500140901345,7.603768246878389
2019-11-18T09:30:00-05:00,59.7,59.7673,59.1,59.35,12754805,13794623.6,49.20411243582333,54.73877629368298,NaN,NaN,-27.55689564728152,23.546505197905468,-0.05934142089670863,0.3337989427941608,0.3931403636908694,-34359542,-24260196,38.754615231549195,57.0941707953854,NaN,NaN,8.044962925187773,7.666796058065445
2019-11-19T09:30:00-05:00,59.16,59.21,58.4,58.47,15380355,13508217.1,44.01009117751932,54.476723837496635,NaN,NaN,-93.98526888594155,-7.786810898012552,-0.15332391682809515,0.20148546765575048,0.35480938448384564,-49739897,-31832719.8,35.30832788483214,55.287212770064976,NaN,NaN,5.038203012725058,7.2912827658739605
2019-11-20T09:30:00-05:00,58.45,59.49,58.09,59.06,17147126,13754892.25,47.97529884761525,54.60970022724383,NaN,NaN,-74.83738086599128,-28.443084160071987,-0.16977513923726134,0.14259046043726897,0.3123655996745303,-32592771,-33817029.4,34.44396780569204,53.61778228986231,NaN,NaN,3.6676953373609287,6.773627418943527
2019-11-21T09:30:00-05:00,59.26,60.08,59.065,60.03,15641682,13876698.8,53.77181945373586,54.551254766441794,NaN,NaN,1.0734744887290368,-31.45816395606635,-0.11213119703501351,0.1722016033807634,0.2843328004157769,-16951089,-31049607.2,36.76884147616314,52.293667683044475,NaN,NaN,4.280629699661568,6.417484887617533
2019-11-22T09:30:00-05:00,60.08,60.37,59.71,59.83,11491975,13857548.35,52.47361901237295,53.756179160621286,NaN,NaN,22.04316834913491,-34.65258051227006,-0.08547872880535695,0.17748438940908073,0.2629631182144377,-28443064,-32417272.6,36.08770354090181,50.758694149706415,NaN,NaN,4.38539812388155,6.127186778512392
2019-11-25T09:30:00-05:00,59.76,59.99,59.53,59.89,12338159,13886628.75,52.84145427666458,52.964542564917686,NaN,NaN,4.2160905909773225,-28.29798326461829,-0.06286086657670559,0.1843870349935557,0.24724790157026127,-16104905,-28766345.2,39.319275987497484,49.26346712490659,NaN,NaN,4.575461652373898,5.905511760492607
2019-11-26T09:30:00-05:00,59.97,59.99,59.12,59.34,13403157,13883365.7,49.09073729484152,52.49297084797454,NaN,NaN,-28.272648542339493,-15.155459195897901,-0.08274298523684781,0.14381917002420153,0.22656215526104934,-29508062,-24719978.2,42.77292185187674,47.8524641323138,NaN,NaN,3.6569811392141003,5.584293100309964
2019-11-27T09:30:00-05:00,59.41,59.61,59,59.49,9668274,13591445.1,50.13039110243924,51.808350085974,NaN,NaN,-46.456648356645836,-9.479312694028813,-0.0833600623699223,0.12236207729864645,0.20572213966856875,-19839788,-22169381.6,44.90168128621035,46.242729011194854,NaN,NaN,3.183513724851403,5.241324618101598
2019-11-29T09:30:00-05:00,59,59.21,58.672,58.89,7830226,13231334.3,46.07698026037581,50.946972989598585,NaN,NaN,-107.93594856937004,-31.28119730564863,-0.11954308991581886,0.056293277273795184,0.17583636718961404,-27670014,-24313166.6,43.43906756856114,44.37398431529214,NaN,NaN,1.6068604056083797,4.722115444888281
2019-12-02T09:30:00-05:00,59.09,59.47,58.82,58.89,15390992,13335379.05,46.07698026037581,50.24040337138165,NaN,NaN,-93.64261193322588,-54.41835336212078,-0.13755833088634112,0.0038884535816876564,0.14144678446802877,-27670014,-24158556.6,43.58180152015607,42.68505031291717,NaN,NaN,0.3144903291214881,4.092454714064454
2019-12-03T09:30:00-05:00,58.37,58.47,57.8,58.01,17128314,13115284.15,40.50590911802505,49.277071333887605,NaN,NaN,-182.56095099081313,-91.77376167847888,-0.19908798739774505,-0.10741319977915254,0.09167478761859252,-44798328,-29897241.2,39.58844043079703,41.26200779658699,NaN,NaN,-2.497294029936175,3.1510620363500785
2019-12-04T09:30:00-05:00,58.52,59.06,58.33,58.88,17430420,13109052.15,47.29107013343049,48.91759844780593,NaN,NaN,-98.13992263045527,-105.74721649610203,-0.17253147681304218,-0.1239895583977102,0.048541918415331974,-27367908,-29469210.4,40.02982391161246,40.26709091873579,NaN,NaN,-2.97606470720283,2.2757582158425205
2019-12-05T09:30:00-05:00,59.13,59.2,58.4,58.6,10894161,12762365.45,45.492809862245565,48.50469946294286,NaN,NaN,-90.68363954556303,-114.59261473388547,-0.16515347862767307,-0.15789992986925938,0.0072535487584136984,-38262069,-33153666.6,37.49059737073674,39.62772118651145,NaN,NaN,-3.9043472762599696,1.392886002685022
2019-12-06T09:30:00-05:00,58.85,59.8952,58.84,59.72,16729654,12936762.6,53.164533246800005,48.436129034447454,NaN,NaN,5.3991507187319305,-91.92559487626508,-0.08046181979148088,-0.09332372598093741,-0.012861906189456523,-21532415,-31926146.8,38.88160496692906,39.38347648810825,NaN,NaN,-2.3160866154640134,0.8630327715208742
2019-12-09T09:30:00-05:00,59.26,59.93,59.26,59.65,8839059,12859223.15,52.66561316337687,48.68337908641557,NaN,NaN,30.26053574556436,-67.14496534050701,-0.027510764156346804,-0.04725036138489003,-0.019739597228543224,-30371474,-32466438.8,38.47576378209876,39.36355852743321,NaN,NaN,-1.1969768475590203,0.5687456830808892
2019-12-10T09:30:00-05:00,59.85,59.99,59.51,59.77,8786138,12574506.4,53.471722306641496,49.35920988135286,NaN,NaN,56.99157480276152,-19.23446018179209,0.014958173197891066,-0.0010418807311793898,-0.016000053929070456,-21585336,-27823840.4,43.894916730914616,39.97688630215339,NaN,NaN,-0.04834303209269817,0.48059015234180535
2019-12-11T09:30:00-05:00,59.68,60.08,59.55,59.67,12436340,12569261.1,52.666793615423806,49.694316650482044,NaN,NaN,64.09506922913504,13.212538190125969,0.03455685127100408,0.027196010159684647,-0.0073608411113194345,-34021676,-29154594,42.73301361973909,40.56896100315675,NaN,NaN,0.6829743119696565,0.5095021751457841
2019-12-12T09:30:00-05:00,59.76,60.975,59.69,60.77,22492370,13154182.35,59.830069585592724,50.127048802757535,NaN,NaN,158.5232692708116,63.05391995340089,0.11529593333441276,0.13675907555669653,0.02146314222228376,-11529306,-23808041.4,48.61778243678323,41.41531392891533,NaN,NaN,3.5487956594136514,0.9436869586126223
2019-12-13T09:30:00-05:00,60.98,61.37,60.27,60.31,11372454,13316956.2,56.01255280839972,50.379829788188026,NaN,NaN,161.76518737163855,94.32712728398221,0.13030582172610589,0.1843454193799161,0.05403959765381023,-22901760,-24081910.4,48.343739236144415,42.29074505000409,NaN,NaN,4.838827100803519,1.500135550354179
2019-12-16T09:30:00-05:00,60.74,61.36,60.71,61.12,11136816,13414623.85,60.76041127150301,50.94546957353362,NaN,NaN,192.7357284959862,126.82216583406657,0.18408252148086757,0.2841427495048947,0.10006022802402713,-11764944,-20360604.4,52.27981286578063,43.216497684167166,NaN,NaN,7.468527911899548,2.3527630305749456
2019-12-17T09:30:00-05:00,61.38,61.71,60.93,61.16,23154716,13934619.4,60.98436963702092,51.79501474083215,NaN,NaN,178.39772310987337,151.10339549548894,0.20977928165500553,0.36228433009278405,0.1525050484377785,11389772,-13765582.8,58.33852614464939,44.32832656222236,NaN,NaN,9.638882666285479,3.3936372642478787
2019-12-18T09:30:00-05:00,61.09,61.775,61.01,61.39,12942045,13812703.9,62.31620340323367,52.66542990517462,NaN,NaN,166.05372210871653,171.49512607140525,0.22817623977710705,0.4377253481591623,0.20954910838205526,24331817,-2094884.2,66.45505987719346,45.86785360443543,NaN,NaN,11.83498421546426,4.599543971564504
2019-12-19T09:30:00-05:00,61.4,61.5699,61.26,61.37,12770101,13593852.65,62.11763363023677,53.811190860164686,NaN,NaN,141.6590247777264,168.1222771727882,0.22455894868918524,0.4902477942435368,0.26568884555435157,11561716,2523320.2,69.02655913278295,47.69553157330842,NaN,NaN,13.583474673428464,5.882962643259355
2019-12-20T09:30:00-05:00,60.96,61.425,60.85,61.36,17420045,13682770.8,62.01123471027398,54.94935189230027,NaN,NaN,106.53876744948049,157.0769931883566,0.2074595384299352,0.5250132685917706,0.31755373016183536,-5858329,5932006.4,70.8054902183809,49.640080766038764,NaN,NaN,15.010741653183167,7.186931073248472
2019-12-23T09:30:00-05:00,61.29,62.03,61.215,61.99,13474589,13781901.5,65.9663249541963,56.76795302345538,NaN,NaN,126.45002284624599,143.81985205840857,0.2231766389978459,0.5965245289091428,0.37334788991129686,7616260,9808247.2,72.72397830491718,52.0069048999045,NaN,NaN,17.415444155742666,8.6481472278905
2019-12-24T09:30:00-05:00,62.13,62.22,61.845,61.96,5037439,13416865.5,65.6159957589357,58.07687628242003,NaN,NaN,123.88957938580715,132.91822331359532,0.21601025358378123,0.6433607068910234,0.4273504533072422,2578821,8046057,70.45719510123928,54.180288556306415,NaN,NaN,19.32456509943777,10.17334978096868
2019-12-26T09:30:00-05:00,62.23,62.44,61.86,61.94,10157406,13254577.95,65.36676338878738,59.49644439145873,NaN,NaN,112.69731989935427,122.24694287172285,0.19502246182418537,0.6711285305874739,0.47610606876328854,-7578585,1663976.6,62.820147745651155,55.98954215451459,NaN,NaN,20.868001509385856,11.701157170742562
2019-12-27T09:30:00-05:00,62.17,62.23,61.64,61.68,10718840,13307106.25,62.06627332976139,60.13228296881312,NaN,NaN,88.9968008895103,111.71449809407963,0.15071116010134167,0.6644950188899656,0.513783858788624,-18297425,-4307851.6,56.634169511121634,57.25758247909977,NaN,NaN,21.385307025254768,13.084607149958591
2019-12-30T09:30:00-05:00,60.12,60.23,59.61,59.7,14632973,13647243.6,43.891222015111516,59.505540743937026,NaN,NaN,-35.59537223800502,83.28767015658254,-0.016005877143711933,0.4937765123589841,0.509782389502696,-32930398,-9722265.4,51.666556315646794,58.199781945781766,NaN,NaN,15.89131505351232,13.485565421894838
2019-12-31T09:30:00-05:00,59.4,60.1,59.23,60.04,10729021,13414145.05,46.773565671632525,59.02710098429352,NaN,NaN,-43.08415323434842,49.38083494046366,-0.10261141475305047,0.38151812106138294,0.4841295358144334,-22201377,-15685792.8,46.79766705046959,58.40712125432141,NaN,NaN,12.33371628247313,13.321015544834594
2020-01-02T09:30:00-05:00,60.44,60.67,60.23,60.58,11946968,13155077.75,51.07256087890052,58.913227217399005,NaN,NaN,-5.646514870375698,23.4736160892271,-0.12146720608411199,0.3322955282092934,0.4537627342934054,-10254409,-18252438.8,44.83915935987729,58.55756023575986,NaN,NaN,10.709685939715518,12.947968458389012
2020-01-03T09:30:00-05:00,61.13,61.31,60.1,60.4,29515623,13759337.9,49.63350402364258,58.18490110583114,NaN,NaN,-4.824093425408453,-0.030666575725445712,-0.14254218685512648,0.2755850007244973,0.4181271875796238,-39770032,-24690728.2,40.284760442844565,57.96234437904996,NaN,NaN,8.953187067789534,12.377285402589086
2020-01-06T09:30:00-05:00,60.61,61.18,60.4,60.87,22460711,14337665.4,53.33116676590268,57.99337353136706,NaN,NaN,4.723068143720535,-16.885413124883396,-0.12209696329884057,0.2655059834560731,0.3876029467549137,-17309321,-24493107.4,40.484585483758586,57.40097625387954,NaN,NaN,8.598927537882245,11.837519993345252
2020-01-07T09:30:00-05:00,60.7,60.77,60,60.71,11493394,14075852.4,51.933386167438265,57.362871738219575,NaN,NaN,-32.27141104662012,-16.220620886606422,-0.11662629698127197,0.24182007552832374,0.3584463725095957,-28802715,-23667570.8,41.367245375554724,56.62150714743483,NaN,NaN,7.893606939007834,11.274103842725621
2020-01-08T09:30:00-05:00,60.65,60.72,59.63,59.71,19038083,14585803.6,44.14566052875223,56.160106801914665,NaN,NaN,-83.91465265522675,-24.386720770782098,-0.17416919708871198,0.14073487614870572,0.3149040732374177,-47840798,-28795455,37.6336532716192,55.1425876565041,NaN,NaN,4.728967284882244,10.339084334462282
2020-01-09T09:30:00-05:00,59.68,60.205,58.98,60.15,15367597,14914876.55,47.851154098123935,55.12688899440683,NaN,NaN,-109.0243055457263,-45.06227890585222,-0.17589688321852137,0.09503296921426596,0.27092985243278733,-32473201,-33239213.4,34.71002528699427,52.875085185775596,NaN,NaN,3.266241422277943,9.328678204150233
2020-01-10T09:30:00-05:00,60.12,60.17,59.74,59.81,9151352,14750627.15,45.34761423408438,53.929030466110234,NaN,NaN,-97.48503576925837,-63.594467374622205,-0.19192697958639054,0.031021127949799165,0.2229481075361897,-41624553,-33610117.6,34.46932615735203,50.406711401816246,NaN,NaN,1.275735321851636,8.17825779239329
2020-01-13T09:30:00-05:00,59.72,60.015,59.41,59.83,8779691,14064993.2,45.52815278792687,52.751667471656866,NaN,NaN,-104.36223299316674,-85.41152760199967,-0.19266942608399468,-0.01788867506880365,0.17478075101519103,-32844862,-36717225.8,32.439877341493315,47.666310482038554,NaN,NaN,-0.26301742740617434,6.972361332421939
2020-01-14T09:30:00-05:00,59.7,59.91,59.31,59.84,17339872,14363364.1,45.62487268122641,51.298706595016164,NaN,NaN,-98.96296910878516,-98.74983921443267,-0.1839899935847764,-0.05520674096577949,0.12878325261899692,-15504990,-34057680.8,35.917788237669285,45.03729690580656,NaN,NaN,-1.4895005435899122,5.763523921563103
2020-01-15T09:30:00-05:00,59.58,59.76,59.225,59.4,10830804,14348063.5,42.084092000933914,49.617856326587464,NaN,NaN,-106.19062175961362,-103.20503303531004,-0.1981586983613985,-0.1189151203327512,0.07924357802864729,-26335794,-29756680,41.19037010505292,42.94680940607896,NaN,NaN,-3.576515592085446,4.429232562470453
2020-01-16T09:30:00-05:00,59.75,59.95,59.465,59.5,8224487,13601552.05,43.16367334219574,48.03192132325949,NaN,NaN,-82.9447182282255,-97.98911557180989,-0.19099224380498342,-0.15949672672758197,0.03149551707740143,-18111307,-26884301.2,44.47603439893899,41.63651559559952,NaN,NaN,-5.022581633153928,3.0789733916669704
2020-01-17T09:30:00-05:00,59.66,59.69,59.015,59.12,11909116,13549905.6,40.104403133567565,46.463216309245645,NaN,NaN,-104.44547837080738,-99.38120409211967,-0.2010261707742803,-0.21978719639044897,-0.01876102561616865,-30020423,-24563475.2,47.05013293665576,40.95194155456625,NaN,NaN,-7.149274053141072,1.6177951852658214
2020-01-21T09:30:00-05:00,58.79,58.8,57.96,58.06,17354555,13779128.3,33.064477699676345,45.6898774295717,NaN,NaN,-166.25368493858915,-111.75949448120416,-0.2642528007145327,-0.3490770265093346,-0.08482422579480184,-47374978,-27469498.4,44.28184309259254,40.4244620386338,NaN,NaN,-11.409883538587946,-0.24330177528471664
2020-01-22T09:30:00-05:00,57.95,57.9887,57.34,57.5,14677719,13642012,30.062119883848283,44.49620273044426,NaN,NaN,-192.09370862642075,-130.38564238473128,-0.3249940244500429,-0.4910667563573554,-0.16607273190731256,-62052697,-36779039.8,36.80996177623314,39.711054519045476,NaN,NaN,-16.03438134389126,-2.499170285085651
2020-01-23T09:30:00-05:00,56.9,57.455,56.46,57.28,13278012,13632183.15,28.94995787411156,42.916016801530766,NaN,NaN,-211.99242363540853,-151.54600275989026,-0.3585545555891547,-0.614265926393756,-0.25571137080460127,-75330709,-46578022.8,30.89982312321223,38.715387644997975,NaN,NaN,-20.15456879075712,-5.021370071610146
2020-01-24T09:30:00-05:00,57.02,57.2789,56.18,56.62,20390559,14399839.15,25.859171441869833,41.217850188547,NaN,NaN,-206.22819359839778,-176.20269783392473,-0.4005820104073591,-0.7564388838138001,-0.355856873406441,-95721268,-62100015,24.256185349177883,37.57048942402178,NaN,NaN,-24.754579308375536,-7.8403999625766305
2020-01-27T09:30:00-05:00,55.48,55.7,54.98,55.05,21682539,14976095.8,20.305550546815795,38.858877601469366,NaN,NaN,-231.4073730529236,-201.59507677034796,-0.5028742869703511,-0.9844497321193799,-0.48157544514902884,-117403807,-79576691.8,19.240205932500047,36.05303374178903,NaN,NaN,-31.19413393450318,-11.176647672851852
2020-01-28T09:30:00-05:00,55.36,55.64,55.08,55.3,14300069,15155157.25,23.136340980468844,36.80194580240012,NaN,NaN,-177.43146820800894,-203.83063342423193,-0.5202827557427876,-1.1319288898275133,-0.6116461340847257,-103103738,-90722443.8,16.847429633144074,34.30161833161684,NaN,NaN,-35.225407145600016,-14.612184740387303
2020-01-29T09:30:00-05:00,55.61,55.81,54.65,54.72,13748945,15110955.85,21.25043460270456,35.16657252196815,NaN,NaN,-154.0803765447863,-196.22796700790505,-0.5353579488915019,-1.280843570199103,-0.7454856213076011,-116852683,-101682441,14.88686412539073,32.67684767831481,NaN,NaN,-39.18826521446514,-18.12305337954128
2020-01-30T09:30:00-05:00,54.15,55.215,54.01,55.16,24430549,15796032.25,26.16724958540695,33.61772219963122,NaN,NaN,-137.82356013230228,-181.3941943072838,-0.48186621739557167,-1.3478183930520657,-0.8659521756564941,-92422134,-105100726,14.326872400896164,31.220908186450654,NaN,NaN,-40.778655078470244,-21.3595679079597
2020-01-31T09:30:00-05:00,54.23,54.38,53.16,53.44,33498974,16873632.55,20.720907396026902,31.858671711198546,NaN,NaN,-151.4471363631665,-170.43798286023753,-0.5249500741155613,-1.5221397683009457,-0.9971896941853844,-125921108,-111140694,13.369862610221531,29.7138036473699,NaN,NaN,-44.27466640765206,-24.633153407915753
2020-02-03T09:30:00-05:00,53.37,53.45,52.55,52.74,21300887,16462895.75,18.988712907793413,29.96299743404615,NaN,NaN,-150.1109377058026,-154.17869579081332,-0.5600166270878639,-1.6972104780452142,-1.1371938509573503,-147221995,-117104331.6,12.483211796786563,28.2883275370337,NaN,NaN,-47.6921953458811,-27.927302256196516
2020-02-04T09:30:00-05:00,53.5,53.92,52.83,52.93,19819836,16330852,20.92107662668684,28.198440573007616,NaN,NaN,-123.19374656974169,-143.33115146315987,-0.5301457307699895,-1.7998760144198371,-1.2697302836498476,-127402159,-121964015.8,11.796670585621442,26.56539056188743,NaN,NaN,-49.649529619036386,-31.03047759374507
2020-02-05T09:30:00-05:00,53.81,55.11,53.78,54.92,34381974,17475281,37.686351601673415,27.88431625877472,NaN,NaN,-74.30419151696918,-127.37591445759645,-0.3450590767991073,-1.7010541296487318,-1.3559950528496245,-93020185,-117197516.2,16.639264023895947,24.811740127519073,NaN,NaN,-45.014677099309935,-33.02822038025433
2020-02-06T09:30:00-05:00,55.18,55.18,54.27,54.36,15400630,17293408.35,35.41120063734796,27.330568208428446,NaN,NaN,-66.98153141224641,-113.2075087135853,-0.23433732450333533,-1.6489167084787937,-1.4145793839754583,-108420815,-120397252.4,16.004046976073298,22.778026740171523,NaN,NaN,-42.24364876312581,-34.34471014923597
2020-02-07T09:30:00-05:00,53.95,54.21,53.7001,53.98,13693685,17209712.75,33.9149724079149,26.888466013738967,NaN,NaN,-78.11751322450276,-98.54158408585255,-0.16400898745304104,-1.6195906182917597,-1.4555816308387186,-122114500,-119635930.8,16.817734091209232,20.61856967978248,NaN,NaN,-40.60054450100119,-35.23840077091672
2020-02-10T09:30:00-05:00,53.7,53.83,53.38,53.71,14640594,17484174.85,32.85280138001457,26.873346276620264,NaN,NaN,-80.42819066736443,-84.60503467816491,-0.11529143549040843,-1.599695925201729,-1.4844044897113207,-136755094,-117542550.6,19.13732721638776,18.822532831482135,NaN,NaN,-39.65220311829846,-35.86894396339982
2020-02-11T09:30:00-05:00,54.44,54.52,54.065,54.31,13844593,17737419.95,37.53461954453839,27.407096252383845,NaN,NaN,-54.910173173823694,-70.9483199989813,-0.02688881950214972,-1.518015514089008,-1.4911266945868582,-122910501,-116644219,20.1661519059287,17.633689269317532,NaN,NaN,-37.343791246457464,-36.07963643240806
2020-02-12T09:30:00-05:00,55.12,55.35,54.59,55.04,17199814,17730417.05,42.76358045432358,28.39378357954184,NaN,NaN,-26.84488612290054,-61.45645892016758,0.0901109959364117,-1.3784879496663436,-1.4685989456027553,-105710687,-119182319.4,19.41456741788157,16.81331386179392,NaN,NaN,-33.691417536500786,-35.738462304421304
2020-02-13T09:30:00-05:00,54.89,55.1801,54.55,54.87,11974888,17787621.25,41.88427899455815,29.53843411901958,NaN,NaN,-26.509230247632622,-53.36199868724482,0.16126037968906393,-1.2670234709914254,-1.4282838506804894,-117685575,-121035271.4,18.861879717376,16.42800631666521,NaN,NaN,-31.044631289571452,-35.06791501658561
2020-02-14T09:30:00-05:00,55.06,55.1,54.24,54.58,12520109,18002402.35,40.35971525078672,30.97087445501751,NaN,NaN,-31.0742146049772,-43.953338963339704,0.1919161681833168,-1.1883886404513433,-1.38030480863466,-130205684,-122653508.2,18.370038704482766,16.365851514663976,NaN,NaN,-29.315015796867932,-34.246072270911654
2020-02-18T09:30:00-05:00,54.1,54.5707,53.625,54.13,16314908,18222691.95,38.04553371682139,32.03581679332841,NaN,NaN,-55.639818800316,-38.995664589930016,0.18493608659298788,-1.1491347003934251,-1.334070786986413,-146520592,-124606607.8,17.767837869805277,16.43159496013978,NaN,NaN,-28.528555171594643,-33.429284113866366
2020-02-19T09:30:00-05:00,54.49,55.07,54.1922,54.85,12455425,17977735.45,43.61621396020688,33.63337246172143,NaN,NaN,-7.665620453348423,-29.546754045834962,0.22897763808920546,-1.0478487393749063,-1.2768263774641118,-134065167,-126837541,17.07911652589138,16.5881844173184,NaN,NaN,-26.156100912989515,-32.39025794231253
2020-02-20T09:30:00-05:00,54.99,55.4,54.65,54.79,13050826,17896390.8,43.26707637945669,34.85478866129641,NaN,NaN,26.426004656344453,-18.892575889985967,0.2523901657137404,-0.9613386703219362,-1.2137288360356766,-147115993,-135118602.2,14.787747230715283,16.621104048019763,NaN,NaN,-24.335657738304818,-31.23960077031143
2020-02-21T09:30:00-05:00,54.27,54.32,53.69,54.14,13808205,17922900.45,39.57153304736176,36.20126192210604,NaN,NaN,-49.628410659301935,-23.516411972319826,0.22341782754729622,-0.9344565516015564,-1.1578743791488526,-160924198,-143766326.8,12.849083914863684,16.583905569779915,NaN,NaN,-23.81188313408302,-30.17849825085023
2020-02-24T09:30:00-05:00,52.1,52.4,51.48,51.64,33037501,18555247.55,29.23042256953744,36.93281261223061,NaN,NaN,-238.82967523056882,-65.06750409743816,0.04455855572333167,-1.102176184494688,-1.1467347402180197,-193961699,-156517529.8,10.635093741139755,16.451897137233715,NaN,NaN,-26.96168186503301,-29.71895305287634
2020-02-25T09:30:00-05:00,51.78,51.82,49.04,49.36,42837329,19612987.05,23.2603449794708,37.099903208858045,NaN,NaN,-298.79760720024245,-113.69906177742344,-0.20493251566664616,-1.4029003848013275,-1.1979678691346813,-236799028,-174573217,8.422135197210636,16.210858895204375,NaN,NaN,-32.199911170227175,-30.073375641069315
2020-02-26T09:30:00-05:00,49.54,49.78,47.85,47.87,48828313,21339399.25,20.33707176251592,35.8606689346325,NaN,NaN,-290.6883694586917,-170.30361157849208,-0.43473245935980276,-1.7413834433344348,-1.306650983974632,-285627341,-204885651.8,6.119830372998862,15.459470777283153,NaN,NaN,-37.60907015954674,-31.149903429423233
2020-02-27T09:30:00-05:00,46.63,47.525,45.29,45.31,61278725,23715888.25,16.50017447941684,34.50988135192314,NaN,NaN,-285.86357095032264,-232.76152669982548,-0.7074379499910171,-2.1909484214634034,-1.4835104714723863,-346906066,-244843666.4,4.408882147746212,14.631244718116934,NaN,NaN,-43.86862209491048,-32.96686323877855
2020-02-28T09:30:00-05:00,43.88,45.84,43.515,45.27,68764415,25932581.55,16.447957896633568,33.26223745826018,NaN,NaN,-234.67704909274806,-269.7712543865147,-0.8303072267725546,-2.5213945049380797,-1.691087278165525,-415670481,-295792923,3.1858427395791438,13.6575381930005,NaN,NaN,-48.31647249524349,-35.15966456113068
2020-03-02T09:30:00-05:00,46.28,47.16,44.93,47.1,36642667,26089766.2,27.718007053062124,32.89546643490644,NaN,NaN,-150.36174484296646,-252.07766830899428,-0.7315895875394864,-2.605574262589883,-1.8739846750503966,-379027814,-332806146,2.6177235310081244,12.477566501187669,NaN,NaN,-47.668026357310296,-36.94657338915634
2020-03-03T09:30:00-05:00,47.37,47.99,45.15,45.66,48595314,27454487.55,24.87470636672667,31.9911869222056,NaN,NaN,-127.1417954626934,-217.74650596148444,-0.7061768240005604,-2.756705705051097,-2.0505288810505364,-427623128,-370970966,2.1850440219714926,11.193201652333581,NaN,NaN,-48.22430464212646,-38.55767785386636
2020-03-04T09:30:00-05:00,46.64,46.75,45.67,46.74,24484539,27687722.7,30.62279596517024,31.12398803012322,NaN,NaN,-106.20499801478687,-180.8498316727035,-0.5656122828053034,-2.757544234557166,-2.1919319517518625,-403138589,-394473215.6,1.9691895847821428,9.947103235683622,NaN,NaN,-46.537790942852055,-39.69769400943574
2020-03-05T09:30:00-05:00,45.4,45.61,44.275,45.03,29387322,27437990.1,27.08866969309146,30.067158794304166,NaN,NaN,-114.99891577168586,-146.67690063697614,-0.5370036010042205,-2.8631864530071383,-2.3261828520029177,-432525911,-411597184.6,1.8275302960764037,8.73036399130508,NaN,NaN,-46.451493464721075,-40.66252250304793
2020-03-06T09:30:00-05:00,43.5,43.89,41.86,42.5,61517408,29743829,22.881166311274796,28.818691012910456,NaN,NaN,-133.5000945584683,-126.44150973012017,-0.6311729417987388,-3.1151490292513415,-2.4839760874526027,-494043319,-427271752.2,1.7065141703212134,7.540112238864968,NaN,NaN,-48.00453756751054,-41.711381797971164
2020-03-09T09:30:00-04:00,35.07,36.43,33.73,33.94,66556947,32386992.1,14.61172446990011,27.144847495273222,NaN,NaN,-216.77844500051654,-139.7248497616302,-1.1807425981116983,-3.959904335092226,-2.7791617369805275,-560600266,-463586242.6,1.464549583867452,6.375591647012267,NaN,NaN,-53.733286718135844,-43.42879678656612
2020-03-10T09:30:00-04:00,36.67,36.82,33.36,35.55,48431137,34076519.25,20.436119099296462,25.489126433779624,NaN,NaN,-175.6602250234397,-149.42853567377944,-1.3352222078702702,-4.448189496818365,-3.112967288948095,-512169129,-480495442.8,1.3673322384854174,5.253321340768983,NaN,NaN,-55.00856341587569,-45.08304916218177
2020-03-11T09:30:00-04:00,34.45,35.05,33.13,33.67,43492869,35558933.05,18.821659714455308,23.74302524342238,NaN,NaN,-165.13817783016344,-161.21517163685476,-1.4536493594299231,-4.930028988235499,-3.4763796288055757,-555661998,-511000124.6,1.2111391420044413,4.283563620146781,NaN,NaN,-56.61736283637497,-46.73080825849509
2020-03-12T09:30:00-04:00,31.19,32,29.38,29.47,38829069,36640395.8,15.815641339218203,22.046175835697845,NaN,NaN,-181.74123227685726,-174.56363493788905,-1.6880152007901406,-5.586398629793251,-3.8983834290031107,-594491067,-543393155.8,1.0712031599818488,3.442286423369506,NaN,NaN,-59.20988737959435,-48.513533847223556
2020-03-13T09:30:00-04:00,31.96,32.22,28.8,32.19,34098421,37746572.45,24.252946456497355,21.69064182762355,NaN,NaN,-147.0308685364209,-177.26978973347957,-1.5372977604251794,-5.820005629534585,-4.282707869109405,-560392646,-556663021.2,1.0192495761545075,2.7554404115848454,NaN,NaN,-57.647624541939166,-49.81840394646864
2020-03-16T09:30:00-04:00,27.95,31.115,27.67,27.81,40233594,39132246.7,20.66181920955968,21.50503284405847,NaN,NaN,-141.8311398743957,-162.28032870825538,-1.6027200371965051,-6.286107915605037,-4.683387878408531,-600626240,-564668216,0.9881151202033465,2.224438977512896,NaN,NaN,-57.90130250877154,-50.97310374108334
2020-03-17T09:30:00-04:00,28.08,29.18,26.95,28,45443564,40588679.5,21.2068473644824,21.567159672770362,NaN,NaN,-127.32542228363205,-152.61336816029387,-1.5048853106847329,-6.564494516764448,-5.059609206079715,-555182676,-573270925.4,0.9543764105107329,1.8554779801923154,NaN,NaN,-57.87475754481674,-51.95905428447383
2020-03-18T09:30:00-04:00,26.04,26.58,22.88,23.98,52135809,42572698.7,18.336638175502657,21.698335651062205,NaN,NaN,-134.41952462368823,-146.46963751899884,-1.5750953419991376,-7.028478383578637,-5.4533830415794995,-607318485,-583602222.8,0.9140139135424761,1.605844534892048,NaN,NaN,-58.9554109617976,-52.95853380980579
2020-03-19T09:30:00-04:00,24.33,25.71,22.9801,25.61,52226458,44531480.3,22.893587231711663,22.158737746424926,NaN,NaN,-115.99716462009972,-133.32082398764734,-1.3827922846297103,-7.181873397366637,-5.799081112736927,-555092027,-575722414.8,4.240499578856131,1.6811771662689747,NaN,NaN,-58.118058793588425,-53.69560880748902
2020-03-20T09:30:00-04:00,26.26,26.835,24.76,25.86,58357226,46758931.35,23.597777467582972,21.864435633176416,NaN,NaN,-97.12572321828745,-123.33979492402065,-1.1209486657715377,-7.200266944951348,-6.079318279179811,-496734801,-562990845.8,9.525563948263724,2.1745943389300892,NaN,NaN,-57.249865923176976,-54.20335982401588
2020-03-23T09:30:00-04:00,25.13,25.29,23.15,23.57,48260209,47520066.75,21.64753706622251,21.633923540283263,NaN,NaN,-101.67397039064193,-115.3083610272699,-0.9887866427163505,-7.315301582575248,-6.326514939858898,-544995010,-551864599.8,13.99295381957603,3.018016467330413,NaN,NaN,-57.17803276592123,-54.628313101430926
2020-03-24T09:30:00-04:00,25.4,27.49,25.4,27.35,44511075,47603754.05,31.683995838512544,21.709723531236286,NaN,NaN,-74.19023616244546,-104.68132380303257,-0.5552078190534742,-7.020524713675741,-6.4653168946222666,-500483935,-540924851.6,18.26634119291272,4.182098725054025,NaN,NaN,-53.63611154457353,-54.48657002187987
2020-03-25T09:30:00-04:00,27.95,30,26.74,28.64,52434902,47784083.5,34.75552192044307,22.257355833189973,NaN,NaN,-55.30959907130136,-88.85933869255518,-0.11307625455430248,-6.606662212815145,-6.493585958260843,-448049033,-509070961.2,29.284141284793975,6.143285224248136,NaN,NaN,-49.80539324242874,-53.81783048195828
2020-03-26T09:30:00-04:00,28.93,31,28.57,30.39,46918069,47066050.7,38.776945032492144,23.392768598991214,NaN,NaN,-37.08203443104638,-73.07631265474453,0.34085258402134144,-6.067520228234166,-6.408372812255507,-401130964,-478278748.6,37.986610852070555,8.734720701515947,NaN,NaN,-45.364294475237855,-52.61018248099822
2020-03-27T09:30:00-04:00,29.12,29.21,28.16,28.33,36528419,45454250.9,35.96666238641846,24.91812130731395,NaN,NaN,-45.69315034047367,-62.78979807918178,0.5344578545052912,-5.740300494123893,-6.2747583486291845,-437659383,-466463665,40.98750223487569,11.557788748016534,NaN,NaN,-42.56311906759433,-51.174887707654804
2020-03-30T09:30:00-04:00,27.95,28.87,27.09,28.62,42127400,45728487.55,36.66257114249916,26.07715359611414,NaN,NaN,-45.000543035126675,-51.45511260807872,0.7035016200300364,-5.395381323591639,-6.098882943621676,-395531983,-436571059.6,47.861858132035124,14.878826311841513,NaN,NaN,-40.13247144894359,-49.597399670696056
2020-03-31T09:30:00-04:00,29.42,30,28.48,29.06,34350607,45016252.2,37.76767113811835,27.43044012637579,NaN,NaN,-28.541208361401075,-42.32530704786984,0.8562583836382434,-5.028559964073871,-5.884818347712114,-361181376,-408710547.8,53.319820503819116,18.60087498054256,NaN,NaN,-37.83609015847257,-47.91721259752127
2020-04-01T09:30:00-04:00,28.12,28.48,27.2303,27.62,23826458,44983348.15,35.579717372073404,28.8421598430083,NaN,NaN,-43.24472923918565,-39.91233308144669,0.8688702139731177,-4.798730580245717,-5.667600794218835,-385007834,-396102308,55.5857548709432,22.494771531325515,NaN,NaN,-36.498760968586126,-46.28600522195911
2020-04-02T09:30:00-04:00,29.01,31.76,28.26,30.15,73128147,47170389.4,41.94344930218144,30.105767189128592,NaN,NaN,8.848727922460684,-30.726180610745274,1.0443565765886946,-4.362155073482967,-5.4065116500716615,-311879687,-378252052.6,58.646333146646484,26.61099178636066,NaN,NaN,-33.422611860085084,-44.44837759883425
2020-04-03T09:30:00-04:00,31.1,31.31,28.975,29.83,63834325,47286235.25,41.38656778608164,31.58610637316588,NaN,NaN,29.24979103935157,-15.737592334780231,1.128469613757992,-3.9959246328741713,-5.124394246632163,-375714012,-365862978.4,60.67197404486536,30.87412456669366,NaN,NaN,-31.070386587433095,-42.53723602577694
2020-04-06T09:30:00-04:00,30.5,31.62,30.09,31.41,38020723,45859424.05,45.25167287065531,33.30359390932109,NaN,NaN,68.80291026895428,7.023098326035958,1.2695838270722977,-3.5374144627917907,-4.806998289864088,-337693289,-354295239.6,62.51811217306935,35.27153426401927,NaN,NaN,-27.931087217027944,-40.450643338812796
2020-04-07T09:30:00-04:00,32.96,33.87,32.02,32.08,51509497,46013342.05,46.8521599463695,35.34041689295443,NaN,NaN,131.02974861206062,38.937289720728295,1.3780601206295113,-3.084423139077199,-4.46248325970671,-286183792,-339295722.8,64.82391927133645,39.83652750386171,NaN,NaN,-24.85631763946786,-38.222882524620665
2020-04-08T09:30:00-04:00,32.76,34.33,32.49,34.22,41905812,45933989.2,51.70816042797333,37.39860069268741,NaN,NaN,166.47395183184642,80.88102593493471,1.5510641798718652,-2.5236530348668786,-4.074717214738744,-244277980,-311149752,68.7133355453002,44.441730072893435,NaN,NaN,-20.719937932384976,-35.722461868587
2020-04-09T09:30:00-04:00,35.54,36.46,32.6245,33.91,91381541,48561612.8,50.981488774340704,39.35458007174153,NaN,NaN,164.59661080054497,112.03060251055157,1.5955553685067314,-2.0802730041053294,-3.675828372612061,-335659521,-315905718.8,67.35804099969968,48.57262129085314,NaN,NaN,-17.500802382016587,-33.119367656219794
2020-04-13T09:30:00-04:00,35.09,35.22,33.26,33.8,33842840,48548833.75,50.70916767681892,41.43041082964128,NaN,NaN,142.1066506195154,134.60197442658432,1.5662918172574605,-1.7179636010402355,-3.284255418297696,-369502361,-314663388.6,67.53815553580641,52.39727855629817,NaN,NaN,-14.897831755767388,-30.516291099012307
2020-04-14T09:30:00-04:00,33.97,34.38,33.42,33.64,36324070,48353357.55,50.2883940391717,42.75929641540265,NaN,NaN,115.54940551564067,143.9512734759216,1.4855734885571046,-1.4272885576013152,-2.91286204615842,-405826431,-328290017,63.40544348182213,55.621500148363126,NaN,NaN,-12.809257442350653,-27.986714862346357
2020-04-15T09:30:00-04:00,32.3,32.38,31.06,32.06,36710536,47916706.15,46.21059871682952,43.577516186573106,NaN,NaN,58.70597081244207,129.48651791599792,1.2828286852641666,-1.3093261895782113,-2.592154874842378,-442536967,-359560652,55.076577616245835,57.46381702918112,NaN,NaN,-11.992017154068968,-25.701758046878158
2020-04-16T09:30:00-04:00,31.98,32.08,30.645,30.69,32302898,46925060.6,42.95786501623359,43.87615332826892,NaN,NaN,35.779269012417295,103.34758135211207,1.0247061526892076,-1.3112721839808685,-2.335978336670076,-474839865,-405673029,45.570368625427164,58.0055140129923,NaN,NaN,-12.146939730473312,-23.765355430248896
2020-04-17T09:30:00-04:00,31.33,33.99,31.31,33.95,45853438,46606409.6,51.674774213406835,44.998161315910956,NaN,NaN,80.59035810392625,86.54633081278834,1.038545412807078,-1.0377965706612287,-2.0763419834683066,-428986427,-424338410.2,42.381608267200775,58.105093015301236,NaN,NaN,-9.729649007200617,-21.76025451267057
2020-04-20T09:30:00-04:00,31.95,34.1,31.78,32.89,56394974,46508297,49.05007595649087,45.882983088338925,NaN,NaN,68.53912591593766,71.83282587207279,0.9440602161614347,-0.8962667132665132,-1.8403269294279478,-485381401,-447514218.2,38.755388360372194,57.45463088875389,NaN,NaN,-8.459196894110866,-19.8601034243049
2020-04-21T09:30:00-04:00,31.94,32.895,31.39,32.31,60430757,47116824.4,47.624666759441354,46.58705420414772,NaN,NaN,40.479018823891856,56.81874853372303,0.8151131931835343,-0.82143543794853,-1.6365486311320643,-545812158,-475511363.6,34.87355829743281,56.13704073115486,NaN,NaN,-7.80871057884094,-18.138475874952906
2020-04-22T09:30:00-04:00,33.77,33.99,33.01,33.46,36899844,46736262.85,50.684765931250084,47.66598624408891,NaN,NaN,76.46170312442818,60.36989499612027,0.7798725316732991,-0.6617079665404404,-1.4415804982137395,-508912314,-488786433,33.17670087000083,54.53639401680184,NaN,NaN,-6.384468131622705,-16.45933191162002
2020-04-23T09:30:00-04:00,34.48,35.345,34.14,34.54,41603647,46194700.1,53.436251477130114,48.48690068515668,NaN,NaN,107.93122636554806,74.80028646674643,0.7989678521269814,-0.44287068305501265,-1.241838535181994,-467308667,-487280193.4,33.571653018951054,52.74534543625217,NaN,NaN,-4.3834807402491105,-14.73421031570989
2020-04-24T09:30:00-04:00,35.23,35.54,34.07,34.62,32441516,45470872.45,53.64257860010975,49.36233002901582,NaN,NaN,100.33680941736876,78.74957672943493,0.7854802319938101,-0.2599882451897315,-1.0454684771835416,-434867151,-488456338.2,33.40562264211725,50.79774890748445,NaN,NaN,-2.6785520826615725,-13.011973425274416
2020-04-27T09:30:00-04:00,34.36,35.62,33.5758,35.37,23288037,44808853.35,55.62765282111899,50.103471454048936,NaN,NaN,97.30318885952583,84.50238931815257,0.7932448656946758,-0.05391239506519696,-0.8471572607598727,-411579114,-473695880.8,37.577933662371706,49.016307585291756,NaN,NaN,-0.6763207932123984,-11.249737334979843
2020-04-28T09:30:00-04:00,35.9,36.4,35.32,36.18,29570938,44181030.25,57.732739662398956,50.88065571947961,NaN,NaN,130.0662419107438,102.41983393552296,0.815944059768294,0.1727728139504947,-0.6431712458177993,-382008176,-440935084.4,45.70832860539395,47.65090825201015,NaN,NaN,1.624617924806829,-9.41054372643889
2020-04-29T09:30:00-04:00,37.37,38.99,37.34,38.86,35537494,44240374.6,63.84450154998993,51.747537228195085,NaN,NaN,201.86997612461028,127.50148853555939,0.9642933474693696,0.5621954385189127,-0.4020979089504569,-346470682,-408446758,52.338151885235746,46.481252276291265,NaN,NaN,5.5944320552031765,-7.266975757632881
2020-04-30T09:30:00-04:00,39.08,39.08,37.44,38,42020062,45150054.8,60.806015721482,52.44928915299089,NaN,NaN,179.50391767643788,141.81602679773735,0.9555086153025324,0.7922878601777086,-0.16322075512482379,-388490744,-392683173.4,55.196981922212366,45.61260519932789,NaN,NaN,8.072749750893252,-5.075586399272005
2020-05-01T09:30:00-04:00,37.22,37.5,35.41,35.85,29265931,42956944,53.899723593102884,52.67718600415403,NaN,NaN,95.36900385546625,140.82246568535683,0.7641932501120137,0.7920208075151933,0.02782755740317966,-417756675,-389261078.2,55.81656384029589,44.775348649648556,NaN,NaN,8.194722455800628,-3.179827991404486
2020-05-04T09:30:00-04:00,35.19,37.12,35.02,37.09,26390227,41084739.1,56.93756364121017,53.15212669001392,NaN,NaN,91.92937296056984,139.74770250556563,0.6831004172696611,0.881703078990256,0.19860266172059493,-391366448,-385218545,56.58044020390109,44.28784841551134,NaN,NaN,9.209616111642303,-1.409907405254945
2020-05-05T09:30:00-04:00,38.61,38.92,36.99,37.12,34366717,40902038.8,57.011370924876886,53.92361041916017,NaN,NaN,127.75537129286005,139.28552838198888,0.5965676553876541,0.9443122309551626,0.3477445755675085,-356999731,-380216856,57.55814052827805,44.46510290922792,NaN,NaN,10.0484314013322,0.2269981385432185
2020-05-06T09:30:00-04:00,37.3,37.62,36.12,36.15,23675053,39510316.6,53.800505218252084,54.69808471930435,NaN,NaN,76.58764895665654,114.22906294839814,0.44598407956147124,0.9052246750193476,0.4592405954578763,-380674784,-387057676.4,55.71043367328594,45.189393269789264,NaN,NaN,9.84603620900829,1.601146434323943
2020-05-07T09:30:00-04:00,37.17,37.7934,36.83,37.09,24240499,38627050.95,56.36519309263539,55.033114639249234,NaN,NaN,88.82325885063618,96.0929311832378,0.3840237842590297,0.9392703257816635,0.5552465415226338,-356434285,-380646384.6,57.10039168219642,46.24073494228895,NaN,NaN,10.393626303021149,2.857214986994973
2020-05-08T09:30:00-04:00,37.96,38.8,37.74,38.78,24840580,35300002.9,60.6000302494461,55.858111374460336,NaN,NaN,115.49138515483715,100.11740744311196,0.4278468853138019,1.0900551481648861,0.6622082628510843,-331593705,-363413790.6,60.67296577524294,47.80627618620829,NaN,NaN,12.120219594602645,4.180501359510354
2020-05-11T09:30:00-04:00,38.52,38.63,37.9201,38.1,23265662,34771144,58.15438740955772,56.61023427804007,NaN,NaN,95.4182509557668,100.81518304215135,0.3834526776247773,1.1415241098820559,0.7580714322572786,-354859367,-356112374.4,62.11263733372871,49.751924688800855,NaN,NaN,12.860211870938148,5.420460004000039
2020-05-12T09:30:00-04:00,38.48,38.53,37.38,37.43,28064487,34358164.85,55.76634019308739,56.973203868171304,NaN,NaN,73.53743538559912,89.97159586069915,0.28585699801479014,1.1153926797757663,0.8295356817609761,-382923854,-361297199,60.4211344164429,51.69795565640386,NaN,NaN,12.803349017505042,6.475158434500753
2020-05-13T09:30:00-04:00,37.18,37.23,35.4695,35.73,34497444,34247510.25,50.140261285999316,56.737775997376254,NaN,NaN,15.062482679412792,77.6665626052504,0.09364807362930805,0.9465957737976112,0.8529477001683031,-417421298,-368646501.8,58.0096216274882,53.443524842727946,NaN,NaN,11.074768252033088,7.132245551291087
2020-05-14T09:30:00-04:00,35.1,36.4696,34.3,36.13,30984194,34181575.05,51.383105353999454,56.57638505122551,NaN,NaN,-13.063126618072173,57.28928551150874,-0.013983039077591908,0.8354689013213132,0.8494519403989051,-386437104,-374647065.6,56.04286062039665,55.06047041260505,NaN,NaN,9.993214914159458,7.540955460272283
2020-05-15T09:30:00-04:00,36.14,36.89,35.67,35.99,27213861,33249596.2,50.90482960413443,56.23904053572661,NaN,NaN,3.8245502686868282,34.95591853427868,-0.0973898854757902,0.7277145835541674,0.8251044690299576,-413650965,-391058517.6,50.95454420082076,56.01594259392284,NaN,NaN,8.967061704370316,7.744684923714859
2020-05-18T09:30:00-04:00,38.05,39.18,37.95,38.93,36597396,32259717.3,59.44239905758339,56.36115906395407,NaN,NaN,111.34855068424787,38.14197847997489,0.035539269465102996,0.8695285558613364,0.8339892863962334,-377053569,-395497358,49.64171626422638,56.29689885526801,NaN,NaN,10.57159572859521,8.148529324412051
2020-05-19T09:30:00-04:00,38.98,39.1,37.81,37.84,26970315,30586695.2,55.583152679280964,55.77106271604629,NaN,NaN,82.23850279488283,39.88219196183163,0.039829086594368124,0.8837756446391936,0.8439465580448254,-404023884,-399717364,48.365887836405676,56.013165708923005,NaN,NaN,10.746505754441689,8.519668814416285
2020-05-20T09:30:00-04:00,38.62,39.42,38.418,39.35,27260646,30104735.3,59.50542838566051,55.67816362063047,NaN,NaN,114.18837288851007,59.70737000365109,0.12910052701988795,1.0053222168196854,0.8762216897997974,-376763238,-391585752,50.980244812696526,55.71197020110044,NaN,NaN,12.111927608599975,9.032848642156813
2020-05-21T09:30:00-04:00,39.47,39.625,38.41,38.72,28120869,29430596.4,57.23453455942998,55.91636440393955,NaN,NaN,97.82229959428497,81.88445524612251,0.13009299935347474,1.038837938991641,0.9087449396381662,-404884107,-395275152.6,49.74946479590968,55.27860598364429,NaN,NaN,12.549828935789883,9.535274398390108
2020-05-22T09:30:00-04:00,38.41,38.52,37.69,38.48,19247501,28770895.65,56.352253597767394,55.874556543693636,NaN,NaN,53.373358817066816,91.79421695579852,0.10029427832339677,1.034112787542412,0.9338185092190153,-424131608,-397371281.2,49.025286584895696,54.73895215371533,NaN,NaN,12.652073398159047,9.9805313983571
2020-05-26T09:30:00-04:00,39.71,39.96,39.445,39.55,37444281,29478707.85,59.360119007257445,56.04232426386368,NaN,NaN,132.74802454515162,96.07411172797926,0.13613088066736667,1.1039821100532237,0.967851229385857,-386687327,-399298032.8,48.32889044795381,54.07972000512074,NaN,NaN,13.609442933612732,10.498947331965047
2020-05-27T09:30:00-04:00,40.13,40.36,38.94,40.06,35612830,29780802.45,60.74854710078488,56.53861296975888,NaN,NaN,131.34466526274394,105.89534422155148,0.17517965667123603,1.1868258002249021,1.011646143553666,-351074497,-388708155.4,52.33638616487209,53.838716611662605,NaN,NaN,14.8053477004998,11.114147384612869
2020-05-28T09:30:00-04:00,40.16,40.16,38.75,38.94,27179408,29362898.15,56.20709599740858,56.52732032009982,NaN,NaN,91.7454744225325,101.40676452835596,0.10977269763627318,1.1488620155990077,1.0390893179627345,-378253905,-389006288.8,52.213610191461434,53.48966079089582,NaN,NaN,14.541208303272748,11.603727515849995
2020-05-29T09:30:00-04:00,38.6,39.05,37.95,38.76,35754826,29049636.35,55.489126814474204,56.1622557890304,NaN,NaN,45.584635055435086,90.95923162058598,0.04206205820129272,1.0916668907143503,1.0496048325130576,-414008731,-390831213.6,51.41846256795876,52.82862484751838,NaN,NaN,14.12332899851172,11.96367058480167
2020-06-01T09:30:00-04:00,38.7,39.655,38.18,39.44,23869771,28779828.35,57.68799575399363,56.12894209934724,NaN,NaN,71.22673460679978,94.52990677853258,0.03124434307125945,1.088660261352132,1.0574159182808724,-390138960,-384032684,54.215736378557956,52.264560493577605,NaN,NaN,14.363578682237478,12.306514598721071
2020-06-02T09:30:00-04:00,39.87,40.58,39.82,40.54,25120548,28716344.4,61.0408250138635,56.50569101511697,NaN,NaN,140.8943624072894,96.15917435096013,0.08338529982448373,1.161647543061477,1.0782622432369933,-365018412,-379698901,55.9566642611992,51.945669768203054,NaN,NaN,15.518140524461824,12.765318302398322
2020-06-03T09:30:00-04:00,41.18,41.92,41.1,41.73,27300871,28363052.1,64.33348909611186,57.519493001553585,NaN,NaN,190.95445780408346,108.08113285922805,0.17780775506830548,1.300521937072375,1.1227141820040696,-337717541,-377027509.8,57.041024235148036,51.87648424017876,NaN,NaN,17.491392890653444,13.440471815006196
2020-06-04T09:30:00-04:00,41.5,41.9,40.9,41.74,27424720,28550535.45,64.36074772333737,58.44646745650629,NaN,NaN,165.80269769902162,122.89257751452587,0.21807155016223678,1.3953036197068656,1.1772320695446288,-310292821,-363435293,62.14754199004725,52.312532909439525,NaN,NaN,19.112445655450532,14.25075379221253
2020-06-05T09:30:00-04:00,43.83,45.245,43.79,44.84,50196696,29848345.3,71.60550554145269,59.925087166314746,NaN,NaN,269.4385498266421,167.66336046876728,0.4189786036526535,1.7009553241104456,1.281976720457792,-260096125,-332652771.8,70.65505778658732,53.71971245127999,NaN,NaN,23.03343590484038,15.50542266544508
2020-06-08T09:30:00-04:00,46.47,46.88,45.43,46.86,47534714,30983052,75.1502981378481,61.04707995776222,NaN,NaN,257.75780645706686,204.9695748388207,0.6401638456903123,2.0821815275706825,1.4420176818803703,-212561411,-297137262,77.06098491485852,55.67823164061086,NaN,NaN,27.67741560961104,17.24427880032593
2020-06-09T09:30:00-04:00,45.36,45.49,44.475,45.1,43699499,32004743.85,67.27030129125131,61.881876287188675,NaN,NaN,167.1683199227449,210.2243663419118,0.6197743354497578,2.2167356011925676,1.5969612657428098,-256260910,-275385761.6,79.94807686846802,57.93410228575817,NaN,NaN,28.963052772390547,18.918389367763734
2020-06-10T09:30:00-04:00,44.68,44.72,42.86,42.88,40488452,32625942.1,58.883202680212065,61.83743159394236,NaN,NaN,101.39801956272869,192.31307869364085,0.4182705859467002,2.119799498176185,1.701528912229485,-296749362,-267192125.8,80.92214111195375,60.07280916427654,NaN,NaN,27.114124368569325,20.089208653593104
2020-06-11T09:30:00-04:00,39.89,41.043,38.71,38.84,48152242,33308682,47.32068364432551,61.129299385720614,NaN,NaN,-20.389819662558388,155.07457522132484,-0.003290371863056807,1.697415947400664,1.7007063192637208,-344901604,-274113882.4,77.49728440556001,62.05479627925157,NaN,NaN,20.924904291956434,20.208593744787866
2020-06-12T09:30:00-04:00,40.55,40.84,38.74,39.82,42817532,33900348.9,49.89111027120412,60.66778914810896,NaN,NaN,-19.773331443146176,97.23219896736717,-0.2203078308303228,1.4253215307258174,1.6456293615561401,-302084072,-282511471.8,73.43649934607674,63.79845433362164,NaN,NaN,17.116532430451485,19.76687069988267
2020-06-15T09:30:00-04:00,38.12,40.35,37.7,39.94,32852798,34182295.75,50.21146730387874,60.01431402643906,NaN,NaN,-42.436566480264894,37.19332437990083,-0.3521260383588136,1.2054718136076232,1.5575978519664369,-269231274,-293845444.4,68.23928986097263,65.22062572026586,NaN,NaN,14.341871383669627,18.99187079756652
2020-06-16T09:30:00-04:00,41.84,41.9,39.92,41.09,32046700,33954760.95,53.29323932488653,59.481792042446315,NaN,NaN,10.542276741234717,5.868115743598795,-0.35709811720997964,1.1112252054539624,1.468323322663942,-237184574,-290030177.2,69.03375400184032,66.41329485147787,NaN,NaN,13.078647687231557,18.14712463894724
2020-06-17T09:30:00-04:00,40.93,40.94,39.68,39.69,23368029,33774646.65,49.29312494031663,58.98793696693975,NaN,NaN,-24.141472096244136,-19.239782588195776,-0.44422599932712536,0.9130408235050353,1.3572668228321607,-260552603,-282790825.4,70.53960521765073,67.72229449620568,NaN,NaN,10.719921130789277,17.086095566353244
2020-06-18T09:30:00-04:00,39.29,40.615,39.05,40.18,18468934,33335061.05,50.68821968112066,58.64501502884307,NaN,NaN,-31.967438357518045,-21.555306327187708,-0.4566522942308737,0.7864514550435686,1.2431037492744423,-242083669,-262227238.4,74.35454576706954,69.36058615328501,NaN,NaN,9.258768958481252,15.96790605094296
2020-06-19T09:30:00-04:00,41.43,41.44,39.53,39.57,26967088,33277372,48.88507098101164,58.01623468791578,NaN,NaN,-26.34893954380057,-22.870427947318586,-0.4907643018167813,0.6296483720034658,1.1204126738202471,-269050757,-255620575.4,75.45429262411223,70.8776258851103,NaN,NaN,7.51685794671779,14.760613464625077
2020-06-22T09:30:00-04:00,38.88,39.38,38.42,39.25,19448200,33287406.95,47.92198702235105,57.07917483137917,NaN,NaN,-73.34318230077248,-29.0517511114201,-0.5170546125623556,0.47409440811730263,0.9911490206796583,-288498957,-259474112,73.47511565200853,72.1289438415967,NaN,NaN,5.812211968879304,13.482270393804253
2020-06-23T09:30:00-04:00,39.84,39.94,39.165,39.29,14805831,32155484.45,48.05973548244451,55.91676385897436,NaN,NaN,-55.409922708500815,-42.2421910013672,-0.51291142270211,0.35000974230202075,0.8629211650041307,-273693126,-266775822.4,69.74221678567493,73.03617188092004,NaN,NaN,4.454209682225677,12.192547435007313
2020-06-24T09:30:00-04:00,38.68,38.69,36.86,37.11,32362974,31992991.65,41.601388700981126,54.29109535737749,NaN,NaN,-119.44777135770649,-61.30345085365968,-0.6304164819073544,0.07490056261993772,0.7053170445272922,-306056100,-275876521.8,65.28989288884028,73.26062551654812,NaN,NaN,1.278172738521211,10.633351049795014
2020-06-25T09:30:00-04:00,36.76,37.955,36.57,37.82,24017220,31834882.25,44.23000460821835,52.33570243357503,NaN,NaN,-115.81865277125591,-78.07369373640725,-0.6321386024217255,-0.08485620849986475,0.5472823939218607,-282038880,-283867564,61.572882084060645,72.61189868065335,NaN,NaN,-0.6353497788842843,9.023536645697972
2020-06-26T09:30:00-04:00,37.55,37.55,36.335,36.51,33861103,31740196.1,40.598917280231845,49.86774665803102,NaN,NaN,-131.40157929284754,-99.08422168621664,-0.6886708528181765,-0.31355617210085995,0.3751146807173166,-315899983,-293237409.2,57.44334594439281,71.21063875419152,NaN,NaN,-3.381724243363917,7.25135651868913
2020-06-29T09:30:00-04:00,36.6,37.32,36.435,37,19452815,31519348.3,42.500406855208155,48.09846848402793,NaN,NaN,-118.83912740995868,-108.18341070805388,-0.660152101745984,-0.4500754464651635,0.21007665528082053,-296447168,-294827051.4,56.74797932079026,69.55348892935739,NaN,NaN,-5.122652846235252,5.483640895128504
2020-06-30T09:30:00-04:00,36.7,38.07,36.315,37.85,20943436,31310492.7,45.74490580929831,47.16001870753409,NaN,NaN,-92.95659651347604,-115.69274546904894,-0.5553410515718766,-0.4840996591840252,0.07124139238785138,-275503732,-295189172.6,56.57995352920489,67.81476124487533,NaN,NaN,-5.68665823232092,3.8878838769214434
2020-07-01T09:30:00-04:00,38,38.51,36.88,36.93,24573415,31174119.9,42.92187793159268,46.845818299481735,NaN,NaN,-85.32896742825744,-108.86898468315913,-0.5198973651571043,-0.5786303140585289,-0.05873294890142469,-300077147,-293993382,57.03238485301952,66.35298270540817,NaN,NaN,-6.9788428973345376,2.335494337742018
2020-07-02T09:30:00-04:00,37.69,38.21,37.2572,37.34,20779169,30841842.35,44.56377816977361,46.465294577950985,NaN,NaN,-74.19261517808789,-100.54377716452551,-0.4437273709501919,-0.6133921625891645,-0.16966479163897266,-279297978,-293445201.6,57.2522864199571,65.19696749639961,NaN,NaN,-7.603039297367406,0.9157038184406718
2020-07-06T09:30:00-04:00,38,38.27,36.98,37.45,22542171,29459116.1,45.02072911272247,46.09452756429697,NaN,NaN,-70.91248862564247,-88.4459590310845,-0.3641578276902233,-0.6248620762517518,-0.2607042485615285,-256755807,-281616366.4,61.795888966299266,64.73672457535152,NaN,NaN,-7.999050244840844,-0.3578324763138303
2020-07-07T09:30:00-04:00,36.98,37.03,36.2,36.26,20910910,28127925.9,41.07611706825073,45.22187597453727,NaN,NaN,-103.53280900333573,-85.38469534975991,-0.3687616534962407,-0.7216563154318294,-0.3528946619355887,-277666717,-277860276.2,63.135785140943575,64.31544108528746,NaN,NaN,-9.443387130539639,-1.6557688554889458
2020-07-08T09:30:00-04:00,36.26,36.82,35.93,36.23,20650858,26975493.85,40.97863869428666,44.627984099820836,NaN,NaN,-103.20941320194639,-87.43525868745398,-0.35101340373783313,-0.7916614166078801,-0.440648012870047,-298317575,-282423044.8,60.366094628603605,63.58876175749838,NaN,NaN,-10.666141238370656,-2.942964910186333
2020-07-09T09:30:00-04:00,36.07,36.17,34.4,34.44,30543584,26478250.45,35.556676194210084,43.54715956504151,NaN,NaN,-152.91664239639192,-100.95279368108088,-0.4317047563964953,-0.9802789583656661,-0.5485742019691708,-328861159,-288179847.2,56.97029771966598,62.347029754112405,NaN,NaN,-13.368142590605709,-4.432276007389101
2020-07-10T09:30:00-04:00,34.24,35.58,34.24,35.54,25227968,25332036.75,40.74523342697433,42.96574259689599,NaN,NaN,-132.52185771409714,-112.61864218828273,-0.3844491798178835,-1.0291356767415252,-0.6446864969236417,-303633191,-293046889.8,54.1945940219352,60.828479853956914,NaN,NaN,-14.21900576874564,-5.830380259011464
2020-07-13T09:30:00-04:00,35.87,36.01,35.08,35.35,37223780,25052349.15,40.14401117821076,42.41017289374311,NaN,NaN,-108.19262358355321,-120.07466917986487,-0.340924711025575,-1.0708423857056104,-0.7299176746800354,-340856971,-309867122.6,45.875809197081836,58.85710082146215,NaN,NaN,-15.087789044909638,-7.152867228425489
2020-07-14T09:30:00-04:00,35.11,36.66,35.01,36.59,34220617,25120740.1,45.768260162322186,42.24649608516295,NaN,NaN,-75.35384603495363,-114.43887658618846,-0.20998415724736463,-0.9923978712392412,-0.7824137139918765,-306636354,-315661050,43.404299034461246,56.975820982089736,NaN,NaN,-14.22287067770277,-8.162867721179387
2020-07-15T09:30:00-04:00,37.52,37.62,36.83,37.38,25902534,24813531.8,49.052748882433285,42.778736098123815,NaN,NaN,-10.532238083555283,-95.90344156251024,-0.059356367477183425,-0.8566091733383558,-0.7972528058611724,-280733820,-312144299,45.32953807621939,55.550081352616814,NaN,NaN,-12.51856375873609,-8.785110012258915
2020-07-16T09:30:00-04:00,37.13,37.685,36.66,37.21,18822756,24586268.15,48.37380943886711,43.074722157455874,NaN,NaN,-8.353947065421567,-66.99090249631617,0.03458517067032474,-0.7540213425232665,-0.7886065131935912,-299556576,-306283382.4,48.47529619390621,54.614539503320074,NaN,NaN,-11.298920809292323,-9.144225840406545
2020-07-17T09:30:00-04:00,37.33,37.74,36.53,36.69,17716903,24548666.6,46.26443323687891,43.47940186864495,NaN,NaN,-13.012425819658768,-43.0890161174285,0.06565728489920764,-0.7065349070695817,-0.7721921919687893,-317273479,-309011440,47.11630548011978,53.876893755872,NaN,NaN,-10.830167455378907,-9.385074642545455
2020-07-20T09:30:00-04:00,36.56,36.98,36.05,36.08,20076219,24204123.15,43.84889676980655,43.57572257683055,NaN,NaN,-49.40855611581546,-31.33220262388095,0.04980197464994196,-0.7099397236563618,-0.7597416983063038,-337349698,-308309985.4,47.52367650309685,53.21801498317961,NaN,NaN,-11.085902835391192,-9.628050098666273
2020-07-21T09:30:00-04:00,36.7,38.55,36.65,38.26,36188840,25041155.15,53.24424296297868,44.11138951637914,NaN,NaN,78.51518964795987,-0.5583954872982417,0.18330239871314435,-0.5306136999148734,-0.7139160986280177,-301160858,-307214886.2,48.19461365391386,52.619062134944535,NaN,NaN,-8.43284745581618,-9.457306863973402
2020-07-22T09:30:00-04:00,37.85,37.85,37.24,37.79,19621693,25281948.25,51.253107781903616,44.70647736282992,NaN,NaN,77.08907316240457,16.96586676189373,0.23388319835186644,-0.42156210068818467,-0.6554452990400511,-320782551,-315224632.4,43.785062453390374,51.67282482068531,NaN,NaN,-6.829335285979249,-9.08188235283138
2020-07-23T09:30:00-04:00,37.66,37.91,37.24,37.72,21043891,24715994.1,50.947519988014704,45.16245892127572,NaN,NaN,76.12348041631465,33.86135225824097,0.2548340531318426,-0.33690273262524784,-0.5917367857570904,-341826442,-323678605.6,39.66047434190967,50.41626681511049,NaN,NaN,-5.611495308901602,-8.586112775127127
2020-07-24T09:30:00-04:00,37.72,38.28,37.365,37.51,19950569,24512661.55,49.98467013747989,45.51702613732982,NaN,NaN,82.65372852691148,52.99458312755503,0.24659986278538626,-0.28348695727535755,-0.5300868200607438,-361777011,-332579312,35.83320872650482,48.56178965512517,NaN,NaN,-4.856638437728311,-8.053330726927296
2020-07-27T09:30:00-04:00,37.46,37.72,36.99,37.55,18230986,23731155.7,50.17781522511918,46.16714743424899,NaN,NaN,50.31987867740699,72.9402700861995,0.2358970664113757,-0.23521548704652417,-0.4711125534578999,-343546025,-333818577.4,35.322113397018384,46.575098816273375,NaN,NaN,-4.176595789422804,-7.49951145014094
2020-07-28T09:30:00-04:00,37.33,37.685,36.81,36.91,17775580,23647293.95,47.04727242482214,46.60062127214439,NaN,NaN,22.8187323723591,61.80097863107936,0.18027438534816737,-0.24576957177269065,-0.426043957120858,-361321605,-345850726.8,30.73799961677524,44.45880631542849,NaN,NaN,-4.406073020749089,-7.0575916745135325
2020-07-29T09:30:00-04:00,37.01,37.71,36.76,37.68,17215023,23460873.3,51.007607909951666,47.70425925184021,NaN,NaN,45.657146605652045,55.51459331972885,0.18898464785093905,-0.18981314730718424,-0.3787977951581233,-344106582,-350515533,29.158053382873206,42.472217434229016,NaN,NaN,-3.5291687548522863,-6.553531257419069
2020-07-30T09:30:00-04:00,36.89,36.91,35.875,36.2,32833724,23873888.75,44.16969294706879,47.94886350327554,NaN,NaN,-44.93127286881064,31.303642662703794,0.09354046886136469,-0.2618722090814174,-0.3554126779427821,-376940306,-357538305.8,26.915089732855407,40.52368141358045,NaN,NaN,-4.7257876827156995,-6.292425032461445
2020-07-31T09:30:00-04:00,35.65,36.07,35.295,36.03,24774420,24073651.3,43.44917930915199,48.184946941199904,NaN,NaN,-82.08523143141117,-1.6441493289607365,0.021205587279207738,-0.32890569384377244,-0.3501112811229802,-401714726,-365525848.8,24.597463940818088,39.00379960956161,NaN,NaN,-5.9160632166706595,-6.2386590587770465
2020-08-03T09:30:00-04:00,36.02,36.36,35.72,36.16,21105539,24001819.7,44.198798148372994,48.07284251163211,NaN,NaN,-51.552314661363326,-22.0185879967148,-0.013755953046777514,-0.36730622243145206,-0.35355026938467454,-380609187,-372938481.2,22.648388177960285,37.52123454838297,NaN,NaN,-6.702483355897729,-6.30491967265143
2020-08-04T09:30:00-04:00,36.04,37.12,36.0058,37.04,22572126,24084880.5,49.11588427616338,48.077352182612834,NaN,NaN,4.22791511715947,-25.736751447754727,0.024434735062560053,-0.3230068505564745,-0.34744158561903454,-358037061,-372281572.4,23.228956229713035,35.942621559346804,NaN,NaN,-6.022054852906198,-6.264510412687825
2020-08-05T09:30:00-04:00,37.77,37.9,37.085,37.43,30763500,24590512.6,51.16951302868356,48.277045296171146,NaN,NaN,64.92712367585818,-21.8827560337135,0.07514745680866536,-0.25350726460820283,-0.3286547214168682,-327273561,-368914968.2,26.282647715387284,34.35743238230974,NaN,NaN,-4.8689761335508495,-6.065148372811114
2020-08-06T09:30:00-04:00,37.22,37.555,36.99,37.13,19190042,24022835.5,49.514086883486094,48.50916341378595,NaN,NaN,37.701611179403564,-5.356179224070656,0.08684483768444157,-0.22009867431131624,-0.3069435119957578,-346463603,-362819627.6,31.588412379300422,33.248297160822645,NaN,NaN,-4.338850427007569,-5.818534380553465
2020-08-07T09:30:00-04:00,36.8,37.27,36.37,37.18,18376577,23680265.95,49.805552705432255,48.934638837759216,NaN,NaN,0.7232842275850118,11.20552390772858,0.09561320810513763,-0.1874270018643358,-0.28304020996947343,-328087026,-348094087.6,42.37841164304748,32.88077824224769,NaN,NaN,-3.8188975296579573,-5.532871973282678
2020-08-10T09:30:00-04:00,37.46,38.345,37.37,38.33,26308068,23134480.35,56.08527080416643,49.137569397844054,NaN,NaN,123.00184983275959,46.11635680655316,0.1720675874080448,-0.06795572570941744,-0.24002331311746222,-301778958,-332328041.8,51.24483758394611,33.098651380107135,NaN,NaN,-1.5515662325984658,-4.9641140103277905
2020-08-11T09:30:00-04:00,39.08,39.53,38.02,38.2,26513139,22749106.45,55.243877940348476,49.422624409161536,NaN,NaN,181.89065291072356,81.64890436526598,0.2048595943604885,0.01605117983314841,-0.1888084145273401,-328292097,-326379049,54.11396129903572,33.83642986908181,NaN,NaN,0.11150911550010079,-4.239024992352378
2020-08-12T09:30:00-04:00,38.78,39.03,38.17,38.58,25533871,22730673.3,57.262185027884506,49.873671912009385,NaN,NaN,155.8091611472631,99.82531185954697,0.2406459531063289,0.11199902685557106,-0.12864692625075785,-302758226,-321475982,56.39171491028626,35.031518481108705,NaN,NaN,2.099530414256178,-3.333517077122584
2020-08-13T09:30:00-04:00,38.27,38.59,37.74,37.83,15761049,22577587.95,52.25361777141893,50.035739600147885,NaN,NaN,83.36593306286638,108.95817623623952,0.20377069256767172,0.12606643945883178,-0.07770425310883992,-318519275,-315887116.4,58.89636427667697,36.678886734692426,NaN,NaN,2.482866815111818,-2.5026050925176695
2020-08-14T09:30:00-04:00,37.53,38.25,37.39,38.19,13279662,22355725.9,54.319030400532746,50.331540684105995,NaN,NaN,65.21960952035774,121.85744129479409,0.19365877105257037,0.16436921070687305,-0.029289560345697324,-305239613,-311317633.8,60.874976053739765,38.504091210172525,NaN,NaN,3.3839923002734666,-1.6616626078332215
2020-08-17T09:30:00-04:00,38.2,38.2197,37.76,37.97,14255817,22064705.8,52.815431318018184,50.74355203362,NaN,NaN,64.63482482853722,110.18403629394959,0.16339604305375846,0.17495549347150074,0.011559450417742291,-319495430,-314860928.2,58.522484877854296,40.488697300249605,NaN,NaN,3.738949971727607,-0.8901465250388175
2020-08-18T09:30:00-04:00,37.83,38.1959,37.375,37.49,14348766,20972702.1,49.59007257290764,50.642299509545424,NaN,NaN,31.518806082404183,80.10966692828572,0.10512459691910295,0.142965196566621,0.037840599647518035,-333844196,-315971348,57.769044267419595,42.53233950628863,NaN,NaN,3.1629693914395283,-0.3111299655419111
2020-08-19T09:30:00-04:00,37.46,37.63,36.94,37.06,14793943,20731314.6,46.83100357009006,50.83239312547551,NaN,NaN,-21.569500918523822,44.63393451512833,0.03530379734129839,0.08197034632414102,0.04666654898284263,-348638139,-325147330.6,51.83072408064911,44.31202767398819,NaN,NaN,1.8966588109044995,0.004268431093290392
2020-08-20T09:30:00-04:00,36.51,36.75,36.25,36.26,19107685,20634504.3,42.13413784412916,50.73846159225959,NaN,NaN,-99.06476087732358,8.147795727090346,-0.06178879164713839,-0.030569440576080353,0.031219351071058034,-367745824,-334992640.4,46.328048341584385,45.86421227404292,NaN,NaN,-0.6133158698590752,-0.08395789761419041
2020-08-21T09:30:00-04:00,36.12,36.1901,35.69,36.03,17347787,20504365.2,40.8651702683739,50.50034531511681,NaN,NaN,-128.08063194762755,-30.51225256650672,-0.13436815841231423,-0.13674084694433475,-0.0023726885320205227,-385093611,-350963440,39.07997076840217,47.03789674478877,NaN,NaN,-3.082536704817365,-0.5123262986432153
2020-08-24T09:30:00-04:00,36.25,37.28,36.035,37.02,24826985,20834165.15,48.1094722123135,50.42845873912753,NaN,NaN,-43.048428354933364,-52.04890320320084,-0.10961457997997821,-0.13939091350699329,-0.029776333527015076,-360266626,-359117679.2,35.98444051672695,47.94900276528976,NaN,NaN,-3.194701859138749,-0.8955228072854344
2020-08-25T09:30:00-04:00,37.22,37.27,36.32,36.5,20118545,20951313.4,44.99173997035986,49.98718923496155,NaN,NaN,-47.28527334607813,-67.80971908889731,-0.12126705919925686,-0.18136015752608614,-0.06009309832682928,-380385171,-368425874.2,32.7913794912175,48.41391217784906,NaN,NaN,-4.2235108403071555,-1.3709496691456802
2020-08-26T09:30:00-04:00,36.45,36.45,35.68,35.73,18001223,20990623.4,40.777661634122595,49.36315886000701,NaN,NaN,-103.39628647918497,-84.17507620102953,-0.17080533163324552,-0.27359976286838616,-0.10279443123514066,-398386394,-378375525.2,29.752312655524605,48.28276219757936,NaN,NaN,-6.4231582887245935,-2.0926937576569533
2020-08-27T09:30:00-04:00,35.74,36.04,35.36,35.8,22259652,20461919.8,41.315786551093616,48.756746991839975,NaN,NaN,-115.65577832270209,-87.49327969010523,-0.18749666967732892,-0.3371652683318018,-0.1496685986544729,-376126742,-380051708.8,29.260320625224438,47.345755696306284,NaN,NaN,-8.046372935013373,-2.943219354422156
2020-08-28T09:30:00-04:00,35.94,36.55,35.76,36.44,14575050,19951951.3,46.13494571061046,48.046009485157406,NaN,NaN,-75.80837422925457,-77.03882814643063,-0.14592178686234467,-0.33207083223240375,-0.18614904537005908,-361551692,-375343325,32.63037140361041,46.01615096913945,NaN,NaN,-8.038153848540883,-3.6710671392962597
2020-08-31T09:30:00-04:00,36.49,36.54,35.65,35.65,18791540,19836251.35,41.59431899069242,47.0710409887534,NaN,NaN,-100.91096508461592,-88.61133549236715,-0.1609328636636342,-0.38731512494960185,-0.22638226128596764,-380343232,-379358646.2,31.262545533911464,44.38390698591628,NaN,NaN,-9.419144540526823,-4.492221053757769
2020-09-01T09:30:00-04:00,35.49,35.57,34.97,35.41,18260946,19620692.35,40.29676683711726,45.8592254036986,NaN,NaN,-136.97914698541172,-106.55011022023385,-0.17515750460026602,-0.44532914203630014,-0.2701716374360341,-398604178,-383002447.6,30.03223282997689,42.50108683732276,NaN,NaN,-10.942030178284973,-5.413622357261655
2020-09-02T09:30:00-04:00,35.4,35.61,35.02,35.24,23850473,19275041,39.360133248981086,44.93826222352447,NaN,NaN,-122.26442064180067,-110.323737052757,-0.18327708773878298,-0.49926799710951286,-0.3159909093707299,-422454651,-387816099,28.43993469343755,40.32562758137709,NaN,NaN,-12.470309161880964,-6.42172047220727
2020-09-03T09:30:00-04:00,35.17,35.9,34.77,34.98,39442315,20287654.65,37.90885945398937,43.766107155914234,NaN,NaN,-112.58494215807082,-109.70956981983072,-0.1924703611464531,-0.5565788608037963,-0.36410849965734315,-461896966,-404970143.8,23.631491542940864,37.6653786877486,NaN,NaN,-14.171148585185419,-7.528781631204149
2020-09-04T09:30:00-04:00,35.34,35.58,34.44,34.87,34341015,21085876.55,37.28253091548545,42.65661427001903,NaN,NaN,-114.63422585994124,-117.47474014596807,-0.19184334777234946,-0.60391268437278,-0.41206933660043055,-496237981,-431907401.6,18.37708152547596,34.797849876864426,NaN,NaN,-15.764666424293033,-8.705336601645417
2020-09-08T09:30:00-04:00,34.21,34.37,33.22,33.6,49215841,22231265.2,30.928903724473088,41.323673637987994,NaN,NaN,-170.62518395937028,-131.41758392091896,-0.2586852782041613,-0.7354259343556322,-0.4767406561514709,-545453822,-464929519.6,14.206800419551158,31.686261030588117,NaN,NaN,-19.24390748023404,-10.210846727158078
2020-09-09T09:30:00-04:00,33.98,34.17,33.7101,33.83,24977619,22154489.2,33.15078798496906,40.34651538190793,NaN,NaN,-146.44752354708996,-133.3112592332546,-0.26799537927640205,-0.8117348802469735,-0.5437395009705714,-520476203,-489303924.6,12.035725357370637,28.84376112178251,NaN,NaN,-21.46699024517105,-11.81886722973136
2020-09-10T09:30:00-04:00,33.93,33.97,32.53,32.59,37003339,22727962.6,27.933660325259808,39.33219555913155,NaN,NaN,-180.42496271436332,-144.94336764776713,-0.33395874353310173,-0.9611879303869486,-0.6272291868538469,-557479542,-516308902.8,10.179612796133654,26.261730011393173,NaN,NaN,-25.221669345858583,-13.733553246320962
2020-09-11T09:30:00-04:00,32.66,32.83,32.35,32.62,25397272,23209773.75,28.22795147577716,38.42953707394606,NaN,NaN,-176.91700789895938,-157.80978079594485,-0.35016377446623825,-1.0649339049366446,-0.7147701304704064,-532082270,-530345963.6,9.370666731494609,24.139636865899774,NaN,NaN,-28.10763340872277,-15.78699326952122
2020-09-14T09:30:00-04:00,32.71,33.17,32.48,32.87,19444213,23518001.3,30.765254155300426,37.19066435558799,NaN,NaN,-141.792861271419,-163.24150787824038,-0.3194937714394763,-1.1141373447697518,-0.7946435733302755,-512638057,-533625978.8,9.186951945603141,22.225530539390927,NaN,NaN,-29.759245372694306,-17.783029284260234
2020-09-15T09:30:00-04:00,33.09,33.39,32.535,32.63,25610440,24085732.45,29.680469293554438,36.097002164387604,NaN,NaN,-125.07798603990422,-154.1320682943472,-0.29159364182400016,-1.1591356256102756,-0.8675419837862755,-538248497,-532184913.8,10.021601707774977,20.599117840573605,NaN,NaN,-31.451595076484555,-19.73568154029228
2020-09-16T09:30:00-04:00,32.92,34.38,32.64,33.94,35899018,25163245.05,41.75307113549448,36.16667427162845,NaN,NaN,-72.36136679733364,-139.31483694439592,-0.16731020628815207,-1.0766797416464655,-0.9093695353583134,-502349479,-528559569,12.207666574196054,19.34592883476442,NaN,NaN,-29.198560420840025,-21.08752138037053
2020-09-17T09:30:00-04:00,33.4,34.02,33.07,33.99,22356743,25541385.05,42.16122824706627,36.22706296419793,NaN,NaN,-61.583632224437395,-115.54657084641072,-0.0691596475225329,-0.9958190947614796,-0.9266594472389467,-479992736,-513062207.8,21.039078010945133,18.758697219458757,NaN,NaN,-27.28016472019116,-21.972184714630618
2020-09-18T09:30:00-04:00,33.97,33.995,33.265,33.61,26406373,25906319.45,39.87433413815322,35.779876423308124,NaN,NaN,-58.02578284133069,-91.76832583488499,-0.019817850730459385,-0.9514317606520208,-0.9316139099215615,-506399109,-507925575.6,23.776050131514594,18.126245700023347,NaN,NaN,-26.328247625220413,-22.594479416143447
2020-09-21T09:30:00-04:00,32.26,32.34,31.43,31.97,30719575,26574908.85,31.845893883243647,35.08356034420464,NaN,NaN,-131.06124057430353,-89.62200169546188,-0.084020106401554,-1.036639042923504,-0.95261893652195,-537118684,-512821701,22.959143191765918,17.53314553272724,NaN,NaN,-28.09869932860924,-23.380796546495702
2020-09-22T09:30:00-04:00,31.99,32.5,31.58,31.64,22348723,26450995.75,30.514522876939054,34.38482863276334,NaN,NaN,-119.8452026429274,-88.57544501606652,-0.13223134769210176,-1.1179081211370772,-0.9856767734449754,-559467407,-517065483,22.245692402380158,16.976964073613193,NaN,NaN,-29.950836825030365,-24.31937372914351
2020-09-23T09:30:00-04:00,31.76,31.88,30.17,30.21,26484596,26769298.3,25.533075357572542,33.397181640519875,NaN,NaN,-164.32979320118244,-106.96913029683628,-0.2377904662429926,-1.2829148562487163,-1.0451243900057237,-585952003,-533785987.8,19.654227524314834,16.349413561532995,NaN,NaN,-33.37803024839176,-25.613467517607546
2020-09-24T09:30:00-04:00,30.1,30.75,29.54,30.2,35241284,27631301.35,25.50172322049221,32.510957623841506,NaN,NaN,-175.00558501643027,-129.65352085523486,-0.2825974846313284,-1.398371245794884,-1.1157737611635556,-621193287,-562026098,16.217892475010515,15.819870770966542,NaN,NaN,-36.00919791432339,-27.098571859995523
2020-09-25T09:30:00-04:00,29.89,30.405,29.7,30.18,27558431,27896240.3,25.434456359663614,31.664666584139948,NaN,NaN,-153.15537559239368,-148.67943940544745,-0.286971485464645,-1.4744881179943619,-1.1875166325297168,-648751718,-590496619.8,13.630486370555431,15.48082825990079,NaN,NaN,-38.103889882383484,-28.67076014890809
2020-09-28T09:30:00-04:00,30.725,31.23,30.685,30.89,26375971,28486286.35,32.26503620445082,31.760104618424073,NaN,NaN,-103.19188562721152,-143.10556841602906,-0.21853260121018914,-1.4606823840424532,-1.242149782832264,-622375747,-607548032.4,12.35875728327916,15.348825178738505,NaN,NaN,-37.808343242405634,-29.976129162264883
2020-09-29T09:30:00-04:00,30.8,30.87,29.74,30.04,23801491,28736783.9,28.856918418254068,31.453399649373008,NaN,NaN,-123.83324772183514,-143.9031774318106,-0.2071011661580231,-1.501026240529793,-1.2939250743717698,-646177238,-624889998.6,11.212915974332716,15.290053079950082,NaN,NaN,-38.624546886108384,-31.21161740852824
2020-09-30T09:30:00-04:00,30.23,30.58,29.81,29.95,24574493,29052461.25,28.51348620730397,31.494815783804732,NaN,NaN,-113.16089211258914,-133.66939721409193,-0.18302670061165793,-1.5227084501363422,-1.3396817495246842,-670751731,-641849944.2,10.215408386237087,15.292609907814612,NaN,NaN,-39.37883533328363,-32.37836282635044
2020-10-01T09:30:00-04:00,29.62,29.745,28.85,29.03,28357845,29277829.85,25.210528414752318,31.2792855651601,NaN,NaN,-134.93132830467775,-125.65454587174145,-0.20484135784831103,-1.595733446835073,-1.390892088986762,-699109576,-657433202,9.388928732146013,15.29391433643257,NaN,NaN,-41.08183181464964,-33.62171553896461
2020-10-02T09:30:00-04:00,28.25,29.5599,28.2,29.31,28705210,28740974.6,27.946203167376822,31.077924780308415,NaN,NaN,-128.16435100854133,-120.65634095497099,-0.17722679637508487,-1.6124255844556181,-1.4351987880805332,-670404366,-661763731.6,9.166971273689398,15.292487145581589,NaN,NaN,-41.64156790629778,-34.767408734297916
2020-10-05T09:30:00-04:00,29.57,30.21,29.495,30.19,31572227,28602535.2,35.88399614574077,31.521033841178866,NaN,NaN,-77.98648869473153,-115.61526156847496,-0.08138402515209342,-1.53692881952065,-1.4555447943685567,-638832139,-665055010,8.992965004455982,15.21901309534452,NaN,NaN,-39.61730604481424,-35.46025120722882
2020-10-06T09:30:00-04:00,30.63,30.8,29.66,29.74,31111451,27697315.7,33.831516370779596,30.955208500842083,NaN,NaN,-66.09352688298449,-104.06731740070484,-0.032493372520084884,-1.4961615100186627,-1.4636681374985778,-669943590,-669808280.4,8.735084379312624,14.970971509995703,NaN,NaN,-38.56255390922169,-35.90343730751352
2020-10-07T09:30:00-04:00,29.91,30.24,29.565,30.16,21043019,27500585.7,37.428794890477526,30.617177546800033,NaN,NaN,-63.423736657898715,-94.11988630976673,0.040001099483923275,-1.4136667631436737,-1.453667862627597,-648900571,-665438048.4,11.254832780702927,14.272096850692689,NaN,NaN,-36.57711762228703,-35.999677352481164
2020-10-08T09:30:00-04:00,30.41,31.31,30.265,31.29,30563066,27178572.05,45.94375458170268,31.050707578482136,NaN,NaN,-13.742452711256409,-69.88211119108247,0.1687090788878718,-1.2427815140177572,-1.411490592905629,-618337505,-649283634.2,20.04268834172383,14.005428151421919,NaN,NaN,-31.998328178880964,-35.42805604196685
2020-10-09T09:30:00-04:00,31.57,31.65,30.735,30.79,25515643,27184490.6,43.14590777183676,31.857851427667356,NaN,NaN,-4.981504379620973,-45.24554186529839,0.2214961965933695,-1.1346203471639171,-1.3561165437572866,-643853148,-643973390.6,22.750640569353223,13.990535106963867,NaN,NaN,-29.09784070765008,-34.52373956563588
2020-10-12T09:30:00-04:00,30.69,30.98,30.37,30.87,16684603,27046510.1,43.73628623955495,32.802263096425634,NaN,NaN,-17.94082630114023,-33.236409386580135,0.2604398114592259,-1.0305667794332543,-1.2910065908924802,-627168545,-641640671.8,23.96880871450591,14.11361484354428,NaN,NaN,-26.60756338068054,-33.3928572534994
2020-10-13T09:30:00-04:00,30.87,31.05,30.3,30.39,25382566,27035116.4,40.98622340700321,33.90605938567068,NaN,NaN,-22.87037973982794,-24.591779957948827,0.2523336115461041,-0.9755895764598499,-1.227923188005954,-652551111,-638162176,25.84664165732096,14.555930138759,NaN,NaN,-25.31075956059654,-32.23827186879899
2020-10-14T09:30:00-04:00,30.46,31.23,30.4,30.52,27243001,26602315.55,42.04901553691944,35.088008836844054,NaN,NaN,-5.364673619683231,-12.979967350305728,0.25351609521642726,-0.91102806898542,-1.1645441642018473,-625308110,-633443683.8,28.428897720441853,15.428144799146954,NaN,NaN,-23.943286274822192,-31.053273926802305
2020-10-15T09:30:00-04:00,30,30.9,29.73,30.89,20360584,26502507.6,45.08056088973764,36.491302017563626,NaN,NaN,-11.463671104691903,-12.524211028992827,0.2751969829113998,-0.8205479355625975,-1.0957449184739974,-604947526,-630765688,29.92049250338121,16.591716665777366,NaN,NaN,-21.909463190769944,-29.747015250226255
2020-10-16T09:30:00-04:00,30.83,30.87,30.14,30.19,18711488,26117763.35,40.73855984926415,37.096553706478865,NaN,NaN,-8.036721467624751,-13.135254446593581,0.23967719529442233,-0.7961484243559696,-1.0358256196503919,-623659014,-626726861.2,32.21493505087837,18.01001507774874,NaN,NaN,-21.374882838304643,-28.550996334237453
2020-10-19T09:30:00-04:00,30.3,30.45,29.52,29.55,25186046,25841086.9,37.20978172796581,37.69318680002971,NaN,NaN,-70.44807097280082,-23.636703380925727,0.17344992553296623,-0.819013212734184,-0.9924631382671503,-648845060,-631062164.2,31.04014881014838,19.426245994592712,NaN,NaN,-21.97223981363266,-27.611173974151054
2020-10-20T09:30:00-04:00,29.72,30.155,29.52,29.9,22993784,25873339.95,40.257500047727376,38.53204493148852,NaN,NaN,-61.96410009266143,-31.455447451492425,0.15423170349629256,-0.7996735088967846,-0.9539052123930771,-625851276,-625722197.2,34.22204326920567,21.141005629090472,NaN,NaN,-21.574085539567907,-26.748732769210605
2020-10-21T09:30:00-04:00,29.73,29.895,29.32,29.33,24656697,25781945,37.099297272097225,39.38124270701316,NaN,NaN,-104.9669744910497,-51.37590762576572,0.10642151685030332,-0.820878316330198,-0.9272998331805014,-650507973,-630762169.8,32.68896303519897,22.805293793594252,NaN,NaN,-22.177283866874294,-26.09566864030542
2020-10-22T09:30:00-04:00,29.38,30.58,29.19,30.54,32827709,25661266.25,46.66469793407465,40.71827804749157,NaN,NaN,-13.90106262893582,-51.863385930614506,0.15654961512385002,-0.7316128142756888,-0.8881624293995388,-617680264,-633308717.4,31.911089691500194,24.429873680580737,NaN,NaN,-19.633002262219687,-25.17243058629317
2020-10-23T09:30:00-04:00,30.7,30.88,30.01,30.39,24987726,25532731,45.73616358716508,41.4220042933076,NaN,NaN,32.50514870049678,-43.7550118969902,0.17828690422920723,-0.6653037991130297,-0.843590703342237,-642667990,-637110512.6,30.735203106937533,25.982890687900852,NaN,NaN,-17.885916093701777,-24.1314999444944
2020-10-26T09:30:00-04:00,29.87,29.91,29.01,29.3,30400969,25733980.9,39.57392434120183,41.8321762911949,NaN,NaN,-110.50940103969675,-51.76727791036937,0.1206949236481707,-0.6927220487820236,-0.8134169724301943,-673068959,-641955292.4,29.255737545142097,27.44865162831724,NaN,NaN,-18.32663131339855,-23.302232997194995
2020-10-27T09:30:00-04:00,29.27,29.28,28.85,28.92,21596759,25623744.3,37.66846983692158,41.84929593022662,NaN,NaN,-145.21979788410698,-68.41841746865849,0.061435413644816306,-0.7366227053741738,-0.7980581190189902,-694665718,-655718180.8,25.50049786387615,28.466199134258183,NaN,NaN,-19.29307031705648,-22.729495471460922
2020-10-28T09:30:00-04:00,28.21,28.3899,27.55,27.71,40549086,26422473.95,32.33037100695806,40.87691138917343,NaN,NaN,-232.94308112556027,-94.01363879556061,-0.04887147476242659,-0.8591474624720234,-0.8102759877095969,-735214804,-672659547,21.792370742698154,28.591176448613492,NaN,NaN,-21.96825440001615,-22.620746746968813
2020-10-29T09:30:00-04:00,27.35,28.65,26.98,28.56,37250905,26867126.95,38.882636431532546,40.57239200772313,NaN,NaN,-185.00892744168831,-128.23521175811112,-0.053815626196312194,-0.8775455204549871,-0.8237298942586749,-697963899,-688716274,18.975920498015924,28.321553586375114,NaN,NaN,-22.00099157482758,-22.53221029380578
2020-10-30T09:30:00-04:00,28.36,28.74,28.03,28.72,37903718,27327052.35,40.05917493191327,40.30974120003443,NaN,NaN,-132.54035887550017,-161.2443132733105,-0.036372806059032814,-0.869195901832466,-0.8328230957734332,-660060181,-692194712.2,18.420513572507915,27.925246790518116,NaN,NaN,-21.650941469723307,-22.406314747508283
2020-11-02T09:30:00-05:00,29.11,30.09,28.57,29.7,41890853,27842983.65,46.81283434527974,40.725927695625614,NaN,NaN,-37.30853768868916,-146.604140603109,0.04660073800980491,-0.774572173261177,-0.8211729112709819,-618169328,-681214786,25.802875387491582,27.922120628387443,NaN,NaN,-19.11827041009696,-21.936594127878095
2020-11-03T09:30:00-05:00,30.2,30.22,29.26,29.53,34877454,28031283.8,45.84780065549801,40.9972694898098,NaN,NaN,-15.248573658568173,-120.60989575800122,0.09280153411188852,-0.7051709936311212,-0.7979725277430098,-653046782,-672890998.8,30.907365241245643,28.099154022730573,NaN,NaN,-17.40674984150413,-21.28947351553896
2020-11-04T09:30:00-05:00,29.57,30.28,28.77,29.57,43613251,29159795.4,46.12920234309743,41.07217245076407,NaN,NaN,-24.936065540770176,-79.0084926410432,0.1267221580537039,-0.6395698301758799,-0.7662919882295838,-609433531,-647734744.2,43.54765317114024,29.072522641856217,NaN,NaN,-15.955882349064607,-20.527531920328336
2020-11-05T09:30:00-05:00,29.61,30.16,29.51,29.57,31795591,29221421.65,46.12920234309743,41.457218343180735,NaN,NaN,-0.43804926689945073,-42.09431700608542,0.14832610084956,-0.5808843621676338,-0.7292104630171938,-609433531,-630028670.6,50.42260810630633,30.37307071724393,NaN,NaN,-14.778176251691058,-19.706195396237295
2020-11-06T09:30:00-05:00,29.57,30.01,28.81,28.93,33223222,29606800.6,42.07228595749441,41.80454007386135,NaN,NaN,-43.312114002727334,-24.24866803153086,0.11989630210628754,-0.5793400853843345,-0.699236387490622,-642656753,-626547985,51.6686817502359,31.846537355821606,NaN,NaN,-14.889713209378492,-19.018126512400322
2020-11-09T09:30:00-05:00,32.4,33.79,28.9169,33.06,99356706,33740405.75,64.0465846935381,43.503760405704966,NaN,NaN,212.71651737209373,25.756342980625725,0.36573364899430794,-0.24206932624773714,-0.6078029752420451,-543300047,-611574128.8,56.70955345760869,33.45278808356468,NaN,NaN,-6.177491096166647,-17.18375002436694
2020-11-10T09:30:00-05:00,33.68,34.13,32.98,34.13,73338096,36138182.25,67.48766783885182,45.6743583033303,NaN,NaN,297.2778022826987,88.2616181688791,0.5744734971271954,0.11028889616694926,-0.46418460096024616,-469961951,-574957162.6,66.03790426520317,35.83485531427926,NaN,NaN,1.9922906046058502,-14.4443156487994
2020-11-11T09:30:00-05:00,34.5,34.57,33.46,33.78,46542504,37103157.4,65.28652847165202,47.0044890560144,NaN,NaN,241.29333521536532,141.5074983201062,0.6570884400479015,0.3571759490996307,-0.29991249094827077,-516504455,-556371347.4,69.61666147360152,38.52811044157222,NaN,NaN,7.310020287837135,-11.336553372137038
2020-11-12T09:30:00-05:00,33.19,33.66,32.34,32.69,38598610,38015058.7,58.84918462221249,47.94113341566064,NaN,NaN,147.47730565252226,171.09056930399055,0.6075972153091793,0.4595840281882033,-0.14801318712097594,-555103065,-545505254.2,71.50705241518618,41.440385392161396,NaN,NaN,9.31633240885575,-8.386141117709496
2020-11-13T09:30:00-05:00,32.94,34.045,32.9,33.88,39440989,39051533.75,63.124129853945824,49.62329095228522,NaN,NaN,149.95902987111367,209.74479807875872,0.6220182523307747,0.6295096282924924,0.007491375961717728,-515662076,-520106318.8,75.3653006992547,44.73392561745516,NaN,NaN,12.510729288111078,-5.400873916877986
2020-11-16T09:30:00-05:00,35.32,36.19,34.885,36.11,47932662,40188864.55,69.51525427243146,51.898061269107345,NaN,NaN,187.78888708173537,204.75927202068706,0.7406949471991133,0.9333600599606093,0.19266511276149606,-467729414,-504992192.2,77.33233446092373,48.436199660101416,NaN,NaN,17.778333769567627,-2.089558533100041
2020-11-17T09:30:00-05:00,35.64,36.5,35.17,36.48,39010057,40989678.2,70.43095556971956,54.61953159501888,NaN,NaN,159.51179832637646,177.2060712294226,0.7981067918764182,1.1902986026070188,0.3921918107306006,-428719357,-496743673.4,78.34842328142486,52.47591769858189,NaN,NaN,22.060493406740346,1.3604488868771574
2020-11-18T09:30:00-05:00,36.79,36.93,35.42,35.42,41000176,41806852.15,64.45740059812866,56.44630046406146,NaN,NaN,130.73371792697876,155.0941477717453,0.7210310855064568,1.2934806676136716,0.5724495821072149,-469719533,-487386689,79.4725235702606,56.79710363231366,NaN,NaN,23.409480166071827,4.510310498190681
2020-11-19T09:30:00-05:00,35.17,36.07,34.81,36,32936212,41812277.3,66.14918577333108,58.309872667019874,NaN,NaN,106.28010572839835,146.85470778692053,0.6667192164538817,1.405848602674567,0.7391293862206852,-436783321,-463722740.2,82.01553878102926,61.339605432922326,NaN,NaN,25.043049620467844,7.443558944230276
2020-11-20T09:30:00-05:00,35.91,36.07,35.5617,35.81,19753247,41550553.35,65.05674314854315,59.61300901011011,NaN,NaN,98.06205068014316,136.47531194872641,0.5788632084475442,1.4627083967801155,0.8838451883325713,-456536568,-451897638.6,83.13958459706406,65.4350846621775,NaN,NaN,25.972829519931413,10.090597597901866
2020-11-23T09:30:00-05:00,36.37,38.39,36.33,38.34,38162335,41938621.65,71.74759185099342,61.462994095502644,NaN,NaN,126.11631035387514,124.14079660315437,0.6468526403578214,1.692410988779848,1.0455583484220266,-418374233,-442026602.4,84.03651126904535,69.2300236641632,NaN,NaN,29.192940325650795,12.819503701865997
2020-11-24T09:30:00-05:00,39.63,40.4163,39.275,40.31,53466025,43532084.95,75.65631210095702,63.572073363921184,NaN,NaN,157.17539789232796,123.67351651634468,0.7717466566618842,2.010241669249382,1.2384950125874976,-364908208,-429264372.6,85.13737293275597,72.20071793285003,NaN,NaN,33.377398177456854,15.756345769807549
2020-11-25T09:30:00-05:00,40.05,40.05,39.15,39.37,35676170,43288439.15,70.63469599850242,65.3224657678787,NaN,NaN,133.23570013296484,124.17391295754189,0.7382918448785076,2.161359818685632,1.4230679738071246,-400584378,-415437341.6,86.2441954696006,74.75940274451389,NaN,NaN,34.9012267684589,18.491328769614885
2020-11-27T09:30:00-05:00,39.15,39.47,38.6,38.91,18755356,42363661.7,68.24743801244149,67.1921194860892,NaN,NaN,111.84025763063593,125.2859433379894,0.6362905740685596,2.218431191392824,1.5821406173242645,-419339734,-411948624.2,86.51702395619388,77.24857004493947,NaN,NaN,35.28676684564786,20.890677066191024
2020-11-30T09:30:00-05:00,38.48,38.53,36.695,36.76,41543555,42545653.55,58.325333118103714,66.78345865927245,NaN,NaN,68.0451878801047,119.2825707779817,0.38737069909281496,2.066353991190283,1.678983292097468,-460883289,-412817968.4,86.05897642419947,79.34495739969596,NaN,NaN,32.09946391196109,22.491932329872462
2020-12-01T09:30:00-05:00,37.78,37.99,36.865,36.93,34479474,42175084.6,58.834947040922486,66.16540717370607,NaN,NaN,60.481670504703395,106.15564280814735,0.20658796435582372,1.9372182475422477,1.730630283186424,-426403815,-414423884.8,85.16202114352146,80.71096574814727,NaN,NaN,29.8191843892898,23.538682624074937
2020-12-02T09:30:00-05:00,36.81,38.71,36.685,38.13,37741795,42318301.65,62.33610264719356,65.95466247195904,NaN,NaN,68.89920642176939,88.50040451403564,0.14325053674191768,1.909693454113821,1.7664429173719034,-388662020,-419174647.2,82.42511906994363,81.62585557645741,NaN,NaN,29.043659440459308,24.32510788355842
2020-12-03T09:30:00-05:00,38.3,39,37.91,38.53,36487667,41962022.45,63.451963927654056,66.28343242234772,NaN,NaN,81.32099422183944,78.11746333181057,0.10546517695074797,1.8982743885603384,1.7928092116095904,-352174353,-409492642.2,83.58307439480622,82.48842857500172,NaN,NaN,28.769924141402285,24.96008163467897
2020-12-04T09:30:00-05:00,39.23,40.655,39.23,40.63,51850225,42964754.15,68.69561839966836,66.68139588989933,NaN,NaN,121.05204877654687,79.95982156099276,0.1939257812610009,2.0352164381858415,1.8412906569248406,-300324128,-385689521,86.02151798637894,83.24958695265343,NaN,NaN,30.26184333677715,25.71747616355014
2020-12-07T09:30:00-05:00,40.15,40.24,39.3,39.68,34656603,43036423.2,64.20768863428992,66.30228405860352,NaN,NaN,99.77447554726056,86.30567909442394,0.16179178830058172,2.0435303923005677,1.881738603999986,-334980731,-360509009.4,88.04454753188999,84.01474502915103,NaN,NaN,30.016195023772063,26.331578857867555
2020-12-08T09:30:00-05:00,39.19,40.665,39.18,40.27,28927347,39514955.25,65.70615263747285,65.9647981348716,NaN,NaN,101.39020213437142,94.48738542035754,0.15366640115294006,2.073821605441161,1.9201552042882208,-306053384,-336438923.2,89.5947627003017,84.81805498764223,NaN,NaN,30.287096598533125,26.896652820819778
2020-12-09T09:30:00-05:00,40.68,41.34,39.87,40.36,43345886,38015344.75,65.94039817034856,66.0707265328873,NaN,NaN,108.68292314375823,102.4441287647553,0.12875602050502866,2.0811002299195067,1.952344209414478,-262707498,-311248018.8,90.92151578280695,85.63584014568126,NaN,NaN,30.57190985787861,27.421689540399612
2020-12-10T09:30:00-05:00,40.41,42.08,40.3,41.6,38802190,37628329.05,69.07464804413111,66.27968812365874,NaN,NaN,123.93286759206465,110.96650343880034,0.16772782680143816,2.1620039929162758,1.9942761661148376,-223905308,-285594209.8,92.0352983340926,86.35153725661436,NaN,NaN,31.768002863623078,28.04259144371725
2020-12-11T09:30:00-05:00,41.32,41.33,40.54,41.12,28076100,37102203.55,66.5227207925135,66.38440081251376,NaN,NaN,103.40035832522386,107.43616534853575,0.13454811637549735,2.1624613115842095,2.027913195208712,-251981408,-275925665.8,92.41308463915324,87.01393011676359,NaN,NaN,32.00520912386898,28.608679683738924
2020-12-14T09:30:00-05:00,41.75,41.76,39.535,39.68,39942167,37127262.45,59.42929360466659,65.50452236634757,NaN,NaN,72.95671155625045,102.07261255033373,-0.0036870513159050766,2.0233043810638307,2.026991432379736,-291923575,-267314234.6,92.74324003317528,87.63583931420143,NaN,NaN,30.03980474284649,28.81312612075429
2020-12-15T09:30:00-05:00,39.9,40.66,39.525,40.46,29345761,36197917.4,61.80508576380814,64.51514905655122,NaN,NaN,62.51540597834109,94.29765331912766,-0.05883881123474266,1.9534429183363073,2.01228172957105,-262577814,-258619120.6,93.07110986697413,88.20253480950272,NaN,NaN,29.101222747679813,28.854282781743652
2020-12-16T09:30:00-05:00,40.56,40.71,39.98,40.26,23814426,35438135.85,60.82158726505949,63.814212718448154,NaN,NaN,61.476193071375,84.85630730465101,-0.1214315593545503,1.860492280377862,1.9819238397324124,-286392240,-263356069,90.66774572400651,88.51850268481743,NaN,NaN,28.052838568023024,28.739790751212134
2020-12-17T09:30:00-05:00,40.62,40.63,39.83,40.07,23181694,34547211.75,59.84726619742076,63.21420044594667,NaN,NaN,50.63228504503183,70.19619079524445,-0.18449201571175045,1.7513088200927243,1.9358008358044747,-309573934,-280489794.2,82.38125038270601,88.22309028671116,NaN,NaN,26.91589506982306,28.479234225299408
2020-12-18T09:30:00-05:00,39.99,40.21,39.09,39.4,36570153,34728908.8,56.41526924235751,63.07776731196479,NaN,NaN,14.134787648856468,52.343076659970976,-0.2747518732162033,1.5923609942842205,1.8671128675004238,-346144087,-299322330,74.33901863007875,87.38595044427396,NaN,NaN,24.9747663681333,27.978595959989963
2020-12-21T09:30:00-05:00,37.41,38.4646,37.015,38.13,40079448,35745218.85,50.50325406225719,62.48264638491727,NaN,NaN,-98.62546067271875,18.02664221417713,-0.41499260073700817,1.3483721165791636,1.7633647173161717,-386223535,-318182322,67.25779639100611,86.10707724766573,NaN,NaN,21.493803583970468,27.052197049130037
2020-12-22T09:30:00-05:00,38.05,38.18,37.45,37.49,25104196,35092311.9,47.785584121237015,61.44332363306323,NaN,NaN,-109.21415523316983,-16.319270028125054,-0.5380577383336684,1.0907925443990862,1.6288502827327547,-411327731,-347932305.4,57.89023365250803,84.35458543213461,NaN,NaN,17.73942876418741,25.721801579852517
2020-12-23T09:30:00-05:00,37.81,38.85,37.8,38.32,26965905,33767305.9,51.43547043250359,60.58500266912392,NaN,NaN,-62.03659810799208,-41.02182826399847,-0.5488679628085138,0.9427653292221123,1.4916332920306261,-384361826,-367526222.6,52.68554584599431,82.14761910721948,NaN,NaN,15.5427260996749,24.267647939827143
2020-12-24T09:30:00-05:00,38.37,38.37,37.74,38.12,11451452,32556070,50.51907919905922,59.28667844050898,NaN,NaN,-68.86368529268995,-64.92102233154284,-0.5532335052680242,0.8000914104455958,1.35332491571362,-395813278,-384774091.4,48.547852855372824,79.47092874071905,NaN,NaN,13.471020452844018,22.725272584543838
2020-12-28T09:30:00-05:00,38.26,38.74,37.7686,37.88,18912276,32563916,49.382096994976486,58.22770760912944,NaN,NaN,-60.77977903933538,-79.90393566918121,-0.5546225724316789,0.6600467001740213,1.2146692726057002,-414725554,-398490384.8,45.48833606808621,76.43119935044733,NaN,NaN,11.422577638299682,21.11060187793753
2020-12-29T09:30:00-05:00,38.11,38.22,37.45,37.63,18984254,31435950.95,48.1660435418058,56.97484267372465,NaN,NaN,-83.90247673662786,-76.95933888196302,-0.5534473049547584,0.5228601414122522,1.0763074463670106,-433709808,-407987639.4,43.446667326575955,73.13490682375264,NaN,NaN,9.361488955331419,19.432157174708085
2020-12-30T09:30:00-05:00,37.66,38.575,37.57,38.22,28218307,31122892.6,51.219065576009974,55.92331891698618,NaN,NaN,-68.94742001759863,-68.90599183884879,-0.49585811570200333,0.45648480173950645,0.9523429174415098,-405491501,-406820393.4,43.7806470254926,69.7677019125159,NaN,NaN,8.363048078346232,17.85085587522782
2020-12-31T09:30:00-05:00,38.05,38.21,37.73,37.9,18154851,30143545.4,49.51557378463076,54.52624218416473,NaN,NaN,-80.03515254501735,-72.50570272625384,-0.46287260678829845,0.3737521589561368,0.8366247657444352,-423646352,-414677298.6,41.98337816831417,66.19256475781744,NaN,NaN,7.057482145477668,16.308945342406368
2021-01-04T09:30:00-05:00,38.34,38.66,37.51,37.96,33858830,30012103.55,49.852352714114176,53.33550160713621,NaN,NaN,-71.44714093690597,-73.02239385509704,-0.4217316703907583,0.30946017775598733,0.7311918481467456,-389787522,-413472147.4,42.37414970958318,62.618355119991,NaN,NaN,6.042121747256933,14.84225625738502
2021-01-05T09:30:00-05:00,38.37,40.7,38.335,39.66,47736719,29806428.25,58.333536631873116,53.257233251936675,NaN,NaN,19.483916274336394,-56.969654792362675,-0.2720135654660304,0.3911748913142077,0.6631884567802381,-342050803,-398937197.2,47.00991854540347,59.35168929943587,NaN,NaN,7.490128077828402,13.791952231734076
2021-01-06T09:30:00-05:00,40.44,41.25,39.92,40.87,43131166,30230156.4,63.1151559992763,53.35080969732726,NaN,NaN,80.22038339253696,-24.14508276652972,-0.09274054658763309,0.5472627735456967,0.6400033201333298,-298919637,-371979163,54.34568666922701,56.58558764245394,NaN,NaN,10.262866906696503,13.287797185300137
2021-01-07T09:30:00-05:00,41.23,41.89,40.8,41.47,25727420,30070160.05,65.24503892710919,53.66677053033078,NaN,NaN,111.17808487297775,11.880018211585556,0.0569417314352576,0.7111804844274019,0.6542387529921443,-273192217,-345519306.2,60.17351721151657,54.407428462990374,NaN,NaN,13.253649898195105,13.28291900142799
2021-01-08T09:30:00-05:00,42,42,41.09,41.42,31371973,29471464.4,64.90867149545045,54.028299480190036,NaN,NaN,110.8679561005394,50.0606399406969,0.13861925080007487,0.8275128164922378,0.688893565692163,-304564190,-321702873.8,64.55888818849135,53.134402591975054,NaN,NaN,15.583940237205454,13.61163632082477
2021-01-11T09:30:00-05:00,40.52,42.235,40.29,42.07,23451593,28703934.55,67.270933673054,54.803704082382644,NaN,NaN,111.01158579448916,86.55238528697592,0.21774745773832271,0.9610778878650663,0.7433304301267436,-281112597,-299967888.8,68.01974497583929,52.68302590238651,NaN,NaN,18.294006228956647,14.280546307700753
2021-01-12T09:30:00-05:00,42.58,43.77,42.26,43.54,43973039,29498781.5,71.8810879677413,56.33069221848866,NaN,NaN,178.30563754752566,118.31672954161377,0.3429639675036269,1.1720353895062772,0.8290714220026503,-237139558,-278985639.8,70.9671716668714,52.947981279234035,NaN,NaN,22.248362073461518,15.418805702809433
2021-01-13T09:30:00-05:00,43.69,43.71,42.87,43.2,27382210,28870783.65,69.44458742575173,57.877763883096854,NaN,NaN,157.08728043997132,133.69010895110063,0.37421202048338265,1.2968364476068786,0.9226244271234959,-264521768,-272106066,71.88220421508309,53.947407747989395,NaN,NaN,24.77297460999736,16.75511554669342
2021-01-14T09:30:00-05:00,43.47,45,43.43,44.48,41657302,29486360.7,73.13634151171253,59.427826103040346,NaN,NaN,168.86895888025293,145.22828375255568,0.4474561011439382,1.4819445535534186,1.0344884524094804,-222864466,-262040515.8,73.21247617000655,55.41361705684741,NaN,NaN,28.206531132418387,18.391032058939846
2021-01-15T09:30:00-05:00,43.69,43.7,42.33,42.75,47748499,30683064.35,62.19820626125277,60.2620494646256,NaN,NaN,102.96677479021068,143.64804749048994,0.3500718915614951,1.4720783168613494,1.1220064252998543,-270612965,-255250270.8,74.1025950629073,57.238955785957025,NaN,NaN,27.624815245305196,19.710143942706324
2021-01-19T09:30:00-05:00,43.27,43.91,43.13,43.61,27809736,30914466.45,65.000471756477,61.37764766187565,NaN,NaN,108.36005750777042,143.1177418331462,0.31533608109475364,1.5161765266682963,1.2008404455735426,-242803229,-247588397.2,75.10770732060033,59.354625161136596,NaN,NaN,28.0753316006259,20.90517075098055
2021-01-20T09:30:00-05:00,43.98,44.09,43.34,43.77,25362807,30354099.15,65.5126985585758,62.61669444878779,NaN,NaN,100.41763137217308,127.54014059807568,0.27629690268831064,1.546211573933931,1.2699146712456204,-217440422,-243648570,75.63144636242711,61.65353794941167,NaN,NaN,28.590418792906807,22.003063328398586
2021-01-21T09:30:00-05:00,43.53,43.75,41.895,42.29,29995048,29849879.15,57.176901360147276,63.04225414765474,NaN,NaN,61.671716097603884,108.45702772960219,0.13131624967728794,1.4340599833422303,1.3027437336649423,-247435470,-240231310.4,76.10113792100438,63.96214444194823,NaN,NaN,26.29519344967033,22.616224774294547
2021-01-22T09:30:00-05:00,41.36,42.185,41.02,42.07,25222345,29855786.6,56.03552017878924,63.50796460438035,NaN,NaN,30.08734458472847,80.70070487049729,0.007644618326251296,1.3122995065727565,1.3046548882465052,-272657815,-250189980.2,71.76028377852086,66.08906627124871,NaN,NaN,24.113095119630092,22.83006339505677
2021-01-25T09:30:00-05:00,41.61,41.77,40.88,41.64,40911640,30553073.35,53.775935982915605,63.788220552151884,NaN,NaN,15.481978663050414,63.20374564506525,-0.10960699283277942,1.1676461472055308,1.2772531400383103,-313569455,-258781278.2,68.14881010003067,67.93011344199496,NaN,NaN,21.627688622972318,22.658295570473275
2021-01-26T09:30:00-05:00,42.01,42.64,40.73,40.75,27499841,31355492.8,49.34107545370838,63.145901896568695,NaN,NaN,8.68362410673832,43.26845896485882,-0.2457944453541121,0.9700100833456702,1.2158045286997823,-341069296,-278434491.6,60.63156740353306,68.90308836043279,NaN,NaN,18.116173595333247,22.009421002596127
2021-01-27T09:30:00-05:00,40.08,41.32,39.51,40.2,49933331,32906545.55,46.77391464928619,61.9786703715694,NaN,NaN,-37.19321560309117,15.746289569805981,-0.36445312413479014,0.7602381235312947,1.1246912476660849,-391002627,-313146932.6,50.1163952304022,68.60099611480244,NaN,NaN,14.398361766635947,20.922126826030386
2021-01-28T09:30:00-05:00,40.53,41.16,40.16,40.67,28624097,33388537.7,49.205988866077874,60.83302393863858,NaN,NaN,-33.86808241630501,-3.361670132975793,-0.39998014362253653,0.6247160681379142,1.0246962117604508,-362378530,-336135544.6,44.59989423794356,67.48859447383293,NaN,NaN,12.000898951904961,19.647665701155326
2021-01-29T09:30:00-05:00,40.1,40.62,39.175,39.32,31533090,33554276.85,43.112376119831936,59.27614569752298,NaN,NaN,-86.65158832039491,-26.70945671400047,-0.4967759770193547,0.4037262404862574,0.9005022175056121,-393911620,-360386305.6,39.642614072121226,65.70886060837793,NaN,NaN,7.928876183300878,17.973552912890405
2021-02-01T09:30:00-05:00,39.8,40,38.94,39.6,30510700,34172069.3,44.643582772131175,57.65990634745707,NaN,NaN,-105.32401437389338,-50.87065532138923,-0.5217446735041456,0.2483213756254301,0.7700660491295757,-363400920,-370352598.6,37.78391307655674,63.54915832985775,NaN,NaN,5.0700050862771375,16.130188937659938
2021-02-02T09:30:00-05:00,40.55,40.99,40.025,40.03,31964506,34077353.1,47.002779793927985,55.88288433504182,NaN,NaN,-73.43738428497369,-67.29485699973164,-0.4896228005451524,0.1580375484481351,0.6476603489932875,-331436414,-368426022.2,38.38532039681543,61.221883239139466,NaN,NaN,3.3693423036667722,14.307210847089486
2021-02-03T09:30:00-05:00,40.24,41.849,40.09,41.74,37192842,33550159.25,55.18278278325164,54.86418400343467,NaN,NaN,-31.00059582608156,-66.0563330443297,-0.34059898725674587,0.22191161492235523,0.5625106021791011,-294243572,-349074211.2,44.21814638355463,59.245879108316004,NaN,NaN,4.404554444386237,12.892545646703308
2021-02-04T09:30:00-05:00,42.05,42.21,41.305,42.2,24163900,32601795.95,57.10098376670837,53.718801307362945,NaN,NaN,5.468241552572471,-58.189068250554215,-0.20511116286357822,0.3061216485996283,0.5112328114632065,-270079672,-330614439.6,49.16207337138258,57.52799319412857,NaN,NaN,5.850897971090934,11.886595978758683
2021-02-05T09:30:00-05:00,42.86,43,42.435,42.56,24098229,32520336.4,58.594588495999034,53.46140003841625,NaN,NaN,46.51199476276694,-31.556351633921842,-0.0911242062638486,0.3973275536333958,0.4884517598972444,-245981443,-301028404.2,55.90722439058067,56.22832386039096,NaN,NaN,7.49069520255208,11.25861015358631
2021-02-08T09:30:00-05:00,43.18,44.5481,43.14,44.34,31184121,32510943.8,65.07027352339753,53.46638587891058,NaN,NaN,109.16591122831555,11.341633486519939,0.09423981144419202,0.6062515242024844,0.5120117127582924,-214797322,-271307684.6,61.44172762653234,55.252182453671814,NaN,NaN,11.139917771250389,11.241654098966894
2021-02-09T09:30:00-05:00,43.99,44.13,43.285,43.87,32399363,32958332.3,62.29965464058854,53.23688274191149,NaN,NaN,85.14389728032845,43.057889799580366,0.17081996496091434,0.7255366689594354,0.554716703998521,-247196685,-254459738.8,64.18605366168524,54.43465440361882,NaN,NaN,13.239081025519939,11.527000802760186
2021-02-10T09:30:00-05:00,44.02,44.75,43.74,44.71,29225494,32220955.05,65.15525580006988,53.80676520190597,NaN,NaN,109.87412939809155,71.23283484441498,0.2584138480538014,0.8777340140657728,0.6193201660119714,-217971191,-239205262.6,66.51021125728957,53.749588213353476,NaN,NaN,15.921212248231914,12.154745294970434
2021-02-11T09:30:00-05:00,44.57,44.58,43.085,44.02,24816343,32092661.7,61.06368811221185,54.165920054293295,NaN,NaN,81.44000598534286,86.42718773096905,0.25008910430738285,0.9319315463961999,0.6818424420888171,-242787534,-233746835,67.32727087194488,53.43294443431234,NaN,NaN,16.895792868577864,12.83203780548578
2021-02-12T09:30:00-05:00,43.705,44.71,43.63,44.67,23700434,31194818.3,63.395652454961954,54.853042659439474,NaN,NaN,102.55456549486456,97.63570187738858,0.2670264861929905,1.0156255498300553,0.7485990636370647,-219087100,-228367966.4,68.15185235691348,53.4331617383754,NaN,NaN,18.430917672956088,13.631877786552968
2021-02-16T09:30:00-05:00,45.7,46.32,45.465,45.79,38296698,30722228.25,67.05683789201068,56.11845426217535,NaN,NaN,152.6652943071777,106.33557849316102,0.3282954880882707,1.1589684237474032,0.8306729356591325,-180790402,-221566582.4,69.2100061960042,54.04590736640905,NaN,NaN,20.928410819802785,14.674239648445798
2021-02-17T09:30:00-05:00,46.26,46.765,45.59,46.47,34535375,31058510.2,69.07900958018416,57.71167532866806,NaN,NaN,151.40080308908134,119.58695965491161,0.38531084433336515,1.3123114910758389,0.9270006467424737,-146255027,-201378250.8,72.16615109006099,55.62088992781325,NaN,NaN,23.646759486051412,15.956028196675172
2021-02-18T09:30:00-05:00,46.27,46.36,45.275,45.42,30680058,31324372.75,62.68088179698446,58.67416768087567,NaN,NaN,117.02473641409745,121.01708105811278,0.32538849894479305,1.333736270423465,1.008347771478672,-176935085,-193171029.6,73.2889139903245,57.67010562441188,NaN,NaN,23.963525963502136,17.099956449079023
2021-02-19T09:30:00-05:00,45.48,46.36,45.425,46.18,27202087,31184724.7,65.19376785253573,60.25140994749736,NaN,NaN,111.06378380044303,126.94183662113281,0.3100814412957873,1.395949573098406,1.0858681318026187,-149732998,-174560122.4,75.68421034947377,60.24450535850849,NaN,NaN,25.016964783665628,18.230957639734253
2021-02-22T09:30:00-05:00,46.49,48.465,46.41,47.78,37821521,31814683.5,69.80362352027241,62.04855571522173,NaN,NaN,141.04008872601918,134.63894126736372,0.37644090219495285,1.5564192595463098,1.179978357351357,-111911477,-153124997.8,78.11807481260855,63.125516911083615,NaN,NaN,27.48290131590634,19.55266387918741
2021-02-23T09:30:00-05:00,48.35,48.71,46.51,48.57,49183045,32228253.75,71.79027190177078,63.81909086578194,NaN,NaN,134.44930554925682,130.99574351577957,0.4379583895280139,1.7274263442613744,1.2894679547333605,-62728432,-129512603.8,80.44060860418948,66.12946606875319,NaN,NaN,30.162737921503552,21.06838874237543
2021-02-24T09:30:00-05:00,48.89,50.58,48.48,50.29,38874435,32796983.45,75.56032631441086,65.27462968943617,NaN,NaN,166.4308531370743,134.00175352537815,0.5515684048864504,1.9789284608414235,1.427360055954973,-23853997,-105032397.8,82.51291370461196,68.86480659168586,NaN,NaN,33.8138095298341,22.88916314058381
2021-02-25T09:30:00-05:00,50.81,50.81,48.98,49.32,37943918,32197512.8,69.88778140506092,66.18797237788992,NaN,NaN,145.67665320245104,139.73213688304887,0.5189467312394109,2.0760434700042367,1.5570967387648258,-61797915,-82004963.8,84.20785493713107,71.36807670352503,NaN,NaN,34.896457492460684,24.60449090513765
2021-02-26T09:30:00-05:00,48.66,48.8,46.73,48.15,45154407,33024028.3,63.67805170824523,66.55107689305036,NaN,NaN,86.98943815943083,134.91726775484642,0.3824336326035116,2.0351387795192153,1.6527051469157037,-106952322,-73448828.6,84.79747165517567,73.43166579385324,NaN,NaN,33.69829194813654,25.903605339851776
2021-03-01T09:30:00-05:00,49.42,50.08,49.06,49.4,34695790,33182163.3,67.04686550999075,66.69226203494988,NaN,NaN,117.08247180654237,130.12574437095105,0.34152674653532533,2.0796135800848603,1.738086833549535,-72256532,-65517839.6,85.3437159695259,75.13895067549565,NaN,NaN,33.82786777477189,27.03564283055465
2021-03-02T09:30:00-05:00,49.58,49.98,49.1,49.13,37234004,33518328.5,65.6308936449411,66.93020767811791,NaN,NaN,105.85155317171106,124.40619389544193,0.26490713132561394,2.0692207477065523,1.8043136163809383,-109490536,-74870260.4,81.61940523779775,76.38419007378941,NaN,NaN,33.47649905434504,27.955765148238992
2021-03-03T09:30:00-05:00,49.49,50.98,49.48,49.85,41287218,33984464.1,67.59617971363159,67.10455938622947,NaN,NaN,114.66954167751499,114.05393160353006,0.2324957064397264,2.0949332494305963,1.86243754299087,-68203318,-83740124.6,78.13677430418113,77.21465886285308,NaN,NaN,33.79738986358819,28.79028296471745
2021-03-04T09:30:00-05:00,50.3,51.96,49.83,51.04,53786915,34814167.75,70.58953692624364,67.78497715866031,NaN,NaN,123.23598780128613,109.56579852329708,0.2589565764939763,2.1861332636083404,1.927176687114364,-14416403,-74263822.2,79.15988081769595,78.05984528754959,NaN,NaN,35.02180907300642,29.6805009801873
2021-03-05T09:30:00-05:00,52.49,53.07,51.18,52.95,56197882,36415866.85,74.63901890969332,68.58807476256969,NaN,NaN,146.01757485883792,121.37142586317847,0.3662888414674206,2.3850377389486397,2.018748897481219,41781479,-44517062,82.00637738197983,79.04945421791149,NaN,NaN,37.4730287986377,30.793719239965927
2021-03-08T09:30:00-05:00,53.47,53.75,52.28,53.05,50305048,37726207.8,74.83438825297257,69.14361407406696,NaN,NaN,147.22051752897647,127.39903500766529,0.4023383774765916,2.5216718693269584,2.119333491850367,92086527,-11648450.2,84.52203084340793,80.1431702641546,NaN,NaN,39.445711990477925,32.02971820432479
2021-03-09T09:30:00-05:00,52.75,53.5115,51.7475,52.12,59444769,39139240.2,69.4741826950533,69.17184072512904,NaN,NaN,118.05768220094761,129.8402608135126,0.3251702994211163,2.5257963661267624,2.200626066705646,32641758,16778008.6,86.3052778935213,81.15310789297321,NaN,NaN,39.432874290938365,33.08731193098387
2021-03-10T09:30:00-05:00,52.2,53.62,51.95,53.44,39208269,39479685.5,72.48650638839256,69.8722424816582,NaN,NaN,118.63604676989122,130.63356183198783,0.32393350712763347,2.605542950615188,2.2816094434875547,71850027,44788677.6,87.79718862923397,82.18941322432387,NaN,NaN,40.378129222020874,34.12885725827487
2021-03-11T09:30:00-05:00,53.55,54.365,53.34,53.46,25398699,39288345.75,72.53073691333323,70.3963117002866,NaN,NaN,124.862153542983,130.95879498032724,0.2866525354613252,2.639925112814211,2.353272577352886,97248726,67121703.4,88.8410036016252,83.12918417090613,NaN,NaN,41.138102946332076,35.13017807085447
2021-03-12T09:30:00-05:00,53.56,54.0493,53.165,53.57,29893370,39542197.1,72.78982950181522,70.60961212753965,NaN,NaN,113.90849289976528,124.5369785885127,0.23382435122598233,2.6455530163853638,2.4117286651593814,127142096,84193826.8,89.57511118870039,83.94754391205554,NaN,NaN,41.82922101853151,36.087184206236905
2021-03-15T09:30:00-04:00,53.45,53.6,52.32,52.96,30245850,39869467.9,68.90831304107361,70.40375792320414,NaN,NaN,88.20725960044484,112.73432700280637,0.1275391651210147,2.5711526215606497,2.443613456439635,96896246,85155770.6,89.61656100715224,84.60296908369574,NaN,NaN,41.3234884536481,36.83522767015279
2021-03-16T09:30:00-04:00,52.08,52.13,51.13,51.45,38643535,39886809.75,60.331833609307985,69.31600844426823,NaN,NaN,42.06686122006152,97.53616280662916,-0.06440677402977091,2.363104988902421,2.427511762932192,58252711,90277961.2,89.84802969941514,85.1269059404674,NaN,NaN,38.271479250276926,37.04040646731338
2021-03-17T09:30:00-04:00,51.3,52.1,50.86,51.85,32276128,39773847.4,61.69200786142113,68.73059604829395,NaN,NaN,37.1118192282839,81.23131729830769,-0.17794255640130308,2.205083567430563,2.383026123831866,90528839,94013723.6,90.0227210301494,85.54225351854014,NaN,NaN,36.13399199630212,36.91091868574034
2021-03-18T09:30:00-04:00,51.39,51.62,49.31,49.52,43603550,40420022,50.7712890224865,67.80868442788262,NaN,NaN,-18.432638597539313,52.57235887020323,-0.4101972933819793,1.8702795071043923,2.2804768004863716,46925289,83949036.2,85.74196784397107,85.60971753202553,NaN,NaN,30.52173972327019,35.99817883395889
2021-03-19T09:30:00-04:00,49.5,50.35,48.86,49.53,40579252,41088880.25,50.811534247485405,66.64901790913224,NaN,NaN,-50.081391922317565,19.774381905786676,-0.5544193381086893,1.5874526278505101,2.1418719659591994,87504541,76021525.2,82.41759860381775,85.40070914876067,NaN,NaN,26.12751024682549,34.58808332151126
2021-03-22T09:30:00-04:00,48.9,49.085,48.44,48.54,29780870,40686847.7,46.73787467366325,65.29951655404095,NaN,NaN,-90.70273921749217,-16.007617857800724,-0.6984578689056906,1.268799629827086,1.9672574987327767,57723671,68187010.2,79.1514594632568,85.22442730772202,NaN,NaN,21.091468670903744,32.65999551428162
2021-03-23T09:30:00-04:00,47.56,48.9,47.26,47.83,51598108,40807600.85,44.01261768829518,63.61497640937407,NaN,NaN,-119.43010828859656,-48.30701175953234,-0.8153697662943491,0.9480452908648402,1.7634150571591893,6125563,57761580.6,74.89791496480612,84.99308021205238,NaN,NaN,16.024680962884585,30.283522006939187
2021-03-24T09:30:00-04:00,48.56,49.69,48.56,49.03,40815358,40904647,49.384534937941815,62.10033341020966,NaN,NaN,-71.45857230030593,-70.02109006525029,-0.7854003700225489,0.7816645946310032,1.5670649646535522,46940921,49043997,71.44071355585588,84.44171112192093,NaN,NaN,13.263897053759823,27.85214701362785
2021-03-25T09:30:00-04:00,48.21,49.35,47.43,49.21,40335130,41024207.6,50.157070803839474,60.3516228312201,NaN,NaN,-84.02322568822717,-83.13920748338786,-0.7282436005031216,0.65676046402465,1.3850040645277717,87276051,57114149.4,72.6971298383822,83.77676486880682,NaN,NaN,11.262853012636603,25.482247870629102
2021-03-26T09:30:00-04:00,50.1,50.5,49.53,50.43,36174313,40575202.9,55.153254114970196,58.9458275356485,NaN,NaN,-32.4821293077264,-79.61935496046962,-0.5890123795998661,0.6487385900279392,1.2377509696278053,123450364,64303314,73.80279233959187,83.0111049756771,NaN,NaN,11.021682865508167,23.41645286989754
2021-03-29T09:30:00-04:00,50,50.26,49.22,49.83,23643070,40022566.9,52.37279409742558,57.72429977867508,NaN,NaN,-49.41561668660188,-71.36193045429158,-0.5204428830740948,0.5871973657851868,1.1076402488592816,99807294,72720038.6,75.07539251243134,82.20897030559924,NaN,NaN,9.991281631812077,21.49857126445676
2021-03-30T09:30:00-04:00,49.32,49.93,49.03,49.4,26696132,39495673.3,50.411350893775996,56.14750295763105,NaN,NaN,-62.936728195237,-60.06325443561966,-0.4877221153023512,0.4979876047313425,0.9857097200336937,73111162,86117158.4,76.99133066296083,81.4371233080083,NaN,NaN,8.563618230583433,19.650720831046286
2021-03-31T09:30:00-04:00,49.3,49.52,48.865,49.06,24048696,38633747.2,48.853378559808995,54.45626307523646,NaN,NaN,-71.631292006237,-60.09779837680588,-0.47233070582303527,0.3952963377548997,0.867627043577935,49062466,86541467.4,77.05149830326688,80.59501578669698,NaN,NaN,6.931475220204784,17.833685743783214
2021-04-01T09:30:00-04:00,49.28,50.33,49.02,50.31,32519753,37570389.1,54.429485760658,53.14480995086808,NaN,NaN,-38.24686526059252,-50.94252629127895,-0.3660612228226243,0.4100505150496545,0.7761117378722788,81582219,85402701,76.47350929315648,79.65918707987241,NaN,NaN,7.1219131131559585,16.303432510836462
2021-04-05T09:30:00-04:00,50.21,50.22,48.82,49.11,26686143,36094802.15,48.916059797348,51.71679186203054,NaN,NaN,-53.40710348813182,-55.12752112736003,-0.363920894620817,0.32121061959625763,0.6851315142170746,54896076,71691843.4,69.69470727458078,78.23619752754588,NaN,NaN,5.606201897853716,14.775256708981784
2021-04-06T09:30:00-04:00,49.35,50.005,48.9,48.98,26628902,34910994.85,48.34473472017282,50.8605705128066,NaN,NaN,-52.70732148022407,-55.785862086084464,-0.35804455325350537,0.23757582265019295,0.5956203759036983,28267174,57383819.4,63.38078452925159,76.34568001539132,NaN,NaN,4.215099734674391,13.2666628555093
2021-04-07T09:30:00-04:00,49,49.4,48.82,49.15,24944345,33185973.65,49.18062900815762,49.96690059471636,NaN,NaN,-56.408813082865116,-54.48027906361009,-0.3301732436301952,0.1829038213659544,0.5130770649961496,53211519,53403890.8,61.70619437833164,74.32307096883292,NaN,NaN,3.3020502499999154,11.843146769007959
2021-04-08T09:30:00-04:00,48.8,48.81,47.95,48.51,31883327,32819726.55,46.1526743415793,49.63699954608012,NaN,NaN,-86.89358413201995,-57.53273748876668,-0.34091675020587486,0.08693112723880603,0.4278478774446809,21328192,47857036,59.35252049372365,72.43811044381525,NaN,NaN,1.6615257642120609,10.388629482608545
2021-04-09T09:30:00-04:00,48.5,48.92,47.97,48.19,22186742,32659128.7,44.671716756308435,49.198441153853196,NaN,NaN,-89.95363297548997,-67.87409103174619,-0.3541014124585421,-0.014778888128496703,0.3393225243300454,-858550,31368882.2,52.893989260434424,70.32928120500216,NaN,NaN,-0.13176644134314938,8.885715779186874
2021-04-12T09:30:00-04:00,48.61,48.96,47.64,47.81,19598134,32144366.9,42.91083179771806,48.925080948428544,NaN,NaN,-105.16963435187164,-78.22659720449414,-0.3711469730973037,-0.12461119204158422,0.24653578105571947,-20456684,16298330.2,47.77656596680611,68.08821738382711,NaN,NaN,-2.1448113260393136,7.309926192725991
2021-04-13T09:30:00-04:00,47.73,48.12,47.38,47.86,22412666,31752707.7,43.22793753804762,48.869032366268,NaN,NaN,-131.64598806353982,-94.01433052115729,-0.36143139912270505,-0.20525346784766185,0.1561779312750432,1955982,11036091.8,46.09943616752541,66.03118318402134,NaN,NaN,-3.7441917182030076,5.730766491164705
2021-04-14T09:30:00-04:00,48.28,49.835,48.23,49.19,33383929,31489727.4,51.02128586523838,48.98594314678919,NaN,NaN,-10.54659770814098,-84.84188744621247,-0.2529413859084889,-0.15999880111056797,0.09294258479792096,35339911,7461770.2,44.94533428553419,64.13865609328408,NaN,NaN,-3.035877155069135,4.478388827417014
2021-04-15T09:30:00-04:00,49.25,49.25,48.59,48.79,24843124,31118077.2,48.84937757081745,48.892536487287614,NaN,NaN,-21.373489586494216,-71.73786853710732,-0.19805674734298853,-0.1546283493808147,0.04342839796217383,10496787,5295489.2,44.222730981613736,62.104770460657754,NaN,NaN,-3.0375730401373913,3.404679989194956
2021-04-16T09:30:00-04:00,49.15,49.27,48.195,48.4,28594505,30367624.95,46.75936919344257,48.292973278607064,NaN,NaN,-45.173447992141455,-62.78183154043761,-0.17855847451665446,-0.17976969518364427,-0.0012112206669897957,-18097718,1847655.6,43.03676790918354,59.90719728705715,NaN,NaN,-3.614645015676431,2.4019192742133293
2021-04-19T09:30:00-04:00,48.5,48.855,47.875,48.35,20413942,29359359.45,46.48477596990693,47.87240055521288,NaN,NaN,-70.65372991887942,-55.87865065383918,-0.16015684528863852,-0.20140727727778795,-0.041250431989149426,-38511660,-1763339.6,41.773228064910974,57.52847125509142,NaN,NaN,-4.166960335432051,1.4635079014068464
2021-04-20T09:30:00-04:00,48.18,48.25,46.59,47.07,36286963,29684664.1,40.00756631957608,47.129273085627176,NaN,NaN,-172.49026294701764,-64.04750563053474,-0.22153791148282853,-0.3181728213426851,-0.09663490985985657,-74798623,-17114260.6,36.82364841256081,54.65935109434855,NaN,NaN,-6.5575721123146,0.31763932801806827
2021-04-21T09:30:00-04:00,46.47,47.84,46.25,47.67,28495529,28529535.15,43.95012210343561,46.7790404816005,NaN,NaN,-162.76453815365926,-94.4910937196384,-0.20922539091270248,-0.35816664850073465,-0.14894125758803217,-46303094,-33442861.6,32.422946216465846,51.47159737386277,NaN,NaN,-7.470620599288534,-0.7949692330257321
2021-04-22T09:30:00-04:00,47.9,47.9157,46.9501,47.11,25031447,27740339.6,41.22689739267524,45.83599845531602,NaN,NaN,-133.4312033065375,-116.90263646364706,-0.2249202235551389,-0.4300915370319558,-0.20517131347681689,-71334541,-49809127.2,28.718357016997174,48.06051506842282,NaN,NaN,-9.044350100814432,-1.9734522141384034
2021-04-23T09:30:00-04:00,47.15,47.75,46.87,47.54,16952371,26571201.65,44.091512315753626,45.49138792091642,NaN,NaN,-111.2651190909046,-130.1209706833997,-0.1936546476713723,-0.44723962306603227,-0.25358497539465996,-54382170,-57066017.6,27.232552798010204,45.02750403438206,NaN,NaN,-9.552670527707722,-3.056197687505449
2021-04-26T09:30:00-04:00,47.36,48.22,47.36,47.86,17945890,25659780.5,46.193306301788205,45.337714462460376,NaN,NaN,-66.80710081669392,-129.3516448629626,-0.14117275555500386,-0.4300509198384148,-0.28887816428341095,-36436280,-56650941.6,27.46371618082395,42.46199915235151,NaN,NaN,-9.384651495156572,-3.960262517169895
2021-04-27T09:30:00-04:00,48.04,48.61,47.82,48.44,21134436,25534348.8,49.87169893928346,45.38707660039794,NaN,NaN,-17.5168467348224,-98.35696162052355,-0.06122972110053365,-0.36541531565907803,-0.3041855945585444,-15301844,-44751585.8,33.9423785102566,40.47886944748901,NaN,NaN,-8.179831868789584,-4.563058138829851
2021-04-28T09:30:00-04:00,48.8,50.3,48.76,50.11,32936985,25846391.45,58.639333962799014,46.278980859056496,NaN,NaN,121.42217130313931,-41.51961972916382,0.10143548787616319,-0.1773912347133404,-0.2788267225895036,17635141,-31963938.8,40.13087082763393,39.105894471339745,NaN,NaN,-4.195658006272169,-4.510572405607324
2021-04-29T09:30:00-04:00,50.83,51.2899,50.05,50.67,33021248,26295019.05,61.096552617584706,47.452183420576226,NaN,NaN,183.8539899620751,21.9374189245587,0.23635337536971707,0.016614996622642764,-0.2197383787470743,50656389,-7565752.8,49.79495803722659,38.88453509825347,NaN,NaN,-0.0976891651863716,-3.880160514118617
2021-04-30T09:30:00-04:00,49.95,50.64,49.28,49.39,29259482,26132005.5,53.301761715911525,48.19439270044719,NaN,NaN,107.01593002283666,65.59362874730695,0.22884396213259506,0.06631657391866952,-0.16252738821392554,21396907,7590062.6,54.687986201665055,39.37820797217197,NaN,NaN,0.9877917960869181,-3.1847387555178264
2021-05-03T09:30:00-04:00,49.96,50.88,49.8,50.75,22870043,25941200.5,59.25048574841439,49.3388604297591,NaN,NaN,152.14579926500832,109.3842087636474,0.30041458272199417,0.21299084018856718,-0.087423742533427,44266950,23730708.6,59.243652709196844,40.317080582291354,NaN,NaN,3.989932914402784,-2.159785659814882
2021-05-04T09:30:00-04:00,50.85,51.23,50.2,50.78,26958756,25957693.2,59.3734278225073,49.93544199813545,NaN,NaN,151.74347346563874,143.2362728037396,0.33223698780373284,0.32787249222123904,-0.004364495582493785,71225706,41036218.6,63.48284982970346,41.64118883544631,NaN,NaN,6.347776007910373,-0.9444197072827027
2021-05-05T09:30:00-04:00,51.41,52.575,51.41,52.42,23462144,25883583.15,65.50104130194794,51.12484655035905,NaN,NaN,203.0914827531242,159.5701350937366,0.43946700184435544,0.5449692567229505,0.10550225487859506,94687850,56446760.4,66.79500007777239,43.253493770886216,NaN,NaN,10.579559603837284,0.7018630514487239
2021-05-06T09:30:00-04:00,52.41,52.69,51.435,52.69,29355230,25757178.3,66.3995673085013,52.52771784429182,NaN,NaN,170.5300058913043,156.90533827958245,0.4999080361446083,0.7303873000593555,0.23047926391474716,124043080,71124098.6,69.62117001453615,45.15237963555426,NaN,NaN,14.209421293979918,2.63151422895318
2021-05-07T09:30:00-04:00,52.15,53.715,51.96,53.63,31598117,26227747.05,69.38876281152392,54.163716904407316,NaN,NaN,172.80522912471596,170.0631980999583,0.5694726687271368,0.942320099823668,0.37284743109653135,155641197,97972956.6,73.98339973918961,47.45310618371702,NaN,NaN,18.26977746845256,4.865551834595949
2021-05-10T09:30:00-04:00,54.3,55.14,53.61,53.65,34499000,26972790.35,69.45103480650528,56.26682179633084,NaN,NaN,179.35305066021505,175.50464837899966,0.5810989088526864,1.0992210671623894,0.518122158309703,190140197,127147606,77.72619752947608,50.37471683492525,NaN,NaN,21.481711346832814,7.239288907772644
2021-05-11T09:30:00-04:00,52.53,53.2821,51.81,52.27,56765912,28690452.65,60.33118791005144,57.43689792537483,NaN,NaN,100.56836380718485,165.2696264473089,0.46513184901833005,1.0995369695826156,0.6344051205642856,133374285,139577321.8,79.10537644105494,53.70917613668161,NaN,NaN,21.438797060946897,9.267790072511822
2021-05-12T09:30:00-04:00,52.54,54.07,52.28,52.52,41097761,29076144.25,61.322060381983505,58.87226671032543,NaN,NaN,103.85401200004884,145.4221322966938,0.3782336280174684,1.107197155586121,0.7289635275686527,174472046,155534161,80.75300576719883,57.42593676169601,NaN,NaN,21.706250289972807,11.044712960720535
2021-05-13T09:30:00-04:00,51.89,52.85,51.18,51.88,39849065,29826441.3,57.3712385744897,59.820818585949425,NaN,NaN,62.55092757744332,123.8263166339216,0.25645074863305084,1.0495269633599662,0.7930762147269154,134622981,157650141.2,80.9673313743452,61.264135231434224,NaN,NaN,20.722087146561112,12.42719498726919
2021-05-14T09:30:00-04:00,52.45,53.69,52.45,53.49,28591832,29826307.65,63.70607278255554,61.07173047743281,NaN,NaN,94.39624206254467,108.14451922148737,0.2621921414349182,1.1208163915205631,0.8586242500856449,163214813,159164864.4,81.12932759511227,65.09739318959768,NaN,NaN,21.887826416556077,13.778713762881601
2021-05-17T09:30:00-04:00,53.3,54.75,53.22,54.73,33702063,30490713.7,67.6886820839638,62.34437213062426,NaN,NaN,115.59359401657802,95.39262789275996,0.3233521796506824,1.262814474648998,0.9394622949983156,196916876,160520200.2,81.28283999661399,68.4788547243375,NaN,NaN,24.22695426911651,15.271319549486588
2021-05-18T09:30:00-04:00,54.65,54.845,53.36,53.46,35217682,30437249.65,60.380683061233725,62.46875420908388,NaN,NaN,94.46606435127222,94.17216800157743,0.25512211970167775,1.2583649446254128,1.003242824923735,161699194,166185182,81.94401080245265,71.4655075796817,NaN,NaN,23.705207462992803,16.476160679987476
2021-05-19T09:30:00-04:00,52.21,52.72,51.4,52.13,43984817,31211714.05,53.826599559085246,61.94947184776249,NaN,NaN,30.06221039312534,79.41380768019273,0.10495905066735789,1.1344416382579325,1.0294825875905746,117714377,154833648.2,76.14001133133758,73.34729710068962,NaN,NaN,20.96917916018969,17.118020462873506
2021-05-20T09:30:00-04:00,52.11,52.29,51.31,52.05,28261328,31373208.1,53.450769991958076,61.960115296051534,NaN,NaN,16.815766284778288,70.26677542165973,-0.009153388079422786,1.0180408524912963,1.027194240570719,89453049,145799661.8,71.78250216719496,74.56833395537033,NaN,NaN,18.741046683894456,17.349881351590785
2021-05-21T09:30:00-04:00,52.57,52.935,52.12,52.16,25269890,31789084.05,53.92712061288403,61.57987492922793,NaN,NaN,31.95859176105768,57.779245361362335,-0.08254180902943942,0.9240169792839197,1.006558788313359,114722939,136101287,67.32774865241674,75.14576937988603,NaN,NaN,17.117674246933614,17.316708908068332
2021-05-24T09:30:00-04:00,52.52,52.8,51.9319,52.68,24010194,32092299.25,56.20850940757196,61.35380932816112,NaN,NaN,29.17810948961362,40.49614845596945,-0.10020469064044979,0.8813029250127968,0.9815076156532466,138733133,124464538.4,62.32951871443678,75.06338858593843,NaN,NaN,16.436041924246776,17.190899338950967
2021-05-25T09:30:00-04:00,52.55,52.69,51.53,51.61,24279253,32249540.1,50.65068998080062,60.293069948079165,NaN,NaN,-12.318562118484072,19.13922316201819,-0.18325566504708235,0.7524380343443937,0.9356936993914761,114453880,115015475.6,58.52988628103929,74.47302331474319,NaN,NaN,14.124933360380618,16.752904199155203
2021-05-26T09:30:00-04:00,51.66,52.255,51.42,52.07,19777242,31591552.95,52.81093243783015,59.32245317160265,NaN,NaN,-24.3537339989354,8.256034283606024,-0.20487825755604738,0.6795958774464168,0.8844741350024642,134231122,118318824.6,59.460305539885496,73.74724728083957,NaN,NaN,12.851814999611003,16.19560574207746
2021-05-27T09:30:00-04:00,52.28,52.75,51.82,52.11,19526767,30916828.9,53.003584203180345,58.15208327100669,NaN,NaN,-7.183449023651424,3.456191221920085,-0.21320169813994372,0.6179720123275345,0.8311737104674782,153757889,131179792.6,62.94594958402573,72.95885798404215,NaN,NaN,11.87620946805024,15.578549131502143
2021-05-28T09:30:00-04:00,52.4,52.47,51.93,52.21,18565492,30382129.4,53.5145284692128,57.01376138977151,NaN,NaN,-22.152706029413533,-7.366068336174161,-0.208438169809969,0.570625998205017,0.779064168014986,172323381,142699881,65.78387045767442,72.10583462177064,NaN,NaN,11.207010202913986,14.954043570275264
2021-06-01T09:30:00-04:00,53.24,54.3375,53.21,54.22,36285148,31052884.65,62.370199067262305,57.159405043858,NaN,NaN,121.86411476012914,11.171132717928941,-0.07335488428446635,0.6873705626594031,0.7607254469438695,208608529,156674960.2,68.89604117530882,71.37659638850306,NaN,NaN,13.298075097747747,14.717476645628476
2021-06-02T09:30:00-04:00,54.55,55.49,53.91,55.23,33946723,31402283,65.8868997333515,57.48546499752714,NaN,NaN,176.07750065096025,48.8503452718178,0.07267853809793501,0.8515736195662882,0.7788950814683532,242555252,182295234.6,73.6312233740199,70.86789764613313,NaN,NaN,16.224091056921356,14.932707275813174
2021-06-03T09:30:00-04:00,55,55.69,54.65,55.38,29380829,31698217.25,66.38928375578928,58.129611081905686,NaN,NaN,171.0343779934643,87.92796767029775,0.1628711408398964,0.9824840075182237,0.8196128666783273,271936081,209836226.4,77.58212295352291,70.62609704464583,NaN,NaN,18.722087768086958,15.474047346138
2021-06-04T09:30:00-04:00,55.74,55.98,54.925,55.75,26329405,31546926,67.65466510383175,58.411653390568276,NaN,NaN,161.40384249572,121.64542597417203,0.2270044241401985,1.1033683968535755,0.876363972713377,298265486,238737745.8,80.82842921758204,70.60460430339366,NaN,NaN,21.172655203968482,16.288134182970925
2021-06-07T09:30:00-04:00,55.74,56.08,55.43,55.51,20035194,30968779.85,65.9210138411037,58.285391373221124,NaN,NaN,140.7286684622696,154.22170087250865,0.23199609425188972,1.166359090528239,0.9343629962763493,278230292,259919128,82.79483098283515,70.71260365955233,NaN,NaN,22.71995429023793,17.20696562686621
2021-06-08T09:30:00-04:00,55.32,56.09,54.66,55.99,28776500,30682654.85,67.70353097934134,58.80845193880024,NaN,NaN,121.80445078454271,154.20976807739137,0.2450772273067452,1.2407095304097808,0.9956323031030356,307006792,279598780.6,84.3962044337864,70.88776034750474,NaN,NaN,24.55043954379797,18.256033329285035
2021-06-09T09:30:00-04:00,56.15,56.39,55.61,55.64,28026119,29245665.2,65.03244055181705,59.60886915256679,NaN,NaN,119.0601491914498,142.80629778548928,0.2090157028614279,1.2569019316798204,1.0478862288183926,278980673,286883864.8,84.95447267933453,71.51736472950452,NaN,NaN,25.368535496114912,19.27210506740359
2021-06-10T09:30:00-04:00,56.39,56.65,54.98,55.57,28676949,28624624.6,64.48448267932412,60.39699148737865,NaN,NaN,98.52383962065389,128.3041901109272,0.1614354742493498,1.2496805716300798,1.08824509738073,250303724,282557393.4,83.05401907275588,72.32247307990173,NaN,NaN,25.903947938787514,20.21951119188701
2021-06-11T09:30:00-04:00,55.77,56.08,55.31,55.38,19045746,27584458.65,62.9344327605715,61.04037092649918,NaN,NaN,83.49482909919092,112.72238743162139,0.10110371546740415,1.2146247417149851,1.113521026247581,231257978,269155891.8,77.28662440304532,73.03382134780377,NaN,NaN,25.957023205861173,21.03915576531189
2021-06-14T09:30:00-04:00,55.58,55.92,54.6905,55.14,18872546,27098494.35,60.941707584616424,61.37845651057379,NaN,NaN,61.51867049762538,96.88038783869251,0.03252091609242136,1.1541721713631077,1.1216512552706863,212385432,255986919.8,71.99595970195907,73.72428141834108,NaN,NaN,25.488911092982754,21.674835097836297
2021-06-15T09:30:00-04:00,55.49,56.335,55.35,56.19,32142515,27020516.95,66.01214658947191,62.47570341119317,NaN,NaN,85.31117255508828,89.58173219280162,0.044612412572580196,1.1774167709864116,1.1328043584138314,244527947,243491150.8,67.28894640732639,74.34992857021872,NaN,NaN,26.450651237305234,22.357094546331858
2021-06-16T09:30:00-04:00,56.1,56.545,55.4,55.89,30393166,26779291.15,63.47665046492197,63.23754041312831,NaN,NaN,76.20266368371705,81.01023509125507,0.0203796116819126,1.1582788730162221,1.1378992613343095,214134781,230521972.4,62.706631505021384,74.58180899629986,NaN,NaN,26.572792722291595,22.959337142897535
2021-06-17T09:30:00-04:00,55.75,56.22,53.26,53.99,53470931,27253596.85,50.29954115541929,63.044394481145375,NaN,NaN,11.304352098508321,63.56633758682595,-0.12750494298237358,0.9785180826063424,1.106023025588716,160663850,212593997.6,56.934693690609414,74.15243357534155,NaN,NaN,22.463753261830856,22.888539445602294
2021-06-18T09:30:00-04:00,52.86,53.53,52.35,52.39,56906115,28685836.2,42.33042988508306,62.245530296564674,NaN,NaN,-70.54417404088875,32.75853695881001,-0.3257037599543171,0.6988933256458196,1.0245970856001367,103757735,187093949,49.89917678488059,73.0178125987134,NaN,NaN,15.949697708386829,21.8972763402858
2021-06-21T09:30:00-04:00,52.29,54.165,52.29,54.07,42183379,29531510.65,51.09230476550177,61.439966417867495,NaN,NaN,-40.14769074902229,12.425264709480482,-0.3349843902237992,0.6058665978203877,0.9408509880441869,145941114,173805085.4,46.66306299416911,71.42974272863201,NaN,NaN,13.412346667050624,20.68514352982363
2021-06-22T09:30:00-04:00,53.94,54.64,53.35,54.43,24172168,29539609.35,52.74898753092201,60.50154411769397,NaN,NaN,-14.613432704326637,-7.559656342402502,-0.3088440741010322,0.5547958954178966,0.8636399695189289,170113282,158922152.4,43.277882909805925,69.26164698118815,NaN,NaN,12.018092113958833,19.44699332755723
2021-06-23T09:30:00-04:00,54.93,55.55,54.48,54.58,20276486,29339471,53.45643667906145,59.577769326499116,NaN,NaN,17.863796254734172,-19.227429828199075,-0.27457070484745194,0.520426588459614,0.7949972933070659,190389768,154173149.8,42.22524436170687,66.73615565320128,NaN,NaN,11.15897082696883,18.26299011318746
2021-06-24T09:30:00-04:00,54.83,55.09,54.3,55.05,20878398,29394528.8,55.6947976067979,58.72349307671099,NaN,NaN,7.051143640203181,-20.0780715198601,-0.21594890750728535,0.5250611589229592,0.7410100664302446,211268166,164294013,45.27988479605312,64.19697390880637,NaN,NaN,11.155241947663805,17.247597518112652
2021-06-25T09:30:00-04:00,55.2,55.37,54.885,55.34,19164970,29376438.95,57.06678071672365,58.09104785354098,NaN,NaN,27.654214323216593,-0.4383938470389978,-0.15613402687938205,0.545842532831017,0.7019765597103991,230433136,189629093.2,52.106259837073985,62.00493311268057,NaN,NaN,11.566436263345572,16.436003053145928
2021-06-28T09:30:00-04:00,55.1,55.13,53.25,53.47,32851447,30090736.7,46.96693859621232,56.60986268331748,NaN,NaN,-92.38667244634065,-10.88619018650267,-0.23619723245873558,0.4067300191369796,0.6429272515957152,197581689,199957208.2,54.59310318622678,59.876140166426296,NaN,NaN,8.58692541229051,15.31470624730944
2021-06-29T09:30:00-04:00,53.79,54.09,53.14,53.21,15955477,29074253.15,45.754440989887414,55.232862714608224,NaN,NaN,-129.53004057926947,-33.86951176149124,-0.2964514870323057,0.272362892805333,0.5688143798376387,181626212,202259794.2,55.15220417053863,57.747406701512304,NaN,NaN,5.834834486899946,13.960438852965225
2021-06-30T09:30:00-04:00,53.37,54.0284,53.32,53.87,23517024,28552768.2,49.330391169289086,54.15042760674857,NaN,NaN,-93.27854816265584,-56.09798064496924,-0.2817433236712577,0.2166352252485666,0.4983785489198243,205143236,205210487.8,55.901554076953296,55.80794491609784,NaN,NaN,4.651660089983188,12.630613315396364
2021-07-01T09:30:00-04:00,55.1,55.27,54.3,54.81,23625827,28265018.1,53.98317156429791,53.511051807014745,NaN,NaN,-4.346586157008794,-58.37752660441163,-0.2023100993452206,0.2454909247382986,0.4478010240835192,228769063,208710667.2,56.8231600504874,54.346268890915134,NaN,NaN,5.120992720082452,11.557810373208662
2021-07-02T09:30:00-04:00,54.58,54.87,54.11,54.69,15235946,27710345.15,53.31017447935271,52.965942299495914,NaN,NaN,-20.54647048158736,-68.01766356537243,-0.15365809962268162,0.25572839955516713,0.40938649917784875,213533117,205330663.4,55.614452514063935,53.176161234636915,NaN,NaN,5.294085068003571,10.662992472465078
2021-07-06T09:30:00-04:00,54.51,54.61,52.69,52.91,34223122,28419741.55,44.456670948583884,51.42626546800391,NaN,NaN,-105.07087591754383,-70.55450425961305,-0.23243669741571005,0.11884062740821122,0.35127732482392127,179309995,201676324.6,54.27034280950927,52.246260977649975,NaN,NaN,2.539366095950175,9.502474418677235
2021-07-07T09:30:00-04:00,52.83,53.32,51.47,52.05,30411932,28501513.15,40.92068082025114,49.81512477909886,NaN,NaN,-167.48516179248028,-78.14552850225523,-0.3277145997560319,-0.05836592487111858,0.2693486748849133,148898063,195130694.8,51.85294677002598,51.47099778229316,NaN,NaN,-0.9253972396179736,8.012778467492204
2021-07-08T09:30:00-04:00,51.13,52.235,50.95,51.75,24689883,28334701.35,39.73344281703773,49.06040346921446,NaN,NaN,-180.17021266508164,-95.52386140274038,-0.3918545018614254,-0.22046945244186844,0.17138504941955696,124208180,178943683.6,46.35408089318598,50.71523972533434,NaN,NaN,-4.072194112305416,6.286353813235401
2021-07-09T09:30:00-04:00,52.414,52.89,51.8,52.85,25603035,28181005.65,45.92816918410439,49.31738484771598,NaN,NaN,-108.44956226761938,-116.3444566248625,-0.34287754398985276,-0.257211880567759,0.08566566342209375,149811215,163152114,41.70727226751397,50.13010368837958,NaN,NaN,-4.810053851777308,4.701152718233585
2021-07-12T09:30:00-04:00,52.25,53.085,51.88,52.77,20676528,28262544.75,45.56137323083126,48.922318309525224,NaN,NaN,-93.59121679527222,-130.95340588759947,-0.3000919388097735,-0.28944926009012306,0.010642678719650384,129134687,146272428,37.39234693222931,49.46790968395531,NaN,NaN,-5.5054425896710795,3.2430676742472047
2021-07-13T09:30:00-04:00,52.51,52.84,52.06,52.37,24893404,28563587.65,43.682872872049465,48.27473869103433,NaN,NaN,-93.44468860635865,-128.62816842536245,-0.28316752786443145,-0.3433167311108889,-0.06014920324645748,104241283,131258685.6,34.02089824609624,48.806696493690325,NaN,NaN,-6.635645335631713,1.8318229585502164
2021-07-14T09:30:00-04:00,52.53,53.14,50.61,50.81,33499696,28631446.7,37.23501696616202,47.11606585439866,NaN,NaN,-138.00562645852455,-122.73226135857131,-0.356722711992435,-0.5060525932370012,-0.14932988124456625,70741587,115627390.4,30.897366122309933,47.99756233373341,NaN,NaN,-9.72811851793341,0.18040274762398423
2021-07-15T09:30:00-04:00,50.26,50.87,49.86,50.1,29835401,28603558.45,34.722907025994246,45.618073670055544,NaN,NaN,-189.8466949630467,-124.6675578181643,-0.4280748116719755,-0.6844233958345356,-0.2563485841625601,40906186,98966991.6,27.951699885851284,46.75983484014757,NaN,NaN,-13.108075778899408,-1.7179513275936433
2021-07-16T09:30:00-04:00,50.48,50.5,48.585,48.68,37126896,27786356.7,30.317419303852105,43.70740499770757,NaN,NaN,-203.98938028179813,-143.77552142100006,-0.5386405379552052,-0.9296492566065666,-0.39100871865136144,3779290,69760606.6,23.688158572435512,44.72997046410196,NaN,NaN,-17.557208669095015,-3.9807023763795533
2021-07-19T09:30:00-04:00,47.02,47.63,46.3,46.96,57497409,27815921.4,26.012331753608777,42.210647366093035,NaN,NaN,-247.59036532455409,-174.57535112685645,-0.6859061960299943,-1.2483914636888542,-0.56248526765886,-53718119,33190045.4,19.647068637710348,42.23382513920793,NaN,NaN,-22.986919070063173,-6.695876189762927
2021-07-20T09:30:00-04:00,46.9799,48.09,46.58,47.59,41671023,27790303.6,29.936763145066024,41.080813234320075,NaN,NaN,-186.31858600436777,-193.15013060645828,-0.6969199222778379,-1.4336351705061574,-0.7367152482283195,-12047096,9932369.6,17.591680211766842,39.550930570724226,NaN,NaN,-26.003396118923284,-9.454093322500121
2021-07-21T09:30:00-04:00,48.53,49.65,48.42,49.25,41021322,28632761.3,39.10253121790321,40.350251809221085,NaN,NaN,-107.1621114969809,-186.98142761414954,-0.5546356043584144,-1.4300097536763374,-0.875374149317923,28974226,1578897.4,16.90751448405763,36.765642028374536,NaN,NaN,-25.398917108015016,-11.731925291859392
2021-07-22T09:30:00-04:00,49.2,49.2,48.28,48.7,23635028,28800688.4,37.35867982715456,39.162788113710846,NaN,NaN,-104.02085345296098,-169.8162593121324,-0.46349873159407284,-1.454747563810514,-0.9912488322164412,5339198,-5534500.2,16.32526518575216,33.87293525232202,NaN,NaN,-25.497955145598688,-13.69850098525072
2021-07-23T09:30:00-04:00,48.86,48.88,48.03,48.52,23475941,28930565.55,36.780560559994484,37.982101405185254,NaN,NaN,-98.80445177859009,-148.7792736114908,-0.3845286890511097,-1.4719096935303284,-1.0873810044792187,-18136743,-9917706.8,15.960531318831258,31.0405123098054,NaN,NaN,-25.755908415339785,-15.420987760977729
2021-07-26T09:30:00-04:00,48.64,49.92,48.55,49.72,23633103,29153972.2,43.10200479735421,37.885339537240284,NaN,NaN,-61.28203482365448,-111.51760751131087,-0.2283795253692693,-1.3728554111908053,-1.144475885821536,5496360,1925189,21.090290097551417,28.67050854466555,NaN,NaN,-23.935536573536584,-16.637351877057565
2021-07-27T09:30:00-04:00,49.33,49.41,48.68,49.26,23444182,28683608.95,41.39333796587173,37.919100761927474,NaN,NaN,-62.40031293904961,-86.73395289824725,-0.13745837975266606,-1.3162988605123687,-1.1788404807597026,-17947822,745043.8,20.9530367832524,26.463372117038865,NaN,NaN,-22.978807240285455,-17.543274071804408
2021-07-28T09:30:00-04:00,49.39,50.12,48.94,49.71,19584641,28865067.15,43.742846555437566,38.20548674324174,NaN,NaN,-42.117884946565965,-73.72510758816426,-0.03379975934943835,-1.2210901799465006,-1.1872904205970622,1636819,-4722437.6,20.294095760821094,24.601944607584237,NaN,NaN,-21.47877863089232,-18.105489008816967
2021-07-29T09:30:00-04:00,50.35,50.57,49.8901,50.19,21897010,28784066.45,46.21951664112714,38.226297275886225,NaN,NaN,-17.14313368786635,-56.34956363514535,0.07440007371794488,-1.094290328449631,-1.168690402167576,23533829,-1083511.4,22.051129153736355,23.19793438517155,NaN,NaN,-19.49182425608819,-18.303536901284286
2021-07-30T09:30:00-04:00,50.09,50.3,49.09,49.39,24800341,28842792.15,42.834812532483184,38.03154294028993,NaN,NaN,-33.13107198386774,-43.21488767620089,0.09791805435996714,-1.046292834217617,-1.1442108885775841,-1266512,2290534.8,23.72995628123813,22.222049338672182,NaN,NaN,-18.774234033646312,-18.370779348764575
2021-08-02T09:30:00-04:00,49.42,50.62,48.94,49.02,28905400,29526264.85,41.32740772988699,37.86329543013547,NaN,NaN,-29.901381815625246,-36.93875707459504,0.09434465944392656,-1.026280064272676,-1.1206247237166025,-30171912,-4843119.6,22.62066100153038,21.40774667834605,NaN,NaN,-18.60973905630679,-18.404916449842034
2021-08-03T09:30:00-04:00,48.86,49.96,48.4,49.86,32151045,29422661,45.97561121069834,38.4876235904595,NaN,NaN,-29.508330344895345,-30.360360555764185,0.15098258109804297,-0.9318964973440487,-1.0828790784420916,1979133,-857728.6,24.7374269577205,20.96775102373252,NaN,NaN,-17.097786728286877,-18.21818363247701
2021-08-04T09:30:00-04:00,48.96,49.565,48.435,48.51,32261915,29515160.15,40.4317588605517,38.89539872149932,NaN,NaN,-53.51427083009106,-32.63963773246921,0.1022859324448131,-0.9550216628860753,-1.0573075953308884,-30282782,-7241648.8,23.62267535492593,20.658534985809286,NaN,NaN,-17.440894056160626,-18.107142264431815
2021-08-05T09:30:00-04:00,48.81,49.6619,48.6,49.06,22899994,29425665.7,43.424873045515845,39.83164541733244,NaN,NaN,-35.0761403870619,-36.22623907230832,0.11114080550567995,-0.9183815884487885,-1.0295223939544684,-7382788,-13424972.2,22.562144864103303,20.578105435214123,NaN,NaN,-16.81751830771523,-17.92291027061516
2021-08-06T09:30:00-04:00,49.48,49.9,49.24,49.51,18107380,29050882.95,45.823453726418926,41.246725558247455,NaN,NaN,-0.312424725913599,-29.662509620717493,0.14896859158186204,-0.8433116544771408,-0.9922802460590029,10724592,-11026751.4,23.987525439080642,20.888138063883428,NaN,NaN,-15.586570089030536,-17.58914738753164
2021-08-09T09:30:00-04:00,48.85,49.2,48.48,48.81,21096707,29071891.9,42.784752325482614,42.164439071134346,NaN,NaN,-45.714212739873304,-32.82507580556704,0.12924320024010238,-0.8307262457588749,-0.9599694459989773,-10372115,-7066792,26.396661268976104,21.51706528225552,NaN,NaN,-15.429434076846926,-17.28061691457668
2021-08-10T09:30:00-04:00,49.07,49.8,49.01,49.67,26641536,29159298.5,47.3997658600662,42.757098688431704,NaN,NaN,28.42497710533274,-21.238414315521425,0.1737396140509062,-0.7427949284353446,-0.9165345424862508,16269421,-4208734.4,28.166240208427467,22.321259976853366,NaN,NaN,-13.90429766380702,-16.798285593038155
2021-08-11T09:30:00-04:00,49.54,50.145,49.23,50.06,23843077,28676467.55,49.39328399911594,43.61671327214323,NaN,NaN,80.10338976362347,5.48511780322148,0.2257661458907796,-0.6343268601227763,-0.8600930060135559,40112498,9870321.6,36.291828425330245,23.747443065394663,NaN,NaN,-12.050228635629741,-16.11999174197981
2021-08-12T09:30:00-04:00,50.02,50.29,49.4,50.01,18269054,28098150.2,49.136171075821025,44.49925688041655,NaN,NaN,95.66177861584467,31.632701603802793,0.2511907542657802,-0.5461045631813306,-0.7972953174471108,21843444,15715568,39.358788018616536,25.418747115379322,NaN,NaN,-10.608041794048338,-15.332570320846742
2021-08-13T09:30:00-04:00,50.04,50.04,49.3,49.42,16525361,27068073.45,46.08753110992608,44.71250875988598,NaN,NaN,53.926999638611626,42.48058647670784,0.223574939393531,-0.517826643205197,-0.741401582598728,5318083,14634266.2,38.984902919926476,26.696933745548968,NaN,NaN,-10.20359023040288,-14.59985887935476
2021-08-16T09:30:00-04:00,48.75,48.77,48.08,48.51,24129911,25399698.55,41.78162803273977,44.74024376466226,NaN,NaN,-104.89921563853402,30.643585896975697,0.14323085650914458,-0.5623630119622973,-0.7055938684714419,-18811828,12946323.6,38.37211859241726,27.94115387477503,NaN,NaN,-11.089950276070988,-14.098443364599936
2021-08-17T09:30:00-04:00,48.04,48.79,47.58,48.01,25554106,24593852.7,39.592806325723416,44.443812319682685,NaN,NaN,-168.97132582568548,-8.835674689227949,0.0598882764087898,-0.6307335229604547,-0.6906217993692445,-44365934,819252.6,34.21142882720642,28.93524909380255,NaN,NaN,-12.476801534051516,-13.866780245950162
2021-08-18T09:30:00-04:00,48,48.375,46.9501,47.01,28152884,23950430.8,35.57836018876539,43.68372971594256,NaN,NaN,-214.97853717142996,-67.85206007623864,-0.0530100772949611,-0.7568843959879459,-0.7038743186929848,-72518818,-21707010.6,28.1134995461654,29.368275550404626,NaN,NaN,-14.9189809013238,-14.017094625289253
2021-08-19T09:30:00-04:00,46.2,46.5,45.14,45.79,49628129,25250085.85,31.395942617891194,42.86666757918599,NaN,NaN,-300.075533222638,-146.99952244393518,-0.19243416439689798,-0.9444170241891072,-0.7519828597922092,-122146947,-50505088.8,22.573916054774486,29.28570124851436,NaN,NaN,-18.423305923285657,-14.646553382145882
2021-08-20T09:30:00-04:00,45.37,46.175,45.17,45.89,30793775,25615977.55,32.100526529209546,42.20760463628046,NaN,NaN,-234.7968915575335,-204.7443006831642,-0.2564973136453017,-1.0726045018488364,-0.8161071882035347,-91353172,-69839339.8,19.758941876122634,29.081292739556666,NaN,NaN,-21.02753319359321,-15.558121926638357
2021-08-23T09:30:00-04:00,47,47.74,46.9,47.61,29352209,25901932.85,42.95300270047865,41.991704028407625,NaN,NaN,-93.8413467773976,-202.5327269109369,-0.1659981662416644,-1.0236048960056152,-0.8576067297639508,-62000963,-78477166.8,18.640564428265947,28.645802558881343,NaN,NaN,-19.94823178354172,-16.185280477624552
2021-08-24T09:30:00-04:00,48.01,48.645,47.93,48.4,22691060,25864276.75,47.13259353144577,42.47033507632863,NaN,NaN,-27.99438873400884,-174.3373394926016,-0.04233856446704776,-0.9105299353477605,-0.8681913708807127,-39309903,-77465960.6,19.217018222438213,28.331112763703647,NaN,NaN,-17.693977463241367,-16.400808618426954
2021-08-25T09:30:00-04:00,48.3,49.035,47.98,48.77,19908774,25880483.4,49.01662802463734,42.86974614626588,NaN,NaN,-6.517205603470315,-132.64507317900967,0.06891600636892892,-0.7820463629195515,-0.8509623692884805,-19401129,-66842422.8,25.21218855434293,28.520401598720763,NaN,NaN,-15.277338899540254,-16.240312944300282
2021-08-26T09:30:00-04:00,48.49,48.76,47.95,48.03,20732666,25822266.2,45.52247897225677,42.84824794954001,NaN,NaN,-25.025156247914502,-77.63499778406495,0.09556851533886768,-0.7315017251148959,-0.8270702404537635,-40133795,-50439792.4,33.42718842731824,29.194663240737736,NaN,NaN,-14.303611948051689,-15.963641373407626
2021-08-27T09:30:00-04:00,48.63,49.64,48.52,49.31,23101326,25737315.45,51.908485818789906,43.49994319906195,NaN,NaN,43.67237489961266,-21.941144492635722,0.196490783317801,-0.5814567613065122,-0.7779475446243133,-17032469,-35575651.8,39.87272728490801,30.157239384732872,NaN,NaN,-11.378722160375393,-15.308652914403021
2021-08-30T09:30:00-04:00,49.5,49.69,48.71,48.73,15908886,25087489.75,49.099853148438214,43.62137800537425,NaN,NaN,37.867492231869804,4.400623309217773,0.21952468840359696,-0.503541684119817,-0.723066372523414,-32941355,-29763730.2,42.2280164638705,31.16165197440738,NaN,NaN,-9.851083985442424,-14.529000210265792
2021-08-31T09:30:00-04:00,48.49,48.93,48.28,48.4,26936587,24826766.85,47.52426529537651,43.48787666939286,NaN,NaN,2.835091933088938,10.566519442637333,0.20798627599426278,-0.46308352753058557,-0.6710698035248484,-59877942,-33877338,41.00372762490769,31.498216202948623,NaN,NaN,-9.083423428703616,-13.751060670042625
2021-09-01T09:30:00-04:00,48.35,48.63,47.51,47.69,31729917,24800166.95,44.23529147742192,43.137813840935785,NaN,NaN,-39.78140719923818,3.9136791234837447,0.15065871235588923,-0.4827464130799868,-0.633405125435876,-91607859,-48318684,36.95325769252024,31.326392608227458,NaN,NaN,-9.427375573523337,-13.133391370539869
2021-09-02T09:30:00-04:00,48.13,49.29,48.13,48.9,30821648,25196249.65,50.52001618114741,43.4544199174516,NaN,NaN,26.322635266961168,14.183237426458879,0.1898231342749891,-0.3961262075921397,-0.5859493418671288,-60786211,-52449167.2,35.86208014901359,31.10333383887654,NaN,NaN,-7.750503114313183,-12.364407333936056
2021-09-03T09:30:00-04:00,48.8,49.16,48.3904,48.62,19583983,25270079.8,49.13989138518764,43.98001015691216,NaN,NaN,26.69294600702907,10.787351647942161,0.19189283525937606,-0.3460832977929087,-0.5379761330522848,-80370194,-65116712.2,32.67539060120188,30.696424696646876,NaN,NaN,-6.807378844056797,-11.57054612109616
2021-09-07T09:30:00-04:00,48.39,48.995,48.15,48.33,21240800,25277284.45,47.68684941776574,44.55815609205804,NaN,NaN,9.217970697710394,5.0574473411102785,0.1695282474347568,-0.32606582375883875,-0.49559407119359555,-101610994,-78850640,29.603957639048616,30.36731961177846,NaN,NaN,-6.454577510915153,-10.839693462498873
2021-09-08T09:30:00-04:00,48.6,48.92,47.68,47.71,21899152,25040165.25,44.64724539849801,45.20593360703894,NaN,NaN,-18.14024899035633,0.8623791564212248,0.11157489117721442,-0.35612545722207756,-0.467700348399292,-123510146,-91577080.8,27.065161865154266,30.29243834884909,NaN,NaN,-7.042122380252315,-10.297183307892222
2021-09-09T09:30:00-04:00,47.39,48.56,47.135,47.81,25264757,25111249.25,45.253379459492905,46.19575052429621,NaN,NaN,-34.611820278997,1.89629654046946,0.08004761123578535,-0.3676408343545603,-0.44768844559034565,-98245389,-92904586.8,26.80691265241539,30.594795248680583,NaN,NaN,-7.3555641455456495,-9.87695199898557
2021-09-10T09:30:00-04:00,48.55,48.65,47.64,47.79,18756543,25135623.7,45.14689847679897,47.127634234838304,NaN,NaN,-9.304286459042865,-5.229087804731347,0.05889583172592078,-0.3740686559329447,-0.43296448765886547,-117001932,-104147731,24.66071364678767,30.944921803728082,NaN,NaN,-7.643035272150536,-9.557821038009136
2021-09-13T09:30:00-04:00,48.41,49.4905,48.41,49.16,34249834,26021847.35,53.25996952682781,47.8638461510061,NaN,NaN,96.58875853676342,8.750074701215523,0.1339283433059173,-0.26555405852646885,-0.39948240183238615,-82752098,-104624111.8,24.570950864499608,31.36852083488763,NaN,NaN,-5.54690101435599,-8.984832463201544
2021-09-14T09:30:00-04:00,49.6,49.689,48.235,48.45,29467876,26288745.6,49.198714076147986,48.0114261899134,NaN,NaN,69.71463148895026,20.849406859463496,0.1322679863732555,-0.2341474188658168,-0.3664154052390723,-112219974,-106745907.8,24.149322636431492,31.720828293030007,NaN,NaN,-4.929043388714933,-8.405434023989171
2021-09-15T09:30:00-04:00,49.14,50.3,49.06,50.26,38347479,26928414.25,57.9927553440902,48.6525781413029,NaN,NaN,154.62825184618634,55.403107026772034,0.24314411122314666,-0.062485266210138946,-0.3056293774332856,-73872495,-96818377.6,30.185674359569546,32.07607727911763,NaN,NaN,-1.4555630842139873,-7.412595318307002
2021-09-16T09:30:00-04:00,50.21,50.22,49.415,49.69,30321859,27036863,54.77693005168669,49.31361036126217,NaN,NaN,132.44827426000572,88.81512593457258,0.26630339848313256,0.027249870670630116,-0.23905352781250244,-104194354,-98008170.6,29.878777269594536,31.822619339280216,NaN,NaN,0.3623087884323787,-6.301894731629948
2021-09-17T09:30:00-04:00,49.44,50.22,49.191,49.32,32229525,26166932.8,52.732788382054494,49.37248911578108,NaN,NaN,112.7929198745447,113.23456720129009,0.2454259966429853,0.06772896799122918,-0.17769702865175613,-136423879,-101892560,28.84759019221636,31.035109546945097,NaN,NaN,1.2095833830311782,-5.228826429535501
2021-09-20T09:30:00-04:00,47.55,47.81,46.47,47.24,42830011,26768744.6,43.01477938689476,48.93784098995654,NaN,NaN,-165.98131839755047,60.72055181442731,0.08835409849091272,-0.06725440553811524,-0.15560850402902796,-179253890,-121192918.4,24.35069033980089,29.758157680940123,NaN,NaN,-1.348143145612141,-4.674443103260735
2021-09-21T09:30:00-04:00,47.8,48.05,46.85,47.35,25661747,26584221.5,43.606665794244314,48.65801245416139,NaN,NaN,-137.0912224567097,19.359381025295324,-0.006288596075459452,-0.16346924912335226,-0.1571806530478928,-153592143,-129467352.2,22.71579761245799,28.451876965765145,NaN,NaN,-3.1441907901595143,-4.455835629960561
2021-09-22T09:30:00-04:00,48.15,49.38,48.15,48.81,39626065,27430971.75,50.89673070051614,49.13382954152525,NaN,NaN,22.23617037330805,-7.119035269280336,0.029327630286193562,-0.12052111519015085,-0.1498487454763444,-113966078,-137486068.8,21.228337815226865,27.328668403101336,NaN,NaN,-2.288169269356216,-4.1461690070170825
2021-09-23T09:30:00-04:00,49.08,50.67,48.85,50.52,24867147,27678890.4,57.78074993497566,49.65245338108441,NaN,NaN,144.7050207208614,-4.6676859771091985,0.160608135664606,0.05091142410441307,-0.10969671156019292,-89098931,-134466984.2,23.265670945030266,26.428924888531096,NaN,NaN,0.8935478383709246,-3.4262094576759385
2021-09-24T09:30:00-04:00,50.25,51.16,50.15,50.9,27751526,28029833.4,59.151260830355255,50.36755119859639,NaN,NaN,188.644629645819,10.502655977145661,0.2597236654766131,0.21495787028557345,-0.04476579519103965,-61347405,-119451689.4,32.60211633106843,26.42369101209299,NaN,NaN,3.8412903699246117,-2.3879951965901456
2021-09-27T09:30:00-04:00,52.02,52.92,51.95,52.71,40848684,28917201.3,64.98222286530317,51.60293501627763,NaN,NaN,267.27328921033416,97.15357749872258,0.42415030837827283,0.4854220902818014,0.061271781903528555,-20498721,-87700655.6,47.22488843317029,27.68232892595882,NaN,NaN,8.492021455802622,-0.8337071033911789
2021-09-28T09:30:00-04:00,53.21,53.83,52.77,52.89,66487649,31446139.45,65.50950086434837,53.09309612098123,NaN,NaN,231.49773062201103,170.87136811446675,0.5159036589825857,0.7061513556317607,0.19024769664917499,45988928,-47784441.4,59.20725368856358,29.978192627630914,NaN,NaN,12.255742984116496,1.036214337681346
2021-09-29T09:30:00-04:00,52.84,53.22,52.19,52.89,34947178,31846669,65.50950086434837,54.53996193561376,NaN,NaN,168.3637162216045,200.09687728412604,0.5446339073540671,0.8710400808417589,0.32640617348769174,45988928,-15793440.2,65.89132936417168,32.76993667847065,NaN,NaN,15.200493796244919,3.0596828317618563
2021-09-30T09:30:00-04:00,52.74,53.03,52.09,52.09,44599415,32490143.9,60.79127046421089,55.657417077571765,NaN,NaN,129.2226206908401,197.00039727812177,0.48006094721518944,0.9264823575066785,0.4464214102914891,1389513,2304248.6,68.9871776676899,35.93611267996367,NaN,NaN,16.26926247873195,4.946765638471869
2021-10-01T09:30:00-04:00,52.47,53.89,52.47,53.84,41656005,33031861.75,66.47883909039558,56.60162204639803,NaN,NaN,146.51693026281785,188.57485740152154,0.5220332515677595,1.0989629747511884,0.5769297231834289,43045518,23182833.2,72.12996512952073,39.33318512746518,NaN,NaN,19.094326551309692,6.967845768877272
2021-10-04T09:30:00-04:00,54.415,55.315,54.165,54.72,57407887,34923056.95,68.9203011955974,58.01030684064442,NaN,NaN,163.07391761764356,167.73498308298343,0.5718746191305317,1.2917729970965937,0.7198983779660619,100453405,47373258.4,75.25840969367808,42.983834202982784,NaN,NaN,22.235650259822048,9.148960696155097
2021-10-05T09:30:00-04:00,55.5,56.05,54.465,55.04,49014807,36311757.3,69.7821797220721,58.85240858192884,NaN,NaN,148.46289259906905,151.128015478395,0.5869940865445405,1.4536409861467376,0.8666468996021971,149468212,68069115.2,77.57741248474065,46.36895835478072,NaN,NaN,25.024986922532715,11.41696444278047
2021-10-06T09:30:00-04:00,54.13,54.755,53.5,54.46,50087432,37721171.3,66.19888419809541,59.66826244952946,NaN,NaN,103.90197189177461,138.23566661242904,0.5207841764588845,1.5176271201758027,0.9968429437169182,99380780,78747485.6,78.68739575838714,49.85528824683734,NaN,NaN,26.25844235723817,13.537175573417285
2021-10-07T09:30:00-04:00,54.6,55.18,54.33,54.88,38798075,38397837.2,67.50032118512473,60.72308622117733,NaN,NaN,105.95384794380375,133.58191206302178,0.46970011239739806,1.5839680842136659,1.1142679718162678,138178855,106105354,81.24850738793167,53.59821090367415,NaN,NaN,27.66214369484593,15.555028162192805
2021-10-08T09:30:00-04:00,55.46,56.7,55.33,56.57,43100213,39615020.7,72.14739917375991,62.80398763452484,NaN,NaN,129.0739186545962,130.09330974137745,0.510752438119761,1.752708519465969,1.241956081346208,181279068,133752064,83.41718999693224,57.81724659346924,NaN,NaN,30.41702743448324,17.67817091537715
2021-10-11T09:30:00-04:00,57.42,57.59,56.305,56.36,43010749,40053066.45,70.79281086776133,64.74585513977605,NaN,NaN,128.46640038868128,123.171806295585,0.48498436785539667,1.8481865411654539,1.3632021733100572,138268319,141315046.8,83.96357899024832,62.192088120454265,NaN,NaN,32.22037768656872,19.755629025547375
2021-10-12T09:30:00-04:00,56.25,56.952,56.021,56.41,35519131,40355629.2,70.93274576855637,66.1769990732075,NaN,NaN,110.80674816139891,115.64057740805097,0.43417258785171375,1.9059179081246995,1.4717453202729858,173787450,146178894.4,84.32136519472321,66.69873293327542,NaN,NaN,33.716603866092996,21.750054002768177
2021-10-13T09:30:00-04:00,56,56.65,55.37,56.36,28951265,39885818.5,70.56863570204828,67.09041948514127,NaN,NaN,93.37475137444038,113.53513330458411,0.36295619969742576,1.9254405698947679,1.562484370197342,144836185,155269975.4,84.99521954876707,71.10798640497092,NaN,NaN,34.8477355995034,23.621151373730353
2021-10-14T09:30:00-04:00,57,57.29,56.48,57.05,23396112,39539531.15,72.65472091402603,68.05495234826061,NaN,NaN,104.49408656660296,113.24318102914394,0.3290816998313093,1.9738364949864788,1.6447547951551695,168232297,161280663.8,85.44076271718853,74.88217543255094,NaN,NaN,36.416821956321996,25.449104314100587
2021-10-15T09:30:00-04:00,57.69,57.91,57.3,57.33,22677414,39061925.6,73.47630001055288,68.66167214434986,NaN,NaN,109.20415729099305,109.26922875642333,0.2934728434440186,2.0115958494601927,1.718123006016174,190909711,163206792.4,85.58844107504041,77.6224291926845,NaN,NaN,37.96727430163732,27.23741431232012
2021-10-18T09:30:00-04:00,57.89,58.21,57.05,57.37,32628772,38551863.65,73.59833517129279,69.23944602341733,NaN,NaN,102.66742996546402,104.10943467177988,0.24265847779209127,2.021446103256288,1.7787876254641968,223538483,180260825.2,86.85936906857938,79.59758029125706,NaN,NaN,39.29386301278294,28.959764126671953
2021-10-19T09:30:00-04:00,57.61,58.22,57.295,58.02,22276253,38382588.95,75.56571642588978,69.957747134956,NaN,NaN,105.99976213539716,103.14803746657954,0.22335307370012214,2.0579789675893494,1.8346258938892273,245814736,194666282.4,87.8352520297932,81.16500333880144,NaN,NaN,41.0035608143826,30.68030651063062
2021-10-20T09:30:00-04:00,57.58,58.5,57.35,58.49,25106257,37656598.55,76.90579253113945,71.10878442545089,NaN,NaN,108.28300042605422,106.12968727690229,0.21281265114524017,2.1006417078207775,1.8878290566755374,270920993,219883244,89.32918014228292,82.6180035155581,NaN,NaN,42.85654749418698,32.419769508281526
2021-10-21T09:30:00-04:00,58.04,58.25,56.9401,57.41,32120878,38019285.1,67.71551511679772,71.19711842733676,NaN,NaN,82.15114625652446,101.66109921488659,0.1089160735825414,2.023974148653714,1.9150580750711728,238800115,233996807.6,90.06460819740398,83.89904944897833,NaN,NaN,41.92928734529849,33.77827205642681
2021-10-22T09:30:00-04:00,57.62,57.995,57.075,57.95,21502534,37706835.5,69.66731425727859,71.25047650317113,NaN,NaN,80.77128713438958,95.9745251835659,0.05508847056846644,1.9839186632817558,1.9288301927132894,260302649,247875395.2,90.74042172689488,85.00490745135096,NaN,NaN,41.680403354884646,34.9071479562065
2021-10-25T09:30:00-04:00,58.66,59.12,58.35,58.8,25056090,36917205.8,72.48693139398245,71.44367305116474,NaN,NaN,114.6353902233416,98.36811723514141,0.055122780715932906,1.9977336686082054,1.9426108878922725,285358739,260239446.4,91.30767627073404,85.98564057892192,NaN,NaN,42.28204266678556,35.96070434343208
2021-10-26T09:30:00-04:00,59,59.41,58.7796,59.14,22751590,34730402.85,73.54621387191261,71.96848231358025,NaN,NaN,121.12392082318699,101.39294897269937,0.0562422514453198,2.0129137021989223,1.9566714507536025,308110329,272698565,91.84952832842224,86.92579290535299,NaN,NaN,43.088666503796276,36.97898465205554
2021-10-27T09:30:00-04:00,58.5,58.82,57.31,57.44,34003784,34683233.15,60.917249665584215,71.49826291932735,NaN,NaN,63.86634277025762,92.50961744154007,-0.07233302635678962,1.8662551678076156,1.9385881941644052,274106545,273335675.4,91.87741208693639,87.68500038385332,NaN,NaN,39.77549770451636,37.378486516692796
2021-10-28T09:30:00-04:00,57.13,57.895,57.12,57.85,23367503,33621637.55,62.58588894192377,70.81529790276763,NaN,NaN,47.638582758699904,85.60710474197516,-0.14063819915686127,1.7627904452183287,1.90342864437519,297474048,285070462,92.39358339919416,88.32617134115775,NaN,NaN,37.579101899194846,37.40714585705023
2021-10-29T09:30:00-04:00,58.14,58.27,57.23,57.47,21998929,32638783.75,60.02780817332001,70.04636913887897,NaN,NaN,43.99221531970198,78.25129037903764,-0.2176819792523932,1.6313261703096984,1.8490081495620916,275475119,288104956,92.52585204407572,88.937762273574,NaN,NaN,34.986857493764504,37.06139037658084
2021-11-01T09:30:00-04:00,58.04,58.62,57.88,58.46,24828366,31009807.7,64.14009368436152,69.56117970429361,NaN,NaN,78.96371772091253,71.1169558785518,-0.20823784615088492,1.5887108418734854,1.7969486880243704,300303485,291093905.2,92.66122052887117,89.53346622601315,NaN,NaN,33.97912269392201,36.621066421915295
2021-11-02T09:30:00-04:00,58.12,58.57,57.72,57.91,17062698,29412202.25,60.42109466245248,68.83635534432248,NaN,NaN,58.22768576641832,58.53770886719807,-0.24288442777529862,1.493343153305247,1.7362275810805456,283240787,286119996.8,89.74818693270109,89.87296389629414,NaN,NaN,31.986217428474912,35.958945137138095
2021-11-03T09:30:00-04:00,57.21,58.03,56.97,57.43,23337358,28074698.55,57.29858628442608,67.73948858506535,NaN,NaN,5.395658310099781,46.843571975166505,-0.2983291649427122,1.3633161249021555,1.6616452898448677,259903429,283279373.6,88.04580625315116,90.05903843457718,NaN,NaN,29.37100629296007,35.01781101654123
2021-11-04T09:30:00-04:00,58.28,58.43,56.99,57.51,38181610,28043875.3,57.69103316042988,66.61196952434229,NaN,NaN,10.048482213974925,39.32555186622151,-0.3274854340862685,1.252288497237032,1.5797739313233006,298085039,283401571.8,88.05630181472112,90.23531420169722,NaN,NaN,27.362234669703806,33.92415725270731
2021-11-05T09:30:00-04:00,58.3,58.52,57.775,58.26,22603513,27019040.3,61.283484137667266,65.73233730765473,NaN,NaN,70.19106321288648,44.56532144485841,-0.2951319406521733,1.210859005508084,1.5059909461602572,320688552,292444258.4,88.8373369309019,90.37659762043457,NaN,NaN,26.646181123668704,32.88444637713037
2021-11-08T09:30:00-05:00,58.75,59.4,58.465,58.79,20011158,25869060.75,63.63344120223682,64.88003193453667,NaN,NaN,142.296689295758,57.23191575982751,-0.2392885639120299,1.2068802412702198,1.4461688051822497,340699710,300523503.4,89.49811694704219,90.49537368595234,NaN,NaN,26.722683669734092,32.00419456178804
2021-11-09T09:30:00-05:00,58.86,59.045,58.02,59.03,19688987,25077553.55,64.67892575112745,64.00668430739292,NaN,NaN,107.01419916763564,66.98921844007097,-0.18961132094271682,1.2091546540038536,1.3987659749465704,360388697,315953085.4,90.6379192559223,90.58885505121229,NaN,NaN,27.084271659696856,31.30134843291787
2021-11-10T09:30:00-05:00,58.78,58.97,57.125,57.47,36016457,25430813.15,53.84348435433345,63.01582496721691,NaN,NaN,-16.54930711079504,62.60022535589201,-0.26084268664424126,1.0727126166412688,1.33355530328551,324372240,328846847.6,91.47097125606571,90.68930955540243,NaN,NaN,24.009804107007422,30.25969924350209
2021-11-11T09:30:00-05:00,57.51,58.08,57.51,57.69,24498285,25485921.8,54.988702208847144,61.96735267804322,NaN,NaN,-40.04682911773922,52.58116308954917,-0.28993320513596,0.97113879686556,1.26107200200152,348870525,339003944.8,92.06961524107862,90.7842519492727,NaN,NaN,21.862902130075277,29.060156798726833
2021-11-12T09:30:00-05:00,57.45,57.78,57.2,57.55,17094986,25206800.4,54.069320115849145,60.65180901531942,NaN,NaN,-80.74738118363742,22.393474210244392,-0.3133992265037142,0.8693229688718773,1.1827221953755915,331775539,341221342.2,92.1983553345113,90.84787188239964,NaN,NaN,19.843444733256828,27.743483646516832
2021-11-15T09:30:00-05:00,57.5,58.365,57.01,58.03,21375656,24644144.6,56.73991390785751,59.45135901788691,NaN,NaN,-36.236742145602555,-13.313212078027721,-0.2918285426246272,0.8179365170948074,1.1097650597194346,353151195,343711639.2,92.34858429233553,90.88351873696487,NaN,NaN,18.878116870491375,26.477002678513195
2021-11-16T09:30:00-05:00,58.2,58.59,57.84,58.12,20479415,24554302.7,57.241920142120144,59.18883548049662,NaN,NaN,24.665989208156876,-29.782854069923474,-0.2673842479049984,0.7755347498381866,1.042918997743185,373630610,346360021.8,92.51368534011951,90.92896682647795,NaN,NaN,18.219792035704373,25.297401158111935
2021-11-17T09:30:00-05:00,57.55,58.38,57.03,57.23,23669489,24482464.3,50.94593816842375,58.35741042524662,NaN,NaN,-73.96781374263492,-41.26655539629145,-0.3043521276571587,0.6624788381717366,0.9668309658288953,349961121,351477798,92.83541019225979,90.96052588312548,NaN,NaN,15.792069705112933,23.939496664826365
2021-11-18T09:30:00-05:00,57.1,57.545,56.2,56.89,28955461,24324193.45,48.740412694127045,57.55116789101855,NaN,NaN,-165.63589152981228,-66.38436787870606,-0.3420806561108217,0.5392301456903681,0.8813108018011898,321005660,345904825,88.38123855400536,90.66448206240618,NaN,NaN,13.10737659829069,22.392050941035553
2021-11-19T09:30:00-05:00,55.66,55.81,54.55,54.67,45689812,25533557.35,37.36582164455227,55.63871988817504,NaN,NaN,-342.80138602152874,-118.79516884628433,-0.49750568959552044,0.25942868980678924,0.7569343794023097,275315848,334612886.8,80.0052162000191,89.76048175320246,NaN,NaN,6.5045087431926945,20.12240205562943
2021-11-22T09:30:00-05:00,54.59,56.48,54.58,55.64,33897329,25975619.3,43.56325660779065,54.43458859855633,NaN,NaN,-226.52586119640083,-156.85299265644397,-0.5138407115105166,0.1146334900141639,0.6284742015246805,309213177,325825283.2,74.1182750206319,88.64405947376895,NaN,NaN,3.0699424271702216,17.68633639442097
2021-11-23T09:30:00-05:00,56.37,57.54,56.32,57.35,33863649,26531222.25,52.488298036952045,54.09099658087962,NaN,NaN,-56.632168738862305,-173.11262424584783,-0.3937442818079079,0.1362938492647956,0.5300381310727035,343076826,319714526.4,70.24738543946579,87.37274370136285,NaN,NaN,3.3028909704153655,15.631558476705884
2021-11-24T09:30:00-05:00,57.05,58.24,56.9725,57.91,21434324,25902749.25,54.99818917405738,53.89865058185301,NaN,NaN,15.176888527642998,-155.28368379179224,-0.2669238051685762,0.19638337461198319,0.4633071797805594,364511150,322624532.2,71.0234810531768,86.15611364696682,NaN,NaN,4.370003720823661,14.02276494015128
2021-11-26T09:30:00-05:00,55.04,55.76,54.14,55.58,44727231,26970735.65,44.471561677152785,52.697798977530546,NaN,NaN,-201.84996371720365,-162.52649822927052,-0.32636164021000885,0.05535512951804833,0.3817167697280572,319783919,322380184,70.8563455107661,84.87175711695711,NaN,NaN,1.3242170528053987,12.20868667053044
2021-11-29T09:30:00-05:00,56.79,57.36,55.72,55.9,35441220,27642850.2,46.000224006202586,51.4382834635281,NaN,NaN,-84.97731456797402,-110.96168393855956,-0.3295660937495533,-0.030240847458884446,0.29932524629066887,355225139,338362042.2,75.00021399992664,83.83619262073458,NaN,NaN,-0.4279268986299355,10.403456160650386
2021-11-30T09:30:00-05:00,54.85,55.68,54.32,54.59,46261967,28714530.25,41.02154509098047,49.74847055923188,NaN,NaN,-163.0623156742597,-98.26897483413134,-0.4006282146664756,-0.20146002204242563,0.19916819262404997,308963172,338312041.2,74.96430092840643,82.71664845448343,NaN,NaN,-3.6678017200601607,8.393276463406021
2021-12-01T09:30:00-05:00,55.87,56.38,53.98,54.01,44799676,30101379.15,39.00849426506226,48.68882840999823,NaN,NaN,-140.21062281734336,-114.98466564982758,-0.4629970057441253,-0.37957806455610665,0.08341894118801865,264163496,322529375.2,64.47040390806671,80.78803650105495,NaN,NaN,-6.909677189760194,6.207140227239419
2021-12-02T09:30:00-05:00,54.04,55.78,53.4,55.58,50371910,31453106.75,46.64160904521824,48.09260746973903,NaN,NaN,-112.6037909528117,-140.5408015459185,-0.3783842699697491,-0.38956139627416775,-0.011177126304418625,314535406,312534226.4,58.851714761299505,78.41532932392785,NaN,NaN,-6.981164934471849,4.323096632709238
2021-12-03T09:30:00-05:00,56.33,56.58,54.61,55.14,37940112,31441031.85,44.94398423091453,47.440797763672265,NaN,NaN,-73.46423348495988,-114.86365549946974,-0.3334929900780642,-0.42804336390199893,-0.09455037382393469,276595294,303896501.4,54.43642694701239,75.7180487248208,NaN,NaN,-7.602735301141382,2.6194063564448644
2021-12-06T09:30:00-05:00,55.99,56.62,55.3,55.96,31969547,31909333.55,48.6919817134694,46.86594546407311,NaN,NaN,-40.15938390331682,-105.9000693665383,-0.23468126987907614,-0.38790196117277986,-0.15322069129370372,308564841,294564441.8,50.06616899087696,72.69787620328803,NaN,NaN,-6.8727685259000495,1.263381373252734
2021-12-07T09:30:00-05:00,56.74,57.81,56.67,57.27,36843346,32750942.95,54.07122847208427,46.63946748764198,NaN,NaN,36.82398839146564,-65.92280855339325,-0.07544759460359993,-0.24753018454820364,-0.1720825899446037,345408187,301853444.8,53.22486491138061,69.89153188694955,NaN,NaN,-4.431800457015144,0.4497839689287515
2021-12-08T09:30:00-05:00,57.59,57.87,57.14,57.26,23514986,32942242.9,54.02466539212473,46.85937657504919,NaN,NaN,53.23027581619937,-27.234628826684695,0.029242743257181847,-0.1355291608731264,-0.16477190413030823,321893201,313399385.8,57.7807175534982,67.38762526989514,NaN,NaN,-2.5526401023201433,0.020866244464623707
2021-12-09T09:30:00-05:00,56.9,57.05,56.47,56.82,23399407,32311390.4,51.90661855113983,47.08553413626439,NaN,NaN,18.040602666304135,-1.105750102861527,0.0667500878345463,-0.08133429433712536,-0.14808438217167166,298493794,310191063.4,56.144301782943536,65.08498692910501,NaN,NaN,-1.64217316261597,-0.2167108136897468
2021-12-10T09:30:00-05:00,57.43,57.47,56.2201,57.24,19525626,32062757.45,53.76978100039633,48.257245518824675,NaN,NaN,34.26232291352989,20.439561176836428,0.11491329072290217,-0.004442768768043948,-0.11935605949094612,318019420,318475888.6,59.346161584382386,63.60934017084524,NaN,NaN,-0.3364588876886134,-0.23381768140387058
2021-12-13T09:30:00-05:00,56.73,56.9,55.38,55.65,28603968,32638206.55,46.43563843843642,48.46241564958509,NaN,NaN,-27.552749935094415,22.960887970480904,0.038695169573355004,-0.07098709752425236,-0.10968226709760737,289415452,314646010.8,57.264787298969274,62.40551961929792,NaN,NaN,-1.4356279290989447,-0.405504859646024
2021-12-14T09:30:00-05:00,55.31,56.2702,55.23,55.42,28798849,33009366.2,45.46948411454173,47.96107179798436,NaN,NaN,-44.90379311118714,6.6153316699503675,-0.024783447288010102,-0.14066157620762,-0.11587812891960989,260616603,297687694,49.05999551153156,60.892134624445475,NaN,NaN,-2.6119498637255565,-0.7207112888002429
2021-12-15T09:30:00-05:00,55.34,55.475,53.92,55.15,33858091,33678300,44.304124793828635,47.19721005653945,NaN,NaN,-93.25386240187171,-22.68149597366385,-0.07944575574059176,-0.2151853235953496,-0.13573956785475783,226758512,278660756.2,41.82004999581609,58.80617526320543,NaN,NaN,-3.9166302354899103,-1.1772711383273382
2021-12-16T09:30:00-05:00,55.63,56.635,55.41,55.5,26865904,33838120.75,46.22803457033146,47.32267240605221,NaN,NaN,-14.053146681085648,-29.100245843141806,-0.08596865983405885,-0.2432003926473314,-0.15723173281327255,253624416,269686880.6,38.90398179580844,56.52386356927989,NaN,NaN,-4.470747361179601,-1.6477677415919472
2021-12-17T09:30:00-05:00,55.1,55.35,53.88,54.37,34834574,34132076.4,41.27120588134788,46.984885397134015,NaN,NaN,-109.7747719262587,-57.90766481109953,-0.1562309789640097,-0.3525204565182847,-0.19628947755427498,218789842,249840965,33.363357994129004,53.549802426008625,NaN,NaN,-6.428934104543489,-2.3307915077278816
2021-12-20T09:30:00-05:00,52.23,53.05,51.66,53.01,36330793,33664125.45,36.23532153121875,46.64301228572246,NaN,NaN,-225.45917746120182,-97.48895031632101,-0.27708264240412067,-0.5426427805594258,-0.26556013815530516,182459049,228449684.4,28.63030925142371,50.24023159193843,NaN,NaN,-9.761854807863752,-3.392371979175863
2021-12-21T09:30:00-05:00,53.55,54.715,53.53,54.52,25159686,33227243.3,44.35399871348323,47.02483403203824,NaN,NaN,-96.08141390182075,-107.72447447444772,-0.23951926033714382,-0.564959213576735,-0.32543995323959113,207618735,217850110.8,26.61546460053863,47.53630735568642,NaN,NaN,-10.076088362891232,-4.347188605420915
2021-12-22T09:30:00-05:00,54.58,55.24,53.92,54.87,21103076,32589214.65,46.06806220352116,46.98386640048845,NaN,NaN,-61.93661052247038,-101.46102409856746,-0.1781161084986681,-0.5480850888629263,-0.3699689803642582,228721811,218242770.6,26.820918888201987,45.248393364750875,NaN,NaN,-9.791344562590998,-5.124925170730927
2021-12-23T09:30:00-05:00,55.11,55.66,54.88,54.9,16685276,32351762.25,46.2209749755108,47.07508002510247,NaN,NaN,-24.039058926669068,-103.45820654768416,-0.12500519528497672,-0.5262254744704791,-0.40122027918550235,245407087,216599304.8,26.48667230853046,43.25198231914502,NaN,NaN,-9.519272409184747,-5.752689061938616
2021-12-27T09:30:00-05:00,54.72,56.15,54.26,56.1,21742156,31202508.5,52.07439891607599,47.31668125386009,NaN,NaN,1.2534345960282867,-81.25256524322675,-0.004924279633552908,-0.4073756287274435,-0.4024513490938906,267149243,226271185,31.86788446027782,41.95210485267365,NaN,NaN,-7.478995625558688,-5.999304285312912
2021-12-28T09:30:00-05:00,56.24,56.608,55.75,56.06,17940733,30327484.15,51.871728107385756,47.15957408495306,NaN,NaN,50.58488861038426,-26.043752028909534,0.07171461639400417,-0.3128080786013854,-0.38452269499538955,249208510,239621077.2,38.55379597019564,40.90417135687472,NaN,NaN,-5.89720460038974,-5.984718616038173
2021-12-29T09:30:00-05:00,55.97,56.24,55.43,55.7,15109066,28769839.1,49.98615297685009,46.87110891243344,NaN,NaN,20.769204269875384,-2.6736283945703043,0.09652225402476222,-0.2638698774644368,-0.360392131489199,234099444,244917219,41.02628168005679,39.707425937343196,NaN,NaN,-5.094979982998994,-5.857613097032576
2021-12-30T09:30:00-05:00,55.72,56.16,55.31,55.36,13589987,27209354.65,48.20395123886172,46.60663267584215,NaN,NaN,3.689040513382252,10.451501812600226,0.08859896520846167,-0.2496434249786219,-0.3382423901870836,220509457,243274748.2,40.482247626545934,38.588707783314796,NaN,NaN,-4.9067478358354535,-5.721775202575844
2021-12-31T09:30:00-05:00,55.22,55.785,55.13,55.5,13241176,25352817.95,49.010118127786676,46.266656756370026,NaN,NaN,-10.207482671585442,13.217817063616948,0.09100646135996149,-0.22448431348713171,-0.3154907748470932,233750633,240943457.4,39.6779865893776,37.18383814081445,NaN,NaN,-4.5333555655800355,-5.5520009687193
2022-01-03T09:30:00-05:00,55.58,57.31,55.55,57.22,32527141,25082169.4,57.71727533050453,47.07248796294632,NaN,NaN,83.52007892036723,29.671145928484737,0.20038737516001215,-0.06500655589707804,-0.2653939310570902,266277774,240769163.6,39.614620328263406,35.923111928621175,NaN,NaN,-1.5477328451447743,-4.97996266535151
2022-01-04T09:30:00-05:00,58,59.43,57.81,59.2,39978797,25482631.9,65.1045270134692,48.47499102715543,NaN,NaN,206.76863538381969,60.90789528317182,0.38721909570829754,0.21862993857828172,-0.16858915713001582,306256571,252178775.8,45.7251735108717,35.684910357145476,NaN,NaN,3.7448070064874135,-3.7335669979459496
2022-01-05T09:30:00-05:00,59.78,60.44,59.1,59.19,45402016,25910565.4,65.04271994891617,49.956319252518824,NaN,NaN,220.6092651360149,100.87590745639973,0.48492175229635087,0.4375630332404228,-0.0473587190559281,260854555,257529798,48.36423723182487,36.15235230257467,NaN,NaN,7.85183803959546,-2.078509135440034
2022-01-06T09:30:00-05:00,60.58,60.845,59.66,60.51,37340673,26601849.75,69.19938417826917,51.597129938800094,NaN,NaN,221.111525813592,144.36040451644166,0.6054105617211345,0.70940448309549,0.10399392137435552,298195228,273066952.2,55.17902232671207,37.31485519763921,NaN,NaN,12.839456914411725,0.05262887168164587
2022-01-07T09:30:00-05:00,60.74,61.5,60.32,61.34,35584587,27211108.75,71.49459885285175,53.75594372247894,NaN,NaN,201.53469158077476,186.7088393669137,0.7012145594116859,0.9805121206389629,0.279297561227277,333779815,293072788.6,62.1127201968603,39.368381069262874,NaN,NaN,17.762676803468324,2.5826357190797427
2022-01-10T09:30:00-05:00,61.48,61.6,60.3506,61.15,33236482,27896651.55,70.20489062298674,56.18234151474808,NaN,NaN,162.89343536027783,202.58351065489583,0.7098321645479222,1.1665877669121798,0.4567556023642576,300543333,299925900.4,64.15817323034955,41.906085639186145,NaN,NaN,21.309869004027394,5.25795475978655
2022-01-11T09:30:00-05:00,61.68,63.34,61.1601,63.23,38443870,28388646.65,75.43022249362807,58.402071784758434,NaN,NaN,170.56098487686563,195.34198055350504,0.8065995245898732,1.465005008101599,0.6584054835117259,338987203,306472026.8,66.04396737210217,44.72240726572641,NaN,NaN,26.398428784264972,8.27802247756918
2022-01-12T09:30:00-05:00,63.57,63.735,62.89,63.35,30248350,28461121.7,75.69505188788949,60.518285333641884,NaN,NaN,155.00609748997553,182.22134702429716,0.8266237137908398,1.6916851257502756,0.8650614119594359,369235553,328148226.4,71.40842337802529,47.907229014999494,NaN,NaN,30.46222504404542,11.447194272780072
2022-01-13T09:30:00-05:00,63.35,63.86,62.77,63.03,29776988,28257066.55,73.42232874639583,62.46123917441939,NaN,NaN,128.6991718313956,163.73887622785787,0.7675332544523501,1.8244779800248736,1.0569447255725235,339458565,336400893.8,73.14776567636707,51.24016425555926,NaN,NaN,33.08056079378579,14.537675204352318
2022-01-14T09:30:00-05:00,63.09,64.615,63.05,64.51,32400471,28533794.9,76.87985867407573,64.23305772856222,NaN,NaN,126.52020949130912,148.73597980996473,0.7750753169645386,2.0257888717781967,1.250713554813658,371859036,344016738,74.67864942317472,54.29807603862332,NaN,NaN,36.53713583338413,17.680455294214006
2022-01-18T09:30:00-05:00,65.2,65.53,63.78,64.77,41091165,28846624.45,77.43522100982648,66.05902150730799,NaN,NaN,123.01878535856973,140.76104980962313,0.7443618826201766,2.181165908088879,1.4368040254687022,412950201,366498111.6,78.56373338658263,57.15592871122239,NaN,NaN,39.487464950201584,20.795742387926516
2022-01-19T09:30:00-05:00,65.27,65.34,63.79,64.3,32989028,28679536.2,73.97594166343782,67.77257784206425,NaN,NaN,107.75139780748124,128.19913239574626,0.6429972470718277,2.2405505843084867,1.597553337236659,379961173,374692905.6,79.78149548669147,59.92415826883916,NaN,NaN,40.908243307277026,23.668956804976588
2022-01-20T09:30:00-05:00,63.88,65.42,63.58,63.71,41990402,29521072,69.76276551215446,69.31249314729943,NaN,NaN,93.81426725692461,115.96076634913607,0.49353986859344046,2.2144781729784597,1.7209383043850193,337970771,368439949.2,76.22327425208431,62.477088742091894,NaN,NaN,40.85964710597228,26.12476970511883
2022-01-21T09:30:00-05:00,62.99,63.39,61.785,62.45,57269777,31329407.05,61.683179913342585,70.21771184626772,NaN,NaN,53.66452313061629,100.95383660898021,0.2778909813529904,2.068302031076257,1.7904110497232668,280700994,356688435,69.9125523217802,64.63670058012066,NaN,NaN,38.29123512015843,27.86283619298163
2022-01-24T09:30:00-05:00,60.97,63.09,59.84,62.87,62294641,33609875.3,63.212603825691104,70.61023531020962,NaN,NaN,35.988468730373334,82.84748845679306,0.13863951523074514,1.9637104437616983,1.8250709285309532,342995635,350915754.8,66.97897012230419,66.5912969939807,NaN,NaN,36.62510995088111,29.11458958696727
2022-01-25T09:30:00-05:00,62.63,65.55,61.47,65.31,59217211,35483628.05,70.56362891091841,71.00017116002742,NaN,NaN,79.62119989573556,74.16797136422619,0.18316795797023433,2.054030875993746,1.8708629180235117,402212846,348768283.8,65.87164261074098,68.03033050111422,NaN,NaN,37.4961641684772,30.311957384325833
2022-01-26T09:30:00-05:00,66,66.53,64.49,65.2,65362736,37854728.2,69.88563728868708,71.34609382715392,NaN,NaN,103.25411410504331,73.26851462373862,0.17739931306528023,2.092612059355112,1.9152127462898316,336850110,340146071.2,61.476973260347144,68.96695450315153,NaN,NaN,37.956176452714885,31.403988679809984
2022-01-27T09:30:00-05:00,66.35,67.06,64.82,65.91,54450687,39821809.25,71.77097699716607,71.5297790285037,NaN,NaN,109.36996819462351,76.3796548112784,0.19233398535126334,2.155630227978911,1.9632962426276475,391300797,350812076.4,64.6213642335994,69.64140749650063,NaN,NaN,38.9269228219311,32.47869355725586
2022-01-28T09:30:00-05:00,65.47,66.27,64.26,65.63,52651198,41774869.8,69.91209166973346,71.4167428011381,NaN,NaN,90.95411814958459,83.83757381507206,0.15584434032575256,2.1581016680348384,2.002257327709086,338649599,362401797.4,67.70593492908588,70.04092283451673,NaN,NaN,39.15334420173476,33.432215077895705
2022-01-31T09:30:00-05:00,65.48,66.34,64.44,65.92,31649182,42695270.1,70.7568879246204,71.45617117982623,NaN,NaN,93.11733700385317,95.26334746976804,0.12505664455289534,2.158578133400205,2.0335214888473097,370298781,367862426.6,69.07407551513212,70.39205871200122,NaN,NaN,39.58303461389935,34.310903583039085
2022-02-01T09:30:00-05:00,65.53,68.43,65.38,68.27,45222321,43330029.1,76.51207219769124,71.53344615868788,NaN,NaN,147.36116376928473,108.81134024447788,0.2306361200682403,2.32181663893261,2.0911805188643697,415521102,370524077.8,69.74685339024063,70.65655057043968,NaN,NaN,41.88981470740002,35.39360517223351
2022-02-02T09:30:00-05:00,67.92,68.62,67.08,68.49,32598533,42961015.9,76.96904163731823,71.62444542650421,NaN,NaN,159.0740287681435,119.9753231770979,0.27969595580541995,2.4408004636211444,2.1611045078157245,448119635,392777982.8,74.70217613065462,70.8918186241989,NaN,NaN,43.86085851507419,36.60321279263932
2022-02-03T09:30:00-05:00,68.21,68.35,67.1001,67.84,30981274,42239978.8,72.48211790281259,71.55728750910541,NaN,NaN,138.72818892755583,125.84696732368438,0.2345997274588436,2.454354167139279,2.219754439680435,417138361,397945495.6,75.69760555369584,71.07395004400811,NaN,NaN,44.12322292880596,37.677499954948836
2022-02-04T09:30:00-05:00,68.7,70,68.54,68.9,40866724,42416281.35,75.03772435136625,71.42570648605474,NaN,NaN,168.8967934959134,141.43550239295013,0.2414458259532415,2.5215617221219873,2.2801158961687458,458005085,421816592.8,79.67603186001554,71.43090593235388,NaN,NaN,45.14491307268185,38.74427325748212
2022-02-07T09:30:00-05:00,68.57,70.43,68.05,69.78,32582458,42266174.9,76.9514678670161,71.3911526901397,NaN,NaN,155.2111833383828,153.85427165985607,0.2684520014617471,2.6156808979959294,2.3472288965341823,490587543,445874345.2,82.74231432887639,71.72937599966058,NaN,NaN,46.60811793234909,39.867679639605974
2022-02-08T09:30:00-05:00,69.57,69.71,67.8,68.28,37882124,42498457,67.45797309300738,70.92558350653754,NaN,NaN,114.06643083089541,147.1953250721782,0.1541805180317346,2.5399545440738507,2.385774026042116,452705419,453311208.6,83.56763579958347,71.99981459343857,NaN,NaN,44.771396105947176,40.568210563369
2022-02-09T09:30:00-05:00,68.44,69.38,68.27,68.85,35395715,42346049.25,69.02195420757121,70.87266841335301,NaN,NaN,107.08241087713,136.7970014939755,0.08910039048266594,2.4971495141454483,2.4080491236627823,488101134,461307508.4,84.42985406604868,72.5859988658646,NaN,NaN,43.769349532218136,41.02551613034745
2022-02-10T09:30:00-05:00,68.51,69.74,67.97,68.42,37821621,42724712.8,66.4282640655109,71.21160299565075,NaN,NaN,90.73617556952263,127.19859882236885,-0.005756681999938618,2.400853271162859,2.4066099531627976,450279513,467935738.8,85.12651754484301,73.67271066751195,NaN,NaN,42.151476416120694,41.186367599743626
2022-02-11T09:30:00-05:00,68.88,70.5,68.45,70.41,46517005,43561713.65,71.72391574188465,71.81955384680744,NaN,NaN,110.80895690091604,115.58103150336937,0.04014706487329445,2.4567937842544154,2.416646719381121,496796518,475694025.4,85.92060313962838,75.02568445446367,NaN,NaN,42.41393402099054,41.361734231350326
2022-02-14T09:30:00-05:00,69.98,70.0599,67.93,68.75,49816495,44432514.85,62.821756059943944,71.26656292888069,NaN,NaN,74.66971284515661,99.47273740472413,-0.0611553601511452,2.3402025191921894,2.4013578793433346,446980023,466972521.4,80.70431405750782,76.0851609863756,NaN,NaN,39.55854421323281,41.104135657333536
2022-02-15T09:30:00-05:00,67.06,68.19,66.68,68.03,43072396,44531576.4,59.379246443783494,70.516106439959,NaN,NaN,30.462293788368562,82.75190999621876,-0.1892853319246326,2.164751214437544,2.3540365463621766,403907627,457212963,75.20233271776758,77.06554380476277,NaN,NaN,36.10860950854527,40.3904890646495
2022-02-16T09:30:00-05:00,68.57,69.77,68.16,68.58,36722109,44718230.45,61.13142586572105,69.75613850199865,NaN,NaN,63.759129116713915,74.08725364413553,-0.2460336528109872,2.046494480348443,2.29252813315943,440629736,447718683.4,70.18920014941092,77.46324637017788,NaN,NaN,33.8890632637346,39.46171395023308
2022-02-17T09:30:00-05:00,68.52,69.185,67.9403,68.47,33811427,44309281.7,60.568704296508166,69.0887536896254,NaN,NaN,49.43992104657073,65.82800273954516,-0.29662539471807525,1.9217463897618359,2.218371784479911,406818309,439026442.6,65.86050175309163,77.33142971474972,NaN,NaN,31.957144567366385,38.38963260982356
2022-02-18T09:30:00-05:00,67.5,68.59,67.39,68.05,31645770,43028081.35,58.35976461683727,68.20324488192662,NaN,NaN,25.40975331476928,48.748162022315796,-0.3598136159918095,1.7686047644901493,2.1284183804819587,375172539,414701646.8,55.538111394642655,76.36457513471476,NaN,NaN,29.70609291568166,37.149126939231856
2022-02-22T09:30:00-05:00,70.11,70.11,65.94,66.95,46501366,42238417.6,52.916553237703404,66.51785067049892,NaN,NaN,-0.9091286798994841,33.63239371730457,-0.4701605589078084,1.5407176818471982,2.0108782407550065,328671173,391039876.8,47.705502721958126,74.79019294412316,NaN,NaN,26.081337142688337,35.56801411115421
2022-02-23T09:30:00-05:00,67.34,68.16,66.95,67.64,33978980,40976506.05,55.707266646677205,64.9991524568817,NaN,NaN,-17.52774193108223,24.03438657341444,-0.48897589659451457,1.3996583700118634,1.888634266606378,362650153,382788382,45.30589568020563,72.69045862623393,NaN,NaN,23.845371131697952,33.89335082837475
2022-02-24T09:30:00-05:00,69.08,69.16,65.361,67.11,61742931,40795515.8,53.1036169314687,63.614973816071426,NaN,NaN,-52.129554962238245,0.8566497576240082,-0.5261777411725153,1.230912090140734,1.7570898313132493,300907222,354843879.2,38.282865586232596,70.01797719998656,NaN,NaN,21.203790112819807,32.08055644043833
2022-02-25T09:30:00-05:00,67.26,68.95,67.26,68.88,39211463,40033554.6,59.852225807448136,62.5302953486487,NaN,NaN,23.220562924728565,-4.387221866744425,-0.42497381761065567,1.2258725592999298,1.6508463769105854,340118685,341503954.4,35.45722915847698,66.85949129273381,NaN,NaN,20.904254975668948,30.483941945471276
2022-02-28T09:30:00-05:00,68.39,70.66,68.01,70.58,48197133,39810851.35,65.05380426653673,61.68046223432874,NaN,NaN,126.1775723501023,15.766341940322182,-0.2458237520222437,1.343566686882781,1.5893904389050246,388315818,344132610.2,36.45257684542961,63.55308147248762,NaN,NaN,22.377184762526152,29.325833776479115
2022-03-01T09:30:00-05:00,71.21,72.49,70.29,71.29,62115463,41334165.4,66.97809176223612,61.646184996416515,NaN,NaN,244.42129095365007,64.83242586703209,-0.08982910227248087,1.4771040610644235,1.5669331633369044,450431281,368484631.8,44.92601541653408,60.792965730841225,NaN,NaN,24.205732016897436,28.594390667967446
2022-03-02T09:30:00-05:00,72.38,73.5002,72.03,72.92,45454101,41345754.4,70.93498668882395,61.782830173648854,NaN,NaN,286.14241934916396,125.56645812308133,0.10239167352262468,1.694922755240185,1.5925310817175604,495885382,395131677.6,52.404689935207294,58.50545400720971,NaN,NaN,27.138876624292408,28.386460090299583
2022-03-03T09:30:00-05:00,72.21,73.619,72.06,73.12,44559875,41943821.5,71.38801712741319,62.13709824949901,NaN,NaN,221.48456360418675,180.28928183636634,0.21574912201438634,1.8622174842355435,1.6464683622211571,540445257,443039284.6,62.31318437738108,56.875930209533855,NaN,NaN,29.588104928394532,28.55812363859886
2022-03-04T09:30:00-05:00,73.11,75.27,72.92,75.23,52625893,43026052.45,75.69261207460283,62.42057655897889,NaN,NaN,231.22685417543946,221.8905400865085,0.39513418202582185,2.1403860897534344,1.7452519077276125,593071150,493629777.6,69.52757486237667,55.704999618301585,NaN,NaN,33.2721352292582,29.23155386583591
2022-03-07T09:30:00-05:00,76.01,77.56,74.635,76.34,65607361,44263084.3,77.60169460640506,63.476286455154685,NaN,NaN,226.1190279457451,241.87883120563706,0.5417821539589178,2.42247960017626,1.880697446217342,658678511,547702316.2,75.02965878439505,55.29966709879353,NaN,NaN,36.96351726222414,30.336120065319943
2022-03-08T09:30:00-05:00,78.08,80.22,75.33,77.54,98027181,47535320.45,79.47818019095037,64.91192457995231,NaN,NaN,205.91315631446054,234.17720427779915,0.6647323829177125,2.7116129248644825,2.04688054194677,756705692,608957198.4,79.53715047860015,55.609296938853,NaN,NaN,40.67116182060831,31.81255460178971
2022-03-09T09:30:00-05:00,74.7,76.94,73.5,75.17,87018243,49992126.4,67.45789811862889,65.36381545516002,NaN,NaN,115.58341133186651,200.06540267433965,0.5370399521228988,2.7181804821003936,2.181140529977495,669687449,643717611.8,81.5702507221173,56.42222912261774,NaN,NaN,39.69752904901977,32.93897952282258
2022-03-10T09:30:00-05:00,76.06,77.665,75.52,77.47,68901344,51667407.85,71.89954713321072,66.17316137206736,NaN,NaN,131.8405901520163,182.13660798390558,0.5557478735193535,2.8758253718766866,2.320077498357333,738588793,683346319,83.57396207239744,57.68747628828244,NaN,NaN,40.49064963823972,34.01778953931074
2022-03-11T09:30:00-05:00,76.23,77.81,76.11,76.85,45918864,52072270,69.15925126254798,66.9445532753324,NaN,NaN,114.83343264709302,158.8579236782363,0.4776217591025915,2.9171046972355725,2.439482938132981,692669929,703266074.8,84.48696325724794,59.75525142132568,NaN,NaN,40.152686713543616,34.89420342134401
2022-03-14T09:30:00-04:00,75.21,75.74,73.55,74.55,50745013,52283670.4,60.020410820122116,67.45197167407659,NaN,NaN,60.3632825589694,125.70677460088116,0.23459517522452566,2.732726907163638,2.4981317319391123,641924916,699915355.8,83.64476187351315,62.32234136072246,NaN,NaN,36.57285007729772,35.13401008648025
2022-03-15T09:30:00-04:00,71.66,72.65,70.44,71.82,62362196,52910955.45,51.34724835474724,67.14054179608159,NaN,NaN,-1.6193186730883449,84.20027960337137,-0.127024258449286,2.339351408877505,2.466375667326791,579562720,664486761.4,75.11823398467872,64.45179409675626,NaN,NaN,30.24741072985,34.4359244641045
2022-03-16T09:30:00-04:00,72.09,72.72,70.74,71.49,53768064,53445738.85,50.39918361259366,66.94736798759051,NaN,NaN,-5.8164316243936645,59.92031101211934,-0.3905667974470619,1.9781671705179633,2.3687339679650252,525794656,635708202.8,68.96813963726967,66.64359938611605,NaN,NaN,25.14262113497643,33.10830970280049
2022-03-17T09:30:00-04:00,72.76,74.135,72.3089,73.95,38478153,53533541.05,56.80224734570054,66.72951238317997,NaN,NaN,29.554852069810607,39.46316339567821,-0.39987984076321714,1.8688841670110037,2.268764007774221,564272809,600845006,62.312435781565625,68.56182843062238,NaN,NaN,23.046019537415717,31.670839679174094
2022-03-18T09:30:00-04:00,73.82,74.38,73.3209,73.88,29275387,53306739.05,56.57842806618547,66.12412836886917,NaN,NaN,33.84128599460113,23.26473406517983,-0.4099058387244421,1.756381709368668,2.16628754809311,534997422,569310504.6,56.958113370725584,70.02650961100066,NaN,NaN,21.380143473505985,30.20074022122151
2022-03-21T09:30:00-04:00,74.66,76.37,74.62,76.13,34357426,53442321.85,61.79009965709807,65.75355750421645,NaN,NaN,71.35087611686934,25.46225277675981,-0.2708618850858109,1.8277101917358465,2.0985720768216574,569354848,554796491,54.631320476270616,70.71974568669613,NaN,NaN,21.70903873441079,28.987640008819977
2022-03-22T09:30:00-04:00,75.81,76.23,74.71,75.57,33231054,52778806.25,59.86422053984704,64.96278849357525,NaN,NaN,60.673788376908256,37.920874186759136,-0.2243829738600227,1.818093359496629,2.042476333356652,536123794,546108705.8,53.22959952613497,70.77866780033382,NaN,NaN,21.350102701731245,27.896563250664443
2022-03-23T09:30:00-04:00,76.99,77.58,76.62,76.87,29331529,52546433.7,62.76553780511859,64.34689711341134,NaN,NaN,94.22098372865115,57.9283572573681,-0.11914627037867165,1.8935434953833123,2.012689765761984,565455323,554040839.2,54.3804954422059,70.21204716210703,NaN,NaN,21.980672967439258,27.051436067346557
2022-03-24T09:30:00-04:00,77.16,77.82,76.545,77.06,26350284,50776801.35,63.184418282571514,63.45345469969482,NaN,NaN,92.06018756078039,70.42942435556206,-0.05316405131762325,1.946234701614955,1.9993987529325783,591805607,559547398.8,55.20458338223242,69.18897634209671,NaN,NaN,22.608816813078324,26.41677617387967
2022-03-25T09:30:00-04:00,76.6,78.85,76.535,78.75,28049621,50218709.25,66.76578093063259,62.67946086571107,NaN,NaN,114.10523020504858,86.48221319765155,0.08060298779431552,2.100152487675473,2.0195494998811574,619855228,576518960,57.738509444676964,67.95389424640257,NaN,NaN,24.2699784519374,26.110090785030774
2022-03-28T09:30:00-04:00,77.13,77.16,76.305,76.8,34880188,49552862,59.5655802714442,61.25713230003207,NaN,NaN,64.76116254070813,85.16427048241931,0.017363942864375925,2.0412544284616274,2.0238904855972515,584975040,579642998.4,58.207151846021645,66.43032291550409,NaN,NaN,23.431895283852732,25.727491427719624
2022-03-29T09:30:00-04:00,75.08,76.64,74.19,76.6,36636968,48278937.25,58.86440994359638,60.64331171610117,NaN,NaN,24.306319226992105,77.89077665243607,-0.05439826792537783,1.9558926506905294,2.0102909186159073,548338072,582085854,58.59381086677605,64.78914864012259,NaN,NaN,22.55348329851243,25.27406169497574
2022-03-30T09:30:00-04:00,77.34,78.04,76.8571,77.49,24868234,47249643.9,61.061041307144514,59.86913272852502,NaN,NaN,85.2447538043595,76.09553066757773,-0.058055502066371556,1.9377215410329427,1.9957770430993143,573206306,583636050.6,58.8539632773158,63.0234344404739,NaN,NaN,22.466268080540768,24.87294832148503
2022-03-31T09:30:00-04:00,76.76,78.21,76.43,76.44,32803294,46661814.85,57.181511811663384,59.01357991060469,NaN,NaN,61.8013122799875,70.04375561141917,-0.14250808557325567,1.8176419361327447,1.9601500217060004,540403012,573355531.6,56.32648079538092,61.011971407483394,NaN,NaN,21.244672973736233,24.35462327180663
2022-04-01T09:30:00-04:00,76.34,77.775,76.29,77.06,24806291,45270834.75,58.8442815543343,58.929570677334134,NaN,NaN,57.49818954470747,58.72234747935094,-0.1662741814889963,1.752307294844755,1.9185814763337512,565209303,562426346.6,53.68688129674651,58.872122794857205,NaN,NaN,20.704159628325215,23.833128465595
2022-04-04T09:30:00-04:00,77.56,77.81,76.34,77.16,23003669,43140650.15,59.12002449602752,59.484768973139865,NaN,NaN,56.69757833591269,57.10963063839184,-0.18356351734749587,1.6891270796493814,1.8726905969968772,588212972,563073933,53.824960198223735,57.35117466725328,NaN,NaN,20.337157030714646,23.333703974897805
2022-04-05T09:30:00-04:00,77.3,78.49,75.86,75.95,27288559,39603719.05,54.37293874339327,59.76860862533984,NaN,NaN,44.96954581390567,61.24227595577456,-0.2790697711368595,1.523853383075803,1.8029231542126625,560924413,565591201.2,54.39415413416665,56.31017570274592,NaN,NaN,18.67507661388404,22.66818578046727
2022-04-06T09:30:00-04:00,76.78,77.47,75.975,76.4,32164186,36861016.2,55.794547655671565,59.69663007605205,NaN,NaN,34.928950956191635,51.179115386140985,-0.31202089973578384,1.4128970295429326,1.7249179292787165,593088599,569567659.8,55.3308790058359,55.81149307590808,NaN,NaN,17.6642822484074,21.95334241874443
2022-04-07T09:30:00-04:00,76.76,77.66,75.34,77.4,27048693,34768383.65,58.86196818003226,59.85974008418397,NaN,NaN,43.69106231024205,47.557065392191895,-0.26822546130364255,1.3896361026491633,1.6578615639528058,620137292,585514515.8,58.970460667029776,55.95523216850124,NaN,NaN,17.63360420693642,21.336236959914714
2022-04-08T09:30:00-04:00,77.61,79.75,77.61,79.53,26713051,33808093,64.5107925007897,60.054075287304805,NaN,NaN,130.89062875933976,62.235553235118346,-0.10589729053893882,1.5254899507791322,1.631387241318071,646850343,601842723.8,62.35285503764052,56.50677035145623,NaN,NaN,19.314384342569696,21.04740087172257
2022-04-11T09:30:00-04:00,78.68,78.7,76.965,77.14,26230495,32582367.1,55.330035576117616,59.7302049327527,NaN,NaN,66.5230750185015,64.20065257163611,-0.16599908956476783,1.4238883793621113,1.5898874689268792,620619848,608324099,63.634393825779,57.249969944287955,NaN,NaN,17.890189818193445,20.59637072121841
2022-04-12T09:30:00-04:00,78.7,79.85,78.265,78.42,31964711,31062492.85,58.718466853655755,59.441128436219635,NaN,NaN,124.63828990983727,80.13440139082243,-0.1277758771381432,1.4301676225042002,1.5579434996423434,652584559,626656128.2,67.05082242493523,58.15499330019719,NaN,NaN,17.7869793846413,20.195029101707394
2022-04-13T09:30:00-04:00,79.38,79.81,78.07,79.59,24647942,29606486.75,61.58676648540662,59.32701045070786,NaN,NaN,151.323976588749,103.4134065173339,-0.03665689231095959,1.5121223842536438,1.5487792765646033,677232501,643484908.6,69.85097429160014,59.20116407943774,NaN,NaN,18.618442954951824,19.96980250931374
2022-04-14T09:30:00-04:00,79.21,80.48,79.09,79.85,25934716,28979314.9,62.215055771805986,59.00195865364882,NaN,NaN,180.26517472640893,130.72822900056727,0.024849004542305764,1.5798405322424856,1.5549915277001798,703167217,660090893.6,72.34819629915943,60.24471314047221,NaN,NaN,19.474834157454836,19.89909274476247
2022-04-18T09:30:00-04:00,80.51,81.5,80.01,81.02,30456565,29038373.8,64.99008191901547,59.38942305704677,NaN,NaN,207.17695126858456,145.98549350241623,0.12258718897392251,1.7082255139175828,1.5856383249436603,733623782,677445581.4,74.70615190907944,61.42321314497634,NaN,NaN,21.05376784991608,20.064046331212985
2022-04-19T09:30:00-04:00,80.6,81.39,79.89,80.36,22863926,28463698.8,62.21432491604899,59.62870269793624,NaN,NaN,155.68110082524322,163.81709866376457,0.12084574640417611,1.7366955079488804,1.6158497615447043,710759856,695473583,76.90893433051944,62.73143624952944,NaN,NaN,21.547670634111046,20.275992660198423
2022-04-20T09:30:00-04:00,80.57,81.1,79.792,80.67,26039656,28104128.9,63.013388514749465,59.768156069908024,NaN,NaN,131.84326071583428,165.25809282496397,0.11847139217020786,1.763939001757464,1.6454676095872562,736799512,712316573.6,78.76921727205182,64.15395439201058,NaN,NaN,22.182620905476615,20.548368123809592
2022-04-21T09:30:00-04:00,81.15,81.51,77.81,78.11,32578853,28266495.1,53.03849422733942,59.472226242456316,NaN,NaN,53.40371622773921,145.674040752762,-0.06760190668473953,1.5609652262313318,1.6285671329160714,704220659,717714205.2,79.34354467994838,65.7980303837654,NaN,NaN,19.660016103508596,20.42146069233802
2022-04-22T09:30:00-04:00,77.8,78.915,76.165,76.2,35749637,28736462.75,47.053723115148394,58.63004349680018,NaN,NaN,-51.300465798838395,99.36091264771255,-0.3174243154893559,1.2317867385543764,1.5492110540437323,668471022,710774966.2,76.47916894778268,67.42605093026798,NaN,NaN,15.49896640479987,19.718247222689712
2022-04-25T09:30:00-04:00,73.8,74.075,71,73.68,55362197,30102091.55,40.55210290468175,57.303763383132626,NaN,NaN,-217.36747579188992,14.452027235617674,-0.6323126286088789,0.7588202682826335,1.3911328968915124,613108825,686671974.8,67.38015785453308,68.39427933429008,NaN,NaN,9.573741460758503,18.269032113842396
2022-04-26T09:30:00-04:00,74.23,75.8,73.59,73.78,44584346,30587299.45,40.90107550078898,56.34148743723232,NaN,NaN,-138.48497112901106,-44.381187155233185,-0.802832576728377,0.387592175981041,1.190424752709418,657693171,676058637.8,63.78172826452841,69.06482034360162,NaN,NaN,5.095834879352066,16.38714679462949
2022-04-27T09:30:00-04:00,74.25,75.59,72.92,74.86,44566257,30983763.9,44.678185906531006,55.54746159800799,NaN,NaN,-128.5651100370569,-96.46286130581142,-0.8095551647145722,0.17848079681620277,0.988035961530775,702259428,669150621,61.48027121695761,69.50406264439603,NaN,NaN,2.54202031476564,14.40927158322037
2022-04-28T09:30:00-04:00,75.36,77.76,73.88,77.13,43734848,31927094.6,51.6699129405097,55.03374336661352,NaN,NaN,-52.24686508722928,-117.59297756880513,-0.6354721715610523,0.19369574707945958,0.8291679186405119,745994276,677505344.4,63.20932203063886,69.8068384560824,NaN,NaN,2.585286059677696,12.720130794142845
2022-04-29T09:30:00-04:00,77.3,77.74,74.88,75.15,39708120,32272335.9,46.186768961863685,53.724884542404524,NaN,NaN,-61.32465478520138,-119.5978153660777,-0.6269661626982417,0.045460215267709714,0.6724263779659514,706286156,685068371.2,64.75176854697011,69.97818942103451,NaN,NaN,0.7874924204040975,11.015468169323023
2022-05-02T09:30:00-04:00,74.69,76.38,74.46,76.35,52070620,33635552.35,49.67253110055188,53.320777079864115,NaN,NaN,-64.02107564853543,-88.92853533740681,-0.5183173452225246,0.02452969643779568,0.5428470416603203,758356776,714117961.4,69.96113487107469,70.43009949569849,NaN,NaN,0.46714168115804383,9.508564385299454
2022-05-03T09:30:00-04:00,76.49,78.85,76.44,78.49,41649436,34567840.7,55.24066323898232,53.07236253595887,NaN,NaN,15.070382985995707,-58.21746451440545,-0.2914265518793944,0.17856385181107726,0.4699904036904717,800006212,742580569.6,74.01354968595183,70.92743715719968,NaN,NaN,2.0815878502868563,8.447567737440512
2022-05-04T09:30:00-04:00,80,81.915,78.98,81.75,45383728,35472599.15,62.11673440354056,53.110217387254146,NaN,NaN,108.47869672035002,-10.808703162924067,0.06982203444043955,0.5572679467410211,0.48744591230058154,845389940,771206672,77.3265414351798,71.46140623888394,NaN,NaN,5.998169095660417,8.09765364575764
2022-05-05T09:30:00-04:00,82.33,82.41,78.875,80.52,46596959,36194237.8,58.46717034757709,52.842511285523514,NaN,NaN,88.87927631697059,17.416525117915917,0.2096457855438454,0.7495031442303883,0.5398573586865429,798792981,781766413,78.41951659606364,71.8950719743771,NaN,NaN,7.853585525608746,8.062786771450655
2022-05-06T09:30:00-04:00,81.56,82.9299,79.925,82.92,47122824,37197944.35,63.031294335098494,52.7025978866723,NaN,NaN,117.36533808167282,53.15452369129075,0.43453524207075434,1.083026411274986,0.6484911692042316,845915805,809692342.8,81.02460467836076,72.34639002932576,NaN,NaN,11.028479369016242,8.486457142531453
2022-05-09T09:30:00-04:00,81.14,81.21,75.75,76.06,53021957,38513389.65,47.09908674189654,51.622938017089986,NaN,NaN,-13.827951617220826,63.19314849755367,0.10901119717150565,0.7847551656686136,0.6757439684971079,792893848,816599757.2,81.61575719616599,72.68259166258623,NaN,NaN,7.571507486673886,8.355750048837514
2022-05-10T09:30:00-04:00,77.23,78.69,75.13,76.75,56863902,40045060,48.508899901636,50.5869031161533,NaN,NaN,-37.73096612974329,52.63287867440588,-0.06286195554923135,0.5971665240605688,0.6600284796098002,849757750,826550064.8,82.46330115648999,72.94645479718896,NaN,NaN,5.570852809619556,7.957907586092092
2022-05-11T09:30:00-04:00,78.03,80.33,77.65,77.78,49852542,40939451.55,50.62426241623908,50.414457986788996,NaN,NaN,16.35381422888403,34.207902176112675,-0.10757855028202301,0.5255552917572714,0.6331338420392945,899610292,837394135.2,83.36346166627538,73.23359172478375,NaN,NaN,4.780034932083118,7.503925778376524
2022-05-12T09:30:00-04:00,77.75,78.15,75.6799,78.11,45021768,41958142.85,51.314366907661075,50.71878968625419,NaN,NaN,-20.711390223368916,12.289768868044776,-0.11467893150865671,0.4897851776534736,0.6044641091621303,944632060,866561951,85.5168890606053,73.87914316141394,NaN,NaN,4.3982689060782585,7.060260510905343
2022-05-13T09:30:00-04:00,79.27,81.1,79.13,80.78,29718696,42147341.85,56.59973939703075,51.86504943570769,NaN,NaN,72.84422449629591,3.3855461509693967,0.051764724675325446,0.6691700150062871,0.6174052903309617,974350756,892248941.2,87.1004533861742,75.28773569938828,NaN,NaN,5.847124418927696,6.886955354908537
2022-05-16T09:30:00-04:00,81.07,83.76,81.02,82.91,28259397,42037483.45,60.302229608136265,53.250846157661066,NaN,NaN,133.57071890858188,32.86528025612994,0.28367764916931937,0.9720023517926109,0.6883247026232915,1002610153,934192202.2,89.18066724869315,77.10194562682862,NaN,NaN,8.298180540739915,7.088558952884448
2022-05-17T09:30:00-04:00,84.03,84.3784,83.12,83.87,28164650,42302519.65,61.88065243672708,54.4795937669608,NaN,NaN,153.07845425028395,71.02716433213538,0.46915495855840794,1.2747684008213014,0.8056134422628934,1030774803,970395612.8,90.59107736360279,79.18128892301756,NaN,NaN,10.771512892936977,7.614695230034809
2022-05-18T09:30:00-04:00,84.47,84.57,80.735,81.72,33230686,42662071.15,56.46570889293454,54.82215062070543,NaN,NaN,106.19292628536469,88.99498674343151,0.41626206343841166,1.325941021560908,0.9096789581224963,997544117,989982377.8,91.25526316977275,81.18457043295571,NaN,NaN,11.124687038916175,8.116122631303575
2022-05-19T09:30:00-04:00,79.86,82.79,79.86,81.42,35720504,42819153.7,55.73285430208304,55.50401385929253,NaN,NaN,73.5887360987251,107.85501200785032,0.3338500077128985,1.3269914677636194,0.9931414600507209,961823613,993420688.4,91.37042437688048,83.085902992235,NaN,NaN,11.182076708011802,8.554116070833322
2022-05-20T09:30:00-04:00,82.42,83.3917,80.13,81.77,31919998,42627671.75,56.4431206813067,55.98762740077501,NaN,NaN,74.92456746449324,108.27108060148979,0.27797665992460585,1.340612284956478,1.0626356250318723,993743611,997299259.4,91.50630805478042,84.62484393392829,NaN,NaN,11.434440539768707,8.965590994966949
2022-05-23T09:30:00-04:00,82.74,84.22,82.225,83.93,26644672,41191795.5,60.64033827856121,56.37331847503064,NaN,NaN,105.16647280721766,102.59023138121695,0.3565426398216356,1.5083139248089168,1.1517712849872812,1020388283,1000854885.4,91.63632619552003,85.88361368461173,NaN,NaN,12.91277549624821,9.529474495149985
2022-05-24T09:30:00-04:00,83,84.6,82.36,84.25,26563838,40290770.1,61.23628985962884,56.31042957903695,NaN,NaN,102.82088658677085,92.53871784851432,0.3970168930771101,1.6480424013336687,1.2510255082565587,1046952121,1004090349,91.75993326300167,86.91457024374186,NaN,NaN,14.289808673099586,10.20952223485707
2022-05-25T09:30:00-04:00,84.54,86.11,84.42,85.99,26323997,39378657.1,64.39329546647954,56.733724230387075,NaN,NaN,137.80430442199312,98.86099347584002,0.5012104636103474,1.877538587769493,1.3763281241591456,1073276118,1019236749.2,92.33131298404501,87.90826998574052,NaN,NaN,16.41862102678308,11.096536347989357
2022-05-26T09:30:00-04:00,86.51,87.585,86.4501,86.94,21339145,38258871.95,66.02044241540564,56.94723480755187,NaN,NaN,160.19766651320333,116.18277955873566,0.5883217541789225,2.1117303168827988,1.5234085627038763,1094615263,1045795079.2,93.21918796451696,88.7793116490374,NaN,NaN,18.68549677625942,12.180673552027937
2022-05-27T09:30:00-04:00,86.55,88.77,86.34,88.53,18667247,37206828.3,68.6062510360506,58.48346082856288,NaN,NaN,164.95424474412312,134.18871501466165,0.6996620853685058,2.3979861694145086,1.6983240840460028,1113282510,1069702859,93.90347219467459,89.6570055775023,NaN,NaN,21.416956814436116,13.50014258951482
2022-05-31T09:30:00-04:00,89.99,90.46,86.73,87.2,39340576,36570326.1,64.2048997616083,59.60460367570376,NaN,NaN,154.2910553091648,144.01363151505106,0.6324098159154494,2.4888363539403144,1.856426538024865,1073941934,1080413589.2,94.18651734776456,90.49437816259334,NaN,NaN,22.48476152798947,14.783659580725484
2022-06-01T09:30:00-04:00,88.3,89.265,87.33,88.62,29648579,35970283.25,66.66389973269648,60.750292055450714,NaN,NaN,140.896250680342,151.62870433376528,0.6308018249918272,2.644928819264649,2.014126994272822,1103590513,1091741267.6,94.47848704099385,91.2883085465018,NaN,NaN,24.1241884427732,16.1180208467323
2022-06-02T09:30:00-04:00,88,88.96,87.4624,88.34,26302723,35016233,65.70540352730643,61.778223242568245,NaN,NaN,118.42355861260958,147.7525551718886,0.5604949362034342,2.714745664527115,2.1542507283236807,1077287790,1092543602,94.49955867017891,91.92992780432849,NaN,NaN,25.20306033444878,17.4158836306918
2022-06-03T09:30:00-04:00,88.45,89.79,88.35,89.51,20525334,33712651.75,67.78946323911534,62.577489231288574,NaN,NaN,121.93333415826886,140.0996887009017,0.5420726436386936,2.8318415328720477,2.289768889233354,1097813124,1093183174.2,94.51751989431109,92.4597182691954,NaN,NaN,26.722979649975194,18.745468776303714
2022-06-06T09:30:00-04:00,89.94,90,88.93,89.41,16692311,32191126.1,67.41239233499849,63.08535799749302,NaN,NaN,111.25431480169283,129.35970271241564,0.474852411579596,2.883334403707849,2.408481992128253,1081120813,1086750834.8,91.28887481117685,92.61030452365853,NaN,NaN,27.877431085861165,20.050034820526207
2022-06-07T09:30:00-04:00,89.35,92.2,89.28,92.08,25689374,30824496.95,71.90577876958899,63.8014384498403,NaN,NaN,127.15310378527363,123.93211240763739,0.5562630161355107,3.103810762297641,2.5475477461621305,1106810187,1093324485.4,91.60450367625089,92.68269211741911,NaN,NaN,30.273030465192146,21.5104627697642
2022-06-08T09:30:00-04:00,92.53,93.31,91.7105,92.28,28492681,29405935.9,72.21483513054054,64.92637603824072,NaN,NaN,134.77707555255938,122.70827738208088,0.5676674056445963,3.257132003217876,2.68946459757328,1135302868,1099666956.4,91.90910756444535,92.72939528846715,NaN,NaN,32.32581150407875,23.05551258895199
2022-06-09T09:30:00-04:00,91.49,92.07,90.14,90.24,24588142,28142715.9,64.42929219531004,65.54755017347122,NaN,NaN,95.76374559494002,118.17631477854698,0.3903500230688204,3.177402126409305,2.7870521033404847,1110714726,1106352343.6,92.22915197099337,92.79073297376091,NaN,NaN,31.903003817469184,24.31943990731159
2022-06-10T09:30:00-04:00,89.2,90.54,87.6838,88.71,31271763,27455215.65,59.26832519817378,65.74935049610458,NaN,NaN,54.978865281346906,104.78542100316261,0.13569808198100253,2.956674705816738,2.8209766238357354,1079442963,1102678311.4,90.11939154929013,92.69166750908305,NaN,NaN,29.99135324113473,25.129713240714896
2022-06-13T09:30:00-04:00,86.02,86.11,82.41,84.08,44731346,28205848.15,46.999226152547976,64.7749853442465,NaN,NaN,-51.63744873168665,72.20706829648671,-0.3522204278310954,2.380701089046866,2.7329215168779615,1034711617,1093396472.2,84.8393421782158,92.20616865070417,NaN,NaN,23.903598732627454,24.954554025273833
2022-06-14T09:30:00-04:00,85.77,86.87,83.14,84.24,34756409,28530698.75,47.40442009134589,63.78699464651201,NaN,NaN,-43.589168012485594,38.05861393693486,-0.6542790179751901,1.915072744408974,2.569351762384164,1069468026,1085928040,80.74023002761662,91.41904699103381,NaN,NaN,19.301662469555357,24.14699808874262
2022-06-15T09:30:00-04:00,84.05,84.47,80.99,82.38,43223150,29283623.75,43.26364640382329,62.27773399917941,NaN,NaN,-89.6960705341742,-6.836015280411902,-0.951430247435546,1.3800639530897314,2.3314942005252774,1026244876,1064116441.6,70.08931207862064,89.83033264064636,NaN,NaN,14.03770076371638,22.702812756596014
2022-06-16T09:30:00-04:00,80.19,80.625,77.07,77.74,57979147,30521046.8,35.04073541959015,60.0648977851926,NaN,NaN,-166.92998775158694,-59.374761949717296,-1.4051730832479337,0.5750278464653604,1.980200929713294,968265729,1035626642.2,59.119176083763975,87.39461750630687,NaN,NaN,6.155137086833764,20.338859089487123
2022-06-17T09:30:00-04:00,77.2,77.77,72.595,73.49,64234188,31946731,29.5084508459732,57.272197771615645,NaN,NaN,-215.99113655976186,-113.56876231793903,-1.9051869924275502,-0.4012828108211437,1.5039041816064065,904031541,1000544357.8,48.957553159467246,84.18419471807779,NaN,NaN,-2.812514646773168,17.03151998430708
2022-06-21T09:30:00-04:00,74.61,76.96,74.48,76.44,35006746,32101068.4,36.949552565405945,55.325387257601186,NaN,NaN,-169.77205142449642,-137.195682856501,-1.9441616725984585,-0.9262979091416668,1.0178637634567917,939038287,981409691.8,44.46802924504075,80.63287413931178,NaN,NaN,-7.2974419810717785,13.55595398925296
2022-06-22T09:30:00-04:00,72.76,74.67,72.355,73.38,41212617,32829465.65,33.05207992991477,52.924542985973915,NaN,NaN,-177.7425767382166,-164.02636460164723,-2.0712358005325004,-1.5711809872088338,0.5000548133236666,897825670,947081220.6,37.77525403051737,76.58264320999204,NaN,NaN,-12.39634961628196,9.848482045605113
2022-06-23T09:30:00-04:00,73.73,74.26,69.47,70.66,56921148,34347331.15,30.020785615319937,50.37564170654631,NaN,NaN,-169.98450579244488,-180.08405165330134,-2.220448748732868,-2.275506122592418,-0.05505737385955034,840904522,910013149.8,32.14859543956793,72.1290029792341,NaN,NaN,-17.607501760548878,5.926198644725972
2022-06-24T09:30:00-04:00,71.87,73.11,70.83,71.59,47398507,35401056.65,32.30677008210327,47.841163623902595,NaN,NaN,-136.2923169672136,-173.95651749642667,-2.137720566485135,-2.727208081965969,-0.5894875154808342,888303029,894020609.8,30.067721215034112,67.52544593071431,NaN,NaN,-20.82128992827149,2.1051288485834774
2022-06-27T09:30:00-04:00,72.42,74.195,72.33,73.69,33979401,36033069.45,37.28841766544511,45.68945114750592,NaN,NaN,-102.2477489299357,-151.20783997046144,-1.8344139608801062,-2.882504966580967,-1.048091005700861,922282430,897670787.6,31.162906523109314,63.23073391013806,NaN,NaN,-21.745081057600384,-1.302043995157074
2022-06-28T09:30:00-04:00,75.44,76.9,74.54,75.68,39800401,37089727.15,41.66912951092468,43.529690486172754,NaN,NaN,-69.83510834775534,-131.2204513551132,-1.4115918488244295,-2.8125808167313977,-1.4009889679069683,962082831,902279696.4,32.59823071291592,59.016000127042716,NaN,NaN,-21.031437994102372,-4.12052885214926
2022-06-29T09:30:00-04:00,76.73,76.99,72.8443,73.05,35591959,36902296.3,37.90092793752156,41.078697115242825,NaN,NaN,-74.70639251577904,-110.61321451062572,-1.227645069998437,-2.9355453054050145,-1.7079002354065775,926490872,908012736.8,34.42972699910217,54.91033008666107,NaN,NaN,-21.68061691870798,-6.629112861657648
2022-06-30T09:30:00-04:00,71.48,73.365,70.87,71.51,37766738,37308204.25,35.856208529208374,39.03776256766413,NaN,NaN,-87.51145314902215,-94.11860398194116,-1.130704211357436,-3.1212804996033725,-1.9905762882459366,888724134,917576659.2,37.48167951821297,50.99979634003388,NaN,NaN,-22.866120779983415,-8.948685421418471
2022-07-01T09:30:00-04:00,72.38,72.89,70.13,72.58,34601989,37723167.55,38.345062843983335,37.5432438280791,NaN,NaN,-79.89738328251212,-82.83961724500087,-0.9242375717210134,-3.1458732528972035,-2.22163568117619,923326123,924581278,39.69555529677556,47.39809375056857,NaN,NaN,-23.04482559379137,-10.962419731757457
2022-07-05T09:30:00-04:00,71.08,71.415,68.19,69.7,44932941,38943547.9,34.46838928993293,36.648184052178024,NaN,NaN,-91.96014205043608,-80.78209586910094,-0.9099188645431169,-3.3590342618550864,-2.4491153973119695,878393182,915803428.4,37.88504075067855,44.04421507717304,NaN,NaN,-24.430011728855128,-12.886361445628552
2022-07-06T09:30:00-04:00,68.95,70.19,66.45,68.51,48209505,40519407.6,32.984508698718685,35.61819038127609,NaN,NaN,-98.7526767104903,-86.56560954164793,-0.906859628195174,-3.5826899325559367,-2.6758303043607627,830183677,889423597.6,33.01199527062373,40.63505545167356,NaN,NaN,-26.018448235717607,-14.762373844212702
2022-07-07T09:30:00-04:00,70.37,71.54,70.2,70.98,33793561,40924616.95,38.86733430384249,35.30416808842031,NaN,NaN,-69.55555704392398,-85.53544244727692,-0.6753784141515973,-3.5200533220502592,-2.844674907898662,863977238,876920870.8,30.978204081253153,37.84140488043302,NaN,NaN,-25.529415378188915,-16.300522634780734
2022-07-08T09:30:00-04:00,71.84,72.14,69.9599,70.95,21970314,40598498.6,38.82275778646343,35.574312543196974,NaN,NaN,-66.10734888705765,-81.25462159488401,-0.47086619302551913,-3.433257649180561,-2.962391456155042,842006924,867577428.8,29.514809611568182,35.726807275276165,NaN,NaN,-25.15409852258463,-17.56531919018129
2022-07-11T09:30:00-04:00,70.06,70.86,69.33,70.27,22754116,40506797.3,37.76548089461109,36.16410040381396,NaN,NaN,-75.68580302574918,-80.41230554353143,-0.3343867649369181,-3.3803749123261895,-3.0459881473892714,819252808,846762765.8,26.510341068530494,34.123434983066396,NaN,NaN,-25.14090153898148,-18.64754524000989
2022-07-12T09:30:00-04:00,68.43,69.305,67.66,68.9,32345148,40560466.55,35.6584946477208,36.07188198112217,NaN,NaN,-99.33340265807298,-81.88695766505882,-0.2909755036093502,-3.4097075269009594,-3.118732023291609,786907660,828465661.4,24.180185244503235,32.67430326874229,NaN,NaN,-25.72206868559347,-19.65819144652183
2022-07-13T09:30:00-04:00,67.9,70.23,67.9,68.79,29489039,39798351.2,35.48729754489405,36.245826096477835,NaN,NaN,-90.71586969560853,-80.27959626208245,-0.2270998077887989,-3.4026067830276077,-3.1755069752388088,757418621,813912650.2,22.487174478740158,31.58229758647249,NaN,NaN,-26.246427079596135,-20.599367965532444
2022-07-14T09:30:00-04:00,66.38,67.57,65.48,67.49,36636771,39892369.3,33.44375453144869,36.490323876201316,NaN,NaN,-132.9528662197288,-92.9590580972434,-0.2291712839580402,-3.461971080186359,-3.232799796228319,720781850,785273572.6,19.58155860841974,30.684652098533338,NaN,NaN,-27.256220484919737,-21.550346896873485
2022-07-15T09:30:00-04:00,68.96,69.03,67.57,68.59,29960251,39229224.35,36.762105178586516,36.80856209737869,NaN,NaN,-96.61660974836425,-99.06091026950473,-0.11878385884258602,-3.3812796197815516,-3.2624957609389655,750742101,767020608,17.98639071011212,29.821699919610335,NaN,NaN,-27.228706478358994,-22.361541122799988
2022-07-18T09:30:00-04:00,70.42,71.32,69.83,70.16,25726762,37616605.1,41.26336588359059,37.09248697010337,NaN,NaN,-31.371472386659185,-90.19804414168674,0.0865689701121406,-3.15428454829879,-3.2408535184109306,776468863,758463819,17.275894473760943,28.829770487514022,NaN,NaN,-25.955364648325407,-22.874944483589335
2022-07-19T09:30:00-04:00,70.06,72.5,70.04,72.32,24388176,35624304.5,46.86688459515593,37.46375519040561,NaN,NaN,12.887554613851567,-67.75385268730182,0.3781344532428883,-2.7681854518573203,-3.1463199051002086,800857039,761253694.8,18.407581391891057,27.81615267886939,NaN,NaN,-23.192199169794964,-22.920266581618712
2022-07-20T09:30:00-04:00,71.52,73.35,71.22,73.02,20924706,34920202.5,48.57895508087608,38.22647141493092,NaN,NaN,55.829273789504136,-38.44482399027931,0.6144163792981958,-2.3782994309774637,-2.9927158102756595,821781745,774126319.6,23.600949441716807,27.04266856762758,NaN,NaN,-20.3868886090474,-22.558355442679954
2022-07-21T09:30:00-04:00,71.02,71.81,69.66,71.74,21579587,33938551,45.68039175953284,38.92819878852553,NaN,NaN,4.50028005577296,-10.954194735178955,0.6759020002268734,-2.1478383099920677,-2.823740310218941,800202158,790010381.2,29.55899694377682,26.47676266945357,NaN,NaN,-18.761444565183773,-22.01593960303764
2022-07-22T09:30:00-04:00,72.02,72.73,70.735,71.15,20418165,32113401.85,44.36633271314017,39.3582894934653,NaN,NaN,23.615208114990796,13.092168837492057,0.6670991762748288,-1.9898663398754053,-2.656965516150234,779783993,795818759.6,31.657852933591613,25.902641072083288,NaN,NaN,-17.74837326637848,-21.40628726922919
2022-07-25T09:30:00-04:00,72.13,73.83,71.27,73.76,19556000,30721276.5,51.0716429001534,40.54423617990962,NaN,NaN,77.18101914973019,34.80266714476993,0.8173984456160701,-1.6352174591301463,-2.4526159047462164,799339993,800392985.6,33.34229041328224,25.57815890512641,NaN,NaN,-14.850124115359254,-20.469692532962057
2022-07-26T09:30:00-04:00,74.64,74.965,72.595,73.09,18614370,29953024.95,49.424826011995265,41.71854455942938,NaN,NaN,100.27773250490574,52.28070272298076,0.8483559349349483,-1.3921709860775309,-2.240526921012479,780725623,796366702.4,32.58108271092509,25.54737943657651,NaN,NaN,-12.891905965455317,-19.387151594746808
2022-07-27T09:30:00-04:00,73.56,75.113,72.81,74.74,22405348,29083272.3,53.40919475813335,42.75724887759301,NaN,NaN,135.38814904180808,68.19247777344155,0.949012871101881,-1.0542608321351281,-2.003273703237009,803130971,792636547.6,31.855479639567534,25.610041976456106,NaN,NaN,-10.014397651401175,-18.048186745697432
2022-07-28T09:30:00-04:00,75.41,75.925,73.77,75.16,23332670,28470307.85,54.39409722652017,43.86948740902564,NaN,NaN,161.33509204253954,99.55944017079487,1.0074207485343856,-0.7439977675690272,-1.7514185161034128,826463641,797888844.2,34.081593488229686,25.93624082478907,NaN,NaN,-7.347570855251963,-16.51952733277665
2022-07-29T09:30:00-04:00,76.53,78.66,76.38,78.42,25833814,27873661.65,61.242667027506215,45.546429275661005,NaN,NaN,223.31841620404404,139.50008178860554,1.2152319465789554,-0.23237858287971846,-1.4476105294586739,852297455,812391536.6,39.917992113165134,26.893930185120116,NaN,NaN,-2.731345245808695,-14.54978703463837
2022-08-01T09:30:00-04:00,77.08,77.275,75.77,76.8,25665504,27426837.4,56.68707352997962,47.04847062439377,NaN,NaN,153.5167574378846,154.7672294462364,1.1915924863140634,0.04188007843390551,-1.149712407880158,826631951,817849928.2,41.99946604130318,28.16673595632011,NaN,NaN,-0.181107082607746,-12.497118470062567
2022-08-02T09:30:00-04:00,76.81,77.39,75.94,76.62,19932173,26176799,56.186960029493946,48.52701794472234,NaN,NaN,130.85762816013158,160.88320857728158,1.1133050125213564,0.24191885777153743,-0.8713861547498188,806699778,823044759.2,43.98829195853541,29.702530062019772,NaN,NaN,1.731665752680721,-10.46443500967067
2022-08-03T09:30:00-04:00,76.945,77.17,73.96,74.42,28506573,25191652.4,50.3411761128351,49.73397662910708,NaN,NaN,80.61205210740466,149.9279891904009,0.8734200530638456,0.2203889115799882,-0.6530311414838574,778193205,818057206,42.482129365845616,31.33828511612162,NaN,NaN,1.6654127857721537,-8.731599610321695
2022-08-04T09:30:00-04:00,73.91,74.12,71.39,71.66,27995502,24901749.45,44.137037565719815,50.26075751390232,NaN,NaN,3.1297200747118947,118.28691479683536,0.5070954935074891,-0.019161774599496084,-0.5262572681069851,750197703,802804018.4,38.176927806250234,32.78046633727434,NaN,NaN,-0.3826467600237668,-7.538892060279133
2022-08-05T09:30:00-04:00,70.69,73.71,70.69,73.08,22589765,24932722,47.707784853533205,50.721073154612505,NaN,NaN,4.045900186786254,74.4324115933838,0.3463264424391329,-0.09334921505806903,-0.43967565749720194,772787468,786902021,34.27692583613516,33.99482572030107,NaN,NaN,-0.9775813607101428,-6.601561960340706
2022-08-08T09:30:00-04:00,73,74.12,72.89,73.46,18882650,24739148.7,48.65364025238274,50.84869855870013,NaN,NaN,28.448143462075596,49.41868879822199,0.2556636627470291,-0.12009607906341557,-0.3757597418104447,791670118,779909654.4,32.695290896370295,35.01537639919245,NaN,NaN,-1.1757084674855356,-5.826440032789967
2022-08-09T09:30:00-04:00,74.5,75.7,74.37,74.75,17341547,23988968.65,51.83841881699132,51.08151739699408,NaN,NaN,63.71945532549847,35.99105423129538,0.271186193365216,-0.036777000103924706,-0.3079631934691407,809011665,780372031.8,32.91572673161748,35.68071763418535,NaN,NaN,-0.39875600419139534,-5.051056600133029
2022-08-10T09:30:00-04:00,74.92,75.715,73.44,75.29,17394167,23384225.05,53.148451892905314,51.614950263663545,NaN,NaN,53.68318200233529,30.605280210281514,0.3039685665765706,0.07199751475157257,-0.23197105182499805,826405832,790014557.2,37.51206314536836,36.24879379144189,NaN,NaN,0.620505795611527,-4.240833400740949
2022-08-11T09:30:00-04:00,76.7,78.54,76.471,77.88,30265776,23065675.3,58.920120333038604,52.65450652222772,NaN,NaN,133.22761845889175,56.62485988711747,0.47598397354902233,0.36300891511127986,-0.11297505843774247,856671608,811309338.2,46.26780139140226,37.29236153842837,NaN,NaN,3.308696708203855,-3.16232909946312
2022-08-12T09:30:00-04:00,77.37,78.51,77.04,78.47,19190468,22527186.15,60.12519223977676,53.3011886179151,NaN,NaN,132.82767477325626,82.38121480441148,0.5975304254226346,0.6339379733405508,0.0364075479179162,875862076,831924259.8,53.11652404844745,38.70480679808303,NaN,NaN,5.874747386024902,-1.8713181729648314
2022-08-15T09:30:00-04:00,75.63,77.36,74.94,76.94,21012209,22291458.5,55.572504426011534,53.74030850463055,NaN,NaN,70.64126938575413,90.8198399891472,0.5444169081322696,0.7169286830832533,0.17251177495098363,854849867,844560209.6,56.75501737666199,40.43151641706423,NaN,NaN,6.740179906582647,-0.6411041616009061
2022-08-16T09:30:00-04:00,77.05,77.86,76.275,76.76,19678778,22055988.6,55.04443554755354,53.857111418160564,NaN,NaN,82.70769358744799,94.6174876415371,0.4695272141340921,0.7594207926185987,0.28989357848450664,835171089,849792094.4,58.201449201903955,42.31337138580255,NaN,NaN,7.295692819886665,0.492723978611604
2022-08-17T09:30:00-04:00,76.41,78.2,76.21,77.4,22736164,22146561.5,56.62271927725462,54.016298707498734,NaN,NaN,85.88250888566208,101.05735301820246,0.4361748127927307,0.83511209447542,0.3989372816826893,857907253,856092378.6,59.93912719132082,44.16033807888049,NaN,NaN,8.20193066191816,1.5940392190839692
2022-08-18T09:30:00-04:00,78.26,79.56,78.12,79.48,23432974,22239230.85,61.36950806163463,54.02535878136506,NaN,NaN,135.03082132195988,101.41799359081608,0.5215088750381159,1.0508233754803342,0.5293145004422183,881340227,861026102.4,61.296072938078254,45.687343852088574,NaN,NaN,10.407986972746489,2.853174612464329
2022-08-19T09:30:00-04:00,79.28,80.0061,78.82,79.46,19744227,22205533.95,61.30004567089821,54.35485679143066,NaN,NaN,133.3415917606205,101.52077698828892,0.5415542425363188,1.2062573036126167,0.664703061076298,861596000,858172887.2,60.029725678167104,46.975219540435994,NaN,NaN,12.186283072202079,4.186475820998293
2022-08-22T09:30:00-04:00,78.78,79.8,77.48,79.31,22848067,22370137.3,60.744715164709014,54.68041072966031,NaN,NaN,102.92679229691839,107.97788157052177,0.5100965017713386,1.3023236882904712,0.7922271865191326,838747933,854952500.4,58.55919709885193,48.01599847903003,NaN,NaN,13.520929910226382,5.519969262316591
2022-08-23T09:30:00-04:00,80.61,82.79,80.55,82.17,27183512,22798594.4,66.90155410881886,55.86329487223058,NaN,NaN,187.27717572553348,128.89177799813888,0.638935232262084,1.5908962268467377,0.9519609945846537,865931445,861104571.6,60.54748732298935,49.306381190254584,NaN,NaN,16.616345065773256,7.105165805667543
2022-08-24T09:30:00-04:00,82.18,83.295,81.81,83.18,24546602,22905657.1,68.76469393764336,57.62241318451083,NaN,NaN,188.1259855193769,149.34047332488183,0.7419718056286675,1.879425751620488,1.1374539459918205,890478047,867618730.4,62.594000527960965,51.050457813233926,NaN,NaN,19.79710488481038,8.918299959830804
2022-08-25T09:30:00-04:00,83.66,84.235,83.01,83.82,19899277,22733987.45,69.92015861354403,59.20901131022589,NaN,NaN,182.7457236962292,158.8834537997357,0.7981310999019018,2.1351178208691977,1.3369867209672959,910377324,873426149.8,64.36852976377568,53.19985809377972,NaN,NaN,22.79637276850652,10.90088178964162
2022-08-26T09:30:00-04:00,83.65,84.56,82.47,82.84,19317554,22408174.45,65.90014030002854,60.440904170772015,NaN,NaN,144.74789072717567,161.16471359304674,0.7167609431919859,2.232937899957278,1.5161769567652923,891059770,879318903.8,66.1246163346326,55.5876670536556,NaN,NaN,24.222942682114194,12.80403334570913
2022-08-29T09:30:00-04:00,82.8,85.18,82.59,84.09,26062525,22428025.5,68.39608592457094,61.62359467845628,NaN,NaN,136.56275089047435,167.8919053117579,0.6941352962046383,2.38384607702109,1.6897107808164518,917122295,894993776.2,70.31555663886202,58.25908347560164,NaN,NaN,26.184582227077108,14.715540328761698
2022-08-30T09:30:00-04:00,82.65,82.67,80.57,81.24,28820855,22872459.6,57.976426961898696,61.96845004052723,NaN,NaN,71.82478395707032,144.8014269580653,0.4462811472416799,2.2475622148685517,1.8012810676268718,888301440,899467775.2,71.40304253558544,60.67986771776,NaN,NaN,24.70576043151275,16.142714629154707
2022-08-31T09:30:00-04:00,79.23,81.84,78.94,80.5,29152256,22904743.75,55.607628184879424,61.73184345851586,NaN,NaN,43.41745926331933,115.85972170685378,0.2038891663371165,2.0561425255482675,1.852253359211151,859149184,893202002.6,67.66436372827627,62.20819359896529,NaN,NaN,22.757330771708688,17.087659792376705
2022-09-01T09:30:00-04:00,79.31,79.61,77.42,78.52,28302095,22920073.4,49.75040831629983,60.990787463981796,NaN,NaN,-6.146731291495815,78.08123070930876,-0.10197125306198429,1.7247892928836706,1.8267605459456548,830847089,877295955.6,59.191450879790615,62.64211694406123,NaN,NaN,19.171507569085662,17.385352331906557
2022-09-02T09:30:00-04:00,80.45,81.02,79.53,79.96,28594084,23220289.35,53.57993324638618,60.84846095115142,NaN,NaN,27.52132435908862,54.63591743569136,-0.21308992815738304,1.560398135748926,1.773488063906309,859441173,870972236.2,56.17951491184864,62.601009625145984,NaN,NaN,17.337743968152598,17.378551137084564
2022-09-06T09:30:00-04:00,80.71,80.98,78.89,79.22,22784132,23415363.45,51.41159345517345,60.588972230267125,NaN,NaN,7.088714031369383,28.741110063870376,-0.33496005820693076,1.3547879911476457,1.6897480493545765,836657041,854879185.4,49.30380339202058,61.965463495868605,NaN,NaN,15.163171463466544,17.062068326567704
2022-09-07T09:30:00-04:00,77.49,78.64,76.78,78.3,30270666,24061819.4,48.76911856713188,60.02800075097264,NaN,NaN,-54.48439253311203,3.4792747658338983,-0.46790409609247896,1.1048679292389778,1.5727720253314568,806386375,838496172.4,43.4709759372,60.78916697771712,NaN,NaN,12.540536312025576,16.416135181633116
2022-09-08T09:30:00-04:00,78.65,79.03,77.69,78.64,26840760,24534149.05,49.79610102233651,59.20132881959421,NaN,NaN,-46.236098717680655,-14.4514368303661,-0.5193431942343041,0.9235930325385766,1.4429362267728807,833227135,833311762.6,41.78627582951518,59.39561004139119,NaN,NaN,10.686837912324336,15.597664143160433
2022-09-09T09:30:00-04:00,80.05,80.99,79.455,80.6,19339380,23987829.25,55.352463102341375,58.77650149326872,NaN,NaN,15.078114445512156,-10.206467682964504,-0.41243174905756197,0.9273965404509283,1.3398282895084903,852566515,837655647.8,43.75318737685678,58.233000162726164,NaN,NaN,10.696483123530665,14.897495426070465
2022-09-12T09:30:00-04:00,81.78,82.97,81.08,82.08,20865906,24071601.15,59.03896405924678,58.654662128592854,NaN,NaN,68.16814277198026,-2.0771040003861776,-0.2415661889575187,1.037870553311592,1.2794367422691106,873432421,840453897.4,45.0414010183084,57.2674432998302,NaN,NaN,11.83632601158317,14.460185509715137
2022-09-13T09:30:00-04:00,80.8,82.18,79.65,80.01,30573038,24549642.6,52.50855713246209,57.62659091599594,NaN,NaN,10.719323449280601,-1.3509821168039338,-0.2655746119673026,0.9474684773099824,1.213043089277285,842859383,841694365.8,45.63581199524255,56.20232363356257,NaN,NaN,10.762402595826636,13.931930807731066
2022-09-14T09:30:00-04:00,80.76,82.85,80.76,82.27,27192149,24925311.15,57.97418921146685,56.8558405784119,NaN,NaN,55.9429219546022,20.734480780738913,-0.1335319284563128,1.0461281787068941,1.179660107163207,870051532,854427397.2,51.441422688385124,55.40571093073573,NaN,NaN,11.623923647462233,13.602215499121233
2022-09-15T09:30:00-04:00,80.81,81.15,79.755,80.15,27943150,25185660.45,51.93601351743239,55.57125878583249,NaN,NaN,-17.28490163720471,26.524720196834103,-0.1898183514959375,0.9423871677932851,1.1322055192892226,842108382,856203646.6,52.208158219597365,54.53711296329442,NaN,NaN,10.329483750239456,13.13468239213812
2022-09-16T09:30:00-04:00,79.9,79.96,77.3,78.44,35201836,25774103.55,47.62707856846248,54.266040090720644,NaN,NaN,-93.8866873949376,4.731759828744151,-0.334597306091138,0.7139588866753002,1.0485561927664382,806906546,847071652.8,48.010898744712065,53.243275992585815,NaN,NaN,7.804091310096959,12.373169380417956
2022-09-19T09:30:00-04:00,75.46,77.69,75.28,77.64,18812925,25727538.45,45.71612853462088,52.64604313429563,NaN,NaN,-151.93000724837424,-39.287870175326745,-0.4684154240276579,0.46303691273186587,0.9314523367595238,788093621,830003892.8,41.32399133034937,51.17244989912063,NaN,NaN,5.158422966297687,11.342491321257917
2022-09-20T09:30:00-04:00,77.1,77.545,76.19,77.1,21149842,25642627.2,44.42053831102367,51.67776537351885,NaN,NaN,-137.67079565930595,-68.96589399704405,-0.5706883289323885,0.21809192559403812,0.7887802545264266,766943779,814820772,36.459223756856844,48.676462843497156,NaN,NaN,2.62371833357905,10.09695232301808
2022-09-21T09:30:00-04:00,78.55,78.6601,75.94,75.97,34352932,26001098.2,41.75389701810811,50.688213147320894,NaN,NaN,-123.94045645758077,-104.94256967948066,-0.6841796982804432,-0.06644436832412737,0.6177353299563159,732590847,787328635,29.652306776121677,45.96131591834325,NaN,NaN,-0.3236702327881233,8.608291957902908
2022-09-22T09:30:00-04:00,77.35,77.6,75.64,75.7,28874033,26217469.75,41.11872634098329,50.071664434798286,NaN,NaN,-125.44942093844878,-126.57547353972946,-0.7423106038760904,-0.3101529248887971,0.4321576789872933,703716814,759650321.4,24.66047173337101,43.49481740788472,NaN,NaN,-2.9047761392276694,6.963567944027112
2022-09-23T09:30:00-04:00,72.76,72.9,69.94,70.48,52737815,27859396.65,31.22798561249816,48.475096746663425,NaN,NaN,-246.84990624760704,-157.16811731026337,-1.0769008850512465,-0.9139684273267648,0.16293245772448167,650978999,728464812,20.477566815518628,40.94467825814685,NaN,NaN,-8.967533726578386,4.687696276797755
2022-09-26T09:30:00-04:00,70.04,70.92,68.66,68.75,36079816,28697509.75,28.758975555648178,46.85705261098305,NaN,NaN,-243.84263132822917,-175.55064212623432,-1.3420526498327616,-1.5146333545664703,-0.17258070473370873,614899183,693825924.4,17.023562739032684,38.63894678293343,NaN,NaN,-14.790736091051063,1.9050630813907814
2022-09-27T09:30:00-04:00,69.94,70.81,69.13,69.52,33835551,29086161.05,31.360236798698125,45.61356105609492,NaN,NaN,-192.88003101812762,-186.59248919799867,-1.3871790351315176,-1.9065544986481058,-0.5193754635165881,648734734,670184115.4,15.1458098245067,36.61572063202677,NaN,NaN,-18.570357339286687,-1.0199969787059997
2022-09-28T09:30:00-04:00,70.22,72.995,69.8,72.6,31573751,29223805.85,40.68917941571573,44.963066655622015,NaN,NaN,-124.17589485204932,-186.6395768768924,-1.1414517104479107,-1.9461901015764766,-0.8047383911285659,680308485,659727643,14.389792587072236,34.65882897185228,NaN,NaN,-18.700683716450424,-3.545809369812346
2022-09-29T09:30:00-04:00,72.07,72.75,70.8,72.6,24281497,28980267.9,40.68917941571573,43.915689249434465,NaN,NaN,-103.8562118255475,-182.32093505431214,-0.9202611527435014,-1.9550648320579427,-1.0348036793144413,680308485,655045977.2,14.051599399957567,32.53728697350233,NaN,NaN,-18.801043113271277,-5.725128476020764
2022-09-30T09:30:00-04:00,72.02,73.02,71.32,72.02,21684701,28649398.2,39.51623128471045,42.521208336967575,NaN,NaN,-89.11731324092747,-150.77441645297623,-0.760961723457872,-1.9860058336367814,-1.2250441101789094,658623784,656574934.2,14.756215543642767,30.374059439597648,NaN,NaN,-19.235381227964073,-7.655164583441237
2022-10-03T09:30:00-04:00,74.61,76.49,74.49,76.09,34775311,28958459.55,50.33548231201942,42.365988706935966,NaN,NaN,-15.196061521116562,-105.04510249155369,-0.3503186713010711,-1.6629424493052483,-1.3126237780041772,693399095,672274916.6,21.841833465508955,28.674489544616677,NaN,NaN,-15.97820307473473,-8.84417008219745
2022-10-04T09:30:00-04:00,77.63,79.43,77.02,79.36,33165429,29477524.4,56.99198057945358,42.29583094750644,NaN,NaN,44.922226431496384,-57.484651001628905,0.14607942304664645,-1.1300244991958692,-1.2761039222425157,726564524,687840874.6,28.213043485082494,27.015319601523633,NaN,NaN,-10.778655319897595,-9.120525116154614
2022-10-05T09:30:00-04:00,79.33,81.63,78.65,81,30636847,29495833.45,59.895180516104084,42.86434287598299,NaN,NaN,77.05067403429919,-17.239337224359183,0.5658493715469741,-0.5687922078087979,-1.134641579355772,757201371,703219451.8,33.942272390808,25.710613470895826,NaN,NaN,-5.5771302222159305,-8.614325845591944
2022-10-06T09:30:00-04:00,80.34,82.69,80.28,82.44,26335115,29470551.2,62.30150839937664,43.912516435334005,NaN,NaN,97.04658515774987,22.9412221723003,0.9015320304858502,-0.007726541248459284,-0.9092585717343095,783536486,723865052,40.77581300514781,25.193821632355515,NaN,NaN,-0.5572178825414453,-7.463310422299016
2022-10-07T09:30:00-04:00,82.61,83.54,81.21,81.8,28457658,29926465.1,60.56225663705487,44.97295415693643,NaN,NaN,100.41670289416165,60.84802539931813,1.0321178510988462,0.3808887421392484,-0.6512291089595978,755078828,743156060.8,46.359570008250316,25.55350582363416,NaN,NaN,2.8890239948116943,-5.9844055055689145
2022-10-10T09:30:00-04:00,82.12,82.82,79.86,80.12,23165843,30041461.95,56.13238277951543,45.809514476114416,NaN,NaN,79.20505041460574,79.72824778646259,0.9585846466068689,0.5470016992989883,-0.4115829473078806,731912985,750858838.8,48.44952623021206,26.40995600030239,NaN,NaN,4.397902882903333,-4.501218592930022
2022-10-11T09:30:00-04:00,78.62,80.85,78.29,79.48,26921104,29858865.25,54.49700781907449,46.719736676183445,NaN,NaN,54.66689338897521,81.67718117795836,0.825153885768068,0.6198594099022046,-0.20529447586586352,704991881,746544310.2,47.33698482152065,27.673147289259465,NaN,NaN,5.128258646286951,-3.1255789873275974
2022-10-12T09:30:00-04:00,78.96,80.675,78.44,80.12,20551213,29526818.45,55.88124897827468,47.77420257884711,NaN,NaN,62.25472537055867,78.71799144521025,0.7409810750561014,0.7209318679542633,-0.020049207101838162,725543094,740212654.8,45.67925310921253,29.174488816105285,NaN,NaN,6.134128418639872,-1.8027636436179593
2022-10-13T09:30:00-04:00,79.07,83.71,79.05,83.39,35067421,29883032,62.20729369069657,49.987010298718424,NaN,NaN,103.56461862107115,80.0215981378745,0.858246281110408,1.0527586442861718,0.19451236317576384,760610515,735627460.6,44.464869699979175,30.887867593566757,NaN,NaN,9.053883418309217,-0.25181406334264844
2022-10-14T09:30:00-04:00,82.48,83.6701,80.12,80.28,26755306,29460705.5,54.2413559895051,51.80718032970821,NaN,NaN,84.89051272809547,76.91636010466127,0.6865088856612807,1.0526484702523646,0.366139584591084,733855209,731382736.8,43.3167965820249,32.76595572520906,NaN,NaN,9.009649112520513,1.0712521046378032
2022-10-17T09:30:00-04:00,81.54,82.62,81.05,81.28,18994191,29469768.8,56.18425442331719,53.58032444575242,NaN,NaN,81.03914144177641,77.2831783100954,0.6033589222263327,1.1203382373739998,0.5169793151476672,752849400,735570019.8,44.83008734574511,34.88626126244038,NaN,NaN,9.590892415005138,2.2883435775474226
2022-10-18T09:30:00-04:00,81.95,82.75,80.41,81.99,25187907,29671672.05,57.56201802739451,54.78552720372948,NaN,NaN,74.00452314168083,81.15070426063653,0.560210403898337,1.2172423200205884,0.6570319161222514,778037307,750179105,49.85965552705808,37.41982290101079,NaN,NaN,10.482352975115532,3.458916348628581
2022-10-19T09:30:00-04:00,82.23,84.72,82.2,84.41,31263774,29517214.15,61.953407617308926,56.304400646700415,NaN,NaN,96.76899372347492,88.05355793121979,0.6522473053357077,1.4723410477918861,0.8200937424561784,809301081,766930702.4,54.93311118995727,40.33993088601078,NaN,NaN,12.643959883049002,4.771065424974355
2022-10-20T09:30:00-04:00,85.05,85.83,83.9812,84.49,25261846,29336604.8,62.093052607854055,57.917030741210674,NaN,NaN,101.68757155047327,87.6781485171002,0.6733711455698667,1.6618076744185117,0.9884365288486451,834562927,781721184.8,58.888512411446655,43.49223780513962,NaN,NaN,14.404651242858819,6.147291970386421
2022-10-21T09:30:00-04:00,84.96,87.1,84.74,86.93,25274182,27963423.15,66.17134910523194,59.048164083582996,NaN,NaN,118.62837924026167,94.42572181953344,0.7980156438055075,1.9859560836055294,1.187940439800022,859837109,806917564.8,64.59012668075098,46.545687320514006,NaN,NaN,17.222368119192208,7.729445705930105
2022-10-24T09:30:00-04:00,86.88,87.95,86.41,87.34,22496039,27284234.3,66.81737428559923,59.74997791973625,NaN,NaN,132.2000435779756,104.65790224677328,0.8496421177612388,2.2499930870015703,1.4003509692403315,882333148,832814314.4,69.30240360155855,49.48064161454801,NaN,NaN,19.70096166356855,9.439662271307025
2022-10-25T09:30:00-04:00,87,87.83,86.53,87.43,18841826,26534548.05,66.96650347222337,60.25507241660192,NaN,NaN,130.0924324066715,115.8754840997714,0.8304378049460897,2.4383982254229437,1.607960420476854,901174974,857441847.8,72.98438531451092,52.26936396624108,NaN,NaN,21.761694987376817,11.199952659316995
2022-10-26T09:30:00-04:00,87.76,89.32,87.7,88.62,22706462,26091183.6,68.95331328106039,60.73020133672219,NaN,NaN,149.1635589890951,126.35439715289544,0.8361515434763898,2.6531498498223414,1.8169983063459516,923881436,880357918.8,75.88308327475848,54.77702612835612,NaN,NaN,24.104891928884406,13.04351541211234
2022-10-27T09:30:00-04:00,89.84,90.44,88.67,88.94,25010642,26127640.85,69.48481594334437,61.367527001457155,NaN,NaN,150.54088808350883,136.12506045950255,0.7997567842068518,2.816694286604516,2.0169375023976643,948892078,903223749,78.37624639426059,57.06393158449971,NaN,NaN,26.20662019406554,14.923958952391368
2022-10-28T09:30:00-04:00,89.9,90.63,87.65,89.25,24663964,26276604,70.0202604160891,62.359518261212415,NaN,NaN,128.35914721273326,138.0712140539969,0.7364161235903928,2.9374576568856554,2.2010415332952626,973556042,925967535.6,80.53205187412081,59.35554055906463,NaN,NaN,28.12213474837215,16.80941263753148
2022-10-31T09:30:00-04:00,88.37,91.18,88.27,90,29760433,26025860.1,71.33093889721863,63.56194190965128,NaN,NaN,125.4092521786764,136.71305577413705,0.6859080469059831,3.0584265919277414,2.3725185450217583,1003316475,950164201,82.5277908446526,61.869169560716905,NaN,NaN,30.132450274738254,18.71270372856102
2022-11-01T09:30:00-04:00,91.51,91.5499,90.32,90.87,21755430,25455360.15,72.8156110445917,64.7715392001025,NaN,NaN,129.1294025673103,136.5204498062648,0.6521856985364396,3.187750668192308,2.5355649696558684,1025071905,974943587.2,84.30252411471854,64.62797463253877,NaN,NaN,32.286492573755204,20.651816420731617
2022-11-02T09:30:00-04:00,90.58,91.05,88.47,88.68,28249565,25335996.05,63.85167171156006,64.88899477302132,NaN,NaN,88.50891903264835,124.38952181497544,0.43398358629350264,3.0780444525227466,2.644060866229244,996822340,989531768,85.25226651627209,67.54136011941684,NaN,NaN,31.761490785252533,22.238912758520318
2022-11-03T09:30:00-04:00,88.14,90.825,87.89,90.32,26817245,25360102.55,67.11633942110981,65.80863644670737,NaN,NaN,84.11301275272687,111.10394674881904,0.3550241633499769,3.087841070416715,2.7328169070667383,1023639585,1004481269.4,86.17534884862194,70.60268528131662,NaN,NaN,32.23372519856816,23.66674310709858
2022-11-04T09:30:00-04:00,92.33,93.02,90.14,91.42,30295307,25451985,69.13015081692744,66.73334333196524,NaN,NaN,107.02318559333749,106.83675442493988,0.332207833561287,3.148076699018347,2.81586886545706,1053934892,1020557039.4,87.1096956212225,73.62265730099357,NaN,NaN,33.21960973825473,25.031438340120886
2022-11-07T09:30:00-05:00,91.61,93.28,91.45,92.99,19387719,25263078.8,71.78595271965631,67.7493386671268,NaN,NaN,115.88355263267563,104.93161451573971,0.37501410974218974,3.284636502634797,2.909622392892607,1073322611,1034558266.6,87.87812292296358,76.33826211498683,NaN,NaN,34.86861007753052,26.436748588322263
2022-11-08T09:30:00-05:00,92.81,93.48,91.935,93.08,21859253,25009986.25,71.9350101397235,68.4623102758707,NaN,NaN,112.94078718371303,101.69389143902028,0.3614025128284828,3.3613755339282108,2.999973021099728,1095181864,1048580258.4,88.61040148295595,78.74378285020101,NaN,NaN,36.250871210518476,27.838766105778866
2022-11-09T09:30:00-05:00,91.82,92.11,88.33,88.53,31513956,25558123.4,55.865993302125325,68.01752032546152,NaN,NaN,46.539716485901415,93.30005092967089,0.016205158912310225,3.0202294697401157,3.0040243108278055,1063667908,1061949372,89.27560831145918,80.91428970020192,NaN,NaN,32.279426032642014,28.473146095330744
2022-11-10T09:30:00-05:00,90.36,90.6,88.5,90.5,29244107,25266957.7,60.02922931471022,67.57879748328139,NaN,NaN,46.07302745884665,85.69205387089484,-0.1026736746495005,2.87568221751593,2.9783558921654305,1092912015,1075803858,89.93185940868403,82.72441346648284,NaN,NaN,30.304222577650762,28.73472844994789
2022-11-11T09:30:00-05:00,92.23,93.61,92.01,93.13,25541289,25206256.85,64.80276746798756,67.43489699630913,NaN,NaN,112.6551615982453,86.8184490718764,-0.03111494708534135,2.939462208308754,2.9705771553940954,1118453304,1088707540.4,90.51407646616214,84.23953295681167,NaN,NaN,30.24190119734998,28.950038842433905
2022-11-14T09:30:00-05:00,92.86,94.71,92.85,93.1,23122640,25412679.3,64.70783714698322,67.2735636873634,NaN,NaN,126.78570588148949,88.99887972163917,-0.013628940836837522,2.9535409793480483,2.967169920184886,1095330664,1093109151,90.7113954029539,85.50574796312902,NaN,NaN,30.163520849503612,29.123393414872435
2022-11-15T09:30:00-05:00,93.45,94.32,92.84,94.08,25771076,25441837.75,66.43747630985777,67.09386104656322,NaN,NaN,130.2143718865578,92.45359666220813,0.03353558948076696,3.0090894070358445,2.9755538175550775,1121101740,1098293126.2,90.95015790881205,86.58196757984715,NaN,NaN,30.6352699230394,29.339375773182002
2022-11-16T09:30:00-05:00,93.24,93.81,91.68,92.16,23638603,25060579.2,60.211382357409114,66.43147293328214,NaN,NaN,82.44985594406577,99.63562455384101,-0.08831805836183282,2.8651562446027867,2.9534743029646195,1097463137,1105052172,91.26541515492033,87.50262249132284,NaN,NaN,29.062486859922572,29.29982021414494
2022-11-17T09:30:00-05:00,90.75,92.44,90.28,92.36,21429904,24868982.1,60.62531821597405,65.76040563327392,NaN,NaN,45.72075515177314,99.56517009242631,-0.17422651426212266,2.735691160136966,2.9099176743990887,1118893041,1110248377.2,91.51026717231126,88.28678072690786,NaN,NaN,27.92930239758764,29.104031954636756
2022-11-18T09:30:00-05:00,90.65,91.88,89.5101,91.63,23683055,24789425.75,58.243549528503,64.82559210693708,NaN,NaN,13.672101630488726,79.76855809887499,-0.292055086893793,2.5448488157818474,2.8369039026756404,1095209986,1105599713.6,89.10377727045034,88.75649404303627,NaN,NaN,26.285803019840596,28.70142782109445
2022-11-21T09:30:00-05:00,89.64,90.6299,87.285,90.39,42576772,25793462.4,54.3384147869396,63.50579237424764,NaN,NaN,-57.41395874903941,42.92862517276922,-0.45559515774474146,2.2674099554947134,2.723005113239455,1052633214,1097060223.6,84.69748565274426,88.78470558146668,NaN,NaN,23.72034316550937,27.989844298868007
2022-11-22T09:30:00-05:00,91.52,93.43,91.1,93.22,26877457,26195243.95,60.79852632169984,63.28771056068621,NaN,NaN,70.39706419416508,30.965163634290672,-0.3784369840896735,2.2499588831273627,2.628395867217036,1079510671,1088742009.8,80.5204686505205,88.44672001962728,NaN,NaN,23.385711808901906,27.332111086015708
2022-11-23T09:30:00-05:00,91.53,92.795,91.19,92.21,20598650,26089853.35,57.66303125330671,62.612474262985984,NaN,NaN,40.75946395963013,22.62708523740354,-0.3986558674621272,2.1300760328893773,2.5287319003515045,1058912021,1081031786.6,76.74254250549453,87.77294813797532,NaN,NaN,22.13933114047171,26.59028537950942
2022-11-25T09:30:00-05:00,92.27,92.92,91.71,91.87,7591311,25218886.8,56.60473308879664,61.7178015681195,NaN,NaN,40.633177980615336,21.609569803171986,-0.4351824442762582,1.984753845006182,2.41993628928244,1051320710,1067517320.4,70.49879287552412,86.58645508471116,NaN,NaN,20.815760862931576,25.765353305712587
2022-11-28T09:30:00-05:00,89.62,90.75,89.0504,89.35,29150244,25443200.8,49.37207026221146,60.116809964016284,NaN,NaN,-85.71551777924361,1.732045921225506,-0.6181462221968506,1.647253511536377,2.2653997337332274,1022170466,1052909416.4,64.39967964120228,84.9094234217282,NaN,NaN,17.34934326244334,24.56306615667412
2022-11-29T09:30:00-05:00,90.34,91.23,90.01,90.7,19024193,24906388.8,52.847944192884825,58.75344811067066,NaN,NaN,-41.52619597761948,4.9095984755094975,-0.6349194979861936,1.4717503612504856,2.1066698592366793,1041194659,1050621705.4,63.47354168170546,83.11393343592461,NaN,NaN,15.502393346673712,23.268684326674062
2022-11-30T09:30:00-05:00,91.71,91.89,89.715,91.15,21915127,24914373.65,53.98207795780574,58.61888272893355,NaN,NaN,-27.076314071887182,-14.585077177700956,-0.6026372913202784,1.3533732450863312,1.9560105364066096,1063109786,1047341528.4,62.0946599024425,81.17243712099484,NaN,NaN,14.33783086872103,21.99284811839506
2022-12-01T09:30:00-05:00,91.79,92.25,90.54,90.85,19451019,24474446.35,53.06570760151717,58.121488320848336,NaN,NaN,-17.592976624863052,-26.25556529459959,-0.5877900608066176,1.2212729603983377,1.8090630212049552,1043658767,1044290877.6,60.77238878732832,79.08961779089802,NaN,NaN,13.121673500241984,20.725537458658906
2022-12-02T09:30:00-05:00,90.22,91.3791,89.78,90.31,18384965,24052832.35,51.375143396562805,57.162372315746566,NaN,NaN,-64.14153924681251,-47.21050874008517,-0.5986255988009526,1.0607810227037646,1.6594066215047172,1025273802,1039081496,58.4822150566317,76.80162769021727,NaN,NaN,11.627754811488797,19.42585422334889
2022-12-05T09:30:00-05:00,91.2,91.56,86.88,87.63,25876919,23831912.95,43.90017032645126,55.676110399994286,NaN,NaN,-145.15300971993685,-59.09800712822382,-0.7601959934722591,0.7091616296643934,1.4693576231366525,999396883,1034526779.4,56.47819171327963,74.35639885524053,NaN,NaN,7.958067061117944,17.787598914458755
2022-12-06T09:30:00-05:00,87.08,88.13,84.73,85.32,32465110,24485782.5,38.67660744558581,53.69319119540343,NaN,NaN,-232.6148403766436,-97.31573600802864,-0.9824291129646727,0.24132123193081156,1.2237503448954843,966931773,1019674202.2,50.41172694519955,71.46079664355393,NaN,NaN,3.0208071625169373,15.678057235609923
2022-12-07T09:30:00-05:00,85.3,86.4199,84.37,85.12,24447088,24615174.25,38.25222247616213,52.124679775314355,NaN,NaN,-217.8131303107797,-135.46309925580712,-1.0941402004673753,-0.14392490568873484,0.9502152947786404,942484685,995549182,42.438015517082796,67.97312524085125,NaN,NaN,-1.0518987713498575,13.288063520329954
2022-12-08T09:30:00-05:00,87.03,87.22,84.265,84.74,25640362,24321494.55,37.41225250077405,50.466603652800075,NaN,NaN,-178.31164986125873,-167.60683390308628,-1.1397155523342888,-0.47442914563922045,0.6652864066950682,916844323,970186293.2,35.992512468263584,64.00757133341928,NaN,NaN,-4.641434010026261,10.726706730279066
2022-12-09T09:30:00-05:00,84.47,85.4,82.65,82.68,24048943,24061736.35,33.16112047315208,48.675001577417866,NaN,NaN,-190.61846418150807,-192.90221889002538,-1.2460652040413787,-0.8922950983566551,0.3537701056847235,892795380,943690608.8,30.74000382254883,59.83873037285489,NaN,NaN,-9.165143616187223,7.8850138236410245
2022-12-12T09:30:00-05:00,83.15,85.05,82.825,84.85,21092424,23839293.1,40.79314761871188,47.70748249397303,NaN,NaN,-143.563156355644,-192.58424821716682,-1.1121432324157179,-1.036408934834924,0.07573429758079397,913887804,926588793,27.908939645952174,55.78240565808402,NaN,NaN,-10.770124750628435,5.219994027316817
2022-12-13T09:30:00-05:00,86.5,87.18,85.775,86.46,27278688,24047095.5,45.74326217373593,46.63210648340418,NaN,NaN,-74.94145139111797,-161.04957042006168,-0.8678471655158997,-1.0090746593140807,-0.14122749379818098,941166492,921435736.8,27.099083760952112,51.966592451686275,NaN,NaN,-10.552826392188694,2.9667339673874586
2022-12-14T09:30:00-05:00,87.05,87.36,85.16,85.93,26337755,24075429.45,44.4264625696111,45.68663729171163,NaN,NaN,-72.86350598099844,-132.05964555410543,-0.7017689588389564,-1.0184386923468765,-0.31666973350792005,914828737,915904547.2,26.219598054460562,48.357810705183844,NaN,NaN,-10.774127896249917,1.003753701153548
2022-12-15T09:30:00-05:00,85.18,85.61,83.96,85.41,20207545,23903876.55,43.11506680984084,44.72308970035764,NaN,NaN,-90.32230324526498,-114.46177623090668,-0.5911846355945402,-1.0556505280010953,-0.4644658924065551,894621192,911459921,25.503335026802773,45.143849430275175,NaN,NaN,-11.338342031329283,-0.7594028320582848
2022-12-16T09:30:00-05:00,83.8,84.76,83.21,84.36,29550525,24309907.6,40.51447103416009,44.090404041211116,NaN,NaN,-98.70288628392953,-96.07866065139098,-0.5536557488013467,-1.1565355784082385,-0.6028798296068918,865070667,905914978.4,24.60044277821278,42.30104679720449,NaN,NaN,-12.576452757679265,-2.4475528214327102
2022-12-19T09:30:00-05:00,84.38,84.65,82.88,83.49,18418305,24046670.1,38.445276082015766,43.06164203329189,NaN,NaN,-97.17125166729396,-86.80027971372095,-0.5511348475842734,-1.2917983890872335,-0.7406635415029601,846652362,892467890,22.51838807277035,39.37567868228056,NaN,NaN,-14.22279747681169,-4.129730629343993
2022-12-20T09:30:00-05:00,83.75,85.29,83.425,84.75,14296507,22632656.85,42.98680992631829,42.2762657453285,NaN,NaN,-71.03913155735651,-86.01981574696866,-0.4335006515839448,-1.282539355982891,-0.8490387043989462,860948869,876424365.4,20.309816766095693,36.391047029684344,NaN,NaN,-14.31508522693879,-5.584781286143249
2022-12-21T09:30:00-05:00,86.48,86.75,85.21,86.36,17029113,22140239.65,48.24167308204855,41.93169185108074,NaN,NaN,-29.727754673178005,-77.39266548540458,-0.22655803345490155,-1.1322362462175732,-0.9056782127626717,877977982,869054214.4,19.36995491748189,33.43373032469531,NaN,NaN,-12.80184309542474,-6.615790116040605
2022-12-22T09:30:00-05:00,86.45,86.5,82.68,84.37,18679664,22044290.35,42.9698395867007,41.33131300751916,NaN,NaN,-64.26590385490312,-72.18138560733223,-0.20371411868339473,-1.1603208611169151,-0.9566067424335204,859298318,861989639.6,18.486844264554435,30.57691812526122,NaN,NaN,-13.09516785700215,-7.54141550760654
2022-12-23T09:30:00-05:00,85.49,87.08,85.05,87.06,14814960,22405472.8,50.79716419449662,41.82395542666526,NaN,NaN,-8.037622933269423,-54.0483329372002,0.0016737519983498483,-0.9545145524355831,-0.956188304433933,874113278,863798161.8,19.498684605623694,27.935524760428653,NaN,NaN,-10.74429080250601,-7.998969121163607
2022-12-27T09:30:00-05:00,87.44,88.36,87.12,87.99,16374639,21766692.55,53.189213051974725,42.86057011283589,NaN,NaN,41.16205482354835,-26.381671639031747,0.19838696307357095,-0.7082046005919693,-0.9065915636655403,890487917,872565272.8,24.39799485327859,26.077401039577158,NaN,NaN,-8.059385137960316,-8.007599980705994
2022-12-28T09:30:00-05:00,87.87,87.87,85.75,86.02,15918974,21611431.6,47.87920914065775,43.548212017442715,NaN,NaN,7.08079179669052,-10.757686968222336,0.193827644896155,-0.6643070075453466,-0.8581346524415016,874568943,875289287.6,25.90685039615687,24.896603530939586,NaN,NaN,-7.48214363787648,-7.932534788873206
2022-12-29T09:30:00-05:00,85.66,87.31,85.62,86.92,13457907,21188570.6,50.31937471603428,44.47014931853273,NaN,NaN,20.87128857089044,-0.6378783194086466,0.2460685344194944,-0.5505489844171336,-0.796617518836628,888026850,877299061.2,27.06344707325229,24.258813145581634,NaN,NaN,-6.234282036149306,-7.689927252769792
2022-12-30T09:30:00-05:00,86.46,87.64,86.45,87.47,11330914,20782565.35,51.80435590146993,45.801808991984004,NaN,NaN,62.97725298842759,24.810753049257492,0.3082751176733167,-0.41127362174498217,-0.7195487394182989,899357764,885310950.4,31.64434696749059,24.323409084506043,NaN,NaN,-4.7672679960265185,-7.272404501806467
2023-01-03T09:30:00-05:00,86.92,87.36,83.35,84.4,26541416,21190387.9,43.91398965107409,46.02472628000988,NaN,NaN,-37.19025375880448,18.980226884150483,0.14174446843340882,-0.5423681538765379,-0.6841126223099467,872816348,885051564.4,31.575204000283165,24.585285109815402,NaN,NaN,-6.008152482037045,-7.091797070410836
2023-01-04T09:30:00-05:00,83.15,84.8801,82.83,84.39,22852575,21039170.7,43.890539366900576,45.892388936664496,NaN,NaN,-89.75785479814026,-7.2037550401872394,0.035534552021539545,-0.6396944322830223,-0.6752289843045618,849963773,876946735.6,29.412645053551643,24.750539487858227,NaN,NaN,-6.98585250789851,-7.0766621329090755
2023-01-05T09:30:00-05:00,84.25,86.4,84.01,85.93,19361852,20384007.8,48.45546054022514,46.18017450599407,NaN,NaN,2.664904746174465,-8.086932450290451,0.0715365901468159,-0.5858082466210419,-0.6573448367678578,869325625,875898072,29.13460462498135,24.958754242895427,NaN,NaN,-6.413296849934315,-6.981895663912681
2023-01-06T09:30:00-05:00,87.04,88.63,86.82,87.56,22211189,20272212.85,52.82983678576877,46.874086647131776,NaN,NaN,127.17238377221096,13.173286589973657,0.20036758332776894,-0.4068853576081466,-0.6072529409359155,891536814,876600064.8,29.614271387024132,25.252392554339814,NaN,NaN,-4.5494913428603905,-6.6344093323337825
2023-01-09T09:30:00-05:00,88.88,89.02,86.965,87.25,23001610,20140275.25,51.92725286760366,47.6892853495206,NaN,NaN,114.02635500703263,23.383106993694668,0.25636548753737487,-0.286796081514197,-0.5431615690515719,868535204,870435552.8,27.832668198641073,25.483265798656117,NaN,NaN,-3.3129286834235403,-6.159912096775177
2023-01-10T09:30:00-05:00,87.82,88.05,86.49,87.87,15799501,19727803.15,53.63344460439934,48.774154529690854,NaN,NaN,90.87837613905724,48.99683297326701,0.3225436384672621,-0.13998202096749424,-0.4625256594347563,884334705,872739224.2,29.53862317864683,25.984711163361574,NaN,NaN,-1.7874759160228662,-5.535278356667703
2023-01-11T09:30:00-05:00,88.64,88.86,87.185,88.14,16451492,19495756.55,54.392583292940024,49.5888526273067,NaN,NaN,113.7959978305381,89.70760349900269,0.3685620782591935,-0.0018230616107643982,-0.3703851398699579,900786197,882903709,36.65396660241047,27.15215043738406,NaN,NaN,-0.31435487320987093,-4.789432144745156
2023-01-12T09:30:00-05:00,88.67,90.4,88.5,89.82,18358035,19049723.9,58.90150235657555,50.350269004058624,NaN,NaN,170.3956247249448,123.25374749475675,0.4886753174667134,0.2404590069634338,-0.24821631050327958,919144232,892867430.4,42.756266922410205,28.82260129487894,NaN,NaN,2.320449136206963,-3.7737348188948534
2023-01-13T09:30:00-05:00,89.75,90.1653,88.8,89.95,15904159,18528044.1,59.23733145803883,51.512232709154205,NaN,NaN,147.7768361556492,127.3746379714444,0.5489020382014007,0.43791123724847125,-0.11099080095292943,935048391,901569745.8,47.512146925259245,30.895837199215,NaN,NaN,4.577752915227008,-2.58066514259173
2023-01-17T09:30:00-05:00,90.16,91.08,89.77,90.14,16966599,18365996.8,59.75493818481907,52.15207370846296,NaN,NaN,155.53693314662473,135.67675359936283,0.571013866183679,0.6027765317766693,0.03176266559299035,952014990,918265703,55.20207118362897,33.44607909764395,NaN,NaN,6.603908455211272,-1.2685832000484443
2023-01-18T09:30:00-05:00,90.56,91.57,88.4,88.49,19037646,17840352.85,53.41199096313864,52.16798641640323,NaN,NaN,107.68169690077175,139.03741775170573,0.44935092170624297,0.5934513177257941,0.1441003960195511,932977344,927994230.8,58.97383635646319,35.915782062157135,NaN,NaN,6.683356774046724,-0.13259177517770593
2023-01-19T09:30:00-05:00,87.98,89.95,87.79,89.59,17146862,17776780.7,56.71103366053391,52.79883102496581,NaN,NaN,84.84540351449543,133.24729888849717,0.4184249216729328,0.6671315481107172,0.24870662643778435,950124206,937861832.6,62.42914585418381,38.5245174520162,NaN,NaN,7.689184542622013,0.9848048416508253
2023-01-20T09:30:00-05:00,89.78,90.79,88.87,90.48,14280030,17775956.85,59.22680155852115,53.435075799429164,NaN,NaN,115.05246413155379,122.17866676981899,0.4316368881381403,0.7882527366104597,0.3566158484723194,964404236,946913833.4,65.31506759501029,41.256776060713214,NaN,NaN,9.271506600650213,2.1686193786507375
2023-01-23T09:30:00-05:00,91.14,91.59,90.31,90.6,14652544,17657128.4,59.56799023372218,53.989621108875745,NaN,NaN,132.57985485138488,119.13927050896612,0.42169769487744324,0.8837379670691234,0.4620402721916802,979056780,955715511.2,67.89721899998162,43.84626692017686,NaN,NaN,10.671949149789597,3.3833807745277173
2023-01-24T09:30:00-05:00,90.3,90.46,88.46,90.25,14886444,17467467.4,58.04240420905887,54.99879357730324,NaN,NaN,77.48270680108587,103.52842523985835,0.36681339580589356,0.9205570169490471,0.5537436211431536,964170336,958146580.4,68.59270426490242,46.49037408193538,NaN,NaN,11.45531081888361,4.536513638007131
2023-01-25T09:30:00-05:00,89.81,90.26,88.38,90.26,13430617,17398250.25,58.07544183923024,56.01200089675536,NaN,NaN,66.05318423125955,95.2027227059559,0.308773817839439,0.9397108934424523,0.6309370756030133,977600953,967071302.2,71.07051446792134,49.46593618296179,NaN,NaN,12.119999644930228,5.619868781853287
2023-01-26T09:30:00-05:00,91.72,93.15,90.6,93.11,18331505,17496093.55,66.23542289594371,57.28199820787812,NaN,NaN,151.62475178200515,108.55859235945786,0.4323375100251964,1.1713589631345087,0.7390214531093123,995932458,976232952.6,73.39125012850613,52.62712514749927,NaN,NaN,15.203081814874015,6.988899215141963
2023-01-27T09:30:00-05:00,92.61,93.07,91.08,91.23,17420541,17571171.9,58.18971015355247,57.66484630557695,NaN,NaN,118.73329417813595,109.29475836877427,0.36040626628289707,1.1895292859629336,0.8291230196800365,978511917,979054488.8,74.08085795465065,55.80330990232974,NaN,NaN,15.467429767134183,8.200117865426567
2023-01-30T09:30:00-05:00,90.57,90.7,89.015,89.14,13762454,17586399.25,50.80172834580597,57.58445169687712,NaN,NaN,34.11419531204425,89.60162646090616,0.1554901905396291,1.0234857578545729,0.8679955673149438,964749463,976193025.4,72.0417089163799,58.96109852502537,NaN,NaN,13.263040019158922,8.923392458816902
2023-01-31T09:30:00-05:00,88.84,90.065,87.93,89.93,13924137,17716060.4,53.219471889635564,57.55488221725113,NaN,NaN,18.90881493350563,77.88684808739012,0.06140431593890283,0.9447509622385724,0.8833466462996695,978673600,979093678.2,72.8573287683026,62.055291781429354,NaN,NaN,12.229829378618176,9.395740590217084
2023-02-01T09:30:00-05:00,89.51,89.89,87,88.16,23483596,17563169.4,47.57794195780497,57.06812212188434,NaN,NaN,-30.718035260912696,58.532604188955666,-0.12179637093743045,0.7311011826278815,0.8528975535653119,955190004,974611488.4,69.48412974095167,64.40030343418229,NaN,NaN,9.476080166646978,9.407217672564212
2023-02-02T09:30:00-05:00,87.82,87.99,85.2,86.15,24901506,17665615.95,42.117849477244754,55.86928977336071,NaN,NaN,-140.4657852992998,0.11449677269467315,-0.366287453726476,0.3950382364072169,0.7613256901336929,930288498,961482696.4,60.62947311234323,65.67696101917751,NaN,NaN,5.23604606826202,8.811336014806756
2023-02-03T09:30:00-05:00,86.51,87.91,85.87,85.96,22727409,17833893.8,41.63148873248492,54.61172957867829,NaN,NaN,-144.15129480010447,-52.462421022953414,-0.5193945513716282,0.11208250091915772,0.6314770522907859,907561089,947292530.8,52.79788235430967,66.05451354982397,NaN,NaN,1.7622658024728357,7.804325984473339
2023-02-06T09:30:00-05:00,86.04,86.69,84.515,85.57,15857170,17516192.85,40.59524205425228,53.24317985506638,NaN,NaN,-174.60098066770885,-94.20545621890403,-0.6187775379927947,-0.1419948702002074,0.4767826677925872,891703919,932683422,46.183704085948605,65.41034447141823,NaN,NaN,-1.3664135298673015,6.4942203395675335
2023-02-07T09:30:00-05:00,86.11,88.48,85.66,88.35,20507016,17391463.15,50.125131193293214,53.008404157220276,NaN,NaN,-77.72406278166018,-113.53203176193719,-0.4755651587749154,-0.11767378067605705,0.35789137809885835,912210935,919390889,41.134381982470735,64.13609773041877,NaN,NaN,-1.1374888320008494,5.403976172200622
2023-02-08T09:30:00-05:00,88.28,88.73,87.055,87.56,13483580,17275667.1,47.779420360779014,52.37043177866635,NaN,NaN,-65.38776649521571,-120.46597800879779,-0.4145512843034815,-0.16029772728049352,0.25425355702298796,898727355,908098359.2,37.39401203457727,62.34787388616116,NaN,NaN,-1.6982402450069194,4.389373826885259
2023-02-09T09:30:00-05:00,87.57,87.85,86.745,86.81,16075156,17256850.3,45.597787929754816,51.39693080518305,NaN,NaN,-91.37430506718624,-110.64768196237507,-0.4047587354931437,-0.2516948623434416,0.15306387314970205,882652199,898571099.4,34.540378979957865,60.149681842228844,NaN,NaN,-2.8345649464538463,3.357382573551101
2023-02-10T09:30:00-05:00,88.25,90.39,88.17,90.21,20001627,17339029.9,55.51438449141608,51.10738753787547,NaN,NaN,26.443039388608266,-76.52881512463253,-0.16181823099950404,-0.049208915599677994,0.11260931539982603,902653826,897589646.8,34.250412448116876,57.746338517095644,NaN,NaN,-0.48319794057760745,2.8087282143898573
2023-02-13T09:30:00-05:00,89.75,90.325,88.82,89.98,12372446,17162444.25,54.786845979116805,50.87484766430818,NaN,NaN,31.89811765175577,-35.228995460739604,-0.01676975057296473,0.09164712718362011,0.10841687775658485,890281380,897305139,34.16088433907433,55.286922808107924,NaN,NaN,1.1122968911606606,2.566380882499972
2023-02-14T09:30:00-05:00,89.27,90.665,89.02,90.01,13511305,16989679.55,54.86992561989368,50.64588222006985,NaN,NaN,42.49582770805542,-11.185017362796483,0.07594903887306612,0.2033531763479175,0.12740413747485138,903792685,895621489,33.6011397100783,52.61053889683342,NaN,NaN,2.3969166788719694,2.5421717105531143
2023-02-15T09:30:00-05:00,89,89.19,87.35,88.48,15972123,16836403.4,49.83998804707584,49.474779730865,NaN,NaN,-29.722043484822166,-4.051872760717773,0.03127946087575137,0.1665034635695406,0.13522400269378923,887820562,893440130.4,32.85010919581522,49.71474311592692,NaN,NaN,1.9760637934354464,2.461299150964876
2023-02-16T09:30:00-05:00,88,88.755,87.52,87.61,12657087,16611914.65,47.19088500849409,48.68914936336084,NaN,NaN,-43.50880425644508,5.521227401430461,-0.055112465187335175,0.06633342120962027,0.12144588639695544,875163475,891942385.6,32.316016264980874,46.73154013809336,NaN,NaN,0.8228081253462509,2.2272290044479295
2023-02-17T09:30:00-05:00,86.25,86.31,84.12,84.49,22340234,17014924.85,39.153549687103435,47.85713660202494,NaN,NaN,-154.57059832650486,-30.68150014159217,-0.30659047433520076,-0.2617922065220455,0.044798267813155254,852823241,881976268.6,28.94384877635163,43.65312155666277,NaN,NaN,-2.939390566135114,1.4891404943646376
2023-02-21T09:30:00-05:00,84.12,85.04,83.91,84.07,16811279,17122861.6,38.21011531741776,46.78503970400938,NaN,NaN,-159.73216640130227,-69.00755695220377,-0.4753518753088929,-0.5493915763229609,-0.07403970101406797,836011962,871122385,25.787762657177055,40.291009691582374,NaN,NaN,-6.226403221030972,0.3869199635938363
2023-02-22T09:30:00-05:00,83.84,84.63,82.79,83.51,20135213,17385300.05,36.93229363834828,46.02463625261961,NaN,NaN,-159.68285792399428,-109.44329407861372,-0.5912724071188145,-0.8131302099125861,-0.2218578027937716,815876749,853539197.8,21.666116043185767,36.8754372845991,NaN,NaN,-9.29685690306958,-0.9964767316437946
2023-02-23T09:30:00-05:00,84.77,85.26,83.695,84.77,17511674,17589352.9,41.65974861282445,45.99191476230387,NaN,NaN,-111.22083066888727,-125.74305151542674,-0.5505007824414799,-0.9099837808456215,-0.35948299840414155,833388423,842652770,19.579549394386206,33.9432998761736,NaN,NaN,-10.483932767347286,-2.3518275938871502
2023-02-24T09:30:00-05:00,83.52,84.78,83.04,84.66,18748388,17610197.05,41.36821144378782,45.97310924168266,NaN,NaN,-113.41901327965367,-139.72509332006845,-0.4998303624391197,-0.9842709514530412,-0.4844405890139215,814640035,830548082,17.555098053051964,31.42595814036948,NaN,NaN,-11.52528010038285,-3.6623208091008213
2023-02-27T09:30:00-05:00,84.83,85.2771,84.21,84.91,15338191,17506079.55,42.355551558325004,46.09884563483071,NaN,NaN,-81.9551304782326,-125.201999750414,-0.4214982229683357,-1.011313367724341,-0.5898151447560054,829978226,825979079,16.84702135409296,29.33048080237979,NaN,NaN,-12.112611541287267,-4.869505199413171
2023-02-28T09:30:00-05:00,85.77,85.8,83.62,83.69,19003820,17768147.85,38.911889940854294,45.297899831085076,NaN,NaN,-88.0165458454199,-110.85887563923752,-0.4227858399215938,-1.1182974446579976,-0.6955116047364038,810974406,820971567.8,16.08144706704435,27.54098545127791,NaN,NaN,-13.608295610636128,-6.1179038295878785
2023-03-01T09:30:00-05:00,83.76,85.77,83.45,85.34,18546968,17999289.4,45.37990971670385,45.12650621365113,NaN,NaN,-63.69912702099319,-91.66212945863731,-0.2897897690953919,-1.0577488161056436,-0.7679590470102517,829521374,823700492.8,18.261393371708593,26.174369832501572,NaN,NaN,-13.027954561592223,-7.105053934159928
2023-03-02T09:30:00-05:00,85.19,86.41,84.92,86.09,16402487,17645233.95,48.071343733864595,45.30318877108755,NaN,NaN,-23.487609945941493,-74.11548531404814,-0.13637456600833908,-0.9384272545206755,-0.8020526885123365,845923861,826207580.4,20.309520188606584,25.157879918833626,NaN,NaN,-11.745997133431452,-7.768045819770146
2023-03-03T09:30:00-05:00,85.06,87.69,85,87.26,25337598,17667038.55,52.0414881415152,45.05512474609463,NaN,NaN,9.29780447372731,-49.57212176337195,0.04891091916813628,-0.7409140395521661,-0.7898249587203023,871261459,837531865.2,28.9674307449675,24.78052408289438,NaN,NaN,-9.448865692477714,-8.008162944442656
2023-03-06T09:30:00-05:00,86.78,87.44,86.425,87.3,16949157,17378125.95,52.17610608954371,44.86864332541084,NaN,NaN,23.90227047385898,-28.400641572953656,0.17223367043320637,-0.5745328706787944,-0.7467665411120008,888210616,849178343.2,36.5967640407827,24.95451549015927,NaN,NaN,-7.5459607885513,-7.942134065029605
2023-03-07T09:30:00-05:00,86.78,87.0009,85.555,85.78,18500179,17510276.4,46.80018242081615,44.29223309690529,NaN,NaN,-13.75156936597491,-13.547646277064661,0.15030648716796569,-0.5588834321520437,-0.7091899193200094,869710437,860925549.4,43.221077513989854,25.641653904724382,NaN,NaN,-7.398259287590898,-7.864437668252647
2023-03-08T09:30:00-05:00,85.4,86.49,84.0831,84.9,19699517,17469901.45,43.97521668368901,43.873320856663376,NaN,NaN,-46.552809741187744,-10.118382821103577,0.07898964403286657,-0.6104528642789262,-0.6894425083117928,850010920,865023458.6,45.36549284873353,26.535609879932824,NaN,NaN,-8.096489856278216,-7.897587980827728
2023-03-09T09:30:00-05:00,85.39,86.59,83.675,83.7,18944056,17742925.25,40.394491114442204,43.38786414994538,NaN,NaN,-60.79042590960623,-17.578946013836525,-0.040146820107673564,-0.7396260334463847,-0.6994792133387111,831066864,862052059.2,44.06589862559025,27.374887191404927,NaN,NaN,-9.770965336383874,-8.165213317335748
2023-03-10T09:30:00-05:00,83.7,84.88,82.15,82.63,28312771,18354806,37.46510124721112,43.26726068995307,NaN,NaN,-106.45876492655098,-40.73025989389218,-0.1746225669403041,-0.9177574220140912,-0.7431348550737871,802754093,848350586,38.577926047731246,28.06303556793204,NaN,NaN,-12.091237803799158,-8.726073958259093
2023-03-13T09:30:00-04:00,80.52,82.395,79.11,80.95,41663451,19437897.2,33.37288166176751,42.921744000263764,NaN,NaN,-184.73354958626004,-82.45742390591599,-0.35019401290965413,-1.1808773712108547,-0.8306833583012005,761090642,822926591.2,30.89029451548204,28.427502129239542,NaN,NaN,-15.429423831116857,-9.683695368667346
2023-03-14T09:30:00-04:00,80.94,83.57,80.305,81.75,30533190,20345934.4,36.906980721106926,42.919935934746526,NaN,NaN,-139.79185237484444,-107.66548050768988,-0.3832537323659382,-1.3097505237586233,-0.9264967913926851,791623832,807309270.2,27.29244088809999,28.82938247530484,NaN,NaN,-17.13286585614795,-10.747862581164576
2023-03-15T09:30:00-04:00,78.75,79.35,76.235,77.36,57673510,22554044.65,28.098978169509394,41.951309474509735,NaN,NaN,-281.77786432350626,-154.7104914241536,-0.6555969798656247,-1.7459930162247161,-1.0903960363590914,733950322,784097150.6,23.003847532837497,29.073975199479936,NaN,NaN,-22.014560373406425,-12.357390837199125
2023-03-16T09:30:00-04:00,75.66,78.4,75.355,78.2,44403048,23975590.9,31.469168026780622,41.24423494472351,NaN,NaN,-228.72114662481195,-188.29663556719476,-0.7283812040937083,-2.0008725414762267,-1.2724913373825184,778353370,773554451.8,21.36198855896525,29.34589594990231,NaN,NaN,-24.689628899826047,-14.119139131860113
2023-03-17T09:30:00-04:00,77.75,78.395,76.34,76.97,33676082,25026540.65,29.303233337928816,40.31192650040949,NaN,NaN,-183.200985540401,-203.64507968996475,-0.802712665333684,-2.2758821690496234,-1.4731695037159394,744677288,761939090.8,19.6942059458885,29.549266277887707,NaN,NaN,-27.59867850784389,-16.04478761414351
2023-03-20T09:30:00-04:00,76.1,78.2,76.1,77.7,26144460,25216751.95,32.282198193222214,39.83837708986435,NaN,NaN,-145.92773119035937,-195.88391601078462,-0.7472051611136388,-2.407175955107988,-1.659970793994349,770821748,763885312,20.80981819524338,29.887007072759065,NaN,NaN,-28.966666813155467,-17.890770356859502
2023-03-21T09:30:00-04:00,79.3,80.635,79.06,80.39,29856229,25868999.45,41.98352757418546,39.59577836539875,NaN,NaN,-68.03435049105377,-181.53241563402648,-0.48644125104615177,-2.268022357802039,-1.781581106755887,800677977,765696141,21.897004590492557,30.14669358838649,NaN,NaN,-26.8408008969719,-19.16934614830413
2023-03-22T09:30:00-04:00,80.44,80.81,78.62,78.68,24604696,26092473.6,38.23376336309808,38.89309405320114,NaN,NaN,-73.94561250221979,-139.96596526976919,-0.39038530011819694,-2.2695627319036333,-1.8791774317854364,776073281,774120732.8,26.92351328567274,30.61912166674836,NaN,NaN,-26.350244069238048,-20.195188708437545
2023-03-23T09:30:00-04:00,79.11,79.795,76.84,77.59,24743111,26454045.45,36.02502442173246,37.74906093035952,NaN,NaN,-90.73440904287135,-112.36861775338107,-0.3621438000953048,-2.3318571819045673,-1.9697133818092625,751330170,768716092.8,25.77736740723587,30.39125999976753,NaN,NaN,-26.684243193266642,-21.12219649198456
2023-03-24T09:30:00-04:00,76.05,78.195,75.805,77.89,20649609,26549106.5,37.10201892285207,36.67234041845297,NaN,NaN,-95.15141764839834,-94.75870417498054,-0.2883555985323891,-2.330157879974749,-2.0418022814423598,771979779,774176591,29.063087970668263,29.853140280473642,NaN,NaN,-26.609511236956866,-21.906098598409177
2023-03-27T09:30:00-04:00,78.71,80,78.08,79.55,20111926,26787793.25,42.8364947403424,36.38921986984771,NaN,NaN,-50.83764725064107,-75.74068738703689,-0.10243846275617319,-2.169850359887576,-2.067411897131403,792091705,778430582.4,31.603347792198846,29.023302443202855,NaN,NaN,-24.716005806457293,-22.307513913844623
2023-03-28T09:30:00-04:00,79.1,81.13,79.07,80.78,16298354,26652519.95,46.71316325442561,36.584787482043176,NaN,NaN,-24.595065713883095,-67.05283043160274,0.11680471575180817,-1.9214060024416426,-2.038210718193451,808390059,779972998.8,32.546539137822364,28.107662892423487,NaN,NaN,-21.90204650951801,-22.24958999894082
2023-03-29T09:30:00-04:00,81.58,81.985,81.05,81.9,18102274,26630285.25,50.03589673142739,37.273459311827835,NaN,NaN,6.715027712271817,-50.92070238870442,0.3381567579174516,-1.6155147707966364,-1.953671528714088,826492333,790056809.2,38.51599608274671,27.711241282220378,NaN,NaN,-18.50905320541995,-21.71522759986641
2023-03-30T09:30:00-04:00,82.58,82.7,81.78,82.26,13730400,26496680.9,51.091567443708264,38.24677832586335,NaN,NaN,25.652065508295767,-27.643407478470998,0.49995480299622175,-1.328728024968811,-1.8286828279650327,840222733,807835321.8,47.36092369249395,28.33859825684628,NaN,NaN,-15.443886306896989,-20.819321700870777
2023-03-31T09:30:00-04:00,82.47,82.965,82.165,82.83,16147327,26037167.35,52.792315990660164,39.63388077792711,NaN,NaN,43.41047224483291,0.06897050017525004,0.6282060468471689,-1.0434252694060717,-1.6716313162532406,856370060,824713378,54.11023774985231,29.99716563072987,NaN,NaN,-12.398483614384771,-19.616344831372775
2023-04-03T09:30:00-04:00,86.32,87.14,85.87,86.58,31226124,26751015.7,62.12402660277302,41.43509834090326,NaN,NaN,145.31935645374048,39.300371241051565,0.9302160257566701,-0.5088612840574029,-1.439077309814073,887596184,843814273.8,60.312141636696715,32.355715684201066,NaN,NaN,-6.3315409636825235,-17.718515707417026
2023-04-04T09:30:00-04:00,86.84,86.95,84.25,85.01,24681487,27060081.1,57.040286564096164,43.50233465480232,NaN,NaN,118.76706789080583,67.97279796198934,0.9836726293964764,-0.20948652306847748,-1.1931591524649539,862914697,854719201.4,63.35691510866701,35.238077653903176,NaN,NaN,-2.9188842741060324,-15.604282645515456
2023-04-05T09:30:00-04:00,85.22,86.29,84.51,86.29,20276134,27088911.95,59.91998254360604,45.53453569171842,NaN,NaN,124.3372530354076,91.4972430266165,1.0581768621820826,0.12956192526264942,-0.9286149369194332,883190831,866058901,66.25597786623237,38.444791175850824,NaN,NaN,0.837464078199421,-13.255461684984759
2023-04-06T09:30:00-04:00,86.16,86.2481,84.805,84.98,16689270,26976172.65,55.79761323660698,47.42699139876685,NaN,NaN,112.58021250567968,108.88287242609329,0.9742681577570828,0.28922026027692027,-0.6850478974801625,866501561,871314666.6,67.53789907668278,41.86219782805041,NaN,NaN,2.642605914655064,-10.9843091707505
2023-04-10T09:30:00-04:00,85.3,86.64,85.3,85.66,13488647,26234966.45,57.434632919584914,49.22359387922133,NaN,NaN,116.08789689657821,123.41835735644236,0.9202445229870153,0.46525775625360666,-0.45498676673340865,879990208,876038696.2,68.68927953078799,45.28215935201789,NaN,NaN,4.614475639511588,-8.755911340713059
2023-04-11T09:30:00-04:00,86.14,87.01,85.6499,86.47,12787580,24791172.9,59.36512446674568,50.46513651440421,NaN,NaN,111.54963914346008,116.66441389438626,0.8939831519931968,0.6624921732580873,-0.23149097873510946,892777788,877075017,68.94946177161538,48.64304915066952,NaN,NaN,6.82994056689553,-6.529361068197547
2023-04-12T09:30:00-04:00,87.07,87.25,86.27,86.53,16667178,24097872.3,59.51160939754994,51.9849826597222,NaN,NaN,104.61527348526823,113.83405501327874,0.8365984782514372,0.814257119079187,-0.02234135917225019,909444966,886381070.8,71.25908533324852,51.809875725496354,NaN,NaN,8.659594601212206,-4.359510258281868
2023-04-13T09:30:00-04:00,86.4,87.29,86.19,87.07,15692262,21998809.9,60.87850897056529,53.7602315560674,NaN,NaN,96.75003461002267,108.31661132820177,0.7914402222011105,0.9669589185791381,0.17551869637802747,925137228,894770350.2,73.19477324179836,55.196833285107964,NaN,NaN,10.580514104344903,-2.225221063620901
2023-04-14T09:30:00-04:00,87.19,87.7388,86.72,87.23,11780079,20367661.45,61.295454167892316,55.48833407357027,NaN,NaN,94.322420139899,104.66505285504563,0.7302579536883457,1.0883411384884596,0.3580831848001139,936917307,908853499.4,76.10425197567226,58.55691642832254,NaN,NaN,12.29040827101455,-0.15155973010155055
2023-04-17T09:30:00-04:00,86.94,87.3,85.9,86.2,11880993,19277907,57.078145787556835,56.50559486265702,NaN,NaN,71.2715462538597,95.70178272650192,0.5846319946797007,1.0888731781497398,0.5042411834700391,925036314,917862720.6,77.76678443638174,61.85430476004989,NaN,NaN,12.652965085622444,1.6776581007161628
2023-04-18T09:30:00-04:00,86,86.76,85.57,86.54,12246759,18583021.95,58.10289474498835,57.31914711198293,NaN,NaN,61.506761968061056,85.69320729142211,0.4798100246765248,1.104003714315695,0.6241936896391703,937283073,926763777.6,79.29919702430448,65.19378032337004,NaN,NaN,13.229974850989237,3.3279890650408874
2023-04-19T09:30:00-04:00,85.76,86.31,85.29,86.24,17123070,17946364,56.81398855169906,57.80329652771662,NaN,NaN,49.27013538053199,74.62417967047487,0.36412125640988535,1.079345260151527,0.7152240037416416,920160003,928906785,79.66263876733565,68.13282622941212,NaN,NaN,13.385782557922091,4.764816706881059
2023-04-20T09:30:00-04:00,85.04,85.5,84.44,85.48,15198120,17476035.2,53.57181033102428,57.980456733953474,NaN,NaN,26.577467285693157,60.58966620560898,0.2174999545620928,0.9870989469442577,0.7695989923821649,904961883,924871716,76.9240809810153,70.24448032144934,NaN,NaN,12.667254087115367,5.8937363326288175
2023-04-21T09:30:00-04:00,85.79,85.83,84.6,84.98,16878782,17082818.75,51.48997957811167,57.887432704485725,NaN,NaN,20.75016822824582,45.875215823278346,0.07527373705188956,0.8636911636970268,0.7884174266451373,888083101,915104874.8,70.59782999730425,71.42216548198164,NaN,NaN,11.495956222544763,6.694053459759667