time,open,high,low,close,Volume,Volume MA,RSI,RSI-based MA,Upper Bollinger Band,Lower Bollinger Band,CCI,Smoothing Line,Histogram,MACD,Signal,OnBalanceVolume,Smoothing Line,RSI,RSI-based MA,Upper Bollinger Band,Lower Bollinger Band,True Strength Index,Signal
1998-12-22T09:30:00-05:00,30.25,30.25,29.828,29.828,7900,NaN,NaN,NaN,NaN,NaN,NaN,NaN,NaN,NaN,NaN,NaN,NaN,NaN,NaN,NaN,NaN,NaN,NaN
1998-12-23T09:30:00-05:00,29.79687,29.79687,29.64062,29.70312,24100,NaN,NaN,NaN,NaN,NaN,NaN,NaN,NaN,NaN,NaN,-24100,NaN,NaN,NaN,NaN,NaN,NaN,NaN
1998-12-24T09:30:00-05:00,30.21875,30.3125,30.15625,30.25,23800,NaN,NaN,NaN,NaN,NaN,NaN,NaN,NaN,NaN,NaN,-300,NaN,NaN,NaN,NaN,NaN,NaN,NaN
1998-12-28T09:30:00-05:00,30.1875,30.25,30.04687,30.09375,3100,NaN,NaN,NaN,NaN,NaN,NaN,NaN,NaN,NaN,NaN,-3400,NaN,NaN,NaN,NaN,NaN,NaN,NaN
1998-12-29T09:30:00-05:00,30.21875,30.67187,30.21875,30.59375,12000,NaN,NaN,NaN,NaN,NaN,NaN,NaN,NaN,NaN,NaN,8600,NaN,NaN,NaN,NaN,NaN,NaN,NaN
1998-12-30T09:30:00-05:00,30.75,30.82812,30.34375,30.34375,70400,NaN,NaN,NaN,NaN,NaN,NaN,NaN,NaN,NaN,NaN,-61800,-16200,NaN,NaN,NaN,NaN,NaN,NaN
1998-12-31T09:30:00-05:00,30.23437,30.23437,30.03125,30.23437,21600,NaN,NaN,NaN,NaN,NaN,NaN,NaN,NaN,NaN,NaN,-83400,-28060,NaN,NaN,NaN,NaN,NaN,NaN
1999-01-04T09:30:00-05:00,30.01562,30.25,29.625,29.75,109300,NaN,NaN,NaN,NaN,NaN,NaN,NaN,NaN,NaN,NaN,-192700,-66540,NaN,NaN,NaN,NaN,NaN,NaN
1999-01-05T09:30:00-05:00,29.98437,30.10937,29.85937,30.10937,111200,NaN,NaN,NaN,NaN,NaN,NaN,NaN,NaN,NaN,NaN,-81500,-82160,NaN,NaN,NaN,NaN,NaN,NaN
1999-01-06T09:30:00-05:00,30.20312,30.51562,30.20312,30.42187,41000,NaN,NaN,NaN,NaN,NaN,NaN,NaN,NaN,NaN,NaN,-40500,-91980,NaN,NaN,NaN,NaN,NaN,NaN
1999-01-07T09:30:00-05:00,30.42187,30.73437,30.25,30.3125,222300,NaN,NaN,NaN,NaN,NaN,NaN,NaN,NaN,NaN,NaN,-262800,-132180,NaN,NaN,NaN,NaN,NaN,NaN
1999-01-08T09:30:00-05:00,30.40625,30.51562,30.10937,30.48437,135900,NaN,NaN,NaN,NaN,NaN,NaN,NaN,NaN,NaN,NaN,-126900,-140880,NaN,NaN,NaN,NaN,NaN,NaN
1999-01-11T09:30:00-05:00,30.3125,30.3125,29.5625,29.67187,129000,NaN,NaN,NaN,NaN,NaN,NaN,NaN,NaN,NaN,NaN,-255900,-153520,NaN,NaN,NaN,NaN,NaN,NaN
1999-01-12T09:30:00-05:00,29.64062,30.125,29.53125,29.6875,7100,NaN,NaN,NaN,NaN,NaN,NaN,NaN,NaN,NaN,NaN,-248800,-186980,NaN,NaN,NaN,NaN,NaN,NaN
1999-01-13T09:30:00-05:00,29.5,30.10937,29.5,29.89062,25900,NaN,50.75334687160138,NaN,NaN,NaN,NaN,NaN,NaN,NaN,NaN,-222900,-223460,NaN,NaN,NaN,NaN,NaN,NaN
1999-01-14T09:30:00-05:00,29.46875,29.76562,29.25,29.39062,20000,NaN,44.93201327356775,NaN,NaN,NaN,NaN,NaN,NaN,NaN,NaN,-242900,-219480,NaN,NaN,NaN,NaN,NaN,NaN
1999-01-15T09:30:00-05:00,29.5,29.79687,29.42187,29.53125,6900,NaN,46.780931590580145,NaN,NaN,NaN,NaN,NaN,NaN,NaN,NaN,-236000,-241300,NaN,NaN,NaN,NaN,NaN,NaN
1999-01-19T09:30:00-05:00,30.4375,30.53125,30,30.53125,12200,NaN,57.665668548022985,NaN,NaN,NaN,NaN,NaN,NaN,NaN,NaN,-223800,-234880,NaN,NaN,NaN,NaN,NaN,NaN
1999-01-20T09:30:00-05:00,30.5625,30.73437,30.28125,30.40625,32700,NaN,56.12053102824647,NaN,NaN,NaN,NaN,NaN,NaN,NaN,NaN,-256500,-236420,NaN,NaN,NaN,NaN,NaN,NaN
1999-01-21T09:30:00-05:00,30.625,30.625,30.29687,30.29687,20500,51845,54.73838361504396,NaN,NaN,NaN,71.66961485096486,NaN,NaN,NaN,NaN,-277000,-247240,4.129606099110546,NaN,NaN,NaN,NaN,NaN
1999-01-22T09:30:00-05:00,30.09375,30.71875,29.96875,30.5,20800,52490,56.863106485640515,NaN,NaN,NaN,63.34230466235732,NaN,NaN,NaN,NaN,-256200,-249900,4.083161188224068,NaN,NaN,NaN,NaN,NaN
1999-01-25T09:30:00-05:00,30.5,30.5,29.35937,29.35937,13600,51965,44.2902091544098,NaN,NaN,NaN,-90.34914099425983,NaN,NaN,NaN,NaN,-269800,-256660,3.9612314976502176,NaN,NaN,NaN,NaN,NaN
1999-01-26T09:30:00-05:00,29.6875,29.9375,29.23437,29.9375,15200,51535,50.28972682237135,NaN,NaN,NaN,-87.07606869889882,NaN,NaN,NaN,NaN,-254600,-262820,3.848455137187713,NaN,NaN,NaN,NaN,NaN
1999-01-27T09:30:00-05:00,29.85937,29.85937,29.48437,29.48437,7800,51770,46.09927459849919,NaN,NaN,NaN,-94.82713011517593,-27.44808405900248,NaN,NaN,NaN,-262400,-264000,3.8259844152135116,NaN,NaN,NaN,NaN,NaN
1999-01-28T09:30:00-05:00,29.5625,29.9375,29.53125,29.53125,17600,52050,46.595081246870485,NaN,NaN,NaN,-75.77061140250228,-56.936129309695914,NaN,NaN,NaN,-244800,-257560,7.016955746597802,NaN,NaN,NaN,NaN,NaN
1999-01-29T09:30:00-05:00,29.53125,29.65625,29.20312,29.48437,39800,50520,46.13803357597483,NaN,NaN,NaN,-110.38846180838539,-91.68228260384446,NaN,-0.18736500209800866,NaN,-284600,-263240,6.802575065050476,NaN,NaN,NaN,NaN,NaN
1999-02-01T09:30:00-05:00,29.65625,29.65625,29.25,29.42187,12200,50050,45.49729030127322,NaN,NaN,NaN,-100.7567788379642,-93.76381017258532,NaN,-0.20413034255981088,NaN,-296800,-268640,6.596244410304877,NaN,NaN,NaN,NaN,NaN
1999-02-02T09:30:00-05:00,29.04687,29.10937,28.65625,29.03125,27700,45970,41.608077003827916,49.169405293995,NaN,NaN,-174.35599933095543,-111.21979629899666,NaN,-0.24609987890384488,NaN,-324500,-282620,6.081928653656348,NaN,NaN,NaN,NaN,NaN
1999-02-03T09:30:00-05:00,28.875,29.21875,28.875,29.1875,32500,42035,43.681912768147875,48.664302858034034,NaN,NaN,-129.7586495178986,-118.20610017954118,NaN,-0.2637130497841689,NaN,-292000,-288540,5.873095534831208,NaN,NaN,NaN,NaN,NaN
1999-02-04T09:30:00-05:00,29.14062,29.14062,28.75,28.75,18200,40895,39.45637947024213,48.27318615779649,NaN,NaN,-151.20032566510525,-133.29204303206174,NaN,-0.30940755061879344,NaN,-310200,-301620,5.429498635078772,NaN,NaN,NaN,NaN,NaN
1999-02-05T09:30:00-05:00,28.85937,29.01562,28.76562,28.76562,8100,30185,39.68072820599225,47.766028773183066,NaN,NaN,-142.04458369700103,-139.6232674097849,NaN,-0.3404360336018293,NaN,-302100,-305120,5.313840825836138,NaN,NaN,NaN,NaN,NaN
1999-02-08T09:30:00-05:00,28.78125,28.96875,28.71875,28.76562,13300,24055,39.68072820599225,46.48139017732374,NaN,NaN,-131.8286684099177,-145.83764532417558,NaN,-0.36086648569848734,NaN,-302100,-306180,5.277176864390782,NaN,NaN,NaN,NaN,NaN
1999-02-09T09:30:00-05:00,28.82812,29.15625,28.76562,28.89062,12200,18215,41.686237380195244,45.45036920246293,NaN,NaN,-98.93431150027618,-130.75330775803974,NaN,-0.36278930160671763,NaN,-289900,-299260,9.659440825889689,5.56422820707301,NaN,NaN,NaN,NaN
1999-02-10T09:30:00-05:00,28.89062,28.98437,28.67187,28.6875,8000,18260,39.39416752823983,44.3543537676912,NaN,NaN,-108.19058290934856,-126.43969443632973,-0.08179002624513942,-0.37636473513473945,-0.2945747088896,-297900,-300440,9.578067440046723,5.9534040171398805,NaN,NaN,NaN,NaN
1999-02-11T09:30:00-05:00,28.76562,28.96875,28.67187,28.8125,4400,17185,41.524990930707744,43.25877408519601,NaN,NaN,-92.49503328181751,-114.6986359596722,-0.06253238630589397,-0.3727401917719675,-0.3102078054660735,-293500,-297100,11.841887106751471,6.507598725606123,NaN,NaN,NaN,NaN
1999-02-12T09:30:00-05:00,28.95312,28.95312,28.21875,28.34375,103000,21335,36.36204800783921,42.69247686044097,NaN,NaN,-117.92287237461038,-109.87429369519407,-0.07427044421998585,-0.40304586074105586,-0.32877541652107,-396500,-315980,10.275775032467948,6.958637549521676,NaN,NaN,NaN,NaN
1999-02-16T09:30:00-05:00,28.71875,28.85937,28.64062,28.85937,59300,23955,44.531736621968875,42.281191846126504,NaN,NaN,-73.26636248484293,-98.16183251017912,-0.041831205572082086,-0.38106442348617264,-0.33923321791409056,-337200,-323000,9.758971157422536,7.380817265252735,NaN,NaN,NaN,NaN
1999-02-17T09:30:00-05:00,28.78125,29.25,28.65625,28.65625,57400,26215,42.231696289788886,42.0049362526472,NaN,NaN,-58.94186368138392,-90.16334294640066,-0.029175977702023126,-0.37570319004161945,-0.3465272123395963,-394600,-343940,8.401603211334034,7.707647179261343,NaN,NaN,-14.227445526723834,NaN
1999-02-18T09:30:00-05:00,28.78125,29.5625,28.65625,29.17187,14000,25280,49.37923150729754,42.20380412839199,NaN,NaN,-16.26855982825617,-71.77893833018219,0.016350413182924017,-0.3260891958609413,-0.34243960904386533,-380600,-360480,7.51273909717662,7.743060275731259,NaN,NaN,-11.985193822244234,NaN
1999-02-19T09:30:00-05:00,29.01562,29.15625,28.75,28.85937,9600,24735,45.68955282758462,42.171769789221266,NaN,NaN,-42.2534326217363,-61.73061819816594,0.0272072939266938,-0.30843049163549807,-0.33563778556219187,-390200,-379820,6.629533480778164,7.730700162568951,NaN,NaN,-11.253258152784968,NaN
1999-02-22T09:30:00-05:00,28.96875,29.79687,28.96875,29.79687,6900,24040,56.25089926263331,42.93988471503269,NaN,NaN,80.95523048700912,-21.954997625842033,0.09547493059101586,-0.21629412232342204,-0.3117690529144379,-383300,-377180,8.21575484987902,7.8463794796813895,NaN,NaN,-6.876045181687783,NaN
1999-02-23T09:30:00-05:00,29.53125,29.53125,28.75,28.85937,15100,24115,46.51059564124253,43.29006461770517,NaN,NaN,-9.226052925233782,-9.146935713920204,0.07627208817678105,-0.21642894269346158,-0.29270103087024263,-398400,-389420,7.573355919205724,7.9529099986492024,NaN,NaN,-6.70254882058527,NaN
1999-02-24T09:30:00-05:00,28.95312,29.5625,28.95312,29.125,66000,26655,49.19495347165173,43.683853239384014,NaN,NaN,38.32419550371744,10.306276123100059,0.07985819514316161,-0.1928782869412906,-0.2727364820844522,-332400,-376980,14.8598002031583,8.59481747495828,NaN,NaN,-5.612067160530487,NaN
1999-02-25T09:30:00-05:00,28.9375,28.96875,28.375,28.5,23600,27445,43.6449390035705,43.98303606319318,NaN,NaN,-108.05018787776308,-8.050049486801319,0.040520045526748816,-0.22208642517601618,-0.262606470702765,-356000,-372060,17.625719498040453,9.46597610802697,NaN,NaN,-6.741034915591718,NaN
1999-02-26T09:30:00-05:00,28.70312,28.70312,28.26562,28.67187,11400,27135,45.46689762474509,44.39633387881839,NaN,NaN,-124.48202546612963,-24.495768055679985,0.02710200265765178,-0.22872896738070025,-0.25583097003835203,-344600,-362940,22.642462943363668,10.703734830707509,NaN,NaN,-6.996675881341656,NaN
1999-03-01T09:30:00-05:00,28.4375,28.4375,28.07812,28.25,8400,25565,41.8871709815285,44.55393693421384,NaN,NaN,-197.92879442989653,-80.27257303906111,-0.0073192941400131994,-0.26498008771336856,-0.25766079357335536,-353000,-356880,25.872960253936213,12.17486221567504,NaN,NaN,-8.430137607102996,NaN
1999-03-02T09:30:00-05:00,28.4375,28.51562,27.82812,27.82812,10300,25470,38.613127108041375,44.33442905763142,NaN,NaN,-226.300078443898,-123.68737814279396,-0.05308455836757747,-0.3240164915328272,-0.2709319331652497,-363300,-349860,29.543556677434466,13.595156205071095,NaN,NaN,-10.724431968925247,NaN
1999-03-03T09:30:00-05:00,27.84375,28.01562,27.84375,27.84375,4700,24320,38.8039723871027,44.29227226183591,NaN,NaN,-210.0197545156309,-173.35616814666363,-0.07551905429342393,-0.3653307510320296,-0.2898116967386057,-358600,-355100,28.412590366599858,14.940479271253464,NaN,NaN,-12.451094756455658,NaN
1999-03-04T09:30:00-05:00,28.07812,28.28125,28,28.28125,5700,22980,44.04756192947829,44.472455904605226,NaN,NaN,-118.81142326571879,-175.50841522425475,-0.05505934225673814,-0.3586358745595284,-0.30357653230279025,-352900,-354480,28.760090786586474,16.148922391241676,NaN,NaN,-12.290716418984617,NaN
1999-03-05T09:30:00-05:00,28.75,28.8125,28.42187,28.76562,21000,23120,49.23392489559229,45.39187568230187,NaN,NaN,-11.85995120392532,-152.98400037181392,-0.005670278299576836,-0.3106643801772613,-0.30499410187768444,-331900,-351940,30.253799620921825,17.57592414755981,NaN,NaN,-10.501431883759818,-9.599390930516792
1999-03-08T09:30:00-05:00,28.64062,28.64062,28.29687,28.4375,39100,24670,46.11552909123196,45.50500371582067,NaN,NaN,-51.916423832494154,-123.78152625233342,0.007423796678476924,-0.2957143560295883,-0.3031381527080652,-371000,-355540,29.31560085007135,18.972826268463297,NaN,NaN,-9.997369865850892,-9.65624506413595
1999-03-09T09:30:00-05:00,28.46875,28.57812,28.1875,28.35937,5800,24295,45.37849651100313,45.729775160193114,NaN,NaN,-62.894272061843246,-91.10036497592247,0.01301932011139384,-0.28686400256882294,-0.2998833226802168,-376800,-358240,28.599266503567733,20.41551650362285,NaN,NaN,-9.813742187360816,-9.678744653168074
1999-03-10T09:30:00-05:00,28.23437,28.375,28.17187,28.26562,34000,25385,44.460270219483355,45.37842078249211,NaN,NaN,-76.07735420717374,-64.31188491423104,0.01259506454948156,-0.28413949199336486,-0.2967345565428464,-410800,-368680,25.958014366287557,21.7330361657022,NaN,NaN,-9.927687546197394,-9.714307923600835
1999-03-11T09:30:00-05:00,28.29687,28.65625,28.21875,28.48437,9600,25465,47.14762848816653,45.48256904396224,NaN,NaN,-35.60878818443873,-47.67135789797503,0.028334281556904373,-0.26131670459671597,-0.28965098615362034,-401200,-378340,23.770483021692698,22.957389704338954,NaN,NaN,-9.265687125602605,-9.650219238172516
1999-03-12T09:30:00-05:00,28.89062,28.92187,28.65625,28.79687,7800,25635,50.809394726901445,45.093890148552816,NaN,NaN,33.277595112914334,-38.643848634607096,0.05929770069274076,-0.21552886028769436,-0.2748265609804351,-393400,-390640,21.308178254998523,23.89256280470463,NaN,NaN,-7.64355552858458,-9.363552993945667
1999-03-15T09:30:00-05:00,28.92187,29,28.75,28.875,15900,21280,51.71020633266887,45.46529091222612,NaN,NaN,45.58715069383959,-19.143133729340356,0.08308810386161458,-0.17096643115341692,-0.2540545350150315,-377500,-391940,21.05987494368395,24.855885592167365,NaN,NaN,-6.048074769215388,-8.889913247555628
1999-03-16T09:30:00-05:00,28.78125,28.92187,28.60937,28.76562,10100,18820,50.32087830444568,45.545714114568554,NaN,NaN,24.061954635688696,-1.7518883898339588,0.08897964260277016,-0.1428299817615688,-0.23180962436433897,-387600,-394100,20.6297203035181,25.26802274219306,NaN,NaN,-5.073129700767367,-8.344658455157305
1999-03-17T09:30:00-05:00,28.82812,28.89062,28.5,28.5,12100,16555,47.01723501102771,45.78659240081549,NaN,NaN,-0.8072732936349054,13.302127792873808,0.07317000128405263,-0.1403471227592732,-0.21351712404332582,-399700,-391880,22.38441540509804,25.60792959269717,NaN,NaN,-5.119442839391625,-7.883913367190779
1999-03-18T09:30:00-05:00,28.4375,28.92187,28.4375,28.92187,13800,16545,52.36612208659427,46.27939414809043,NaN,NaN,31.789411092052227,26.78176764817199,0.08829448471195572,-0.10314901815338118,-0.1914435028653369,-385900,-388820,24.850582544841956,25.765652421374195,NaN,NaN,-3.6402270220725197,-7.277672460745313
1999-03-19T09:30:00-05:00,28.59375,28.75,28.20312,28.20312,51000,18615,44.18222290055933,46.4433264280212,NaN,NaN,-45.23615572542002,11.079017480505119,0.04902208312964293,-0.13016589895328323,-0.17918798208292616,-436900,-397520,22.647289261763163,25.535247350504694,NaN,NaN,-4.820034337727142,-6.926581300314146
1999-03-22T09:30:00-05:00,28.20312,28.53125,28.20312,28.29687,38400,20190,45.38125193680327,46.92676391578991,NaN,NaN,-47.52427064696083,-7.543266787654967,0.029453612659475215,-0.14237096625858214,-0.17182457891805736,-398500,-401720,21.64936930774435,24.971376824098257,NaN,NaN,-5.418597918314407,-6.711155102885612
1999-03-23T09:30:00-05:00,28.04687,28.04687,27.23437,27.40625,34400,21155,37.20484476372033,46.812540514119746,NaN,NaN,-215.31717263025985,-55.41909224084468,-0.03962632843406633,-0.22135748946064027,-0.18173116102657394,-432900,-410780,19.63905628916011,24.344695818566844,NaN,NaN,-8.731709186094488,-6.9998056862011655
1999-03-24T09:30:00-05:00,27.59375,27.90625,27.25,27.78125,23700,19040,41.94759002856822,46.66254252119759,NaN,NaN,-174.34699873038952,-90.1270373281956,-0.05525858735745323,-0.2508043952233905,-0.19554580786593725,-409200,-412680,19.235656619187353,23.66437909232405,NaN,NaN,-9.92052892946253,-7.417051863809932
1999-03-25T09:30:00-05:00,27.79687,27.79687,27.53125,27.6875,7600,18240,41.11161578181637,46.082377584499305,NaN,NaN,-142.05439303338673,-124.89579815328338,-0.06635999012268284,-0.2784957955192908,-0.21213580539660798,-416800,-418860,17.944536284596538,22.785145996872245,NaN,NaN,-11.126452256093904,-7.9469662055647845
1999-03-26T09:30:00-05:00,27.26562,27.39062,27.15625,27.32812,12300,18285,37.98639120002883,45.501724877984806,NaN,NaN,-182.38936342732825,-152.32643969366504,-0.09084022434725375,-0.32568608583067515,-0.2348458614834214,-429100,-417300,19.414934860106314,22.0779555690176,NaN,NaN,-13.13264320640335,-8.68777720568458
1999-03-29T09:30:00-05:00,27.39062,27.54687,27.1875,27.1875,14500,18590,36.807349663139625,44.8895001031374,NaN,NaN,-147.14525063923892,-172.25063569212065,-0.1082549612266519,-0.3701645630167363,-0.2619096017900844,-443600,-426320,17.466039063655657,21.282725037595306,NaN,NaN,-15.127200731097695,-9.607694852172168
1999-03-30T09:30:00-05:00,26.9375,27.07812,26.75,26.75,11500,18650,33.34011085158498,44.095203005430385,NaN,NaN,-177.64740060967154,-164.716681288003,-0.13902772504764815,-0.43569425809964457,-0.2966665330519964,-455100,-430760,16.583584786189945,20.61312292473119,NaN,NaN,-17.944422695436028,-10.798655972638434
1999-03-31T09:30:00-05:00,26.9375,26.98437,26.6875,26.6875,20500,19440,32.863839830877794,43.07493238705262,NaN,NaN,-156.73341555497038,-161.19396465291916,-0.15231138599914756,-0.4870557655509309,-0.3347443795517833,-475600,-444040,14.262489767365295,19.933980549422092,NaN,NaN,-20.363366938139833,-12.165043253424347
1999-04-01T09:30:00-05:00,26.79687,27.25,26.79687,27.25,11200,19715,41.02880339028209,42.37631872015123,NaN,NaN,-102.65923867392283,-153.31493378102635,-0.1137036762908275,-0.4768739749153177,-0.3631702986244902,-464400,-453560,12.871663921563922,19.33137238274819,NaN,NaN,-20.025128492670255,-13.28791257331662
1999-04-05T09:30:00-04:00,27.32812,27.57812,27.1875,27.46875,8400,19085,43.88687074524633,41.817509035335334,NaN,NaN,-61.419195754103605,-129.12090024638144,-0.06627350895413325,-0.44601218481715676,-0.3797386758630235,-456000,-458940,12.150550823896495,18.694992088477655,NaN,NaN,-18.875585431116015,-14.086151553002248
1999-04-06T09:30:00-04:00,27.5,27.625,27.29687,27.32812,38900,19075,42.46208858216578,41.256166912315344,NaN,NaN,-54.87129218440223,-110.6661085554141,-0.03858370513193876,-0.427968307277947,-0.38938460214600823,-494900,-469200,10.89678392507966,17.99978234716062,NaN,NaN,-18.341941035536262,-14.694121479078536
1999-04-07T09:30:00-04:00,27.5625,27.75,27.4375,27.6875,29100,20240,47.18122757064187,41.2678806665735,NaN,NaN,-29.33120876586428,-81.00287018665264,0.007279086156318393,-0.38028574445061025,-0.38756483060692865,-465800,-471340,10.649941862728355,17.161605665562785,NaN,NaN,-16.465490549466104,-14.947174203419618
1999-04-08T09:30:00-04:00,27.78125,28.53125,27.78125,28.42187,44900,20785,55.25692768146338,41.47436678049272,NaN,NaN,37.57062728664853,-42.14206161832888,0.08604254586025939,-0.2800116482816044,-0.3660541941418638,-420900,-460400,20.55740532230746,16.854950149667467,NaN,NaN,-12.101747808470455,-14.54068471842688
1999-04-09T09:30:00-04:00,28.46875,28.46875,28.15625,28.21875,17300,21170,52.85001975127325,42.093495126972286,NaN,NaN,43.08734972603416,-12.992743938337478,0.12127406640809985,-0.214461611131739,-0.33573567753983885,-438200,-455160,24.855383073747703,17.012671136237792,NaN,NaN,-9.29337928563203,-13.791069656599044
1999-04-12T09:30:00-04:00,28.25,28.67187,28.15625,28.625,9500,21255,56.89422825464683,42.91585057824682,NaN,NaN,68.92512315639712,13.076119843762655,0.16598587799426084,-0.12825333004701278,-0.2942392080412736,-428700,-449700,29.15627164634293,17.54887844613769,NaN,NaN,-5.605760119802948,-12.62173972277103
1999-04-13T09:30:00-04:00,28.625,28.65625,28.15625,28.15625,13000,21110,51.4143722044952,43.93081682401645,NaN,NaN,56.76152642962784,35.40268356656867,0.15807711406147962,-0.0966428154644241,-0.2547199295259037,-441700,-439060,36.75311428411984,18.771311160063384,NaN,NaN,-4.1955822344497875,-11.418002938725138
1999-04-14T09:30:00-04:00,28.25,28.25,27.73437,27.75,26600,21935,47.17367354179525,44.30410850353267,NaN,NaN,14.17006253722006,44.10293782718554,0.12122969756728902,-0.10318280756679243,-0.22441250513408145,-468300,-439560,36.554738588068794,20.008388443554914,NaN,NaN,-4.377960660939942,-10.412282613327253
1999-04-15T09:30:00-04:00,27.82812,28.14062,27.82812,28.03125,17500,22205,50.234011250679124,44.955708179880006,NaN,NaN,31.869870272141288,42.96278642428409,0.11177403361421212,-0.0846949631163163,-0.19646899673052842,-450800,-445540,34.17863742640485,21.167967096541222,NaN,NaN,-3.561570610830875,-9.433609470113485
1999-04-16T09:30:00-04:00,28.1875,28.40625,28.17187,28.34375,2800,21655,53.46017121803447,46.06097818116613,NaN,NaN,81.95973438191639,50.73726335546054,0.12172221737876451,-0.044316225007072774,-0.1660384423858373,-448000,-447500,33.412046124680785,22.167760758296538,NaN,NaN,-1.8687162195303617,-8.352910434315895
1999-04-19T09:30:00-04:00,28.625,29.125,28.57812,28.625,11900,19700,56.21148826145396,47.446988081045724,NaN,NaN,141.11601939766913,65.17544260371494,0.14103912519661932,0.010260464109936862,-0.13077866108668246,-436100,-448980,32.81356171385711,23.26401237616807,NaN,NaN,0.39556483014879146,-7.103128253678083
1999-04-20T09:30:00-04:00,28.65625,28.9375,28.65625,28.9375,10300,18295,59.10439646523598,49.287294196306505,NaN,NaN,139.0655715980023,81.63625163738983,0.16688838881994944,0.07783182493825436,-0.08905656388169508,-425800,-445800,35.48745477784388,24.614288804143353,NaN,NaN,3.1968587689560164,-5.631701536158926
1999-04-21T09:30:00-04:00,29.0625,29.45312,28.85937,29.45312,19600,17555,63.40084791300854,51.46850905931584,NaN,NaN,162.4305463474498,111.28834839943579,0.20805921687483867,0.17101745721185324,-0.03704175966298542,-406200,-433380,44.738015384126236,26.79111206248342,NaN,NaN,7.013512122894448,-3.825242442008444
1999-04-22T09:30:00-04:00,29.39062,29.39062,28.98437,29.35937,13200,17030,62.12290559409089,52.97523064530218,NaN,NaN,138.6899123744634,132.6523568199002,0.21731228300731556,0.23459859409615902,0.017286311088843466,-419400,-427100,48.74042564436168,29.35316647125469,NaN,NaN,9.701020401262223,-1.8929191786840631
1999-04-23T09:30:00-04:00,29.53125,29.53125,29.3125,29.34375,6100,16955,61.89903631019937,54.261813899941686,NaN,NaN,134.10807520171448,143.0820249838598,0.2105656287233462,0.2804933469930262,0.06992771826968,-425500,-422600,51.453671032529684,32.16053220044277,NaN,NaN,11.806967236984962,0.06420745212579737
1999-04-26T09:30:00-04:00,29.34375,29.54687,29.1875,29.1875,6100,16645,59.58585535669121,55.48494009812208,NaN,NaN,112.7304317871889,137.4049074617638,0.18468973069073658,0.3007898816331007,0.11610015094236414,-431600,-421700,52.000890995870066,35.09653984835637,NaN,NaN,12.94009857879528,1.9036204702214374
1999-04-27T09:30:00-04:00,29.04687,29.375,29.04687,29.35937,8700,16355,61.29907029477971,56.4933574355605,NaN,NaN,99.52663839894163,129.49712082195165,0.1686993572009965,0.32697434744360976,0.15827499024261327,-422900,-421120,52.37347533619094,38.07679223931798,NaN,NaN,14.378085360222409,3.685686883078719
1999-04-28T09:30:00-04:00,29.48437,29.54687,29.23437,29.23437,8700,16215,59.32918269634068,56.78423279376602,NaN,NaN,98.04207977359508,116.61942750718069,0.14041323096447833,0.3337915289482112,0.19337829798373285,-431600,-426200,48.800453412028745,40.094152817155226,NaN,NaN,15.065475141894458,5.311370920052396
1999-04-29T09:30:00-04:00,29.73437,29.82812,29.64062,29.65625,13700,15875,63.582793889673574,57.550859517937475,NaN,NaN,122.26434115655455,113.33431326359892,0.14048374442508163,0.3689829785150849,0.22849923409000325,-417900,-425900,49.021636746594424,41.82031379378713,NaN,NaN,16.893177137515327,6.965914665404243
1999-04-30T09:30:00-04:00,29.53125,29.59375,29,29.26562,32500,16940,57.57806635792366,57.599705096742966,NaN,NaN,71.4786404163451,100.80842630652504,0.10615127295734111,0.36118832528667966,0.25503705232933854,-450400,-430880,45.50717414937443,42.988235401146525,NaN,NaN,16.74750979385203,8.363285398039642
1999-05-03T09:30:00-04:00,29.35937,29.79687,29.35937,29.70312,4400,16740,61.91609413549586,58.349828091814445,NaN,NaN,98.86507481658889,98.03535491240503,0.10466282363320567,0.38586558187084563,0.28120275823763996,-446000,-433760,43.562136046099646,43.47459409843079,NaN,NaN,17.929299817636153,9.729858886553428
1999-05-04T09:30:00-04:00,29.875,29.875,29.375,29.45312,50200,17305,58.25046995648726,59.14102783572101,NaN,NaN,86.76794228825932,95.48361569026856,0.07972520644653419,0.3808592662958077,0.3011340598492735,-496200,-448420,35.292956028588094,43.384466772753605,NaN,NaN,17.81497235124747,10.884875095795433
1999-05-05T09:30:00-04:00,29.51562,29.6875,29.39062,29.6875,627100,47205,60.605237779885115,59.8818297306643,NaN,NaN,82.49653880325293,92.37450749620012,0.07212766635764312,0.3912936427963274,0.3191659764386843,130900,-335920,74.81000822802218,46.286707544297705,NaN,NaN,18.41663799205209,11.960841223832098
1999-05-06T09:30:00-04:00,29.46875,29.5625,29.0625,29.0625,16700,45795,52.15721550579161,59.788761465504095,NaN,NaN,32.59230999787138,74.4401012644635,0.020788808793141045,0.34515198743011055,0.3243631786369695,114200,-229500,84.47113951733826,49.93378564377324,NaN,NaN,16.248209027420383,12.573322338630424
1999-05-07T09:30:00-04:00,29.42187,29.59375,29.42187,29.42187,6100,45235,55.95868616423669,59.77070417284572,NaN,NaN,61.67198819229171,72.47877081965281,0.007497820423843837,0.3337354541667743,0.32623763374293047,120300,-115360,89.23845491290852,53.9641351579912,NaN,NaN,15.624375522850583,13.009187079233303
1999-05-10T09:30:00-04:00,29.42187,29.42187,29.32812,29.34375,4100,44965,54.93679738353071,59.47301852415249,NaN,NaN,41.730985704615236,61.051952997258084,-0.009185443863963971,0.3147558289129755,0.32394127277693946,116200,-2920,91.88229513997183,57.99233804100033,NaN,NaN,14.81220623756655,13.266761244709482
1999-05-11T09:30:00-04:00,29.26562,29.46875,29.04687,29.45312,15600,45095,56.14428579301612,58.95469265843873,NaN,NaN,31.501986367931043,49.998761813192424,-0.015134247422674607,0.3050234634985962,0.3201577109212708,131800,122680,93.73410757808823,61.492058911997624,NaN,NaN,14.496384406163534,13.442421696345775
1999-05-12T09:30:00-04:00,29.39062,29.53125,29.23437,29.53125,11800,44355,57.030073849176155,58.590918962373394,NaN,NaN,48.978172894893326,43.29508863152051,-0.016002222651413378,0.3001549326070041,0.3161571552584175,143600,125220,93.76508342199179,64.70810589611406,NaN,NaN,14.483637685676099,13.591166837678678
1999-05-13T09:30:00-04:00,29.42187,30,29.42187,29.92187,10300,43995,61.24467384919331,58.544178786587246,NaN,NaN,141.5619884234528,65.08902431663682,0.006338721649543355,0.3240805573203467,0.31774183567080333,153900,133160,93.86714779703232,67.73763995072139,NaN,NaN,15.701276209670956,13.892611033677575
1999-05-14T09:30:00-04:00,29.65625,29.65625,29.35937,29.35937,15600,44635,53.15891801450495,58.08511183357395,NaN,NaN,35.987948869216595,59.9522164520218,-0.018784921103410457,0.2942606842915403,0.31304560539495074,138300,136760,93.91577902037224,70.73156052390011,NaN,NaN,14.28448981961486,13.948593717382902
1999-05-17T09:30:00-04:00,29.54687,29.98437,29.32812,29.96875,10200,44550,59.41082956205049,57.95023749552187,NaN,NaN,137.7001164024109,79.14604259158094,0.0024880338976971395,0.31615564776707217,0.31366761386937503,148500,143220,94.00760547048502,73.70542696206398,NaN,NaN,15.071299660448606,14.108980280678002
1999-05-18T09:30:00-04:00,29.92187,29.92187,29.26562,29.3125,10800,44575,51.447161838612516,57.38723600568414,NaN,NaN,25.123379351130655,77.87032118822086,-0.02904890652354586,0.2773564807149427,0.30640538723848854,137700,144400,94.0253436855771,76.93577626731744,NaN,NaN,13.000470812465812,13.950621785219118
1999-05-19T09:30:00-04:00,29.60937,29.95312,29.60937,29.92187,31100,45150,57.18606733161543,56.93032696582285,NaN,NaN,150.49430537699945,98.17354768464207,-0.011197727753756492,0.2924082275462929,0.3036059553000494,168800,149440,94.10560056931506,80.15605939751177,NaN,NaN,13.266837419047143,13.852938304337407
1999-05-20T09:30:00-04:00,29.89062,30.10937,29.6875,29.85937,28200,45900,56.44908849618422,56.84968568998431,NaN,NaN,149.4466505997064,99.75048011989279,-0.006178472873235918,0.2958828642085045,0.30206133708174043,140600,146780,93.39255480541296,83.57644373008596,NaN,NaN,13.228760270079059,13.763770013729072
1999-05-21T09:30:00-04:00,29.6875,29.76562,29.57812,29.57812,7000,45945,53.130841742041184,56.222167661880405,NaN,NaN,47.58233201569154,102.06935674918779,-0.023411168896252832,0.2727973759614244,0.2962085448576772,133600,145840,93.12402372041036,87.11657856396528,NaN,NaN,12.127396197939126,13.53000232575908
1999-05-24T09:30:00-04:00,29.92187,30.03125,29.70312,29.875,10900,46185,56.06659595491231,56.066176661767905,NaN,NaN,120.62175419244855,98.65368430719532,-0.016739325480060074,0.27528438800760213,0.2920237134876622,144500,145040,92.87925953447551,91.22988595724296,NaN,NaN,12.141538541334027,13.331650356555501
1999-05-25T09:30:00-04:00,30,30.34375,29.875,29.90625,20900,46795,56.376343850201444,55.76411280964765,NaN,NaN,162.54182110358445,126.13737265768607,-0.012348062638935176,0.27658863518899324,0.2889366978279284,165400,150580,93.01615380334927,92.53032492690919,NaN,NaN,12.245088540654296,13.176427239998187
1999-05-26T09:30:00-04:00,29.85937,30.14062,29.71875,30.0625,14900,47105,57.97188535328761,56.17944637018307,NaN,NaN,122.68519950288183,120.57555148286255,-0.0016110690647053727,0.2869228614970467,0.2885339305617521,180300,152880,93.075670740717,93.14493430000766,NaN,NaN,12.794219233336465,13.12182609618937
1999-05-27T09:30:00-04:00,29.9375,29.9375,29.53125,29.54687,8900,46865,51.30329367243014,55.846918335054035,NaN,NaN,19.69324463506759,94.62487028993479,-0.030333685362930962,0.25061682385808837,0.28095050922101933,171400,159040,93.241788194918,93.43088667729405,NaN,NaN,11.254543770024233,12.85507147816578
1999-05-28T09:30:00-04:00,29.625,29.70312,29.60937,29.60937,3100,45395,52.02368767443703,55.63883907011876,NaN,NaN,2.949037198687842,85.69821132653405,-0.045319091073583784,0.22430164537903963,0.2696207364526234,174500,167220,93.46595781952317,93.54400544011915,NaN,NaN,10.212916971051158,12.477620834292262
1999-06-01T09:30:00-04:00,29.51562,29.59375,29.25,29.59375,5400,45445,51.81737230515506,55.329773820985835,NaN,NaN,-53.2379534478458,50.92626979847519,-0.05579086411414691,0.19988215630993977,0.2556730204240867,169100,172140,93.60339089347201,93.53466853407515,NaN,NaN,9.304517829784245,12.02432040507683
1999-06-02T09:30:00-04:00,29.70312,29.73437,29.40625,29.59375,60000,45935,51.81737230515506,54.95743799641291,NaN,NaN,-17.543565770096247,14.909192423739052,-0.06176064142064738,0.17847221864827745,0.24023286006892483,169100,172880,93.62510956972805,93.52467040177058,NaN,NaN,8.552842615513796,11.528395006567825
1999-06-03T09:30:00-04:00,29.59375,29.59375,29.20312,29.3125,8200,14990,47.85429757245446,54.00098254807442,NaN,NaN,-84.38465371201637,-26.504778219240592,-0.08240366238221355,0.1372282820911579,0.21963194447337145,160900,169000,91.86389175795239,93.38158068469345,NaN,NaN,6.806585175315287,10.853850744960319
1999-06-04T09:30:00-04:00,29.5625,29.75,29.53125,29.75,13400,14825,53.77658055966385,54.04510130130005,NaN,NaN,14.934486100223307,-27.45652992620945,-0.06510468644496917,0.13825108641716,0.20335577286212916,174300,169580,91.88845610384492,93.23677190494149,NaN,NaN,6.893613864018952,10.288102619111552
1999-06-07T09:30:00-04:00,29.9375,30.07812,29.82812,30,10900,15065,56.796115534686514,53.858336013631195,NaN,NaN,111.29981250899347,-5.786374864148328,-0.036748668030089277,0.15741993782451758,0.19416860585460685,185200,171720,91.98461365833239,93.09227248978775,NaN,NaN,7.840921763077635,9.93850535396385
1999-06-08T09:30:00-04:00,30.17187,30.26562,30,30,4300,15075,56.79611553468652,54.24040413477935,NaN,NaN,136.0214158633139,32.06549899808361,-0.01881943724862939,0.17064430929382013,0.18946374654244952,185200,174940,92.13568004545044,92.95729651549298,NaN,NaN,8.615194930446235,9.749461007747048
1999-06-09T09:30:00-04:00,30.125,30.28125,30.09375,30.23437,5000,14545,59.66116869319127,54.41719708917761,NaN,NaN,155.38020428852943,66.65025300980875,0.006634444313651178,0.1977568019345135,0.19112235762086233,190200,179160,92.33945203302096,92.83114304861483,NaN,NaN,10.091403258760693,9.798309900748997
1999-06-10T09:30:00-04:00,30,30,29.71875,29.98437,4800,14195,55.43798477529929,54.344975394828694,NaN,NaN,47.856399288998304,93.09846361001169,0.004543813612633896,0.1968021246366547,0.1922583110240208,185400,184060,92.57986796970839,92.77309398892164,NaN,NaN,10.20498886795742,9.856406896064486
1999-06-11T09:30:00-04:00,30,30.03125,29.75,29.78125,7300,14045,52.204621139797986,54.27881678038275,NaN,NaN,29.39920548632796,95.99140748723262,-0.011720173623755603,0.1776080939943263,0.1893282676180819,178100,184820,92.61856223231285,92.73698959691468,NaN,NaN,9.392182873994415,9.790089178625905
1999-06-14T09:30:00-04:00,30.15625,30.64062,30.14062,30.60937,79600,17245,61.94871951307648,54.69896846310876,NaN,NaN,208.29027301696047,115.38949958882601,0.029822879214687376,0.22660686663644114,0.19678398742175376,257700,199320,93.33291098193655,92.76939327173332,NaN,NaN,11.751290339274606,10.070260773004291
1999-06-15T09:30:00-04:00,30.67187,30.8125,30.625,30.64062,43500,18910,62.261387281688876,55.11932870821501,NaN,NaN,227.2109666585941,133.62740974788204,0.054498155246474306,0.26490668147984664,0.21040852623337233,301200,222520,94.28577575546811,92.86008055402752,NaN,NaN,13.714318062805825,10.590840385833081
1999-06-16T09:30:00-04:00,30.71875,31,30.71875,30.9375,124900,24615,65.1879574845777,55.634762431878585,NaN,NaN,223.5506837019296,147.26150563056208,0.08413519053567903,0.3155775144029711,0.23144232386729208,426100,269700,95.647975954168,93.0438166407026,NaN,NaN,16.301008746750416,11.406578723106986
1999-06-17T09:30:00-04:00,30.70312,30.84375,30.625,30.67187,4000,23260,60.65559392601943,56.30278387856354,NaN,NaN,151.46379725487347,167.9829852237371,0.07923870284734236,0.33049070242647005,0.2512519995791277,422100,317040,96.5394093340149,93.27936100778093,NaN,NaN,17.10861465385032,12.221155284641748
1999-06-18T09:30:00-04:00,30.78125,30.875,30.54687,30.59375,68500,25275,59.34870579448892,56.825999458567246,NaN,NaN,120.64315970828021,186.23177606812754,0.06473980306820204,0.33217675341438024,0.2674369503461782,353600,352140,97.0258443648593,93.53363861816209,NaN,NaN,17.382623158947997,12.95850783811407
1999-06-21T09:30:00-04:00,30.42187,30.57812,30.23437,30.35937,58600,27855,55.485980546357204,57.0880429043674,NaN,NaN,60.89052560120571,156.75182658497664,0.03486265045004194,0.31101526340873065,0.2761526129586887,295000,359600,97.11854916447594,93.78472135180523,NaN,NaN,16.477918338190957,13.461280766696483
1999-06-22T09:30:00-04:00,30.28125,30.45312,30.25,30.25,11000,27860,53.72866026012429,57.22456347257948,NaN,NaN,42.81181076303985,119.87199540586577,0.004811303710031578,0.2821667425962282,0.2773554388861966,284000,356160,95.63816623919163,93.92851111390976,NaN,NaN,15.21855400440198,13.712319800654411
1999-06-23T09:30:00-04:00,30.35937,30.35937,30.09375,30.15625,8700,27250,52.20244343707714,57.53514532005254,NaN,NaN,20.559078588618075,79.27367438320348,-0.02278801730279545,0.24887041725770231,0.27165843456049776,275300,326000,83.60544096470016,93.3386217715346,NaN,NaN,13.735042629839434,13.715565919109414
1999-06-24T09:30:00-04:00,29.92187,29.92187,29.67187,29.82812,5100,26760,47.153678527100006,57.062080889155126,NaN,NaN,-47.14175937991105,39.55256305624656,-0.06230929962485837,0.19377181002942478,0.25608110965428316,270200,295620,73.5651560489273,92.02981462475478,NaN,NaN,10.933982286942301,13.318196828799827
1999-06-25T09:30:00-04:00,29.71875,30.03125,29.67187,29.67187,18200,27225,44.92551944100122,56.21418116817761,NaN,NaN,-51.699011937562446,5.084128727078038,-0.0961202698489339,0.1359307723431158,0.2320510421920497,252000,275300,67.70818242393611,90.29578382229792,NaN,NaN,7.912150889730905,12.545904551789981
1999-06-28T09:30:00-04:00,29.9375,30.15625,29.9375,29.98437,9900,27565,50.01299581622572,55.72967261685898,NaN,NaN,-14.450813413943496,-9.984139075951791,-0.09444609269534579,0.11399342632286746,0.20843951901821325,261900,268680,65.86827337112757,88.41954048841771,NaN,NaN,6.723650900327238,11.714154030152446
1999-06-29T09:30:00-04:00,29.9375,30.0625,29.78125,30,3900,27490,50.2604798730438,55.0581948439913,NaN,NaN,-35.30277445321278,-25.607056119202337,-0.08934856386763929,0.09675381418366413,0.18610237805130342,265800,265040,64.82517096070828,86.45423469753824,NaN,NaN,5.823902484047645,10.872689523566047
1999-06-30T09:30:00-04:00,30.20312,30.92187,30.03125,30.64062,26100,25795,59.18080613613551,55.32553922690817,NaN,NaN,71.47692702053139,-15.423486432819676,-0.042283520256538976,0.13324797773062969,0.17553149798716866,291900,268360,65.36393744166344,84.51023965982074,NaN,NaN,7.7684986284377855,10.429233681404867
1999-07-01T09:30:00-04:00,30.79687,30.79687,30.46875,30.53125,28500,26810,57.29171305011744,55.68890293478813,NaN,NaN,77.02759886278314,9.410385215719163,-0.01914751577333748,0.1515971032704968,0.17074461904383428,263400,267000,64.92523744825928,82.53214503238834,NaN,NaN,8.783513160220224,10.19413074980706
1999-07-02T09:30:00-04:00,30.4375,30.54687,30.34375,30.54687,7600,26520,57.500366307721166,55.3711634201199,NaN,NaN,45.31913051008442,28.814013705248534,-0.004202386156262838,0.16549163634850572,0.16969402250476856,271000,270800,65.61957403003794,80.55262096439559,NaN,NaN,9.663511906357067,10.118328057885632
1999-07-06T09:30:00-04:00,30.45312,30.6875,30.29687,30.45312,11400,26545,55.740189129828664,54.90536355212988,NaN,NaN,40.67431512371769,39.83903941278077,-0.0021447464154740192,0.16701308948542604,0.16915783590090006,259600,270340,65.45066677616197,78.49297032301656,NaN,NaN,9.911386232601718,10.08876493998793
1999-07-07T09:30:00-04:00,30.5625,30.73437,30.54687,30.73437,7700,26715,59.723493611700825,54.51504470406724,NaN,NaN,77.40323628951961,62.38024156132725,0.01566391171026904,0.18873772553873636,0.17307381382846732,267300,270640,65.51301416067325,76.34047305205266,NaN,NaN,11.284502231045485,10.259584552996152
1999-07-08T09:30:00-04:00,30.78125,30.78125,30.48437,30.48437,4900,26710,54.98630527888711,54.11009551498637,NaN,NaN,52.520168756950724,58.58888990861112,0.00847260859899493,0.18366457457721097,0.17519196597821604,262400,264740,63.10126532557496,73.95203419430695,NaN,NaN,11.096243903102705,10.379107317297088
1999-07-09T09:30:00-04:00,29.90625,30.54687,29.90625,30.48437,31300,28035,54.986305278887116,53.79849547815767,NaN,NaN,-14.423282840545792,40.298713567945335,0.0019238992718373926,0.1775968400680128,0.1756729407961754,262400,264540,63.01657730643737,71.5228008329911,NaN,NaN,10.94318181979606,10.459689389082655
1999-07-12T09:30:00-04:00,30.59375,30.59375,30.26562,30.35937,7200,28030,52.56839844068481,53.59009675632392,NaN,NaN,2.104031638345629,31.65569379359757,-0.011860343489200675,0.16084751143467457,0.17270785492387525,255200,261380,61.60964125828125,68.9864502682629,NaN,NaN,10.145450975516532,10.414798187144637
1999-07-13T09:30:00-04:00,30.48437,30.5,30.21875,30.21875,1000,24100,49.90956824982355,53.317304469873875,NaN,NaN,-21.746273808752914,19.17157600710345,-0.0304268854350202,0.13467424813009998,0.16510113356512018,254200,260300,61.10748909129859,66.51997332912768,NaN,NaN,8.722691475187737,10.17306865686508
1999-07-14T09:30:00-04:00,30.26562,30.40625,30.25,30.40625,13000,22575,53.301212712722396,53.39578798956283,NaN,NaN,-5.824039527055718,2.526120843788385,-0.03000839017429402,0.12759064584725266,0.15759903602154668,267200,260280,61.097557897968706,64.91226739578971,NaN,NaN,8.414649387597466,9.921865904112565
1999-07-15T09:30:00-04:00,30.54687,30.875,30.54687,30.875,7200,16690,60.50165446803176,54.34921484248652,NaN,NaN,118.21265566234466,15.664618224867173,0.00030473353310842,0.1579799529379322,0.1576752194048238,274400,262680,61.89780285616886,64.0788850248784,NaN,NaN,10.331163671045534,9.980337013674417
1999-07-16T09:30:00-04:00,31.03125,31.25,31.03125,31.23437,1500,16565,64.96208715169988,55.78039825039356,NaN,NaN,212.62462995694065,61.074200784364464,0.04078509654314544,0.2086565900837556,0.16787149354061015,275900,265380,62.82429658100893,63.73003603609788,NaN,NaN,13.45759155736783,10.477087662773476
1999-07-19T09:30:00-04:00,31.25,31.25,30.9375,30.9375,5800,13430,59.031582055061676,56.424582981738986,NaN,NaN,159.83474844037303,92.62034414476994,0.04354337946760359,0.22230071787511463,0.17875733840751104,270100,268360,63.868571337728525,63.587200176569375,NaN,NaN,14.22174416237636,11.012038591288174
1999-07-20T09:30:00-04:00,31.01562,31.23437,30.98437,31.07812,5100,10755,60.85454773783884,57.18130211493864,NaN,NaN,146.71303541412647,126.31220598934583,0.05033394521767029,0.2416747699295989,0.19134082471192862,275200,272560,65.34606573306323,63.62440694602329,NaN,NaN,15.418073488704978,11.641472148062004
1999-07-21T09:30:00-04:00,31,31.42187,31,31.26562,14800,10945,63.20553692392892,57.46878288549531,NaN,NaN,150.24364078768468,157.52574205229388,0.062172945884140574,0.26905700706710434,0.20688406118296376,290000,277120,66.92734995996882,63.736079268759404,NaN,NaN,17.14820651593989,12.428148486330274
1999-07-22T09:30:00-04:00,30.9375,31.21875,30.9375,31.21875,4100,10715,62.19990875743947,57.81936829316117,NaN,NaN,113.4809848807696,156.5794078959789,0.06145693718490958,0.28370523266410075,0.22224829547919117,285900,279420,67.72725956810638,63.93622370589134,NaN,NaN,18.25363944738342,13.260361480766438
1999-07-23T09:30:00-04:00,31.10937,31.20312,31.01562,31.01562,3400,10630,57.90031863893662,57.84793631681941,NaN,NaN,94.24711590555519,132.9039050857018,0.04279700526591532,0.2757445520615853,0.23294754679567,282500,280740,68.20258873124067,64.12072475597725,NaN,NaN,17.932119607944923,13.927755498934793
1999-07-26T09:30:00-04:00,30.92187,31.29687,30.92187,31.0625,24600,10950,58.61139511893314,58.0530224588983,NaN,NaN,86.86458646098914,118.30987268982501,0.029725865468715085,0.27010487863156385,0.24037901316284876,307100,288140,70.79913905303542,64.50275849003965,NaN,NaN,17.86871336683425,14.490749480063288
1999-07-27T09:30:00-04:00,31.23437,31.40625,31.09375,31.25,5400,10725,61.41823686972482,58.17407554875716,NaN,NaN,105.26359537479007,110.01998468195772,0.02974917167347163,0.2775654777546883,0.2478163060812167,312500,295600,73.177088850955,65.05019239648834,NaN,NaN,18.61499844315813,15.07992790336255
1999-07-28T09:30:00-04:00,31.28125,31.35937,31.17187,31.1875,2600,10660,59.95857628474438,58.52923776346125,NaN,NaN,93.19675015725133,98.61060655587106,0.021956380866620107,0.2752617821644918,0.2533054012978717,309900,299580,74.37598913565803,65.85552981149428,NaN,NaN,18.833221828967485,15.61611274987754
1999-07-29T09:30:00-04:00,30.82812,31.01562,30.59375,30.67187,15900,10150,49.50536664017972,58.13774214641072,NaN,NaN,-9.05905924713849,74.10259773028945,-0.019294618192085444,0.2291871285577649,0.24848174674985035,294000,301200,74.86838475485065,66.70208748638093,NaN,NaN,15.779792406186525,15.63949555792168
1999-07-30T09:30:00-04:00,30.82812,30.9375,30.54687,30.73437,5100,8980,50.628929604134896,57.99920865808573,NaN,NaN,-15.355352339482282,52.182104081281956,-0.0424152461344825,0.19546268908174724,0.23787793521622974,299100,304520,75.89086844652697,67.72217514268421,NaN,NaN,13.630844679865048,15.35254543248502
1999-08-02T09:30:00-04:00,30.78125,31.3125,30.78125,31.20312,47200,10960,58.15020474690929,58.587825550734706,NaN,NaN,57.01164670621655,46.21151613032744,-0.026937488331475967,0.2042060748018848,0.23114356313336076,346300,312360,78.15145514393957,68.93960128930142,NaN,NaN,14.063197187939803,15.168352826121417
1999-08-03T09:30:00-04:00,31.32812,31.46875,31,31,58600,13320,54.29062627566401,58.658497948087685,NaN,NaN,63.37539437911632,37.833875931192686,-0.030894157562433883,0.19252586618031842,0.2234200237427523,287700,307400,73.45864675842545,69.82253620790547,NaN,NaN,13.189627192901648,14.88567773566145
1999-08-04T09:30:00-04:00,31.0625,31.15625,30.53125,30.53125,7700,13320,46.60325047741674,57.665754805900896,NaN,NaN,-31.49699413309784,12.89512707312286,-0.0637060060172428,0.14378751622119879,0.20749352223844159,280000,301420,68.14566666941974,70.26881219456625,NaN,NaN,9.793946628326939,14.158287577470805
1999-08-05T09:30:00-04:00,30.54687,30.8125,30.32812,30.8125,13100,13730,51.0791770044328,56.67411836681039,NaN,NaN,-53.11218023922088,4.084502874706383,-0.06487522373947835,0.12639949256409366,0.191274716303572,293100,301240,67.98627247477886,70.63752475840695,NaN,NaN,8.481182617489173,13.347272583187715
1999-08-06T09:30:00-04:00,30.75,30.90625,30.6875,30.6875,2600,12295,49.10888599275889,55.96535436236019,NaN,NaN,-36.12437562618485,-0.06930178263413041,-0.07192822338123298,0.1013644370770308,0.17329266045826378,290500,299520,66.38831029789102,70.8175061127043,NaN,NaN,6.793016585569905,12.410950297813743
1999-08-09T09:30:00-04:00,30.875,31,30.79687,30.8125,8700,12370,51.138609987883854,55.271358808791966,NaN,NaN,-15.919750985540764,-14.655581320985593,-0.06618097872151171,0.09056643705637413,0.15674741577788584,299200,290100,58.30550748314105,70.3146090948527,NaN,NaN,6.053107819650742,11.502687086647601
1999-08-10T09:30:00-04:00,30.85937,30.85937,30.23437,30.25,16100,13125,42.85541427153984,53.81777861933561,NaN,NaN,-139.93676635382124,-55.31801346757311,-0.09643587301460152,0.036202574509633934,0.13263844752423545,283100,289180,57.56832405608837,69.64610724457553,NaN,NaN,2.5640909109961663,10.225744775840253
1999-08-11T09:30:00-04:00,30.29687,30.45312,28.29687,30.09375,11700,13060,40.874856880801,52.29456062814715,NaN,NaN,-314.1575287309358,-111.85012038714069,-0.12152447618579384,-0.01926714770800686,0.10225732847778699,271400,287460,56.139239867478324,68.81839155167351,NaN,NaN,-0.8890150887354555,8.637921938043723
1999-08-12T09:30:00-04:00,30.03125,30.23437,29.9375,29.9375,23600,13880,38.936969374632156,50.94003568069683,NaN,NaN,-175.37139055223287,-136.3019624497431,-0.14178278327118787,-0.07497115061119786,0.06681163265999002,247800,278400,49.20963032369846,67.46175166542051,NaN,NaN,-4.32002907294011,6.786786079331747
1999-08-13T09:30:00-04:00,30.04687,30.45312,30.04687,30.32812,12000,14405,45.84889101485274,50.028428244691085,NaN,NaN,-108.55201793723731,-150.7874909119536,-0.12272846296095449,-0.0865989460412031,0.03612951691975139,259800,272260,45.14280401053567,65.62915630524195,NaN,NaN,-5.052365772646023,5.095478671906351
1999-08-16T09:30:00-04:00,30.23437,30.35937,30.09375,30.09375,2500,14240,42.72406899458794,48.693130539324166,NaN,NaN,-111.90110814815051,-169.98376234447556,-0.1196382870846329,-0.11341834193603972,0.006219945148593163,257300,263880,40.253274535563726,63.277455282714,NaN,NaN,-6.6662207561026365,3.4152358964764957
1999-08-17T09:30:00-04:00,30.51562,30.51562,30.26562,30.42187,30000,15485,48.06115392384344,47.843314656402676,NaN,NaN,-63.1294977358488,-154.62230862088106,-0.09054664221092087,-0.10696335761505793,-0.01641671540413706,287300,264720,40.943775306918326,60.889440009232594,NaN,NaN,-6.2891040802330656,2.028901614089415
1999-08-18T09:30:00-04:00,30.45312,30.45312,30.17187,30.23437,26600,16075,45.45462080087464,47.553975667880884,NaN,NaN,-74.23926786010846,-106.6386564467156,-0.07938210210211609,-0.11564434303178217,-0.03626224092966608,260700,262580,39.685428631136816,58.37637171468161,NaN,NaN,-6.80735098169322,0.7665798146918958
1999-08-19T09:30:00-04:00,29.92187,30,29.59375,29.89062,7400,16240,41.058238181231964,46.87035485195925,NaN,NaN,-135.2230881219513,-98.60899596065929,-0.08982976969872153,-0.148549453053068,-0.058719683354346464,253300,263680,40.69438372979726,55.86233709205806,NaN,NaN,-8.67367368677687,-0.5820278283750706
1999-08-20T09:30:00-04:00,29.98437,30.0625,29.8125,29.8125,12900,16715,40.10881146739001,45.58168390342216,NaN,NaN,-108.27235817318078,-98.55306400784798,-0.09611924013195003,-0.178868733519284,-0.08274949338733398,240400,259800,38.26300616454724,53.01316216495861,NaN,NaN,-10.459618084987211,-1.9931121507482334
1999-08-23T09:30:00-04:00,29.84375,30.01562,29.625,29.95312,8100,15890,42.67831731567589,44.75223326342301,NaN,NaN,-101.25591046920727,-96.42402447205932,-0.08529417773321366,-0.18936721555385105,-0.1040730378206374,248500,258040,37.1779092764638,50.42168091624706,NaN,NaN,-11.165398420742497,-3.303438760747414
1999-08-24T09:30:00-04:00,29.84375,29.9375,29.75,29.875,2300,15735,41.610278286040206,44.395592392610396,NaN,NaN,-94.1941777217553,-102.63696046924062,-0.07807459847668914,-0.20166628591649882,-0.12359168743980968,246200,249820,32.53692806253265,47.878199587183694,NaN,NaN,-12.053462753624897,-4.55344218830134
1999-08-25T09:30:00-04:00,30.14062,30.4375,30.07812,30.29687,38900,17550,49.028627223671386,44.249124551127444,NaN,NaN,-20.559199073577368,-91.9009467119344,-0.04140718694331694,-0.17535067111895586,-0.13394348417563892,285100,254700,37.52320374557461,45.702266106526245,NaN,NaN,-10.574248338728204,-5.413557352648035
1999-08-26T09:30:00-04:00,30.39062,30.45312,30.20312,30.3125,7700,17140,49.28570601791443,44.261754552924266,NaN,NaN,-7.805686805355806,-66.4174664486153,-0.014035523335163919,-0.1514878883445938,-0.1374523650094299,292800,262600,44.654732197600545,44.14986767079121,NaN,NaN,-9.311096578795173,-5.970348670669055
1999-08-27T09:30:00-04:00,30.0625,30.125,29.90625,29.90625,12800,17525,43.18854608051975,43.6938928452554,NaN,NaN,-66.02328053180274,-57.9676509203397,-0.020816528488470376,-0.16347302562001786,-0.1426564971315475,280000,270520,50.72705887912884,43.60854991336176,NaN,NaN,-10.025304156714318,-6.549628025818378
1999-08-30T09:30:00-04:00,29.82812,29.95312,29.48437,29.5,24700,16400,38.11112628345106,43.35501513182049,NaN,NaN,-119.75841198288204,-61.66815122307465,-0.048600848199919,-0.20340755738144622,-0.15480670918152722,255300,271880,51.70690545651804,43.18987715624961,NaN,NaN,-12.283019140721036,-7.368683899375901
1999-08-31T09:30:00-04:00,29.5,29.5,28.90625,29.26562,20100,14475,35.516824597928405,42.97229854018672,NaN,NaN,-179.09345201878713,-78.64800608248102,-0.07701402557957615,-0.2510742411559974,-0.17406021557642126,235200,269680,49.97559087356851,42.74961651382747,NaN,NaN,-14.993221315887729,-8.457903530306162
1999-09-01T09:30:00-04:00,29.0625,29.42187,28.9375,29.375,23800,15280,37.64990804295777,42.88036558792427,NaN,NaN,-153.45747891117128,-105.2276620499998,-0.08221840239728256,-0.27683321857302445,-0.1946148161757419,259000,264460,46.036782028405334,42.52298449273511,NaN,NaN,-16.545881238143377,-9.613328917140048
1999-09-02T09:30:00-04:00,29.03125,29.03125,28.8125,28.96875,152200,22235,33.25045076215736,41.98047699844603,NaN,NaN,-181.93602591712036,-140.0537298723527,-0.10532204024350009,-0.326267366480117,-0.22094532623661692,106800,227260,28.685625903856433,41.34747177082944,NaN,NaN,-19.32287704893084,-11.00040722168159
1999-09-03T09:30:00-04:00,29.375,29.5625,29.35937,29.51562,16800,22945,42.919777800486486,41.994456198867354,NaN,NaN,-80.86319819083819,-143.0217134041598,-0.07736751529116634,-0.31765472035057485,-0.2402872050594085,123600,195980,21.386489878623223,39.999844295333695,NaN,NaN,-18.526631517349294,-12.07558212106269
1999-09-07T09:30:00-04:00,29.64062,29.67187,29.3125,29.3125,20400,23530,40.569082344074644,41.45930822888386,NaN,NaN,-81.92193382945585,-135.45441777347457,-0.06656241891777304,-0.3234902287066248,-0.25692780978885177,103200,165560,16.886398690085358,38.281460251274204,NaN,NaN,-18.651782610656777,-13.015039333861845
1999-09-08T09:30:00-04:00,29.1875,29.23437,28.85937,28.89062,6200,23035,36.141505792352575,40.79408572827515,NaN,NaN,-141.66246514222516,-127.96822039816217,-0.08088171606433175,-0.3580299548692665,-0.2771482388049347,97000,137920,14.00321081374942,36.44701612146081,NaN,NaN,-20.244847363443796,-14.047869052373551
1999-09-09T09:30:00-04:00,28.78125,29,28.64062,29,56700,25285,38.02987509150358,40.577774079008826,NaN,NaN,-139.14517009546367,-125.10575863502065,-0.07610973723949904,-0.3722854103543085,-0.29617567311480947,153700,116860,12.282431187273403,34.41759093985196,NaN,NaN,-20.90392889142736,-15.027306172238381
1999-09-10T09:30:00-04:00,29.14062,29.1875,29,29.10937,11900,24700,39.9422894958197,40.5658796524681,NaN,NaN,-91.6700365984775,-107.0525607712921,-0.05944904020064751,-0.37048697336561887,-0.31103793316497136,165600,128620,18.31851021230989,32.99298408612072,NaN,NaN,-20.848998402672777,-15.858976490871866
1999-09-13T09:30:00-04:00,29.125,29.375,29.03125,29.375,7100,24455,44.427885440643195,40.69084880425147,NaN,NaN,-60.43134532937569,-102.96619019899958,-0.026102461641196173,-0.3436660102164666,-0.3175635485752704,172700,138440,23.078488685099813,31.985882615309013,NaN,NaN,-19.4166741791397,-16.367219017767273
1999-09-14T09:30:00-04:00,29.1875,29.51562,29.15625,29.39062,5500,24605,44.68949139278335,40.91079259759027,NaN,NaN,-40.83918355271746,-94.74964014365192,0.00005886010443850731,-0.3174899734447223,-0.3175488335491608,178200,153440,29.807291387651134,31.79090856710319,NaN,NaN,-18.191003350840354,-16.627759636777714
1999-09-15T09:30:00-04:00,29.75,29.8125,29.42187,29.42187,5400,23375,45.24484473383391,40.64052241974474,NaN,NaN,-3.1856422832632947,-67.05427557185953,0.021342518296677382,-0.2908706856783141,-0.31221320397499147,183600,170760,36.693491795664585,31.731643427823908,NaN,NaN,-17.029658742010675,-16.685173794668138
1999-09-16T09:30:00-04:00,28.90625,29.26562,28.90625,29.26562,3000,22195,42.92414943351935,40.186125520859385,NaN,NaN,-68.15953609241714,-52.857148771250216,0.026438771055518395,-0.27916474015559345,-0.30560351121111184,180600,176140,38.705044705740804,31.306665749833922,NaN,NaN,-16.664384001875877,-16.682203824269244
1999-09-17T09:30:00-04:00,29.17187,29.5625,29.17187,29.42187,10600,22355,45.91184192805997,40.38064665282654,NaN,NaN,-20.3940326344669,-38.60194797844811,0.041004678335856415,-0.2543476632912913,-0.29535234162714774,191200,181260,40.638181840187954,30.586031675623865,NaN,NaN,-15.522909661457678,-16.51659037243902
1999-09-20T09:30:00-04:00,29.4375,29.53125,27.89062,29.26562,11900,22305,43.46178729206931,40.762836724870695,NaN,NaN,-105.69375387280795,-47.65442968713456,0.040705934784580566,-0.24446992314642202,-0.2851758579310026,179300,182580,41.15346680064364,29.832214628775695,NaN,NaN,-15.206090094814984,-16.32937604706416
1999-09-21T09:30:00-04:00,29.1875,29.23437,28.875,28.875,10300,22415,38.00198993080478,40.940348534361874,NaN,NaN,-80.0474963102167,-55.496092238634404,0.016056253770512674,-0.26510554071786174,-0.2811617944883744,169000,180740,40.624104933786235,29.164251347362676,NaN,NaN,-16.519094079507486,-16.35647862312749
1999-09-22T09:30:00-04:00,29,29.59375,29,29.42187,14700,23035,47.87461272876779,41.6706845833483,NaN,NaN,-7.185223091992127,-56.296008400380174,0.037227880123476886,-0.2346269443340283,-0.2718548244575052,183700,180760,40.63304391171259,28.778270053313197,NaN,NaN,-14.561967527302173,-16.100119895152446
1999-09-23T09:30:00-04:00,29.32812,29.5,29.125,29.15625,17400,21960,44.193535752456064,42.452333511226776,NaN,NaN,-15.640132700634709,-45.792127722023686,0.034073499045538136,-0.22926295065058255,-0.2633364496961207,166300,177900,39.71233190694421,29.56589191067661,NaN,NaN,-14.097488873415346,-15.814029749190002
1999-09-24T09:30:00-04:00,28.875,28.875,28.53125,28.73437,28000,22975,39.05688460063005,42.17641256837989,NaN,NaN,-154.02147108161213,-72.51761541145274,0.005787597106630682,-0.25610195331283236,-0.26188955041946305,138300,167320,36.424272520542765,30.64001924224229,NaN,NaN,-15.40235154016587,-15.755218576472268
1999-09-27T09:30:00-04:00,28.96875,29.23437,28.96875,29.15625,12100,22940,45.836606404939964,42.55266428701314,NaN,NaN,-26.041493489631964,-56.58716333481753,0.01706613940868218,-0.24055687615861032,-0.2576230155672925,150400,161540,34.73236926150763,31.914731425915306,NaN,NaN,-14.208247289961706,-15.534222678399331
1999-09-28T09:30:00-04:00,28.98437,28.98437,28.79687,28.82812,900,21750,41.92955471483857,42.966096352904984,NaN,NaN,-99.41916137486626,-60.461496347747435,0.004648885822208015,-0.2518119082895325,-0.2564607941117405,149500,157640,33.598340878743315,33.31438357341487,NaN,NaN,-14.542471762591891,-15.392543976141125
1999-09-29T09:30:00-04:00,29.5625,29.75,29.20312,29.20312,9500,21220,47.44316328964981,43.638474081344,NaN,NaN,71.99273787540149,-44.62590415426871,0.022892017597150982,-0.22784577211530177,-0.25073778971245275,159000,152700,32.165724607934564,34.73461881774781,NaN,NaN,-12.939122839709782,-15.042055242365219
1999-09-30T09:30:00-04:00,29.375,29.78125,29.32812,29.78125,8500,20455,54.59992086809403,44.68544775079217,NaN,NaN,133.64715897938964,-14.768445818263837,0.07230725632586826,-0.16035371930511744,-0.2326609756309857,167500,152940,32.31671955812911,35.73449091387776,NaN,NaN,-8.991333676473122,-14.177666447237776
1999-10-01T09:30:00-04:00,29.59375,29.65625,29.26562,29.57812,13100,13500,51.92449679347472,45.22091999028014,NaN,NaN,85.79893255795406,33.1956349096494,0.08864714842256718,-0.12185204010277673,-0.2104991885253439,154400,156160,34.42571720709121,36.54500723687714,NaN,NaN,-6.780629246260108,-13.120946847098109
1999-10-04T09:30:00-04:00,29.78125,30.0625,29.73437,30.0625,18300,13575,57.29786964905119,46.12151843715641,NaN,NaN,196.0363656632174,77.61120674021927,0.12707272715071316,-0.05165827958695246,-0.17873100673766562,172700,160620,37.33818631279939,37.08292830295916,NaN,NaN,-3.0326850305908484,-11.679766587597072
1999-10-05T09:30:00-04:00,30.0625,30.17187,29.20312,29.26562,13300,13220,47.82703955812691,46.305960924605905,NaN,NaN,81.33080878250212,113.76120077169294,0.09527020966404373,-0.05964324465761095,-0.15491345432165468,159400,162600,38.641113841787465,37.22204416339651,NaN,NaN,-3.2325493016114453,-10.473021261027696
1999-10-06T09:30:00-04:00,29.54687,29.78125,29.45312,29.70312,23400,14080,52.47187239992453,46.987941136492,NaN,NaN,97.45701764687576,118.85405672598782,0.09967533031630474,-0.030319291426273765,-0.1299946217425785,182800,167360,41.77547953691881,37.44136093705208,NaN,NaN,-1.6980458518907509,-9.219453345436705
1999-10-07T09:30:00-04:00,29.64062,29.64062,29.21875,29.28125,8900,11690,48.03134432948243,47.13933416516503,NaN,NaN,22.266735560097665,96.5779720421294,0.07147360739680216,-0.04065261249657581,-0.11212621989337797,173900,168640,42.62424617930543,37.58322267556047,NaN,NaN,-2.058615296121725,-8.196476481248851
1999-10-08T09:30:00-04:00,29.34375,29.78125,29.34375,29.5,3200,11255,50.3763859263104,47.63323406761082,NaN,NaN,62.388956342749864,91.89597679908857,0.06503289652861627,-0.030835099232607632,-0.0958679957612239,177100,173180,45.65052080148026,37.904440818477376,NaN,NaN,-1.5413922096604908,-7.245750156736229
1999-10-11T09:30:00-04:00,29.39062,29.4375,29.29687,29.3125,10700,11435,48.36196199016792,48.37323207185104,NaN,NaN,6.0471072582078085,53.89812511808665,0.04649505008789778,-0.03774918315135167,-0.08424423323924946,166400,171920,44.9420335712901,38.2128642925848,NaN,NaN,-1.7890789942240586,-6.4662257049487755
1999-10-12T09:30:00-04:00,29.10937,29.10937,28.6875,28.73437,14200,11870,42.693162341278516,48.00312847274467,NaN,NaN,-118.70137429264948,13.89168850305632,-0.0036883276676837468,-0.08885464282385414,-0.08516631515617039,152200,170480,44.099672506193244,38.460480620761984,NaN,NaN,-3.9204566449232154,-6.10254441065941
1999-10-13T09:30:00-04:00,28.625,29.07812,28.54687,29,6600,11930,45.83471626534046,48.12035565223641,NaN,NaN,-97.22239797662965,-25.044194621644756,-0.01722061732193808,-0.10669208680859299,-0.08947146948665491,158800,165680,41.319546140737835,38.57528163746152,NaN,NaN,-4.622571794032419,-5.891119751141268
1999-10-14T09:30:00-04:00,28.90625,29.35937,28.84375,29.1875,11700,12365,48.00160612677341,48.75926433267522,NaN,NaN,-33.9068125677212,-36.27890424720853,-0.012018154822947172,-0.10449416301533887,-0.0924760081923917,170500,165000,40.925923546408335,38.89682813930907,NaN,NaN,-4.509399633326164,-5.693731162881967
1999-10-15T09:30:00-04:00,28.57812,28.79687,28.3125,28.5,12900,12480,41.45327312028911,48.446169098057304,NaN,NaN,-150.5887778775752,-78.87445109127354,-0.051158898342220344,-0.15642463112016713,-0.10526573277794679,157600,161100,38.651698502011556,39.17678022791649,NaN,NaN,-6.590951186645936,-5.821905451991105
1999-10-18T09:30:00-04:00,28.4375,28.71875,28.26562,28.71875,5900,12180,44.067821976197344,48.59890247386864,NaN,NaN,-132.34446576229595,-106.55276569537429,-0.058089922558327456,-0.1778781359758561,-0.11978821341752866,163500,160520,38.31073841600957,39.51338005200694,NaN,NaN,-7.433506128435528,-6.052134120054594
1999-10-19T09:30:00-04:00,28.95312,28.96875,28.3125,28.375,6500,11990,40.97143889289311,48.136636445528886,NaN,NaN,-121.82038320878058,-107.1765674786005,-0.08023422019232679,-0.22008098865793713,-0.13984676846561034,157000,161480,39.26572383663774,40.02052285405716,NaN,NaN,-9.12400862632246,-6.490973335235718
1999-10-20T09:30:00-04:00,28.40625,28.4375,28.07812,28.42187,16900,12100,41.574240493112626,47.20623070445878,NaN,NaN,-143.06419883647382,-116.34492765056936,-0.08564173634290123,-0.24689893889423686,-0.16125720255133563,173900,164500,42.292231936489,40.73305945251144,NaN,NaN,-10.28996915019632,-7.033687023087232
1999-10-21T09:30:00-04:00,28.1875,28.1875,27.76562,27.98437,6900,11575,37.70376189000273,46.19046392563935,NaN,NaN,-165.7284744121029,-142.7092600194457,-0.11099165815558726,-0.2999967752458197,-0.18900511709023243,167000,163800,41.77262430476886,41.25783853091699,NaN,NaN,-12.496136811309384,-7.814036992833254
1999-10-22T09:30:00-04:00,28.15625,28.32812,27.98437,28.32812,4400,10395,42.25281005885524,45.11581681205393,NaN,NaN,-118.93766621332917,-136.37903768659652,-0.09740168640071264,-0.31075722509112325,-0.2133555386904106,171400,166560,44.659661963622874,41.780801077404384,NaN,NaN,-12.979285141033731,-8.551929585433323
1999-10-25T09:30:00-04:00,28.125,28.26562,27.95312,28.01562,110200,15300,39.433662384732536,44.516289871097186,NaN,NaN,-119.38950889404023,-133.78804631294537,-0.10177569625924779,-0.34057515901447033,-0.23879946275522254,61200,146100,31.99510498567541,41.30608615911067,NaN,NaN,-14.248697705510313,-9.365753602587178
1999-10-26T09:30:00-04:00,28.54687,28.54687,28.1875,28.1875,8100,15660,41.73627297350053,43.749461340638334,NaN,NaN,-81.39557188949401,-125.70308404908806,-0.08603592154953382,-0.3463443646921398,-0.260308443142606,69300,128560,25.356552176784874,40.13330563338682,NaN,NaN,-14.614963185494624,-10.11564068585967
1999-10-27T09:30:00-04:00,28.46875,28.96875,28.46875,28.92187,54800,17925,50.41088070603643,43.91942822467791,NaN,NaN,-19.051284172175794,-100.90050111622844,-0.022421430350945182,-0.28833523108128745,-0.26591380073034226,124100,118600,22.50148991808571,38.695965900442545,NaN,NaN,-12.165683239876339,-10.408503907862052
1999-10-28T09:30:00-04:00,29.45312,30.10937,29.45312,30,19700,18485,59.859621466524935,44.59680219183609,NaN,NaN,112.49522820765137,-45.25576059227759,0.08985429199801193,-0.15359593573282737,-0.2434502277308393,143800,113960,21.298353850905357,36.95652540397291,NaN,NaN,-6.485032642493701,-9.84800801280943
1999-10-29T09:30:00-04:00,30.14062,30.375,29.9375,29.9375,27700,19215,59.155934627416414,45.36780023735383,NaN,NaN,129.5764673752361,4.447066125435461,0.1537471144274886,-0.051266334696478566,-0.20501344912396716,116100,102900,18.72787621066911,35.08408559249998,NaN,NaN,-2.3693815902408386,-8.779632809585346
1999-11-01T09:30:00-05:00,30,30.21875,29.96875,30.21875,25900,19595,61.357386285489376,46.70095909051175,NaN,NaN,132.27863161393117,54.78069422702974,0.20555200635402832,0.051926558818568225,-0.1536254475354601,142000,119060,31.69870290030474,34.19830204922223,NaN,NaN,1.6983374380596157,-7.282779917064637
1999-11-02T09:30:00-05:00,30.01562,30.39062,29.90625,29.9375,88300,23345,57.99128187639494,47.56928520558707,NaN,NaN,116.74077865364231,94.407964335657,0.2106987890863301,0.10974803882245254,-0.10095075026387756,53700,115940,30.680608752321078,33.4383779500496,NaN,NaN,3.994732057612897,-5.67170677782499
1999-11-03T09:30:00-05:00,29.79687,29.79687,29.5,29.59375,4400,22395,54.08576459194773,48.00386795309953,NaN,NaN,67.8522628848683,111.78867374706583,0.18186254088907158,0.12637742584746192,-0.05548511504160966,49300,100980,26.316149203825248,32.3948226398651,NaN,NaN,4.7039175591123055,-4.18947472969109
1999-11-04T09:30:00-05:00,29.78125,29.78125,29.3125,29.4375,10700,22485,52.35963088136896,48.78289350746238,NaN,NaN,53.36736469947104,99.96310104542977,0.1447893414941352,0.12550156182605932,-0.019287779668075863,38600,79940,21.651196658092942,31.180501079585195,NaN,NaN,4.7632116858651194,-2.9105195274687747
1999-11-05T09:30:00-05:00,29.84375,29.90625,29.57812,29.6875,76800,26165,54.84289123358096,49.55254131156121,NaN,NaN,74.32099931105523,88.91200743259358,0.13009274076638325,0.1433281462899032,0.013235405523519955,115400,79800,21.623728947517137,29.988571831835735,NaN,NaN,5.545543384905356,-1.7025105399867562
1999-11-08T09:30:00-05:00,29.6875,29.875,29.625,29.875,15400,26400,56.66724631980488,50.67367041348348,NaN,NaN,76.21350897396538,77.69898290460043,0.12590666701173386,0.17061873928818727,0.04471207227645342,130800,77560,21.161151432230568,28.695388088663794,NaN,NaN,6.726955225147221,-0.49830114496761646
1999-11-09T09:30:00-05:00,29.67187,29.67187,29.39062,29.4375,3900,25885,51.44466669214514,51.378700856271514,NaN,NaN,42.099560718550805,62.77073931758214,0.08835482219600153,0.15515560002145534,0.06680077782545381,126900,92200,31.478302406651267,27.92296455081824,NaN,NaN,6.212400632164935,0.4603705374798909
1999-11-10T09:30:00-05:00,29.34375,29.59375,29.34375,29.5625,23300,26720,52.78361057153482,52.45583290495237,NaN,NaN,38.5195847964767,56.90420369990382,0.06755454562360991,0.1512439598549662,0.08368941423135628,150200,112380,42.62415674114867,27.983788296273936,NaN,NaN,6.170148820437897,1.2760531493310348
1999-11-11T09:30:00-05:00,29.53125,29.60937,29.40625,29.46875,5700,26420,51.633594936534095,53.12588896764372,NaN,NaN,35.31704922400845,53.29414060481129,0.04423012792861854,0.13897707414212945,0.09474694621351092,144500,133560,51.53472510787984,28.474864235149436,NaN,NaN,5.814592536201369,1.9244159188839396
1999-11-12T09:30:00-05:00,29.71875,29.71875,29.39062,29.5625,3800,25965,52.7424144577755,54.07651411571822,NaN,NaN,37.45374615473431,45.920689973547105,0.03241133455349893,0.13526111440538457,0.10284977985188565,148300,140140,53.92855235123312,30.041539046974986,NaN,NaN,5.813245686680658,2.479963028569185
1999-11-15T09:30:00-05:00,29.45312,29.5,29.3125,29.42187,14800,26410,50.858873055021306,54.72812840725542,NaN,NaN,19.588526794307857,34.5956935376156,0.013392148246272176,0.11958996515972586,0.10619781691345369,133500,140680,54.128794192907506,32.09669919098375,NaN,NaN,5.309296145627605,2.884153473863245
1999-11-16T09:30:00-05:00,29.53125,29.53125,29.35937,29.35937,7300,26450,50.00418382611126,54.69907863011791,NaN,NaN,16.681127051026586,29.512006804110758,-0.004187537022800961,0.10096339563495249,0.10515093265775345,126200,140540,54.06318818914842,34.35110621034537,NaN,NaN,4.660018671801237,3.137848502140101
1999-11-17T09:30:00-05:00,29.42187,29.79687,29.42187,29.57812,13500,26280,52.982390100257035,54.20784781824163,NaN,NaN,33.5213432696511,28.512358498745634,-0.0019851525854247404,0.10266949192597252,0.10465464451139726,139700,138440,53.02500992311214,36.61729592978871,NaN,NaN,4.8619368439688335,3.3841468366870626
1999-11-18T09:30:00-05:00,29.60937,29.65625,29.35937,29.35937,10700,26470,49.78839724024577,53.53873800487229,NaN,NaN,8.146850297660018,23.07831871347595,-0.015414906085830266,0.08538601190410944,0.1008009179899397,129000,135340,51.45421910611734,38.95489185089216,NaN,NaN,4.190159006159993,3.4992914323260527
1999-11-19T09:30:00-05:00,29.125,29.375,29.125,29.375,13100,26905,50.02023926842391,52.72894178936762,NaN,NaN,-32.39313361126306,9.108942760276474,-0.022945853196023408,0.07211860149491045,0.09506445469093386,142100,134100,50.8058887998166,40.31969084371443,NaN,NaN,3.6846888371928213,3.525776775878448
1999-11-22T09:30:00-05:00,29.20312,29.28125,28.98437,29.04687,35300,23160,45.29217960989347,51.821863056046084,NaN,NaN,-95.41263025865045,-13.89128865031519,-0.04827041992094172,0.03472642978975671,0.08299684971069843,106800,128760,48.00091320625687,41.55685544756699,NaN,NaN,1.9465755825661706,3.3001766054052655
1999-11-23T09:30:00-05:00,28.875,28.9375,28.73437,28.75,32400,24375,41.472697144324435,50.92092966693013,NaN,NaN,-185.41679932476023,-54.31087392547256,-0.08131516884405317,-0.018647111344368028,0.06266805749968514,74400,118400,43.03663079862127,42.751175561480984,NaN,NaN,-0.6805665928405926,2.731499005655857
1999-11-24T09:30:00-05:00,28.70312,28.70312,28.54687,28.59375,18800,22575,39.58077196631312,50.00815403014043,NaN,NaN,-225.5660886772793,-106.12836031485863,-0.10830714445759192,-0.07271587307230476,0.03559127138528716,55600,101580,36.44624691794843,43.807964865756375,NaN,NaN,-3.4646585811879036,1.8463336361067484
1999-11-26T09:30:00-05:00,28.75,29.0625,28.75,28.92187,2500,21715,45.231092847241946,49.321597002544785,NaN,NaN,-134.05641375211795,-134.56901312481423,-0.09893217934474688,-0.08807395279564645,0.010858226549100434,58100,87400,31.997628437417816,44.54895768646357,NaN,NaN,-4.359507883633327,0.959784847572452
1999-11-29T09:30:00-05:00,28.65625,28.6875,28.5,28.59375,26100,21635,41.09256506645691,48.209119770162786,NaN,NaN,-173.88120679581314,-162.86662776172426,-0.10890878874699032,-0.12527775938463748,-0.01636897063764715,32000,65380,26.57332459863558,44.93554148406393,NaN,NaN,-6.373626662345981,-0.0878453681301814
1999-11-30T09:30:00-05:00,28.84375,29.3125,28.8125,28.95312,20700,21375,46.83061389850512,47.879544570617064,NaN,NaN,-69.70508425035126,-157.7251185600644,-0.08636936894502258,-0.12433068181892537,-0.037961312873902794,52700,54560,24.385777308718986,44.42893254849734,NaN,NaN,-6.409751318054563,-0.9909747895479502
1999-12-01T09:30:00-05:00,28.90625,29.17187,28.90625,29.09375,4800,17200,48.92716259570013,47.60408400091459,NaN,NaN,-54.04777169374836,-131.45131303386205,-0.05839370812958659,-0.11095344803588603,-0.05255973990629944,57500,51180,23.728636461547737,43.07925252852584,NaN,NaN,-5.816827967464371,-1.680382386393153
1999-12-02T09:30:00-05:00,29.0625,29.14062,28.92187,28.92187,17700,17865,46.513088806056814,47.23833356302335,NaN,NaN,-60.03491784624439,-98.34507886765506,-0.0482878141789292,-0.11291950762996095,-0.06463169345103174,39800,48020,23.101844270019654,41.04833246867868,NaN,NaN,-6.018762180200611,-2.300150928365647
1999-12-03T09:30:00-05:00,29.39062,29.84375,29.39062,29.48437,12900,17975,54.43630196936438,47.35932552813684,NaN,NaN,65.66831925543836,-58.40013226614376,-0.0029356379137441962,-0.06830124084321199,-0.06536560292946779,52700,46940,22.879402252771158,38.83053603307426,NaN,NaN,-3.688102696299679,-2.498429752356223
1999-12-06T09:30:00-05:00,29.64062,29.64062,29.20312,29.28125,9900,14630,51.471243082157116,47.403066244360836,NaN,NaN,27.628983181952545,-18.09809427059063,0.013277400392033012,-0.048768852439426524,-0.062046252831459536,42800,49100,24.44629976387273,36.71035785957178,NaN,NaN,-2.6710775601047607,-2.5230937248917282
1999-12-07T09:30:00-05:00,29.21875,29.6875,29.21875,29.5,109500,19335,54.354745991345716,47.71382068473472,NaN,NaN,55.14164703021024,6.871251985521684,0.03726917323852361,-0.015459786283305021,-0.052728959521828635,152300,69020,37.13213780524908,35.50099711786468,NaN,NaN,-0.9285789426739386,-2.295305898860615
1999-12-08T09:30:00-05:00,29.34375,29.5,29.21875,29.26562,10000,19640,50.86722789908535,47.562737670365316,NaN,NaN,24.219361408312256,22.524678605933808,0.035876175828578986,-0.0078837397361049,-0.043759915564683886,142300,85980,45.51950515392569,34.964889634351366,NaN,NaN,-0.5176153407525944,-2.0413501048451836
1999-12-09T09:30:00-05:00,29.42187,29.5625,29.1875,29.29687,8300,18890,51.315747738461866,47.671834134523614,NaN,NaN,31.873431026133378,40.90634838040936,0.03551563641083723,0.0006346299488626528,-0.034881006461974576,150600,108140,54.13043723893871,35.15604807241004,NaN,NaN,-0.0551920618264484,-1.7576132415567929
1999-12-10T09:30:00-05:00,29.29687,29.32812,29.07812,29.07812,8000,19005,48.01174353688312,47.52837015369927,NaN,NaN,-11.265797649567194,25.51952499940825,0.019785758458745407,-0.010148808388542818,-0.029934566847288225,142600,126120,59.69659457652015,35.791098485031725,NaN,NaN,-0.6164372509557375,-1.5945881000423565
1999-12-13T09:30:00-05:00,29,29.15625,28.8125,29.0625,13900,19510,47.77520053755142,47.70572879138912,NaN,NaN,-44.67578566458358,11.058571230101025,0.008165449367038571,-0.01972775513849001,-0.027893204505528582,128700,143300,64.17052730921444,36.94607092095726,NaN,NaN,-1.1416328345307547,-1.5298802049692706
1999-12-14T09:30:00-05:00,29.10937,29.29687,29,29.04687,10200,19280,47.522894213910156,48.13788572493096,NaN,NaN,-13.413341566914118,-2.6524264893238465,-0.0002891546617683413,-0.02825464783273901,-0.02796549317097067,118500,136540,61.28763265490763,38.249713910692,NaN,NaN,-1.6454079296433919,-1.546384165637002
1999-12-15T09:30:00-05:00,29.0625,29.29687,28.95312,29.17187,12900,19560,49.805935169871404,48.86825452518512,NaN,NaN,-2.455101379395293,-7.987319046865356,0.0026589853313537873,-0.024641761506778437,-0.027300746838132224,131400,134360,60.34609686884882,39.95684605004203,NaN,NaN,-1.4816491358219175,-1.5371363042348472
1999-12-16T09:30:00-05:00,28.84375,28.90625,28.71875,28.875,11200,19445,44.81886308101982,48.83880954188354,NaN,NaN,-85.85194844391981,-31.532394940875996,-0.014329220200637045,-0.04521227208892853,-0.030883051888291484,120200,128280,57.684426127567704,41.791617313624165,NaN,NaN,-2.7153036842563827,-1.7054459299522093
1999-12-17T09:30:00-05:00,28.9375,29.0625,28.6875,29.0625,474100,42615,48.33738738355541,49.35629685024772,NaN,NaN,-47.618508215923164,-38.802937054147186,-0.011978570056201003,-0.04585626445854274,-0.033877694402341736,594300,218620,75.19275914715206,45.2644340670896,NaN,NaN,-2.8098610058616544,-1.8632195122249873
1999-12-20T09:30:00-05:00,28.9375,28.9375,28.39062,28.39062,186800,51300,38.792112029752744,48.78211814533684,NaN,NaN,-145.17354293453357,-58.90248850813718,-0.0524462471419643,-0.09943550332979711,-0.04698925618783281,407500,274380,80.54371961079264,49.27571566009486,NaN,NaN,-5.97379163266804,-2.450444100859709
1999-12-21T09:30:00-05:00,28.625,29.09375,28.46875,28.76562,277500,63410,45.28631009627141,48.5220572525205,NaN,NaN,-75.02290764911262,-71.2244017245769,-0.05070126820080734,-0.11036584143884198,-0.059664573238034646,685000,387680,86.7824485487689,53.77955938061066,NaN,NaN,-6.572367781412064,-3.0392903409386167
1999-12-22T09:30:00-05:00,28.90625,28.98437,28.625,28.6875,84600,66020,44.23341700526396,48.35922355246387,NaN,NaN,-76.8300449165054,-86.0993904319989,-0.051391190319580365,-0.12390356113751011,-0.07251237081792974,600400,481480,89.72106040308073,58.53807481868645,NaN,NaN,-7.379245576188651,-3.659283945974336
1999-12-23T09:30:00-05:00,28.73437,28.95312,28.60937,28.82812,297500,79955,46.63841968717425,47.80223196087886,NaN,NaN,-73.01200310617907,-83.53140136445076,-0.03949448769175426,-0.12188048043262256,-0.0823859927408683,897900,637020,92.64225210991316,63.52113552276803,NaN,NaN,-7.312239190935749,-4.181134695254538
1999-12-27T09:30:00-05:00,28.875,28.875,27.82812,28.0625,912300,125445,37.22535162864491,46.784668285627994,NaN,NaN,-197.7720612444648,-113.5621119701591,-0.07807648105807578,-0.17998159406346304,-0.10190511300538725,-14400,515280,74.73890067401696,67.1134641592069,NaN,NaN,-10.502546719249107,-5.08419355582519
1999-12-28T09:30:00-05:00,28.09375,28.375,28.09375,28.3125,99200,129100,41.385455631577116,45.858290402787375,NaN,NaN,-178.72614625822342,-120.27263263489706,-0.0812825634726177,-0.20350831734615937,-0.12222575387354168,84800,450740,67.31214695270393,69.26917909831081,NaN,NaN,-11.687093869646702,-6.027465029228264
1999-12-29T09:30:00-05:00,28.3125,28.3125,27.89062,27.89062,27900,129460,36.93694635865702,44.86327029275679,NaN,NaN,-187.48367013658262,-142.76478513239107,-0.10484019467178735,-0.25327599721327587,-0.14843580254148853,56900,325120,55.708637395893895,69.9969742584514,NaN,NaN,-14.224171372270474,-7.198423078234294
1999-12-30T09:30:00-05:00,27.89062,28.0625,27.89062,27.89062,6800,129560,36.93694635865702,43.836213051342156,NaN,NaN,-167.77467810204675,-160.95371176949934,-0.11275650439749535,-0.2893814330383577,-0.17662492864086238,56900,216420,47.99824136843574,69.55896026770118,NaN,NaN,-16.176686314505062,-8.481032111987261
1999-12-31T09:30:00-05:00,28.10937,28.17187,28,28.14062,38100,130580,41.27514236268121,43.35502725318488,NaN,NaN,-120.924426187422,-170.53619638574793,-0.09424273997325366,-0.29442835360742947,-0.2001856136341758,95000,55840,39.33664309021329,68.10467801867927,NaN,NaN,-16.443167154972567,-9.618479975270876
2000-01-03T09:30:00-05:00,27.9375,28.9375,27.21875,27.45312,176700,138770,34.28941507247599,42.391756862822355,NaN,NaN,-139.07801001117818,-158.7973861390906,-0.11974790079242434,-0.34987048962470624,-0.2301225888322819,-81700,42380,38.706134792410666,66.28579283890757,NaN,NaN,-19.089509341474802,-10.971484170442865
2000-01-04T09:30:00-05:00,27.46875,27.46875,26.625,26.625,93500,142950,28.116508648709896,41.00558646530805,NaN,NaN,-225.33986394558121,-168.12012967656216,-0.18020735868807547,-0.4553817871923762,-0.27517442850430074,-175200,-9620,36.2863342226119,64.49998580802931,NaN,NaN,-23.788726517262212,-12.802518791417057
2000-01-05T09:30:00-05:00,27.21875,27.42187,26.85937,27.29687,273400,151145,37.88646304236947,40.15419559905791,NaN,NaN,-158.47537981289548,-162.31847161182472,-0.16326952155408458,-0.47926133044690644,-0.31599180889282186,98200,-1360,36.96051108036817,62.82958682313784,NaN,NaN,-23.95709511484469,-14.396029694763861
2000-01-06T09:30:00-05:00,27.25,27.25,26.9375,27.25,34500,152370,37.503523832188506,39.63167136699853,NaN,NaN,-141.15811299028053,-156.9951585894715,-0.14420465216795975,-0.49624762410277157,-0.3520429719348118,63700,0,37.0785658138347,61.35773965787119,NaN,NaN,-24.21591812195054,-15.798870898647673
2000-01-07T09:30:00-05:00,27.29687,27.48437,27.17187,27.48437,46500,154280,40.72960539316206,39.088258367684716,NaN,NaN,-103.19348115384378,-153.44896958275586,-0.10652926078611163,-0.4852045479174514,-0.37867528713133974,110200,3040,37.360946679718054,58.65546733876876,NaN,NaN,-23.328668145584075,-16.87455621963859
2000-01-10T09:30:00-05:00,27.46875,27.65625,27.42187,27.57812,15500,154655,42.01892333928118,39.3187448897939,NaN,NaN,-76.08860680523263,-140.85108894156673,-0.06789539918698939,-0.4635445361150765,-0.3956491369280871,125700,44520,41.236168817467394,55.847785139245524,NaN,NaN,-22.217381884426025,-17.637817028893938
2000-01-11T09:30:00-05:00,27.45312,27.45312,27.07812,27.28125,25700,155245,39.11711487040659,38.878088087946416,NaN,NaN,-96.45639147327357,-115.07439444710522,-0.055459746380670194,-0.46497381990392483,-0.40951407352325464,100000,99560,46.00921281168149,52.935411158025,NaN,NaN,-22.19734802733632,-18.289178600099994
2000-01-12T09:30:00-05:00,26.85937,27.21875,26.85937,27,36700,156570,36.54238531498189,38.328728681497694,NaN,NaN,-111.35927564608151,-105.65117361374243,-0.05897328488190123,-0.48323067962563115,-0.4242573947437299,63300,92580,45.50443444183935,49.77708073222204,NaN,NaN,-22.98248618531534,-18.959651112273615
2000-01-13T09:30:00-05:00,27.25,27.25,26.73437,26.75,139600,162905,34.37639131970748,37.45286951239292,NaN,NaN,-111.22036861757012,-99.66362473920037,-0.07017056797382121,-0.5119706047110064,-0.4418000367371852,-76300,64580,43.44529400800272,46.2630122963713,NaN,NaN,-24.304654136775454,-19.723222972916734
2000-01-14T09:30:00-05:00,26.78125,26.96875,26.65625,26.96875,45700,164630,37.84782916829367,37.49733219379641,NaN,NaN,-103.54306402848273,-99.73354131412817,-0.05552243040101479,-0.5112030747384537,-0.45568064433743893,-30600,36420,41.41548890243452,43.88276859840113,NaN,NaN,-24.355651582948376,-20.38499848863554
2000-01-18T09:30:00-05:00,26.9375,27.28125,26.85937,26.85937,46000,143225,36.799574926990026,37.1697692863259,NaN,NaN,-80.40658096326406,-100.59713614573447,-0.046256706619600574,-0.5135015276119397,-0.4672448209923391,-76600,-4040,38.62333542242524,41.833567774809794,NaN,NaN,-24.702230833119245,-21.001745966418927
2000-01-19T09:30:00-05:00,26.78125,27.04687,26.78125,26.875,26000,135185,37.06780303673582,37.179116191902956,NaN,NaN,-83.31874266294807,-97.96960638366936,-0.03276702553445354,-0.508203602910406,-0.47543657737595246,-50600,-34160,36.64281598678887,40.47172338844514,NaN,NaN,-24.910422740585055,-21.560128362728374
2000-01-20T09:30:00-05:00,26.92187,27.15625,26.85937,27,112500,126935,39.28702884788312,37.34697922684768,NaN,NaN,-66.49162450492727,-88.99607615543852,-0.010282580645081751,-0.48828980318230464,-0.4780072225372229,61900,-34440,36.62401489662775,39.65927864045886,NaN,NaN,-24.482145830329518,-21.977559429528537
2000-01-21T09:30:00-05:00,27.5625,27.90625,27.375,27.875,201100,132760,52.03719626945279,38.11569736304565,NaN,NaN,28.38173086854422,-61.075656258215645,0.06454762012885218,-0.39732269737615766,-0.46187031750500984,263000,33420,44.10878170282664,40.00014568421695,NaN,NaN,-19.98319139733251,-21.69264971064339
2000-01-24T09:30:00-05:00,27.9375,27.9375,27.5,27.5,64300,121100,47.43909343489763,39.054960103218626,NaN,NaN,30.16150439455951,-34.334742573607194,0.08834520695480685,-0.35143880881150125,-0.4397840157663081,198700,79280,48.532537889896695,40.702031619751665,NaN,NaN,-17.609923122727594,-21.10940305522685
2000-01-25T09:30:00-05:00,27.15625,27.46875,26.625,26.85937,56900,78330,40.80556133101255,39.96132100909739,NaN,NaN,-66.21997503104734,-31.497421387163786,0.06175578856219871,-0.3625892800635597,-0.42434506862575844,141800,122960,52.39721513464573,41.85280882775408,NaN,NaN,-17.74201534767168,-20.628347668433253
2000-01-26T09:30:00-05:00,26.79687,26.95312,26.65625,26.73437,31400,74940,39.6407964963015,40.08663054152111,NaN,NaN,-94.24740693859667,-33.683154242293504,0.037744180766427105,-0.37716484266772454,-0.41490902343415165,110400,155160,55.075295649273656,43.146722011247334,NaN,NaN,-18.221751846549715,-20.284548265307034
2000-01-27T09:30:00-05:00,26.8125,26.9375,26.5625,26.5625,18700,74480,38.033272955448375,40.1244697646111,NaN,NaN,-105.21114769247178,-41.4270588798024,0.013529862344253352,-0.397996695503835,-0.41152655784808834,91700,161120,55.573501048989,44.46778881375836,NaN,NaN,-19.112782710146885,-20.11715318599844
2000-01-28T09:30:00-05:00,26.53125,26.625,26.23437,26.42187,28400,75560,36.72109372128373,39.838147502334074,NaN,NaN,-146.0967420025486,-76.32275345402097,-0.007579330062864376,-0.4210007204266688,-0.41342139036380443,63300,121180,51.455367986518404,45.47453319281552,NaN,NaN,-20.237970596346972,-20.13441281604823
2000-01-31T09:30:00-05:00,26.26562,27.64062,26.23437,27.64062,414800,94395,52.13382267398653,40.560640311955886,NaN,NaN,11.639644530978758,-80.02712542673711,0.06113401977404431,-0.33700386564624907,-0.3981378854202934,478100,177060,56.33108043708482,46.55274116564534,NaN,NaN,-15.867941930647772,-19.524916975276735
2000-02-01T09:30:00-05:00,27.59375,27.59375,27.3125,27.4375,23200,86720,49.950185761534094,41.33443108989356,NaN,NaN,88.37642957206356,-49.10784450611495,0.0916645731461867,-0.28355716898756,-0.3752217421337467,454900,239680,61.05196879359908,47.62722373578231,NaN,NaN,-13.17767360419465,-18.61816792226501
2000-02-02T09:30:00-05:00,27.5,27.54687,27.29687,27.29687,14500,82770,48.4374870646188,42.184081214867625,NaN,NaN,64.05425904682798,-17.447511309030023,0.10044147106872037,-0.24966990329784622,-0.3501113743665666,440400,305680,65.30879765797323,49.0418211083633,NaN,NaN,-11.533825422761579,-17.606118993764518
2000-02-03T09:30:00-05:00,27.32812,27.60937,27.1875,27.25,96100,73905,47.916648160856944,43.15124241780688,NaN,NaN,52.711852778347165,14.137088785133766,0.1008781174313017,-0.22401372757743943,-0.32489184500874113,344300,356200,68.17600723257732,50.808300624404346,NaN,NaN,-10.38688072289766,-16.574799240783538
2000-02-04T09:30:00-05:00,27.5,27.5,27.10937,27.10937,19300,73145,46.307697571407054,43.755518732314975,NaN,NaN,24.50866406036197,48.25816999771588,0.08985090017506386,-0.21257821978991132,-0.3024291199649752,325000,408540,70.86284979167746,52.911683545064555,NaN,NaN,-9.91231986277349,-15.623016472496388
2000-02-07T09:30:00-05:00,26.98437,27.125,26.90625,27.03125,23000,71970,45.39581063677034,44.36953556872786,NaN,NaN,-24.281674878204893,41.073906115879154,0.0760008740334529,-0.20742802742315902,-0.2834289014566119,302000,373320,66.77724489505721,54.92267707882399,NaN,NaN,-9.778734021372763,-14.788118979478728
2000-02-08T09:30:00-05:00,27.35937,27.5,27.09375,27.09375,32600,72825,46.30679227060387,45.02946337114701,NaN,NaN,33.278836044038755,30.054387410274195,0.069908425746532,-0.1960433692734469,-0.2659517950199789,334600,349260,64.0600788715098,56.88105299916119,NaN,NaN,-9.420154618952575,-14.021266927974992
2000-02-09T09:30:00-05:00,27.15625,27.25,26.96875,27.09375,16300,72355,46.30679227060387,45.53087504419848,NaN,NaN,2.568949771687944,17.75732555524619,0.06484971374426812,-0.18488965283964376,-0.24973936658391188,334600,328100,61.68292464304392,58.670975123905215,NaN,NaN,-9.122400069311231,-13.32142880530874
2000-02-10T09:30:00-05:00,26.78125,27.04687,26.6875,26.70312,83200,74680,41.31100065246254,44.76471821441346,NaN,NaN,-71.58830232599428,-7.102705465622103,0.03562721402824304,-0.2052053490486081,-0.24083256307685114,251400,309520,59.59184091774456,59.77690792497077,NaN,NaN,-10.226049344355328,-12.879231739458252
2000-02-11T09:30:00-05:00,26.71875,26.71875,26.10937,26.23437,92500,72325,36.2562179926144,43.96594139710753,NaN,NaN,-168.3529602491853,-45.67503032753156,-0.01227542549825028,-0.256176844949664,-0.2439014194514137,158900,276300,55.94034983368976,60.30603734952742,NaN,NaN,-12.73745913687472,-12.858978510517748
2000-02-14T09:30:00-05:00,26.23437,26.42187,26.125,26.26562,11600,70620,36.81131579575421,43.68063814458907,NaN,NaN,-165.32799311412873,-73.88429397471631,-0.037438469157553944,-0.29069950589835614,-0.2532610367408022,170500,250000,53.162980916574625,60.360734905379495,NaN,NaN,-14.636932779894124,-13.112971977571515
2000-02-15T09:30:00-05:00,26.21875,26.3125,26.09375,26.20312,26100,69625,36.13358470513256,43.43012301664844,NaN,NaN,-151.0426020870038,-110.74858160092484,-0.05292726247657842,-0.3194201148365252,-0.2664928523599468,144400,211960,49.346735763098025,59.95155205636695,NaN,NaN,-16.41137686187016,-13.584172675328464
2000-02-16T09:30:00-05:00,26.14062,26.26562,25.95312,26.09375,154000,76025,34.92193455584999,43.207884559534264,NaN,NaN,-142.7941249315958,-139.8211965415816,-0.06441097692975484,-0.34700657352214037,-0.28259559659238553,-9600,143120,43.29047789942167,59.07419325996928,NaN,NaN,-18.255506713917384,-14.251506109412595
2000-02-17T09:30:00-05:00,26.07812,26.07812,25.875,25.9375,10700,70935,33.20867097180586,42.95699722028586,NaN,NaN,-139.5455565894227,-153.41264739426725,-0.07562735668785858,-0.3771297924522088,-0.3015024357643502,-20300,88780,39.20067030100449,58.198857711004,NaN,NaN,-20.32257459200594,-15.11880160692593
2000-02-18T09:30:00-05:00,25.6875,25.6875,24.96875,24.98437,14900,61625,25.114572601902935,41.027050786565596,NaN,NaN,-210.31314259042298,-161.8046838625148,-0.1367708449764094,-0.47246599198486194,-0.33569514700845254,-35200,49960,36.54451604772451,56.78553168319256,NaN,NaN,-25.133239427424925,-16.54943558128293
2000-02-22T09:30:00-05:00,25.0625,25.07812,24.76562,24.89062,32000,60010,24.4824863782505,39.20792940204534,NaN,NaN,-204.39099400031316,-169.6172840397517,-0.17084708259888426,-0.5492540002570578,-0.3784069176581736,-67200,2420,33.54674464691871,54.82087281557252,NaN,NaN,-29.194932179157846,-18.35593509526506
2000-02-23T09:30:00-05:00,24.9375,24.9375,24.26562,24.375,51900,59760,21.306327026768372,37.26998939934174,NaN,NaN,-199.93157582280972,-179.39507878691288,-0.2127051219738646,-0.6442883201255043,-0.4315831981516397,-119100,-50280,30.554559610273344,52.33842724073683,NaN,NaN,-33.87283041299942,-20.57263442636997
2000-02-24T09:30:00-05:00,24.54687,24.54687,23.375,23.5625,103700,63375,17.462009290985478,35.094658051493774,NaN,NaN,-214.25176866009664,-193.68660753261304,-0.27570776637298533,-0.7762179061178713,-0.500510139744886,-222800,-92920,28.351127551354026,49.4937929777923,NaN,NaN,-39.566211215046295,-23.286002539038016
2000-02-25T09:30:00-05:00,23.64062,23.9375,23.4375,23.4375,7400,62810,16.955154263260724,32.99804781519761,NaN,NaN,-186.45097322189005,-203.0676908591065,-0.30415769919167424,-0.8807072637344788,-0.5765495645428046,-230200,-134900,26.337375255184355,46.31340193947136,NaN,NaN,-44.15766905288317,-26.26766918387304
2000-02-28T09:30:00-05:00,23.51562,24.32812,23.375,24.10937,195500,71165,28.90090707707914,31.819840418076815,NaN,NaN,-134.96458009755932,-187.99797836053378,-0.25791165061175214,-0.8989391278074947,-0.6410274771957426,-34700,-134800,26.350795054608582,43.425798379439314,NaN,NaN,-43.943659643621814,-28.792810678122862
2000-02-29T09:30:00-05:00,24.14062,24.3125,24.03125,24.28125,9100,50880,31.611166218073947,30.770152842896106,NaN,NaN,-101.72392034204395,-167.46456362887994,-0.19859226318763712,-0.889267806180289,-0.6906755429926519,-25600,-126480,27.533681468062994,40.816769993478836,NaN,NaN,-42.8573118332652,-30.80202512885748
2000-03-01T09:30:00-05:00,25.15625,25.42187,25.14062,25.34375,46100,52025,45.453312051478925,30.70918997010147,NaN,NaN,-31.611965592957286,-133.80064158290946,-0.07689846086987484,-0.7867986190799954,-0.7099001582101205,20500,-98560,31.509115285694392,38.6614978965253,NaN,NaN,-36.60597499986268,-31.631160824715366
2000-03-02T09:30:00-05:00,25.59375,26.125,25.59375,26,105600,56580,51.92559114350148,31.467375005175676,NaN,NaN,9.635846985268174,-89.02311845383649,0.05176036732438738,-0.6451996990546363,-0.6969600663790236,126100,-28780,40.321022884154324,37.28501089412599,NaN,NaN,-28.989305944897044,-31.25375298474132
2000-03-03T09:30:00-05:00,26.51562,26.60937,26.23437,26.23437,45600,54055,54.02375654613766,32.73648490185591,NaN,NaN,43.16070348996926,-43.10078311146462,0.15099886207191537,-0.5082114887891294,-0.6592103508610447,171700,51600,48.53495705546053,36.75605426710962,NaN,NaN,-22.3887438649101,-29.987323110479714
2000-03-06T09:30:00-05:00,25.90625,25.90625,25.5,25.5,79200,57050,47.088838440007315,33.4705936621597,NaN,NaN,0.7520421475996738,-15.957458662432817,0.16442813530578326,-0.4536751817288156,-0.6181033170345989,92500,77040,50.841097812937406,36.59020547399267,NaN,NaN,-19.333817227007618,-28.46539369855513
2000-03-07T09:30:00-05:00,25.90625,26.04687,25.04687,25.20312,81900,59995,44.59649448256095,34.0750872176903,NaN,NaN,-8.424285697799432,2.7024682664160826,0.1509146909648591,-0.42945995332852505,-0.5803746442933841,10600,84280,51.507072946371736,36.744515272797926,NaN,NaN,-17.812840233435253,-26.943600346395147
2000-03-08T09:30:00-05:00,24.92187,25.92187,24.92187,25.375,24900,59610,46.36642348248109,34.89255071244967,NaN,NaN,-3.9091523788432347,8.243030909238898,0.15079367328104798,-0.39188255269207417,-0.5426762259731222,35500,87280,51.798469251188294,37.352228940781266,NaN,NaN,-16.03524351282786,-25.385263655885534
2000-03-09T09:30:00-05:00,25.14062,25.67187,25.14062,25.57812,156700,66630,48.46178980406877,35.98205920046845,NaN,NaN,8.183895461596306,7.952640604504531,0.16072308765228416,-0.341772366407767,-0.5024954540600511,192200,100500,53.13491081152291,38.34753183438972,NaN,NaN,-13.939172863285055,-23.75010782837118
2000-03-10T09:30:00-05:00,25.54687,25.85937,25.375,25.57812,22600,63600,48.46178980406878,37.64971757205173,NaN,NaN,28.002138568952425,4.920927620301147,0.16310243751513953,-0.2986174071661267,-0.46171984468126626,192200,104600,53.564914790291596,39.563274601715946,NaN,NaN,-12.283357223722536,-22.112000599135662
2000-03-13T09:30:00-05:00,25.15625,25.75,25.15625,25.65625,186200,68285,49.344632192526944,39.42558513021434,NaN,NaN,25.098969155497336,9.79031302188068,0.16523915438844233,-0.2551709016957133,-0.42041005608415566,378400,161780,59.18892429527536,41.39485886231285,NaN,NaN,-10.675752191099024,-20.478250826558998
2000-03-14T09:30:00-05:00,25.42187,25.625,25.25,25.48437,170000,76205,47.42017097181953,41.290859697717984,NaN,NaN,23.4205600410476,16.159282169650087,0.15078011578687067,-0.23193491135056732,-0.382715027137438,208400,201340,62.566870658294626,43.68145250860009,NaN,NaN,-9.851931916026293,-18.96020526791147
2000-03-15T09:30:00-05:00,25.25,25.95312,25.21875,25.625,213500,85575,49.16700740388839,43.5555024200682,NaN,NaN,43.16312988569822,25.573738622558377,0.14627714559888272,-0.1998685951388346,-0.3461457407377173,421900,278620,68.11837485222674,46.521970172948144,NaN,NaN,-8.678011975662232,-17.491320511875863
2000-03-16T09:30:00-05:00,26.09375,27.09375,26.04687,26.84375,53000,80525,61.19814925930363,46.71571634835698,NaN,NaN,150.41444714117486,54.019848958474086,0.21672020386094387,-0.07524548591153746,-0.29196568977248133,474900,335160,71.45397203531853,49.74458422867201,NaN,NaN,-3.5229567969485136,-15.495839981171956
2000-03-17T09:30:00-05:00,26.65625,27.09375,26.5625,26.64062,62800,83130,58.70427241661452,48.84452815832379,NaN,NaN,150.4871369492305,78.5168486345297,0.23921023028226443,0.007047098080349201,-0.23216313220191523,412100,379140,73.75423013130396,53.130543877007405,NaN,NaN,-0.13788261560634976,-13.301846071805441
2000-03-20T09:30:00-05:00,26.75,26.8125,26.375,26.53125,61300,85450,57.349168298921164,50.6829568783843,NaN,NaN,117.46123175358358,96.98930115414694,0.23590359665988114,0.0627163636229362,-0.17318723303694494,350800,373620,72.95956953274631,56.37525016734192,NaN,NaN,2.1876053781414013,-11.089067293241607
2000-03-21T09:30:00-05:00,26.3125,26.59375,26.20312,26.35937,89700,88335,55.19292299675755,51.37864337447564,NaN,NaN,92.40157817663376,110.78550478126417,0.21207454130447453,0.09190594359364823,-0.1201685977108263,261100,384160,73.54567747509782,59.3778617522993,NaN,NaN,3.4857669390646557,-9.006948117197854
2000-03-22T09:30:00-05:00,26.125,26.3125,25.65625,25.75,48500,88165,48.26443210046843,51.117132014258985,NaN,NaN,42.88820350906449,110.73051950593745,0.1482286375280723,0.06511719919926406,-0.08311143832880823,212600,342300,67.30601391986222,61.30536111199273,NaN,NaN,2.502034592080721,-7.362807730158059
2000-03-23T09:30:00-05:00,25.9375,26.28125,25.70312,26.1875,7100,83335,52.84159178994564,51.03269167453099,NaN,NaN,52.25681333263836,91.09899274423015,0.1291188108651864,0.07828707525267475,-0.05083173561251163,219700,291260,60.55945799427162,62.164254036193526,NaN,NaN,3.08700805104093,-5.869976904272489
2000-03-24T09:30:00-05:00,26.39062,26.39062,25.875,25.9375,24300,84180,50.11320667188152,51.24871797680772,NaN,NaN,44.94939093086905,69.99144354055785,0.09488152758372034,0.0677701738671388,-0.027111353716581542,195400,247920,55.474529973777656,62.49521347625354,NaN,NaN,2.727368518800051,-4.641784700976412
2000-03-27T09:30:00-05:00,26.09375,26.34375,26.09375,26.29687,33000,76055,53.80558148058017,51.90650990523766,NaN,NaN,59.798437173198664,58.45888462448088,0.0916297381319542,0.08742581894836121,-0.0042039191835929884,228400,223440,52.77884048755115,62.586054014909216,NaN,NaN,3.554550729988261,-3.4708796394100307
2000-03-28T09:30:00-05:00,26.34375,26.35937,26.07812,26.17187,17600,76480,52.3540601091929,52.334198235717075,NaN,NaN,46.29160132622815,49.23688925439974,0.07684931556891092,0.09185772527754565,0.015008409708634741,210800,213380,51.6677059088624,62.576713776171644,NaN,NaN,3.7984400691246827,-2.4324053953336433
2000-03-29T09:30:00-05:00,26.5,26.79687,26.375,26.64062,12900,74820,57.034939820706356,52.94656609404833,NaN,NaN,102.01942710444159,61.06313397347517,0.0933343660492342,0.1316763672701775,0.0383420012209433,223700,215600,51.90831745675425,62.48909996511674,NaN,NaN,5.4368743892551645,-1.3082225689638136
2000-03-30T09:30:00-05:00,26.625,26.85937,26.54687,26.57812,33600,71220,56.24155781928049,53.5022638094206,NaN,NaN,98.9950104356833,70.41077339408416,0.09443597393088238,0.15638696863454626,0.06195099470366389,190100,209680,51.17666563268906,62.31851073957371,NaN,NaN,6.5342025006884965,-0.1878761304420551
2000-03-31T09:30:00-05:00,26.78125,26.8125,26.34375,26.73437,59400,71910,57.821205420223464,54.10773332568464,NaN,NaN,89.40777652012017,79.30245051193438,0.09958266518610581,0.18642932618629615,0.08684666100019034,249500,220500,52.49462049587096,61.8403461824734,NaN,NaN,7.9020650427604355,0.9678297514440148
2000-04-03T09:30:00-04:00,26.64062,26.96875,26.42187,26.90625,80900,71995,59.55100618551773,54.97422155523451,NaN,NaN,98.74409097474984,87.09158127224461,0.10776543932150044,0.2215534601520659,0.11378802083056545,330400,240900,54.96309813913213,61.29721957396178,NaN,NaN,9.54538071524303,2.193194174843874
2000-04-04T09:30:00-04:00,27.54687,28.0625,27.03125,27.28125,64500,71125,63.10607034058893,55.969868907855975,NaN,NaN,176.91299200320037,113.21585940763907,0.13013924148564215,0.27646207268761813,0.14632283120197598,394900,277720,59.094577514097836,60.65266262123829,NaN,NaN,12.026940334062365,3.5980150547322296
2000-04-05T09:30:00-04:00,27.9375,28.14062,27.64062,27.64062,10700,70415,66.17426038446362,56.32530541679598,NaN,NaN,194.34475806012082,131.6809255987749,0.15894074967062455,0.34499876829025666,0.18605801861963212,405600,314100,62.73232825046912,60.029688065177616,NaN,NaN,15.105136737722379,5.241889580873679
2000-04-06T09:30:00-04:00,27.89062,28,27.65625,27.8125,129200,69040,67.56366067300897,56.95811886368129,NaN,NaN,172.24408819714714,146.33074115106768,0.17793376490473706,0.4084752247505534,0.23054145984581637,534800,383040,68.4569746625297,59.65131267455089,NaN,NaN,18.091930154365873,7.077609662801136
2000-04-07T09:30:00-04:00,27.92187,27.92187,27.51562,27.73437,169700,76395,66.23190518889412,57.59260007010793,NaN,NaN,143.5479585240854,157.15877755186074,0.17342276036271814,0.44731991029921403,0.2738971499364959,365100,406160,70.11492670826462,59.44812390137362,NaN,NaN,20.202846496229114,8.952643496147989
2000-04-10T09:30:00-04:00,27.54687,28,27.5,27.67187,26600,68415,65.12601325242278,58.30210651694115,NaN,NaN,129.74044150807254,163.35804765852527,0.15501857042051131,0.46767036296213504,0.31265179254162373,338500,407780,70.23299022041384,59.21150338318191,NaN,NaN,21.673748705990327,10.76994424041118
2000-04-11T09:30:00-04:00,27.90625,28.51562,27.90625,28.39062,28300,61330,71.10184183276587,59.933350069248114,NaN,NaN,163.05185197638204,160.58581965316156,0.17837541025197257,0.5356210553565894,0.35724564510461687,366800,402160,69.211473561818,59.34760764332161,NaN,NaN,24.895900072815685,12.78793793075468
2000-04-12T09:30:00-04:00,28.65625,29,28.53125,28.64062,76000,54455,72.84483548487468,61.36215319031448,NaN,NaN,172.08798341682308,156.13446472450204,0.19636176680453926,0.6026978536102909,0.4063360868057517,442800,409600,69.8369357454897,60.01028462555147,NaN,NaN,28.147444989992014,14.98215322493144
2000-04-13T09:30:00-04:00,28.65625,28.71875,28.45312,28.67187,25000,53055,73.06354155302989,63.001462824682214,NaN,NaN,134.68777346613976,148.62320177830057,0.19563147180335239,0.6508754265599421,0.45524395475658974,467800,396200,67.18947255189937,60.84706623827446,NaN,NaN,30.851952115426805,17.249267352145065
2000-04-14T09:30:00-04:00,28.70312,28.73437,27.35937,27.625,138300,56830,56.613828226090384,63.202051877932945,NaN,NaN,65.86556455441274,133.08672298436602,0.113959242069265,0.597693007343171,0.483733765273906,329500,389080,65.76292659818824,61.774500960462824,NaN,NaN,28.0422621092539,18.791123746017757
2000-04-17T09:30:00-04:00,27.67187,27.67187,26,27.20312,117800,59655,51.574490902951766,63.14636836320144,NaN,NaN,-14.199402767789321,104.29875412919367,0.02546123453522109,0.5155603084429323,0.49009907390771124,211700,363720,60.810510541617184,62.42755843423102,NaN,NaN,23.973670144723183,19.53148751726139
2000-04-18T09:30:00-04:00,27.25,27.59375,27.25,27.28125,47600,57550,52.41917906633826,62.816671166460864,NaN,NaN,17.28415895426532,75.14521552477034,-0.030824387713903723,0.4515685892653316,0.48239297697923533,259300,342220,56.8984099348979,62.78399361124127,NaN,NaN,21.03349233174207,19.746059633615772
2000-04-19T09:30:00-04:00,27.39062,27.53125,27.28125,27.53125,7200,55485,55.11698733393665,62.73634470322202,NaN,NaN,18.29760658090649,44.38714015758702,-0.05293072870309257,0.41622956610036965,0.4691602948034622,266500,306960,51.093139136449295,62.77802743293843,NaN,NaN,19.418775133657356,19.699304705050285
2000-04-20T09:30:00-04:00,27.73437,27.75,27.625,27.625,8000,55530,56.12170682420188,62.61495194636333,NaN,NaN,33.94984718489294,24.239554901337662,-0.06230617757162815,0.39127757283892706,0.4535837504105552,274500,268300,45.599652060240345,62.28552968753625,NaN,NaN,18.40338269483853,19.51417298930575
2000-04-24T09:30:00-04:00,27.78125,28.45312,27.78125,28.375,16700,55150,63.215826349190436,62.8767248151971,NaN,NaN,83.57598663603797,27.781639317662712,-0.02118832311314528,0.4270983465191236,0.4482866696322689,291200,260640,44.576953813148045,61.543662235680245,NaN,NaN,19.75224417551629,19.5481831587644
2000-04-25T09:30:00-04:00,28.59375,29.3125,28.39062,29.21875,18300,54415,69.24086804574529,63.31492465127969,NaN,NaN,152.92517507267098,61.206554885754734,0.055453488235356674,0.5176035299264647,0.46215004169110807,309500,280200,47.79660968862803,60.73666453386097,NaN,NaN,23.095744524038025,20.054977639517773
2000-04-26T09:30:00-04:00,29.23437,29.375,29.04687,29.15625,23400,54705,68.34782038545231,63.470178937064595,NaN,NaN,163.54405115554866,90.4585333260114,0.09238218960210431,0.5776277786937385,0.4852455890916342,286100,285560,48.67647493481635,59.732675011314335,NaN,NaN,25.381500425290245,20.8159094660567
2000-04-27T09:30:00-04:00,28.875,29.09375,28.5,28.5,11100,54615,59.648494462920794,62.9048099220583,NaN,NaN,97.37851281406543,106.27471457264319,0.06438132386681361,0.5657222439251512,0.5013409200583376,275000,287260,48.970246488810815,58.34076585604871,NaN,NaN,24.408333882081667,21.329112954060264
2000-04-28T09:30:00-04:00,28.5,28.65625,28.3125,28.48437,9700,53420,59.45439726831241,62.420702213445324,NaN,NaN,64.79315331780572,112.44337579922576,0.03788784875256557,0.5487007309990446,0.510812882246479,265300,285420,48.64568931726113,56.80724889954846,NaN,NaN,23.593841700273668,21.65264563209075
2000-05-01T09:30:00-04:00,28.23437,28.57812,28.23437,28.48437,27500,51825,59.45439726831241,62.015586786008875,NaN,NaN,51.0575531541558,105.93968910284931,0.014639124634701517,0.5291117880398559,0.5144726634051544,265300,280240,47.687481030160136,55.196855385958905,NaN,NaN,22.948538826699767,21.837773231320607
2000-05-02T09:30:00-04:00,28.29687,28.4375,27.375,27.45312,24200,48990,47.60171326483521,60.33700617401382,NaN,NaN,-40.610859028410545,67.23248228263301,-0.07120244722314623,0.4254696043762216,0.49667205159936784,241100,266560,45.1576698592922,53.47872655006421,NaN,NaN,18.313256421425233,21.334270829906984
2000-05-03T09:30:00-04:00,27.5,28.5,27.35937,27.54687,183600,54945,48.60481992891943,58.6055764914456,NaN,NaN,-37.84338415809277,26.954995219904724,-0.11981888980131938,0.3468984393477186,0.46671732914903796,424700,294280,50.84775651855049,52.12235660528284,NaN,NaN,14.979341074067154,20.426423721929865
2000-05-04T09:30:00-04:00,27.1875,27.60937,27.07812,27.5,28000,55810,48.108953960862486,56.82310594914793,NaN,NaN,-87.20998639293695,-9.962704621495757,-0.15125573666209113,0.277647658321424,0.42890339498351515,396700,318620,55.23925115669761,51.268769362768424,NaN,NaN,12.169076330239033,19.24680266597403
2000-05-05T09:30:00-04:00,27.32812,27.5625,27.3125,27.5625,14900,50095,48.858210653365525,56.26913326538186,NaN,NaN,-71.79053043017316,-37.27944137109152,-0.16295229398042527,0.22521302750798355,0.3881653214884088,411600,347880,59.8798113392006,50.848546844269315,NaN,NaN,10.086870054306042,17.938240864307176
2000-05-08T09:30:00-04:00,27.25,28.0625,27.25,27.75,32300,43225,51.13760212595936,56.23792692416812,NaN,NaN,-44.815495342096774,-56.45405107034204,-0.15331425816719152,0.1965224987794194,0.3498367569466109,443900,383600,64.69224720424933,51.125813748743035,NaN,NaN,8.956763240359072,16.65517263231459
2000-05-09T09:30:00-04:00,27.59375,27.78125,27.5,27.65625,10300,42410,49.93910110388223,56.06077849827841,NaN,NaN,-49.29107148862953,-58.19009356238585,-0.1484086382043493,0.16432595919117432,0.3127345973955236,433600,422100,69.0073806701088,51.990740229829534,NaN,NaN,7.681708507019759,15.3732491858439
2000-05-10T09:30:00-04:00,27.78125,28.35937,27.71875,28.1875,38200,42905,56.2031264751762,56.138359865509806,NaN,NaN,7.9884588117481,-49.02372496841767,-0.1065020723265161,0.17960700698737853,0.2861090793138946,471800,431520,69.9743041218069,53.339394871640785,NaN,NaN,8.332771534134904,14.367466664171186
2000-05-11T09:30:00-04:00,28.26562,28.65625,28.26562,28.60937,47900,41500,60.43674095102706,56.446576588854455,NaN,NaN,65.22059713908648,-18.537608262012974,-0.05033847810963071,0.22318598167685622,0.27352445978648693,519700,456120,72.39628256029248,55.25343990735879,NaN,NaN,10.191583396197823,13.770911911603562
2000-05-12T09:30:00-04:00,28.54687,28.54687,28.0625,28.15625,12000,40850,54.35878923968972,55.81393108103298,NaN,NaN,35.313484810169086,2.883194786055475,-0.04390812923893228,0.21863929823782158,0.26254742747675386,507700,475340,74.15068487512949,57.3658492689289,NaN,NaN,9.941612572053216,13.223869148810655
2000-05-15T09:30:00-04:00,28.03125,28.85937,28.03125,28.70312,919300,79900,59.63494177848157,55.127793490514144,NaN,NaN,65.91437601141968,25.029169056758768,-0.0050696034223362,0.2562104231988336,0.2612800266211698,1427000,671960,84.79628761429933,60.00868340647685,NaN,NaN,11.430150251315673,12.967623592025658
2000-05-16T09:30:00-04:00,28.625,28.8125,28.34375,28.57812,906400,119330,57.98493415333904,54.38758733107748,NaN,NaN,65.57204463494583,48.00179228147384,0.009180141014797027,0.27275520288966604,0.263575061874869,520600,689360,85.37048013032388,62.62968377758453,NaN,NaN,12.120301048552761,12.846577514386674
2000-05-17T09:30:00-04:00,28.34375,28.34375,28.01562,28.14062,6600,117280,52.50884688598099,53.8776125041532,NaN,NaN,2.5768264583001645,46.919465810784246,-0.012692824844184158,0.2477090308196388,0.26040185566382296,514000,697800,85.65350945844163,65.24991684684387,NaN,NaN,10.994643161846545,12.582015464023797
2000-05-18T09:30:00-04:00,28.375,28.65625,28.23437,28.375,12000,117520,54.96273296434674,53.556779339584224,NaN,NaN,36.34520705454254,41.14438779387546,-0.01315344720876277,0.24396004665286952,0.2571134938616323,526000,699060,85.69799420277334,67.89651005295188,NaN,NaN,10.81781034700395,12.329986161592391
2000-05-19T09:30:00-04:00,27.8125,28,27.51562,27.84375,7400,117490,48.80691062678871,52.796244579475385,NaN,NaN,-69.07682525096934,20.266325781647776,-0.048999819493446756,0.19586371949482384,0.2448635389882706,518600,701240,85.78014865620139,70.6174148833834,NaN,NaN,8.69170250266431,11.810231353174094
2000-05-22T09:30:00-04:00,28.03125,28.07812,27.73437,28.03125,14800,117395,50.89722130642495,53.031638011017506,NaN,NaN,-39.04904025326524,-0.7263574712892066,-0.05916554185445272,0.1709066116702047,0.23007215352465743,533400,522520,56.915509423396294,71.45726056653369,NaN,NaN,7.601178295448759,11.208938059213333
2000-05-23T09:30:00-04:00,27.96875,27.96875,27.51562,27.51562,15100,117235,45.40639041872305,52.8031787602892,NaN,NaN,-76.4568291521911,-29.132132228716593,-0.09743949011820638,0.10827279087689945,0.20571228099510583,518300,522060,56.86247297398876,71.88688317049358,NaN,NaN,4.888646823055392,10.30603931119077
2000-05-24T09:30:00-04:00,27.82812,28.17187,27.79687,27.98437,14700,116800,50.62156773631879,52.98265117282178,NaN,NaN,-15.491741368986618,-32.74584579417395,-0.08828183000149845,0.09535999349323276,0.1836418234947312,533000,525860,57.21714264291343,72.0281611337947,NaN,NaN,4.256938947288968,9.441882116347655
2000-05-25T09:30:00-04:00,28.0625,28.0625,27.51562,27.51562,25000,117495,45.899621310533966,52.77132336261953,NaN,NaN,-63.738370855529666,-52.7625613761884,-0.1095028640114119,0.04676324348046634,0.15626610749187825,508000,522260,56.74118229484397,71.80397334491208,NaN,NaN,2.1701099321556674,8.403057518605943
2000-05-26T09:30:00-04:00,27.96875,28.21875,27.71875,28.0625,114600,122740,51.574949612319415,52.80256246878811,NaN,NaN,1.8164207794259997,-38.58391217010933,-0.08358752021752394,0.05178170721997333,0.13536922743749727,622600,543060,58.87004828922081,71.38810199383862,NaN,NaN,2.2876426160752885,7.529426818244421
2000-05-30T09:30:00-04:00,28.28125,28.28125,27.9375,28.26562,28400,122785,53.52504128200008,53.058701052939384,NaN,NaN,41.90490013613239,-22.3931240922298,-0.051233980391717296,0.07132675194785065,0.12256073233956795,651000,566580,61.195535924711486,70.8301130834531,NaN,NaN,3.0112299011115615,6.88397011579687
2000-05-31T09:30:00-04:00,28.125,28.46875,28.125,28.42187,9300,122040,55.02543065943101,52.974579923243304,NaN,NaN,73.94501412403264,7.687244563014948,-0.019415491339298777,0.09829136816544448,0.11770685950474326,660300,594980,63.85315047192444,70.39288782274721,NaN,NaN,4.0612758938928195,6.480728084096291
2000-06-01T09:30:00-04:00,28.32812,28.625,28.26562,28.625,6800,113200,56.97030677869133,52.72697748236218,NaN,NaN,98.47614700390594,30.480822237593458,0.013435684392208977,0.13450146499500448,0.1210657806027955,667100,621800,66.20691624877907,69.95079022906769,NaN,NaN,5.518091199049489,6.343208529089605
2000-06-02T09:30:00-04:00,28.51562,28.6875,28.39062,28.53125,50800,114340,55.771581182179126,52.82789119254,NaN,NaN,96.77060028821995,62.58261646634338,0.026235204535191042,0.15385978627178432,0.12762458173659327,616300,643460,68.01817460803153,69.51275378141784,NaN,NaN,6.368226140680402,6.346782473602576
2000-06-05T09:30:00-04:00,28.15625,28.15625,27.875,27.875,16800,114435,48.136275507785506,52.006557887490274,NaN,NaN,-37.41322530866116,54.73668724872596,-0.010161467811101388,0.11492274697271654,0.12508421478381793,599500,638840,67.19093471920428,68.25522857462533,NaN,NaN,4.792539619261426,6.1247477801252685
2000-06-06T09:30:00-04:00,28.0625,28.60937,28.0625,28.53125,46200,115130,54.80026151562662,51.779081270510815,NaN,NaN,60.72527894537637,58.500763010574744,0.008298456987279657,0.1354572860179175,0.12715882903063785,645700,637780,66.98962598362986,66.94231042129005,NaN,NaN,5.5572436975909705,6.043675768334655
2000-06-07T09:30:00-04:00,28.3125,28.73437,28.3125,28.64062,32400,116235,55.81913020369363,52.015530078918864,NaN,NaN,92.04400122113182,62.12056042999459,0.02525421651485807,0.15872659967421043,0.13347238315935236,678100,641340,67.34350138324785,65.63445270163335,NaN,NaN,6.484233450832266,6.106612580120028
2000-06-08T09:30:00-04:00,28.625,28.85937,28.5,28.8125,8100,114730,57.442689964949224,52.19266986467618,NaN,NaN,117.78058914896552,65.9814488590065,0.044310028156120146,0.18885991835450255,0.1445498901983824,686200,645160,67.74309693512186,64.35196003965824,NaN,NaN,7.735007936439851,6.339240488165717
2000-06-09T09:30:00-04:00,28.82812,29.21875,28.82812,29.17187,134300,119050,60.6949380079762,53.04181467761815,NaN,NaN,178.37187137273384,82.30170307590927,0.07554735691501102,0.23898408634214618,0.16343672942713516,820500,686000,71.7263665543211,63.34811846095251,NaN,NaN,9.797712480674871,6.8333079156670244
2000-06-12T09:30:00-04:00,29.28125,29.28125,28.96875,29.04687,44800,120690,59.00583048645441,53.62100104762025,NaN,NaN,155.7383846657309,120.93202507078767,0.08169876268581885,0.26556018278440874,0.18386142009858988,775700,721240,74.63678952936166,64.61392418280718,NaN,NaN,11.004860032917033,7.429243932417026
2000-06-13T09:30:00-04:00,29.21875,29.76562,29.21875,29.67187,31200,76285,64.34827541707654,54.973992833216926,NaN,NaN,205.7461213206994,149.9361935458523,0.11948137092468664,0.33321313375444817,0.21373176282976153,806900,753480,76.97223676150873,66.05033588191576,NaN,NaN,13.768532989770343,8.334856654896072
2000-06-14T09:30:00-04:00,29.84375,29.84375,29.35937,29.54687,37800,32855,62.59137505167952,55.82897907002841,NaN,NaN,178.86166356647698,167.2997260149213,0.1269736072394506,0.37244877187907477,0.24547516463962418,769100,771680,78.19297698191667,67.54860976327313,NaN,NaN,15.500217061988916,9.35847957019505
2000-06-15T09:30:00-04:00,29.54687,29.90625,29.39062,29.39062,227100,43880,60.37244465449177,56.862752166025395,NaN,NaN,147.7614991271513,173.29590801055846,0.1128039693169266,0.38648012628578243,0.27367615696885583,542000,742840,71.70609328737532,68.61753197702538,NaN,NaN,16.298462707086045,10.349905732608049
2000-06-16T09:30:00-04:00,29.15625,29.5,28.84375,28.84375,236000,55080,53.25623977249457,56.98284432032362,NaN,NaN,71.30749657157232,151.8830330503262,0.060614325212405507,0.34944406348436274,0.28882973827195724,306000,639940,54.37359356072922,68.29635663927598,NaN,NaN,14.842244450057319,10.991668406529373
2000-06-19T09:30:00-04:00,29.25,29.51562,29.17187,29.3125,91800,59300,57.84314483543177,57.291280288425874,NaN,NaN,94.00856924141885,139.53706996546376,0.05200668860450708,0.3538380990275911,0.30183141042308403,397800,564360,45.64617630831798,67.18568809524787,NaN,NaN,15.003089042437146,11.56472849737334
2000-06-20T09:30:00-04:00,29.07812,29.14062,28.79687,29,240200,70570,54.03621845035004,57.22062227349152,NaN,NaN,43.43181267397799,107.07420823611949,0.021190552885377578,0.328319601529806,0.3071290486444284,157600,434500,35.1937624717081,65.13858895237527,NaN,NaN,13.952249776721908,11.905802965851706
2000-06-21T09:30:00-04:00,28.8125,29.34375,28.8125,29.09375,175800,78605,54.99320666923899,57.079400837102064,NaN,NaN,50.2459228898528,81.35106010079464,0.00394762129858911,0.3120635752676648,0.3081159539690757,333400,347360,30.196860536687325,62.5664421157973,NaN,NaN,13.383182294512538,12.116857155660396
2000-06-22T09:30:00-04:00,28.95312,29.04687,28.90625,28.90625,15400,78640,52.63292920823953,56.855211410392094,NaN,NaN,27.599031072932142,57.3185664899508,-0.021841701304510186,0.28081382733843796,0.30265552864294815,318000,302560,27.996076434587025,59.70772081769412,NaN,NaN,12.217673814767137,12.131259535532788
2000-06-23T09:30:00-04:00,28.96875,29.21875,28.96875,29,39200,79350,53.70287728846582,57.25282582329783,NaN,NaN,36.964659561471386,50.44999908793063,-0.03363731771572448,0.26060888149829253,0.294246199214017,357200,312800,29.265060760263168,56.9987298206269,NaN,NaN,11.549869575694208,12.04820382698442
2000-06-26T09:30:00-04:00,29.21875,29.25,28.90625,28.90625,14300,74335,52.42752485980495,57.08334463359629,NaN,NaN,24.859700187010578,36.62022527704896,-0.047932750200006036,0.23433026146400948,0.2822630116640155,342900,301820,28.68136442041431,54.262425423254356,NaN,NaN,10.640659967791121,11.847126132813948
2000-06-27T09:30:00-04:00,28.8125,28.96875,28.125,28.125,3486300,247230,43.21688928531531,56.183184567997834,NaN,NaN,-87.69669113329411,10.39452451559454,-0.10681102421763283,0.1487492313919745,0.2555602556096073,-3143400,-358380,12.516398635801451,50.34620379843676,NaN,NaN,6.918979379932194,11.143105168116554
2000-06-28T09:30:00-04:00,28.10937,28.35937,27.60937,28.35937,1770500,335290,46.26668368675213,55.38489840526946,NaN,NaN,-134.37981346108566,-26.53062275459315,-0.1254885235231129,0.09869960120571619,0.2241881247288291,-1372900,-699640,9.527304577441399,46.1879329157453,NaN,NaN,4.719318405714667,10.225421344916285
2000-06-29T09:30:00-04:00,27.85937,28.03125,27.625,27.90625,11500,335525,41.6131981179068,54.021916984550224,NaN,NaN,-157.17797719170355,-63.48602440752029,-0.16157784264992986,0.02221582141641676,0.18379366406634662,-1384400,-1040120,7.581831496072397,41.60618041158468,NaN,NaN,1.335098251931611,8.955375188775617
2000-06-30T09:30:00-04:00,27.84375,28.21875,27.15625,27.25,4043900,535180,35.970382896263644,52.37652787096517,NaN,NaN,-174.1092427208695,-105.70080486398847,-0.21928370483840082,-0.09031096698165442,0.1289727378567464,-5428300,-2197220,4.3390665978599685,36.58491448790598,NaN,NaN,-3.5721518705435726,7.165728466015733
2000-07-03T09:30:00-04:00,27.90625,28.125,27.8125,28.0625,255100,547095,45.77447222034993,51.049827642627555,NaN,NaN,-111.17137374476897,-132.90701965034438,-0.19328137513349825,-0.11262898106012642,0.08065239407337182,-5173200,-3300440,3.015011147030222,31.302255515443242,NaN,NaN,-4.505147038769856,5.49846053676065
2000-07-05T09:30:00-04:00,27.23437,28.8125,27.23437,28.3125,2175000,653535,48.39288010211164,50.03564943194414,NaN,NaN,-89.37708924490559,-133.24309927266668,-0.1516323660836377,-0.1088880635311753,0.04274430255246239,-2998200,-3271400,3.846761402868438,25.99181154551122,NaN,NaN,-4.358105553802808,4.090379666680156
2000-07-06T09:30:00-04:00,28.32812,28.625,28.3125,28.34375,366400,670235,48.72617138550332,49.20377276987353,NaN,NaN,-46.36315329970003,-115.63976724038955,-0.11597414454876567,-0.10222337813349469,0.013750766415270975,-2631800,-3523180,3.5615683107210003,21.124345475750196,NaN,NaN,-4.138327826225805,2.914850024836447
2000-07-07T09:30:00-04:00,28.25,28.73437,28.25,28.64062,38000,671730,51.903957410178,49.107181172565205,NaN,NaN,-29.352461658813976,-90.07466413381164,-0.06872451906488967,-0.07215488241584112,-0.0034303633509514438,-2593800,-3765060,3.3078493691890003,17.476792319211604,NaN,NaN,-2.9626048589737515,2.0752136128635614
2000-07-10T09:30:00-04:00,28.875,29.01562,28.59375,28.64062,68100,668420,51.903957410178,48.68295349933279,NaN,NaN,-0.2769614867448621,-55.3082078869867,-0.03547544236982064,-0.04777466631322724,-0.012299223943406604,-2593800,-3198160,18.043985460601633,15.505207258660437,NaN,NaN,-2.025376638162903,1.4894150055740667
2000-07-11T09:30:00-04:00,28.625,28.625,28.375,28.375,6800,666520,48.76760973423073,48.30662430532427,NaN,NaN,-34.741846702286566,-40.022302478490204,-0.029615002115865204,-0.04931797658823811,-0.019702974472372906,-2600600,-2683640,28.66946144624231,15.039185756841452,NaN,NaN,-2.130062227303137,0.972346829448752
2000-07-12T09:30:00-04:00,28.53125,28.625,28.45312,28.5,6100,665265,50.28991638814777,47.970674999532044,NaN,NaN,-20.228904702656887,-26.192665570040454,-0.01623248811838831,-0.03999358462035829,-0.023761096501969982,-2594500,-2602900,30.19879304855708,15.03932379340358,NaN,NaN,-1.7864379983821965,0.5782347111871879
2000-07-13T09:30:00-04:00,28.5625,28.625,28.34375,28.625,5200,663635,51.831287615202896,47.91341488574371,NaN,NaN,-13.279364107189757,-19.575907731538404,0.001200179601353997,-0.022260872000277487,-0.023461051601631484,-2589300,-2594400,30.368051192438443,15.208750561821535,NaN,NaN,-1.0701039222346154,0.3427577635555018
2000-07-14T09:30:00-04:00,28.5625,28.5625,28.01562,28.23437,62000,655380,46.93364284539252,47.42989813980991,NaN,NaN,-48.83609501204601,-23.472634402184806,-0.012651481484676534,-0.039275403457477154,-0.02662392197280062,-2651300,-2605900,30.261136970164785,15.27989886252879,NaN,NaN,-1.8238712983231808,0.03323932614426145
2000-07-17T09:30:00-04:00,28.07812,28.25,27.89062,28,149200,651040,44.233025575515285,46.844576762360646,NaN,NaN,-80.19333401352685,-39.4559089075412,-0.03538444339150039,-0.07085447621217611,-0.03547003282067572,-2800500,-2647240,29.854242368683572,15.36367585883374,NaN,NaN,-3.2433585486169516,-0.43484608453591184
2000-07-18T09:30:00-04:00,28.0625,28.25,27.82812,27.89062,172300,655065,42.98975869052701,46.8283531484472,NaN,NaN,-82.90819168687906,-49.0891779044597,-0.05443511506122177,-0.10351392664720294,-0.049078811585981166,-2972800,-2721680,29.09558725526584,16.54790361736691,NaN,NaN,-4.779641038435077,-1.0555310779500782
2000-07-19T09:30:00-04:00,28.3125,28.35937,27.95312,28.17187,171000,651605,47.10655051058454,46.8883436358638,NaN,NaN,-44.80834404963256,-54.00506577385484,-0.04512596820406224,-0.10548627184105897,-0.06036030363699672,-2801800,-2763140,28.658766321309955,17.914436599071813,NaN,NaN,-4.966986718624872,-1.6143104551893344
2000-07-20T09:30:00-04:00,28.07812,28.10937,27.5,27.71875,92600,647445,41.861751972787225,46.90609748264097,NaN,NaN,-107.98248874207482,-72.94569070083185,-0.06529236394432367,-0.1419757585674013,-0.07668339462307763,-2894400,-2824160,27.99265323020775,19.372352437224333,NaN,NaN,-6.690810350507798,-2.339524725949115
2000-07-21T09:30:00-04:00,27.95312,28.25,27.73437,28,11800,647265,45.88890224106509,47.61456315012679,NaN,NaN,-59.13053124680189,-75.00457794778302,-0.055861710677908655,-0.14651053297046346,-0.0906488222925548,-2882600,-2870420,27.471352153139435,21.024658548315724,NaN,NaN,-6.9699094317093095,-3.0010082553434283
2000-07-24T09:30:00-04:00,27.875,28.125,27.76562,27.90625,87400,649675,44.77553082679532,47.54321019344432,NaN,NaN,-66.2156597044836,-72.20904308597437,-0.052178874705199246,-0.15587241567405385,-0.10369354096885461,-2970000,-2904320,27.07345846591184,22.743119071092984,NaN,NaN,-7.519244484541317,-3.6464705738002694
2000-07-25T09:30:00-04:00,28.3125,28.34375,28.07812,28.14062,133100,655615,48.161626256446915,47.52669206161112,NaN,NaN,1.688069889901168,-55.289790770618325,-0.031232941543738083,-0.1427347178985272,-0.11150177635478913,-2836900,-2877140,27.97421915727648,24.466508910693555,NaN,NaN,-7.015928075811717,-4.127821645516191
2000-07-26T09:30:00-04:00,28.28125,28.28125,27.875,27.875,4900,481545,44.80834499037777,47.24684731910215,NaN,NaN,-41.937313125064975,-54.71558458570481,-0.03240186147461645,-0.15200410319805968,-0.11960224172344323,-2841800,-2885140,27.865122865804565,26.202477093199523,NaN,NaN,-7.548459442179459,-4.616484187896657
2000-07-27T09:30:00-04:00,28.0625,28.0625,27.73437,27.76562,4400,393240,43.466251235628505,46.64415402092004,NaN,NaN,-78.04630235472614,-48.72834730823509,-0.03732594398215261,-0.16625967170113398,-0.12893372771898137,-2846200,-2875500,28.228348661515042,27.9825127569371,NaN,NaN,-8.371942400298943,-5.1529782182398405
2000-07-28T09:30:00-04:00,27.9375,27.9375,27.59375,27.59375,11500,393240,41.36948089523453,45.8916914127098,NaN,NaN,-111.83940400340485,-59.27012185955569,-0.048248453536813424,-0.18924429463999815,-0.14099584110318472,-2857700,-2870520,28.42884498142432,28.724288436995863,NaN,NaN,-9.664059340576799,-5.797418378573692
2000-07-31T09:30:00-04:00,27.875,27.96875,27.67187,27.67187,54000,193745,42.72196944377799,45.45985996339174,NaN,NaN,-102.76397098394642,-66.57978411544823,-0.04629433919327461,-0.198863765094778,-0.15256942590150338,-2803700,-2837260,29.83855433522318,28.807795071923067,NaN,NaN,-10.38234056865483,-6.452407262870997
2000-08-01T09:30:00-04:00,27.85937,28.3125,27.8125,28.28125,9500,181465,52.01981666241134,45.583424268696284,NaN,NaN,-6.678354395859773,-68.25306897260043,-0.0023625581117363015,-0.15552262354117374,-0.15316006542943744,-2794200,-2828720,30.21861371700963,28.809210833955394,NaN,NaN,-8.252795047047067,-6.7096055177532925
2000-08-02T09:30:00-04:00,28.34375,28.75,28.34375,28.75,29700,74200,57.70703878463068,46.00312078079827,NaN,NaN,108.31406400252204,-38.20279354708303,0.0566077413656656,-0.08240038872235544,-0.13900813008802104,-2764500,-2813260,30.94784695491991,28.850624816989782,NaN,NaN,-4.533445444628766,-6.398725507306931
2000-08-03T09:30:00-04:00,28.75,29.04687,28.75,28.79687,59500,58855,58.24005032264479,46.81072131488772,NaN,NaN,150.96106595391305,7.598680114644807,0.09486015578213927,-0.02043293536034696,-0.11529309114248623,-2705000,-2785020,32.33878109144473,28.99902796850978,NaN,NaN,-1.3919191898922783,-5.683467461961981
2000-08-04T09:30:00-04:00,28.46875,28.8125,28.23437,28.64062,17600,57835,55.71899960710414,47.63114803142978,NaN,NaN,81.10324728536573,46.18721037239892,0.10494289708381602,0.015885530212283783,-0.08905736687153223,-2722600,-2758000,33.71457295162266,29.27476586729114,NaN,NaN,0.5020345765152451,-4.799824313608092
2000-08-07T09:30:00-04:00,28.5625,29.3125,28.5625,29.20312,36900,56275,62.082382627159305,48.99490688404637,NaN,NaN,173.92521699198167,101.52504796758454,0.1424706388331483,0.08903093166990317,-0.05343970716324515,-2685700,-2734400,34.958555922028594,29.69354934348848,NaN,NaN,4.273660837141066,-3.503612149215355
2000-08-08T09:30:00-04:00,28.65625,28.65625,28.375,28.4375,53400,58605,51.280523330642964,49.29304779976484,NaN,NaN,57.326996621532686,114.32611817106303,0.11015087385664146,0.08424888515755669,-0.025901988699084784,-2739100,-2723380,35.566636946264126,30.18696867384235,NaN,NaN,4.0158918688178735,-2.4293972894963227
2000-08-09T09:30:00-04:00,28.375,28.4375,27.875,27.98437,75400,62070,46.161317783868625,49.60015964341351,NaN,NaN,-23.126419330078008,88.03802150454302,0.05543762596502565,0.04339504375719727,-0.012042582207828374,-2814500,-2733380,35.244628471608536,30.704966905370977,NaN,NaN,2.0030227889552097,-1.796194421146104
2000-08-10T09:30:00-04:00,28,28.0625,27.78125,27.98437,4600,62040,46.16131778386862,49.6196178964709,NaN,NaN,-54.32092795608215,46.98162272254398,0.01834808012215675,0.010892517944867564,-0.007455562177289186,-2814500,-2755280,34.507793070710164,31.2075698280546,NaN,NaN,0.4630036493769025,-1.4734518396428173
2000-08-11T09:30:00-04:00,28.10937,28.59375,28.10937,28.29687,11900,59535,50.14220402717594,50.00295169649809,NaN,NaN,36.996172149078625,38.160207695286566,0.014150225533237863,0.010232219739258142,-0.00391800579397972,-2802600,-2771280,33.94936182226313,31.698705782079692,NaN,NaN,0.4450033768400516,-1.1993868087166932
2000-08-14T09:30:00-04:00,27.96875,28.5625,27.96875,28.46875,12500,52700,52.234207220329,50.293850336775385,NaN,NaN,33.12113473715895,9.999391244322029,0.021782013166189974,0.02330951066375775,0.0015274974975677744,-2790100,-2792160,33.19442115248408,32.07157735316595,NaN,NaN,1.0794996923726838,-0.8738315942753536
2000-08-15T09:30:00-04:00,28.46875,28.75,28.34375,28.65625,7100,44440,54.47814016452621,50.984549992071706,NaN,NaN,79.49799133691454,14.433590187398403,0.037375506741686666,0.048246880924676105,0.010871374182989441,-2783000,-2800940,32.86348551680429,32.428603256808785,NaN,NaN,2.286954574133729,-0.4222907130740561
2000-08-16T09:30:00-04:00,28.5,28.53125,28.1875,28.25,16900,36735,49.096438053340805,51.38670619333687,NaN,NaN,20.700052953507722,23.198884644115545,0.01916488242594943,0.03482747721542623,0.0156625947894768,-2799900,-2798020,33.10235588454387,32.776746629882275,NaN,NaN,1.6670308511230678,-0.12381620390303844
2000-08-17T09:30:00-04:00,28.1875,28.28125,27.875,27.875,12500,32730,44.7062032564001,51.6250435048487,NaN,NaN,-51.07563794228478,23.84794264687502,-0.017328255720560785,-0.005997724861224185,0.0113305308593366,-2812400,-2797600,33.13920492190492,33.113200911345174,NaN,NaN,-0.2580381928788493,-0.1429907737567257
2000-08-18T09:30:00-04:00,27.8125,28.25,27.8125,28.03125,10400,32660,46.83925911746625,51.91913562439786,NaN,NaN,-47.08332101194752,7.032044014669789,-0.029424860238294,-0.025450544438530898,0.0039743157997631,-2802000,-2797480,33.15053492160962,33.34977095322992,NaN,NaN,-1.183510480523571,-0.2916364461519893
2000-08-21T09:30:00-04:00,28.20312,28.25,28.0625,28.21875,5600,28570,49.363636362299815,51.729408460104175,NaN,NaN,-17.698825683616164,-3.131948069485233,-0.023534698916572297,-0.025444057845952273,-0.0019093589293799748,-2796400,-2798740,33.08713459395072,33.55466530158286,NaN,NaN,-1.2001634048821628,-0.4214260116848712
2000-08-22T09:30:00-04:00,28.25,28.25,27.875,27.875,12200,22525,45.132306537616856,50.831213299603185,NaN,NaN,-55.23535370245526,-30.078617077359194,-0.04052904678147936,-0.05257066740622918,-0.012041620624749817,-2808600,-2803860,32.81251935221378,33.68785618710384,NaN,NaN,-2.504389402810976,-0.7189922104171719
2000-08-23T09:30:00-04:00,27.875,28.125,27.78125,28.09375,98700,27215,48.17659444144518,50.11239502237464,NaN,NaN,-55.029428619238985,-45.22451339190853,-0.03498628006780675,-0.05577447070950825,-0.020788190641701502,-2709900,-2785860,34.859454568814556,33.867904292630264,NaN,NaN,-2.6865115628415204,-1.0000664036206501
2000-08-24T09:30:00-04:00,28.1875,28.1875,27.875,28.03125,11200,27555,47.36792685662947,49.51588982591216,NaN,NaN,-51.347185020919596,-45.27882280763549,-0.03347722468231323,-0.06263472149459304,-0.02915749681227981,-2721100,-2767600,36.957720835591154,34.09955771291373,NaN,NaN,-3.067831825054591,-1.2954614638254989
2000-08-25T09:30:00-04:00,27.92187,28.09375,27.90625,28,159900,34975,46.94363437583661,48.4345506651034,NaN,NaN,-64.99556905319697,-48.86127241588538,-0.0325049252271484,-0.06978865334621531,-0.03728372811906691,-2881000,-2783400,35.88073128177625,34.16542738146713,NaN,NaN,-3.4984258795009686,-1.6101706660648516
2000-08-28T09:30:00-04:00,28.125,28.70312,28.125,28.5,11900,32870,54.03758927806439,48.63148394706207,NaN,NaN,36.976913963234644,-37.92612448651522,0.002057195668285175,-0.034712233533710446,-0.03676942920199562,-2869100,-2797940,34.87357969292749,34.11592329194308,NaN,NaN,-1.796264982514635,-1.6367555684148207
2000-08-29T09:30:00-04:00,28.4375,28.4375,28.21875,28.25,10400,32915,50.40840851820239,48.93484757094306,NaN,NaN,-1.6734203761859663,-27.21373782126137,0.007993025782658467,-0.026778146973672534,-0.034771172756331,-2879500,-2812120,33.874940502996196,34.0180884370422,NaN,NaN,-1.411212447155612,-1.6045351225206481
2000-08-30T09:30:00-04:00,28.25,28.59375,28.25,28.53125,7300,31795,54.13991892949849,49.504747652773766,NaN,NaN,43.60056453079714,-7.487739191254138,0.029560201576337774,0.0021790792140912174,-0.027381122362246556,-2872200,-2844580,31.641251543772725,33.813335470832385,NaN,NaN,0.04097938487123638,-1.3694616214646647
2000-08-31T09:30:00-04:00,28.75,29.03125,28.75,28.75,6000,29120,56.85891093222973,49.984512431706186,NaN,NaN,150.9573765767649,32.97317312828276,0.05573823735173554,0.04229167432742287,-0.01344656302431267,-2866200,-2873600,29.75239218402062,33.51355192524364,NaN,NaN,2.085306621602136,-0.8759233010265502
2000-09-01T09:30:00-04:00,28.98437,29.09375,28.78125,29.09375,242300,40355,60.79276838573055,50.59583822923486,NaN,NaN,170.51816447373182,80.07591983366851,0.09128414420356641,0.10065861723014535,0.009374473026578936,-2623900,-2822180,36.936062605638355,33.78081202904037,NaN,NaN,5.077218524074986,-0.025474468869187916
2000-09-05T09:30:00-04:00,29.25,29.375,29.125,29.20312,156400,46330,61.98064795849475,51.13173164308976,NaN,NaN,220.77911098315104,116.83635923765178,0.11567263691117949,0.1539652691655533,0.038292632254373814,-2467500,-2741860,46.192320271013685,34.73287165434104,NaN,NaN,7.892031377572538,1.1055977949082014
2000-09-06T09:30:00-04:00,29.51562,29.625,29.40625,29.5625,136900,50505,65.66210915437773,52.31499386459239,NaN,NaN,225.08178635220258,162.18740058332952,0.14748080629378937,0.22264364012161053,0.07516283382782116,-2330600,-2632080,55.751798460806405,36.35068898121694,NaN,NaN,11.49737256218089,2.5901370473757286
2000-09-07T09:30:00-04:00,29.59375,29.75,29.4375,29.5625,34200,48445,65.66210915437773,53.8118442858765,NaN,NaN,186.64595367956204,190.79647841308247,0.15900111786108123,0.2739142311541727,0.11491311329309147,-2330600,-2523760,62.77853257875473,38.46778381384907,NaN,NaN,14.396506340371964,4.276761232089476
2000-09-08T09:30:00-04:00,29.75,30.5625,29.71875,30.5,960400,96235,73.44233416115276,55.71206393185411,NaN,NaN,224.3929619429517,205.48359548631984,0.21666814354091485,0.38574829271923505,0.1690801491783202,-1370200,-2224560,74.72027806772033,41.437051181428366,NaN,NaN,19.95091706457664,6.515926351016214
2000-09-11T09:30:00-04:00,30.6875,31.35937,30.6875,31.20312,563900,123835,77.55066077004874,57.72542281812189,NaN,NaN,241.48421972690954,219.67680653695538,0.2847846202675245,0.5250609245127258,0.24027630424520133,-806300,-1861040,82.19466859594601,44.944732181570885,NaN,NaN,26.364722460982392,9.351468652439953
2000-09-12T09:30:00-04:00,31.15625,31.25,30.8125,31.125,690300,157725,76.14132983631893,59.94035305374347,NaN,NaN,189.0097145343473,213.32292724719463,0.3053738387670889,0.6219936027040625,0.31661976393697355,-1496600,-1666860,84.78286513952857,48.65689973780765,NaN,NaN,30.82543443694877,12.419178050226925
2000-09-13T09:30:00-04:00,31.125,31.3125,30.875,30.90625,101900,162465,72.18541053968542,61.65526848933206,NaN,NaN,152.4008187645263,198.78673372965937,0.2854238848981196,0.6733996200596231,0.38797573516150347,-1598500,-1520440,86.38944929125844,52.33761364655364,NaN,NaN,33.16330715758834,15.38262506556427
2000-09-14T09:30:00-04:00,30.875,30.875,30.34375,30.5,60500,164645,65.39067183263532,62.94260741618962,NaN,NaN,102.43750056838094,181.94504310742315,0.22849422197556968,0.6735935126309656,0.4450992906553959,-1659000,-1386120,87.6749819571027,55.96027515523304,NaN,NaN,32.91483041314523,17.887225829504406
2000-09-15T09:30:00-04:00,30.3125,30.71875,30.3125,30.53125,54200,166730,65.65845574429123,64.27938037107924,NaN,NaN,87.44822462846733,154.5560956445263,0.17877018420517155,0.6685620209118603,0.4897918367066888,-1604800,-1433040,84.66667647817434,59.44498552640433,NaN,NaN,32.800372543585176,20.017675360087374
2000-09-18T09:30:00-04:00,30.5,30.5625,30.3125,30.34375,61200,169270,62.53215576928764,64.88613512045232,NaN,NaN,71.17476810107199,120.4942053193588,0.1218015415375826,0.6420437636286671,0.5202422220910845,-1666000,-1604980,74.56927196697279,62.28039211740757,NaN,NaN,31.758580962380734,21.694947588986427
2000-09-19T09:30:00-04:00,30.4375,30.4375,29.84375,29.84375,50200,171500,55.010110907891345,65.21482814828725,NaN,NaN,41.8947592982455,91.07121427213845,0.043057880962504846,0.5740645732942156,0.5310066923317107,-1716200,-1648900,72.20058298813979,65.01793800920355,NaN,NaN,28.431894282790914,22.65736854524421
2000-09-20T09:30:00-04:00,29.75,29.75,29.1875,29.3125,96300,175705,48.354565841139745,64.80158864197591,NaN,NaN,-5.3665668934243715,59.517737140548306,-0.0472985057944435,0.4718835600886564,0.5191820658830999,-1812500,-1691700,69.8713476152885,67.74865915716896,NaN,NaN,23.28778809231469,22.747428480539995
2000-09-21T09:30:00-04:00,29.5,29.53125,29.15625,29.53125,146900,178115,50.984290066907086,64.38197286588142,NaN,NaN,-12.112288559687116,36.6077793149347,-0.09222584252018978,0.40389976273286265,0.49612560525305244,-1665600,-1693020,69.79656140173714,70.60895695843442,NaN,NaN,19.92492214400567,22.344213289606518
2000-09-22T09:30:00-04:00,29.84375,30.28125,29.78125,30.28125,25300,178820,58.7412601874997,64.2354365660078,NaN,NaN,36.958552299959344,26.50984484923311,-0.07221063030965535,0.4058623173659832,0.47807294767563857,-1640300,-1700120,69.36648932922057,72.92541601011887,NaN,NaN,19.528699030276627,21.941996966845107
2000-09-25T09:30:00-04:00,30.3125,30.5,30.25,30.5,57000,173675,60.69504018731232,64.14360743949477,NaN,NaN,54.95805037440443,23.266501303899595,-0.046278468339704726,0.42022486225100764,0.46650333059071236,-1583300,-1683580,69.83283035115866,74.61402387298635,NaN,NaN,19.8580986005876,21.644297200236892
2000-09-26T09:30:00-04:00,30.625,31.125,30.625,30.9375,16700,173915,64.33287126625083,64.04866187605714,NaN,NaN,88.7999076717301,32.64753097859648,-0.003931491721613778,0.46158896593869514,0.4655204576603089,-1566600,-1653660,70.70171051466389,75.68187473397619,NaN,NaN,21.348798638196467,21.6020831199454
2000-09-27T09:30:00-04:00,30.8125,31.04687,30.5625,30.8125,51800,175985,62.55151955311739,63.82647690453854,NaN,NaN,75.74586371579092,48.87001710043954,0.010595598988202337,0.4787649563955618,0.4681693574073595,-1618400,-1614840,71.83518273295554,76.32877831641909,NaN,NaN,21.97032675365773,21.654689353332877
2000-09-28T09:30:00-04:00,31,31.82812,30.95312,31.8125,112500,181245,69.76441701020323,63.563768536613566,NaN,NaN,137.27032083670133,78.74653897971723,0.07869491235307946,0.5665379978487088,0.4878430854956294,-1505900,-1582900,72.76865572902419,76.18937672079794,NaN,NaN,25.10743397600912,22.14793858514377
2000-09-29T09:30:00-04:00,31.875,32.5625,31.84375,32.28125,59400,183915,72.44372158818413,63.19898716648038,NaN,NaN,188.1953930466902,108.9939071290634,0.14271988294963234,0.6662429391826699,0.5235230562330375,-1446500,-1544140,73.89918654239361,75.59684228840135,NaN,NaN,28.622277134343538,23.072844092172307
2000-10-02T09:30:00-04:00,31.98437,32.46875,31.8125,32.46875,22700,172935,73.45693175197762,63.00724444617028,NaN,NaN,169.9668760134048,131.9956722568635,0.18256083424599667,0.7517240990405334,0.5691632647945367,-1423800,-1512240,74.82551604885444,74.88560306763891,NaN,NaN,31.72416016661659,24.30874638852149
2000-10-03T09:30:00-04:00,32.23437,32.8125,32.0625,32.0625,91700,169700,67.65274741058553,62.683482794091724,NaN,NaN,153.019553311599,144.83960138483727,0.16684735130505957,0.7777224539258611,0.6108751026208016,-1515500,-1502020,75.13004691468053,74.08136004074048,NaN,NaN,32.38056366230448,25.46186314191906
2000-10-04T09:30:00-04:00,32.28125,32.5625,31.78125,32.0625,58500,165780,67.65274741058553,62.84505962108817,NaN,NaN,121.60790863574223,154.01201036882753,0.1426827990560391,0.7892286014408505,0.6465458023848114,-1515500,-1481440,75.76578589211631,73.23070317895574,NaN,NaN,32.89200320139352,26.523311721843985
2000-10-05T09:30:00-04:00,32.54687,32.54687,32.25,32.34375,199200,174030,69.58249507486767,63.125348144700766,NaN,NaN,127.31381459375356,152.02070912023797,0.1321115410359619,0.8116852286797638,0.6795736876438019,-1316300,-1443520,76.93569439773904,72.67849017321036,NaN,NaN,33.90540167486135,27.577896000846465
2000-10-06T09:30:00-04:00,32.25,32.5625,32.07812,32.1875,20400,127030,67.18452076521461,63.45765993012413,NaN,NaN,104.45862624361816,135.27335575962354,0.10239312246063792,0.8075650907195993,0.7051719682589613,-1336700,-1421560,77.60980253883275,72.89567092834321,NaN,NaN,34.03487918814868,28.500322170461068
2000-10-09T09:30:00-04:00,32.45312,32.625,32.125,32.1875,40400,100855,67.18452076521461,64.32726063421866,NaN,NaN,93.75512789579088,120.03100613610077,0.07196965853392612,0.795134041426369,0.7231643828924429,-1336700,-1404140,78.15523019968211,73.3210028720248,NaN,NaN,34.139804312359004,29.30596247644649
2000-10-10T09:30:00-04:00,32.46875,32.67187,32.0625,32.125,14900,67085,66.12732637380611,65.59674352940911,NaN,NaN,81.02854870784648,105.63280521535026,0.03854649669302357,0.7713475037587223,0.7328010070656987,-1351600,-1371360,79.18288049782089,73.98611236363426,NaN,NaN,33.94304601024773,29.968402981275236
2000-10-11T09:30:00-04:00,32.3125,32.3125,31.34375,31.625,40900,64035,58.23276974598374,66.11449207791459,NaN,NaN,39.33043920427509,89.17731132905683,-0.02301280349717505,0.7040350026942299,0.727047806191405,-1392500,-1346760,79.94535225141394,74.71102599575404,NaN,NaN,31.49242257922128,30.1861200666961
2000-10-12T09:30:00-04:00,31.3125,31.76562,30.8125,31.1875,62500,64135,52.34422120518097,65.65756072203467,NaN,NaN,1.2762211302148687,63.9697926363491,-0.09493919505646109,0.6083738123708287,0.7033130074272897,-1455000,-1374500,76.54085891390558,75.22348096608869,NaN,NaN,27.540116472692162,29.808119553266966
2000-10-13T09:30:00-04:00,31.3125,31.65625,31.28125,31.65625,58400,64345,57.32361366211081,65.41674454166314,NaN,NaN,18.335690483860542,46.745205484397566,-0.11154183487916725,0.5638857138283306,0.6754275487074979,-1396600,-1386480,75.05434106132833,75.5964460168151,NaN,NaN,25.56373725262433,29.201779224603733
2000-10-16T09:30:00-04:00,31.84375,32.0625,31.78125,31.84375,78700,65220,59.16172919579041,65.04737725091596,NaN,NaN,41.575322107775605,36.30924432679451,-0.11029277264293691,0.5375615829038267,0.6478543555467636,-1317900,-1382720,75.21702547208947,75.91896851377406,NaN,NaN,24.47597667882496,28.526664575206766
2000-10-17T09:30:00-04:00,32.125,32.40625,32.03125,32.26562,34100,64415,63.02097690733681,65.0809099190745,NaN,NaN,63.54369770051369,32.81227412532796,-0.08271176189977425,0.5444646531720458,0.6271764150718201,-1283800,-1369160,75.82923197257631,76.20425774517555,NaN,NaN,24.711177434989644,27.981594983747176
2000-10-18T09:30:00-04:00,32.09375,32.23437,31.8125,32,135000,66350,59.225955751788035,64.32816268633054,NaN,NaN,40.160854483811114,32.978357181235175,-0.08375772698745798,0.5224792563374976,0.6062369833249556,-1418800,-1374420,75.05471096635402,76.36754740498482,NaN,NaN,23.752897565507272,27.377495352570048
2000-10-19T09:30:00-04:00,31.625,32.10937,31.625,31.84375,38500,60930,57.0496206432991,63.228584047410195,NaN,NaN,16.220191190213118,35.96715119323482,-0.09552105601697813,0.48683566330373296,0.5823567193207111,-1457300,-1374880,74.98258133677545,76.44493274744066,NaN,NaN,22.315487046299353,26.65435130881709
2000-10-20T09:30:00-04:00,31.625,31.82812,30.92187,31.67187,81100,63720,54.66976350234501,61.886643458150715,NaN,NaN,-45.52264040761159,23.195485014940395,-0.11416492626657426,0.43965056148749326,0.5538154877540675,-1538400,-1403240,70.48513140747293,76.13490527305626,NaN,NaN,20.419029822684617,25.763591096512453
2000-10-23T09:30:00-04:00,31.76562,32.46875,31.76562,32.34375,24400,62090,61.441092287187026,61.442953806479395,NaN,NaN,52.617524576600054,25.40392550870528,-0.08203704698571745,0.45126917902192076,0.5333062260076382,-1514000,-1442460,64.70509620844416,75.39026593689653,NaN,NaN,20.781099167343676,25.051806535202626
2000-10-24T09:30:00-04:00,32.6875,32.6875,32.0625,32.20312,11000,61805,59.43969442537038,60.856307164678306,NaN,NaN,69.32883357513829,26.560952683630198,-0.07143612623613882,0.4440110682124647,0.5154471944486035,-1525000,-1490700,58.36534230786502,74.14737710944999,NaN,NaN,20.470836162628345,24.397382196263443
2000-10-25T09:30:00-04:00,32.28125,32.54687,31.9375,32,76500,63040,56.57324057318756,59.92707470027258,NaN,NaN,33.052160642626234,25.139213915393224,-0.07870875226059482,0.41706125412286,0.4957700063834548,-1601500,-1527240,54.04576263263278,72.51238198337099,NaN,NaN,19.358959351636166,23.67760750417383
2000-10-26T09:30:00-04:00,32,32.09375,31.71875,31.89062,29600,58895,55.03412798483015,59.05918950167369,NaN,NaN,-35.12269370119589,14.870636937111424,-0.09064126708741105,0.382468422524191,0.47310968961160205,-1631100,-1562000,50.23681943605083,70.55716890460084,NaN,NaN,17.996598032489985,22.86603472250471
2000-10-27T09:30:00-04:00,32.09375,32.625,31.9375,32.625,27300,57290,62.425430143977735,58.719254457299634,NaN,NaN,86.46783752567306,41.26873252376836,-0.05081560598839979,0.4095901821261023,0.4604057881145021,-1603800,-1575080,48.84190333927926,68.4633598431435,NaN,NaN,19.052208797886614,22.32120244755927
2000-10-30T09:30:00-05:00,33.28125,33.95312,33.28125,33.89062,52200,58765,71.20885740210679,59.082220959321106,NaN,NaN,323.7756427233878,95.5003561531259,0.05338166486630569,0.5271328691973842,0.47375120433107853,-1551600,-1582600,48.01641589910441,66.23718380037805,NaN,NaN,23.357986247489016,22.469314418977806
2000-10-31T09:30:00-05:00,33.8125,34.15625,33.75,34.15625,27100,55535,72.65372055340325,60.11228887413678,NaN,NaN,296.5328462308841,140.94115868427508,0.12852492726128006,0.6344073634076786,0.5058824361463985,-1524500,-1582500,48.02899489133545,63.957443988943865,NaN,NaN,27.229005373699,23.149270269652263
2000-11-01T09:30:00-05:00,34.28125,34.375,33.78125,33.95312,40300,54625,69.770223202698,61.35700330253086,NaN,NaN,228.3901981352303,180.00876618279588,0.15131046364196143,0.6950205156988503,0.5437100520568888,-1564800,-1575160,49.004417747029244,61.990555334166984,NaN,NaN,29.313934168071615,24.029936540855026
2000-11-02T09:30:00-05:00,34.03125,34.03125,33.5,33.96875,5900,44960,69.86931558901728,62.25312486873846,NaN,NaN,158.83279771086856,218.7998644652088,0.1537006212093549,0.7358358285685824,0.5821352073592275,-1558900,-1560720,50.9546462503082,60.26914856195127,NaN,NaN,30.967898107834635,25.0210739075664
2000-11-03T09:30:00-05:00,33.82812,34.15625,33.70312,33.8125,9800,44430,67.48767859449748,62.84783554007468,NaN,NaN,132.65990187590108,228.03827733525435,0.13186275958834281,0.746963656844656,0.6151008972563132,-1568700,-1553700,51.91735712533106,58.6048865371828,NaN,NaN,31.60693784022566,25.961911612232008
2000-11-06T09:30:00-05:00,34,34.0625,33.65625,33.65625,13300,43075,65.09798983841998,62.99619360658062,NaN,NaN,103.83505227158768,184.05015924489436,0.09568347980410186,0.7347052470114406,0.6390217672073387,-1582000,-1559780,50.983925675623134,56.83022180168615,NaN,NaN,31.438654121784626,26.744303399310954
2000-11-07T09:30:00-05:00,33.71875,33.71875,33.4375,33.70312,14400,43050,65.49270820731883,63.44381878197568,NaN,NaN,78.20692794325402,140.38497558736833,0.06515641645369807,0.7204672877744613,0.6553108713207633,-1567600,-1568400,49.62175861364243,55.01358234792104,NaN,NaN,31.410163992278395,27.41085491259202
2000-11-08T09:30:00-05:00,33.75,33.875,33.48437,33.875,18600,41935,66.96802899047124,64.1522765210594,NaN,NaN,77.033189163518,110.11357379302588,0.047601673467762784,0.7148129631554667,0.6672112896877039,-1549000,-1565240,50.147591504076196,53.23965450272823,NaN,NaN,31.79088338519077,28.03657326582041
2000-11-09T09:30:00-05:00,33.9375,34.15625,33.59375,34.0625,12700,39445,68.54777604406326,65.14356313118215,NaN,NaN,81.00407276731441,94.54782880431506,0.03998631627199756,0.7171941850277008,0.6772078687557033,-1536300,-1560720,50.93645114628813,51.84332019835789,NaN,NaN,32.550930409489915,28.68148142920177
2000-11-10T09:30:00-05:00,34.3125,34.40625,34.03125,34.125,12900,37170,69.07863019634121,65.68910155326458,NaN,NaN,89.25532321959028,85.86691307305288,0.030931638259202865,0.7158724165797068,0.6849407783205039,-1523400,-1551660,52.55699298138776,50.97559853928242,NaN,NaN,33.33069831005612,29.34565526932382
2000-11-13T09:30:00-05:00,34.3125,34.54687,34.09375,34.28125,25600,34515,70.42265634651608,66.47359883334641,NaN,NaN,89.00354600183448,82.90061181910224,0.027361889548630947,0.7191431402562927,0.6917812507076617,-1497800,-1534820,55.499164750900746,50.77087157092784,NaN,NaN,34.36252165394744,30.062350467127196
2000-11-14T09:30:00-05:00,33.90625,34.0625,33.57812,33.6875,16300,33625,59.787837024382505,66.70321286557463,NaN,NaN,45.987006260025936,76.45662748245661,-0.020508490754171937,0.6661456372649468,0.6866541280191187,-1514100,-1524120,57.310677731795536,51.0040797922966,NaN,NaN,32.24675421342331,30.374408145169497
2000-11-15T09:30:00-05:00,33.65625,33.96875,33.35937,33.65625,19700,27860,59.28042575344716,67.00651984904727,NaN,NaN,33.442012359293685,67.73839212161175,-0.05769202535930518,0.6145390963199873,0.6722311216792924,-1533800,-1521080,57.835837270372096,51.5468667804624,NaN,NaN,30.370014760525148,30.373780518791733
2000-11-16T09:30:00-05:00,34.09375,34.23437,33.9375,34.04687,21000,26985,63.45545018671788,67.08009270924299,NaN,NaN,62.72626803724017,64.08283117559691,-0.05917378016241348,0.5982638964762756,0.6574376766386891,-1512800,-1516380,58.68212669776362,52.24973987749701,NaN,NaN,29.88123436915159,30.303416783128856
2000-11-17T09:30:00-05:00,33.59375,33.75,33.34375,33.53125,8800,23370,55.383213192192216,65.94968955139196,NaN,NaN,9.168002697963846,48.06536707127162,-0.09589992565227257,0.5375627695733485,0.633462695225621,-1521600,-1516020,58.75042097000714,53.01645452541863,NaN,NaN,26.93466540002321,29.822166585542334
2000-11-20T09:30:00-05:00,33.9375,33.96875,33.8125,33.85937,11300,22715,58.96096148711814,64.97163533237158,NaN,NaN,42.23120402632597,38.71089867616992,-0.09872723619497792,0.5100536499818986,0.6087808861768765,-1510300,-1518520,58.03304981856004,53.73102987736324,NaN,NaN,25.521880405478335,29.207839988390333
2000-11-21T09:30:00-05:00,33.5625,33.8125,33.45312,33.53125,4800,22405,54.27403355842675,63.864764643495064,NaN,NaN,-0.6681051109284172,29.379876401979054,-0.12181388579375851,0.45651352893467845,0.578327414728437,-1515100,-1518720,57.9720643505511,54.37157606332909,NaN,NaN,22.84510969112953,28.298878517353074
2000-11-22T09:30:00-05:00,33.78125,33.96875,33.67187,33.78125,25300,19845,57.07389894231359,62.950806311587655,NaN,NaN,23.878842083062064,27.467242346732725,-0.11921655001101694,0.4293067272146658,0.5485232772256827,-1489800,-1509920,59.96558969771884,55.01521488100127,NaN,NaN,21.4673148304477,27.322940847795163
2000-11-24T09:30:00-05:00,33.9375,33.9375,33.6875,33.71875,6700,18700,56.1482733463902,62.14084879386571,NaN,NaN,0.4758657159910667,15.017161882482899,-0.12032844771676354,0.3981127175797283,0.5184411652964919,-1496500,-1506660,60.709113947387706,55.64319751114817,NaN,NaN,20.078992635455936,26.288091103175272
2000-11-27T09:30:00-05:00,33.5,33.6875,33.46875,33.48437,35300,19100,52.69677949475394,61.25504805503242,NaN,NaN,-118.36535031847207,-10.489508720804277,-0.13440166078292864,0.3504390893178311,0.4848407501007597,-1531800,-1508700,59.9586824856249,56.28425156900545,NaN,NaN,17.87672897562287,25.08646794209636
2000-11-28T09:30:00-05:00,33.53125,34.04687,33.53125,33.96875,101400,21560,58.38954736100942,60.74767942315317,NaN,NaN,1.9728261818927733,-18.541184289690918,-0.10968512151362214,0.34773434820873206,0.4574194697223542,-1430400,-1492720,63.73978778053527,57.29268222378351,NaN,NaN,17.654330897662454,24.0247340786058
2000-11-29T09:30:00-05:00,33.96875,34.25,33.96875,34.1875,41300,22270,60.69034558524979,60.29927346563735,NaN,NaN,115.46617397704543,4.685671527903852,-0.07865349025440271,0.3591026069043508,0.4377560971587535,-1389100,-1467520,68.75112122715316,58.62150577543186,NaN,NaN,18.17361438020248,23.188859835976753
2000-11-30T09:30:00-05:00,34.29687,34.375,33.6875,34.14062,22200,21365,59.92560742312729,59.68340427842764,NaN,NaN,86.45816791660255,17.20153669461195,-0.062063029893146826,0.36017730979232,0.4222403396854668,-1411300,-1451820,71.40285227323811,60.083391570214,NaN,NaN,18.37344172639632,22.500942963179547
2000-12-01T09:30:00-05:00,34,34.07812,33.29687,33.48437,13500,21745,50.35939439108523,58.34631600662364,NaN,NaN,-83.74150391606412,0.35806276820090943,-0.09414083062671424,0.304564301402074,0.39870513202878827,-1424800,-1437480,73.60595697192078,61.58688899810921,NaN,NaN,15.51998212507955,21.503662843450975
2000-12-04T09:30:00-05:00,33.59375,34.1875,33.59375,33.84375,20000,22255,54.630684782886426,57.21831803779295,NaN,NaN,13.282284367933954,26.687589705482118,-0.09001168333425141,0.286190527860974,0.3762022111952254,-1404800,-1412080,76.98770740187105,63.12178490174995,NaN,NaN,14.46166866833317,20.497663675577
2000-12-05T09:30:00-05:00,33.9375,34.0625,33.76562,34.0625,23300,22755,57.05301606678381,57.02297368367875,NaN,NaN,42.79460686634235,34.851945842372025,-0.07217470241725255,0.2859838331736597,0.35815853559091226,-1381500,-1402300,78.1486321849562,64.61021021983285,NaN,NaN,14.351149218405332,19.619590181695333
2000-12-06T09:30:00-05:00,34.25,34.29687,33.9375,34.1875,45300,24300,58.41920492064537,56.961457909907196,NaN,NaN,97.37698023571764,31.23410709410647,-0.052499366199801556,0.2925343278411603,0.34503369404096185,-1336200,-1391720,79.36160643489737,66.14776516015608,NaN,NaN,14.675595844354042,18.913305276360862
2000-12-07T09:30:00-05:00,34.375,34.42187,34.125,34.17187,20100,24375,58.170026186215125,56.583927624157,NaN,NaN,115.87195890009096,37.11686529080415,-0.0415582195189283,0.29308591964230146,0.33464413916122976,-1356300,-1380720,80.56929044162831,67.71113399900356,NaN,NaN,14.86672194890505,18.335221943867175
2000-12-08T09:30:00-05:00,33.73437,33.90625,33.34375,33.34375,44200,25950,46.78401085454938,55.969698885753935,NaN,NaN,-111.38862784706701,31.587440504603574,-0.08842154070518593,0.22411721327974732,0.31253875398493325,-1400500,-1375860,81.09563222799648,69.30722051743136,NaN,NaN,11.349884911854211,17.33731665357961
2000-12-11T09:30:00-05:00,33.21875,33.46875,33.0625,33.4375,18600,26235,48.024335132960566,55.1885112890284,NaN,NaN,-157.47368119482877,-2.5637526079489703,-0.11002580943667378,0.17500649218909103,0.2850323016257648,-1381900,-1371280,81.60143027148715,70.99067626406902,NaN,NaN,8.920205500667901,16.134872203163653
2000-12-12T09:30:00-05:00,33.5625,33.875,33.42187,33.53125,17200,25815,49.29699254015493,54.83300835915184,NaN,NaN,-63.23034768138492,-23.768743517494425,-0.11441489089677598,0.14201368800479486,0.25642857890157084,-1364700,-1367920,81.98229687849755,72.70569287320805,NaN,NaN,7.318389679537384,14.875374699788471
2000-12-13T09:30:00-05:00,33.9375,34.40625,33.875,34.35937,33500,26675,58.87587433585346,54.961720887261826,NaN,NaN,117.9245669870967,-19.659226167218613,-0.060657191128138555,0.18060708999139763,0.24126428111953618,-1331200,-1366920,82.10105455288681,74.28679750572005,NaN,NaN,8.992167520873705,14.034916531372076
2000-12-14T09:30:00-05:00,34.23437,34.34375,33.85937,34.15625,30800,27230,56.07745074022081,54.9566621296783,NaN,NaN,81.06027246081831,-26.621563455073147,-0.03894536045498459,0.19258258055080546,0.23152794100579005,-1362000,-1368060,81.44203182540971,75.76772021129305,NaN,NaN,9.446559851093978,13.379437005618062
2000-12-15T09:30:00-05:00,33.95312,33.98437,33.53125,33.625,28800,27620,49.45636494631632,54.72520394764704,NaN,NaN,-34.55341407763507,-11.254520701186758,-0.059309155414390746,0.15739149673780162,0.21670065215219236,-1390800,-1366120,81.7110746451791,77.32146250840405,NaN,NaN,7.633281162003287,12.55855759938738
2000-12-18T09:30:00-05:00,33.59375,33.59375,33.20312,33.3125,12800,27820,46.0146651891651,53.8412837925153,NaN,NaN,-130.75762424242296,-5.911309310705596,-0.0908823420763108,0.10309772455680388,0.19398006663311468,-1403600,-1370460,78.95345230923057,78.40815283188229,NaN,NaN,5.004871561960138,11.47945959404063
2000-12-19T09:30:00-05:00,32.4375,33.125,32.0625,32.15625,25600,28535,36.0251755286931,52.07948593133268,NaN,NaN,-291.89657450814303,-51.64455467605721,-0.18146525428327168,-0.03285150122097491,0.14861375306229677,-1429200,-1383360,71.25579264988117,78.58705793350573,NaN,NaN,-1.244635972690214,9.661731655936224
2000-12-20T09:30:00-05:00,32.09375,32.3125,31.71875,31.85937,24700,29530,33.98508573042153,50.22659152471084,NaN,NaN,-289.83774068952164,-133.19701621138088,-0.24902923153830775,-0.1626727863605879,0.08635644517771984,-1453900,-1407900,59.392876249511836,77.72920250323956,NaN,NaN,-6.8487238607873175,7.303095153547147
2000-12-21T09:30:00-05:00,31.60937,31.875,31.40625,31.67187,33400,29935,32.72464302157766,48.96696642688887,NaN,NaN,-250.6033451840119,-199.5297397403469,-0.2910756069239873,-0.2774880634772643,0.013587543446723013,-1487300,-1432960,50.20152440874063,76.05745732015528,NaN,NaN,-11.651968466515033,4.595228922109693
2000-12-22T09:30:00-05:00,31.84375,32.17187,31.60937,32.17187,39300,31565,39.20037757730661,47.86480162649031,NaN,NaN,-162.97731251072565,-225.21451942696504,-0.2703858392786213,-0.3243947556515536,-0.054008916372932314,-1448000,-1444400,46.652191587546916,73.89063476198926,NaN,NaN,-13.470231745298214,2.0144488267657064
2000-12-26T09:30:00-05:00,32.3125,33.15625,32.3125,33.07812,7500,30175,48.816979479703264,47.2765132988417,NaN,NaN,-60.44932923872561,-211.15286042622557,-0.1849166744435738,-0.28515475942739954,-0.10023808498382576,-1440500,-1451780,44.467991813618994,71.48487473546517,NaN,NaN,-11.568412407817524,0.07404007896810216
2000-12-27T09:30:00-05:00,33.03125,33.34375,32.875,33.07812,17800,25995,48.816979479703264,46.59064005306011,NaN,NaN,-30.54662379421141,-158.88287028343922,-0.1207387686161692,-0.25116154575403726,-0.13042277713786807,-1440500,-1454040,43.79183073301876,68.94417647104527,NaN,NaN,-10.136966694745606,-1.3846751744195702
2000-12-28T09:30:00-05:00,33.15625,33.21875,32.8125,32.8125,12200,24540,46.32623116459252,45.74465469437279,NaN,NaN,-40.308909789958605,-108.97710410352663,-0.08994618311357813,-0.24285550602984074,-0.1529093229162626,-1452700,-1453800,43.889404936075564,66.32418464922009,NaN,NaN,-9.771214608323223,-2.582752236405806
2000-12-29T09:30:00-05:00,32.76562,33.40625,32.71875,33.1875,18600,24360,50.19016121617363,45.98795114877452,NaN,NaN,-19.609309173728445,-62.778296901469936,-0.040605190483401,-0.20366581102051384,-0.16306062053711284,-1434100,-1443160,48.183929736781614,63.97334875699044,NaN,NaN,-8.223109620367277,-3.3885175769717306
2001-01-02T09:30:00-05:00,32.9375,33,32.64062,32.6875,7400,24055,45.488098993558125,45.80679142453149,NaN,NaN,-49.025620839922915,-39.9879585673094,-0.03797286037157349,-0.2105266960015797,-0.1725538356300062,-1441500,-1441860,48.700547551427405,61.6232857055576,NaN,NaN,-8.414825299237238,-4.1065615372953745
2001-01-03T09:30:00-05:00,33.4375,33.92187,32,32,77900,26950,39.94649102862179,45.13889845942197,NaN,NaN,-56.816343945577685,-39.26136150867982,-0.07663387025916574,-0.2683461734539634,-0.19171230319479765,-1519400,-1457640,43.08514615722993,58.84491779689563,NaN,NaN,-10.440406101865904,-5.011396475091164
2001-01-04T09:30:00-05:00,32,32,31,31.5,48400,28205,36.46696845809185,43.53826232529615,NaN,NaN,-153.27565471380686,-63.807167692598924,-0.12700959559329622,-0.3504742976864179,-0.2234647020931217,-1567800,-1483100,35.8939063625962,55.544407211874876,NaN,NaN,-13.298207781306864,-6.195226661693407
2001-01-05T09:30:00-05:00,31.32812,31.9375,31.1875,31.1875,35200,27700,34.44738422391032,41.993257574131114,NaN,NaN,-140.07728775685914,-83.76084328597902,-0.16983180632803652,-0.4357544600031673,-0.2659226536751308,-1603000,-1513160,29.60999805516552,51.842119085428855,NaN,NaN,-16.276350623420267,-7.635387227654387
2001-01-08T09:30:00-05:00,31.54687,31.71875,31.21875,31.65625,363900,44890,39.83028309670371,41.30568029915879,NaN,NaN,-116.87922308999407,-103.21482606923215,-0.15543017850309504,-0.46021037680399957,-0.3047801983009045,-1239100,-1474160,43.44400720146454,49.108757125163535,NaN,NaN,-17.01759683344192,-8.975702885624035
2001-01-09T09:30:00-05:00,31.4375,32.07812,31.4375,31.79687,52000,45280,41.38525857402031,40.975008398077016,NaN,NaN,-83.98486104256158,-110.20667410975989,-0.12650294761846165,-0.46290888282398157,-0.3364059352055199,-1187100,-1423280,55.68143075246658,47.44646987110896,NaN,NaN,-17.12621681674865,-10.140062018641837
2001-01-10T09:30:00-05:00,31.65625,32.09375,31.54687,31.71875,19600,45330,40.75513212941148,41.31286244098548,NaN,NaN,-74.02305236004437,-113.64801579265323,-0.10365891336360228,-0.4659795769100228,-0.3623206635464205,-1206700,-1360740,65.5489729523712,47.038839892715394,NaN,NaN,-17.398441228795857,-11.176973334378125
2001-01-11T09:30:00-05:00,31.53125,31.625,30.875,30.98437,30100,45975,35.3120134463511,41.40764299212329,NaN,NaN,-114.7022906940226,-105.93334298869635,-0.1274699513541772,-0.521658102739142,-0.3941881513849648,-1236800,-1294540,72.52291986586404,47.976700151026265,NaN,NaN,-19.348104924698823,-12.344277847281083
2001-01-12T09:30:00-05:00,31,31.28125,30.5625,31.21875,46900,46645,38.15112023878223,41.79524850763791,NaN,NaN,-115.58575131687711,-101.03503570069998,-0.11716074100824436,-0.5406390776452703,-0.42347833663702594,-1189900,-1211920,78.39979242272412,49.990862152025095,NaN,NaN,-20.0843495801044,-13.450002380541557
2001-01-16T09:30:00-05:00,30.71875,30.78125,30.0625,30.71875,43600,47285,34.65666851360952,41.47069786023097,NaN,NaN,-146.55549310197642,-106.97028970309641,-0.13260542879201803,-0.5892351226270485,-0.45662969383503044,-1233500,-1210800,78.46702769837714,52.26335044565582,NaN,NaN,-21.80504022071253,-14.643579214851696
2001-01-17T09:30:00-05:00,30.65625,31,30.5625,30.79687,28700,47280,35.64843128631553,40.53008727498899,NaN,NaN,-115.6707407028064,-113.30746563514538,-0.12618602253100397,-0.6143622219987854,-0.48817619946778146,-1204800,-1214340,77.64437001487546,54.63309174574557,NaN,NaN,-22.898351890565287,-15.822832454239352
2001-01-18T09:30:00-05:00,30.9375,31.51562,30.70312,31.34375,17700,47525,42.2558115436525,40.06143242241393,NaN,NaN,-72.40029912205252,-112.98291498754699,-0.07619637002305713,-0.5834216619966028,-0.5072252919735457,-1187100,-1210420,77.9204215848557,57.07084823516249,NaN,NaN,-21.839327303803252,-16.682331718462766
2001-01-19T09:30:00-05:00,30.96875,31.40625,30.90625,31.25,10300,46760,41.46973410342901,39.71453977518797,NaN,NaN,-66.4246318576402,-103.32738322027053,-0.04222811448320418,-0.560010435077551,-0.5177823205943468,-1197400,-1202540,78.49528134260952,59.542696549914915,NaN,NaN,-21.205958372715557,-17.328564097641735
2001-01-22T09:30:00-05:00,31.25,31.46875,30.9375,31.1875,19800,46515,40.92316941325631,39.052611789265306,NaN,NaN,-60.14312519521456,-92.23885799593802,-0.01799188385311601,-0.5402721754107418,-0.5222802915576258,-1217200,-1208000,76.99935798484479,61.60094142477657,NaN,NaN,-20.83717144841436,-17.82979371918068
2001-01-23T09:30:00-05:00,31.42187,31.60937,31.125,31.15625,41600,46925,40.634790808215165,38.70594691888367,NaN,NaN,-47.74716009928887,-72.47719139540051,0.0009093079830686523,-0.5211436565787899,-0.5220529645618586,-1258800,-1213060,75.56217261648871,63.5196289294238,NaN,NaN,-20.608176146867038,-18.226705494564445
2001-01-24T09:30:00-05:00,31.21875,31.48437,30.98437,31.20312,17900,45855,41.30288872679543,38.80283246875321,NaN,NaN,-50.48653414786201,-59.44035008441163,0.020459132551928993,-0.49647904887194727,-0.5169381814238763,-1240900,-1220280,73.45538533234641,65.68893172764642,NaN,NaN,-20.242033542107997,-18.514609501356382
2001-01-25T09:30:00-05:00,31.46875,31.51562,31,31.42187,16300,46295,44.445325272825194,39.37271509837702,NaN,NaN,-37.68490781374699,-52.49727182275052,0.05031302299851015,-0.45404690267573855,-0.5043599256742487,-1224600,-1227780,71.23356130809799,68.21319279518227,NaN,NaN,-19.09710950382459,-18.59782378742327
2001-01-26T09:30:00-05:00,31.46875,31.46875,30.40625,31.125,25700,46690,41.220088225970954,39.85647966995278,NaN,NaN,-67.69416921818815,-52.751179294860115,0.05203997467153937,-0.4393099573348245,-0.49134993200636384,-1250300,-1238360,68.10410842928582,70.96277210761943,NaN,NaN,-18.927559132150034,-18.64492883666995
2001-01-29T09:30:00-05:00,31.5,31.75,31.33,31.61,52800,48720,47.87499219967801,40.43110174873666,NaN,NaN,8.99707085804424,-38.923140084208356,0.08582548355054392,-0.38406807756818395,-0.4698935611187279,-1197500,-1234420,68.65634933804881,72.76365368880401,NaN,NaN,-16.877616392593758,-18.39245563037335
2001-01-30T09:30:00-05:00,31.25,31.61,31.23,31.61,8900,48235,47.87499219967801,40.89465415056936,NaN,NaN,11.495080291317326,-27.074692006087112,0.10678640221615904,-0.33641055834852907,-0.4431969605646881,-1197500,-1222160,70.37516274925129,73.81320597428864,NaN,NaN,-15.194326954830437,-17.93558010529579
2001-01-31T09:30:00-05:00,31.25,31.34,31.13,31.32001,8400,48285,44.38994904711424,41.15428393040526,NaN,NaN,-18.056290840157313,-20.58864334454617,0.09986043805509187,-0.3183714129958233,-0.41823185105091515,-1205900,-1215160,71.34149169747776,74.22695731322482,NaN,NaN,-14.654760945907801,-17.46689165395465
2001-02-01T09:30:00-05:00,31.45,31.7,31.28,31.7,14800,45130,49.570305133640346,42.17273333664021,NaN,NaN,76.83729882187286,2.3157979825777915,0.11834754274943549,-0.2702974226141208,-0.3886449653635563,-1191100,-1208460,72.27371955037889,74.20915729069017,NaN,NaN,-12.687519607969506,-16.784124218813915
2001-02-02T09:30:00-05:00,31.36,31.60001,31.35001,31.35001,9100,43165,45.377408451829005,42.68889678042927,NaN,NaN,42.39659674230717,24.33395117467685,0.10493858587003252,-0.25747173302601567,-0.3624103188960482,-1200200,-1198440,73.65398020798678,73.87017070392321,NaN,NaN,-12.175199317197126,-16.1257063757258
2001-02-05T09:30:00-05:00,31.64999,31.64999,31.36,31.58,7800,41795,48.46240523794879,43.67502083216779,NaN,NaN,67.57248693396981,36.049034389861966,0.10901450759934783,-0.2261421843968634,-0.33515669199621123,-1192400,-1197420,73.79698084279423,73.53659592852443,NaN,NaN,-10.839640648796296,-15.370554129021587
2001-02-06T09:30:00-05:00,31.53999,31.89999,31.53999,31.77,38400,25520,50.92812868805026,44.76642778943455,NaN,NaN,117.73330182998723,57.29667869759594,0.1210354114597722,-0.18386242767149596,-0.30489783913126817,-1154000,-1188720,75.04134609333677,73.35066564841452,NaN,NaN,-8.995977640934344,-14.459900345009123
2001-02-07T09:30:00-05:00,31.92,31.97,31.7,31.78,7300,23285,51.06083996033544,45.39535839062619,NaN,NaN,137.3385498769602,88.37564684101945,0.12564287688328774,-0.14784424302715848,-0.2734871199104462,-1146700,-1176880,76.66544752656588,73.26102464425095,NaN,NaN,-7.447172733440068,-13.458082114784972
2001-02-08T09:30:00-05:00,32.06,32.13,31.91,32.06,14300,23020,54.7508561698285,46.34400996679759,NaN,NaN,181.86310440463936,109.38080795757273,0.14230661546515147,-0.09560385057900689,-0.23791046604415836,-1132400,-1165140,78.18151215955888,73.23861255974735,NaN,NaN,-5.042228519006376,-12.255817315388029
2001-02-09T09:30:00-05:00,32.25,32.44,31.95,32.02,230100,33020,54.1230284372273,47.28685703993837,NaN,NaN,170.87657655728617,135.07680392056855,0.14490745379789244,-0.056776148796792825,-0.20168360259468526,-1362500,-1197600,65.50847197917906,72.41783498791408,NaN,NaN,-3.205536968597378,-10.962920122989365
2001-02-12T09:30:00-05:00,32.10001,32.71001,31.96001,32.05,10900,31220,54.5440326406694,48.28037431368511,NaN,NaN,165.63703167809035,154.68971286939265,0.14269456152332008,-0.02331540069053517,-0.16600996221385525,-1351600,-1229440,55.931232216535456,71.015624959346,NaN,NaN,-1.5504162699217732,-9.61827671540828
2001-02-13T09:30:00-05:00,32.12,32.49001,31.78999,32.32001,31300,30605,58.25698032940936,49.49138085672895,NaN,NaN,142.4613205814323,159.63531661968167,0.15257216735423013,0.024705246978932394,-0.12786692037529773,-1320300,-1262700,48.03164777843686,69.19964370549532,NaN,NaN,0.9447711495435462,-8.109269877558019
2001-02-14T09:30:00-05:00,32.2,32.2,31.78,31.78,11100,29725,49.54128859248631,49.855378236704745,NaN,NaN,75.60221156387692,147.288048957065,0.1174687358689972,0.018968999460948766,-0.09849973640804843,-1331400,-1299640,41.09023579375878,67.04654902589965,NaN,NaN,0.7510185812365183,-6.843514383444513
2001-02-15T09:30:00-05:00,31.89999,32.12,31.60001,31.83,20300,29855,50.2829608490033,50.50272628120705,NaN,NaN,53.24806948303564,121.56504197274428,0.09339756632416876,0.018247221497162514,-0.07515034482700625,-1311100,-1335380,35.71267792081048,64.73287541815141,NaN,NaN,0.8004899682319676,-5.751513761776445
2001-02-16T09:30:00-05:00,31.97,32.3,31.87,32.00999,29000,30790,52.9632184258591,50.86617101164857,NaN,NaN,86.69893083961249,104.72951282920954,0.08558584149003637,0.031831957035539205,-0.05375388445449716,-1282100,-1319300,39.546102676818954,62.65357208520643,NaN,NaN,1.596006382972892,-4.701868026812254
2001-02-20T09:30:00-05:00,32.11,32.55,32.07001,32.16,19600,30780,55.134138356692056,51.38468145143528,NaN,NaN,114.17053221606017,94.4362129368035,0.08626640412060135,0.054079120696254535,-0.03218728342434682,-1262500,-1301480,43.56249175609822,60.73838129998121,NaN,NaN,2.8825165396011174,-3.618384517324629
2001-02-21T09:30:00-05:00,32.25,32.3,31.78,31.78,9000,29150,48.96858788770083,51.711727082905746,NaN,NaN,46.92517909675698,75.32898463986844,0.05821347320853165,0.040579558086317746,-0.017633915122213906,-1271500,-1291720,45.69069226082759,58.90618134022048,NaN,NaN,2.229973958755662,-2.782904735027445
2001-02-22T09:30:00-05:00,31.85001,32.23,31.81,32.12,24400,29475,53.932518882785004,52.023313779273224,NaN,NaN,61.86422812659527,72.5813879524121,0.059437563865790376,0.056663039710024066,-0.00277452415576631,-1247100,-1274860,49.25082455894152,57.26168884083209,NaN,NaN,3.1556426947461116,-1.9345408164883655
2001-02-23T09:30:00-05:00,31.67999,31.94,31.2,31.94,9900,29155,51.09867414210421,52.43197561429288,NaN,NaN,-22.530085078690274,57.42575704006691,0.04562710018135895,0.05425935107093238,0.00863225088957343,-1257000,-1264040,51.45036626807966,55.675716416553016,NaN,NaN,3.0810453913945794,-1.2180285010765162
2001-02-26T09:30:00-05:00,32,32.42,32,32.3,16700,28705,56.070298218462625,52.975396541472435,NaN,NaN,100.30079550486403,60.14612997311724,0.05747478150113858,0.08047572776599665,0.023000946264858074,-1240300,-1255680,53.14028775835172,54.20023833909284,NaN,NaN,4.550057040182603,-0.3940162808966421
2001-02-27T09:30:00-05:00,32.55,32.67,32.31,32.34,13600,26745,56.59828939990999,53.38040802089098,NaN,NaN,135.03496652984649,64.3190168358745,0.06423076692188665,0.10328940491721639,0.03905863799532974,-1226700,-1248520,54.5979192936756,52.73999356768847,NaN,NaN,5.891421382767881,0.5039033853411468
2001-02-28T09:30:00-05:00,32.42,32.42,31.75,31.97,15500,27075,50.54647370724413,53.3436675742416,NaN,NaN,32.80118590386278,61.494218197295666,0.041129579000569884,0.0904706117460421,0.04934103274547221,-1242200,-1242660,55.809483659078985,51.250281862867986,NaN,NaN,5.229292764969063,1.1789590110022776
2001-03-01T09:30:00-05:00,31.8,31.86,31.55,31.62,9400,27125,45.58144792466228,52.68870984244402,NaN,NaN,-78.1906075570526,33.48325106056608,0.0017081063479011324,0.05147616568034863,0.049768059332447497,-1251600,-1243560,55.56424117893033,49.634762507108796,NaN,NaN,3.0799495023090087,1.4505290811889535
2001-03-02T09:30:00-05:00,30.99001,31.89999,30.89999,31.7,15600,27165,46.86616770722341,52.17036264744373,NaN,NaN,-127.1459686069745,12.560074354909244,-0.0184383635388548,0.026720104908878994,0.045158468447733795,-1236000,-1239360,56.524360346238986,48.993040247613074,NaN,NaN,1.7199875878285076,1.4890231535660328
2001-03-05T09:30:00-05:00,31.8,31.82001,31.38,31.64,43200,28870,45.989240363402416,51.55930605621038,NaN,NaN,-101.40416032256626,-27.78091681057681,-0.034339972043141424,0.0022335033938070126,0.03657347543694844,-1279200,-1247140,54.188666107457905,48.868571239821826,NaN,NaN,0.35077303829791284,1.3264159942420157
2001-03-06T09:30:00-05:00,31.71001,31.85001,31.59,31.60001,13300,29145,45.379771792811596,50.639505446453406,NaN,NaN,-86.64892536030904,-72.11769518860791,-0.04539213588002954,-0.020166694413088493,0.02522544146694105,-1292500,-1260300,50.39524651662059,49.03739972112066,NaN,NaN,-0.9512542263660455,1.0010345341551499
2001-03-07T09:30:00-05:00,31.50999,31.66,31.24001,31.45,32700,28860,43.073760862904514,50.177539180054694,NaN,NaN,-143.66456888214503,-107.4108461458095,-0.0597431505712457,-0.04945349674711608,0.010289653824129621,-1325200,-1276900,46.01904873832137,49.38945778858941,NaN,NaN,-2.7164776204624226,0.4699613692097825
2001-03-08T09:30:00-05:00,31.64999,32.06,31.55,32.03999,54800,31235,53.15609847961089,50.38276329652666,NaN,NaN,-18.702038326041354,-95.51313229960725,-0.028048279214535222,-0.024770695194039405,0.003277584020495816,-1270400,-1280660,45.06448222904101,50.05744381060588,NaN,NaN,-1.311069517053798,0.21552838545784242
2001-03-09T09:30:00-05:00,31.85001,31.95,31.48,31.48,10300,31035,45.00796039453832,49.81453058000375,NaN,NaN,-81.80553704357985,-86.4450459869283,-0.04247934540496567,-0.049821597735711265,-0.007342252330745601,-1280700,-1289600,42.79167699908831,50.28927054791084,NaN,NaN,-2.756743303022026,-0.2090818557535673
2001-03-12T09:30:00-05:00,31.48,31.88,31.48,31.84,19000,20480,50.28400359992422,49.46809238309176,NaN,NaN,-49.16036255474652,-75.99628643336436,-0.02625632374965398,-0.040162657017813075,-0.013906333268159096,-1261700,-1286100,43.98282102627216,50.319294067208965,NaN,NaN,-2.1930313018745604,-0.4925032051994234
2001-03-13T09:30:00-05:00,30.92,31.17,30.85001,31.10001,160800,27975,41.475398898768105,48.932864598168,NaN,NaN,-207.17898130698097,-100.10229762269874,-0.06180929985329811,-0.09116795808478173,-0.029358658231483623,-1422500,-1312100,37.70270636593092,49.748723646144924,NaN,NaN,-4.923081998142638,-1.1254430327627396
2001-03-14T09:30:00-05:00,30.5,30.71001,29.75999,30.03,45100,28665,32.5862798282557,47.40813323713019,NaN,NaN,-322.89934779065163,-135.94925340440005,-0.14887095204463785,-0.21544734828728096,-0.0665763962426431,-1467600,-1340580,32.26765966841754,48.535640439678936,NaN,NaN,-11.051061796028398,-2.5433885703721195
2001-03-15T09:30:00-05:00,30.2,30.59,30.2,30.56,3600,28290,39.50263557642805,46.579844768153315,NaN,NaN,-211.89011722247625,-174.58686918368704,-0.16120512155032893,-0.26808279818055425,-0.10687767663022532,-1464000,-1379300,26.644094134514475,46.763763858709986,NaN,NaN,-13.082029425069003,-4.048908692471674
2001-03-16T09:30:00-05:00,30.14999,30.5,29.97,30.10001,274900,41020,36.046074685545015,45.14954308723063,NaN,NaN,-196.94809217732953,-197.61538021043697,-0.18886640499622248,-0.3429606828755034,-0.15409427787928093,-1738900,-1470940,18.44903145791352,44.28581698010726,NaN,NaN,-16.003096048852,-5.756649743383149
2001-03-19T09:30:00-05:00,29.85001,30.48,29.39999,30.48,79300,43535,40.66496651912979,44.01144859574633,NaN,NaN,-165.28128490597814,-220.8395646806833,-0.17064835034366593,-0.36740471580886336,-0.19675636546519742,-1659600,-1550520,14.327745742918992,41.409376012196084,NaN,NaN,-16.555825124790484,-7.299389083584197
2001-03-20T09:30:00-05:00,30.09,30.35001,29.95,30.03999,18700,43490,37.30515795962712,43.065640328059395,NaN,NaN,-136.10410403162413,-206.6245892256119,-0.17657057815171479,-0.4174695881548409,-0.24089901000312613,-1678300,-1601680,12.408656392427048,38.30931692172094,NaN,NaN,-18.217889865879435,-8.859174909626374
2001-03-21T09:30:00-05:00,30.05,30.10001,29.3,29.37,44500,45265,32.85400165426056,42.15653702303071,NaN,NaN,-155.36742701180594,-173.1182050698428,-0.21158736062399153,-0.5053832107831155,-0.293795850159124,-1722800,-1652720,10.847608757197904,35.11527174874006,NaN,NaN,-21.244153677976314,-10.628457590819222
2001-03-22T09:30:00-05:00,29.25999,29.25999,28.37,29,229100,55500,30.677111507674752,41.00017586592009,NaN,NaN,-178.94238466272589,-166.52865855789273,-0.24337749734168368,-0.5980177218362286,-0.3546402244945449,-1951900,-1750300,8.61594342455517,31.693241968619784,NaN,NaN,-24.40980434949107,-12.59722141348663
2001-03-23T09:30:00-05:00,28.41,28.97,28.3,28.95,99000,59955,30.38412478917182,39.88552475347505,NaN,NaN,-156.93203873151634,-158.52544786873008,-0.2505023845451693,-0.6677682051760065,-0.4172658206308372,-2050900,-1812700,7.546734479266306,28.361675423748956,NaN,NaN,-26.92374121544346,-14.643867099480461
2001-03-26T09:30:00-05:00,29.75,30.06,29.58,29.91,118600,65050,41.864603985853456,39.634441338692326,NaN,NaN,-69.74218263364084,-139.41762741426265,-0.17676728677627218,-0.6382249291011775,-0.46145764232490527,-1932300,-1867240,6.757410535961213,25.244687139416147,NaN,NaN,-25.103620082425937,-16.13811752561553
2001-03-27T09:30:00-05:00,30.5,31.06,30.5,31.00999,28600,65800,51.69452960098523,40.25021053426952,NaN,NaN,7.314561141253189,-110.73389437968717,-0.04687930945068519,-0.5200567791382618,-0.47317746968757657,-1903700,-1912320,6.181877741089039,22.399174925328122,NaN,NaN,-19.74780407742761,-16.653787033017256
2001-03-28T09:30:00-05:00,30.95,30.95,30.14999,30.35001,10600,65555,46.60297971604965,39.78213062258658,NaN,NaN,-16.104056557891234,-82.88122028890423,-0.0008150638423621848,-0.4741962994905293,-0.47338123564816714,-1914300,-1950620,5.734967523654404,19.589923874943366,NaN,NaN,-17.34721384631311,-16.752848006345236
2001-03-29T09:30:00-05:00,30.14999,31.06,30.12,31.06,21100,66140,52.07190198216822,40.28669787884586,NaN,NaN,9.482972229517232,-45.19614891045559,0.07772546938443387,-0.3762243989176248,-0.4539498683020587,-1893200,-1938880,7.932129015258681,17.099956161812674,NaN,NaN,-13.358980784261904,-16.2680098317619
2001-03-30T09:30:00-05:00,31.2,31.38,31.03,31.28999,9600,65840,53.72527181352835,40.532502751246156,NaN,NaN,53.239968093597604,-3.16174754543281,0.14169465528696412,-0.2768315491933535,-0.41852620448031763,-1883600,-1905420,14.078988183977245,14.963968101648756,NaN,NaN,-9.72576036928275,-15.333402765693451
2001-04-02T09:30:00-04:00,31.28999,31.92999,31.10001,31.39,55500,66455,54.46094176325179,41.460041527280694,NaN,NaN,75.46554826270032,25.879798633835417,0.1845594618271737,-0.1878268771963505,-0.3723863390235242,-1828100,-1884580,17.761765035629452,13.539615149484364,NaN,NaN,-6.676157304994394,-14.096653414165015
2001-04-03T09:30:00-04:00,31.5,31.5,31.07001,31.24001,16300,66605,53.09756065754007,42.92513301508672,NaN,NaN,61.030012346062954,36.62288887479737,0.19557434395281892,-0.12791840908250052,-0.32349275303531944,-1844400,-1872720,19.866804023794174,12.653839746296983,NaN,NaN,-4.659601258144496,-12.748503106162083
2001-04-04T09:30:00-04:00,31.10001,31.46001,30.92,31.36,9600,65450,54.08777206100039,43.96692847827046,NaN,NaN,60.675778384939534,51.97885586336353,0.20283263155573233,-0.06995196359065403,-0.27278459514638637,-1834800,-1856820,22.72265584496833,12.373737011329398,NaN,NaN,-2.7325410696185366,-11.317651386655863
2001-04-05T09:30:00-04:00,30.95,31.14999,30.78,31.14999,5300,62975,52.01780185745768,45.10776613340708,NaN,NaN,47.21004128054176,59.524269673568426,0.18583374140326278,-0.04049241839230788,-0.22632615979557066,-1840100,-1846200,24.65415528977887,12.816960142176926,NaN,NaN,-1.7185630808238883,-9.946353057251295
2001-04-06T09:30:00-04:00,31.10001,31.36,29.94,30.57001,391000,82010,46.70211623994842,45.538991113465556,NaN,NaN,13.87385045662398,51.6510461461737,0.1304878583148947,-0.06321633690195227,-0.19370419521684698,-2231100,-1915700,20.961709927271215,13.290814726773508,NaN,NaN,-2.4056805087204878,-8.869114121746895
2001-04-09T09:30:00-04:00,30.75,31.34,30.75,31.24001,20700,82095,52.71370234376614,46.63960142661835,NaN,NaN,71.63228584619502,50.88439366287264,0.13348154079996383,-0.02685226921689221,-0.16033381001685604,-2210400,-1992160,17.80274320777295,13.676106642155363,NaN,NaN,-1.1492195143961983,-7.76627203498251
2001-04-10T09:30:00-04:00,31.3,31.99001,31.3,31.89,17500,74930,57.69854000339445,48.414211308699336,NaN,NaN,129.00548219608172,64.4794876328764,0.17130317609355158,0.05379516010008345,-0.11750801599346813,-2192900,-2061860,15.508353419494853,14.009016975176573,NaN,NaN,1.5428967104709215,-6.43639078563202
2001-04-11T09:30:00-04:00,31.89,32,31.17,31.46001,93200,77335,53.66796334153643,50.05641501111802,NaN,NaN,98.10863895800573,71.96605974748964,0.15965938969938473,0.08206622113076278,-0.07759316856862195,-2286100,-2152120,13.145648324676614,14.332567325185247,NaN,NaN,2.5117163357521397,-5.1580897682914255
2001-04-12T09:30:00-04:00,31.5,31.56,31.06,31.44,24200,78365,53.48073433185875,51.706172835595666,NaN,NaN,71.88587077434428,76.90122564625014,0.14342209158609157,0.1016844459139925,-0.041737645672099054,-2310300,-2246160,11.226569278406046,14.595412667980941,NaN,NaN,3.2233403540984487,-3.960742607950015
2001-04-16T09:30:00-04:00,31.39999,31.94,31.39999,31.94,11500,65195,57.473091919455406,52.82106483085295,NaN,NaN,100.72571888854448,94.27159933263424,0.15801579072011604,0.155782092728046,-0.002233697992070037,-2298800,-2259700,10.978068632083662,14.896888246275404,NaN,NaN,5.048478605143564,-2.673711006079504
2001-04-17T09:30:00-04:00,32,32.67999,32,32.67999,30200,62740,62.59017832724663,53.59932545415733,NaN,NaN,148.45595136469115,109.63633243633346,0.20612418699877694,0.25542153575640114,0.0492973487576242,-2268600,-2271340,10.75761589523215,15.223726685857054,NaN,NaN,8.300411110796462,-1.1059792750972233
2001-04-18T09:30:00-04:00,32.60001,32.64999,31.89999,32,573400,90475,55.930284179180134,54.26556148723808,NaN,NaN,113.54281196279632,106.54379838967638,0.18162741954721934,0.2763316231916484,0.09470420364442904,-2842000,-2401160,8.66716517382065,15.433169375154645,NaN,NaN,8.94631835531364,0.33006324353289984
2001-04-19T09:30:00-04:00,32.45,32.99001,31.8,32.06,56400,91070,56.371413261591094,54.57266943576828,NaN,NaN,116.02352778214643,110.12677615450453,0.15971777051395894,0.2943514167868777,0.13463364627291877,-2785600,-2501060,7.46500444143733,15.399803334167403,NaN,NaN,9.590927741060426,1.6530438860368322
2001-04-20T09:30:00-04:00,31.85001,31.94,31.39999,31.67999,33600,81295,52.768695374055895,54.50434254723454,NaN,NaN,54.447090703491234,106.63902014033393,0.11213377782778619,0.2748008685576515,0.16266709072986532,-2819200,-2602840,6.479007457818909,14.856947568013236,NaN,NaN,9.037032630160237,2.7078994209116045
2001-04-23T09:30:00-04:00,31.67999,31.75,31.34,31.75,322500,92470,53.360091880676805,54.4257104127649,NaN,NaN,39.907706368062264,94.47541763623747,0.07941568496931095,0.261936696941504,0.18252101197219306,-2496700,-2642420,6.139405739912945,14.026779046890628,NaN,NaN,8.758097039671158,3.5722133664486835
2001-04-24T09:30:00-04:00,32,32.45,31.87,31.89999,15900,87335,54.66965005439705,54.5380025125404,NaN,NaN,96.10044400100409,84.00431616350006,0.06265351895617527,0.26083791066741213,0.19818439171123686,-2480800,-2684860,5.789016732936375,13.021222811829357,NaN,NaN,8.890671231787213,4.3319930614970446
2001-04-25T09:30:00-04:00,32.25,32.49001,31.75999,32.46001,197600,95785,59.26825442021652,54.908036966770126,NaN,NaN,108.53827687316965,83.00340914557472,0.08279527586455254,0.3016784865419275,0.21888321067737498,-2283200,-2573100,18.913140519260438,12.749114574278792,NaN,NaN,10.34846246951024,5.191488691213215
2001-04-26T09:30:00-04:00,32.60001,32.99001,32.60001,32.75,83900,99450,61.44915109078641,55.58170476915075,NaN,NaN,168.57619239043837,93.51394206723312,0.10759044159038714,0.3533712626653589,0.24578082107497176,-2199300,-2455840,29.94077341532106,13.126730154674663,NaN,NaN,12.219088344336221,6.195431498802216
2001-04-27T09:30:00-04:00,32.64999,33,32.60001,32.77,18200,99305,61.60185283330476,56.645971668676204,NaN,NaN,148.77848268073248,112.38022046268136,0.1165271188182499,0.3914397195977841,0.2749126007795342,-2181100,-2328220,39.57280290785666,14.456093939002196,NaN,NaN,13.790621860836705,7.280458693378571
2001-04-30T09:30:00-04:00,32.7,33.27,32.7,32.8,176500,107650,61.84598568705429,57.29827762176821,NaN,NaN,141.30483587196545,132.659646363462,0.11542811506149842,0.41919774460640724,0.3037696295449088,-2004600,-2229800,45.76546892577509,16.45343149028806,NaN,NaN,15.162640516694642,8.40648466813801
2001-05-01T09:30:00-04:00,33,33.14999,32.82001,33.11,121300,110940,64.36709844142159,57.77460322448444,NaN,NaN,131.55143776968725,139.74984511719862,0.12570241432599738,0.4608976474524056,0.3351952331264082,-1883300,-2110300,52.17426027213396,19.07242483690514,NaN,NaN,17.05435932912602,9.641895333993439
2001-05-02T09:30:00-04:00,33.10001,33.10001,32.62,32.69,58800,113065,58.707116316805276,58.134542722717924,NaN,NaN,94.5087020744571,136.94393015745612,0.0956932880256754,0.4548118431585024,0.35911855513282703,-1942100,-2042080,55.41342370561042,22.091551649828983,NaN,NaN,17.182113872511735,10.719069410924623
2001-05-03T09:30:00-04:00,32.60001,32.60001,31.89999,32.27,36600,114415,53.62864894362309,58.145108052129665,NaN,NaN,28.726843141063526,108.97406030758115,0.04179031462918509,0.4113564484193084,0.3695661337901233,-1978700,-1997960,57.42189648689949,25.391217879007087,NaN,NaN,15.835217247251023,11.449947673256966
2001-05-04T09:30:00-04:00,32.35001,32.66,32,32.60001,13800,114840,56.79146512281068,58.096420423797895,NaN,NaN,42.89519836755154,87.79740344494496,0.02350546116897434,0.39894796025134127,0.37544249908236693,-1964900,-1954720,59.35435725549974,28.84666706639395,NaN,NaN,15.571636910568376,12.03876042144431
2001-05-07T09:30:00-04:00,32.8,32.82001,32.50999,32.77,11300,95855,58.36670236391903,57.794743569274495,NaN,NaN,74.03651083997545,74.34373843854698,0.01823820121507047,0.39824025060120505,0.3800020493861346,-1953600,-1944520,59.817653559979476,32.35095547101876,NaN,NaN,15.792075297949504,12.574948260945053
2001-05-08T09:30:00-04:00,33,33,32.3,32.3,24600,96050,52.65132509334566,57.56053220600061,NaN,NaN,44.48001954978153,56.92945479456582,-0.019478000067697898,0.3556545493015122,0.3751325493692101,-1978200,-1963500,58.481837772673366,35.90914637093681,NaN,NaN,14.307758207188359,12.82249253897981
2001-05-09T09:30:00-04:00,32.55,32.55,32.00999,32.35001,21900,96270,53.176719283501285,57.33233977899419,NaN,NaN,3.0654554966031635,38.640805478995034,-0.042325205876652006,0.3222260420233951,0.3645512479000471,-1956300,-1966340,58.27214425111401,39.53822778591372,NaN,NaN,13.235992385046858,12.881563945560817
2001-05-10T09:30:00-04:00,32,32.5,32,32.37,11800,92200,53.399311713580914,57.37738380324597,NaN,NaN,-6.210443001190176,31.653348250544298,-0.056474463663318875,0.2939581683208985,0.35043263198421737,-1944500,-1959500,58.65664059050715,43.265201581105735,NaN,NaN,12.407981498248457,12.81390931023048
2001-05-11T09:30:00-04:00,32.55,32.55,32.17999,32.39,13500,91665,53.636790014481754,57.397147955660614,NaN,NaN,-0.1093889777498319,23.052430781484023,-0.06430093376022078,0.2700564647839414,0.3343573985441622,-1931000,-1952720,59.05933840543264,47.045196771499995,NaN,NaN,11.773962548864802,12.665345487178241
2001-05-14T09:30:00-04:00,32.8,32.82001,32.49001,32.82001,14900,91835,58.530050660462415,57.67289085609385,NaN,NaN,65.72745581067261,21.390619775623456,-0.04144169135415604,0.28255528435146715,0.3239969757056232,-1916100,-1945220,59.528945108870985,50.88376308406676,NaN,NaN,12.516846554756853,12.644131353975185
2001-05-15T09:30:00-04:00,33.08,33.08,32.53,32.60001,31400,91895,55.313539159463865,57.39041119461153,NaN,NaN,65.10669509791067,25.515954885249286,-0.04193522375303266,0.2715779460143324,0.31351316976736504,-1947500,-1939080,59.93412312561369,53.813833270234845,NaN,NaN,12.283190742589928,12.592568409491577
2001-05-16T09:30:00-04:00,32.82001,33.36,32.5,33.3,27000,64575,62.394763742970774,57.45795495548184,NaN,NaN,117.21010804882151,48.34488539569296,0.0017672401958150896,0.3157222200121339,0.3139549798163188,-1920500,-1931920,60.43160710056162,55.99174996203774,NaN,NaN,14.201565311328729,12.822425109754027
2001-05-17T09:30:00-04:00,33.39999,33.39999,32.95,33.10001,33200,63415,59.49403600179521,57.30739661037402,NaN,NaN,120.90201781166033,73.76737755826306,0.01344129408109096,0.3307565974176825,0.3173153033365915,-1953700,-1933760,60.22465575522726,57.4668823082785,NaN,NaN,14.9461930350666,13.125820527655824
2001-05-18T09:30:00-04:00,33.14999,33.3,33,33.3,26600,63065,61.425318716877115,57.27734896964707,NaN,NaN,121.92412923066915,98.17408119994687,0.029923741582490948,0.3547199803147052,0.32479623873221425,-1927100,-1932980,60.28674281325481,58.504116157384196,NaN,NaN,16.139150693655886,13.556296265655833
2001-05-21T09:30:00-04:00,33.3,33.55,33.10001,33.42,23600,48120,62.57826339213455,57.149575037555145,NaN,NaN,149.07388518593933,114.8433670750002,0.04338298272564123,0.3790249671392658,0.3356419844136246,-1903500,-1930460,60.501259462054236,59.098901813807075,NaN,NaN,17.462815455667496,14.114370435657499
2001-05-22T09:30:00-04:00,33.42,33.50999,33.25999,33.3,10600,47855,60.62682158315919,57.28669684229471,NaN,NaN,137.56447947597553,129.33492395061316,0.038826663122281,0.3841753133164758,0.3453486501941948,-1914100,-1923780,61.1010831448878,59.50516320232689,NaN,NaN,18.036786907218804,14.674715645880543
2001-05-23T09:30:00-04:00,33.5,33.53,33.14999,33.28999,15900,38770,60.45745820890198,57.774468932671766,NaN,NaN,117.0754403081422,129.30799040247732,0.030148199889198757,0.38303390005569327,0.3528857001664945,-1930000,-1925680,60.818181408761724,59.7477549824599,NaN,NaN,18.467769203152642,15.216580439776557
2001-05-24T09:30:00-04:00,33.19,33.28,33.03,33.2,14200,35285,58.86539745911098,57.92260695669322,NaN,NaN,73.36782968620804,119.80115277738687,0.01416814567331931,0.37059588225814366,0.35642773658482435,-1944200,-1923780,61.01258123384416,59.86619955234165,NaN,NaN,18.421563951488594,15.674435227163992
2001-05-25T09:30:00-04:00,33,33.22,32.66,32.67999,12300,34990,50.577092243083,57.36620623377636,NaN,NaN,5.584296708376896,96.53318627292842,-0.033025867332245495,0.3151454024195175,0.348171269751763,-1956500,-1929660,60.02011326433884,59.88066095979589,NaN,NaN,16.002496969667572,15.721301190378789
2001-05-29T09:30:00-04:00,32.78,32.78,32.41,32.66,21300,27230,50.28398864043361,57.19711077285407,NaN,NaN,-40.816551509147324,58.55509893391106,-0.06532481595195072,0.2665152498118246,0.33184006576377534,-1977800,-1944520,57.475588432394126,59.8087860069188,NaN,NaN,13.926261526805133,15.464866952725409
2001-05-30T09:30:00-04:00,32.5,32.95,32.2,32.52,44500,23390,48.17818599030309,56.84007268048278,NaN,NaN,-48.63721953016728,21.314759132682504,-0.09410453188716933,0.21420940090481366,0.308313932791983,-2022300,-1966160,53.89247047359854,59.495952165667696,NaN,NaN,11.562595305599936,14.907399574564627
2001-05-31T09:30:00-04:00,32.64999,33.03,32.63,33.03,69500,23925,55.490683009203714,56.98945634445583,NaN,NaN,21.467672029102236,2.1932054768745113,-0.07747381594403513,0.21147166286193908,0.2889454788059742,-1952800,-1970720,53.140679593283984,59.10195495158032,NaN,NaN,11.4719831459207,14.416625799044066
2001-06-01T09:30:00-04:00,32.7,32.89,32.44,32.75,18700,23030,51.21756799780983,56.816654771836404,NaN,NaN,-26.71375332638038,-17.823111125643173,-0.08349190657457067,0.18458059558776085,0.2680725021623315,-1971500,-1976180,52.20167889551628,58.612122129443435,NaN,NaN,10.116686574909412,13.80234876702483
2001-06-04T09:30:00-04:00,32.85001,32.85001,32.35001,32.77,13100,22995,51.50483096155392,56.31485336477151,NaN,NaN,-38.753538844107815,-26.690678236140123,-0.0840547580408541,0.16300405461126388,0.247058812652118,-1958400,-1976560,52.13263518448665,58.0838142777017,NaN,NaN,9.09513543649169,13.12988971980581
2001-06-05T09:30:00-04:00,32.89999,32.89999,32.2,32.28999,251100,34985,44.701205508823364,55.5568295325829,NaN,NaN,-77.35385432942928,-33.998138800196514,-0.11288675796996367,0.10595036518966339,0.21883712315962706,-2209500,-2022900,44.41738886669368,56.97547611635026,NaN,NaN,6.078226538002774,12.122509265262519
2001-06-06T09:30:00-04:00,32.10001,32.39999,31.89,32.03,18200,34665,41.50329674709654,54.064581890020456,NaN,NaN,-142.16808908324333,-52.70431271081172,-0.14362743726303218,0.039302826580836836,0.182930263843869,-2227700,-2063980,38.91871791389482,55.43884117444549,NaN,NaN,2.517984629007314,10.75043431722606
2001-06-07T09:30:00-04:00,32.10001,32.10001,31.58,31.75999,25500,34845,38.428554137842,52.5599046140238,NaN,NaN,-185.14799912041303,-94.02744694071478,-0.1742650596081523,-0.03490106066632137,0.13936399894183094,-2253200,-2124060,32.56852437646292,53.463403218819465,NaN,NaN,-1.4769391541907562,9.00366667845223
2001-06-08T09:30:00-04:00,31.52,32.41,31.52,31.88,14300,34970,40.537153806278454,51.06789283469533,NaN,NaN,-150.85465664932406,-118.85562760530351,-0.17794466250202773,-0.08306682918570374,0.09487783331632399,-2238900,-2177540,28.16338681651652,51.16887779048102,NaN,NaN,-4.151181342110832,7.12440267551465
2001-06-11T09:30:00-04:00,31.50999,32.23,31.50999,32.17999,55700,37080,45.55636977477825,49.852043290598445,NaN,NaN,-133.48137403968784,-137.8011946444195,-0.1526431351892819,-0.09592608567027838,0.05671704951900351,-2183200,-2222500,25.090854671625266,48.639563162593234,NaN,NaN,-4.961796246399106,5.397802829526971
2001-06-12T09:30:00-04:00,32,32.46001,32,32.46001,8300,36750,49.81464879252769,49.07974523412478,NaN,NaN,-67.6131000109576,-135.85304378072516,-0.11142967895616106,-0.08257004917619781,0.028859629779963245,-2174900,-2215580,26.421393608239285,46.16244248140406,NaN,NaN,-4.353181680228118,4.004805042419101
2001-06-13T09:30:00-04:00,32.5,32.5,31.77,31.78999,13900,35875,41.45885455992097,47.722702116340415,NaN,NaN,-101.53731231097771,-127.72688842627205,-0.12277877397386677,-0.12461383768737022,-0.0018350637135034521,-2188800,-2207800,27.970430465641385,43.81617455689546,NaN,NaN,-6.570422338713067,2.4940582736859342
2001-06-14T09:30:00-04:00,31.8,31.8,30.85001,30.85001,50900,37070,33.07650438277619,45.88063832517365,NaN,NaN,-193.0263286547739,-129.30255433314423,-0.1834264983581791,-0.2311181866612273,-0.04769168830304822,-2239700,-2205100,28.53275378276713,41.49618688181853,NaN,NaN,-11.775363282742129,0.4555694799104968
2001-06-15T09:30:00-04:00,30.5,31.41,30.5,30.82001,75600,39190,32.848234895558434,44.61429137177903,NaN,NaN,-188.16788837780555,-136.76520067884053,-0.2133035308145555,-0.3143211018212426,-0.10101757100668711,-2315300,-2220380,27.23683955259422,39.15452447383677,NaN,NaN,-15.754915878307694,-1.8602141426921017
2001-06-18T09:30:00-04:00,31.00999,31.3,30.8,30.86,124400,44080,33.50698262503661,43.41593379925068,NaN,NaN,-152.30019039196733,-140.5289639492964,-0.21737512610285906,-0.37273647863526094,-0.15536135253240188,-2190900,-2221920,27.103230563033748,36.98507034031103,NaN,NaN,-18.63506504509827,-4.256621414464411
2001-06-19T09:30:00-04:00,30.86,31.28999,30.78999,30.98,9900,43395,35.550123504705226,42.51392933599369,NaN,NaN,-130.51280233285112,-153.10890441367513,-0.1994574403906943,-0.40468315302076974,-0.20522571263007544,-2181000,-2223140,26.99027436668119,35.06348490410265,NaN,NaN,-20.340451197693586,-6.554311383497151
2001-06-20T09:30:00-04:00,31.17999,31.34,30.8,31.06,23300,44030,36.94123254921149,41.18896858885138,NaN,NaN,-112.753569394541,-155.3521558303878,-0.17079467674316998,-0.4187190585590379,-0.24792438181586793,-2157700,-2216920,28.62354889156336,33.31226128255118,NaN,NaN,-21.320873180698438,-8.663820211668764
2001-06-21T09:30:00-04:00,31,31.09,30.25,30.25,13300,43900,29.903394218208092,39.66652760459412,NaN,NaN,-149.88723824308732,-146.7243377480505,-0.193308101027099,-0.4895595080997417,-0.2962514070726427,-2171000,-2203180,32.23013356599117,31.885722330442242,NaN,NaN,-24.58154058914285,-10.937780265593632
2001-06-22T09:30:00-04:00,30.25,30.60001,30.23,30.59,22100,44295,35.46148286118178,38.52057416885325,NaN,NaN,-134.16988811429047,-135.92473769534746,-0.17288667590155404,-0.5123597519495853,-0.33947307604803123,-2148900,-2169900,40.12216071737044,31.027831297076805,NaN,NaN,-25.458500733203564,-13.012168903823623
2001-06-25T09:30:00-04:00,30.53,30.62,30.23,30.23,14300,44395,32.521111853092336,37.65056747915817,NaN,NaN,-124.76445122342689,-130.41758986163939,-0.17090336476889734,-0.5531022820091529,-0.38219891724025556,-2163200,-2164360,41.34665249995342,30.808492985166787,NaN,NaN,-27.154631247897044,-15.032520667262682
2001-06-26T09:30:00-04:00,30.10001,30.71001,30.03,30.67999,16400,44150,39.29663806008921,37.49294900151479,NaN,NaN,-100.6574394666099,-124.44651728839115,-0.12849948187402482,-0.5428232695827866,-0.41432378770876177,-2146800,-2157520,42.899262895281005,31.09281762669437,NaN,NaN,-26.31667101759826,-16.64454214588205
2001-06-27T09:30:00-04:00,30.5,30.82001,30.48,30.75,9400,42395,40.30098594289332,37.626694130447035,NaN,NaN,-74.0072611032348,-116.69725563012989,-0.0869402088711112,-0.5229990487976508,-0.4360588399265396,-2137400,-2153460,43.84938370175458,31.898593292786625,NaN,NaN,-25.33811158665113,-17.88648063742049
2001-06-28T09:30:00-04:00,31.14,31.25,30.82001,30.82001,9500,39395,41.346074731921064,37.68447419656435,NaN,NaN,-43.84286830877221,-95.48838164326688,-0.04789077242770812,-0.4959223054611748,-0.44803153303346666,-2127900,-2144840,45.907363829568645,33.16602022229035,NaN,NaN,-24.235295300305943,-18.79345416068984
2001-06-29T09:30:00-04:00,30.8,31.14999,30.8,31.14999,14200,39170,46.132639601071304,37.725636327013866,NaN,NaN,-32.19207641518123,-75.09281930344503,0.004238341919655497,-0.4427336056338973,-0.4469719475535528,-2113700,-2137800,47.59662192903201,34.77357502639083,NaN,NaN,-21.818534614221853,-19.225608511194412
2001-07-02T09:30:00-04:00,31,31.35001,31,31.24001,36800,40355,47.39388379849212,37.55272454172562,NaN,NaN,-9.062265411991122,-51.95238214115788,0.04650950402014142,-0.38883506752837604,-0.43534457154851747,-2076900,-2120540,51.588346732553454,36.571214535270414,NaN,NaN,-19.46782515070723,-19.26021088826767
2001-07-03T09:30:00-04:00,31.45,31.55,31.19,31.32001,14900,28545,48.5468617873232,38.05901077225434,NaN,NaN,18.030465885514328,-28.21480107073304,0.07964051090643942,-0.3357939329154682,-0.41543444382190764,-2062000,-2103580,55.19956146855279,38.5161524640498,NaN,NaN,-17.192500661334993,-18.964823712991574
2001-07-05T09:30:00-04:00,31.25,31.75,31.25,31.58,28800,29075,52.21250649606072,39.42586806606038,NaN,NaN,48.74156301224253,-3.6650362476375777,0.11661088792791297,-0.2696708339120164,-0.38628172183992937,-2033200,-2082740,59.22449993933107,40.70842004666151,NaN,NaN,-14.150305584400789,-18.277035408907174
2001-07-06T09:30:00-04:00,31.7,31.84,31.52,31.55,99400,32770,51.7543282444934,40.77630330527001,NaN,NaN,67.48075499629655,18.599688413376175,0.13527739538301153,-0.21718497761116495,-0.3524623729941765,-2132600,-2083680,58.9671630558696,42.97487172546689,NaN,NaN,-11.761388984878526,-17.346228776903082
2001-07-09T09:30:00-04:00,31.57001,31.84,31.47,31.84,20800,33095,55.792777108808004,42.36814576839655,NaN,NaN,83.39675156321233,41.71745400905489,0.16160619070681542,-0.15045463461065722,-0.31206082531747265,-2111800,-2083300,59.044636318851154,45.25640070802528,NaN,NaN,-8.487798608577958,-16.080738752856636
2001-07-10T09:30:00-04:00,31.8,32.03999,31.8,31.89,7900,30705,56.469339997809996,43.86237551790403,NaN,NaN,114.35810536642623,66.40152816473835,0.1756727881519643,-0.09246984012751724,-0.26814262827948154,-2103900,-2088700,57.38648272279575,47.42755844774774,NaN,NaN,-5.57168386283149,-14.579445197138758
2001-07-11T09:30:00-04:00,31.85001,32.22,31.85001,32.03999,19400,31260,58.520166528650726,45.403727945006835,NaN,NaN,140.746105198405,90.94465602731648,0.18729701762897594,-0.034021356243261636,-0.22131837387223757,-2084500,-2093200,55.97574073671554,49.38128643668718,NaN,NaN,-2.487857632901629,-12.852075545104883
2001-07-12T09:30:00-04:00,31.85001,31.89999,31.67,31.71001,9500,31040,52.6440187799612,47.02805827084634,NaN,NaN,102.23604889440601,101.64355320374918,0.16572360497074592,-0.014163867658805174,-0.1798874726295511,-2094000,-2105360,52.23863368596009,50.81046501668497,NaN,NaN,-1.3364829622420067,-11.206990890410186
2001-07-13T09:30:00-04:00,31.75,31.8,31.55,31.63,24400,29715,51.29897271699095,48.15930754626128,NaN,NaN,76.53555669478723,103.45451354344732,0.14004825111359953,-0.0048271587375516845,-0.14487540985115122,-2118400,-2102520,53.02740246936211,51.73226799897009,NaN,NaN,-0.7389724418889737,-9.711559683478583
2001-07-16T09:30:00-04:00,31.85001,32.12,31.83,31.85001,111800,31525,54.724549720273615,49.74526739391708,NaN,NaN,104.20342083420155,107.61584739764517,0.13197520166192342,0.020093592226253065,-0.11188160943567035,-2006600,-2081480,58.495989357660974,52.95722063166348,NaN,NaN,0.7411767193051308,-8.218311625938053
2001-07-17T09:30:00-04:00,32.03,32.2,31.89999,31.89999,14400,26025,55.49047618262742,50.90197011695553,NaN,NaN,100.4557881395078,104.83538395226148,0.1242064226312835,0.04337641885343402,-0.08083000377784948,-1992200,-2059140,63.37201206211862,54.41955985786617,NaN,NaN,2.187213770356158,-6.7318079978960235
2001-07-18T09:30:00-04:00,32.17999,32.19,31.57001,31.57001,18900,26475,49.53260002957505,51.56137112314708,NaN,NaN,63.45772338206077,89.37770758899264,0.09250435553422397,0.034800440639930486,-0.05770391489429348,-2011100,-2044460,66.18347403215708,56.01485202432349,NaN,NaN,1.8123996811083583,-5.511206900895398
2001-07-19T09:30:00-04:00,31.89999,32.14999,31.77,31.77,22900,26455,52.83761993113486,52.38219578023378,NaN,NaN,72.62774178311263,83.456046166734,0.081073853039865,0.04363840140553776,-0.03743545163432723,-1988200,-2023300,69.78373678145272,57.72030723517235,NaN,NaN,2.4296034127243478,-4.376805427521148
2001-07-20T09:30:00-04:00,31.64999,31.82001,31.06,31.10001,40500,27815,42.739560476460596,52.13983298561873,NaN,NaN,-8.557032576562747,66.437528312464,0.027243505463045343,-0.0033810698055205535,-0.030624575268565896,-2028700,-2005360,72.46074021872464,59.49631568443611,NaN,NaN,-0.2713793744333933,-3.790315991365755
2001-07-23T09:30:00-04:00,30.95,31.09,29.95,30.25,28000,28110,33.89024330195949,51.1752872358664,NaN,NaN,-137.22858810504923,18.15112652461384,-0.06189091711974777,-0.10798822166825062,-0.046097304548502846,-2056700,-2015380,68.79473289079732,60.72534326716782,NaN,NaN,-6.117055961391088,-4.122707415655088
2001-07-24T09:30:00-04:00,30.35001,30.35001,29.33,29.38,71500,30970,27.592904865620085,49.67857602717332,NaN,NaN,-221.48268797448745,-46.2365686981852,-0.16961532942361016,-0.25811646632801555,-0.08850113690440539,-2128200,-2042580,59.930799216733995,61.06328882060933,NaN,NaN,-13.815969104866147,-5.507459085542383
2001-07-25T09:30:00-04:00,29.39999,30.67999,29.39999,30.67999,82500,34275,44.25984754937195,49.110528959552695,NaN,NaN,-140.85086070633366,-87.09828551586409,-0.14447421548446732,-0.2690939062599895,-0.12461969077552222,-2045700,-2049500,57.887290907085976,60.96777388973469,NaN,NaN,-13.338461551333907,-6.626173723512601
2001-07-26T09:30:00-04:00,30.48,30.81,30.2,30.78999,8600,34235,45.40500448815821,48.65700583410018,NaN,NaN,-94.41566447132696,-120.50696676675202,-0.1129865982707734,-0.26585293861398895,-0.15286634034321556,-2037100,-2059280,55.03132041644831,60.686642272633165,NaN,NaN,-12.547018150810421,-7.472008641698004
2001-07-27T09:30:00-04:00,31,31.19,30.56,30.77,34200,35470,45.223175674450786,47.902034303074664,NaN,NaN,-61.903510804342034,-131.17626241230786,-0.08720988748931174,-0.2618786997048552,-0.17466881221554348,-2071300,-2067800,52.59679027456274,60.22608184089828,NaN,NaN,-12.03504697864388,-8.1238712612617
2001-07-30T09:30:00-04:00,30.85001,31.14999,30.60001,31.12,24700,35995,49.06893147417165,47.37343369424336,NaN,NaN,-46.21868893163802,-112.97428257762563,-0.04255325358385548,-0.22786037919536284,-0.18530712561150736,-2046600,-2065780,53.126248131342294,59.92177937008017,NaN,NaN,-10.279412809789953,-8.431805768194307
2001-07-31T09:30:00-04:00,30.67999,31.17,30.63,30.87,13700,34840,46.554701238781774,46.518757602109865,NaN,NaN,-50.75763462835324,-78.8292719083988,-0.026597634988128116,-0.2185541693466675,-0.19195653435853938,-2060300,-2052200,56.63308273560904,59.968732370001135,NaN,NaN,-9.720656480960125,-8.615927298589424
2001-08-01T09:30:00-04:00,30.7,31.37,30.64999,31.23,28800,35535,50.48883200300464,46.364815689470106,NaN,NaN,-25.191796649473893,-55.69745909702683,0.009521719669388362,-0.1800543847718039,-0.18957610444119227,-2031500,-2049360,57.3516884431932,60.33395056694635,NaN,NaN,-7.9542258041218785,-8.521398513665488
2001-08-02T09:30:00-04:00,31,31.47,31,31.17999,8400,34515,49.938889608023615,46.26766689597245,NaN,NaN,-7.643413381075226,-38.34300887897649,0.03019829493135115,-0.15182823577700333,-0.18202653070835448,-2039900,-2049920,57.15059069632322,60.62846401172929,NaN,NaN,-6.736604463348176,-8.26642793504873
2001-08-03T09:30:00-04:00,31,31.13,30.82001,31.09,18500,30470,48.90657701593967,45.85209741709145,NaN,NaN,-28.484708582718085,-31.65924843465171,0.03749147678081666,-0.13516218473233366,-0.1726536615131503,-2058400,-2047340,57.883299980258755,60.58470048477199,NaN,NaN,-6.055296383568837,-7.950551999123031
2001-08-06T09:30:00-04:00,30.71001,30.75,30.39999,30.49001,14600,30160,42.58578571112922,44.93033381198443,NaN,NaN,-76.57243297158124,-37.72999724264033,0.0033814270684429937,-0.16842687767759656,-0.17180830474603956,-2073000,-2052620,55.781105590376654,60.04249287964757,NaN,NaN,-7.4232599635768075,-7.87522456547357
2001-08-07T09:30:00-04:00,30.63,30.88,30.57001,30.73,12300,30380,45.613593918936864,44.65040480408171,NaN,NaN,-49.79970967748053,-37.53841225246579,-0.0012934066056153326,-0.1734250630030587,-0.17213165639744338,-2060700,-2052700,55.74806938405218,59.297106833354356,NaN,NaN,-7.627844217115862,-7.839884515708183
2001-08-08T09:30:00-04:00,30.55,30.55,30.00999,30.12,29100,30865,39.85967124605684,43.723408469433274,NaN,NaN,-102.78607280975221,-53.05726748452146,-0.04151518274885571,-0.224025634833513,-0.1825104520846573,-2089800,-2064360,51.0065028710136,57.95587583975156,NaN,NaN,-9.674034303992478,-8.10190591403451
2001-08-09T09:30:00-04:00,30,30.35001,30,30.17,73600,34070,40.52196580655538,43.565008850154335,NaN,NaN,-100.12326898908647,-71.5532386061237,-0.059694322185503634,-0.25712835481653684,-0.1974340326310332,-2016200,-2059620,52.76530743072561,56.54905921203734,NaN,NaN,-11.094739151442162,-8.52945351937846
2001-08-10T09:30:00-04:00,30.10001,30.75999,29.95,30.75999,14200,33560,47.82358170588893,44.56024730757787,NaN,NaN,-54.31522494035647,-76.71934187765137,-0.028507627722339723,-0.23306856728395786,-0.20456093956161814,-2002000,-2048340,56.74484372015734,55.68835284270592,NaN,NaN,-10.031767842742704,-8.744069851287637
2001-08-13T09:30:00-04:00,30.53,30.64999,30.42,30.42,9000,28420,44.438074185805156,45.76347368759109,NaN,NaN,-47.64642301715433,-70.934139886766,-0.02729841935030386,-0.23868396374949796,-0.2113855443991941,-2011000,-2035940,60.667828057941904,55.740997759935055,NaN,NaN,-10.21331430656879,-8.953961916327803
2001-08-14T09:30:00-04:00,30.33,30.53999,30.33,30.42,58600,30630,44.43807418580516,45.776204161622026,NaN,NaN,-50.99087502408161,-71.1723729560862,-0.023182321059790928,-0.24036344572393276,-0.21718112466414183,-2011000,-2026000,63.52370073568874,56.14359846197811,NaN,NaN,-10.356889070270258,-9.154380081176726
2001-08-15T09:30:00-04:00,30.44,30.44,30.03999,30.03999,9800,30175,40.702943912212966,45.440342691911646,NaN,NaN,-85.50577595763097,-67.71631358566196,-0.041658526386460726,-0.26925428264721774,-0.227595756260757,-2020800,-2012200,67.09577117693382,57.005344944869925,NaN,NaN,-11.607367987876092,-9.504806924990922
2001-08-16T09:30:00-04:00,30.11,30.39999,30,30.37,15300,29795,45.02446601611937,45.42614914488797,NaN,NaN,-66.78333862600549,-61.04832751304576,-0.0279198308489165,-0.2624955448219026,-0.23457571397298613,-2005500,-2010060,67.62523373837097,58.0788051922848,NaN,NaN,-11.371152417816202,-9.771427709680248
2001-08-17T09:30:00-04:00,30,30.25999,29.95,30,32400,29390,41.382933543420094,44.877149292691435,NaN,NaN,-97.82135156520887,-69.74955283801623,-0.039319032585118596,-0.2837245047043844,-0.24440547211926578,-2037900,-2017240,63.90950219975246,58.84903762574267,NaN,NaN,-12.280379788760172,-10.129849435263095
2001-08-20T09:30:00-04:00,30.10001,30.36,30.10001,30.24001,15400,28760,44.51768071845421,44.73164782695375,NaN,NaN,-59.15660512559177,-72.05158925970372,-0.026857587205108113,-0.27797745612565095,-0.25111986892054283,-2022500,-2019540,62.72063304955618,59.283862648167464,NaN,NaN,-12.098312522383491,-10.411058447708866
2001-08-21T09:30:00-04:00,30.53999,30.61,30.25,30.25,45100,27440,44.65036334150306,44.3146143511322,NaN,NaN,-41.79987154254777,-70.21338856339695,-0.014712125185957992,-0.2695100254029903,-0.2547979002170323,-1977400,-2012820,64.78201849084152,59.81460050871379,NaN,NaN,-11.913725047978204,-10.6257251048902
2001-08-22T09:30:00-04:00,30.3,30.31,30.05,30.2,60900,26360,44.08215002287657,43.89627580933598,NaN,NaN,-82.31063740820804,-69.57436085351237,-0.007196290347413814,-0.2637932631512996,-0.25659697280388577,-2038300,-2016320,62.833235180274386,60.220503686138876,NaN,NaN,-11.915532452768794,-10.809983297444285
2001-08-23T09:30:00-04:00,30,30.37,30,30.13,11500,26505,43.252283637818294,43.492397710898736,NaN,NaN,-78.71338326190906,-71.96036978069307,-0.004236160091447283,-0.2618921729181949,-0.2576560128267476,-2049800,-2025180,58.07091991112775,60.23390510977237,NaN,NaN,-12.136435096790438,-10.999476411636593
2001-08-24T09:30:00-04:00,30.03,30.37,30.03,30.34,4400,25015,46.505835627642966,43.77240127636401,NaN,NaN,-56.72921332201548,-63.7419421320544,0.01359196880610869,-0.24066605181911171,-0.2542580206252204,-2045400,-2026680,57.27938641349397,60.340925168566464,NaN,NaN,-11.461800358999795,-11.065522689831337
2001-08-27T09:30:00-04:00,30.45,30.45,30.24001,30.42,4200,23990,47.73518176642479,43.92394326547029,NaN,NaN,-24.129886457939115,-56.73659839852387,0.03147721609223142,-0.21491150050993113,-0.24638871660216255,-2041200,-2030420,55.25700546621668,60.30584917443536,NaN,NaN,-10.565858826913011,-10.994142137985861
2001-08-28T09:30:00-04:00,30.14999,30.28999,30.12,30.28,3200,23465,45.75358347149729,44.3449369958589,NaN,NaN,-54.192639359605394,-59.2151519619354,0.03434906087849221,-0.2034523905040473,-0.2378014513825395,-2044400,-2043820,48.631753271480406,60.13622420304013,NaN,NaN,-10.298780697957246,-10.894804789410344
2001-08-29T09:30:00-04:00,30.33,30.33,30.02,30.10001,41500,24100,43.26680613026099,44.540997018980725,NaN,NaN,-72.3441180417141,-57.221848088636605,0.025029892152672067,-0.20651408619169942,-0.2315439783443715,-2085900,-2053340,44.54540985788572,59.54908866212299,NaN,NaN,-10.71463650155651,-10.869066462574082
2001-08-30T09:30:00-04:00,30,30.25,29.74001,29.75,291000,38230,38.84532929763783,43.899693275534226,NaN,NaN,-147.38165554497135,-70.95550254524908,-0.002349168829060194,-0.23448043938069674,-0.23213127055163654,-2376900,-2118760,27.46610270075415,57.45775001787991,NaN,NaN,-12.320148593462676,-11.07636390984388
2001-08-31T09:30:00-04:00,29.98,29.98,29.64,29.77,9300,37770,39.22749689945207,43.52750918365185,NaN,NaN,-195.22430972579488,-98.65452182600495,-0.015994036760003272,-0.2521238165016406,-0.23612977974163735,-2367600,-2183200,19.52490647591179,54.51896990487775,NaN,NaN,-13.555548728194728,-11.430533169608287
2001-09-04T09:30:00-04:00,29.89999,30.42999,29.78,30.08,435500,58815,44.96807130471756,43.56536612071703,NaN,NaN,-65.28804535167455,-106.88615360475205,-0.0017717158860713622,-0.23834442459922656,-0.2365727087131552,-1932100,-2161380,27.20032756209787,51.92444324962126,NaN,NaN,-13.092384988868384,-11.66794057235973
2001-09-05T09:30:00-04:00,29.95,29.95,29.64,29.89999,96100,63005,42.45995660629047,43.69086702743685,NaN,NaN,-174.38498262127777,-130.9246222570865,-0.0020955938562958465,-0.239192201033525,-0.23709660717722916,-2028200,-2158140,28.293960059478664,49.15288531266018,NaN,NaN,-13.38438665144437,-11.913147155086106
2001-09-06T09:30:00-04:00,29.75,29.92999,29.67,29.67,9600,62030,39.43368760890516,43.29152571263584,NaN,NaN,-173.565780573395,-151.1689547634227,-0.014704599792269929,-0.25547735691756657,-0.24077275712529664,-2037800,-2148520,31.580483453217212,46.57826029229205,NaN,NaN,-14.493914553281744,-12.281828211971197
2001-09-07T09:30:00-04:00,29.42999,29.87,29.42999,29.63,33900,60045,38.91420399229511,43.11518788755548,NaN,NaN,-175.15734440192801,-156.72409253481402,-0.022194468302060094,-0.26851584250287175,-0.24632137420081165,-2071700,-2087480,47.89815617346209,45.4345927189856,NaN,NaN,-15.559082110498142,-12.75000734033219
2001-09-10T09:30:00-04:00,29.5,30.12,29.5,30.12,11700,59920,47.95850485827122,43.36096104039955,NaN,NaN,-70.83859831167136,-131.8469502519893,0.007790818142519362,-0.23658285152266245,-0.24437366966518181,-2060000,-2025960,58.6118791160418,45.14111029516314,NaN,NaN,-13.87937741612786,-12.911345922588714
2001-09-17T09:30:00-04:00,29.64999,29.89999,29.39999,29.85001,1183900,118665,44.08534608680038,43.32060266506364,NaN,NaN,-121.49316320584558,-143.08797382282353,0.011174384259082876,-0.2304056893413282,-0.2415800736004111,-3243900,-2288320,30.144031505609533,42.66696836764657,NaN,NaN,-13.585849963090435,-13.007703642660388
2001-09-18T09:30:00-04:00,29.75,30.25,29.64999,30.06,95400,120505,47.628043663565336,43.5738807822557,NaN,NaN,-24.273172787067548,-113.06561185598147,0.028312868905229827,-0.20618898746887382,-0.23450185637410365,-3148500,-2512380,20.836342447135777,39.66719031527952,NaN,NaN,-12.26805729689779,-12.902039878980018
2001-09-19T09:30:00-04:00,30.14999,30.37,29.46001,29.83,10300,120530,44.31609334527775,43.649867189931385,NaN,NaN,-53.4287897567913,-89.03821369266075,0.025030577665039078,-0.2032136342928048,-0.2282442119578439,-3158800,-2736580,15.634290644046317,36.63600251048799,NaN,NaN,-12.136049285083116,-12.79261265128046
2001-09-20T09:30:00-04:00,29.66,30.23,29.66,30.21001,24200,120975,50.44722853562224,43.93139525478704,NaN,NaN,1.279694524296246,-53.750805907415895,0.04799336620175193,-0.16825250420565396,-0.2162458704074059,-3134600,-2949160,12.458275325283921,33.434494575615844,NaN,NaN,-10.092481988071,-12.406879699393395
2001-09-21T09:30:00-04:00,29,29.84,29,29.13,24500,120580,37.73168716060866,43.21685992580018,NaN,NaN,-206.69144904862753,-80.92137605480713,-0.007082137145058842,-0.22509854183872946,-0.21801640469367062,-3159100,-3168980,10.159889753287857,30.213272024692362,NaN,NaN,-12.789489319501332,-12.461538216551672
2001-09-24T09:30:00-04:00,29.13,29.39999,29.13,29.23,22200,120920,39.25834280066452,42.752914163597836,NaN,NaN,-191.58030899311123,-94.93880521226026,-0.0328617579935187,-0.259093602185569,-0.22623184419205028,-3136900,-3147580,11.864584688345715,27.587045697325596,NaN,NaN,-14.310773859561598,-12.725714736981661
2001-09-25T09:30:00-04:00,29.14999,29.7,29.14999,29.67,43600,120845,45.58050788551876,42.91817857468767,NaN,NaN,-109.8249619567417,-112.04916304619508,-0.017154972632166865,-0.24767555998225887,-0.230520587350092,-3093300,-3136540,12.784001698201166,25.31837368591955,NaN,NaN,-13.36297546325787,-12.816751983592548
2001-09-26T09:30:00-04:00,29,29.25999,28.86,28.96001,45700,120085,38.59913266394918,42.90059310085277,NaN,NaN,-199.3552031139512,-141.23444571762707,-0.04961926278758458,-0.2925446658345727,-0.24292540304698815,-3139000,-3132580,13.134045563340663,24.294655318961446,NaN,NaN,-15.123505510543502,-13.146288201728398
2001-09-27T09:30:00-04:00,28.95,28.95,28.39,28.60001,58100,122415,35.61999465477902,42.642914369090406,NaN,NaN,-229.1566977362994,-187.3217241697462,-0.08812578161706963,-0.3530826300683252,-0.26495684845125556,-3197100,-3145080,12.957263131745208,23.825537937235264,NaN,NaN,-17.606127044637184,-13.783408036429654
2001-09-28T09:30:00-04:00,28.84,29.38,28.84,29.25999,12600,122825,44.13297412242775,42.58326457035542,NaN,NaN,-107.47698731517985,-167.47883182305665,-0.06310727975293567,-0.34384094814242516,-0.2807336683894895,-3184500,-3150160,12.881380675154062,22.802756016739274,NaN,NaN,-16.540622226538147,-14.177295777873724
2001-10-01T09:30:00-04:00,29.21001,29.53,29.03999,29.50999,45000,124865,46.992298753975355,42.90700329519005,NaN,NaN,-59.60949867447849,-141.0846697593301,-0.02560416836715096,-0.3127388788484282,-0.28713471048127726,-3139500,-3150680,12.873070033613814,21.70126387203464,NaN,NaN,-14.696577393320498,-14.251478865794692
2001-10-02T09:30:00-04:00,29.2,29.94,29.2,29.83,9800,125195,50.48568730833255,43.69643184514915,NaN,NaN,5.039227329283179,-118.11183190212512,0.0222843110526994,-0.259279321665403,-0.2815636327181024,-3129700,-3157960,12.749058248238839,20.356162071679044,NaN,NaN,-12.008914650069132,-13.931112549262469
2001-10-03T09:30:00-04:00,29.95,30.16,29.95,30.14999,20200,124130,53.76678779082157,44.75733068790104,NaN,NaN,97.30595468205536,-58.779600342923814,0.07411967792932495,-0.18891403530644624,-0.2630337132357712,-3109500,-3152060,13.476536541595294,17.89747495511713,NaN,NaN,-8.718244851869443,-13.186417163920607
2001-10-04T09:30:00-04:00,30.25,30.25,29.85001,29.85001,12300,110195,50.39531602947666,44.93138862870143,NaN,NaN,73.98170953187531,1.8480811107111266,0.08597761103847876,-0.15556169943767273,-0.2415393104761515,-3121800,-3137000,15.415188924217745,14.811997084272551,NaN,NaN,-7.134982882882242,-12.321926552343697
2001-10-05T09:30:00-04:00,30.25,30.25,29.91,29.91,10500,110255,51.056273796055756,45.42931203650539,NaN,NaN,78.04566161881255,38.9526108975096,0.09493333478329091,-0.12287264199703785,-0.21780597678032876,-3111300,-3122360,17.35379579628477,13.898408819320784,NaN,NaN,-5.680200541243646,-11.373108550757976
2001-10-08T09:30:00-04:00,30.10001,30.31,30.09,30.19,31100,90035,54.12853068747765,45.89363253821341,NaN,NaN,111.3484369428139,73.14419802096809,0.115424688029855,-0.07352511674300999,-0.188949804772865,-3080200,-3110500,18.97392796667161,13.765379213573343,NaN,NaN,-3.5153638941481984,-10.250573599813723
2001-10-09T09:30:00-04:00,29.97,30.16,29.92,30.03999,73200,88890,52.236696522914,46.45938990804457,NaN,NaN,75.3214668919324,87.20064593349794,0.1143668499380231,-0.04599124235033614,-0.16035809228835923,-3153400,-3115240,18.81517779763533,13.992585438829703,NaN,NaN,-2.291494411398555,-9.113562287182985
2001-10-10T09:30:00-04:00,29.89,30.13,29.8,30.10001,28800,89850,52.945327357029335,46.63782553814508,NaN,NaN,64.67337012258612,80.67412902160409,0.11300080855984657,-0.01910708158855101,-0.13210789014839758,-3124600,-3118260,18.70778071008388,14.438978680601126,NaN,NaN,-1.0889303765094516,-7.967186299943909
2001-10-11T09:30:00-04:00,30.08,30.12,29.57001,29.66,1023100,139310,47.393960476541,47.327987917854536,NaN,NaN,19.724128186316452,69.82261275249232,0.0793449033398335,-0.032926760973605695,-0.1122716643134392,-4147700,-3323440,13.196471590487207,14.655877383258225,NaN,NaN,-1.6511284980920873,-7.064892328250791
2001-10-12T09:30:00-04:00,29.64,29.75,29.23,29.48,45500,141000,45.30139751568931,47.75963468321344,NaN,NaN,-32.651607652574874,47.6831588982148,0.04362702287244499,-0.057737885722882965,-0.10136490859532796,-4193200,-3539820,9.888112321388832,14.514700785618446,NaN,NaN,-2.733238929737215,-6.446084699891709
2001-10-15T09:30:00-04:00,29.39999,29.42,29.23,29.41,130000,88305,44.47892753200205,47.68095037224797,NaN,NaN,-52.46371309813107,14.920728890025805,0.015409634792179966,-0.082102865105103,-0.09751249989728297,-4323200,-3788420,7.547100269841621,14.14063639787848,NaN,NaN,-3.858666079490928,-6.076453468405883
2001-10-16T09:30:00-04:00,29.55,29.63,29.42,29.63,14700,84270,47.69315289945304,48.33052324621253,NaN,NaN,-11.169076402811205,-2.377379768922917,0.01184461297404929,-0.08270673367972137,-0.09455134665377066,-4308500,-4019440,6.101468266973569,13.638309448137973,NaN,NaN,-3.9387128854022957,-5.771061956548228
2001-10-17T09:30:00-04:00,29.85001,29.92999,29.49001,29.60001,21100,84810,47.291234767105905,49.16418325423587,NaN,NaN,12.759617191907063,-12.760130355058728,0.007937327021290505,-0.08462968787715752,-0.09256701489844803,-4329600,-4260440,5.020983651333125,13.071432342394255,NaN,NaN,-4.113018387455681,-5.5341985895350065
2001-10-18T09:30:00-04:00,29.64999,29.64999,29.02,29.03,31300,85165,40.33390581149373,48.8928212320263,NaN,NaN,-66.83667448838366,-30.072290889998754,-0.030460562662822765,-0.13064271822697648,-0.10018215556415372,-4360900,-4303080,4.85709617396472,12.498269163737872,NaN,NaN,-6.329034334647534,-5.64774655312251
2001-10-19T09:30:00-04:00,29.12,29.58,28.97,29.53,15300,84705,47.61418158775178,48.93724143443891,NaN,NaN,-42.12614748380863,-31.967198856245506,-0.02010864949958635,-0.12531796743863666,-0.1052093179390503,-4345600,-4333560,4.73804368649958,11.917195853229712,NaN,NaN,-6.079964174859954,-5.709491927656431
2001-10-22T09:30:00-04:00,29.25,29.25,28.78,28.97,7000,83945,41.505731867191805,48.29581604578599,NaN,NaN,-108.00993730479718,-43.076443697578725,-0.047344860712947856,-0.16439039383023513,-0.11704553311728727,-4352600,-4339440,4.714038672761859,11.343265883552785,NaN,NaN,-7.855398786113893,-6.016050050293211
2001-10-23T09:30:00-04:00,28.60001,28.64999,28.05,28.23,39700,83750,35.09798633803001,46.96233022772945,NaN,NaN,-196.03792587750013,-80.0502135925165,-0.10809208385781019,-0.25216063793955,-0.14406855408173982,-4392300,-4356200,4.64184896641045,10.712216771039582,NaN,NaN,-11.699591499640357,-6.827984543057089
2001-10-24T09:30:00-04:00,28.2,28.2,27.88,27.98,77000,85315,33.231437814006796,45.73633892662446,NaN,NaN,-207.68549693781264,-124.13923641846046,-0.15514187125331885,-0.3379958931483884,-0.18285402189506955,-4469300,-4384140,4.517646157696035,9.933820859145175,NaN,NaN,-15.40472434230333,-8.053233085806552
2001-10-25T09:30:00-04:00,27.95,28.22,27.95,28.17,36200,84220,36.01642905871792,44.662064302528904,NaN,NaN,-178.77562395227224,-146.52702631123816,-0.16270657189687232,-0.38623723676615995,-0.22353066486928763,-4433100,-4398580,4.451354621905011,9.012217918118049,NaN,NaN,-17.47772244850157,-9.399588709048697
2001-10-26T09:30:00-04:00,28.10001,28.44,27.92999,28.25999,115500,89365,37.3493449943469,43.46355103873385,NaN,NaN,-143.66040720921262,-166.83387825631897,-0.15113779437863234,-0.41245290784257804,-0.2613151134639457,-4317600,-4392980,5.0333539534918685,8.016462631462351,NaN,NaN,-18.726605834625996,-10.73201972698831
2001-10-29T09:30:00-05:00,28.35001,28.35001,28.03,28.21001,58600,90045,36.88969628114999,42.367336735750705,NaN,NaN,-121.79383335665518,-169.59065746669057,-0.13677106265879063,-0.432278941787434,-0.29550787912864335,-4376200,-4397700,5.005678194957895,7.030069802699679,NaN,NaN,-19.869859121446254,-12.037425354768017
2001-10-30T09:30:00-05:00,28,28,27.73,27.78999,46000,91855,33.192738083313074,40.95643750191383,NaN,NaN,-134.14771657033535,-157.2126156052576,-0.14470711466876696,-0.47639177246460207,-0.3316846577958351,-4422200,-4403680,4.968404463408106,6.0486857850799804,NaN,NaN,-21.997230553846673,-13.46025466892211
2001-10-31T09:30:00-05:00,27.60001,27.95,27.60001,27.72,13700,91530,32.606340427998305,39.900178927017926,NaN,NaN,-121.47744964355022,-139.97100614640513,-0.14353818483213676,-0.511107388836006,-0.3675692040038693,-4435900,-4397000,5.812117851132371,5.521231946554634,NaN,NaN,-23.903836259739407,-14.952194896181723
2001-11-01T09:30:00-05:00,28,28.23,27.61,27.95,70500,94440,36.57192488602349,39.27664516775609,NaN,NaN,-93.46169570442802,-122.90822049683626,-0.11725189247378165,-0.5141340695960963,-0.39688217712231466,-4365400,-4383460,7.602776180621177,5.357993650785515,NaN,NaN,-24.39791906086869,-16.301584062565574
2001-11-02T09:30:00-05:00,27.89999,28.08,27.64999,28.06,37700,95800,38.437671801736776,38.84512690130857,NaN,NaN,-82.97540595470754,-110.77122024593525,-0.08399137364999953,-0.5018713941848141,-0.41788002053481454,-4327700,-4385480,7.579624486597098,5.360316809125193,NaN,NaN,-24.287809440719123,-17.442473402301797
2001-11-05T09:30:00-05:00,28.45,28.49001,28.24001,28.33,22900,95390,42.87909391710392,38.501265545426484,NaN,NaN,-40.84996087526991,-94.5824457496582,-0.03770085660697087,-0.4650060912935281,-0.42730523468655723,-4304800,-4371200,9.673671594639416,5.615474189672753,NaN,NaN,-22.924470809065703,-18.225615888982354
2001-11-06T09:30:00-05:00,28.2,28.45,28,28.45,54400,94450,44.78569905142833,38.32229870859238,NaN,NaN,-40.2620486675329,-75.80531216909772,0.004843263797676189,-0.42125115493946197,-0.42609441873713816,-4250400,-4336840,14.68283027660739,6.305606091478057,NaN,NaN,-21.24118918107959,-18.656412073567672
2001-11-07T09:30:00-05:00,28.45,28.45,28.05,28.08,51000,95560,40.317204402182796,38.321105750784454,NaN,NaN,-45.44193942309143,-60.59821012500596,0.011527288228172838,-0.4116853084519221,-0.4232125966800949,-4301400,-4309940,18.49371103825102,7.279650010355652,NaN,NaN,-21.00870884031518,-18.992454468817318
2001-11-08T09:30:00-05:00,28.17999,28.52,28.10001,28.46001,44300,46620,46.24900295732802,38.22359299146847,NaN,NaN,-23.057035787763013,-46.517278141672946,0.043222124640385495,-0.36918494087961307,-0.41240706551999856,-4257100,-4288280,21.532965182326308,8.47928726005756,NaN,NaN,-19.017261551797937,-18.995998337814548
2001-11-09T09:30:00-05:00,28.64999,28.72,28.42,28.64,45900,46640,48.842493333546244,38.74764738192236,NaN,NaN,10.181030001969285,-27.88599095033758,0.07606843668303209,-0.3173215196662085,-0.39338995634924057,-4211200,-4264980,24.782182632074694,9.912726114294191,NaN,NaN,-16.574322951105056,-18.650044711141764
2001-11-12T09:30:00-05:00,28.3,28.58,28.3,28.53999,25600,41420,47.47188205908188,39.63149707628321,NaN,NaN,0.4341813998019876,-19.629162495323204,0.08987229216659631,-0.28104959114099515,-0.37092188330759146,-4236800,-4251380,26.690366648230253,11.487620234424176,NaN,NaN,-14.934618198778757,-18.119269495089906
2001-11-13T09:30:00-05:00,28.63,28.63,28.21001,28.52,37400,42555,47.186851434770475,40.62831233490918,NaN,NaN,6.5841745604045405,-10.259917849735714,0.09591893620392955,-0.2510232130526795,-0.34694214925660904,-4274200,-4256140,26.437568571571532,13.053328978272427,NaN,NaN,-13.661565140525806,-17.482454587295035
2001-11-14T09:30:00-05:00,28.64999,28.64999,28.06,28.22,696500,76325,43.01290393518934,41.12806054037143,NaN,NaN,-8.046427691184725,-2.780815503354385,0.07869833261327974,-0.24856923349000937,-0.3272675661032891,-4970700,-4390000,20.544480402559756,14.202837962604908,NaN,NaN,-13.693616636021321,-16.941192022827362
2001-11-15T09:30:00-05:00,28.14999,28.3,28,28.17,220800,85800,42.34067501448228,41.48458411323825,NaN,NaN,-35.18277061399122,-5.205962468600026,0.06357204800217853,-0.24780250610056598,-0.3113745541027445,-5191500,-4576880,15.38758270492832,14.942425730564654,NaN,NaN,-13.90327321538851,-16.50720362176467
2001-11-16T09:30:00-05:00,28.45,28.63,28.41,28.47,1136200,141845,47.62929965514891,42.25169863995245,NaN,NaN,78.31892114712879,8.421615760431875,0.07274267556755348,-0.22044620964330264,-0.2931888852108561,-4055300,-4545700,19.039046004120564,15.944809145504845,NaN,NaN,-12.600813823425241,-15.94914793628761
2001-11-19T09:30:00-05:00,28.75,28.8,28.21001,28.39999,41500,143570,46.55611747682078,43.206225739488715,NaN,NaN,86.88977601176602,25.71273468282468,0.07288242846389015,-0.2020858496309934,-0.27496827809488356,-4096800,-4517700,22.28257542453204,17.181535642727983,NaN,NaN,-11.80176371086782,-15.356664475513353
2001-11-20T09:30:00-05:00,28.55,28.59,28.25,28.46001,17500,142460,47.645238247967356,44.280432726629364,NaN,NaN,69.513907569427,38.298681284629176,0.0754865750261744,-0.18061005931216556,-0.25609663433833996,-4079300,-4478720,26.686067572483125,18.672532051395894,NaN,NaN,-10.836736115513489,-14.710960424084801
2001-11-21T09:30:00-05:00,28.28,28.28,27.94,28.25,20100,139615,44.24745984831358,44.82868522393579,NaN,NaN,-28.3186357582453,34.244239671217066,0.06209410919456282,-0.17847899784513643,-0.24057310703969925,-4099400,-4304460,42.39877726944228,21.157960700597403,NaN,NaN,-10.901103527709282,-14.166695153174013
2001-11-23T09:30:00-05:00,28.25,28.37,28,28.22,4300,138020,43.76729406570215,45.209372528504744,NaN,NaN,-15.98804228638013,38.08318533673928,0.050723624437843284,-0.17716857649239515,-0.22789220093023843,-4103700,-4086900,55.28403715200875,24.565418748126806,NaN,NaN,-11.081489168450988,-13.725951441070723
2001-11-26T09:30:00-05:00,28.3,28.35001,28,28.25,20000,133245,44.41687091711219,45.31921374279106,NaN,NaN,-14.559901516420094,19.5074208040295,0.044929988275001165,-0.17172971558648698,-0.21665970386148814,-4083700,-4092580,54.93850197909098,27.798620918444776,NaN,NaN,-11.069635723746964,-13.346477767167329
2001-11-27T09:30:00-05:00,28.05,28.19,27.85001,27.87,76600,134145,38.370605169791894,44.8609927512456,NaN,NaN,-88.0941630250918,-15.489367003342068,0.01666787805355341,-0.19582485629454638,-0.2124927343480998,-4160300,-4105280,54.123943973786325,30.615843325386127,NaN,NaN,-12.746957690815162,-13.260832041974162
2001-11-28T09:30:00-05:00,27.77,27.86,27.5,27.5,26200,133155,33.57775610519441,44.379603587175,NaN,NaN,-192.59260452076347,-67.91066942138016,-0.023595302729893325,-0.24198686276046644,-0.2183915600305731,-4186500,-4126720,52.703288844365005,33.059384597251416,NaN,NaN,-15.731933182854346,-13.613846490671332
2001-11-29T09:30:00-05:00,27.3,27.49001,27.25999,27.49001,677100,166325,33.456243668536445,43.46583506654703,NaN,NaN,-234.199701313949,-109.08688253252089,-0.04624108395505175,-0.2761929149743878,-0.22995183101933606,-4863600,-4279560,43.864219087190335,34.65447416188456,NaN,NaN,-18.193008198102678,-14.26801244887581
2001-11-30T09:30:00-05:00,27.55,27.60001,27.37,27.37,28100,164205,31.959966642651636,42.259940302911694,NaN,NaN,-191.34925368217344,-144.15912481167956,-0.06357331775989417,-0.30941847821920376,-0.2458451604593096,-4891700,-4437160,36.97752821937212,35.52557027526294,NaN,NaN,-20.71937985623344,-15.189636364212614
2001-12-03T09:30:00-05:00,27.23,27.56,27.2,27.42,146500,169645,33.29843498919145,41.247551226490955,NaN,NaN,-173.5594381716088,-175.9590321427173,-0.06567200116962041,-0.3279351619213351,-0.2622631607517147,-4745200,-4569460,32.381474263883504,35.93207796209532,NaN,NaN,-22.480692824696398,-16.23121585856744
2001-12-04T09:30:00-05:00,27.42,27.73,27.2,27.73,42500,170625,41.04234285495043,40.808657756503806,NaN,NaN,-113.72262845320627,-181.0847252283402,-0.04137030149501608,-0.31397603762048476,-0.2726057361254687,-4702700,-4677940,29.178956724806724,36.12789140161212,NaN,NaN,-21.87663665773611,-17.037704544162967
2001-12-05T09:30:00-05:00,27.75,27.95,27.60001,27.92999,41300,169970,45.4428909564632,40.98222825802337,NaN,NaN,-51.18619859714695,-152.8034440436169,-0.00872157832828141,-0.28350770903582045,-0.27478613070753904,-4661400,-4772920,26.69003512390013,36.56685959599357,NaN,NaN,-20.0579655912999,-17.469170408039673
2001-12-06T09:30:00-05:00,27.60001,27.78,27.5,27.67,34800,169160,41.143554699349494,40.8967196640853,NaN,NaN,-75.7690306237651,-121.11730990558013,-0.001887573324902303,-0.27714559736366695,-0.27525802403876465,-4696200,-4739440,28.98937288933709,37.53841603773706,NaN,NaN,-19.73545692169815,-17.7929256242766
2001-12-07T09:30:00-05:00,27.60001,27.85001,27.5,27.7,13700,167630,41.82747060291943,40.48230330321178,NaN,NaN,-62.097529712833094,-95.26696511171205,0.006918803104856763,-0.2666095201576937,-0.27352832326255044,-4682500,-4697600,31.865434350252812,38.454586633889356,NaN,NaN,-19.275777907403917,-18.004761664723357
2001-12-10T09:30:00-05:00,27.64999,27.64999,27.35001,27.50999,19200,166295,38.755730368112076,39.92513279544687,NaN,NaN,-85.43651928993236,-77.64238133537678,0.0024434853608601426,-0.27047396656147527,-0.2729174519223354,-4701700,-4688900,32.477831912768764,39.18281924019198,NaN,NaN,-19.765081950724696,-18.25623599129498
2001-12-11T09:30:00-05:00,27.45,27.45,26.99001,27.07001,33800,166705,32.75689698791555,38.861679848300305,NaN,NaN,-129.20418498207482,-80.73869264115048,-0.026080008052722037,-0.3055174619882379,-0.2794374539355159,-4735500,-4695460,32.24250908269107,39.57970791949255,NaN,NaN,-22.12986736060522,-18.80961190119644
2001-12-12T09:30:00-05:00,27.19,27.37,26.64,27.37,511500,190410,39.61946066957054,38.531108478390095,NaN,NaN,-123.56408974191449,-95.21427087010397,-0.020898585118887536,-0.3055606853341253,-0.28466210021523775,-4224000,-4607980,38.62856782987467,39.31040724523772,NaN,NaN,-21.944080653040935,-19.25739315145994
2001-12-13T09:30:00-05:00,26.99001,27.39,26.99001,27.34,41600,157665,39.18873667613041,38.20406866484926,NaN,NaN,-94.67596958351231,-98.99565866205342,-0.015874751123676922,-0.3045055391198339,-0.288630787996157,-4265600,-4521860,44.20376719071893,38.51895939085988,NaN,NaN,-21.928217696746167,-19.63893951507226
2001-12-14T09:30:00-05:00,27.25,27.3,27.08,27.14999,28200,148035,36.483374618983326,37.63739035784005,NaN,NaN,-96.63579005422072,-105.90331073033094,-0.021388331120230697,-0.3153662018964454,-0.2939778707762147,-4293800,-4444120,48.73139618736986,38.07559469145122,NaN,NaN,-22.74088991703149,-20.08207528678072
2001-12-17T09:30:00-05:00,27.2,27.41,27.19,27.27,24100,92430,39.33208853308578,37.70606774093246,NaN,NaN,-72.92664445622411,-103.40133576358929,-0.013384026619220113,-0.31070790405023985,-0.29732387743101973,-4269700,-4357720,53.269936674791154,38.014594170094426,NaN,NaN,-22.564624572895838,-20.436725184797165
2001-12-18T09:30:00-05:00,27.5,27.62,27.45,27.52,51300,92920,44.87824031056548,38.51324518417325,NaN,NaN,-21.396377412663995,-81.83977424970712,0.010999590155126415,-0.2835743897371117,-0.2945739798922381,-4218400,-4254300,58.056312604152275,38.39695301007924,NaN,NaN,-20.70664172608128,-20.475284690694895
2001-12-19T09:30:00-05:00,27.64999,28.11,27.3,28.11,52600,94675,55.27076107848822,40.07142499916982,NaN,NaN,58.35731792693789,-45.45549271593666,0.06604414846611623,-0.2120187943095928,-0.27806294277570903,-4165800,-4242660,58.57065419295953,39.44741266049132,NaN,NaN,-15.353601634575545,-19.743615682677845
2001-12-20T09:30:00-05:00,27.88,28,27.63,27.97,41800,95760,52.73026522262567,41.55501775488225,NaN,NaN,72.54835562412127,-12.01062767440994,0.0906834416670369,-0.16470864069191293,-0.25539208235894983,-4207600,-4231060,59.108805651913,41.0282181913871,NaN,NaN,-11.899373913271132,-18.623009715619744
2001-12-21T09:30:00-05:00,27.60001,27.73,27.50999,27.56,83100,99700,46.05403590487555,42.46613210600254,NaN,NaN,13.26333085114288,9.969196506662778,0.07753621614304035,-0.15847181218014939,-0.23600802832318973,-4290700,-4230440,59.139356272338844,42.939495477705336,NaN,NaN,-11.174653841228526,-17.558958876421
2001-12-24T09:30:00-05:00,27.7,27.78,27.55,27.78,32100,100305,49.73183363980951,43.086810019206766,NaN,NaN,57.38733618448496,36.0319926348046,0.08142273950008608,-0.13422960394808214,-0.21565234344816822,-4258600,-4228220,59.256735710975946,45.08790826243171,NaN,NaN,-9.346071217692781,-16.385689210888398
2001-12-26T09:30:00-05:00,27.85001,27.94,27.75,27.75,21400,97545,49.23886401073733,43.357950951654914,NaN,NaN,99.94859164550238,60.300986446437875,0.0796419538328011,-0.11609990115716684,-0.19574185498996793,-4280000,-4240540,58.256565041409914,47.3426603993967,NaN,NaN,-8.07061042792124,-15.19782081332166
2001-12-27T09:30:00-05:00,27.7,28.12,27.7,28.12,15700,97020,55.14449846385252,44.35801836340513,NaN,NaN,138.69627977563567,76.36877881617743,0.09974790579474252,-0.07105697274653977,-0.1708048785412823,-4264300,-4260240,56.611138562048,49.31564366173319,NaN,NaN,-5.021074689120969,-13.743999938435849
2001-12-28T09:30:00-05:00,28.14999,28.21001,27.96001,28.02,35800,64955,53.33833262666264,45.180222793672506,NaN,NaN,142.27875271936213,90.3148582352256,0.10229640601222587,-0.04293437102599995,-0.14523077703822582,-4300100,-4278740,55.03898765389593,50.97089746913627,NaN,NaN,-3.1292632441629498,-12.22760898211115
2001-12-31T09:30:00-05:00,28.2,28.3,28.00999,28.03,57400,66420,53.50234295033223,46.233552263831086,NaN,NaN,136.42564031521022,114.94732012803907,0.10049342784625163,-0.01961399223041127,-0.1201074200766629,-4242700,-4269140,55.72609463624104,52.63148766367,NaN,NaN,-1.5714808266340907,-10.705304959900142
2002-01-02T09:30:00-05:00,27.89999,28.45,27.69,28.42999,22500,60220,59.616648140760525,48.15210591760573,NaN,NaN,138.21041387870136,131.11193566688235,0.12071674828887258,0.03078851528442783,-0.08992823300444475,-4220200,-4261460,56.30144190772862,54.3499828654584,NaN,NaN,1.7596471038792336,-8.924597522217374
2002-01-03T09:30:00-05:00,28.5,28.58,28.12,28.58,71700,61680,61.65322430311675,49.72594617714474,NaN,NaN,167.88160661442961,144.6985386606678,0.13745730861501365,0.08189340276432233,-0.05556390585069133,-4148500,-4235160,58.29991531727669,55.75507911455855,NaN,NaN,5.1482828249895345,-6.914186044044959
2002-01-04T09:30:00-05:00,28.64999,28.7,28.3,28.45,76200,63425,58.88189644809571,51.13260044657084,NaN,NaN,154.91647039526043,147.94257678459275,0.13295449748098753,0.1106292160005431,-0.022325281480444444,-4224700,-4227240,58.90935169923592,56.805478008024046,NaN,NaN,7.136456898282183,-4.906951337998224
2002-01-07T09:30:00-05:00,28.60001,28.7,28.36,28.48,39800,63675,59.33615502885747,52.76494190441899,NaN,NaN,137.1865766910905,146.92414157893842,0.12528059348555287,0.13427546037649662,0.008994866890943767,-4184900,-4204200,60.70836160705579,57.66097553800161,NaN,NaN,8.884745938145468,-2.9367088699776973
2002-01-08T09:30:00-05:00,28.3,28.39,28.12,28.13,390600,82520,52.10392871548419,53.677216203161734,NaN,NaN,74.09362126343285,134.45773776858294,0.09148513658190369,0.12335128761832337,0.03186615103641969,-4575500,-4270760,53.43062493561673,57.67245327091773,NaN,NaN,8.284222559576653,-1.3337186657556472
2002-01-09T09:30:00-05:00,28.14999,28.24001,27.85001,27.88,26000,82860,47.63752059625563,53.8743076521396,NaN,NaN,31.27504158178481,113.07066330919963,0.04926206331914933,0.09344373018535634,0.04418166686620702,-4601500,-4347020,46.54575037062571,56.85027025423726,NaN,NaN,6.38100808898722,-0.23161484364952334
2002-01-10T09:30:00-05:00,27.7,28.16,27.64999,28.10001,35100,82925,51.57186834328862,53.61010102819677,NaN,NaN,22.33036671844375,83.96041533000246,0.03385278862726698,0.08649765265029075,0.05264486402302376,-4566400,-4430600,40.401197743798356,55.55245193644003,NaN,NaN,5.959846267298227,0.6528796007715838
2002-01-11T09:30:00-05:00,28.3,28.3,27.83,27.83,262900,70495,46.91312275329926,53.194590851816315,NaN,NaN,19.143767903733433,56.80587483169707,0.0047085740750496125,0.058530581616835775,0.05382200754178616,-4829300,-4551520,33.50907337463721,53.72389963092032,NaN,NaN,4.126017053682175,1.1490420940445254
2002-01-14T09:30:00-05:00,27.7,28.23,27.7,28.09,42400,70535,51.460199638825685,53.58074540424132,NaN,NaN,17.10565662941369,32.78969081936171,0.002296621400967036,0.05669278429299496,0.05439616289202792,-4786900,-4671920,28.32731347704781,51.52303943125668,NaN,NaN,3.989290460364453,1.5547918606616578
2002-01-15T09:30:00-05:00,28.37,28.37,27.92999,28.10001,86600,73455,51.63197027648103,53.716469449717856,NaN,NaN,43.22148006564196,26.615262579803538,0.0008073588843569429,0.055405361497474104,0.05459800261311716,-4700300,-4696880,27.38198535336923,49.24627154857048,NaN,NaN,3.9315085187775787,1.894322811821075
2002-01-16T09:30:00-05:00,28.09,28.17,27.95,27.98,40000,74250,49.375992475139874,53.72626434003232,NaN,NaN,3.5631938069103315,21.072893024828648,-0.00832492249880229,0.0441918494896143,0.05251677198841659,-4740300,-4724640,26.3295855064175,46.96577301035675,NaN,NaN,3.2233477146734115,2.084183512228552
2002-01-17T09:30:00-05:00,27.89999,27.94,27.57001,27.7,43700,73870,44.49151007479128,52.96533659795652,NaN,NaN,-105.618479039331,-4.516876126726316,-0.03196018460900061,0.012566541227165828,0.04452672583616644,-4784000,-4768160,24.725196413125417,44.68820571400513,NaN,NaN,1.1161480407872526,1.9458927305940805
2002-01-18T09:30:00-05:00,27.50999,27.74001,27.45,27.64999,34100,72945,43.66074663528544,52.27408045571529,NaN,NaN,-137.99542414078036,-35.944714535629075,-0.04869636634721733,-0.016343732097855224,0.032352634249362106,-4818100,-4765920,24.978589474823636,42.541034415499965,NaN,NaN,-0.8491927612361443,1.5465948031897627
2002-01-22T09:30:00-05:00,27.5,27.5,27.05,27.05,78600,74785,35.17474630783944,50.96496640982294,NaN,NaN,-229.23157258267764,-85.21216037804734,-0.09521844974099614,-0.08667042792688306,0.008548021814113071,-4896700,-4787880,24.121324195209,40.28355081256911,NaN,NaN,-5.569060978079498,0.5300725487227256
2002-01-23T09:30:00-05:00,27.10001,27.55,27.10001,27.45,128900,77075,43.1130097184077,49.78613509394061,NaN,NaN,-167.08824570815673,-127.27410553280708,-0.09393694700937845,-0.10887316194760999,-0.01493621493823154,-4767800,-4801380,23.58543218863423,37.94669297549093,NaN,NaN,-6.982971553987418,-0.5432194659501519
2002-01-24T09:30:00-05:00,27.5,27.64,27.21001,27.39,63600,78650,42.27671669313871,48.402098836085024,NaN,NaN,-139.12786200177226,-155.8123166945436,-0.09190228514690069,-0.1298140713718574,-0.037911786224956716,-4831400,-4819600,22.84766844476019,35.41438962745405,NaN,NaN,-8.36072918278394,-1.6600065683549787
2002-01-25T09:30:00-05:00,27.3,27.31,27.11,27.22,217200,88440,39.914276881152475,47.04726886701765,NaN,NaN,-157.124565508654,-166.1135339884082,-0.09631269719143615,-0.1583026577142519,-0.06198996052281575,-5048600,-4872520,20.81141758928773,32.69310861960061,NaN,NaN,-10.242473026017674,-2.8860732051639353
2002-01-28T09:30:00-05:00,27.2,27.28,27.10001,27.22,14000,88355,39.914276881152475,45.6599918564673,NaN,NaN,-131.68703723207608,-164.85185660666735,-0.09346303664386241,-0.17881875632764377,-0.08535571968378136,-5048600,-4918620,19.20564492488134,29.72862885658815,NaN,NaN,-11.737798901248663,-4.1506054474617535
2002-01-29T09:30:00-05:00,27.42,27.44,26.8,26.87,27700,87950,35.21552838310734,44.45367754701181,NaN,NaN,-135.71547498916848,-146.1486370879655,-0.10833544833132111,-0.22077503009793276,-0.11243958176661165,-5076300,-4954540,18.037797796809187,27.200569775244755,NaN,NaN,-14.535162043761346,-5.63411353264741
2002-01-30T09:30:00-05:00,26.7,26.84,26.28,26.84,49500,87555,34.83697057383564,43.53935254541039,NaN,NaN,-165.7385352762679,-145.87869500158774,-0.11286750434354953,-0.25352396219604856,-0.14065645785249903,-5125800,-5026140,15.955134985353752,25.015525819153904,NaN,NaN,-16.9007477261421,-7.243632703146651
2002-01-31T09:30:00-05:00,26.64999,27.09,26.64999,27.02,79400,90400,39.06921469079222,42.64630585594636,NaN,NaN,-110.64605815531459,-140.18233423229623,-0.09702189060463545,-0.26193382110829333,-0.16491193050365788,-5046400,-5069140,14.84647370994557,23.19018838816442,NaN,NaN,-17.692430528141333,-8.73631810671732
2002-02-01T09:30:00-05:00,27.25,27.34,27.05,27.08,17200,87675,40.45744130333726,42.18518575237765,NaN,NaN,-69.63184972554625,-122.68379107567466,-0.07667158864652088,-0.260751416311809,-0.1840798276652881,-5029200,-5065260,15.417592424797732,21.89793974889017,NaN,NaN,-17.954588559373295,-10.053213885668173
2002-02-04T09:30:00-05:00,27.25,27.25,26.66,26.8,18800,84805,36.300897024387055,41.10237842277489,NaN,NaN,-96.30178967088183,-115.6067415634358,-0.07608788747726142,-0.27918968701186486,-0.20310179953460344,-5048000,-5065140,15.43648281793024,20.977166130381768,NaN,NaN,-19.40943398254287,-11.389816756650273
2002-02-05T09:30:00-05:00,26.59,26.78999,26.3,26.44,14800,83555,31.780068993258396,39.68438547397327,NaN,NaN,-140.60375396920668,-116.58439735944344,-0.09285610073843081,-0.31917192545764195,-0.22631582471921113,-5062800,-5062440,15.891646170779694,20.156427617339663,NaN,NaN,-22.132581415897327,-12.924497422256994
2002-02-06T09:30:00-05:00,26.39999,26.5,25.78,25.91,123100,70180,26.53977231555156,38.053226891145535,NaN,NaN,-183.39218109069802,-120.11512652232946,-0.1302585053673998,-0.38913895642846086,-0.25888045106106106,-5185900,-5074460,15.491873071695593,19.382305300573815,NaN,NaN,-26.425956888639696,-14.853277346025951
2002-02-07T09:30:00-05:00,25.82001,26.42999,25.82001,26.28,99700,73865,34.64209773095578,37.349697438014424,NaN,NaN,-148.69465245858873,-127.72484538298427,-0.12090054262158312,-0.4100061293380399,-0.2891055867164568,-5086200,-5082420,15.21883736924488,18.70327965458235,NaN,NaN,-27.261914361339628,-16.62593977678505
2002-02-08T09:30:00-05:00,26.10001,26.48,26.10001,26.42,53800,74800,37.45318052747039,36.90629985888478,NaN,NaN,-115.7627235995885,-136.95102015779273,-0.09712715326030202,-0.4105145282918343,-0.3133873750315323,-5032400,-5083060,15.19564813925588,18.004498130613225,NaN,NaN,-26.990597903392405,-18.106605223443243
2002-02-11T09:30:00-05:00,26.49001,26.60001,26.2,26.60001,63500,64830,40.96886542021557,37.320165509768785,NaN,NaN,-87.12923730315636,-135.11650968424763,-0.06278997696522548,-0.3918748462380641,-0.32908486927283864,-4968900,-5067240,18.501370283817565,17.603072851228124,NaN,NaN,-25.626829213265985,-19.180922936275064
2002-02-12T09:30:00-05:00,26.55,26.83,26.48,26.60001,106900,68055,40.96886542021557,37.16701234561221,NaN,NaN,-57.17637686141764,-118.43103426268983,-0.03497634180069287,-0.37280529652370475,-0.3378289547230119,-4968900,-5048460,22.369952676302717,17.516252886061586,NaN,NaN,-24.554239930218447,-19.948539649695547
2002-02-13T09:30:00-05:00,26.7,26.95,26.64999,26.75999,46500,66050,44.20156367031591,37.30450141541058,NaN,NaN,-28.848259496726612,-87.52224994389555,-0.0024203045344733387,-0.34085433539110355,-0.3384340308566302,-4922400,-4995760,32.10894085602352,18.177772344008968,NaN,NaN,-22.68237832364589,-20.339088031688455
2002-02-14T09:30:00-05:00,26.61,26.99001,26.61,26.82001,82800,68190,45.40942394180556,37.697011919742934,NaN,NaN,-18.26140661938752,-61.435600776055296,0.025027839912088512,-0.3071492309665196,-0.3321770708786081,-4839600,-4946440,39.729485672269284,19.529062921364794,NaN,NaN,-20.794192363872263,-20.40410293628614
2002-02-15T09:30:00-05:00,26.99001,26.99001,26.64999,26.77,65700,69290,44.54419442987579,38.02772031608031,NaN,NaN,-11.722500846024072,-40.62755622534242,0.04075667794819293,-0.28123122344336693,-0.32198790139155986,-4905300,-4921020,43.264303141567396,21.247538508270942,NaN,NaN,-19.461314327872838,-20.269418849369956
2002-02-19T09:30:00-05:00,26.60001,26.75999,26.31,26.31,49900,70080,37.47167568921412,38.18887369508794,NaN,NaN,-72.77905280143642,-37.757519324998455,0.022058053384518828,-0.2944153346609113,-0.3164733880454301,-4955200,-4918280,43.64794988452576,23.076835085964984,NaN,NaN,-20.335813608379237,-20.27890381494271
2002-02-20T09:30:00-05:00,26.50999,26.64,26,26.64,23300,67315,44.30371024868865,38.865069386148875,NaN,NaN,-71.42872649063177,-40.60798925084128,0.033126854682128726,-0.2750648196927692,-0.3081916743748979,-4931900,-4910880,44.734856579213165,25.13252948552637,NaN,NaN,-18.94516211580657,-20.08836928649469
2002-02-21T09:30:00-05:00,26.39999,26.59,25.95,26.11,51200,63430,37.26189242913407,38.73597493888757,NaN,NaN,-104.28814414406918,-55.69596618030979,0.007314363278489,-0.29904872027678664,-0.30636308355527564,-4983100,-4923020,43.26068647260633,27.162116111430713,NaN,NaN,-20.077237554891163,-20.086779039122757
2002-02-22T09:30:00-05:00,26.14999,26.52,25.84,26.47,34100,61955,43.79649799909432,38.97447898858451,NaN,NaN,-84.70516877696917,-68.98471861182612,0.016519575455848146,-0.2857136142354655,-0.30223318969131363,-4949000,-4944900,40.66003241411063,28.965147539238778,NaN,NaN,-18.767332009085653,-19.898286606260314
2002-02-25T09:30:00-05:00,26.61,26.81,26.39999,26.77,32400,52715,48.600976654146685,39.85305610499591,NaN,NaN,8.749345565632845,-64.89034932949474,0.0433239421157986,-0.24807826204656536,-0.29140220416236395,-4916600,-4947160,40.38994259136613,30.747537523055627,NaN,NaN,-16.029594670697023,-19.345616329751273
2002-02-26T09:30:00-05:00,27,27,26.69,26.74001,446400,74335,48.15778730984336,41.022893127609116,NaN,NaN,54.26495773988381,-39.4815472212307,0.05859605374992388,-0.2181571369749591,-0.27675319072488297,-5363000,-5028720,32.10231371168345,31.90544234740589,NaN,NaN,-14.04951713398612,-18.58903073035625
2002-02-27T09:30:00-05:00,26.96001,27.21001,26.87,26.92,54700,75685,51.043237603403625,42.77314064816998,NaN,NaN,105.77859188158887,-4.040083546786573,0.07910626281211586,-0.17787036220973818,-0.25697662502185403,-5308300,-5104000,26.66394612219041,32.70344756529838,NaN,NaN,-11.505708248626144,-17.57712751868052
2002-02-28T09:30:00-05:00,27.11,27.28999,26.97,26.97,25500,74485,51.84505825986098,44.00192354309178,NaN,NaN,112.03951552383832,39.22544838679492,0.09334847351869185,-0.14029103312348923,-0.23363950664218108,-5282800,-5163940,23.281948075434983,33.27938404431196,NaN,NaN,-9.2177871093817,-16.382936031637833
2002-03-01T09:30:00-05:00,27.25,27.55,27.2,27.55,255100,83270,60.02414766982122,45.61413548183112,NaN,NaN,177.89147593201827,91.74477732859242,0.13652602583766246,-0.062981974345103,-0.19950800018276546,-5027700,-5179680,22.475760684547453,33.79939208326136,NaN,NaN,-4.37194738122554,-14.667080510150363
2002-03-04T09:30:00-05:00,27.75,27.88,27.53999,27.88,100400,87430,63.79235666722528,47.244384856617536,NaN,NaN,222.03986906352267,134.40288202817038,0.17931066468479873,0.024630330673232947,-0.15468033401156578,-4927300,-5181820,22.36238276319608,34.07517868893125,NaN,NaN,0.990812775464559,-12.430238612205375
2002-03-05T09:30:00-05:00,27.89999,27.97,27.69,27.86,88600,90920,63.402286345587726,48.84677206557268,NaN,NaN,196.42467892983444,162.83482626616052,0.1968613239013421,0.09139632086511185,-0.10546500303623024,-5015900,-5112400,33.99429426957373,34.90548880273632,NaN,NaN,5.068992650352563,-9.930348431839956
2002-03-06T09:30:00-05:00,27.95,28.45,27.89999,28.45,262000,103280,69.35529376440948,50.64346707229365,NaN,NaN,215.42709080374865,184.76452605059245,0.23615586714228462,0.18972983089162554,-0.04642603625065908,-4753900,-5001520,47.51915995316086,36.00621873824613,NaN,NaN,10.836959833769402,-6.963590108181476
2002-03-07T09:30:00-05:00,28.5,28.5,28.05,28.28,56000,99925,66.02288286858487,52.115856995635035,NaN,NaN,173.89835757766096,197.13629446135698,0.23797949926078085,0.251048337825317,0.01306883856453614,-4809900,-4906940,55.832653532942025,37.15644501400847,NaN,NaN,14.403413101811665,-3.911161078182456
2002-03-08T09:30:00-05:00,28.3,28.53999,28,28.2,63900,98135,64.45342140935182,53.53794463702617,NaN,NaN,142.3544551822962,190.02889031141257,0.22142267873731744,0.28984718698618295,0.0684245082488655,-4873800,-4876160,58.155776964044044,38.22012171561395,NaN,NaN,16.77024310082825,-0.9566747668952127
2002-03-11T09:30:00-05:00,28.10001,28.28999,27.96001,28.28999,75800,99235,65.44839899148593,55.53628201575988,NaN,NaN,114.57278045827806,168.53547259036364,0.20455698007542222,0.3241207333431433,0.11956375326772106,-4798000,-4850300,60.05667900081181,39.39217379534866,NaN,NaN,18.99720938574726,1.8938801120537119
2002-03-12T09:30:00-05:00,28.10001,28.19,27.92,28,46600,98390,59.653755355774706,56.63271380912317,NaN,NaN,86.52338488315813,146.55521378102839,0.16366614774077445,0.32414643794368914,0.16048029020291468,-4844600,-4816040,62.487977223544235,40.66025384137231,NaN,NaN,19.17591282487331,4.362741928170797
2002-03-13T09:30:00-05:00,28.10001,28.17999,27.96001,28,18600,93975,59.6537553557747,58.23213258959749,NaN,NaN,77.70976302762874,119.01174822580438,0.12799384813763276,0.3204726003749556,0.19247875223732286,-4844600,-4834180,60.391899608310275,41.88391192249402,NaN,NaN,19.319443671601395,6.499413605803739
2002-03-14T09:30:00-05:00,28.17999,28.2,27.85001,27.89999,56200,94460,57.61351265878748,59.21906220814701,NaN,NaN,64.27060266363374,97.08619724299894,0.0907882962128935,0.30596412250343974,0.21517582629054624,-4900800,-4852360,58.28188359053657,43.142615577953016,NaN,NaN,18.86747626584578,8.26627970009546
2002-03-15T09:30:00-05:00,27.8,28.05,27.8,27.91,21500,91395,57.76919835110451,59.873935186501136,NaN,NaN,52.73136994921815,79.16158019638331,0.061386402429733755,0.29190882932771345,0.2305224268979797,-4879300,-4853460,58.1494992760901,44.41115534114759,NaN,NaN,18.534677516540913,9.733193673873382
2002-03-18T09:30:00-05:00,27.61,28.08,27.61,28.03999,69700,91595,59.83247244394074,60.707841267508094,NaN,NaN,47.19893184085833,65.68681047289938,0.045933917520685735,0.28793982379883687,0.24200590627815113,-4809600,-4855780,57.851033830059535,46.250349635317306,NaN,NaN,18.78818917684745,11.026764460012535
2002-03-19T09:30:00-05:00,28.19,28.2,27.89,28.17,48200,91510,61.84055317063514,61.47907809373891,NaN,NaN,59.79928898715133,60.341991293698015,0.03993128030569498,0.29192000666026985,0.25198872635457487,-4761400,-4839140,59.45834361522372,48.5928065991054,NaN,NaN,19.539916902372884,12.242929094635441
2002-03-20T09:30:00-05:00,28.14999,28.23,27.84,28,25300,91610,57.77339726681337,61.9025308799498,NaN,NaN,48.783463579411496,54.556731404054574,0.020929343926045396,0.2781504062621316,0.2572210623360862,-4786700,-4827560,60.584804883012445,51.25729637107522,NaN,NaN,19.098016150112425,13.222227245417868
2002-03-21T09:30:00-05:00,28.2,28.3,28.06,28.3,27500,90425,62.46490071834343,62.076870383415674,NaN,NaN,69.47075441601554,55.596761754530974,0.02472241135841935,0.28812407653411043,0.2634016651756911,-4759200,-4799240,63.2724741266558,54.17134733122582,NaN,NaN,20.024043629863915,14.193915300338732
2002-03-22T09:30:00-05:00,28.3,28.36,27.97,27.97,119100,94675,55.199812845893945,61.46311725332057,NaN,NaN,50.73982472272511,55.19845270923237,0.00234263112356059,0.2663299540801418,0.2639873229565812,-4878300,-4799040,63.29151119533901,57.094856504950315,NaN,NaN,18.65919545576123,14.83181246539909
2002-03-25T09:30:00-05:00,27.97,28.13,27.8,28.00999,54700,95790,55.86964256147377,60.92507126874101,NaN,NaN,24.69978740219191,50.69862382149908,-0.011662039810352465,0.24940977319364066,0.2610718130039931,-4823600,-4801840,62.80073235420523,59.152459225281135,NaN,NaN,17.7376925116066,15.246938186285876
2002-03-26T09:30:00-05:00,28.10001,28.11,27.75,27.86,42700,75605,52.68772023729244,59.734530302518365,NaN,NaN,-2.2474266910458107,38.28928068585965,-0.03178070611964956,0.22134593035443118,0.25312663647408074,-4866300,-4822820,59.10262694600677,59.97984972477013,NaN,NaN,16.026870107536755,15.358357032178859
2002-03-27T09:30:00-05:00,27.95,28.14,27.75,27.92999,228500,84295,54.00412939858678,58.87604791180422,NaN,NaN,-7.709169293385938,26.990754111300163,-0.04056580820557815,0.20241937621710804,0.24298518442268618,-4637800,-4793040,62.48001616718566,60.454661341501826,NaN,NaN,14.95885812326403,15.30128575947674
2002-03-28T09:30:00-05:00,28.25,28.37,27.98,28.17999,33500,84695,58.4511091696478,58.44731132325393,NaN,NaN,72.26273914513853,27.54915105712476,-0.030206446889551014,0.20522712581074742,0.23543357270029844,-4604300,-4762060,65.65733700842148,60.99048705895735,NaN,NaN,15.283133944322072,15.298692643026072
2002-04-01T09:30:00-05:00,27.89999,27.92999,27.7,27.89,36300,73755,52.15244205739725,57.49760011367617,NaN,NaN,-104.0797155309806,-3.414756993616385,-0.04278281532358802,0.18195505354581343,0.22473786886940145,-4640600,-4714520,69.87343326799389,61.6916837923275,NaN,NaN,13.660463383564275,15.064659891674387
2002-04-02T09:30:00-05:00,27.64999,28.05,27.64999,28.05,35800,70525,55.03172143191034,57.16745483340014,NaN,NaN,-71.41300022106374,-22.63731451826751,-0.040260759579758304,0.17441191939470357,0.21467267897446188,-4604800,-4670760,73.14197103143034,62.45268335003366,NaN,NaN,13.147905699356171,14.790837864200356
2002-04-03T09:30:00-05:00,27.95,28.10001,27.81,28.05,14600,66825,55.03172143191034,56.837309553124115,NaN,NaN,-38.43631870810772,-29.87509292167989,-0.03852657819174904,0.16651445623477557,0.2050410344265246,-4604800,-4618460,76.4329037255155,63.59846935840546,NaN,NaN,12.734387424134386,14.497059229905217
2002-04-04T09:30:00-05:00,28,28.19,27.91,28.09,24000,54925,55.80285153069387,56.70797661540314,NaN,NaN,13.96236225669038,-25.54078661166463,-0.03473661342273099,0.16162026764811088,0.19635688107084187,-4580800,-4607060,77.09180976620458,64.94203551381031,NaN,NaN,12.600045082696413,14.226057208875387
2002-04-05T09:30:00-05:00,28.25,28.25,27.8,27.94,12400,52745,52.188641900878466,56.309365440387,NaN,NaN,-23.089277339509366,-44.611189908594206,-0.04190298403032178,0.14397815103293965,0.18588113506326143,-4593200,-4604840,77.2253468815864,66.30459605706005,NaN,NaN,11.480226938355825,13.833795741658307
2002-04-08T09:30:00-04:00,27.89999,27.89999,27.53,27.74001,51500,52125,47.74829856182746,55.44621016309319,NaN,NaN,-202.50739227350186,-64.29672525709846,-0.05865564004090462,0.11256158501213065,0.17121722505303527,-4644700,-4605660,77.04669369069073,67.67571461853372,NaN,NaN,9.213005183952445,13.173682804843184
2002-04-09T09:30:00-04:00,27.89999,27.89999,27.14999,27.14999,366700,66670,37.58751302892405,53.71385015297097,NaN,NaN,-327.4204648116294,-115.4982181752116,-0.1052957074646777,0.03959759072218816,0.14489329818686586,-5011400,-4686980,61.782197858766025,67.84170420735816,NaN,NaN,3.563526198464685,11.800803289646256
2002-04-10T09:30:00-04:00,27.17999,27.72,27.17999,27.72,25100,65595,48.90069562763207,53.08008575017231,NaN,NaN,-196.93146239410882,-147.1972469124118,-0.09395328116860413,0.027451696726110697,0.12140497789471483,-4986300,-4763280,51.47705528255967,67.19115066446868,NaN,NaN,2.4769228539630412,10.46882037026294
2002-04-11T09:30:00-04:00,27.44,27.44,26.86,26.89,262600,77795,38.07737332324108,51.338119507665,NaN,NaN,-293.11832032779245,-208.61338342930839,-0.135994368834203,-0.048587983148038916,0.08740638568616407,-5248900,-4896900,39.15874739283421,65.46874161205285,NaN,NaN,-2.937054910179817,8.55369533019969
2002-04-12T09:30:00-04:00,26.89999,27.07001,26.64999,27.07001,19900,75980,41.121118753491956,50.332498501064855,NaN,NaN,-239.32936371164428,-251.86140070373534,-0.144524908247529,-0.09324974962324717,0.05127515862428182,-5229000,-5024060,31.446607557108663,63.194105637893536,NaN,NaN,-5.827243922964509,6.4992754368905175
2002-04-15T09:30:00-04:00,26.86,26.86,26.62,26.64999,101800,79995,36.600443351801005,48.95612712894537,NaN,NaN,-216.11581732857616,-254.5830857147502,-0.16956761157167624,-0.1606843558403135,0.008883255731362755,-5330800,-5161280,25.589760263741653,60.536179060003285,NaN,NaN,-9.890186547788424,4.157923724793526
2002-04-16T09:30:00-04:00,26.95,27.36,26.88,27.3,54200,79220,46.417783306429236,48.50827449102657,NaN,NaN,-102.7640186996084,-209.65179649234602,-0.1349737457504066,-0.15983392645664551,-0.024860180706238903,-5276600,-5214320,23.748571266641576,58.010889368620056,NaN,NaN,-9.432254656855424,2.2164696702722475
2002-04-17T09:30:00-04:00,27.5,27.61,27.35001,27.44,41500,78885,48.27557064283616,48.099091722758665,NaN,NaN,-43.902264103764935,-179.04595683427723,-0.09705431560582754,-0.14617807521352333,-0.049123759607695786,-5235100,-5264080,22.139202163800732,55.129402654092566,NaN,NaN,-8.404463487540744,0.6991935048703917
2002-04-18T09:30:00-04:00,27.45,27.45,26.89999,27.37,102200,82730,47.39081330841439,47.30907058981342,NaN,NaN,-74.83022862011069,-135.38833849274087,-0.07221878834172903,-0.13939724503485706,-0.06717845669312804,-5337300,-5281760,21.57963924783607,51.980995671193604,NaN,NaN,-7.922218385606099,-0.5324367651976785
2002-04-19T09:30:00-04:00,27.16,27.16,26.95,27.13,47700,83740,44.387145776780734,46.75440656976939,NaN,NaN,-90.98657169377981,-105.71978008916797,-0.06757031892575177,-0.15164135535031775,-0.08407103642456598,-5385000,-5312960,20.590601192249395,48.460793380069,NaN,NaN,-8.523839919088942,-1.6740657871821447
2002-04-22T09:30:00-04:00,26.82001,26.85001,26.7,26.72,18900,78730,39.751898845879964,45.66299067076721,NaN,NaN,-128.73213368673035,-88.24304336079881,-0.08651338315279582,-0.19221276536556076,-0.10569938221276494,-5403900,-5327580,20.12513820156755,44.67387674936451,NaN,NaN,-10.598147027237689,-2.9489345357615084
2002-04-23T09:30:00-04:00,26.8,27.24001,26.8,26.85001,120000,81995,41.82642536776626,44.71975523761406,NaN,NaN,-85.24661619269091,-84.73956285941532,-0.08459077875637963,-0.21143785565823947,-0.12684707690185984,-5283900,-5329040,20.076330244941502,40.6484072150378,NaN,NaN,-11.579949242240593,-4.181936636687092
2002-04-24T09:30:00-04:00,26.7,27.17,26.7,26.92,49600,82340,42.964998686041774,43.802765748710335,NaN,NaN,-81.80490814204762,-92.32009166707185,-0.073328300287958,-0.21850745226180734,-0.14517915197384934,-5234300,-5328880,20.099199640932795,36.5775064918041,NaN,NaN,-12.016620538252084,-5.301177194053519
2002-04-25T09:30:00-04:00,26.50999,26.92,26.50999,26.74001,37000,72765,40.755862901321805,42.986138677313434,NaN,NaN,-103.28145428522758,-98.0103368000952,-0.07258817699830891,-0.23591437322173547,-0.16332619622342656,-5271300,-5315680,22.080116305040775,32.63856145062227,NaN,NaN,-13.041702404743774,-6.406966509866413
2002-04-26T09:30:00-04:00,26.53,26.64999,25.39999,26.31,22300,72205,35.99423535865202,42.14656273422948,NaN,NaN,-175.99271728776029,-115.0115659188913,-0.09427230973788875,-0.2811665833957875,-0.18689427365789874,-5293600,-5297400,24.858436197778175,28.91082877255709,NaN,NaN,-15.446220482107197,-7.698288505900811
2002-04-29T09:30:00-04:00,26.39999,26.39999,25.92,25.92,226900,81735,32.30751940800634,41.76942033273536,NaN,NaN,-161.6644687997992,-121.59803294150508,-0.12610660326445777,-0.34452752773847095,-0.21842092447401318,-5520500,-5320720,23.697588753969555,26.190499550785916,NaN,NaN,-18.71603081687237,-9.272251693182461
2002-04-30T09:30:00-04:00,26.14999,26.49001,26.03999,26.47,56800,82785,41.4200407218783,41.235087839467226,NaN,NaN,-113.98970158578945,-127.3466500201248,-0.10235798821449346,-0.34636840974213,-0.24401042152763655,-5463700,-5356680,21.99211819673478,24.08443261608414,NaN,NaN,-18.525133369406696,-10.594091932643066
2002-05-01T09:30:00-04:00,26.31,26.78,26.11,26.72,45300,84320,45.04158914918078,41.73253182703435,NaN,NaN,-77.68808564103904,-126.52328551992306,-0.06392802911755141,-0.3239204579245758,-0.2599924288070244,-5418400,-5393500,20.375190741685827,22.742749998144973,NaN,NaN,-17.168708184795324,-11.533322825807675
2002-05-02T09:30:00-04:00,26.77,26.77,26.45,26.55,11700,83705,43.09074390486901,41.873219337847,NaN,NaN,-63.400259424594715,-118.5470465477965,-0.04496836384896574,-0.31620288361823157,-0.2712345197692658,-5430100,-5425260,19.072580961962316,21.858890955634518,NaN,NaN,-16.689433908740973,-12.269910123369575
2002-05-03T09:30:00-04:00,26.66,26.66,26.32001,26.39999,25100,84340,41.38728362759247,42.215136500403524,NaN,NaN,-77.46627188739845,-98.84175746772416,-0.03782799143537241,-0.31851950906348137,-0.28069151762810896,-5455200,-5457580,17.823794023041884,21.30417908129882,NaN,NaN,-16.81967858168836,-12.919877045986544
2002-05-06T09:30:00-04:00,26.5,26.55,26.25,26.25999,73800,85455,39.8057223037724,41.742846428785185,NaN,NaN,-87.79838083443498,-84.06853987465132,-0.03774500046724921,-0.3278727682121705,-0.29012776774492127,-5529000,-5459280,17.757932233376735,20.87627629320847,NaN,NaN,-17.39727639045629,-13.559505523767937
2002-05-07T09:30:00-04:00,26.09,26.19,25.95,26,29000,68570,36.97957786718587,40.93598980195303,NaN,NaN,-131.26392614879953,-87.52338478725333,-0.049661242979020914,-0.3522043214686974,-0.3025430784896765,-5558000,-5478140,17.00710301351927,20.509697782474085,NaN,NaN,-18.736385440438763,-14.299059797578055
2002-05-08T09:30:00-04:00,26.06,26.46001,26.02,26.37,34500,69040,43.164038374599755,40.634077306680545,NaN,NaN,-79.54788941910446,-87.89534554286641,-0.02815602540240758,-0.33773811024268596,-0.3095820848402784,-5523500,-5499160,16.185700589225974,20.12441644971622,NaN,NaN,-18.004760728943094,-14.828445644915918
2002-05-09T09:30:00-04:00,26.22,26.53999,26.14999,26.14999,175700,64695,40.611927736981706,40.36441887526633,NaN,NaN,-72.14587595639591,-89.64446884922664,-0.024419109716516563,-0.34010597198592407,-0.3156868622694075,-5699200,-5552980,14.283501428642609,19.673909323744308,NaN,NaN,-18.163522230378852,-15.30488515712491
2002-05-10T09:30:00-04:00,26.17999,26.21001,25.53,25.55,237900,75595,34.603230189754385,39.99665682840021,NaN,NaN,-149.96053110199267,-104.1433206921455,-0.056208696528646684,-0.3859477329302159,-0.3297390364015692,-5937100,-5649360,11.644333472083659,19.0681375573526,NaN,NaN,-20.271429630916334,-16.014391510523684
2002-05-13T09:30:00-04:00,25.5,25.94,25.35001,25.86,177200,79365,39.577483666277544,39.83601813543673,NaN,NaN,-137.27585965642137,-114.03881645654276,-0.05039759728664184,-0.3927360330098715,-0.34233843572322964,-5759900,-5695540,10.630774669161681,18.393455016225467,NaN,NaN,-20.410788620140224,-16.642448240468905
2002-05-14T09:30:00-04:00,26.03999,26.25999,26,26.25,69000,80105,45.22245540942606,39.99726504424989,NaN,NaN,-56.444465577119196,-99.0749243422067,-0.01610346447288158,-0.36246776631433164,-0.34636430184145006,-5690900,-5722120,10.08656846603526,17.678267075161354,NaN,NaN,-18.667249724202772,-16.93170559528803
2002-05-15T09:30:00-04:00,26.23,26.36,26.10001,26.11,57400,80900,43.64609166762868,40.203709956128954,NaN,NaN,-47.186673026677944,-92.60268106372139,0.00045886809469602996,-0.34579071672308004,-0.34624958481777607,-5748300,-5767080,9.22621274875226,16.76013110685503,NaN,NaN,-17.759432088205134,-17.04995223713333
2002-05-16T09:30:00-04:00,26.31,26.42,26.13,26.21001,13800,76480,45.1178400527668,40.855396005708585,NaN,NaN,-28.595025526093334,-83.89251097766086,0.020354858588549463,-0.3208060115820892,-0.3411608701706387,-5734500,-5774140,9.09502252609353,15.634172987448986,NaN,NaN,-16.579139801537295,-16.982693317762468
2002-05-17T09:30:00-04:00,26.02,26.12,25.66,25.96001,45600,76375,42.15416054829089,41.55872751572891,NaN,NaN,-99.78194494043353,-73.85679374534905,0.018914127235739375,-0.31751821112596446,-0.33643233836170383,-5780100,-5742740,14.891455247184481,15.005163451250052,NaN,NaN,-16.462484834259584,-16.9083778201192
2002-05-20T09:30:00-04:00,25.99001,26.14999,25.86,26.10001,32200,77040,44.35838284221273,41.7686090957528,NaN,NaN,-64.41236254517597,-59.284094323099964,0.029021257275630652,-0.3001557667671655,-0.32917702404279614,-5747900,-5740340,15.335819507458396,14.529713544873166,NaN,NaN,-15.719812584285716,-16.7385827864287
2002-05-21T09:30:00-04:00,26.17999,26.57001,26.10001,26.28999,54400,73760,47.29341376971597,41.92945371150531,NaN,NaN,19.175116169134903,-44.160177973849144,0.04895999218116487,-0.2679770338163401,-0.31693702599750495,-5693500,-5740860,15.317159106723437,14.168425570947281,NaN,NaN,-14.236889787872151,-16.381198072349193
2002-05-22T09:30:00-04:00,26.41,26.75999,26.37,26.75999,107100,76635,53.78788033618648,42.69353488517084,NaN,NaN,122.44730293646074,-10.233382781221412,0.09177439761215078,-0.20221902898231647,-0.29399342659446726,-5586400,-5708480,21.705708543696616,14.356506112499732,NaN,NaN,-10.891410241598901,-15.596942667956293
2002-05-23T09:30:00-04:00,26.64,27.25,26.64,27.24001,35700,76570,59.30336024682448,43.97325464368742,NaN,NaN,231.2303413519567,41.731690594388596,0.14711270884820526,-0.11010254053421065,-0.2572152493824159,-5550700,-5671720,28.317279480043666,15.10604078799986,NaN,NaN,-6.141570303287492,-14.246175187289321
2002-05-24T09:30:00-04:00,27.14999,27.25,26.96001,26.96001,78200,79365,55.1672497404211,45.070506603448045,NaN,NaN,193.45340859433145,100.3787613013416,0.1585618354212758,-0.05901295510582116,-0.21757479052709697,-5628900,-5641480,33.30667465970035,16.216665247022974,NaN,NaN,-3.48038966340068,-12.708205826733801
2002-05-28T09:30:00-04:00,26.89999,27.16,26.86,27.14999,20900,69065,57.341230474615834,46.52491036112161,NaN,NaN,161.32672431895844,145.52657867416846,0.17153352033298994,-0.0031578901108595403,-0.17469141044384948,-5608000,-5613500,37.63225210763152,17.689890182316706,NaN,NaN,-0.6144250287140186,-10.980522855588118
2002-05-29T09:30:00-04:00,26.95,26.95,26.62,26.7,19400,67195,51.029333929228386,47.08671718645223,NaN,NaN,81.3033944532025,157.95223433098198,0.1435471682528492,0.00474254987221201,-0.13880461838063718,-5627400,-5600280,39.62471100608436,19.36410521209231,NaN,NaN,-0.12456348938552511,-9.429671517559177
2002-05-30T09:30:00-04:00,26.48,26.64999,26.16,26.45,51400,67500,47.87625484783956,47.60559769437065,NaN,NaN,11.48106160472767,135.7589860646354,0.10379192445038354,-0.00906471281765775,-0.1128566372680413,-5678800,-5618760,37.80647325336261,21.04431748528659,NaN,NaN,-0.7170306579980166,-8.185008537621869
2002-05-31T09:30:00-04:00,26.3,26.60001,26.24001,26.25,655200,99675,45.45642456845926,48.380825864278144,NaN,NaN,1.7390831986424022,89.86073443397251,0.061698523290351304,-0.035733483155102164,-0.09743200644545347,-6334000,-5775420,26.644644921156612,22.115768303077516,NaN,NaN,-1.9574343882689582,-7.29535508771431
2002-06-03T09:30:00-04:00,26.19,26.31,25.64999,25.64999,425200,119680,39.07551457373547,48.34497092909656,NaN,NaN,-99.03901391186224,31.36224993273378,-0.005322111077525449,-0.10408464529236028,-0.09876253421483483,-6759200,-6001480,18.264821212158154,22.66105734186298,NaN,NaN,-5.189949678319086,-6.994582886372135
2002-06-04T09:30:00-04:00,25.50999,25.91,25.50999,25.74001,39800,117980,40.42666731214387,48.00241463643355,NaN,NaN,-116.38971535556077,-24.18103800217007,-0.040405087167607684,-0.14926889317434444,-0.10886380600673676,-6719400,-6223760,13.701709911321231,22.919281730811974,NaN,NaN,-7.343775498879844,-7.044467545301808
2002-06-05T09:30:00-04:00,25.74001,25.98,25.5,25.64,27200,117890,39.3817153945031,47.69781633121029,NaN,NaN,-110.78781574104897,-62.59928004102036,-0.06566622949442374,-0.19094659287476645,-0.1252803633803427,-6746600,-6447600,10.780797587513973,23.030323505009243,NaN,NaN,-9.40923763865289,-7.382291844351963
2002-06-06T09:30:00-04:00,25.67,25.67,24.89,24.89,471100,139720,32.5804727656802,46.802290096418396,NaN,NaN,-179.74552234390475,-100.84459683074685,-0.12477818256104886,-0.2812530915816538,-0.15647490902060493,-7217700,-6755380,8.194160046760615,22.96597618505689,NaN,NaN,-13.614321438027543,-8.272581786305617
2002-06-07T09:30:00-04:00,24.87,25.28999,24.85001,25.17999,56100,133740,37.10347432164713,46.44152679451526,NaN,NaN,-157.2033767301714,-132.63308881650963,-0.13535429483075692,-0.3256677775590511,-0.19031348272829415,-7161600,-6920900,7.194443952973728,22.416189664041838,NaN,NaN,-15.619779558102694,-9.322181467990914
2002-06-10T09:30:00-04:00,25.19,25.50999,25.02,25.27,47300,124210,38.482996323787695,46.02185632891348,NaN,NaN,-122.21626467117365,-137.2685389683719,-0.1274084216960562,-0.3495740098483644,-0.2221655881523082,-7114300,-6991920,6.810501439153768,21.807238373448648,NaN,NaN,-16.796430994395234,-10.389931400334389
2002-06-11T09:30:00-04:00,25.39999,25.50999,24.85001,24.85001,15700,116135,34.66269853656878,45.119662383688684,NaN,NaN,-135.16097650817898,-141.02279119889553,-0.1405264817219002,-0.39782369030468345,-0.25729720858278327,-7130000,-7074040,6.386117599077977,21.16930683718826,NaN,NaN,-19.02804111484986,-11.623947073836598
2002-06-12T09:30:00-04:00,25.05,25.37,24.92,25.36,23100,113840,42.17007754175444,44.28981932694353,NaN,NaN,-101.59099409487558,-139.18342686966088,-0.10648989731887265,-0.39040958023137406,-0.2839196829125014,-7106900,-7146100,6.030979240391488,20.049683315523605,NaN,NaN,-18.520329951265232,-12.609144627754974
2002-06-13T09:30:00-04:00,25.36,25.55,25.32001,25.33,14300,111685,41.86533993840767,43.044246447770895,NaN,NaN,-71.5287546218005,-117.54007332524002,-0.07890013759051395,-0.3825448549006438,-0.3036447173101299,-7121200,-7126800,7.514461091728023,18.563767716358203,NaN,NaN,-18.213810736868663,-13.409811214771215
2002-06-14T09:30:00-04:00,24.73,25.09,24.61,25.00999,29100,112450,38.65634238652733,41.86489592249278,NaN,NaN,-113.86027891148413,-108.87145376150256,-0.07512535477770388,-0.39755141078225975,-0.32242605600455587,-7150300,-7124540,7.698217898849705,16.734592233440303,NaN,NaN,-18.937488210441554,-14.199479357009835
2002-06-17T09:30:00-04:00,25.24001,25.57001,25.24001,25.57001,46600,112500,46.39934695653358,41.08333281405833,NaN,NaN,-49.2192526752747,-94.27205136232276,-0.030142533906072688,-0.36010422338714676,-0.32996168948107407,-7103700,-7122420,7.8831111127647375,14.609653590949815,NaN,NaN,-17.07024419742469,-14.609588619926242
2002-06-18T09:30:00-04:00,25.64,25.83,25.5,25.75999,31000,112440,48.76210971654775,40.92138822743828,NaN,NaN,-22.42751211275555,-71.72535848323807,0.014764225700679479,-0.3115064073552247,-0.3262706330559042,-7072700,-7110960,8.944925195509938,12.418240318765926,NaN,NaN,-14.804281175404546,-14.637401842137429
2002-06-19T09:30:00-04:00,25.8,25.8,24.97,25.05,57300,112585,41.414709631782955,40.459849283434245,NaN,NaN,-61.611406851716104,-63.72944103460617,-0.00019840852618069338,-0.32651864371363004,-0.32632023518744935,-7130000,-7115580,8.900384190295597,10.353519671404,NaN,NaN,-15.212457494725223,-14.719552649649971
2002-06-20T09:30:00-04:00,25.03999,25.03999,24.62,24.75,38900,109175,38.757300471273986,39.98134041934958,NaN,NaN,-103.65942341456984,-70.15557479316004,-0.025736596732528205,-0.3584909811031096,-0.3327543843705814,-7168900,-7125120,8.80290755612971,9.079109859616363,NaN,NaN,-16.422414209372054,-14.962818586753126
2002-06-21T09:30:00-04:00,24.49001,24.60001,24.25,24.60001,61900,110485,37.46300868888456,39.86616142757451,NaN,NaN,-130.67920786858335,-73.51936058457989,-0.046932636605836575,-0.39142018012787716,-0.3444875435220406,-7230800,-7141220,8.631108593702209,8.390987529726655,NaN,NaN,-17.801954677746227,-15.368409456894998
2002-06-24T09:30:00-04:00,24.48,24.48,24.06,24.19,40400,108595,34.10970093662549,39.41494954360892,NaN,NaN,-149.31614988010114,-93.53874002554518,-0.08078287056398648,-0.44546613172702365,-0.3646832611630372,-7271200,-7174720,8.269469270710601,8.00297034111161,NaN,NaN,-20.054066861261504,-16.037789086090214
2002-06-25T09:30:00-04:00,24.2,24.37,23.97,24.03,140500,114575,32.873121770361536,38.95004999902738,NaN,NaN,-156.6250922735788,-120.37825605770982,-0.10465084838932637,-0.4954968216496951,-0.39084597326036874,-7411700,-7242520,7.577474050424044,7.774161517033759,NaN,NaN,-22.267770306177585,-16.927786403245552
2002-06-26T09:30:00-04:00,23.46001,23.89999,23.46001,23.78,30600,115135,30.98307216926112,38.83594995642601,NaN,NaN,-190.57691206813007,-146.17135710099262,-0.1265160119129093,-0.5489909881515054,-0.4224749762385961,-7442300,-7304980,6.996615441234496,7.688622616639036,NaN,NaN,-24.700229492077284,-18.0381354159358
2002-06-27T09:30:00-04:00,23.84,24.00999,23.33,23.75999,45200,114825,30.830279863932716,38.38786463801784,NaN,NaN,-166.0431706073591,-158.64810653955047,-0.13101386214660582,-0.5862423039218534,-0.45522844177524757,-7487500,-7368700,6.453145070550505,7.635672696465948,NaN,NaN,-26.705080015120846,-19.27627035867652
2002-06-28T09:30:00-04:00,23.88,24.25,23.75,24.25,30200,83575,38.79071566932617,38.409844591270584,NaN,NaN,-104.1815862694045,-153.3485822197147,-0.09154354013587629,-0.5696578669450929,-0.4781143268092166,-7457300,-7414000,6.090920491524614,7.584274057349579,NaN,NaN,-26.116184185052703,-20.25340090530169
2002-07-01T09:30:00-04:00,24.37,24.37,23.75,23.75,44400,64535,34.435791117418546,38.393636918474144,NaN,NaN,-104.49174752014262,-144.383701747723,-0.08955539817960922,-0.5900585745337281,-0.5005031763541189,-7501700,-7460100,5.737940617272514,7.537975701506331,NaN,NaN,-26.953887249299495,-21.21061324015852
2002-07-02T09:30:00-04:00,23.64,23.75,23.12,23.25,41800,64635,30.721469453661157,37.57587919789604,NaN,NaN,-146.21545282277017,-142.30177385756127,-0.11096046734993203,-0.6392037605415339,-0.5282432931916019,-7543500,-7486460,5.540232646068148,7.502922373340376,NaN,NaN,-28.883155051060644,-22.306690641715967
2002-07-03T09:30:00-04:00,23.28,23.35001,22.99001,23.11,32400,64895,29.753740505950972,36.710764952720574,NaN,NaN,-146.20237921684264,-133.42686728730376,-0.1226785986320369,-0.681591541481648,-0.5589129428496111,-7575900,-7513180,5.339399104961359,7.347560802857042,NaN,NaN,-30.73920753436979,-23.511335912095085
2002-07-05T09:30:00-04:00,23.11,23.38,22.98,23.38,33700,43025,34.06727415680642,36.38297436488337,NaN,NaN,-119.59728719878387,-124.13769060558874,-0.1012660096010265,-0.6854954548508942,-0.5842294452498678,-7542200,-7524120,5.255399064594172,7.173073743267361,NaN,NaN,-30.97439618745862,-24.57748738000416
2002-07-08T09:30:00-04:00,23.3,23.46001,23.07001,23.08,26400,41540,31.735444876082354,35.33555278770829,NaN,NaN,-109.6070268515218,-125.22277872201221,-0.09635547288227708,-0.7046737863527142,-0.6083183134704371,-7568600,-7546380,5.080266804283937,6.972870578375876,NaN,NaN,-31.883429538688766,-25.62119340267339
2002-07-09T09:30:00-04:00,23.06,23.11,22.42,22.47,79500,43150,27.59884481474326,33.823891009007966,NaN,NaN,-140.1916365179202,-132.36275652156775,-0.12160938347411787,-0.7603300428130844,-0.6387206593389665,-7648100,-7575660,4.851261402955473,6.680466021764843,NaN,NaN,-34.03253545831683,-26.82281369633674
2002-07-10T09:30:00-04:00,22.32001,22.32001,21.17,21.2,96800,47205,21.357169125598006,32.39120954428047,NaN,NaN,-200.6030159979033,-143.24026915659437,-0.2062884192701192,-0.8965811834266155,-0.6902927641564963,-7744900,-7615940,4.547563987375369,6.369550292984827,NaN,NaN,-38.43406608691173,-28.481564037847452
2002-07-11T09:30:00-04:00,20.89999,21.94,20.84,21.94,63300,49215,31.130643963974208,31.846448365187626,NaN,NaN,-171.06585081896046,-148.21296347701792,-0.19503127999732572,-0.9340818641531534,-0.7390505841558277,-7681600,-7637080,4.392159094965919,6.054496831473128,NaN,NaN,-38.380183135382836,-29.895652480352506
2002-07-12T09:30:00-04:00,21.36,21.44,20.89,21.12,64900,51745,27.110075965896215,31.10695317068846,NaN,NaN,-173.94748401865166,-159.08300284099147,-0.2233443624438669,-1.0182310372106613,-0.7948866747667944,-7746500,-7677940,4.100484185099887,5.730880802287247,NaN,NaN,-39.87373085625516,-31.321092248338598
2002-07-15T09:30:00-04:00,20.99001,21.45,19.64999,21.45,162200,58400,30.973732128215488,30.88295539865918,NaN,NaN,-163.57329884329278,-169.87625723934568,-0.20107571432426075,-1.0462313176721203,-0.8451556033478596,-7584300,-7681080,4.078071606492443,5.431495254843093,NaN,NaN,-39.610019212214844,-32.50522467174949
2002-07-16T09:30:00-04:00,21.50999,21.50999,20.75999,20.82001,127300,62435,27.930000763047047,30.529875326708144,NaN,NaN,-134.60188052853763,-168.75830604146918,-0.20907680361032077,-1.1065016078607606,-0.8974248042504398,-7711600,-7693780,3.983240254331207,5.17476426940789,NaN,NaN,-40.491884340363804,-33.6461760529801
2002-07-17T09:30:00-04:00,21.3,21.3,20.42999,20.42999,56700,63720,26.212640319781755,30.189130194602473,NaN,NaN,-131.7770612798428,-154.99311509785707,-0.2198400944448009,-1.172224922306441,-0.95238482786164,-7768300,-7698460,3.946817651914799,4.95692157017077,NaN,NaN,-41.78833937665863,-34.80934224207704
2002-07-18T09:30:00-04:00,20.39999,20.48,19.95,19.95,64500,64080,24.237456390530994,29.718214232216635,NaN,NaN,-140.54347408012512,-148.88863975009002,-0.23701106537540895,-1.2486486595809012,-1.0116375942054923,-7832800,-7728700,3.71070895702654,4.7610332763476295,NaN,NaN,-43.51816303142564,-36.05345949769826
2002-07-19T09:30:00-04:00,19.64999,19.64999,18.67999,18.83,171600,70715,20.37872684991119,28.403072173686997,NaN,NaN,-164.8889971405222,-147.07694237446412,-0.2976018622425556,-1.3836399220086868,-1.0860380597661312,-8004400,-7780280,3.343319236872773,4.564776043872497,NaN,NaN,-46.45297733339017,-37.539104902797106
2002-07-22T09:30:00-04:00,19.10001,19.10001,18.07001,18.37,103800,72810,19.03810726129997,27.303237612535668,NaN,NaN,-161.37978631233665,-146.63823986827293,-0.3394331421692163,-1.5103294874776516,-1.1708963453084353,-8108200,-7885060,2.7480916401368916,4.351215402648525,NaN,NaN,-49.251440784964814,-39.21229574310678
2002-07-23T09:30:00-04:00,18.57001,18.75,16.67,16.94,277700,84675,15.601967819541457,26.223273210098547,NaN,NaN,-177.16380855660105,-155.15062547388558,-0.4284429526050131,-1.7064500360647017,-1.2780070834596886,-8385900,-8019920,2.204166579418967,4.11292496931644,NaN,NaN,-53.055388655502774,-41.18988044487764
2002-07-24T09:30:00-04:00,16.39999,18.45,16.39999,18.45,380900,96695,29.974377323504058,26.239032982780913,NaN,NaN,-146.10565414317074,-158.01634404655118,-0.35375687084111496,-1.7202031720110824,-1.3664463011699675,-8005000,-8067260,2.0507243408468128,3.878019629022543,NaN,NaN,-50.51193146064681,-42.521602018558944
2002-07-25T09:30:00-04:00,18.5,19.33,18.00999,19,270200,108675,34.35910079651174,26.259877742759866,NaN,NaN,-95.72327236493896,-149.05230370351393,-0.24084321678049703,-1.6675003221455889,-1.4266571053650918,-7734800,-8047660,4.999481375692227,3.8597397941009755,NaN,NaN,-46.905149544707584,-43.147823093723034
2002-07-26T09:30:00-04:00,19.36,19.36,18.50999,18.75,139300,113380,33.337273932345425,26.37429410392151,NaN,NaN,-83.65263692544977,-132.80503166049945,-0.16039358196777553,-1.6271490828248112,-1.4667555008570357,-7874100,-8021600,8.925371954432961,4.134390161968763,NaN,NaN,-44.539213584147035,-43.3465931637836
2002-07-29T09:30:00-04:00,19.05,19.25,18.62,19.05,114500,117595,35.80448411849494,26.96041119704663,NaN,NaN,-71.88899152535092,-114.90687270310232,-0.06904378376336329,-1.5530602305612398,-1.4840164467978765,-7759600,-7951880,18.615341470240665,5.11753873820342,NaN,NaN,-41.85809934700723,-43.13395118995841
2002-07-30T09:30:00-04:00,19.10001,20.60001,18.91,20.60001,264800,128615,46.766826584354156,28.775386729814926,NaN,NaN,-23.88150322628178,-84.25041163703845,0.10427940101147826,-1.3536671955335287,-1.457946596545007,-7494800,-7773660,37.05227820890931,7.4393040397415575,NaN,NaN,-35.454516973192064,-42.03688915899179
2002-07-31T09:30:00-04:00,20.64999,21.53,20.00999,20.67999,186300,135840,47.26721924230624,29.927999249695784,NaN,NaN,12.098362737857434,-52.60960826083283,0.22584447446104727,-1.175641003468698,-1.4014854779297452,-7308500,-7634360,47.13336294819752,10.492247172115244,NaN,NaN,-30.433400724061677,-40.37924795400178
2002-08-01T09:30:00-04:00,20.8,21,20,20.38,187000,143570,45.53814374172746,31.244289805112306,NaN,NaN,5.98672491470446,-32.26760880490414,0.2838323814644572,-1.0466950010991738,-1.330527382563631,-7495500,-7586500,50.09079105663283,13.777269091510453,NaN,NaN,-26.96906191691423,-38.4635070915607
2002-08-02T09:30:00-04:00,20.33,20.48,19.78,19.98,117800,147775,43.26548922890354,32.12227245516145,NaN,NaN,-5.523513175175881,-16.64178405484937,0.29190221435906705,-0.9656496146147973,-1.2575518289738643,-7613300,-7534340,53.165792067338955,17.283534838713777,NaN,NaN,-24.8275702964553,-36.51551612083136
2002-08-05T09:30:00-04:00,19.8,20.28,19.63,19.63,87900,150850,41.32221357180706,33.0788590843586,NaN,NaN,-10.216775455998286,-4.30734084097881,0.27078691049959014,-0.9190681908493765,-1.1898551013489667,-7701200,-7522660,53.851457894939266,20.845550384471494,NaN,NaN,-23.64773852268819,-34.677262178239474
2002-08-06T09:30:00-04:00,20.35001,20.56,20.2,20.44,147200,154235,47.22947100147563,34.580061275908164,NaN,NaN,33.581649171701734,7.185289638617898,0.3058971393373089,-0.8074836771773306,-1.1133808165146395,-7554000,-7534500,53.004319949019845,24.34965769140757,NaN,NaN,-20.778614462008143,-32.69174107592071
2002-08-07T09:30:00-04:00,20.60001,20.8,20.22,20.59,297900,164290,48.26810254169514,36.29653600099131,NaN,NaN,48.18736831461955,14.403090753970327,0.3315910470106369,-0.6988920077513434,-1.0304830547619803,-7256100,-7524020,53.69861633333372,27.92022250400094,NaN,NaN,-18.1525352073953,-30.614711666131367
2002-08-08T09:30:00-04:00,20.75,20.97,20.47,20.97,95200,165885,50.90437258297966,38.47693926763906,NaN,NaN,71.58215153134773,27.52217607729898,0.3639583695131309,-0.5755350928705667,-0.9394934623836976,-7160900,-7457100,57.96872442259334,31.822037160123838,NaN,NaN,-15.167501630412087,-28.40796737531433
2002-08-09T09:30:00-04:00,21,21.16,20.64,21.02,103400,167810,51.25635468643361,40.77824265514861,NaN,NaN,82.84173711066236,45.19522613446663,0.3769223468098114,-0.4683405288714333,-0.8452628756812447,-7057500,-7345940,63.9209252927013,36.19152527816415,NaN,NaN,-12.633368866747155,-26.154453302661874
2002-08-12T09:30:00-04:00,21,21.48,20.85001,21.38,164100,167905,53.82330685439324,43.50833830049516,NaN,NaN,101.48453040807266,67.53548730728082,0.3959694836364476,-0.3503010211356852,-0.7462705047721327,-6893400,-7184380,70.467019820785,41.06744336683315,NaN,NaN,-9.738758284041213,-23.809354014287493
2002-08-13T09:30:00-04:00,21.08,21.35001,20.78999,20.78999,110100,167045,49.24597821204638,44.88488122110533,NaN,NaN,83.2360177903173,77.46636103100393,0.3563010312667034,-0.3008942156887535,-0.657195246955457,-7003500,-7074280,73.93744036274776,46.20220879696894,NaN,NaN,-8.47254715079038,-21.618381605216477
2002-08-14T09:30:00-04:00,20.99001,21.42,20.74001,21.42,75300,167975,53.76728398802935,46.27118002049944,NaN,NaN,95.37581874834524,86.90405111774906,0.3589570150091733,-0.20849897819399033,-0.5674559932031636,-6928200,-7008700,75.76427651284645,51.256837021051375,NaN,NaN,-6.035605606145065,-19.392270748206275
2002-08-15T09:30:00-04:00,21.5,21.69,21.27,21.46001,169000,173200,54.04725346315496,47.75046427270012,NaN,NaN,104.48920368465444,93.48546154841041,0.3495313469904393,-0.1305418094651145,-0.4800731564555538,-6759200,-6928360,77.81577798202184,56.1775803087363,NaN,NaN,-3.9694525044785385,-17.189010999102315
2002-08-16T09:30:00-04:00,21.66,21.66,21.03999,21.12,84000,168820,51.209221567730935,48.85080266193126,NaN,NaN,84.39034396242148,93.79518291876224,0.30797860155429113,-0.0950999045126899,-0.40307850606698103,-6843200,-6885500,78.84460419586267,60.479670503423584,NaN,NaN,-2.976934497818202,-15.158714356061727
2002-08-19T09:30:00-04:00,21.19,21.45,21.07001,21.45,71500,167205,53.74775780329895,49.349440606141606,NaN,NaN,82.12923888701218,89.92412461455014,0.290524017380109,-0.039923484341844784,-0.3304475017219538,-6771700,-6861160,79.42808376833774,63.50651375766847,NaN,NaN,-1.4226198534428656,-13.19641514140189
2002-08-20T09:30:00-04:00,21.42,21.67999,21.17999,21.39,53600,156000,53.20572449498808,49.77361955276174,NaN,NaN,86.83967986483769,90.64485702945422,0.26353764007924785,-0.0010254516228940247,-0.2645630917021419,-6825300,-6825520,80.28550070364182,65.87452359734307,NaN,NaN,-0.27183497684103036,-11.350046546464624
2002-08-21T09:30:00-04:00,21.63,22.09,21.37,22.05,133900,143650,58.199453305760564,50.677998807335534,NaN,NaN,120.6680097359196,95.70329522696909,0.2773396523578769,0.08211147374520422,-0.19522817861267266,-6691400,-6778160,81.39518959952437,68.11055206469247,NaN,NaN,2.1777219170560556,-9.417508194533099
2002-08-22T09:30:00-04:00,22.13,22.60001,22.13,22.5,113900,135835,61.236869675202655,51.96166883921404,NaN,NaN,165.35789564617718,107.87703361927363,0.3019496901626463,0.1822089340906352,-0.11974075607201108,-6577500,-6741820,82.22209164193346,70.18600203430636,NaN,NaN,5.186040229630092,-7.331286991081214
2002-08-23T09:30:00-04:00,22.5,22.5,22.05,22.14999,75800,132660,57.72347104325985,53.13318723003209,NaN,NaN,139.89168626000406,118.97730207879015,0.28030091648027067,0.2306353895283273,-0.0496655269519434,-6653300,-6703840,83.06905521139578,72.27297327119611,NaN,NaN,6.7735666641885794,-5.316307897471244
2002-08-26T09:30:00-04:00,22.35001,22.53,22.22,22.5,61800,130025,60.18361732238598,54.0584833958114,NaN,NaN,148.41570404907867,132.23459511120345,0.2748276589671284,0.2938690467569671,0.0190413877898387,-6591500,-6667800,83.85507694076409,74.47659877060642,NaN,NaN,8.836502553721747,-3.2944778330151028
2002-08-27T09:30:00-04:00,22.5,22.74001,22.17,22.28,59200,119745,57.90281221745823,54.7466769440802,NaN,NaN,132.55841703342762,141.37834254492142,0.242776724440593,0.32251229334057996,0.07973556889998695,-6650700,-6632880,84.60104256274845,76.68391492985032,NaN,NaN,9.94407085960825,-1.403256591211767
2002-08-28T09:30:00-04:00,22.39999,22.39999,21.85001,22.14,157200,118290,56.437047666904355,55.14186802150339,NaN,NaN,92.28983086477886,135.70270677069328,0.20029965564850233,0.3301101384606149,0.12981048281211255,-6807900,-6656180,81.88247479622622,78.39203995653838,NaN,NaN,10.476495620326467,0.29385086757940915
2002-08-29T09:30:00-04:00,21.96001,21.98,21.60001,21.83,105500,114215,53.22418669901333,55.28242745097337,NaN,NaN,51.125181940707414,112.85616402959934,0.14220887974197355,0.3075715824895795,0.16536270274760595,-6913400,-6723360,74.45366419199352,79.14437844934498,NaN,NaN,10.056694760458173,1.6885428522763752
2002-08-30T09:30:00-04:00,22,22,21.39999,21.5,73200,111985,49.96344110118947,55.00672275431596,NaN,NaN,26.064159060453115,90.09065858968914,0.07577647308817884,0.2600832941078295,0.18430682101965065,-6986600,-6790020,67.8734746743051,78.9591252245964,NaN,NaN,8.781868256293478,2.701875052850247
2002-09-03T09:30:00-04:00,21.55,21.55,20.75,20.91,111700,113175,44.691662658195355,54.68141450046945,NaN,NaN,-53.39571338247372,49.72837510337865,-0.009167112085382345,0.17284793091292272,0.18201504299830507,-7098300,-6891380,59.29247507868689,77.91305627573492,NaN,NaN,6.080668637076164,3.1845598505968065
2002-09-04T09:30:00-04:00,21,21,20.48,20.78,71300,109380,43.60005182303894,53.955183631541566,NaN,NaN,-100.25757400948423,3.1651768947962724,-0.0718832431777087,0.0921609890261692,0.1640442322038779,-7169600,-6995160,52.03823235880468,76.2183388361605,NaN,NaN,3.5188494875827363,3.232315513023368
2002-09-05T09:30:00-04:00,20.8,20.84,20.57001,20.72,89700,98970,43.077077770809765,53.171599653516914,NaN,NaN,-108.84170670493769,-37.061130619147036,-0.11274888052498674,0.02310813154764446,0.1358570120726312,-7259300,-7085440,46.687030630124326,73.99485688245353,NaN,NaN,1.2416510746779994,2.9479348789740296
2002-09-06T09:30:00-04:00,21,21.2,20.64,20.72,72900,97855,43.077077770809765,52.59073223945111,NaN,NaN,-89.84630076687522,-65.25542716066357,-0.1336907701357381,-0.03125645059704141,0.10243431953869668,-7259300,-7154620,43.035078490283176,71.43703361776929,NaN,NaN,-0.6584942987572144,2.432730710726709
2002-09-09T09:30:00-04:00,20.52,20.77,20.14999,20.67999,183500,101860,42.68115004369855,51.800260256622515,NaN,NaN,-126.94888662243895,-95.85803629724198,-0.14329566861548682,-0.07668526623066185,0.06661040238482496,-7442800,-7245860,38.73192079511423,68.53016483396762,NaN,NaN,-2.376354935830808,1.7457184755042066
2002-09-10T09:30:00-04:00,20.75,20.75,20.10001,20.21001,50700,96190,38.2355303295363,50.730960673375954,NaN,NaN,-134.64643420916943,-112.10818046258112,-0.1724043371358591,-0.1488950190349989,0.023509318100860183,-7493500,-7324900,35.42710912402491,65.32599400685213,NaN,NaN,-5.1723559873217075,0.7574221236719332
2002-09-11T09:30:00-04:00,20.3,20.39999,20.08,20.23,87500,95060,38.528812660285475,49.325914912984885,NaN,NaN,-135.7597872177956,-119.2086231042434,-0.18054998126436322,-0.20217815847959386,-0.02162817721523063,-7406000,-7372180,33.58128543049078,61.91071513763543,NaN,NaN,-7.450532072964195,-0.4151427615617991
2002-09-12T09:30:00-04:00,20.05,20.2,19.7,19.71001,131700,97880,34.00543914464049,47.38081273223044,NaN,NaN,-153.06164397920637,-128.05261055909713,-0.2091781518795131,-0.283100867064622,-0.0739227151851089,-7537700,-7427860,31.499820840005924,58.28769579464061,NaN,NaN,-10.843869813446737,-1.9049609118310757
2002-09-13T09:30:00-04:00,19.95,20.03,19.57001,20,84600,93660,38.35221284867798,45.99715143261745,NaN,NaN,-131.24231851451552,-136.3318141086252,-0.19697584661500406,-0.32014252345386396,-0.12316667683885991,-7453100,-7466620,30.101123829925513,54.50427212453559,NaN,NaN,-12.619358111148028,-3.4355890831620686
2002-09-16T09:30:00-04:00,20.23,20.23,19.49001,19.77,121500,95535,36.30949406363122,44.291856914134975,NaN,NaN,-116.28356213242301,-134.198749210622,-0.1925570543022076,-0.3638629947166194,-0.17130594041441183,-7574600,-7492980,29.153042129633945,50.59698392374058,NaN,NaN,-14.72568051349695,-5.048459287495623
2002-09-17T09:30:00-04:00,19.8,20.07001,19.03,19.05,140800,99000,30.782258430503262,42.35467450078105,NaN,NaN,-133.68376036969,-134.0062144427261,-0.2240802363041962,-0.4514062357946571,-0.2273259994904609,-7715400,-7537360,27.578136464333056,46.52391920242519,NaN,NaN,-18.413511176001112,-6.957752414424979
2002-09-18T09:30:00-04:00,19.2,19.83,18.86,19.67999,192000,105920,39.46540734426272,41.142414477735215,NaN,NaN,-113.11083691268689,-129.47642438170436,-0.1898147220422911,-0.4645944020433248,-0.2747796800010337,-7523400,-7560840,26.75463353238581,42.58621625500802,NaN,NaN,-18.924110135898783,-8.667232088921237
2002-09-19T09:30:00-04:00,19.67999,19.67999,19.24001,19.27,362200,117335,36.276043749525954,39.93183283848612,NaN,NaN,-107.01467858330064,-120.26703130252322,-0.18204685024969514,-0.5023382428131526,-0.3202913925634575,-7885600,-7630420,24.426868973916214,39.01287373943107,NaN,NaN,-20.38084424960535,-10.340605254733253
2002-09-20T09:30:00-04:00,19.05,19.05,18.25999,18.59,589700,141125,31.700212974100054,38.62731654369402,NaN,NaN,-147.8431188238142,-123.58719136438295,-0.20811087789878746,-0.5804299899369418,-0.3723191120381544,-8475300,-7834860,19.15382216139959,35.53289855993783,NaN,NaN,-23.201554033424756,-12.177883651689182
2002-09-23T09:30:00-04:00,18.64999,18.64999,17.8,18.10001,163300,145500,28.87391054372216,37.49747710694594,NaN,NaN,-160.0955730667701,-132.34959355125235,-0.24141344419776478,-0.6740859172853604,-0.4326724730875956,-8638600,-8047660,15.421972200012249,32.39929121146106,NaN,NaN,-26.517428020815398,-14.226389990135784
2002-09-24T09:30:00-04:00,17.99001,17.99001,17.44,17.50999,173100,151065,25.88156844137245,36.23187115111262,NaN,NaN,-175.02252674169145,-140.61734682565265,-0.28334066157285087,-0.7868483000536592,-0.5035076384808084,-8811700,-8266920,12.68053256653829,29.58802694058489,NaN,NaN,-30.351406274721114,-16.529963745076547
2002-09-25T09:30:00-04:00,17.50999,18.21001,17.50999,18.03,405200,168365,32.51923287708172,35.477739372989184,NaN,NaN,-140.5049845302683,-146.09617634916896,-0.25699043708977476,-0.8247456848430268,-0.567755247753252,-8406500,-8443540,10.986359641400966,27.037979012818933,NaN,NaN,-31.259865680343385,-18.634235450114666
2002-09-26T09:30:00-04:00,18.25,18.74001,18.25,18.74001,1633800,242195,40.371265869977584,35.284467094358305,NaN,NaN,-88.37668551069883,-142.36857773464857,-0.1765154677976416,-0.7883995825003041,-0.6118841147026625,-6772700,-8220960,24.649148278819297,25.72469828342866,NaN,NaN,-29.26228045978564,-20.152527594353376
2002-09-27T09:30:00-04:00,18.92999,18.92999,18.28,18.42,324600,253150,38.21303733119185,34.96531618632211,NaN,NaN,-80.8075942477549,-128.96147281943672,-0.13166594352757022,-0.7764665441121252,-0.644800600584555,-7097300,-7945360,37.45119878973051,25.633218140186962,NaN,NaN,-28.389847311330207,-21.329287553921496
2002-09-30T09:30:00-04:00,18.10001,18.7,18,18.67,109500,254965,40.872393491422,35.15366355502824,NaN,NaN,-78.79464994396807,-112.70128819487631,-0.07482004431904099,-0.7383256559833562,-0.6635056116643152,-6987800,-7615200,48.69644049835361,26.581027524067586,NaN,NaN,-26.820524990004763,-22.113750044790535
2002-10-01T09:30:00-04:00,18.89,19.00999,18.36,18.97,278400,263300,43.987891712595086,35.54359777305036,NaN,NaN,-48.70207892653714,-87.43719863184546,-0.010073592470971837,-0.6760976022530301,-0.6660240097820582,-6709400,-7194740,58.84411751890876,28.385515530383152,NaN,NaN,-24.53919043533684,-22.460241529154292
2002-10-02T09:30:00-04:00,18.8,19.11,18.3,18.39999,369600,278215,39.706858116622215,35.95084198533476,NaN,NaN,-55.38475992059491,-70.41315370991077,0.0007316107750214851,-0.6651094963132813,-0.6658411070883028,-7079000,-6929240,63.72354137026604,30.687209853973165,NaN,NaN,-23.946865257897084,-22.672616347546118
2002-10-03T09:30:00-04:00,18.85001,18.85001,18.21001,18.3,226600,285060,38.99000924837125,35.99639887102714,NaN,NaN,-60.494303380191596,-64.83667728380934,0.007154968662602679,-0.6568973962600495,-0.6640523649226522,-7305600,-7035820,60.61666114234662,32.866891090574676,NaN,NaN,-23.691985460601146,-22.81824050655398
2002-10-04T09:30:00-04:00,18.35001,18.35001,17.39999,17.46001,327900,297810,33.51588118815839,35.79685509420765,NaN,NaN,-111.05087507656425,-70.8853334495712,-0.03674623111053399,-0.7099851538108197,-0.6732389227002857,-7633500,-7143060,57.57491020818821,34.89702452475712,NaN,NaN,-25.242257768916375,-23.164528686891465
2002-10-07T09:30:00-04:00,17.39999,17.84,17.3,17.3,261300,301700,32.57758869166702,35.92509297000506,NaN,NaN,-124.70095559656022,-80.06659458008963,-0.06641002810488295,-0.7562514578313895,-0.6898414297265065,-7894800,-7324460,52.75274726199231,36.69521101030421,NaN,NaN,-26.778051802105423,-23.680746274779175
2002-10-08T09:30:00-04:00,17.55,17.55,15.77,16.64999,3280600,463195,29.02301353182601,35.17920769768815,NaN,NaN,-184.32401862705112,-107.19098252019243,-0.11671436498950227,-0.8357343859633843,-0.7190200209738821,-11175400,-8217660,36.52922405329181,37.393396047511786,NaN,NaN,-29.265540109149896,-24.478573965403562
2002-10-09T09:30:00-04:00,16.7,16.7,15.14,15.23,966800,507160,23.09470154206808,34.237683254298304,NaN,NaN,-233.52748325017646,-142.81952718610873,-0.2261910650797948,-1.0017588523236256,-0.7755677872438308,-12142200,-9230300,26.557365149298477,37.54557434575338,NaN,NaN,-33.776059144706615,-25.806786133875427
2002-10-10T09:30:00-04:00,15.24,16.5,14.9,16.25999,1438800,572515,33.67710736089403,34.37888999621216,NaN,NaN,-178.21117265333066,-166.36290104073655,-0.21014937135676548,-1.0382545014397877,-0.8281051300830222,-10703400,-9909860,22.18133107881461,37.76182498271159,NaN,NaN,-33.6345533238978,-26.92503858959291
2002-10-11T09:30:00-04:00,16.75,16.85001,16.3,16.48,1442900,640430,35.71204841812745,34.86732841581254,NaN,NaN,-112.45771515941463,-166.64426905730664,-0.16748817059238819,-1.0374653433235075,-0.8699771727311193,-9260500,-10235260,20.44417174313797,38.12055352150629,NaN,NaN,-32.81186231880673,-27.766013408052025
2002-10-14T09:30:00-04:00,15.85,16.5,15.85,16.45,309300,649820,35.551866203178534,35.55806397022726,NaN,NaN,-116.7516886306751,-165.0544156641296,-0.1259520638693028,-1.0274172525677479,-0.901465188698445,-9569800,-10570260,18.810847684774103,38.55843317280885,NaN,NaN,-32.23274668555372,-28.40411816198084
2002-10-15T09:30:00-04:00,16.7,16.75,16.39999,16.5,738700,679715,36.06657423100497,35.81144549550749,NaN,NaN,-85.82361275395498,-145.35433448951036,-0.0819060523077384,-1.003847754083118,-0.9219417017753797,-8831100,-10101400,27.536630920503868,39.740595407030476,NaN,NaN,-31.618117304284286,-28.86326089659562
2002-10-16T09:30:00-04:00,16.58,16.58,15.8,15.93,1269800,733605,32.846072225028365,35.273931663725406,NaN,NaN,-103.59607766421081,-119.36805337231723,-0.07797611683284755,-1.0194118478164391,-0.9414357309835916,-10100900,-9693140,34.171032945971575,40.420730026112786,NaN,NaN,-32.07443780024654,-29.32200045426004
2002-10-17T09:30:00-04:00,16.36,16.39999,15.84,16.2,1069300,768960,35.77169761409914,35.09955025536164,NaN,NaN,-89.09067299117432,-101.54395343988598,-0.04561161343299358,-0.9984502477748336,-0.95283863434184,-9031600,-9358780,39.089582045999215,40.53775740156055,NaN,NaN,-31.57065206947662,-29.643236399290977
2002-10-18T09:30:00-04:00,16.3,16.46001,15.72,16.34,669200,772935,37.297098141084064,34.844172016051786,NaN,NaN,-77.50442682503947,-94.55329577301094,-0.005313812677923968,-0.959480900189245,-0.9541670875113211,-8362400,-9179160,41.613401058008975,40.03182601296451,NaN,NaN,-30.71476867678362,-29.796312438932784
2002-10-21T09:30:00-04:00,16.34,17.35001,16.34,17.3,1303000,829920,46.65317730241315,35.034549558181645,NaN,NaN,-18.329048490243572,-74.86876774492464,0.0901865434457948,-0.8414339082040776,-0.9316204516498724,-7059400,-8677080,48.0883238353703,39.2635550355689,NaN,NaN,-26.969107643693896,-29.392426039612943
2002-10-22T09:30:00-04:00,17.3,17.67999,16.86,17.08,1362000,889365,44.996193900013665,35.41235925699532,NaN,NaN,-2.2456995244120375,-58.15318509901605,0.1397701086682862,-0.7569078158145146,-0.8966779244828008,-8421400,-8595140,49.080778979866515,38.21764343625465,NaN,NaN,-24.40495682609712,-28.67993043768211
2002-10-23T09:30:00-04:00,17.10001,17.5,17.07001,17.39,549800,896595,47.80910110136782,36.04229438935222,NaN,NaN,8.192580019562874,-35.79545356226131,0.1914794639611549,-0.6573285945313572,-0.8488080584925121,-7871600,-8149280,54.210555502802556,37.760064462001495,NaN,NaN,-21.412403957782292,-27.641712369124992
2002-10-24T09:30:00-04:00,17.7,17.85001,17.14999,17.39999,1321000,880955,47.90156576868344,37.069843287961156,NaN,NaN,24.55292889758531,-13.06673318450938,0.22222817568400888,-0.5710228388875009,-0.7932510145715098,-6550600,-7653080,59.14364753415948,37.87211712814231,NaN,NaN,-18.966258234634555,-26.402361778483503
2002-10-25T09:30:00-04:00,17.64999,17.75999,17.2,17.64999,783200,903885,50.275719025481266,38.33399545466217,NaN,NaN,36.105983660422375,9.65534891258299,0.2530376383423316,-0.47695396664359535,-0.729991604985927,-5767400,-7134080,63.565115848992995,38.64442917007092,NaN,NaN,-16.213109112688112,-24.946754254798446
2002-10-28T09:30:00-05:00,17.95,18.21001,17.85001,18,593500,928085,53.47254161671426,40.08039031786848,NaN,NaN,80.3227110706185,29.385700824755407,0.28807577616366353,-0.3698968847813475,-0.6579726609450111,-5173900,-6756980,66.40955435521037,40.77873847735082,NaN,NaN,-12.91374534366202,-23.227752981778956
2002-10-29T09:30:00-05:00,18.10001,18.2,17.56,17.88,885600,958445,52.23266718662066,42.16167357819366,NaN,NaN,76.62049317578268,45.15893936479434,0.2932760854351879,-0.2913775541510262,-0.5846536395862141,-6059500,-6284600,69.61012703449933,43.85393575486517,NaN,NaN,-10.482192900822174,-21.406958684499415
2002-10-30T09:30:00-05:00,17.92999,18.28,17.81,18.28,315700,955750,55.90310847391367,43.74924508626649,NaN,NaN,104.2926625511001,64.3789558711018,0.3120187626842007,-0.19463018623096318,-0.5066489489151639,-5743800,-5859040,72.18168723380822,47.42538976593614,NaN,NaN,-7.300941115760382,-19.391813317536695
2002-10-31T09:30:00-05:00,18.39999,18.39999,18.03999,18.24001,245700,956705,55.444416435401784,45.15869994464323,NaN,NaN,116.91667858561651,82.85170580870803,0.30947672393184034,-0.11980304400036346,-0.4292797679322038,-5989500,-5746820,72.83448682221587,51.16755512872742,NaN,NaN,-4.7806514704575385,-17.304504482239672
2002-11-01T09:30:00-05:00,18.14,18.44,18.13,18.33,358200,958220,56.313104706108085,46.64164555199534,NaN,NaN,116.52925065595312,98.93635920781419,0.3013167553036876,-0.05263382380259429,-0.3539505791062819,-5631300,-5719600,72.99999349002641,55.03820840053116,NaN,NaN,-2.4146693995227038,-15.177385184708676
2002-11-04T09:30:00-05:00,18.57001,19.28,18.55,18.99001,565200,973415,62.14286284203783,48.50423759564054,NaN,NaN,153.13094543939891,113.49800608157027,0.32575391899986783,0.0532418196435529,-0.27251209935631493,-5066100,-5698040,73.13958391719282,58.295562186008944,NaN,NaN,1.4746223388060864,-12.79852696706371
2002-11-05T09:30:00-05:00,19.08,19.08,18.75,18.99001,213000,820035,62.14286284203783,50.59686549685551,NaN,NaN,133.7342898063632,124.92076540768637,0.3264785418531509,0.13558607796012367,-0.19089246389302722,-5066100,-5499360,74.4504694494338,61.1726647933991,NaN,NaN,4.671275582036855,-10.302840888620771
2002-11-06T09:30:00-05:00,19.08,19.39,19,19.39,422200,792805,65.38909992023241,52.71239423300785,NaN,NaN,142.14603174603081,132.4914392466725,0.33708493428073205,0.23046370395788784,-0.10662123032284421,-4643900,-5279380,75.85549453637721,63.79880139985467,NaN,NaN,8.444147110715587,-7.624699745858434
2002-11-07T09:30:00-05:00,19.00999,19.00999,18.3,18.49001,462100,743970,54.13986755223744,53.91544919094738,NaN,NaN,83.65907929520105,125.83991938858944,0.2695990524583296,0.2303775852500678,-0.03922146720826181,-5106000,-5102680,76.95190753734308,66.32298043409283,NaN,NaN,8.571604863002804,-5.3109419445925425
2002-11-08T09:30:00-05:00,18.50999,18.59,17.89999,17.92,316000,687625,48.454235526474825,54.044096206951785,NaN,NaN,42.176575120138594,110.96938428142653,0.17714824940677332,0.18221384455020484,0.005065595143431523,-5422000,-5060820,77.21586609369652,68.4035191668304,NaN,NaN,6.841332434404185,-3.5749027475930104
2002-11-11T09:30:00-05:00,17.89999,17.99001,17.50999,17.72,967200,720520,46.60486055077108,54.15900096772017,NaN,NaN,4.938280642286607,81.33085132200407,0.09710575833872212,0.12644779306683418,0.029342034728112056,-6389200,-5325440,71.63103422741031,70.0142516845121,NaN,NaN,4.851301103336808,-2.3711593403173223
2002-11-12T09:30:00-05:00,17.7,18.09,17.3,17.39,1398000,753485,43.644839758508155,53.861553728944486,NaN,NaN,-13.39393105752851,51.905207149225724,0.020518896516689436,0.05499065537397385,0.034471758857284415,-7787200,-5869660,61.74068717850204,70.55211823277635,NaN,NaN,2.252949463435579,-1.7105723683526222
2002-11-13T09:30:00-05:00,17.35001,17.7,17.31,17.5,810900,730540,44.9010725412658,53.64723278412894,NaN,NaN,-31.615626524762444,17.152875495067057,-0.02185422862603866,0.007153973074736086,0.029008201700774748,-6976300,-6336140,54.761157724050356,70.23908324633999,NaN,NaN,0.4989052862242386,-1.3949327034130707
2002-11-14T09:30:00-05:00,17.8,17.99001,17.71001,17.89,511600,702655,49.222840463839354,53.572027172583084,NaN,NaN,-3.3780405882364652,-0.25454848162043914,-0.022642821133512098,0.000704675283884626,0.023347496417396724,-6464700,-6607880,51.13475454246427,69.35120029587365,NaN,NaN,0.25547188429737716,-1.1591606194544353
2002-11-15T09:30:00-05:00,17.89999,18.24001,17.85001,18.14999,316600,685025,51.929736167309045,53.46182678333985,NaN,NaN,13.07227851884647,-6.075407801878869,-0.005571021792556131,0.01638371917670156,0.021954740969257692,-6148100,-6753100,49.25745747493297,68.12605051871098,NaN,NaN,0.8446340871207408,-0.8729042328008387
2002-11-18T09:30:00-05:00,18.14999,18.49001,18.10001,18.10001,294300,634590,51.362874962149185,53.399698767306184,NaN,NaN,27.821688310973432,-1.4987262681415046,0.002031529446454402,0.024494152777325695,0.022462623330871293,-6442400,-6763740,49.11518120989629,66.66212581695362,NaN,NaN,1.167169798716957,-0.5814650854411536
2002-11-19T09:30:00-05:00,18.14999,18.32001,17.97,18.2,521000,592540,52.48045313290916,53.15522338580586,NaN,NaN,11.31264085081492,3.4425881135271816,0.012866505902604117,0.03854575570912644,0.025679249806522322,-5921400,-6390580,54.12034971778853,65.37203028009506,NaN,NaN,1.7421070603444482,-0.24952620747178195
2002-11-20T09:30:00-05:00,18.22,18.39999,18,18.19,358700,582985,52.35089572616787,52.934257620860585,NaN,NaN,10.502763318036058,11.866266082086883,0.018110886279708926,0.04831785765615848,0.030206971376449555,-6280100,-6251340,55.864840909981226,64.15991271493544,NaN,NaN,2.1868281562136818,0.09852441591185568
2002-11-21T09:30:00-05:00,18.39999,18.66,18.31,18.5,597900,546830,55.978932013002584,52.91038814278162,NaN,NaN,57.531356218180406,24.048145443370256,0.039956644305383995,0.08015277675817956,0.04019613245279556,-5682200,-6094840,57.80674049780459,63.07468035834817,NaN,NaN,3.5589506262522494,0.5928710173890548
2002-11-22T09:30:00-05:00,18.5,19.10001,18.45,19.02,763900,545865,61.30167376634964,52.85030320880389,NaN,NaN,111.43676135710434,43.72104201102183,0.08437327361188217,0.14566272446764827,0.061289450855766106,-4918300,-5848880,60.73106787635646,62.18835778400272,NaN,NaN,6.362626461884931,1.41712179517418
2002-11-25T09:30:00-05:00,19.10001,19.38,18.8,19.06,820600,557220,61.68545157914889,52.81763097574039,NaN,NaN,128.44980827258482,63.846666003344104,0.10978371227351243,0.19851909119765665,0.08873537892414422,-4097700,-5379940,65.62307832891065,61.557829846822486,NaN,NaN,8.782485941422639,2.469316673209674
2002-11-26T09:30:00-05:00,19.02,19.16,18.56,18.58,741400,550010,54.67791237625703,52.05254615117072,NaN,NaN,67.0623873962891,74.99661531243893,0.08851397719422002,0.19937785041691924,0.11086387322269922,-4839100,-5163480,67.62780640359003,60.97013783733769,NaN,NaN,8.95518246642609,3.3958689293834476
2002-11-27T09:30:00-05:00,18.74001,18.87,18.45,18.69,167900,542620,55.91391793391388,52.17926403557619,NaN,NaN,46.10464134690098,82.11699091821194,0.07655168861265513,0.20655348398851814,0.130001795375863,-4671200,-4841700,70.39197194103986,60.501571009030314,NaN,NaN,9.446475241664816,4.260241259709357
2002-11-29T09:30:00-05:00,18.75999,18.8,18.52,18.77,113400,536005,56.83588486665036,52.77795327416016,NaN,NaN,45.73504374806993,79.75772842418984,0.068961203417156,0.216203299647308,0.147242096230152,-4557800,-4616820,72.17981116531999,60.14185279986056,NaN,NaN,10.109017238633896,5.095780685270006
2002-12-02T09:30:00-05:00,18.85001,18.94,18.37,18.49001,222300,529210,52.68325115658782,53.21212403171851,NaN,NaN,28.00976429127216,63.0723290110234,0.04137788833504258,0.19896445664895523,0.15758656831391266,-4780100,-4589180,72.4004051037997,60.196807862459806,NaN,NaN,9.530673694030293,5.729336829378618
2002-12-03T09:30:00-05:00,18.60001,18.85001,18.31,18.69,307600,516330,55.20104038292824,54.0375669334628,NaN,NaN,34.29525862187551,44.241419080881535,0.03324631146314866,0.1991444576428485,0.16589814617969983,-4472500,-4664140,70.7616735382594,60.84116403101391,NaN,NaN,9.727616665066277,6.300519663048283
2002-12-04T09:30:00-05:00,18.75,18.89999,18.24001,18.27,1001900,555775,49.2714400336715,54.349736040063206,NaN,NaN,15.195119300190543,33.867965461661825,-0.0019091105041269818,0.1635117580495411,0.16542086855366808,-5474400,-4791200,67.95400498852526,61.78351026419068,NaN,NaN,8.160787949566993,6.566272275408099
2002-12-05T09:30:00-05:00,18.39999,18.55,18.03999,18.21001,685400,568935,48.470554583362514,54.29600133431486,NaN,NaN,-12.12718705044683,22.22159978219226,-0.02918030132719368,0.12894549189467597,0.15812579322186965,-6159800,-5088920,61.769490601038775,62.54313426837458,NaN,NaN,6.640214414789552,6.576835438176878
2002-12-06T09:30:00-05:00,18.2,18.25,17.92,18.19,859000,588780,48.189184682808175,54.028819085421944,NaN,NaN,-35.78632488610141,5.917326055357995,-0.04746226991683716,0.09879795582582318,0.14626022574266034,-7018800,-5581120,53.156308279857846,62.821623611583504,NaN,NaN,5.303852518680651,6.3949807353917025
2002-12-09T09:30:00-05:00,18.3,18.59,18.25,18.44,1608100,653385,51.94268738544006,54.07023425851414,NaN,NaN,20.272832522967143,4.369939701696997,-0.04181201363657466,0.093995208696942,0.13580722233351666,-5410700,-5707240,51.18672652220762,62.969591133891456,NaN,NaN,5.1416816716629095,6.215938012001875
2002-12-10T09:30:00-05:00,18.5,18.64999,18.31,18.58,472500,628650,53.954449770728324,54.175519732644084,NaN,NaN,31.663110229429492,3.843510023207793,-0.028382343206079907,0.10032929332591678,0.1287116365319967,-4938200,-5800380,49.721514395815895,62.65538861089341,NaN,NaN,5.5487452642692725,6.120624762325789
2002-12-11T09:30:00-05:00,18.42999,18.82001,18.39999,18.75,272200,572360,56.34426370466138,54.46076030253648,NaN,NaN,56.26191622354097,12.05686940787788,-0.008801473198108145,0.11770979503436152,0.12651126823246966,-4666000,-5638700,52.27533723311397,62.398995491117184,NaN,NaN,6.553959922767194,6.18252978524599
2002-12-12T09:30:00-05:00,18.85001,18.89999,18.7,18.81,282200,545925,57.18880479956482,54.54717978729092,NaN,NaN,87.07213416688543,31.896733651344334,0.006608505292646921,0.1347718998482783,0.1281633945556314,-4383800,-5283500,57.39530659777933,62.369607355401094,NaN,NaN,7.62848046322016,6.389094167813728
2002-12-13T09:30:00-05:00,19.05,19.2,18.87,19,952300,567960,59.83838844712106,54.44265940734602,NaN,NaN,134.90290967421814,66.03458056340824,0.026877667423710366,0.16176047883526934,0.13488281141155897,-3431500,-4566040,65.45651372004366,62.70713920137875,NaN,NaN,9.291835130363694,6.803771448178009
2002-12-16T09:30:00-05:00,19.14999,19.31,19.06,19.3,1112200,607740,63.6624769877909,54.583875507963306,NaN,NaN,170.35170383889627,96.05035482659407,0.056088612129467585,0.20499357657339345,0.14890496444392587,-2319300,-3947760,70.6161948154406,63.06379037898803,NaN,NaN,11.877377866778568,7.5285723651209455
2002-12-17T09:30:00-05:00,19.39999,19.49001,19.3,19.32001,1066200,646335,63.90932087643391,55.24326182940451,NaN,NaN,181.57872876210277,126.03347853312872,0.07137666194674325,0.23812579187735494,0.1667491299306117,-1253100,-3210740,75.34398630495477,63.61494608622837,NaN,NaN,14.091089097732553,8.466074755494033
2002-12-18T09:30:00-05:00,19.32001,19.48,19.21001,19.25999,381600,639365,62.537055596900345,55.716343091046404,NaN,NaN,146.20345733923546,144.02178675626763,0.07186667665957294,0.25658247575507787,0.18471579909550492,-1634700,-2604480,78.41986225493352,64.18836682293507,NaN,NaN,15.615267890620196,9.487388060512055
2002-12-19T09:30:00-05:00,19.38,19.45,19.14999,19.28,330000,637930,62.82365569527012,56.14404100737638,NaN,NaN,123.34680892970012,151.27672170883056,0.06799941121564512,0.2697150631150613,0.2017156518994162,-1304700,-1988660,81.01119480601282,64.8191799401274,NaN,NaN,16.979507193069303,10.557690793734519
2002-12-20T09:30:00-05:00,19.2,19.35001,19.14999,19.25,487500,632410,62.05713305864426,56.813604000380415,NaN,NaN,99.5233551823047,144.20081081044788,0.05825730964837711,0.2745372889598876,0.2162799793115105,-1792200,-1660800,82.23431786543992,65.52160228024457,NaN,NaN,17.960396722616185,11.615220212146186
2002-12-23T09:30:00-05:00,19.25,19.39,19.06,19.17,380000,613215,59.95630711659681,57.15326590992817,NaN,NaN,80.48232605287171,126.22693525324296,0.04202000829189223,0.2688049896763758,0.22678498138448355,-2172200,-1631380,82.34421804169051,66.3489268876325,NaN,NaN,18.30261288719291,12.570562022867147
2002-12-24T09:30:00-05:00,19.2,19.22,19.05,19.09,173400,580855,57.84735577808819,57.76583132024365,NaN,NaN,61.63812480323939,102.23881446147028,0.022467055609763337,0.25486880089668773,0.2324017452869244,-2345600,-1849880,78.46209021513174,67.09950440381867,NaN,NaN,18.080327060921306,13.357671314017741
2002-12-26T09:30:00-05:00,19.24001,19.47,19.11,19.21001,223600,554965,60.11390588893828,58.59749927064191,NaN,NaN,80.57104025814526,89.11233104525225,0.014573878976697041,0.2506190940077957,0.23604521503109865,-2122000,-1947340,76.72456621425842,68.16772409047722,NaN,NaN,18.44446946700649,14.084356764444705
2002-12-27T09:30:00-05:00,19.11,19.47,18.92,19.14,233200,558230,58.14957619639201,59.30895580732648,NaN,NaN,57.68131541188946,75.9792323416901,0.002242748148932272,0.23884865021726398,0.2366059020683317,-2355200,-2157440,72.97296013220904,69.58319922278802,NaN,NaN,18.270032081844832,14.682310381216151
2002-12-30T09:30:00-05:00,19.10001,19.25999,18.96001,19.19,389800,572050,59.175591746228996,59.82559183309712,NaN,NaN,45.684227876358065,65.21140688050079,-0.004569941978324499,0.23089347459542608,0.23546341657375058,-1965400,-2192080,72.34486272479887,71.09449466583025,NaN,NaN,18.369114407234942,15.208996670647407
2002-12-31T09:30:00-05:00,19.3,19.3,19,19.14999,374800,579675,57.951257003735655,60.111078064026216,NaN,NaN,43.927710313730074,57.90048373267247,-0.01330046000861368,0.21883784156298347,0.23213830157159715,-2340200,-2225680,71.7002015857378,72.66440089368182,NaN,NaN,18.155049643556442,15.629861381062984
2003-01-02T09:30:00-05:00,19.38,19.64999,19.21001,19.60001,525000,590545,66.37752380468646,60.82773949974229,NaN,NaN,99.93356912155026,65.55957259633465,0.00852751700695778,0.24279769783029437,0.2342701808233366,-1815200,-2119600,72.53239356815642,74.11133348904198,NaN,NaN,20.335112793543477,16.302040154274483
2003-01-03T09:30:00-05:00,19.8,20,19.67,19.8,620900,571495,69.3199118047418,61.694247142969225,NaN,NaN,154.86868426146904,80.4191013969994,0.03238894165614331,0.2747563578935157,0.2423674162373724,-1194300,-1934060,73.97396736613962,75.29552354392487,NaN,NaN,23.134804913206573,17.278149405550497
2003-01-06T09:30:00-05:00,19.75,20.7,19.75,20.69,2183100,646380,78.38529208298834,63.0190259741026,NaN,NaN,251.41534907898563,119.16590813041861,0.1002350418395842,0.36766121853685263,0.2674261766972684,988800,-1265260,78.37888292863336,76.21854991596697,NaN,NaN,29.551850658688405,19.031535298855914
2003-01-07T09:30:00-05:00,20.5,20.7,20.02,20.24001,1411100,673985,67.52176721623793,63.29468956184882,NaN,NaN,218.0671265064825,153.6424878564435,0.1063497925662989,0.40036341740514203,0.29401362483884314,-422300,-956640,80.0563241479532,76.89284486828932,NaN,NaN,30.752977090729832,20.70602698340933
2003-01-08T09:30:00-05:00,20.3,20.5,20.10001,20.38,1618400,674500,68.9628751188078,63.65565772201838,NaN,NaN,179.6179706441584,180.78053992252916,0.11086073666080859,0.43258954566485386,0.32172880900404527,1196100,-249380,83.2613362928043,77.45836986742142,NaN,NaN,32.19174801704886,22.346844273929264
2003-01-09T09:30:00-05:00,20.48,20.52,20.23,20.28,664700,684110,66.68657159898102,63.952051722167006,NaN,NaN,148.70168700916756,190.53416350005264,0.09856169950246357,0.44493093338212475,0.3463692338796612,531400,219940,84.9856121652201,77.92735200387047,NaN,NaN,32.52543881369237,23.800929208181135
2003-01-10T09:30:00-05:00,20.39999,20.39999,20.14999,20.28,560500,698525,66.68657159898102,64.22797428671778,NaN,NaN,115.92668753872361,182.74576415550354,0.08252835194093566,0.44952967380583075,0.3670013218648951,531400,565080,86.11812953293911,78.29213305579378,NaN,NaN,32.78328436935784,25.084122802634948
2003-01-13T09:30:00-05:00,20.55,20.55,19.72,19.85001,797600,724295,57.26111620325072,63.88540165418967,NaN,NaN,69.06524424909378,146.27574318952517,0.037365849464534584,0.4137086336955633,0.37634278423102874,-266200,314080,81.31451210726077,78.22643264449526,NaN,NaN,29.819683160196565,25.76063142514375
2003-01-14T09:30:00-05:00,19.95,19.95,19.64999,19.89,983800,725870,57.857684375278325,63.73550002980978,NaN,NaN,32.27379663567894,109.11707721536445,0.006221111332069262,0.38411917339611534,0.3778980620640461,717600,542060,82.28126239734087,78.221935812756,NaN,NaN,27.677401019704845,26.034455652938192
2003-01-15T09:30:00-05:00,19.88,19.95,19.71001,19.83,405600,690540,56.58155038435746,63.645085358829014,NaN,NaN,28.065774472574766,78.80663798104773,-0.020900212417951702,0.3517727965416064,0.3726730089595581,312000,365240,78.8728154922878,78.25127333255287,NaN,NaN,25.557269814066856,25.966286247385145
2003-01-16T09:30:00-05:00,19.94,20.08,19.78,19.8,729600,673710,55.917444646045645,63.34533812719383,NaN,NaN,32.9353999735315,55.65338057392053,-0.04211582764639765,0.3200282244015611,0.36214405204795874,-417600,175440,75.26853520537148,78.14727111763237,NaN,NaN,23.638926002371047,25.63380621238313
2003-01-17T09:30:00-05:00,19.85001,19.99001,19.60001,19.71001,530000,681130,53.87474144760389,63.03999278799467,NaN,NaN,11.392935824055177,34.74663023098684,-0.06225013274075131,0.2843313861220196,0.3465815188627709,-947600,-120360,69.9068926698115,77.92826629888968,NaN,NaN,21.44099184712452,25.0348327316319
2003-01-21T09:30:00-05:00,19.75,19.89999,19.3,19.3,406500,684955,45.68585913810913,62.07644045884326,NaN,NaN,-33.76350041782502,14.180881297603074,-0.10093226817861084,0.22041618363950732,0.32134845181811816,-1354100,-337940,66.17292779756387,77.48741380408718,NaN,NaN,16.828565253649757,23.86250880620588
2003-01-22T09:30:00-05:00,19.37,19.39999,18.89999,19.13,826000,701880,42.782224625502664,60.99293814611234,NaN,NaN,-90.137663727469,-10.301410775026527,-0.1336651203371877,0.15426705139663355,0.28793217173382124,-2180100,-917480,57.38129215956511,76.46463455936058,NaN,NaN,12.033999182416476,22.172721717093108
2003-01-23T09:30:00-05:00,19.25,19.59,19.25,19.48,415200,703640,49.84931762381576,59.812351990335856,NaN,NaN,-45.431714476948386,-25.00090856493116,-0.1274633317623481,0.12860300703088612,0.2560663387932342,-1764900,-1332860,52.04415748369592,75.00118912475625,NaN,NaN,10.01052623121034,20.435265219109855
2003-01-24T09:30:00-05:00,19.23,19.39,18.86,18.98,537900,721865,41.88952247653686,57.85303846689265,NaN,NaN,-105.12896527832379,-52.613781615302216,-0.15113767219894653,0.06714424854455103,0.21828192074349756,-2302800,-1709900,47.70662207570105,73.12495017543921,NaN,NaN,5.406147539898381,18.28824840779393
2003-01-27T09:30:00-05:00,18.98,19.03999,18.22,18.25,388600,730115,33.48318262102576,54.64574493389532,NaN,NaN,-175.72086453115784,-90.03654168634482,-0.20663033280854742,-0.040005995267186734,0.1666243375413607,-2691400,-2058660,44.04952719796227,70.67285333753414,NaN,NaN,-2.067131974440033,15.38033692461765
2003-01-28T09:30:00-05:00,18.5,18.83,18.39999,18.8,644900,750700,42.79731601857197,52.879712705490604,NaN,NaN,-137.37360021012498,-110.75856164480481,-0.19699952110076419,-0.07962506383459456,0.11737445726616963,-2046500,-2197140,42.65143354964602,68.00107543765505,NaN,NaN,-4.601308206922514,12.525816191540484
2003-01-29T09:30:00-05:00,18.8,18.95,18.48,18.78999,479500,755185,42.68017923406787,51.002377285152036,NaN,NaN,-120.03517681886632,-116.73806426308427,-0.18234496981667686,-0.11055675500467643,0.07178821481200041,-2526000,-2266320,41.93536657993999,65.04922045816474,NaN,NaN,-6.494476415926502,9.808631533330914
2003-01-30T09:30:00-05:00,18.97,18.97,18.47,18.49001,825900,777740,39.216127443549865,49.040202702621244,NaN,NaN,-122.74448224276361,-132.2006178162473,-0.18339945859238294,-0.15746110842847827,0.025938350163904673,-3351900,-2583720,38.7231710645983,61.74476037954889,NaN,NaN,-9.243152111417665,7.086948155509688
2003-01-31T09:30:00-05:00,18.55,18.7,18.42,18.7,340900,768535,42.72078961157123,47.32836113209197,NaN,NaN,-111.44281924289147,-133.46338860916086,-0.16128169281768095,-0.17566376585819654,-0.014382073040515572,-3011000,-2725360,37.34831809600963,58.26120241976822,NaN,NaN,-10.251710370941604,4.609996937445219
2003-02-03T09:30:00-05:00,18.8,18.84,18.62,18.75999,285200,751750,43.719141039966146,46.36107719185736,NaN,NaN,-85.33119493938514,-115.38545469080631,-0.135004512612525,-0.18313771380617183,-0.04813320119364682,-2725800,-2732240,37.279081175352765,55.11581449606051,NaN,NaN,-10.722882757069389,2.419585552514561
2003-02-04T09:30:00-05:00,18.69,18.71001,18.50999,18.67,171700,651180,42.52185291429664,45.265660658930095,NaN,NaN,-87.56660779314059,-105.42405620740942,-0.11676145585746821,-0.19408502101548208,-0.07732356515801388,-2897500,-2902440,35.52458852873242,51.77605207687418,NaN,NaN,-11.465743078529373,0.43596717665114193
2003-02-05T09:30:00-05:00,18.69,18.69,18.25999,18.39,194000,590325,38.947819065052464,44.006108421836885,NaN,NaN,-97.02685792755616,-100.82239242914741,-0.11637023454010531,-0.22278635833314553,-0.10641612379304022,-3091500,-3015540,34.367099287900544,48.597072347989375,NaN,NaN,-13.201015457306248,-1.512173199628485
2003-02-06T09:30:00-05:00,18.45,18.46001,18.09,18.22,271700,522990,36.918873059720944,42.64906759424226,NaN,NaN,-107.91701829104977,-97.85689963880463,-0.11990353197174022,-0.2562955387577155,-0.13639200678597527,-3363200,-3017800,34.343019264890444,45.67382120938358,NaN,NaN,-15.2604871045805,-3.4762180431930583
2003-02-07T09:30:00-05:00,18.3,18.3,17.81,17.89999,675700,523540,33.392446112787496,41.18604649889824,NaN,NaN,-126.33353962397756,-100.83504371502184,-0.13501142378075592,-0.30515628651192017,-0.17014486273116425,-4038900,-3223380,32.13715610175602,42.97598288309391,NaN,NaN,-18.14615865066336,-5.571923844260244
2003-02-10T09:30:00-05:00,17.99001,18.10001,17.8,17.96001,327500,511890,34.653193135369236,40.39799892727397,NaN,NaN,-121.97384246347927,-108.16357321984067,-0.13202172132969503,-0.33517201439328304,-0.203150293063588,-3711400,-3420500,30.138248945622834,40.40207725081241,NaN,NaN,-20.109560762580944,-7.648729118306058
2003-02-11T09:30:00-05:00,18.16,18.19,17.56,17.66,516000,497810,31.448885872908477,39.58847473066009,NaN,NaN,-130.167697713508,-116.68379120391417,-0.14052089184393318,-0.37880140786850447,-0.2382805160245713,-4227400,-3686480,27.64005021821096,38.27770282642997,NaN,NaN,-22.79675755274651,-9.81273318036898
2003-02-12T09:30:00-05:00,17.7,17.75,17,17.05,709900,484115,26.153480869309718,37.895914962481086,NaN,NaN,-181.79566175559228,-133.63755196952138,-0.17523808686365983,-0.45732812460414607,-0.28209003774048624,-4937300,-4055640,24.593054910782215,36.31690978550757,NaN,NaN,-27.06104443129898,-12.27677764478755
2003-02-13T09:30:00-05:00,17.02,17.55,16.71001,17.28999,503200,488995,31.070977074547642,37.12316171948186,NaN,NaN,-173.4385017756153,-146.7418486664345,-0.1699245198701549,-0.49449568757817985,-0.32457116770802497,-4434100,-4269820,23.008285173071314,34.55274286389116,NaN,NaN,-28.95704638269359,-14.659673178774128
2003-02-14T09:30:00-05:00,17.5,17.58,17.3,17.58,413200,473175,36.56799268570823,37.3435052955306,NaN,NaN,-120.99368056207736,-145.67387685405444,-0.1362195408364023,-0.4948455937535279,-0.35862605291712557,-4020900,-4266220,23.097986665730687,33.056204254446044,NaN,NaN,-28.742166490737723,-16.67145793762607
2003-02-18T09:30:00-05:00,17.7,17.89999,17.62,17.77,636600,478505,39.946968583808946,37.13990905019039,NaN,NaN,-77.34704427931268,-136.74851721722115,-0.09255817813512007,-0.4743237755860257,-0.3817655974509056,-3384300,-4200800,24.812319282590337,31.781981806799212,NaN,NaN,-27.484080141806082,-18.216118252508927
2003-02-19T09:30:00-05:00,17.8,17.94,17.63,17.78,749900,495675,40.12774149932685,36.95759206913747,NaN,NaN,-66.33754204984729,-123.98248608448898,-0.05622136849463194,-0.45204230806919554,-0.3958209395745636,-2634400,-3882200,32.6828337081167,31.121086601668974,NaN,NaN,-26.43297599250029,-19.389955072507693
2003-02-20T09:30:00-05:00,17.88,18,17.73,17.77,398600,474305,39.998076662099805,37.013445584748176,NaN,NaN,-53.40041968075467,-98.30343766952147,-0.027528495822701116,-0.43023155935294,-0.4027030635302389,-3033000,-3501340,40.67717248427925,31.26065813164619,NaN,NaN,-25.61796162467112,-20.279670294245324
2003-02-21T09:30:00-05:00,17.99001,18.17,17.77,18,316800,469385,44.44455946705052,37.136572002996694,NaN,NaN,-27.17999815521216,-69.05173694544085,0.010248159773478871,-0.3898928638133903,-0.40014102358686915,-2716200,-3157760,46.81345944626225,31.936739656664237,NaN,NaN,-23.62394216970738,-20.757423419311333
2003-02-24T09:30:00-05:00,18.10001,18.10001,17.8,17.88,861400,485560,42.667952574992164,37.06148711264141,NaN,NaN,-29.025983145683263,-50.65819746216202,0.029378499849849637,-0.3634178987745571,-0.39279639862440674,-3577600,-3069100,48.299607887477514,32.72392013610172,NaN,NaN,-22.430599268122947,-20.996448540570135
2003-02-25T09:30:00-05:00,17.96001,18.10001,17.72,18,658200,499040,45.03414681900011,37.24093667726309,NaN,NaN,-23.423358567888727,-39.873460319877246,0.05106812633179186,-0.3289612407096669,-0.3800293670414588,-2919400,-2976120,49.881246315353664,33.74939569228895,NaN,NaN,-20.754497951642314,-20.961884170723305
2003-02-26T09:30:00-05:00,18,18,17.61,17.69,755000,504545,40.395885569583484,37.344369999015306,NaN,NaN,-47.54811608324671,-36.11557512655713,0.04566686785901469,-0.32294578221769044,-0.36861265007670513,-3674400,-3184120,46.45730831969855,34.6129820517031,NaN,NaN,-20.572933672775907,-20.906319813873676
2003-02-27T09:30:00-05:00,17.8,17.94,17.64999,17.72,636600,512400,41.02887567218055,37.637941614190986,NaN,NaN,-42.94302356739418,-34.024095903885026,0.04516263209727289,-0.312159359955114,-0.3573219920523869,-3037800,-3185080,46.44146350830584,35.47715664051849,NaN,NaN,-20.247777931951475,-20.812242402170504
2003-02-28T09:30:00-05:00,17.72,17.92999,17.7,17.7,987500,520480,40.7184161529449,38.16122518848795,NaN,NaN,-36.97699658565187,-35.983495589972975,0.04446037020665816,-0.3017465292940642,-0.34620689950072236,-4025300,-3446900,42.21288557009682,36.19685160254283,NaN,NaN,-20.059409422453957,-20.704694833639568
2003-03-03T09:30:00-05:00,17.89999,18.09,17.8,17.82001,213700,514120,43.482009873923275,38.79185495552752,NaN,NaN,-1.822925085991048,-30.542883978034535,0.05250458003761266,-0.28057617445370653,-0.3330807544913192,-3811600,-3493700,41.48575046696595,37.0073874254959,NaN,NaN,-19.160290562373813,-20.484065652030175
2003-03-04T09:30:00-05:00,17.75999,17.94,17.64999,17.71001,312600,515490,41.56914023573132,39.514730267157724,NaN,NaN,-27.850717396956465,-31.428355743848083,0.05081084871137248,-0.26956719360210357,-0.32037804231347605,-4124200,-3734660,37.86885445097093,37.73801629926447,NaN,NaN,-18.881968218312146,-20.255194590070456
2003-03-05T09:30:00-05:00,17.78999,17.89999,17.63,17.89,239500,518880,45.772851753744874,40.916113901760234,NaN,NaN,-5.090219378762476,-22.93677640295124,0.06149302884624669,-0.24351175625566768,-0.30500478510191437,-3884700,-3776720,37.258238163932326,38.64267224591806,NaN,NaN,-17.493924916194796,-19.860727493802504
2003-03-06T09:30:00-05:00,17.95,17.98,17.71001,17.89,435600,530960,45.772851753744874,41.966247807417176,NaN,NaN,29.2714151083808,-8.493888667796211,0.06774551662752226,-0.22032288931751154,-0.2880684059450338,-3884700,-3946100,34.82306026076712,39.48658475218205,NaN,NaN,-16.337452197604915,-19.35740245148856
2003-03-07T09:30:00-05:00,17.92,18.05,17.75,17.95,421400,538445,47.24030786384018,42.7285560344266,NaN,NaN,66.8307508467101,12.267660818676184,0.07456844741087759,-0.1948578466814368,-0.2694262940923144,-3463300,-3833700,37.73153570129789,40.53183825472256,NaN,NaN,-14.963742429366725,-18.729736734042586
2003-03-10T09:30:00-05:00,17.94,17.94,17.5,17.53,989700,554145,39.236122155489284,42.67778128954662,NaN,NaN,-46.679163945670986,3.2964130467401973,0.05058881630282752,-0.20619027371377996,-0.2567790900166075,-4453000,-3961980,35.7696939043382,41.314507870561684,NaN,NaN,-15.906051739539736,-18.32635316339932
2003-03-11T09:30:00-05:00,17.64999,17.78,17.47,17.5,867000,581120,38.73131749577943,42.57803671786467,NaN,NaN,-68.27838827840081,-4.78912112954867,0.03333337477664325,-0.21511237154580343,-0.24844574632244668,-5320000,-4201140,32.388538519400456,41.29348678565338,NaN,NaN,-16.825273275621466,-18.111913179431056
2003-03-12T09:30:00-05:00,17.57001,17.7,17.39,17.53,273300,568985,39.56862395960315,42.547361524829185,NaN,NaN,-75.57547361989138,-18.886171977774453,0.024950170094539398,-0.21725803370427244,-0.24220820379881183,-5046700,-4433540,29.473074963109994,40.493194105569856,NaN,NaN,-17.372302875835043,-18.006254564631625
2003-03-13T09:30:00-05:00,17.8,17.94,17.60001,17.84,429200,554950,47.545833743808586,42.76888111602619,NaN,NaN,21.134635390633136,-20.513527921323988,0.04037945240893742,-0.19173388828764004,-0.23211334069657746,-4617500,-4580100,27.77508293919759,39.133310069350955,NaN,NaN,-15.581456781088162,-17.659854881268274
2003-03-14T09:30:00-05:00,17.94,18.03999,17.81,17.91,422600,550920,49.17726068160247,43.23383169506979,NaN,NaN,88.14005228133983,-16.25166763439804,0.05451683951740366,-0.1639672912998229,-0.21848413081722656,-4194900,-4726420,26.154997918726508,37.55155221444017,NaN,NaN,-13.61688456871548,-17.082287693760733
2003-03-17T09:30:00-05:00,18,18.32001,17.89,18.31,460300,553275,57.34188073582401,44.11295554627149,NaN,NaN,223.21283082015262,37.72673131876668,0.0880389607007594,-0.1084354299412773,-0.1964743906420367,-3734600,-4582740,30.4452847585368,36.16326924609611,NaN,NaN,-9.196008730417676,-15.955676413283154
2003-03-18T09:30:00-05:00,18.35001,18.53999,18.25999,18.52,522300,547560,60.89383319948902,45.57709466269331,NaN,NaN,288.29915560915396,109.04224009627765,0.11962775794719566,-0.046939693208042144,-0.1665674511552378,-3212300,-4161200,41.23292495606862,35.79009900583683,NaN,NaN,-4.281158566689318,-14.287888149484035
2003-03-19T09:30:00-05:00,18.64999,18.67999,18.38,18.42,313900,525760,58.40013065636499,46.817898590135066,NaN,NaN,241.02518188355683,172.36237119696727,0.12829271661296074,-0.0062015553890368835,-0.13449427200199762,-3526200,-3857100,47.55248837091005,35.86945792459427,NaN,NaN,-0.9920692060701113,-12.388485443282045
2003-03-20T09:30:00-05:00,18.60001,18.7,18.42999,18.63,534300,532545,61.92627942503207,48.332745966712714,NaN,NaN,215.30005697279458,211.19545551339957,0.1416262966448611,0.04253859880407873,-0.09908769784078235,-2991900,-3531980,53.330733067191815,36.66358988867249,NaN,NaN,2.942141897252874,-10.198395823205628
2003-03-21T09:30:00-05:00,18.60001,18.74001,18.49001,18.74001,604600,546935,63.66386021145919,49.77430670510814,NaN,NaN,182.5073150611162,230.06890806935485,0.1504831866216214,0.0890162854362444,-0.061466901185376996,-2387300,-3170460,58.77019174519832,37.898192837117655,NaN,NaN,6.737065846156575,-7.779044156153884
2003-03-24T09:30:00-05:00,18.55,18.60001,18.22,18.28,287400,518235,52.810592433392905,50.577267576369685,NaN,NaN,90.62134035104754,203.55060997553383,0.11934955484054564,0.08772004236530506,-0.03162951247524058,-2674700,-2958480,61.59664078831374,39.59303471835643,NaN,NaN,6.67127640838257,-5.714712646934391
2003-03-25T09:30:00-05:00,18.37,18.69,18.3,18.53,318900,501270,57.09179086887676,51.385763227450525,NaN,NaN,105.09457978705109,166.90969481111324,0.10982187290042517,0.10564782865029088,-0.0041740442501342866,-2355800,-2787180,63.758761957135356,41.48592927501379,NaN,NaN,8.04119580505119,-3.749582868079308
2003-03-26T09:30:00-05:00,18.73,18.74001,18.32001,18.37,407800,483910,53.731954486956674,51.954270565537094,NaN,NaN,86.19406241393236,135.94347091718834,0.08792029014659816,0.10572631843311342,0.017806028286515257,-2763600,-2634660,65.61500117959673,43.685353626358754,NaN,NaN,8.055553972909632,-2.0631347479380313
2003-03-27T09:30:00-05:00,18.28999,18.60001,18.21001,18.46001,586600,481410,55.32477440869218,52.53173246159795,NaN,NaN,67.21353916952383,106.32616735653421,0.07516576924900231,0.11176323984776815,0.036597470598765836,-2177000,-2471680,67.52890477117393,45.8137371313499,NaN,NaN,8.563439838449261,-0.5450526641684181
2003-03-28T09:30:00-05:00,18.55,18.59,18.39999,18.49001,294500,446760,55.870072422549995,53.719871766387996,NaN,NaN,72.81214747173985,84.38713383865893,0.06481204657786596,0.1176125288210983,0.05280048224323233,-1882500,-2370720,68.69145994169662,48.16529184830407,NaN,NaN,9.13245318120612,0.8374481708850874
2003-03-31T09:30:00-05:00,18.5,18.64,18.27,18.39999,308600,451505,53.75001234847262,54.79263568443752,NaN,NaN,56.226296251782344,77.50812501880588,0.048698741199344725,0.11367390874241323,0.06497516754306851,-2191100,-2274000,69.80672596782948,50.83801952319186,NaN,NaN,8.990576665405936,2.0021808129594945
2003-04-01T09:30:00-05:00,18.50999,18.58,18.31,18.53,496200,460685,56.327515838556316,55.989699390077035,NaN,NaN,57.96934520241418,68.0830781018785,0.04375093334327522,0.11966383422216254,0.07591290087888732,-1694900,-2141820,71.31079678820639,53.826428224984454,NaN,NaN,9.607096907752172,3.0885973979298766
2003-04-02T09:30:00-05:00,18.84,18.84,18.53,18.53999,643100,480865,56.52799568379517,56.63128238579036,NaN,NaN,83.08224891557997,67.46071540220802,0.03830170204793676,0.12379002843880826,0.0854883263908715,-1051800,-1799460,74.81084219030302,57.18612531434913,NaN,NaN,10.167596896138496,4.0998830405311075
2003-04-03T09:30:00-05:00,18.7,18.7,18.41,18.47,424300,480300,54.63567673666976,57.021169246866585,NaN,NaN,56.56759747314762,65.33152706293279,0.02763241188523717,0.12002884124741797,0.0923964293621808,-1476100,-1659280,76.09672199371596,60.75339131970553,NaN,NaN,10.133018122590556,4.9617594808253145
2003-04-04T09:30:00-05:00,18.60001,18.75,18.48,18.7,243600,471410,59.4407220908647,57.17108648651235,NaN,NaN,76.15734685763259,66.00056694011133,0.033332272886827885,0.13406177047071566,0.10072949758388777,-1232500,-1529280,77.256274230955,64.09703342487826,NaN,NaN,11.457535652749604,5.8897275053859275
2003-04-07T09:30:00-04:00,19.10001,19.14999,18.62,18.7,314400,437645,59.4407220908647,57.06729283589633,NaN,NaN,115.31661046356464,77.8186297824678,0.03423917091236919,0.14352846122434926,0.10928929031198006,-1232500,-1337560,78.8832068715638,66.78633927598506,NaN,NaN,12.54533988353382,6.840529273692769
2003-04-08T09:30:00-04:00,18.75,18.84,18.55,18.58,308000,409695,55.860494714345904,56.88589026860925,NaN,NaN,75.96201142305762,81.41716302659647,0.024358233852061886,0.13973708262705742,0.11537884877499553,-1540500,-1306680,79.14201320790828,69.04273390719922,NaN,NaN,12.520966590065466,7.6520203188888685
2003-04-09T09:30:00-04:00,18.78,18.83,18.46001,18.53999,395300,415795,54.67796819443665,56.368153752138156,NaN,NaN,62.092413745057236,77.21919599249193,0.013282923389882711,0.13198250301234893,0.11869957962246622,-1935800,-1483480,73.58161484587785,70.48922546281965,NaN,NaN,12.18472252210509,8.299549205062615
2003-04-10T09:30:00-04:00,18.7,18.7,18.50999,18.7,192200,403945,58.464877183283356,55.99679782155416,NaN,NaN,70.96066952147928,80.09781040215826,0.014774123541319753,0.1371672340491159,0.12239311050779615,-1743600,-1536980,71.93461728799826,71.42954157301965,NaN,NaN,12.912960478943097,8.958607958474111
2003-04-11T09:30:00-04:00,18.86,18.87,18.53999,18.64,242900,394960,56.55657389839383,56.26436792619709,NaN,NaN,88.67844864410831,82.60203075945341,0.00998940048300577,0.13487986111155337,0.1248904606285476,-1986500,-1687780,67.35799536117531,71.84106689965262,NaN,NaN,13.018098436939527,9.538535169683456
2003-04-14T09:30:00-04:00,18.81,18.89999,18.64999,18.88,411900,392540,61.91190452048048,56.608661758454495,NaN,NaN,152.52908519173124,90.04452570508673,0.02064440471170162,0.15069596651817463,0.130051561806473,-1574600,-1756200,65.32719368343194,71.95309773724523,NaN,NaN,14.65443782514525,10.269378406177998
2003-04-15T09:30:00-04:00,18.92999,19.14,18.83,19.12,340800,383465,66.37566250111384,57.51178375946572,NaN,NaN,239.39172864128645,122.73046914873248,0.040371125184170104,0.18051546828668563,0.14014434310251553,-1233800,-1694860,66.30792820475763,72.00259252475672,NaN,NaN,17.494174119552035,11.301492079517146
2003-04-16T09:30:00-04:00,19.25,19.27,19,19.10001,298200,382680,65.68516059095424,58.25181134391301,NaN,NaN,234.9237415187813,157.29673470347728,0.04806574598937419,0.20022652558923326,0.15216077959985908,-1532000,-1614100,67.60705092777258,72.00817439308521,NaN,NaN,19.597369655539477,12.486617447520336
2003-04-17T09:30:00-04:00,19.2,19.25,19.02,19.14,237800,367855,66.43736412600428,59.00661789415975,NaN,NaN,192.2447002761475,181.55354085441095,0.05153374700424651,0.2165779633551672,0.1650442163509207,-1294200,-1524220,69.037933006962,72.03292246917559,NaN,NaN,21.557717302516473,13.782488855376927
2003-04-21T09:30:00-04:00,19.35001,19.39,19.22,19.32001,298800,352565,69.6612589542602,60.143135508858855,NaN,NaN,197.494912766261,203.31683367884148,0.060989079728094364,0.24128056601103864,0.18029148628294428,-995400,-1326000,71.97778158234236,72.18799787021223,NaN,NaN,24.24935181546324,15.277754992532115
2003-04-22T09:30:00-04:00,19.25,19.61,19.12,19.59,370700,356730,73.7361737418399,61.38661107337912,NaN,NaN,188.16612135881087,210.4442409122574,0.07930479874844906,0.2794224847185056,0.20011768597005655,-624700,-1136020,74.47892751228062,72.4142929219318,NaN,NaN,27.985749397109384,17.093182764614582
2003-04-23T09:30:00-04:00,19.64999,19.64999,19.28,19.59,494400,365505,73.7361737418399,62.615766648953745,NaN,NaN,167.96218434593075,196.15833205318629,0.08480301325671735,0.30612145254095324,0.2213184392842359,-624700,-1014200,75.96061066901895,72.49641924184009,NaN,NaN,30.9695663447148,19.07552327605747
2003-04-24T09:30:00-04:00,19.7,20,19.67,19.77,626000,376415,76.20711424643372,64.15658361393689,NaN,NaN,190.41879169978728,187.25734208938746,0.0932731350293266,0.33790985807089413,0.24463672304156753,1300,-707540,79.22967153745296,72.72020135210701,NaN,NaN,34.344545923225226,21.256812225652865
2003-04-25T09:30:00-04:00,19.89,19.98,19.64,19.72,302900,362230,74.12104832906401,65.20517834523683,NaN,NaN,152.92715521522078,179.39383307720215,0.08827132190026982,0.3549758754169048,0.26670455351663497,-301600,-509020,81.02828555441432,72.9896307323541,NaN,NaN,36.52404248996086,23.43784512055401
2003-04-28T09:30:00-04:00,19.8,20.10001,19.8,19.99001,444900,369750,77.67504933814362,66.50763029147105,NaN,NaN,156.8761262466758,171.2700757732851,0.09530886667915939,0.38584063686558423,0.29053177018642484,143300,-281280,82.86178174329167,73.27381465176323,NaN,NaN,39.62640872867686,25.750497064571558
2003-04-29T09:30:00-04:00,20.2,20.24001,19.89999,20.02,1079100,408275,78.03584938123545,68.09158419624887,NaN,NaN,147.67714657770694,163.17228081706432,0.09398878417164386,0.40801775040097965,0.3140289662293358,1222400,88140,85.33723669465357,73.71633061510218,NaN,NaN,42.239981185983474,28.10613765334469
2003-04-30T09:30:00-04:00,20.11,20.16,19.92,19.99001,363600,401645,76.70091082238402,69.66465152681653,NaN,NaN,124.87357749510583,154.55455944689936,0.08345750077464892,0.41835084219764695,0.33489334142299804,858800,384840,86.96563640121072,74.67233215476881,NaN,NaN,44.007242286934165,30.377724029571755
2003-05-01T09:30:00-04:00,20,20,19.61,19.72,865700,412775,65.78883493333441,70.1877913661059,NaN,NaN,79.15824151150905,132.3024494092437,0.05219715019303767,0.4001397791642951,0.34794262897125744,-6900,383200,86.90818285418793,75.7418725523538,NaN,NaN,42.267839716867805,32.07631198489976
2003-05-02T09:30:00-04:00,19.8,19.89999,19.67999,19.88,523900,417755,68.63630336580258,71.05062918520652,NaN,NaN,76.85612466168085,117.08824329853572,0.03690620687618462,0.3940753875664882,0.35716918069030357,517000,546920,87.77636735341999,77.20032769465698,NaN,NaN,41.64212533720882,33.44285674951534
2003-05-05T09:30:00-04:00,20,20.09,19.85001,19.96001,506200,430885,69.9818060963463,71.62705072633979,NaN,NaN,88.45273188046787,103.40356442529412,0.027237263530206834,0.39121576010306214,0.3639784965728553,1023200,722900,88.64780850756561,78.86608589638082,NaN,NaN,41.52619033123597,34.59761868976115
2003-05-06T09:30:00-04:00,20.14999,20.14999,19.87,19.92999,674200,448875,68.78938441815853,71.79945943470013,NaN,NaN,82.5900445874256,90.38614402723786,0.014515006054128254,0.3821222541405156,0.36760724808638734,349000,548220,82.37049250080425,80.01341191752701,NaN,NaN,41.08340404778896,35.52415945519369
2003-05-07T09:30:00-04:00,20,20,19.78999,19.89999,947900,480870,67.55067438406948,71.93271041992264,NaN,NaN,64.43275599672667,78.29797972756202,0.0005141059116504643,0.3682498804759504,0.36773577456429996,-598900,256680,73.07040276444394,80.4036513344321,NaN,NaN,40.36823383447277,36.216170080804986
2003-05-08T09:30:00-04:00,19.89999,19.92,19.75,19.87,276900,474950,66.26604115127928,71.92047306458514,NaN,NaN,51.5744338577723,72.78121819681465,-0.013554805936571435,0.3507922671435857,0.3643470730801571,-875800,82900,68.13235587579403,80.33896725363438,NaN,NaN,39.41825498716158,36.67361078171307
2003-05-09T09:30:00-04:00,19.92,20.10001,19.89999,20,361400,483410,69.01665332055897,71.87442980503506,NaN,NaN,71.5260853024176,71.715210324962,-0.01668774841871512,0.3434873875567632,0.36017513597547834,-514400,-123380,62.71454320242211,79.67730736935437,NaN,NaN,39.32255436145515,37.0520312931048
2003-05-12T09:30:00-04:00,20.19,20.24001,19.97,20.14999,214400,481985,71.86690492815156,71.74091060405732,NaN,NaN,90.00003966665338,72.0246718821991,-0.011488253291333073,0.345814819361312,0.35730307265264505,-300000,-388020,56.50653471626443,78.39356502678177,NaN,NaN,40.048888497414694,37.48015375086335
2003-05-13T09:30:00-04:00,20.22,20.22,20.05,20.19,540900,488435,72.59123297484628,71.65912912070063,NaN,NaN,96.45779324501733,74.79822161371746,-0.00833119643635627,0.34688907710719974,0.355220273543556,240900,-409640,56.01866743034871,76.96914050973389,NaN,NaN,40.85693985589269,37.962551765867545
2003-05-14T09:30:00-04:00,20.28999,20.3,20.12,20.28,536000,498195,74.20035911616927,71.51578946853888,NaN,NaN,115.89595414135198,85.0908612426425,-0.0034105649628949353,0.35095706733993737,0.3543676323028323,776900,-134480,60.67252780773299,75.64363024332533,NaN,NaN,42.00593018736335,38.54017725465266
2003-05-15T09:30:00-04:00,20.35001,20.67,20.35001,20.59,889300,527750,78.81408409337219,71.8510063088466,NaN,NaN,187.14473231252904,112.20492093359385,0.01640515268983611,0.37487407316512744,0.35846892047529133,1666200,373920,67.51265413341147,74.67822799896798,NaN,NaN,44.56625400847058,39.40104536234094
2003-05-16T09:30:00-04:00,20.69,21.03999,20.61,21.02,885700,560145,83.28044814708652,72.25139193805681,NaN,NaN,258.3507758718058,149.56985904747154,0.05213877812740686,0.4236423931345499,0.371503615007143,2551900,987180,73.50003820688997,74.00953203208215,NaN,NaN,48.63088619141879,40.7195940522092
2003-05-19T09:30:00-04:00,20.8,20.94,20.67999,20.69,824100,586410,70.92311282268,71.74333932673143,NaN,NaN,193.3569253157927,170.24123617729938,0.047355964767572534,0.4306985709666087,0.38334260619903615,1727800,1392740,76.57473664289505,73.38363917124225,NaN,NaN,47.46242295634068,41.68285532422799
2003-05-20T09:30:00-04:00,20.52,20.89999,20.5,20.78,522100,593980,72.13738730675976,71.4173733613297,NaN,NaN,152.01258391213437,181.3521943107228,0.044124440463517434,0.43849815677843296,0.3943737163149155,2249900,1794540,79.15518316922267,72.82574965467168,NaN,NaN,46.98994575548712,42.44101110012215
2003-05-21T09:30:00-04:00,20.84,20.84,20.60001,20.73,604200,599470,70.37896173148256,71.74523956119741,NaN,NaN,128.3967813009148,183.85235974263537,0.03299959447027245,0.4356232094027561,0.40262361493248366,1645700,1968300,80.17238117877756,72.34462096357093,NaN,NaN,46.03478812899088,42.95440781853197
2003-05-22T09:30:00-04:00,20.83,21.17,20.75,21.10001,2864400,711390,75.19723866512057,72.21387779686299,NaN,NaN,155.88265000186905,177.59994328050337,0.0442393944003272,0.45792285793289267,0.41368346353256547,4510100,2537080,83.0825690328789,72.00934965496086,NaN,NaN,46.88641288486847,43.51612282800861
2003-05-23T09:30:00-04:00,21.24001,22.09,21.17,21.89999,2234900,807990,82.01056687373394,73.07307499524782,NaN,NaN,223.73861432721915,170.67751097158603,0.0962465626178261,0.5339916668048481,0.437745104187022,6745000,3375700,86.2800536142374,71.84022430543742,NaN,NaN,50.607070683879485,44.52911537884731
2003-05-27T09:30:00-04:00,21.75,22.32001,21.75,22.22,1273700,849430,83.91415214631446,74.15341554725896,NaN,NaN,218.14554155865136,175.63523422015777,0.14022969629954302,0.6130322245614508,0.4728025282619078,8018700,4633880,89.48966725253128,72.34873678770363,NaN,NaN,54.25305510206574,45.91824962502137
2003-05-28T09:30:00-04:00,22.42,22.42,22.10001,22.12,1448900,867920,81.02869367093702,75.11613121060664,NaN,NaN,188.93355400963037,183.01942823965697,0.1497541832158653,0.6599952572817394,0.510241074065874,6569800,5497860,91.03978402577162,73.6322640206556,NaN,NaN,55.82286009184997,47.33319397742545
2003-05-29T09:30:00-04:00,22.27,22.39,21.64999,21.78999,1633900,931435,72.20485061175987,75.54033188635525,NaN,NaN,135.61665397979337,184.46340277543268,0.12216134764152575,0.6629427586177812,0.5407814109762554,4935900,6155900,92.00673697403562,75.33757695624429,NaN,NaN,53.73451802115915,48.24766884081598
2003-05-30T09:30:00-04:00,21.92999,22.14999,21.02,22.00999,1561500,966225,74.22032222864333,75.91202252264699,NaN,NaN,101.35693850098886,173.55826047525665,0.1075724783022588,0.675247008854079,0.5676745305518202,6497400,6553360,92.53102922853243,77.4673259581093,NaN,NaN,52.82640566801462,48.90177410184436
2003-06-02T09:30:00-04:00,22.3,22.35001,22.10001,22.2,1182200,999140,75.84916190967894,76.19646944989894,NaN,NaN,129.3088481914495,154.6723072481027,0.09973994453255508,0.6923494612175141,0.592609516684959,7679600,6740280,92.77116918405775,80.0576569915231,NaN,NaN,52.67967480222712,49.44147420189904
2003-06-03T09:30:00-04:00,22.27,22.38,22.10001,22.28999,483400,998000,76.60314367297964,76.48303449976561,NaN,NaN,115.0226177672317,134.0477224898188,0.08994237512478964,0.705037485590946,0.6150951104661564,8163000,6769140,92.80960900980523,82.68558139005572,NaN,NaN,52.814674844338164,49.923360007961776
2003-06-04T09:30:00-04:00,22.35001,22.63,22.25999,22.60001,1138600,1021220,79.03181937463205,76.82813880394153,NaN,NaN,117.56905583541396,119.7748228549755,0.09326356792964319,0.7316745703782104,0.6384110024485672,9301600,7315500,93.51289436296976,85.03132185828692,NaN,NaN,53.74626145400121,50.46948878596741
2003-06-05T09:30:00-04:00,22.48,22.64999,22.25,22.34,907600,1019205,72.25729596862786,76.35979679503122,NaN,NaN,97.76823269171999,112.20513859736079,0.0680426948792956,0.7234643710476867,0.6554216761683911,8394000,8007120,94.27610444266206,86.94299688037624,NaN,NaN,52.23369636763754,50.721518440491714
2003-06-06T09:30:00-04:00,22.7,22.7,22.10001,22.10001,860100,1048365,66.58401220073682,75.16719422743482,NaN,NaN,79.95397575508424,107.9245460481799,0.027376874307799448,0.6896427690531404,0.6622658947453409,7533900,8214420,94.48552241256026,88.44196003792412,NaN,NaN,49.08309058108571,50.487457317719425
2003-06-09T09:30:00-04:00,22.10001,22.23,22.00999,22.08,952400,1077915,66.11787867586791,74.82396321694823,NaN,NaN,58.12381771989015,93.68753995386803,-0.006861558387864175,0.6536889467605107,0.6605505051483749,6581500,7994800,90.69948974572227,89.45087097384034,NaN,NaN,46.47852940167644,49.914753329713285
2003-06-10T09:30:00-04:00,22.25,22.25,22.05,22.17999,426300,1088510,67.34799012346875,74.48186341814174,NaN,NaN,57.628268888249835,82.20867017807166,-0.027602835126279146,0.626046961240526,0.6536497963668051,7007800,7763760,86.76087950197028,89.99413499760804,NaN,NaN,44.71136811799968,49.17141258518277
2003-06-11T09:30:00-04:00,22.17999,22.39,22.10001,22.35001,613600,1092145,69.38343109805012,74.41075408718227,NaN,NaN,64.57111588163377,71.60908218731562,-0.034265000552208824,0.610818545676544,0.6450835462287529,7621400,7427720,81.23537621140076,90.07006321422398,NaN,NaN,43.819005042273254,48.4067829361957
2003-06-12T09:30:00-04:00,22.44,22.62,22.28,22.62,659500,1098320,72.33290467890383,74.2061588024525,NaN,NaN,84.47499994852446,68.95043563867651,-0.025295461325645197,0.6134642195716964,0.6387596808973416,8280900,7405100,80.86205815589838,89.91145529443966,NaN,NaN,43.94156135708537,47.768894139179935
2003-06-13T09:30:00-04:00,22.64999,22.69,22.21001,22.32001,421100,1074910,64.85661605513428,72.98087660112397,NaN,NaN,69.32270243180027,66.82418097401971,-0.04331560907674337,0.5846151695514124,0.6279307786281557,7859800,7470280,81.13114091917765,89.54367581622111,NaN,NaN,41.68658512765096,46.89999285181865
2003-06-16T09:30:00-04:00,22.39999,22.75,22.39999,22.75,836800,1072465,69.69212222484632,71.96501732101909,NaN,NaN,94.2633647905411,74.05209038814989,-0.030623380557768254,0.5896515529309454,0.6202749334887137,8696600,7893300,82.81947471714342,89.06723349226482,NaN,NaN,41.28527363804139,46.097890106993326
2003-06-17T09:30:00-04:00,22.95,22.95,22.58,22.64,1619100,1112215,67.14680040520182,70.97345351632372,NaN,NaN,105.81522226902898,83.68948106430572,-0.033737680588329155,0.5781028327533022,0.6118405133416314,7077500,7907240,82.87385716991531,88.48395300256081,NaN,NaN,40.1504381685783,45.24825411579118
2003-06-18T09:30:00-04:00,22.66,22.77,22.50999,22.75,343300,1103275,68.39007527635124,70.70096956379454,NaN,NaN,101.48189639668928,91.07163716731682,-0.03247916869827494,0.5712415524687877,0.6037207211670627,7420800,7867120,82.06869618717744,87.77409294635665,NaN,NaN,39.61015012980445,44.442810689221645
2003-06-19T09:30:00-04:00,22.95,22.95,22.71001,22.82001,533100,1099720,69.18925374891529,70.34160752952825,NaN,NaN,134.5327598360569,101.08318914482331,-0.031023878065438493,0.5649408735852646,0.5959647516507031,7953900,7801720,80.69243925333835,86.92847937669993,NaN,NaN,39.40615351965636,43.723288236426605
2003-06-20T09:30:00-04:00,22.78999,22.81,22.52,22.52,445500,978775,61.96002098730459,69.34952603507294,NaN,NaN,81.61408591918268,103.5414658422998,-0.05306464134080646,0.5296339499746949,0.5826985913155014,7508400,7731440,79.15624596500145,85.95598486105304,NaN,NaN,37.012115722580155,42.76454930587711
2003-06-23T09:30:00-04:00,22.5,22.52,22.19,22.28,515500,892805,56.843285919864115,67.93810762413612,NaN,NaN,-5.042557513785788,83.68028138143441,-0.08472621972291228,0.47679081666186107,0.5615170363847733,6992900,7390700,71.99945581718173,84.46954534729421,NaN,NaN,33.37020728937806,41.42250044637725
2003-06-24T09:30:00-04:00,22.33,22.33,21.96001,22.14,658500,862045,54.0398110111992,66.1529641696052,NaN,NaN,-63.41040735474486,49.83515545667965,-0.11418331179582608,0.4187878966399907,0.5329712084358168,6334400,7242080,69.06628075075768,82.72335866070765,NaN,NaN,29.49157119423658,39.71808198178572
2003-06-25T09:30:00-04:00,22.2,22.39999,22.07001,22.10001,353500,807275,53.232204151152715,64.79402903978556,NaN,NaN,-48.4151444986478,19.855747277612227,-0.13407183369324038,0.36538141631926635,0.49945325001250673,5980900,6954100,63.65487390667612,80.53612790813723,NaN,NaN,26.104498800445707,37.773284384451436
2003-06-26T09:30:00-04:00,22.2,22.32001,22.12,22.31,379300,744545,56.87664272823764,64.1006455060356,NaN,NaN,-37.05459309090541,-14.461723307780241,-0.13066165556650666,0.3361261805543734,0.46678783612088004,6360200,6635360,58.217873341881194,77.94558154594586,NaN,NaN,24.217947275386788,35.83680765458506
2003-06-27T09:30:00-04:00,22.28999,22.32001,22.00999,22.02,245800,678760,50.96949135256064,63.018617840085085,NaN,NaN,-95.40992624341666,-49.86652574030011,-0.14443746019693782,0.28624101087470777,0.4306784710716456,6114400,6356560,53.88259391352891,75.31580327221776,NaN,NaN,20.74875477557798,33.681371529012615
2003-06-30T09:30:00-04:00,22.3,22.3,22.02,22.12,185200,628910,52.79029098059376,61.97878218702259,NaN,NaN,-81.99577564758634,-65.25716936706021,-0.14304486435220942,0.2518723906313838,0.3949172549835932,6299600,6217900,51.81594231456786,72.81973633026045,NaN,NaN,18.415031857750225,31.500465861689417
2003-07-01T09:30:00-04:00,21.99001,22.14,21.7,21.97,688400,639160,49.80267762097216,60.58015693865987,NaN,NaN,-139.8050571163546,-80.53609931938216,-0.14784639889929307,0.21010925635947686,0.35795565525876993,5611200,6073260,49.67559736210165,70.56546641245338,NaN,NaN,15.558311625703139,29.22301525654852
2003-07-02T09:30:00-04:00,21.92999,22.17999,21.89999,22.13,315100,597985,52.866830231185126,59.18972304953711,NaN,NaN,-87.49573671085847,-88.35221776182429,-0.13615814236778156,0.18775797729904298,0.32391611966682454,5926300,6062340,49.50932262671935,68.3259853032263,NaN,NaN,14.012928179439504,27.050145674104375
2003-07-03T09:30:00-04:00,22.13,22.25,21.92,22,295900,567400,50.18628616236715,58.14184234291088,NaN,NaN,-83.64668127739714,-97.67063539912263,-0.13294391252856458,0.15773622900611883,0.2906801415346834,5630400,5916380,47.23354607527061,65.90472852866152,NaN,NaN,11.930515503864779,24.89019850692729
2003-07-07T09:30:00-04:00,22,22.17999,22,22.03999,216000,535195,51.00918617450592,56.80734691074371,NaN,NaN,-71.82370132444174,-92.95339041532766,-0.12405816294952732,0.1356074378477743,0.2596656007973016,5846400,5862780,46.39024068171035,63.30264038327344,NaN,NaN,10.437886235490351,22.825582468150586
2003-07-08T09:30:00-04:00,22.03,22.06,21.78999,21.87,477400,511445,47.42291560972679,55.3984979967812,NaN,NaN,-114.73504795737904,-99.5012448772862,-0.12520109974978758,0.10316422611006715,0.22836532585985472,5369000,5676660,43.48685165676336,60.48928284661974,NaN,NaN,8.124050184055095,20.725363570422658
2003-07-09T09:30:00-04:00,21.75999,21.95,21.64999,21.71001,390900,509675,44.26833253749487,53.67551637257718,NaN,NaN,-139.25067802097433,-99.39036905821015,-0.13164637297888354,0.06380735963625028,0.19545373261513382,4978100,5550040,41.5802513268474,57.59725107088188,NaN,NaN,5.217235545212475,18.509916709678347
2003-07-10T09:30:00-04:00,21.71001,21.71001,21.12,21.32001,609200,509455,37.687156079872054,51.42536653907409,NaN,NaN,-201.6215302727604,-122.21552777059053,-0.1554558282266259,0.0011339473318514592,0.15658977555847736,4368900,5238560,37.25332698448859,54.49445733739261,NaN,NaN,0.4656154990959788,15.932159393880866
2003-07-11T09:30:00-04:00,21.35001,21.47,21.25,21.45,507000,501830,40.84390395842407,49.91707246558263,NaN,NaN,-175.3526499282059,-140.5567215007523,-0.15536182308964971,-0.03761250330358479,0.11774931978606493,4875900,5087660,35.3349228740949,51.36436283089928,NaN,NaN,-2.5344910126912232,13.294066478656282
2003-07-14T09:30:00-04:00,21.58,21.67,21.3,21.42,262400,493895,40.33603516731603,48.737983126114905,NaN,NaN,-140.6240133905052,-154.316783913965,-0.1501466069880286,-0.06993393894897082,0.08021266803905777,4613500,4841080,32.398905241860604,48.535752075519206,NaN,NaN,-5.116366389794454,10.664004640306176
2003-07-15T09:30:00-04:00,21.38,21.39999,21,21,1196700,511890,33.96798120137825,47.30428099684199,NaN,NaN,-179.54991605321166,-167.2797575331315,-0.16654157971392286,-0.1279643066033458,0.03857727311057706,3416800,4450640,28.37805192600787,45.629450016608494,NaN,NaN,-9.544354172620997,7.777096238459437
2003-07-16T09:30:00-04:00,21.14999,21.14999,20.57001,20.64999,587500,460310,29.75245170315371,45.62715582198491,NaN,NaN,-198.83134025290707,-179.19588997951806,-0.19077576833761126,-0.19989243731143702,-0.009116668973825764,2829300,4020880,24.738721297363057,42.84972483022899,NaN,NaN,-14.841177440203749,4.545914284364697
2003-07-17T09:30:00-04:00,20.64999,20.8,20.5,20.60001,383500,462320,29.195271852907652,43.649915045175625,NaN,NaN,-183.31055815683894,-175.53369555633375,-0.1990709991612068,-0.2579554179253343,-0.05888441876412747,2445800,3636260,22.017312435557614,40.26397047977731,NaN,NaN,-19.212365938594488,1.1518742525133847
2003-07-18T09:30:00-04:00,20.85001,21,20.71001,20.92,203400,445835,37.292179535334284,42.67296420108802,NaN,NaN,-126.46229257065349,-165.75562408482327,-0.17287680616000983,-0.2749804264641398,-0.10210362030412994,2649200,3190920,19.361485632291675,37.79817703111751,NaN,NaN,-20.415615399340094,-1.9291956977513975
2003-07-21T09:30:00-04:00,20.99001,20.99001,20.50999,20.62,327700,439945,33.43214889524886,41.290239766420534,NaN,NaN,-128.9963724521,-163.4300958971422,-0.1656107455372744,-0.30911705222572294,-0.14350630668844855,2321500,2732520,17.07794546954625,35.31689154218739,NaN,NaN,-22.709932785485396,-4.89787242457054
2003-07-22T09:30:00-04:00,20.72,21.05,20.57001,20.97,351600,431750,41.09291169285161,40.66811362869764,NaN,NaN,-95.36197013556666,-146.5925067136132,-0.1287304286247652,-0.30441934246940505,-0.17568891384463986,2673100,2583780,16.40196565770684,32.940203563302056,NaN,NaN,-22.057693854119474,-7.349275485934673
2003-07-23T09:30:00-04:00,20.99001,21,20.75999,20.84,292100,413430,39.28453426372234,39.69794963102172,NaN,NaN,-85.1110125589925,-123.84844117483028,-0.10556087269385314,-0.3076400047119563,-0.20207913201810315,2381000,2494120,15.99107026120808,30.546042680051244,NaN,NaN,-22.118904935372207,-9.459222550140035
2003-07-24T09:30:00-04:00,20.89999,21.10001,20.81,20.83,340500,412780,39.14184058387937,38.909060661129736,NaN,NaN,-72.12573626244392,-101.61147679595129,-0.08430082829264005,-0.3074551673839032,-0.22315433909126317,2040500,2413060,15.610320409464023,28.287240846779344,NaN,NaN,-22.21000347140673,-11.280762681749563
2003-07-25T09:30:00-04:00,20.98,21.07001,20.8,21,335000,410565,42.936519146365384,38.33244158769112,NaN,NaN,-60.48248928351559,-88.41551613852371,-0.05367279725576243,-0.2902453356609662,-0.23657253840520379,2375500,2358320,15.344614585894846,26.069696125649664,NaN,NaN,-21.12756768970994,-12.687449111458188
2003-07-28T09:30:00-04:00,21.14999,21.14999,20.77,20.85001,285000,412525,40.53500850223143,37.84044822287002,NaN,NaN,-58.69471799776044,-74.35518524765578,-0.03907734876426472,-0.2854192243605347,-0.24634187559626997,2090500,2312120,15.11083871059867,24.04283805806646,NaN,NaN,-20.92563464278055,-13.864332758789953
2003-07-29T09:30:00-04:00,21.12,21.12,20.64999,20.75999,775900,442060,39.12075803530359,37.47276432985637,NaN,NaN,-63.670980979927144,-68.01698741652788,-0.03137971945571849,-0.28556652491591805,-0.25418680546019956,1314600,2040420,13.78111779982143,22.057185663278894,NaN,NaN,-21.164914361250403,-14.907272987712874
2003-07-30T09:30:00-04:00,20.96001,20.96001,20.61,20.61,501200,432700,36.8159235578217,37.4105334354242,NaN,NaN,-74.77351760266731,-65.94948842526289,-0.0321646565972068,-0.29439262620670803,-0.26222796960950123,813400,1726900,12.422658107773373,20.283566457799232,NaN,NaN,-22.031637560024585,-15.925039355185975
2003-07-31T09:30:00-04:00,20.7,20.86,20.60001,20.64,1005800,467235,37.60770816059445,37.17937659272207,NaN,NaN,-74.77707050054603,-66.4797552728833,-0.026665303283783803,-0.295559598714231,-0.2688942954304472,1819200,1682640,12.239237754578866,18.63387466354809,NaN,NaN,-22.52453364026037,-16.867824253053744
2003-08-01T09:30:00-04:00,20.75999,20.75999,20.48,20.55,967500,500815,36.144365759182676,36.87997163499826,NaN,NaN,-89.00318366042988,-72.18389414826615,-0.025112707686198,-0.3002851800381947,-0.2751724723519967,851700,1377880,11.031434434001781,17.107626748701033,NaN,NaN,-23.341913204910345,-17.792694103318972
2003-08-04T09:30:00-04:00,20.64,20.64,20.27,20.55,222100,501120,36.144365759182676,37.03542767484144,NaN,NaN,-110.79734848608439,-82.60442024593094,-0.020314426306080935,-0.3005655052345979,-0.280251078928517,851700,1130120,10.154144589467478,15.805919081805294,NaN,NaN,-24.020014529227165,-18.682311307020143
2003-08-05T09:30:00-04:00,20.60001,20.60001,20.17,20.23,588800,506690,31.146791658680527,37.1350233859505,NaN,NaN,-150.1501208356493,-99.90024821707537,-0.034108697530500276,-0.3228869508416423,-0.28877825331114204,262900,919780,9.465891755317543,14.715002685944897,NaN,NaN,-26.077203326505234,-19.738724452660872
2003-08-06T09:30:00-04:00,20.14999,20.53999,20.12,20.35001,640400,519165,34.78841902397862,37.53453389816985,NaN,NaN,-147.14778200400235,-114.3751010973424,-0.03067515116074271,-0.3271221922620704,-0.2964470411013277,903300,937760,10.027286040381938,13.858572229146636,NaN,NaN,-26.805236339766314,-20.74822615081879
2003-08-07T09:30:00-04:00,20.56,20.60001,20.3,20.53999,440800,510745,40.18201296566168,37.74095057176466,NaN,NaN,-96.39664123620145,-118.69901524447346,-0.012088297843851348,-0.31155741340614185,-0.2994691155622905,1344100,842740,9.685474529102564,13.167428578918845,NaN,NaN,-25.873534044505504,-21.480412992774035
2003-08-08T09:30:00-04:00,20.50999,20.69,20.5,20.64,276000,499195,42.861210771309345,38.41445499148326,NaN,NaN,-50.41487147000411,-110.98135280638833,0.009307877597295455,-0.2878342685656712,-0.29714214616296664,1620100,996420,14.747203899444543,13.000947038197296,NaN,NaN,-24.31221525349634,-21.88495617287722
2003-08-11T09:30:00-04:00,20.73,20.77,20.50999,20.64,284000,500275,42.86121077130935,38.54076206851596,NaN,NaN,-31.982952835106854,-95.2184736761928,0.024939639753942422,-0.2659675964705386,-0.290907236224481,1620100,1150100,19.59989467705887,13.229370539579586,NaN,NaN,-23.032741019276912,-22.048925436648606
2003-08-12T09:30:00-04:00,20.74001,20.92,20.61,20.92,1393900,510135,50.1159041323605,39.31443134484726,NaN,NaN,48.70942538191134,-55.44656443268068,0.053951039921770694,-0.22346843632226765,-0.27741947624403834,3014000,1700320,34.06970148056267,14.520701340962054,NaN,NaN,-19.70957768328085,-21.71473290045321
2003-08-13T09:30:00-04:00,20.99001,20.99001,20.71001,20.72,641900,512855,45.656776337450545,39.77978389867377,NaN,NaN,43.77163020899032,-17.262681990082147,0.059072268486849766,-0.2035791406354761,-0.2626514091223259,2372100,1994080,40.25226428235983,16.28084018902604,NaN,NaN,-18.105861150430943,-21.199179793307174
2003-08-14T09:30:00-04:00,20.82001,20.99001,20.71001,20.8,155200,501440,47.66277089306259,40.11737330915214,NaN,NaN,50.45839419359535,12.10832509587721,0.06668544527702425,-0.17929460252604557,-0.2459800478030698,2527300,2230720,44.747147175949365,18.381021088315652,NaN,NaN,-16.18121097849642,-20.482327105477065
2003-08-15T09:30:00-04:00,20.89999,20.92999,20.64999,20.75999,95900,496065,46.733639352275596,40.560132655583864,NaN,NaN,30.479138286073653,28.28712704709277,0.06765068417648515,-0.16141669258246338,-0.22906737675894853,2431400,2392980,47.65504891242042,20.705607531302917,NaN,NaN,-14.845813018721927,-19.67711080736919
2003-08-18T09:30:00-04:00,20.92,20.92,20.63,20.71001,234300,491395,45.53938331489215,41.018605889840195,NaN,NaN,17.50666446097693,38.18505050630953,0.06360807327808998,-0.14955728516133604,-0.21316535843942602,2197100,2508380,49.6832751910217,23.27004734496008,NaN,NaN,-14.045583812526075,-18.87260695096303
2003-08-19T09:30:00-04:00,20.84,20.84,20.57001,20.73,409700,494300,46.13230517106072,41.68406171935727,NaN,NaN,3.4181379610424747,29.126793022135757,0.06095890575969087,-0.13696672623981243,-0.1979256319995033,2606800,2426940,48.26204645522748,25.83000365549251,NaN,NaN,-13.217895805666366,-18.064791073063507
2003-08-20T09:30:00-04:00,20.85001,20.95,20.62,20.92999,586500,509020,51.78758338557868,42.69690994971328,NaN,NaN,59.385046907143256,32.24947636176635,0.07067023710548045,-0.10958783561765273,-0.18025807272313318,3193300,2591180,51.28834981152591,28.619225945274444,NaN,NaN,-10.879398681659293,-17.038306445720046
2003-08-21T09:30:00-04:00,20.87,21.10001,20.82001,21.00999,565700,520280,53.87370924343382,43.963291627159784,NaN,NaN,121.706026403297,46.499002803706674,0.07980125239336261,-0.08050650723142994,-0.16030775962479255,3759000,2837520,55.49337462690561,31.795078816196146,NaN,NaN,-8.296087615367782,-15.789418041384009
2003-08-22T09:30:00-04:00,21.02,21.10001,20.72,20.72,568400,531950,46.08878204835451,44.67360707638635,NaN,NaN,67.45960033025094,53.89509521254213,0.06429609327682875,-0.07993764302875661,-0.14423373630558536,3190600,2989360,57.905484978562995,35.20588884398868,NaN,NaN,-8.191383092417777,-14.703984477245976
2003-08-25T09:30:00-04:00,20.63,20.88,20.63,20.82001,210100,528205,48.83476441531073,45.93703370185994,NaN,NaN,39.74790487771677,58.3433432958901,0.058904608474112885,-0.07060297571294427,-0.12950758418705716,3400700,3230080,61.47061404625287,38.92051186476978,NaN,NaN,-7.290711659204498,-13.64494550324005
2003-08-26T09:30:00-04:00,20.89,21,20.74001,20.88,241900,501505,50.46463850373602,47.05676366469975,NaN,NaN,85.13395652387773,74.68650700845714,0.05744657091535496,-0.05769937054286345,-0.11514594145821841,3642600,3437240,64.2747761542974,42.7953325871923,NaN,NaN,-6.071264068807277,-12.562991012606798
2003-08-27T09:30:00-04:00,20.8,20.99001,20.8,20.95,438500,498370,52.3712074307341,47.92742041220492,NaN,NaN,95.02093941228988,81.81368550948648,0.05903825708315533,-0.041348120104274244,-0.10038637718742957,4081100,3614800,66.52368858724441,46.85520501991671,NaN,NaN,-4.501674214167636,-11.411374327115489
2003-08-28T09:30:00-04:00,20.85001,21.03,20.85001,21,527900,474475,53.740801679879155,48.704534048531336,NaN,NaN,103.94295833630281,78.26107189608764,0.06104709877428112,-0.024077503719578175,-0.0851246024938593,4609000,3784800,68.56407445418424,50.69926720239812,NaN,NaN,-2.8003818196712977,-10.181232540337747
2003-08-29T09:30:00-04:00,21,21.05,20.88,21.05,530300,452615,55.13030674975243,49.58089804699155,NaN,NaN,108.54593488032006,86.47833880610146,0.06307295997821966,-0.006283402521084724,-0.06935636249930438,5139300,4174540,72.67587231588884,54.49040846231454,NaN,NaN,-0.9779150985020975,-8.866472905789797
2003-09-02T09:30:00-04:00,20.97,21.44,20.97,21.44,960500,489535,64.17057235418372,50.58480291997893,NaN,NaN,213.13023486704267,121.15480480396664,0.08655753935504298,0.03884056169449934,-0.047716977660543634,6099800,4714360,77.1365938228208,57.56661505819012,NaN,NaN,3.6826900311218256,-7.073735343373851
2003-09-03T09:30:00-04:00,21.38,21.58,21.38,21.50999,963200,508255,65.51344245653263,52.003136214199074,NaN,NaN,264.3071591418318,156.98944532755746,0.10164135436154256,0.07933471529138458,-0.022306639070157987,7063000,5398440,81.3023075539773,60.4987610061628,NaN,NaN,7.924257238940645,-4.9311649744717805
2003-09-04T09:30:00-04:00,21.56,21.60001,21.46001,21.52,992600,525865,65.71137942541688,53.29232253793867,NaN,NaN,224.3558352990855,182.8564245049166,0.10660956982080941,0.11095532320585377,0.004345753385044365,8055600,6193340,84.77389166785922,63.35781418415637,NaN,NaN,11.413511813335226,-2.596211147642208
2003-09-05T09:30:00-04:00,21.64,21.66,21.41,21.48,929000,550275,64.12746490874159,54.53473864911481,NaN,NaN,179.38372699674295,197.9445782370046,0.10154257524959401,0.13127397244703687,0.029731397197442867,7126600,6696860,86.48558459634515,66.13142387586527,NaN,NaN,13.889222936186533,-0.2411491356666735
2003-09-08T09:30:00-04:00,21.60001,21.73,21.45,21.64,666400,569795,67.50184876879229,56.10348618153625,NaN,NaN,166.68931422552637,209.5732541060459,0.10298342236842331,0.15846067515797202,0.0554772527895487,7793000,7227600,88.01499780575216,68.86940406263173,NaN,NaN,17.078873057840266,2.233139749120032
2003-09-09T09:30:00-04:00,21.83,21.83,21.50999,21.59,354900,573340,65.4305271391987,57.48193060783181,NaN,NaN,142.7766047944489,195.50252809152713,0.09479129754117709,0.17396637471602006,0.07917507717484297,7438100,7495260,88.70897813116159,71.75847061091274,NaN,NaN,19.171562832330764,4.652914475292993
2003-09-10T09:30:00-04:00,21.59,21.66,21.48,21.56,336100,520450,64.15842638569204,58.36556225069705,NaN,NaN,105.67861130611647,163.77681852438405,0.08205116197504675,0.1817390296436514,0.09968786766860466,7102000,7503060,88.72945905835647,74.43283555711491,NaN,NaN,20.57711256838448,6.927799917163206
2003-09-11T09:30:00-04:00,21.74001,21.74001,21.5,21.5,1398900,558300,61.57976796353146,58.91599501641832,NaN,NaN,94.35324018852681,137.7762995022723,0.0650267392359312,0.18097129171351867,0.11594455247758746,5703100,7032560,79.3763268805741,76.13876071809123,NaN,NaN,21.087341174645825,8.950591525375009
2003-09-12T09:30:00-04:00,21.5,21.7,21.42,21.66,2120500,656565,65.55546971181484,60.30647270666549,NaN,NaN,85.85049746268999,119.0696535954617,0.06010113361634706,0.19107096949802127,0.1309698358816742,7823600,7171960,80.04741004661024,77.72032679438033,NaN,NaN,22.6656687032233,10.909888265067622
2003-09-15T09:30:00-04:00,21.74001,21.74001,21.48,21.53999,567800,680160,60.498605263298785,61.139604195807486,NaN,NaN,76.0118078664892,100.93415232365427,0.04501047387369486,0.18723292822379278,0.14222245435009792,7255800,7064520,77.94231580732607,78.89687692017128,NaN,NaN,22.58213222986756,12.57735168861047
2003-09-16T09:30:00-04:00,21.60001,21.77,21.50999,21.73,148100,675850,65.09019902595502,62.1842870902517,NaN,NaN,84.30971469731898,89.24077430422831,0.044021796618482795,0.19724970012320142,0.15322790350471863,7403900,7057680,77.80203766212126,79.86310988501585,NaN,NaN,23.886065996744502,14.19288230405819
2003-09-17T09:30:00-04:00,21.75,21.77,21.60001,21.67,504400,680585,62.615116435625886,62.915994876315395,NaN,NaN,79.88976734750297,84.08300551250561,0.035868408170784044,0.1980634137181987,0.16219500554741464,6899500,7017180,76.91929199901763,80.60565298585678,NaN,NaN,24.231011842174485,15.626900809503374
2003-09-18T09:30:00-04:00,21.71001,21.97,21.67,21.91,247000,663610,67.87693373203422,63.925718594326476,NaN,NaN,106.52568700055933,86.5174948749121,0.042715279434064946,0.21558910483999583,0.17287382540593088,7146500,7305860,78.7684447427169,81.33453657789482,NaN,NaN,26.204315645580433,17.137960071800098
2003-09-19T09:30:00-04:00,21.77,21.84,21.64999,21.75,239500,647300,61.647499280632665,64.3912323465322,NaN,NaN,79.02871892660136,85.15313916769438,0.03298067628602325,0.21409967076345993,0.18111899447743668,6907000,7122540,74.67689579053165,81.47746682608361,NaN,NaN,25.87287211291723,18.385804649102546
2003-09-22T09:30:00-04:00,21.88,21.88,21.50999,21.63,334500,635605,57.39315664979911,63.90713122479044,NaN,NaN,59.642485069108076,81.87927460821814,0.015840967116335702,0.20092020337285632,0.18507923625652062,6572500,6985880,71.68742236557742,81.08824029342337,NaN,NaN,24.22295006416347,19.21968256553982
2003-09-23T09:30:00-04:00,21.64,21.85001,21.57001,21.73,192400,634720,59.87802152595374,63.50460115832052,NaN,NaN,69.15701620670255,78.84873491009486,0.008962154101257225,0.19628192888309215,0.18731977478183492,6764900,6858080,68.90924448251114,80.20302150260434,NaN,NaN,23.625950035788794,19.84914934700396
2003-09-24T09:30:00-04:00,21.77,21.77,21.45,21.47,288100,637030,51.472632320343216,62.4875477936724,NaN,NaN,19.415037755127514,66.75378899161977,-0.01411951478216994,0.1696703813041225,0.18378989608629243,6476800,6773540,67.05791713076516,78.93759474995477,NaN,NaN,20.256143228902225,19.90729133013228
2003-09-25T09:30:00-04:00,21.48,21.66,21.45,21.50999,243800,627295,52.57533243737374,61.66239547428899,NaN,NaN,0.3015776398626061,45.50896711948043,-0.026969998399943185,0.15007739808636344,0.17704739648630663,6720600,6688360,65.15842974228943,77.41422654609364,NaN,NaN,17.929865891495293,19.624801981755567
2003-09-26T09:30:00-04:00,21.5,21.75,21.37,21.71001,934400,647620,57.747046024750574,60.96562384971458,NaN,NaN,23.245911596523573,34.352405653464864,-0.02245991889597415,0.14897249786633893,0.17143241676231308,7655000,6837960,66.93015801498768,75.90816656103904,NaN,NaN,17.578948691402402,19.33253722599083
2003-09-29T09:30:00-04:00,21.66,21.94,21.64999,21.94,253200,633765,62.77391686528982,60.77586597300681,NaN,NaN,168.0105258781298,56.02601381526921,-0.005341194494492774,0.1647559236441971,0.17009711813868988,7908200,7105100,69.87596662601253,74.5629514535284,NaN,NaN,18.967246540693584,19.28035284237694
2003-09-30T09:30:00-04:00,21.75,21.89999,21.63,21.89999,175200,594500,61.405272559114465,60.579212128251264,NaN,NaN,130.15297261418445,68.22520509676558,0.0015643968701242739,0.1720526142263452,0.17048821735622094,7733000,7298720,71.8343097351964,73.35615507330269,NaN,NaN,19.625801799881046,19.329702693448954
2003-10-01T09:30:00-04:00,21.97,22,21.61,21.92999,785300,585605,62.07299701014451,60.61444277443791,NaN,NaN,137.82516239271962,91.907230024284,0.006170900865181628,0.17820184343769796,0.17203094257251633,8518300,7707020,75.45762482308072,73.07624778348173,NaN,NaN,20.355562179078287,19.47625404853886
2003-10-02T09:30:00-04:00,21.89999,22.14999,21.89999,22.14,192000,545575,66.44900502719796,60.678266725536695,NaN,NaN,233.47604616180448,138.54212372867238,0.02056865381891773,0.1977417598461635,0.17717310602724576,8710300,8104960,78.37720516034246,72.9569474344626,NaN,NaN,22.3841102422632,19.891662076213766
2003-10-03T09:30:00-04:00,22.17,22.34,22.10001,22.19,332200,515735,67.41302998344014,61.17215420554679,NaN,NaN,245.61873988212636,183.01668938579294,0.030090273420817687,0.21478594780326787,0.1846956743824502,9042500,8382460,80.15050950490475,73.11467555571822,NaN,NaN,24.324291880887284,20.52489490545284
2003-10-06T09:30:00-04:00,22.25,22.25,22.10001,22.16,175800,491205,66.1842518602737,61.25030083656956,NaN,NaN,180.71743928885405,185.5580720679378,0.03088249314575059,0.22329879081463844,0.19241629766888785,8866700,8574160,81.29192648019234,73.36395332843759,NaN,NaN,25.55241577151208,21.24311217203273
2003-10-07T09:30:00-04:00,22.10001,22.2,21.92999,22.09,378000,492360,63.28560041039627,61.298192549053155,NaN,NaN,118.43448259991158,183.2143740650832,0.02353867067584231,0.22183963601369072,0.1983009653378484,8488700,8725300,82.16281634397791,73.73849078164903,NaN,NaN,25.764025075751963,21.88895687256405
2003-10-08T09:30:00-04:00,22.16,22.19,21.96001,22.00999,548100,502960,60.04837100547737,60.73900949715623,NaN,NaN,97.45793285490463,175.14092815752022,0.010787845681834135,0.21178577244014107,0.20099792675830694,7940600,8609760,79.13022294079056,73.76433208151145,NaN,NaN,25.025322604872542,22.337009120036694
2003-10-09T09:30:00-04:00,22.10001,22.22,22.00999,22.05,399400,452985,61.119422239809204,60.701289708525984,NaN,NaN,99.89596008653032,148.42491094246537,0.0029512439016270153,0.20468698163534071,0.2017357377337137,8340000,8535700,77.16419040633733,73.94199598264042,NaN,NaN,24.697487192123198,22.67422027319191
2003-10-10T09:30:00-04:00,22.27,22.27,21.92999,21.98,203900,357155,58.1806334700117,60.75753805282688,NaN,NaN,78.90851823534553,115.08286661310922,-0.00842171803621758,0.19120859018844172,0.1996303082246593,8136100,8354420,72.42107034037936,73.994399409412,NaN,NaN,23.605705054513354,22.807289527666402
2003-10-13T09:30:00-04:00,21.97,22.17999,21.89999,22.12,340100,345770,62.105132313373296,60.91661739478542,NaN,NaN,71.79503867862174,93.29838649106273,-0.007994108351826568,0.1896376727848761,0.19763178113670266,8476200,8276320,70.41296373989418,74.10180792779649,NaN,NaN,23.73321613679501,22.939564757541916
2003-10-14T09:30:00-04:00,22.08,22.2,22.00999,22.17999,496300,363180,63.67806883439226,61.78843428864606,NaN,NaN,83.76825378818488,86.36514072871739,-0.00528037608800061,0.1910313110267019,0.1963116871147025,8972500,8373080,71.46850651890983,74.41685002694967,NaN,NaN,24.2814319622483,23.13126007249997
2003-10-15T09:30:00-04:00,22.25,22.25,21.87,21.89999,845400,380230,52.685781328941886,61.79632349518664,NaN,NaN,35.89708728832094,74.05297161540065,-0.022961337286598327,0.1676100155064546,0.19057135279305293,8127100,8410380,71.88490731407222,74.89731271064845,NaN,NaN,21.352662949013563,22.87717476914477
2003-10-16T09:30:00-04:00,21.89,22.06,21.88,22,392300,387495,55.63182919192656,61.64523657855635,NaN,NaN,24.003871953454503,58.8745539887855,-0.02819474807450542,0.15532791769992116,0.18352266577442658,8519400,8446260,72.30364110500376,75.28113293136389,NaN,NaN,19.805307223706734,22.438336548367907
2003-10-17T09:30:00-04:00,22.25,22.25,21.86,21.86,190600,385050,50.85790132884601,60.7940926116675,NaN,NaN,24.11948132455652,47.916746606627704,-0.04060454733161756,0.13276698160990463,0.1733715289415222,8328800,8484800,72.77272086309097,75.48804394829804,NaN,NaN,16.970047438524254,21.657152389818815
2003-10-20T09:30:00-04:00,22.00999,22.00999,21.83,21.97,203400,378495,54.18459902232812,60.278330216182766,NaN,NaN,-0.6108642294836402,33.43556602500662,-0.04081486373696003,0.12235294927032214,0.16316781300728217,8532200,8496000,72.9162775295121,75.56532736217774,NaN,NaN,15.617580247843584,20.79435636953664
2003-10-21T09:30:00-04:00,22,22.11,21.89999,21.94,349500,386350,53.12827154374914,59.63942125429738,NaN,NaN,14.049355095943113,19.491786286558288,-0.042209203104591836,0.11040630912654237,0.1526155122311342,8182700,8338040,67.50996912874791,74.99763766972539,NaN,NaN,14.207534084247525,19.85338175735248
2003-10-22T09:30:00-04:00,22.05,22.17,21.89999,21.92999,308900,387390,52.75868666368962,58.66154137118964,NaN,NaN,14.182261959779588,15.148821220850015,-0.04290065314132885,0.09898969580447314,0.141890348945802,7873800,8287380,65.82432654092949,74.10100348262448,NaN,NaN,12.955359149386997,18.867949956214552
2003-10-23T09:30:00-04:00,21.99001,22.05,21.81,21.97,414800,395940,54.13214686447961,57.71290686269246,NaN,NaN,-33.50439794969238,3.6471672402206337,-0.03982535999861758,0.09210864894753001,0.1319340089461476,8288600,8241220,64.25013728534938,72.9652626097991,NaN,NaN,12.278676817356441,17.926625222091964
2003-10-24T09:30:00-04:00,22.03,22.14,21.81,21.89999,436500,371045,51.3204973512848,56.6512101120504,NaN,NaN,-48.85955276113359,-10.94863957691739,-0.0414808064751309,0.08008300085223397,0.12156380732736487,7852100,8145880,61.005021941789714,71.51619799991319,NaN,NaN,10.91914436100172,16.9255565276505
2003-10-27T09:30:00-05:00,22,22.14999,21.91,21.99001,331900,374980,54.58676651569914,56.02986483385774,NaN,NaN,-2.227274119139295,-11.271921554848516,-0.03570732376612312,0.07692965261971096,0.11263697638583409,8184000,8076240,58.673877593432984,69.83841666058855,NaN,NaN,10.63629093612868,16.027090014575954
2003-10-28T09:30:00-05:00,22,22.14,21.75999,21.92999,917100,412075,52.077770962726156,55.4605362593755,NaN,NaN,-80.00380120845735,-30.082552815728604,-0.03507400573522931,0.06879446921679744,0.10386847495202675,7266900,7893080,52.94362449944937,67.9679453433499,NaN,NaN,9.700618275266557,15.123308337531755
2003-10-29T09:30:00-05:00,21.92999,22.05,21.84,21.91,471200,396370,51.23314385589466,54.754373517667325,NaN,NaN,-99.54351864585205,-52.827708936854926,-0.03506108108429398,0.06004212359665928,0.09510320468095326,6795700,7677460,47.110636583027805,65.82126292739922,NaN,NaN,8.68947083853606,14.204188694818084
2003-10-30T09:30:00-05:00,22.24001,22.25,21.92,22.09,408500,407195,57.860580318290104,54.73151257825864,NaN,NaN,55.781515048927574,-34.97052633713094,-0.022594878633646176,0.06685960638889554,0.08945448502254172,7204200,7460580,42.08780279272822,63.65460095970985,NaN,NaN,9.664636070475485,13.555681177054856
2003-10-31T09:30:00-05:00,22.17999,22.19,21.95,22.05,206500,400910,56.03804497506438,54.29814919695086,NaN,NaN,45.16142241619127,-16.16633130166597,-0.016965089591112287,0.06824812303365135,0.08521321262476364,6997700,7289700,38.59615602360153,61.38197183711752,NaN,NaN,9.967921529374735,13.043144084529125
2003-11-03T09:30:00-05:00,22.17,22.25,22.02,22.16,352786,409759.3,59.7891071873269,54.02036622216048,NaN,NaN,142.13114762139818,12.705353046441527,-0.006304038430330713,0.07733316458685024,0.08363720301718096,7350486,7122997.2,35.50186236921,58.81292582642468,NaN,NaN,11.330628931315925,12.798499062641525
2003-11-04T09:30:00-05:00,22.17,22.28999,21.96001,22.05,319050,406811.8,54.75751235233847,54.16834700954595,NaN,NaN,87.2585561945692,46.157824527046834,-0.007073877425100988,0.07479485623580473,0.08186873366090572,7031436,7075904.4,34.65658443089198,56.15375990619752,NaN,NaN,11.03834640468409,12.54704868293332
2003-11-05T09:30:00-05:00,22.03999,22.09,21.85001,22.03999,361400,397476.8,54.30960692020426,54.07390256156578,NaN,NaN,-32.0560804698926,59.65531216223873,-0.00857076968134815,0.07115527155922052,0.07972604124056867,6670036,7050771.6,34.18873885760868,53.43126688852645,NaN,NaN,10.673374965710778,12.279381009044386
2003-11-06T09:30:00-05:00,22.2,22.2,21.81,21.95,455600,400286.8,50.324270691401686,54.03578608746262,NaN,NaN,-35.711573425842595,41.3566944672847,-0.015529497505300666,0.06031416935894285,0.07584366686424351,6214436,6852818.8,30.676180795551275,50.424371169416474,NaN,NaN,9.211402892408424,11.841098420953534
2003-11-07T09:30:00-05:00,21.96001,22.03,21.75999,21.81,341500,407166.8,44.81459257594067,53.366499912720656,NaN,NaN,-164.30935812577172,-0.5374616411079103,-0.02870293653988283,0.03996499618938998,0.06866793272927281,5872936,6627866,27.24992222191878,47.16248864744552,NaN,NaN,6.235489389825647,11.040297130792407
2003-11-10T09:30:00-05:00,21.94,21.99001,21.75999,21.75999,915100,435916.8,43.00339838187622,52.64329468687259,NaN,NaN,-178.14316569959735,-64.59232430530702,-0.03927269135471919,0.01957706853587382,0.05884975989059301,4957836,6149336,21.69802414500488,43.89020686289245,NaN,NaN,3.2157646207519166,9.922506772215193
2003-11-11T09:30:00-05:00,21.75999,21.84,21.7,21.78,531800,437691.8,43.978997410707905,52.01617402594532,NaN,NaN,-215.1635079699747,-125.0767371382158,-0.04309840010111931,0.004976759764193872,0.04807515986531318,5489636,5840976,19.010223840381272,40.54634238428186,NaN,NaN,0.9983018662946375,8.647620357083685
2003-11-12T09:30:00-05:00,21.78999,21.92,21.77,21.83,609000,425871.8,46.445741015419884,51.46714503672677,NaN,NaN,-123.69217092500932,-143.40395522923913,-0.04048439974190811,-0.002530339812071958,0.03795405992983615,6098636,5726696,18.11464560498142,37.25095012139843,NaN,NaN,-0.20940419109116556,7.38233113591585
2003-11-13T09:30:00-05:00,21.87,21.92,21.75999,21.86,472600,429886.8,47.927300722669976,51.22477384896856,NaN,NaN,-102.67914274576971,-156.79746909322455,-0.03515522583164589,-0.005989972359721207,0.02916525347192468,6571236,5798056,20.62911759250744,34.366956953592556,NaN,NaN,-0.8265831943057805,6.209629088741331
2003-11-14T09:30:00-05:00,21.81,21.97,21.81,21.83,674000,454056.8,46.54072692330744,50.6500567352263,NaN,NaN,-73.94427744319395,-138.724452956709,-0.03215253180187397,-0.011025411280417785,0.021127120521456183,5897236,5802916,20.807474884998612,31.6622139029901,NaN,NaN,-1.7213189329670864,5.0766365142115575
2003-11-17T09:30:00-05:00,21.75999,21.8,21.52,21.64999,880400,487906.8,39.21042831752546,49.73096083199768,NaN,NaN,-208.7924297924578,-144.8543057752811,-0.040265442098069856,-0.02920468210113114,0.011060759996938717,5016836,5814716,21.270068842388454,29.399817070342895,NaN,NaN,-4.7480498570438225,3.6731098897465033
2003-11-18T09:30:00-05:00,21.75999,21.95,21.25999,21.25999,296000,485231.8,28.67336081386037,48.11954775756665,NaN,NaN,-246.2530930268932,-151.07222278666478,-0.06822940381473325,-0.07422599477147784,-0.005996590956744595,4720836,5660956,19.65862577516421,27.438959155495493,NaN,NaN,-11.748072125381851,1.47008388758531
2003-11-19T09:30:00-05:00,21.27,22.39999,21.25,21.53,690800,504326.8,40.5791219726242,46.88515787573338,NaN,NaN,-96.27636505656301,-145.5890616129755,-0.06489389799254748,-0.08711396344742894,-0.022220065454881463,5411636,5523556,18.322753732138494,25.74145565116766,NaN,NaN,-13.247367910051972,-0.6324092263628729
2003-11-20T09:30:00-05:00,21.64,21.7,21.35001,21.48,931200,530146.8,39.27186266109776,45.68757342473576,NaN,NaN,-176.98119332114558,-160.4494717280507,-0.06238972929340601,-0.10020722707163898,-0.03781749777823297,4480436,5105396,14.98528534679157,24.054964888538375,NaN,NaN,-14.847843288826951,-2.663185521000598
2003-11-21T09:30:00-05:00,21.38,21.53999,21.35001,21.44,483100,532476.8,38.21132554552402,44.14630330746412,NaN,NaN,-173.85706153115808,-180.4320285456435,-0.05975752380708056,-0.11251440253708367,-0.05275687873000311,3997336,4725416,12.718257014494057,22.42756450605867,NaN,NaN,-16.442431504556346,-4.631649232937134
2003-11-24T09:30:00-05:00,21.58,21.81,21.55,21.77,1128500,572306.8,50.16757628688099,43.818450731360024,NaN,NaN,-55.19214505262222,-149.71197159767638,-0.03343431680714125,-0.09454977473892967,-0.06111545793178842,5125836,4747216,13.526524822489321,20.91827453402991,NaN,NaN,-13.421573146371408,-5.88735264914203
2003-11-25T09:30:00-05:00,21.83,21.92,21.7,21.89,325100,542706.8,53.677743703606524,43.77331764446018,NaN,NaN,0.4334263042054998,-100.37466773145665,-0.006967460868053693,-0.06982478401685555,-0.06285732314880185,5450936,4893236,18.941201949304485,19.82916475486532,NaN,NaN,-9.75350370759837,-6.4396599432072215
2003-11-26T09:30:00-05:00,21.86,22.10001,21.85001,22.05,471000,542696.8,57.93260012608393,44.31676974693748,NaN,NaN,68.46973428289905,-67.42544786356424,0.02077058192581427,-0.036894095741534016,-0.057664677667348285,5921936,4995296,22.589717551379934,19.251560237424506,NaN,NaN,-5.222030622809253,-6.265712897436083
2003-11-28T09:30:00-05:00,22.09,22.10001,21.98,22.10001,254100,534976.8,59.19424795882085,45.34388798857178,NaN,NaN,95.2812755404093,-12.972954091253268,0.040784660774108784,-0.0066838516997123065,-0.04746851247382109,6176036,5334416,33.32815399377084,19.685719649699653,NaN,NaN,-1.2753814838956004,-5.552808409787443
2003-12-01T09:30:00-05:00,22.19,22.23,22,22.16,390000,544151.8,60.71623944236979,46.60909092146419,NaN,NaN,121.42794618240151,46.084047451458645,0.055452281367548366,0.021846839235614368,-0.033605442131934,6566036,5848156,45.632451206355384,21.39532158265326,NaN,NaN,2.372268030523235,-4.420654632600203
2003-12-02T09:30:00-05:00,22.03,22.25999,22.03,22.2,275600,540292.5,61.74092614778935,47.87780011697,NaN,NaN,134.16652313922194,83.95578108982748,0.06459784253055835,0.04714186103126394,-0.017455981499294407,6841636,6191316,52.00415963808636,23.752031282489334,NaN,NaN,5.6225683017486086,-2.985908499121802
2003-12-03T09:30:00-05:00,22.34,22.34,22.11,22.16,291000,538890,60.05396750991491,48.849816295148216,NaN,NaN,144.00677430634357,112.6704506902551,0.06455021373881362,0.06323178567422261,-0.0013184280645910026,6550636,6411256,55.596102945648184,26.429278235394104,NaN,NaN,7.785427872094002,-1.4471461603766873
2003-12-04T09:30:00-05:00,22.16,22.24001,22.06,22.21001,480300,544835,61.47138012477647,49.81725053815582,NaN,NaN,119.8946795252694,122.95543973872915,0.06434007329103061,0.07910666354919726,0.014766590258166654,7030936,6633056,58.93383895192772,29.16532976106698,NaN,NaN,9.99860353555609,0.18796093904228073
2003-12-05T09:30:00-05:00,22.25999,22.49001,22.2,22.33,419600,543035,64.7071815841375,51.11485444250082,NaN,NaN,159.34798777617826,135.76878218588294,0.06835840566740142,0.10021459734241844,0.031856191675017013,7450536,6887956,62.42906948085721,32.13830080362831,NaN,NaN,12.893941590947321,2.003101032171572
2003-12-08T09:30:00-05:00,22.39,22.48,22.3,22.39,301900,541055,66.23427422241652,53.04512914999304,NaN,NaN,144.71876228952337,140.42694540730733,0.07083219098125366,0.1203964304015841,0.04956423942033043,7752436,7125236,65.38272961220513,35.28920514432951,NaN,NaN,15.772054220832942,3.970094344837482
2003-12-09T09:30:00-05:00,22.49001,22.53999,22.2,22.2,297200,510160,57.71752643530145,55.119712408667404,NaN,NaN,105.72805897525178,134.73925257451327,0.056092347359737324,0.11967967362000209,0.06358732626026477,7455236,7247956,66.83493588082254,38.65894158044796,NaN,NaN,15.788392864607047,5.658422704804563
2003-12-10T09:30:00-05:00,22.35001,22.8,22.25,22.3,126600,489900,60.589830357591545,56.54904872187935,NaN,NaN,124.13283940628068,130.7644655945007,0.04971529826519,0.12573144909175227,0.07601615082656227,7581836,7454196,69.17526569610506,42.291263863588426,NaN,NaN,16.67734752741003,7.23255482231963
2003-12-11T09:30:00-05:00,22.28999,22.45,22.25999,22.39999,1090600,513980,63.27616022615186,58.263641405097516,NaN,NaN,93.0325014878458,125.39202998701599,0.04880023281925125,0.13701644185062634,0.08821620903137509,8672436,7782496,72.50173953035268,46.39958201955708,NaN,NaN,18.249636202245927,8.806423590880529
2003-12-12T09:30:00-05:00,22.55,22.55,22.3,22.45,960100,538355,64.57670399994231,60.14688272327025,NaN,NaN,97.334765544879,112.98938554075615,0.04805576971132648,0.14828592117053319,0.1002301514592067,9632536,8218896,76.18133979363148,50.932659360924035,NaN,NaN,19.932054400863862,10.395799420878149
2003-12-15T09:30:00-05:00,22.69,22.7,22.37,22.37,359600,522635,60.86347727736197,60.910875651161746,NaN,NaN,97.66372108106647,103.57837729906475,0.03905079953725098,0.14904365088077043,0.10999285134351945,9272936,8522996,78.35489865223268,55.56325749161999,NaN,NaN,20.268886859364954,11.80624048351912
2003-12-16T09:30:00-05:00,22.60001,22.64,22.41,22.50999,1483500,552790,64.68968778428243,61.69744308549574,NaN,NaN,98.88048766191534,102.20886303639746,0.03929060217519184,0.15910610406250925,0.1198155018873174,10756436,9183236,82.16110349461341,60.07896474485634,NaN,NaN,21.720716312851845,13.222594173423795
2003-12-17T09:30:00-05:00,22.57001,22.7,22.39999,22.61,1753100,625645,67.15983613453247,62.35653137181349,NaN,NaN,105.4827633857204,98.47884783228542,0.042671297030704436,0.17315462317569796,0.13048332614499353,12509536,10168776,86.09244256767693,64.61487367459185,NaN,NaN,23.706461872332994,14.720289558982252
2003-12-18T09:30:00-05:00,22.88,22.95,22.63,22.89999,2825600,732385,73.04752007321173,63.34605080855569,NaN,NaN,153.4097357788407,110.5542946904844,0.059870243922964084,0.20532113104869865,0.14545088712573456,15335136,11501316,89.4711120142299,68.62508496176748,NaN,NaN,27.561868613583666,16.55480085249674
2003-12-19T09:30:00-05:00,22.82001,22.95,22.61,22.74001,468600,709255,66.01590471456088,63.72459832799791,NaN,NaN,129.5756708162247,117.00247574475354,0.05597611568738786,0.2154210317349694,0.15944491604758154,14866536,12548116,91.26613309980172,71.88463366844222,NaN,NaN,28.412810255887987,18.248802195838348
2003-12-22T09:30:00-05:00,22.94,22.95,22.71001,22.95,241800,697190,70.08630644608806,64.32069692073354,NaN,NaN,150.90884685734508,127.65150090000925,0.06254843343146912,0.23763045783691794,0.17508202440544882,15108336,13715196,92.75014665162216,74.79506131226621,NaN,NaN,30.556135930373546,20.006992729343377
2003-12-23T09:30:00-05:00,23.13,23.14,22.98,23.07001,421900,661860,72.14004641728533,65.18398827125999,NaN,NaN,184.90076582995536,144.8555565336173,0.06945151106811462,0.2618964132405921,0.19244490217247748,15530236,14669956,93.69411156664123,77.51634764233714,NaN,NaN,32.99007650248393,21.86171898264917
2003-12-24T09:30:00-05:00,23.24001,23.24001,23.00999,23.11,125200,651865,72.80993761494648,65.99388523484357,NaN,NaN,174.02817883338426,158.56463962315004,0.07093504836001169,0.2811137126224921,0.21017866426248039,15655436,15299136,94.22751389159438,80.03732442374191,NaN,NaN,35.11910769886061,23.75563165639366
2003-12-26T09:30:00-05:00,23.10001,23.2,23.07001,23.14,165300,636580,73.32806077958655,66.60966232023279,NaN,NaN,151.28212097237136,158.13911666185618,0.06814473949606153,0.2953595886325573,0.22721484913649576,15820736,15396256,94.30755732977991,82.31435927009353,NaN,NaN,36.97880235704225,25.6446560422006
2003-12-29T09:30:00-05:00,23,23.32001,23,23.31,219100,634830,76.1065803859014,67.31482704619599,NaN,NaN,142.76607589329723,160.77719767727066,0.07160109655009889,0.31671621982411935,0.24511512327402046,16039836,15630916,94.50579349739361,84.39457811903557,NaN,NaN,39.47840523463254,27.620905926833736
2003-12-30T09:30:00-05:00,23.38,23.42999,23.28,23.37,180800,624370,77.01661896243048,68.69333365527663,NaN,NaN,148.10523210722093,160.21647472724584,0.07160841843297167,0.33462564631523506,0.2630172278822634,16220636,15853376,94.69442500481829,86.3845416278924,NaN,NaN,41.80063681628161,29.64658176818343
2003-12-31T09:30:00-05:00,23.48,23.48,23.21001,23.33,562900,638735,74.96666959555687,69.72025074370274,NaN,NaN,125.28420475718046,148.29316251269088,0.0629085916120079,0.34165296739727324,0.27874437578526534,15657736,15878876,94.71681623244372,88.20893809477374,NaN,NaN,43.10349610332029,31.56899810177441
2004-01-02T09:30:00-05:00,23.39999,23.49001,23.2,23.27,202400,634305,71.8762323346848,70.33454160859795,NaN,NaN,108.45693938592649,135.17891462319932,0.04778761728498493,0.3384788973914965,0.2906912801065116,15455336,15838856,94.0459941720214,89.7478134263215,NaN,NaN,43.30878267754945,33.24611018402799
2004-01-05T09:30:00-05:00,23.41,23.44,23.10001,23.31,409400,630760,72.68467913121313,70.913682689403,NaN,NaN,91.86424927629805,123.29534028398466,0.035707507295441254,0.3353256642258131,0.29961815693037186,15864736,15847656,94.05596318145267,91.0245722397373,NaN,NaN,43.70321346190979,34.739982080868245
2004-01-06T09:30:00-05:00,23.39999,23.39999,23.11,23.25999,187700,619165,69.97629395887046,71.56459816665361,NaN,NaN,78.49091630039409,110.44030836540404,0.020340998936145827,0.32504440560055414,0.3047034066644083,15677036,15775096,92.67805916182235,92.04765513327943,NaN,NaN,43.29219330219462,35.96172654105773
2004-01-07T09:30:00-05:00,23.39999,23.39999,23.17,23.38,451500,626645,72.6135292762709,72.1305868446528,NaN,NaN,81.55320470817533,97.12990288559492,0.014524095458094521,0.32285852598702647,0.30833443052893195,16128536,15756676,92.30835810395706,92.77245903394683,NaN,NaN,43.66146048408855,37.06168853291928
2004-01-08T09:30:00-05:00,23.45,23.45,23.3,23.37,271600,625365,72.04564536164528,72.47957321801799,NaN,NaN,85.02005721880897,89.0770733779206,0.0066675931809058175,0.31666892200506425,0.31000132882415843,15856936,15796516,92.37916744770952,93.221510811092,NaN,NaN,43.81210950956832,38.02603438672628
2004-01-09T09:30:00-05:00,23.33,23.42,23.25,23.28999,641900,651130,67.49726131617291,72.08312616394379,NaN,NaN,68.6558129281292,81.11684808636114,-0.006538510715811907,0.3018281904293936,0.3083667011452055,15215036,15748456,91.28739669626471,93.35124543123734,NaN,NaN,42.692652194723614,38.69269407358304
2004-01-12T09:30:00-05:00,23.34,23.37,23.17999,23.28,554700,624335,66.92910179443587,72.148354526792,NaN,NaN,55.26996728676439,73.7979916884544,-0.01792194007128539,0.28596427605609875,0.30388621612738415,14660336,15507576,85.8132856685531,92.96175632900531,NaN,NaN,41.60685737029833,39.10900311597094
2004-01-13T09:30:00-05:00,23.28999,23.32001,23.13,23.17,915500,622105,60.85487004849021,71.48896621267787,NaN,NaN,33.975475306553385,64.89490348968626,-0.03390777099008868,0.2615015023897733,0.295409273379862,13744836,15121136,77.75744655238492,91.8908491790598,NaN,NaN,38.943775085815844,39.08539911166307
2004-01-14T09:30:00-05:00,23.28999,23.45,23.2,23.45,275300,617890,68.65345877908294,71.23992423852056,NaN,NaN,75.25122692217157,63.634507932485505,-0.026974122815541013,0.26169161986043576,0.2886657426759768,14020136,14699456,70.03176282523896,90.20068141181677,NaN,NaN,38.73044442472904,39.034691299243924
2004-01-15T09:30:00-05:00,23.49001,23.5,23.25,23.37,256000,556515,64.68812731182045,70.65979493115442,NaN,NaN,75.21290286019449,61.673077060762616,-0.028951341956160892,0.25247656523077566,0.28142790718693655,13764136,14280896,63.307992371724005,87.99214416039747,NaN,NaN,37.31443383123086,38.78894023238492
2004-01-16T09:30:00-05:00,23.5,23.5,23.25,23.33,652500,501485,62.736956857853166,69.90328750817346,NaN,NaN,69.64757414155507,61.87142930344778,-0.03379137848590863,0.23918868407955074,0.27298006256545937,13111636,13860216,57.348382641581175,85.35220311124043,NaN,NaN,35.56931239323523,38.328993398220675
2004-01-20T09:30:00-05:00,23.28,23.53999,23.25999,23.5,356900,378050,67.25718413260626,69.27118777579524,NaN,NaN,101.09154697469545,71.035745241034,-0.026693323991927087,0.2396134075755505,0.2663067315674776,13468536,13621856,54.233151225045276,82.47558580607269,NaN,NaN,35.42038461971545,37.91347785843421
2004-01-21T09:30:00-05:00,23.45,23.96001,23.42,23.91,1623800,435810,75.10177033159115,69.13441287359242,NaN,NaN,272.49246916476113,118.73914401267555,0.002892281732034485,0.2699220837325207,0.2670298020004862,15092336,13891356,57.07247589925574,79.78830372710395,NaN,NaN,38.17800618173064,37.95126761890513
2004-01-22T09:30:00-05:00,24,24.03999,23.78,24,271900,437315,76.43633664781525,69.23938909161089,NaN,NaN,321.5249668050738,167.993891989256,0.024593478053975715,0.2977716495679559,0.27317817151398016,15364236,14160176,59.75453582584995,77.29099798377581,NaN,NaN,40.808478621634364,38.35944061929502
2004-01-23T09:30:00-05:00,24.12,24.12,23.75,23.78999,283600,430400,67.36284837815629,68.91700452328742,NaN,NaN,225.0222421648064,197.95575985017837,0.021013275905226725,0.29944476639551354,0.2784314904902868,15080636,14423476,62.2428531936169,75.01934505674693,NaN,NaN,39.74912342226507,38.55796673400503
2004-01-26T09:30:00-05:00,23.84,23.88,23.5,23.64999,614500,454865,62.07292510277204,68.15902209268448,NaN,NaN,107.74368329503108,205.57498168087358,0.00619484422730715,0.28617504577442077,0.2799802015471136,14466136,14694376,64.66362396634167,72.91989225566756,NaN,NaN,37.01731201985483,38.337873203412144
2004-01-27T09:30:00-05:00,23.85001,23.85001,23.55,23.57001,332400,463220,59.21218712868615,67.39015731909988,NaN,NaN,84.38757815673728,202.23418791728196,-0.011074468444705832,0.26613711599123135,0.2772115844359372,14133736,14827416,65.82254058213415,71.00164092854699,NaN,NaN,33.886339196779026,37.70193977389313
2004-01-28T09:30:00-05:00,23.53,23.99001,23.53,23.66,408300,472680,61.36945577466552,66.58700921184236,NaN,NaN,93.96355295826307,166.52840467598236,-0.018102330663096133,0.25458367110706703,0.27268600177016317,14542036,14717356,63.95388580919602,68.97632147892121,NaN,NaN,32.05730216618745,36.89556297279232
2004-01-29T09:30:00-05:00,23.86,23.95,23.64999,23.85001,706400,498960,65.51661401001206,66.12064982958289,NaN,NaN,106.7179126425697,123.56699384348151,-0.011918336388193285,0.2577880812849216,0.2697064176731149,15248436,14694196,63.545067807595196,66.91674293319875,NaN,NaN,31.873763287444312,36.178163017742605
2004-01-30T09:30:00-05:00,23.94,23.99001,23.66,23.81,205100,481070,63.959565786914084,65.86795729177868,NaN,NaN,93.60664146331517,97.28387370318327,-0.012429756349824461,0.25416922223583427,0.26659897858565873,15043336,14686736,63.40447343767953,64.92510555758551,NaN,NaN,31.235356391435186,35.472047785412975
2004-02-02T09:30:00-05:00,23.99001,23.99001,23.66,23.67,226500,482275,58.702411432027596,65.28033655160667,NaN,NaN,70.82302769025418,89.8997425822279,-0.023463721039843122,0.23726932728585481,0.26073304832569794,14816836,14756876,64.20634307790775,63.381752515396556,NaN,NaN,29.01978141283071,34.55029544647265
2004-02-03T09:30:00-05:00,23.7,23.88,23.60001,23.88,240300,473820,63.54303858703717,65.4723485900743,NaN,NaN,67.25161491393217,86.47254993366687,-0.01812493334557863,0.23807688164372465,0.2562018149893033,15057136,14941556,66.30017675687458,62.56337610143154,NaN,NaN,28.676587578398156,33.71119432246201
2004-02-04T09:30:00-05:00,23.99001,23.99001,23.41,23.49001,755700,502220,51.47600247557824,64.24538742553825,NaN,NaN,17.00573688691787,71.08098671939783,-0.04105253944719872,0.20488614068030486,0.24593868012750358,14301436,14893436,65.2294703575965,62.22035521088565,NaN,NaN,23.954025484768746,32.317313059934406
2004-02-05T09:30:00-05:00,23.53999,23.61,23.31,23.35001,652700,512280,47.95530628192155,63.05018592340263,NaN,NaN,-50.103785136880916,39.716647163507695,-0.06444772575186036,0.16537902293767814,0.2298267486895385,13648736,14573496,58.46855250029597,61.874680934355084,NaN,NaN,18.948039762958228,30.407416874652096
2004-02-06T09:30:00-05:00,23.55,23.60001,23.35001,23.55,408300,519115,52.91000560619641,62.34826083399857,NaN,NaN,-28.634604699325852,15.268397930979486,-0.06506531101965901,0.14849510991496473,0.21356042093462374,14057036,14376236,54.703815862547835,61.68578330728128,NaN,NaN,16.567866309658474,28.43033822251015
2004-02-09T09:30:00-05:00,23.72,23.72,23.52,23.69,1622000,568120,56.063355566342835,61.54870165069404,NaN,NaN,14.2717757327165,3.9581475394719474,-0.05505408704001441,0.14474281213460571,0.19979689917462012,15679036,14548676,57.29261810226407,61.90431665565405,NaN,NaN,15.73761286688929,26.61709174313574
2004-02-10T09:30:00-05:00,23.49001,23.89,23.49001,23.89,328400,556805,60.16702971604992,60.48193446386967,NaN,NaN,50.093958647756125,0.5266162862367473,-0.03495119701237992,0.15610790290914522,0.19105909992152514,16007436,14738736,60.005757616949616,62.113836778346474,NaN,NaN,16.463722899603177,25.166610479773947
2004-02-11T09:30:00-05:00,23.81,24,23.67,23.87,195800,520820,59.56786982087473,59.27704397623107,NaN,NaN,81.01269174278116,13.328007257409405,-0.023537098119621735,0.161637727271998,0.18517482539161972,15811636,15040776,63.92770181653638,62.4119200633955,NaN,NaN,16.835026909653738,23.97638425547106
2004-02-12T09:30:00-05:00,23.84,24.00999,23.8,23.8,254500,519780,57.41287520992801,58.5663316070719,NaN,NaN,84.8051083879149,40.309785962368565,-0.02130454848841326,0.15854413978110315,0.17984868826951642,15557136,15422456,68.17482072365907,62.83563202982709,NaN,NaN,16.475203001858695,22.904786933526438
2004-02-13T09:30:00-05:00,23.89999,23.92999,23.66,23.77,257800,519870,56.46998806932,58.16612181896818,NaN,NaN,41.4745726287677,54.33162142798729,-0.022342586070775383,0.15192045568104717,0.17426304175182256,15299336,15670916,70.60137178546704,63.259756874050325,NaN,NaN,15.90845731490536,21.905311273723427
2004-02-17T09:30:00-05:00,23.89999,24.00999,23.8,23.95,469900,510740,60.6461173620528,58.2685454070658,NaN,NaN,106.40369303887223,72.75800488921843,-0.01192351603665523,0.15935864670600353,0.17128216274265876,15769236,15688956,70.77560415909424,63.61354712954748,NaN,NaN,16.672383643144112,21.15775018364067
2004-02-18T09:30:00-05:00,23.92999,24.09,23.92999,24.03,288400,507315,62.373852130404785,58.34028800390432,NaN,NaN,156.8144853072106,94.10211022110931,-0.0012241280543084376,0.1697520026747732,0.17097613072908163,16057636,15698996,70.87904434043219,64.10820131035005,NaN,NaN,17.822056749616234,20.681222550208606
2004-02-19T09:30:00-05:00,24.10001,24.14,23.8,23.87,579200,455085,56.985357629166046,57.7309125481296,NaN,NaN,96.06600037422271,97.11277194739763,-0.0062233710913924545,0.16319691686484106,0.1694202879562335,15478436,15632356,69.13001795911005,64.50712632117255,NaN,NaN,17.209873932600818,20.185315604836063
2004-02-20T09:30:00-05:00,23.89999,23.95,23.56,23.64,346500,458815,50.26321560863178,56.752601821109444,NaN,NaN,-25.831459591159568,74.98545835158274,-0.025253195483234847,0.13785379360218997,0.16310698908542481,15131936,15547316,66.86258418630081,64.75413423178836,NaN,NaN,14.547915306454176,19.37997270506722
2004-02-23T09:30:00-05:00,23.55,23.83,23.55,23.73,321100,460690,52.61854760282201,56.31804011902333,NaN,NaN,-29.112249660887954,60.8680938936516,-0.03160033204844176,0.12360657402487263,0.1552069060733144,15453036,15578056,67.2803585365669,64.97370676454972,NaN,NaN,13.074117437153799,18.479136238222445
2004-02-24T09:30:00-05:00,23.86,23.86,23.52,23.60001,226800,441305,49.008615919903704,55.27986707137093,NaN,NaN,-54.96669865959863,28.594015553957426,-0.04363270251593049,0.10066602792840129,0.14429873044433178,15226236,15469456,64.20089637416568,64.8237581657848,NaN,NaN,10.720191002865588,17.37071549031432
2004-02-25T09:30:00-05:00,23.64999,23.91,23.62,23.84,453100,447340,55.129187057182946,55.54080882719984,NaN,NaN,21.563173673227467,1.5437532271608034,-0.03488700369535,0.10068997582514427,0.13557697952049427,15679336,15393796,62.069396587325265,64.59803861076541,NaN,NaN,10.589725364438863,16.402002615189257
2004-02-26T09:30:00-05:00,23.81,24.02,23.81,24,298500,441850,58.68934111645781,56.307525601095286,NaN,NaN,106.6111157128013,3.65277629487652,-0.01860173795729797,0.11232480707387182,0.1309265450311698,15977836,15493676,63.77902308877767,64.97735793851412,NaN,NaN,11.625463086030932,15.719639825309496
2004-02-27T09:30:00-05:00,23.94,24.28,23.94,24.25999,501700,431615,63.72578725988769,57.08008143350181,NaN,NaN,200.31175250075037,48.881418713258505,0.007979007047506537,0.14090030384055297,0.13292129679304643,16479536,15763196,67.97384423761672,65.92521710816189,NaN,NaN,14.222899416511872,15.505819766909836
2004-03-01T09:30:00-05:00,24.46001,24.5,24.25999,24.38,360000,439360,65.79856112889682,57.775453259398525,NaN,NaN,240.20175391468948,102.74421942837398,0.030667970072136258,0.17125625938321676,0.1405882893110805,16839536,16040496,71.61608865348258,66.94832214753464,NaN,NaN,17.020001979810253,15.722131511609895
2004-03-02T09:30:00-05:00,24.5,24.5,24.25999,24.27,479800,452025,62.28538429457153,57.9267643007215,NaN,NaN,181.07673140893982,149.9529054420817,0.03497964725246633,0.1843128483766634,0.14933320112419707,16359736,16267196,74.19941980420174,67.96215516090979,NaN,NaN,18.20568479409663,16.076924837679428
2004-03-03T09:30:00-05:00,24.42999,24.42999,24.11,24.25999,239400,451980,61.9611721236943,58.097714465208604,NaN,NaN,130.43423007196608,171.72711672182942,0.033848174963659744,0.19164341982877175,0.157795244865112,16120336,16355396,75.1471522454356,68.76354447725974,NaN,NaN,19.051673216736397,16.501888891830422
2004-03-04T09:30:00-05:00,24.45,24.45,24.28999,24.42999,248200,426605,65.26772814232665,58.65877538895135,NaN,NaN,145.51575109369531,179.5080437980082,0.04077502651227388,0.20876402800545435,0.16798900149318047,16368536,16433536,75.98866759059433,69.32167639632654,NaN,NaN,20.792614282623408,17.114849661943705
2004-03-05T09:30:00-05:00,24.39999,24.62,24.37,24.62,598100,423875,68.55758412203323,59.52217510700229,NaN,NaN,161.66009393921811,171.77771208570175,0.05357361924187862,0.23495602554552875,0.18138240630365013,16966636,16530956,77.03279484449287,69.78106375768553,NaN,NaN,23.334247679763703,18.003335093060848
2004-03-08T09:30:00-05:00,24.72,24.75,24.5,24.55,546500,430785,66.07454180990248,59.90991971042013,NaN,NaN,151.20399308104962,153.97815991897377,0.05266624632532835,0.24721521421031056,0.19454896788498222,16420136,16447076,74.04713444333746,70.01474449227433,NaN,NaN,24.6787287486525,18.95696275814537
2004-03-09T09:30:00-05:00,24.47,24.53,24.36,24.41,237400,361555,61.293140787566585,59.832726043074544,NaN,NaN,94.39422096296633,136.6416578297791,0.038628532162196805,0.24283463308772824,0.20420610092553143,16182736,16411676,72.76533867968242,70.14947980222078,NaN,NaN,24.390387825435738,19.73316633918685
2004-03-10T09:30:00-05:00,24.37,24.52,24.13,24.13,288900,359580,53.02815343873042,59.550068600900566,NaN,NaN,45.477819874908214,119.6503757903675,0.008074339482326331,0.21429902527843936,0.20622468579611303,15893836,16366376,71.06992357775181,70.28804448926662,NaN,NaN,21.472109828226735,19.98158683762112
2004-03-11T09:30:00-05:00,24.25,24.28999,23.78,23.78,1399100,419745,44.88129146007847,59.16564544743248,NaN,NaN,-33.86572923654886,83.77407972431868,-0.0357160002059779,0.16157968553864066,0.19729568574461856,14494736,15991616,58.853047699045035,69.71593474017692,NaN,NaN,16.019589773475847,19.41558725702894
2004-03-12T09:30:00-05:00,23.87,24.07001,23.8,24.00999,819500,447995,50.2861782029656,58.999047633157026,NaN,NaN,-32.97569732564834,44.846921471345375,-0.04841192761913765,0.1367807762206965,0.18519270383983416,15314236,15661136,50.59367318561184,68.52402864368013,NaN,NaN,13.324255904106208,18.545397063754262
2004-03-15T09:30:00-05:00,24.03,24.12,23.88,23.94,1715300,520870,48.72047024234736,58.97846579904586,NaN,NaN,-31.3638855789025,8.333345739354959,-0.05998662053933895,0.11020942816566048,0.17019604870499944,13598936,15096896,40.21637120999585,66.81084827481085,NaN,NaN,10.688992939114083,17.423053617377093
2004-03-16T09:30:00-05:00,24,24.2,23.82001,24.17,578000,526275,53.8100945796479,58.88424490779335,NaN,NaN,-11.295159250466682,-12.804530303331637,-0.050970398261209166,0.10648305087848797,0.15745344913969714,14176936,14695736,34.75780023388796,64.86001996385104,NaN,NaN,10.135842150550314,16.38202340783041
2004-03-17T09:30:00-05:00,24.27,24.59,24.25,24.55,1074300,565570,60.74278252724373,59.030919294278064,NaN,NaN,87.46010375621708,-4.408073527069865,-0.0198320130989649,0.13266343276599102,0.15249544586495592,15251236,14567216,33.20294327463043,62.676014262840525,NaN,NaN,12.100014480039126,15.770307846717369
2004-03-18T09:30:00-05:00,24.35001,24.60001,24.27,24.44,311100,552165,58.027695977965,58.62391277414072,NaN,NaN,73.04024281144153,16.973120882528214,-0.0076856645236164645,0.14288836521043535,0.15057402973405182,14940136,14656296,35.36130828315592,60.34654740895047,NaN,NaN,12.738675542519454,15.337217517546238
2004-03-19T09:30:00-05:00,24.3,24.39999,24.10001,24.10001,289400,549310,50.512414280336145,57.53204514210068,NaN,NaN,6.740820181789223,24.916424384015723,-0.022739795524580192,0.12214928532832658,0.14488908085290678,14650736,14523596,33.61860804451156,57.63244165116682,NaN,NaN,10.6639823162814,14.669612488794119
2004-03-22T09:30:00-05:00,24.25,24.25,23.78,23.82001,472400,556875,45.30811243000995,56.31938286606056,NaN,NaN,-70.98446286447552,16.992308926901124,-0.050173247494064654,0.08217252148532594,0.1323457689793906,14178336,14639476,36.558879696531854,54.94383164347612,NaN,NaN,7.0983090956144075,13.587997718339874
2004-03-23T09:30:00-05:00,24.07001,24.07001,23.78,23.81,464100,568740,45.12910058897578,55.117092042152095,NaN,NaN,-98.72175576323319,-0.493010375652176,-0.06658322510127399,0.04911673760279811,0.1156999627040721,13714236,14546936,35.21734054763748,52.09170223649054,NaN,NaN,4.316969280253066,12.263565084327473
2004-03-24T09:30:00-05:00,23.99001,23.99001,23.72,23.86,410800,566625,46.271018816374664,53.76018423315553,NaN,NaN,-111.00380985349278,-40.18579309759415,-0.0712422097519165,0.02664720051417646,0.09788941026609296,14125036,14321696,32.12716220264217,48.95873756592253,NaN,NaN,2.4503573375327776,10.861678263356803
2004-03-25T09:30:00-05:00,23.91,23.99001,23.8,23.89999,640300,583715,47.21715104648791,52.23586758490229,NaN,NaN,-96.35549723506988,-74.06494110689644,-0.06876810740592523,0.011929276008686429,0.08069738341461166,14765336,14286736,31.662768352198,45.71802138790146,NaN,NaN,1.2159348588444887,9.483714919855043
2004-03-26T09:30:00-05:00,24,24.05,23.89999,23.98,506800,583970,49.14663202860718,51.026731171952626,NaN,NaN,-64.99879761468294,-88.41286466619087,-0.05924210152142477,0.006644756512830696,0.06588685803425547,15272136,14411016,35.24615881871071,42.94652312899956,NaN,NaN,0.7365719557970156,8.234123067846753
2004-03-29T09:30:00-05:00,24.06,24.14,23.87,24.13,6678898,899914.9,52.641848582047984,50.40878172870129,NaN,NaN,-39.16485548074079,-82.04894318944392,-0.041193845063089485,0.01439455170539361,0.055588396768483095,21951034,15965555.6,62.0513283896872,42.18123667971418,NaN,NaN,1.3320590505661658,7.248113922520955
2004-03-30T09:30:00-05:00,24.05,24.25,24,24.22,405500,896199.9,54.65563596867424,50.52503048084014,NaN,NaN,-2.808030330975708,-62.86619810299241,-0.022485297198888032,0.027481775269873054,0.04996707246876109,22356534,17694015.2,74.62769276353356,42.43536305012717,NaN,NaN,2.409398396127693,6.556868847321917
2004-03-31T09:30:00-05:00,24.25,24.37,24.14999,24.32001,687400,918599.9,56.85133032796729,51.38003325711791,NaN,NaN,36.06023988945755,-33.453388154402354,-0.0036535611114691946,0.045400121079424594,0.04905368219089379,23043934,19477794.8,81.4573278143393,44.049954486933906,NaN,NaN,3.9503689731774836,6.184511722444141
2004-04-01T09:30:00-05:00,24.37,24.45,24.31,24.39,394000,925889.9,58.37056997451275,51.95748981222842,NaN,NaN,69.01999660874371,-0.37828938563963843,0.012360717181045547,0.06450457866720072,0.05214386148615517,23437934,21212314.4,85.53475366265194,46.54574594957962,NaN,NaN,5.677211034210937,6.112040195553683
2004-04-02T09:30:00-05:00,24.39999,24.46001,24.23,24.27,1296300,960799.9,54.80746570466337,52.392275202393854,NaN,NaN,55.462978602528075,23.71406585780256,0.013616682057019033,0.06916471405742897,0.05554803200040993,22141634,22586214,87.81950596393742,49.94596986057545,NaN,NaN,6.199963459160109,6.124600661783172
2004-04-05T09:30:00-04:00,24.46001,24.46001,24.25,24.34,637900,965369.9,56.47648011250541,52.58273131188367,NaN,NaN,74.44016542869032,46.435070039688775,0.017650903197940236,0.07761166099783523,0.059960757799894994,22779534,22751914,88.0643621702741,53.753581427460176,NaN,NaN,7.102018014153762,6.264231712121828
2004-04-06T09:30:00-04:00,24.3,24.41,24.25999,24.35001,687700,987884.9,56.72261609653041,52.29557656683272,NaN,NaN,74.39385269452424,61.87544664478878,0.01934634937229951,0.08414369451526937,0.06479734514296986,23467234,22974054,88.4009945656586,57.69629937681933,NaN,NaN,7.919015241508333,6.500629359177043
2004-04-07T09:30:00-04:00,24.39999,24.39999,24.10001,24.10001,1006600,1023769.9,49.2339211515628,51.66744979351828,NaN,NaN,24.384901944446916,59.54037905578665,0.0028496936043558713,0.0683594621484147,0.06550976854405884,22460634,22857394,87.01304234276795,61.38570895250591,NaN,NaN,6.569973340528515,6.510535642227253
2004-04-08T09:30:00-04:00,24.23,24.32001,24.03999,24.08,332300,970429.9,48.67994416710639,51.53655907114472,NaN,NaN,0.790610876107912,45.89450190925949,-0.009513707793389656,0.05361763380232176,0.06313134159571142,22128334,22595474,83.83066516598873,64.97228446118285,NaN,NaN,5.301090342384059,6.337757742249654
2004-04-12T09:30:00-04:00,24.10001,24.17999,23.64,23.7,1040900,981499.9,39.57342976202748,51.12693888057454,NaN,NaN,-113.6926200739005,12.063382173973778,-0.04159039262875223,0.011143350809771135,0.05273374343852336,21087434,22384634,81.25444224536153,68.16482464324211,NaN,NaN,1.2176629143945792,5.606315623984643
2004-04-13T09:30:00-04:00,23.67,23.7,23.11,23.27,2677600,1029614.9,32.226790635342795,50.2053453124579,NaN,NaN,-238.2241400492488,-50.46947892161405,-0.08743755906297984,-0.05656320539020143,0.030874353672778403,18409834,21510694,71.45251765968307,70.7530515798168,NaN,NaN,-5.189954776522051,4.063991281055115
2004-04-14T09:30:00-04:00,23,23.38,22.95,23.3,2270000,1114214.9,33.159110037437245,49.26878039967666,NaN,NaN,-222.5111538465139,-109.85048022982168,-0.10995699912145329,-0.1065718952290382,0.0033851038924150798,20679834,20953214,65.98439974684419,73.17142569011695,NaN,NaN,-9.868270623377695,2.073668151850428
2004-04-15T09:30:00-04:00,23.25,23.60001,23.25,23.42999,1630100,1142004.9,37.19094112128228,48.552622547876254,NaN,NaN,-144.00583781239072,-143.5286281811892,-0.11004282351314795,-0.13416842549901986,-0.024125601985871912,22309934,20923074,65.69169521650443,75.60206332328168,NaN,NaN,-12.464096561893582,-0.0031553786844304987
2004-04-16T09:30:00-04:00,23.42,23.53999,23.39999,23.50999,420700,1147484.9,39.6054167198611,47.87110716868011,NaN,NaN,-115.65051299877884,-166.81685295616654,-0.09900262831991752,-0.14787888738576882,-0.048876259065851295,22730634,21043534,66.33446868340172,77.82265688504533,NaN,NaN,-13.844443378920475,-1.9804822358610081
2004-04-19T09:30:00-04:00,23.39999,23.53,23.35001,23.36,263800,1146204.9,36.75277230294715,46.736173148744335,NaN,NaN,-115.41759677402726,-167.1618482961919,-0.09601938235807245,-0.16890048701344185,-0.0728811046553694,22466834,21319414,67.82139005276599,78.2348041466938,NaN,NaN,-15.890656751823732,-3.9676500238556827
2004-04-20T09:30:00-04:00,23.50999,23.52,23.10001,23.10001,1246000,1184884.9,32.396896542945655,45.14626318976372,NaN,NaN,-131.4730793942497,-145.81163616519206,-0.10504355819313962,-0.20418555239679392,-0.0991419942036543,21220834,21881614,70.66484424240821,77.951743538042,NaN,NaN,-19.097720058720846,-6.129088600264991
2004-04-21T09:30:00-04:00,23.05,23.28,23.05,23.28,525500,1187954.9,37.88541796600625,43.791555163909365,NaN,NaN,-118.4774049888261,-125.00488639365453,-0.09280277993532995,-0.21514546912281673,-0.12234268918748678,21746334,22094914,71.6870737464599,77.25386824747918,NaN,NaN,-20.039140343601883,-8.116238849313119
2004-04-22T09:30:00-04:00,23.33,23.55,22.72,23.53999,483800,1191604.9,44.85045762476602,42.82583285321317,NaN,NaN,-92.61461717535732,-114.72664226624784,-0.06255829283296957,-0.20054055522869874,-0.13798226239572917,22230134,22078954,71.48634488553947,76.25041047768543,NaN,NaN,-18.53493792015854,-9.604624430862465
2004-04-23T09:30:00-04:00,23.55,23.60001,23.36,23.55,391900,1179184.9,45.105680471922796,42.1328481937317,NaN,NaN,-48.77344401840572,-101.35122847017323,-0.03842545240473075,-0.1860140779016426,-0.14758862549691185,22622034,22057234,71.19418197068538,75.06288733531028,NaN,NaN,-17.278065030192234,-10.700830230766718
2004-04-26T09:30:00-04:00,23.5,23.8,23.49001,23.62,566800,1182184.9,46.95441900180873,41.45270097153907,NaN,NaN,-24.66219452417532,-83.20014802020283,-0.015472356051313363,-0.16692907056105355,-0.1514567145097402,23188834,22201634,72.01311541798879,73.91636971014704,NaN,NaN,-15.689635933527265,-11.41351675973251
2004-04-27T09:30:00-04:00,23.55,23.8,23.50999,23.66,660800,881280,48.03146729366834,40.8319046284775,NaN,NaN,-18.693190090327484,-60.64417015941839,0.003658795047055019,-0.1468832207009214,-0.15054201574797643,23849634,22727394,74.82002674266361,72.94630057993312,NaN,NaN,-14.074021030051126,-11.793588798349454
2004-04-28T09:30:00-04:00,23.49001,23.71001,23.49001,23.67999,770000,899505,48.59321831118025,40.78614013987875,NaN,NaN,-20.12131480784964,-40.972952123223095,0.018106207762636106,-0.12790925604468129,-0.1460154638073174,24619634,23302054,77.47875877750567,72.26528032527152,NaN,NaN,-12.585189798188859,-11.906674655469368
2004-04-29T09:30:00-04:00,23.63,23.75999,23.28999,23.31,672000,898735,39.97930448614203,40.164665876952725,NaN,NaN,-45.53511477687046,-31.55705164352573,0.003931706505594823,-0.14110083067532386,-0.14503253718091869,23947634,23645554,78.91211082342393,71.91395501508833,NaN,NaN,-13.781620293883584,-12.174524032385685
2004-04-30T09:30:00-04:00,23.17999,23.60001,23.02,23.28,965500,927310,39.36990072393171,40.15012808851731,NaN,NaN,-70.28434086668119,-35.85923101318082,-0.005750998785781475,-0.15222128566314552,-0.14647028687736405,22982134,23717574,79.21086095915142,71.76798492321618,NaN,NaN,-14.928430759582104,-12.56793927912803
2004-05-03T09:30:00-04:00,23.49001,23.49001,23.21001,23.44,554400,890215,44.250718383341635,41.00898007051723,NaN,NaN,-49.65189772439401,-40.85717165322456,0.0000277138397540011,-0.14643564457767155,-0.14646335841742555,23536534,23787114,79.51266614507796,72.3437098150301,NaN,NaN,-14.466898276681347,-12.839219135921361
2004-05-04T09:30:00-04:00,23.42999,23.64,23.31,23.53,983400,907490,46.842941930965765,41.98639663434069,NaN,NaN,-17.330343052629924,-40.58460224568505,0.010727114380785913,-0.13305446544144317,-0.14378157982222908,24519934,23921174,80.11208267090154,73.35283002389133,NaN,NaN,-13.315895504398076,-12.907315759989464
2004-05-05T09:30:00-04:00,23.50999,23.57001,23.33,23.37,534000,899805,43.013786400088655,42.40231415425544,NaN,NaN,-29.604326271226917,-42.4812045383605,0.007970961303440327,-0.13381787819292867,-0.141788839496369,23985934,23794434,77.79472749339956,74.21733232938384,NaN,NaN,-13.4490127904506,-12.98470105005534
2004-05-06T09:30:00-04:00,23.28,23.46001,23.14,23.45,2002800,949615,45.41635642299988,42.817381275908204,NaN,NaN,-49.72481300289542,-43.3191441835655,0.012223681877197828,-0.12650923714987172,-0.13873291902706955,25988734,24202654,79.81956578792804,75.18055355113573,NaN,NaN,-12.8576672925692,-12.966553370414463
2004-05-07T09:30:00-04:00,23.38,23.38,22.62,22.74001,2154300,1040715,32.371998812701435,42.504468883747805,NaN,NaN,-227.05686770964294,-74.67364955215784,-0.02979668245165293,-0.1759787720916357,-0.14618208963998278,23834434,24373114,80.61448759745196,76.09434623289901,NaN,NaN,-16.99618814243835,-13.54221548070359
2004-05-10T09:30:00-04:00,22.59,22.64999,22.25,22.42,1876600,1082500,28.411094323483255,42.21976872521477,NaN,NaN,-333.4897235552798,-131.441214718335,-0.07366181780318704,-0.23825936189396657,-0.16459754409077954,21957834,24057374,74.74164498983198,76.38554628628641,NaN,NaN,-21.93006812438843,-14.740480144087138
2004-05-11T09:30:00-04:00,22.45,22.60001,22.24001,22.36,1435400,1020390,27.726101460531552,41.49410326053801,NaN,NaN,-251.58081222774538,-178.29130855335808,-0.09962261606150563,-0.2891258141676616,-0.18950319810615596,20522434,23257874,62.35437171914964,75.71892471290711,NaN,NaN,-25.921169001804174,-16.337721409475286
2004-05-12T09:30:00-04:00,22.2,22.39999,22.07001,22.34,2095900,1011685,27.488194185106707,40.25394158627664,NaN,NaN,-216.60256793663024,-215.69095688643876,-0.11022064810526025,-0.32727900823773126,-0.217058360132471,18426534,22145994,49.954622961808326,74.18094457549775,NaN,NaN,-29.08014357796812,-18.15806743354569
2004-05-13T09:30:00-04:00,22.14,22.48,22.14,22.42999,1013200,980840,30.38276785485337,39.20230497077167,NaN,NaN,-156.56028026077604,-237.05805033801488,-0.10336350956413737,-0.3462627470876427,-0.24289923752350534,19439734,20836194,39.89103154704833,71.94500525952368,NaN,NaN,-30.75114635717767,-19.95707870835026
2004-05-14T09:30:00-04:00,22.23,22.72,22.23,22.55,2174100,1068510,34.157532278471336,38.288241633390435,NaN,NaN,-107.5693728738265,-213.16055137085158,-0.08377387818207815,-0.34761658525110306,-0.2638427070690249,21613834,20392074,37.157618808513625,69.45532693027545,NaN,NaN,-30.988789714994784,-21.533037423585192
2004-05-17T09:30:00-04:00,22.38,22.48,22.25999,22.31,912800,1100960,30.58585496769136,37.04212646724921,NaN,NaN,-112.00533575312704,-168.86367381042103,-0.08001474734098163,-0.36386114124525193,-0.2838463939042703,20701034,20140714,35.667953648742156,66.65875028070964,NaN,NaN,-32.313534815571934,-23.073108479583297
2004-05-18T09:30:00-04:00,22.67,22.7,22.5,22.5,570600,1067190,36.267495526995475,36.1617176969503,NaN,NaN,-69.99666619205448,-132.54684460328286,-0.0587509621654585,-0.3572850966110934,-0.2985341344456349,21271634,20290554,37.282120527576865,63.787561834286144,NaN,NaN,-31.634179955112696,-24.296118690373213
2004-05-19T09:30:00-04:00,22.52,22.71001,22.34,22.34,660400,1073935,33.761401785924434,35.7175817897919,NaN,NaN,-75.33274805144922,-104.29288062624667,-0.04983255853957491,-0.36082483262010356,-0.31099227408052865,20611234,20727494,41.86303462367575,61.14119924858985,NaN,NaN,-31.84566869321931,-25.37462583363694
2004-05-20T09:30:00-04:00,22.39,22.67999,22.39,22.57001,626400,1081065,40.162634668027785,35.774205642941624,NaN,NaN,-57.798526373763295,-84.5405298488441,-0.024116412807720866,-0.34113779009017975,-0.3170213772824589,21237634,21087074,45.39756103112709,58.72596353944526,NaN,NaN,-29.96652596780505,-26.03061156708953
2004-05-21T09:30:00-04:00,22.55,22.73,22.47,22.53999,400700,1081505,39.62440956241496,35.44375501287543,NaN,NaN,-48.25055647215801,-72.6767665685104,-0.005759391542840719,-0.32422061671100977,-0.31846122516816905,20836934,20931694,44.14851276066104,56.199952583415474,NaN,NaN,-28.63021627341252,-26.401983667992813
2004-05-24T09:30:00-04:00,22.75,22.89999,22.67999,22.85001,637300,1085030,47.45566459762895,35.48752091763709,NaN,NaN,-12.249490295917175,-52.72559747706843,0.0287364529107218,-0.28254065902976677,-0.31127711194048857,21474234,21086334,45.74833303253166,53.74539903781763,NaN,NaN,-24.904845521632748,-26.188106789941376
2004-05-25T09:30:00-04:00,22.87,23.28999,22.75,23.25999,849700,1094475,55.648527101261095,36.39000239629226,NaN,NaN,36.75249986092677,-31.375764266472185,0.07785318739629554,-0.21396062769511914,-0.2918138150914147,22323934,21296794,47.93418879582527,51.612503416562326,NaN,NaN,-18.68855423970701,-25.116742139907895
2004-05-26T09:30:00-04:00,23.3,23.48,23.14,23.27,747000,1093325,55.82961815943119,37.133806806037356,NaN,NaN,73.34523690456275,-1.640167275269792,0.1078566379576234,-0.15699301764438545,-0.26484965560200885,23070934,21788734,52.72858850455592,49.677433610607174,NaN,NaN,-13.83697171690456,-23.505346365193134
2004-05-27T09:30:00-04:00,23.39999,23.61,23.25,23.50999,733800,1096415,60.04207652683714,39.11024092847562,NaN,NaN,99.50619051300099,29.820776102083062,0.1387383812140277,-0.09142667908447422,-0.23016506029850192,23804734,22302154,57.16216718039303,48.00226786653153,NaN,NaN,-8.305175914572587,-21.333893443675912
2004-05-28T09:30:00-04:00,23.39999,23.63,23.32001,23.56,500600,1073170,60.87933412705434,41.42940091444499,NaN,NaN,102.66664396420488,60.004216189355645,0.15611145669843599,-0.03502573942545695,-0.19113719612389293,24305334,22995834,62.306128239899174,47.114016670107766,NaN,NaN,-3.625801855123069,-18.804166073882648
2004-06-01T09:30:00-04:00,23.59,23.66,23.41,23.53,370900,1063995,60.06624943157612,43.73941148380532,NaN,NaN,104.12748776459348,83.27961180145778,0.15864497473523004,0.0071690222951446,-0.15147595244008544,23934434,23487874,65.47316343477766,47.336787506938336,NaN,NaN,-0.07965827253919135,-16.12923638797644
2004-06-02T09:30:00-04:00,23.47,23.66,23.25,23.57001,236400,1026645,60.81784836289548,46.120101067933085,NaN,NaN,97.87403917962816,95.50391966519805,0.15585082510780945,0.04333757894467638,-0.11251324616313307,24170834,23857254,67.66927895847031,48.60212007812847,NaN,NaN,3.0595011508630483,-13.387988168142229
2004-06-03T09:30:00-04:00,23.64999,23.64999,23.32001,23.32001,708500,1035370,53.98117924539948,47.80570188154353,NaN,NaN,87.8443783836357,98.40374796101264,0.1310008943035518,0.05123787171630667,-0.07976302258724513,23462334,23935534,68.13189087099519,50.61932431555325,NaN,NaN,3.887700095443073,-10.920032701915758
2004-06-04T09:30:00-04:00,23.32001,23.5,23.32001,23.39999,440400,957250,55.69700305544934,49.344235508470526,NaN,NaN,83.14910719997926,95.1323312984083,0.11438947675414213,0.06322382335543253,-0.0511656533987096,23902734,23955134,68.25437371406531,52.84052109452123,NaN,NaN,5.0714635382989774,-8.63553323902794
2004-06-07T09:30:00-04:00,23.46001,23.60001,23.35001,23.60001,496200,874345,59.73986691687467,51.42666493341219,NaN,NaN,88.68538764679018,92.33608003492536,0.11121255327188999,0.08785003819115289,-0.023362515080737098,24398934,23973854,68.37937769160179,55.177051383296906,NaN,NaN,7.308923024276598,-6.357753772841576
2004-06-08T09:30:00-04:00,23.46001,23.57001,23.34,23.38,1074500,834240,53.91217546631692,52.686999214792294,NaN,NaN,68.5723914986399,85.22506078173464,0.08956384074186254,0.08859228584659107,-0.0009715548952714641,23324434,23851854,66.5404513047997,57.266932153098544,NaN,NaN,7.494325956318194,-4.3788852401044664
2004-06-09T09:30:00-04:00,23.17999,23.46001,23.17999,23.23,830200,803980,50.308797975588895,53.868956085482615,NaN,NaN,43.60437243336902,74.37112743248282,0.061735970512255725,0.0761984082450482,0.01446243773279247,22494234,23516534,61.63424725148398,58.67916162651342,NaN,NaN,6.547620529096758,-2.817955844504292
2004-06-10T09:30:00-04:00,23.2,23.39,23.2,23.39,429000,720635,53.851949084128314,54.84676425806122,NaN,NaN,44.17179574041835,65.63661090383934,0.051136673906318965,0.07838328011569118,0.027246606209372214,22923234,23408714,60.09978111536672,59.729320203959105,NaN,NaN,6.811983940929439,-1.4422501608709017
2004-06-14T09:30:00-04:00,23.17999,23.36,23.17999,23.23,638500,701900,50.011641870471195,55.58870942292238,NaN,NaN,28.49332554228073,54.705454572299644,0.03135334287198231,0.0664382847993501,0.03508494192736779,22284734,23085114,55.62378578355288,60.548982562737095,NaN,NaN,5.858956399910483,-0.39922065218784697
2004-06-15T09:30:00-04:00,23.27,23.55,23.2,23.39,659500,626170,53.57684193847836,56.025936375840196,NaN,NaN,45.77879311172713,46.12413566528703,0.027200903696579626,0.06908607154809232,0.041885167851512695,22944234,22794174,51.88252932346322,60.987139440660776,NaN,NaN,6.1290683260117,0.5333920589835167
2004-06-16T09:30:00-04:00,23.41,23.5,23.28999,23.46001,713800,616220,55.086291911427736,55.98577671942353,NaN,NaN,49.116075588697946,42.232872483298635,0.027258334512161884,0.07595808599171505,0.04869975147955317,23658034,22860894,52.668745967644846,61.325322095790746,NaN,NaN,6.795506509472755,1.4279798376248363
2004-06-17T09:30:00-04:00,23.42,23.67999,23.41,23.62,1193200,647350,58.41402421959816,56.170377152292595,NaN,NaN,81.34777168793642,49.78155233421212,0.03563160579327313,0.09323925872114458,0.05760765292787145,24851234,23332294,57.90250712036677,61.69488771120581,NaN,NaN,8.358702461426374,2.4180830695964843
2004-06-18T09:30:00-04:00,23.38,23.55,23.3,23.53999,1409500,684805,56.17256996233338,55.89398382625661,NaN,NaN,53.42667628363611,51.632528442855666,0.03338069310346961,0.09933351930720846,0.06595282620373885,23441734,23435994,58.97715340786154,61.82452958459641,NaN,NaN,9.010878286121029,3.3599109576714192
2004-06-21T09:30:00-04:00,23.67,23.8,23.5,23.7,2402200,773595,59.51807329171619,55.79675090944674,NaN,NaN,121.03936740400226,70.14173681519998,0.039830178605713695,0.11574054946088097,0.07591037085516728,25843934,24147834,65.4896434498088,62.05192352816134,NaN,NaN,10.5591310111075,4.388370965305145
2004-06-22T09:30:00-04:00,23.74001,23.77,23.56,23.61,425800,774850,56.88772015665221,55.56971310409504,NaN,NaN,123.09869824371586,85.60571784159772,0.03534897728780076,0.12009659246491822,0.08474761517711746,25418134,24642614,69.15503211809553,62.31491414839833,NaN,NaN,11.100627608757021,5.347264771512556
2004-06-23T09:30:00-04:00,23.58,23.83,23.58,23.78999,537400,769855,60.63460510269393,55.556624299794926,NaN,NaN,170.36789026795418,109.85608077744897,0.04140110879605238,0.13649900117218294,0.09509789237613056,25955534,25102114,72.11692480448667,62.6326031373995,NaN,NaN,12.681379733411935,6.394995480355324
2004-06-24T09:30:00-04:00,23.82001,23.92,23.78999,23.87,296500,742195,62.206998910305046,56.14418284728818,NaN,NaN,214.55097897991092,136.49672223584386,0.047263214990824115,0.1541769111146607,0.10691369612383658,26252034,25382274,73.77070186276596,63.035375351097414,NaN,NaN,14.459759431161809,7.547104616184821
2004-06-25T09:30:00-04:00,23.91,23.92,23.69,23.73,378100,723750,57.85250833819672,56.298147510341565,NaN,NaN,145.92281393717667,154.99594976655197,0.03855066906325233,0.155102032452902,0.11655136338964966,25873934,25868714,76.38921389742539,63.61643536419456,NaN,NaN,14.72597521844784,8.572657559365252
2004-06-28T09:30:00-04:00,23.75,24.05,23.75,23.84,553600,714740,60.20934008414667,56.33168130800385,NaN,NaN,162.8009713310415,163.34827055195984,0.03702629077927258,0.16283422686374038,0.1258079360844678,26427534,25985434,76.98298304098739,64.2309786034364,NaN,NaN,15.632986406509165,9.581275966100097
2004-06-29T09:30:00-04:00,23.84,23.85001,23.5,23.66,736000,726510,54.808410030779854,56.395698062608346,NaN,NaN,58.63000921242256,150.4545327457012,0.021495714231453827,0.15267757887378508,0.13118186464233125,25691534,26040114,77.27135211899372,64.99747151873596,NaN,NaN,14.817554756073736,10.32931579323919
2004-06-30T09:30:00-04:00,23.62,23.78,23.44,23.75999,755000,745715,57.11000765705463,56.88149875414161,NaN,NaN,49.25856731767651,126.23266815564564,0.015819777054145973,0.1509565859600137,0.13513680890586774,26446534,26138314,77.80905590665905,66.15281499410561,NaN,NaN,14.80056703475765,10.96806597059897
2004-07-01T09:30:00-04:00,23.87,23.87,23.41,23.48,295700,748680,49.50664188171395,56.57111966825487,NaN,NaN,16.223978757199223,86.5672681111033,-0.007667413445288651,0.12555254209925693,0.13321995554454558,26150834,26118074,77.4026043673496,67.38873094067581,NaN,NaN,12.388194831985793,11.17094152222566
2004-07-02T09:30:00-04:00,23.32001,23.8,23.31,23.72,463500,736430,55.0330222053468,56.92978969217456,NaN,NaN,22.863558734988825,61.95541707066574,-0.007885092534251015,0.1233635898767318,0.1312486824109828,26614334,26266154,78.29589166066164,69.00816707475501,NaN,NaN,12.058021322083066,11.297667207919574
2004-07-06T09:30:00-04:00,23.7,23.8,23.61,23.67999,393400,734080,53.97249694296298,56.95805076392346,NaN,NaN,55.480282033514534,40.49127921116034,-0.011358093903642924,0.11705106503142915,0.12840915893507207,26220934,26224834,77.37673035847689,70.82918143439885,NaN,NaN,11.467409844337414,11.321916155979265
2004-07-07T09:30:00-04:00,23.64999,23.75,23.55,23.73,621100,740325,55.136264048030405,56.96162020225222,NaN,NaN,42.77323008847867,37.31992338637156,-0.010918654251311,0.11476084112093332,0.12567949537224432,26842034,26454934,78.86472590358159,72.70032285839433,NaN,NaN,11.326260416157838,11.322536764576205
2004-07-08T09:30:00-04:00,23.55,23.75999,23.55,23.64,869900,730095,52.560655980125986,56.543522470861355,NaN,NaN,27.351787659483644,32.93856745473299,-0.016960233805310934,0.10447920311560566,0.12143943692091659,25972134,26360054,76.62667990329729,74.03776377146077,NaN,NaN,10.457606749547278,11.198975333857787
2004-07-09T09:30:00-04:00,23.61,23.8,23.46001,23.59,937200,735445,51.13161677148074,56.18345438580045,NaN,NaN,4.974770527519772,30.688725808797095,-0.024155918699924478,0.091244538546011,0.11540045724593548,25034934,26136874,71.48763490855191,74.93136959293868,NaN,NaN,9.32932205058193,10.93188200767552
2004-07-12T09:30:00-04:00,23.53,23.64,23.50999,23.64,459800,736985,52.52176968481063,55.68371841387863,NaN,NaN,-14.770875117818633,23.161839038235605,-0.025260942164091887,0.08382427954082061,0.1090852217049125,25494734,25912954,66.65734996703962,75.0147772013123,NaN,NaN,8.758208021924135,10.62135715256818
2004-07-13T09:30:00-04:00,23.7,23.7,23.52,23.59,523600,731240,50.960587060696334,55.26035176416749,NaN,NaN,-25.797018050685445,6.906379021395613,-0.028814721468233967,0.07306681986962005,0.10188154133785401,24971134,25662994,61.64968785421922,74.478681182464,NaN,NaN,7.8518486599126,10.225713082188811
2004-07-14T09:30:00-04:00,23.50999,23.87,23.50999,23.8,421400,719335,56.77237438366608,54.98447814137979,NaN,NaN,59.67685466842431,10.28710393738474,-0.017058771337682382,0.08055807716575103,0.09761684850343341,25392534,25373094,56.36122141439884,73.35327379745772,NaN,NaN,8.674830636067634,10.004158447028644
2004-07-15T09:30:00-04:00,23.85001,23.97,23.75999,23.91,399100,703600,59.481188609460645,54.78977740560519,NaN,NaN,166.5286725795324,38.1224809213945,-0.00266613171909727,0.09428418385456183,0.0969503155736591,25791634,25336994,55.72022528907401,72.063954042194,NaN,NaN,10.166091821806095,10.027291786282566
2004-07-16T09:30:00-04:00,23.97,24.10001,23.95,24.08,449400,666410,63.30794483511752,55.17945144109954,NaN,NaN,230.33121906365105,83.19377062862075,0.01645978432046194,0.11752504597423652,0.10106526165377458,26241034,25578214,59.06994259109934,70.82686323459929,NaN,NaN,12.629641847607303,10.399056080757529
2004-07-19T09:30:00-04:00,24.12,24.24001,24.07001,24.19,767600,634315,65.57360170164242,55.56261298520638,NaN,NaN,241.446717068592,134.4372890659029,0.03368323919201102,0.14316931064378835,0.10948607145177733,27008634,25880994,62.86711250010249,69.81858676739321,NaN,NaN,15.4064340224129,11.114395786708297
2004-07-20T09:30:00-04:00,24.19,24.28999,24.12,24.24001,482600,538335,66.58384827446429,56.40371571689813,NaN,NaN,204.6047879807561,180.5176502721912,0.044906193727515406,0.1656188136111716,0.12071261988365618,27491234,26385014,68.16212530508795,69.1679277092571,NaN,NaN,18.004943392177815,12.0987597303468
2004-07-21T09:30:00-04:00,24.28999,24.3,23.83,23.86,448900,539490,53.6907301667589,56.159481610448424,NaN,NaN,91.18306845775798,186.81889303005792,0.024234602985625325,0.15100587361568785,0.12677127063006252,27042334,26714974,71.07048218008237,68.68660101450162,NaN,NaN,16.328255994856118,12.702973482419559
2004-07-22T09:30:00-04:00,23.74001,23.81,23.56,23.7,310800,528160,49.357132118181894,56.148802341624695,NaN,NaN,-38.090945067257245,145.8949695007,-0.0013589432370739452,0.12507259158372008,0.12643153482079403,26731534,26902954,72.60579662683885,68.34397189017942,NaN,NaN,13.495275733056571,12.816159518224847
2004-07-23T09:30:00-04:00,23.78,23.78,23.53,23.56,267500,526710,45.86848942648608,55.494192857420366,NaN,NaN,-61.103138814330535,87.60809792510368,-0.027416369233820584,0.0921610732785183,0.11957744251233889,26464034,26947554,72.97229596335406,67.96371505465746,NaN,NaN,9.999157718020307,12.413730689624199
2004-07-26T09:30:00-04:00,23.53,23.69,23.44,23.5,761900,545900,44.419425938946894,54.811830642847795,NaN,NaN,-86.54449144220489,22.009856222944304,-0.04723067220083235,0.06053910226129844,0.10776977446213079,25702134,26686254,67.29204555251732,67.24338042566033,NaN,NaN,6.72155178298903,11.600562274390603
2004-07-27T09:30:00-04:00,23.7,23.7,23.38,23.47,823400,559390,43.67644958655671,53.99327246702824,NaN,NaN,-91.8084361393783,-37.272788601082574,-0.0600710299288264,0.03268098705109779,0.09275201697992419,24878734,26163754,57.63151314642192,65.72672237157751,NaN,NaN,3.8470884948548667,10.492923163028355
2004-07-28T09:30:00-04:00,23.67999,23.78,23.45,23.78,508400,548010,52.51504411312572,53.99001447652822,NaN,NaN,-28.349430853102767,-61.17928846325473,-0.046032221392657474,0.03521174023910234,0.08124396163175981,25387134,25832714,52.4899804239862,64.00267240876958,NaN,NaN,4.005949308900511,9.566212612438662
2004-07-29T09:30:00-04:00,23.91,24.07001,23.85001,23.95,1465300,583525,56.5424918971365,54.37650555693221,NaN,NaN,77.90742990261529,-37.97961346928024,-0.024711565910146824,0.05035450424407628,0.0750660701542231,26852434,25856894,52.82106672024631,62.669346109604895,NaN,NaN,5.448549642569462,8.97797504531449
2004-07-30T09:30:00-04:00,23.75,24.12,23.75,24.12,799700,608725,60.17966117465645,54.9234978062069,NaN,NaN,80.74343440490645,-9.610298825432844,0.00011186883174782447,0.07520590619390788,0.07509403736216005,27652134,26094514,56.061566136234106,61.912504407404505,NaN,NaN,7.85423280819059,8.817440440011076
2004-08-02T09:30:00-04:00,24.21001,24.33,24.05,24.3,1112100,641155,63.64882941565779,55.82980083156129,NaN,NaN,137.50321221096667,35.19924190520147,0.026467413951842975,0.10817830480196378,0.0817108908501208,28764234,26706934,63.09680510835839,62.0158699255573,NaN,NaN,11.029786186609378,9.133489832382262
2004-08-03T09:30:00-04:00,24.37,24.37,24.17,24.25,897600,666365,62.032166258379846,56.20550025118371,NaN,NaN,127.52438090740986,79.0658053145591,0.037663267681149054,0.12878997545155713,0.09112670777040807,27866634,27304514,68.41167095168062,62.87661632107743,NaN,NaN,13.071099815104024,9.696005544199656
2004-08-04T09:30:00-04:00,24.31,24.47,24.10001,24.46001,614600,666040,65.94478394819161,56.66718563252162,NaN,NaN,131.04488436875548,110.94466835893074,0.05527780394966622,0.16022396270749084,0.10494615875782462,28481234,27923334,72.78306994507108,64.09539093936293,NaN,NaN,16.10367430186893,10.611386795295266
2004-08-05T09:30:00-04:00,24.3,24.47,24.17,24.17,2012400,723165,57.18153610433504,56.2295850088943,NaN,NaN,99.11266045171112,115.18571446874992,0.04395596542651818,0.15989111554097235,0.11593515011445417,26468834,27846614,71.46268053332648,64.98058650666486,NaN,NaN,15.849968056987096,11.359755546965527
2004-08-06T09:30:00-04:00,23.97,24.55,23.96001,24.35001,1781600,765385,60.674744829241455,55.87966666086566,NaN,NaN,93.85725685938657,117.80847895964594,0.0449862710695203,0.17216798895135454,0.12718171788183424,28250434,27966274,72.30654724754406,65.65483184576784,NaN,NaN,16.804823677950434,12.137622422820513
2004-08-09T09:30:00-04:00,24.55,24.55,24.25,24.28999,646400,774715,58.9479288977581,55.33424384824379,NaN,NaN,104.5866458145492,111.22516568036244,0.038283964393049486,0.1750366733731461,0.13675270898009662,27604034,27734234,68.10108943316705,65.65047214063063,NaN,NaN,17.015070654890767,12.834400741687693
2004-08-10T09:30:00-04:00,24.38,24.48,24.24001,24.47,1015000,799285,62.40387162235505,55.956611095072084,NaN,NaN,103.90721543836356,106.50173258655317,0.04231724905859888,0.18964927030334522,0.14733202124474634,28619034,27884714,69.34623489856217,65.52731162052204,NaN,NaN,18.296759144221944,13.614737656335443
2004-08-11T09:30:00-04:00,24.44,24.57001,24.2,24.57001,469300,801680,64.20674069745436,57.01729742216297,NaN,NaN,105.81612800299429,101.45598131340094,0.04766610027159046,0.20691464658423442,0.15924854631264396,29088334,28006134,70.35186384570824,65.36631642186985,NaN,NaN,19.910731091205772,14.514165289888346
2004-08-12T09:30:00-04:00,24.7,24.7,24.46001,24.56,664800,814965,63.87657040883229,58.30358892090198,NaN,NaN,122.89757777532488,106.2129647781237,0.04642926743301451,0.21728513060391208,0.17085586317089757,28423534,28397074,73.37994464039198,65.39543418451542,NaN,NaN,21.105044344935656,15.455719440609391
2004-08-13T09:30:00-04:00,24.62,24.67,24.36,24.47,454400,815215,60.84694284849489,59.476982985869704,NaN,NaN,93.83287100963972,106.20808760817434,0.03591889561705722,0.21575448269221909,0.17983558707516187,27969134,28340814,72.23653650015176,65.74861210934645,NaN,NaN,21.23905680546593,16.281910492731754
2004-08-16T09:30:00-04:00,24.00999,24.61,24.00999,24.58,274400,790555,63.147581969433716,60.8677781560752,NaN,NaN,65.3254777022464,98.35585398571376,0.03282868662131666,0.2208714453518077,0.18804275873049103,28243534,28468714,73.25675569824851,66.86470086304836,NaN,NaN,22.014273861584503,17.100819545425004
2004-08-17T09:30:00-04:00,24.75,24.78,24.48,24.57001,520800,792465,62.78674727115943,61.601471238791895,NaN,NaN,103.2367448575385,98.22175986954876,0.026818981091879912,0.22156648509534094,0.19474750400346102,27722734,28289454,69.40710513335112,68.07306691371727,NaN,NaN,22.551191328697364,17.879444085892484
2004-08-18T09:30:00-04:00,24.7,24.89,24.59,24.73,481300,794085,66.1251657822943,62.28594794487459,NaN,NaN,117.98995654736954,100.65652557842381,0.03008103100248269,0.2323487927565644,0.2022677617540817,28204034,28112594,65.73671252067352,68.99561304231922,NaN,NaN,23.97670033099658,18.750480692335927
2004-08-19T09:30:00-04:00,24.75999,24.81,24.60001,24.61,1987700,877930,61.65729402239147,62.39149314828423,NaN,NaN,100.3654232244187,96.15009466824257,0.02104656710582825,0.22857597063636703,0.20752940353053878,26216334,27671154,57.55542588268998,69.10231730992322,NaN,NaN,23.935983632231522,19.491266826606726
2004-08-20T09:30:00-04:00,24.74001,24.75999,24.49001,24.71001,328400,880975,63.84956539495603,62.405831432519825,NaN,NaN,93.37579552442448,96.05867957119952,0.01877104293685722,0.23099320720161032,0.2122221642647531,26544734,27386274,52.973507800575405,68.37922464508156,NaN,NaN,24.52426261357118,20.210266224744505
2004-08-23T09:30:00-04:00,24.81,24.83,24.66,24.66,421200,863940,61.94236023240723,62.39941671637892,NaN,NaN,105.07190847540362,104.00796572583097,0.01123446905406697,0.22626525058233682,0.21503078152826985,26123534,26962274,46.97900163698809,66.8483196940321,NaN,NaN,24.48657653225434,20.821167697245908
2004-08-24T09:30:00-04:00,24.84,24.84,24.61,24.71001,445100,845025,63.12844467381194,62.19824962535181,NaN,NaN,103.00084648760746,103.96078605184478,0.00715288789822946,0.22397189140105667,0.2168190035028272,26568634,26731454,44.05623385576848,64.79640283051049,NaN,NaN,24.77617299198174,21.386168453636742
2004-08-25T09:30:00-04:00,24.83,24.85001,24.67,24.81,455500,842380,65.44713234067146,62.78864935651869,NaN,NaN,113.12279587099022,102.98735391656889,0.008624096437202605,0.22759912404933047,0.21897502761212786,27024134,26495474,41.231934768528625,62.63706384731064,NaN,NaN,25.66590312516813,21.997559120998368
2004-08-26T09:30:00-04:00,24.89,24.89,24.73,24.81,355900,786910,65.44713234067146,63.129534178763684,NaN,NaN,113.62090589503903,105.63845045069294,0.007097778533415228,0.2278472507788969,0.22074947224548166,27024134,26657034,43.88428662471741,60.6069023742516,NaN,NaN,26.403349259625635,22.626957712230833
2004-08-27T09:30:00-04:00,24.91,24.91,24.7,24.8,528600,773355,64.97322003746075,63.55991211731388,NaN,NaN,102.45339939103826,107.4539712240157,0.0031183273224924257,0.2246473813985972,0.22152905407610476,26495534,26647194,43.754759423710254,58.86787880214754,NaN,NaN,26.906297916520383,23.23829202712934
2004-08-30T09:30:00-04:00,24.8,24.89999,24.72,24.86,543500,744925,66.53883289757165,63.855266494115064,NaN,NaN,101.77888646507178,106.79536682194934,0.002270038256451584,0.22436660189666924,0.22209656364021765,27039034,26830294,46.8956988775628,57.26426908636187,NaN,NaN,27.74642132417913,23.88231049813645
2004-08-31T09:30:00-04:00,24.96001,25.10001,24.75999,25.10001,843600,742225,71.9415331462841,64.40775166903147,NaN,NaN,147.4801633825534,115.69123020093852,0.014911413464153644,0.2407358304704097,0.22582441700625605,27882634,27093094,51.11527353664816,55.89022692142901,NaN,NaN,30.109754654863462,24.77194537766888
2004-09-01T09:30:00-04:00,25.13,25.17999,25.02,25.02,741200,748555,67.99988732497268,64.70227430589864,NaN,NaN,160.74275204916302,125.21522143657307,0.014888252220659426,0.24443473228208035,0.22954648006142092,27141434,27116554,51.485864313537824,54.32636404093943,NaN,NaN,31.018103519400025,25.664253683630474
2004-09-02T09:30:00-04:00,25.17999,25.27,25.03,25.25,428900,669380,72.64049079560729,65.54467058783524,NaN,NaN,181.0550071462858,138.70204168682244,0.026678599654776702,0.2628947296298918,0.2362161299751151,27570334,27225794,53.262605942431435,52.97108328681655,NaN,NaN,33.295475181160874,26.754428183277675
2004-09-03T09:30:00-04:00,25.39999,25.49001,25.05,25.16,585300,609565,68.45698769870536,65.92391385421179,NaN,NaN,177.48871157714433,153.70910412404365,0.02477289762041207,0.26718225200063017,0.2424093543802181,26985034,27323694,54.85819334722681,51.656900261743566,NaN,NaN,33.928519098270975,27.779298313991003
2004-09-07T09:30:00-04:00,25.16,25.36,25.16,25.34,539100,604200,71.93792203501305,66.57756919448704,NaN,NaN,168.1596437307664,166.98525557718258,0.03155698395148632,0.281855584319576,0.2502986003680897,27524134,27420714,56.44511765488292,50.731044013281554,NaN,NaN,35.58572563417085,28.89450221687384
2004-09-08T09:30:00-04:00,25.33,25.33,25.00999,25.10001,1448300,625865,62.09831399711534,66.28993692411713,NaN,NaN,108.39209345998673,159.16764159266924,0.016557322888670456,0.27099525397892776,0.2544379310902573,26075834,27059354,49.46956166392299,49.5691046663708,NaN,NaN,33.75312032118949,29.58859051749036
2004-09-09T09:30:00-04:00,25.08,25.31,25.08,25.21001,955200,650160,64.4954265800651,66.49266067823666,NaN,NaN,107.84162666486841,148.58741651581033,0.01098814467083381,0.26817311192879956,0.25718496725796575,27031034,27037274,49.070521331775105,48.96304005559116,NaN,NaN,33.03290973588986,30.08063612011886
2004-09-10T09:30:00-04:00,25.13,25.32001,25.06841,25.25999,519700,642905,65.56120304136581,66.61492051012308,NaN,NaN,97.90120460995233,131.95665600854363,0.007766375539515757,0.26689293668236047,0.2591265611428447,27550734,27033354,48.994959615029614,48.67885804233789,NaN,NaN,32.787444077508646,30.467322971174543
2004-09-13T09:30:00-04:00,25.34,25.34,25.03,25.06,305600,635465,58.05197127300522,66.3370355844515,NaN,NaN,68.2462101336166,110.10815571983808,-0.00978539515699195,0.24689481719660478,0.2566802123535967,27245134,27085374,50.093230738957,48.90130297819281,NaN,NaN,30.116389831555466,30.417189665514673
2004-09-14T09:30:00-04:00,25.09,25.17,25.00999,25.02,549900,649240,56.65425971021866,65.8745938013377,NaN,NaN,39.12531404132427,84.30128978194965,-0.025166349464324944,0.22522227552319052,0.25038862498751546,26695234,26919594,46.64609612690111,49.08629314041657,NaN,NaN,27.541165796664487,30.00632911282179
2004-09-15T09:30:00-04:00,25.14999,25.16,24.92,25.07001,1238600,685130,58.01530669542968,65.34374911239185,NaN,NaN,28.724161813279714,68.36770345260824,-0.032578795952730666,0.20966513004660214,0.2422439259993328,27933834,27291194,54.24642654657051,50.01589969599099,NaN,NaN,25.83388879462533,29.410266210222293
2004-09-16T09:30:00-04:00,25.02,25.31,25.02,25.22,1116300,716880,61.88124997860801,65.08904322938731,NaN,NaN,67.9857411797331,60.3965263555812,-0.028153419727991263,0.20705215133934374,0.235205571067335,29050134,27695014,60.78412626831681,51.223031099105235,NaN,NaN,25.51856584326515,28.8543090149427
2004-09-17T09:30:00-04:00,25.25,25.27,25.02,25.16,408900,637940,59.520213996158255,64.6995427978657,NaN,NaN,51.450007882985936,51.10628701018793,-0.029877214984337763,0.1978590523369128,0.22773626732125057,28641234,27913114,63.79326261760413,52.65435275581194,NaN,NaN,24.555044731999306,28.240128403093642
2004-09-20T09:30:00-04:00,25.10001,25.17,25.05,25.07001,253000,634170,56.06508925966118,63.951418252300684,NaN,NaN,26.425531729526988,42.74215132937001,-0.037210623121409686,0.18122298841948847,0.21843361154089816,28388234,28141734,66.67951634115762,54.067482574640145,NaN,NaN,22.713940493042596,27.450672987372066
2004-09-21T09:30:00-04:00,25.06,25.25,25.03999,25.21001,391600,632690,59.95929938837731,63.09554441245019,NaN,NaN,52.02415033505772,45.3219185881167,-0.032913363524979755,0.17729190713467347,0.21020527065965322,28779834,28558654,71.18989629084287,55.501384199939764,NaN,NaN,22.27531483085174,26.711336107869162
2004-09-22T09:30:00-04:00,25.07001,25.17999,24.99001,25.10001,641900,642530,55.77611303510007,62.22241767745929,NaN,NaN,8.609665001540673,41.299019225768895,-0.0374308959068487,0.16341665077609235,0.20084754668294105,28137934,28599474,71.59530853605239,56.93777307297652,NaN,NaN,20.635076313136036,25.843298994335857
2004-09-23T09:30:00-04:00,25.10001,25.13,24.85001,24.85001,301800,634845,47.64100085557363,60.43673982459974,NaN,NaN,-84.33740282575206,10.834390424671858,-0.05608571296870429,0.13074040547206067,0.18682611844076497,27836134,28356674,65.67539830406614,57.82440109880757,NaN,NaN,16.48148576266219,24.50589710409676
2004-09-24T09:30:00-04:00,24.83,24.95,24.78,24.86,1144800,674290,47.967588251360674,58.97321129264655,NaN,NaN,-138.34639004990126,-27.12488916190558,-0.06590380474646787,0.10444636250768013,0.170350167254148,28980934,28424614,66.50986498039535,58.65666335831961,NaN,NaN,13.30149469280717,22.90526818819825
2004-09-27T09:30:00-04:00,24.85001,24.96001,24.77,24.89,949500,695335,48.99643123082547,57.33453337806173,NaN,NaN,-139.78094887441893,-60.36618528269476,-0.06824132816238279,0.08504850705116951,0.1532898352135523,29930434,28733054,70.06760928927262,59.62969847506173,NaN,NaN,11.005691877891191,21.20532871529724
2004-09-28T09:30:00-04:00,25.07001,25.14999,25,25.05,591000,697710,54.1980930498467,56.77023188182825,NaN,NaN,-25.42325890993476,-75.85566713169325,-0.057315807324766654,0.08164507605759397,0.13896088338236062,30521434,29081374,73.49230646545564,61.345608818028346,NaN,NaN,10.5383186175535,19.68147012990528
2004-09-29T09:30:00-04:00,25.05,25.10001,24.88,25,551900,683125,52.39961817171853,55.906245566946346,NaN,NaN,-80.29999064158933,-93.63759826031927,-0.05192107623579756,0.07405953808761367,0.12598061432341123,29969534,29447694,76.53320204038063,63.30722886864304,NaN,NaN,9.626242086439222,18.245008980838698
2004-09-30T09:30:00-04:00,24.97,25.13,24.91,25.05,1662600,729195,54.041970945412544,55.08344327437826,NaN,NaN,-50.2081071628101,-86.81173912773087,-0.04377563271307086,0.07126107343207266,0.11503670614514352,31632134,30206894,81.31685620202697,65.61593576771428,NaN,NaN,9.333940005523512,16.971999127222244
2004-10-01T09:30:00-04:00,25.06,25.33,25.05,25.25,404300,727965,59.988761955813196,55.221785466007404,NaN,NaN,78.39505068251988,-43.46345098124664,-0.024660670441687252,0.08421086809303446,0.10887153853472172,32036434,30817994,84.12247966866957,68.04659640555089,NaN,NaN,10.890232584707842,16.10317533543447
2004-10-04T09:30:00-04:00,25.49001,25.5,25.3,25.35001,646900,731045,62.595196222640894,55.64613807403756,NaN,NaN,182.40786436094677,20.9743116658265,-0.0059971857906307435,0.10137505629643329,0.10737224208706403,32683334,31368574,86.14169394596532,70.86771053548404,NaN,NaN,13.009561635920821,15.661230521218236
2004-10-05T09:30:00-04:00,25.32001,25.5,25.32001,25.46001,608500,734515,65.27464479019588,56.16466222366371,NaN,NaN,193.0498781947819,64.66893908676984,0.012056157990283325,0.12244243957491818,0.11038628158463486,33291834,31922654,87.82038242261328,73.26585024091567,NaN,NaN,15.643933525324194,15.658759521804802
2004-10-06T09:30:00-04:00,25.45,25.58,25.38,25.56,616800,692940,67.55015719904475,56.56958416798062,NaN,NaN,198.2869928189688,120.38633577888145,0.028114397943869524,0.14552927901447177,0.11741488107060224,33908634,32710474,89.72601104198215,75.3331277247489,NaN,NaN,18.57789023937621,16.075778195743574
2004-10-07T09:30:00-04:00,25.59,25.64,25.41,25.42,1122600,701310,61.47589515871482,56.70927567959181,NaN,NaN,162.4643469331876,162.920826598081,0.026700666457249972,0.15079071414216472,0.12409004768491474,32786034,32941254,90.20926536163176,77.21998506360804,NaN,NaN,19.253141143919876,16.529687188340187
2004-10-08T09:30:00-04:00,25.48,25.71001,25.37,25.53,741300,712390,64.19985836376652,57.29033061559935,NaN,NaN,155.941574641372,178.43013138985143,0.030303511635422165,0.16196943722919244,0.13166592559377027,33527334,33239434,90.81069436952055,78.94364063706253,NaN,NaN,20.669467568604663,17.121084385520827
2004-10-11T09:30:00-04:00,25.64,25.64,25.45,25.46001,341600,714190,61.23309515369938,57.38131602740806,NaN,NaN,124.16519890149462,166.781598297961,0.02530617363886037,0.16329864264234573,0.13799246900348536,33185734,33339914,91.01107811808757,80.35943933900857,NaN,NaN,20.95110588268774,17.66823031368753
2004-10-12T09:30:00-04:00,25.31,25.67999,25.31,25.67,885800,730985,66.26948248428766,58.13084241663576,NaN,NaN,117.2906098523112,151.62974462946687,0.03299036778412881,0.17923042873364636,0.14624006094951755,34071534,33495854,91.32716289272025,81.76885750734199,NaN,NaN,22.81721064984617,18.403798933138766
2004-10-13T09:30:00-04:00,25.7,25.71001,25.23,25.33,1024300,720270,54.030117327998944,58.58720787895186,NaN,NaN,64.90927244904394,124.95420055548186,0.013046013794648925,0.16254757819282872,0.1495015643981798,33047234,33323574,87.65976290646222,83.339169264656,NaN,NaN,20.220889460675785,18.663383294215482
2004-10-14T09:30:00-04:00,25.44,25.44,25.25999,25.38,532900,691100,55.33651001082023,59.11355943319897,NaN,NaN,40.177033389951255,100.49673784683459,0.0016892914653587332,0.15161317872987823,0.1499238872645195,33580134,33482394,88.13286954414053,84.88366959063781,NaN,NaN,18.63207199160532,18.658910250985457
2004-10-15T09:30:00-04:00,25.5,25.64999,25.39,25.58,624100,701860,60.207789860431724,59.91437076388513,NaN,NaN,86.7511785281431,86.65865862418882,0.005879267776888797,0.1572729719856305,0.1513937042087417,34204234,33617774,88.53632303574821,86.20286342967177,NaN,NaN,18.93166732636338,18.69787554746802
2004-10-18T09:30:00-04:00,25.64999,25.64999,25.39999,25.39999,547200,716570,54.4513928698008,59.93246360816756,NaN,NaN,63.243454972224065,74.4743098383347,-0.004670782342846319,0.1455552262801838,0.15022600862303012,33657034,33712034,88.821291628185,87.29779094129529,NaN,NaN,17.210333281739924,18.485369509506864
2004-10-19T09:30:00-04:00,25.34,25.59,25.28,25.36,830300,738505,53.23373728540043,59.99204354485913,NaN,NaN,37.70732603958256,58.55765307578897,-0.014960149462007771,0.13152582179552041,0.14648597125752819,32826734,33463074,82.95577202740311,87.75654594036834,NaN,NaN,15.466207889753663,18.05406070668498
2004-10-20T09:30:00-04:00,25.34,25.46001,25.2,25.39,966800,754750,54.063638871627184,59.99359125387446,NaN,NaN,16.461791187389505,48.86815682345809,-0.02004604440257529,0.12142841575430907,0.14147446015688436,33793534,33612334,83.6527709383665,87.92339699296402,NaN,NaN,14.326323329472856,17.521526795654676
2004-10-21T09:30:00-04:00,25.45,25.53,25.36,25.5,336700,756495,57.07174580340575,59.785232957273934,NaN,NaN,48.70083795933398,50.57291773733464,-0.01645279067727659,0.12090847181028863,0.13736126248756522,34130234,33722354,84.16674116668057,87.92655852853622,NaN,NaN,14.274345712983,17.057643783844437
2004-10-22T09:30:00-04:00,25.64999,25.72,25.44,25.66,899400,744225,61.065516112939385,59.67597009229525,NaN,NaN,99.50342118625157,53.12336626895634,-0.004379596580218192,0.1318867667622925,0.1362663633425107,35029634,33887434,84.93224919071265,87.84016961744676,NaN,NaN,15.471699281256804,16.831080283474776
2004-10-25T09:30:00-04:00,25.60001,26.07001,25.60001,26.05,887600,741130,68.70754678421876,59.921177377582595,NaN,NaN,219.58171650434542,84.3910185753806,0.027063807738110818,0.1700961230151492,0.14303231527703839,35917234,34339474,86.81247428551472,87.76817617908257,NaN,NaN,19.29523634278684,17.183102577662215
2004-10-26T09:30:00-04:00,26.19,26.38,26,26.31,687000,745930,72.57257613917618,60.27992158759199,NaN,NaN,304.8208456409572,137.81372249565553,0.06064178915909341,0.21883455172590516,0.15819276256681175,36604234,35094974,89.2311290125059,87.7328274626914,NaN,NaN,23.94370467950568,18.14890287792557
2004-10-27T09:30:00-04:00,26.55,26.55,26.17999,26.28,1272600,781965,71.47558406907092,60.99418508118885,NaN,NaN,273.7865673326872,189.27867772471507,0.07515213147212685,0.2521329269069703,0.17698079543484346,35331634,35402594,90.03271858451188,87.72021697861142,NaN,NaN,27.140138138959465,19.433365058073267
2004-10-28T09:30:00-04:00,26.14999,26.28999,25.94,26.13,1017300,749700,66.09586122507287,61.12961385699645,NaN,NaN,157.1773561266641,210.9739813581811,0.06912118430514075,0.2633822758162694,0.19426109151112864,34314334,35439414,90.12744375617253,87.67141336337228,NaN,NaN,28.01575057146861,20.65942013141546
2004-10-29T09:30:00-04:00,26.25,26.34,26.09,26.27,1135700,786270,68.48039978360927,61.64727847341859,NaN,NaN,150.71908513444927,221.2171141478206,0.06888108840546595,0.28036245201796106,0.21148136361249512,35450034,35523494,90.35290852040376,87.62440124925202,NaN,NaN,29.516204159851018,21.924674992620538
2004-11-01T09:30:00-05:00,26.42,26.50999,26.27,26.48,1545500,831200,71.69608870464349,62.03489320344401,NaN,NaN,157.15572070115476,208.7319149871825,0.07659341465005459,0.30722313192506334,0.23062971727500875,36995534,35739154,90.9253616953138,87.59570116372298,NaN,NaN,31.865795091818537,23.34483500679168
2004-11-02T09:30:00-05:00,26.56,26.56,25.95,25.96001,1147100,858130,56.36249589967969,62.20149167284978,NaN,NaN,86.3294248845683,165.03363083590472,0.04212504384939203,0.2832860220867488,0.24116097823735677,35848434,35587994,87.02727990865789,87.55052380673695,NaN,NaN,28.31944570708455,24.05549367826209
2004-11-03T09:30:00-05:00,26.45,26.56,26.28,26.50999,803700,867475,64.91046056785589,62.885345284066595,NaN,NaN,123.55632088743022,134.98758154685333,0.05121249252935339,0.3051765938990485,0.2539641013696951,36652134,35852094,87.99560748149422,87.54071937369076,NaN,NaN,28.655704945459505,24.712666716433148
2004-11-04T09:30:00-05:00,26.64999,27.11,26.45,27.03999,985200,860605,70.8386729674689,63.644694077426394,NaN,NaN,166.1564500166802,136.7834003248566,0.08573170541444991,0.3611287331377575,0.2753970277233076,37637334,36516694,90.01536821019032,87.64636545757949,NaN,NaN,31.444241933699256,25.674320318899735
2004-11-05T09:30:00-05:00,27.28,27.3,26.72,26.94,2871100,967095,68.48782342806922,64.64729626015985,NaN,NaN,157.43645117445607,138.12687353285793,0.09398161130157551,0.39287404185027697,0.29889243054870146,34766234,36379934,86.7797191263246,87.50053885030374,NaN,NaN,32.551407845702705,26.656761394157304
2004-11-08T09:30:00-05:00,26.89999,27.24001,26.89999,27.2,2579500,1078990,71.16725048819188,65.92826148893069,NaN,NaN,151.14907831289568,136.9255450552061,0.10809346847953205,0.4340092661481165,0.3259157976685845,37345734,36449974,87.03671813341863,87.79203500073343,NaN,NaN,34.42969391045117,27.767180325056426
2004-11-09T09:30:00-05:00,27.34,27.34,27.13,27.21001,1682600,1118830,71.26854050389449,67.15718303409263,NaN,NaN,146.07698057316907,148.87505619292625,0.10893957163220114,0.46209026220883587,0.35315069057663473,39028334,37085954,89.10736371520966,88.18164877050795,NaN,NaN,35.86032355767516,28.92334364400196
2004-11-10T09:30:00-05:00,27.21001,27.3,27.05,27.2,1995600,1167395,70.99992988180861,68.15205332540712,NaN,NaN,126.59377984155536,149.4825479837513,0.09990067808721409,0.4780265381856523,0.37812586009843824,37032734,37162074,89.32710568806519,88.55024623632112,NaN,NaN,36.87722145172787,30.05961190224852
2004-11-11T09:30:00-05:00,27.27,27.55,27.14,27.49001,3031200,1292310,74.05136043505074,69.07961363412936,NaN,NaN,135.39797095838904,143.33085217209305,0.1040587754974221,0.5081993294702158,0.40414055397279375,40063934,37647394,90.62559353642531,88.9569136895863,NaN,NaN,38.74686758952527,31.30064842900234
2004-11-12T09:30:00-05:00,27.55,27.83,27.46001,27.82001,1705900,1346400,77.01505571052016,69.67300712886518,NaN,NaN,149.16902846633818,141.67736763046946,0.11858541421075663,0.5523723217362395,0.4337869075254829,41769834,39048114,93.19783041358843,89.41301055587726,NaN,NaN,41.35453239713882,32.73691756730755
2004-11-15T09:30:00-05:00,27.85001,27.87,27.56,27.67999,575500,1347815,73.19507114392914,69.71747105777611,NaN,NaN,129.46078616984778,137.33970920185988,0.10858348484145275,0.5695162635772988,0.46093277873584604,41194334,39817834,94.14806869853138,89.76422053345051,NaN,NaN,42.22378497306538,34.09218433955867
2004-11-16T09:30:00-05:00,27.63,27.82001,27.60001,27.63,1042000,1358400,71.82532117934474,69.74245227993852,NaN,NaN,112.15327426881476,130.55496794098903,0.08922986240759423,0.5724701067453388,0.4832402443377446,40152334,40042634,94.3943651161402,90.07576671428112,NaN,NaN,42.496069014722195,35.29273929315346
2004-11-17T09:30:00-05:00,27.66,27.82001,27.33,27.39999,865300,1353325,65.73032413768652,69.71634248798235,NaN,NaN,85.83138048976228,122.4024880706304,0.05333750005537363,0.5499121194069616,0.496574619351588,39287034,40493494,94.86148325830546,90.41391239300489,NaN,NaN,40.83732824469113,36.084823429087415
2004-11-18T09:30:00-05:00,27.31,27.53999,27.31,27.39999,2195700,1446275,65.73032413768652,69.51990851327358,NaN,NaN,68.78404145112628,109.07970216917784,0.023517646777787338,0.5259716778238221,0.5024540310460348,39287034,40338114,92.01569913645568,90.53268315129432,NaN,NaN,39.51668111393481,36.57508881263704
2004-11-19T09:30:00-05:00,27.58,27.58,27.19,27.3,1914000,1497005,63.03353611372572,68.90115475677946,NaN,NaN,56.551660389044834,90.55622855371918,-0.007367599151350768,0.4932445321068464,0.5006121312581971,37373034,39458754,77.79225767981256,89.59460429304423,NaN,NaN,37.63468134429297,36.72645917430217
2004-11-22T09:30:00-05:00,27.39999,27.75,27.37,27.73,645300,1484890,68.93601880433862,69.79926353568366,NaN,NaN,82.9388372460015,81.25183876894992,-0.003462041031837948,0.4962845799683997,0.49974662100023765,38018334,38823554,69.44211038829408,88.33852075587538,NaN,NaN,37.69271866305579,36.86449624412412
2004-11-23T09:30:00-05:00,27.89999,27.98,27.69,27.89999,972300,1499155,70.9132677298131,70.22803547582348,NaN,NaN,106.00912478462222,80.02300887211142,0.005459643167813777,0.5065711749600048,0.501111531792191,38990634,38591214,66.62506661296263,86.81205355098028,NaN,NaN,38.35280442829768,37.07711169900605
2004-11-24T09:30:00-05:00,27.95,28.14,27.92999,28,998300,1485440,72.04081180604257,70.3139025357216,NaN,NaN,119.51695248266253,86.76012327069148,0.012579244842742865,0.5168355878456197,0.5042563430028768,39988934,38731594,67.48337254987021,85.20262528952883,NaN,NaN,39.234584378503975,37.38532208179147
2004-11-26T09:30:00-05:00,28.14999,28.19,28.05,28.11,368200,1452985,73.26825079257851,70.65536163318653,NaN,NaN,124.78820942206183,97.96095686487858,0.018804982636955514,0.5277625712990712,0.5089575886621157,40357134,38945614,68.80071927406303,83.9184110143673,NaN,NaN,40.33175463411901,37.80624101783826
2004-11-29T09:30:00-05:00,28.25,28.25,27.66,27.74001,1188300,1455615,63.21557985905779,70.08738515967696,NaN,NaN,85.89929215557392,103.83048321818441,-0.006530600410086573,0.5007943381495075,0.507324938559594,39168834,39304774,70.92920067848328,82.76787405330049,NaN,NaN,38.17209602718804,37.858506019173944
2004-11-30T09:30:00-05:00,27.69,27.78,27.41,27.44,1970800,1476880,56.45201693990315,69.0290620479633,NaN,NaN,27.081824130144184,92.65908059501295,-0.04583923011434399,0.45002590091666406,0.49586513103100804,37198034,39140714,68.6260943474459,81.30492624131738,NaN,NaN,34.094968289643326,37.320857772098144
2004-12-01T09:30:00-05:00,27.3,27.39999,27.07001,27.2,1593800,1499215,51.687718427838995,67.64961837267975,NaN,NaN,-45.58483721824572,62.34028819443936,-0.08791109655346468,0.3859762603391772,0.4738873568926419,35604234,38463434,59.96910787453903,79.20792639749406,NaN,NaN,29.09840083746909,36.14622106715114
2004-12-02T09:30:00-05:00,27,27.2,26.75,26.86,3739800,1646020,45.79170246592528,65.63107137488508,NaN,NaN,-119.08751695875515,14.619394306155822,-0.13569082869614335,0.3042738210224627,0.43996464971860605,31864434,36838534,45.22805667703114,75.96524519325162,NaN,NaN,22.78803469597514,34.23790872841171
2004-12-03T09:30:00-05:00,26.8,27.13,26.8,27.06,1505200,1672020,49.44489112227308,63.661773904296005,NaN,NaN,-109.48007322622215,-32.23426222350098,-0.1497726426633209,0.25274884638945494,0.40252148905277585,33369634,35441034,36.840487797901474,71.93972072070257,NaN,NaN,18.800112060046107,32.032509204359485
2004-12-06T09:30:00-05:00,27.13,27.35001,26.97,27.31,671200,1562025,53.649764957426584,62.26568060526011,NaN,NaN,-65.63235998866125,-62.540592652348,-0.13846281705860025,0.22944296772952555,0.3679057847881258,34040834,34415434,32.1310981987035,67.50993711357201,NaN,NaN,16.83824184358278,29.861899581391384
2004-12-07T09:30:00-05:00,27.35001,27.38,27.08,27.10001,641600,1465130,49.89575993522288,60.69928337353712,NaN,NaN,-73.03057401813568,-82.56307228200397,-0.1408707858460796,0.1918173024805263,0.3326880883266059,33399234,33655674,29.157559996209045,62.850165319291214,NaN,NaN,13.99588316454064,27.595325807555565
2004-12-08T09:30:00-05:00,26.95,27.14,26.88,26.96001,771600,1419580,47.50895666493951,59.39775712548376,NaN,NaN,-112.19261835749505,-95.88462850985384,-0.14696290139115736,0.1489844615876592,0.2959473629788166,32627634,33060354,27.045520531401678,58.00616798165523,NaN,NaN,10.923880742799753,25.213690798304736
2004-12-09T09:30:00-05:00,27,27.03999,26.82001,26.97,1409600,1390280,47.70120685850209,58.10996303411344,NaN,NaN,-116.15670562048517,-95.29846624219985,-0.14513784041067895,0.1145250624654679,0.25966290287614685,34037234,33494914,30.975909245506386,53.646182989444576,NaN,NaN,8.538427139339623,22.831510275595434
2004-12-10T09:30:00-05:00,26.85001,27.16,26.84,27.07001,787000,1278070,49.687837754418496,57.1566988655915,NaN,NaN,-88.7485674353661,-91.15216508402864,-0.13237045468401837,0.0941998345211239,0.22657028920514227,34824234,33785834,33.55664539980468,50.48649639801544,NaN,NaN,7.1192250489322095,20.586898100357832
2004-12-13T09:30:00-05:00,27.2,27.5,27.06,27.47,1440000,1264775,56.76209083979893,56.287132582410095,NaN,NaN,-18.43858030257258,-81.7134091468109,-0.09396819741736812,0.10911004243343214,0.20307823985080026,36264234,34230514,37.40889343783881,48.19840947298292,NaN,NaN,8.016071570597253,18.791065738963464
2004-12-14T09:30:00-05:00,27.7,27.75,27.39,27.57001,1474400,1309720,58.3393834913253,55.38899799394668,NaN,NaN,32.758440440060305,-60.555606255171725,-0.060441459344375004,0.12752641567033152,0.18796787501470652,37738634,35098394,44.20771449381432,46.597170035900895,NaN,NaN,9.230846994789072,17.42532020408141
2004-12-15T09:30:00-05:00,27.7,27.75999,27.5,27.7,542200,1284730,60.363316368986,54.55489117701406,NaN,NaN,51.817773106805475,-27.75352796231162,-0.029677117384409313,0.1508714782841949,0.1805485956686042,38280834,36229034,51.585791243721964,45.461628514033166,NaN,NaN,10.853260185342533,16.486454487118714
2004-12-16T09:30:00-05:00,27.85001,27.88,27.58,27.71001,2199900,1351460,60.52236515390219,53.644470774251474,NaN,NaN,62.71847381036565,8.02150792385855,-0.009846112584048716,0.1682409549385433,0.178087067522592,40480734,37517734,58.34704183266139,44.71493726821876,NaN,NaN,12.216473409050467,15.876457190251822
2004-12-17T09:30:00-05:00,27.33,27.55,27.3,27.52,975200,1290435,55.93421466609008,53.12437326046807,NaN,NaN,5.100635136004939,26.791348438132765,-0.010649853576775892,0.16477475055162216,0.17542460412839805,39505534,38453994,62.44996908660504,44.109277868798884,NaN,NaN,12.115378707813369,15.339160264189186
2004-12-20T09:30:00-05:00,27.50999,27.92,27.50999,27.67,626600,1226065,58.60228698159085,53.277963977731474,NaN,NaN,52.19141089829444,40.917346678306174,-0.002622002995002204,0.1721471003846453,0.17476910337964752,40132134,39227574,65.47593056618928,43.8842661701377,NaN,NaN,12.792110344634319,14.975295989967062
2004-12-21T09:30:00-05:00,27.85001,27.96001,27.72,27.96001,610200,1224310,63.236910690487726,54.102906282206376,NaN,NaN,83.744810598234,51.11462070994091,0.019461572082725753,0.19909606848305472,0.17963449640032897,40742334,39828314,67.65572960067354,44.4333105791473,NaN,NaN,14.79975139572805,14.95021819079006
2004-12-22T09:30:00-05:00,27.98,28.10001,27.95,28.02,2334400,1292415,64.13145621387447,55.412888692774175,NaN,NaN,108.1500774865571,62.38108158589123,0.03447364958214788,0.2227265583780138,0.18825290879586593,43076734,40787494,70.8233172138809,46.261543474636575,NaN,NaN,16.71270879631222,15.202002563007513
2004-12-23T09:30:00-05:00,28.14999,28.14999,27.92999,28.00999,728600,1278930,63.852261859344715,56.44198660256501,NaN,NaN,109.28177248097678,71.69374132001346,0.039720682600424745,0.23790376204639685,0.1981830794459721,42348134,41160974,71.97422576025266,48.77109618623308,NaN,NaN,18.20401076531542,15.630860877622927
2004-12-27T09:30:00-05:00,28.2,28.2,27.78999,27.83,822400,1301640,58.88793003767147,56.81614125115393,NaN,NaN,95.87878568599285,89.84937143001105,0.027633858811097173,0.23272540295984356,0.2050915441487464,41525734,41565014,73.20560154386585,51.704989282316106,NaN,NaN,18.137221751357593,15.988912431013594
2004-12-28T09:30:00-05:00,27.86,27.95,27.75999,27.89999,574200,1270935,60.184248578896145,57.551033297130594,NaN,NaN,82.10700306260799,95.83248986287376,0.02120627711009357,0.23159939053636336,0.2103931134262698,42099934,41958574,74.38613780332967,54.93560198282472,NaN,NaN,18.436630563637966,16.338586449959934
2004-12-29T09:30:00-05:00,27.96001,28.03,27.86,27.98,705100,1207650,61.67206969252387,58.56268422767233,NaN,NaN,89.79489505414828,97.04250675405662,0.019253862762483615,0.23446044187937432,0.2152065791168907,42805034,42371114,75.59972193881138,58.403759226211136,NaN,NaN,19.09601667611092,16.73250505369579
2004-12-30T09:30:00-05:00,28.02,28.11,27.98,27.99001,630100,1159465,61.86407119170248,59.5743173943295,NaN,NaN,92.76485428680691,93.96546211410657,0.01569762548476844,0.23482861097285124,0.2191309854880828,43435134,42442794,75.81414568053857,61.60649040014199,NaN,NaN,19.697362486087883,17.15605611546609
2004-12-31T09:30:00-05:00,28.10001,28.10001,27.85001,27.85001,675100,1006230,57.52381306014957,60.134029916167435,NaN,NaN,69.96281176364263,86.10166997063975,0.0017135010871095202,0.2212728618469697,0.21955936075986018,42760034,42525174,76.07437122691871,64.64347081636444,NaN,NaN,19.082222327634046,17.43122271720437
2005-01-03T09:30:00-05:00,27.8,28.05,27.48,27.53,2026400,1032290,49.052372340085356,59.58333573761647,NaN,NaN,16.843848083198328,70.29468245008084,-0.02956527310639151,0.1826027693768708,0.21216804248326232,40733634,42366754,74.4162018089494,67.28684998572948,NaN,NaN,16.01340300478761,17.228677044001977
2005-01-04T09:30:00-05:00,27.5,27.64999,27.3,27.34,1287600,1063110,44.83091906458698,58.61844542142087,NaN,NaN,-41.87121505426466,45.499038826706304,-0.061679993999154414,0.13506804998431932,0.19674804398347373,39446034,41835974,68.99034798234182,69.05703809205286,NaN,NaN,12.054517366780624,16.489511375827497
2005-01-05T09:30:00-05:00,27.39999,27.39999,26.91,26.91,1431900,1102625,37.05800976649544,56.95378066410012,NaN,NaN,-117.1815489888529,4.103750018106067,-0.10781082148510959,0.06198451712708675,0.16979533861219634,38014134,40877794,60.42518185707886,69.68842313586408,NaN,NaN,5.725938034794956,14.951858041394278
2005-01-06T09:30:00-05:00,26.89999,27.13,26.89999,27.05,772200,1102655,40.665126850442746,55.53540649956731,NaN,NaN,-128.5168593024626,-40.152592699747835,-0.12368662779605846,0.015187053867123268,0.13887368166318173,38786334,39948034,53.486173312027795,69.34121824153311,NaN,NaN,1.7023299977345747,13.059068320871463
2005-01-07T09:30:00-05:00,27.25,27.34,27.00999,27.05,367800,1050565,40.665126850442746,54.44475736987822,NaN,NaN,-111.43969975664336,-76.43309500380504,-0.12841950306182393,-0.021650697164098176,0.10676880589772575,38786334,39153294,48.372671369048916,68.33569697599339,NaN,NaN,-1.4661762808140986,10.984033377773525
2005-01-10T09:30:00-05:00,26.97,27.28,26.97,27.19,2065200,1114475,44.36300662716893,53.427665915990936,NaN,NaN,-112.65109183136246,-102.33208298671718,-0.11669293292223389,-0.039097360255066604,0.07759557266716728,40851534,39176874,48.529901331596015,67.1252663163796,NaN,NaN,-3.046475858831912,8.97967491540132
2005-01-11T09:30:00-05:00,27.10001,27.21001,26.94,27.11,362300,1060590,42.72443390392104,51.962489002664746,NaN,NaN,-117.32529207346704,-117.42289839055766,-0.10903854670017075,-0.058702610708046166,0.05033593599212459,40489234,39385514,49.98142924458377,65.86281629094461,NaN,NaN,-4.838409363412349,7.005662875570796
2005-01-12T09:30:00-05:00,27.08,27.24001,26.94,27.19,197200,996730,44.91551632894506,50.58992186802693,NaN,NaN,-95.76902038292609,-113.14039266937229,-0.09387843492534767,-0.06701210766456,0.026866327260787668,40686434,39919974,53.59192055079726,64.63200224358148,NaN,NaN,-5.715580231029098,5.188342431770812
2005-01-13T09:30:00-05:00,27.28,27.53999,27.21001,27.32001,875200,1013380,48.372086317938745,49.48419504364079,NaN,NaN,-43.975886032223876,-96.23219801532456,-0.0714031085838885,-0.06238755846907296,0.009015550114815543,41561634,40475034,57.05865130786001,63.566604068410584,NaN,NaN,-5.476128940876204,3.6648465213926666
2005-01-14T09:30:00-05:00,27.52,27.62,27.28,27.55,799100,943340,53.88493163691801,49.12683801501554,NaN,NaN,-16.80695882105942,-77.30564982820778,-0.03897770906053625,-0.039706586210854766,-0.0007288771503185191,42360734,41189914,61.09012855170947,62.70121314039942,NaN,NaN,-3.594421477531584,2.6278082358320596
2005-01-18T09:30:00-05:00,27.5,27.81,27.35001,27.78999,594200,924290,58.825617101420946,49.0297929094816,NaN,NaN,14.40239359910602,-51.894952742114086,-0.001288574733661578,-0.0023395955673954916,-0.0010510208337339137,42954934,41610594,63.275132239739804,61.907569885857285,NaN,NaN,-0.3719738958544902,2.1992679313054095
2005-01-19T09:30:00-05:00,27.89999,27.89999,27.67,27.67,1123600,949140,55.61720531457418,48.59730259677091,NaN,NaN,33.02032674449067,-21.825828978522548,0.014753894194202154,0.01739134690901878,0.0026374527148166254,41831334,41879014,64.63958172591043,61.12470272779293,NaN,NaN,1.3452004621862457,2.0772582928598147
2005-01-20T09:30:00-05:00,27.47,27.75999,27.47,27.58,808000,959030,53.270324197197425,47.98346352573483,NaN,NaN,7.619681559475579,-1.1480885900422184,0.018267944514057985,0.025472383357389106,0.007204438843331122,41023334,41946394,64.99120306705785,60.35163539825859,NaN,NaN,2.075147480424095,2.0769567482261406
2005-01-21T09:30:00-05:00,27.47,27.67999,27.46001,27.47,3274400,1006030,50.46729993165025,47.47942687369916,NaN,NaN,-1.1758564099132447,7.411917334419902,0.012427222824629856,0.022738467374118443,0.010311244549488587,37748934,41183854,57.96616462373029,59.05819206945942,NaN,NaN,1.8682662483867525,2.0471438196776566
2005-01-24T09:30:00-05:00,27.58,27.84,27.47,27.71001,886400,1013920,55.91768567179461,47.96980639739268,NaN,NaN,34.80199964097797,17.7337090268274,0.023337787912361765,0.039483479439940794,0.01614569152757903,38635334,40438774,52.04633459462971,57.460344411293725,NaN,NaN,3.3661466752220432,2.2355727990411403
2005-01-25T09:30:00-05:00,27.72,27.87,27.50999,27.55,1102700,1027935,51.823526949686745,48.469278389185526,NaN,NaN,32.79411237139055,21.412052781284295,0.018594251755167355,0.03938850622153822,0.020794254466370867,37532634,39354314,44.86453677470252,55.73707218217664,NaN,NaN,3.383952087536489,2.3996269831119044
2005-01-26T09:30:00-05:00,27.60001,27.98,27.55,27.95,1397600,1069105,59.75608500719091,50.090569477806625,NaN,NaN,78.75744434383137,30.559476301152436,0.03998384206522532,0.07077405704790252,0.030790214982677196,38930234,38774094,41.56019865528672,54.38957338204863,NaN,NaN,6.080147289555145,2.9254155983180814
2005-01-27T09:30:00-05:00,28.03999,28.13,27.78,28.09,1179000,1092800,62.10778020463194,51.62218757453443,NaN,NaN,120.08458868984587,53.052457727226496,0.05994816823692828,0.10572542527883755,0.04577725704190927,40109234,38591274,40.54686090259077,53.46533678137456,NaN,NaN,9.05370659639771,3.8008857409008856
2005-01-28T09:30:00-05:00,27.91,28.12,27.85001,28.12,370000,1079795,62.61196684159745,53.189819002474046,NaN,NaN,127.3166375884613,78.7509565269014,0.0708160264696371,0.13429729012895564,0.06348126365931854,40479234,39137334,44.87061604115256,53.2151899722391,NaN,NaN,11.563847521939904,4.9098802810493165
2005-01-31T09:30:00-05:00,28.24001,28.44,28.17,28.44,959200,1094000,67.56893273824689,54.847385153265336,NaN,NaN,187.58826094652682,109.30820878801117,0.09375840219740127,0.18067926640607013,0.08692086420866886,41438434,39697954,48.973550305255216,53.246879184643326,NaN,NaN,15.444097347413779,6.4147684333870965
2005-02-01T09:30:00-05:00,28.5,28.7,28.38,28.63,1890600,1087210,70.10343622205454,56.80302817598915,NaN,NaN,198.2081300812954,142.39101232999215,0.11455618366238081,0.23011609378664488,0.11555991012426407,43329034,40857234,56.22811142748441,53.69307076913623,NaN,NaN,19.52422528456935,8.28754798355599
2005-02-02T09:30:00-05:00,28.87,28.87,28.63,28.74001,1701400,1107900,71.49259712549488,58.70139109002842,NaN,NaN,192.40620950184177,165.1207653615942,0.12755364927637136,0.2750019717197283,0.14744832244335693,45030434,42077274,62.30245400388278,54.31525173007092,NaN,NaN,23.293259979991408,10.431221125903907
2005-02-03T09:30:00-05:00,28.87,28.87,28.53999,28.82001,1752200,1123915,72.49353820387759,60.424351939024056,NaN,NaN,160.95663884802264,173.29517539322956,0.13277479074809212,0.31341681087847206,0.18064202013037994,46782634,43411954,67.59960201034053,55.06817678024809,NaN,NaN,26.67664649845462,12.751996179125436
2005-02-04T09:30:00-05:00,29,29.17999,28.89999,29.10001,738000,1122205,75.70838300786258,61.98316989409153,NaN,NaN,174.26538356914392,182.6849245893661,0.14530909419423624,0.36227838787317523,0.216969293678939,47520634,44820234,72.06069405053387,55.85178860159268,NaN,NaN,30.7055793097211,15.31679376921053
2005-02-07T09:30:00-05:00,29.3,29.35001,29,29.03999,871400,1147385,73.71940604519371,63.04701196150388,NaN,NaN,153.6368039403772,175.8946331881362,0.1397396061178971,0.3916438013263104,0.2519041952084133,46649234,45862394,74.82330442997704,56.67665804375248,NaN,NaN,33.357870412074206,17.89409043247677
2005-02-08T09:30:00-05:00,29.22,29.25,29.08,29.21001,1456400,1116945,75.66937522686618,64.47930981238189,NaN,NaN,137.4094009886425,163.7348873696056,0.13747709456795387,0.4237505634183556,0.2862734688504017,48105634,46817714,77.0622991215198,57.56399500058173,NaN,NaN,36.21870622987263,20.511892689247606
2005-02-09T09:30:00-05:00,29.19,29.24001,29.03999,29.03999,1680700,1182865,70.07036053864303,65.67931240819942,NaN,NaN,111.28762670478667,147.5111708101946,0.11539203992020497,0.4305135187506579,0.31512147883045294,46424934,47096614,77.68619525132755,58.47078015660099,NaN,NaN,36.94210799924823,22.85906630496198
2005-02-10T09:30:00-05:00,29.07001,29.23,29,29.07001,3697300,1357870,70.48562089229847,67.10919247681716,NaN,NaN,97.91366253491525,134.90257554757312,0.09454341801338384,0.4333007513471827,0.33875733333379887,50122234,47764534,79.14888528227056,59.983831632211015,NaN,NaN,37.64786302433218,24.971751550586294
2005-02-11T09:30:00-05:00,29.25,29.34,28.92999,29.09,2574600,1442840,70.77638428134077,68.17052809178473,NaN,NaN,90.09475188544312,118.06844921083295,0.07470711266405494,0.4321412241638676,0.35743411149981263,52696834,48799774,81.20531983279048,62.06661629207964,NaN,NaN,38.30695491392475,26.876780602491788
2005-02-14T09:30:00-05:00,29.28,29.41,29.03,29.35001,1018200,1453795,74.32011767163206,69.77742742906655,NaN,NaN,95.80113574815704,106.50131557238892,0.0716924026735376,0.44704961484173467,0.37535721216819706,53715034,50212934,83.58520524251487,64.8323783254948,NaN,NaN,39.94836275620363,28.744149481593478
2005-02-15T09:30:00-05:00,29.55,29.55,29.25999,29.3,845100,1466340,72.49911213231468,70.68764365228967,NaN,NaN,97.77739604949777,98.57491458455999,0.05943102522042232,0.44964599369372493,0.3902149684733026,52869934,51165794,84.96742451350332,67.93289445822457,NaN,NaN,40.78433000773891,30.464175271042826
2005-02-16T09:30:00-05:00,29.39999,29.46001,29.10001,29.38,1049600,1462640,73.6129292193525,71.509440010484,NaN,NaN,84.41994285026081,93.20137781365482,0.050178256551316136,0.45293778916244776,0.4027595326111316,53919534,52664714,86.8441261353141,71.23984197484766,NaN,NaN,41.80211040273403,32.083880289855855
2005-02-17T09:30:00-05:00,29.58,29.58,29.24001,29.32001,1234100,1483945,71.2815243581767,72.12869411881108,NaN,NaN,85.63425405702915,90.7454961180776,0.03424806985016754,0.44556961992384103,0.4113215500736735,52685434,53177354,87.4224569938443,74.27925918575421,NaN,NaN,42.02017247737665,33.50335060235883
2005-02-18T09:30:00-05:00,29.23,29.24001,28.92,29.00999,1067900,1373620,60.600030937500925,71.6309154187578,NaN,NaN,42.800781419472315,81.28670202488344,-0.0010666951633145905,0.4099881811195303,0.41105487628284487,51617534,52961494,85.71381198934795,76.90356359176084,NaN,NaN,38.99174918299048,34.28740754244907
2005-02-22T09:30:00-05:00,29.05,29.05,28.25,28.32001,4252602,1541930.1,44.586425358898786,69.80827178567525,NaN,NaN,-34.73944498192556,55.17858587886692,-0.07092580831449691,0.3223976158897237,0.3933234242042206,47364932,51691473.6,76.26886888168015,78.33504626706053,NaN,NaN,29.928674305430054,33.66473136573207
2005-02-23T09:30:00-05:00,28.42999,28.61,28.39999,28.47,1737200,1573655.1,47.814731344695566,68.11699565847529,NaN,NaN,-53.33182128364284,24.956742412238803,-0.10500794215417802,0.2620634965114981,0.3670714386656761,49102132,50937913.2,71.25194712924821,78.9742957760152,NaN,NaN,23.90659989633032,32.27071258438896
2005-02-24T09:30:00-05:00,28.55,28.73,28.42,28.69,1999600,1603755.1,52.21236568610741,66.66834047863456,NaN,NaN,-44.892492389871634,-0.9057446357876842,-0.11017190771777385,0.22935655401845878,0.33952846173623263,51101732,50374352.8,67.66706840896028,78.97911480448805,NaN,NaN,20.49700639947661,30.58875455797291
2005-02-25T09:30:00-05:00,28.8,29.34,28.7,29.25,3548100,1722210.1,61.179980916559835,65.63059747211294,NaN,NaN,38.00728389947346,-10.431138667298828,-0.07499071227486792,0.24579007139264775,0.32078078366751567,54649832,50767232.4,68.84392662146912,78.749345702412,NaN,NaN,20.82292426706195,29.19363594498563
2005-02-28T09:30:00-05:00,29.32001,29.38,28.94,29.05,1969700,1802195.1,57.06155119111182,64.44075069682137,NaN,NaN,38.13826894519449,-11.3636411621544,-0.06469671342711636,0.23990989188362022,0.3046066053107366,52680132,50979752,69.49082157902345,78.36845407020101,NaN,NaN,19.571530436036713,27.819049443707215
2005-03-01T09:30:00-05:00,29.10001,29.33,29,29.13,1480100,1828240.1,58.271588740367726,63.198051662071485,NaN,NaN,41.38172701735143,3.860593237700992,-0.05252475292407033,0.2389506641556487,0.291475417079719,54160232,52338812,73.30764650392368,78.10026459751558,NaN,NaN,19.024474144558774,26.562681543828866
2005-03-02T09:30:00-05:00,29.25,29.28,28.96001,29.10001,2570400,1862230.1,57.61609659721978,62.30846138054125,NaN,NaN,25.55693320506497,19.638344135442555,-0.046713387027150055,0.23308368329578144,0.2797970703229315,51589832,52836352,74.56229950910166,77.87712918735659,NaN,NaN,18.39024952966874,25.395191256091707
2005-03-03T09:30:00-05:00,29.25,29.32001,29,29.25,2312300,1892775.1,60.037324713305125,61.56215451061315,NaN,NaN,48.06834764035907,38.230512141488695,-0.033600987615218736,0.23779583580390806,0.2713968234191268,53902132,53396432,75.9336657489542,77.64747064926256,NaN,NaN,18.624232836114874,24.427911481809303
2005-03-04T09:30:00-05:00,29.44,29.75,29.3,29.71001,1710200,1890675.1,66.38060991949646,61.248170627624276,NaN,NaN,186.97598741336768,68.02425284426752,0.0032615200993213467,0.2754737235432785,0.27221220344395713,55612332,53588932,76.4045022250294,77.30455510585105,NaN,NaN,20.99493285556736,23.93748596377474
2005-03-07T09:30:00-05:00,29.75,29.98,29.75,29.92,1129700,1910260.1,68.81412292289787,60.854885288428974,NaN,NaN,241.0455162478266,108.60570230479395,0.03711461604333921,0.3186054734981312,0.28149085745479197,56742032,54401312,78.33117797605252,76.92926744396088,NaN,NaN,23.759674254035733,23.912084290954883
2005-03-08T09:30:00-05:00,29.97,29.97,29.64,29.72,1761900,1954785.1,64.05820173365511,60.25196311709614,NaN,NaN,168.64435434538436,134.05822777040052,0.04105764005653567,0.33281290752546155,0.2917552674689259,54980132,54565292,78.709089439384,76.48224351009523,NaN,NaN,24.477641741310364,23.99287821243424
2005-03-09T09:30:00-05:00,29.87,29.87,29.16,29.19,4277301,2095830.15,53.505045546360186,58.81568571188241,NaN,NaN,59.028627507956514,140.75256663097883,0.0048935028769417355,0.29787214606510304,0.2929786431881613,50702831,54387891.8,77.1416470876598,75.78920929240563,NaN,NaN,21.38274242303688,23.62000167109176
2005-03-10T09:30:00-05:00,29.25,29.47,29.03,29.38,2399300,2131760.15,56.28537821674455,57.74453241606583,NaN,NaN,26.258766834924334,136.3906504698919,-0.008575677438296625,0.28225904639029054,0.29083472382858716,53102131,54227891.6,75.67783115518019,74.95030744678677,NaN,NaN,19.862009144663215,23.083145595887682
2005-03-11T09:30:00-05:00,29.39999,29.53999,29.17999,29.25,1756400,2034715.15,53.90998987162758,57.266672339932015,NaN,NaN,30.998671681701826,105.19518732355873,-0.027516128494533054,0.25643956321042083,0.2839556917049539,51345731,53374571.4,68.24051810459136,73.702215026447,NaN,NaN,17.870262428917215,22.33844800060619
2005-03-14T09:30:00-05:00,29.27,29.72,29.21001,29.7,553300,1933650.15,60.175335117260424,58.3801658941007,NaN,NaN,79.7124944023165,72.9285829544567,-0.011816016476095426,0.2691856711098346,0.28100168758593,51899031,52405971.2,60.921765351004645,72.60599334568448,NaN,NaN,18.274078741118167,21.757823820679327
2005-03-15T09:30:00-05:00,29.71001,29.92,29.57001,29.57001,2551100,2010295.15,57.733867500105504,59.08867561948712,NaN,NaN,103.00697821817297,59.80110772901444,-0.012213572182814936,0.26573472235741136,0.2779482945402263,49347931,51279531,53.70770713871147,71.35283334636043,NaN,NaN,17.79266532629488,21.191372607195834
2005-03-16T09:30:00-05:00,29.55,29.64999,29.14999,29.3,4048500,2170465.15,52.93002116408361,59.13993672505685,NaN,NaN,28.059282984843914,53.60723882439193,-0.031587905715132814,0.2384634123963103,0.2700513181114431,45299431,50198851,47.85318241186382,69.93755577513926,NaN,NaN,15.810921235525521,20.42273669695722
2005-03-17T09:30:00-05:00,29.35001,29.56,29.32001,29.47,833600,2159665.15,55.443763240204596,58.73020689103147,NaN,NaN,45.02646870710988,57.36077919882903,-0.03368847588581164,0.22794072325417858,0.2616291991399902,46133031,48805031,41.56057243652852,67.98874476192923,NaN,NaN,14.995743674436321,19.647451979454235
2005-03-18T09:30:00-05:00,29.45,29.45,28.97,29.16,1351900,2165555.15,50.18100387709631,58.23873922574466,NaN,NaN,-11.878675038122884,48.78530985486409,-0.05540776625190441,0.19236949132510972,0.24777725757701413,44781131,47492111,36.66913095602489,65.6443382888579,NaN,NaN,12.59169481816332,18.63948667069839
2005-03-21T09:30:00-05:00,29.3,29.3,29.07001,29.14999,926900,2158505.15,50.015911861314294,57.64904802009799,NaN,NaN,-18.246625094738324,29.193485955453127,-0.06901418279250682,0.1615095290863806,0.23052371187888743,43854231,45883151,31.73917890428028,62.675162031740506,NaN,NaN,10.650860669096456,17.498254384755256
2005-03-22T09:30:00-05:00,29.17999,29.27,28.53,28.56,3712100,2131480.05,41.375651542334964,56.489016230463356,NaN,NaN,-117.9679789144863,-15.00150547107874,-0.11367800773143077,0.08842620221459896,0.20210420994602973,40142131,44041991,27.228011260895457,59.29414144258292,NaN,NaN,5.942344370210266,15.847410096963115
2005-03-23T09:30:00-05:00,28.58,28.58,28.13,28.42,6573301,2373285.1,39.626326480667046,55.03108778527492,NaN,NaN,-213.50355387534478,-63.31407284311648,-0.14649025735004456,0.018991388258474018,0.16548164560851858,33568830,41695870.8,22.784072682671223,55.497741937848424,NaN,NaN,1.5922120445066308,13.810953232326474
2005-03-24T09:30:00-05:00,28.55,28.84,28.5,28.72,2378700,2392240.1,44.99318418289767,53.50341451837501,NaN,NaN,-141.0779853447896,-100.53496365349638,-0.14174044380816553,-0.011693909151688331,0.1300465346564772,35947530,39658770.6,19.767277648484992,51.452225896666675,NaN,NaN,-0.36574573114692227,11.785710523258846
2005-03-28T09:30:00-05:00,28.89999,28.97,28.74001,28.77,818000,2255735.1,45.85705300908621,51.863623810245606,NaN,NaN,-98.43830717111133,-117.84689008009407,-0.12932781066177607,-0.0316132286707429,0.09771458199103317,36765530,38055650.4,17.772884621483357,47.12663351419745,NaN,NaN,-1.658008818452178,9.8651791887287
2005-03-29T09:30:00-05:00,28.89999,28.89999,28.37,28.41,1305700,2222535.1,40.87911012102807,50.20797440934367,NaN,NaN,-140.40235169847543,-142.27803540084147,-0.13863343930561753,-0.07557721714098875,0.06305622216462878,35459830,36376770.2,15.9571306986808,42.64435074700436,NaN,NaN,-4.3640613056680415,7.832430546672022
2005-03-30T09:30:00-05:00,28.58,28.87,28.42,28.87,1174300,2207245.1,48.56266568287982,49.85494727623793,NaN,NaN,-95.1007092848797,-137.7045814749202,-0.10841737927527458,-0.07246550192946444,0.03595187734581014,36634130,35675170,15.255698269908407,38.22392583145069,NaN,NaN,-4.2036031300827466,6.112997164278483
2005-03-31T09:30:00-05:00,28.98,29.19,28.7,29.14999,769300,2117190.1,52.60063632755672,49.59175142701024,NaN,NaN,-35.105610118411235,-102.02499272353346,-0.0662545787686249,-0.04686634611497098,0.019388232653653914,37403430,36442090,19.42511929618756,34.2058749843798,NaN,NaN,-2.7291449347338794,4.849834007276717
2005-04-01T09:30:00-05:00,29.39999,29.5,29.02,29.25,1704800,2086815.1,53.9900204577355,49.59746789744651,NaN,NaN,11.913445410610613,-71.42670657245341,-0.03014893199849955,-0.018297932344470524,0.011850999654029026,39108230,37074230,22.796814876328057,30.959896182360982,NaN,NaN,-1.1112590491285237,3.9982492849331117
2005-04-04T09:30:00-04:00,29.49001,29.49001,29.06,29.33,1674500,2085030.1,55.1232107440346,49.236601870787524,NaN,NaN,22.704988861429236,-47.1980473659453,-0.0009407854477695207,0.010675017844317125,0.011615803292086646,40782730,37877670,26.97916458517271,28.535424699087276,NaN,NaN,0.5410592143360572,3.5043649891335327
2005-04-05T09:30:00-04:00,29.3,29.52,29.27,29.5,1223500,2089720.1,57.517645455853774,49.22115743905526,NaN,NaN,57.76614662967534,-7.564347700315155,0.02815873626979723,0.046814223629333185,0.018655487359535955,42006230,39186950,33.3186402674704,27.07906277971291,NaN,NaN,2.6471786129555515,3.3819097925366783
2005-04-06T09:30:00-04:00,29.58,29.69,29.39999,29.41,760600,2039655.1,55.819611755553304,49.427556767017386,NaN,NaN,77.98777470446818,27.05334909755441,0.03900795698475201,0.06741543359047597,0.028407476605723958,41245630,40109250,37.43899509482204,26.335192257067067,NaN,NaN,3.908075975881247,3.457076390157331
2005-04-07T09:30:00-04:00,29.5,29.72,29.44,29.67999,1010500,1876315.05,59.66643044847785,49.72917585332261,NaN,NaN,98.23592189179303,53.72165549959527,0.06073432229424709,0.10432537947353282,0.04359105717928573,42256130,41079790,41.53316330020679,26.333234461615515,NaN,NaN,6.154925490745608,3.842483404527085
2005-04-08T09:30:00-04:00,29.8,29.8,29.39,29.45,1059800,1809340.05,55.25302141951346,50.09146282063813,NaN,NaN,78.9949079913165,67.13794801573644,0.056093357778293794,0.11370775440215297,0.05761439662385918,41196330,41497410,43.25403881409354,26.803585022906134,NaN,NaN,6.792302198369844,4.2638860893617645
2005-04-11T09:30:00-04:00,29.63,29.82001,29.42,29.74001,1468500,1794945.05,59.33741692202272,50.75728461068872,NaN,NaN,95.26302488477171,81.64955522040493,0.06822648585286328,0.14289750393993828,0.07467101808707499,42664830,41873830,44.830259009147206,27.738662173253772,NaN,NaN,8.592571842637305,4.882269768401128
2005-04-12T09:30:00-04:00,29.89999,30.10001,29.47,30.02,769600,1805760.05,62.86191894059641,52.29201799627883,NaN,NaN,127.59987579351447,95.61630105317276,0.08944229661877215,0.18647388886054017,0.09703159224176802,43434430,42159470,46.054779124977955,29.083431306402524,NaN,NaN,11.240713365069038,5.7906188536394
2005-04-13T09:30:00-04:00,30.10001,30.10001,29.75999,29.81,678200,1712115.05,58.74887090219978,53.65791402638831,NaN,NaN,127.40950972333165,105.50064805694547,0.08376491489666613,0.2017377358626007,0.11797282096593456,42756230,42461590,47.3849878403289,30.8406395319495,NaN,NaN,12.218926257749164,6.708948482797938
2005-04-14T09:30:00-04:00,29.71001,29.89999,29.5,29.53,784000,1548890.05,53.703403783285246,54.28007256927314,NaN,NaN,75.918064978165,101.03707667421985,0.05687086520990528,0.18906140247831615,0.13219053726841087,41972230,42404810,47.149674737774255,32.7965250383273,NaN,NaN,11.493768651165306,7.3924942211361335
2005-04-15T09:30:00-04:00,29.44,29.63,28.96001,29.00999,1170100,1565715.05,45.83112104445416,54.27822028608513,NaN,NaN,-2.1725616022096483,84.80358275551463,0.0026419519044678375,0.13549297714899566,0.13285102524452783,40802130,42325970,46.80213305932049,34.870042783887094,NaN,NaN,8.208646161316079,7.509087355447554
2005-04-18T09:30:00-04:00,28.99001,29.25999,28.8,29.12,989500,1547595.05,47.58172048782876,54.75697816942803,NaN,NaN,-26.50876925976226,60.44922392660784,-0.025676772092740635,0.10075506012860203,0.12643183222134266,41791630,42151330,45.993399446527,37.015490551590396,NaN,NaN,6.13601705450773,7.312934455313293
2005-04-19T09:30:00-04:00,29.2,29.55,29,29.53,804800,1541490.05,53.60023233305722,55.11680435872642,NaN,NaN,26.253335112189394,40.179915790342825,-0.017067793562793532,0.10509709026785075,0.12216488383064428,42596430,41983730,45.186419483583144,39.153399209710024,NaN,NaN,6.299326113615443,7.168133263642171
2005-04-20T09:30:00-04:00,29.60001,29.60001,29.25999,29.27,779400,1394855.05,49.702943100242926,54.90982627106114,NaN,NaN,25.24867858022526,19.74774956172154,-0.028483477181352426,0.08656053735395375,0.11504401453530617,41817030,41795890,44.249347695847554,40.92655838111431,NaN,NaN,5.16693621764499,6.882247971356859
2005-04-21T09:30:00-04:00,29.11,29.63,29.11,29.53,3848200,1258600,53.355375995038024,54.86449452372562,NaN,NaN,27.80664885257588,10.125466336603719,-0.01860169730231767,0.09179189290740908,0.11039359020972675,45665230,42534490,48.74989756169749,42.78035000149784,NaN,NaN,5.401404062527839,6.670698841524143
2005-04-22T09:30:00-04:00,29.64999,29.75,29.48,29.72,2159000,1247615,55.87694129590184,54.91833242028756,NaN,NaN,72.14222726142434,24.98842410933052,-0.0003139385698987668,0.1100011669973533,0.11031510556725206,47824230,43938910,56.0200388612111,44.85469816407201,NaN,NaN,6.3907908123567,6.630711980214508
2005-04-25T09:30:00-04:00,29.89999,29.97,29.75,29.92,647300,1239080,58.424737581375005,54.983124714967644,NaN,NaN,117.81916949088861,53.8540118594607,0.02292274249278753,0.13896853368323647,0.11604579119044894,48471530,45274890,61.60040160690839,46.87482397403187,NaN,NaN,8.006539133408227,6.827258716385039
2005-04-26T09:30:00-04:00,29.98,29.98,29.53999,29.53999,1247900,1236190,52.2510604769345,54.72822819506631,NaN,NaN,64.81314686098015,61.56597420921885,0.010976078219609733,0.1297658889649611,0.11878981074535137,47223630,46200330,64.92080047881112,48.83781007288824,NaN,NaN,7.4484800271860125,6.916004617928035
2005-04-27T09:30:00-04:00,29.7,29.89999,29.32001,29.75999,575700,1206260,55.20236846380729,54.40936662473269,NaN,NaN,50.92950558213674,66.70213960960115,0.015869658351445506,0.13862688368465825,0.12275722533321275,47799330,47396790,68.69024878974672,50.77760189356966,NaN,NaN,7.913061613295795,7.058441331552001
2005-04-28T09:30:00-04:00,29.89,29.89999,29.53,29.63,2233000,1279445,53.11342328626069,54.256538186643205,NaN,NaN,53.39776620883601,71.82036308085317,0.008690133548799939,0.13361989226921267,0.12492975872041273,45566330,47377010,68.55908742324544,52.585105365651934,NaN,NaN,7.6579900907363,7.1440911542926155
2005-04-29T09:30:00-04:00,29.55,30.06,29.55,30.05,940500,1241230,58.568757016462044,54.20163390767459,NaN,NaN,112.72011378916662,79.93594038640163,0.029399053372773543,0.16167857543637965,0.1322795220636061,46506830,47113530,66.73121481262619,54.149459351614716,NaN,NaN,9.164374923347559,7.432703121300465
2005-05-02T09:30:00-04:00,30.22,30.3,30.03999,30.13,1095700,1212290,59.534546757144966,53.96396446599948,NaN,NaN,185.1970385470553,93.41151419763496,0.04473730211525653,0.18820114970767676,0.14346384759242023,47602530,46939730,65.49085311807639,55.53775035112175,NaN,NaN,10.672117478625708,7.895476600918356
2005-05-03T09:30:00-04:00,30.3,30.3,29.89,29.98,2295300,1265880,56.85825117012877,53.82892019942299,NaN,NaN,136.16577064357912,107.68203895415476,0.041125233887707446,0.19487038995205452,0.15374515606434708,45307230,46556450,62.72205883702792,56.63325542231454,NaN,NaN,11.138350789313542,8.358744342117669
2005-05-04T09:30:00-04:00,30.17999,30.17999,29.78999,30.00999,1495700,1302635,57.27182142584147,54.08380717389128,NaN,NaN,103.44955662407203,118.1860491625418,0.037217633280865636,0.2002671976654291,0.16304956438456347,46802930,46357170,61.271612742069266,57.64196527976418,NaN,NaN,11.635184441222984,8.826807213418428
2005-05-05T09:30:00-04:00,30.2,30.2,29.61,29.89,1048100,1304515,55.00003355866183,54.73872949633469,NaN,NaN,66.66726998719118,120.83994991821285,0.023673441850943944,0.1926413666982434,0.16896792484729944,45754830,46394870,61.45321938015149,58.68847144553782,NaN,NaN,11.426878511099936,9.198245970230072
2005-05-06T09:30:00-04:00,29.8,29.99001,29.78999,29.82001,1499600,1326505,53.662894730512285,55.1730990850978,NaN,NaN,51.13054982667811,108.52203712571516,0.007936157508628167,0.17888812173308466,0.1709519642244565,44255230,45944550,57.95719666172144,59.543028389480284,NaN,NaN,10.889825278709392,9.439900157155689
2005-05-09T09:30:00-04:00,29.82001,30.08,29.63,30.07001,3138100,1409985,57.625717100333034,55.46063371133179,NaN,NaN,62.293025583597675,83.94123453302362,0.012052185602684673,0.18601719622781232,0.17396501062512765,47393330,45902710,57.629156518023656,60.431795320511746,NaN,NaN,11.51027340310982,9.735667763720565
2005-05-10T09:30:00-04:00,30.10001,30.10001,29.81799,29.85001,838200,1413415,53.30541247359696,55.71795295228564,NaN,NaN,59.549351260676666,68.61795065644313,-0.0016256550480216736,0.17193294181510055,0.17355859686312222,46555130,46152290,59.1157044913734,61.4936779487636,NaN,NaN,10.830252309108985,9.892036984490339
2005-05-11T09:30:00-04:00,30,30.03999,29.71001,29.99001,685300,1413770,55.58730503477922,55.87737645512429,NaN,NaN,56.31347218893095,59.190733769414905,-0.00276126872389984,0.17010701095824743,0.17286827968214727,47240430,46239790,59.65019040664874,62.27227029483155,NaN,NaN,10.889210780038415,10.034490383854349
2005-05-12T09:30:00-04:00,30.08,30.08,29.64,29.64999,781500,1413645,49.28750719301372,55.406702590632285,NaN,NaN,19.705650858063745,49.79840994358942,-0.026603588265656897,0.13961379435007615,0.16621738261573304,46458930,46380610,60.54417864566011,62.59542313657791,NaN,NaN,9.072082554846956,9.897003551139008
2005-05-13T09:30:00-04:00,29.56,29.95,28.7,29.17,2051500,1457715,42.04373627865877,54.236631069009704,NaN,NaN,-128.5427080621958,13.863758365814647,-0.07230010079975288,0.07584225661604194,0.14814235741579482,44407430,46411050,60.746635365309665,62.53443983360658,NaN,NaN,5.064785562478881,9.206686695616133
2005-05-16T09:30:00-04:00,29.17999,29.36,29.02,29.36,2995700,1558025,45.46072325108209,53.75160698144881,NaN,NaN,-145.2091610669217,-27.636678964289228,-0.0863769282827051,0.040171197062413455,0.12654812534511856,47403130,46413010,60.760597107168095,62.23728244991779,NaN,NaN,2.8122951840309764,8.293202193961111
2005-05-17T09:30:00-04:00,29.5,29.74001,29.25999,29.7,767200,1556145,51.025214745342566,53.45323885870133,NaN,NaN,-55.539403696079326,-50.654429955640424,-0.07012769912872563,0.03888850143421152,0.10901620056293715,48170330,46736050,63.09074208273971,61.837317685131566,NaN,NaN,2.654517646883492,7.48767583009288
2005-05-18T09:30:00-04:00,29.89,29.96001,29.67999,29.71001,1267400,1580545,51.18313065149663,53.315360813361046,NaN,NaN,6.919690636014178,-60.53318626622378,-0.05662185230239328,0.03823888518494556,0.09486073748733884,49437730,47175510,66.0447722955009,61.65772374743553,NaN,NaN,2.5777364480649045,6.786255918374598
2005-05-19T09:30:00-04:00,29.82001,29.92,29.7,29.88,489200,1412595,53.9015333701783,52.981987695769355,NaN,NaN,19.152389535460337,-60.64383853074446,-0.03520490066650368,0.050854611654209236,0.08605951232071292,49926930,47869110,70.11078346285564,61.89912150816621,NaN,NaN,3.3263549717803724,6.2919843545754235
2005-05-20T09:30:00-04:00,29.50999,29.92,29.50999,29.87,868500,1348070,53.71204747461767,52.56609488987455,NaN,NaN,-9.356846948498779,-36.806666308005056,-0.021358436014841914,0.05936146730216052,0.08071990331700243,49058430,48799310,74.51785271964101,62.543907193992254,NaN,NaN,3.8796685200501537,5.947367806786099
2005-05-23T09:30:00-04:00,29.72,29.87,29.64999,29.75999,629200,1347165,51.56449689375916,52.18796958441958,NaN,NaN,-9.771112244654681,-9.719056543551652,-0.019316584859784783,0.05657417224227146,0.07589075710205624,48429230,49004530,75.38032604628731,63.448069137510785,NaN,NaN,3.754547642635766,5.634107783336051
2005-05-24T09:30:00-04:00,29.7807,29.85001,29.64999,29.75999,452200,1307380,51.56449689375916,51.78030354641369,NaN,NaN,-14.19483899243201,-1.45014360282219,-0.017716066361763677,0.05374567414985165,0.07146174051161533,48429230,49056310,75.6046848574939,64.47186000289825,NaN,NaN,3.651197006924022,5.35083481527719
2005-05-25T09:30:00-04:00,29.83,29.88,29.67,29.84,398800,1298535,53.14469640237507,51.64777946382178,NaN,NaN,1.185322698712792,-2.5970171902824655,-0.011329638666651556,0.05729969217830089,0.06862933084495244,48828030,48934370,73.89681266389157,65.36068809459398,NaN,NaN,3.975687456385742,5.154385192578411
2005-05-26T09:30:00-04:00,29.72,29.99001,29.72,29.92,880300,1230900,54.7348620086274,51.72434855511572,NaN,NaN,32.653849883944474,0.10327487941435969,-0.0022530985364877937,0.0658129576743427,0.06806605621083049,49708330,48890650,73.25784417625191,66.45359148848901,NaN,NaN,4.668872298240094,5.085026207672938
2005-05-27T09:30:00-04:00,29.92,30.07001,29.85001,30.03999,1425100,1255130,57.08725381107599,51.685886891597356,NaN,NaN,77.16731068867308,17.40810640684873,0.010590948363319183,0.08130474166497947,0.07071379330166029,51133430,49305650,75.42963488393877,67.72505422891152,NaN,NaN,5.895370176431447,5.200789631781296
2005-05-31T09:30:00-04:00,30.12,30.23,29.95,30.03,1543500,1277520,56.8224823758844,51.93710617033217,NaN,NaN,118.12010694039532,42.98635024385873,0.01680393049866788,0.09171870642499513,0.07491477592632725,49589930,49537790,76.57561308183959,68.97219055680196,NaN,NaN,6.866108171562328,5.438692280321444
2005-06-01T09:30:00-04:00,30.14,30.56,30.05,30.42,2130300,1269270,63.86793043727706,52.52857941336773,NaN,NaN,214.7293793261283,88.77119390757079,0.04402312270845818,0.12994367931189998,0.0859205566034418,51720230,50195990,79.49573822767431,70.38972968687521,NaN,NaN,9.825986604481585,6.065448612344321
2005-06-02T09:30:00-04:00,30.5,30.5,30.35001,30.38,1388500,1263910,62.73720750777853,53.489272292993796,NaN,NaN,208.70253940885027,130.2746372495983,0.055439792358565734,0.15522029705164897,0.09978050469308324,50331730,50496730,80.68079840987592,71.82805967003348,NaN,NaN,11.989257882218944,6.9117070794692665
2005-06-03T09:30:00-04:00,30.42,30.53999,30.22,30.48,1163900,1269700,64.43252514695534,55.08847149787211,NaN,NaN,175.7841338024223,158.90069403329386,0.06516138075915846,0.1812322306420313,0.11607084988287285,51495630,50854190,82.01158982133092,73.34698498832071,NaN,NaN,14.321332721248039,7.970225028294806
2005-06-06T09:30:00-04:00,30.5,30.5,30.3,30.45,929200,1241180,63.49916419091499,56.37693156500304,NaN,NaN,147.42447803494346,172.95212750254794,0.06486609107977392,0.19715346373259024,0.13228737265281632,50566430,50740790,80.1259264455784,74.73022279820717,NaN,NaN,16.041565684297574,9.123273693438058
2005-06-07T09:30:00-04:00,30.45,30.86,30.45,30.52,3105300,1239540,64.78114401738769,57.35949794157769,NaN,NaN,164.85118081965533,182.29834227839993,0.06454181929111275,0.21296464676670723,0.1484228274755945,53671730,51557150,83.13262436884902,76.16178581864355,NaN,NaN,17.865637929850784,10.372182870068448
2005-06-08T09:30:00-04:00,30.60001,30.78,30.50999,30.58,1027700,1249015,65.88709278403076,58.40978095104442,NaN,NaN,138.71344063163573,167.0951545395014,0.06343110044101458,0.22771170302686272,0.16428060258584815,54699430,52152990,84.92523540245504,77.51039032628312,NaN,NaN,19.729720880785585,11.70897401445661
2005-06-09T09:30:00-04:00,30.55,30.61,30.35001,30.61,994600,1264480,66.45431228239049,59.30640801620243,NaN,NaN,101.97157332444493,145.74896132262035,0.059826575303091156,0.23906382171471208,0.17923724641162092,55694030,53225450,87.5002318670562,78.75249378372602,NaN,NaN,21.471394843472645,13.1036055614589
2005-06-10T09:30:00-04:00,30.59,30.82001,30.57001,30.72,1236600,1287235,68.52115451950738,60.3642013765517,NaN,NaN,117.59607520968622,134.11134960407313,0.05981699209956698,0.25400848653607966,0.19419149443651268,56930630,54312450,89.46455185665178,79.82011515065537,NaN,NaN,23.564950854663984,14.598083460488198
2005-06-13T09:30:00-04:00,30.8,30.89999,30.59,30.85001,478200,1208570,70.81027860353714,61.73890007010726,NaN,NaN,116.83950434281181,127.99435486564678,0.063201807650552,0.2731937539997027,0.2099919463491507,57408830,55680930,91.31498867906788,80.95830533871113,NaN,NaN,26.056647689974373,16.23502120755765
2005-06-14T09:30:00-04:00,30.88,31.06,30.82001,30.92999,1184800,1118025,72.15191608495792,63.20943001233575,NaN,NaN,130.2200628516066,121.06813127203705,0.06519988153126371,0.29149179826323035,0.22629191673196664,58593630,56665310,92.35514689376026,82.15476691273014,NaN,NaN,28.58796830709427,17.999727936062882
2005-06-15T09:30:00-04:00,30.91,31,30.60001,30.78,518900,1105610,66.02322726780449,64.12932507415213,NaN,NaN,96.16402767480841,112.55824868067157,0.05139927839747141,0.2905410147288059,0.23914173633133448,58074730,57340370,92.97637961431823,83.51759312347492,NaN,NaN,29.191609911021217,19.598568218199787
2005-06-16T09:30:00-04:00,30.95,30.95,30.56,30.73,1159100,1100195,64.06950226431925,64.79608509241584,NaN,NaN,81.07339244652721,108.37861250508801,0.03468379985556508,0.2824964861507908,0.24781268629522574,56915630,57584690,93.19200781248057,84.9414619546341,NaN,NaN,29.17715639033317,20.966937957075984
2005-06-17T09:30:00-04:00,30.72,30.95,30.57001,30.87,923300,1121900,67.01292853336267,65.50506185829346,NaN,NaN,84.32081636261124,101.72356073567303,0.029063891614237725,0.28414255081302286,0.25507865919878514,57838930,57766350,93.35535118902418,86.2218702621402,NaN,NaN,29.971026313565226,22.253236293717304
2005-06-20T09:30:00-04:00,30.94,30.95,30.64999,30.92999,1353900,1146170,68.21451300571994,66.31877833185315,NaN,NaN,88.3110576625875,96.01787139962816,0.02552078298680155,0.2869796379322871,0.26145885494548554,59192830,58123150,93.67627762602586,87.44334630101064,NaN,NaN,30.975159608170532,23.499225338639192
2005-06-21T09:30:00-04:00,30.85001,31.03,30.85001,30.97,746600,1152040,69.02490940764605,66.68713397259378,NaN,NaN,101.82686538873246,90.33923190705335,0.022131863782191397,0.2891236846732248,0.2669918208910334,59939430,58392310,93.9150377035598,88.47329626357389,NaN,NaN,32.044102690493645,24.719922103189827
2005-06-22T09:30:00-04:00,31.92,31.92,30.89999,31.25,1899500,1224405,74.01747858902195,67.49286762125404,NaN,NaN,173.5683245943563,105.8200912909629,0.03428239841051589,0.30984481890417825,0.27556242049366236,61838930,59145150,94.53639969811678,89.46298206987682,NaN,NaN,34.55367082894629,26.124743349726465
2005-06-23T09:30:00-04:00,31.3,31.5,31.17999,31.34,1358800,1272405,75.3905184103746,68.27558142578398,NaN,NaN,159.37423328175345,121.48025945800816,0.043332317903100326,0.3297278178725378,0.2863954999694375,63197730,60401570,95.38363455384169,90.41812812219902,NaN,NaN,37.08475834652767,27.690459777840925
2005-06-24T09:30:00-04:00,31.39999,31.44,31.09,31.12,908300,1273805,66.18354815264358,68.46732313733602,NaN,NaN,122.91195746727236,129.19848767894038,0.03008218126221579,0.3239982265472072,0.29391604528499143,62289430,61291670,95.87200834406737,91.54284825780537,NaN,NaN,36.49066822757803,28.947632413517653
2005-06-27T09:30:00-04:00,31.19,31.32001,31.02,31.31,906400,1247870,69.63276760768916,68.8138676795004,NaN,NaN,114.75362890994724,134.48700192841233,0.029646074307427495,0.33097363816927583,0.30132756386184834,63195830,62092270,96.25570153702857,92.48021091267533,NaN,NaN,37.06363086784682,30.107060764136104
2005-06-28T09:30:00-04:00,31.44,31.63,31.31,31.62,1109800,1226185,74.2480266309119,69.41107723999193,NaN,NaN,167.14954335751983,147.5515375221698,0.04485496461606581,0.3573962696319306,0.3125413050158648,64305630,62965510,96.62426811329536,93.31585610630678,NaN,NaN,39.153187224874955,31.399364544241653
2005-06-29T09:30:00-04:00,31.78,31.78,31.44,31.53,2351300,1237235,70.87996625447443,69.72719538085506,NaN,NaN,153.88599635283387,143.61507187386533,0.04344326188932379,0.3668453823775195,0.3234021204881957,61954330,62988590,96.6336997097416,93.96824666649859,NaN,NaN,39.708724436906834,32.58641595747954
2005-06-30T09:30:00-04:00,31.66,31.82001,31.53,31.56,2308200,1283220,71.34655602214872,69.92900977390087,NaN,NaN,142.2017675415975,140.18057872583412,0.03924720090867406,0.3724611216240383,0.33321392071536426,64262530,63201550,96.72463325357721,94.48682390913612,NaN,NaN,40.29305938029364,33.687365017881554
2005-07-01T09:30:00-04:00,31.71001,31.89,31.57001,31.85001,639600,1257005,75.44290322718862,70.25991153273313,NaN,NaN,143.4260142439275,144.28339008116515,0.05002970102618881,0.39575104699810026,0.34572134597191145,64902130,63724090,96.94285287025022,94.88881420850628,NaN,NaN,42.17108698474309,34.899325298861775
2005-07-05T09:30:00-04:00,31.82001,32.03,31.67,31.91,1088900,1264990,76.20083856839075,70.54912028154976,NaN,NaN,140.67542481202858,149.46774926158145,0.0548418697437415,0.4142736831515883,0.3594318134078468,65991030,64283130,97.1607938066321,95.23207470228284,NaN,NaN,43.91265228047253,36.186943439091884
2005-07-06T09:30:00-04:00,31.91,32.00999,31.37,31.37,1213300,1170390,58.6523370025145,70.02262811974333,NaN,NaN,80.00535977650098,132.03891254537766,0.017244732739955193,0.3809877293327908,0.3637429965928356,64777730,64377550,97.19713758276228,95.53355741431456,NaN,NaN,39.10838010787238,36.604291534631955
2005-07-07T09:30:00-04:00,31.16,31.67,31,31.62,2175800,1227795,62.91085108747162,69.93986732139707,NaN,NaN,47.04362652721092,110.67043858025306,0.0054138187446721164,0.37051027002367576,0.36509645127900364,66953530,65377390,97.55417209973679,95.84514057769,NaN,NaN,36.731132876661036,36.62241172635039
2005-07-08T09:30:00-04:00,31.67999,31.99001,31.60001,31.99001,1485300,1252330,68.1408276819596,70.0204315462968,NaN,NaN,117.38611677166838,105.70730842626725,0.017999288864451457,0.38759556235956794,0.3695962734951165,68438830,66212650,97.80564499062068,96.16301870637548,NaN,NaN,36.69848078141952,36.63327873421741
2005-07-11T09:30:00-04:00,32.10001,32.23,31.99001,32.17,1431700,1262085,70.3323957007355,70.17170888165506,NaN,NaN,151.12633619787044,107.24737281705582,0.03306106788457114,0.4109226083508304,0.37786154046625925,69870530,67206330,98.06105624972415,96.47621717949679,NaN,NaN,37.47405977445714,36.75339031139452
2005-07-12T09:30:00-04:00,32.35001,32.38,32.11,32.25999,1931100,1334730,71.39198778703921,70.34078590875457,NaN,NaN,153.92091605950418,109.89647106655093,0.04306644339983473,0.43169459471605265,0.3886281513162179,71801630,68368450,98.30895653577487,96.790068524655,NaN,NaN,38.43859806323782,36.99413427594356
2005-07-13T09:30:00-04:00,32.34,32.42,32.23,32.35001,1952500,1373115,72.4519174445639,70.22896011272186,NaN,NaN,148.17334082127812,123.53006727550637,0.04928182223342292,0.4502304291079966,0.4009486068745737,73754130,70163730,98.60556074982986,97.08072288549165,NaN,NaN,39.54998379060054,37.35925563518027
2005-07-14T09:30:00-04:00,32.53999,32.60001,31.85001,32.03,1502700,1422305,63.45190242984202,69.37620182839811,NaN,NaN,108.30522276044967,135.78238652215413,0.02651640420577739,0.4340941121317954,0.407577707926018,72251430,71223310,98.74542462256696,97.32085074754345,NaN,NaN,37.43914363530012,37.370668206625965
2005-07-15T09:30:00-04:00,32.03,32.14999,31.89999,32.02,1081800,1418440,63.1877543820953,69.16221655907323,NaN,NaN,77.61708093136376,127.8285793540932,0.006503462699130658,0.41570703629993133,0.4092035736008007,71169630,71769470,98.81159177152063,97.53082099236154,NaN,NaN,35.72214031047712,37.13516422146184
2005-07-18T09:30:00-04:00,32.02,32.09,31.92999,32,1046600,1424605,62.626223481663224,68.66174912149994,NaN,NaN,66.84261058674936,110.97183423186898,-0.011388167730065624,0.39496836393821866,0.4063565316682843,70123030,71819970,98.81780035689872,97.7138280509237,NaN,NaN,34.184841015901874,36.71368947781042
2005-07-19T09:30:00-04:00,32.00999,32.10001,31.87,32.03,1080600,1410940,63.15514775775011,67.86940063055982,NaN,NaN,58.48160786928089,91.88397259382432,-0.02379545351219936,0.3766122147780351,0.40040766829023444,71203630,71700370,97.5184145331118,97.77769565233915,NaN,NaN,33.078744388897555,36.194411607965726
2005-07-20T09:30:00-04:00,32.09,32.22,31.82001,32.2,945700,1420895,66.08428576060072,67.52685202385456,NaN,NaN,68.536059831312,75.9565163958311,-0.023126140309843835,0.3714999929029297,0.3946261332127735,72149330,71379410,93.94818806429642,97.58587339195022,NaN,NaN,32.95449961649168,35.73156703775515
2005-07-21T09:30:00-04:00,32.25,32.25,31.5,31.62,3780500,1514945,51.14499685527898,66.0838835119353,NaN,NaN,-0.0002764608033803531,54.29541655158049,-0.062106293415432834,0.31699326644348247,0.3790995598589153,68368830,70602890,85.76701040840301,96.80318604586634,NaN,NaN,27.732439921814585,34.588834592620785
2005-07-22T09:30:00-04:00,31.53,31.94,31.53,31.8,1204100,1507210,54.576919602372094,64.59345611016269,NaN,NaN,-13.862554238574377,35.99948951759289,-0.075251582520659,0.28503508170809155,0.36028666422875055,69572930,70283550,82.58208957864214,95.77741723932289,NaN,NaN,24.59996335021774,33.161852986563204
2005-07-25T09:30:00-04:00,32.02,32.16,31.81,31.81,1428600,1533225,54.767025584361974,63.06246946844635,NaN,NaN,22.981527980380857,27.227272996319194,-0.08219247086909576,0.25754607564238086,0.3397385465114766,71001530,70459250,82.9570844980856,94.76286657442672,NaN,NaN,22.218024144069588,31.598448866206972
2005-07-26T09:30:00-04:00,31.97,32.07001,31.83,31.92,3144800,1645145,56.90369158329543,62.93756622421642,NaN,NaN,18.93073075017508,19.317097572498035,-0.07831160853719155,0.24184903583998718,0.3201606443771787,74146330,71047790,84.18531212750707,93.8334504704799,NaN,NaN,20.893973191153194,30.069238055485005
2005-07-27T09:30:00-04:00,32.05,32.11,31.89,32.06,3962600,1787785,59.524264652918184,62.695667193176895,NaN,NaN,39.73472664362401,13.556830934960436,-0.06575830583606146,0.23796276208210188,0.30372106791816333,78108930,72239710,86.33339665685455,93.03196651027405,NaN,NaN,20.566714998154374,28.71173476158063
2005-07-28T09:30:00-04:00,32.09,32.28,31.92,32.25999,2608700,1800655,62.986680066003196,62.327513792037145,NaN,NaN,80.46263517686594,29.649413262494306,-0.04444905226257445,0.24815975258994527,0.2926088048525197,80717630,74709470,89.51222138387318,92.43957910979206,NaN,NaN,21.347918756101166,27.659761046512134
2005-07-29T09:30:00-04:00,32.46001,32.46001,32.23,32.27,3059000,1838195,63.15656505963697,61.8149544605301,NaN,NaN,129.22216097700354,58.26635630560988,-0.030791575988299846,0.2541193348671449,0.28491091085544473,83776630,77550210,91.8580481609851,91.99650710345358,NaN,NaN,22.025092254632415,26.85480836195789
2005-08-01T09:30:00-04:00,32.45,32.49001,31.8,31.85001,1967900,1904610,52.30836515154577,60.45183855799486,NaN,NaN,24.357633511192667,58.54157741177225,-0.050017448171240875,0.2223891006413936,0.2724065488126345,81808730,79711650,93.1191518175505,91.62580676643755,NaN,NaN,19.195342182956242,25.760598907814796
2005-08-02T09:30:00-04:00,31.95,32.59,31.89999,32.59,3258000,2013065,64.03128274680712,59.85036465101223,NaN,NaN,131.41260446231294,81.03795215419981,-0.014704900564676326,0.2540254231067891,0.26873032367146543,85066730,81895730,94.11164255472247,91.30481260964416,NaN,NaN,20.830902938103527,25.056356626427473
2005-08-03T09:30:00-04:00,32.59,33,32.39,32.67999,5275301,2216165.05,65.15307152280526,59.97187672908103,NaN,NaN,219.4560944290419,116.9822257112834,0.011492163845819081,0.2830955284787393,0.27160336463292023,90342031,84342350.2,94.98439403678705,91.03616756780274,NaN,NaN,22.472367429512563,24.687215312582484
2005-08-04T09:30:00-04:00,32.8,32.8,32.41,32.47,1674800,2191115.05,60.41784847077967,59.7740263068442,NaN,NaN,156.43728745191456,132.17715616629312,0.011432310822235003,0.28589375316071397,0.27446144233847897,88667231,85932270.4,95.4557530415362,90.79646480137527,NaN,NaN,22.168844385336506,24.32744803726163
2005-08-05T09:30:00-04:00,32.46001,32.46001,31.71001,31.91,2777700,2255735.05,49.98467325580276,58.87105843356846,NaN,NaN,-37.803707538856976,98.77198246312102,-0.027444608835317075,0.24015568129433262,0.2676002901296497,85889531,86354850.6,95.57478972300645,90.56482118466867,NaN,NaN,18.01255490054443,23.425320446302027
2005-08-08T09:30:00-04:00,31.88,32.05,31.17,31.25999,6976898,2532994.95,41.11062108234232,57.29644938532505,NaN,NaN,-196.07050349459064,54.686355061964356,-0.09429499758319917,0.14973154315065074,0.2440265407338499,78912633,85775631.2,92.01680030758442,90.17184873998816,NaN,NaN,10.855083849740224,21.629572361078914
2005-08-09T09:30:00-04:00,31.3,31.59,31.3,31.59,2814900,2577184.95,46.32113095175711,55.884795470407646,NaN,NaN,-172.61732929468104,-6.119631689434442,-0.11241670270955909,0.10350566234690106,0.21592236505646015,81727533,85107791.8,87.95127148754091,89.74349755593418,NaN,NaN,7.275787268145642,19.57903163351702
2005-08-10T09:30:00-04:00,31.5,32.08,31.42999,31.58,2820300,2620574.95,46.18777026322388,55.530707856689425,NaN,NaN,-102.35445672581044,-70.48174192040491,-0.12048866671560995,0.0653115316619477,0.18580019837755765,78907233,82820832.2,75.62854520663757,89.01932147009381,NaN,NaN,4.5951926550924425,17.438483208027794
2005-08-11T09:30:00-04:00,31.7,31.89999,31.47,31.77,1023900,2596634.95,49.18147532611699,55.14531897981406,NaN,NaN,-87.00930598942557,-119.17106060867293,-0.10880035118447695,0.04979975939696146,0.1586001105814384,79931133,81073612.6,67.81151467576446,87.96428040560254,NaN,NaN,3.4657445806523737,15.442377689831305
2005-08-12T09:30:00-04:00,31.75999,31.84,31.5,31.74001,1539000,2619494.95,48.72074216911367,54.71344159301061,NaN,NaN,-82.22891117082722,-128.05610133506698,-0.09913066592868586,0.03468677817058108,0.13381744409926694,78392133,79574133,61.898438085050564,86.46009137610005,NaN,NaN,2.4414593092452064,13.585103635461863
2005-08-15T09:30:00-04:00,31.78999,31.89,31.66,31.86,1073000,2620814.95,50.71030349501055,54.271056729561685,NaN,NaN,-47.093129877227604,-98.26062661159436,-0.08143580784252058,0.03202268429611621,0.11345849213863679,79465133,79684633,62.16029509217956,84.88687587357666,NaN,NaN,2.2109089822134638,11.960218684997805
2005-08-16T09:30:00-04:00,31.77,31.89,31.36,31.36,2012700,2667419.95,43.19039715807279,53.1043519085013,NaN,NaN,-104.77960337653788,-84.69308142796572,-0.09901922531142286,-0.01031553950064179,0.08870368581078107,77452433,78829613,58.79326001056826,82.91972325598478,NaN,NaN,-0.4512728155798118,10.187148470629575
2005-08-17T09:30:00-04:00,31.45,31.45,31.03999,31.33,2353100,2737789.95,42.78047840011057,51.661051789508974,NaN,NaN,-147.60286596632238,-93.74276327606813,-0.10757264380721082,-0.045762118948232455,0.061810524858978366,75099333,78068033,55.889321911509356,80.51808757938737,NaN,NaN,-2.6740267215663054,8.349837728887307
2005-08-18T09:30:00-04:00,31.2,31.5,31.06,31.45,1712300,2634379.95,45.02796486348285,50.36615177549796,NaN,NaN,-118.53394990908805,-100.04769206000063,-0.10020002016780824,-0.06343950035078194,0.0367605198170263,76811633,77444133,53.5556013562417,77.7821985219057,NaN,NaN,-3.83894310441365,6.608583324130027
2005-08-19T09:30:00-04:00,31.67,31.67,31.49001,31.64,931100,2620729.95,48.47858894845377,50.092596332419966,NaN,NaN,-59.16975749672661,-95.4358613251805,-0.07853613438905735,-0.061409648169295394,0.01712648621976196,77742733,77314253,53.058905795803966,74.92075237749522,NaN,NaN,-3.8027294244288212,5.121252931478763
2005-08-22T09:30:00-04:00,31.67,31.92999,31.60001,31.85001,1182800,2608439.95,52.06054293322236,49.237543488592486,NaN,NaN,-17.429662677754518,-89.50316788528589,-0.04759442787002362,-0.04236654861776756,0.005227879252256054,78925533,77206333,52.62219026329803,71.95722007096491,NaN,NaN,-2.6996753927008825,4.0039774565959565
2005-08-23T09:30:00-04:00,31.92,32.17999,31.87,32.11,3001600,2601279.95,56.1271263684166,48.59283312042187,NaN,NaN,34.57019868603621,-61.633207472771076,-0.009161494270628323,-0.00622398858602935,0.0029375056845989734,81927133,78101273,55.86624306393487,69.1630664300469,NaN,NaN,-0.5022185916897219,3.3602351639837167
2005-08-24T09:30:00-04:00,32.19,32.42,31.89999,31.96001,1690400,2487669.95,53.317204211369614,48.08564424474973,NaN,NaN,41.44293668864031,-23.824046941778533,0.005808992533519825,0.010198746351498755,0.00438975381797893,80236733,79128753,59.310967156362125,66.58129600967733,NaN,NaN,0.5086290071089615,2.9528628558587515
2005-08-25T09:30:00-04:00,32.38,32.38,32.00999,32.2,1308000,2422634.95,57.02450554568918,48.58848940831304,NaN,NaN,61.30577399710653,12.143897839460383,0.030163267240294167,0.04209383786834664,0.011930570628052473,81544733,80075373,62.23548601222206,64.19991717319273,NaN,NaN,2.5044913938824322,2.8888097898621345
2005-08-26T09:30:00-04:00,32.21001,32.3,32.00999,32.14999,871400,2313254.95,56.026025846532924,49.653875462898085,NaN,NaN,55.86164342354895,35.1501780235155,0.04054655639203046,0.06261376611809055,0.02206720972606009,80673333,80661493,63.962619187198506,62.19604709316517,NaN,NaN,3.8484547278928605,3.025901923866524
2005-08-29T09:30:00-04:00,32.05,32.33,31.87,32.28,1619600,2295839.95,58.0809406774121,50.493861871873435,NaN,NaN,55.01416853432113,49.63894426593063,0.05302483532264283,0.08834825387936363,0.0353234185567208,82292933,81334973,65.8928540343712,60.62044584651018,NaN,NaN,5.576353318098246,3.390252123042484
2005-08-30T09:30:00-04:00,32.2,32.35001,31.97,32.23,881900,2177034.95,56.9781716786883,51.264604830120895,NaN,NaN,63.3367584801716,55.392256224757716,0.05455340926969899,0.10351518014384453,0.04896177087414554,81411033,81231753,65.31542775788958,59.883794600171036,NaN,NaN,6.714257436908929,3.8651100250234047
2005-08-31T09:30:00-04:00,32.25999,32.56,32.17999,32.48,2116600,2019099.9,60.968601748132635,52.106542431693434,NaN,NaN,118.2439356458758,70.7524560162048,0.06815975078250008,0.13416145935227064,0.06600170856977056,83527633,81889933,67.28413928834016,59.84612492964074,NaN,NaN,8.874707607395836,4.580766822505181
2005-09-01T09:30:00-04:00,32.39999,33.03999,32.39999,32.99001,2580700,2064394.9,67.57587758891819,53.45333781882233,NaN,NaN,194.56707469980935,97.40471615674537,0.10506081702465146,0.1973277298505849,0.09226691282593343,86108333,82802653,69.84063736597682,60.41342487827832,NaN,NaN,13.037163011522527,5.788823420936231
2005-09-02T09:30:00-04:00,33.02,33.14999,32.91,33,1981300,2024574.9,67.69124946942239,54.66626253128032,NaN,NaN,194.72501146016978,125.17738976406955,0.122478587449087,0.24536514713729218,0.12288655968820518,88089633,84285913,73.4689592475273,61.221186603660314,NaN,NaN,16.380613658292788,7.301936311987167
2005-09-06T09:30:00-04:00,33.2,33.48,33.12,33.31,2030300,1777245,71.12475893314436,56.66157408664257,NaN,NaN,203.37083473868265,154.84872300494186,0.1456383210482608,0.30493446099853116,0.15929613995027037,90119933,85851313,76.660290096393,62.49740303836207,NaN,NaN,20.410894010104773,9.174644554575396
2005-09-07T09:30:00-04:00,33.33,33.39999,33.13,33.33,1543400,1713670,71.33640090149231,58.701282836741264,NaN,NaN,172.32075419918053,176.64552214874362,0.15234387271974087,0.34972598084994644,0.19738210813020557,91663333,87901773,80.04605614012489,64.22288405469176,NaN,NaN,23.714893722383657,11.251823007119434
2005-09-08T09:30:00-04:00,33.36,33.38,32.97,33.03999,1540800,1649695,64.00998513657169,60.05714142767618,NaN,NaN,129.14001905113415,178.8247388297953,0.12825340936836427,0.3576988698406609,0.22944546047229664,90122533,89220753,81.86816698960766,66.24521017136075,NaN,NaN,24.444184556075992,13.136446085541799
2005-09-09T09:30:00-04:00,33.14999,33.52,33.10001,33.42999,3424900,1769745,68.66990450519239,61.4993782531575,NaN,NaN,132.40312585995207,166.39194906182382,0.12922779642479598,0.39098020600329164,0.26175240957849566,93547433,90708573,83.67866702848035,68.43233597369479,NaN,NaN,26.583768211849605,15.057492103585771
2005-09-12T09:30:00-04:00,33.59,33.75,33.22,33.39999,1187700,1752180,67.94116768406383,62.63370859250332,NaN,NaN,123.57503212474086,152.16195319473803,0.118763312058834,0.4102065496520382,0.2914432375932042,92359733,91562593,84.62752859104894,70.71843156853414,NaN,NaN,28.068220131736716,16.91616753617876
2005-09-13T09:30:00-04:00,33.52,33.52,33.11,33.11,1755900,1786325,61.182263902422335,62.994789844932306,NaN,NaN,88.26899951136556,129.14158614927462,0.08481509022780265,0.3974621003779575,0.31264701015015484,90603833,91659373,84.73582717140646,72.78054471906782,NaN,NaN,27.26876197544254,18.39510959893073
2005-09-14T09:30:00-04:00,33.2,33.38,33.10001,33.23,702900,1720835,62.83011288021835,63.67428332127865,NaN,NaN,77.48461475527573,110.17435826049366,0.06389863183606775,0.3925202999452395,0.32862166810917176,91306733,91588053,84.26470323996139,74.56295443932491,NaN,NaN,27.10111744998888,19.638825006224753
2005-09-15T09:30:00-04:00,33.42999,33.57001,33.39999,33.53999,1691700,1687765,66.75611149707669,64.36939803209204,NaN,NaN,95.66920584212632,103.48019561869212,0.06422578565397419,0.40890390017663947,0.3446781145226653,92998433,92163233,84.9895384215342,76.18824389713292,NaN,NaN,28.17169085964401,20.857805842427503
2005-09-16T09:30:00-04:00,33.5,33.60001,33.19,33.59,1656800,1684990,67.35516719391592,65.17862241404796,NaN,NaN,83.94777261812804,93.78912497032731,0.06111317430763269,0.42106958240720616,0.35995640809957347,94655233,92384793,85.27099410709486,77.71027067712554,NaN,NaN,29.21389391615835,22.051532710103338
2005-09-19T09:30:00-04:00,33.61,33.77,33.46001,33.49001,1058900,1691380,64.83935360093918,65.6613661942999,NaN,NaN,90.59523940305945,87.19316642599104,0.046295814166965044,0.41782617580827974,0.3715303616413147,93596333,92632113,85.59567845356149,79.11761527849626,NaN,NaN,29.352815461566973,23.094573103169573
2005-09-20T09:30:00-04:00,33.58,33.67,33.28,33.36,1431900,1703835,61.616719582624775,65.99269104458108,NaN,NaN,68.85134454898797,83.30963543351551,0.02289757095080447,0.40015232532982026,0.3772547543790158,92164433,92944233,86.01467226377879,80.59613274320263,NaN,NaN,28.543482868873348,23.872988783984397
2005-09-21T09:30:00-04:00,33.34,33.39999,32.5,32.78,2692900,1688400,49.7396134987346,65.19062045533836,NaN,NaN,-7.386548102195437,66.33540286202127,-0.03342192770179431,0.33547734475177293,0.36889927245356724,89471533,92577193,82.95867413854724,81.71574237536028,NaN,NaN,23.85982572092009,23.87110834640378
2005-09-22T09:30:00-04:00,32.62,32.72,32.3848,32.60001,2317700,1719765,46.72933465363581,63.70158167424677,NaN,NaN,-60.9777791989006,35.006005853815886,-0.08181959125082522,0.2666247833900357,0.3484443746408609,87153833,91408273,73.94789329703863,82.00911779900756,NaN,NaN,19.020927205533216,23.178225326279414
2005-09-23T09:30:00-04:00,32.61,32.73,32.45,32.67999,1850700,1746900,48.22871217235146,62.3114004387417,NaN,NaN,-59.79336422820967,6.257778484548342,-0.10593775507025904,0.21602218080303714,0.3219599358732962,89004533,90278133,66.43465056234348,81.50666717863727,NaN,NaN,15.565634966047973,22.090712417674922
2005-09-26T09:30:00-04:00,32.88,33.02,32.74001,32.95,720200,1739340,53.034704421765994,61.01925368792895,NaN,NaN,-22.46666650370017,-16.35460269680358,-0.10120496060239459,0.19545373512030295,0.29665869572269754,89724733,89503813,61.80152847889284,80.44532706310156,NaN,NaN,14.061736319306522,20.94371583219372
2005-09-27T09:30:00-04:00,32.95,33.06,32.67999,32.96001,1000800,1708400,53.20812612509416,59.72437691818623,NaN,NaN,-33.47043795475332,-36.81895919755184,-0.09499897133828161,0.1779099815498455,0.2729089528881271,90725533,89216033,60.123316439502204,79.02227422734279,NaN,NaN,12.911952897565024,19.796321127246763
2005-09-28T09:30:00-04:00,33.16,33.37,33.03999,33.3,1589900,1743800,58.776043795788546,59.35052396527315,NaN,NaN,28.320213746758775,-29.677606827761004,-0.0669198657500007,0.18925912070062623,0.2561789864506269,92315433,89784813,62.30219047629028,77.62470447639154,NaN,NaN,13.597961887583002,18.910841235866226
2005-09-29T09:30:00-04:00,33.22,33.77,33.16,33.63,1915300,1733735,63.3363176952653,58.96955347884978,NaN,NaN,91.24886011351929,0.767721034722976,-0.027088082266867763,0.22231888361704222,0.24940696588390998,94230733,91200193,67.11718214221533,76.44174127022976,NaN,NaN,15.667759780676857,18.447543885124887
2005-09-30T09:30:00-04:00,33.64999,33.78,33.46001,33.60001,1498300,1679615,62.65795078344402,58.59218084309123,NaN,NaN,108.717057631047,34.46980540657431,-0.004889977454413774,0.24329449406589276,0.24818447152030654,92732433,91945773,69.33882429224604,75.3496909631724,NaN,NaN,17.11175953958488,18.256717550047743
2005-10-03T09:30:00-04:00,33.8,33.99001,33.56,33.98,2568800,1708990,67.41951624989929,59.03769886791101,NaN,NaN,153.94569839934428,69.75227838718321,0.03126712891320621,0.2872683826618143,0.2560012537486081,95301233,93061073,72.34841380314641,74.4648757225824,NaN,NaN,19.936811699360955,18.49673099994963
2005-10-04T09:30:00-04:00,33.7,34.05,33.33,33.39,2918600,1753405,55.57099137347398,58.51919018885785,NaN,NaN,79.97293669779437,92.44095331769275,0.012304291924254473,0.2713816186539262,0.2590773267296717,92382633,93392493,73.19054196211427,73.67386420273617,NaN,NaN,18.40807065808501,18.484065236826112
2005-10-05T09:30:00-04:00,33.3,33.5,32.36,32.42,4343699,1893419.95,42.383090359778,56.77826010762222,NaN,NaN,-109.67113424183904,64.84268371997318,-0.06449135068118425,0.1784631383781914,0.24295448905937564,88038934,92537193.2,67.4790273131357,72.42311340927914,NaN,NaN,11.638685619396645,17.506153862907617
2005-10-06T09:30:00-04:00,32.3,32.44,31.45,31.99001,7534801,2193120,38.0700610262469,54.68646680993158,NaN,NaN,-221.6548105761656,2.261949582036209,-0.1389005554836134,0.06932879470485886,0.20822935018847227,80504133,89791873.2,53.14370537636349,70.12830707136976,NaN,NaN,4.6046041602910375,15.663075333962391
2005-10-07T09:30:00-04:00,32.06,32.33,31.92,32.27,1741900,2108970,42.195057783652494,53.06901710869681,NaN,NaN,-150.31272554538114,-49.544007053249416,-0.16228748641307011,0.00536999217213463,0.16765747858520474,82246033,87694593.2,45.237232434428066,67.24556092714595,NaN,NaN,0.7416495888434056,13.53144308465968
2005-10-10T09:30:00-04:00,32.53999,32.69,31.60001,31.7,2172700,2158220,36.8184810797262,51.29771435848978,NaN,NaN,-149.95025299514367,-110.32319733214702,-0.20634315303971623,-0.09027146271444053,0.11607169032527569,80073333,84649013.2,36.69875287507716,63.722995256524406,NaN,NaN,-4.510874006676875,10.953969214468742
2005-10-11T09:30:00-04:00,31.8,32.06,31.69,31.77,2253200,2183085,37.86557209172232,50.44956854370319,NaN,NaN,-146.3575681282026,-155.58929829734637,-0.21973050931029392,-0.1585914463125917,0.06113906299770221,82326533,82637793.2,32.35557259996355,60.108488003768436,NaN,NaN,-8.06804424630119,8.236538720073037
2005-10-12T09:30:00-04:00,31.64,31.97,31.07001,31.17,4390602,2367470.1,32.84150616730456,49.45758079467952,NaN,NaN,-170.9587762492204,-167.84682669882267,-0.2554507999365329,-0.25817443692296393,-0.0027236369864310217,77935931,80617192.6,28.682877689240684,56.875272603211435,NaN,NaN,-12.929468452593254,5.212823409692138
2005-10-13T09:30:00-04:00,30.89999,31.05,30.27,30.50999,8538898,2709830,28.380660004657514,48.039862782701384,NaN,NaN,-209.65984993072948,-165.44783456973545,-0.3065438984567153,-0.38590351005732515,-0.07935961160060985,69397033,78395772.6,25.284821619631145,53.9359991073034,NaN,NaN,-18.70807923609408,1.7955516031512504
2005-10-14T09:30:00-04:00,30.60001,30.87,30.46001,30.86,4197301,2836855.05,33.53641821816008,46.64712805387239,NaN,NaN,-165.0691023770296,-168.39910993606514,-0.2994381981311154,-0.4536573592645041,-0.1542191611333887,73594334,76665432.8,22.999192258517894,51.1644036629909,NaN,NaN,-21.39900329496303,-1.5179562394365038
2005-10-17T09:30:00-04:00,30.66,31.39999,30.66,31.2,3449400,2956380.05,38.19116373628682,45.57448788324329,NaN,NaN,-115.39830292533287,-161.48871992210297,-0.25618344533091175,-0.47444846779702843,-0.21826502246611665,77043734,76059513,22.241018051998253,48.45852520674061,NaN,NaN,-21.904975247050167,-4.430387526238455
2005-10-18T09:30:00-04:00,31.38,31.38,30.53,30.67999,2329900,3001280.05,34.24131799418623,43.822007468843125,NaN,NaN,-116.53352909033258,-155.52391211452897,-0.24683858754736437,-0.5268132569003221,-0.27997466935295773,74713834,74536973.2,20.41947597625156,45.466902742452135,NaN,NaN,-23.711831974180654,-7.184879590230198
2005-10-19T09:30:00-04:00,30.60001,30.78999,30.00999,30.75999,6809398,3207104.95,35.3491012198768,41.82292057774395,NaN,NaN,-124.60696164463762,-146.2535491936124,-0.2203838363645093,-0.5554544648085944,-0.3350706284440851,81523232,75254433.4,23.595033456407506,42.358177836323,NaN,NaN,-24.73724298478372,-9.692360075166416
2005-10-20T09:30:00-04:00,30.55,30.83,29.78999,29.95,3224400,3252439.95,29.863579916734935,39.48046551583615,NaN,NaN,-128.79101915690742,-130.079783038848,-0.24088652052304066,-0.6361787790978859,-0.39529225857484523,78298832,77034793.2,30.95751541989398,39.61665577401214,NaN,NaN,-27.570246771804914,-12.246343888971916
2005-10-21T09:30:00-04:00,29.7,30.5,29.00999,30.35001,2650900,3292449.95,35.21068584101501,37.179834772344414,NaN,NaN,-126.6810601629006,-122.40217459602222,-0.21197802852820707,-0.6602647942351041,-0.448286765706897,80949732,78505872.8,36.41011690411622,37.04963456693855,NaN,NaN,-28.018253492505245,-14.49947383233382
2005-10-24T09:30:00-04:00,30.14,31.17,30.14,31.13,2448300,3378854.95,44.15172196120434,36.36417267146801,NaN,NaN,-65.90466000381781,-112.50344601171919,-0.1288824227901894,-0.6093897941946338,-0.4805073714044444,83398032,79776732.4,40.76252835225508,34.73334788052004,NaN,NaN,-25.173064845995786,-16.024272548571243
2005-10-25T09:30:00-04:00,30.95,31.42999,30.86,31.17,4336398,3545634.85,44.574149741102374,36.520676912991185,NaN,NaN,-40.20128838395539,-97.23699787044376,-0.06311007683521119,-0.5593949674484584,-0.4962848906132472,87734430,82380851.6,48.53566421261087,33.38025051619684,NaN,NaN,-22.87217148326407,-17.002543824955932
2005-10-26T09:30:00-04:00,31.3,31.3,30.71001,30.78999,4446102,3688444.95,41.37249762572669,36.75656524152546,NaN,NaN,-48.66027134797196,-82.0476598111106,-0.038303725912629094,-0.5441645480040336,-0.5058608220914045,83288328,82733870.8,49.50302233033034,33.12020172719447,NaN,NaN,-22.0105113977816,-17.71796776393103
2005-10-27T09:30:00-04:00,30.62,30.94991,30.41,30.44,2217300,3703544.95,38.62105477071184,36.501279312029695,NaN,NaN,-65.22170563690817,-69.33379710711077,-0.038471348731851096,-0.5539500080062183,-0.5154786592743672,81071028,83288310,51.05896761182692,33.536039954151526,NaN,NaN,-22.180358653962188,-18.35545217679262
2005-10-28T09:30:00-04:00,30.27,31.12,30.27,31.05,3449200,3801089.95,45.432533862395395,37.116568796506066,NaN,NaN,-45.7177329449067,-53.141131663511985,0.00706861567303374,-0.506642889683075,-0.5137115053561088,84520228,84002409.2,53.064898639606064,34.70505036590359,NaN,NaN,-20.064515841385962,-18.599604128877385
2005-10-31T09:30:00-05:00,31.44,31.59,31.14999,31.45,2605100,3802904.95,49.39808707155231,37.94031986649393,NaN,NaN,12.187200442164356,-37.52275957431554,0.06545210985488764,-0.4318963680374992,-0.49734847789238684,87125328,84747868.4,55.1323086242601,36.33196008192477,NaN,NaN,-17.009233412584095,-18.372408312264056
2005-11-01T09:30:00-05:00,31.55,31.55,30.8,30.83,3345800,3824264.95,44.054019781411974,38.741213696073025,NaN,NaN,-9.96639045952308,-31.47577998942909,0.0635819247492827,-0.41787107195578344,-0.48145299670506614,83779528,83956888,52.4902988427012,38.03249016431481,NaN,NaN,-16.16939886956717,-18.057692677593074
2005-11-02T09:30:00-05:00,30.72,31,30.50999,30.95,4953699,3854764.95,45.287751109603214,39.94886306071201,NaN,NaN,-32.32536420620593,-28.208798561075888,0.07112409412488613,-0.3925478790489585,-0.4636719731738446,88733227,85045867.8,55.64195902887707,40.20085712211809,NaN,NaN,-15.11585453060106,-17.637430085165644
2005-11-03T09:30:00-05:00,30.81,31.17,30.78,30.92999,3935600,3674804.9,45.10911611184169,40.77548433883211,NaN,NaN,-5.765674357000421,-16.317592305094344,0.0750731546516415,-0.36983052985929277,-0.44490368451093426,84797627,85791187.6,57.709741933002974,42.68018209886702,NaN,NaN,-14.332695323517125,-17.165325119215854
2005-11-04T09:30:00-05:00,30.89999,31.27,30.82001,30.89,2902300,3732824.9,44.729392335902055,41.24250066737606,NaN,NaN,10.892132879166118,-4.995619140279776,0.07511692405543402,-0.3510075294416417,-0.42612445349707573,81895327,85266207.4,55.7387942301066,45.07288039730333,NaN,NaN,-13.80225524503299,-16.68488656576116
2005-11-07T09:30:00-05:00,31.60001,31.60001,30.71001,30.81,4170199,3832699.85,43.932656765012695,41.934739151006525,NaN,NaN,33.820357985052944,-0.668987631702074,0.06998608678308471,-0.3386418450182198,-0.4086279318013045,77725128,83386167.4,49.251622965688334,47.13231946797738,NaN,NaN,-13.576294854441809,-16.24080203557268
2005-11-08T09:30:00-05:00,30.64999,31.03,30.60001,30.8,1748100,3807444.85,43.82756631282407,42.54034380050276,NaN,NaN,-7.288035703710513,-0.13331668053956064,0.06618859728176779,-0.3258921851990948,-0.3920807824808626,75977028,81825667.4,44.61056604573924,48.63342893864394,NaN,NaN,-13.41569230242709,-15.837214930837597
2005-11-09T09:30:00-05:00,30.64999,31.25999,30.64999,31.07001,3232700,3749549.75,47.48065036640091,43.7987059754789,NaN,NaN,50.82330217824872,16.49641659635137,0.08114462185061366,-0.29065000516759554,-0.3717946270182092,79209728,79920967.6,39.69393167323008,49.257458671025084,NaN,NaN,-12.307206186910975,-15.332927967419508
2005-11-10T09:30:00-05:00,31.00999,31.19,30.53,30.92,2886500,3466929.85,45.702370162534535,44.54811199844458,NaN,NaN,14.835426858489496,20.616636839449352,0.08008132603737428,-0.27169296947149135,-0.35177429550886563,76323228,78226087.8,35.90211553851853,49.22117285919668,NaN,NaN,-11.814116195237183,-14.830240571393462
2005-11-11T09:30:00-05:00,30.89999,30.98,30.5,30.64,1847300,3349429.8,42.50258114383538,44.430316225775364,NaN,NaN,-36.55033970206386,11.128142323203358,0.06055499061751102,-0.2760805572369769,-0.3366355478544879,74475928,76742208,32.93568392281844,48.66211254280835,NaN,NaN,-12.229957959925407,-14.458771626898026
2005-11-14T09:30:00-05:00,30.5,30.8,30.41,30.44,2760700,3314994.8,40.330515050860384,44.12719946218665,NaN,NaN,-73.34622593619984,-10.3051744610472,0.035447378461961165,-0.29232632477703646,-0.3277737032389976,71715228,75540228,30.721375274293706,47.38966333292855,NaN,NaN,-13.175408410974763,-14.275434024623273
2005-11-15T09:30:00-05:00,30.60001,30.73,30.3,30.5,2324500,3314724.8,41.29969413536437,44.12199921287506,NaN,NaN,-74.3632519213334,-23.720217704571777,0.024669513540147625,-0.2969368113138131,-0.32160632485396073,74039728,75152768,30.020716067281498,45.99807002842506,NaN,NaN,-13.72361248539253,-14.196602376161739
2005-11-16T09:30:00-05:00,30.47,30.89,30.46001,30.78,3454900,3146999.9,45.72971065245245,44.62976034728511,NaN,NaN,-24.02155611466139,-38.6891893631538,0.03742190928828182,-0.27482893824360843,-0.31225084753189025,77494628,74809748,29.381831647048145,44.44970317379801,NaN,NaN,-13.03273232846994,-14.030335226491482
2005-11-17T09:30:00-05:00,30.81,31.27,30.81,31.23,3106800,3141119.9,51.9994611660136,45.09882658325783,NaN,NaN,83.07046675084796,-25.042181384682106,0.0750178256580466,-0.21847856545933197,-0.2934963911173786,80601428,75665388,33.200656702878646,43.03082874974605,NaN,NaN,-10.606343513457698,-13.541193553200943
2005-11-18T09:30:00-05:00,31.28,31.47,30.83,31.17,3201300,3168639.9,51.15093523046214,45.22403002317997,NaN,NaN,95.61969306817932,1.3918251693665298,0.09349635004783668,-0.1766259535575827,-0.2701223036054194,77400128,76250228,35.75785281383574,41.64693904900145,NaN,NaN,-8.820240327906825,-12.866771663873212
2005-11-21T09:30:00-05:00,31.25,31.36,31.10001,31.24001,1784700,3135459.9,52.132459188471046,45.80106140939847,NaN,NaN,110.084397585603,38.07794987372709,0.10710762610598629,-0.13623777097293654,-0.24334539707892283,79184828,77744148,41.87857990416882,40.888959124820566,NaN,NaN,-7.051182065548048,-12.035973149826761
2005-11-22T09:30:00-05:00,31.3,31.39,31.08,31.24001,2973600,3067320,52.132459188471046,46.289969129317605,NaN,NaN,107.65366699761128,74.48133365751603,0.1122426850321862,-0.10304204078869006,-0.21528472582087627,79184828,78773168,45.71514694775036,40.17990111902581,NaN,NaN,-5.5708860239988125,-11.112389274708482
2005-11-23T09:30:00-05:00,31.32001,31.73,31.21001,31.63,2901400,2990084.9,57.632212352448924,47.18447600364669,NaN,NaN,172.78281095140906,113.84220707073014,0.13642825392619815,-0.04474940841312858,-0.18117766233932672,82086228,79691488,48.953522863209365,39.554456899754825,NaN,NaN,-2.6790158033650684,-9.907621635945137
2005-11-25T09:30:00-05:00,31.64,31.75,31.61,31.75,298400,2894139.9,59.186110416143784,48.217098723663945,NaN,NaN,195.57963632722948,136.34404098600643,0.15374538727071776,0.011004071749070476,-0.1427413155216473,82384628,80048128,50.19612590536438,39.1585520194161,NaN,NaN,0.22011663517263377,-8.460801882928314
2005-11-28T09:30:00-05:00,31.62,31.8,31.50999,31.63,1760000,2809679.9,56.937223053043866,49.14599631566618,NaN,NaN,152.85699348568554,147.79150106950766,0.15018306937807344,0.044987521200944514,-0.10519554817712892,80624628,80693028,52.450171026080234,39.38701973801552,NaN,NaN,2.118829443338287,-6.949425979175942
2005-11-29T09:30:00-05:00,31.83,31.97,31.66,31.71001,1811200,2769984.9,58.08091075244144,50.16409234706742,NaN,NaN,167.85033306446482,159.34468816528005,0.14614253188869683,0.07748261668374212,-0.06865991520495471,82435828,81343228,54.6773447574423,40.10607536028003,NaN,NaN,4.042921009795319,-5.37909069503719
2005-11-30T09:30:00-05:00,31.92999,31.94,31.37,31.39999,2227000,2714044.9,52.28630978652945,50.50735373421945,NaN,NaN,102.31388191445541,158.27673114864885,0.11679017546203238,0.07732780412258577,-0.039462371339446606,80208828,81548028,55.386175044485206,41.22694988679825,NaN,NaN,4.210332071889863,-4.009173156904754
2005-12-01T09:30:00-05:00,31.46001,32.35001,30.46001,31.52,1811100,2556914.95,54.19154318260615,51.11372323565314,NaN,NaN,66.93259828100511,137.10668861456807,0.10028888186066068,0.08589873098637923,-0.014390150874281436,82019928,81534768,55.32584228211786,42.61435893991249,NaN,NaN,4.869470328086386,-2.7407955161917337
2005-12-02T09:30:00-05:00,31.58,31.61,31.39,31.57001,1564100,2438339.95,54.9979634773873,52.006250545192565,NaN,NaN,75.18772134861881,113.02830561884593,0.08801159543404877,0.09562434341827952,0.007612747984230759,83584028,81774648,56.254216843208496,44.27996843422607,NaN,NaN,5.638447779646881,-1.5437607596433602
2005-12-05T09:30:00-05:00,31.50999,31.73,31.32001,31.55,4298699,2508159.9,54.58391103084231,53.02435025804841,NaN,NaN,69.43913642415555,96.34473420653995,0.07435632146427779,0.100558149814578,0.02620182835030021,79285329,81506788.2,54.882701955817424,46.00577748290634,NaN,NaN,6.182034992955808,-0.4400756521291933
2005-12-06T09:30:00-05:00,31.60001,31.7,31.46001,31.46001,848800,2342089.95,52.663687196601366,53.83606404813678,NaN,NaN,64.23837038018122,75.62234166968322,0.05591775041295831,0.09609901636649809,0.04018126595353978,78436529,80706928.4,50.89253949172701,47.49662201322388,NaN,NaN,6.166392438420811,0.5037055036636644
2005-12-07T09:30:00-05:00,31.45,31.66,30.55,31.31,1566800,2333024.95,49.53535321475268,54.10789565972964,NaN,NaN,-10.772255832120974,53.005114120367956,0.03148989773506433,0.0795436381223702,0.048053740387305866,76869729,80039108.6,47.7697806539533,48.81004694228853,NaN,NaN,5.337800559306584,1.1942905116126528
2005-12-08T09:30:00-05:00,31.12,31.74001,31.12,31.64,1196300,2231204.95,55.761013649429984,54.37657797997367,NaN,NaN,51.01680178520514,49.82195482120795,0.035149972730218824,0.0919912063000794,0.05684123356986057,78066029,79248328.8,44.30320688288775,49.6030862408606,NaN,NaN,6.278803697743269,1.9206495382027406
2005-12-09T09:30:00-05:00,31.56,32.03999,31.55,32,1343800,2154069.95,61.3611165126213,55.10587664298503,NaN,NaN,112.94908569110342,57.37422768970488,0.058057565474588665,0.1294131904130964,0.07135562493850774,79409829,78413489,40.92656676836173,49.97228009475531,NaN,NaN,8.815742613613352,2.905662834689971
2005-12-12T09:30:00-05:00,31.97,32.12,31.69,31.7,2381500,2180779.95,55.101370980609495,55.31794177099493,NaN,NaN,100.55148086057933,63.59669657698963,0.04957629253791035,0.13332599061089567,0.08374969807298532,77028329,77962089,39.187407952035265,49.78005352674578,NaN,NaN,9.122468780751703,3.793777969841647
2005-12-13T09:30:00-05:00,31.67,32.17,31.67,32.17,1169500,2101219.95,61.694425827223576,56.00093938804868,NaN,NaN,132.6855883879184,77.28614017853707,0.07089229577836416,0.17236506779594052,0.10147277201757636,78197829,77914349,38.99865701196337,49.30030424561813,NaN,NaN,11.579912002169536,4.906082831602774
2005-12-14T09:30:00-05:00,32.2,32.58,32.17,32.53,1929300,2081459.95,65.83299183408067,56.58670935102237,NaN,NaN,226.75124570857966,124.79084048667718,0.10258571344253081,0.22970491382073988,0.12711920037820906,80127129,78565829,43.03123474992118,48.87728366609754,NaN,NaN,15.0894052849802,6.360843182085263
2005-12-15T09:30:00-05:00,32.58,32.73,32.45,32.60001,3138800,2065654.95,66.58898835308206,57.11548634651797,NaN,NaN,224.07719317623108,159.40291876488237,0.12038177417632992,0.27759641809862146,0.15721464392229154,83265929,79605809,48.84479003052022,48.780759675037245,NaN,NaN,18.10126701270606,8.038046586459663
2005-12-16T09:30:00-05:00,32.55,32.75,32.28999,32.31,774000,1949014.95,60.606653383483035,57.37758851297791,NaN,NaN,160.90337963192226,168.99377755304613,0.10528433217074823,0.28882005913572684,0.1835357269649786,82491929,80222229,51.973209512650314,48.74669099550653,NaN,NaN,18.727576933322663,9.565122350297234
2005-12-19T09:30:00-05:00,32.27,32.37,31.8,31.88,2274400,1902669.95,53.003204926011065,57.01489523966145,NaN,NaN,61.06726262382168,161.0969339056946,0.061187513710752706,0.2600201191034195,0.19883260539266678,80217529,80860069,55.0373371187715,48.77240473560148,NaN,NaN,16.6894900329956,10.582889162111286
2005-12-20T09:30:00-05:00,31.83,32.02,31.75999,31.92999,1399200,1883394.95,53.729962421345135,57.11801328500543,NaN,NaN,31.07506333965003,140.77482889604093,0.031718457725756544,0.23848067754986246,0.20676221982410592,81616729,81543849,58.12193936421159,48.96781647272479,NaN,NaN,15.317303555729852,11.259234075485367
2005-12-21T09:30:00-05:00,31.94,32.16,31.57001,31.64,3122600,1890844.95,48.996579810290825,56.746944472697194,NaN,NaN,-0.24047878783637178,95.37648399675774,-0.008806405642592802,0.1957542127708649,0.2045606184134577,78494129,81217249,56.14082121203753,49.02602925343334,NaN,NaN,12.613888029692866,11.45275606894358
2005-12-22T09:30:00-05:00,31.60001,31.82001,31.46001,31.78,1007700,1796159.95,51.230329930130736,56.47782779075029,NaN,NaN,-27.77656377790769,45.005732605929985,-0.026675425745544323,0.17121633623152732,0.19789176197707165,79501829,80464429,51.76122122469975,48.705100994968426,NaN,NaN,11.089397416597794,11.40084769003704
2005-12-23T09:30:00-05:00,31.74001,31.92,31.74001,31.84,899800,1826229.95,52.19660751544339,56.307306111078944,NaN,NaN,6.893985512269184,14.203853781999362,-0.0344520930596699,0.15482664565248427,0.18927873871215417,80401629,80046369,49.45399988713045,48.317336561490784,NaN,NaN,10.138342571770261,11.220489815998928
2005-12-27T09:30:00-05:00,31.62,31.84,31.62,31.78,2075000,1841979.95,51.106147083180254,56.19605324583457,NaN,NaN,-16.219408889192707,-1.2534805206035116,-0.04307499978527557,0.13543498898055972,0.1785099887658353,78326629,79668189,47.395883215878534,48.067575398930174,NaN,NaN,9.041839130398689,10.909254003770322
2005-12-28T09:30:00-05:00,31.83,31.85001,31.49001,31.62,6315000,2067169.95,48.21353607428876,56.10163773580143,NaN,NaN,-37.45404100658529,-14.959301389850584,-0.058059875704463915,0.1059351441352554,0.1639950198397193,72011629,77747169,38.60668776073458,47.41306876370027,NaN,NaN,7.270662567552185,10.38945522716773
2005-12-29T09:30:00-05:00,31.69,31.73,31.52,31.56,1360500,2023844.95,47.136112176863826,55.485573344903855,NaN,NaN,-50.55374814919423,-25.02195526212215,-0.06973268212254471,0.07682916718653843,0.14656184930908314,70651129,76178569,33.19378434867488,46.61953858268506,NaN,NaN,5.4912120923647825,9.689706207910167
2005-12-30T09:30:00-05:00,31.35001,31.5,31.28,31.39,2297600,2048169.95,44.12722054157004,54.254580775543054,NaN,NaN,-102.18480292734917,-39.90360309201045,-0.0855786478738618,0.03958853946675589,0.12516718734061769,68353529,73948909,27.328438031716573,45.64824367292469,NaN,NaN,3.0920462060937943,8.747183350507827
2006-01-03T09:30:00-05:00,31.59,32.08,31.28,32,3912200,2165574.95,55.1824241878277,54.26037029034435,NaN,NaN,-7.714706484884773,-42.82534149144124,-0.053236768511754004,0.05862122670092518,0.11185799521267918,72265729,72321729,23.996031659055106,44.56314536628326,NaN,NaN,4.244085905304015,8.10388371547871
2006-01-04T09:30:00-05:00,32.09,32.12,31.61011,32.05,4682398,2184759.9,55.951766850403786,53.85018036342865,NaN,NaN,24.195574528257026,-34.742344807951284,-0.028003650518594853,0.07685343206443562,0.10485708258303048,76948127,72046028.6,23.473741378977678,43.45422282106999,NaN,NaN,5.401909201261932,7.717887356304885
2006-01-05T09:30:00-05:00,31.97,32.2,31.8,31.84,1557000,2220169.9,51.92047633897311,52.85642925663525,NaN,NaN,24.823184395842322,-22.286899727465762,-0.02507769478135298,0.07350996410633925,0.09858765888769223,75391127,72721928.2,27.632335641965184,42.354301456215985,NaN,NaN,5.166570791001677,7.353413561261569
2006-01-06T09:30:00-05:00,32,32.19,31.84,32.17999,939100,2188784.9,57.286218995377496,52.19194573108492,NaN,NaN,50.54257428473039,-2.0676352406808407,-0.0011305855570534207,0.09717442694137546,0.09830501249842888,76330227,73857747.8,34.11202358535412,41.30196099584698,NaN,NaN,6.65757462970588,7.2540079996107565
2006-01-09T09:30:00-05:00,32.11,32.17,31.87,31.98,2000200,2228979.9,53.50370648770233,51.68459238138631,NaN,NaN,25.3959702752305,23.448519399835092,0.0002791431141758449,0.09865394139114869,0.09837479827697285,74330027,75053047.4,40.18208271520632,40.45973765317241,NaN,NaN,6.722152907958323,7.178028700803266
2006-01-10T09:30:00-05:00,31.81,32.10001,31.78999,32.03,2480300,2285804.9,54.315867254294595,51.778353976263695,NaN,NaN,13.085849468922135,27.60863059059647,0.003442119524099743,0.10267744768209752,0.09923532815799778,76810327,75961967,44.37835768028995,39.69838197899515,NaN,NaN,7.016603845335315,7.154968007164988
2006-01-11T09:30:00-05:00,31.91,32.09,31.88879,31.98,2358900,2284674.9,53.31300447439884,51.74857126576753,NaN,NaN,14.966172043002718,25.762750093545613,0.001148577532172429,0.10067105007321331,0.09952247254104088,74451427,75462627,42.60988410573458,38.59037803196109,NaN,NaN,6.971327099480182,7.128733591781444
2006-01-12T09:30:00-05:00,31.95,32.14,31.91,31.98,2024000,2327399.9,53.31300447439884,52.05688731320381,NaN,NaN,22.444077060817097,25.286928626540565,-0.0012565078722343026,0.097951837700748,0.0992083455729823,74451427,75274687,41.93257574332594,37.57550335562455,NaN,NaN,6.934232805820742,7.100947765215629
2006-01-13T09:30:00-05:00,31,32.22,31,32.2,1651500,2313509.9,57.33302856216934,52.492794358349435,NaN,NaN,-36.09378376112962,7.9596570173685635,0.010437321899974261,0.11225499794795013,0.10181767604797587,76102927,75229227,41.759662618917176,36.86110631235436,NaN,NaN,8.027845964333318,7.233361793661014
2006-01-17T09:30:00-05:00,32.2,32.55,32.00999,32.53999,7231398,2518139.8,62.68101931939458,53.241680915774516,NaN,NaN,175.44804694210367,37.970072350743195,0.037988761397337714,0.149303627794648,0.1113148663973103,83334325,77030086.6,50.472471402373195,36.93385427772885,NaN,NaN,10.638951956945387,7.71987467413021
2006-01-18T09:30:00-05:00,32.3,32.74001,32.3,32.61,8649500,2911914.8,63.690273203847205,54.14054706725073,NaN,NaN,236.19815715562999,82.59253388808477,0.05671907452336966,0.18221370955152238,0.12549463502815272,91983825,80064786.2,61.047665117224255,37.90898155639639,NaN,NaN,13.09018984703782,8.487062555974154
2006-01-19T09:30:00-05:00,32.94,32.99001,32.50999,32.89999,7795500,3187969.8,67.59901110170297,55.52522385492317,NaN,NaN,256.18312204313776,130.83592388811178,0.08284793801170859,0.22905455754278847,0.14620661953107988,99779325,85130365.8,71.85180763831133,40.2836329762233,NaN,NaN,16.473719174243826,9.628013501441249
2006-01-20T09:30:00-05:00,33,33.12,32.5,32.71001,4059100,3320964.8,62.827326881107616,56.64602490522629,NaN,NaN,196.63690639661564,165.6744897552715,0.08142496002173388,0.24798781955824722,0.16656285953651334,95720225,89384125.4,77.49644890479298,43.448109015946024,NaN,NaN,17.925829507702574,10.813415788050008
2006-01-23T09:30:00-05:00,33.64999,33.64999,32.56,32.66,6164398,3473054.7,61.59476478466083,57.89370663687564,NaN,NaN,186.84280710416496,210.26180792833037,0.07155459086871371,0.2560060981224055,0.18445150725369178,89555827,92074705.4,80.20095371287819,47.22471727888614,NaN,NaN,18.756040332762105,11.948076437294594
2006-01-24T09:30:00-05:00,32.77,32.97,32.67999,32.95,2206800,3533009.7,65.7864115739597,58.651134307313654,NaN,NaN,137.6390030977696,202.6999991594636,0.07844253813691385,0.2825046799248341,0.20406214178792023,91762627,93760365.8,81.68596451090161,51.345426768303746,NaN,NaN,20.76758751598732,13.208006591393554
2006-01-25T09:30:00-05:00,32.72,33.09,32.3,32.5,4167102,3696374.8,55.63865437571918,58.62876913055046,NaN,NaN,82.29265535788603,171.91889879991479,0.04806933826102572,0.26414881461420237,0.21607947635317665,87595525,92882705.8,78.38923969433372,55.267962362257755,NaN,NaN,19.2795462981026,14.075369406637703
2006-01-26T09:30:00-05:00,32.63,32.75,32.06,32.21001,3138300,3749539.8,50.25845695492325,58.51005346026119,NaN,NaN,28.604987332430117,126.40327185777328,0.006035691192570469,0.22362409034388975,0.21758839915131928,84457225,89818285.8,68.06071217286177,58.155703543036076,NaN,NaN,16.210504133496865,14.380388653331869
2006-01-27T09:30:00-05:00,32.38,32.60001,32.25011,32.39,2285100,3548044.8,53.278338518522595,58.223776283342985,NaN,NaN,35.55677702774174,94.1872459839985,-0.011123755959245363,0.20368370420226256,0.21480746016150792,86742325,88022705.8,62.836341255948234,60.20744051950708,NaN,NaN,14.672341410292855,14.42209619004058
2006-01-30T09:30:00-05:00,32.27,32.42999,32.16,32.17,1359500,3547994.8,49.335666554671846,57.92605914526938,NaN,NaN,1.9882875045732258,57.21634206408014,-0.03729408398279932,0.16818985518300877,0.2054839391658081,85382825,87188105.4,60.51129048157552,61.659526788533455,NaN,NaN,12.104517711974957,14.09101355031692
2006-01-31T09:30:00-05:00,32.19,32.34,32.07001,32.14999,2676800,3566954.8,48.98062970841903,57.5449707491354,NaN,NaN,-20.274045923985508,25.63373225972911,-0.05489247037945599,0.1368683511914881,0.1917608215709441,82706025,85376785,55.69472989953411,62.46783908990803,NaN,NaN,9.964076377063034,13.501451096994936
2006-02-01T09:30:00-05:00,32.28999,32.36,32,32.24001,2784600,3510574.8,50.699489477777796,57.358291106519616,NaN,NaN,-23.188942207052477,4.5374127467414045,-0.05904862474216585,0.11795004064323678,0.17699866538540263,85490625,84955805,54.60680664213883,63.32476212822262,NaN,NaN,8.698807948124745,12.81535921858491
2006-02-02T09:30:00-05:00,32.13,32.34,31.67999,31.82001,5531199,3553014.85,43.35965688121363,56.647337707006386,NaN,NaN,-80.51867237665897,-17.287319195076414,-0.08697527714607928,0.06827956895280352,0.1552548460988828,79959426,84056245.2,52.25777776624055,64.06227655843081,NaN,NaN,5.195048481946133,11.726743399065084
2006-02-03T09:30:00-05:00,31.83,31.8399,31.42999,31.66,2526500,3601489.85,40.928616613318574,55.47559399637419,NaN,NaN,-138.99469109167077,-52.197612818958916,-0.11154666727966717,0.01582151199929882,0.127368179278966,77432926,82194365.4,47.68548468209101,64.48554956294323,NaN,NaN,1.5250034984220782,10.269351984687512
2006-02-06T09:30:00-05:00,31.53999,31.94,31.53999,31.85001,2459100,3677489.85,44.88068238933101,54.2041413585125,NaN,NaN,-102.75680557704001,-73.14663143528156,-0.11013527504358538,-0.010300914525515736,0.09983436051806964,79892026,81096205.6,45.17487791231824,64.1071500279393,NaN,NaN,-0.34761195818842566,8.75264284999095
2006-02-07T09:30:00-05:00,31.72,32.2,31.56,31.66,1762100,3665584.85,41.86437033716776,52.64514829660682,NaN,NaN,-91.9381766454114,-87.47945757956674,-0.11651333373566469,-0.045807306651511226,0.07070602708415347,78129926,80180985.8,43.13651235589316,62.82778197355851,NaN,NaN,-2.860156270533447,7.093671547058894
2006-02-08T09:30:00-05:00,31.58,32.60001,31.52,31.64999,2053800,3644259.85,41.70535064890317,50.79560112140684,NaN,NaN,-67.5492546579269,-96.35152006974162,-0.11568658404389427,-0.07390220297071437,0.0417843810731799,76076126,78298086,39.21606534936162,60.49665752434782,NaN,NaN,-4.921563823435982,5.377209351273912
2006-02-09T09:30:00-05:00,31.58,31.95,31.57001,31.75999,3077200,3680174.85,44.21308744224465,49.466012590059485,NaN,NaN,-94.90560773377535,-99.22890714116491,-0.10246490866166622,-0.08629675475390286,0.01616815390776335,79153326,78136866,38.890148695062635,57.739064652224215,NaN,NaN,-5.946579017838866,3.7595252985435152
2006-02-10T09:30:00-05:00,31.7,32.03,31.59,31.78,3768300,3767389.85,44.67929578868422,48.257764804632586,NaN,NaN,-82.62084946215751,-87.95413881526224,-0.0876768493711779,-0.09342790780620902,-0.005751058435031126,82921626,79234606,42.400316579074826,55.03901914266684,NaN,NaN,-6.664531323955221,2.2703743524722677
2006-02-13T09:30:00-05:00,31.66,31.89,31.66,31.74001,1612600,3765444.85,43.88988838914009,46.693727434288334,NaN,NaN,-88.55584856718959,-85.11394741329215,-0.076311452051155,-0.10114037349897487,-0.024828921447819875,81309026,79518006,43.305717566981684,52.29757293238684,NaN,NaN,-7.477637955950211,0.8778011655547708
2006-02-14T09:30:00-05:00,31.86,31.86,31.3,31.71001,2703900,3539069.95,43.272215501296444,45.81041037182956,NaN,NaN,-101.87294399949036,-87.10090088410796,-0.06687563815719726,-0.10842346914431644,-0.041547830987119186,78605126,79613046,43.625749206104665,49.814466468941916,NaN,NaN,-8.325028504025168,-0.43688878724236324
2006-02-15T09:30:00-05:00,31.66,32,31.58,31.75999,2891300,3251159.95,44.66929131941122,45.411184255007264,NaN,NaN,-67.0760196214548,-87.00625387681353,-0.05388733086966896,-0.10890699457420538,-0.055019663704536426,81496426,80697106,47.281277159240275,48.33022111082609,NaN,NaN,-8.70177040825896,-1.6175861616733056
2006-02-16T09:30:00-05:00,31.62,32.7,31.62,32.00999,1194700,2921119.95,51.14992967090625,45.25915505160611,NaN,NaN,-3.4240314048112754,-68.70993861102073,-0.02646562883231094,-0.0881016997449251,-0.06163607091261416,82691126,81404666,49.57939358745478,47.38329627736226,NaN,NaN,-7.286723510636358,-2.4274629258108846
2006-02-17T09:30:00-05:00,32.45,32.45,31.64999,32.3,4265301,2931430,57.385379974253304,45.83413458157621,NaN,NaN,8.013429651510503,-50.58308278828713,0.011178819730805603,-0.04766254624910715,-0.058841365979912755,86956427,82211626.2,52.14173851016979,46.78547113654757,NaN,NaN,-4.12988061901692,-2.670665453411747
2006-02-21T09:30:00-05:00,32.36,32.60001,32.21001,32.35001,3302800,2788350.1,58.37214828139734,46.50495733678895,NaN,NaN,74.78179053178381,-17.91555496849245,0.037915585462920745,-0.011446884151261827,-0.04936246961418257,90259227,84001666.4,57.32282180581627,46.90176341556772,NaN,NaN,-1.2258913105983433,-2.4642691472955462
2006-02-22T09:30:00-05:00,32.53999,32.61,32.35001,32.47,1673800,2761700.1,60.72219585684525,47.22086493529377,NaN,NaN,107.78788021544949,24.01660987449552,0.060793584298575364,0.026629510759036634,-0.03416407353953873,91933027,86667246.6,63.63601127551522,47.54670660366604,NaN,NaN,1.9527903078240532,-1.8332606537070322
2006-02-23T09:30:00-05:00,32.5,32.56,32.32001,32.42999,1946200,2650655,59.51568217048402,48.374866741670225,NaN,NaN,103.95289081555758,58.222391961898,0.06970429321047733,0.05296629297355793,-0.016738000236919397,89986827,88365326.8,66.9864135970787,48.59875202015447,NaN,NaN,4.2867790155766,-0.9589692723807992
2006-02-24T09:30:00-05:00,33.38,33.38,32.39,32.53,1364500,2561965,61.571109782870536,49.84933053949536,NaN,NaN,170.23404395283802,92.95400703342787,0.07817034040792192,0.080974925272983,0.002804584865061084,91351327,90097367,70.02054022624509,50.19411313045119,NaN,NaN,6.877538022871987,0.1605317697981703
2006-02-27T09:30:00-05:00,32.62,32.92,32.62,32.78999,5540398,2724729.9,66.35357854004431,51.3831088359749,NaN,NaN,157.9131543131784,122.93395196576145,0.09594526191323174,0.12273616225660078,0.026790900343369027,96891725,92084426.6,73.07752697265525,52.18715949190384,NaN,NaN,10.688306426468518,1.6644995778939342
2006-02-28T09:30:00-05:00,32.83,32.97,32.42999,32.57001,1483500,2730929.9,59.59555913243279,52.649622321350975,NaN,NaN,118.18135050588286,131.61386396058126,0.08777377197268009,0.13650811530921914,0.048734343336539046,95408225,93114226.2,74.5272091244224,54.42935211822736,NaN,NaN,12.03474209781404,3.145962795025378
2006-03-01T09:30:00-05:00,32.28,32.69,32.28,32.48,1656500,2679914.9,57.035823869752036,53.744656122840176,NaN,NaN,74.82112435199438,125.02051278789024,0.07186226459405862,0.1385621740791123,0.0666999094850537,93751725,93477965.8,75.03848042057848,56.9880960518857,NaN,NaN,12.398191413414308,4.467709740509511
2006-03-02T09:30:00-05:00,32.00999,32.52,32.00999,32.46001,2392800,2660324.9,56.455865344401914,54.61914025870855,NaN,NaN,41.67082837117636,112.56410029901402,0.05623829592688494,0.13699777939365987,0.08075948346677493,91358925,93752385.4,75.4390058077434,59.59872870279146,NaN,NaN,12.530947020559221,5.619600780516612
2006-03-03T09:30:00-05:00,32.36,32.64999,32.22,32.3,2322500,2499889.95,51.90612279970636,55.13534218806727,NaN,NaN,48.323560936243624,88.18200369569513,0.03254965746840219,0.12144655530227766,0.08889689783387547,89036425,93289405,73.30199372401519,61.80599135600149,NaN,NaN,11.32796198676019,6.435080952837123
2006-03-06T09:30:00-05:00,32.35001,32.39999,31.60001,31.78,3958800,2571504.95,40.48696903969931,54.892276520250064,NaN,NaN,-46.12070913630957,47.375231005797524,-0.01799987025625474,0.06639706001355705,0.08439693026981179,85077625,90926585,63.42697876004794,63.243224298363366,NaN,NaN,6.23729006924635,6.406825112324156
2006-03-07T09:30:00-05:00,31.78,31.78,31.41,31.63,4174199,2657259.9,37.897010109806736,54.5083332780008,NaN,NaN,-106.48386143283149,2.442188618054652,-0.05908183226073371,0.010544639943894651,0.06962647220462836,80903426,88025625.2,53.83735729101367,63.972624875856866,NaN,NaN,1.2032471388643735,5.66345683040133
2006-03-08T09:30:00-05:00,31.46001,31.87,31.12,31.60001,3873000,2762804.9,37.38212364954986,53.98782130158213,NaN,NaN,-114.63821292775228,-35.449678837894695,-0.08428270587453116,-0.03572691013853557,0.048555795735995576,77030426,84681365.4,45.328986142814855,63.83317551754077,NaN,NaN,-2.9367216475818805,4.434859904975157
2006-03-09T09:30:00-05:00,31.56,32,31.45,31.50999,3044900,2812359.9,35.809405630166566,52.89206958438644,NaN,NaN,-85.34003722042172,-60.851851956214304,-0.10184742653919933,-0.07875348743800359,0.02309393910119574,73985526,81206685.6,38.5177882501961,63.04306085059371,NaN,NaN,-6.837979226351652,2.8244543147856134
2006-03-10T09:30:00-05:00,31.42999,31.78,31.42,31.71001,3386500,2827824.9,41.680508862386425,51.770293076395944,NaN,NaN,-85.80804080407724,-87.67817230427849,-0.09496337669028031,-0.09561028176165465,-0.0006469050713743402,77372026,78873805.8,34.7431217426725,61.800302510058195,NaN,NaN,-8.422104463887267,1.2178030606894876
2006-03-13T09:30:00-05:00,31.73,31.89999,31.64,31.75,2828800,2780849.9,42.80681198843654,50.658483341184464,NaN,NaN,-62.368116568983964,-90.92765379081337,-0.08311248439941864,-0.10453751057064764,-0.021425026171229003,80200826,77898446,33.274901532175235,60.082593919083834,NaN,NaN,-9.375667840839883,-0.2955499252432794
2006-03-14T09:30:00-05:00,31.71001,32.16,31.71001,32.09,1981000,2799269.9,51.4006005206277,49.992655102883205,NaN,NaN,-25.11482373892018,-74.6538462520311,-0.04943434736042639,-0.08321796037176199,-0.0337836130113356,82181826,78154126,34.0615445976331,57.97013201352082,NaN,NaN,-7.496453532879042,-1.3242504406198168
2006-03-15T09:30:00-05:00,32.00999,32.32001,31.74001,32.3,1290400,2728594.9,55.81655874925107,49.72843200136656,NaN,NaN,-5.429501220321109,-52.81210391054486,-0.012024405190494733,-0.04881411949945402,-0.03678971430895929,83472226,79442486,38.02634015235688,55.901555338897836,NaN,NaN,-4.449327670219145,-1.7706900448482923
2006-03-16T09:30:00-05:00,32.3,32.61,32.22,32.47,2416300,2704844.9,59.059655164132906,49.549042385742446,NaN,NaN,50.60790407734267,-25.622515650991964,0.023238168651897706,-0.007742003494087157,-0.030980172145984863,85888526,81823086,44.649121625694576,54.08931115314423,NaN,NaN,-0.8445259435171961,-1.6383808875152786
2006-03-17T09:30:00-05:00,32.35001,32.35001,32.05,32.14999,1572800,2723749.9,51.40991751845755,48.48163802705768,NaN,NaN,-0.10119589018036815,-8.481146668212595,0.0239820333043133,-0.0010026305155932391,-0.02498466381990654,84315726,83211826,48.13135131172043,52.30744146307745,NaN,NaN,-0.2352899577700118,-1.4379393261230975
2006-03-20T09:30:00-05:00,32.25,32.25,31.64,31.67999,1709100,2595939.85,42.6684977099012,47.272562211162565,NaN,NaN,-60.54828867277727,-8.117181088971252,-0.006575426140256687,-0.0332039464952274,-0.026628520354970712,82606626,83692986,49.320987843584135,50.50699708587472,NaN,NaN,-2.8759796007360046,-1.6433736510677985
2006-03-21T09:30:00-05:00,31.53999,31.69,31.3,31.44,2405200,2551059.85,39.02009043141768,45.9857241084244,NaN,NaN,-117.09613704853555,-26.51344375089433,-0.04045638902256425,-0.07719900663317603,-0.036742617610611775,80201426,83296906,48.33815977295657,48.5998313253303,NaN,NaN,-6.325793883014495,-2.312290827060184
2006-03-22T09:30:00-05:00,31.39999,31.69,31.27,31.59,2832700,2609004.85,42.338750769202285,44.977358781624424,NaN,NaN,-97.91575572073998,-45.0106946509781,-0.049663904406430995,-0.09882249811865051,-0.04915859371221952,83034126,83209286,48.1097661099178,46.64774277548561,NaN,NaN,-7.91381158859872,-3.112508078708546
2006-03-23T09:30:00-05:00,31.53999,31.59,31.39,31.55,2265000,2624944.85,41.68722376904821,44.24743742229169,NaN,NaN,-89.6414056553633,-73.06055659751931,-0.054936069772510365,-0.11782868092785748,-0.06289261115534711,80769126,82185406,45.409707826497566,44.65543663994864,NaN,NaN,-9.359530981170419,-4.004939921917385
2006-03-24T09:30:00-05:00,31.60001,31.64999,31.41,31.49001,1192000,2616319.85,40.67625237849121,44.26095766077684,NaN,NaN,-82.35179188186598,-89.51067579585643,-0.05861576305178837,-0.13616231497008258,-0.07754655191829421,79577126,81237686,43.00388702818776,43.196644373387194,NaN,NaN,-10.83043464077275,-4.98001059603958
2006-03-27T09:30:00-05:00,31.37,31.479,31.21001,31.28,1844000,2431499.95,37.26881938865353,44.21608689498017,NaN,NaN,-110.36273897192436,-99.47356585568585,-0.07054475882144248,-0.16572750044509732,-0.09518274162365484,77733126,80262986,40.620288157130375,42.252568006681244,NaN,NaN,-13.15165840514904,-6.147388854483789
2006-03-28T09:30:00-05:00,31.14999,31.38,31.00999,31.14999,5874699,2651059.9,35.297522308517884,44.06718679919218,NaN,NaN,-128.75976340233638,-101.806291126446,-0.08175272102604188,-0.19737364290620718,-0.1156209218801653,71858427,78594386.2,36.85429543638185,41.64723295622174,NaN,NaN,-15.687243897938524,-7.510225289263037
2006-03-29T09:30:00-05:00,31.06,31.5,31.06,31.34,2493400,2692904.9,40.27011095868093,44.38580860837178,NaN,NaN,-98.33146205925219,-101.88943239414844,-0.07131195369873891,-0.20476086400358895,-0.13344891030485004,74351827,76857926.4,33.38540664889679,41.28063427041466,NaN,NaN,-16.33319375225697,-8.770649355405027
2006-03-30T09:30:00-05:00,31.12,31.44,30.96001,31.06,2683800,2707454.9,35.89255008067461,43.97238298110665,NaN,NaN,-120.77978594077035,-108.11710845122987,-0.077681910185805,-0.23055129803710628,-0.15286938785130127,71668027,75037706.6,30.178784476869723,40.95461018000017,NaN,NaN,-18.285550816079436,-10.129920992644228
2006-03-31T09:30:00-05:00,31.08,31.2,30.78,30.83,4076500,2795154.9,32.74383476689468,43.25359889385366,NaN,NaN,-160.29130810605326,-123.70501169606732,-0.09088664305934552,-0.2664776916754832,-0.17559104861613767,67591527,72640586.8,26.560681502815243,40.475023035045886,NaN,NaN,-20.958029174155403,-11.676793590002967
2006-04-03T09:30:00-04:00,30.98,31.21001,30.85001,30.87,2613900,2727909.9,33.83101215612744,41.99862829638936,NaN,NaN,-135.04417460832573,-128.6412988233476,-0.09024514916850132,-0.2883974850767643,-0.198152335908263,70205427,71135047,24.568431671398372,39.796943540314835,NaN,NaN,-22.76380532799629,-13.260652409716299
2006-04-04T09:30:00-04:00,30.81,31.33,30.8,31.2,5013102,2769855.05,42.140623163424735,41.02177575454463,NaN,NaN,-94.30389074078107,-121.75012429103654,-0.06224592730071829,-0.2759597450341609,-0.21371381773344258,75218529,71807067.4,27.193552656348814,39.023173004885685,NaN,NaN,-21.720311967369334,-14.469175203666731
2006-04-05T09:30:00-04:00,31.21001,31.59,31.1125,31.5,3168400,2734625.05,48.4754196074738,40.26575892906897,NaN,NaN,-31.235659475535485,-108.3309637742932,-0.020339835876236723,-0.23913861257873847,-0.21879877670250175,78386929,72614087.8,30.329244980549106,38.00032467308959,NaN,NaN,-18.71849290217117,-15.076220589167365
2006-04-06T09:30:00-04:00,31.49001,31.62,30.9588,31.11,2571800,2710970.05,42.032635615271545,39.59595307884141,NaN,NaN,-61.41307344533982,-96.45762127520709,-0.015901804027360245,-0.23867603173670204,-0.2227742277093418,75815129,73443508.2,33.49928539127691,36.955177107343616,NaN,NaN,-18.287662327545444,-15.534997980364233
2006-04-07T09:30:00-04:00,31.00999,31.11,30.50999,30.67,3738400,2728565.05,36.1887891306248,39.13311675175023,NaN,NaN,-137.60979250112092,-91.9213181542206,-0.03833531476944824,-0.2706933711711521,-0.23235805640170387,72076729,74340548.6,36.84613493823009,36.064116185532605,NaN,NaN,-20.009806736223904,-16.174256374058473
2006-04-10T09:30:00-04:00,30.42,30.89011,30.42,30.66,2423500,2708300.05,36.066061344599234,38.922114674120344,NaN,NaN,-138.986747355579,-92.70983270367125,-0.04890641673815738,-0.2934910773244006,-0.24458466058624323,69653229,74230109,36.60189819972227,35.225811787444435,NaN,NaN,-21.355729979746968,-16.91446688915683
2006-04-11T09:30:00-04:00,30.67,30.74001,30.25999,30.31,2368700,2727685.05,31.97837164234909,38.18208759363083,NaN,NaN,-159.75534982861214,-105.80012452123746,-0.07307477414914981,-0.3359281282726805,-0.26285335412353067,67284529,72643309,33.197029791105294,34.16061633610068,NaN,NaN,-23.898368837343767,-17.91216716746925
2006-04-12T09:30:00-04:00,30.38,30.42,30.28,30.38,2572000,2791765.05,33.59930991193454,37.60437946097985,NaN,NaN,-156.59558127821245,-130.87210888177285,-0.07752871162173675,-0.3597642436507016,-0.28223553202896484,69856529,70937229,29.969044794673238,33.05771183382752,NaN,NaN,-25.381821887273247,-18.97926069886982
2006-04-13T09:30:00-04:00,30.2,30.36,30.16,30.24001,1826500,2762275.05,31.95910640464612,36.98172617713377,NaN,NaN,-159.95511362652533,-150.58051691800998,-0.08261691745545796,-0.38550667884828727,-0.3028897613928293,68030029,69380209,27.35480519867238,31.939920274576423,NaN,NaN,-27.110062389331084,-20.140803797507143
2006-04-17T09:30:00-04:00,30.14999,30.25999,30.10001,30.21001,1554000,2761335.05,31.603060945087663,36.57702914545049,NaN,NaN,-148.82202908617103,-152.82296423501998,-0.08062833274258374,-0.40367517732105895,-0.3230468445784752,66476029,68260069,25.62312615747898,30.86869441745847,NaN,NaN,-28.60231278951222,-21.34959079636501
2006-04-18T09:30:00-04:00,30.21001,30.89999,30.14999,30.78999,5576898,2954724.95,44.48057975308344,37.232961820062314,NaN,NaN,-67.52688470581695,-138.53099170506758,-0.03519713085669529,-0.36704325814934435,-0.33184612729264906,72052927,68740008.6,27.734021134445925,30.21724625303447,NaN,NaN,-25.752321511534966,-21.978552327103575
2006-04-19T09:30:00-04:00,30.67,31,30.67,30.89,2467800,2957854.95,46.356138417725084,37.66767806713689,NaN,NaN,-20.42305499366164,-110.66453273807747,0.00453114045383185,-0.3261822017253593,-0.3307133421791911,74520727,70187248.2,33.83237714363766,30.249172716944532,NaN,NaN,-22.871467681380825,-22.106111663428898
2006-04-20T09:30:00-04:00,30.8,31.28999,30.75,31.11,1956100,2914024.95,50.33111079327616,38.69900383232272,NaN,NaN,21.418959537647577,-75.06162457490548,0.04624945782972539,-0.27290151989203437,-0.31915097772175977,76476827,71511307.8,38.91151520498792,30.872939197524406,NaN,NaN,-19.17948394914206,-21.68802198995935
2006-04-21T09:30:00-04:00,31.28,31.5,31.12,31.25,2664400,2933994.95,52.73146988841711,40.12669205528861,NaN,NaN,72.55822133083416,-28.558957583433575,0.08181732941758757,-0.21687931594977528,-0.29869664536736285,79141227,73733547.4,46.354480172269156,32.286781959628264,NaN,NaN,-15.390088263764007,-20.788317171931443
2006-04-24T09:30:00-04:00,31.2,31.56,31.00999,31.53999,1898100,2969299.95,57.33129100101619,41.80528340135208,NaN,NaN,91.76933616589639,19.55931546697991,0.12105122729001472,-0.14738261125484442,-0.26843383854485914,81039327,76646207,54.22647056145691,34.40521330891816,NaN,NaN,-10.639097585261693,-19.33842865955005
2006-04-25T09:30:00-04:00,31.46001,31.46001,30.96001,31.09,2885100,3021354.95,49.312158620369516,42.317535933990996,NaN,NaN,53.34400421653832,43.73349325145097,0.11302651855252241,-0.12715069035420612,-0.24017720890672853,78154227,77866467,57.068781822979886,36.539158249391804,NaN,NaN,-9.05510595285918,-17.86938255859421
2006-04-26T09:30:00-04:00,31.02,31.14,30.7,30.78,2453600,2850300,44.67604669504751,42.04615215453197,NaN,NaN,-5.606975544258862,46.69670914133153,0.08447792369465154,-0.1345798042884141,-0.21905772798306564,75700627,78102447,57.61687913545383,38.48827497474214,NaN,NaN,-9.286040819759355,-16.6431908816178
2006-04-27T09:30:00-04:00,30.53999,31.34,30.5,31.19,5391000,2995180,51.20948967344166,42.70164173011555,NaN,NaN,28.15038585549034,48.042994404900085,0.09031809481953024,-0.10616010945865284,-0.19647820427818308,81091627,79025407,59.779707476867884,40.365447980855784,NaN,NaN,-7.2249688156117635,-15.297730586474081
2006-04-28T09:30:00-04:00,31,31.36,30.91,31.32001,1830800,2952530,53.1008381974413,43.90964523488816,NaN,NaN,69.19827037007286,47.37100421274782,0.09933216592062619,-0.07231299687740034,-0.17164516279802652,82922427,79781647,61.512743240266424,42.12734857385838,NaN,NaN,-4.96908583552239,-13.822209907766696
2006-05-01T09:30:00-04:00,31.34,31.42999,30.87,31.03,2143300,2855870,48.57718362600812,44.80329682641736,NaN,NaN,46.67190792802682,38.35151856517391,0.08283195028032614,-0.06810522494761884,-0.15093717522794498,80779127,79729607,61.3169466398566,43.89270917672512,NaN,NaN,-4.57113172655229,-12.500627310450353
2006-05-02T09:30:00-04:00,31.03,31.62,31.03,31.53,4416602,2946005.1,55.600019959852226,46.49055742052473,NaN,NaN,97.84707915116192,47.25213355209861,0.10143264439629723,-0.024146369732573447,-0.12557901412887068,85195729,81137907.4,64.60074769954119,46.13583188447054,NaN,NaN,-1.792217990626457,-10.970854550475512
2006-05-03T09:30:00-04:00,31.39999,31.50999,31.25999,31.42999,3263900,2858545,54.011114939388186,47.94854349391427,NaN,NaN,92.52117197331674,66.87776305561374,0.10253640762659307,0.0025914954043706473,-0.09994491222222242,81931829,82384147.8,67.25019912817471,48.79877147972065,NaN,NaN,-0.1321266280950137,-9.422464847278297
2006-05-04T09:30:00-04:00,31.39999,31.53,31.3,31.47,1797200,2789985,54.57044896859158,49.563639391338945,NaN,NaN,98.35311492673347,80.91830886986236,0.10131762053099923,0.02670211344152662,-0.07461550708947261,83729029,82911628.2,68.33061435449297,51.725614990850694,NaN,NaN,1.3511626576264333,-7.883375203720479
2006-05-05T09:30:00-04:00,31.64999,32.17999,31.61,32.17999,4026700,2862730,63.13814278394521,51.81614523697163,NaN,NaN,181.89384798471735,103.45742439279124,0.14123262977283868,0.10192528012657576,-0.03930734964626293,87755729,83878288.6,70.26650272494837,54.914427602812786,NaN,NaN,5.6975429791207,-5.943244034743167
2006-05-08T09:30:00-04:00,32.19,32.19,31.84,31.92999,1507900,2751205,58.924172712300425,52.84783044834427,NaN,NaN,157.57024875832616,125.63709255885112,0.14325087810404247,0.13975624798379016,-0.0034946301202523136,86247829,84972029,72.32766192396682,58.099687659207135,NaN,NaN,7.814362887717011,-3.9778716172488564
2006-05-09T09:30:00-04:00,31.95,31.98,31.61,31.66,1234800,2691770,54.67975101609722,53.442374205370854,NaN,NaN,106.88287840141213,127.44425240890116,0.11980815813861732,0.14626556755301934,0.026457409414402017,85013029,84935489,72.14772216304507,60.83649801773624,NaN,NaN,8.148170906444046,-2.2455798281498707
2006-05-10T09:30:00-04:00,31.66,31.91,31.50999,31.91,2229400,2684805,57.71691806806931,53.969931867856076,NaN,NaN,102.12058985889374,129.36413598601658,0.11454738260508436,0.16964163767075746,0.0550942550656731,87242429,85997609,74.160073102045,63.35425215324032,NaN,NaN,9.408438751528651,-0.5807200310529392
2006-05-11T09:30:00-04:00,31.91,31.91,31.44,31.61,2420200,2677215,53.11674885382574,53.99745179395669,NaN,NaN,75.12643193981816,124.71879938863349,0.08559768438992342,0.16209136055307738,0.07649367616315396,84822229,86216249,74.56742897609027,65.36946278208468,NaN,NaN,8.965044081147157,0.7829605564042172
2006-05-12T09:30:00-04:00,31.45,31.63,31.23,31.25999,2949200,2733350,48.28173802748752,53.35105515299036,NaN,NaN,19.43946103328163,92.22792199834636,0.039931203581286295,0.12640768063976182,0.08647647705847553,81873029,85039709,68.32538858717581,66.37652835535032,NaN,NaN,6.996539165393262,1.670614643402652
2006-05-15T09:30:00-04:00,31.11,31.58,31,31.46001,2226600,2766980,51.02530376426612,53.47342266326869,NaN,NaN,3.4668914154040933,61.40725052976195,0.02119149802464057,0.11296584958927625,0.09177435156463568,84099629,84610069,66.14780158982325,67.0250297672677,NaN,NaN,6.257969510037074,2.3259510529218552
2006-05-16T09:30:00-04:00,31.50999,31.5546,31.28999,31.32001,2352400,2605755.1,49.06344046102079,53.786807932266775,NaN,NaN,4.77499432460042,40.98567371439961,-0.0014362418930869147,0.08997904919827704,0.09141529109136395,81747229,83956909,62.8674614064703,67.40007135805459,NaN,NaN,5.049905861000065,2.715087454075885
2006-05-17T09:30:00-04:00,31.07001,31.27,30.71001,30.84,6927898,2828760,42.96394109903446,53.19784017695198,NaN,NaN,-121.06370259127686,-3.651184775634519,-0.047010113296393305,0.03265264947087232,0.07966276276726562,74819331,81472289.4,52.25215193604471,66.86238881942437,NaN,NaN,1.9945677211604718,2.6121560636593975
2006-05-18T09:30:00-04:00,30.75,31.08,30.69,30.83,4754199,2968664.95,42.84444187659207,52.46524043974846,NaN,NaN,-133.6748464612265,-45.41144045584345,-0.07447503199989457,-0.013431027232602588,0.06104400476729198,70065132,78520870,42.97036697184251,65.5379333716798,NaN,NaN,-0.4478681049273254,2.1750097538612945
2006-05-19T09:30:00-04:00,30.89999,31.35001,30.84,31.09,3352700,3003079.95,46.97403777936357,52.350730022130996,NaN,NaN,-67.4209009347665,-62.783512849453075,-0.07174934066435891,-0.028642671063156655,0.043106669601202255,73417832,76829830.6,38.72578404215643,63.9242789004155,NaN,NaN,-1.2916072419776694,1.6797787544557283
2006-05-22T09:30:00-04:00,31.00999,31.5388,30.94,31.33,3752600,3095804.95,50.52737647203708,51.98839834442991,NaN,NaN,-20.614416640779957,-67.59977446068989,-0.05135646710504701,-0.021088914280106508,0.0302675528249405,77170432,75443991.2,35.620444086079885,61.85425721373969,NaN,NaN,-0.9375163057728495,1.30587946013736
2006-05-23T09:30:00-04:00,31.37,31.53,30.88,30.89,2133100,3058204.95,44.6234935920234,51.31785396247528,NaN,NaN,-61.828327929257675,-80.9204389114615,-0.06423813374680855,-0.05003011435857019,0.01420801938823836,75037332,74102011.8,32.87161579104338,59.398644118230315,NaN,NaN,-2.485781408527712,0.7642136217566355
2006-05-24T09:30:00-04:00,30.83,31.13,30.55,31,5290699,3200059.9,46.31241539447576,50.72799442146701,NaN,NaN,-114.12167070179837,-79.5320325335658,-0.06205423249976986,-0.06335977123647396,-0.0013055387367041042,80328031,75203751.8,37.15915634927404,57.17211140357181,NaN,NaN,-3.2329683251605035,0.1931876293399014
2006-05-25T09:30:00-04:00,31.2,31.33,31.00999,31.28999,3197600,3090389.9,50.59068221220713,49.83174723777143,NaN,NaN,-38.69887271032549,-60.5368377833856,-0.03891403342198701,-0.049948080514187865,-0.011034047092200858,83525631,77895851.6,46.20128482247888,55.45316726768114,NaN,NaN,-2.5672237684355013,-0.20115685605658468
2006-05-26T09:30:00-04:00,31.35001,31.66,31.31,31.63,2618700,3129784.9,55.107770005645165,49.55914704443891,NaN,NaN,41.2772376027979,-38.79721007587271,-0.0005710278300440508,-0.011747831879755921,-0.01117680404971187,86144331,80441151.4,53.07602007050074,54.07804999243357,NaN,NaN,-0.5801394146728606,-0.2552972215731955
2006-05-30T09:30:00-04:00,31.60001,31.69,31.31,31.31,2165900,3130914.9,50.43450500899353,49.25591518678864,NaN,NaN,12.299636096940436,-32.21439952832864,0.0031718038373617623,-0.007212049253009667,-0.01038385309037143,83978431,81802751.2,56.29356539024068,52.94561022294754,NaN,NaN,-0.3470936005335202,-0.268410989996099
2006-05-31T09:30:00-04:00,31.5,32.05,31.5,31.83,2292900,3024729.8,56.83967070845131,49.19325466110165,NaN,NaN,96.08183199897448,-0.6323675426822121,0.03863131980918744,0.037905296671112865,-0.0007260231380745701,86271331,84049551,61.04078780584999,52.00851841607647,NaN,NaN,1.979501613416266,0.05271938191995307
2006-06-01T09:30:00-04:00,31.71001,32.17999,31.57001,32.14999,2690500,2996059.8,60.24428729976314,49.70236455009717,NaN,NaN,119.83863204761414,46.15969300720029,0.07925917309509867,0.09834794323079876,0.019088770135700095,88961831,85776311,64.25423441960557,51.27186166204184,NaN,NaN,5.042736105333341,0.7655789138361513
2006-06-02T09:30:00-04:00,32.34,32.56,32.08,32.53999,4726801,3142539.85,63.97428804057497,50.823260979603425,NaN,NaN,174.89105866248133,88.87767928176167,0.12528388783446118,0.17569362992877657,0.05040974209431539,93688632,87808911.2,67.63800476531532,51.22276281762324,NaN,NaN,8.878141254059825,1.9245163910109617
2006-06-05T09:30:00-04:00,32.55,32.60001,32.14999,32.14999,2227100,3052559.85,58.103500601066514,51.3288464679463,NaN,NaN,146.62095888915428,109.94642353903296,0.12221523407891766,0.20317878469296247,0.08096355061404481,91461532,88872351.4,69.27667041418132,51.44625344793453,NaN,NaN,10.148998626137654,3.0994424246004892
2006-06-06T09:30:00-04:00,32.10001,32.39,31.85001,32.21001,4035400,3178934.85,58.73116738502382,52.019398391089375,NaN,NaN,114.66044230578376,130.4185847808016,0.11697734377909716,0.22718523033791627,0.11020788655881911,95496932,91176051.6,72.52252762000961,52.13590103461591,NaN,NaN,11.345088793890069,4.277391905927572
2006-06-07T09:30:00-04:00,32.25,32.42,32.06,32.09,2559300,3245159.85,56.89573967253605,53.01452686062521,NaN,NaN,110.66479785050196,133.3351779511071,0.09889868785748995,0.23383124638068153,0.13493255852319158,92937632,92509311.8,74.22005487954628,53.705036959151734,NaN,NaN,11.765586405429914,5.347133977285049
2006-06-08T09:30:00-04:00,32.14999,32.32001,31.94,32.2,13835699,3825474.8,58.185633906601225,54.110326291340144,NaN,NaN,95.82857470985677,128.53316648355562,0.0881726925680153,0.2451484242332107,0.1569757316651954,106773331,96071611.8,78.1110840760211,56.21508818087877,NaN,NaN,12.486845208121377,6.367092724547382
2006-06-09T09:30:00-04:00,32.45,32.60001,32.13,32.47,3280200,3868474.8,61.25078950078648,55.130094271441784,NaN,NaN,116.70875518494941,116.89670578804926,0.09262733972395817,0.27275990632014313,0.18013256659618496,110053531,99344591.6,80.95525208395213,59.231478755292756,NaN,NaN,14.01025769676478,7.458973434864153
2006-06-12T09:30:00-04:00,32.63,32.77,32.42999,32.53999,7724102,4107219.9,62.02783996319585,55.95155594938169,NaN,NaN,122.14561782873851,112.0016375759661,0.09338811211791309,0.2968677067435763,0.20347959462566323,117777633,104607811.8,84.45353905569576,62.71955696740817,NaN,NaN,15.485828644435271,8.605667036231456
2006-06-13T09:30:00-04:00,32.55,32.63,32.07001,32.14999,6806000,4336189.9,55.36533433924496,56.71883028846894,NaN,NaN,74.5980188478894,103.98915288438722,0.0622254168498208,0.28126136568793925,0.21903594883811844,110971633,107702752,86.07351018677008,66.51969228138866,NaN,NaN,14.842126726437414,9.49658984911802
2006-06-14T09:30:00-04:00,32.14999,32.2,31.67999,31.91,2745100,4355824.9,51.68625448265103,57.10267593762432,NaN,NaN,26.52172014990222,87.16053734426728,0.022118773928736374,0.24668441624903892,0.22456564232030254,108226533,110760532.2,87.46343980885136,70.11285538564418,NaN,NaN,13.195495514945138,10.02500494423618
2006-06-15T09:30:00-04:00,32.14999,32.49001,31.95,32.39999,4474801,4233170.05,57.84545630004415,57.620874086755535,NaN,NaN,66.15646003034041,81.226114408364,0.025043899460500063,0.25587051664592764,0.23082661718542757,112701334,111946132.8,87.96499003292351,73.09597718639023,NaN,NaN,13.62736786387416,10.539628218470178
2006-06-16T09:30:00-04:00,32.05,32.3,31.95,32.11,2302100,4110565.1,53.49858750601157,57.50593247963885,NaN,NaN,39.427197793313574,65.76980293003683,0.004953582343461743,0.23701859511475476,0.23206501277129302,110399234,112015273.4,87.99515286316934,75.59020095729512,NaN,NaN,12.625339255571916,10.83758693805614
2006-06-19T09:30:00-04:00,32.08,32.35001,31.53,31.67,4663801,4176120.15,47.6479182319406,57.30689056699221,NaN,NaN,-6.860028102675749,39.96867374375399,-0.038093778687123714,0.18444778941238837,0.2225415680995121,105735433,109606833.4,80.43297100397419,77.31444421541894,NaN,NaN,9.84690076661289,10.696060342135675
2006-06-20T09:30:00-04:00,31.7,31.92,31.57001,31.75,2508000,4113890.15,48.74545136660018,56.72873204257427,NaN,NaN,-29.929052718113446,19.063259430553423,-0.060001547680866546,0.1475396334984289,0.20754118117929546,108243433,109061193.4,78.78113975038681,78.58161221145728,NaN,NaN,7.961325320838792,10.305383910521835
2006-06-21T09:30:00-04:00,31.85001,31.91,31.61,31.72,1529700,4083720.15,48.336216817211046,55.878155579534834,NaN,NaN,-39.55489624064909,5.847936152443159,-0.07439417583206087,0.11454846138921937,0.18894263722128024,106713733,108758633.4,77.82669639559124,79.55107378117056,NaN,NaN,6.32328503134907,9.736512642068583
2006-06-22T09:30:00-04:00,31.61,31.71001,31.33,31.61,2787800,3958575.2,46.78524738136103,54.65036696101955,NaN,NaN,-94.34018199697843,-26.251392253020605,-0.08825782767553897,0.07862035262685652,0.16687818030239548,103925933,107003553.2,72.35096231186462,79.88771360592408,NaN,NaN,4.513004534885489,8.990297198185283
2006-06-23T09:30:00-04:00,31.37,31.95,31.37,31.66,1062500,3851820.2,47.608164692277946,53.9007001103918,NaN,NaN,-81.17493465893972,-50.371818743471266,-0.09065118822625898,0.05356419501957177,0.14421538324583075,104988433,105921393,69.1216707727853,79.87664220296722,NaN,NaN,3.2309133343655065,8.167528074782458
2006-06-26T09:30:00-04:00,31.60001,31.82001,31.60001,31.78999,1759100,3808840.2,49.7823912785808,53.26150181707443,NaN,NaN,-67.89300763968242,-62.5784146508726,-0.0804183411726471,0.04369245678002187,0.12411079795266897,106747533,106123813,69.39682486555871,79.65337772050643,NaN,NaN,2.7139833649560816,7.388450259092976
2006-06-27T09:30:00-04:00,31.83,32.06,31.57001,31.67,2518900,3826490.2,47.81005821486523,52.612524570097946,NaN,NaN,-68.75619830302116,-70.34384376785415,-0.07857790448910415,0.025888417341288772,0.10446632183039292,104228633,105320853,66.85197819634959,79.12708652884952,NaN,NaN,1.7420264475453868,6.581818286014749
2006-06-28T09:30:00-04:00,31.64,31.87,31.64,31.75999,4097102,3916700.3,49.42830911688726,51.98700137083266,NaN,NaN,-70.3858241061261,-76.51002934094954,-0.06851461878220773,0.018823048352633265,0.087337667134841,108325735,105643253.4,67.36938674537538,78.3598224338034,NaN,NaN,1.333817660654552,5.832103910963292
2006-06-29T09:30:00-04:00,31.81,32.24001,31.81,32.17,2307100,3897530.3,56.10630394075439,51.61953811654465,NaN,NaN,10.43095938785829,-55.5558010639822,-0.03324585722585707,0.045780345602519645,0.07902620282837672,110632835,106984633.8,69.50235024904461,77.54175801702429,NaN,NaN,2.855359397522098,5.406854694757407
2006-06-30T09:30:00-04:00,32.17,32.42,32.14999,32.28999,3579600,3840170.25,57.86005464754429,51.32183916542669,NaN,NaN,68.73772710237982,-25.573268711718313,-0.002460263304771823,0.07595087369741194,0.07841113700218376,114212435,108829434.2,72.19434059756136,76.66610098430041,NaN,NaN,4.6404908089569235,5.297374139643052
2006-07-03T09:30:00-04:00,32.39999,32.64999,32.25999,32.64999,886200,3773125.25,62.6781068679963,51.8441800603375,NaN,NaN,122.9685289996375,12.599038616145672,0.039224021222410296,0.12744116353019663,0.08821714230778634,115098635,110499654.6,74.39774600506009,75.83211782846398,NaN,NaN,7.701963172868331,5.640886858675235
2006-07-05T09:30:00-04:00,32.39999,32.64999,32.36121,32.42999,2055900,3674150.25,58.29188592245292,52.316010877466205,NaN,NaN,102.76380423705673,46.90303912416125,0.04845059031101816,0.14878038019655904,0.10032978988554088,113042735,112262475,76.51320198375544,75.04995798381427,NaN,NaN,9.03645845894839,6.125968515857115
2006-07-06T09:30:00-04:00,32.53,32.57001,32.14999,32.25999,1678400,3630105.25,55.084055058959194,52.11876793167442,NaN,NaN,62.53282295675237,73.48676853673695,0.03993007467038402,0.1502423832235209,0.11031230855313688,111364335,112870195,77.21225058415644,74.2819051660452,NaN,NaN,9.223153190252512,6.5684234693421715
2006-07-07T09:30:00-04:00,32.31,32.649,32.25999,32.50999,1415900,3009115.3,58.68477426993564,52.48920984338328,NaN,NaN,88.68681716054297,89.13794009127388,0.04744509973521388,0.16961868322215423,0.12217358348694035,112780235,113299675,77.71700624108021,73.54775183589597,NaN,NaN,10.462286931410713,7.124689678209106
2006-07-10T09:30:00-04:00,32.53,32.78999,32.53,32.69,5482699,3119240.25,61.10273418256613,53.450268125570815,NaN,NaN,124.26869223996071,100.24413311879006,0.06004220575224531,0.19722634067724698,0.13718413492500167,118262934,114109774.8,78.67645002187398,73.42228605146025,NaN,NaN,12.23384470364949,7.854568967557732
2006-07-11T09:30:00-04:00,32.74001,32.97,32.7,32.94,4100000,2938035.15,64.23345284901352,54.556553945743204,NaN,NaN,156.80944172314244,107.01231566349104,0.07949405049909519,0.23655169804887066,0.15705764754977547,122362934,115562634.6,80.31357806586438,73.53174593113722,NaN,NaN,14.716145846655456,8.834794236000263
2006-07-12T09:30:00-04:00,32.92999,33,32.67,32.78,3836700,2789570.15,60.8574457892605,55.45092744374673,NaN,NaN,129.24887838719894,112.30933049351947,0.07587618965283846,0.25190288461582355,0.1760266949629851,118526234,116659334.4,81.47007764633585,73.79198744904753,NaN,NaN,15.804972794031519,9.830534030004728
2006-07-13T09:30:00-04:00,32.55,32.95,32.5,32.66,6685398,2986585.05,58.37919021645029,56.27906621768169,NaN,NaN,95.53692227405857,118.91015035698072,0.06036810788739905,0.2514868298222339,0.19111872193483487,111840836,116754634.6,81.5713899062956,74.45058942007833,NaN,NaN,15.995181762788228,10.711197991830941
2006-07-14T09:30:00-04:00,32.78999,32.78999,32.35001,32.66,5639102,3044800.1,58.37919021645028,57.04842518369399,NaN,NaN,71.03013702956447,115.378814330785,0.045740953802732104,0.24829491418825,0.2025539603855179,111840836,116566754.8,80.63537029326622,75.2729965286841,NaN,NaN,16.150255111292978,11.48820615175409
2006-07-17T09:30:00-04:00,32.57001,32.86,32.57001,32.75,2898800,3074635.1,59.80301478570938,57.76418400563175,NaN,NaN,83.21060330716575,107.16719654422602,0.038072064566748665,0.2501440410939537,0.21207197652720505,114739636,115862095.2,77.06362494890955,75.82062510606632,NaN,NaN,16.666703085961796,12.227991428069476
2006-07-18T09:30:00-04:00,32.75,32.85001,32.67,32.8,4617898,3072339.95,60.60923294000348,58.67841077171305,NaN,NaN,83.26514049904318,92.45833629940618,0.03252701629087987,0.2527307468908049,0.220203730599925,119357534,115261015.2,74.05047770221493,76.33480364219955,NaN,NaN,17.3160866268085,12.954862170746479
2006-07-19T09:30:00-04:00,32.94,33.33,32.908,33.3,3351700,3114524.95,67.60614490608316,59.97682761379847,NaN,NaN,136.5304736626331,93.91465535449302,0.057247644044828516,0.29176328565596066,0.23451564161113214,122709234,116097615.2,75.48707899589851,76.9146388029512,NaN,NaN,20.045562962592026,13.967819426724414
2006-07-20T09:30:00-04:00,33.3,33.56,33.23,33.38,2256600,3150869.95,68.56816979408423,60.866960889036314,NaN,NaN,154.76645389607862,105.760561678897,0.07270841727071808,0.3254011631995297,0.25269274592881164,124965834,118722614.8,79.35005379631109,77.61804619918452,NaN,NaN,22.587108310054912,15.199146410057342
2006-07-21T09:30:00-04:00,33.32001,33.65759,33.32001,33.46001,4235898,3223274.85,69.54239288607401,61.701413620359865,NaN,NaN,158.03757656395717,123.16204958577555,0.08138973477767886,0.3544299144009102,0.27304017962323135,129201732,122194794,83.1357902535784,78.39957831747145,NaN,NaN,24.992480120799378,16.59819408302049
2006-07-24T09:30:00-04:00,33.71001,33.82001,33.55,33.77,3517800,3346039.85,73.03021502948137,62.440849917608794,NaN,NaN,176.06402869513585,141.73273466336957,0.0998580144267624,0.39786269765668436,0.29800468322992196,132719532,125790773.2,85.99865556048624,79.2282147142876,NaN,NaN,28.219022438755324,18.258312419554038
2006-07-25T09:30:00-04:00,33.84,34,33.72,33.91,1842700,3350219.85,74.45307517636105,63.59522057860223,NaN,NaN,178.3467933044512,160.74906522445116,0.11241647331852761,0.43852527487808146,0.32610880155955385,134562232,128831712.8,87.87342693950416,80.03965935398394,NaN,NaN,31.36964748115964,20.131360285497696
2006-07-26T09:30:00-04:00,33.99001,34.11,33.85001,34.03,3381300,3393339.85,75.6394182020172,65.06346080310638,NaN,NaN,166.24633443507057,166.69223737893867,0.11907986272632526,0.4749586299674604,0.35587876724113515,137943532,131878572.4,89.40429500907541,80.91051967004958,NaN,NaN,34.37526603167209,22.16620396352261
2006-07-27T09:30:00-04:00,34.28,34.28,33.75999,33.75999,4874398,3432204.65,67.98886675472264,65.72803883773402,NaN,NaN,132.98247786875612,162.33544217347418,0.09653809674450292,0.4765513881717638,0.38001329142726087,133069134,133499232.4,90.11884335102886,81.79636517790304,NaN,NaN,34.74500372155981,23.963175357527923
2006-07-28T09:30:00-04:00,33.81,34.22,33.75999,33.99001,4373699,3535534.6,70.70704640911364,66.41406113963028,NaN,NaN,120.9139484391799,154.9107165485187,0.08856349837222982,0.49071766439254816,0.40215416602031834,137442833,135147452.6,90.79846913573735,82.66222368603614,NaN,NaN,35.88793487388395,25.66671243129307
2006-07-31T09:30:00-04:00,34.00999,34.13,33.81,33.84,1633700,3438239.6,66.72760650306046,66.5922149720622,NaN,NaN,99.58872714023767,139.6156562375391,0.06568287916079385,0.4842577649713107,0.41857488581051683,135809133,135765372.8,91.04708473840778,83.42890273407497,NaN,NaN,35.64070348592283,27.09156829624018
2006-08-01T09:30:00-04:00,33.84,34.25999,33.72,34.25999,4834801,3635669.65,71.55458107478836,67.35629606388561,NaN,NaN,105.03934470087516,124.95416651682385,0.07088525854065686,0.5071814589863379,0.43629620044568107,140643934,136981713.2,91.53209580895,84.14761831711883,NaN,NaN,36.96544517843063,28.5021221365531
2006-08-02T09:30:00-04:00,34.28,34.39,34.14999,34.23,6457102,3855729.75,70.76511695724452,68.24100511679949,NaN,NaN,112.14958109489004,114.13481584878775,0.0645385658483355,0.5169694077561005,0.45243084190776495,134186832,136230373.2,88.34825591458649,84.63168017485388,NaN,NaN,37.774052701907465,29.82668364588944
2006-08-03T09:30:00-04:00,34.2,34.28999,33.96001,34.06,5445602,4044089.85,66.29968423092603,68.80675468926204,NaN,NaN,86.53218693682231,104.84475766240098,0.04220363508473318,0.5051853857636814,0.46298175067894826,128741230,135364792.4,84.69329585910442,84.92153200098518,NaN,NaN,37.094359736713336,30.86492308743571
2006-08-04T09:30:00-04:00,34.39,34.42,33.97,34.07001,4422398,4194414.75,66.43399591812096,69.28039619872001,NaN,NaN,84.91888668700126,97.64574531196527,0.02241004746158609,0.49099431000593086,0.46858426254434477,133163628,134508951.4,81.1198914244255,85.21126532066491,NaN,NaN,36.58419396537169,31.681961784283708
2006-08-07T09:30:00-04:00,34.09,34.24001,33.66,33.67,1578400,3999199.8,56.707779460304415,69.00172095017008,NaN,NaN,43.39513641311281,86.40702716654027,-0.02097065849433577,0.442370939426425,0.4633415979207608,131585228,133664170.4,77.63778525175327,85.46750157420335,NaN,NaN,33.05754853782975,31.87847417764743
2006-08-08T09:30:00-04:00,33.67999,34.13,33.67999,33.99001,3217700,3955084.8,61.55676477391158,68.56962236930067,NaN,NaN,48.5644556044035,75.11204934724594,-0.03086343429876104,0.4247623050473095,0.45562573934607054,134802928,132495969.2,72.97296579822022,85.28792206008347,NaN,NaN,31.508368501033036,31.825601938131086
2006-08-09T09:30:00-04:00,34.02,34.25,33.97,34,2537100,3890104.8,61.700981381039014,68.07910891122602,NaN,NaN,63.076320347161676,65.29739719770028,-0.038962436725497096,0.4069226934391992,0.4458851301646963,137340028,133126608.4,73.8851798114487,84.89757391830759,NaN,NaN,30.327626374847664,31.6116054290906
2006-08-10T09:30:00-04:00,34.03999,34.06,33.82001,33.95,2903200,3700994.9,60.47810455232785,67.43165974452987,NaN,NaN,40.20673429997596,56.032306670331,-0.04925219203791953,0.38431989011729684,0.43357208215521637,134436828,134265728,75.49412624483924,84.35174077482623,NaN,NaN,29.00534381131138,31.239282340836425
2006-08-11T09:30:00-04:00,33.99001,34.00999,33.82001,33.87,2212100,3529644.8,58.480958650559586,66.39242714603544,NaN,NaN,27.226724088909894,44.49387415071272,-0.062177937046840714,0.35584966084666547,0.4180275978935062,132224728,134077948,74.6773406255665,83.54307542233197,NaN,NaN,27.329298856509958,30.68071327164693
2006-08-14T09:30:00-04:00,34,34.21001,34,34.10001,2453300,3507369.8,62.33238147547238,65.52666331025769,NaN,NaN,68.49665052123969,49.51417697233814,-0.056152450361827644,0.34783703494122165,0.4039894853030493,134678028,134696508,75.61331689017806,82.66735327595153,NaN,NaN,26.953764874216667,30.148292072014033
2006-08-15T09:30:00-04:00,34.17999,34.41,34.17999,34.32001,4039000,3478424.9,65.6176445650728,64.8108223361903,NaN,NaN,133.1136294158028,66.42401173461799,-0.03907539678806332,0.35514523931797015,0.3942206361060335,138717028,135479328,76.78289274492062,81.76582454279762,NaN,NaN,27.603918961211605,29.78481019904226
2006-08-16T09:30:00-04:00,34.46001,34.48,33.97,34,3826900,3502184.9,57.73029131072945,64.07806694733364,NaN,NaN,78.53670732884288,69.51608913095424,-0.05033975846444538,0.33129593802547674,0.3816356964899221,134890128,134989348,74.37839922924874,80.64150710552761,NaN,NaN,25.70859763011996,29.202494117767646
2006-08-17T09:30:00-04:00,34,34,33.67999,33.96001,4875301,3633119.95,56.81128643251405,63.08551266329081,NaN,NaN,-49.44463782918987,51.585814705121074,-0.0607925169881634,0.3056450502547179,0.3664375672428813,130014827,134104947.8,70.110655526067,79.1638061334083,NaN,NaN,23.90625772098209,28.445888918226853
2006-08-18T09:30:00-04:00,33.88,34.35001,33.88,34.34,2868200,3564735.05,62.86117857597109,62.80933923992728,NaN,NaN,91.65826220488586,64.47212232831626,-0.043247926611569065,0.31237765897841996,0.355625585589989,132883027,134236607.6,70.38310133076784,77.68780731857687,NaN,NaN,24.187294845170083,27.8375183363616
2006-08-21T09:30:00-04:00,34.27,34.5,34.25999,34.41,2766800,3527185.05,63.865358804845776,62.26010907778853,NaN,NaN,175.58282543223967,85.88935731051626,-0.028759123595567537,0.3196766810955296,0.34843580469109714,135649827,134430967.4,70.80615260143932,76.20738280375467,NaN,NaN,24.722086730840502,27.392456678430015
2006-08-22T09:30:00-04:00,34.32001,34.59,34.32001,34.53,1219100,3496005.05,65.58334660826982,61.88998262429033,NaN,NaN,190.73922117775342,97.41447566290638,-0.013688724841532718,0.33132489863918124,0.34501362348071396,136868927,134061347.2,68.7936533135087,74.81062547510626,NaN,NaN,25.68457804767454,27.14847401689352
2006-08-23T09:30:00-04:00,34.7,34.7,34.14,34.17,2384000,3446140.05,56.85083597802577,61.215064891940315,NaN,NaN,107.34395097579093,103.175924392296,-0.029645087611234522,0.3079572639666708,0.3376023515779053,134484927,133980307,68.33504941604049,73.6421793006017,NaN,NaN,23.77468644711082,26.66650436406742
2006-08-24T09:30:00-04:00,34.39,34.39,34.17,34.31,2610000,3332920.15,59.12992456521593,60.69334550958995,NaN,NaN,77.04281221327858,128.4734144007897,-0.03223556545265066,0.29730789476209196,0.3295434602147426,137094927,135396327,71.86443115718897,72.98107499579909,NaN,NaN,22.904883394800674,26.129129939886457
2006-08-25T09:30:00-04:00,34.3,34.42999,34.25,34.31,2064700,3217470.2,59.12992456521593,60.866355874226485,NaN,NaN,84.8470811985854,127.11117819952958,-0.035173769992450366,0.28557624772417967,0.32075001771663003,137094927,136238707,73.73961661082708,72.70263437859009,NaN,NaN,22.2118515362113,25.569518739361435
2006-08-28T09:30:00-04:00,34.39,34.66,34.27,34.57001,5336801,3402625.25,63.304678646579674,60.99120686513135,NaN,NaN,139.45312442134744,119.88523799735114,-0.021502498447116936,0.2938718946577339,0.3153743931048508,142431728,137595087.2,76.4601288511312,72.95171745379801,NaN,NaN,22.86244172331912,25.18279345135539
2006-08-29T09:30:00-04:00,34.67,34.7,34.42,34.60001,2657800,3293775.2,63.76459041243498,61.13860751023106,NaN,NaN,144.84194437252282,110.70578263630503,-0.01276709202698828,0.2994155280711155,0.31218262009810377,145089528,139239207.4,79.26430348842504,73.33594057358202,NaN,NaN,23.524234791346277,24.94585649992552
2006-08-30T09:30:00-04:00,34.74001,34.74001,34.39999,34.42,2408400,3091340.1,58.98729226252963,61.03212091810262,NaN,NaN,111.00496017950013,111.43798447704687,-0.020956563475963697,0.28598691575314916,0.30694347922911286,142681128,140878447.6,81.6157764152897,73.77320130004277,NaN,NaN,22.705453744381952,24.625798963419296
2006-08-31T09:30:00-04:00,34.42999,34.87,34.42999,34.77,1994900,2918805,64.54876969627101,61.46553599279628,NaN,NaN,145.04791459481163,125.03900495335347,-0.005453150610856772,0.3001270409655419,0.30558019157639865,144676028,142394667.8,83.48168925286679,74.40208334484994,NaN,NaN,23.695408063993888,24.492885977787093
2006-09-01T09:30:00-04:00,34.92,34.92,34.73,34.8,3651100,2880240.1,64.98703642470255,61.65515420345558,NaN,NaN,157.94266297102916,139.65812130784224,0.0036785650259428815,0.3101783978588273,0.3064998328328844,148327128,144641108,85.78389415865016,75.12855314974081,NaN,NaN,24.621778618958786,24.511299212240193
2006-09-05T09:30:00-04:00,34.8,34.87,34.34,34.42999,3910900,2996865.1,55.8209979304175,60.95539372955164,NaN,NaN,75.02109969526342,126.77171636262543,-0.01719816324028356,0.28500212878252995,0.3022002920228135,144416228,145038008,86.15114527342163,75.79771404463375,NaN,NaN,22.554225847299453,24.231717302962945
2006-09-06T09:30:00-04:00,34.3,34.47,34.16,34.3,4915699,3081765.05,52.993151272997466,60.61702658399935,NaN,NaN,-2.0903826611002314,97.38525095590083,-0.0404324964295224,0.2516596714859105,0.2920921679154329,139500529,143920208.2,79.89148745015586,76.19150606041283,NaN,NaN,19.96501409520331,23.622188273282998
2006-09-07T09:30:00-04:00,34.10001,34.38,34.10001,34.35001,2636900,3086755.05,53.95949129613101,60.41332693140056,NaN,NaN,-17.316352054276706,71.72098850914546,-0.05234721524621333,0.22665814885766622,0.27900536410387955,142137429,143811468.4,79.28794766961374,76.84702692780903,NaN,NaN,18.150677670545797,22.8405439014634
2006-09-08T09:30:00-04:00,34.28,34.44,34.28,34.35001,5329398,3208064.95,53.959491296131006,59.7774921256977,NaN,NaN,3.622423573860428,43.435890304955215,-0.05961464129827504,0.20448706248103576,0.2641017037793108,142137429,143303748.6,76.38632288870089,77.27582846766138,NaN,NaN,16.681763021673408,21.9607180614934
2006-09-11T09:30:00-04:00,34.23,34.39999,34.14999,34.23,6532500,3424084.95,51.039349705565,58.861348618606215,NaN,NaN,-43.95073006173417,3.0572116984025484,-0.0711111478044304,0.1752127690237728,0.2463239168282032,135604929,140759308.8,63.78768292419091,76.77450920500078,NaN,NaN,14.596797581835302,20.90872942154224
2006-09-12T09:30:00-04:00,34.16,34.55,33.89999,34.05,10640801,3833460,46.93649210108799,57.529430439521796,NaN,NaN,-85.63481953291485,-29.07397214723311,-0.08832203910243966,0.13592136795015364,0.2242434070525933,124964128,136868888.8,50.164131118499164,75.44382904821438,NaN,NaN,11.578465999816594,19.575834647010005
2006-09-13T09:30:00-04:00,34,34.13,33.73,34.12,5627199,3912869.95,48.664744845798,56.944709644362675,NaN,NaN,-141.1600252085542,-56.887900656723914,-0.09205665297322085,0.10917259083606723,0.20122924380928808,130591327,135087048.4,45.38326827164567,73.80441610932904,NaN,NaN,9.51975640174929,18.13925204054419
2006-09-14T09:30:00-04:00,33.98,34.31,33.85001,33.98,3182700,3880659.95,45.47470664551678,55.969336935812734,NaN,NaN,-115.03784329420063,-76.4321989047087,-0.10034071626967683,0.07580334847219206,0.1761440647418689,127408627,132141288,38.799786624428755,71.44265578556046,NaN,NaN,6.823895510908354,16.522772536310498
2006-09-15T09:30:00-04:00,33.85001,33.85001,33.67,33.72,3489000,3811344.9,40.20387287546903,54.617476100830814,NaN,NaN,-219.5936536251669,-121.07541434451414,-0.11847144491079525,0.028054758603374808,0.14652620351417006,123919627,128497727.6,32.51662101074365,68.49815609984022,NaN,NaN,2.797336347205656,14.56199593786695
2006-09-18T09:30:00-04:00,33.62,33.78999,33.47,33.62,3027900,3819329.9,38.36215240434424,52.835867083528285,NaN,NaN,-217.95283093782896,-155.8758345197331,-0.13134258327527806,-0.01765202557992751,0.11369055769535055,120891727,125555087.2,28.50219562998771,65.0725894411871,NaN,NaN,-1.1286524264257363,12.320474742967995
2006-09-19T09:30:00-04:00,33.57001,33.78,33.56,33.69,6799602,4020970,40.41966035614274,51.168372079507414,NaN,NaN,-165.15397039569356,-171.77966469228883,-0.12909402684378588,-0.0476769758593818,0.08141705098440408,127691329,126100527.4,30.22181482324895,61.56955453653167,NaN,NaN,-3.826303244770974,10.013792173291
2006-09-20T09:30:00-04:00,33.64,33.81,33.62,33.64,3565400,4138285,39.40777202568555,49.76983491973284,NaN,NaN,-134.38023964340317,-170.42370757925863,-0.12485049993294248,-0.07464607393177403,0.05020442600116845,124125929,124807447.8,28.473410512618784,57.773671257769465,NaN,NaN,-6.364905232434685,7.673978258187331
2006-09-21T09:30:00-04:00,33.58,33.67999,33.44,33.59,11840398,4611104.9,38.37321879583431,47.90015271255879,NaN,NaN,-136.30844511039365,-174.67782794249723,-0.11929445732340793,-0.09891364565309146,0.020380811670316468,112285531,121782828.6,24.851744946271367,53.58581809301264,NaN,NaN,-8.790818692656192,5.321864408066828
2006-09-22T09:30:00-04:00,33.59,33.62,33.49001,33.55,3837900,4672499.9,37.52450626225051,45.93854341524078,NaN,NaN,-119.56112485554387,-154.67132218857262,-0.1122969393988984,-0.11999036257830653,-0.007693423179408132,108447631,118688429.4,21.797117568368307,49.01533405084966,NaN,NaN,-11.073480205261944,2.9796723204484317
2006-09-25T09:30:00-04:00,33.55,34.14,33.55,34.02,3236000,4731064.9,51.186028148706704,45.60747414511859,NaN,NaN,-45.774647717903584,-120.23568554458757,-0.07195979813819484,-0.09764317085215168,-0.025683372713956844,111683631,116846810.2,20.205362722528577,44.30492101150015,NaN,NaN,-9.128970815765763,1.2498661581321182
2006-09-26T09:30:00-04:00,33.75,34.92,32.36,33.97,4512602,4689854.95,49.93504443521511,45.38903794241985,NaN,NaN,-67.75229989045648,-100.75535144354015,-0.04586174071431486,-0.08301054860685042,-0.03714880789253556,107171029,112742750.2,17.192291303954192,39.82640700105718,NaN,NaN,-7.916431994836991,-0.05960500657775447
2006-09-27T09:30:00-04:00,33.89999,34.46001,33.89999,34.44,3768000,4745364.95,59.86479331162543,45.810845229240876,NaN,NaN,35.738230067475996,-66.73165750136431,0.0032331448915331323,-0.033107376778119146,-0.03634052166965228,110939029,110105370.2,15.58399768075239,35.27612485899565,NaN,NaN,-3.3267449868704215,-0.5263392894767068
2006-09-28T09:30:00-04:00,34.55,34.59,34.2,34.33,2643600,4757124.95,57.01462683875667,46.02906919657128,NaN,NaN,59.90449780404053,-27.489068918477493,0.02714674784488257,-0.0024070868635490683,-0.029553834708431637,108295429,109307349.8,15.123003338655877,30.900173462563856,NaN,NaN,-0.5571560681709588,-0.5307416864330285
2006-09-29T09:30:00-04:00,34.49001,34.49001,33.94,33.99001,3217800,4818269.95,49.21530158339075,45.898780044987404,NaN,NaN,19.363476963248193,0.2958514452809318,0.01928432266099768,-0.005448431382184538,-0.024732754043182217,105077629,108633349.4,14.72676639746517,27.39582228208345,NaN,NaN,-0.7859951994271787,-0.5672064740036215
2006-10-02T09:30:00-04:00,34.19,34.42999,34.00999,34.24001,2674300,4769429.95,54.178881107694664,46.41609354545931,NaN,NaN,49.929306313305936,19.436642251522848,0.02952529056846941,0.012173859167404544,-0.017351431401064866,107751929,107847009,14.257420536525117,24.83105724051387,NaN,NaN,0.7510946780153904,-0.37887773800090546
2006-10-03T09:30:00-04:00,34.12,34.5,33.92999,34.38,5995500,4873659.95,56.72922346499082,46.99212773254451,NaN,NaN,67.10044092125362,46.40719041386487,0.04348839077834804,0.03700905707187019,-0.006479333706477856,113747429,109162289,18.912547815559705,22.94029149365059,NaN,NaN,2.8474746074782367,0.08202973992468626
2006-10-04T09:30:00-04:00,34.46001,34.52,34.27,34.52,4585301,4857140.05,59.17637076048752,47.97081802647099,NaN,NaN,106.16291103112488,60.49212660659464,0.05895400195702059,0.06721316873979788,0.008259166782777291,118332730,110641029.2,23.91402154162941,21.877022559164924,NaN,NaN,5.358597376405387,0.8358251165647863
2006-10-05T09:30:00-04:00,34.46001,34.92999,34.32001,34.41,3553200,4902955.05,56.47389090768941,49.132962171629586,NaN,NaN,126.1914466395001,73.74951637368656,0.05846184095870609,0.0813364679811599,0.022874627022453815,114779530,111937849.4,28.10226680083173,21.56171154417122,NaN,NaN,6.551990972656642,1.6524202388636229
2006-10-06T09:30:00-04:00,34.27,34.36,34.07001,34.22,5548000,4913885.15,52.05210196582269,50.11081571173519,NaN,NaN,47.737516232771775,79.42432422759127,0.04275479793949975,0.0763181244468285,0.03356332650732875,109231530,112768629.6,30.732813858370477,21.721041417627134,NaN,NaN,6.163908870781185,2.296918614851846
2006-10-09T09:30:00-04:00,34.17999,34.28,34.02,34.19,3019900,4738255.15,51.36819513334267,50.892853910106616,NaN,NaN,36.346843562644345,76.70783167745896,0.02844813015848756,0.0691234892054382,0.040675359046950646,106211630,112460569.8,30.290258672353914,21.725930263991778,NaN,NaN,5.648100727687458,2.775658916685505
2006-10-10T09:30:00-04:00,34.22,34.44,34.08,34.44,3658600,4389145.1,56.49768817560452,52.11356220652941,NaN,NaN,71.87248249833145,77.66223999287452,0.03357327643857387,0.08264195459516799,0.04906867815659412,109870230,111685130,29.152276836022367,21.774420715663464,NaN,NaN,6.78407163633238,3.348289305206487
2006-10-11T09:30:00-04:00,34.39,34.57001,34.31,34.52,3043600,4259965.15,58.023479548045486,53.51715226025878,NaN,NaN,96.31702342137483,75.6930624709245,0.039683715541281105,0.0986733225831955,0.058989607041914395,112913830,110601350,27.592028575133725,21.970155260582207,NaN,NaN,8.176020899870373,4.037965247301328
2006-10-12T09:30:00-04:00,34.60001,34.60001,34.37,34.50999,5498301,4375745.2,57.7505392662569,54.96186890340209,NaN,NaN,91.73730481030239,68.80223410508498,0.04025672264697959,0.10931051035063888,0.06905378770365929,107415529,109128549.8,25.587824347023982,22.240920030486183,NaN,NaN,9.225483925571856,4.779039344197117
2006-10-13T09:30:00-04:00,34.46001,34.58,34.36,34.55,3570200,4379805.2,58.58903030233255,55.49065477151822,NaN,NaN,86.06677468755404,76.46808579604142,0.040429343005660937,0.11959046646073546,0.07916112345507452,110985729,109479389.6,26.949061660876694,22.72261281179677,NaN,NaN,10.331288971071391,5.572217862322013
2006-10-16T09:30:00-04:00,34.45,34.72,34.45,34.72,3148000,4385810.2,62.0365589081677,56.355048662443416,NaN,NaN,110.54300872576896,91.30731882866635,0.048545471132585866,0.13984296237080684,0.09129749123822098,114133729,111063809.4,32.91730389120586,23.84582799660046,NaN,NaN,12.29038530738557,6.531956068759664
2006-10-17T09:30:00-04:00,34.71001,34.98,34.47,34.87,4641199,4277890.05,64.81960388075686,56.708963703095655,NaN,NaN,136.29353970269068,104.19153026953818,0.05982797696484121,0.1660824624442725,0.10625448547943128,118774928,112844749,38.95453323699509,25.515151964903506,NaN,NaN,14.805215654958628,7.713850295359515
2006-10-18T09:30:00-04:00,35.42,35.42,34.92999,35.25,2246600,4211950.05,70.68302212035918,57.685277651781554,NaN,NaN,213.44993946232128,127.61811347772748,0.08704536201728486,0.21506118800103735,0.1280158259837525,121021528,114466288.6,43.90466713681276,27.570985093343285,NaN,NaN,19.063303984148806,9.335200822329414
2006-10-19T09:30:00-04:00,35.33,35.49001,35.2,35.39,2813600,3760610.15,72.50142244474407,59.34857199902108,NaN,NaN,218.3620779151924,152.9430680987055,0.10730900705224791,0.2621520847990624,0.15484307774681447,123835128,117750208.4,52.33447333546952,30.25724987462931,NaN,NaN,23.19064003382632,11.314549281114687
2006-10-20T09:30:00-04:00,35.64,35.66,35.37,35.61,2682400,3702835.15,75.1136490624607,60.84391256721865,NaN,NaN,221.07164131866256,179.9440414249272,0.12701276297572434,0.3136090314664699,0.18659626849074556,126517528,120856568.2,58.66263479071512,33.42905089278574,NaN,NaN,27.589949727525305,13.639606487744775
2006-10-23T09:30:00-04:00,35.60001,35.78,35.32001,35.64999,4575000,3769785.15,75.56798112165747,62.189538114123415,NaN,NaN,183.1239167034733,194.46022302046805,0.13355538236388065,0.3535404964455964,0.21998511408171573,131092528,124248328,64.24444086033009,36.66704325312649,NaN,NaN,31.25843187314969,16.15658154280262
2006-10-24T09:30:00-04:00,35.69,35.74001,35.52,35.67999,3166400,3702475.05,75.92309476612456,63.38573268595463,NaN,NaN,158.3754132488729,198.8765977297045,0.1305639432323632,0.38319004312216975,0.25262609988980655,134258928,127345128,68.4353281727077,39.84713658391779,NaN,NaN,34.34725348755985,18.755248963482224
2006-10-25T09:30:00-04:00,35.61,36.16,35.61,36.06,8759801,3952065.1,79.90701717198027,65.05952741911825,NaN,NaN,164.81459416257712,189.14952866975568,0.1437927959843388,0.43236709487023006,0.28857429888589126,143018729,131744568.2,73.2348787123627,43.070894577598565,NaN,NaN,38.53659106780936,21.5811549783861
2006-10-26T09:30:00-04:00,36.14999,36.14999,35.83,35.89999,4093300,4024550.1,74.32989079305436,66.6507980496348,NaN,NaN,138.2541746650908,173.12794801973536,0.1317041874455523,0.4532045331928316,0.3215003457472793,138925429,134762628.4,75.9378916901377,46.29982870843909,NaN,NaN,40.280205893858955,24.252447966310793
2006-10-27T09:30:00-04:00,35.8,35.89999,35.67999,35.77,2865500,4006935.1,70.05233498663164,67.98537946772687,NaN,NaN,101.21115240620254,149.15585023724333,0.105996415269137,0.4539958648337006,0.3479994495645636,136059929,136671108.6,77.48624909544365,49.67097088151693,NaN,NaN,40.391880355864956,26.55808116481853
2006-10-30T09:30:00-05:00,35.74001,35.87,35.64999,35.75,2807200,4013580.1,69.39067022347318,68.90630675686035,NaN,NaN,86.87532326679364,129.9061315499074,0.07987777664130635,0.4478466703661965,0.36796889372489017,133252729,137103148.8,77.83398248468104,53.14823557070683,NaN,NaN,40.28554353958032,28.51914721835593
2006-10-31T09:30:00-05:00,35.75,35.89,35.66,35.78999,2889500,3858280.1,70.00081230355272,69.76183052511087,NaN,NaN,80.43285506415731,114.31761991296426,0.05851716111924554,0.4411153451239471,0.3825981840047016,136142229,137479809,78.15082527699633,56.75957819226845,NaN,NaN,40.36795369416231,30.21183385775684
2006-11-01T09:30:00-05:00,35.94,36.13,35.85001,36.00999,6893398,3973684.95,73.16938545625337,70.86317668153919,NaN,NaN,94.51878005859666,100.25845709216819,0.052612986280892504,0.4483644168558172,0.3957514305749247,143035627,137483188.6,78.15384266715239,60.51429378656333,NaN,NaN,41.36675165912692,31.805393543666852
2006-11-02T09:30:00-05:00,35.86,36.03999,35.69,35.84,3565800,3974314.95,67.25807144926284,71.48239390631991,NaN,NaN,72.75530242216065,87.15868264358215,0.03169794927278613,0.4353738671659073,0.4036759178931212,139469827,137592068.2,78.2580171800352,64.17921918078893,NaN,NaN,40.450989232486414,33.040478642069644
2006-11-03T09:30:00-05:00,35.99001,35.99001,35.42999,35.58,5147898,3954309.85,59.35900299672123,71.29113991264516,NaN,NaN,46.86592752590297,76.28963766752223,-0.003345678492630011,0.39949381977733367,0.4028394982699637,134321929,137244468.2,76.99569332398592,67.32767556884465,NaN,NaN,37.12945709727223,33.6246184213843
2006-11-06T09:30:00-05:00,35.60001,35.60001,35.21001,35.42,6933898,4150009.75,55.07255086731669,70.59492184025659,NaN,NaN,10.294668872874743,60.97350678873845,-0.039018396494317265,0.35406650265206707,0.39308489914638434,127388031,136071528.6,72.73235160632866,69.7403768809399,NaN,NaN,32.96613309882994,33.53054908959082
2006-11-07T09:30:00-05:00,35.42999,35.69,35.25999,35.3,5162199,4225189.7,52.03744864869788,69.26309516370934,NaN,NaN,4.3940897637897605,45.76575372866494,-0.07057375587364473,0.3048677043043284,0.37544146017797314,122225832,133288249.2,63.71659627437297,71.15551467647992,NaN,NaN,28.55404285983306,32.819619628196854
2006-11-08T09:30:00-05:00,35.27,35.8,35.24001,35.64999,4042200,4275119.7,59.114696822939464,68.30690047643759,NaN,NaN,21.276208987639194,31.117239514473454,-0.06773973487063834,0.2907667915896752,0.35850652646031356,126268032,129934730.2,54.88819462057209,71.33792333970153,NaN,NaN,26.859123905417743,31.96812023922841
2006-11-09T09:30:00-05:00,35.62,35.8,35.39999,35.64,7978102,4399109.75,58.84777337950201,67.14505221336911,NaN,NaN,23.728741869735696,21.31192740398846,-0.06631837060395168,0.27560856320537397,0.34192693380932565,118289930,125698750.8,46.18349038575315,70.44655588220425,NaN,NaN,25.448976644850557,31.036814011460145
2006-11-10T09:30:00-05:00,35.66,35.92999,35.66,35.91,2909500,4366074.75,63.62793100573949,66.29219149080355,NaN,NaN,67.81652904120033,25.502047707047943,-0.04783748180169012,0.282130081557213,0.3299675633589031,121199430,123074251,41.764162376613605,68.84082170479594,NaN,NaN,25.736851832233114,30.279676557284855
2006-11-13T09:30:00-05:00,35.98,36.03999,35.86,35.89999,2255100,4321429.75,63.334205134743684,65.39298508856204,NaN,NaN,90.99261130780461,41.64163619403392,-0.037393364995708556,0.2832258571142674,0.32061922210997595,118944330,121385510.8,39.16704671288691,66.75023017195159,NaN,NaN,25.87610924463508,29.6505955126206
2006-11-14T09:30:00-05:00,35.96001,36.07001,35.8,35.99001,3782100,4278474.8,64.90330378881343,64.32129127547871,NaN,NaN,92.58628615386363,59.28007547204869,-0.02606513108548858,0.2880378082531152,0.3141029393386038,122726430,121485630.4,39.40761948827248,64.33399737023086,NaN,NaN,26.45487541312672,29.19406406983576
2006-11-15T09:30:00-05:00,36,36,35.84,35.87,3269800,4329634.8,61.14645643122817,63.37961739249112,NaN,NaN,68.93981300067968,68.81279627465679,-0.028120810668576968,0.27895192600288254,0.3070727366714595,119456630,120123350,37.24910247475893,61.57051242627523,NaN,NaN,25.848229919082634,28.716087762585314
2006-11-16T09:30:00-05:00,35.96001,36.17999,35.92,36,3730000,4375454.8,63.60410482912153,62.91902952409754,NaN,NaN,112.36256953886978,86.53956180848361,-0.022438358672356107,0.2790247883310144,0.3014631470033705,123186630,121102690,39.801862542566084,58.87877052964112,NaN,NaN,26.04681694862992,28.334763360591687
2006-11-17T09:30:00-05:00,36.27,36.28,35.8801,36.03999,1785600,4330614.8,64.35111716991449,62.55906144884335,NaN,NaN,115.21241816697882,96.0187396336393,-0.017896765600189546,0.27909219000313357,0.2969889556033231,124972230,121857250,41.767487044506424,56.302592283914365,NaN,NaN,26.421794536825765,28.0614821000537
2006-11-20T09:30:00-05:00,36.05,36.09,35.92,35.92,1046700,4154199.8,60.34870631065295,61.869625306493376,NaN,NaN,71.42797817292455,92.10581300666328,-0.024477078121587448,0.2663926079513388,0.29086968607292624,123925530,122853490,44.35110859959286,53.888326806956975,NaN,NaN,25.613531572603065,27.711774881846466
2006-11-21T09:30:00-05:00,35.95,36.03,35.87,35.98,975300,4044644.8,61.633715406235254,61.04564887434922,NaN,NaN,59.205376243793964,85.42963102464935,-0.02614110522330504,0.25819330454379497,0.2843344097671,124900830,123288370,45.48806832886983,51.55505721136536,NaN,NaN,25.286433965959144,27.36529760814828
2006-11-22T09:30:00-05:00,35.92999,36.14999,35.92999,36.06,1658000,3689554.75,63.33967436350795,60.76576336822387,NaN,NaN,91.35021550180002,89.91171152487343,-0.023300534674941087,0.25520874142342365,0.27850927609836473,126558830,124708810,49.14298573479479,49.4754121081339,NaN,NaN,25.473564743424937,27.095050056044943
2006-11-24T09:30:00-05:00,36.14999,36.2,36.03999,36.2,296400,3499709.75,66.17425572914964,61.252567134825895,NaN,NaN,122.9966940111819,92.03853641933584,-0.013903310529232382,0.26113013793682427,0.27503344846605665,126855230,125442530,50.97161526109256,47.616549389355804,NaN,NaN,26.436205637983377,27.00092942489329
2006-11-27T09:30:00-05:00,36.14999,36.17999,35.75,35.8,2347400,3473804.75,53.45651680135092,61.13713613011406,NaN,NaN,27.162428004556197,74.42853838685133,-0.035318970954582196,0.2308847347728289,0.2662037057274111,124507830,125349650,50.722983736298424,46.044451684353646,NaN,NaN,23.310299247663938,26.473696542431952
2006-11-28T09:30:00-05:00,35.82001,36.14,35.6416,36.06,1914300,3429159.75,58.97553477642321,61.63271371066587,NaN,NaN,38.49033523919497,67.84100980010541,-0.0327247489783456,0.2252977695044791,0.2580225184828247,126422130,125848970,52.076361446642196,45.213006339515736,NaN,NaN,22.40299274214098,25.89216742810467
2006-11-29T09:30:00-05:00,36.22,36.56,36.12,36.50999,3169400,3443154.75,66.40127737991553,62.15318375044986,NaN,NaN,189.66442618195936,93.93281978773848,-0.003018286993079433,0.2542496597414754,0.25726794673455483,129591530,126787110,54.59932128203755,45.192372529620414,NaN,NaN,24.281038619420638,25.662006169721238
2006-11-30T09:30:00-05:00,36.55,36.74001,36.4227,36.74001,2642900,3230629.85,69.44577510301522,62.91018387355796,NaN,NaN,234.72387602788598,122.60755189295567,0.028093247730228366,0.29238450639734026,0.2642912586671119,132234430,127922230,57.51383993516399,46.001683211721186,NaN,NaN,26.910431542541126,25.84035265155265
2006-12-01T09:30:00-05:00,36.74001,36.86,36.56,36.72,2527600,3178719.85,68.8612088999496,63.2839894374301,NaN,NaN,213.13671645475864,140.63555638167102,0.04243417608680239,0.31733397877561487,0.2748998026888125,129706830,128492550,58.94005292739297,47.22853253677686,NaN,NaN,28.717836735845708,26.251421806451656
2006-12-04T09:30:00-05:00,36.88,37.17999,36.73,37.00999,1986200,3020634.95,72.47700683398125,63.93704670166136,NaN,NaN,223.54746338974206,179.9125634587082,0.0651985978242538,0.3563980499691297,0.2911994521448759,131693030,129929590,62.367964105825884,48.88574092198679,NaN,NaN,31.51465413995942,27.003312139809907
2006-12-05T09:30:00-05:00,37.16,37.39,37.05,37.10001,4029800,2875430.05,73.50549405459233,64.55148886350271,NaN,NaN,210.79492802811194,214.37348201649155,0.07913913439236714,0.3901233701353348,0.3109842357429677,135722830,131789730,66.29096941985611,50.80598020281419,NaN,NaN,34.074802423178866,28.013525037434043
2006-12-06T09:30:00-05:00,37.23,37.25,36.91,36.92,1993700,2717005.1,68.03090187697052,65.04323496677002,NaN,NaN,147.4281231150984,205.92622140311943,0.06940518686469949,0.39774071932384203,0.32833553245914254,133729130,132617250,67.8944329175962,52.994932377302575,NaN,NaN,34.43763321421498,28.93125477697418
2006-12-07T09:30:00-05:00,36.99001,37.14999,36.78999,36.88,3017300,2665760.1,66.83962147786339,65.27434329882301,NaN,NaN,112.07550872396425,181.39654794233508,0.0541197236217727,0.39598518698635843,0.34186546336458573,130711830,132312730,66.63823432729447,54.911816076211736,NaN,NaN,34.36097691952107,29.70692936876659
2006-12-08T09:30:00-05:00,36.82001,36.94,36.62,36.77,1986200,2366165,63.544271463512004,65.2167114626514,NaN,NaN,74.64376481523664,153.69795761443066,0.03156538085581706,0.38132218943435703,0.34975680857853997,128725630,132116490,65.79341668622153,56.62795390776282,NaN,NaN,33.30438185253731,30.220851152162407
2006-12-11T09:30:00-05:00,36.81,36.97,36.77,36.97,1897000,2315540,66.75373485336638,65.67421350141665,NaN,NaN,84.39392315382062,125.86724956724636,0.025348913038982623,0.38144294987726823,0.3560940368382856,130622630,131902410,64.82786734532348,58.090579532457866,NaN,NaN,33.36386462709731,30.669853077153107
2006-12-12T09:30:00-05:00,37.03999,37.14,36.88721,37.11,2842000,2344885,68.8228550055515,66.18772347279638,NaN,NaN,94.80581477568995,102.66942691676198,0.025811751108773484,0.38835872572425245,0.36254697461547897,133464630,131450770,62.73611325643182,59.322582741569434,NaN,NaN,34.04113573346547,31.15146488519773
2006-12-13T09:30:00-05:00,37.19,37.28,37.03999,37.25,1786000,2245080,70.78120297178414,66.71926123053039,NaN,NaN,103.96688535434127,93.97717936461054,0.030377955770266196,0.4005194193283117,0.3701414635580455,135250630,131755070,63.588586328837415,60.354411355429626,NaN,NaN,35.20536965996111,31.730594138735356
2006-12-14T09:30:00-05:00,37.13,37.44,37.13,37.31,2988400,2231010,71.60441597557212,67.10712981956057,NaN,NaN,108.01396748040244,93.1648711158982,0.032102052510916246,0.41026902919669084,0.3781669766857746,138239030,133260510,67.54433923549615,61.53817735360129,NaN,NaN,36.40404632411606,32.398230165218315
2006-12-15T09:30:00-05:00,37.10001,37.1664,36.86,36.94,2762800,2182650,60.31852697046992,67.59727340306907,NaN,NaN,58.085344045668506,89.85318696198456,0.004439628554645192,0.3837165123790811,0.3792768838244359,135476230,134610630,70.62640769286473,62.959850493356036,NaN,NaN,33.92654871750648,32.616561386973764
2006-12-18T09:30:00-05:00,36.94,37,36.62,36.67999,1896200,2188180,53.89045370089201,67.23405332624542,NaN,NaN,20.42475877890209,77.05935408700086,-0.03318240125738975,0.3377988822526987,0.37098128351008847,133580030,135202110,71.88599123706453,64.37482404981476,NaN,NaN,29.665371682470305,32.19496285775898
2006-12-19T09:30:00-05:00,36.56,36.9496,36.48,36.84,2418100,2256750,56.93221012542959,66.55769137949642,NaN,NaN,13.763888234374804,60.85096877873783,-0.04819438553870847,0.3107383015867029,0.3589326871254114,135998130,135708810,72.95587921099695,65.68600675902617,NaN,NaN,27.112755362481177,31.46893321557644
2006-12-20T09:30:00-05:00,36.85001,36.95,36.71001,36.72,1047000,2260335,54.05237785899944,65.45816300492386,NaN,NaN,14.719818784263465,43.00155546472227,-0.06600761758081813,0.2764231651493887,0.34243078273020683,134951130,135648910,72.60412651371169,66.76388437177957,NaN,NaN,24.109382678196297,30.41756885309356
2006-12-21T09:30:00-05:00,36.75,36.84,36.53,36.7,4136398,2384254.9,53.56604660803507,64.36565141264425,NaN,NaN,-14.949640819132693,18.40883380481524,-0.0781106072973804,0.24479252360848136,0.32290313090586176,130814732,134164050.4,64.32473536017736,67.14850454554988,NaN,NaN,21.562300091361344,29.152530458560385
2006-12-22T09:30:00-05:00,36.60001,36.73,36.48,36.57001,2591700,2499019.9,50.39247918038223,62.78818515167289,NaN,NaN,-47.26857432357874,-2.661949869034204,-0.09284134399900762,0.20685145090710222,0.29969279490610984,128223032,132713410.8,57.434008359973376,66.79607913513185,NaN,NaN,18.457713248764037,27.624699428589476
2006-12-26T09:30:00-05:00,36.56,36.82001,36.5,36.75,1393300,2451314.9,54.419299462750246,61.424885537969885,NaN,NaN,-37.75249463911576,-14.297400552637772,-0.088453088410616,0.18912643439283983,0.2775795228034558,129616332,131920671.2,54.027882507766435,65.92014435569686,NaN,NaN,16.961528066789793,26.101389234046664
2006-12-27T09:30:00-05:00,36.89,37.00999,36.82001,36.95,1447400,2427969.9,58.45483786445907,60.74088096564764,NaN,NaN,22.872528538236704,-12.475672491865387,-0.07083286452676629,0.189038442144998,0.2598713066717643,131063732,130933791.6,50.048625241890925,64.6454438074322,NaN,NaN,16.89268398199815,24.78585991232545
2006-12-28T09:30:00-05:00,37.10001,37.10001,36.73,36.73,1411200,2340059.9,52.905991329265156,59.74562166931919,NaN,NaN,-13.926841241723587,-18.2050044970628,-0.07248475689033454,0.1692653605588461,0.24175011744918065,129652532,129874072,46.120464738221365,63.17988883678413,NaN,NaN,15.105500500297875,23.40295142489294
2006-12-29T09:30:00-05:00,36.81,36.81,36.60001,36.72,1313500,2273589.9,52.66129032478814,58.968265873696055,NaN,NaN,-77.04353101280354,-30.623782535796984,-0.0725625266026966,0.1510469591958099,0.2236094857985065,128339032,129378932,44.368235362369965,61.64951874222329,NaN,NaN,13.60580028406019,22.003358404773977
2007-01-03T09:30:00-05:00,36.41,37.10001,36.41,36.82001,4229301,2358674.95,54.90756417921878,58.12211082554266,NaN,NaN,-50.979230705316205,-31.365913812144477,-0.0644636240436807,0.14302995574390565,0.20749357978758634,132568333,130247992.2,48.09564891617868,60.454360282998664,NaN,NaN,12.989945013302364,20.71572792027803
2007-01-04T09:30:00-05:00,36.86,36.94,36.66,36.77,2958400,2407284.95,53.53946241513046,57.03043992622687,NaN,NaN,-41.1049000018837,-32.03639488469806,-0.06109129985546108,0.13112945496826,0.19222075482372109,129609933,130246712.4,48.09053891128512,59.408247829773906,NaN,NaN,12.09509302935294,19.484208650145874
2007-01-05T09:30:00-05:00,36.67,36.67,35.99001,36.11,3784500,2395019.95,39.538016962987655,54.7987837827414,NaN,NaN,-239.03935123952533,-84.41877084025047,-0.09964718354972207,0.06766177538656848,0.16730895893629055,125825433,129199052.6,43.97190088358044,58.007056012255546,NaN,NaN,6.340432357006626,17.606526322554554
2007-01-08T09:30:00-05:00,35.97,36.22,35.92999,36.09,2415000,2416084.95,39.20344171691978,52.484428478551955,NaN,NaN,-261.1712727908147,-133.8676571500687,-0.12139127159536112,0.015569869442089157,0.13696114103745027,123410433,127950632.8,39.61770153437244,56.012296176461,NaN,NaN,1.7751138386090795,15.3448959677052
2007-01-09T09:30:00-05:00,35.94,36.17999,35.87,36.12,2342100,2382324.95,40.02329747270864,51.034769228711866,NaN,NaN,-213.8698897856485,-161.2329289046377,-0.12799063234751085,-0.023027149396938285,0.10496348295057256,125752533,127433333,37.94117589055131,53.67763676201004,NaN,NaN,-1.620722433317055,12.921236196130593
2007-01-10T09:30:00-05:00,35.99001,36.2,35.95,36.13,1918100,2378919.95,40.31223715151937,50.06489661804239,NaN,NaN,-163.09800297028377,-183.6566833576312,-0.12573625877406513,-0.05220684051700886,0.07352941825705628,127670633,126453793,34.92713949820782,51.037718780663134,NaN,NaN,-4.2805438567737095,10.463839045715693
2007-01-11T09:30:00-05:00,36.19,36.36,36.03999,36.17,4538301,2510985,41.52572141285067,48.964433138572474,NaN,NaN,-116.28467945458283,-198.69263924817102,-0.11584960575646334,-0.0712825889385229,0.04456701681794044,132208934,126973593.2,37.753027148660266,48.52322934763909,NaN,NaN,-6.1596390091320545,8.089056466451728
2007-01-12T09:30:00-05:00,35.98,36.25,35.72,35.87,10246000,2881185,35.66863903690685,47.65130893699443,NaN,NaN,-143.4937726436387,-179.5835235289937,-0.12313142354571255,-0.10934726261420025,0.013784160931512298,121962934,126201093.4,35.299609361575065,45.858620979629336,NaN,NaN,-9.665636688358228,5.552671730050307
2007-01-16T09:30:00-05:00,35.83,36.07001,35.83,35.98,4051700,2994470,39.06258029020933,46.61534705714973,NaN,NaN,-119.84831322925136,-151.31893161668103,-0.1143464977205706,-0.12914896121920094,-0.01480246349863035,126014634,126721933.6,38.214979679015535,43.99363843097492,NaN,NaN,-11.61664898717015,3.099911627590241
2007-01-17T09:30:00-05:00,35.99001,36.06,35.85001,36.06,1722400,2931170,41.48061922057319,45.97878563144908,NaN,NaN,-99.39231638721235,-128.4234169369938,-0.0976056797069324,-0.13680956313229586,-0.039203883425363455,127737034,127118833.8,40.418219666072055,42.77822495283912,NaN,NaN,-12.547705006498427,0.8645378227204317
2007-01-18T09:30:00-05:00,36.19,36.19,35.89999,36.03999,2210300,2903545,41.041938170194754,45.02325982483797,NaN,NaN,-78.98924115626966,-111.60166457419095,-0.08291578541471423,-0.14284861519375625,-0.05993282977904201,125526734,126690054,38.80816934102784,41.69110258378635,NaN,NaN,-13.434312176118787,-1.1781550342565996
2007-01-19T09:30:00-05:00,35.86,36.10001,35.7,36.05,2427100,2930090,41.37594180630331,43.80333867782685,NaN,NaN,-86.94511196622159,-105.7337510765187,-0.06817665079588107,-0.14515364327389335,-0.07697699247801228,127953834,125839034,35.76316219601769,40.67071236622398,NaN,NaN,-14.08208026331857,-3.0215729241225953
2007-01-22T09:30:00-05:00,36.05,36.13,35.97,36.03999,2778500,2948110,41.12504274167293,42.96184235014169,NaN,NaN,-62.349715263434376,-89.50493960047784,-0.05530154433799098,-0.146103922900501,-0.09080237856251003,125175334,126481514,39.61525653486541,40.206054637412834,NaN,NaN,-14.690811891667163,-4.688607062343248
2007-01-23T09:30:00-05:00,36.03999,36.25,35.87,36.25,3458200,3068670,48.21933900092626,42.64456011272298,NaN,NaN,-43.129331558957844,-74.16114326641915,-0.030102503175730017,-0.12843050753217256,-0.09832800435644254,128633534,127005294,42.635420734910824,40.08228216402289,NaN,NaN,-13.29752615788836,-5.918452647421121
2007-01-24T09:30:00-05:00,36.25,36.47,36.14999,36.37,2970800,3010390.1,51.793777057378136,42.42214674687722,NaN,NaN,2.073116057517511,-53.86805677747316,-0.004175652098607124,-0.10354756947970145,-0.09937191738109433,131604334,127778754,46.8619382193094,39.99415997138937,NaN,NaN,-11.06163221510402,-6.653192585661535
2007-01-25T09:30:00-05:00,36.37,36.5,36.23,36.34,4437801,3102695.15,50.84874804433323,42.22995286324885,NaN,NaN,10.828723038156948,-35.90446393858784,0.011285115340714233,-0.08526552320520153,-0.09655063854591577,127166533,128106713.8,48.59151983116583,40.02994432280942,NaN,NaN,-9.438804028409253,-7.051137077482638
2007-01-26T09:30:00-05:00,36.38,36.38,36.08,36.25,2482400,3157150.15,48.01814557748136,42.83567633571268,NaN,NaN,-11.951789722795658,-20.90579948990264,0.015520684451054784,-0.07714978298209729,-0.09267046743315208,124684133,127452773.6,45.41715128904387,40.13317649462824,NaN,NaN,-8.78018555844112,-7.298144003333849
2007-01-29T09:30:00-05:00,36.25,36.37,36.21001,36.37,2389600,3204260.15,51.86563375776755,43.74011862434467,NaN,NaN,17.42004189503136,-4.951848058209497,0.025864815807637137,-0.06033944767360566,-0.0862042634812428,127073733,127832453.4,47.559204592119144,40.700426713038716,NaN,NaN,-7.1203548555276015,-7.272745553647242
2007-01-30T09:30:00-05:00,36.28,36.48,36.28,36.48,1987100,3233055.15,55.14318916127707,44.82011088781383,NaN,NaN,57.507607850878244,15.175539823757726,0.03879829139375508,-0.03770639923904895,-0.07650469063280403,129060833,127917913.2,48.053356673212704,41.42272534037168,NaN,NaN,-4.734350714168632,-6.910117719436013
2007-01-31T09:30:00-05:00,36.34,36.67,36.25,36.59,6324398,3483600.05,58.207795840836965,46.09836507990794,NaN,NaN,94.72272765412252,33.70546214307873,0.05258829446306225,-0.010769322553976224,-0.06335761701703847,135385231,128674092.6,52.33344541172861,42.66603290562316,NaN,NaN,-1.7684944355524799,-6.1756001074526505
2007-02-01T09:30:00-05:00,36.64999,36.94,36.63,36.89999,2998100,3422040,65.38493249689627,47.80259444305407,NaN,NaN,199.46491670394371,71.43270087623608,0.07883529284363694,0.0351864990375077,-0.04364879380612924,138383331,130917452.2,62.26646899683667,44.416993037635756,NaN,NaN,3.375985970699602,-4.811087810573757
2007-02-02T09:30:00-05:00,36.91,37.10001,36.60001,37.10001,2175300,3382885,69.07531699588779,50.18878572583842,NaN,NaN,224.8985029621306,118.80275941322134,0.10431647345782964,0.08674679801615781,-0.017569675441671827,140558631,134092351.8,71.36197005811205,46.99287594453126,NaN,NaN,9.069188225058813,-2.8281912340548185
2007-02-05T09:30:00-05:00,37.17,37.57001,37,37.5,3009100,3344115,74.84974771025934,52.7450119701277,NaN,NaN,260.7722166869969,167.47319437161445,0.1405057486285226,0.15806251034398144,0.017556761715458825,143567731,137391151.4,77.44536051124983,49.79504600397656,NaN,NaN,16.458875351814214,-0.07289600750209946
2007-02-06T09:30:00-05:00,37.46001,37.82001,37.46001,37.7,2688100,3357770,77.14749987239274,55.29264630240052,NaN,NaN,247.01634733723628,205.37494226888603,0.16842641280316198,0.2280897777194113,0.05966336491624932,146255831,140830151,81.78854335229877,52.75006912442133,NaN,NaN,23.327060949908848,3.26995498641375
2007-02-07T09:30:00-05:00,37.64,37.86,37.64,37.84,1595300,3320430,78.6199870599967,57.97679265167209,NaN,NaN,203.85943685106622,227.20228410827477,0.18548788674934075,0.29152322335292524,0.10603533660358451,147851131,143323331,84.16864975503655,55.99010343970766,NaN,NaN,29.3379661957439,6.993956587746628
2007-02-08T09:30:00-05:00,37.64999,38.05,37.64999,37.91,1720000,3310525,79.33690247358612,60.6882898421923,NaN,NaN,171.16453180652627,221.5422071287913,0.1899586390993121,0.34348363547772465,0.15352499637841255,149571131,145560891,85.94412751138451,59.57445810509101,NaN,NaN,34.3149242641097,10.89695197008421
2007-02-09T09:30:00-05:00,37.99001,38.28999,37.85001,38.03999,3882400,3277729.95,80.63546709582899,63.5104630103463,NaN,NaN,157.32758848717927,208.02802423380103,0.18969887433907723,0.3906485893022591,0.20094971496318187,153453531,148139871,87.66168436756799,63.006345807426904,NaN,NaN,38.83423047777975,14.887991756897858
2007-02-12T09:30:00-05:00,38.11,38.14,37.89999,37.89999,2131595,2872009.7,75.15721991690123,65.43459736148736,NaN,NaN,126.16196057981446,181.10597301236456,0.168825237236585,0.4119812615089131,0.24315602427232813,151321936,149690712,88.56645443387417,66.28713392878143,NaN,NaN,40.84168284410182,18.59566191221271
2007-02-13T09:30:00-05:00,37.92999,38.25,37.92999,38.23,3104356,2824642.5,78.81148311638778,67.36443350855947,NaN,NaN,122.74575917669284,156.25185538025585,0.16573560816144872,0.45032553447413903,0.2845899263126903,154426292,151324804.2,89.44475774405274,69.32876389483452,NaN,NaN,43.87270805028375,22.206668503365712
2007-02-14T09:30:00-05:00,38.11,38.58,38.11,38.5,2598082,2868426.6,81.24253943013981,69.53541860754567,NaN,NaN,126.95957661260633,140.87188333256387,0.16974717126429423,0.4967738903930581,0.32702671912876385,157024374,153159452.8,90.34181494217336,72.31092783133506,NaN,NaN,47.289606776430425,25.789945399517812
2007-02-15T09:30:00-05:00,38.41,38.5,38.14999,38.17,6272801,3071551.65,70.58319208002989,71.14720764344199,NaN,NaN,101.99540625743747,127.03805822274612,0.1393218448544728,0.5011790251968549,0.36185718034238207,150751573,153395541.2,90.45424147373201,75.52786284452706,NaN,NaN,46.34979466706554,28.727066723453202
2007-02-16T09:30:00-05:00,38.11,38.24001,37.99001,38.24001,2887700,3094581.65,71.43933498376363,72.54532915958455,NaN,NaN,82.89221903882193,112.15098433307465,0.1141172501747586,0.5045037430608303,0.39038649288607175,153639273,153432689.6,90.4730336928204,78.59313635172,NaN,NaN,45.90841230011386,31.18154466297615
2007-02-20T09:30:00-05:00,38.19,38.39999,38.11,38.34,2281000,3069706.65,72.6630544764828,73.79674811067068,NaN,NaN,85.6379776752439,104.04618775216053,0.0951593327673842,0.509335658845302,0.41417632607791777,155920273,154352357,90.94812962428932,81.65704870536834,NaN,NaN,45.94659142294039,33.29083705725676
2007-02-21T09:30:00-05:00,38.28,38.31,38.03999,38.17999,1938000,2993696.65,67.66658689498536,74.47237604310986,NaN,NaN,70.25373262370208,93.54778244156239,0.06430103705231155,0.4945526223933072,0.43025158534099567,153982273,154263553.2,90.47892793242019,84.3817260282749,NaN,NaN,44.36265580090393,34.87252544920636
2007-02-22T09:30:00-05:00,38.2,38.37,38.03999,38.23,2019500,2946131.65,68.39799286919761,74.68759464113138,NaN,NaN,67.98770425400909,81.75340796984294,0.04085788829969039,0.48132394571560866,0.44046605741591827,156001773,154059033,89.33583681697502,86.31525230114191,NaN,NaN,43.312043050895305,36.07817082087621
2007-02-23T09:30:00-05:00,38.25,38.7,38.17999,38.67,3985200,2923501.6,73.97581430377076,75.03763016312303,NaN,NaN,91.50318275493721,79.65496326934289,0.0480864659235577,0.5005741398203654,0.45248767389680766,159986973,155906113,90.5028143890125,87.6824554676348,NaN,NaN,44.18810730990439,37.236733176451665
2007-02-26T09:30:00-05:00,39.5,40.3,39.42999,39.59,7878594,3193311.3,81.37722094047254,75.50387825099538,NaN,NaN,205.50559434028366,104.17763832963524,0.10468343329617696,0.5833419655170289,0.4786585322208519,167865567,158751371.8,91.96198277779594,88.71935705810237,NaN,NaN,48.093826683113974,38.78774653454628
2007-02-27T09:30:00-05:00,39.45,39.59,38,38.14999,6929699,3420316.25,55.00684931424503,73.9224032111277,NaN,NaN,78.61345162464863,102.77273311951618,0.0384077248808436,0.5266681883219064,0.48826046344106283,160935868,159754490.8,92.40503182767938,89.47767766348672,NaN,NaN,38.64659094359227,38.767581450124275
2007-02-28T09:30:00-05:00,38.3,38.81,38.25999,38.45,6458199,3643871.2,58.05638788344288,72.45357469851672,NaN,NaN,66.55293622153921,102.0325738390836,0.009548558293405285,0.5001961613078194,0.4906476030144141,167394067,162436849.6,93.44542296928007,90.14030432164695,NaN,NaN,33.5594606316844,38.02356419034715
2007-03-01T09:30:00-05:00,38.22,38.86,37.87,38.64999,5792918,3617297.2,60.00254250865611,71.072548986736,NaN,NaN,56.15672908269807,99.66637880482139,-0.0007506053860294459,0.48970934628187734,0.4904599516679068,173186985,165873892,94.48744384016354,90.75054120227404,NaN,NaN,30.76515414136349,36.98664846906377
2007-03-02T09:30:00-05:00,38.64,38.64,38.05,38.05,7719102,3853347.3,52.18018683281025,69.04002896794894,NaN,NaN,14.655021909436163,84.29674663572118,-0.04992796355044654,0.4280499972298486,0.47797796078029514,165467883,166970074,94.77285986257156,91.25848230906,NaN,NaN,25.304627043189114,35.31778826536739
2007-03-05T09:30:00-05:00,37.91,38.21001,37.47,37.57001,2615000,3875332.3,46.91130693633603,67.02246375505143,NaN,NaN,-96.7480604810545,23.846015671453518,-0.11312354685910697,0.3365735272064114,0.4496970740655184,162852883,165967537.2,90.17441487138149,91.37333662602482,NaN,NaN,18.95154982247343,32.97975420209683
2007-03-06T09:30:00-05:00,37.82001,38.13,37.67,38.13,6222102,4035982.4,52.888195685921765,65.17080036716101,NaN,NaN,-60.95694472208902,-4.06806359789401,-0.11516573974431576,0.3057398993851237,0.42090563912943946,169074985,167595360.6,90.94285490459498,91.48034356606354,NaN,NaN,16.29391457970035,30.59606282746876
2007-03-07T09:30:00-05:00,38.10001,38.32001,37.97,38.05,2320800,4017617.4,51.98772750574072,63.08117094398964,NaN,NaN,-36.96715285625285,-24.77208141345242,-0.11935129777470121,0.2717165169110629,0.3910678146857641,166754185,167467384.2,90.34463451668216,91.48054496424275,NaN,NaN,14.017687381952609,28.22772347810931
2007-03-08T09:30:00-05:00,38.78,38.78,38.07001,38.25,2502700,4062987.4,54.092095932721286,61.903235504896166,NaN,NaN,19.5106868445739,-32.10128986107726,-0.10651989006707535,0.2579179521019199,0.3644378421689953,169256885,166681364.2,86.57770838690239,91.20364974375491,NaN,NaN,12.96852725931423,26.04783830399573
2007-03-09T09:30:00-05:00,38.27,38.39,38.03,38.2,3445000,4149237.4,53.46123563116525,60.61908555113915,NaN,NaN,-27.87620917572858,-40.607536078110215,-0.09940685708140695,0.24017927081723656,0.3395861278986435,165811885,166750164.6,86.6302556247314,90.92916559603427,NaN,NaN,11.955000425078415,24.034575749864683
2007-03-12T09:30:00-04:00,38.2,38.63,38.09,38.63,6427102,4276472.5,57.998059127101435,59.57158588332619,NaN,NaN,33.4986530993958,-14.558193362020154,-0.06539182056325937,0.2578463521945693,0.3232381727578287,172238987,168627385.4,88.00958081047037,90.71926925219006,NaN,NaN,12.56602914642885,22.39621194937385
2007-03-13T09:30:00-04:00,38.57001,38.75999,38.00999,38.06,3887200,4364252.75,50.9128091291389,58.374887471480015,NaN,NaN,-19.178708710527847,-6.202546159707921,-0.07996687646202882,0.22327957718029268,0.3032464536423215,168351787,168482745.8,87.26256793147425,90.48952925212248,NaN,NaN,10.715361343268896,20.72751900564457
2007-03-14T09:30:00-04:00,38.16,38.39,37.75,38.25,7801602,4599115.05,52.97502315929988,57.2732467779159,NaN,NaN,-61.4110445982728,-11.09132450811191,-0.07554952723833558,0.20880954459440204,0.2843590718327376,176153389,170362586.6,88.61509534802401,90.438047718626,NaN,NaN,9.901883959240429,19.180999713301123
2007-03-15T09:30:00-04:00,38.32001,38.83,38.12,38.74001,9121289,4925275.4,57.88863557431607,56.12416258295485,NaN,NaN,58.77048013469176,-3.2393658500883418,-0.040141541196935526,0.23418214533656823,0.27432368653350375,185274678,173566145.2,90.47190204721167,90.43583969421165,NaN,NaN,10.828903789570084,17.987843152768118
2007-03-16T09:30:00-04:00,38.52,38.69,38.27,38.39999,2356470,4729458.85,53.695898549067174,54.146925269283045,NaN,NaN,25.605198442742903,7.456915673605957,-0.040044454330192325,0.22426811862076335,0.26431257295095567,182918208,176987409.8,91.97684825619935,90.43690151409761,NaN,NaN,10.232693036652242,16.879964564751564
2007-03-19T09:30:00-04:00,38.64999,38.75999,38.38,38.67999,3144515,4742299.6,56.490540960290026,54.25290324400054,NaN,NaN,60.56396982600717,12.869979018928229,-0.02242514710251786,0.23628113907280834,0.2587062861753262,186062723,179752157,92.94641579309615,90.47557179734167,NaN,NaN,10.63674129371257,15.988075526031707
2007-03-20T09:30:00-04:00,38.60001,39.25999,38.53,39.24001,3457083,4801103.75,61.495988889805474,54.4985890301693,NaN,NaN,144.2758179712547,45.56088435528474,0.02317444885479103,0.287674347243815,0.264499898389024,189519806,183985760.8,94.11850408624042,90.5236490199817,NaN,NaN,12.646583729061096,15.510719555035905
2007-03-21T09:30:00-04:00,39.37,39.8,39,39.7,4189500,4913678.75,65.05235688146513,54.859290056798514,NaN,NaN,213.01233350687278,100.44555997631386,0.07748464138138783,0.3613557001157588,0.28387105873437096,193709306,187496944.2,94.87859810693546,90.55158861046542,NaN,NaN,15.528498015239997,15.513259335065062
2007-03-22T09:30:00-04:00,39.78999,39.84,39.45,39.66,4243805,5024894,64.49450396231335,55.738884137477314,NaN,NaN,192.51859344712148,127.19518263879982,0.10232264014629683,0.411774358917242,0.3094517187709452,189465501,188335108.8,95.0432757926629,90.57090403404337,NaN,NaN,17.610846287939463,15.812914614047118
2007-03-23T09:30:00-04:00,39.7,39.86,39.5,39.85001,3563745,5003821.25,65.98663651229145,57.10140767861698,NaN,NaN,162.82867834222523,154.6398786186963,0.1218314767546182,0.46174106471421794,0.33990958795959975,193029246,190357316.4,95.42546137819657,90.94597878453017,NaN,NaN,19.778659441248532,16.379449589361606
2007-03-26T09:30:00-04:00,39.94,40.08,39.62,40.02,3664752,4793129.15,67.31023194048785,58.1315531253717,NaN,NaN,182.61216028608638,179.0495167107121,0.13542210410526245,0.5091872180911778,0.3737651139859154,196693998,192483571.4,95.79278475827408,91.29240234550723,NaN,NaN,21.967595111699747,17.17775609255277
2007-03-27T09:30:00-04:00,40.06,40.09,39.77,39.96001,2827900,4588039.2,66.32927242769486,59.15594919122557,NaN,NaN,148.82217060680372,179.95878723782192,0.12960542871166691,0.535771899875499,0.4061664711638321,193866098,193352829.8,95.93644150299879,91.69181713024416,NaN,NaN,23.488268484123708,18.07925786277719
2007-03-28T09:30:00-04:00,39.78999,40.27,39.78999,39.88,2879200,4409089.25,64.96930560716189,59.9328927393999,NaN,NaN,127.23244818926895,162.80281017430116,0.11035652505750881,0.5441121274857181,0.4337556024282093,190986898,192808348.2,93.7764887443547,92.20601572720501,NaN,NaN,24.390613607288163,18.980880111993045
2007-03-29T09:30:00-04:00,40.13,40.25,39.85001,40.11,2193200,4229103.35,67.06011031250065,60.90424093092385,NaN,NaN,116.17622376789349,147.53433623845555,0.10323020940867089,0.5627933641890479,0.459563154780377,193180098,193551267.6,93.97578728572721,92.7306965601333,NaN,NaN,25.749671151280424,19.94785026046267
2007-03-30T09:30:00-04:00,40.25,40.28999,39.36,39.7,7460258,4216161.15,60.16630851370837,61.05911588711007,NaN,NaN,78.89973768521052,130.7485481070526,0.0629970829381244,0.5383095084530325,0.4753124255149081,185719840,192089386.4,88.0037194285711,92.73027788999764,NaN,NaN,25.009749827409333,20.67097877002648
2007-04-02T09:30:00-04:00,39.81,40.66,39.8,40.64999,5148563,4342839.3,68.29830039418681,62.30093669175635,NaN,NaN,117.77840678623116,117.78179740708158,0.09077013732208977,0.5887750971675203,0.49800495984543053,190868403,190924267.4,83.45187165822891,92.45808529905153,NaN,NaN,26.946341863212425,21.567459211910187
2007-04-03T09:30:00-04:00,40.7,40.89999,40.5,40.7,4051700,4234319.2,68.66100572627778,63.42136401796905,NaN,NaN,130.17077831591342,114.0515189489035,0.10207073437690117,0.625593377816557,0.5235226434396558,194920103,191135068.4,83.61697951556702,92.1010770253046,NaN,NaN,28.585092095639514,22.56997819530009
2007-04-04T09:30:00-04:00,40.75,40.81,40.45,40.52,3331279,4284843.15,65.7453466113032,63.982557663468135,NaN,NaN,109.72853985772394,110.5507372825945,0.08754297762624164,0.6329513654724579,0.5454083878462163,191588824,191255453.6,83.71689692104702,91.61857665915001,NaN,NaN,29.063626989979657,23.497642308825743
2007-04-05T09:30:00-04:00,40.63,40.74001,40.44,40.7,2221516,4270783.95,67.24334325254085,64.95023228514482,NaN,NaN,103.4782737775681,108.01114728452941,0.08036290892374565,0.6458620240008983,0.5654991150771527,193810340,191381502,83.82811025696103,91.0365239449187,NaN,NaN,29.90265892801559,24.412644682995722
2007-04-09T09:30:00-04:00,40.95,41.00999,40.78,41,3446731,4270870.5,69.62734949359316,65.88857575180933,NaN,NaN,121.10300112016908,116.45179997152113,0.08563957614028328,0.6725485852525068,0.5869090091122235,197257071,193688948.2,85.74721375700088,90.52229522805476,NaN,NaN,31.331685031942158,25.4010790185595
2007-04-10T09:30:00-04:00,41,41.11,40.89999,41.00999,2709541,4084992.45,69.70641506351129,66.47503476421689,NaN,NaN,119.3820956611351,116.77253774650191,0.07974432188814462,0.6865894114724043,0.6068450895842596,199966612,195508590,87.05210904568212,90.01755272515774,NaN,NaN,32.51239602865261,26.416981448572802
2007-04-11T09:30:00-04:00,41.05,41.17999,40.85001,40.91,4218965,4101580.7,67.80386997112291,66.67157141347816,NaN,NaN,109.6975088227397,112.67788384786718,0.059955342557994284,0.6817892677817525,0.6218339252237582,195747647,195674098.8,87.16719369509438,89.46673812431196,NaN,NaN,32.98685447080812,27.35553473746356
2007-04-12T09:30:00-04:00,40.95,40.95,40.49049,40.73,3043822,3863691.7,64.39645675848601,66.6645680417762,NaN,NaN,79.70695422536234,106.67356672139485,0.027252714875899198,0.6558998188186322,0.628647103942733,192703825,195897099,87.33059050947963,88.915832032656,NaN,NaN,32.467394759653374,28.085800454919248
2007-04-13T09:30:00-04:00,40.73,40.78999,40.53,40.72,2469084,3531081.45,64.20341971390845,66.53719541332028,NaN,NaN,67.98548982658306,99.57500993119785,-0.0010427232334851988,0.6273436999008766,0.6283864231343618,190234741,195181979.2,83.6522023256721,88.07488495747567,NaN,NaN,31.98446326501757,28.642752284933295
2007-04-16T09:30:00-04:00,40.73,40.96001,40.67999,40.96001,1572458,3491880.85,66.7775161153088,66.49914428295035,NaN,NaN,80.71468529844206,91.49734676685246,-0.009135095970233653,0.6169675531715697,0.6261026491418034,191807199,194092004.8,78.24270166208643,86.82130759346228,NaN,NaN,32.235750692708564,29.15603777175833
2007-04-17T09:30:00-04:00,41,41.28999,40.85001,41.14999,2979257,3483617.95,68.6963670589528,66.66822247089733,NaN,NaN,101.35123817969047,87.89117527056354,-0.007312340168201481,0.6169622239315515,0.624274564099753,194786456,193055973.6,73.3850264502,85.21049223254808,NaN,NaN,32.97123858736511,29.701066459702158
2007-04-18T09:30:00-04:00,41.14999,41.45,41.09,41.45,1484467,3384987.15,71.49615488653204,67.13442599085235,NaN,NaN,123.96730805292898,90.74513511660139,0.007667998095112982,0.6338595617186442,0.6261915636235312,196270923,193160628.8,73.56357650901157,83.76671278716643,NaN,NaN,34.414407181003476,30.37440084845949
2007-04-19T09:30:00-04:00,41.28,41.36,41.06,41.25,4116500,3381337.15,67.182312481433,67.14315471720467,NaN,NaN,102.52118083039247,95.30798043760741,-0.001816986949378152,0.6239203299368086,0.6257373168861867,192154423,193050748.4,73.00976875177261,82.2691400347411,NaN,NaN,34.45678633273934,30.957598774785183
2007-04-20T09:30:00-04:00,41.47,41.62,41.25999,41.57001,2663524,3302323.1,70.27297300173134,67.86505932349202,NaN,NaN,132.70847972265867,108.25257841682253,0.0070508205607218155,0.6345508425870889,0.6275000220263671,194817947,193967389.6,74.71956576320765,81.32027191578656,NaN,NaN,35.388778165649725,31.590624402051546
2007-04-23T09:30:00-04:00,41.52,41.97,41.52,41.88,4339602,3341115.95,72.93225404954649,68.19605601316057,NaN,NaN,164.9161544006204,125.09287223725819,0.02630141453057655,0.6603767901895878,0.6340753756590113,199157549,195437459.6,77.21274388151284,80.87461993173542,NaN,NaN,37.00097467067478,32.36353158328344
2007-04-24T09:30:00-04:00,41.92999,42.17999,41.77,42.17999,2677651,3291760.9,75.24057937327706,68.6660255593748,NaN,NaN,177.02109099822025,140.22684280096416,0.050352467077292795,0.6970159595056273,0.6466634924283345,201835200,196847208.4,79.31907717797318,80.56762690762159,NaN,NaN,39.10435967967621,33.32650702562526
2007-04-25T09:30:00-04:00,42.21001,42.46001,42.2,42.3,2987556,3299743.7,76.11800607966356,69.40692980711484,NaN,NaN,188.94836062342162,153.22305331506269,0.06455089155103644,0.72735210686713,0.6628012153160936,204822756,198557575,81.54761369254912,80.41267810558602,NaN,NaN,41.10540334970467,34.43777792906518
2007-04-26T09:30:00-04:00,42.35001,42.53999,42.11,42.16,2482205,3279893.95,72.87359519194405,69.80909065992934,NaN,NaN,157.07700678674016,164.13421850633222,0.05508921944469325,0.7316627396219602,0.6765735201772669,202340551,200594800.6,83.78844478353031,80.40984485748383,NaN,NaN,41.85004802605757,35.49667365720695
2007-04-27T09:30:00-04:00,42.05,42.05,41.75,41.81,4199172,3380192.55,65.37182511850281,69.50512463313717,NaN,NaN,93.32340721638077,156.25720400507663,0.01776658478445159,0.6987817511578314,0.6810151663733798,198141379,201259487,84.45187750578101,80.31732083953956,NaN,NaN,40.25201234123286,36.17600775492494
2007-04-30T09:30:00-04:00,42.03,42.10001,41.5,41.64999,4730789,3243719.1,62.21844399732935,68.97026955698132,NaN,NaN,69.042149111877,137.08240294732795,-0.02297802295822915,0.6522926376755933,0.6752706606338225,193410590,200110095.2,78.4716081386804,79.70442791761089,NaN,NaN,37.971239177379466,36.432469386704156
2007-05-01T09:30:00-04:00,41.64,42.03,41.45,41.99001,3430932,3157837.55,65.97450257859052,68.83960045751473,NaN,NaN,70.01936766885466,115.68205828145483,-0.031768439468164766,0.6355601112986164,0.6673285507667812,196841522,199111359.6,73.59490514524752,78.73497873547896,NaN,NaN,37.091510517752624,36.52661811971108
2007-05-02T09:30:00-04:00,42.08,42.25999,41.96001,42.22,2755195,3093012.3,68.27214481125675,69.11643531842694,NaN,NaN,100.56930432073797,98.00624702091808,-0.027019230660259685,0.6335545124414566,0.6605737431017162,199596717,198066151.8,68.77766832764134,77.40977000820479,NaN,NaN,37.04037376071459,36.60001178271158
2007-05-03T09:30:00-04:00,42.36,42.36,41.98,42.17,1598729,3006384.8,67.2095814234746,69.33116115482451,NaN,NaN,93.2379556301511,85.23843678960027,-0.0318393337828764,0.6207745758731207,0.6526139096559971,197997988,197197639.2,64.97196927576708,76.07546764749729,NaN,NaN,36.6893322242267,36.61277184578517
2007-05-04T09:30:00-04:00,42.35001,42.35001,42.03999,42.09,2748966,3032757.3,65.45427090018879,69.2366436394588,NaN,NaN,83.38351700756996,83.25045874783811,-0.04424658009703519,0.5973056845347031,0.6415522646317383,195249022,196619167.8,62.491694774480756,74.95039572695404,NaN,NaN,35.90136922815836,36.51114290040991
2007-05-07T09:30:00-04:00,42.2,42.59,42.16,42.59,2021610,2961501.25,70.61906567112047,69.37397925461364,NaN,NaN,109.69335293469658,91.38069951240202,-0.023643800502018086,0.6119975140042158,0.6356413145062338,197270632,197391176.2,64.44256746845733,74.31164865682956,NaN,NaN,36.74202413448654,36.54412593384943
2007-05-08T09:30:00-04:00,42.49001,42.49001,42.17999,42.39999,2867500,2969399.2,66.54732203354246,69.0204911936858,NaN,NaN,90.17221425882775,95.41126883039665,-0.027411945135295768,0.6013763830871142,0.6287883282224099,194403132,196903498.2,62.24030526881137,73.50284356824383,NaN,NaN,36.21072989764357,36.496497928677165
2007-05-09T09:30:00-04:00,42.31,42.48,42.22,42.42999,2162600,2866580.95,66.87209651013671,68.99833291002179,NaN,NaN,87.1653952043075,92.73048700711055,-0.032154778979006426,0.5885948544986519,0.6207496334776583,196565732,196297301.2,59.51756241103745,72.53911454390561,NaN,NaN,35.873493146413296,36.407497245496614
2007-05-10T09:30:00-04:00,42.36,42.42,41.94,42,3885249,2908652.3,58.15695496098715,68.13290304996863,NaN,NaN,47.004044092217015,83.48370469952373,-0.06654210188365295,0.5375720061230922,0.6041141080067451,192680483,195233800.2,54.973955966388914,71.12871384413285,NaN,NaN,32.87457371119327,35.90279388345328
2007-05-11T09:30:00-04:00,42.06,42.31,42,42.2,3631451,2966770.65,60.721114185615335,67.26067877397355,NaN,NaN,49.230597778078405,76.65312085362541,-0.07735122299472241,0.5074250792633421,0.5847763022580645,196311934,195446382.6,55.70192764826485,69.5922269703294,NaN,NaN,31.124539662028056,35.220186137535386
2007-05-14T09:30:00-04:00,42.34,42.56,42.34,42.37,2340247,3005160.1,62.80743662287336,66.37259714894472,NaN,NaN,89.6756146303019,72.64957319274649,-0.07455358284816571,0.49158432369785743,0.5661379065460231,198652181,195722692.4,56.68225297012387,67.97531095548304,NaN,NaN,30.28128422339544,34.51462872122968
2007-05-15T09:30:00-04:00,42.58,43.02,42.53,42.60001,5087168,3110555.65,65.47912924068376,65.61267737473187,NaN,NaN,144.28421043449424,83.47197242787976,-0.059374524569811404,0.49191975083375894,0.5512942754035703,203739349,197589935.8,62.69105253595403,66.62841373001196,NaN,NaN,30.3652449378314,33.92185960931564
2007-05-16T09:30:00-04:00,42.69,42.8658,42.59,42.7,3842851,3228474.85,66.60228919940451,65.16472694669334,NaN,NaN,140.31424817741416,94.1017430225011,-0.04539299068938463,0.4945530370418396,0.5399460277312242,207582200,199793229.4,68.2819820895154,65.52080925186803,NaN,NaN,30.76423338146192,33.47077014819368
2007-05-17T09:30:00-04:00,42.71001,42.746,42.49001,42.60001,2931725,3169236.1,64.34764904089725,65.09157151257865,NaN,NaN,110.95949013443709,106.89283223094512,-0.045553773613487336,0.48300381071436504,0.5285575843278524,204650475,202187227.8,73.01399374693948,64.70381755480791,NaN,NaN,30.45582507485297,33.04006370914501
2007-05-18T09:30:00-04:00,42.61,42.83,42.5901,42.83,2328600,3152489.9,67.10595496650703,65.44067943894848,NaN,NaN,134.3047260731627,123.90765788996195,-0.033407879250708095,0.48679773526446724,0.5202056145151753,206979075,204320656,76.39388783243857,64.55540896150492,NaN,NaN,30.986637939667457,32.74671717064822
2007-05-21T09:30:00-04:00,42.82001,42.89,42.71001,42.77,3134410,3092230.3,65.67836472383479,65.41952673503737,NaN,NaN,130.54577333390242,132.0816896306821,-0.032615446853053176,0.4794363059488589,0.5120517528019121,203844665,205359152.8,77.84828696185119,64.85922194840518,NaN,NaN,31.028198166762493,32.5012144558074
2007-05-22T09:30:00-04:00,42.95,43.10001,42.64999,42.69,4998785,3208287,63.73156831840115,65.09519984269053,NaN,NaN,121.22398860868607,127.46964526552044,-0.04018270115329525,0.461823376360293,0.5020060775135883,198845880,204380459,73.26693635448778,65.17988395032279,NaN,NaN,30.530968349396304,32.2197507263201
2007-05-23T09:30:00-04:00,42.87,42.87,42.02,42.02,7946645,3456241.45,50.28757233667316,63.886484907919005,NaN,NaN,-9.202447720341157,97.56630608596937,-0.090153794295398,0.3893138346443408,0.47946762893973877,190899235,201043866,60.249166416213505,64.8425408889261,NaN,NaN,25.72691158988497,31.29220227825794
2007-05-24T09:30:00-04:00,42.02,42.19,40.96001,41.08,14908023,4077532.35,38.13357738451221,61.935006799656385,NaN,NaN,-193.9130575242026,36.59179655424144,-0.18110851534621142,0.2530819847569745,0.43419050010318594,175991212,195312013.4,45.34430938852884,63.6177276470724,NaN,NaN,16.384468257090283,29.162525989519704
2007-05-25T09:30:00-04:00,41.12,41.35001,40.59,41.10001,12540699,4494608.7,38.474470054462195,59.63896425560937,NaN,NaN,-234.98862787519957,-37.26687423543102,-0.23130460522979301,0.14505974356594464,0.37636434879573766,188531911,191622580.6,38.70669346066226,61.7794509322299,NaN,NaN,9.514862385724845,26.355716903263296
2007-05-29T09:30:00-04:00,40.87,41.52,40.87,41.22,10780898,4797114.15,40.58852204338164,57.784764256312165,NaN,NaN,-178.55205858393055,-99.08644061899763,-0.24641493273493742,0.06834568287706588,0.3147606156120033,199312809,190716209.4,37.26356527694555,59.99539807566805,NaN,NaN,4.761505743815806,23.2708295947708
2007-05-30T09:30:00-04:00,41.03,41.73,40.95,41.73,8606109,5055873,48.66277732208154,56.48409860002251,NaN,NaN,-122.67627657757488,-147.86649365624982,-0.21329091922715515,0.04814696657805939,0.26143788580521454,207918918,192530817,41.93146000965283,58.73924790414058,NaN,NaN,3.347518379356931,20.424642278283102
2007-05-31T09:30:00-04:00,41.75999,41.95,41.60001,41.84,6213813,5228803.9,50.23376962736382,55.918156790477994,NaN,NaN,-62.50873432504861,-158.5277509771913,-0.17671190312768176,0.04054800689561233,0.2172599100232941,214132731,197177516.2,51.81777773251796,58.51380660172123,NaN,NaN,2.7462936075058746,17.8991638967435
2007-06-01T09:30:00-04:00,41.89999,42.00999,41.47,41.61,11632863,5730510.6,46.99546658372261,54.93775339034279,NaN,NaN,-70.21873310087,-133.7888860925248,-0.1611801343317834,0.015784742108564842,0.17696487644034825,202499868,202479247.4,60.15347507149144,58.831774274808836,NaN,NaN,1.2166359132610598,15.515945613388865
2007-06-04T09:30:00-04:00,41.42999,41.58,41.11,41.45,10742398,6130182.2,44.8304004503217,53.65367937801768,NaN,NaN,-101.05711504594781,-107.00258352667443,-0.15481997478137582,-0.016560092036371543,0.13825988274500428,191757470,203124359.2,61.036782509658806,59.142812099061345,NaN,NaN,-0.7077070692647615,13.198280944438348
2007-06-05T09:30:00-04:00,41.2,41.41,40.7,40.89999,15758758,6817039.6,38.29859386239983,51.71221256528311,NaN,NaN,-128.17391651565816,-96.92695511301989,-0.1790784733218803,-0.08558820890734609,0.0934902644145342,175998712,198461539.8,52.05465351190029,58.38306931162892,NaN,NaN,-4.615576907771439,10.65344410840838
2007-06-06T09:30:00-04:00,40.62,40.7,40.12,40.25,15417855,7444557.35,32.307747861304705,49.262602469704554,NaN,NaN,-169.91577283217285,-106.37485436393948,-0.2272288169569722,-0.19054575678168106,0.03668306017529114,160580857,188993927.6,39.38212335905788,56.31879368802482,NaN,NaN,-10.23082275179711,7.66997741409331
2007-06-07T09:30:00-04:00,40.10001,40.14999,38.95,39,27356832,8704268.95,24.402332566435845,46.4093655786716,NaN,NaN,-220.9175036809646,-138.05660823512267,-0.325603321687088,-0.3703210919335689,-0.044717770246480874,133224025,172812186.4,27.195753728394337,53.046062258128735,NaN,NaN,-18.795834567332534,3.8891471310324754
2007-06-08T09:30:00-04:00,39.07001,39.56,38.85001,39.28,19759008,9497956.9,28.615920577564154,43.66007740803282,NaN,NaN,-190.2912928362594,-162.07112018220056,-0.3519172620198371,-0.4846143477712772,-0.13269708575144015,152983033,162908819.4,22.58882789286092,49.20284369101604,NaN,NaN,-23.582106868045308,-0.03531772597863636
2007-06-11T09:30:00-04:00,39.28,40.03,39.21001,39.8,9541262,9793447.45,35.77530556107686,41.52414461069298,NaN,NaN,-133.76313362899128,-168.61232389880925,-0.31556728645754634,-0.5271561938233731,-0.21158890736582675,162524295,157062184.4,20.392540144332287,45.09886177547899,NaN,NaN,-24.67611508076662,-3.555431633805491
2007-06-12T09:30:00-04:00,39.5,39.77,39.14999,39.14999,11454676,10249168.9,31.519730746225576,39.223299069823284,NaN,NaN,-137.02810765727853,-170.3831621271333,-0.3157943713632584,-0.6063318715698998,-0.2905375002066414,151069619,152076365.8,18.720918909807438,41.202717672287534,NaN,NaN,-27.180782937586166,-6.930481820059873
2007-06-13T09:30:00-04:00,39.52,40.03,39.45,39.92999,8157199,10402670.45,40.64401201340452,38.534473332446964,NaN,NaN,-94.43508922674678,-155.2870254060481,-0.24695568830203857,-0.5992321105841896,-0.352276422282151,159226818,151805558,18.63158307712645,38.23003314806703,NaN,NaN,-25.676969837125164,-9.608551536783486
2007-06-14T09:30:00-04:00,39.92999,40.41,39.92999,40.17999,7624785,10591767.15,43.253770420699254,38.900201406460326,NaN,NaN,-62.40779038751586,-123.58508274735834,-0.17169705727773799,-0.5668977438793235,-0.39520068660158547,166851603,158531073.6,27.84111279149768,36.97980481970767,NaN,NaN,-23.57747795895516,-11.604112454236581
2007-06-15T09:30:00-04:00,40.35001,40.64999,40.25,40.44,13328898,11111625.8,45.917132447963255,39.431820148853255,NaN,NaN,-38.56053628243315,-93.23893143659309,-0.09532956190343345,-0.5143626389808773,-0.41903307707744386,180180501,163970567.2,34.31636020067933,36.666209586851735,NaN,NaN,-21.00850098162404,-12.947596529577647
2007-06-18T09:30:00-04:00,40.5,40.55,40,40,8320238,11411207.7,42.29910636330253,39.55400474313332,NaN,NaN,-49.6699083520846,-76.42028638121175,-0.06672608962987842,-0.5024406891147919,-0.4357145994849135,171860263,165837760.8,36.425310526907516,36.606334247563304,NaN,NaN,-20.133924441228015,-13.974214802670556
2007-06-19T09:30:00-04:00,40.03999,40.2701,39.84,40.25999,6506316,11579803,45.05410167678972,39.296242197041046,NaN,NaN,-47.37193655930786,-58.48905216161762,-0.024735814223257546,-0.46663436726398544,-0.4418985530407279,178366579,171297152.8,42.26253584720928,36.629982521674485,NaN,NaN,-18.523375969797662,-14.624094969403
2007-06-20T09:30:00-04:00,40.25999,40.41,39.07001,39.21001,9712234,11815475.45,37.30702271144877,38.37290313161854,NaN,NaN,-83.77328298543904,-56.356690913356104,-0.06009899672783525,-0.517022298950522,-0.45692330222268673,168654345,173182658.2,44.16915773626093,36.083652521941836,NaN,NaN,-19.809477957815815,-15.364863967747688
2007-06-21T09:30:00-04:00,39.11,39.63,38.95,39.46001,10081543,11922220.35,39.9544739341956,37.86997508522376,NaN,NaN,-95.69226786547321,-63.013586408947575,-0.05899336722385218,-0.530665011252502,-0.4716716440286498,178735888,175559515.2,46.56465375570864,35.113022427957354,NaN,NaN,-19.91683024771519,-16.0151448648859
2007-06-22T09:30:00-04:00,39.22,39.49001,38.67999,38.71001,8100008,11581819.6,35.157833972149035,37.17907747964,NaN,NaN,-118.25272916694962,-78.95202498585085,-0.09877095779739015,-0.5951353412753875,-0.49636438347799733,170635880,173650591,44.89846913852595,33.96028575859073,NaN,NaN,-21.675376368182803,-16.823749365356885
2007-06-25T09:30:00-04:00,38.88,40.3,38.7,38.92,9397383,11424653.8,37.42304246956978,37.11653809443785,NaN,NaN,-80.59054457898556,-85.13615223123104,-0.10059871356826755,-0.6221127754383318,-0.5215140618700642,180033263,175285191,46.65857524019137,33.57485159632581,NaN,NaN,-22.307393265226175,-17.60712706533821
2007-06-26T09:30:00-04:00,39.06,39.99001,38.69,38.71001,12716359,11521426.85,36.06618100175643,37.38499760447012,NaN,NaN,-88.55004734661203,-93.37177438869188,-0.1051172917504688,-0.6529106765581503,-0.5477933848076815,167316904,173075256,44.58501439393667,33.94648667024572,NaN,NaN,-23.242314294820186,-18.412153812407066
2007-06-27T09:30:00-04:00,38.49001,39.42,38.39999,39.28,12411105,11711676.65,42.19293755383361,38.65575510356996,NaN,NaN,-89.35605862829907,-94.48832951726389,-0.06106946895984733,-0.6241302210074906,-0.5630607520476433,179728009,175289988.8,47.121269038842684,35.36973776384918,NaN,NaN,-22.069420055535545,-18.934620418568276
2007-06-28T09:30:00-04:00,39.41,39.89999,39.25,39.27,9711371,11886554.55,42.116681983581344,39.62009520399976,NaN,NaN,-42.98167382223314,-83.94621070861588,-0.025764643748019456,-0.5952665567326676,-0.5695019129846481,170016638,173546138.8,45.36083739862877,36.99630987140402,NaN,NaN,-21.168928092261407,-19.253807229095866
2007-06-29T09:30:00-04:00,39.35001,39.77,39.05,39.58,10840816,11846952.2,45.41041204628595,40.308317095800405,NaN,NaN,-37.93115223571045,-67.88189532236804,0.022689877941774794,-0.5411395655574296,-0.5638294434992044,180857454,175590453.6,47.821851933912576,38.95554642780262,NaN,NaN,-19.426525334940365,-19.278481244216508
2007-07-02T09:30:00-04:00,39.88,43.14999,39.61,40.14999,4734473,11546555.95,50.93839349120284,41.69536443472736,NaN,NaN,160.5739985975911,-19.64898668705272,0.09338654813215241,-0.4470962583340139,-0.5404828064661663,185591927,176702186.4,49.16285155703226,41.12997018831868,NaN,NaN,-16.186931200133547,-18.836831237918943
2007-07-03T09:30:00-04:00,40.31,40.53999,39.94,40.14999,5404473,11028841.7,50.938393491202824,42.43067739742724,NaN,NaN,72.69194497133651,12.599411776536988,0.1377298527958094,-0.3683204904714046,-0.506050343267214,185591927,180357191,53.40290230535714,43.61363584747801,NaN,NaN,-13.598215083868592,-18.088457501626035
2007-07-05T09:30:00-04:00,40.03,40.42999,39.53999,40.07001,9681203,10742009.1,50.11257049784497,42.92059168865193,NaN,NaN,48.83737804813637,40.23809911182408,0.1578127782460016,-0.30878437045971197,-0.46659714870571356,175910724,179593734,52.419426957108094,45.369229716450185,NaN,NaN,-11.68576617016531,-17.17378731141736
2007-07-06T09:30:00-04:00,40.05,40.08,39.47,39.86,6424770,9695406,47.91590136449902,43.06336089697591,NaN,NaN,13.8898807232424,51.612410020919185,0.15297908979920072,-0.27537328645671266,-0.4283523762559134,169485954,179487597.2,52.275294696154624,46.652010751841274,NaN,NaN,-10.646211020645048,-16.2412764127356
2007-07-09T09:30:00-04:00,39.91,40.12,39.89999,39.92,3565061,8885708.65,48.60900937076472,43.514068254651775,NaN,NaN,36.36551932011552,66.47174433208438,0.14966427752973283,-0.24127202934374736,-0.3909363068734802,173051015,177926309.4,50.09331664712293,47.62829690328523,NaN,NaN,-9.592360197986785,-15.291431239200056
2007-07-10T09:30:00-04:00,39.83,39.98,39.37,39.55,6458918,8731591.45,44.66199223716388,43.48606043753565,NaN,NaN,-18.253702658155024,30.70620408093516,0.11969252475527897,-0.24132065092938149,-0.36101317568466046,166592097,174126343.4,45.1533369211382,47.83478269428016,NaN,NaN,-9.719570487853602,-14.495451131864849
2007-07-11T09:30:00-04:00,39.44,39.64999,39.37,39.64999,6583977,8488056.5,45.939523791757395,44.102667657557696,NaN,NaN,-32.727437548494464,9.62232757696896,0.10430474725189859,-0.23063224161978724,-0.3349369888716858,173176074,171643172.8,42.22307293658256,47.69577663716028,NaN,NaN,-9.488892557902599,-13.78022847844167
2007-07-12T09:30:00-04:00,39.73,40.3,39.73,40.14999,7250664,8442729.75,51.91724405001723,44.95715123725923,NaN,NaN,45.263763392702934,8.907604645882277,0.12415454771973777,-0.17974380422201364,-0.3038983519417514,180426738,172546375.6,43.655369121947096,47.487970591891596,NaN,NaN,-7.59658906356718,-12.896851419173885
2007-07-13T09:30:00-04:00,40.21001,40.92,40.17999,40.75,6749387,8398959.85,57.929125735214726,46.58367207747822,NaN,NaN,122.76468190824646,30.68256488288309,0.17114945128410913,-0.08996153783661498,-0.2611109891207241,187176125,176084409.8,48.989897464503805,47.78021547231858,NaN,NaN,-4.052175981082456,-11.633326356589395
2007-07-16T09:30:00-04:00,40.72,40.81,40.14999,40.16,8533672,8159198.55,51.15590744696612,47.5645910044351,NaN,NaN,87.72673014420653,40.954807047701294,0.15636108674199867,-0.06565963069322578,-0.22202071743522445,178642453,177202697.4,50.58247521340539,48.06049404183387,NaN,NaN,-3.007237304524155,-10.401027920580075
2007-07-17T09:30:00-04:00,40.14999,40.46001,40.11,40.2,7390902,8112731.75,51.56934611602069,48.67195994116826,NaN,NaN,69.05428411821389,58.41640440297507,0.14347214685731996,-0.04268053386357451,-0.18615268072089447,186033355,181090949,55.75491042148572,48.85834375808737,NaN,NaN,-2.0488453956928954,-9.207858988453335
2007-07-18T09:30:00-04:00,40.00999,40.53999,39.99001,40.5,8553871,8215109.5,54.668512985071786,49.56307247197099,NaN,NaN,78.38757993679766,80.63940790003349,0.14871497962512864,-0.0002589561894836834,-0.14897393581461232,194587226,185373179.4,60.64097053217939,49.82403672189714,NaN,NaN,-0.3139303967583126,-7.937297761068332
2007-07-19T09:30:00-04:00,40.69,41.33,40.53,41.14999,10251184,8242057,60.55771908988037,50.880289408135205,NaN,NaN,148.46807343634472,101.28026990876185,0.18704421090268614,0.08483132781374536,-0.10221288308894078,204838410,190255513.8,65.34053638029006,51.251158077730096,NaN,NaN,3.1124130569692965,-6.358767644205814
2007-07-20T09:30:00-04:00,41.12,41.75,40.47,40.7,7963496,8136154.65,55.21014795940997,51.58027054478692,NaN,NaN,128.66139664874177,102.45961285686091,0.17347760869852383,0.114634127784214,-0.05884348091430982,196874914,192195271.6,67.0251520219791,52.62282236973484,NaN,NaN,4.346511516446035,-4.829442049826979
2007-07-23T09:30:00-04:00,40.87,41.11,40.67,40.74001,4779828,7970145.65,55.58569153551397,51.912220405094864,NaN,NaN,102.48310188602267,105.41088720522414,0.15897015187219177,0.1398692089259299,-0.01910094294626187,201654742,196797729.4,70.66804933108338,54.15890792502422,NaN,NaN,5.441660301734745,-3.3621417138895904
2007-07-24T09:30:00-04:00,40.81,40.83,39.34,39.52,10015203,8001036.65,43.58519479139559,51.3869919265372,NaN,NaN,-25.420597304688947,86.51591092064358,0.063859632559333,0.06072359775290437,-0.003136034806428621,191639539,197918966.2,71.49425604218203,55.451147477654565,NaN,NaN,2.3473996468995226,-2.5464929480625744
2007-07-25T09:30:00-04:00,39.53,39.95,38.86,39.60001,13027172,8016577.3,44.43246686257808,50.98127023830385,NaN,NaN,-89.19715129105236,52.998964675073566,0.006033216101949684,0.004405485321008484,-0.0016277307809412,204666711,199934863.2,72.96851364965431,56.91893938426501,NaN,NaN,0.21547143913352804,-2.15192660703456
2007-07-26T09:30:00-04:00,39.11,39.28999,37.91,38.7,18394640,8315754.05,37.59296960964151,50.243917970099744,NaN,NaN,-197.5040834530458,-16.195466702804538,-0.08794922850887973,-0.11156426641704087,-0.02361503790816114,186272071,196221595.4,66.1790687858847,57.91206610496001,NaN,NaN,-4.092007499721573,-2.4290810202755617
2007-07-27T09:30:00-04:00,38.53,38.63,37.55,37.55,12646824,8462526.7,31.02200902073598,48.987703659383406,NaN,NaN,-246.4703842793385,-91.22182288842059,-0.21542017975820354,-0.29289026260591555,-0.07747008284771202,173625247,191571662,58.80075965232792,58.53402631961751,NaN,NaN,-10.429081294059205,-3.5719382022446537
2007-07-30T09:30:00-04:00,37.7,38.22,37.37,38.07001,11953105,8518141.15,36.43272068586286,48.39989854857619,NaN,NaN,-206.1005954935509,-152.9385623643353,-0.25013171737127116,-0.39013472956180095,-0.1400030121905298,185578352,188356384,54.293232280773374,59.186875988162875,NaN,NaN,-13.498625727571993,-4.990036420148559
2007-07-31T09:30:00-04:00,38.47,38.78999,37.7,38,14124813,8987658.15,36.02302900677521,47.69157749250604,NaN,NaN,-149.4916428007113,-177.75277146353977,-0.261967412631199,-0.46746227797952855,-0.20549486534832956,171453539,184319184,49.193902164151865,59.684792361560696,NaN,NaN,-15.96639510936589,-6.55808766146532
2007-08-01T09:30:00-04:00,37.89,39.10001,37.89,38.86,16436820,9539275.5,44.30784088496463,47.14804869500228,NaN,NaN,-93.41510666858441,-178.5963625390462,-0.19889638412878852,-0.4541153455093152,-0.2552189613805267,187890359,180963913.6,45.37923585978559,59.80792569997772,NaN,NaN,-15.209396917112866,-7.793988983700684
2007-08-02T09:30:00-04:00,38.78999,39.46001,38.78999,39.28,9305547,9520492.7,47.85902850660579,46.42875603581593,NaN,NaN,-40.80938672391865,-147.25742319322075,-0.11980800687831117,-0.40497896997841565,-0.2851709631001045,197195906,183148680.6,48.19612534779785,59.75122769164159,NaN,NaN,-13.388642247082302,-8.593225164183773
2007-08-03T09:30:00-04:00,39.17,39.52,37.73,37.95,14192359,9908872.15,39.310761909824045,45.58267421173435,NaN,NaN,-93.38015087268705,-116.63937651189046,-0.14623405416154683,-0.467963530802038,-0.3217294766404912,183003547,185024340.6,50.55377283363705,59.74917752165813,NaN,NaN,-14.890764252954195,-9.49287360543669
2007-08-06T09:30:00-04:00,37.98,39.23,37.44749,39.14,10965457,10278891.95,48.2220246350097,45.34357982023357,NaN,NaN,-69.121851039692,-89.24362762111868,-0.07625539171279516,-0.4170487162814851,-0.34079332456868994,193969004,186702471,52.63092265834773,59.526035538576856,NaN,NaN,-12.742740585589512,-9.957140316887093
2007-08-07T09:30:00-04:00,39.03999,40.3,38.78,39.85001,10269805,10469436.3,52.685977706067796,45.20197015744757,NaN,NaN,9.215376171004625,-57.502223826775506,0.020021439013302778,-0.31576652580206144,-0.3357879648153642,204238809,193259525,59.74644300734601,59.46214071537446,NaN,NaN,-9.367831256800216,-9.872953308303254
2007-08-08T09:30:00-04:00,40.16,40.75999,39.85001,40.42999,12531000,10766787.45,56.02138832144787,44.877946531130966,NaN,NaN,57.04259431325918,-27.410683630406776,0.1193906178432349,-0.1865496925113206,-0.3059403103545555,216769809,199035415,64.76704349386887,59.42117693777295,NaN,NaN,-5.496938957031164,-9.24780840097867
2007-08-09T09:30:00-04:00,39.92,40.39,39.35001,39.7,12301719,11019340.2,51.135222895231195,44.5868804551182,NaN,NaN,19.4614121209021,-15.356523861442625,0.1316175835623351,-0.14141833090163658,-0.2730359144639717,204468090,200489851.8,65.91973986631142,59.342218926653835,NaN,NaN,-4.095736539584253,-8.511798135065181
2007-08-10T09:30:00-04:00,39.34,39.98,38.77,39.00999,12530809,11308411.3,46.96541876233154,43.97114668560516,NaN,NaN,-17.417551313077325,-0.16400394952067926,0.09083598768466772,-0.15949092985813706,-0.2503269175428048,191937281,202276598.6,67.33364214987782,59.10404698513914,NaN,NaN,-4.421833276040738,-7.927517440918832
2007-08-13T09:30:00-04:00,39.33,39.7,39.14999,39.21001,7670602,11265257.8,48.28197718851954,44.30663114254259,NaN,NaN,-6.105675854638127,12.439231087490096,0.07556009272641201,-0.15587680163478979,-0.2314368943612018,199607883,203404374.4,68.22959205499389,58.870856700339985,NaN,NaN,-4.242416901562242,-7.401074506725034
2007-08-14T09:30:00-04:00,39.14,39.3,38.35001,38.55,6789699,11235197.65,44.368046947126906,44.30202972001037,NaN,NaN,-50.68545830690468,0.45906419190823017,0.02201414248417516,-0.20391921625598286,-0.22593335874015802,192818184,201120249.4,64.37831805238793,58.257271300535244,NaN,NaN,-5.378504033800966,-7.112135867735882
2007-08-15T09:30:00-04:00,38.46001,39.09,37.83,38.03,8226301,11218819.15,41.512776028435376,44.582015892781364,NaN,NaN,-77.19931674678706,-26.38931802010102,-0.04382683337632254,-0.2807169004605612,-0.23689006708423865,184591883,194684664.2,54.96448176562642,57.456229370516795,NaN,NaN,-7.237958365371402,-7.130110510255242
2007-08-16T09:30:00-04:00,37.53,38.3,36.69,38.3,18047104,11608615.15,43.5443359395918,45.47646781555677,NaN,NaN,-112.38194162622393,-52.75798876952622,-0.0634067557139707,-0.316148511726702,-0.2527417560127313,202638987,194318843.6,54.476836856337194,57.14737774223175,NaN,NaN,-8.114303022850084,-7.270709440625933
2007-08-17T09:30:00-04:00,38.95,39.63,37.73,38.63,18994640,12160172.35,46.012623249521184,46.1607465701038,NaN,NaN,-29.51092909970014,-55.17666432685079,-0.048991157394613516,-0.3139807027559982,-0.2649895453613847,221633627,200258112.8,60.59014065040094,57.597156911490856,NaN,NaN,-8.095737291347659,-7.388570562157608
2007-08-20T09:30:00-04:00,38.89,39.02,38.21001,38.84,7176410,12280001.45,47.58316337306194,46.986470453409986,NaN,NaN,-19.581175952322635,-57.87176434638769,-0.021569973715193425,-0.2919520125053765,-0.2703820387901831,228810037,206098543.6,65.49693423379284,58.761659202179494,NaN,NaN,-7.62387379537156,-7.422185309759601
2007-08-21T09:30:00-04:00,38.63,39.24001,38.56,38.8,6941551,12126318.85,47.30090189458765,47.20026052552591,NaN,NaN,6.341764854189497,-46.466319714168854,-0.0033398584731387793,-0.27455686188160655,-0.27121700340846777,221868486,211908604,69.5575587169973,60.488682263408904,NaN,NaN,-7.316330465749122,-7.407063189186675
2007-08-22T09:30:00-04:00,39.34,39.42,38.92,39.25,5818699,11765895.2,50.83433918115898,47.41278271656544,NaN,NaN,50.28849634584413,-20.968757095642616,0.03945208785182891,-0.22190189359368162,-0.26135398144551053,227687185,220527664.4,74.3754346363012,62.358632926873426,NaN,NaN,-6.0598912571078305,-7.214610056032554
2007-08-23T09:30:00-04:00,39.46001,39.77,39.2,39.37,13170102,11504668.3,51.76314851966889,48.30223890298292,NaN,NaN,73.04448423344444,16.11652807629106,0.07424594117275746,-0.16854655497956372,-0.24279249615232118,240857287,228171324.4,77.73998952883646,64.30050554795909,NaN,NaN,-4.757788535048813,-6.863635553034877
2007-08-24T09:30:00-04:00,39.63,39.78999,39.17999,39.61,6020000,11173327.1,53.649129323877496,48.68988923790205,NaN,NaN,73.8467618039817,36.78806625702743,0.10969169160213893,-0.10567788164964753,-0.21536957325178646,246877287,233220056.4,79.64143515339804,66.22982786903411,NaN,NaN,-3.1338169714257216,-6.330804327090712
2007-08-27T09:30:00-04:00,39.72,39.72,38.42,38.60001,27206096,11935976.65,45.57373949736701,48.18187222299485,NaN,NaN,-8.17158631119694,39.06998418525257,0.06366646255197145,-0.13578649506182217,-0.1994529576137936,219671191,231392287.2,77.07462535316407,67.46755517944969,NaN,NaN,-3.9533186152864457,-5.991163511118675
2007-08-28T09:30:00-04:00,38.35001,38.61,37.98,38,11494102,11804441.1,41.57049502633265,47.14966555905805,NaN,NaN,-104.52293399924721,16.89704441456523,-0.0049916224555203725,-0.2056924856831941,-0.20070086322767372,208177089,228654007.8,73.2649167414387,68.07454612570469,NaN,NaN,-5.877292443739142,-5.974896215778742
2007-08-29T09:30:00-04:00,38.14,39.10001,38.14,38.75,5383102,11251755.2,47.74895052492856,46.90778896117929,NaN,NaN,-42.43611259019646,-1.6478773726428884,0.0019294884101782872,-0.19828900271495087,-0.20021849112512916,213560191,225828609,69.45038131771022,68.32673480080459,NaN,NaN,-5.658633184284738,-5.92971578270817
2007-08-30T09:30:00-04:00,38.50999,38.99001,38.35001,38.67999,5028000,11037877.85,47.246720260224826,46.92788192531453,NaN,NaN,-37.676617027915945,-23.792097624914966,0.003523838767177989,-0.19581369266615667,-0.19933753143333466,208532191,219363589.8,61.55321830426505,67.91384738326082,NaN,NaN,-5.630824673831118,-5.8870170528685914
2007-08-31T09:30:00-04:00,38.78,39.07001,38.45,38.60001,5537301,10605124.95,46.643143009971695,46.81082234113254,NaN,NaN,-36.148930239241224,-45.79123603355955,0.0010516067039632593,-0.1980230230533806,-0.19907462975734386,202994890,210587110.4,52.77927037583167,66.81025297760638,NaN,NaN,-5.777825368255744,-5.871418240781042
2007-09-04T09:30:00-04:00,38.77,39.67,38.7,39.35001,4629000,10288302.1,52.74016726881859,47.408830935539086,NaN,NaN,33.16995662720447,-37.52292744587927,0.04912510584345803,-0.1376682474530213,-0.18679335329647934,207623890,208177650.2,50.644926768255345,65.82929645731119,NaN,NaN,-4.103525117398614,-5.618862080297838
2007-09-05T09:30:00-04:00,39.22,39.27,38.82001,39.25,6627801,10106201.9,51.888701228445214,48.14996844982551,NaN,NaN,20.550597442860443,-12.508221157457736,0.07200197932983729,-0.09679087913418272,-0.16879285846402,200996089,206741450.2,49.363520254654176,65.42922777795603,NaN,NaN,-2.9714684666500015,-5.240662992633861
2007-09-06T09:30:00-04:00,39.08,39.60001,39.00751,39.3,4777000,9718501.9,52.30329754920877,48.775608564798155,NaN,NaN,64.26402105688183,8.831805571957922,0.08729603316008674,-0.05967281701391158,-0.14696885017399833,205773089,205184029.8,47.94679326955381,64.9627960931858,NaN,NaN,-1.9233211518845086,-4.766757015383954
2007-09-07T09:30:00-04:00,39.2,39.37,38.78,39.00999,5545398,9380685.85,49.631734266164486,49.0341164945584,NaN,NaN,31.753786546304205,22.71788628680195,0.07513797376711315,-0.053046382965106886,-0.12818435673222003,200227691,203523129.8,46.416840826812326,63.95041753435803,NaN,NaN,-1.7382163395769301,-4.334108347411522
2007-09-10T09:30:00-04:00,39.13,39.25,38.72,39.03999,4747000,8991495.4,49.916719349889874,49.20079906433182,NaN,NaN,25.636466118256216,35.074965558301436,0.0666618431624842,-0.04485705277911478,-0.11151889594159899,204974691,203919090,46.852248416013246,62.61865426165949,NaN,NaN,-1.5093621352353468,-3.9305731742434973
2007-09-11T09:30:00-04:00,39.14999,39.49001,39.00999,39.3,5290199,8872475.25,52.42896010569223,49.56708893655357,NaN,NaN,78.5319444498867,44.14736312283789,0.07546457199383566,-0.01718818094930441,-0.09265275294314007,210264890,204447290,47.465507187042505,61.04065058094843,NaN,NaN,-0.6512998737606943,-3.462105559888811
2007-09-12T09:30:00-04:00,39.41,39.78999,39.31,39.63,3396300,8702805.3,55.48121213247964,49.89900843307647,NaN,NaN,122.26948531208342,64.49114069668248,0.09893050084748016,0.031010373116210133,-0.06792012773127003,213661190,206980310.2,50.42004748650446,59.329551498820095,NaN,NaN,0.9239555859357346,-2.83552539619959
2007-09-13T09:30:00-04:00,39.85001,39.95,39.63,39.71001,4318000,8507390.25,56.2147467688165,50.216979736587014,NaN,NaN,141.1015549635362,79.85864747801335,0.1141776562347957,0.07480194256222461,-0.039375713672571096,217979190,209421530.4,53.154475325063295,57.573443341407724,NaN,NaN,2.450750969176734,-2.080343058288687
2007-09-14T09:30:00-04:00,39.61,39.98,39.5648,39.7,3889800,7799525.05,56.09022680642945,50.39134384248358,NaN,NaN,131.8819404771107,99.88427826417464,0.11746906248619782,0.10746061443517618,-0.010008448051021641,214089390,212193870.2,56.114565562462346,55.89295265634089,NaN,NaN,3.710195904471513,-1.253123206465801
2007-09-17T09:30:00-04:00,39.88,39.88,39.47,39.73,2616200,6980603.05,56.4019204475486,51.16478533892512,NaN,NaN,108.76601791631425,116.51018862378626,0.11537990482045508,0.13421643297454722,0.01883652815409213,216705590,214540050,58.50424698865964,54.56649705887629,NaN,NaN,4.8657208100436575,-0.3790026326787356
2007-09-18T09:30:00-04:00,39.55,40.64999,39.25,40.64999,5315000,6887532.55,64.6816119851909,52.81557940741499,NaN,NaN,176.9061472024452,136.18502917429797,0.16656193950634957,0.2270389525370291,0.060477013030679524,222020590,216891190,60.80741388432206,53.676675426225096,NaN,NaN,8.384274797150676,0.8728941430111804
2007-09-19T09:30:00-04:00,40.56,41.14999,40.50999,41.10001,7010000,6890955,67.8935857855985,54.25448192603427,NaN,NaN,244.9652423685359,160.72418058558847,0.21807826287467105,0.33307484162401835,0.1149965787493473,229030590,219965070,63.64821362436115,53.26223487670016,NaN,NaN,12.459347043421689,2.5281017002126815
2007-09-20T09:30:00-04:00,41.05,41.07001,40.53999,40.53999,3709000,6785470.05,60.51776423322106,55.20241363839115,NaN,NaN,173.8012436992377,167.26411833272874,0.2021481034790564,0.3676817080981678,0.1655336046191114,225321590,221433550,64.95506954836458,53.505224251278705,NaN,NaN,13.866010658651165,4.147802979989608
2007-09-21T09:30:00-04:00,40.5,40.78999,40.32001,40.32001,4084600,6331194.95,57.85878287860043,56.00353077186463,NaN,NaN,122.19112924538643,165.32595608638388,0.16601870260774002,0.3730569828787864,0.2070382802710464,221236990,222863070,66.22788968014524,54.46583991587253,NaN,NaN,14.244281044124737,5.590156989151769
2007-09-24T09:30:00-04:00,40.42,40.82001,40.41,40.47,4041200,6232254.95,59.17586601254824,56.46322353927389,NaN,NaN,115.05574593522036,166.58390169016513,0.142355002275721,0.3849820331156977,0.24262703083997667,225278190,224577590,67.74119684039123,55.68700206388223,NaN,NaN,14.936952970953968,6.925413557980654
2007-09-25T09:30:00-04:00,40.38,40.8,40.32001,40.52,4101000,5077000.15,59.62883635047479,57.016090333704575,NaN,NaN,100.32891172709584,151.26845459509528,0.12103946776402369,0.39392636554500626,0.2728868977809826,229379190,226049310,69.02428797813533,57.09134261555946,NaN,NaN,15.633140301567758,8.16937452135024
2007-09-26T09:30:00-04:00,40.69,40.96001,40.57001,40.72,4882145,4746402.3,61.47042114251488,57.670884876083576,NaN,NaN,109.77264377366002,124.2299348761201,0.11160988978017133,0.41239926000619676,0.3007893702260254,234261335,227095459,69.93957521003681,58.66225561130825,NaN,NaN,16.735439756511607,9.393098126373292
2007-09-27T09:30:00-04:00,40.74001,40.86,40.33,40.42999,5472602,4750877.3,57.38280692040179,58.22453292281482,NaN,NaN,78.35683298883446,105.14105273403945,0.07859883817582902,0.39903791794581167,0.32043907976998265,228788733,227788887.6,70.56052860058006,60.386804738005935,NaN,NaN,16.56077865985844,10.417052488299742
2007-09-28T09:30:00-04:00,40.46001,40.55,39.8,39.8,3540100,4676482.3,49.657835761782714,58.20604123795001,NaN,NaN,21.006661299321365,84.90415914482644,0.010661997632650189,0.33376657681079536,0.32310457917814517,225248633,228591216.2,71.29926933940129,62.13302051824794,NaN,NaN,14.060502782556389,10.937545387479263
2007-10-01T09:30:00-04:00,40.09,40.53,39.91,40.34,5701199,4684677.2,55.22228054033704,58.405564126138934,NaN,NaN,38.10174012948569,69.51335798367951,-0.0009625617101128303,0.32190137704050414,0.322863938750617,230949832,229725544.6,72.3554607074608,63.91087434113496,NaN,NaN,13.562790553583515,11.312580411208442
2007-10-02T09:30:00-04:00,40.2,40.60001,40.2,40.49001,2499500,4578202.2,56.65557152801172,58.48944694010551,NaN,NaN,52.72807171542781,59.993189981345914,-0.0015683523766159002,0.3209034982798471,0.322471850656463,233449332,230539573,73.11993932054276,65.53229518642341,NaN,NaN,13.585556082814424,11.637291221437868
2007-10-03T09:30:00-04:00,40.28,40.49001,40.25,40.36,5379699,4515797.1,55.01206447216446,58.40354106177322,NaN,NaN,40.08247073696593,46.0551553740071,-0.013102683388018677,0.3060934964214397,0.31919617980945836,228069633,229301232.6,69.95085231817514,66.73203640021711,NaN,NaN,13.123145656502814,11.84955614073286
2007-10-04T09:30:00-04:00,40.36,40.78999,40.36,40.58,3666100,4460252.1,57.27089352557097,58.48787439885475,NaN,NaN,62.2884980104787,42.841488378335946,-0.0085154788967306,0.3085518311885451,0.3170673100852757,231735733,229890632.6,70.60389696535572,67.76698864328092,NaN,NaN,13.378679971522939,12.068002402274299
2007-10-05T09:30:00-04:00,40.58,41.16,40.58,40.89999,4985301,4432247.25,60.386409070067295,58.77248072903467,NaN,NaN,99.71365630499538,58.582887379470755,0.012336459586199111,0.3324878845680246,0.32015142498182547,236721034,232185112.8,73.05855225216713,68.80658187638859,NaN,NaN,14.508368334803393,12.416626106921312
2007-10-08T09:30:00-04:00,41.06,41.17,40.75,40.84,2917600,4340777.25,59.51036517912978,58.40310595717316,NaN,NaN,102.65965440617018,71.49447023480765,0.018012171979129743,0.34266663995573765,0.3246544679766079,233803434,232755833.2,73.64799042218294,69.72376591480723,NaN,NaN,15.194500684595798,12.813465332303382
2007-10-09T09:30:00-04:00,40.98,41.49001,40.87,41.28999,4087782,4280656.4,63.75765270881869,58.107682165974595,NaN,NaN,148.2744084484696,90.603737581416,0.04638286845919842,0.38263305355060595,0.3362501850914075,237891216,233644210,74.58027120955114,70.50462717089223,NaN,NaN,17.057518319721954,13.41975861622032
2007-10-10T09:30:00-04:00,41.28999,41.36,40.98,40.98,2916000,4256641.4,59.154207800588956,58.01028527792944,NaN,NaN,121.83133400464075,106.95351023495098,0.03888523841267866,0.3848567331072559,0.3459714946945772,234975216,235025326.6,76.00171911209618,71.29367356830163,NaN,NaN,17.30661783695167,13.975024219181941
2007-10-11T09:30:00-04:00,41.36,41.63,41.05,41.39999,5516398,4316561.3,63.04712212832519,58.38088093862407,NaN,NaN,157.69328218347349,126.03446706954988,0.0557960652501408,0.4157165762572532,0.3599205110071124,240491614,236776502.8,77.70414549253104,72.11340612632918,NaN,NaN,18.706956234610615,14.651014507100323
2007-10-12T09:30:00-04:00,41.45,41.67,41.28999,41.28999,3882502,4316196.4,61.39664103739496,58.53950772611312,NaN,NaN,148.4947641384251,135.7906886362358,0.05316925233964759,0.4263820764316719,0.37321282409202433,236609112,236754118.4,77.62833858250599,72.81963053648023,NaN,NaN,19.372905919574876,15.325570423168116
2007-10-15T09:30:00-04:00,41.31,41.50999,40.69,40.99001,5312398,4451006.3,57.01329529003255,58.35268336465297,NaN,NaN,72.59779597358704,129.7783169497192,0.026189063962292758,0.4059491540448903,0.37976009008259753,231296714,236252774.4,75.84366432062731,73.30672884665823,NaN,NaN,18.648732192947946,15.80030781885095
2007-10-16T09:30:00-04:00,40.94,41.16,40.75,40.89,4537199,4412116.25,55.58840592104156,57.93253942026201,NaN,NaN,39.36291616358769,107.99601849274282,-0.0019390742376793058,0.3773362472854984,0.3792753215231777,226759515,234026434.2,68.33095556437767,73.19182744339687,NaN,NaN,17.63933793835554,16.063026407351604
2007-10-17T09:30:00-04:00,41.09,41.25999,40.5,41,5077473,4315489.9,56.865330992171764,57.895576853959874,NaN,NaN,36.421907245371024,90.91413314088888,-0.01590543454222204,0.35939352834540017,0.3752989628876222,231836988,233398788.6,66.33599579440681,72.89007510009878,NaN,NaN,17.143775047361647,16.21741907021018
2007-10-18T09:30:00-04:00,40.63,40.95,40.62,40.64,2937300,4276904.9,51.63304702432458,58.03666337271286,NaN,NaN,-4.239303036641457,58.527616096865884,-0.050221377427296876,0.31252224110350113,0.362743618530798,228899688,231080403.4,59.43353425821995,72.04252259430011,NaN,NaN,15.186366831801646,16.070125893294676
2007-10-19T09:30:00-04:00,40.56,40.64,39.62,39.74001,6483000,4396824.9,41.381870377698945,57.04806264681014,NaN,NaN,-150.09216679708456,-1.1897700902360326,-0.12983958161349124,0.20044414151393397,0.3302837231274252,222416688,228241918.6,52.26324357262465,70.6073642275261,NaN,NaN,9.864625698761117,15.183625865504167
2007-10-22T09:30:00-04:00,39.55,40.14999,39.33,40.02,4411398,4415334.8,45.037813921044695,56.21822281774107,NaN,NaN,-157.2428115452749,-47.157891594008426,-0.15807915008437806,0.13268478552195262,0.2907639356063307,226828086,227348193,50.20928558437672,68.9708889606571,NaN,NaN,6.650153702179915,13.964558413600702
2007-10-23T09:30:00-04:00,40.17,40.37,39.82001,40.03999,3605800,4390574.8,45.300120299737976,55.524512519710605,NaN,NaN,-101.39568066653119,-75.3096109600322,-0.16886751844900405,0.07967953754507562,0.24854705599407967,230433886,228083067.2,51.883766887718586,67.68038285848164,NaN,NaN,4.1872697773441265,12.567802894135477
2007-10-24T09:30:00-04:00,39.88,40.25999,39.64,40,5064699,4399702.5,44.839094761812255,54.63652689372783,NaN,NaN,-105.0479200471719,-103.6035764185408,-0.17159516881919695,0.034053094970083464,0.20564826378928042,225369187,226789507,48.7743310854882,66.1211281527768,NaN,NaN,2.054654589010097,11.065924564831851
2007-10-25T09:30:00-04:00,40.23,41.08,40.16,40.98,5408102,4396477.5,56.5178380462156,54.36020039202415,NaN,NaN,15.36209202481526,-99.68329740624945,-0.10364305035564753,0.076094450844721,0.17973750120036852,230777289,227165027.2,49.716453504099285,64.45383538505767,NaN,NaN,3.837574281373015,10.033303095766303
2007-10-26T09:30:00-04:00,40.03999,41.66,40.03999,41.53999,4930254,4465985.2,61.53000712227512,54.504460530820246,NaN,NaN,63.61562211577729,-56.94173962367707,-0.021520217920650675,0.1528372287995552,0.17435744672020587,235707543,229823198.2,55.89943752637207,63.18608160678548,NaN,NaN,7.1032935038831555,9.614730296925854
2007-10-29T09:30:00-04:00,41.78999,42.09,41.71001,41.91,2730700,4317460.25,64.44621388112728,54.553643471699424,NaN,NaN,176.35662819213337,9.778148323804572,0.0531044980791609,0.24073806931915698,0.18763357123999608,238438243,232145229.6,60.47187989031328,62.17833936969706,NaN,NaN,10.78225771027576,9.781519927404412
2007-10-30T09:30:00-04:00,42.11,42.25,41.69,41.96001,3507008,4367835.65,64.83422526925966,54.959359005175905,NaN,NaN,163.91954670545095,62.841193798201004,0.09857490072113503,0.3108521971414149,0.21227729642027984,241945251,234447502.6,64.4117684199791,61.35048574883149,NaN,NaN,13.780597140048624,10.35281667206787
2007-10-31T09:30:00-04:00,42.5,42.66,42,42.45,5754762,4386588.8,68.46550378114323,55.34638626609148,NaN,NaN,192.61287408206536,122.37335262404845,0.15124213450865998,0.4013299645561048,0.25008783004744484,247700013,238913667.8,70.54511787051229,60.83912663297301,NaN,NaN,17.56363771617147,11.382933964082671
2007-11-01T09:30:00-04:00,41.91,42.52,41.58,41.58,6498371,4528202.35,57.176108435625174,55.04491965167934,NaN,NaN,112.39699989284497,141.78033419765438,0.11852320317573506,0.39824183401711366,0.2797186308413786,241201642,240998538.4,72.8936243338278,60.50093275806743,NaN,NaN,17.041439927763516,12.19129195889422
2007-11-02T09:30:00-04:00,42.22,42.22,41.52,41.92,6411363,4599505.45,59.95511918729677,55.25504993005536,NaN,NaN,98.96067180158883,148.8493441348167,0.11095029306072879,0.4184064971672896,0.3074562041065608,247613005,243379630.8,75.3144276150766,60.463130136242384,NaN,NaN,17.568235909054472,12.959426808917113
2007-11-05T09:30:00-05:00,41.81,42.62,41.72,42.38,10061785,4956714.7,63.41434220595927,55.81404537897806,NaN,NaN,122.0340933757062,137.98483717153127,0.12694064784488746,0.4661320139126701,0.33919136606778266,257674790,247226940.2,78.63462639780242,61.19910662434415,NaN,NaN,19.182304257463887,13.848409301566653
2007-11-06T09:30:00-05:00,42.89999,42.89999,41.84,42.42,4929813,4998816.25,63.707924731884404,56.302802074671824,NaN,NaN,119.07587026434801,129.01610188331068,0.12976901753363929,0.5014026379848318,0.37163362045119247,262604603,251358810.6,81.51078950890158,62.28302046109377,NaN,NaN,20.529660547233505,14.802873765233345
2007-11-07T09:30:00-05:00,41.87,42.28,41.42,41.45,10559941,5381013.3,52.670175424445716,56.37688267468047,NaN,NaN,47.58689182810118,100.01090543251784,0.05944783184549984,0.4459434102580673,0.38649557841256743,252044662,252227740.4,82.05780701842309,63.89903994396542,NaN,NaN,17.93262194137066,15.249980647538676
2007-11-08T09:30:00-05:00,41.46001,42.34,41.19,42.25999,8470469,5528716.85,59.05031575855421,57.638914487598704,NaN,NaN,62.85954989497159,90.10341543294317,0.060423584528493446,0.46202505907318425,0.4016014745446908,260515131,256090438.2,84.28378806370932,66.18622169332862,NaN,NaN,17.989855793863978,15.641391382728004
2007-11-09T09:30:00-05:00,42.09,42.41,41.77,41.92999,5784547,5623819.1,55.75284225129822,58.404273654045376,NaN,NaN,66.99276050030205,83.70983317268582,0.03314651021622139,0.44303461231496755,0.40988810209874615,254730584,257513954,85.02131173487122,68.67279498979251,NaN,NaN,16.88977709815372,15.819732199217393
2007-11-12T09:30:00-05:00,42.25999,42.3,41.2,41.2,8278547,5772126.55,49.206892269446634,58.68332879473885,NaN,NaN,22.90166829960335,63.88334815746525,-0.036010954351853475,0.3648744091589293,0.4008853635107828,246452037,255269403.4,78.74636030594606,70.59155166252303,NaN,NaN,13.630642182573292,15.507005053982521
2007-11-13T09:30:00-05:00,41.77,41.77,40.87,41.55,5823820,5836457.6,52.110146045748806,59.202689600734324,NaN,NaN,5.870971706230577,41.24236844584177,-0.058788372608655826,0.32739989774996303,0.38618827035861886,252275857,253203654.2,73.3786950075506,72.34900622838464,NaN,NaN,12.02176913668252,15.00911420865395
2007-11-14T09:30:00-05:00,41.62,41.88,41.3,41.3,3935521,5779360,49.915462240431125,58.73109132889257,NaN,NaN,12.436812227379196,34.21235252569737,-0.08945825416320408,0.27436545265461376,0.36382370681781784,248340336,252462789,71.49640967957771,73.90471738377596,NaN,NaN,10.018849925090457,14.296219311002021
2007-11-15T09:30:00-05:00,40.92,41.89,40.92,41.67,5920867,5928538.35,53.065992844038085,58.12651888044707,NaN,NaN,9.405149553422119,23.52147245738748,-0.08369636791594476,0.2592032469228869,0.34289961483883163,254261203,251212003.4,68.31051515018225,74.79122292833382,NaN,NaN,9.377642632223926,13.593565499748008
2007-11-16T09:30:00-05:00,42,42.00999,41.21001,41.67999,4402609,5824518.8,53.1516813339587,57.319766555649316,NaN,NaN,17.598112317426878,13.642542820812448,-0.07818603920778472,0.24516706582910075,0.32335310503688547,258663812,251998649,69.2389039553267,75.41743893297765,NaN,NaN,8.89787328793801,12.922752326632294
2007-11-19T09:30:00-05:00,41.67999,41.99001,41.53,41.8,3659211,5786909.45,54.23268439931021,56.56251363636721,NaN,NaN,27.16187839113862,14.494584839119502,-0.06592282125592885,0.2409495784669744,0.30687239972290326,262323023,255172846.2,72.7127740391838,76.01036790577798,NaN,NaN,8.815870479302054,12.336054919870831
2007-11-20T09:30:00-05:00,42,42.5701,41.95,42.31,7743344,5993786.65,58.60415072257855,55.85813127504116,NaN,NaN,95.10830613949115,32.34205172577159,-0.025031379143664823,0.27558317579332225,0.3006145549369871,270066367,258730948.2,75.98646073686115,76.39903525337432,NaN,NaN,10.04579002074489,12.008874219995697
2007-11-21T09:30:00-05:00,42.34,42.53,41.94,41.96001,5625883,6021845.85,54.740061709010845,55.68412793742585,NaN,NaN,70.6649060956228,43.98767049942031,-0.02316541884411738,0.2716577813818404,0.29482320022595776,264440484,261950977.8,78.50029365054796,76.79951163314004,NaN,NaN,9.950352062174385,11.714799626021223
2007-11-23T09:30:00-05:00,42.009,42.49001,41.63,41.92,1164352,5809658.35,54.29929323755946,55.28014036958747,NaN,NaN,37.49000414339508,49.6046414174149,-0.026022693112175088,0.2622948338357389,0.288317526947914,263276132,263753963.6,79.77686706803057,77.11825730835105,NaN,NaN,9.748301252536834,11.433871286952025
2007-11-26T09:30:00-05:00,41.77,42.64999,41.75,41.85001,5542656,5840278.45,53.48793399519321,54.57111121167561,NaN,NaN,49.22920417233071,55.93085978839567,-0.033544558844209926,0.24638682839265158,0.2799313872368615,257733476,263567896.4,79.25387395767243,77.16248927691319,NaN,NaN,9.359891767648191,11.13758849848005
2007-11-27T09:30:00-05:00,42.39999,42.39999,41.67,42.00999,6249992,6016243.05,55.13803923862434,53.958976533585606,NaN,NaN,30.726857053288942,56.64385552082573,-0.0288431885236185,0.2438774015823384,0.2727205901059569,263983468,263899985.4,79.51203292181256,77.01972094926397,NaN,NaN,9.469395992917763,10.899275283399723
2007-11-28T09:30:00-05:00,42.21001,42.74001,42.02,42.74001,4881945,6084989.9,61.79818533912948,54.61097724177731,NaN,NaN,140.30259656050046,65.6827136050276,0.019717376294123068,0.29736731047361076,0.2776499341794877,268865413,263659794.6,78.74875890714803,76.78336036988718,NaN,NaN,11.536467494565011,10.99030274213762
2007-11-29T09:30:00-05:00,42.53999,42.75,42.3,42.45,3671927,5980848.15,58.10755134323971,54.5436369263977,NaN,NaN,135.3398348259311,78.61769935108926,0.028081537965680137,0.3127518566365879,0.28467031867090775,265193486,263810395,78.88562012203235,76.39777694548168,NaN,NaN,12.22268332199015,11.166357110687981
2007-11-30T09:30:00-05:00,42.63,42.88,42.59,42.73,7937527,6052805.95,60.55676952112417,54.88677458852813,NaN,NaN,163.03010094461342,103.72571871133292,0.0471256127503728,0.34357733460887374,0.29645172185850094,273131013,265781371.2,80.64266033536086,76.08501613123094,NaN,NaN,13.524261985811261,11.50320066427702
2007-12-03T09:30:00-05:00,43.44,43.66,42.73,43.14999,3549785,5909727.05,63.96036339441223,55.9405939545971,NaN,NaN,211.77195667860425,136.23426921258763,0.0806917542548734,0.39731641467709267,0.31662466042221926,276680798,269570835.6,83.48772095540932,76.42368474904973,NaN,NaN,15.682525106476236,12.100247013162623
2007-12-04T09:30:00-05:00,43.24001,43.77,42.82001,43.46001,7669020,5790088.8,66.2738523884739,56.95228726479176,NaN,NaN,197.65833020085879,169.6205638421016,0.1143985119168362,0.4596228003182645,0.3452242884014283,284349818,273644105.6,85.88857980632426,77.31724794896215,NaN,NaN,18.21598521299716,12.97392389885327
2007-12-05T09:30:00-05:00,43.89999,44.24001,43.60001,44.21001,6799184,5883557.35,71.10610242758051,58.46590442101671,NaN,NaN,233.5792363043424,188.27589179087,0.17424419950508868,0.5630295377827892,0.3887853382777005,291149002,278100823.4,87.95258221710682,78.49268884449994,NaN,NaN,22.09473638644257,14.276897111366027
2007-12-06T09:30:00-05:00,44.39999,44.46001,43.77,43.95,4106320,5560876.3,67.49556879715254,59.496588417667745,NaN,NaN,189.1223958470441,199.03240399509258,0.18248243573310596,0.616888382944083,0.43440594721097703,287042682,282470662.6,89.56432272276233,80.01081795682708,NaN,NaN,24.1641127707435,15.689356491277096
2007-12-07T09:30:00-05:00,44.36,44.47,43.89999,44.17999,6117262,5443215.95,68.99524140862486,60.6282712801439,NaN,NaN,164.37807698827876,199.30199920382566,0.1887970001821082,0.6704021974386123,0.4816051972565041,293159944,286476448.8,90.78178366816445,81.54959507917263,NaN,NaN,26.33307732832824,17.20988803942726
2007-12-10T09:30:00-05:00,44.39999,44.49001,44.2,44.38,3020585,5305017.85,70.27945737082976,61.77446934953815,NaN,NaN,149.4731737279411,186.84224261369303,0.19123126441061977,0.7206442777697788,0.529413013359159,296180529,290376395,91.78644791484741,82.91200035600575,NaN,NaN,28.516470747106798,18.825114140524335
2007-12-11T09:30:00-05:00,44.66,44.66,43.34,43.35001,6489457,5215563.35,57.151348408028916,61.670697755641754,NaN,NaN,89.27315928631639,165.16520843078456,0.11217424225212225,0.6696308161743119,0.5574565739221896,289691072,291444645.8,92.04228398877865,84.05884487399986,NaN,NaN,26.218648848880004,19.881333384575143
2007-12-12T09:30:00-05:00,43.59,44.24001,43.05,43.36,7704543,5309599.5,57.23478980135046,61.848892619380294,NaN,NaN,62.747482962641854,130.99885776244443,0.05229778650038841,0.6228288070476751,0.5705310205472867,297395615,292693968.4,92.3426796367821,85.04758673015944,NaN,NaN,24.453682315843803,20.534526089042096
2007-12-13T09:30:00-05:00,43.00999,44,43.00999,44,4821973,5353922.1,62.29987080690861,62.42036244576237,NaN,NaN,64.14153396985208,106.00268538700604,0.04766873008232353,0.630116933150191,0.5824482030678675,302217588,295728949.6,93.03092952392947,85.99430547700936,NaN,NaN,24.52097036323934,21.10401812821313
2007-12-14T09:30:00-05:00,43.87,43.92,43.17999,43.17999,4896566,5302707.05,53.54865819349733,62.42469988849838,NaN,NaN,38.89751469748492,80.9065729288473,-0.01537273799547001,0.5632322805735299,0.5786050185689999,297321022,296561165.2,93.21112006533457,86.99125162755665,NaN,NaN,21.57693911234477,21.171578268803366
2007-12-17T09:30:00-05:00,43.02,43.27,42.61,42.78,4169910,5291072.1,49.86885056002668,62.04832926859855,NaN,NaN,-12.659652382334816,48.48000770679211,-0.08488150340122602,0.47250313931746746,0.5573846427186935,293151112,295955281.8,91.35909522064175,87.83747036318732,NaN,NaN,17.93124601085442,20.708673660524944
2007-12-18T09:30:00-05:00,43.17,43.47,42.89999,43.16,4001526,5308187.85,53.16187653452388,61.43145006826958,NaN,NaN,8.043577152238534,32.23409127997654,-0.10482947942226006,0.4263477934408684,0.5311772728631284,297152638,297447595,91.79169678220367,88.76910878283414,NaN,NaN,16.020099973827726,20.0388774195682
2007-12-19T09:30:00-05:00,43.2,43.63,43,43.05,3438402,5092940.75,52.095088716565996,61.0019884520786,NaN,NaN,8.874620278578895,21.45951874316395,-0.12369973462573636,0.37655260458095796,0.5002523392066943,293714236,296711319.2,89.41323647648409,89.52108137958069,NaN,NaN,14.169075217893793,19.200334247900425
2007-12-20T09:30:00-05:00,43.06,43.5,42.84,43.24001,4282957,5025794.45,53.81897942057227,60.520717730610606,NaN,NaN,-0.29389001406063936,8.572433946381409,-0.12147741130126938,0.3484055750801076,0.469882986381377,297997193,295867240.2,86.64153841804438,89.94957267120094,NaN,NaN,13.167667811764591,18.338524757023876
2007-12-21T09:30:00-05:00,43.36,43.39999,42.99001,43,4978707,5216512.2,51.30739811787078,59.616934496571936,NaN,NaN,-15.80603536690552,-2.3682760664966795,-0.1333171664496876,0.3032365283192675,0.4365536947689551,293018486,295006733,83.78991642239195,89.97115806169971,NaN,NaN,11.587248232184178,17.374056682046778
2007-12-24T09:30:00-05:00,43.17999,43.21001,42.99001,43.21001,2215852,5050172,53.35846553103204,58.69440686389752,NaN,NaN,-23.997353565293047,-4.635816303088326,-0.12432701856717038,0.28114492155999216,0.40547194012716253,295234338,295423378.2,84.0634165787974,89.8407892597335,NaN,NaN,10.853135125949628,16.442496459747186
2007-12-26T09:30:00-05:00,43.31,43.31,42.89999,42.99001,1941012,4834723,50.93785459148651,57.25381773274795,NaN,NaN,-46.02292280546415,-15.449116294628862,-0.12991123660881831,0.2430828943661396,0.3729941309749579,293293326,294651515.8,81.32588395498759,89.36745366958212,NaN,NaN,9.541532506032775,15.456644466359414
2007-12-27T09:30:00-05:00,43.14999,43.2,42.57001,42.61,2955747,4738413.1,46.97384414574592,55.78798025764747,NaN,NaN,-94.42054228215115,-36.10814880677487,-0.15425302132301127,0.18017785432119382,0.3344308756442051,290337579,293976184.4,78.90475899488008,88.60605626044767,NaN,NaN,7.242923282037782,14.283255725742038
2007-12-28T09:30:00-05:00,43.11,43.11,42.64999,42.92,1562996,4632966.55,50.367089301706564,54.457397964296156,NaN,NaN,-84.5525052315063,-52.95987185026401,-0.144689248806881,0.15356931463560386,0.29825856344248486,291900575,292756860.8,74.58718913480394,87.44929950806477,NaN,NaN,6.24934987180617,13.135554889465485
2007-12-31T09:30:00-05:00,42.99001,42.99001,42.31,42.33,1908072,4331493.8,44.52695194145364,52.617933290769294,NaN,NaN,-139.7317754492666,-77.74501986673624,-0.17148160000751073,0.08390656343309644,0.25538816344060716,289992503,292151664.2,72.46764479681177,86.06938499963364,NaN,NaN,3.5713866735486053,11.769245144334503
2008-01-02T09:30:00-05:00,42.14999,42.74001,41.89999,42.09,4999656,4403987.35,42.37454129537549,51.5624470684369,NaN,NaN,-165.76783435352303,-106.09911602438224,-0.19692974230668514,0.009225985557250738,0.20615572786393588,284992847,290103366,65.66619489325939,84.185378635668,NaN,NaN,0.6893934905751482,10.186409193797452
2008-01-03T09:30:00-05:00,41.97,42.58,41.97,42.03,5143535,4277713.1,41.83014368152786,50.46211520273529,NaN,NaN,-149.36127487441385,-126.76678643817218,-0.20826530463300993,-0.05417590292732655,0.1540894017056834,279849312,287414563.2,57.974143933264024,81.73048322827385,NaN,NaN,-1.8167547874324064,8.471671482193187
2008-01-04T09:30:00-05:00,42.10001,42.619,41.86,42.35001,7023469,4288927.35,45.82762173488571,49.285525983305085,NaN,NaN,-128.3057040504872,-133.54381879183939,-0.18543511714583516,-0.07770449472661056,0.1077306224192246,286872781,286721603.6,56.14867901094898,79.09603676306095,NaN,NaN,-2.841338670754619,6.8555271746292155
2008-01-07T09:30:00-05:00,42.60001,43.35001,42.39999,43.23,9154438,4541333.25,54.98803277531295,49.38833845343477,NaN,NaN,-21.9288659151493,-121.01909092856798,-0.10622803620304273,-0.025054422834578816,0.08117361336846392,296027219,287546932.4,57.85095756594821,76.57031087024764,NaN,NaN,-0.8753243542579071,5.751119813359627
2008-01-08T09:30:00-05:00,43.28,44.11,43.24001,43.24001,9603910,4715665.65,55.08108084772967,49.760640616842124,NaN,NaN,70.35381497514278,-79.0019728436861,-0.051115152696576655,0.017279672497743093,0.06839482519431975,305631129,290674657.6,63.615337188762034,74.58861386797051,NaN,NaN,0.7088043116527277,5.030789027401498
2008-01-09T09:30:00-05:00,43.58,43.85001,43.19,43.71001,9080160,5018644.4,59.33198068319263,50.201362341747036,NaN,NaN,93.5402086769093,-27.14036423759965,0.015478835167861749,0.08774336915414693,0.07226453398628518,314711289,296618346,71.5718903822961,73.14434198226286,NaN,NaN,3.4118503918436627,4.799512079464665
2008-01-10T09:30:00-05:00,43.64,43.99001,43.22,43.44,8489773,5118660.2,56.05030093425744,50.483877500153575,NaN,NaN,91.95333375529043,21.122557488341204,0.038517001134618936,0.12041078540455885,0.08189378426993991,306221516,301892786.8,76.48593787632458,72.22096351082288,NaN,NaN,4.692953213586812,4.7842893843392575
2008-01-11T09:30:00-05:00,43.06,43.71001,43.06,43.42999,5366238,5001744.95,55.92680113775973,50.63443619423838,NaN,NaN,66.6908637889509,60.12187105622881,0.04955232757948004,0.14383419374428996,0.09428186616480992,300855278,304689286.2,78.59827459044433,71.64644466599431,NaN,NaN,5.690424066722928,4.913737196108353
2008-01-14T09:30:00-05:00,43.82001,43.87,43.27,43.49001,4852961,5003294.35,56.545065185788864,51.00855527051825,NaN,NaN,96.23617705889494,83.75487965103767,0.056842227917601754,0.1653346510618121,0.10849242314421036,305708239,306625490.2,79.94180761080781,71.37157975088117,NaN,NaN,6.687617813279588,5.1671487128471005
2008-01-15T09:30:00-05:00,43.21001,43.69,42.91,43.03,8744625,5195697.3,50.67734689346892,50.8170467964066,NaN,NaN,35.54018891606533,76.79215443922217,0.02808576446073731,0.143599628720132,0.11551386425939468,296963614,304891987.2,75.37923835282282,70.75128130616869,NaN,NaN,5.9102007361314515,5.273299001887722
2008-01-16T09:30:00-05:00,42.78,43.28,42.2,42.25999,9678680,5471135.8,42.691364349396636,50.22801177911447,NaN,NaN,-80.46250312308877,41.99161207922256,-0.04160388907834828,0.06350900291145933,0.10511289198980761,287284934,299406716.2,63.10587780257367,69.44985229528197,NaN,NaN,2.6558873051728917,4.899383045214175
2008-01-17T09:30:00-05:00,42.08,42.3,40.56,40.63,14361152,5989117.1,31.40820233045646,49.11618022087951,NaN,NaN,-252.75602740935554,-26.95026015370663,-0.1880835172091872,-0.1299915045216764,0.058092012687510804,272923782,292747169.4,52.029607047384005,67.53019858474653,NaN,NaN,-4.9696309817388595,3.489523898506598
2008-01-18T09:30:00-05:00,40.53,41,39.66,40.03,10885023,6361448.15,28.429599950115716,47.54921669576587,NaN,NaN,-276.3896178277427,-95.56635647704536,-0.3088546736557255,-0.32797632938214605,-0.01912165572642057,262038759,284983865.6,42.6350356482844,65.247901907138,NaN,NaN,-12.204075040638259,1.2475811929144762
2008-01-22T09:30:00-05:00,36.94,39.3,36.05,38.64999,13937609,6844180.75,23.02176190543382,46.01313169319303,NaN,NaN,-336.8643462614617,-182.1864611411167,-0.45625570819888306,-0.5894412909750244,-0.13318558277614134,248101150,273462447.8,33.08676433344556,62.43498187404041,NaN,NaN,-20.766934772412917,-1.8973496592751515
2008-01-23T09:30:00-05:00,37.27,40.05,37.27,39.67999,14849773,7337734.05,33.23047277663636,45.35998394185452,NaN,NaN,-200.35063463946557,-229.3646258522229,-0.4577797215998841,-0.7054102347759965,-0.2476305131761124,262950923,266659909.6,28.962521431026445,59.81329091245234,NaN,NaN,-23.497834241621625,-4.983133171038933
2008-01-24T09:30:00-05:00,40.21001,40.21001,38.60001,38.60001,13442195,7899051.2,28.90235266151602,44.43657029756796,NaN,NaN,-152.34259955540415,-243.74064513868592,-0.5014015746728773,-0.874382481517209,-0.3729809068443317,249508728,259104668.4,25.204719886269487,57.47261776623845,NaN,NaN,-27.44455463715439,-8.191907666198283
2008-01-25T09:30:00-05:00,38.99001,39.28,37.86,38.17999,12528297,8428415.45,27.407262494718594,43.12083035184173,NaN,NaN,-150.01972834689767,-223.19338532619435,-0.5258629074369037,-1.0303095411404612,-0.5044466337035576,236980431,251915998.2,22.24701926444982,55.051070641488515,NaN,NaN,-30.96220150161601,-11.444806785543673
2008-01-28T09:30:00-05:00,38.2,38.84,38.17,38.78,5729918,8567124,32.758392221441724,41.53299888370808,NaN,NaN,-119.80222895565154,-191.87590755177615,-0.47073801422720385,-1.0928691514875624,-0.6221311372603585,242710349,248050316.2,20.831379915498772,52.40681509502783,NaN,NaN,-31.737589236053154,-14.343775707045026
2008-01-29T09:30:00-05:00,38.99001,39.25999,38.72,38.91,6068395,8792393.95,33.895374515760736,40.0197341457103,NaN,NaN,-91.70939875369173,-142.84491805022213,-0.39754178742621393,-1.119058371543126,-0.721516584116912,248778744,248185835,21.02111598223341,49.36437072313293,NaN,NaN,-31.93542125024903,-16.85686792750274
2008-01-30T09:30:00-05:00,38.78,39.58,38.5,38.71001,6502445,9022112.6,32.97172564931567,38.13685878614767,NaN,NaN,-82.20355336355405,-119.21550179503984,-0.3370089787252656,-1.142777807523494,-0.8057688287982284,242276299,244050910.2,19.486553409019464,45.643989510756036,NaN,NaN,-32.38611170267687,-19.07533132395619
2008-01-31T09:30:00-05:00,38.81,39.95,38.28,39.22,4439695,8994114.55,37.63854277676144,36.82173320346938,NaN,NaN,-66.90449054176723,-102.12787999231243,-0.24150920842637924,-1.1076553393312025,-0.8661461309048233,246715994,243492363.4,19.281789782358302,41.55797893261558,NaN,NaN,-31.26510869120705,-20.816728090706313
2008-02-01T09:30:00-05:00,39.49001,40.3,39.46001,40.24001,4434703,8958672.95,45.77100008747911,36.09631884273505,NaN,NaN,-34.323134012206495,-78.98856112537418,-0.09600034654690737,-0.9861465640884575,-0.8901462175415501,251150697,246326416.6,23.664831107514658,37.63416154097774,NaN,NaN,-27.534079675921014,-21.776349745736983
2008-02-04T09:30:00-05:00,40.28,41.21001,40.28,40.82001,4683855,8841692.25,49.781320505280554,35.613194222698745,NaN,NaN,-5.879041718335602,-56.20392367791099,0.045363824068705094,-0.8334414374556687,-0.8788052615243738,255834552,248951257.2,27.58677649878797,33.89451646154775,NaN,NaN,-23.116794539177207,-21.967841859085585
2008-02-05T09:30:00-05:00,40.5,40.64,39.46001,39.59,6278184,8697879.55,42.58841595427242,35.03541344132757,NaN,NaN,-32.329719043766616,-44.327987735925966,0.06110563606143571,-0.8024232164475791,-0.8635288525090148,249556368,249106782,27.823398270542924,30.4976707413849,NaN,NaN,-21.70626950028635,-21.930474379257124
2008-02-06T09:30:00-05:00,39.63,40.11,39.33,39.52,4241953,8429781.7,42.21458565639661,35.001357820399,NaN,NaN,-36.550659760262214,-35.1974090152676,0.07117443168223314,-0.7745608129062234,-0.8457352445884565,245314415,249714405.2,28.802262355866645,28.047412495191544,NaN,NaN,-20.742623256394925,-21.76078136170538
2008-02-07T09:30:00-05:00,39.25,39.45,38.91,39.31,7165992,8334073.3,41.05044145401897,35.69008918636775,NaN,NaN,-49.03774556024807,-31.624060018963768,0.06806297377996984,-0.7606565273634942,-0.828719501143464,238148423,248000891,27.66290038291885,26.306933447729744,NaN,NaN,-20.32746379232037,-21.556021708936093
2008-02-08T09:30:00-05:00,39,39.32001,38.85001,39,4974355,8158302.4,39.32637026268039,36.46842992297952,NaN,NaN,-52.42825601094337,-35.245084418711144,0.050316600411335344,-0.7658237506292949,-0.8161403510406302,233174068,244405565.2,25.393107660297744,25.075367162873555,NaN,NaN,-20.500924262877504,-21.405293502356294
2008-02-11T09:30:00-05:00,39,39.45,38.92,39.32001,3369582,8058469.6,42.03285637641967,37.82636524233565,NaN,NaN,-39.614535691178425,-41.992183213279716,0.06441872444170826,-0.7356169454884949,-0.8000356699302031,236543650,240547384.8,23.19378441192586,24.36872573990786,NaN,NaN,-19.84976064594871,-21.183074522869497
2008-02-12T09:30:00-05:00,39.34,40.2,39.34,39.99001,4194074,8025525.25,47.33025858950451,38.83349280039766,NaN,NaN,6.185748550971347,-34.28908969433212,0.11993233384550306,-0.6501202526233243,-0.7700525864688273,240737724,238783656,22.245268077296004,23.888921928927115,NaN,NaN,-17.680101502559744,-20.682649805682388
2008-02-13T09:30:00-05:00,40.05,40.27,39.64999,39.8,5625266,7869557.3,46.04511703155226,40.05797596968596,NaN,NaN,27.379966033584463,-21.50296453556279,0.1433345657622499,-0.590884379266015,-0.7342189450282649,235112458,236743264.6,21.166829603403826,23.600501194436706,NaN,NaN,-16.26665489862727,-20.0517933903888
2008-02-14T09:30:00-05:00,39.97,40.35001,39.28,39.3,5084852,7639865.9,42.75523997493482,41.154260075415685,NaN,NaN,21.926424160620012,-7.310130591389173,0.12527369862762971,-0.5776268217437277,-0.7029005203713574,230027606,235119101.2,20.322268953652568,23.46301902937976,NaN,NaN,-16.003708630490134,-19.47349556754613
2008-02-15T09:30:00-05:00,39.28,39.85001,38.84,39.85001,3824372,7113026.9,47.222395060788436,42.187403135369024,NaN,NaN,19.67410431901162,7.1103414746018245,0.14889500586644377,-0.5167817630383027,-0.6656767689047465,233851978,235254683.2,20.607051886146948,23.446995598711773,NaN,NaN,-14.451111258362456,-18.756012094805605
2008-02-19T09:30:00-05:00,40.25999,40.25999,39.37,39.53,3998458,6768698.65,45.02104790014672,42.982094091396604,NaN,NaN,52.0973207628293,25.45271276540337,0.14154161881542182,-0.4887497453854692,-0.630291364200891,229853520,233916657.2,19.85291784544107,23.363552874655173,NaN,NaN,-13.785015604333642,-18.045869739023896
2008-02-20T09:30:00-05:00,39.00999,39.61,39.00999,39.61,4712879,6307462.15,45.702494030843944,43.89143469007719,NaN,NaN,0.900475678779191,24.395658190964937,0.14036447188668544,-0.4548357743425342,-0.5952002462292196,234566399,232682392.2,19.156488398778407,23.3399768024951,NaN,NaN,-13.04793932053802,-17.3318796792402
2008-02-21T09:30:00-05:00,39.61,39.67999,38.74001,38.74001,5052406,5817593.8,39.90929924310199,44.05363158053008,NaN,NaN,-54.955097810606084,7.928645422126829,0.08217411912571126,-0.49248259732208055,-0.5746567164477918,229513993,231562699.2,18.521728436935575,23.285686706393477,NaN,NaN,-14.092652157724833,-16.86913289045229
2008-02-22T09:30:00-05:00,39.02,39.42,38.64,39.42,5607152,5425841.65,45.702649879367314,44.048749422807816,NaN,NaN,-38.659580678596356,-4.188555545716445,0.0900282390496564,-0.46212141763572134,-0.5521496566853777,235121145,232581407,21.083822197008743,23.101328927071624,NaN,NaN,-13.240404046794337,-16.35074305564401
2008-02-25T09:30:00-05:00,39.61,39.62,39.12,39.46001,6071176,5102985.6,46.03234068584525,43.780965149991005,NaN,NaN,-9.715197852059717,-10.066415979930714,0.09781880795606357,-0.4298761467402983,-0.5276949546963619,241192321,234049475.6,24.755861226924168,22.89912069336707,NaN,NaN,-12.459094196304173,-15.794793218595462
2008-02-26T09:30:00-05:00,39.08,40,39.07001,39.97,4359426,5034461,50.184468928930926,44.32354036246662,NaN,NaN,32.119970773883495,-14.061885977719893,0.1349312266114655,-0.35903092143202997,-0.4939621480434955,245551747,237189121,32.03902053234668,23.200236569210198,NaN,NaN,-10.560477909521587,-15.047033888727766
2008-02-27T09:30:00-05:00,39.8,39.8,39.00999,39.00999,7140785,5088080.5,43.413365996186755,44.409167529594484,NaN,NaN,-49.73717792710901,-24.18941669889753,0.09435701694843174,-0.3760158768579558,-0.4703728938063875,238410962,237958033.6,33.73078546048994,23.552273933826147,NaN,NaN,-10.943592163848063,-14.460827928030666
2008-02-28T09:30:00-05:00,38.88,39.03,38.55,38.75,6369047,5081410.6,41.76968747672369,44.46054224550197,NaN,NaN,-143.19759049992467,-41.83791523676125,0.051675883109296605,-0.4057780399197668,-0.4574539230290634,232041915,238463618,34.8786876984871,24.06768731350959,NaN,NaN,-11.757836801871663,-14.07468633857938
2008-02-29T09:30:00-05:00,38.64999,38.74001,37.5,37.61,10232184,5371035.05,35.43458478890716,44.18255756880387,NaN,NaN,-248.43416714546169,-83.79283253013432,-0.04636637654918491,-0.5154118937155445,-0.4690455171663596,221809731,235801335.2,31.759039356566234,24.52239672038591,NaN,NaN,-14.591067634110901,-14.148455095083882
2008-03-03T09:30:00-05:00,37.60001,38.2,37.5,38.17999,6409555,5469777.65,40.309268089284906,44.05944411972282,NaN,NaN,-205.86978612423485,-123.02375018456935,-0.06473513478687587,-0.5499644356499545,-0.4852293008630786,228219286,233206728.2,29.033531420190045,24.939521506690493,NaN,NaN,-15.371468720016779,-14.323171327217153
2008-03-04T09:30:00-05:00,37.81,38.89999,37.72,38.84,7960211,5633595.45,45.445504053853796,43.924818795747775,NaN,NaN,-117.63250507500798,-152.97424535434763,-0.02631075464286442,-0.5181177441666591,-0.4918069895237947,236179497,231332278.2,27.216355313342902,25.294599166408126,NaN,NaN,-14.350786300526932,-14.327116323404265
2008-03-05T09:30:00-05:00,38.88,38.91,38.2,38.73,6227398,5631056.15,44.75431033132288,43.83261831715996,NaN,NaN,-86.19736862605681,-160.2662834941372,-0.003384076911851386,-0.49603708566360893,-0.49265300875175755,229952099,229640505.6,25.65560908535477,25.61522627226177,NaN,NaN,-13.754086099335941,-14.245254862823076
2008-03-06T09:30:00-05:00,38.5,38.74001,37.92,37.94,7308125,5784364.75,40.04384587463426,43.63894730999563,NaN,NaN,-127.19580266747458,-157.06592592764719,-0.03476121154430545,-0.5361045231821393,-0.5013433116378339,222643974,227760917.4,24.00832111989436,25.87851571270761,NaN,NaN,-14.728381717888023,-14.314272984975212
2008-03-07T09:30:00-05:00,37.55,37.91,37.35001,37.7,11485625,6000346.4,38.710845258205126,43.030979466953966,NaN,NaN,-165.078402957617,-140.39477309007825,-0.06335113954853444,-0.5805322360735019,-0.5171810965249675,211158349,225630641,22.263545988076658,25.996836719988305,NaN,NaN,-15.9288827381789,-14.544931521147166
2008-03-10T09:30:00-04:00,37.64,37.92,37.3,37.64999,7211012,6112179.25,38.42381653095323,42.55974865486872,NaN,NaN,-139.23486331948345,-127.06778852912797,-0.0764262611563915,-0.6127139229704568,-0.5362876618140653,203947337,220776251.2,18.89391066100619,25.928336206814386,NaN,NaN,-16.979873494176104,-14.892780374437015
2008-03-11T09:30:00-04:00,38.58,38.75,37.8,38.3,8211949,6354297.6,44.21367962250946,42.45340476855911,NaN,NaN,-62.84875692190295,-116.11103889850695,-0.034243751272190925,-0.579092350904304,-0.5448485996321131,212159286,215972209,16.269563331313847,25.72212727342406,NaN,NaN,-16.186699193374597,-15.077625919999527
2008-03-12T09:30:00-04:00,38.21001,39.06,38.14999,38.3,4831914,6386189.6,44.21367962250946,42.76086050994536,NaN,NaN,-35.3705557982983,-105.94567633295523,-0.001042176580578591,-0.5461513203578363,-0.5451091437772577,212159286,212413646.4,14.646667119637257,25.445337179331325,NaN,NaN,-15.545741929602316,-15.144499635657068
2008-03-13T09:30:00-04:00,37.52,38.39999,37.52,38.17999,7758574,6492855,43.341066213463805,42.59217596238083,NaN,NaN,-77.19832675368794,-95.94618115019792,0.017133458010088254,-0.5236923212646474,-0.5408257792747356,204400712,208764994,13.193494355605921,24.881742333516836,NaN,NaN,-15.246258547621613,-15.159036623080574
2008-03-14T09:30:00-04:00,38.5,38.52,37.37,37.89999,7478785,6612551.65,41.29334618343163,42.25367635506557,NaN,NaN,-80.7541818635898,-79.08133693139246,0.014689088996529431,-0.5224644180290738,-0.5371535070256033,196921927,205917709.6,12.1780864679249,23.983329850731174,NaN,NaN,-15.540952482065972,-15.213596031507059
2008-03-17T09:30:00-04:00,37.00999,38.17999,37.00999,37.92,5438488,6693257.45,41.50604043312132,41.633788605364884,NaN,NaN,-97.1698172482466,-70.66832771714509,0.01856109697932562,-0.5139521358014463,-0.5325132327807719,202360415,205600325.2,12.066604357492537,22.556728695384447,NaN,NaN,-15.731763438603629,-15.287619946806569
2008-03-18T09:30:00-04:00,38.06,38.64999,37.89,38.59,4479449,6717307,48.264799368386385,41.980319560522,NaN,NaN,-15.838571211294848,-61.26629057502347,0.06762764944854183,-0.4479786709700946,-0.5156063204186364,206839864,204536440.8,11.680606349241472,20.981715901723845,NaN,NaN,-14.03481075781594,-15.108647205522193
2008-03-19T09:30:00-04:00,38.60001,39.49001,37.64,37.83,5970633,6780194.7,42.29489516865558,42.01783439565999,NaN,NaN,-17.53016562748588,-57.69821254086099,0.05103572072692575,-0.4518116695099792,-0.502847390236905,200869231,202278429.8,10.884749898125676,19.267863201698027,NaN,NaN,-14.232100239499552,-14.9834262103761
2008-03-20T09:30:00-04:00,38.21001,38.21001,36.10001,37.45,7491770,6902162.9,39.65384387042006,42.31921004433948,NaN,NaN,-146.2803745472807,-71.51462209957954,0.018294495851219394,-0.4799792704228807,-0.4982737662741001,193377461,200073779.6,10.157076656110078,17.724865865951163,NaN,NaN,-15.182054609163814,-15.011801695917201
2008-03-24T09:30:00-04:00,37.7,37.99001,37.31,37.57001,5948043,6919207.45,40.90880473051173,42.36203409014139,NaN,NaN,-89.7889992883659,-73.32158558453474,0.009015327349110203,-0.4870046070877123,-0.4960199344368225,199325504,200554495,11.54565424580393,16.47573178206644,NaN,NaN,-15.609812505522841,-15.09723181157515
2008-03-25T09:30:00-04:00,37.72,37.95,37.46001,37.46001,4259430,6828620.15,40.085932339714354,41.97920753913143,NaN,NaN,-82.96852822863019,-70.48132778061147,0.00022890198304065246,-0.4957338069580217,-0.49596270894106237,195066074,199095626.8,10.990496631794983,15.31674187624159,NaN,NaN,-16.193259964696384,-15.25380726202104
2008-03-26T09:30:00-04:00,37.42,38.03999,37.42,37.60001,5466695,6883983.6,41.693440369939545,41.76057397046119,NaN,NaN,-67.99772460827405,-80.91315846000732,0.008165811645686138,-0.4857554443839547,-0.4939212560296408,200532769,197834207.8,10.519496840970618,14.235591001642721,NaN,NaN,-16.256867084915015,-15.397101522434465
2008-03-27T09:30:00-04:00,37.63,38.45,37.63,37.98,7344480,6894168.35,45.93358557984964,42.18126966369086,NaN,NaN,-2.2126185636777063,-77.84964904724568,0.04146550740294147,-0.44208937177596397,-0.48355487917890544,207877249,199235811.4,14.884289755663545,13.583874475626235,NaN,NaN,-15.14955668721447,-15.361737974545894
2008-03-28T09:30:00-04:00,38,38.41,37.59,37.63,5330020,6842217,42.84311301383104,42.476431646235575,NaN,NaN,-24.60254328792439,-53.51408279537445,0.04223571635950657,-0.4307602337295222,-0.4729959500890288,202547229,201069765,20.358511874995344,13.447800610406142,NaN,NaN,-15.033104056899676,-15.314790272025006
2008-03-31T09:30:00-04:00,37.75,38.19,37.56,37.94,3945357,6527875.65,46.29000735238644,43.03830241919509,NaN,NaN,-19.34525594912082,-39.42533412752544,0.06460009194273647,-0.3922458351606082,-0.45684592710334465,206492586,202503181.4,24.448521804792847,13.844558549248045,NaN,NaN,-13.967414635962786,-15.122308038301831
2008-04-01T09:30:00-04:00,38.25,39.10001,38.2,38.92,8953289,6655062.35,55.43882729369774,43.84009868142282,NaN,NaN,142.57903644113796,5.6841788064281955,0.14193749337662775,-0.27942406038255996,-0.4213615537591877,215445875,206579141.6,34.71539148041428,15.16211770275522,NaN,NaN,-10.077735658329106,-14.40165484116287
2008-04-02T09:30:00-04:00,38.96001,39.57001,38.96001,39.42,2974614,6405782.5,59.25246907858531,44.914297928285386,NaN,NaN,217.35562315126316,62.75484835833564,0.21872078514117332,-0.14796057233272109,-0.3666813574738944,218420489,210156685.6,42.14666452481917,17.12640323169678,NaN,NaN,-5.529204448113302,-13.134161927870075
2008-04-03T09:30:00-04:00,39.38,39.42,38.78999,39.21001,4750988,6331962,57.044414983222914,45.893108554696745,NaN,NaN,168.2961668152336,96.85660543411791,0.24532325262128485,-0.060027291697288376,-0.3053505443185732,213669501,211315136,44.35544341945075,19.352256736257125,NaN,NaN,-2.474797237653287,-11.61139554355339
2008-04-04T09:30:00-04:00,39.08,40,39.03999,39.17,7871727,6360142.1,56.61153964459004,46.987265230493776,NaN,NaN,171.15095781755133,136.00730565521306,0.24936739147944004,0.006358695030726835,-0.2430086964487132,205797774,211965245,45.61041249450335,21.740280023869875,NaN,NaN,-0.13149807321200335,-9.971410190647479
2008-04-07T09:30:00-04:00,39.27,39.57001,39.05,39.34,3741857,5972953.7,58.06755175321924,48.17023032478648,NaN,NaN,136.63739158890806,167.20383516281882,0.25189439539456776,0.07185929779449651,-0.18003509760007125,209539631,212574654,46.82116813289047,24.22274886496973,NaN,NaN,2.2483423753302425,-8.225731252650661
2008-04-08T09:30:00-04:00,39.17,39.7,39.17,39.60001,4078332,5816319.7,60.26390286953219,49.0273091462969,NaN,NaN,136.64697372490127,166.0174226195715,0.25850812843840665,0.1431000629479371,-0.11540806549046957,213617963,212209071.6,46.15735965890131,26.685374101374002,NaN,NaN,4.912729509674546,-6.3488082866042035
2008-04-09T09:30:00-04:00,39.58,39.78999,39.32001,39.5,4874785,5649461.5,58.984153397012214,50.219399019750945,NaN,NaN,120.74939341904427,146.6961766731277,0.24377181366902445,0.18930670159581098,-0.05446511207321346,208743178,210273609.4,42.70538729583005,28.9582767726386,NaN,NaN,6.7986733416179845,-4.4705966254296055
2008-04-10T09:30:00-04:00,39.56,39.57001,39.12,39.22,4036482,5609689.9,55.434798198945764,51.34661004321707,NaN,NaN,85.49446017926772,130.13583534593454,0.20438405793642866,0.20101496034732236,-0.003369097589106293,204706696,208481048.4,39.740973749102096,31.071412279280885,NaN,NaN,7.47141225301703,-2.7645953570800863
2008-04-11T09:30:00-04:00,39.19,39.48,39.13,39.27,7199637,5581743.05,55.944609924642336,52.42059612851211,NaN,NaN,75.08109600202474,110.92186298282923,0.17220402427570214,0.21188593275552137,0.03968190847981924,211906333,209702760.2,42.66227337169264,33.29402793113008,NaN,NaN,8.169167643274342,-1.202629214172311
2008-04-14T09:30:00-04:00,39.27,39.42999,39.08,39.21001,2338999,5324753.75,55.129730498467104,53.495153139851595,NaN,NaN,63.11795191283406,96.21797504761442,0.138816789064397,0.2132028948103155,0.0743861057459185,209567334,209708300.8,42.675846012616056,35.5572671726173,NaN,NaN,8.550589077305672,0.19068768461025787
2008-04-15T09:30:00-04:00,39.47,39.7,39.34,39.64,4202004,5262929.55,59.66479575256362,54.7788213814676,NaN,NaN,84.37356565905547,85.76329343444527,0.13737610472348705,0.2461062366502773,0.10873013192679026,213769338,209738575.8,42.75558469430379,37.859844876426806,NaN,NaN,10.125323640245258,1.6099213925581148
2008-04-16T09:30:00-04:00,39.55,40.60001,39.54739,40.47,4655855,5271749.85,66.66791822114423,56.25984514156,NaN,NaN,127.6561048246841,87.14463571557323,0.18124901838708682,0.3352914049106488,0.15404238652356197,218425193,211674978.8,47.760815030746464,40.208168110361306,NaN,NaN,13.791681694333555,3.350172864240321
2008-04-17T09:30:00-04:00,40.64,40.86,40.34,40.55,3601947,5153315.55,67.25799604765874,58.00376535826198,NaN,NaN,141.7610539307827,98.39795446587624,0.20294737573976965,0.40772660619827406,0.2047792304585044,222027140,215139067.6,55.29186383789776,42.7034075362829,NaN,NaN,16.952657588816482,5.293384967751201
2008-04-18T09:30:00-04:00,40.88,41,40.39,40.67999,3501930,4953823.55,68.24179739243705,59.57175036112273,NaN,NaN,143.4672007233033,112.07517541013195,0.21233737393496432,0.4702009478772098,0.25786357394224546,225529070,217863615,60.157061262833196,45.2540174975715,NaN,NaN,19.87274247278475,7.3761503256131355
2008-04-21T09:30:00-04:00,40.45,40.688,40.05,40.31,3507028,4831772.8,62.48667824062816,60.07516828590348,NaN,NaN,110.3431739108832,121.52021980974177,0.18112897645896153,0.48427479451594735,0.3031458180569858,222022042,220354556.6,64.01286594246557,47.34669424486088,NaN,NaN,20.77089069077747,9.289684663493755
2008-04-22T09:30:00-04:00,40.16,40.25999,39.94,40.19,3942982,4815950.4,60.6987121323086,60.17847136116943,NaN,NaN,87.27216489208195,122.09993965634708,0.14165123506480526,0.4802098618879924,0.33855862682318716,218079060,221216501,65.26550247426212,48.998039812678236,NaN,NaN,21.011719972578756,10.964261136220184
2008-04-23T09:30:00-04:00,40.33,40.5,40.07001,40.25,2753044,4680267.85,61.29505088474418,60.48208821127809,NaN,NaN,94.16399676203558,115.40151804381738,0.11022424521369689,0.4763389333403083,0.3661146881266114,220832104,221697883.2,65.97775859773,50.54249089684104,NaN,NaN,21.373038930444654,12.451229392537964
2008-04-24T09:30:00-04:00,40.66,40.66,39.96001,40.21001,5093367,4567712.2,60.63467359198413,60.769454921806236,NaN,NaN,85.3295563530524,104.11521852827131,0.0788584136433797,0.464687705180836,0.3858292915374563,215738737,220440202.6,62.37879722550097,51.74023266334086,NaN,NaN,21.501287878033928,13.74409489046596
2008-04-25T09:30:00-04:00,40.25,40.49001,40.14999,40.34,3991845,4500803.45,62.06536463588741,61.05501298485397,NaN,NaN,80.03567718922542,91.42891382145572,0.05984315583874483,0.4606332363358874,0.40079008049714254,219730582,219280505,59.173516398217096,52.62254325372134,NaN,NaN,21.980936278351717,14.920786517306782
2008-04-28T09:30:00-04:00,40.34,40.5,39.64999,39.95,6284539,4617762.55,55.54305904277341,60.71780985437119,NaN,NaN,36.19763321337536,76.59980568195417,0.01624486796967195,0.42109616545923245,0.4048512974895605,213446043,217565305.2,54.69693274437869,53.23251275982687,NaN,NaN,20.60850550170047,15.733317800791594
2008-04-29T09:30:00-04:00,40.00999,40.3,39.92999,40.14,4208414,4380518.8,57.866101533873966,60.637949007004174,NaN,NaN,41.692765519799664,67.48392580749771,-0.003498872924361962,0.40047770633410806,0.40397657925847,217654457,217480384.6,54.477188739957256,54.07335572012166,NaN,NaN,20.051006089677273,16.35013041348955
2008-04-30T09:30:00-04:00,40.11,40.55,39.88,39.88,3822276,4422901.9,53.728694077215955,60.516084426880624,NaN,NaN,34.43381554698124,55.53788956448685,-0.035966020469960336,0.3590190536710196,0.39498507414097994,213832181,216080400,50.850235801235826,54.86687443813122,NaN,NaN,18.38662535171153,16.641058261806975
2008-05-01T09:30:00-04:00,40.10001,40.60001,40.0304,40.35001,8876414,4629173.2,59.382440511491794,60.761643754512725,NaN,NaN,62.04119112923181,50.88021651972273,-0.028036464688298846,0.35993949328060637,0.3879759579689052,222708595,217474371.6,54.12527186534092,55.68566004482038,NaN,NaN,18.530222027143274,16.91093879971216
2008-05-02T09:30:00-04:00,40.7,41.17,40.60001,41.02,4097414,4440457.55,65.79784379411498,61.523651847059,NaN,NaN,143.78211477438106,63.62950403675383,0.01762343889213286,0.4100052565840713,0.3923818176919384,226806009,218889457,57.240171184499445,56.72596898566919,NaN,NaN,20.74690509216736,17.458933984348615
2008-05-05T09:30:00-04:00,40.71001,40.82001,40.22,40.42999,3719160,4439322.7,57.22591392311665,61.3494460020985,NaN,NaN,71.36928322484448,70.66383403904766,0.004088002127078771,0.3974918203507869,0.3934038182237081,223086849,220817618.2,61.114557549955705,58.03732418964433,NaN,NaN,19.757683757856842,17.787326809135504
2008-05-06T09:30:00-04:00,40.03,40.49001,39.83,40.42,2747618,4372787,57.09029508035989,60.66533006347105,NaN,NaN,26.66226607831845,67.65773415075141,-0.008834173216989094,0.38236110170247173,0.3911952749194608,220339231,221354573,62.14325880310318,59.06464160195552,NaN,NaN,18.948251283695704,17.953173162644102
2008-05-07T09:30:00-04:00,40.2,40.46001,39.77,39.81,3332584,4295676.95,49.39294485670957,59.38925497840326,NaN,NaN,-22.344887472137156,56.301993546927726,-0.05896566799830766,0.31748818992157624,0.3764538579198839,217006647,221989466.2,63.376944223740914,59.64214734380146,NaN,NaN,15.63116405180912,17.62145757538196
2008-05-08T09:30:00-04:00,39.77,40.14,39.629,39.91,3682743,4277990,50.56954372679993,58.12695114514346,NaN,NaN,-58.09072200413003,32.27561092025536,-0.08434633154835158,0.2710209434844444,0.35536727503279597,220689390,221585625.2,61.993063309791296,59.773290347155616,NaN,NaN,13.3700836361103,17.014118441200296
2008-05-09T09:30:00-04:00,39.82001,40.25999,39.56,40.03999,3036106,4069813.45,52.127648814689664,57.38702047186215,NaN,NaN,-59.17856550119316,-8.316525134859484,-0.09077702317406855,0.24189599606521028,0.33267301923927883,223725496,220969522.6,59.846071500335306,59.47566217271775,NaN,NaN,12.001620827977314,16.298047353597013
2008-05-12T09:30:00-04:00,40.12,40.50999,40.00999,40.42999,2574918,4081609.4,56.5525702369858,57.09086747933908,NaN,NaN,23.320464223912314,-17.926288935045918,-0.06819300207098883,0.24743176665054278,0.3156247687215316,226300414,221612235.6,61.34986109656703,59.19597350288238,NaN,NaN,12.184983397756016,15.710466788476872
2008-05-13T09:30:00-04:00,40.64,40.66,40.10001,40.37,2980276,4020523,55.6997200368867,56.69120099020641,NaN,NaN,34.072734607988586,-16.444195229111887,-0.0571688977380157,0.24416364654901201,0.3013325442870277,223320138,222208417,62.743675857623,58.964967592874736,NaN,NaN,12.080569273916725,15.191910000682565
2008-05-14T09:30:00-04:00,40.66,40.8,40.3,40.52,3849546,3980207.55,57.42848745594406,56.46218769477497,NaN,NaN,82.82314969008905,4.589412203333362,-0.0404368563422447,0.2507864738592218,0.2912233302014665,227169684,224241024.4,67.0999067683085,59.30218970307527,NaN,NaN,12.492694401818289,14.806307772273383
2008-05-15T09:30:00-04:00,40.52,40.71001,40.3201,40.48,3663031,3983261.75,56.79202778556584,56.08552077689485,NaN,NaN,73.1243205594599,30.83242071605135,-0.03303750418520357,0.24992644996996205,0.2829639541551656,223506653,224804477,68.20958151341978,59.94762292558975,NaN,NaN,12.656254389626087,14.499157289038056
2008-05-16T09:30:00-04:00,40.53,40.92,40.48,40.78,2972949,3956812.7,60.34196483472234,56.428299762034065,NaN,NaN,149.32612932943874,72.53335968217773,-0.010102282252837491,0.2703361013391188,0.2804383835919563,226479602,225355298.2,69.29971316586447,60.99067866998159,NaN,NaN,13.80980258081656,14.400678045006414
2008-05-19T09:30:00-04:00,40.74001,41.42999,40.74001,41.24001,2379806,3900451.6,65.07964864634339,56.94355312721046,NaN,NaN,227.00404648911618,113.2700761352185,0.03160270917474034,0.3199417700603817,0.2883390608856414,228859408,225867097,70.3181791848461,62.12217798747365,NaN,NaN,16.290712464044645,14.670682962011876
2008-05-20T09:30:00-04:00,41.2,41.75999,41.2,41.52,4699059,3938255.45,67.61554448040467,57.9354710131525,NaN,NaN,242.7721665814079,155.00996252990234,0.0713254991189492,0.37749593478432786,0.30617043566537866,233558467,227914762.8,74.03025092251826,63.77789335327954,NaN,NaN,19.190534748364378,15.316376074347948
2008-05-21T09:30:00-04:00,41.35001,41.98,41.25,41.31,4104781,4005842.3,63.86921604620397,58.25595497991766,NaN,NaN,193.70041609353322,177.1854158105912,0.07629096695316134,0.4015341443568303,0.325243177403669,229453686,228371563.2,74.78776253126907,65.25378554370297,NaN,NaN,20.518885667029814,16.05959173044536
2008-05-22T09:30:00-04:00,41.55,41.81,41.17,41.55,3068591,3904603.5,66.17577114474588,58.28294979067703,NaN,NaN,157.58059023629886,194.076669745959,0.08775498679331839,0.43493691089531694,0.34718192410199855,232522277,230174688,77.56909171876623,66.7058512961506,NaN,NaN,22.340229431735022,16.956825687772454
2008-05-23T09:30:00-04:00,41.50999,41.53,40.8,40.91,1783233,3794172.9,55.92321821561424,58.189900097283996,NaN,NaN,77.40060532960894,179.691564945993,0.04633165474406614,0.40509649253208124,0.3587648377880151,230739044,231026576.4,78.76119188066674,67.96632517691567,NaN,NaN,20.69567540298236,17.490947075659584
2008-05-27T09:30:00-04:00,40.45,41.2,40.45,41.12,2517614,3605826.65,58.21102194679437,58.26995201631503,NaN,NaN,47.118292754251456,143.71441419902007,0.028070449675556608,0.39385289988246086,0.36578245020690425,233256658,231906026.4,79.94608245405837,69.2379554376982,NaN,NaN,20.065103298101356,17.85868367886555
2008-05-28T09:30:00-04:00,41.31,41.31,40.89,41.14999,2702587,3530535.3,58.541969676147616,58.92345378913203,NaN,NaN,67.80879255343667,108.72173939342584,0.01373230372180656,0.3829478298591624,0.36921552613735587,235959245,232386182,80.58300361962792,70.46695968026155,NaN,NaN,19.659980402630886,18.116011782260596
2008-05-29T09:30:00-04:00,41.21001,41.62,41.06,41.59,2879585,3483400.75,63.15274121684083,59.822253609849234,NaN,NaN,101.18381991520427,90.21842015776005,0.028739904343050182,0.40514040656616856,0.3764005022231184,238838830,234263210.8,82.87303060084326,71.95838591533668,NaN,NaN,20.728601051384505,18.48923882070687
2008-05-30T09:30:00-04:00,41.73,41.74001,41.19,41.31,3462977,3212728.9,58.68036897814841,60.2903050500963,NaN,NaN,89.07611521239193,76.51752515297866,0.015339266991613087,0.39557458596263473,0.38023531897102164,235375853,234833926,83.50985008133682,73.64865581397964,NaN,NaN,20.243625443192396,18.739865481061944
2008-06-02T09:30:00-04:00,41.35001,41.47,40.75999,41.00999,5493016,3282509,54.247472134899226,60.125655185661536,NaN,NaN,40.49841778266743,69.13708764359036,-0.01647657275388259,0.3596396030286684,0.37611617578255097,229882837,234662684.6,82.5184230584999,75.16069595411771,NaN,NaN,18.446212316125717,18.697915028928197
2008-06-03T09:30:00-04:00,41.12,41.3,40.57001,40.64999,4517016,3322401.8,49.4227414714641,59.677299573845644,NaN,NaN,4.993122700896957,60.71205363291945,-0.06195773391581988,0.2986690083877761,0.360626742303596,225365821,233084517.2,73.82025901000479,75.95188046500212,NaN,NaN,15.368158212528261,18.222235483728205
2008-06-04T09:30:00-04:00,40.72,41.278,40.61,41.14,4386691,3404355.45,55.25605081150473,59.52212552781426,NaN,NaN,25.041725369933097,52.15864019621874,-0.05923298954815104,0.2865855053684072,0.34581849491655825,229752512,231843170.6,67.7691703312596,75.99968500521292,NaN,NaN,14.57222648607056,17.70080562691997
2008-06-05T09:30:00-04:00,41.3,41.69,40.92999,41.63,2801179,3377785.2,60.199439209731175,59.76551205811179,NaN,NaN,80.73610053216564,48.069096319611006,-0.026302187312138403,0.3129407607763852,0.3392429480885236,232553691,230586142.8,62.20829970914748,75.57102201919348,NaN,NaN,15.548522399472184,17.393336594427428
2008-06-06T09:30:00-04:00,41.48,41.62,40.53999,40.53999,4641969,3425746.5,47.600797268500195,58.85542866052449,NaN,NaN,-11.809238255865889,27.892025625959445,-0.07693769926489569,0.24307082400740398,0.32000852327229967,227911722,229093316.6,56.299931679303526,74.64246619872483,NaN,NaN,11.697182284008042,16.579600264367514
2008-06-09T09:30:00-04:00,40.64,41.38,40.55,41.17,3895031,3468692.75,53.63996001807483,58.03830804421959,NaN,NaN,3.462560703973755,20.48485421022071,-0.06735354609567701,0.23581659065270344,0.30317013674838045,231806753,229478099.8,57.42244489999141,73.72134232123521,NaN,NaN,10.838643309918647,15.759463556589104
2008-06-10T09:30:00-04:00,41.46001,41.46001,40.74001,41.13,3823911,3531142.4,53.220559730429116,57.01009484779276,NaN,NaN,13.194367124963192,22.125103095033957,-0.06313225120167881,0.22425482274628195,0.28738707394796076,227982842,230001504,58.96646882481938,72.6453578856853,NaN,NaN,10.053593498327706,14.944339262551761
2008-06-11T09:30:00-04:00,41.21001,41.39,40.83,41.09,4694254,3616841.3,52.776171199589776,56.21773450160604,NaN,NaN,2.8108125862310023,17.67892053829354,-0.06234968806162394,0.20944996387093084,0.2717996519325548,223288588,228708719.2,53.77895374643087,71.14472868676829,NaN,NaN,9.304753294935317,14.138684124320841
2008-06-12T09:30:00-04:00,41.14,41.14,40.75,40.92,3869333,3617830.65,50.833466701255745,55.12185561278532,NaN,NaN,-55.71390411715401,-9.61108039157039,-0.07191766736373284,0.1819025677278887,0.25382023509162155,219419255,226081832,45.09726308762587,68.82531235597256,NaN,NaN,8.09491463624474,13.275288483167113
2008-06-13T09:30:00-04:00,40.92,41.55,40.8501,41.28999,9768512,3923104.7,54.73849019372523,55.037232182650385,NaN,NaN,27.408763431861676,-1.7674800540248767,-0.05284678166362769,0.18776175801208694,0.24060853967571463,229187767,226337041,46.00917144410895,66.48588232478986,NaN,NaN,8.280872053767073,12.56180042182425
2008-06-16T09:30:00-04:00,41.28,41.535,40.84,41.33,3087176,3928816.05,55.15329885355388,54.818823390276066,NaN,NaN,21.73959948524574,1.8879277022295202,-0.03776344175003238,0.19340423748817415,0.23116767923820652,232274943,226430679,46.361199345091464,64.08696210272078,NaN,NaN,8.552390168262072,11.989027528458225
2008-06-17T09:30:00-04:00,41.52,41.77,41.44,41.56,4147063,4017178.9,57.56113277711782,54.74876361177394,NaN,NaN,127.88733366679445,24.826521010595773,-0.013759323414906766,0.21396852496957308,0.22772784838447985,236422006,228118511.8,52.3873677288667,62.07298811052355,NaN,NaN,9.486532398496104,11.631528224177922
2008-06-18T09:30:00-04:00,41.31,41.74001,41.21001,41.39999,3912144,3977833.15,55.33525203892947,54.19037152763741,NaN,NaN,83.91265821038306,41.04689013542618,-0.01028033632165165,0.21487742798241527,0.22515776430406692,232509862,229962766.6,57.94687905879707,60.292548714663106,NaN,NaN,9.638113293073934,11.346754662591637
2008-06-19T09:30:00-04:00,41.28999,41.78,41.285,41.45,4454789,3995333.55,55.90912490454661,53.99242552238014,NaN,NaN,102.43110521685784,72.67589200222855,-0.006422061384155908,0.21713018757387204,0.22355224895802794,236964651,233471845.8,66.06596083194952,59.04655662542119,NaN,NaN,9.92087542755201,11.143057629014548
2008-06-20T09:30:00-04:00,41.19,41.42999,40.67,40.67,7005688,4192188.4,45.98505255877549,53.40225269551416,NaN,NaN,-83.56908832450193,50.48032165095583,-0.05548297528999252,0.15419852984553728,0.2096815051355298,229958963,233626085,66.37327286108,57.89333161131976,NaN,NaN,7.136859589476241,10.570743623366218
2008-06-23T09:30:00-04:00,40.91,41.5,40.91,41.16,4405211,4323287.3,51.776083272654574,53.57034853845632,NaN,NaN,6.467994294107459,47.426000612728174,-0.05396586739934306,0.14222417088635098,0.19619003828569404,234364174,234043931.2,67.23885726286807,57.42323148652428,NaN,NaN,6.538285289694372,9.994678147127383
2008-06-24T09:30:00-04:00,40.91,41.2,40.82001,40.82001,4614102,4428111.7,47.935854225360636,53.04747735373174,NaN,NaN,-79.29909132024034,5.988715615321217,-0.07367198827234472,0.10410005294526314,0.17777204121760787,229750072,232709544.4,61.770511316436334,56.994755842608335,NaN,NaN,4.81466459101061,9.254676210539273
2008-06-25T09:30:00-04:00,40.94,41.41,40.94,41.3,5109434,4548454.05,53.211960245019036,52.54837171339516,NaN,NaN,13.741051031282629,-8.045605820498867,-0.05315026901236011,0.11133420495215773,0.16448447396451785,234859506,233179473.2,62.91438010152494,57.04519015634958,NaN,NaN,5.041331062597304,8.652769760833277
2008-06-26T09:30:00-04:00,40.83,41.38989,40.07001,40.07001,5622371,4685593.35,41.5829210409905,52.11852341143019,NaN,NaN,-201.3911823431146,-68.81006333249334,-0.11749608989459023,0.017614361596280048,0.13511045149087028,229237135,231633970,56.88593701122373,57.08704768005816,NaN,NaN,0.9467030482658891,7.5519030876093645
2008-06-27T09:30:00-04:00,40.07001,40.41,39.71001,39.73,6410215,4832955.25,39.0428224396742,51.07587072725871,NaN,NaN,-298.07603990670606,-111.71145364893418,-0.1745978847230814,-0.0831369044129815,0.09146098031009992,222826920,230207561.4,51.93929982762013,56.69539446060306,NaN,NaN,-3.1782082532647573,6.019030038913062
2008-06-30T09:30:00-04:00,39.83,40.985,39.8,40.7,7282871,4922448,48.67508940188458,50.751194275219824,NaN,NaN,-129.35357092546207,-138.8757666928481,-0.14016617224546377,-0.0837467349967298,0.056419437248733974,230109791,229356684.8,49.19139554908415,55.99717494090769,NaN,NaN,-3.1405904850115434,4.710512821209547
2008-07-01T09:30:00-04:00,40.31,41.16,40.19,40.91,11974469,5295320.65,50.498782624244726,50.58852366269518,NaN,NaN,-64.67300566802814,-135.95054956240566,-0.09834995539305201,-0.06651800699258104,0.031831948400470975,242084260,231823522.4,56.3942968805782,56.183985164775365,NaN,NaN,-2.4659664800638215,3.685301492456209
2008-07-02T09:30:00-04:00,41.09,41.44,40.71001,40.8,4329227,5292447.45,49.506480974973464,50.49373896796073,NaN,NaN,-9.603893386515113,-140.6195384459652,-0.07429484242472703,-0.06103660463043781,0.013258237794289217,237755033,232402627.8,57.9030647179694,57.09868528122848,NaN,NaN,-2.2700894236145066,2.8345313615889642
2008-07-03T09:30:00-04:00,41.10001,41.2,40.38,40.38,5440578,5424417.4,45.80546161175051,49.85566549781968,NaN,NaN,-78.98149908130499,-116.1376017936033,-0.0822471968614647,-0.08955075828254166,-0.007303561421076962,232314455,233018091.8,59.50665175253445,58.062791017544576,NaN,NaN,-3.313209716868565,1.9562826360950316
2008-07-07T09:30:00-04:00,40.39,40.89,39.75,39.98,6528277,5518732.8,42.54343683224737,48.95496106772636,NaN,NaN,-155.82805746258614,-87.68800530477931,-0.10838052494489578,-0.1427792176021967,-0.03439869265730091,225786178,233609943.4,61.043451848267146,59.111523339199984,NaN,NaN,-5.233702647287572,0.9291418813260883
2008-07-08T09:30:00-04:00,39.97,40.57001,39.8,40.19,9724387,5810200.6,44.767310781234336,48.04111663944896,NaN,NaN,-133.4858203511056,-88.514455189908,-0.1053635867764206,-0.16610317612782666,-0.06073958935140606,235510565,234690098.2,63.74758742280271,59.922967603052555,NaN,NaN,-6.0986625341858804,-0.07483017803276426
2008-07-09T09:30:00-04:00,40.28,40.89999,40.23,40.67,4823316,5860170.85,49.57183426362769,47.629443941213125,NaN,NaN,-50.885036830739736,-85.75686142245033,-0.06676306518190293,-0.14419342082878472,-0.07743035564688179,240333881,234340022.4,62.23967512201315,60.22959589328228,NaN,NaN,-5.323174100169395,-0.8245935954808544
2008-07-10T09:30:00-04:00,40.75999,40.91,40.58,40.77,5612879,5906102.1,50.53716597565219,47.245732589149235,NaN,NaN,-20.346387884509376,-87.90536032204919,-0.031981491711224344,-0.11740722028591222,-0.08542572857468787,245946760,235978367.8,66.26185584170986,60.24358839397945,NaN,NaN,-4.408434351000754,-1.3365708462694115
2008-07-11T09:30:00-04:00,40.50999,41.03,40.10001,40.46001,9236012,6174436.05,47.50157154441079,47.35405537383747,NaN,NaN,-55.10522302075253,-83.1301051099387,-0.02750858019420238,-0.11981145381744085,-0.09230287362323847,236710748,236857626.4,68.21843311502566,60.37538555497557,NaN,NaN,-4.531924608306357,-1.7930499551318322
2008-07-14T09:30:00-04:00,40.96001,40.96001,39.91,40.17999,6649465,6018483.7,44.879144107812465,46.86141686206304,NaN,NaN,-78.63164699255813,-67.69082301593309,-0.040291715222941574,-0.14266751765191543,-0.10237580242897386,230061283,237712647.4,70.03809254868705,60.57533093253408,NaN,NaN,-5.406800506879733,-2.309300033952961
2008-07-15T09:30:00-04:00,39.92,40.07001,39.42,39.89999,7711637,6249706.75,42.36080959681492,46.46319938859548,NaN,NaN,-154.82644808934631,-71.95894856358125,-0.06312738353760171,-0.181285031850976,-0.11815764831337429,222349646,235080463.6,58.864509705672035,60.367759388908055,NaN,NaN,-6.885361303753001,-2.9630230724958238
2008-07-16T09:30:00-04:00,39.92999,39.92999,38.82001,39.11,7050051,6394856.15,36.19044264805346,45.24737670309794,NaN,NaN,-209.16289255638432,-103.61451970871016,-0.12346919179267699,-0.2724941380542205,-0.14902494626154353,215299595,230073606.4,44.36552868728165,59.04284143074783,NaN,NaN,-10.201096173328828,-3.9970335154719674
2008-07-17T09:30:00-04:00,39.03999,39.108,38.05,38.49001,11657605,6782129.2,32.223408071910384,44.578840062449366,NaN,NaN,-258.10705706027045,-151.16665354386237,-0.19302549053653387,-0.39030680943221085,-0.197281318895677,203641990,221612652.4,30.633834471869918,57.16769124936541,NaN,NaN,-14.384761829480516,-5.480994703187474
2008-07-18T09:30:00-04:00,38.53999,39.24001,38.255,38.53,6553844,6887081.95,32.73557195232428,44.12832217049579,NaN,NaN,-195.2419166865703,-179.19399227702593,-0.22215267138357664,-0.4749721581251478,-0.2528194867415712,210195834,216309669.6,25.33999714194954,55.2677410575318,NaN,NaN,-17.529559874921915,-7.202218299149537
2008-07-21T09:30:00-04:00,38.59,39.3215,38.50999,39.21001,9143602,6993977.65,40.912222771171926,43.57383169687346,NaN,NaN,-131.1527595335955,-189.6982147852334,-0.18306185735314173,-0.48164680843299834,-0.2985849510798566,219339436,214165300.2,23.566508007307277,53.437391947404876,NaN,NaN,-17.71508248050336,-8.704056039342941
2008-07-22T09:30:00-04:00,39.00999,39.60001,38.95,39.08,5250488,7036241.5,39.91325093848513,42.81772229074778,NaN,NaN,-95.40770561288544,-177.8144662899412,-0.15453887984473624,-0.4917585508857769,-0.33721967104104067,214088948,212513160.6,22.27310305340498,51.000163816892496,NaN,NaN,-18.167237793386708,-10.055939147063478
2008-07-23T09:30:00-04:00,39.34,39.34,37.98,38.13,8453223,7228197.55,33.4801658156439,41.67298549365281,NaN,NaN,-143.03308300138684,-164.58850437894176,-0.18611245993498643,-0.5698602459597737,-0.38374778602478726,205635725,210580386.6,20.832638487317254,48.35227622898878,NaN,NaN,-20.712582689814273,-11.578316796027877
2008-07-24T09:30:00-04:00,38.14,38.41,37.49001,38.07001,6411629,7293307.3,33.11717518039757,40.766679319984746,NaN,NaN,-159.16414246826372,-144.7999214605404,-0.19647571190584812,-0.6293424259070974,-0.4328667140012493,199224096,209696807.8,20.189798715797963,45.5439295835076,NaN,NaN,-22.824714775930588,-13.184945078871122
2008-07-25T09:30:00-04:00,38.03999,38.2,37.57001,37.61,6317773,7328077.4,30.395765069508784,39.89898847978913,NaN,NaN,-147.0591089279888,-135.1633599088241,-0.21808201632099483,-0.7054692344024929,-0.48738721808149804,192906323,206238905.6,17.866286989793622,42.459846379330926,NaN,NaN,-25.479419859090225,-14.941298618902422
2008-07-28T09:30:00-04:00,37.61,38.13,37.5,37.7,5199414,7267537.35,31.58039095146127,38.957065634805346,NaN,NaN,-126.12267760412247,-134.1573435229295,-0.21000520370893394,-0.7498937227176654,-0.5398885190087315,198105737,201992165.8,15.506115670831079,39.01402696847581,NaN,NaN,-27.264473747709637,-16.701752208732024
2008-07-29T09:30:00-04:00,37.67999,37.88,37.52,37.75,4117566,7109272.1,32.27005636247645,37.72122435615169,NaN,NaN,-114.75545454192888,-138.02689330873818,-0.18582105047894615,-0.7721648321074142,-0.586343781628468,202223303,199619036.8,14.364182924044059,35.59434895433516,NaN,NaN,-28.52246481878542,-18.39042543873965
2008-07-30T09:30:00-04:00,37.75,38.49001,37.7,38.49001,5313898,6776243.55,41.645363284413776,37.0860955924918,NaN,NaN,-74.09859441757081,-124.23999559197497,-0.10835055150281792,-0.7217819710069904,-0.6134314195041725,207537201,199999332,15.4388955113602,31.96413750216733,NaN,NaN,-26.813879762953114,-19.593776056484433
2008-07-31T09:30:00-04:00,38.38,38.55,38.07001,38.08,5411855,6830374.95,38.4681415182934,36.440850590626276,NaN,NaN,-67.53736637635411,-105.91464037359306,-0.0746869718309836,-0.7067901342929019,-0.6321031624619183,202125346,200579582,17.14742272522227,28.31620818860995,NaN,NaN,-26.31857526908408,-20.55446165828438
2008-08-01T09:30:00-04:00,38.34,38.35001,36.89999,36.99001,9852770,7050984.55,31.572136175353123,35.490350024022035,NaN,NaN,-113.3606197423324,-99.17494253646177,-0.11346992929716049,-0.7739405740833689,-0.6604706447862084,192272576,200452832.6,17.066306777175768,24.532509204930566,NaN,NaN,-28.184841644551156,-21.64451594203678
2008-08-04T09:30:00-04:00,37.10001,37.22,36.45,36.59,6958188,7072480.1,29.48329499679491,34.57052755259203,NaN,NaN,-141.97014127748145,-102.34443527113356,-0.15133637340022132,-0.849641111536485,-0.6983047381362637,185314388,197894562.8,15.475102147691771,21.433265807931978,NaN,NaN,-30.40202274145724,-22.89558834195399
2008-08-05T09:30:00-04:00,36.55,37.24001,36.24001,36.89,8714629,7021992.2,33.06030591626582,34.34694635746435,NaN,NaN,-127.59880111073348,-104.91310458489447,-0.1416254140557056,-0.8753365057058957,-0.7337110916501901,194029017,196255705.6,14.539855765886415,19.302860599260892,NaN,NaN,-31.043622882142518,-24.059593276266636
2008-08-06T09:30:00-04:00,36.85001,37.49001,36.8,37.09,5702371,7065944.95,35.41248432488996,34.57473751839146,NaN,NaN,-98.49222926704337,-109.791831554789,-0.10866189790841285,-0.8695384640357062,-0.7608765661272934,199731388,194694543,13.691026707698782,18.09266004467724,NaN,NaN,-30.83083053635775,-25.026912884851082
2008-08-07T09:30:00-04:00,37,37.5,36.515,37.06,5453566,7057979.3,35.212608313581384,34.751668687052685,NaN,NaN,-98.69921021787515,-116.02420032309321,-0.07728253185277989,-0.8574797309432682,-0.7801971990904883,194277822,193125038.2,12.877113921730981,17.202454100375917,NaN,NaN,-30.71842121501824,-25.83998550344639
2008-08-08T09:30:00-04:00,36.8,37.39,36.67,37.17,5669703,6879663.85,36.625073846566174,34.445443763866564,NaN,NaN,-88.62675085848826,-111.07742654632439,-0.03943042314788203,-0.8294852280253409,-0.7900548048774588,199947525,194660028,18.01076354543784,16.805615210242383,NaN,NaN,-30.226001813378744,-26.466559262008154
2008-08-11T09:30:00-04:00,37.38,37.89,37.10001,37.58,4655648,6779973,41.72480145709327,34.57484022948143,NaN,NaN,-45.832297195257894,-91.84985772987966,0.0197295742213629,-0.7653928371007552,-0.7851224113221181,204603173,198517785,29.28796556591024,17.306676818278472,NaN,NaN,-28.318378016001223,-26.73110479829288
2008-08-12T09:30:00-04:00,37.55,37.698,36.78999,37.14,5624938,6675638.05,38.174566239045355,34.91015454543868,NaN,NaN,-68.85438815513658,-80.10097513876028,0.03485369664811988,-0.7415552905119682,-0.7764089871600881,198978235,199507628.6,31.877096785787714,18.095566696740647,NaN,NaN,-27.677208335061998,-26.866262446402754
2008-08-13T09:30:00-04:00,36.97,37.448,36.88,37.14,3918567,6519063.85,38.174566239045355,35.27139676391352,NaN,NaN,-69.0737024025936,-74.21726976587033,0.049584487743487116,-0.7144283774807292,-0.7640128652242163,198978235,199356998,31.686957185712444,18.91679230173454,NaN,NaN,-27.157049689734723,-26.907803481164464
2008-08-14T09:30:00-04:00,37.17,37.17,36.64999,36.82001,4344797,6153423.45,35.61839309171184,35.644441622642304,NaN,NaN,-90.27152358891625,-72.53173244007856,0.042762506647244014,-0.7105597319151613,-0.7533222385624053,194633438,199428121.2,31.89352610467175,19.918737952797265,NaN,NaN,-27.41719166117502,-26.980573221165972
2008-08-15T09:30:00-04:00,36.92,37.09,36.83,36.95,2781253,5964793.9,37.45069431352336,36.063749005646734,NaN,NaN,-74.8913714644924,-69.78465656127938,0.05140849297179184,-0.6890616223476655,-0.7404701153194574,197414691,198921554.4,31.170563037658596,21.0376270504278,NaN,NaN,-27.133607197575994,-27.002435217795977
2008-08-18T09:30:00-04:00,37.12,37.33,36.96001,37,2967124,5655970,38.179500935109786,36.48585218940626,NaN,NaN,-53.92263169816881,-71.40272346186156,0.06407431943829078,-0.6603772160215939,-0.7244515354598847,200381815,198077282.8,29.951941918067448,22.151038407143762,NaN,NaN,-26.70314523595595,-26.959679506104546
2008-08-19T09:30:00-04:00,37.14999,37.22,36.95,37.2,2133429,5500117.05,41.134098208728076,36.44933325542871,NaN,NaN,-44.54102889313004,-66.54005160946025,0.0880223515136096,-0.6144235960678728,-0.7024459475814824,202515244,198784684.6,32.33883087174701,23.358176647171387,NaN,NaN,-25.544349442109304,-26.757489496962368
2008-08-20T09:30:00-04:00,37.12,37.42,36.94,37.34,3486465,5251779.15,43.18120513383159,36.785980656538584,NaN,NaN,-21.163307545860693,-56.95797263811367,0.11375677550501118,-0.5602499782002184,-0.6740067537052296,206001709,200189379.4,36.93429980066674,24.77152500970314,NaN,NaN,-24.006739661527092,-26.364525234757327
2008-08-21T09:30:00-04:00,37.14999,37.88,37.09,37.7,4112430,5136819.2,48.17232081889132,37.97170813107703,NaN,NaN,41.66473873833525,-30.570720172663336,0.1530424456493743,-0.48270369664351165,-0.635746142292886,210114139,203285519.6,45.690044852147764,26.816077729343995,NaN,NaN,-21.2478749877126,-25.633575199465223
2008-08-22T09:30:00-04:00,37.86,38.03,37.75,37.85001,2653301,4953595.6,50.13784789561051,39.447033338135284,NaN,NaN,99.20340084132708,4.248234288500564,0.1850124686896819,-0.4044805564307836,-0.5894930251204655,212767440,206356069.4,52.70317760607335,29.475225976371252,NaN,NaN,-18.346201622723914,-24.59252183135932
2008-08-25T09:30:00-04:00,37.83,37.94,37.28,37.45,3464056,4866827.7,45.21378639780678,40.315139086816785,NaN,NaN,43.94820742083669,23.822402112301656,0.17519859212377242,-0.37049478496575006,-0.5456933770895225,209303384,208140383.2,56.239521188014415,32.453773506523255,NaN,NaN,-17.08434266164889,-23.519924807114972
2008-08-26T09:30:00-04:00,37.39999,37.99001,37.35001,37.86,2545830,4788240.9,50.57209446852013,41.397968382790374,NaN,NaN,77.3043099868635,48.19146988830037,0.1910034692380423,-0.30693904054196963,-0.4979425097800119,211849214,210007177.2,59.63959142648649,35.73581384357952,NaN,NaN,-14.385047271827037,-22.214942302073837
2008-08-27T09:30:00-04:00,38.07001,38.25,37.82001,38.13,2623068,4653699.4,53.77813113425428,42.724077155695575,NaN,NaN,146.30880980091177,81.68589335765486,0.21266735858976193,-0.23210831154280953,-0.44477567013257147,214472282,211701291.8,62.488029450372565,39.27945066705392,NaN,NaN,-11.119721817552769,-20.629910804285114
2008-08-28T09:30:00-04:00,38.34,38.39999,38.10001,38.19,1799801,4473096.7,54.48465411720922,43.99976146074151,NaN,NaN,178.42286193234375,109.03751799645656,0.22298148509617582,-0.1660488137623517,-0.3890302988585275,216272083,212932880.6,64.45216735269413,42.59669379614361,NaN,NaN,-8.228936919072254,-18.858343106397562
2008-08-29T09:30:00-04:00,38.14,38.39999,37.66,37.66,2205970,4090756.7,47.56790365782211,44.41712590365071,NaN,NaN,101.4294186292664,109.48272155404443,0.18748047501637066,-0.15467970508806417,-0.34216018010443483,214066113,213192615.2,64.86993025277972,45.13826270234858,NaN,NaN,-7.64157353604303,-17.25594745348977
2008-09-02T09:30:00-04:00,38.58,38.58,37.09,37.2,6224098,4054052.2,42.52231901435886,44.72767967331596,NaN,NaN,43.85650399365592,109.46438086860826,0.12916437706331196,-0.18070470877529488,-0.30986908583860684,207842015,212900341.4,63.959045404619275,47.42983046083655,NaN,NaN,-8.701961662221901,-16.033949483308646
2008-09-03T09:30:00-04:00,37.19,37.19,36.47,36.61,3440855,3790363.5,37.088385988278155,44.65009536968973,NaN,NaN,-116.41393069539447,70.72073273215668,0.0510145622115889,-0.2461008830741207,-0.2971154452857096,204401160,211410730.6,59.38241821933571,49.40807767752392,NaN,NaN,-11.444787039190548,-15.378354848434633
2008-09-04T09:30:00-04:00,36.55,36.745,36.03999,36.14999,4199797,3715234.8,33.49445151184045,44.49838525684178,NaN,NaN,-173.55981061068508,6.7470086498373005,-0.027290514105103247,-0.33122858791708865,-0.3039380738119854,200201363,208556546.8,51.742560253016045,50.82586583097709,NaN,NaN,-14.988105229738894,-15.32260490290667
2008-09-05T09:30:00-04:00,36.06,36.12,35.23981,35.39,6154988,3750305.9,28.568937119554278,43.86397402870113,NaN,NaN,-243.9264938693556,-77.72286251050257,-0.12066984599666675,-0.4547753813078188,-0.33410553531115206,194046375,204111405.2,42.55906805797995,51.63933047528575,NaN,NaN,-19.885472780242246,-15.974443171097468
2008-09-08T09:30:00-04:00,35.57001,36.38,35.57001,36.28,6509195,3792280.5,39.74391007252716,43.975717538516655,NaN,NaN,-150.47009158526996,-128.10276455340983,-0.1130287922553811,-0.47539152563037845,-0.36236273337499736,200555570,201409296.6,38.12893742338628,52.223401582808535,NaN,NaN,-20.012813703895283,-16.55135324721144
2008-09-09T09:30:00-04:00,36.5,36.52,35.03999,35.14,8899270,4004461.6,32.68941352317245,43.37252577526267,NaN,NaN,-179.94216394777916,-172.86249814169688,-0.17176291662181875,-0.5770663791522708,-0.405303462530452,191656300,198172153.6,33.61458055194919,52.31452655996583,NaN,NaN,-22.93603744582621,-17.463450989870694
2008-09-10T09:30:00-04:00,35.31,35.69,35.21001,35.53,4254289,3935929.15,36.82096225803691,42.91822271270592,NaN,NaN,-155.42242791589035,-180.66419758579605,-0.1709882688003881,-0.6190387985309371,-0.44805052973054904,195910589,196474039.4,31.507210370192084,51.92687731493192,NaN,NaN,-23.60642672388033,-18.34101895187207
2008-09-11T09:30:00-04:00,35.25,35.96001,34.89999,35.81,8394316,4159716.6,39.68345295872852,42.31187500840857,NaN,NaN,-125.25454921129555,-171.00314530591814,-0.13958550993491664,-0.6225324171491948,-0.4829469072142782,204304905,197294747.8,33.67152219918937,51.06841141114918,NaN,NaN,-23.10030539319695,-19.02091701491848
2008-09-12T09:30:00-04:00,35.69,36.60001,35.69,36.48,6197137,4252333.6,45.98941579602841,42.01555842986699,NaN,NaN,-57.07253843015312,-133.63235421807764,-0.06542479644120847,-0.5647279027657888,-0.4993031063245803,210502042,200585881.2,41.63606473729885,50.277903349093855,NaN,NaN,-20.415451357580157,-19.220136206727293
2008-09-15T09:30:00-04:00,35.37,36.23,35.21001,35.21001,8370012,4531771.55,37.900810937354684,41.493203039834704,NaN,NaN,-101.5789575374016,-123.85412740850396,-0.09200836577632732,-0.6143135635449894,-0.5223051977686621,202132030,200901173.2,42.350249185237004,49.28581249175261,NaN,NaN,-21.149215646450294,-19.495718983830578
2008-09-16T09:30:00-04:00,35.28999,35.33,33.17999,34.67999,18645232,5315676.95,35.124296111742396,40.38978887149343,NaN,NaN,-159.44488794615032,-119.75467220817818,-0.13291008284351524,-0.6884428013230561,-0.5555327184795409,183486798,199267272.8,39.642991751631385,47.85748394354868,NaN,NaN,-22.753568868112183,-19.96112611015652
2008-09-17T09:30:00-04:00,34.33,34.64,33,33,15351238,5976567.4,28.098005482797163,38.555494182103644,NaN,NaN,-179.81571435815874,-124.63332949663186,-0.25372747182165034,-0.8726920582566038,-0.6189645864349534,168135560,193712267,32.124179368416904,45.688637509123275,NaN,NaN,-27.03543809323947,-20.9717421077398
2008-09-18T09:30:00-04:00,33.17,34.33,33.05,34.21001,17985952,6701541.75,37.755922332666394,37.36058476892202,NaN,NaN,-140.2681000438101,-127.63603966313477,-0.23328966389310224,-0.9105766663013313,-0.677287002408229,186121512,190075588.4,28.335261905873423,43.10885854863608,NaN,NaN,-26.544394174983736,-21.76783526020322
2008-09-19T09:30:00-04:00,34.89,36.75,34.09,35,9355668,6963703.65,43.12705138405724,37.043381035081666,NaN,NaN,-55.811769171440744,-127.38388581139229,-0.15166019959788657,-0.8668622519055873,-0.7152020523077007,195477180,187070616,25.64381404280833,40.306993105066695,NaN,NaN,-24.050196342845616,-22.093886843437847
2008-09-22T09:30:00-04:00,35.00999,35.00999,34.03999,34.13,5658262,7113951.7,39.123147190924776,36.80058304769352,NaN,NaN,-96.79236079510663,-126.42656646293328,-0.14154716146417334,-0.8921360041379174,-0.750588842673744,189818918,184607993.6,23.66036013643884,37.42851558591095,NaN,NaN,-23.62084673097572,-22.31202397022897
2008-09-23T09:30:00-04:00,34.00999,34.42999,33.53999,33.53999,3520766,7116787.2,36.63886607381935,36.768474482375034,NaN,NaN,-116.05060678926195,-117.7477102315556,-0.15859845360972047,-0.9488369096858946,-0.7902384560761742,186298152,185170264.4,25.085114518700152,34.97870817872269,NaN,NaN,-24.198240824114638,-22.581483520784065
2008-09-24T09:30:00-04:00,33.64,33.85001,33.21001,33.85001,3306543,7154822.85,38.83659259686776,37.150055988448415,NaN,NaN,-117.70459266678075,-105.32548589328003,-0.13398267488082105,-0.9577167996772005,-0.8237341247963794,189604695,189464091.4,35.053589905097624,33.78663886815709,NaN,NaN,-23.88598725447012,-22.76784119702493
2008-09-25T09:30:00-04:00,33.77,34.89,33.77,34.52,4199453,7233642.1,43.40526512944372,38.20979370344052,NaN,NaN,-69.15196142387495,-91.10225816929298,-0.06126336508733776,-0.9003133311555516,-0.8390499660682138,193804148,191000618.6,38.22153834160142,33.47681531698719,NaN,NaN,-22.082415606541346,-22.669923255527273
2008-09-26T09:30:00-04:00,33.52,34.80251,33.52,34.53,3207616,7304032.85,43.473133845003225,38.47616683004595,NaN,NaN,-67.34569866625458,-93.40904406825574,-0.004185148666848604,-0.8442814019017746,-0.840096253234926,197011764,191307535.4,38.863031378908005,33.52925059952446,NaN,NaN,-20.668411683823145,-22.383993030998113
2008-09-29T09:30:00-04:00,34.14,34.14,32.50999,32.72,7997824,7593625.55,35.23650211465929,38.65810172943787,NaN,NaN,-127.52027056560452,-99.55462602235531,-0.07604121032402944,-0.9351477661399628,-0.8591065558159333,189013940,191146539.8,38.636395072183674,33.887951636684065,NaN,NaN,-22.210916769644367,-22.35926785080472
2008-09-30T09:30:00-04:00,32.74001,33.25999,32.57001,33.23,3359161,7450378.7,38.75743967597169,38.796421545004634,NaN,NaN,-122.18091788878858,-100.78068824226064,-0.07671367276279362,-0.9549986467694254,-0.8782849740066317,192373101,192361529.6,41.41314216434711,34.59551819340943,NaN,NaN,-22.258339806899034,-22.344849558818193
2008-10-01T09:30:00-04:00,33.33,33.41,32.48,33.09,6724496,7614560.75,38.144382252849546,38.68648792315614,NaN,NaN,-113.86016409924477,-100.01180252875344,-0.07404101817838926,-0.9708362467296183,-0.8967952285512291,185648605,191570311.6,40.13933455462715,35.05750479022641,NaN,NaN,-22.48898805422034,-22.365440772447073
2008-10-02T09:30:00-04:00,32.8,33.36,32.20351,32.61,5241301,7666635.95,36.03952330171893,37.97578131641974,NaN,NaN,-122.74810983277372,-110.7310322105332,-0.09094106525982215,-1.0104715601260068,-0.9195304948661847,180407304,188890942.8,36.0909229199734,34.66142323184602,NaN,NaN,-23.331512240742384,-22.503450982203546
2008-10-03T09:30:00-04:00,32.78,33.28,31.98,32.12,8126621,7765217.6,33.978261777804775,37.69559923359475,NaN,NaN,-127.57512850760322,-122.77691817880293,-0.11965387772011893,-1.0690978420163333,-0.9494439642962144,172280683,183944726.6,30.06294906465962,33.78375893751907,NaN,NaN,-24.664778146888946,-22.812212005730032
2008-10-06T09:30:00-04:00,31.28,32.3,29.5,30.55,9640902,7921802.95,28.37783015042045,37.213708807786034,NaN,NaN,-206.2248129196007,-138.51782664960214,-0.22291589112600185,-1.2280888282037168,-1.005172937077715,162639781,178669894.8,25.22440681527499,32.753860013493615,NaN,NaN,-27.771686070895207,-23.52070830075363
2008-10-07T09:30:00-04:00,30.52,31.12,29.22,29.3,9039863,7928832.6,24.86396017562339,36.982705571559336,NaN,NaN,-220.1717878241612,-158.1160006366767,-0.3465610112226627,-1.4383742011060434,-1.0918131898833807,153599918,170915258.2,20.102134630456007,31.89514253221069,NaN,NaN,-31.675439152766266,-24.685669851041148
2008-10-08T09:30:00-04:00,28.22,29.78999,28.00999,28.78999,10497039,8240970.1,23.580975045997974,35.97020933679731,NaN,NaN,-222.99096744252975,-179.94216130533368,-0.4284858705022696,-1.6274205280112177,-1.1989346575089481,143102879,162406113,16.21183514184574,31.029183477637293,NaN,NaN,-35.229672519896894,-26.191955946591968
2008-10-09T09:30:00-04:00,29.14999,29.77,26.85001,26.85001,9766270,8309567.8,19.466280955372284,34.280154306176954,NaN,NaN,-219.43524671695752,-199.27958868217044,-0.5702473808163533,-1.9117438835293896,-1.3414965027130363,133336609,152991974,13.17414965268037,30.138493164056722,NaN,NaN,-39.94793743171915,-28.157096158752992
2008-10-10T09:30:00-04:00,26.17999,26.8,23.28,25.75999,14829203,8741171.1,17.6072399304949,32.743303787574824,NaN,NaN,-241.49527841939044,-222.0636186645279,-0.6865398014812958,-2.199671254564656,-1.5131314530833602,118507406,142237318.6,10.706152615157379,29.21319262682233,NaN,NaN,-44.47251473997799,-30.487870241785135
2008-10-13T09:30:00-04:00,27.27,29.16,26.21001,28.87,6070543,8626197.65,36.29946723070947,32.71906101306697,NaN,NaN,-122.32844409944698,-205.28434490049713,-0.5111715836726494,-2.1520959326741718,-1.6409243490015224,124577949,134624952.2,9.368347368643512,28.090566401818286,NaN,NaN,-41.08130080330462,-32.001217464859344
2008-10-14T09:30:00-04:00,30.86,30.86,27.49001,28.63,11083203,8248096.2,35.627737781076064,32.489857097653285,NaN,NaN,-81.97489177984124,-177.64496569163313,-0.3748139683612979,-2.109441809453145,-1.734627841091847,113494746,126603917.8,8.204943653214144,26.17280595525518,NaN,NaN,-38.85504083712925,-32.98033508946933
2008-10-15T09:30:00-04:00,28.13,28.67999,26.39999,26.5,8674348,7914251.7,30.273372585875066,31.551864773112666,NaN,NaN,-113.93047272080689,-155.8328667472886,-0.3898166422136111,-2.221898643858861,-1.8320820016452497,104820398,118947421.6,7.276085058399346,23.962416435026462,NaN,NaN,-39.007598197970985,-33.84137267639814
2008-10-16T09:30:00-04:00,27.03999,27.5,25.36,27.27,10749719,7552440.05,34.127446552873536,30.884315680817682,NaN,NaN,-110.22433674287187,-133.99068475247145,-0.31294285197290983,-2.223260566611387,-1.910317714638477,115570117,115394123.2,6.886451982386461,21.67837504956064,NaN,NaN,-37.71777154880629,-34.39514394388502
2008-10-17T09:30:00-04:00,27.72,29.17999,26.55,27.41,11200602,7644686.75,34.83274480715829,30.85547587313904,NaN,NaN,-77.09194986280342,-101.11001904115402,-0.22200439323758325,-2.187823206185456,-1.9658188129478729,126770719,117046785.8,9.318727986687833,19.584255972025225,NaN,NaN,-36.504033381583525,-34.69641386355623
2008-10-20T09:30:00-04:00,27.62,29.96001,27.60001,29.72,9968727,7860210,45.249350271857686,31.319183772845182,NaN,NaN,-37.47324257600976,-84.13897873646658,0.01197270636007186,-1.950852929997783,-1.962825636357855,136739446,119479085.2,12.923824077576356,17.54930468011303,NaN,NaN,-31.67255165423718,-34.26443354793922
2008-10-21T09:30:00-04:00,29.60001,29.69,28.57001,28.78,7187012,8043522.3,42.287205187153354,31.615099696724027,NaN,NaN,-34.824451702758076,-74.70889072104995,0.11590349311449799,-1.8179462699647324,-1.9338497630792304,129552434,122690622.8,17.582874052769313,15.938128929980325,NaN,NaN,-28.84569845719403,-33.49032853497562
2008-10-22T09:30:00-04:00,28.92,28.92,26.22,27.56,9744133,8365401.8,38.74236420036189,31.808159760912808,NaN,NaN,-68.19179701171764,-65.56115557923215,0.1147424334407674,-1.7904217212782711,-1.9051641547190385,119808301,125688203.4,21.789240144555578,14.916580160307623,NaN,NaN,-27.74410711221076,-32.66943976029492
2008-10-23T09:30:00-04:00,27.42999,28.85001,26.44279,28.22,15932184,8952038.35,41.59475116024541,32.35219471680143,NaN,NaN,-55.85091587428811,-54.686471405515405,0.16748839182130837,-1.695803664942403,-1.8632920567637115,135740485,129722277,27.175932419274304,14.710364685637247,NaN,NaN,-25.923703720256487,-31.705763183146573
2008-10-24T09:30:00-04:00,26.52,28.14999,26.3708,27.47,13917188,9487516.95,39.35231294818391,33.1360863452131,NaN,NaN,-67.42029890596689,-52.7521412141481,0.1608925485616226,-1.6621763710616833,-1.8230689196233059,121823297,128732792.6,26.690353521754602,14.815075164671507,NaN,NaN,-25.15979839848971,-30.77062535676702
2008-10-27T09:30:00-04:00,27.17999,27.78999,26.39999,26.39999,7508004,9463025.95,36.342061523392545,33.955950727196615,NaN,NaN,-80.08673238583486,-61.27483917611312,0.09665918141669416,-1.7022449428524382,-1.7989041242691324,114315293,124247962,24.54926047920476,15.132727011010704,NaN,NaN,-25.482178203511985,-30.015132906302014
2008-10-28T09:30:00-04:00,28,29.39999,26.37,29.06,7972281,9693681.95,47.162707304610706,35.64036017424038,NaN,NaN,-20.931006155721832,-58.496150066705866,0.23748780673780656,-1.5020443658468743,-1.7395321725846808,122287574,122794990,23.880874508713063,15.680515537215513,NaN,NaN,-22.010328598912984,-28.871589433817867
2008-10-29T09:30:00-04:00,29.23,29.64999,28.13,28.13,8763434,9795628.85,44.3258220404284,37.416041680315814,NaN,NaN,3.9945030381311444,-44.058890056736104,0.2698155129456121,-1.4022627814026656,-1.6720782943482777,113524140,121538157.8,23.290175277809823,16.40308879615333,NaN,NaN,-20.178350075338695,-27.62969809689227
2008-10-30T09:30:00-04:00,29.16,29.86,28.62,29.7,10375695,10052348.55,49.81398665396825,39.71652358913534,NaN,NaN,57.635336091892015,-21.361639663500085,0.3913714686989802,-1.1828639584745524,-1.5742354271735326,123899835,119170027.8,22.177077252157616,17.222440555939063,NaN,NaN,-16.769239149389048,-26.078203961534665
2008-10-31T09:30:00-04:00,30.05,30.42,28.88,28.91,11896125,10240823.75,47.28797055497982,40.50141668372608,NaN,NaN,78.01251071889963,7.724922261473219,0.41098009721361195,-1.0605103056565177,-1.4714904028701297,112003710,117206110.4,21.269225987533503,18.072503314431206,NaN,NaN,-14.858770946408509,-24.475427816516643
2008-11-03T09:30:00-05:00,29.46001,29.49001,28.72,29.21001,6081480,10062852.65,48.35893083106409,41.41078761586808,NaN,NaN,71.81715369023709,38.105699476687604,0.4342873843180928,-0.9286311724725138,-1.3629185567906066,118085190,117960089.8,22.5795747172281,19.099262676146488,NaN,NaN,-13.010751860995354,-22.837616965727886
2008-11-04T09:30:00-05:00,29.66,30.31,29.33,29.75999,7789891,10000354.05,50.35040723477682,42.84486151936106,NaN,NaN,120.73519871830193,66.43894045149236,0.47365378509661826,-0.7708513254198337,-1.244505110516452,125875081,118677591.2,23.87795165509212,20.28511029019597,NaN,NaN,-10.894204616575319,-21.131415201563232
2008-11-05T09:30:00-05:00,29.19,29.8,28.72,29.21001,8785652,9914784.7,48.34272156359874,43.860238305841435,NaN,NaN,76.99189056943807,81.03841795775375,0.44974564515117854,-0.6823230540774787,-1.1320686992286573,117089429,119390649,25.220149381820463,21.594660104441257,NaN,NaN,-9.722968431397733,-19.50163709153959
2008-11-06T09:30:00-05:00,28.75,28.94,27.31,27.84,9872352,9920088.8,43.67128722400327,44.491562764187506,NaN,NaN,-10.868393402693048,67.33767205883673,0.33407409295389234,-0.714476083036292,-1.0485501759901843,107217077,116054097.4,23.162161068115964,22.583476753114695,NaN,NaN,-10.103478326136345,-18.15904298219627
2008-11-07T09:30:00-05:00,27.99001,29.09,27.57001,29.06,8427535,9600005.4,48.448566954695856,44.72007824153309,NaN,NaN,19.442846824124675,55.62373927988175,0.3314776706445326,-0.6342030876845186,-0.9656807583290512,115644612,116782277.8,24.608086311258973,23.418066912663456,NaN,NaN,-8.975957110476397,-16.847173571950574
2008-11-10T09:30:00-05:00,29.49001,29.59,27.83,28.36,8320758,9712516.15,46.036042522299276,44.98785233690065,NaN,NaN,19.042452454356138,45.068799032705556,0.276605238675115,-0.6199242099851574,-0.8965294486602724,107323854,114630010.6,23.2174091021634,23.82053370190589,NaN,NaN,-8.76122523518434,-15.692038095269684
2008-11-11T09:30:00-05:00,28.25,28.84,27.53,28.36,7997289,9558220.45,46.036042522299276,45.50882935989618,NaN,NaN,-7.880094254311234,19.34574043818292,0.23588564554354563,-0.6016723917308404,-0.837558037274386,107323854,110919765.2,21.01283694595371,23.765076330577184,NaN,NaN,-8.588382469005658,-14.677230148660538
2008-11-12T09:30:00-05:00,27.67999,28.05,27.42,27.42,6930848,9471045.45,42.72282515857549,45.589406074062616,NaN,NaN,-65.76965893903507,-9.206569463511707,0.14564513087782294,-0.6555016236771074,-0.8011467545549303,100393006,107580480.6,19.241933973935517,23.19836215591013,NaN,NaN,-9.389278242325345,-13.92180844775551
2008-11-13T09:30:00-05:00,27.44,29.59,27.2,29.5,14754645,9671291.75,51.1079635998044,46.429095406321224,NaN,NaN,30.808511718989788,-0.8711884391751369,0.22149380888342207,-0.5242794934506527,-0.7457733023340748,115147651,109166595.4,22.57951509120913,22.904730839442596,NaN,NaN,-7.542606472143219,-13.010493879810896
2008-11-14T09:30:00-05:00,28.78,30.12,28.25,28.8,13079559,9765239.6,48.53292072056073,47.29987106326181,NaN,NaN,55.29569650909969,6.29938149781986,0.21954992753084557,-0.4713358929205178,-0.6908858204513634,102068092,106451291.4,20.980918297892586,22.649849255063152,NaN,NaN,-6.791067942634194,-12.122004460214225
2008-11-17T09:30:00-05:00,28.74001,29.55,28.13,28.75,10494219,9791514.2,48.34554685640351,47.38435960267559,NaN,NaN,31.702150707857893,8.831321148520212,0.20993016132375142,-0.42847311879667416,-0.6384032801204256,91573873,103301295.2,19.275949771547076,22.3209260595513,NaN,NaN,-6.240165153650346,-11.28174170213367
2008-11-18T09:30:00-05:00,28.08,29.08,27.78,28.44,12351027,10049714.95,47.1306146041202,47.584701928653566,NaN,NaN,-5.2172102668594444,9.363897946010571,0.1789325173421764,-0.4147376334427051,-0.5936701507848815,79222846,97681093.6,16.672655834910458,21.848246099344202,NaN,NaN,-6.118953624479481,-10.544200548183072
2008-11-19T09:30:00-05:00,28.25,29.34,27.78,27.83,10548227,10089919.65,44.747644531364614,47.2228203484676,NaN,NaN,-23.60224661097962,17.79738041162166,0.11660745890191937,-0.4479108271574823,-0.5645182860594017,68674619,91337416.2,14.321553982382241,21.287137294360242,NaN,NaN,-6.676237306490711,-9.99163437079845
2008-11-20T09:30:00-05:00,27.61,28.25,25.98,26.21001,15884520,10087536.45,39.09440627831986,46.63756575727759,NaN,NaN,-175.86310137808854,-23.536942207794006,-0.026806807722759562,-0.5980267957128511,-0.5712199879900915,52790099,78865905.8,11.02881002471932,20.555679011302086,NaN,NaN,-8.873095093381162,-9.831843045453123
2008-11-21T09:30:00-05:00,26.44,28.83,26.44,28.83,19200896,10351721.85,50.07896622141716,46.76042542801709,NaN,NaN,-53.1761260674288,-45.231306723099706,0.05711851012976932,-0.49982185032787996,-0.5569403604576493,71990995,72850486.4,9.852199916248168,19.64658081123209,NaN,NaN,-7.351782094280431,-9.477548623857023
2008-11-24T09:30:00-05:00,28.86,29.81,28.44,29.12,10074285,10480035.9,51.12960725572196,46.81608257237032,NaN,NaN,64.91896845693977,-38.58794317328333,0.13031166823413742,-0.39405077516497755,-0.524362443399115,82065280,70948767.8,9.506891255591341,18.62007649698204,NaN,NaN,-5.815185551263139,-8.954353899200754
2008-11-25T09:30:00-05:00,29.7,30,28.75,29.7,11610184,10661931.05,53.248836279983124,47.16651933782635,NaN,NaN,98.63562452586538,-17.817376214738367,0.21115132608693032,-0.26042328579045204,-0.47157461187738237,93675464,73839291.4,14.416846024644443,17.848411971469467,NaN,NaN,-3.903276323762444,-8.232771388423853
2008-11-26T09:30:00-05:00,29,29.7,28.69,29.60001,9718277,10709673.2,52.8235582236277,47.82025298065666,NaN,NaN,72.06606274734648,1.3162856569268542,0.24866928359582474,-0.16073800738260147,-0.4094072909784262,83957187,76895805,19.39705308927074,17.579475687266235,NaN,NaN,-2.480790903006383,-7.4110598905070715
2008-11-28T09:30:00-05:00,29.74001,30.14,29.10001,30.12,2974558,10339616.35,54.843354791420104,48.27702354042268,NaN,NaN,119.23192610811807,60.33529115416818,0.29606619289760455,-0.03932454985642053,-0.3353907427540251,86931745,83724134.2,29.29573814843269,17.914307961350072,NaN,NaN,-0.7045852203956525,-6.452992080491154
2008-12-01T09:30:00-05:00,29.75999,29.95,28.12,28.12,9235531,10206586.65,46.58250097099025,48.31605628675775,NaN,NaN,3.9657726892400293,71.76367090550194,0.18567574410526738,-0.10329606262244084,-0.2889718067277082,77696214,84865178,30.824539967169954,18.457674451707685,NaN,NaN,-1.5944836862968188,-5.758919452749106
2008-12-02T09:30:00-05:00,28.58,28.85001,27.94,28.85001,11060602,10455542.75,49.56847822121459,48.56837312239456,NaN,NaN,-14.701006740594476,55.83967586599509,0.15597375366559976,-0.09400461464570853,-0.2499783683113083,88756816,86203485.2,32.66359080034954,19.2898711555931,NaN,NaN,-1.4334574390750046,-5.14099630793852
2008-12-03T09:30:00-05:00,28.63,29.56,28.25,29.35001,9836668,10557881.6,51.565503717552076,49.19999301946432,NaN,NaN,55.563103825127904,47.2251717258476,0.16336855655569107,-0.045767672616694455,-0.20913622917238553,98593484,87187089.2,34.05129563286961,20.347682702659824,NaN,NaN,-0.7092366655432177,-4.507887787596334
2008-12-04T09:30:00-05:00,29.25999,29.41,27.66,28.28999,11409633,10689080.65,47.29006951457315,48.92728629909066,NaN,NaN,-18.893706132791078,29.033217949820095,0.09369808113844622,-0.09201362774932775,-0.18571170888777397,87183851,87832422,34.99780154081316,21.23470316334583,NaN,NaN,-1.3713134829532931,-4.0598057440758994
2008-12-05T09:30:00-05:00,27.71001,28.83,26.99001,28.47,11929465,10791936.3,48.07737782466948,48.89474752081271,NaN,NaN,-69.07388946816499,-8.627945165436525,0.05829908451081084,-0.11283785324926043,-0.17113693776007127,99113316,90268736.2,38.581648513231684,22.49189817872719,NaN,NaN,-1.685653992558457,-3.720641208144836
2008-12-08T09:30:00-05:00,29.57001,29.57001,28.49001,28.92999,8192078,10780163.45,50.12736501967995,49.02202024676103,NaN,NaN,51.06979130910746,0.7928585585369646,0.06397125484629113,-0.09117286920220735,-0.15514412404849848,107305394,96190572.2,46.327684440723445,24.424164940811217,NaN,NaN,-1.3745997648221355,-3.3854924305273073
2008-12-09T09:30:00-05:00,28.92999,29.08,28.3,28.52,8966813,10812466.2,48.29705467151792,49.1053373944323,NaN,NaN,2.2294981040549997,4.178959527466854,0.03942279781377986,-0.10586562678127365,-0.1452884245950535,98338581,98106925.2,48.58740479104861,26.703789866249657,NaN,NaN,-1.6189338448304507,-3.133126918284899
2008-12-10T09:30:00-05:00,28.48,29.12,28.48,28.95,5746563,10699929.9,50.344883891509255,49.5051402058712,NaN,NaN,27.809961295403745,-1.3716689784779725,0.050735854599473634,-0.08186860634571147,-0.1326044609451851,104085144,99205257.2,49.889596932129,29.244364362660143,NaN,NaN,-1.26975907357397,-2.8669315118976235
2008-12-11T09:30:00-05:00,29.03999,29.47,28.50999,28.72,6380824,10672428.7,49.221881386739895,50.22853128504406,NaN,NaN,28.992618366656316,8.205595921411506,0.04169786896769685,-0.08048212473556404,-0.1221799937032609,97704320,101309351,52.37804676863775,32.19788127294003,NaN,NaN,-1.273765231064057,-2.6393363289213996
2008-12-12T09:30:00-05:00,28.64,28.92,28,28.89999,6910594,10280226.15,50.15883648310911,50.23423630373634,NaN,NaN,-14.577004015408004,19.104973011962905,0.046447596465857416,-0.06412049812093912,-0.11056809458679653,104614914,102409670.6,53.67363691661153,35.32798391582313,NaN,NaN,-1.0349920289850747,-2.4101442860733533
2008-12-15T09:30:00-05:00,29.05,29.06,28.08,28.45,6820387,9967267.55,47.784884753345594,49.9953275535666,NaN,NaN,-22.68745890667943,4.3535229688055255,0.01928049155788518,-0.08646748013944006,-0.10574797169732524,97794527,100507497.2,51.08614215819853,38.29793040886649,NaN,NaN,-1.443571508501023,-2.2720624607058775
2008-12-16T09:30:00-05:00,28.5,29.55,28.49001,29.42,7237035,9804408.35,52.95383350670482,49.974255926903865,NaN,NaN,68.55539677817697,17.618702703629918,0.06410917926447363,-0.025611497616733203,-0.08972067688120683,105031562,101846093.4,52.81019588728956,41.04031254191258,NaN,NaN,-0.4099129702034001,-2.0060411049198095
2008-12-17T09:30:00-05:00,29.23,29.35001,28.42,28.53,9380086,9655861.3,48.235627749375666,49.64654660731443,NaN,NaN,8.636496160609646,13.784009676671099,0.032866468617757466,-0.04863759110901,-0.08150405972676747,95651476,100159359.8,50.399583316966165,43.254778986747965,NaN,NaN,-0.8180832547547305,-1.8363328406105124
2008-12-18T09:30:00-05:00,28.62,29.32001,28.57001,28.77,9909816,9623940.75,49.54126270046434,49.267825743674734,NaN,NaN,23.466771227556226,12.67884024885108,0.027620524533090787,-0.04697840406040399,-0.07459892859349478,105561292,101730754.2,52.57163990334177,44.9173433978129,NaN,NaN,-0.802799085798872,-1.6886851613517067
2008-12-19T09:30:00-05:00,28.67999,29.06,28.36,28.58,7990824,9229255.95,48.49835736885238,49.404672629236316,NaN,NaN,-33.777981993897406,8.8386446531532,0.011439302941817664,-0.060299799916222696,-0.07173910285804036,97570468,100321865,50.4389478472318,46.31837253210303,NaN,NaN,-1.0694792244246,-1.60022717036212
2008-12-22T09:30:00-05:00,28.53,28.64999,27.89,28.2,6321359,8585279.1,46.394765520341224,49.177978864888225,NaN,NaN,-126.26431707941516,-11.876726981393947,-0.022899120975744536,-0.10036300407772103,-0.0774638831019765,91249109,99012781.4,48.471347260509305,47.44749799354302,NaN,NaN,-1.8627444162980802,-1.6377296340672571
2008-12-23T09:30:00-05:00,28.23,28.58,27.75,27.87759,3434988,8253314.25,44.62614988528072,48.68231073401169,NaN,NaN,-143.88840782729096,-54.36548790248753,-0.06309059963666694,-0.15632713264781017,-0.09323653301114324,87814121,95569293.2,43.64797356393583,48.132974988619175,NaN,NaN,-3.017984350712714,-1.8349088793023225
2008-12-24T09:30:00-05:00,27.75999,28.12,27.75999,28.02,1053725,7725491.3,45.612386550629516,48.56247623658715,NaN,NaN,-150.01589454660262,-86.09596604392998,-0.07503623315932414,-0.18703182446029842,-0.11199559130097428,88867846,94212567.2,41.87970719018306,48.62453967785988,NaN,NaN,-3.7498817245761864,-2.10847642862716
2008-12-26T09:30:00-05:00,28.16,28.38,28.06,28.08,1086551,7293905,46.04837641119853,48.41754756419636,NaN,NaN,-99.42935129943518,-110.67519054932828,-0.07373989923536362,-0.2041704653451788,-0.13043056610981518,89954397,91091188.2,38.05950956653833,48.587244038810354,NaN,NaN,-4.264649572840659,-2.416501163514803
2008-12-29T09:30:00-05:00,28.02,28.33,27.778,28.14,1865817,7238467.95,46.51015354286925,48.15917531585274,NaN,NaN,-109.53595203025539,-125.82678455659986,-0.06404364447538197,-0.21048512170404265,-0.1464414772286607,91820214,89941137.4,36.73009790790671,47.90170214360916,NaN,NaN,-4.594923001821693,-2.7277042832729297
2008-12-30T09:30:00-05:00,28.47,28.62,28.22,28.57001,3990709,6976226.85,49.82474122803881,48.26829578417567,NaN,NaN,-19.830286643650965,-104.53997846944704,-0.02583163355608256,-0.17873101917376388,-0.15289938561768132,95810923,90853500.2,38.56350109614543,47.18570902254464,NaN,NaN,-4.068038717792789,-2.919180631061481
2008-12-31T09:30:00-05:00,28.67999,29.21001,28.61,29.03,4280945,6637244,53.16789503993439,48.46993943763461,NaN,NaN,79.83522293131897,-59.79525231772503,0.030222493206467388,-0.11512126910959708,-0.14534376231606447,100091868,93309049.6,43.32373033308396,46.716718551184286,NaN,NaN,-2.733334095064645,-2.8926311259190762
2009-01-02T09:30:00-05:00,29.34,29.92999,29.00999,29.71001,5375410,6414181.1,57.65924529238726,49.072608288038,NaN,NaN,189.51501847500944,8.11093028659738,0.1084935417881592,-0.00972683508086547,-0.11822037686902467,105467278,96628936,49.069385481796665,46.48038560212421,NaN,NaN,-0.2871358495451584,-2.5204175150085164
2009-01-05T09:30:00-05:00,29.74001,30.13,29.61,30.13,6810984,6184248.65,60.198141414039945,49.7897014973902,NaN,NaN,217.9926375867754,71.5953280638395,0.179745481175768,0.10646147460068534,-0.07328400657508266,112278262,101093709,55.58988725474918,46.6172606262769,NaN,NaN,2.5616287410602734,-1.7944109069986895
2009-01-06T09:30:00-05:00,30.13,30.47,29.58,29.7,9581418,6066846.3,56.464956322135265,50.40970660944661,NaN,NaN,180.40111102506745,129.58274067490407,0.18820878212357556,0.1619769710793868,-0.026231811044188764,102696844,103269035,58.38537587192734,47.138634462971815,NaN,NaN,4.040289660593024,-0.9608822544855876
2009-01-07T09:30:00-05:00,29.46001,29.55,29.11,29.46001,4880445,5901264.65,54.435912977156605,50.51556942876459,NaN,NaN,87.7800055340261,151.1047991104395,0.16857074911156747,0.18448162534527057,0.015910876233703103,97816399,103670130.2,58.89910586259021,47.57355660406471,NaN,NaN,4.7554326186559095,-0.14426584403680232
2009-01-08T09:30:00-05:00,29.14999,29.39,29.05,29.31,8393676,5872607.8,53.150243494760744,50.86661341057781,NaN,NaN,62.51560966220399,147.64087645661647,0.13770690908238603,0.18804451258668564,0.05033760350429961,89422723,101536301.2,55.00851388069099,47.90276593004506,NaN,NaN,5.022026592278842,0.5937759325797183
2009-01-09T09:30:00-05:00,29.5,29.5,28.96001,29.08,4481191,5809339.2,51.15531693597186,50.981902998828346,NaN,NaN,48.261333605447895,119.39013948270417,0.09600624735945198,0.17034541270361458,0.0743391653441626,84941532,97431152,48.386565399159196,47.60383203688916,NaN,NaN,4.725581381860229,1.1840338539055053
2009-01-12T09:30:00-05:00,29.14999,29.36,29,29.09,4682742,5724435.1,51.241007543907834,51.17780658276089,NaN,NaN,41.23888495177115,84.03938895570333,0.06479671499603293,0.15533505908920375,0.09053834409317082,89624274,92900354.4,42.32990066540716,47.02461438104454,NaN,NaN,4.49716286534148,1.6573379983963588
2009-01-13T09:30:00-05:00,29.19,29.21001,28.34979,28.53999,7800992,5768955,46.4176008000877,51.17943767417135,NaN,NaN,-20.903635259867094,43.778439698716426,0.005912659790966418,0.09792916883187885,0.09201650904091244,81823282,88725642,37.65312682605084,46.251884350011785,NaN,NaN,2.992380769479626,1.848058394265397
2009-01-14T09:30:00-05:00,28.2,28.32001,27.55,28.19,6545738,5755222.55,43.60479220593645,51.10648355421819,NaN,NaN,-105.363987928232,5.1496410062647895,-0.05447911774236529,0.023917611862955823,0.07839672960532111,75277544,84217871,33.36637700246605,45.5174845956211,NaN,NaN,0.8957348400361621,1.7120121722326491
2009-01-15T09:30:00-05:00,28.23,28.41,27.75999,28.34,7933254,5790033.5,45.13919703838336,51.072684303343465,NaN,NaN,-77.58482372553911,-22.87044567128383,-0.08061770698911731,-0.022375404131075527,0.058242302858041786,83210798,82975486,32.27573487646703,44.83148657321281,NaN,NaN,-0.49402315382637035,1.3968642685099322
2009-01-16T09:30:00-05:00,28.71001,29.14999,28.5,28.89999,6029043,5622481.35,50.54860796230378,51.394129414136685,NaN,NaN,8.708801865281867,-30.780952019317027,-0.05756848532196922,-0.01371830379441974,0.04385018152754948,89239841,83835147.8,33.88609185169483,44.533385307866844,NaN,NaN,-0.26577195393325237,1.159344808160906
2009-01-20T09:30:00-05:00,28.89999,29.12,28.37,28.39999,5973184,5425649.75,46.17104930088344,51.36990768256628,NaN,NaN,-17.567739090659146,-42.542276827803086,-0.0724124502341966,-0.04666538126519626,0.02574706896900033,83266657,82563624.4,32.64947414709874,44.24191218209484,NaN,NaN,-1.3206477846526914,0.8050601520446776
2009-01-21T09:30:00-05:00,28.94,28.94,28.05,28.72,6050914,5328654.25,49.20311155282198,51.325505562907935,NaN,NaN,-24.358667155131812,-43.23328320685603,-0.05773282008343307,-0.04641895613529101,0.011313863948142058,89317571,84062482.2,35.63147847200193,44.03248199465602,NaN,NaN,-1.3607402688447183,0.49566009191762106
2009-01-22T09:30:00-05:00,28.55,28.94,28.39999,28.71001,6774895,5351331.05,49.11011223818079,51.03566393421124,NaN,NaN,-13.350167673768413,-24.830519155963312,-0.04624614726841917,-0.0464938201373819,-0.00024767286896273423,82542676,85515508.6,38.47537636740959,43.68617099710786,NaN,NaN,-1.4191529402956629,0.2221153730300091
2009-01-23T09:30:00-05:00,28.22,28.89,28.06,28.77,7678383,5563500.8,49.7246384887654,50.46890630538111,NaN,NaN,-32.44362690465319,-15.80227979178614,-0.032791544185163994,-0.04123710310041773,-0.008445558915253733,90221059,86917560.8,41.17603755523174,43.122360430924644,NaN,NaN,-1.3060004752094316,0.0038131089958032827
2009-01-26T09:30:00-05:00,28.88,29.72,28.827,29.46001,6168094,5819219.25,56.266277798045905,50.18805890423868,NaN,NaN,64.07124028269868,-4.729792108302777,0.02147235005942752,0.018394878659030667,-0.003077471400396853,96389153,88347423.2,43.881502543704414,42.286047237278595,NaN,NaN,0.6748005615660145,0.09966845936297632
2009-01-27T09:30:00-05:00,29.53999,29.82001,29.27,29.60001,4958699,6012826.65,57.475288384439935,50.26022548011758,NaN,NaN,86.4732416719574,16.07840404422053,0.06332082128791232,0.07607355520949355,0.012752733921581227,101347852,91963662.2,50.128708456738494,41.69628527905082,NaN,NaN,2.6804486354572656,0.46835134166216047
2009-01-28T09:30:00-05:00,29.96001,30,28.89,29.78999,7079297,6273500.65,59.12656317028743,50.59527192248408,NaN,NaN,77.72040483657598,36.49421844256209,0.09823906576090374,0.1355515661227109,0.037312500361807166,108427149,95785577.8,55.73698509975623,41.47041951027696,NaN,NaN,4.854258279416214,1.0949094756270252
2009-01-29T09:30:00-05:00,29.62,30.17999,29.42999,29.57001,8182520,6483091.2,56.395795832191254,50.8270970894434,NaN,NaN,92.47907001457212,57.66006598023019,0.10059651012813897,0.16305813802198088,0.06246162789384191,100244629,99325968.4,60.20174041726756,41.84136426288957,NaN,NaN,5.987896091966066,1.7939075636754596
2009-01-30T09:30:00-05:00,29.66,29.81,28.744,28.98,8119320,6675009.95,49.75797373167077,50.727286860564746,NaN,NaN,11.8174464906615,66.51228065929313,0.058578164729775575,0.13568433380606137,0.0771061690762858,92125309,99706818.4,60.661427951835364,42.7181401595093,NaN,NaN,5.095350095548212,2.2655422110858527
2009-02-02T09:30:00-05:00,28.64999,29.24001,28.42,29.14,7307727,6771625.8,51.427579434184345,50.740613424155924,NaN,NaN,-19.813444101064036,49.73534378254059,0.03867897965937048,0.1254548936504989,0.08677591399112841,99433036,100315595,61.428357471011346,44.08231564562389,NaN,NaN,4.818402936019142,2.630236600362037
2009-02-03T09:30:00-05:00,29.03999,29.47,28.88,29.27,6674148,6764784,52.800029503064295,51.19650118865426,NaN,NaN,28.78062006548681,38.19681946124648,0.03168411679329279,0.1263810599827444,0.09469694318945161,106107184,101267461.4,62.65432756386874,45.86811569832516,NaN,NaN,4.964746686811996,2.9637380412834595
2009-02-04T09:30:00-05:00,29.57001,29.83,29.23,29.49001,8083547,6689890.45,55.11168879572828,52.01842237363939,NaN,NaN,85.83656152405602,39.820050798742486,0.038816128765545826,0.1432171041463839,0.10440097538083806,114190731,102420177.8,64.14075608374877,48.0662856327025,NaN,NaN,5.7296499864119745,3.3588683191589617
2009-02-05T09:30:00-05:00,29.39999,29.87,29.21001,29.7,8261035,6858919.95,57.26311209576272,52.88441630630934,NaN,NaN,94.55692491586233,40.23562177900053,0.05370079755013488,0.17152697231850667,0.11782617476837179,122451766,106861605.2,69.22359566974632,50.70541854650816,NaN,NaN,6.983798501956029,3.876715488129971
2009-02-06T09:30:00-05:00,29.7,30.21899,29.45,29.89,7881387,6833305.5,59.169943319427965,53.50022597467535,NaN,NaN,124.05600330677913,62.68333314222404,0.07126629241745056,0.20690904029018498,0.13564274787273442,130333153,114503174,75.62522512151715,53.686785208638334,NaN,NaN,8.5889312002509,4.549889161290103
2009-02-09T09:30:00-05:00,29.97,30.05,29.42,29.724,7296480,6974069.95,56.78603221842461,54.25843904021401,NaN,NaN,95.5213873994656,85.75029944232998,0.06670974625544573,0.21902993069204157,0.15232018443659584,123036673,119223901.4,78.58825358164607,56.968126596820284,NaN,NaN,9.324569308693595,5.231986325204888
2009-02-10T09:30:00-05:00,29.64999,29.73,28.67,28.88,9563770,7218121.35,46.52300068679706,54.06700254978365,NaN,NaN,2.780956460696079,80.55036672137183,0.005105973956475968,0.1587026518821908,0.15359667792571483,113472903,120697045.2,79.42864017097489,60.09649528960406,NaN,NaN,6.874500588796904,5.466631220003747
2009-02-11T09:30:00-05:00,29.11,29.11,28.52,28.78999,8869871,7271565.3,45.57695428787651,53.814634124761916,NaN,NaN,-40.626850855634466,55.25768424543372,-0.04091828016299731,0.10244882772196817,0.14336710788496548,104603032,118779505.4,75.28647047245249,62.72585915424998,NaN,NaN,4.591892442087285,5.341668537444253
2009-02-12T09:30:00-05:00,28.25999,28.57001,27.78999,28.53999,11907980,7539677.4,42.963707643374626,53.33171049294829,NaN,NaN,-122.2822410610874,11.889851050043784,-0.08488185365734684,0.037264790813281934,0.12214664447062877,92695052,112828162.6,64.11159692110837,64.36411339466974,NaN,NaN,1.8676886644813084,4.8453856984495465
2009-02-13T09:30:00-05:00,28.33,28.71001,28.28999,28.37,6889457,7487487.55,41.23252426573284,52.25787095492593,NaN,NaN,-103.79192316569319,-33.67973424445067,-0.11994967509258177,-0.02779044939509845,0.09215922569748332,85805595,103922651,51.736437755427936,64.92518019550714,NaN,NaN,-0.932081448429027,4.020033248895465
2009-02-17T09:30:00-05:00,27.99001,27.99001,27.02,27.14,9309660,7651518.4,31.379772650869114,50.39390554538516,NaN,NaN,-221.2509853111357,-97.03420878657093,-0.21497747058055894,-0.17656261252821537,0.038414858052343584,76495935,94614503.4,42.501961947015474,64.38041258766978,NaN,NaN,-7.214632640576752,2.4150809789708627
2009-02-18T09:30:00-05:00,27.07001,27.19,26.53,26.73,8623742,7784046.3,28.90069922438215,48.23491526353479,NaN,NaN,-237.43560361981835,-145.07752080267383,-0.28978504065019184,-0.32381644276039623,-0.034031402110204376,67872193,85494361.4,35.76587607304734,62.953904800047724,NaN,NaN,-13.250639512527194,0.1771209087568546
2009-02-19T09:30:00-05:00,26.92,27.16,26.71001,26.84801,7819520,7872476.6,30.60018505024499,46.39237163625291,NaN,NaN,-187.22203009181575,-174.39655664991008,-0.3136405853242742,-0.42608213376554716,-0.11244154844127294,75691713,79712097.6,32.27346601483504,60.95902805701683,NaN,NaN,-17.470548149617095,-2.3439746710108524
2009-02-20T09:30:00-05:00,26.57001,26.7,25.75999,26.24001,11346258,8101044.75,27.017076087750155,44.76802180454429,NaN,NaN,-196.4910238549525,-189.23831320868308,-0.34992725228529653,-0.5498506137978936,-0.19992336151259707,64345455,74042178.2,29.25667643749921,58.715831520278535,NaN,NaN,-22.353469550427015,-5.2024739394988755
2009-02-23T09:30:00-05:00,26.38,26.53,25.45,25.61,5783504,8006300.8,23.89482157830335,42.80139624340994,NaN,NaN,-177.99471993452622,-204.0788725624497,-0.39271037061160907,-0.6908113247771084,-0.2981009541654993,58561951,68593449.4,26.67605660502379,56.23352431556514,NaN,NaN,-27.627725516483487,-8.406081307639534
2009-02-24T09:30:00-05:00,25.62,26.55,25.62,26.35001,7726012,8084196.7,33.60135201912506,41.43006213741427,NaN,NaN,-132.398671544849,-186.30840980919237,-0.3489960348828497,-0.7343459977690614,-0.3853499628862117,66287963,66551855,25.759222522221577,53.5981596697332,NaN,NaN,-28.707276244711633,-11.306252012935548
2009-02-25T09:30:00-05:00,26.24001,26.47,26.0101,26.17999,6559078,8164215.65,32.57342944397523,39.82018646943192,NaN,NaN,-111.09561633536799,-161.0404123523023,-0.310638904445791,-0.7736485934434505,-0.4630096889976595,59728885,64923193.4,25.020450700464977,50.80385214235579,NaN,NaN,-29.89073120397906,-13.96117761165605
2009-02-26T09:30:00-05:00,26.28999,26.5,25.64,25.75,6724238,8146462.7,30.0681648464964,37.87769023734146,NaN,NaN,-107.6143530732699,-145.1188769485931,-0.2935329798225772,-0.829925913775881,-0.5363929339533038,53004647,60385780.2,23.038075208947873,47.50488639515589,NaN,NaN,-31.696275308910334,-16.49476299697809
2009-02-27T09:30:00-05:00,25.55,25.78,24.92,25.35001,9145395,8194606.45,27.917181039970345,35.64535007452306,NaN,NaN,-120.4168918805122,-129.90405055370508,-0.28806006918299654,-0.8964680204320494,-0.6084079512490529,43859252,56288539.6,21.39002688285221,43.630943663822684,NaN,NaN,-33.89072149222601,-18.979899924870647
2009-03-02T09:30:00-05:00,25.03,25.36,24.38,24.55,11494652,8363373.05,24.18987682518828,33.31705326072046,NaN,NaN,-129.44416137182088,-120.19393884116398,-0.3150372000728223,-1.0022044513400807,-0.6871672512672584,32364600,51049069.4,19.471757909020894,39.40833683006374,NaN,NaN,-37.090349700168865,-21.567107035627537
2009-03-03T09:30:00-05:00,24.64,24.92,23.50999,23.67,6113391,8303656.25,20.88648180760518,31.48587334077818,NaN,NaN,-142.25882648926387,-122.16596983004698,-0.365325943976998,-1.143824681238506,-0.778498737261508,26251209,43041718.6,16.967383726889807,34.9468185126291,NaN,NaN,-41.035808942211006,-24.34835016513946
2009-03-04T09:30:00-05:00,23.82001,24.24001,23.56,23.89,5701113,8255004.5,23.69205312679199,29.922666114986434,NaN,NaN,-132.11350332649073,-126.36954722827151,-0.3565576543203205,-1.2241958051619086,-0.8676381508415881,31952322,37486406,15.479855270502071,30.674917426775497,NaN,NaN,-43.156338197643635,-27.03520559835434
2009-03-05T09:30:00-05:00,23.61,23.86,22.8,23.21001,11321492,8416901.75,21.19067197836175,28.36744928177123,NaN,NaN,-142.45367904851958,-133.33741242332144,-0.36785580062614354,-1.3274579016242676,-0.959602100998124,20630830,31011642.6,13.945313332044975,27.09161145612811,NaN,NaN,-45.80047924272998,-29.715958976122288
2009-03-06T09:30:00-05:00,23.24001,23.85001,22.64,23.17999,9966391,8502169.55,21.08483432239457,26.92832857153278,NaN,NaN,-131.62543917847353,-135.5791218829137,-0.34882094801236985,-1.3956282860135865,-1.0468073380012166,10664439,24372680,12.56941046045749,24.293966649344508,NaN,NaN,-47.87489004712916,-32.31009198626613
2009-03-09T09:30:00-04:00,22.94,23.2,22.48,22.74001,10118496,8614025,19.54413178714961,26.08292565269568,NaN,NaN,-137.37851179856258,-137.16599196826206,-0.3371394537101984,-1.4682316551389647,-1.1310922014287663,545943,18008948.6,11.407564055786835,22.072938228542466,NaN,NaN,-50.099373680048956,-34.85141794252082
2009-03-10T09:30:00-04:00,22.83,23.42,22.77,23.03999,8585746,8678488.3,23.64100798162049,25.707233421069848,NaN,NaN,-113.26466372007512,-131.3671594144243,-0.2826883376437688,-1.4844526234834774,-1.2017642858397086,9131689,14585044.6,10.827651513800916,20.291636474310575,NaN,NaN,-50.65853056281432,-37.10957688827703
2009-03-11T09:30:00-04:00,23.3,23.35001,22.96001,23,9392672,8669933.4,23.46943788771165,25.19789433803175,NaN,NaN,-99.65167000373687,-124.87479274987354,-0.2253362559858001,-1.4834346058219587,-1.2580983498361586,-260983,8142383.6,9.816418932168332,18.687561682691527,NaN,NaN,-51.15623015643857,-39.116241640871536
2009-03-12T09:30:00-04:00,23.03999,23.45,22.82001,23.3,6516352,8552257.45,27.708016792725786,25.247247245530012,NaN,NaN,-86.53709672452979,-113.6914762850756,-0.1469614417568308,-1.4418001520321972,-1.2948387102753665,6255369,5267291.4,9.39474852478834,17.268852546069322,NaN,NaN,-50.34064397662553,-40.71972768883639
2009-03-13T09:30:00-04:00,23.5,23.78999,23.42999,23.62,7156934,8314705.15,32.0321803697546,25.8284871592051,NaN,NaN,-61.67658089458578,-99.70170462829805,-0.05790721517113395,-1.367222729239284,-1.30931551406815,13412303,5816864.2,10.188908781584246,16.091199130109352,NaN,NaN,-48.378382662645166,-41.81382125652336
2009-03-16T09:30:00-04:00,23.88,24.7,23.78,24.25999,8983730,8419418.8,39.789190118858684,26.270475594900354,NaN,NaN,-27.41668916375263,-77.70934010133604,0.053725286974222186,-1.2421589053503723,-1.2958841923245945,22396033,10186882.2,16.45931249543844,15.426919842481983,NaN,NaN,-44.22874972859891,-42.15881103824844
2009-03-17T09:30:00-04:00,24.33,24.74001,24.0675,24.64,6313855,8269628.55,43.884443642755905,27.07840518052755,NaN,NaN,-9.740408198958434,-57.00448899711271,0.15694368756422672,-1.099704582869311,-1.2566482704335378,28709888,14102522,21.732249397169625,15.192048320818028,NaN,NaN,-39.44166018629215,-41.77064663082611
2009-03-18T09:30:00-04:00,24.64,25.60001,24.34,25.44,8897887,8283335.8,51.381451378004925,28.60078278992102,NaN,NaN,32.090213338696216,-30.65611232862609,0.2759224874046997,-0.911745161177663,-1.1876676485823627,37607775,21676273.6,30.82687697364628,15.748391304010775,NaN,NaN,-32.67289321934534,-40.47096757204314
2009-03-19T09:30:00-04:00,25.71001,25.87939,25.36,25.81,8747738,8329746.7,54.41481731714569,30.49347109543354,NaN,NaN,72.49689569418621,1.1506861551171113,0.3704720562711432,-0.7245775782434336,-1.0950496345145768,46355513,29696302.4,38.92056782490603,17.000572799871758,NaN,NaN,-26.082874151749564,-38.41552565485835
2009-03-20T09:30:00-04:00,25.57001,25.935,25.25999,25.35001,7856699,8155268.75,50.21984112829771,32.35275425994136,NaN,NaN,66.72685617433847,26.831373568901967,0.39094100825312206,-0.6063733741981743,-0.9973143824512963,38498814,34713604.6,43.383604544134684,18.70856184523703,NaN,NaN,-21.838004597974397,-36.047308361017784
2009-03-23T09:30:00-04:00,25.84,26.39,25.61,26.33,7055742,8218880.65,57.70146085368844,34.982395620375875,NaN,NaN,102.99124748789177,52.912960899230846,0.45490977437284497,-0.42867716448524007,-0.883586938858085,45554556,39345309.2,47.21783280244753,20.869308207776864,NaN,NaN,-15.44768292678477,-33.10450472755593
2009-03-24T09:30:00-04:00,26.2,26.33,25.75999,25.75999,6445004,8154830.25,52.736705408464296,37.05701364049533,NaN,NaN,94.6170183986567,73.78444621875387,0.44283582252732945,-0.3300421606989232,-0.7728779832262527,39109552,41425242,48.89169745504697,23.255868363815786,NaN,NaN,-11.81935408352853,-30.0637689212663
2009-03-25T09:30:00-04:00,25.92,26.23,25.35001,25.75,7075602,8180656.45,52.65120129005063,39.304194305615965,NaN,NaN,86.73233215692748,84.71286998240014,0.41846256043561214,-0.24979978268173753,-0.6682623431173497,32033950,40310477,48.012858323684036,25.68926443464715,NaN,NaN,-9.037728783660818,-27.060048901608372
2009-03-26T09:30:00-04:00,25.92,26.13,25.44,26.06,6961230,8192506.05,55.08479627414104,41.732763016455,NaN,NaN,94.00749893734302,89.0149906310315,0.4071252690560766,-0.1593557567972539,-0.5664810258533305,38995180,38838410.4,46.81612186240224,28.135458106214628,NaN,NaN,-5.9851780281358,-24.049353062540863
2009-03-27T09:30:00-04:00,25.92999,25.94,25.62,25.8,7694930,8119982.8,52.64102792691148,44.09682702643799,NaN,NaN,84.77220517832743,92.62406043182929,0.3672490019010943,-0.10741977347696263,-0.4746687753780569,31300250,37398697.6,45.618512528726605,30.579097282853184,NaN,NaN,-4.186577305931694,-21.211813668739552
2009-03-30T09:30:00-04:00,25.36,25.4825,24.97,25.28999,8899137,7990207.05,48.13039258059505,45.8460687835076,NaN,NaN,47.09561234273555,81.44493340279804,0.29478334854534916,-0.10618958969637049,-0.40097293824171965,22401113,32768009,41.90535278958098,32.79893308826605,NaN,NaN,-4.008490062070055,-18.75419601064391
2009-03-31T09:30:00-04:00,25.36,26.03,25.25,25.55,7701652,8069620.1,50.46093599411403,47.77403293396491,NaN,NaN,63.097563797367826,75.14104248254026,0.25415907518601655,-0.08327409425919896,-0.3374331694452155,30102765,30966651.6,40.52354099750942,34.99229895007612,NaN,NaN,-3.1697976760665227,-16.527853391418567
2009-04-01T09:30:00-04:00,25.22,25.89999,24.97,25.64999,5540480,8061588.45,51.36591025802659,49.46388246720068,NaN,NaN,51.63661298547939,68.12189864825065,0.2248305709687795,-0.05639495573424114,-0.28122552670302065,35643245,31688510.6,41.35803852178976,37.27539109271908,NaN,NaN,-2.2249581377893946,-14.484582640900115
2009-04-02T09:30:00-04:00,26.17999,26.33,25.59,25.98,9312375,7961132.6,54.33117507236972,51.05666780310177,NaN,NaN,73.579387381655,64.03627633711304,0.2182863893500658,-0.00836754001543838,-0.2266539293655042,44955620,32880598.6,42.78569974253293,39.60373330421542,NaN,NaN,-0.5667403244378694,-12.49631945283408
2009-04-03T09:30:00-04:00,26.17,26.27,25.89999,26.14999,5210074,7723316.75,55.82526787694245,52.20210192867918,NaN,NaN,77.41849392529762,62.56553408650709,0.21565641514440004,0.04291658956499589,-0.17273982557940415,50165694,36653687.4,47.16972399443447,41.79733412557227,NaN,NaN,1.243481710927431,-10.533490715153864
2009-04-06T09:30:00-04:00,25.92999,26.31,25.73,25.92999,5510715,7492927.7,53.390777980417305,52.88112580994071,NaN,NaN,66.97191724013229,66.54079506598643,0.19023788260295066,0.06505752767428419,-0.12518035492866647,44654979,41104460.6,51.85605688916003,43.949034660714446,NaN,NaN,2.1172895016087034,-8.726236398473498
2009-04-07T09:30:00-04:00,25.74001,26.02,25.41,25.81,4548676,7291074.2,52.05735985195296,52.92940498665128,NaN,NaN,45.003720684511315,62.922026443415135,0.1578172186051121,0.07209116832772366,-0.08572605027738844,40106303,43105168.2,53.838334897180125,45.59271022668115,NaN,NaN,2.494660495871997,-7.123251127852713
2009-04-08T09:30:00-04:00,25.87,26.14,25.67,26.06,4475281,7045204.65,54.6013902614876,52.942731625532836,NaN,NaN,61.228452114214484,64.84039426916215,0.14595949911516595,0.09672332361656899,-0.049236175498596955,44581584,44892836,55.597545222218336,46.78392289791775,NaN,NaN,3.505142662643069,-5.604909157781887
2009-04-09T09:30:00-04:00,26.53999,26.95,25.81,26.07001,6163738,7027573.95,54.7050306599385,53.263102306364324,NaN,NaN,100.47066139585634,70.21864907200242,0.13196356375929197,0.11571827920051803,-0.016245284558773956,50745322,46050776.4,56.747373168875285,47.73847779968493,NaN,NaN,4.375396039652822,-4.179151272434072
2009-04-13T09:30:00-04:00,26.00999,26.06,25.59,25.73,4574063,6898430.4,50.48880445117943,52.74791256332797,NaN,NaN,27.815649774858144,60.29808024191453,0.09472289583657095,0.10215833523693973,0.007435439400368782,46171259,45251889.4,55.676152542665875,48.342643495414805,NaN,NaN,4.029528425215916,-3.006482744198359
2009-04-14T09:30:00-04:00,25.52,25.75999,25.285,25.39999,6403422,6769415,46.72468727527633,52.31848269667169,NaN,NaN,-49.347452357784064,37.03420632233126,0.045287381214139666,0.06404466591804336,0.0187572847039037,39767837,44274461,54.32496114756373,48.73073375916601,NaN,NaN,2.683748965545885,-2.1935924999491814
2009-04-15T09:30:00-04:00,25.27,25.75999,25.27,25.64,4925715,6700008,49.66392245884842,52.1051056373001,NaN,NaN,-56.84698092387582,16.66406600065384,0.027073989925456666,0.05259977211072453,0.025525782185267864,44693552,45191910.8,55.41862326894601,49.25971696954186,NaN,NaN,2.309547573098137,-1.5502867752281357
2009-04-16T09:30:00-04:00,25.74001,25.98,25.57001,25.82001,20328176,7271522.45,51.811286329596605,51.87128349840407,NaN,NaN,1.2433491655664801,4.667045410924238,0.02549402980827281,0.05739331944560888,0.03189928963733607,65021728,49279939.6,60.01312130526247,50.20235978688902,NaN,NaN,2.566827970005263,-0.9621275259090787
2009-04-17T09:30:00-04:00,25.88,25.964,25.63,25.78,6824512,7175361.15,51.287571334623905,51.77460802752638,NaN,NaN,-0.15450538854875648,-15.457987945956782,0.020323137782370847,0.05730321186529963,0.036980074082928784,58197216,50770318.4,61.56816678865495,51.34162080545533,NaN,NaN,2.6449132239206112,-0.446835990219123
2009-04-20T09:30:00-04:00,25.52,25.78999,25.47,25.49001,4977496,7031401,47.536966953737355,51.73222048275083,NaN,NaN,-75.45593168867819,-36.112304238664066,-0.00282687423460775,0.033446481289669094,0.036273355524276844,53219720,52180010.6,63.03255862671728,52.85070693667935,NaN,NaN,1.700872595754236,-0.14002047793721456
2009-04-21T09:30:00-04:00,25.49001,25.75,25.42999,25.584,3790296,6868128.7,48.84277520971154,51.61663756957922,NaN,NaN,-65.89132196831278,-39.42107816076981,-0.011521138894139457,0.021871931906602526,0.033393070800741984,57010016,55628446.4,66.40485157613105,54.69937197800947,NaN,NaN,1.2366187141007483,0.0566422637824944
2009-04-22T09:30:00-04:00,25.49001,25.62,25.1899,25.31,6268348,6859295.9,45.30276646117446,51.18355586980407,NaN,NaN,-123.8709475607283,-52.82587148814031,-0.03415705654658193,-0.009303249882485431,0.0248538066640965,50741668,56838069.6,67.5239835418539,56.56836805087119,NaN,NaN,-0.13933035116187398,0.02864617593329892
2009-04-23T09:30:00-04:00,25.39,25.42,25.14,25.39999,6490109,6830021.25,46.669881080637374,50.636320584680334,NaN,NaN,-120.9988906605097,-77.27431945335555,-0.041037877698734945,-0.02644354045932218,0.014594337239412763,57231777,55280079.4,64.54172952210625,58.12237017798357,NaN,NaN,-0.9542876015707593,-0.11177293513870938
2009-04-24T09:30:00-04:00,25.46001,25.59,25.13,25.36,5720063,6767962.9,46.11824310476393,49.94296167238186,NaN,NaN,-96.58381806514846,-96.56018198867548,-0.04588449189526832,-0.042761277629672634,0.0031232142655956818,51511714,53942979,62.010476123070895,59.1824239014576,NaN,NaN,-1.7879326958089952,-0.3512243295201788
2009-04-27T09:30:00-04:00,25.02,25.77,25.00999,25.53999,5656234,6666028.1,49.03799293529646,49.632048454873235,NaN,NaN,-66.46555395016723,-94.7621064409733,-0.03505884733120562,-0.040700344898411345,-0.005641497567205724,57167948,54732624.6,62.93498708498249,59.973776058302064,NaN,NaN,-1.7753460040399782,-0.5546702830230072
2009-04-28T09:30:00-04:00,25.32001,25.8602,25.31,25.64,4540910,6448116.75,50.63855133325722,49.53070498925211,NaN,NaN,-26.9919168774523,-86.9822254228012,-0.02000186332208087,-0.03064382671980681,-0.010641963397725942,61708858,55672393,64.05609338449787,60.70361595025333,NaN,NaN,-1.355127058656517,-0.6690212509706515
2009-04-29T09:30:00-04:00,25.71001,25.97,25.67,25.83,6688484,6397458.35,53.61886019969645,49.46052427055273,NaN,NaN,36.31662500308914,-54.94471091003771,0.0027064701537215206,-0.007258875705574042,-0.009965345859295562,68397342,59203527.8,67.97568346203741,61.58776868166898,NaN,NaN,-0.2036468109093523,-0.6025391881047516
2009-04-30T09:30:00-04:00,25.91,26.2,25.56,25.85001,8539090,6547388.85,53.93430918682716,49.405472736759066,NaN,NaN,45.56853304337818,-21.631226169260138,0.01816557961411391,0.012741628658346826,-0.005423950955767085,76936432,63144458.8,71.68656545748377,62.65485384514101,NaN,NaN,0.8532277412718751,-0.39457248390809063
2009-05-01T09:30:00-04:00,26.14999,26.53,25.7,26.53,3491821,6256361.15,63.11503837584802,50.307346588521106,NaN,NaN,149.48877916649477,27.583293277068503,0.07034760257549601,0.08251055226360293,0.012162949688106921,80428253,68927766.6,76.06904130104043,64.11148875645348,NaN,NaN,4.64567121448019,0.325462330147378
2009-05-04T09:30:00-04:00,26.60001,26.96001,26.42,26.92999,7614863,6376600.6,67.24975231834941,51.77342266302633,NaN,NaN,253.8145496779508,91.63931400269212,0.12478208612282692,0.16814055734164057,0.04335847121881366,88043116,75102800.2,79.68477413592561,65.92290396990789,NaN,NaN,9.331695374044047,1.612067050704045
2009-05-05T09:30:00-04:00,26.88,26.95,26.565,26.88,3852881,6293708.9,66.25020797698372,52.95815734289313,NaN,NaN,213.71733818504444,139.78116501519148,0.148773746771979,0.2293256546837874,0.08055190791180841,84190235,79599075.6,81.83670863523407,67.8099100674999,NaN,NaN,12.841133106563326,3.216219344398228
2009-05-06T09:30:00-04:00,27.14999,27.14999,26.59,26.72,4853305,6308940.35,63.02155039464388,53.7588904903965,NaN,NaN,172.16807158448998,166.95145433147164,0.14506708664916296,0.2618857662232621,0.11681867957409915,79336930,81786993.2,82.7919263961236,69.43696757398999,NaN,NaN,14.878937091676436,4.882321879723686
2009-05-07T09:30:00-04:00,26.73,27.03999,26.67,26.86,6903031,6430327.85,64.64514120850762,54.71300262424533,NaN,NaN,146.1360768608372,187.06496309496342,0.14300862683149618,0.2955794631134694,0.1525708362819732,86239961,83647699,83.5826806177408,71.00943284749611,NaN,NaN,17.069543390002924,6.623353524049291
2009-05-08T09:30:00-04:00,26.98,27.82001,26.89999,27.25,8105734,6527427.65,68.76004379103988,56.22893668405264,NaN,NaN,179.5472314001642,193.07665354169734,0.1577196052654309,0.34972034286376186,0.19200073759833094,94345695,86431187.4,84.71427721073034,72.55812703206848,NaN,NaN,20.29688505671831,8.576715171573436
2009-05-11T09:30:00-04:00,27.02,27.39,26.98,27.13,3901700,6493809.5,66.20667497113328,57.46921523843991,NaN,NaN,131.07484932582,168.52871347127115,0.14926368548841545,0.37858034445885025,0.2293166589704348,90443995,86911363.2,84.90753855476166,73.87974753054209,NaN,NaN,22.229334656887843,10.527089383761208
2009-05-12T09:30:00-04:00,27.3,27.5,27.07001,27.32001,4505199,6398898.35,68.21911648634233,59.106097383094756,NaN,NaN,123.98333319994826,150.58191247425194,0.14617438784557757,0.41203464377740673,0.26586025593182916,94949194,89063155,85.7754628077576,75.18342462096379,NaN,NaN,24.468663481243887,12.518742826258734
2009-05-13T09:30:00-04:00,27.06,27.2,26.5607,26.59,7408652,6523045.2,54.73320619348255,59.682049176869405,NaN,NaN,62.38883335342973,128.62606482803986,0.08756404301148946,0.375315309696191,0.2877512666847015,87540542,90703877.4,86.41688032843703,76.74593539284456,NaN,NaN,22.109371392578307,13.888832621447245
2009-05-14T09:30:00-04:00,26.7,26.85001,26.25,26.57001,4503672,5731820,54.41597981183329,60.27474465594579,NaN,NaN,34.9867828138981,106.39620601865207,0.042338874041967844,0.34067485923716134,0.2983359851951935,83036870,90063259.2,84.80885559168645,78.37439106917425,NaN,NaN,20.161748202871816,14.784963418793613
2009-05-15T09:30:00-04:00,26.39999,26.42,25.66,25.94,10400742,5910631.5,45.47112252085876,60.01996819777167,NaN,NaN,-23.49084119336968,65.78859149994527,-0.03115249806142717,0.25939536261840956,0.29054786067983673,72636128,85721345.8,74.66757588990401,79.21243312666864,NaN,NaN,15.283878299038554,14.856236973114319
2009-05-18T09:30:00-04:00,26.12,26.14999,25.6474,25.94,5424113,5932962.35,45.471122520858756,59.65086613974321,NaN,NaN,-36.08630626470612,32.356360381840055,-0.0782312702910331,0.19275877281604537,0.27099004310707847,72636128,82159772.4,67.5338191798628,79.46084211205185,NaN,NaN,11.508421299409921,14.377977591156547
2009-05-19T09:30:00-04:00,25.99001,26.53,25.92,26.41,6796609,6083278,52.26070058008679,59.553854738342515,NaN,NaN,0.6399293210632404,7.687679606063064,-0.07611458269872906,0.17584681473366714,0.2519613974323962,79432737,79056481,61.97751816828624,79.03240173392678,NaN,NaN,10.389286548767537,13.808164585100974
2009-05-20T09:30:00-04:00,26.53,26.55,25.91,25.92999,7092270,6124474.1,45.965809096309044,58.984676160448366,NaN,NaN,-22.887951410537095,-9.36767734673029,-0.1037280324987849,0.12230135680891507,0.22602938930769997,72340467,76016466,57.02771135003302,77.9853407262517,NaN,NaN,7.257680665137317,12.872381167963308
2009-05-21T09:30:00-04:00,25.67999,25.78,25.52,25.62,5785043,6089220.8,42.41283224761453,57.50594715128882,NaN,NaN,-86.46253930726093,-33.65754177096211,-0.13744151740995292,0.054227492545258826,0.19166900995521174,66555424,72720176.8,52.16306335070214,76.27777087265612,NaN,NaN,3.4683952086755414,11.52895460235077
2009-05-22T09:30:00-04:00,25.56,26.06,25.56,25.83,4892488,6047842.05,45.486908089213735,55.95145827777913,NaN,NaN,-70.00665718265907,-42.96070496882,-0.13971326553522295,0.017027428036183068,0.15674069357140602,71447912,72482533.6,51.81986395536068,74.28742014547291,NaN,NaN,1.401490328557985,10.082173991808943
2009-05-26T09:30:00-04:00,25.66,26.58,25.58,26.58,7123469,6121203.8,54.772650773706744,55.131632763259354,NaN,NaN,-21.072671405159813,-39.957977996910735,-0.08737888012536693,0.04751709341469734,0.13489597354006427,78571381,73669584.2,53.466793165875096,72.26099761194727,NaN,NaN,2.8257207685125567,9.045537817052317
2009-05-27T09:30:00-04:00,26.63,26.63,25.98,26.03999,5936820,6190999.3,48.38226277459031,54.08596936182696,NaN,NaN,-31.32199559464736,-46.35036298005285,-0.08568815343264151,0.027785781749262384,0.11347393518190389,72634561,72309949,51.303612903305826,70.01183236246028,NaN,NaN,1.7091925685347775,7.997488495835525
2009-05-28T09:30:00-04:00,26.08,26.71001,26.08,26.58,6474941,6180322.15,54.143892424984266,53.335880163003864,NaN,NaN,-0.5857426569110616,-41.88992122932764,-0.0467088676691699,0.05508785059544152,0.10179671826461142,79109502,73663756,53.32840419629354,67.8508126180712,NaN,NaN,2.8918728274248435,7.268114828919714
2009-05-29T09:30:00-04:00,26.625,26.86,26.35001,26.77,5180203,6012377.8,56.00464934255497,52.42478055954065,NaN,NaN,26.467617282436777,-19.303889911388104,-0.008631555604696112,0.09100727375874129,0.0996388293634374,84289705,77210612.2,58.22880833527857,65.95899341268179,NaN,NaN,4.4564368906442695,6.866446552023222
2009-06-01T09:30:00-04:00,26.97,27.72,26.855,27.63,8817867,6278680.1,63.2698091725031,52.215004431067065,NaN,NaN,130.791108240312,20.85566317320611,0.06966184902022243,0.18671614063871544,0.11705429161849301,93107572,81542544.2,63.297517989691,64.41542051517673,NaN,NaN,8.543402118904437,7.106011633006252
2009-06-02T09:30:00-04:00,27.50999,27.73,27.28,27.3,6526215,6224247.7,59.22808865279034,51.572788157241924,NaN,NaN,121.62916633570221,49.396030721378516,0.09295585831461423,0.23324911451176078,0.14029325619714655,86581357,83144539.4,64.9894531178596,62.93070553732689,NaN,NaN,10.327186584240106,7.566179483182517
2009-06-03T09:30:00-04:00,27.22,27.35001,26.58,26.84,6337328,6348470.05,54.045378812455404,51.523657630025696,NaN,NaN,46.30791243354654,64.9220123270173,0.07204804017200978,0.2303533064121588,0.158305266240149,80244029,84666433,66.56626863520603,61.512804702096105,NaN,NaN,9.955345201933971,7.907488871575582
2009-06-04T09:30:00-04:00,27.00999,27.14,26.85001,27.09,3602932,6285951.4,56.28427385322281,51.65710720441066,NaN,NaN,58.2200085084635,76.6831625600922,0.06967772455233462,0.24540242193056727,0.17572469737823265,83846961,85613924.8,67.54626075963719,60.27976221409258,NaN,NaN,10.41616541794714,8.265871235342948
2009-06-05T09:30:00-04:00,27.42999,27.5,26.88,27.12,6163461,6248972.9,56.55778963346393,52.44901199816818,NaN,NaN,73.13985481547013,86.01761006669888,0.0648519165759748,0.25678959309820115,0.19193767652222635,90010422,86758068.2,68.73790204016905,59.856214081968645,NaN,NaN,10.860286890923774,8.636502043283066
2009-06-08T09:30:00-04:00,27.17,27.23,26.64999,26.95,6417035,6164537.95,54.47772881026407,53.09234101883999,NaN,NaN,47.48419516825482,69.35622745228743,0.04582868699002607,0.24922353525975893,0.20339484826973286,83593387,84855231.2,64.49637798500154,59.63925399662141,NaN,NaN,10.59173032044573,8.915820368592017
2009-06-09T09:30:00-04:00,27.00999,27.14,26.75999,26.88,4049599,6171932.9,53.603528836032645,53.18825732283612,NaN,NaN,48.04081133577361,54.638556452301714,0.025181331252169148,0.2348715123349443,0.20969018108277515,79543788,83447717.4,61.474635959979175,59.603333838885206,NaN,NaN,10.120035752950143,9.087851137786036
2009-06-10T09:30:00-04:00,27.08,27.36,26.94,27.3,13613113,6627328.6,57.96232370793881,54.04515122366682,NaN,NaN,88.86266345052104,63.14950665569661,0.035811635135833686,0.2544547250025673,0.2186430898667336,93156901,86030291.8,64.73902037546586,60.15414162641613,NaN,NaN,10.999406343201475,9.360930452845384
2009-06-11T09:30:00-04:00,27.39,28.16,27.3,27.83,13626035,6938197.75,62.72168833678409,55.49578380146465,NaN,NaN,147.68147649187773,81.04180025237946,0.07242723308550097,0.3091771312236098,0.23674989813810882,106782936,90617486.8,69.65705243103719,61.40371227501149,NaN,NaN,13.264794472502675,9.918625312796426
2009-06-12T09:30:00-04:00,27.67999,28.36,27.5,28.17999,11927359,7309382.1,65.49948412773861,56.92525351850214,NaN,NaN,152.1977235696428,96.85337400321399,0.11175756580946838,0.37644685539994427,0.2646892895904759,118710295,96357461.4,74.45774290029453,63.02070362822105,NaN,NaN,16.05372959592377,10.795068781814617
2009-06-15T09:30:00-04:00,27.99001,28.03999,27.37,27.61,7117043,7145197.15,57.92880354121556,57.15069300189562,NaN,NaN,101.95592218537404,107.74771940663784,0.09176198820744252,0.37939177484977904,0.2876297866423365,111593252,101957434.4,78.09841905624597,64.78010547753325,NaN,NaN,16.061369973995205,11.547397523554702
2009-06-16T09:30:00-04:00,27.71001,27.85001,27.36,27.42,6804125,7214197.75,55.620958931904504,57.66774272741806,NaN,NaN,80.66405652512059,114.27236844450722,0.05967121050739016,0.36221879977657423,0.30254758926918407,104789127,107006502.2,80.7610668102672,66.8842093280305,NaN,NaN,15.345914839409087,12.090042854391042
2009-06-17T09:30:00-04:00,27.45,27.77,27.33,27.5,9084320,7328583.3,56.408431743164556,57.829495535859515,NaN,NaN,73.66537697318236,111.2329111490395,0.03877641377517105,0.3510181064881479,0.31224169271297686,113873447,111149811.4,82.62753472655257,68.97700436590614,NaN,NaN,15.001146836957377,12.505914851900519
2009-06-18T09:30:00-04:00,27.58,28.16,27.53999,28.12,11918523,7569895.95,62.03143374281711,58.259980135878244,NaN,NaN,112.62606691942503,104.22182923454895,0.0603675399539953,0.387701117655471,0.3273335777014757,125791970,114951618.2,84.14727971990854,70.82832375052257,NaN,NaN,16.454142844432567,13.06994742226224
2009-06-19T09:30:00-04:00,27.89999,28.07001,27.41,27.47,9979941,7779640.85,54.14579575585476,57.60826489183193,NaN,NaN,70.79865608606849,87.9420157378341,0.026270154129330814,0.36017127036313923,0.3339011162338084,115812029,114371965,82.95571277687404,72.23248052103564,NaN,NaN,15.137514345871756,13.365314125635027
2009-06-22T09:30:00-04:00,27.34,27.69,27.16,27.39,10242098,8047121.35,53.24858514138462,57.1811574981601,NaN,NaN,32.022242735052174,73.95527984776973,-0.004628077464270353,0.32811601940347046,0.3327440968677408,105569931,113167300.8,80.40737666471112,73.33376077438218,NaN,NaN,13.816027791892862,13.42970179224329
2009-06-23T09:30:00-04:00,27.39,27.50999,27.03999,27.14999,8396680,8110781.9,50.54268358344553,56.93096498180224,NaN,NaN,-3.9850278025790478,57.0254629822298,-0.04210232086947374,0.28011619578089864,0.3222185166503724,97173251,111644125.6,77.17904355145349,74.0918161255427,NaN,NaN,11.8905670213669,13.209825396403804
2009-06-24T09:30:00-04:00,27.28999,27.56,27.17,27.38,5630520,8095466.9,53.00723015004795,56.69689043157547,NaN,NaN,11.408356471869372,44.574058881967204,-0.05164228126385717,0.2576656650705509,0.30930794633440806,102803771,109430190.4,72.61540796745433,74.45389806895821,NaN,NaN,11.014991552458877,12.896277704411672
2009-06-25T09:30:00-04:00,27.60001,27.95,27.13,27.84,8727570,8208098.35,57.56191238382997,56.76861348517304,NaN,NaN,61.26649673799132,34.30214484568046,-0.02837834604955375,0.2738350137724659,0.30221335982201963,111531341,106578064.6,67.1100263291397,74.33762123245613,NaN,NaN,11.645396657103072,12.717580411939014
2009-06-26T09:30:00-04:00,27.83,27.99001,27.58,27.74001,3339352,8116055.8,56.28487915745352,56.897695652829434,NaN,NaN,84.99893831263456,37.14220129099368,-0.021445672080810385,0.2754062697210067,0.29685194180181707,108191989,105054056.6,64.30456859429844,74.32392056169161,NaN,NaN,11.783400876091996,12.584126192532297
2009-06-29T09:30:00-04:00,27.89999,28.13,27.675,28.10001,4483012,7899313.05,59.747393686654874,57.3365431421596,NaN,NaN,116.50108216789371,54.03796917756199,0.00429182770734976,0.3022167264360043,0.2979248987286545,112675001,106475070.6,65.74259409621027,74.62877471427954,NaN,NaN,12.936127031760861,12.634412026707807
2009-06-30T09:30:00-04:00,28.37,28.37,27.57001,27.89,6621566,7904080.6,56.915278306261,57.2617541848969,NaN,NaN,98.07348565709208,74.44967186949621,0.004080137244808435,0.3030250702846651,0.29894493303985664,106053435,108251107.4,67.50462604584342,74.82631797644937,NaN,NaN,13.075832394479555,12.697472079246628
2009-07-01T09:30:00-04:00,27.89999,28.35001,27.85001,28.25,7764629,7975445.65,60.38209363253686,57.09464027745066,NaN,NaN,131.40266098818753,98.44853277275986,0.023982501310933158,0.3289230596785231,0.30494055836758993,113818064,110453966,69.59364783874494,74.82178907699993,NaN,NaN,14.229236484952212,12.916295565775997
2009-07-02T09:30:00-04:00,28,28.25,27.41,27.44,9472266,8268912.35,50.53008761104531,56.02539766911542,NaN,NaN,28.61425156562458,91.91808373828651,-0.01927267736812671,0.28084971165743156,0.30012238902555827,104345798,109016857.4,66.58623174068363,74.25953827988486,NaN,NaN,12.092565412542463,12.798619829599778
2009-07-06T09:30:00-04:00,27.28999,27.69971,27.13,27.60001,6640824,8292780.5,52.18961909016397,55.61545592261174,NaN,NaN,-28.714390429780693,69.17541798980345,-0.037898573922832524,0.2527491716220176,0.2906477455448501,110986622,109575784,67.18026244919332,73.47966995080967,NaN,NaN,10.88782968272943,12.525649808618299
2009-07-07T09:30:00-04:00,27.71001,27.71001,27,27.05,8574691,8400663.3,46.42460096619142,54.95857321077509,NaN,NaN,-93.74261048050258,27.126679460124194,-0.08533635246300081,0.1839773049660991,0.2693136574290999,102411931,107523170,62.767073596431665,72.19438472124999,NaN,NaN,7.965709896863178,11.874229821224711
2009-07-08T09:30:00-04:00,27.09,27.38,26.72,26.92999,8780434,8637205.05,45.25006244163733,54.16154683209457,NaN,NaN,-162.0924317309973,-24.906504017493695,-0.12070999946382838,0.11842615809931445,0.23913615756314283,93631497,105038782.4,57.81645965567112,70.4221650733299,NaN,NaN,5.255999971593788,10.928768414134579
2009-07-09T09:30:00-04:00,26.98,27.23,26.7,26.94,6336164,8273357.6,45.374204284440296,52.97174472792479,NaN,NaN,-164.29437272770468,-84.04591076067213,-0.1380950423534284,0.06651735462135733,0.20461239697478573,99967661,102268701.8,52.814522053587886,68.18411095430699,NaN,NaN,3.1217450506051523,9.813479362201804
2009-07-10T09:30:00-04:00,26.97,27.04739,26.7,26.91,6618234,7922967.55,45.04455757421799,52.32165628637932,NaN,NaN,-154.8463877075636,-120.73803861530978,-0.14553242220165802,0.02269686922271319,0.1682292914243712,93349427,100069427.6,49.17688435124254,65.77133749533331,NaN,NaN,1.2803853567976564,8.594465932858354
2009-07-13T09:30:00-04:00,26.91,27.42,26.75,27.38,6289793,7641089.25,51.04518206648393,52.16427035245784,NaN,NaN,-77.51427709596825,-130.49801594854728,-0.11410439009527251,0.025598803805280568,0.13970319390055308,99639220,97799947.2,45.68042888167537,63.29084122511647,NaN,NaN,1.3475161081486309,7.55918738647125
2009-07-14T09:30:00-04:00,27.55,27.60001,27.22,27.59,5788945,7574684.35,53.4888860830979,52.3747133881473,NaN,NaN,-8.24268000480177,-113.39802985340711,-0.0762963057058796,0.044332811768203584,0.12062911747408318,105428165,98403194,46.76392239262068,61.11833257091412,NaN,NaN,2.1095014126137115,6.780660818777316
2009-07-15T09:30:00-04:00,27.94,28.14999,27.66,28.14,7632422,7616099.2,59.229140113560064,52.81913552839816,NaN,NaN,101.07209736790696,-60.765124033626265,-0.014599389994377682,0.10237987998111109,0.11697926997548877,113060587,102289012,53.23482231823684,59.734005024541446,NaN,NaN,4.563025099791526,6.46385571606506
2009-07-16T09:30:00-04:00,28.09,28.28,27.75,28.14999,4377980,7380782.2,59.32732949902572,52.945236750912144,NaN,NaN,103.19038014305302,-7.268173459474721,0.0244074264401114,0.14748855302562802,0.12308112658551662,117438567,105783193.2,58.15975707619197,59.09470007790232,NaN,NaN,6.564286420514602,6.478202959557852
2009-07-17T09:30:00-04:00,28.28999,28.28999,27.77,28.02,3797987,6974755.4,57.39053267010182,53.0242120018156,NaN,NaN,94.27901298408973,42.556906678855945,0.038158900411668834,0.17077975210010266,0.13262085168843382,113640580,109841423.8,63.02953134585648,59.0036259887279,NaN,NaN,7.705564345583259,6.653540300418625
2009-07-20T09:30:00-04:00,28.02,28.25,27.8399,28.23,4397016,6695609.15,59.68054565994142,53.01943714276463,NaN,NaN,98.94844505907908,77.84945110986541,0.056970335684501744,0.203833771294061,0.14686343560955925,118037596,113521099,66.80245525150985,59.07933035696358,NaN,NaN,9.332532921300453,7.036253531973172
2009-07-21T09:30:00-04:00,28.33,28.55,28.2182,28.50999,6784508,6522729.65,62.5690350283247,53.42327690862633,NaN,NaN,138.19700386123932,107.13738788307364,0.0823038815234707,0.24974328751389763,0.16743940599042692,124822104,117399886.8,70.24908502715243,59.2753631413428,NaN,NaN,11.582260867726541,7.68568315136651
2009-07-22T09:30:00-04:00,28.50999,28.61,28.25,28.36,5892898,6397540.55,60.08571973528745,53.40210734453708,NaN,NaN,120.81348348870615,111.08566510723347,0.08276942729375919,0.2709011901076259,0.18813176281386673,118929206,118573610.6,71.22271310674866,59.391724946200206,NaN,NaN,12.801043325583686,8.416448890540392
2009-07-23T09:30:00-04:00,28.41,29.22,28.34,29.10001,7794516,6505740.35,67.03692471162346,54.58116713743552,NaN,NaN,173.4389819544268,125.13538546950822,0.1242328602460509,0.3434228381214304,0.21918997787537947,126723722,120430641.6,72.74261275328456,59.831466447100276,NaN,NaN,16.156830280263108,9.52221766050078
2009-07-24T09:30:00-04:00,29.10001,29.56,28.91,29.56,5255109,6332117.3,70.47855978400571,55.887520044138505,NaN,NaN,201.18563531003676,146.51670993469764,0.17106601891207834,0.4330225015154774,0.26195648260339904,131978831,124098291.8,75.49536282274822,60.425402188068475,NaN,NaN,20.193308026669207,11.046659141381983
2009-07-27T09:30:00-04:00,29.50999,29.56,29.28,29.49001,3178409,6324070.15,69.29306632296328,57.520981855336494,NaN,NaN,181.74903337407963,163.07682759769773,0.18459776653091892,0.4927036907670477,0.30810592423612876,128800422,126250857,76.96568004064079,61.439588362654845,NaN,NaN,23.060060950875823,12.762859399881103
2009-07-28T09:30:00-04:00,29.46001,29.5,28.77,29.00999,4706172,6335228.15,61.6356518011941,58.691381095304834,NaN,NaN,121.74906234139232,159.78723929372833,0.1499595859452214,0.4955554066676555,0.3455958207224341,124094250,126105286.2,76.63081573866563,62.783470940011604,NaN,NaN,23.168999231135594,14.24945080434603
2009-07-29T09:30:00-04:00,28.89999,29.08,28.53,28.87,5322848,6270292.25,59.56822840807827,59.705239961278984,NaN,NaN,82.54500207209496,152.13354301040607,0.10830335022853549,0.4809750085081035,0.372671658279568,118771402,126073725.4,76.55304922080839,64.4790800233845,NaN,NaN,22.62525643507174,15.445994465878274
2009-07-30T09:30:00-04:00,29.2,29.47,28.985,29.31,6449367,6204529.15,63.6906828151999,61.037106049920546,NaN,NaN,111.29112403838792,139.70397142719833,0.10119878382292041,0.4991701380582185,0.3979713542352981,125220769,125773134.8,75.76443128973042,66.37819051899076,NaN,NaN,23.434660240839968,16.587232433729945
2009-07-31T09:30:00-04:00,29.23,29.37,28.92,28.94,5337598,5997795.75,58.3069086133314,61.555800803266784,NaN,NaN,83.49364312082038,116.16557298935504,0.06420000728408648,0.4782213633404062,0.41402135605631973,119883171,123354002.8,69.55434974752494,68.08347058083716,NaN,NaN,22.41607598570572,17.419924369726484
2009-08-03T09:30:00-04:00,29.07001,29.24001,28.89,29.23,6160887,5973798.9,61.083581708290154,62.098279062209095,NaN,NaN,78.46605484829719,95.50897728419855,0.05237698930132295,0.4794925926829734,0.42711560338165044,126044058,122802730,68.18284060296014,69.61339331014712,NaN,NaN,22.428863486865705,18.135487100746374
2009-08-04T09:30:00-04:00,29.14,29.14,28.765,28.8,6495371,5869832.9,55.212071292429975,61.811345574985516,NaN,NaN,53.38347680519151,81.83586017695839,0.010885335483164227,0.4407222727356057,0.4298369372524415,119548687,121893617.4,65.87589816694616,70.51632729934065,NaN,NaN,20.55373469601062,18.480951042926982
2009-08-05T09:30:00-04:00,28.94,28.99001,28.41,28.60001,4517027,5656662.55,52.67599342403026,61.33625014105727,NaN,NaN,26.43845461893077,70.61455068632556,-0.032373092471515486,0.3893705716630471,0.4217436641345626,115031660,121145669,63.95855883904507,70.93052742525873,NaN,NaN,18.22223201114195,18.443991181243405
2009-08-06T09:30:00-04:00,28.74001,28.74001,28.46001,28.64999,5115352,5595621.95,53.25388547080892,61.04077534110778,NaN,NaN,14.553238750158592,51.26697362867969,-0.05844493570167153,0.34868749450747316,0.4071324302091447,120147012,120130917.6,61.34965967324997,70.81053659150112,NaN,NaN,16.514153819891007,18.168300129621635
2009-08-07T09:30:00-04:00,28.8,29.03999,28.64999,28.92,7172352,5623327.85,56.354667899524706,60.80321264393515,NaN,NaN,37.265176940999744,42.021280392715575,-0.0582028230817081,0.33437890135700954,0.39258172443871764,127319364,121618156.2,63.68752832903959,70.58804181132467,NaN,NaN,15.960038388683252,17.852834166630437
2009-08-10T09:30:00-04:00,28.91,29,28.59,28.98,3221219,5469899.15,57.036660854228685,60.40804306007116,NaN,NaN,28.771542374265735,32.08237789790928,-0.05475001623586373,0.324144204143888,0.37889422037975173,130540583,122517461.2,65.06364550161487,70.21765327378624,NaN,NaN,15.697454095394564,17.544922727882454
2009-08-11T09:30:00-04:00,28.96001,29,28.73,29,2834741,5322188.95,57.276309113444455,60.20737087279665,NaN,NaN,30.291859782044547,27.464054493279896,-0.05189373048198653,0.31402705727726854,0.3659207877592551,133375324,125282788.6,68.95910003627449,70.05596662589524,NaN,NaN,15.54532973488952,17.25926658602632
2009-08-12T09:30:00-04:00,29.02,29.34,28.8,29.14,4548984,5168017.05,59.00031785712642,59.63332752604686,NaN,NaN,59.65804136081348,34.107971841656436,-0.041784667844118606,0.31368995295410684,0.35547462079822545,137924308,129861318.2,74.10697013308386,70.15342072445232,NaN,NaN,15.875205126435926,17.06154352037055
2009-08-13T09:30:00-04:00,29.17,29.24001,28.86,29.03999,5736328,5235934.45,57.22388771045075,58.68656523507865,NaN,NaN,46.090127825638454,40.41534965675241,-0.04288128071560432,0.30187301990372006,0.3447543006193244,132187980,132269511.8,76.33045060836427,70.21306985199632,NaN,NaN,15.690808188843578,16.865724187295267
2009-08-14T09:30:00-04:00,28.92999,29.17999,28.75,29.03999,3563065,5224188.35,57.22388771045075,57.824481048470616,NaN,NaN,25.795091067061936,38.12133248196484,-0.04446376797640661,0.2891745906488161,0.33363835862522273,132187980,133243235,77.18360243827237,70.22863573754144,NaN,NaN,15.535984823353003,16.6757614210178
2009-08-17T09:30:00-04:00,28.7,28.81,28.58,28.64,4782023,5243438.7,50.21141311857663,57.00846399971222,NaN,NaN,-77.67711164569768,16.831601677972166,-0.07169292072344735,0.24402220772091354,0.3157151284443609,127405957,132616309.8,75.30166235172351,70.13369620990271,NaN,NaN,13.475065379782853,16.218519129412808
2009-08-18T09:30:00-04:00,28.84,28.84,28.5,28.7,4672520,5137839.3,51.17790269111015,56.40915501992879,NaN,NaN,-85.16282690120721,-6.259335658678188,-0.08405061950994153,0.21065185405693398,0.2947024735668755,132078477,132356940.4,74.49241645785776,69.98650815540624,NaN,NaN,11.988564141481195,15.614239845422578
2009-08-19T09:30:00-04:00,28.64999,28.98,28.57001,28.91,3827239,5034556.35,54.506558512067016,55.753146141133584,NaN,NaN,-50.41415946236465,-28.273775823313816,-0.076675150135182,0.19885853589789804,0.27553368603308004,135905716,131953222,73.17422479558903,69.80149340582471,NaN,NaN,11.564804820376743,15.035749127558887
2009-08-20T09:30:00-04:00,28.98,29.14999,28.8,29.14999,3969199,4843290.5,58.02837541853936,55.73325091293416,NaN,NaN,24.460359341606253,-32.59972952012025,-0.05522929762912099,0.20649706399667878,0.26172636162579976,139874915,133490609,74.98924959879281,70.18970053805813,NaN,NaN,12.16441600417076,14.625558681360584
2009-08-21T09:30:00-04:00,29.23,29.73,29.2,29.72,7122570,4936663.55,64.96561232891509,56.01053881440736,NaN,NaN,197.30672387526542,1.7025970415204228,-0.004901644436792807,0.25559930607980874,0.26050095051660155,146997485,136452510,78.06803764953317,70.89578604138478,NaN,NaN,14.889010536318088,14.663194660640228
2009-08-24T09:30:00-04:00,29.78999,29.86,29.56,29.77,3239577,4939721.95,65.50421559702811,56.74569197902151,NaN,NaN,236.7008063137607,64.5781806334121,0.027715651626729232,0.2951455150500131,0.26742986342328384,150237062,141018731,81.789730408909,72.03248834438213,NaN,NaN,17.25857808479832,15.03396372123424
2009-08-25T09:30:00-04:00,29.77,29.88,29.57001,29.58,3282756,4868551.15,61.62705200220531,57.38505330603402,NaN,NaN,182.21420810502931,118.05358763465941,0.03214317749877654,0.30760883529675453,0.275465657797978,146954306,143993896.8,83.72731699689933,73.44454249851458,NaN,NaN,18.153284024371967,15.479580907396773
2009-08-26T09:30:00-04:00,29.61,29.67999,29.36,29.55,3335461,4769181.8,61.01297978505121,57.93927432847989,NaN,NaN,122.18546058779062,152.57351164469046,0.028807368726465943,0.31147486870606045,0.2826674999795945,143618845,145536522.6,84.63990101655202,75.1081311658933,NaN,NaN,18.71631640082731,15.941971692172563
2009-08-27T09:30:00-04:00,29.61,29.62,29.34,29.55,4852926,4689359.75,61.01297978505121,58.27201089173178,NaN,NaN,106.03650962726748,168.8887417018227,0.02262939290193422,0.3109542411070123,0.2883248482050781,143618845,146285308.6,85.07736374457248,76.63597655271708,NaN,NaN,19.181356893524303,16.404741006651385
2009-08-28T09:30:00-04:00,29.59,29.66,29.31,29.48,3347407,4589850.2,59.410985494493495,58.441605508893545,NaN,NaN,88.35891925117348,147.0991807770043,0.010475048101228068,0.3014186583316132,0.2909436102303851,140271438,144940099.2,80.63428856362161,77.7481653428604,NaN,NaN,19.160857886359558,16.798471989466837
2009-08-31T09:30:00-04:00,29.41,29.45,29.14999,29.23,7359953,4649803.5,53.9615696035582,58.20483840104453,NaN,NaN,39.183249618160346,107.59566943788425,-0.016299072394371672,0.27056976973742053,0.2868688421317922,132911485,141474983.8,70.43088065229954,77.85329252971935,NaN,NaN,17.652097479703418,16.920418488072063
2009-09-01T09:30:00-04:00,29.12,29.45,28.95,29,6581027,4654086.3,49.46621088755876,57.52383076036113,NaN,NaN,5.76496164389842,72.30582014565806,-0.049519539265588886,0.22496941804980608,0.27448895731539497,126330458,137350214.2,60.6005381961952,76.88854739137015,NaN,NaN,15.032917811513299,16.650775534277955
2009-09-02T09:30:00-04:00,28.89,28.98,28.7,28.8,5235965,4690033.2,45.88647245393925,56.714015384896015,NaN,NaN,-64.93334278640484,34.88205947081898,-0.08301158442966156,0.17072447677831804,0.2537360612079796,121094493,132845343.8,52.055070149501844,75.15459164430855,NaN,NaN,11.705390754322059,15.944291994284255
2009-09-03T09:30:00-04:00,28.92999,28.92999,28.62,28.78,3759200,4622225.6,45.53162598094356,55.878853832788366,NaN,NaN,-79.7104783235341,-2.2673381193413347,-0.10324176157626153,0.12468385923765268,0.2279256208139142,117335293,127588633.4,44.21920830957689,72.79999206368744,NaN,NaN,8.857532823885926,14.931897827084494
2009-09-04T09:30:00-04:00,28.92999,28.99001,28.74001,28.92,5521836,4539699.8,48.53200287275809,55.758895958087045,NaN,NaN,-55.425853401135065,-31.024292649803044,-0.1036530223906576,0.09835934282559222,0.20201236521624982,122857129,124105771.6,39.930421111145215,70.27347483221756,NaN,NaN,7.19374228394251,13.826447035207067
2009-09-08T09:30:00-04:00,29.14,29.16,28.87,28.99001,3096467,4533462.2,50.014825945546356,55.67581904768963,NaN,NaN,-29.339380875367787,-44.72881874850867,-0.09585096351849373,0.08219866081813265,0.17804962433662638,125953596,122714193.8,38.3307638483748,67.69049964582594,NaN,NaN,6.174996044400139,12.733382607948935
2009-09-09T09:30:00-04:00,28.98,29.11,28.92,28.95,4620750,4622762.65,49.14343955330415,55.29273912206371,NaN,NaN,-33.831015308442716,-52.6480141389769,-0.0901127074423157,0.06540874003373176,0.15552144747604746,121332846,121714671.4,37.17867317336469,65.11938881566705,NaN,NaN,5.0831860079336,11.640497379375315
2009-09-10T09:30:00-04:00,28.89999,29.03,28.75999,28.95,5300688,4660347.85,49.14343955330415,54.658100845975476,NaN,NaN,-49.49371964391254,-49.56008951047844,-0.08321008202415489,0.05150884494585384,0.13471892697000873,121332846,121762342,37.275505224113566,62.42554993176138,NaN,NaN,4.162730223963374,10.572244928602181
2009-09-11T09:30:00-04:00,29,29.10001,28.87,28.94,7102652,4728664.05,48.89650003250606,53.510307110517694,NaN,NaN,-35.07076385729734,-40.63214661723108,-0.07638802352006387,0.0392338975699289,0.11562192108999277,114230194,121141322.2,36.4864931292393,59.455439608883246,NaN,NaN,3.314904362680278,9.535481990613338
2009-09-14T09:30:00-04:00,28.86,29.36,28.8,29.36,6760055,4888513.55,58.360318909556696,53.0000287756983,NaN,NaN,9.639404958355314,-27.619094945333007,-0.042358387177668586,0.06267393711790703,0.10503232429557562,120990249,120767946.2,35.99319871103316,56.184258773320686,NaN,NaN,5.135122438308788,8.906859197426973
2009-09-15T09:30:00-04:00,29.38,29.59,29.19,29.58,4184961,4858660.45,62.298802116362914,53.04801092670956,NaN,NaN,66.33818313952635,-8.48358214235418,-0.005726447343903984,0.09787426511569564,0.10360071245959962,125175210,120612269,35.77601396187788,52.75916569939058,NaN,NaN,7.930212864757161,8.767338292759858
2009-09-16T09:30:00-04:00,29.67,30.06,29.42,30.05,5672133,4908641.1,69.03675453173338,53.62113769432971,NaN,NaN,137.14237252955306,25.711095425244974,0.0465837267720071,0.1618303709246085,0.1152466441526014,130847343,122515168.4,40.501942691886306,49.60645439048589,NaN,NaN,12.84202254754481,9.349436043443422
2009-09-17T09:30:00-04:00,30,30.11,29.81,29.85001,5353977,4984978,63.810839387180565,53.82098480876753,NaN,NaN,135.85550093265974,62.78093954055943,0.06311515831504624,0.1941405920464092,0.13102543373136297,125493366,123347272.4,42.49465493558692,46.5648323327012,NaN,NaN,15.26029601215333,10.19384461040198
2009-09-18T09:30:00-04:00,29.55,29.74001,29.55,29.67999,4784582,5025747.15,59.67511430937211,53.839851152687416,NaN,NaN,71.18283828381755,84.0316599687824,0.058123325376388396,0.20367959045184847,0.14555626507546007,120708784,124642990.4,45.552645574546496,44.059000690624394,NaN,NaN,15.940740285296155,11.014829706815433
2009-09-21T09:30:00-04:00,29.52,29.64,29.31,29.53999,6129305,4976083.9,56.43176627097752,54.016293771788796,NaN,NaN,38.710092158032936,89.84579740871793,0.04168613881891986,0.1976639385991099,0.15597779978019005,114579479,123360836.4,43.10968120927653,42.10748644469419,NaN,NaN,15.480810736572625,11.652826996780746
2009-09-22T09:30:00-04:00,29.67,29.67,29.39999,29.46001,4942836,5061246.85,54.605863606005634,54.38341182310643,NaN,NaN,45.40009729635815,85.65818024008428,0.022672215866761686,0.18431806961364217,0.16164585374688048,109636643,120253123,37.815927454049714,40.480014248826656,NaN,NaN,14.54937323769618,12.066619316911522
2009-09-23T09:30:00-04:00,29.5,29.84,29.33,29.36,9684316,5381324.85,52.3259529111467,54.84337471290696,NaN,NaN,48.53577526853062,67.9368607878798,0.001710043349915813,0.16378340793427526,0.16207336458435945,99952327,114074119.8,29.942854618504725,38.90057028232685,NaN,NaN,13.094644406740432,12.213480044029938
2009-09-24T09:30:00-04:00,29.37,29.565,29.28,29.28,4808516,5454977.6,50.50926289437552,55.198920206723535,NaN,NaN,20.587927178724502,44.88334603709275,-0.018101288610240074,0.13944675382155935,0.15754804243179943,95143811,108004208.8,24.538272860712027,37.49478917883651,NaN,NaN,11.353102507613201,12.090568967398974
2009-09-25T09:30:00-04:00,29.25,29.39999,29.19,29.2,2957958,5360229.2,48.68881775260386,55.21012126956966,NaN,NaN,-2.4066039247828623,30.16545759537267,-0.036111496748666205,0.11240867149596667,0.14852016824463288,92185853,102299622.6,20.747991440719176,36.12461563094893,NaN,NaN,9.368348783352493,11.701680369678048
2009-09-28T09:30:00-04:00,29.28,29.67,29.17,29.45,3720317,5378874.7,54.239336608622345,55.51187203121795,NaN,NaN,38.36198538027591,30.095836239821256,-0.03090653603259952,0.10988699820388348,0.140793534236483,95906170,98564960.8,18.71037780608181,34.72315948507086,NaN,NaN,9.214350122942927,11.346347477287317
2009-09-29T09:30:00-04:00,29.61,29.64,29.33,29.50999,5505336,5286143.85,55.48374719718588,55.96475114863807,NaN,NaN,49.08650526783719,30.83311783411707,-0.023479161927249942,0.11144458182742056,0.1349237437546705,101411506,96919933.4,17.877540650843954,33.344507162033665,NaN,NaN,9.444141472928887,11.07460376237897
2009-09-30T09:30:00-04:00,29.62,29.64,29.16,29.33,6633426,5288763.8,51.00232786613931,56.09752888526916,NaN,NaN,19.484039145085962,25.022770609428136,-0.030309626592140815,0.09703671051449447,0.1273463371066353,94778080,95885084,17.35421595227281,31.92155792833075,NaN,NaN,8.336019586696045,10.683377451567123
2009-10-01T09:30:00-04:00,29.36,29.36,28.78,28.83,9242969,5489114,41.07681656336181,55.53898006604457,NaN,NaN,-75.6919453092983,5.766796111823578,-0.06607177296171902,0.04475662090448651,0.11082839386620554,85535111,93963344,16.39445598954363,30.48641241835249,NaN,NaN,3.952320114010572,9.721797831916188
2009-10-02T09:30:00-04:00,28.59,28.64999,28.42,28.52,6435582,5622933.1,36.35313000727179,53.96703800159565,NaN,NaN,-175.65256133650422,-28.882395370520697,-0.1058170790562588,-0.021442954954117965,0.08437412410214083,79099529,91346079.2,15.164411262793664,28.99864188633538,NaN,NaN,-1.449230887659701,8.12593658626249
2009-10-05T09:30:00-04:00,28.53,28.89999,28.35001,28.83,6849188,5689300.7,43.36672456987629,52.61474674827518,NaN,NaN,-130.93801248519756,-62.74239494361539,-0.10616730778358228,-0.04833501062733703,0.05783229715624526,85948717,89354588.6,14.286091603337965,27.463647432153966,NaN,NaN,-3.589572455115067,6.452292437494268
2009-10-06T09:30:00-04:00,28.92,29.17999,28.83,29.05,3964030,5732678.85,47.76582629992813,51.09539473171766,NaN,NaN,-58.33222039057255,-84.22614007529734,-0.0873087186317118,-0.051303601133394494,0.03600511749831731,89912747,87054836.8,13.32620294051138,25.52252316419861,NaN,NaN,-3.8242604987022135,4.984213446609057
2009-10-07T09:30:00-04:00,29,29.11,28.86,29.07001,3281446,5665713.65,48.16025118245347,49.97749557423715,NaN,NaN,-60.268351614977675,-100.17661822731006,-0.06996291333188168,-0.05144852416653478,0.018514389165346888,93194193,86738059.4,13.194691187160856,23.429668610739608,NaN,NaN,-3.8795055980860997,3.717967868795463
2009-10-08T09:30:00-04:00,29.25,29.25,29.02,29.07001,9158660,5858612.25,48.16025118245348,49.155005350885816,NaN,NaN,-41.60150637328239,-93.35853044010688,-0.05559211924088469,-0.050975759885758976,0.004616359355125714,93194193,88269875.8,17.43772976006457,21.421460338276614,NaN,NaN,-3.923171069888589,2.6263765918405984
2009-10-09T09:30:00-04:00,29.12,29.33,28.96001,29.25,4574125,5732185.9,51.94566047195251,48.83456922238404,NaN,NaN,-29.70484265369779,-64.16898670354558,-0.032226098317480106,-0.03566626354172442,-0.0034401652242443126,97768318,92003633.6,26.826498507495316,20.25837585957796,NaN,NaN,-2.8178411796869067,1.8486311959080977
2009-10-12T09:30:00-04:00,29.24001,29.55,29.24001,29.55,2466727,5517519.5,57.514313472715386,49.04231564143473,NaN,NaN,32.00032631749378,-31.58131894300733,0.0032852787221457234,0.0006664331784378419,-0.0026188455437078815,100235045,94860899.2,33.09646518799663,19.92127141200274,NaN,NaN,-0.06901022496897014,1.574682421497088
2009-10-13T09:30:00-04:00,29.44,29.44,29.22,29.34,4897875,5553165.2,52.89365523545537,49.08286580745678,NaN,NaN,5.833748546738056,-18.748125155545203,0.011993068254824326,0.012372489774822526,0.0003794215199982003,95337170,95945783.8,35.361224890366245,20.308297859992845,NaN,NaN,0.8192627818861055,1.4667653301240906
2009-10-14T09:30:00-04:00,29.47,29.53999,29.2,29.36,7977871,5668452.1,53.278635801526484,49.280678157967564,NaN,NaN,21.614863169618275,-2.371482198626019,0.018095139743246547,0.022998346199056385,0.004903206455809837,103315041,97969953.4,39.47779790933418,21.375406792037285,NaN,NaN,1.6437941434302161,1.4920551605963943
2009-10-15T09:30:00-04:00,29.28999,29.63,29.28999,29.59,7534082,5777457.35,57.57286867712908,49.915253224005085,NaN,NaN,68.540730123993,19.65696510082905,0.03560458389002402,0.04940893631833987,0.013804352428315843,110849123,101500939.4,45.94494580949166,23.1751892469496,NaN,NaN,3.6800617015617854,1.8046275235914502
2009-10-16T09:30:00-04:00,29.45,29.81,29.36,29.69,7568719,5916664.2,59.32340650521797,50.27840107376191,NaN,NaN,103.28275862866717,46.254485357302045,0.050968627881315204,0.07751513727995984,0.026546509398644644,118417842,105630844.2,52.35737369683519,25.57854609628913,NaN,NaN,5.895329020860661,2.389013451772766
2009-10-19T09:30:00-04:00,29.7,30.23,29.5799,30.11,8893531,6054875.5,65.72066865134586,51.00960974905905,NaN,NaN,183.48210434148092,76.55084096209947,0.08448805265337367,0.13215657521536173,0.04766852256198806,127311373,111046109.8,59.1930936643924,28.529657025828303,NaN,NaN,10.043281576414783,3.4824803267216256
2009-10-20T09:30:00-04:00,30.17,30.19,29.69,29.81,6201141,6117790.75,58.62797628547398,51.55429892186867,NaN,NaN,148.60412046798933,105.10491534634973,0.08148849142497747,0.1495291368432099,0.06804064541823243,121110232,116200722.2,64.42536184695852,31.89188173259157,NaN,NaN,11.270103864455045,4.594997974969257
2009-10-21T09:30:00-04:00,29.8,30.21001,29.77,29.85001,8343355,6050742.7,59.259468242205934,52.85305975607182,NaN,NaN,145.38309097238204,129.85856090690248,0.07726969433721258,0.16462776333974816,0.08735806900253558,129453587,121428431.4,68.79531002892098,35.63479987826138,NaN,NaN,12.435633922134482,5.715088824564289
2009-10-22T09:30:00-04:00,29.88,29.95,29.61,29.92,4214508,6021042.3,60.39821701880371,54.570565971181246,NaN,NaN,105.10135381918248,137.17068564594038,0.07424500044569816,0.18016431955965828,0.10591931911396012,133668095,125992225.8,72.02596276276984,39.69633927111682,NaN,NaN,13.726615502622858,6.859592635715512
2009-10-23T09:30:00-04:00,30.00999,30.00999,29.33501,29.42999,7168418,6231565.3,49.88521572743437,55.0361724824354,NaN,NaN,48.868818977840014,126.28789771577495,0.036220195643709124,0.15119456366859652,0.11497436802488739,126499677,127608592.8,73.08864767656289,43.89652184777574,NaN,NaN,11.445707040208324,7.514751836357343
2009-10-26T09:30:00-04:00,29.48,29.84,28.95,29.03999,12202582,6655678.55,43.4089296551621,54.724965579237825,NaN,NaN,-17.88409490372774,86.01465786673322,-0.015448826105468272,0.09566333539305205,0.11111216149852032,114297095,125005737.2,68.57127057002765,47.8425981070269,NaN,NaN,7.200151288258204,7.469808900914609
2009-10-27T09:30:00-04:00,29.14,29.33,28.87,28.97,10762695,6918546.5,42.346434188767574,54.30969293683169,NaN,NaN,-59.09365813126762,44.47510214688183,-0.05250370160767277,0.04548253448892936,0.09798623609660213,103534400,121490570.8,62.9157056903252,51.394099142967214,NaN,NaN,3.5270438730758205,6.906556754080497
2009-10-28T09:30:00-04:00,28.96001,29.09,28.64,28.67999,15738938,7373822.1,38.176702718194285,53.596582332241745,NaN,NaN,-98.77158597198033,-4.355833241990643,-0.09237773139802506,-0.017485928150929197,0.07489180324709586,87795462,113158945.8,51.973928927843865,53.860970512094305,NaN,NaN,-0.994845817590035,5.7777849581275635
2009-10-29T09:30:00-04:00,28.8,28.98,28.63,28.92999,7537871,7288567.2,43.3547548739497,52.98294621809868,NaN,NaN,-87.07704533989597,-42.79151307380633,-0.09725576577564352,-0.04667790397245852,0.050577861803184986,95333333,105491993.4,44.33318797468031,55.111448331178956,NaN,NaN,-3.0717371131638713,4.5135675193716445
2009-10-30T09:30:00-04:00,28.92,29.00999,28.35001,28.39,13260672,7629821.7,36.28544386551626,51.46659838901303,NaN,NaN,-139.03776878281118,-80.37283062593656,-0.13013692426730833,-0.11209329353095043,0.018043630736357896,82072661,96606590.2,37.460019584575655,55.42313078807745,NaN,NaN,-7.46240033961408,2.8027149680879697
2009-11-02T09:30:00-05:00,28.50999,28.7,28.10001,28.34,8284621,7701593.35,35.70489723165507,50.23882996017015,NaN,NaN,-167.6272429201998,-110.32146022923098,-0.14727958831290383,-0.1660558546547719,-0.01877626634186807,73788040,88504779.2,32.51071487754153,55.21952293001855,NaN,NaN,-11.030913097740317,0.8264823872553575
2009-11-03T09:30:00-05:00,28.34,28.42999,28.17999,28.28,8381699,7922476.8,34.981610659427346,48.93189959287735,NaN,NaN,-159.32422646716392,-130.36757389641022,-0.15396151883364442,-0.2112281648839236,-0.057266646050279174,65406341,80879167.4,28.67102085917729,54.44761028357876,NaN,NaN,-14.084780725254497,-1.3036980573889072
2009-11-04T09:30:00-05:00,28.38,28.8701,28.35001,28.47,7950176,8155913.3,39.183015502122075,47.618338651805416,NaN,NaN,-104.64692412541211,-131.54264152709658,-0.13743126100077713,-0.2290557223012506,-0.09162446130047347,73356517,77991378.4,27.35349724831245,53.11964967206597,NaN,NaN,-15.343778213084446,-3.3094237939168414
2009-11-05T09:30:00-05:00,28.66,28.98,28.64,28.95,6484617,8022211.15,48.27629020433772,46.82925891602826,NaN,NaN,-54.776326670069025,-125.08249779313118,-0.0883982404828084,-0.20212226190398397,-0.11372402142117558,79841134,74892938.6,25.974315052071574,51.23514548315428,NaN,NaN,-13.447769776364751,-4.757758934266542
2009-11-06T09:30:00-05:00,28.88,29.08,28.78,28.92,7214238,8154216.8,47.7952900336312,45.54887472904864,NaN,NaN,-40.91919825368552,-105.45878368730607,-0.053909041031569294,-0.1811103227106372,-0.1272012816790679,72626896,73003785.6,25.141945073123907,48.80292058377796,NaN,NaN,-12.109930945463073,-5.8080692215803325
2009-11-09T09:30:00-05:00,29.07001,29.44,29.03,29.44,4752434,8268502.15,55.98198434096401,45.359875304440784,NaN,NaN,15.82018386845374,-68.76929832957538,0.004878977018646646,-0.12110256040575962,-0.12598153742440626,77379330,73722043.6,26.111444382783574,46.06621219347975,NaN,NaN,-8.109821780817464,-6.136891015757065
2009-11-10T09:30:00-05:00,29.36,29.64,29.33,29.58,5523715,8299794.15,57.89636312926174,45.2625106535162,NaN,NaN,45.47469021792667,-27.80951499255725,0.05155342634532016,-0.06153975449275606,-0.11309318083807622,82903045,77221384.4,30.81282097864721,43.353177261317335,NaN,NaN,-4.27188113622889,-5.870461032967326
2009-11-11T09:30:00-05:00,29.74001,29.78,29.4175,29.50999,5798402,8190820.7,56.571378322144966,44.98916503232629,NaN,NaN,50.67284632063696,3.2544390966525683,0.07466872545015381,-0.019757274025383964,-0.09442599947553777,77104643,77971009.6,31.813713680403936,40.48087375543406,NaN,NaN,-1.6051838508006078,-5.261135721229223
2009-11-12T09:30:00-05:00,29.47,29.58,29.08,29.10001,5460039,8087118.55,49.43638461881227,44.957105667424706,NaN,NaN,7.23888994976769,15.657482420619914,0.05993958713990369,-0.019501515550658155,-0.07944110269056184,71644604,76331703.6,30.765554645536525,37.457795681789314,NaN,NaN,-1.5259340590032384,-4.727535483768368
2009-11-13T09:30:00-05:00,29.16,29.49001,29.05,29.36,8499133,8133639.25,53.44625312472391,45.674057343821985,NaN,NaN,17.01401242367466,27.24412455609194,0.0648817201797349,0.0016610475341067854,-0.06322067264562811,80143737,77835071.8,32.94737317045693,34.91323158181998,NaN,NaN,-0.16326632046591236,-4.075497031868017
2009-11-16T09:30:00-05:00,29.58,29.78999,29.49001,29.77,7794402,8078682.8,58.97192451491966,46.86159236711857,NaN,NaN,79.94040510551,40.0681688035032,0.0913197594102831,0.05092902661722576,-0.04039073279305734,87938139,79946833.6,35.99843664882057,32.99056950742679,NaN,NaN,2.8771977114731775,-3.082254925676418
2009-11-17T09:30:00-05:00,29.84,29.84,29.535,29.61,5431910,8040221.25,56.170004822224485,48.146828231692155,NaN,NaN,80.38501487987705,47.05023373589327,0.09326088591315665,0.07618537459838848,-0.017075511314768175,82506229,79867470.4,35.93226393398608,31.844736293579803,NaN,NaN,4.429356724782052,-2.009167547039494
2009-11-18T09:30:00-05:00,29.60001,29.6915,29.44,29.48,4762277,7861167.35,53.92801879731931,48.902061369075696,NaN,NaN,66.55988053010859,50.2276405777876,0.08144803453434665,0.08473453185316515,0.0032864973188184918,77743952,79995332.2,36.13594849216589,31.25921918768592,NaN,NaN,4.992026623635845,-1.0089969512287313
2009-11-19T09:30:00-05:00,29.41,29.48,29.03999,29.12,6193527,7960118.3,48.19156733888325,49.752498760030484,NaN,NaN,18.513217462387328,52.48250608031152,0.046770006243204224,0.061749005122823775,0.01497899887961955,71550425,79976496.4,36.11773189992315,31.16334149592502,NaN,NaN,3.638997515909491,-0.3449977416375568
2009-11-20T09:30:00-05:00,29.05,29.25,29.03,29.25,7480695,7975732.15,50.249594113770314,50.79140568018157,NaN,NaN,16.469149327569564,52.3735334610905,0.030742464547075046,0.053407079563463355,0.02266461501638831,79031120,79753973,35.88756231299496,31.404544884171695,NaN,NaN,3.1728257294475077,0.1575484685174524
2009-11-23T09:30:00-05:00,29.50999,29.75,29.39999,29.62,7404883,7735847.2,55.6495659677985,52.26768820220808,NaN,NaN,88.6682571602923,54.119103872046956,0.04249104776967589,0.07577842472848317,0.033287376958807284,86436003,79453545.8,35.55809359679928,31.896478651144694,NaN,NaN,4.4902910913701,0.7765117003535449
2009-11-24T09:30:00-05:00,29.69,29.74001,29.48,29.67999,7341898,7564807.35,56.47446502440332,53.50279173951388,NaN,NaN,86.98857165919266,55.43981522791008,0.05115232817919631,0.09722778718280267,0.046075459003606364,93777901,81707880.2,40.0087293852472,32.80042380378289,NaN,NaN,5.795821641559944,1.4935559776687448
2009-11-25T09:30:00-05:00,29.69,30.09,29.67999,30.02,6320629,7093891.9,60.91201931334606,54.40534381872876,NaN,NaN,126.36081099190181,67.40000132026873,0.07517814408456933,0.14004813910931802,0.06486999502474869,100098530,86178795.8,47.72040429193521,34.353715892344574,NaN,NaN,8.328774825881348,2.470015813127688
2009-11-27T09:30:00-05:00,29.60001,29.82001,29.37199,29.50999,5992461,7016621.4,52.29884317097304,54.727026185681744,NaN,NaN,59.37500854395172,75.5723595365816,0.053157043412055294,0.1313162992898178,0.07815925587776251,94106069,90689924.6,54.127827377237004,36.42413605692409,NaN,NaN,7.74455432940279,3.2235213154527025
2009-11-30T09:30:00-05:00,29.64999,29.81,29.50999,29.75999,5720578,6639616.7,55.61221237592007,54.700613902464326,NaN,NaN,76.18505726657943,87.51554112438357,0.05180991701449385,0.14292165214587982,0.09111173513138597,99826647,94849030,59.104367331291485,38.78077341038893,NaN,NaN,8.346396432577802,3.955360617899145
2009-12-01T09:30:00-05:00,29.98,30.33,29.91,30.32001,10539508,6752361.05,61.98267142488776,54.9924930664376,NaN,NaN,156.50086501688807,101.08206269570273,0.08315812261862356,0.1950593884046654,0.11190126578604186,110366155,99635060.4,63.95091649845269,41.14778023323218,NaN,NaN,11.088624265813724,4.974398281886942
2009-12-02T09:30:00-05:00,30.4201,30.73,30.33,30.73,13092090,6987880.6,65.84713150094278,55.65504686492319,NaN,NaN,223.30267433127983,128.34488323012016,0.1235917058841805,0.2663908981412675,0.14279919225708698,123458245,105571129.2,68.87742630879947,43.79518827811757,NaN,NaN,14.732481952953766,6.368410234896489
2009-12-03T09:30:00-05:00,30.83,31.05,30.60001,30.83,9964199,7088581.75,66.73531373059504,56.89068465862197,NaN,NaN,240.10545224505884,151.09381148075158,0.14753570450221773,0.32721882288485915,0.17968311838264142,133422444,112235912,73.2908615769556,46.83271020179036,NaN,NaN,17.86907806065482,8.011362781433393
2009-12-04T09:30:00-05:00,31.14,31.22,30.28,30.64,20348528,7781777.3,63.363582844218215,57.599065352871555,NaN,NaN,179.61394209812136,175.1415981915855,0.14104578072530377,0.3559903442892711,0.21494456356396735,113073916,116029481.4,75.42689484578207,49.866961750027876,NaN,NaN,19.348366962689358,9.630934807327101
2009-12-07T09:30:00-05:00,30.83,31.08,30.38,30.91,11117090,7976919.9,65.99300490947753,58.10057109533998,NaN,NaN,154.74210087021373,190.85300691231237,0.14485533001398826,0.3960137260814527,0.25115839606746443,124191006,120902353.2,77.87460912350011,52.85811692679071,NaN,NaN,21.42055003207828,11.315165553720126
2009-12-08T09:30:00-05:00,30.92,30.92999,30.53999,30.78,15201254,8499360.9,63.625227212585095,58.63308698036574,NaN,NaN,124.27666496358013,184.40816690165076,0.1290634664921576,0.4124877291826614,0.2834242626905038,108989752,120627072.6,77.40552799288868,55.820492930998036,NaN,NaN,22.384212255357603,12.896457939668338
2009-12-09T09:30:00-05:00,30.84,30.92,30.64999,30.89,9903203,8718335.3,64.77683711060888,59.40800257417213,NaN,NaN,114.43071232557726,162.63377450051024,0.11683573031304373,0.4294689255818085,0.31263319526876476,118892955,119714014.6,75.77515725138666,58.65186498522809,NaN,NaN,23.51462708639742,14.41333924634392
2009-12-10T09:30:00-05:00,31.16,31.37,30.99001,31.28,12060469,9031438.65,68.57549475044256,60.86399738928351,NaN,NaN,137.6796296558258,142.14860998266363,0.1250855718457372,0.4689901600759363,0.3439045882301991,130953424,119220210.6,74.85685240079135,61.41894502100439,NaN,NaN,25.681136830314838,16.023024615482623
2009-12-11T09:30:00-05:00,31.42999,31.82001,31.28,31.82001,12524816,9384677.5,72.92890421197197,62.48394811058363,NaN,NaN,157.65976504576415,137.7577745721922,0.15502608447506522,0.5376871938240306,0.3826611093489654,143478240,125301075.4,78.338218046141,64.4511347162291,NaN,NaN,29.057590506992838,17.88510545712694
2009-12-14T09:30:00-05:00,32.02,32.08,31.75999,31.97,13813082,9650374.95,74.00605963546485,63.79512622970266,NaN,NaN,160.68087768838078,138.9455299358256,0.1717488573360162,0.5973471810189857,0.42559832368296946,157291322,131921138.6,81.36355970810571,67.72295372417956,NaN,NaN,32.128545475006966,19.919882602538372
2009-12-15T09:30:00-05:00,31.83,31.87,31.63,31.77,6862699,9603789.8,70.00605481653982,64.76166835771241,NaN,NaN,125.22237968232993,139.13467287957556,0.1565833770472464,0.6213275449920275,0.4647441679447811,150428623,140208912.8,84.31666610749178,70.88780634719703,NaN,NaN,33.44208323797275,21.85162555045757
2009-12-16T09:30:00-05:00,31.87,31.95,31.62,31.63,12374844,9950936.5,67.26531907615728,65.21547548362749,NaN,NaN,110.3778487478518,138.32410016403043,0.12569813163806753,0.6218668324923655,0.496168700854298,138053779,144041077.6,85.46366257039978,73.58375336708737,NaN,NaN,33.70232260237888,23.544582272160614
2009-12-17T09:30:00-05:00,31.52,31.67999,31.36,31.45,8905602,10158102.75,63.80651669945898,66.03745216423364,NaN,NaN,82.80962854477579,127.35009994182045,0.083739899572845,0.6008435753203543,0.5171036757475093,129148177,143680028.2,84.8341541298039,75.77706242084214,NaN,NaN,32.895841698394705,24.880476475908342
2009-12-18T09:30:00-05:00,31.41,31.47,31.03,31.35001,11180910,10407471.9,61.90232677756625,66.4867460500655,NaN,NaN,59.068205501736934,107.631788033015,0.041956044960645644,0.5695487319483163,0.5275926869876707,117967267,138577833.6,76.28303255359809,77.00410993672118,NaN,NaN,31.67823370316276,25.8515846512304
2009-12-21T09:30:00-05:00,31.45,31.58,31.35001,31.44,5335969,10300235.6,62.97330955728645,66.5575059166654,NaN,NaN,70.79356901376433,89.65432629809175,0.014500318919846156,0.5457180856374784,0.5312177667176322,123303236,131780216.4,66.64469173121583,77.19652245334711,NaN,NaN,30.95309210506158,26.58037143034914
2009-12-22T09:30:00-05:00,31.58,31.61,31.14999,31.17999,10711059,10465544.4,57.908031183948296,65.99042732259439,NaN,NaN,49.37460330028583,74.48477102168293,-0.024904770682994792,0.5000868033638888,0.5249915740468836,112592177,124212927.2,57.87764200383423,76.41082357442103,NaN,NaN,28.86327580598205,26.906500626868127
2009-12-23T09:30:00-05:00,31.35001,31.35001,31.10001,31.25,5206055,10358752.25,58.86740447694331,65.4284338044764,NaN,NaN,34.136437552176886,59.23648878254795,-0.04861594153486859,0.46422164712829783,0.5128375886631664,117798232,120161817.8,53.79756073156414,75.01844494260736,NaN,NaN,27.3790206159758,26.974003482454936
2009-12-24T09:30:00-05:00,31.37,31.5126,31.24001,31.48,1993106,10142376.1,61.93675597054561,65.32651759921407,NaN,NaN,49.57346555974657,52.58925618554209,-0.05092649579952069,0.4491794689137656,0.5001059647132863,119791338,118290450,51.974836443953635,73.34329791390533,NaN,NaN,26.924215507957754,26.966890914669623
2009-12-28T09:30:00-05:00,31.5,31.60001,31.38,31.5,9607500,10323128.05,62.20089276081532,65.0556524457382,NaN,NaN,54.97686022593641,51.77098713038199,-0.052988072729989455,0.4338708738007995,0.4868589465307889,129398838,120576764.2,54.0243361008197,71.63970698371388,NaN,NaN,26.618281452947635,26.917089562995052
2009-12-29T09:30:00-05:00,31.58,31.64,31.48,31.48,4656277,10269913,61.73949988194736,64.92095763640692,NaN,NaN,57.147186057878635,49.04171053920486,-0.05721746023816743,0.41533712123307964,0.47255458147124707,124742561,120864629.2,54.288844114887546,69.98851527814237,NaN,NaN,26.24188539848499,26.8206318252079
2009-12-30T09:30:00-05:00,31.48,31.57001,31.39999,31.47,2314745,9858674.85,61.493881501399684,64.6864608071777,NaN,NaN,42.31180227557092,47.629150334261865,-0.06181529113310963,0.39528546755486005,0.4571007586879697,122427816,122831757,56.14559009387122,68.58640333831984,NaN,NaN,25.86202900127528,26.683688564646097
2009-12-31T09:30:00-05:00,31.60001,31.61,31,31.02,5506902,9479415.45,51.55445831783972,63.47067249056321,NaN,NaN,-21.72756267857251,36.456350288111985,-0.0943419118392042,0.33917336888896443,0.43351528072816864,116920914,122656293.4,55.92737045525535,67.23429748506727,NaN,NaN,22.68801063126045,26.11287743130529
2010-01-04T09:30:00-05:00,31.28,31.36,31.00999,31.08,8217547,9392082.85,52.65331801334298,62.02241633351828,NaN,NaN,-41.68153503860429,18.20535016844181,-0.10990662487575881,0.29613199963347014,0.40603862450922895,125138461,123725718,57.0237342265427,65.71183435509597,NaN,NaN,20.319712102816183,25.285282384378274
2010-01-05T09:30:00-05:00,30.99001,31.17,30.56,30.71001,18024384,9275875.65,45.760420048341075,60.004870648723724,NaN,NaN,-127.43521378746645,-18.27706463423876,-0.14121447264999465,0.22952053369673564,0.3707350063467303,107114077,119268765.8,51.29648823237441,63.564186392543725,NaN,NaN,16.073571146061596,23.96932363604732
2010-01-06T09:30:00-05:00,30.69,31,30.69,30.89,12745055,9357273.9,49.24160472565327,58.521695642231826,NaN,NaN,-118.24380401329239,-53.355262648472966,-0.14532830807415797,0.18907462125403285,0.3344029293281908,119859132,118292080,50.108791150180686,61.12076675273579,NaN,NaN,13.446522429228445,22.46606632078748
2010-01-07T09:30:00-05:00,30.85001,30.87,30.6366,30.75,6563051,8925363.75,46.72934365374237,57.054840254916485,NaN,NaN,-145.4985350243373,-90.9173301084546,-0.15227159097615772,0.1440634406079937,0.2963350315841514,113296081,116465733,47.876486656319386,58.43596847315862,NaN,NaN,10.485098244133985,20.754499452694123
2010-01-08T09:30:00-05:00,30.71001,30.78999,30.52,30.72,6267582,8743582.7,46.18557170817448,55.79620132696759,NaN,NaN,-158.44130448212852,-118.26007846916582,-0.1532573376016516,0.10476335958208693,0.25802069718373855,107028499,114487250,45.51116001306588,55.627183179105906,NaN,NaN,7.894827104320479,18.91740340292646
2010-01-11T09:30:00-05:00,30.8,31.10001,30.75,31.03999,8874543,8584286.4,52.530691900796086,55.12679883576972,NaN,NaN,-81.16220776495642,-126.15621301443623,-0.12777249280599684,0.09830508117624248,0.22607757398223932,115903042,112640166.2,43.357524099676134,53.27536114668292,NaN,NaN,7.395173821419025,17.271370605568254
2010-01-12T09:30:00-05:00,30.95,31.16,30.78999,30.91,8327488,8374420,49.95395982741875,54.196845283636314,NaN,NaN,-74.90717735407961,-115.65060572775887,-0.11545780481189188,0.08175531796737445,0.19721312277926634,107575554,112732461.6,43.501394102367925,51.62226845890806,NaN,NaN,6.224602047142676,15.693260811507457
2010-01-13T09:30:00-05:00,30.99001,31.25999,30.86,31.25,7859430,8076737.4,56.0293316888008,54.06265246255435,NaN,NaN,-28.42415197564687,-97.68667532022975,-0.08178665673682625,0.09497980185823351,0.17676645859505977,115434984,111847632,42.38978147751711,50.51599270702827,NaN,NaN,7.042814392273919,14.457482751616952
2010-01-14T09:30:00-05:00,31.21001,31.28999,30.97,31.11,4816570,7974430.95,53.16725550493847,53.655498964554,NaN,NaN,-22.02257911188716,-72.99148413773973,-0.06694086074546302,0.093090382663231,0.160031243408694,110618414,111312098.6,41.69531834935976,49.6515468225851,NaN,NaN,6.865182343021894,13.372868407531945
2010-01-15T09:30:00-05:00,30.89,31.03999,30.58,30.91,12710625,7991220,49.293418624429265,52.752403439831404,NaN,NaN,-90.32803862786224,-59.368830966886456,-0.06834915995655272,0.07459479346300313,0.14294395341955585,97907789,109487956.6,39.3316479217445,48.74846192814159,NaN,NaN,5.539574603733534,12.253826435560743
2010-01-19T09:30:00-05:00,30.92,31.3,30.84,31.27,5897371,7840808.45,55.56882777598242,52.27868451234334,NaN,NaN,-1.1793185227869205,-43.372253118452555,-0.043977712475588016,0.08797181282507083,0.13194952530065884,103805160,107068380.2,36.385256453789644,47.488527667639445,NaN,NaN,6.366186615403595,11.41273503268115
2010-01-20T09:30:00-05:00,31.16,31.16,30.655,30.94,9519680,7757746.95,49.51896658214882,51.40578927664344,NaN,NaN,-61.86291089386001,-40.763399826408644,-0.04865956468527219,0.0711250694440686,0.11978463412934079,94285480,104410365.4,33.423164038534935,45.99812194789997,NaN,NaN,5.099733245978946,10.510877634580835
2010-01-21T09:30:00-05:00,30.98,31.16,30.395,30.49001,12905219,8136209.45,42.69326699008886,50.06288824012124,NaN,NaN,-117.01898345664036,-58.482366122607345,-0.07885260834662702,0.021218873696057017,0.10007148204268404,81380261,97599420.8,27.291997383722162,43.93715104003218,NaN,NaN,1.619488685975386,9.240679213351484
2010-01-22T09:30:00-05:00,30.5,30.5,29.82001,29.82001,12704254,8235869.2,34.96523847683122,48.87794396576349,NaN,NaN,-241.0201369976211,-102.28187769975413,-0.13731360650747126,-0.07157052609165504,0.06574308041581622,68676007,89210939.4,21.95111684905264,41.51027578244627,NaN,NaN,-4.432078931787532,7.287428049760196
2010-01-25T09:30:00-05:00,30.10001,30.13499,29.75,30.02,7476738,8349403.35,38.54134571843409,47.869945944698564,NaN,NaN,-215.71626336967608,-127.3595226481169,-0.15459409395185347,-0.12749953702400063,0.02709455692785285,76152745,84859930.6,19.78804147129405,38.850583442785656,NaN,NaN,-7.852751361897134,5.124545276666292
2010-01-26T09:30:00-05:00,30,30.25999,29.84,30.14,7540863,8626791.2,40.650178050527344,47.50492865914044,NaN,NaN,-164.15559445923134,-159.9547778354058,-0.14990998708923348,-0.16029292693368902,-0.010382939844455527,83693608,80837620.2,18.02019397669156,36.473705281665445,NaN,NaN,-9.799984752368507,2.9924695582327496
2010-01-27T09:30:00-05:00,30.14999,30.14999,29.57001,29.94,14299180,8861375.2,38.291877774257514,46.722805305469315,NaN,NaN,-172.0447137210162,-181.99113840083703,-0.15178442389914648,-0.20011346971838861,-0.04832904581924215,69394428,75859409.8,16.102743287184566,34.04470186288001,NaN,NaN,-12.154652578778801,0.8285949672310999
2010-01-28T09:30:00-05:00,29.89999,30.12,29.55,29.71001,14063668,9331744.75,35.72518009765781,45.93679362289185,NaN,NaN,-157.7946083178308,-190.14626337307513,-0.1592393120809521,-0.24737818592043226,-0.08813887383948017,55330760,70649509.6,14.378426898218152,31.65198330872993,NaN,NaN,-14.930013917736796,-1.4226348734785992
2010-01-29T09:30:00-05:00,29.71001,29.88811,29.48,29.53,9572793,9694647.15,33.81468569114374,45.05315890738965,NaN,NaN,-152.0259606678118,-172.34742810711325,-0.16624857607361,-0.29594959393149267,-0.12970101785788268,45757967,66065901.6,13.054012595827373,29.33361563607003,NaN,NaN,-17.811121855337042,-3.7638472994583765
2010-02-01T09:30:00-05:00,29.56,29.74001,29.35001,29.72,6690426,9753823.35,37.607366655779124,43.98720710417415,NaN,NaN,-130.40544037453324,-155.28526350808468,-0.14861900633424935,-0.3154747757756944,-0.16685576944144503,52448393,61325031.2,11.839299297919766,27.082313864516003,NaN,NaN,-19.020946277174126,-5.943432867703484
2010-02-02T09:30:00-05:00,29.78999,29.98,29.47,29.96001,6553883,9670640.15,42.11945609039352,43.427599694386636,NaN,NaN,-89.73139104613627,-140.40042282546568,-0.11294020997692278,-0.3080310319125985,-0.19509082193567573,59002276,56386764.8,10.720281339599893,24.740805810032576,NaN,NaN,-18.635537664033063,-7.756590695750567
2010-02-03T09:30:00-05:00,29.7999,29.91,29.655,29.75,3982400,8968540.95,39.432306257524004,42.24209787786686,NaN,NaN,-83.04682179709039,-122.6008444406805,-0.09628066099577931,-0.3154416481803999,-0.21916098718462057,55019876,53511854.4,10.120559242932615,22.43586136470511,NaN,NaN,-19.13135595218158,-9.381557160954998
2010-02-04T09:30:00-05:00,29.61,29.67,28.97,28.97,7240793,8693327.85,31.4156319473815,40.688410480898504,NaN,NaN,-134.090596507037,-117.86004207852174,-0.12857131598961058,-0.3798751321716338,-0.25130381618202324,47779083,52001519,9.810067791610223,20.158343467723,NaN,NaN,-22.391256893679074,-11.240085694201294
2010-02-05T09:30:00-05:00,29.03,29.03,28.46001,28.92,9988242,8864587.4,30.980826332085314,39.38036817430251,NaN,NaN,-156.52558802235924,-118.75996754943124,-0.14297034639602668,-0.43001674917705657,-0.2870464027810299,37790841,50408093.8,9.479637518053607,18.02605701031651,NaN,NaN,-25.051888706288423,-13.21320041021374
2010-02-08T09:30:00-05:00,28.95,29.12,28.58,28.59,5124680,8807442.3,28.20609506473717,37.425887266356426,NaN,NaN,-142.65343797189053,-121.2095670689027,-0.16294351969182524,-0.49072580239581143,-0.3277822827039862,32666161,46451647.4,8.696379923157721,16.04828011527137,NaN,NaN,-28.20869581706294,-15.355414039763627
2010-02-09T09:30:00-05:00,28.84,29.21001,28.74001,28.88,8715254,8799477.85,33.81593071687075,36.304241847407994,NaN,NaN,-115.18241576656013,-126.29977201298746,-0.14542509820490984,-0.5095636554601235,-0.36413855725521366,41381415,42927475.2,8.057731024515704,14.236463471412856,NaN,NaN,-29.009253505753385,-17.30596253490502
2010-02-10T09:30:00-05:00,28.94,28.94,28.5,28.75,6572164,8711711.65,32.586701149446796,35.582344287362126,NaN,NaN,-125.61844957537558,-134.8140975686445,-0.1317979816313819,-0.528886034294441,-0.39708805266305913,34809251,38885350.2,7.387593474068325,12.814720335009014,NaN,NaN,-30.03725518794636,-19.12471862819664
2010-02-11T09:30:00-05:00,28.78,28.96001,28.45,28.92,8109949,8724237.6,35.86966006256928,35.64694582920056,NaN,NaN,-111.76878546271111,-130.34973535977932,-0.10187852215355997,-0.5244362053550091,-0.42255768320144915,42919200,37913373.6,7.231842454772831,11.763343592560457,NaN,NaN,-29.87816719666278,-20.660925566548944
2010-02-12T09:30:00-05:00,28.75,28.83,28.55,28.81,10063332,8986575.7,34.69237312972706,35.37201921572149,NaN,NaN,-105.50069995256908,-120.1447577458213,-0.0809525093929021,-0.5237483199425768,-0.44279581054967465,32855868,36926379,7.06886730522497,10.854831152126954,NaN,NaN,-30.09189034905699,-22.008206249764378
2010-02-16T09:30:00-05:00,28.85001,29.32001,28.85001,29.31,6014367,8651762.8,43.732502859852524,35.59218527353043,NaN,NaN,-52.3268215696561,-102.0794344653744,-0.027647108897367267,-0.47735469667138375,-0.4497075877740165,38870235,38167193.8,9.820295057522273,10.269124086472004,NaN,NaN,-27.407073774282033,-22.779473038981184
2010-02-17T09:30:00-05:00,29.45,29.49001,29.13,29.19,6447512,8679269.85,42.22191962687743,35.87290254871757,NaN,NaN,-32.038992979070706,-85.45074990787653,0.003654769147094561,-0.4451391263401483,-0.44879389548724286,32422723,36375455.4,9.38805517536376,9.789503507056233,NaN,NaN,-25.675811023903965,-23.19323560825587
2010-02-18T09:30:00-05:00,29.03,29.44,29,29.35001,5526828,8479627.25,44.952341412590286,36.53198549978417,NaN,NaN,-25.243906550098583,-65.37584130282113,0.03738562351471236,-0.4020618660938524,-0.4394474896085648,37949551,37003515.4,10.869004752878979,9.538830496674862,NaN,NaN,-23.41049924177078,-23.22427327018657
2010-02-19T09:30:00-05:00,29.31,29.88,29.19,29.75999,5596570,8114194.8,51.30235714556826,37.78110488938592,NaN,NaN,33.989527397361805,-36.224178730806535,0.08673797808722844,-0.33102501699952924,-0.4177629950867577,43546121,37128899.6,11.181099582880123,9.405050995750061,NaN,NaN,-19.389836938499663,-22.676496651374155
2010-02-22T09:30:00-05:00,29.99001,30.06,29.58,29.60001,5657883,7761876.25,48.93042301116367,38.589894629056246,NaN,NaN,59.730040666899995,-3.1780306069127193,0.10672324530496557,-0.2843589384555507,-0.3910821837605163,37888238,38135373.6,13.790597088494394,9.544429409362534,NaN,NaN,-16.782877729907305,-21.834551091164606
2010-02-23T09:30:00-05:00,29.50999,29.64999,29.3199,29.39999,5544285,7665253.6,46.06288704612672,38.87156826875148,NaN,NaN,18.12719090117304,10.91277188725311,0.10445562724890978,-0.26051264969937904,-0.3649682769482888,32343953,36830117.2,13.247036234397484,9.724911901848074,NaN,NaN,-15.446283310506512,-20.92194140821345
2010-02-24T09:30:00-05:00,29.48,29.53,29.11,29.42999,4990730,7537746.95,46.56866332553189,39.381308059323466,NaN,NaN,7.8744346395243445,18.89545741097212,0.10280046762646816,-0.2364676924152036,-0.33926816004167176,37334683,37812509.2,15.932785281003518,10.140070904567425,NaN,NaN,-14.217215824688653,-19.964123467709907
2010-02-25T09:30:00-05:00,29.06,29.38,28.89999,29.37,7381375,7191856.7,45.64688977385782,40.397826475500345,NaN,NaN,-13.390411424739417,21.26615643604395,0.09563869666028402,-0.21971978921631674,-0.31535848587660076,29953308,36213260.6,15.112556700021258,10.51882011231107,NaN,NaN,-13.449035694407332,-19.033396642952397
2010-02-26T09:30:00-05:00,29.3,29.435,29.1082,29.14,8315680,6904457.3,42.19817118855969,41.19906539381994,NaN,NaN,-5.750555469184778,13.318139862734634,0.07433329929189353,-0.22244186176173386,-0.2967751610536274,21637628,31831562,13.11969110378216,10.778823939863111,NaN,NaN,-13.741485726618816,-18.277409369190458
2010-03-01T09:30:00-05:00,29.24001,29.61,29.23,29.56,4933551,6672495.2,49.67528554795638,42.73257899976418,NaN,NaN,50.98025678774508,11.568183086903652,0.08659187589404371,-0.18853531618607278,-0.2751271920801165,26571179,29568150.2,12.223036979467864,11.030728015313835,NaN,NaN,-11.759060175798801,-17.346216627277364
2010-03-02T09:30:00-05:00,29.58,29.78,29.58,29.64999,4715438,6573745.8,51.13386496019453,43.96957430285874,NaN,NaN,95.90178542311814,27.123101991292675,0.09798725865950919,-0.15264311875573,-0.2506303774152392,31286617,29356683,12.139559678733931,11.32228720490085,NaN,NaN,-9.697656242764001,-16.253565143775454
2010-03-03T09:30:00-05:00,29.71001,29.84,29.55,29.60001,3626675,6427385.4,50.262540552481894,45.23213426021839,NaN,NaN,98.32805411758362,45.21382588690453,0.09908835226861576,-0.12676993707946949,-0.22585828934808524,27659942,27421734.8,11.37410824556629,11.60703826000785,NaN,NaN,-8.238268486387847,-15.108522764148653
2010-03-04T09:30:00-05:00,29.66,29.67999,29.46001,29.66,5413242,6498927.5,51.33445504820111,46.3367624734778,NaN,NaN,88.21343726620817,65.53459562509404,0.10047164981327483,-0.1002687270814917,-0.20074037689476654,33073184,28045710,13.273220323341562,12.0385652506199,NaN,NaN,-6.7223851645213255,-13.910503107059034
2010-03-05T09:30:00-05:00,29.78999,30.00999,29.67999,29.96001,5190414,6396408.55,56.395596215461985,47.88699269388744,NaN,NaN,134.54632362449013,93.59397144382902,0.11704783303072111,-0.054430585606365156,-0.17147841863708627,38263598,31370904,22.77066194553369,13.160122010641953,NaN,NaN,-3.8986374193751496,-12.48023658024705
2010-03-08T09:30:00-05:00,30.075,30.075,29.94501,29.96001,3484323,6071212.6,56.39559621546199,48.79149936214526,NaN,NaN,139.7010221354965,111.33812451337931,0.12286495872790787,-0.017897220227201416,-0.14076217895510929,38263598,33709387.8,28.6853799768449,14.507628076307855,NaN,NaN,-1.5828194971389506,-10.923462711231608
2010-03-09T09:30:00-05:00,29.92999,30,29.86,29.92,3937125,6011834.85,55.50281699567542,49.740134888487965,NaN,NaN,113.96953604699198,114.95167463815407,0.1188001934442712,0.00773806285022971,-0.11106213059404149,34326473,34317359,30.182475473844292,15.992943811913607,NaN,NaN,0.13765764015372042,-9.343302661033704
2010-03-10T09:30:00-05:00,29.97,30,29.78999,29.92999,3848150,5768479.65,55.69142853058403,50.50721253977324,NaN,NaN,99.8805956833485,115.26218295130704,0.11167484556998677,0.02853142636844197,-0.0831434192015448,38174623,36420295.2,35.24613396072232,17.734167326759557,NaN,NaN,1.6362392836065436,-7.77479666894224
2010-03-11T09:30:00-05:00,29.89999,30.03999,29.78999,30.03,3665144,5623128.65,57.6277603142962,50.95902705182523,NaN,NaN,101.6079076191128,117.94107702188799,0.10849504286518405,0.052475384379935264,-0.056019658485248786,41839767,38173611.8,39.20513649626648,19.7358842491443,NaN,NaN,3.4464879523310405,-6.171756008760342
2010-03-12T09:30:00-05:00,30.07001,30.13,29.77,29.84,5719227,5503592.55,52.8981299353995,51.242434689270645,NaN,NaN,86.06773936995978,108.2453601709819,0.08919987911412279,0.055480190407404706,-0.033719688706718084,36120540,37745000.2,38.584100579333324,21.50684878420422,NaN,NaN,3.848353309342798,-4.740311820459894
2010-03-15T09:30:00-04:00,29.83,29.9693,29.75,29.95,3791862,5190019.05,55.191025293280106,51.89444456406732,NaN,NaN,76.14786656101953,95.5347290560865,0.07975739821078219,0.06597705905675966,-0.013780339154022533,39912402,38074761,39.37973103197405,23.373469841173975,NaN,NaN,4.801735469166194,-3.377162207656167
2010-03-16T09:30:00-04:00,29.91,30.32001,29.89,30.3,5529172,5165759.3,61.59682378193078,52.96788459666725,NaN,NaN,138.13748519592536,100.3683188858732,0.09211983456257665,0.10136945404919828,0.009249619486621632,45441574,40297781.2,44.590961269385105,25.420482411772664,NaN,NaN,7.5559162138837745,-1.8152938617218897
2010-03-17T09:30:00-04:00,30.38,30.45,30.24001,30.39999,5891027,5137935.05,63.214737412517835,54.22273085657152,NaN,NaN,166.0363763879951,113.59947502680252,0.10133609740897426,0.13591974124783945,0.0345836438388652,51332601,42929376.8,50.063637233311105,27.916988164150506,NaN,NaN,10.348784568789087,-0.07756837164889308
2010-03-18T09:30:00-04:00,30.34,30.5,30.1774,30.25999,4317039,5077445.6,59.43888514052979,55.454210424569396,NaN,NaN,137.44756540520294,120.76740658402055,0.09255070132236028,0.15027202049181554,0.05772131916945526,47015562,43964535.8,52.06906761463059,30.699086486353966,NaN,NaN,11.683458125361492,1.6025782707811618
2010-03-19T09:30:00-04:00,30.08,30.17,29.75,29.96001,5765973,5085915.75,52.23878302951844,55.63731738753811,NaN,NaN,44.31877510970498,112.41761373196957,0.06252226751971432,0.13587415356909816,0.07335188604938384,41249589,44990345.6,54.0388838616739,33.685932692225826,NaN,NaN,10.711095364835705,2.903794998503239
2010-03-22T09:30:00-04:00,29.84,29.88499,29.66,29.75999,5110215,5058532.35,48.05851478335143,55.4176495177636,NaN,NaN,-4.191081510632666,96.34982411763914,0.02698996212284041,0.10708933870293436,0.08009937658009395,36139374,44235740,52.33500022667343,36.55703558850722,NaN,NaN,8.580088183879562,3.714694024985571
2010-03-23T09:30:00-04:00,29.83,29.88,29.67999,29.88,5823207,5072478.45,50.61215591454027,55.442622043624915,NaN,NaN,2.8766407367025972,69.29765522579457,0.01023265017005312,0.09289018929266035,0.08265753912260723,41962581,43539941.4,50.74614322412643,39.36932380126152,NaN,NaN,7.557170574054292,4.2636192462811024
2010-03-24T09:30:00-04:00,29.78,29.88,29.53,29.57001,6599328,5152908.35,44.52315098743355,54.95610032499866,NaN,NaN,-46.27076232982916,26.836227482229738,-0.02134333136252453,0.05597837491945157,0.0773217062819761,35363253,40346071.8,44.12416967814202,41.572963040890116,NaN,NaN,4.700850236120285,4.326080816258129
2010-03-25T09:30:00-04:00,29.62,29.71001,29.35001,29.38,10484078,5308043.5,41.247465382683856,53.87409097980022,NaN,NaN,-109.86540021828313,-22.626365642467476,-0.0528466136992745,0.01126343915788297,0.06411005285715747,24879175,35918794.4,36.93017650941255,42.584356938310044,NaN,NaN,1.2418177056856687,3.885471800462063
2010-03-26T09:30:00-04:00,29.37,29.57001,29.3,29.45,8272516,5305885.3,42.91376832322478,52.91110327321185,NaN,NaN,-132.99390531029601,-58.088901726467654,-0.06593919658007599,-0.018313942867937527,0.047625253712138466,33151691,34299214.8,34.70128331615058,43.01406431968901,NaN,NaN,-1.0709852179060981,3.1774065121237545
2010-03-29T09:30:00-04:00,29.56,29.82001,29.53,29.81,8611273,5489771.4,50.663471756800355,52.56543575614934,NaN,NaN,-47.7910107370633,-66.80888757175379,-0.04814856361307209,-0.01256045080420165,0.03558811280887044,41762964,35423932.8,37.521388302911625,43.53827237890811,NaN,NaN,-0.678303134133133,2.6265908483727705
2010-03-30T09:30:00-04:00,29.77,29.94,29.72,29.73,5566000,5532299.5,49.069297763776405,52.09242641566309,NaN,NaN,-23.65407496982468,-72.11503071305926,-0.03990357540158415,-0.014291356443109748,0.025612218958474403,36196964,34270809.4,35.81363228836416,43.57880797373967,NaN,NaN,-0.8537166600614065,2.1294040614536023
2010-03-31T09:30:00-04:00,29.69,29.82001,29.5,29.66,6036824,5652806.95,47.65626095662264,51.38017646154355,NaN,NaN,-74.00491034460318,-77.66186031601406,-0.03734470334104232,-0.021068660217828494,0.016276043123213825,30160140,33230186.8,34.29658220325604,43.22819695281036,NaN,NaN,-1.418512665115496,1.622558814800874
2010-04-01T09:30:00-04:00,29.8,30.12,29.75999,30.07001,5285449,5646417.3,55.70267263511997,51.58050094009501,NaN,NaN,40.66112241695063,-47.55655578896731,-0.007765686085202344,0.006568935516710894,0.014334621601913239,35445589,35343469.6,39.86730167978002,43.31985417427084,NaN,NaN,0.6602941728338256,1.48509243737701
2010-04-05T09:30:00-04:00,30.14,30.25,30.02,30.25,3550173,5564405.25,58.70381147567545,51.831414238837525,NaN,NaN,102.2681309791641,-0.5041485310752847,0.02253681428837639,0.042505639462383726,0.019968825174007335,38995762,36512283.8,42.7580500641498,43.5611626765691,NaN,NaN,3.3574030205288707,1.7525653778272758
2010-04-06T09:30:00-04:00,30.00999,30.5,30.00999,30.5,4025556,5591466.9,62.50371936400825,51.8961924947002,NaN,NaN,143.28285214634153,37.710624045605684,0.05612078140725067,0.09011980193307068,0.03399902052582,43021318,36763954.6,43.3891114467701,43.47531626066803,NaN,NaN,6.899710238807555,2.487871786538744
2010-04-07T09:30:00-04:00,30.41,30.44,30.10001,30.2,5835320,5686376.65,55.86111168638277,51.370933514261985,NaN,NaN,98.87811518187836,62.21706207594629,0.05477335554564235,0.10246571495787293,0.04769235941223059,37185998,36961761.4,43.9124905895227,43.03594864325458,NaN,NaN,7.748304041398195,3.2393621086615227
2010-04-08T09:30:00-04:00,30.07001,30.14,29.927,30.02,4774313,5732684.8,52.271606978606265,50.85898507412459,NaN,NaN,29.03370754640569,82.82478565414806,0.03913552368891306,0.0966117640233719,0.05747624033445885,32411685,37412070.4,45.15558171926114,42.542128222156755,NaN,NaN,7.273400366416784,3.8156532883408456
2010-04-09T09:30:00-04:00,30.05,30.24001,29.82001,30.24001,6605617,5879708.45,55.993756774305886,51.12719748446655,NaN,NaN,46.822317368499604,84.05702464445785,0.04079900912074416,0.10847500173538904,0.06767599261464488,39017302,38126413,47.15640962555971,42.050522919577176,NaN,NaN,8.08163913403972,4.425079837726399
2010-04-12T09:30:00-04:00,30.27,30.39999,30.25,30.32001,4633629,5825428.55,57.29782198994179,51.787147999223,NaN,NaN,99.52392047058244,83.50818254274152,0.04419132208602805,0.12291514522217994,0.0787238231361519,43650931,39057446.8,49.73050934618719,41.864487856685294,NaN,NaN,9.136754794415742,5.09817626011059
2010-04-13T09:30:00-04:00,30.32001,30.32001,30,30.16,5240520,5897861.45,53.859927067476185,52.019131653004145,NaN,NaN,49.87825735314264,64.82726358410174,0.03307180155025505,0.1200635750739707,0.08699177352371565,38410411,38135265.4,47.2741474624319,41.6164881594214,NaN,NaN,8.964997567540692,5.6505793040291765
2010-04-14T09:30:00-04:00,30.14999,30.25999,30.03999,30.19,4773199,5860062.8,54.41221026940874,52.725493030288085,NaN,NaN,50.92514092153905,55.23666873203388,0.02549006553410174,0.11885435544134282,0.09336428990724108,43183610,39334787.8,50.68619183992404,42.085204028120124,NaN,NaN,8.98650361734129,6.127139920216622
2010-04-15T09:30:00-04:00,30.13,30.22,30.02,30.17999,4765609,5803791.9,54.179179383456656,53.649186887486145,NaN,NaN,49.664066794202185,59.36274058159319,0.017911749701950114,0.11575397703467871,0.0978422273327286,38418001,40536051,53.90336736055057,43.297574803201414,NaN,NaN,8.939405802831493,6.528892189161604
2010-04-16T09:30:00-04:00,30.12,30.17999,29.75999,29.83,7691375,5972508.7,46.655560743138295,53.91645777462282,NaN,NaN,-6.132038471798092,48.77186941353364,-0.011004708432103855,0.08408634179259877,0.09509105022470263,30726626,38877915.8,49.13806247986345,44.32877331489518,NaN,NaN,6.63276909060836,6.54373174651114
2010-04-19T09:30:00-04:00,29.78,29.92,29.681,29.86,5285449,5948482.5,47.33071356611249,53.67840361814512,NaN,NaN,-33.97721254526127,22.071642810364906,-0.027504496224298666,0.06071042994432929,0.08821492616862796,36012075,37350144.6,45.17529277340852,44.87548077707353,NaN,NaN,4.943475130027234,6.315123658442011
2010-04-20T09:30:00-04:00,30.05,30.24001,30,30.24001,3634014,5874672.45,55.085319028575725,54.10811942277364,NaN,NaN,59.13739575397979,23.923470490532345,-0.012957300633120755,0.07201830037722701,0.08497560101034776,39646089,37597280.2,45.93484895320139,45.5984248245619,NaN,NaN,5.765630174937605,6.236624589369953
2010-04-21T09:30:00-04:00,30.27,30.32001,30.07001,30.27,5036340,5835329.1,55.640399593236324,54.67841503967462,NaN,NaN,70.06577361590689,27.7515970294059,-0.0020209717485716733,0.08244938632463317,0.08447035807320484,44682429,37897044,46.89588638451285,46.498375123223106,NaN,NaN,6.591936807606402,6.2873834776894455
2010-04-22T09:30:00-04:00,30.13,30.41,30.06,30.37,6454555,5828090.45,57.525374105208456,54.8086080018238,NaN,NaN,81.05731979670463,34.030247629906384,0.01055131625410552,0.09765950339083673,0.08710818713673121,51136984,40440840.6,54.31694559133487,47.530492545477024,NaN,NaN,7.831892415010873,6.508027611592507
2010-04-23T09:30:00-04:00,30.39,30.63,30.19,30.61,4490066,5528389.85,61.728647093642216,55.024667688821424,NaN,NaN,133.764731207365,62.00960156573901,0.03240035597682753,0.12760863210776563,0.0952082761309381,55627050,45420925.4,64.71342463080904,49.09873358595268,NaN,NaN,10.194497847907384,7.034666216780346
2010-04-26T09:30:00-04:00,30.60001,30.71001,30.48,30.5,5645445,5397036.3,58.853901484876936,54.763966411740626,NaN,NaN,159.60240910099864,100.725525894991,0.03650849188966701,0.14084389099302186,0.10433539910335485,49981605,48214831.4,68.97873283989588,50.92656368546166,NaN,NaN,11.335458100410948,7.649065057299003
2010-04-27T09:30:00-04:00,30.38,30.58189,29.95,29.98,6357199,5284332.6,47.57458020535332,54.172071305952805,NaN,NaN,13.92810241329011,91.68366722685306,0.0030331653168025052,0.10812685574935799,0.10509369043255548,43624406,49010494.8,70.08763673247014,52.79621698138647,NaN,NaN,8.681814334368926,7.796600668308992
2010-04-28T09:30:00-04:00,30.10001,30.33,29.965,30.28999,6939609,5353013.05,53.31818402188331,54.24682680904402,NaN,NaN,17.967028697405105,81.26391824315269,0.0007171940995833459,0.10599018305703467,0.10527298895745132,50564015,50186812,71.69837682113067,54.6921309172343,NaN,NaN,8.35511506963005,7.876388439926286
2010-04-29T09:30:00-04:00,30.38,30.55,30.22,30.32001,3278981,5215120.9,53.845540055761745,54.09338275771944,NaN,NaN,89.38372294385354,82.92919887258248,0.00018404423096637923,0.1055030442461593,0.10531900001519293,53842996,50728014.4,72.43385654294711,56.497662839904834,NaN,NaN,8.26759815951201,7.932275542724247
2010-04-30T09:30:00-04:00,30.35001,30.74001,30.33,30.44,4991461,5200421.5,55.98580711971721,53.99966740984625,NaN,NaN,140.50769234168735,84.27779109944694,0.006537536581410541,0.1134909207419561,0.10695338416054556,58834457,51369495.8,73.31891485579726,58.18254894773412,NaN,NaN,8.856613899059433,8.06432387934356
2010-05-03T09:30:00-04:00,30.56,30.91,30.46001,30.83,5653621,5305593.9,62.132300933477346,54.590551257417765,NaN,NaN,201.04642828015102,92.56659493527744,0.03409088932980238,0.14956699582279853,0.11547610649299615,64488078,54270790.4,76.92711212768094,60.30061785239476,NaN,NaN,11.413369440806202,8.542758959552508
2010-05-04T09:30:00-04:00,30.64999,30.7,30.14999,30.3,9340730,5571352.6,51.58877505280348,54.38887731337453,NaN,NaN,54.95721905261684,100.77241826314278,0.014697560840345653,0.1338480575434282,0.11915049670308256,55147348,56575378.8,79.319512110505,62.345855014579115,NaN,NaN,9.97059249083756,8.746735178307516
2010-05-05T09:30:00-04:00,30.06,30.47,29.95,30.09,9189410,5739057.1,48.10547379744424,53.955041200087926,NaN,NaN,-29.413001398994094,91.29641224386293,-0.012716253907780861,0.10325517931835648,0.11597143322613734,45957938,55654163.4,75.93029475145467,63.91920697107226,NaN,NaN,7.598371856532681,8.582683275196825
2010-05-06T09:30:00-04:00,29.99001,30.08,25.75999,29.25999,18174288,6409055.85,37.36641986895593,53.29153113764634,NaN,NaN,-487.1562960266205,-24.01159155023189,-0.08325868342062508,0.011898078950355995,0.09515676237098107,27783650,50442294.2,60.246011122523655,64.71263187411942,NaN,NaN,1.1256477150929605,7.517392480896273
2010-05-07T09:30:00-04:00,29.00999,29.6095,28.67999,29.10001,17669232,6962236.6,35.71161034343385,52.46159519316929,NaN,NaN,-204.10401227049456,-92.93393247266827,-0.1341858297382155,-0.0725755248017883,0.06161030493642719,10114418,40698286.4,42.549925699797164,64.52510565457575,NaN,NaN,-4.379555850939703,5.817828433491134
2010-05-10T09:30:00-04:00,29.78,30.19,29.63,30,9506258,7205868.05,49.311432159855,52.04917470254639,NaN,NaN,-31.070849571757986,-139.3573880430501,-0.10219816563133081,-0.06613740210273633,0.03606076352859448,19620676,31724806,32.95095110729392,63.59768437986808,NaN,NaN,-3.814164987396853,4.441829373364278
2010-05-11T09:30:00-04:00,29.85001,30.38,29.72,30.06,7226016,7305142.85,50.06976958736829,51.65127255927009,NaN,NaN,-6.975139934331668,-151.7438598404398,-0.073291220024949,-0.055553261502591766,0.017737958522357232,26846692,26064674.8,28.572464717188325,62.288868546487755,NaN,NaN,-3.122197406666783,3.361254119074127
2010-05-12T09:30:00-04:00,30.10001,30.39999,29.97,30.31,5227012,7327833.5,53.210795866636765,51.343088399372114,NaN,NaN,27.31410928802872,-140.3984377030352,-0.03553815730531393,-0.026684738109285178,0.00885341919602875,32073704,23287828,26.698130609794973,60.31609604780632,NaN,NaN,-1.4564196941025478,2.673015002906031
2010-05-13T09:30:00-04:00,30.3,30.59,30.14,30.17999,7051715,7442138.8,51.39990713198457,50.60532125925371,NaN,NaN,40.50213295169632,-34.86675190737182,-0.018389949466822108,-0.014134017637498886,0.004255931829323223,25021989,22735495.8,26.328172002931964,57.57429228867225,NaN,NaN,-0.7642036130659433,2.1819837720528916
2010-05-14T09:30:00-04:00,30.05,30.23,29.776,29.92999,7542617,7434700.9,48.015945492751,49.831181545530434,NaN,NaN,-24.72556780085705,1.0089369865556876,-0.022670969943163453,-0.024082780599631093,-0.0014118106564676401,17479372,24208486.6,29.14791341024153,54.72923375798265,NaN,NaN,-1.3098185731744407,1.6831548655918442
2010-05-17T09:30:00-04:00,30,30.10001,29.5,29.96001,8477203,7594288.6,48.45478609832474,49.894053395028386,NaN,NaN,-50.55452978356773,-2.887799055806255,-0.022237103458095688,-0.02920818997908725,-0.006971086520991563,25956575,25475666.4,31.574245926123524,51.97827727181504,NaN,NaN,-1.6031258666607768,1.2136861895557556
2010-05-18T09:30:00-04:00,30.10001,30.21001,29.62,29.67,7786906,7801933.2,44.54276823628151,49.26723798177112,NaN,NaN,-48.982056629877,-11.289182394915311,-0.03924366526091186,-0.05602566809713139,-0.01678200283621953,18169669,23740261.8,30.056219893179673,49.003837491247104,NaN,NaN,-3.0665922489031767,0.6022178412044795
2010-05-19T09:30:00-04:00,29.55,29.66,29.17,29.37,8552414,7977736.9,40.86714171145741,48.34020952860652,NaN,NaN,-112.7284283557061,-39.297689923662276,-0.06683813177585007,-0.10032966755603212,-0.03349153578018205,9617255,19248972,26.504628669582104,45.723178357435316,NaN,NaN,-5.467360533055512,-0.26486478368980493
2010-05-20T09:30:00-04:00,28.92,29.00999,28.45,28.49001,11225098,8216264.05,32.416935682176245,46.656718711639314,NaN,NaN,-191.37859486781687,-85.6738354875649,-0.13648361352546248,-0.20409605268701014,-0.06761243916154766,-1607843,13923005.6,23.029400845659126,42.13107021385402,NaN,NaN,-10.777162613834857,-1.7666216165676691
2010-05-21T09:30:00-04:00,28.065,28.64999,28,28.62,9875313,8485526.4,34.56918344196579,44.68792460510277,NaN,NaN,-178.352441701507,-116.39921026769488,-0.164069287858026,-0.27269904898408015,-0.10862976112605416,8267470,12080625.2,21.956898815446664,38.204626405837296,NaN,NaN,-14.19436091456498,-3.542012944852999
2010-05-24T09:30:00-04:00,28.61,28.82001,28.34,28.35001,6804188,8543463.55,32.270483544455374,43.308046640220766,NaN,NaN,-137.66203022452322,-133.820710355886,-0.1889984451827325,-0.3448778176044698,-0.15587937242173727,1463282,7181966.6,19.373423018448207,33.922762899261805,NaN,NaN,-17.75313123383787,-5.572172700422266
2010-05-25T09:30:00-04:00,27.82001,28.22,27.44,28.2,13531273,8902167.25,31.035642349673694,42.088772965380016,NaN,NaN,-158.8999595368917,-155.80429093728895,-0.2028681124998935,-0.40946451304660414,-0.20659640054671063,-12067991,1134434.6,16.75278990741056,29.69579826754437,NaN,NaN,-21.011179038347333,-7.777745034411561
2010-05-26T09:30:00-04:00,28.49001,28.53,28.05,28.19,7571254,8933749.5,30.950618758515304,41.63050145749139,NaN,NaN,-111.69559603154566,-155.59772447245686,-0.1996813462834503,-0.4561980834010235,-0.2565167371175732,-19639245,-4716865.4,14.683220246006343,26.441313204935987,NaN,NaN,-23.621596285301674,-10.041152355967291
2010-05-27T09:30:00-04:00,28.42,28.75,28.39,28.73,5422504,9040925.65,40.43950891065393,41.968208498007115,NaN,NaN,-71.21810117387385,-131.56562573366824,-0.15041616423784093,-0.4445369424148744,-0.29412077817703347,-14216741,-7238645,13.886986871412617,24.393960431479943,NaN,NaN,-23.000558395575688,-11.892496075911348
2010-05-28T09:30:00-04:00,28.77,29.02,28.64999,28.75999,7328945,9157799.85,40.92505043420606,41.36918123188933,NaN,NaN,-49.316915338450535,-105.75852046105697,-0.10705730394673901,-0.42794240811045725,-0.32088510416371824,-6887796,-10269698.2,12.976158948664064,22.96718956300638,NaN,NaN,-22.36051526214802,-13.387927388230873
2010-06-01T09:30:00-04:00,28.60001,28.7,28.07001,28.09,10813563,9415796.95,34.21454265434046,40.23666502238734,NaN,NaN,-85.48326001565296,-95.32276641928291,-0.11410043787840035,-0.46351065151171866,-0.3494102136333183,-17701359,-14102626.4,11.912161262428427,21.777167887666387,NaN,NaN,-23.93624773219509,-14.894830294511475
2010-06-02T09:30:00-04:00,28.24001,28.71001,28.09,28.67999,6126922,9255106.55,43.0674833703967,39.51214270122734,NaN,NaN,-61.18626478990974,-75.7800274698865,-0.07169631458602449,-0.43903060686584894,-0.36733429227982445,-11574437,-14003915.6,12.112028972386327,20.73530348499434,NaN,NaN,-22.28267164678648,-15.950236201979333
2010-06-03T09:30:00-04:00,28.73,29.00999,28.72,28.98,6986820,9144977.05,46.97511114841353,39.196085845257976,NaN,NaN,-19.158236647353515,-57.27255559304808,-0.01886493838089537,-0.3909154652559437,-0.3720505268750483,-4587617,-10993590,18.207060830854644,20.15522411556025,NaN,NaN,-19.61585229960157,-16.473895644496796
2010-06-04T09:30:00-04:00,28.64999,28.7,28.03011,28.11749,8889773,8680751.3,38.74225083891253,38.533679084269515,NaN,NaN,-78.96043238841847,-58.82102183595705,-0.0364137836306454,-0.4175677564133551,-0.3811539727827097,-13477390,-10845719.8,18.506028274197362,19.395089462985663,NaN,NaN,-20.185445781232943,-17.00411709260196
2010-06-07T09:30:00-04:00,28.34,28.67999,28.12,28.28999,7605281,8177553.75,40.97048975060488,37.999086488003805,NaN,NaN,-64.81753540668981,-61.92114584960491,-0.03102073412419709,-0.41992989043795603,-0.38890915631375894,-5872109,-10642582.4,18.944342261503678,18.492953486941385,NaN,NaN,-19.85924664149522,-17.411992742443854
2010-06-08T09:30:00-04:00,28.25,28.72,28.17,28.66,11029422,8253711.95,45.5460001838681,38.07074591283141,NaN,NaN,-46.33658801633824,-54.091811449741954,0.0011444672989033844,-0.3874785721901297,-0.3886230394890331,5157313,-6070848,28.292008349061575,18.366938376647234,NaN,NaN,-18.03612750500693,-17.501154851381436
2010-06-09T09:30:00-04:00,28.86,28.87,28.41499,28.5,6174141,8201118.2,43.959238393759705,38.291609961567296,NaN,NaN,-34.628731883477904,-48.78030486845559,0.014577173399035637,-0.37040157274023855,-0.3849787461392742,-1016828,-3959326.2,32.182130679237176,18.77247423447974,NaN,NaN,-17.09777405251923,-17.443529022972548
2010-06-10T09:30:00-04:00,28.71001,29.25,28.71001,29.2,6190715,8249303.35,51.86095893393719,39.6804687652645,NaN,NaN,24.838653249121787,-39.98092688916053,0.07041451624556527,-0.29696060083231757,-0.36737511707788284,5173887,-2007025.4,35.65771648813043,19.67449678037055,NaN,NaN,-13.5570482951861,-16.88831749043163
2010-06-11T09:30:00-04:00,28.92999,29.25,28.87,29.22,6026031,8198019.15,52.06890543768846,40.93044890781612,NaN,NaN,46.30588613872807,-14.927663183731221,0.10634667778963258,-0.23444176984084208,-0.34078844763047467,11199918,2928436.2,43.5358350473596,21.215849368364328,NaN,NaN,-10.755168016892123,-16.012153279925986
2010-06-14T09:30:00-04:00,29.38,29.60001,29.33,29.39,5408938,8091335.2,53.892100495965984,42.47485011863831,NaN,NaN,105.0870539603379,19.053254689674322,0.13724929801978608,-0.16922682510574205,-0.30647612312552813,16608856,7424629.2,49.59112443904549,23.374256612692704,NaN,NaN,-7.908549449934451,-14.854495589927195
2010-06-15T09:30:00-04:00,29.59,29.96001,29.53999,29.96001,4782504,7906600.25,59.460297388421466,44.50518262140601,NaN,NaN,165.52218026425612,61.425008345793195,0.18859441756699813,-0.07073310116678044,-0.2593275187337786,21391360,10671438.6,53.47153148641695,25.99702386833602,NaN,NaN,-3.589016091098076,-13.24514137580875
2010-06-16T09:30:00-04:00,29.71001,30.25,29.71001,30.14999,6336473,7834078.6,61.144527888440464,46.66189041640066,NaN,NaN,192.4219978519552,106.83515429287982,0.22537843203167407,0.022395521305814015,-0.20298291072586006,27727833,16420370.8,59.427078183720376,29.193013721029878,NaN,NaN,0.4589311414282449,-11.287416730489179
2010-06-17T09:30:00-04:00,30.25999,30.39,29.92999,30.37,7351910,7774053.4,63.05858007598305,48.27753835678131,NaN,NaN,193.22433472404293,140.51229058786404,0.2525103105136385,0.11265497741618802,-0.13985533309745043,35079743,22401542,64.51593234627794,32.809366969234546,NaN,NaN,4.403656724543454,-9.04583480834166
2010-06-18T09:30:00-04:00,30.09,30.14999,29.95,30.08,4794617,7452529.35,58.93730042847441,49.56412764208619,NaN,NaN,140.73009510453966,159.39713238102635,0.2390469504523648,0.15895335496800556,-0.08009359548435924,30285126,26218583.6,67.33193150898558,36.69192215211466,NaN,NaN,6.5096481549343,-6.823622956445094
2010-06-21T09:30:00-04:00,30.24001,30.34,29.72,29.87,6213262,7269426.8,56.079086020265265,51.12588073965225,NaN,NaN,112.25404721281662,160.8305310315221,0.205405629665315,0.17666344159728453,-0.02874218806803048,24071864,27711185.2,68.38837821428868,40.7259376486761,NaN,NaN,7.425388165412644,-4.788049939036846
2010-06-22T09:30:00-04:00,29.87,29.88,29.06,29.13,10656699,7462052.35,47.362671696452,51.432679905799056,NaN,NaN,38.61745936821013,135.44958685231293,0.12658916483006002,0.12949426796954455,0.0029051031394845273,13415165,26115946.2,65.93422550102454,44.57038025786454,NaN,NaN,5.454305867669299,-3.3248562523645395
2010-06-23T09:30:00-04:00,29.12,29.14,28.7025,28.87,12423430,7406660.2,44.731914674543475,51.27245158623691,NaN,NaN,-18.135118095751853,93.3381636627715,0.05393344053753577,0.07032190381140424,0.01638846327386847,991735,20768726.6,58.37259850294432,47.43934723444238,NaN,NaN,2.993825181865945,-2.422187476045899
2010-06-24T09:30:00-04:00,28.75999,29.12,28.69,28.71001,7415074,7398851.2,43.1438520049941,51.58685166952846,NaN,NaN,-30.552916540949024,48.58271340977312,-0.004792638473070293,0.010397665182530602,0.015190303655600895,-6423339,12468110.2,48.981735270351244,49.61618344845336,NaN,NaN,0.4986088465133589,-2.0049308585374335
2010-06-25T09:30:00-04:00,28.78999,28.96001,28.5,28.84,3897616,7322606.8,44.85679894712516,51.864445183565614,NaN,NaN,-41.021112748751506,12.232471839114885,-0.03319259803468542,-0.026300443887755875,0.006892154146929541,-2525723,5905940.4,43.0810246573215,51.340232191011786,NaN,NaN,-1.0539234552156216,-1.869072658062889
2010-06-28T09:30:00-04:00,28.92999,29.175,28.67,29.03,6479234,7280121.25,47.3534878067224,51.99355144234092,NaN,NaN,-18.021144560569468,-13.822566515562325,-0.03719060998051658,-0.039596108328716184,-0.0024054983481996053,3953511,1882269.8,39.90653572581435,52.16984128935127,NaN,NaN,-1.6452171486243912,-1.8370932995716749
2010-06-29T09:30:00-04:00,28.75999,28.77,28.32001,28.44,8740609,7176473.55,41.12650896417328,51.79121362594189,NaN,NaN,-77.86990032798221,-37.120038454800806,-0.07537738436720359,-0.09662722880720409,-0.021249844440000505,-4787098,-1758182.8,37.23330166305684,52.530639216766964,NaN,NaN,-4.110987597569178,-2.1619353421427467
2010-06-30T09:30:00-04:00,28.34,28.74001,28.14999,28.25999,6475098,7193882.35,39.42315051332437,50.902798738755266,NaN,NaN,-92.77661484829055,-52.04833780530854,-0.10665479459656749,-0.15456833768570988,-0.047913543089142384,-11262196,-4208969,35.50879975381304,52.52000230717287,NaN,NaN,-6.664113542114211,-2.8051036564243845
2010-07-01T09:30:00-04:00,28.21001,28.31,27.91499,28.13,9990461,7344064.4,38.19297881625914,49.91166112293888,NaN,NaN,-114.83023221613625,-68.90380094034597,-0.1285266883059638,-0.20857190347159715,-0.08004521516563334,-21252657,-7174832.6,33.48743606852017,51.80225952297004,NaN,NaN,-9.135572446481598,-3.709456340718272
2010-07-02T09:30:00-04:00,28.17999,28.34,28.08,28.16,6037172,7201434.35,38.66863487008647,48.82427072109034,NaN,NaN,-104.5264437159299,-81.60486713378165,-0.13285369931082558,-0.24611233930416532,-0.11325863999333974,-15215485,-9712785,31.818261003836767,50.53276927759799,NaN,NaN,-11.03016535298891,-4.755271913899792
2010-07-06T09:30:00-04:00,28.39999,28.64999,28.23,28.49001,8784820,7260411.3,43.79295764144101,47.705175024877455,NaN,NaN,-73.89178807839242,-92.77899583734624,-0.10650835089422267,-0.24639407861111806,-0.1398857277168954,-6430665,-11789620.2,30.479417249716036,48.89047540354793,NaN,NaN,-11.259875904259236,-5.684501055379712
2010-07-07T09:30:00-04:00,28.5,29.41,28.49001,29.37,7444102,7081145.3,54.6692741881713,47.242656903429655,NaN,NaN,-0.6476579111926628,-77.33454735398834,-0.026978035689662366,-0.17360827232897336,-0.146630236639311,1013437,-10629513.2,32.19570983138743,46.945377664095574,NaN,NaN,-7.955524147968557,-6.008932925749547
2010-07-08T09:30:00-04:00,29.46001,29.64,29.36,29.60001,6385543,7091715.4,57.010826505519994,46.81067450553944,NaN,NaN,49.06206263174544,-48.96681185798114,0.0402997590651496,-0.09625553780787399,-0.1365552968730236,7398980,-6897278,37.538249021598396,45.018400283761316,NaN,NaN,-4.498586387094444,-5.793169134513104
2010-07-09T09:30:00-04:00,29.55,29.84,29.46001,29.8,7266672,7145513.25,58.994192257883945,46.81473820764012,NaN,NaN,62.75448018948922,-13.449869376856048,0.09436344062997373,-0.01860099608555643,-0.11296443671553016,14665652,286383.8,46.30755598672395,43.516659175028344,NaN,NaN,-1.0354540630906062,-5.113495552881318
2010-07-12T09:30:00-04:00,29.75999,29.92999,29.63,29.89999,4138676,7051145.5,59.988144186615024,47.09395664809368,NaN,NaN,69.23746866385608,21.302913099101133,0.1307138247728779,0.05042784425056723,-0.08028598052231067,18804328,7090346.4,53.033321052297005,42.41986937774322,NaN,NaN,2.0865140312242745,-4.084922755151948
2010-07-13T09:30:00-04:00,30.05,30.19,29.83,30,8834473,7222422.25,61.00623546440217,48.06849691723297,NaN,NaN,83.19020033928675,52.71931078263697,0.15375966315831868,0.11191359842558768,-0.041846064732731,27638801,13904239.6,58.62321253107691,41.897654165604095,NaN,NaN,4.9637372405029065,-2.7922570414869687
2010-07-14T09:30:00-04:00,29.83,30.05,29.71001,30.00999,6321406,7299367.35,61.1126774111185,49.23855139841691,NaN,NaN,72.99934044337537,67.44871045355058,0.16116305361367173,0.15960775228435864,-0.0015553013293130719,33960207,20493593.6,63.18626635366037,42.24148758351239,NaN,NaN,7.35674502953408,-1.3423996027696763
2010-07-15T09:30:00-04:00,30,30.28999,29.81,30.21001,7766523,7370869.85,63.274302229092584,50.67644070013823,NaN,NaN,91.47048309830815,75.93039454686313,0.17013391024597824,0.2111120864781597,0.04097817623218149,41726730,27359143.6,67.24003890820714,43.54565212907357,NaN,NaN,10.03288054818192,0.28264041879483726
2010-07-16T09:30:00-04:00,30.08,30.17999,29.66,29.69,8235141,7415031.4,54.75304784842244,51.38331562165946,NaN,NaN,67.87824504017955,76.95514751700118,0.13327855510819564,0.20757637011742602,0.0742978150092304,33491589,31124331,69.24047673475906,45.4141844203191,NaN,NaN,10.033624179960345,1.6756380989613382
2010-07-19T09:30:00-04:00,29.8,30.25,29.75,30.14999,6944246,7522512.85,59.89781349382999,52.27933888502429,NaN,NaN,90.77684417082106,81.26302261839419,0.13186977860582444,0.23913503826651095,0.10726525966068651,40435835,35450632.4,71.40140910316077,47.66381823298671,NaN,NaN,11.610755025401035,3.0949405170241517
2010-07-20T09:30:00-04:00,29.69,30.44,29.69,30.42,6744465,7549073,62.586965446630245,53.81222863377122,NaN,NaN,102.58610393958087,85.14220333845302,0.1403274435978966,0.28267456415805725,0.14234712056016066,47180300,39358932.2,73.2309823076995,50.235081136175474,NaN,NaN,13.769366647975145,4.619858535731437
2010-07-21T09:30:00-04:00,30.39999,30.42,29.8,29.95,6617914,7347133.75,55.59805348039862,54.96757884570509,NaN,NaN,80.47960046628332,86.6382553430346,0.10698029416844246,0.27607248827071373,0.16909219410227128,40562386,40679368,73.83990009090324,52.97301687453906,NaN,NaN,13.442086160612703,5.880176767857332
2010-07-22T09:30:00-04:00,30.2,30.58,30.2,30.42999,5530852,7002504.85,60.45473056567883,56.55770397066364,NaN,NaN,103.46554034179054,89.03726679173107,0.10956112234990334,0.30604359703965045,0.1964824746897471,46093238,41552669.6,74.25697820012934,55.88512702679686,NaN,NaN,14.742805738019948,7.1462666207377055
2010-07-23T09:30:00-04:00,30.45,30.52,30.2128,30.48,7142160,6988859.15,60.93418076544346,58.148100106046286,NaN,NaN,94.2525978131559,94.31213734632634,0.10683558853131778,0.33002696035389434,0.22319137182257656,53235398,45501431.4,76.11156458971132,59.0489344257879,NaN,NaN,15.91863531976127,8.399462149169644
2010-07-26T09:30:00-04:00,30.45,30.7,30.45,30.7,5062199,7047088.3,63.05616175468763,59.52404325699247,NaN,NaN,105.96427049353406,97.34962261086895,0.1115318715544018,0.3626062112655788,0.251074339711177,58297597,49073783.8,77.6782905352422,62.4202825176112,NaN,NaN,17.54454393979168,9.705902404972791
2010-07-27T09:30:00-04:00,30.82001,31.2,30.72,31.14999,21684640,7807358.6,67.00409225314993,60.405101690205235,NaN,NaN,132.39119160166052,103.31064014328486,0.1350570394786249,0.41989563905945815,0.28483859958083324,79982237,55634171.2,80.24116084778704,65.85210044735402,NaN,NaN,20.215006277277283,11.207202958159147
2010-07-28T09:30:00-04:00,31.14,31.14999,30.94,31,8070047,7773830.5,64.52880704508024,60.94210030017383,NaN,NaN,126.649398521116,112.54459975425138,0.1305534152571542,0.44803036865227597,0.3174769533951218,71912190,61904132,82.32935813585411,69.05146538408657,NaN,NaN,21.64929443412898,12.698930311869123
2010-07-29T09:30:00-04:00,31.03,31.19,30.41,30.52,8314199,7865785.55,57.241031542563256,60.81687453479378,NaN,NaN,91.4398342340486,110.13945853270302,0.08735994967219674,0.4266768904853677,0.339316940813171,63597991,65405082.6,83.38522784738632,71.69987051699103,NaN,NaN,20.605999961562286,13.828511690396718
2010-07-30T09:30:00-04:00,30.35001,30.53,30.1714,30.37,9082434,7820384.2,55.145072616848225,60.47094085123901,NaN,NaN,48.603506600824815,101.00964029023679,0.0430414319705979,0.39311873077641835,0.35007729880582045,54515557,65661114.4,83.46305049776466,73.87342262023871,NaN,NaN,19.109008842851857,14.582868426461738
2010-08-02T09:30:00-04:00,30.78,31,30.64,31,7628039,7899927.55,61.5183519437153,60.50752059976138,NaN,NaN,111.19491562638862,102.05576931680771,0.050020680976897824,0.4126031500269427,0.3625824690500449,62143596,66430314.2,83.70991851034955,75.66533019018676,NaN,NaN,19.815506906820325,15.330388209370108
2010-08-03T09:30:00-04:00,30.89999,31.12,30.81,30.85001,4248340,7673103.55,59.356012109142235,60.38204450676307,NaN,NaN,108.77670962344787,97.33287292116518,0.03889536573601465,0.4112016762200632,0.37230631048404855,57895256,62012918,76.63459710506018,76.62592524385818,NaN,NaN,19.705908572222103,15.955462546920392
2010-08-04T09:30:00-04:00,30.91,30.98,30.66,30.98,5127805,7557288.7,60.64702088273783,60.19438155345201,NaN,NaN,91.86125761324564,90.37524473959111,0.03478468688676678,0.415787169092507,0.38100248220574023,63023061,60235092.2,73.92642360015752,77.10352415042607,NaN,NaN,20.00403216040357,16.533829634560846
2010-08-05T09:30:00-04:00,30.74001,30.95,30.66,30.92999,3665299,7421276.5,59.85925748163664,60.55911081296731,NaN,NaN,79.80864932858682,88.04900775849876,0.023719673984746614,0.41065207468667353,0.3869324007019269,59357762,59387046.4,72.60831035676387,77.34408369485497,NaN,NaN,20.019636269993022,17.031802011051155
2010-08-06T09:30:00-04:00,30.78,31,30.55,30.99001,6328418,7374363.8,60.52203070253467,60.603697756446216,NaN,NaN,71.50297508431413,92.62890145519663,0.015843661101527295,0.40673697707883605,0.39089331597730875,65686180,61621171,73.92721447850421,77.52449836452237,NaN,NaN,20.21481907052463,17.48651873383308
2010-08-09T09:30:00-04:00,31.05,31.2399,31.03,31.10001,4701094,7402484.7,61.76794611401984,60.54519637554547,NaN,NaN,108.38436299439708,92.06679092879831,0.013532821187842825,0.4078093424621123,0.3942765212742695,70387274,63269906.6,74.88816528491472,77.6428685771806,NaN,NaN,20.716497412921044,17.947944259417074
2010-08-10T09:30:00-04:00,31.00999,31.45,30.808,31.28,9234090,7422465.55,63.78212084623823,61.12977261596259,NaN,NaN,107.23785307873281,91.75901961985531,0.01926701617660609,0.41836029149502707,0.399093275318421,79621364,67615128.2,77.26626526521642,77.8876089467744,NaN,NaN,21.69748192399263,18.483592497213582
2010-08-11T09:30:00-04:00,30.89,30.94,30.64,30.64999,9512926,7582041.55,53.21437766001196,60.6126045512721,NaN,NaN,25.585499784294807,78.50386805406514,-0.021993133912115936,0.37160185792827605,0.393594991840392,70108438,69032203.6,77.9980421810179,78.15482780255216,NaN,NaN,19.439820991687693,18.62019656785274
2010-08-12T09:30:00-04:00,30.38,30.69,30.31,30.59,6465523,7516991.55,52.32535751661965,59.997688604927546,NaN,NaN,-20.848438602319995,58.37245046788378,-0.054118032286544826,0.32594745148221094,0.38006548376875576,63642915,69889234.2,78.44984238340754,78.32184764495902,NaN,NaN,17.33873977556008,18.437131311810933
2010-08-13T09:30:00-04:00,30.50999,30.89999,30.48129,30.7,5886738,7399571.4,53.84791075114123,59.339956390388515,NaN,NaN,4.7907033457761266,45.02999612017618,-0.0678613809941303,0.29523875752609285,0.36310013852022316,69529653,70657928.8,78.86897157777909,78.40689629085452,NaN,NaN,16.002982009717435,18.08939569722615
2010-08-16T09:30:00-04:00,30.59,30.78,30.33,30.7,8452984,7475008.3,53.84791075114123,58.40022914024503,NaN,NaN,-26.530152290807326,18.047093063135296,-0.07622835463698374,0.2678146952239935,0.3440430498609772,69529653,70486404.6,78.5020824057933,78.2826764021407,NaN,NaN,14.903648056636593,17.63428889142764
2010-08-17T09:30:00-04:00,31.00999,31.17999,30.778,31,6973727,7486471.4,58.082208297495725,57.939757801131854,NaN,NaN,70.80422818795438,10.760368084979598,-0.06146787097790318,0.2672082111385983,0.32867608211650146,76503380,69862807.8,77.09786539573678,77.90899834927517,NaN,NaN,15.085652544982327,17.270197984792595
2010-08-18T09:30:00-04:00,30.94,31.05,30.595,30.83,20505216,8180836.5,55.002666510168815,57.77987458453225,NaN,NaN,15.319265152355063,8.707121158591645,-0.06283951836189461,0.2501266841641332,0.3129662025260278,55998164,67040753,70.91568592720975,77.01831678354826,NaN,NaN,14.385557873400645,16.858106540308032
2010-08-19T09:30:00-04:00,30.7,30.75999,30.21001,30.39,10088270,8408707.4,47.9206899876965,57.26384725387855,NaN,NaN,-113.47715809553019,-9.81862274005039,-0.0913381141872609,0.19879355979195168,0.2901316739792126,45909894,63494148.8,63.972993981538515,75.62616988953211,NaN,NaN,11.619596542833207,16.1097479692402
2010-08-20T09:30:00-04:00,30.34,30.53,30.14999,30.47,8124699,8457834.35,49.20138179447846,56.38406367179021,NaN,NaN,-136.4410501397911,-38.06497343716383,-0.10195204905127325,0.162691612665121,0.26464366171639425,54034593,60395136.8,58.576585030716046,73.830931783844,NaN,NaN,9.702466748851096,15.194422080613185
2010-08-23T09:30:00-04:00,30.55,30.91,30.53999,30.67,5509555,8480202.15,52.35576505266693,55.88404602489911,NaN,NaN,-27.865926027928733,-38.332128184588115,-0.09290933590321457,0.14850699183737603,0.2414163277405906,59544148,58398035.8,55.33702917782975,72.30967693189896,NaN,NaN,8.956282965095925,14.303259349825005
2010-08-24T09:30:00-04:00,30.44,30.92999,30.36,30.7225,13737375,8082838.9,53.1776848381697,55.350522021715676,NaN,NaN,-35.413213929196964,-59.57561660801838,-0.0812215968022964,0.1398893317377201,0.22111092854001652,73281523,57753664.4,54.29367544079466,70.90733777765877,NaN,NaN,8.565505137663767,13.483580176659114
2010-08-25T09:30:00-04:00,30.60001,30.77,30.35001,30.7,10712047,8214938.9,52.757623991104985,54.8432624866777,NaN,NaN,-53.10120674592508,-73.25971098767441,-0.0730899016113104,0.1297485515258785,0.2028384531371889,62569476,59067926.8,56.11127902711869,69.72897839696982,NaN,NaN,8.128312268067738,12.718541904003203
2010-08-26T09:30:00-04:00,30.8,30.8,30.47,30.56,6863816,8142419.75,50.105473581774326,54.099222692337676,NaN,NaN,-48.78142631731355,-60.320564632031086,-0.07494533157818845,0.10915678866445333,0.18410212024264178,55705660,61027080,58.745003984728555,68.64453479027156,NaN,NaN,7.038955028064358,11.907172350297653
2010-08-27T09:30:00-04:00,30.57001,31.14999,30.42999,31.14,9926129,8184604.5,59.245941483531375,53.91907950444564,NaN,NaN,53.813153793689814,-22.2697238453349,-0.03684369988716579,0.13804749538368455,0.17489119527085034,65631789,63346519.2,61.677080878267944,67.70088590408251,NaN,NaN,8.745573096731455,11.45551531407391
2010-08-30T09:30:00-04:00,31.11,31.14,30.67,30.67,8391125,8222758.8,51.079761758702446,53.01176814105023,NaN,NaN,23.794948791098957,-11.937548881529363,-0.04261967930288618,0.12161659614224263,0.1642362754451288,57240664,62885822.4,60.753474732169146,66.52140086600771,NaN,NaN,7.652139711175917,10.91217594223134
2010-08-31T09:30:00-04:00,30.61,30.94,30.39999,30.81,8936391,8457161.35,53.15120763389989,53.00725599632794,NaN,NaN,-16.58473744595691,-8.171853584881354,-0.03656859512542074,0.11852553153835288,0.15509412666377362,66177055,61464928.8,57.874857101214914,65.08403050316464,NaN,NaN,7.411657321871624,10.412101853608522
2010-09-01T09:30:00-04:00,31.05,31.53,30.95,31.48,8258516,8613696.9,61.54358926860041,53.66570112146943,NaN,NaN,194.97669285563018,41.4437263354297,0.010484964601149588,0.1682003324152106,0.157715367814061,74435571,63838147.8,61.183080772433556,63.85069038809507,NaN,NaN,10.107226695905988,10.368548259651018
2010-09-02T09:30:00-04:00,31.52,31.56,31.21001,31.48,6005828,8730723.35,61.54358926860041,54.21539244414509,NaN,NaN,187.72977351163672,88.74596630121975,0.03798972418570551,0.2052025230461929,0.1672127988604874,74435571,67584130,65.7546719382454,62.913954699556946,NaN,NaN,12.177528491995961,10.626974007128867
2010-09-03T09:30:00-04:00,31.57001,31.64,31.345,31.62,5359766,8682290.75,63.14359802666651,54.87937010668261,NaN,NaN,179.51986610931957,113.8873087643457,0.060647716286083286,0.2430224442180915,0.1823747279320082,79795337,70416839.6,68.75171848390966,62.21750013370812,NaN,NaN,14.369534707971784,11.161625535820713
2010-09-07T09:30:00-04:00,31.56,31.74001,31.45,31.46001,4926270,8693549.55,60.06788751302776,55.02120433636346,NaN,NaN,160.5791167183339,141.2441423497927,0.05979718965655753,0.25712121500270513,0.1973240253461476,74869067,73942520.2,72.03246003535646,61.855685465109524,NaN,NaN,15.261703639422047,11.747350979192332
2010-09-08T09:30:00-04:00,31.53999,31.62,31.28999,31.31,4892680,8476479.05,57.25197806883057,55.18186944769644,NaN,NaN,118.27991346187585,168.21707253135924,0.04475717532811305,0.2532704945062889,0.20851331917817587,69976387,74702386.6,72.69776840280194,61.98297707050897,NaN,NaN,15.169936604728054,12.236291782840292
2010-09-09T09:30:00-04:00,31.52,31.69,31.5,31.62,5402156,8270940.55,61.29047985606431,56.13685443829415,NaN,NaN,134.6707902871742,156.15589201766804,0.050866640286330866,0.27209661953608943,0.22122997924975857,75378543,74890981,72.87026893604968,62.61849671011691,NaN,NaN,16.321979535885237,12.819961461846713
2010-09-10T09:30:00-04:00,31.56,31.56,31.32069,31.44,6233668,8259347.8,57.87173824779296,56.756165613530904,NaN,NaN,89.52287310960078,136.51451193726086,0.03852533024627375,0.26938664205760077,0.23086131181132702,69144875,73832841.8,70.19066654734357,63.448073961304594,NaN,NaN,16.259206992674372,13.31128225196495
2010-09-13T09:30:00-04:00,31.73,31.73,31.4982,31.55,4950461,8212533.95,59.363483257860366,57.256716913901855,NaN,NaN,102.56717215523784,121.12397314644451,0.033685699240178446,0.27296843586155006,0.23928273662137162,74095336,72692841.6,67.31855326621104,64.3038971104747,NaN,NaN,16.6436458681638,13.787334197136214
2010-09-14T09:30:00-04:00,31.55,31.64,31.34,31.50999,5181461,8048957.8,58.5513661931199,57.64055129639829,NaN,NaN,76.14477214999053,104.23710423277585,0.024151612503571285,0.2694722522508357,0.24532063974726442,68913875,71501803.2,64.35567004519697,65.02261101078913,NaN,NaN,16.731731625925477,14.207962401248967
2010-09-15T09:30:00-04:00,31.46001,31.48,31.24001,31.33,5879855,7994264.2,54.91195854683202,57.79443233609309,NaN,NaN,46.492669333169,89.87965540703446,0.0031866814514032726,0.2493039915615185,0.24611731011011523,63034020,70113329.8,60.98586017540609,65.37079537852395,NaN,NaN,15.779906349300976,14.432525822399255
2010-09-16T09:30:00-04:00,31.28,31.34,31.09,31.22,5321680,7235087.4,52.753833113728874,57.98360087408984,NaN,NaN,21.395529426944712,67.22460323498856,-0.019384529837870396,0.22188664781277723,0.24127117765064762,57712340,66580089.2,53.332828202544654,64.98421139408224,NaN,NaN,14.36902409466059,14.423454147008016
2010-09-17T09:30:00-04:00,31.06,31.09,30.75999,30.85001,9963879,7228867.85,46.1796423962503,57.0502937964269,NaN,NaN,-38.46768076739162,41.62649245959008,-0.05832707941936685,0.16836232837643905,0.2266894077958059,47748461,62300806.4,45.831310938102426,63.852370684070415,NaN,NaN,11.109206756948218,13.94999023414233
2010-09-20T09:30:00-04:00,30.98,31.28999,30.85001,31.25999,5753840,7110324.9,53.147208773920894,57.19796858322822,NaN,NaN,-3.448919779980333,20.423274072546448,-0.05558063141811223,0.15721361852316562,0.21279424994127785,53502301,58182199.4,39.99985540406335,62.36996930349143,NaN,NaN,10.335765512260425,13.43367241673063
2010-09-21T09:30:00-04:00,31.28999,31.32961,31.03,31.10001,7369063,7203300.3,50.40502788505025,57.00181288688183,NaN,NaN,-4.267808142772357,4.340758013993871,-0.06309513689230556,0.13392532882589592,0.19702046571820148,46133238,53626072,34.73472909552581,60.71710301737079,NaN,NaN,8.847248112164376,12.778468944649736
2010-09-22T09:30:00-04:00,31.08,31.44,31.08,31.32001,8011734,6917018.25,53.92562827332415,56.457672815790666,NaN,NaN,18.510116616348487,-1.255752529370222,-0.052253843945875234,0.13170316078585742,0.18395700473173265,54144972,51848262.4,32.914159787554695,58.69789437559373,NaN,NaN,8.66795027241751,12.191251991473704
2010-09-23T09:30:00-04:00,31.14999,31.32001,30.92999,30.96001,6829320,6722881.9,47.92979979742859,55.48525928213554,NaN,NaN,-41.612053485150334,-13.85726911178923,-0.06737095858496925,0.0997433065005211,0.16711426508549035,47315652,49768924.8,30.875777456923075,56.206544769785,NaN,NaN,6.592473451393251,11.391426485747925
2010-09-24T09:30:00-04:00,31.3,31.55,31.25681,31.46001,4976852,6628533.7,55.35457245000576,54.92890031237406,NaN,NaN,46.8561356609061,3.2074941738703115,-0.04292909314596838,0.11345289865302988,0.15638199179899825,52292504,50677733.4,32.83366011794918,53.64096917221639,NaN,NaN,7.258411330246878,10.800995749247775
2010-09-27T09:30:00-04:00,31.50999,31.67999,31.42,31.52,9402773,6602365.9,56.16224579567063,54.6499259039914,NaN,NaN,76.97518023700692,19.292314177267762,-0.022956274522869163,0.1276866486454118,0.15064292316828096,61695277,52316328.6,36.33505201816975,51.091154313845905,NaN,NaN,8.04005443019456,10.406575560811602
2010-09-28T09:30:00-04:00,31.56,31.67999,31.31,31.53999,5150551,6440337.2,56.44500409262183,54.59228490569078,NaN,NaN,63.16540410426714,32.778956626675665,-0.009331960579379545,0.13897797244405652,0.14830993302343606,66845828,56458846.6,44.247817946979886,49.0590149955729,NaN,NaN,8.746232455292517,10.16938368859459
2010-09-29T09:30:00-04:00,31.50999,31.597,31.27,31.48,4921887,6239612,55.29239195363355,54.16385005551716,NaN,NaN,34.70764178138626,36.01846165968321,-0.00548384275444283,0.14145512958038253,0.14693897233482536,61923941,58014640.4,46.916283301763805,47.2051588788382,NaN,NaN,8.99464163382298,10.001563395055788
2010-09-30T09:30:00-04:00,31.64999,31.71001,31.31,31.38,11023137,6377843.05,53.337181266919984,53.83995312831194,NaN,NaN,39.15601987405352,52.17207633152399,-0.010505825897757004,0.13380668996262912,0.14431251586038613,50900804,58731670.8,48.14806814630766,45.630687564478485,NaN,NaN,8.654157579043824,9.809076849911222
2010-10-01T09:30:00-04:00,31.41,31.64999,31.3419,31.55,6427973,6398950.3,56.174380617386554,53.61216008256381,NaN,NaN,56.3538793744847,54.071625074239705,-0.0035694416976535803,0.13985071373831914,0.14342015543597272,57328777,59738925.4,49.906561577409306,44.386973872421216,NaN,NaN,9.161064921396187,9.716503717266217
2010-10-04T09:30:00-04:00,31.59,31.75,31.33,31.49001,4684605,6365192.25,54.905703899743614,53.35175563303693,NaN,NaN,60.747490327612596,50.826087092360844,-0.004170690262143034,0.13820679260829394,0.14237748287043697,52644172,57928704.4,46.832582293626906,43.13532474730907,NaN,NaN,9.238885119351718,9.648272488992717
2010-10-05T09:30:00-04:00,31.7,31.87,31.64,31.84,4531871,6345472.3,60.509324204977574,53.75156746576162,NaN,NaN,158.38538950262046,69.87008417203151,0.016708609086719922,0.16326324422883687,0.14655463514211695,57176043,55994747.4,43.733337987700374,41.90300173390152,NaN,NaN,10.955378690443233,9.835001946342791
2010-10-06T09:30:00-04:00,31.84,31.86,31.57001,31.69,4607023,6331189.45,57.22709364303698,54.0710860749979,NaN,NaN,113.9569818341903,85.71995218259232,0.018010696314922664,0.16906800553577028,0.15105730922084762,52569020,54123763.2,40.91253906096924,41.01583822378899,NaN,NaN,11.465174044556758,10.067883674659072
2010-10-07T09:30:00-04:00,31.8,31.8923,31.63,31.75,3699461,6246054.7,58.20372142027544,54.92994886242827,NaN,NaN,126.46410388829048,103.18156898543971,0.020334568077042703,0.176475519317151,0.1561409512401083,56268481,55197298.6,43.17724953214219,40.826262409077536,NaN,NaN,12.163461988713081,10.367252005238216
2010-10-08T09:30:00-04:00,31.8,31.88,31.64999,31.85001,3846228,6126682.7,59.84934246867975,55.40867269776819,NaN,NaN,123.98016974103165,116.7068270587491,0.02568405152741446,0.18824601564937637,0.16256196412196192,60114709,55754485,44.369047597051036,41.13834756571952,NaN,NaN,13.214246213109776,10.773965463505581
2010-10-11T09:30:00-04:00,31.89999,31.97,31.75999,31.86,3736054,6065962.35,60.018681113186936,56.09536221406366,NaN,NaN,135.81925627244436,131.72118024771547,0.026846095760422684,0.19611958382249028,0.1692734880620676,63850763,57995803.2,49.00262028408766,42.15748265061679,NaN,NaN,14.132077055520067,11.253695690936222
2010-10-12T09:30:00-04:00,31.94,31.94,31.58,31.73,4023370,6008057.8,56.66923267389418,56.29133395696152,NaN,NaN,89.87290445499654,118.01868323819068,0.01632759549681001,0.18968298243308013,0.17335538693627012,59827393,58526073.2,50.062375559735386,43.38235520577256,NaN,NaN,14.045800443956722,11.65256779851058
2010-10-13T09:30:00-04:00,31.99001,31.99001,31.73,31.85001,4086996,5918414.85,58.94690636602766,57.07827014043289,NaN,NaN,109.36196765600086,117.09968040255278,0.014957193635463606,0.1920518789805996,0.177094685345136,63914389,60795147,54.42658464028362,45.06455571886975,NaN,NaN,14.579637111111715,12.0707205574536
2010-10-14T09:30:00-04:00,31.86,31.97,31.66,31.8,4144539,5859557.8,57.5884227285117,57.23783087461188,NaN,NaN,87.94611573612706,109.3960827721201,0.008508111682493491,0.18772982494825285,0.17922171326575936,59769850,61495420.8,55.71293280424614,46.698789482176664,NaN,NaN,14.678718129383322,12.443291639157845
2010-10-15T09:30:00-04:00,31.99001,31.995,31.72501,31.895,5788008,5650764.25,59.49793307290773,57.47609425155739,NaN,NaN,96.78965021561326,103.95797886703642,0.00844869069371304,0.18978257663290066,0.18133388593918762,65557858,62584050.6,57.711269335608016,48.22566214770797,NaN,NaN,15.264714123872961,12.846351994117148
2010-10-18T09:30:00-04:00,31.97,32.27,31.89999,31.89999,4468223,5586483.4,59.60082273379839,57.701509868784285,NaN,NaN,129.40967311643078,102.67606223583371,0.0066338161600907886,0.18962615613930112,0.18299233997921033,70026081,63819114.2,59.920821721683204,49.34516241732963,NaN,NaN,15.784985426852488,13.266156770222196
2010-10-19T09:30:00-04:00,31.98,32.21001,31.85001,31.96001,8429621,5639511.3,60.88784604022653,58.101185160683784,NaN,NaN,114.70288672455212,107.64205868974484,0.007310562306313745,0.19213054286210252,0.18481998055578877,78455702,67544776,65.73661211622019,50.68947161836224,NaN,NaN,16.561807699330593,13.73696404580911
2010-10-20T09:30:00-04:00,32.05,32.39999,32.03999,32.22,3932210,5435535.1,65.94838671245569,59.00198554965061,NaN,NaN,167.67668317118896,119.30500179278246,0.022258487856042453,0.21264309037584184,0.19038460251979938,82387912,71239480.6,70.33398861831719,52.27418022350577,NaN,NaN,18.686420445676774,14.444029245790205
2010-10-21T09:30:00-04:00,32.3,32.3893,31.89999,32.08,5888930,5388515.6,61.345562253770204,59.37135566653516,NaN,NaN,133.57549583000605,128.43087781155828,0.019790558272924752,0.21512280036095532,0.19533224208803057,76498982,74585307,73.76672635382538,53.9784777075355,NaN,NaN,19.287220554515,15.135913718465176
2010-10-22T09:30:00-04:00,32.10001,32.13,31.75,31.87,4291879,5354266.95,55.12995176079083,59.38737337089567,NaN,NaN,54.21181946981038,119.9153116623977,0.0020237378877691614,0.19786191444774204,0.19583817655997288,72207103,75915156,75.00473267421796,55.990774163291995,NaN,NaN,18.021594784459822,15.548153870750125
2010-10-25T09:30:00-04:00,32.08,32.08,31.73,31.8,5277398,5147998.2,53.19515157996982,58.86493246910941,NaN,NaN,31.89264698237669,100.41190643558687,-0.015470904354002946,0.1764995461174692,0.19197045047147215,66929705,75295880.8,73.27066303505747,58.10058309524607,NaN,NaN,16.403947533698346,15.670410108314156
2010-10-26T09:30:00-04:00,31.71001,31.77,31.57001,31.72,3891189,5085030.1,50.992569829844335,58.419609339595645,NaN,NaN,-48.08743751155284,67.85384158836588,-0.03248076787133916,0.1513694906322982,0.18385025850363737,63038516,72212443.6,65.18920611978686,59.83463074230447,NaN,NaN,14.405166326153122,15.489660996576866
2010-10-27T09:30:00-04:00,31.56,31.61,31.25,31.59,6006328,5139252.15,47.547295164720886,57.65843603562747,NaN,NaN,-136.90984029183534,6.936536895760989,-0.05141194927359555,0.11958532191164295,0.1709972711852385,57032188,67141298.8,54.53562899830968,60.645943561316436,NaN,NaN,11.67341759721338,14.944483368096368
2010-10-28T09:30:00-04:00,31.73,31.78,31.52,31.67,5376254,4856908,49.79527723263166,56.9402885187669,NaN,NaN,-70.6673702442597,-33.91203631909216,-0.05703608405893798,0.09970216611156602,0.156738250170504,62408442,64323190.8,49.677023544428195,61.02508470041481,NaN,NaN,9.967170423069586,14.23343866166397
2010-10-29T09:30:00-04:00,31.56,31.78,31.47,31.72,4173324,4744175.55,51.20289176184679,56.310589279385454,NaN,NaN,-77.35456304451864,-60.22531282195796,-0.05580932652798817,0.08697659201051877,0.14278591853850695,66581766,63198123.4,47.84442134087766,60.94235620447124,NaN,NaN,8.907330806938552,13.47256611098891
2010-11-01T09:30:00-04:00,31.84,31.96001,31.25999,31.41,7352117,4877551.15,43.128968584570224,55.343427558719455,NaN,NaN,-133.05442515297221,-93.21472724902773,-0.07320002930405242,0.05128588190844141,0.12448591121249383,59229649,61658112.2,45.37681073408543,60.6076730026391,NaN,NaN,5.445471499262012,12.325838309313639
2010-11-02T09:30:00-04:00,31.62,31.86,31.62,31.78,4136086,4857761.9,52.713153599388704,54.898159503959526,NaN,NaN,-30.650448929608174,-89.72732953263879,-0.057785297074478575,0.05225428986939562,0.1100395869438742,63365735,61723556,45.50543645249369,59.97044813208269,NaN,NaN,5.38916882069727,11.334885525225586
2010-11-03T09:30:00-04:00,31.88,31.92,31.49899,31.72,8632461,5059033.8,51.206129342657334,54.44228140496993,NaN,NaN,-50.188672616679774,-72.38309599760768,-0.0499267105261714,0.047631198786159956,0.09755790931233135,54733274,61263773.2,44.70888561191666,59.184444761201995,NaN,NaN,4.866988225422976,10.410900196682356
2010-11-04T09:30:00-04:00,32.11,32.11,31.91,32.06,8827590,5315440.25,58.454460071392255,54.367747619147394,NaN,NaN,88.88610962673248,-40.47240002340925,-0.021575271197084356,0.07058882031597591,0.09216409151306026,63560864,61494257.6,45.2264856760758,58.292674499806836,NaN,NaN,6.866603222463537,9.904572057508238
2010-11-05T09:30:00-04:00,32.02,32.10001,31.92,32.05,5357387,5390998.2,58.18070794682231,54.266310848649105,NaN,NaN,78.62237288096264,-9.277012838312995,-0.004152545984596842,0.08697340903231421,0.09112595501691105,58203477,59818599.8,42.13802792582104,57.02247494295954,NaN,NaN,8.335482257094032,9.68041637173478
2010-11-08T09:30:00-05:00,32.00999,32.00999,31.75,31.87,3778419,5393116.45,53.33855728675448,53.72707593768682,NaN,NaN,14.428144859014028,20.219501164084253,-0.005332593458070745,0.08446021319432262,0.08979280665239336,54425058,58857681.6,40.43285284388833,55.21506356636441,NaN,NaN,8.051163917014051,9.44766602106039
2010-11-09T09:30:00-05:00,31.92999,32.03,31.66,31.75999,9396227,5661759.3,50.568530474864154,52.628514777858854,NaN,NaN,-13.35185639665373,23.679219670675145,-0.0136318860672556,0.07275294906832386,0.08638483513557946,45028831,55190300.8,34.66698009586892,52.66742010047525,NaN,NaN,6.953614064965253,9.091372884475371
2010-11-10T09:30:00-05:00,31.72,31.8,31.39999,31.62,7738875,5844353.25,47.208722268608774,51.61874049320447,NaN,NaN,-93.88367502775229,14.940219188460645,-0.027840504707760047,0.051584204250879395,0.07942470895863944,37289956,51701637.2,30.248061636187757,49.55894404921542,NaN,NaN,4.986082982893141,8.504902898535052
2010-11-11T09:30:00-05:00,31.53999,31.6102,31.47,31.60001,4907527,5882502.65,46.731256679658955,51.018833701695044,NaN,NaN,-100.20188094576875,-22.8773789260396,-0.03728656135435718,0.03281650726569296,0.07010306862005014,32382429,45465950.2,24.288541291003824,45.93635895041441,NaN,NaN,3.2596987315849666,7.755588017542183
2010-11-12T09:30:00-05:00,31.5,31.5,31.21001,31.34,7300922,5958148.35,40.932322738720266,50.142917355891505,NaN,NaN,-152.6149694436488,-69.12484739096189,-0.0584848905649441,-0.003003044586129988,0.055481845978814115,25081507,38841556.2,19.820854981504937,42.11851551801781,NaN,NaN,-0.10784927693059622,6.6322398326175005
2010-11-15T09:30:00-05:00,31.45,31.63,31.42999,31.44501,3618562,5915665.3,43.95705501625602,49.64038058349234,NaN,NaN,-91.41164985985498,-90.29280633473567,-0.06251004255088591,-0.022655707209793263,0.03985433534109264,28700069,33696558.4,17.177977711097938,38.68914206025431,NaN,NaN,-1.9952510208665262,5.399741139262639
2010-11-16T09:30:00-05:00,31.34,31.38,30.89999,31.08,9276582,5958013.35,36.88636641168919,48.8788856725615,NaN,NaN,-192.19058727280327,-126.0605525099656,-0.08541347994992271,-0.06691251459631076,0.018500965353611957,19423487,28575489.6,15.02980992070114,35.86729784042513,NaN,NaN,-6.092450731585504,3.757999443427191
2010-11-17T09:30:00-05:00,31.12,31.19,30.99001,31.065,5405836,6031694.65,36.625637319192144,47.938197107315816,NaN,NaN,-184.21571452085263,-144.12696040858566,-0.09641732976713394,-0.10202069685530546,-0.005603367088171527,14017651,23921028.6,13.390750990658603,33.27542122944159,NaN,NaN,-9.388248430136116,1.879964032918147
2010-11-18T09:30:00-05:00,31.31,31.33,31.10001,31.25,4427316,5958613.95,42.0647912056018,47.2854756390126,NaN,NaN,-123.73604751141895,-148.83379372171572,-0.08640262126966906,-0.11360664367525786,-0.027204022405588797,18444967,21133536.2,12.51080632898487,30.751591585734964,NaN,NaN,-10.507945932133635,0.11026260933932108
2010-11-19T09:30:00-05:00,31.16,31.27,30.91,31.13,4370496,5962544.8,39.68551964424188,47.03951500041772,NaN,NaN,-140.49013749976487,-146.40882733293893,-0.08300633359872259,-0.13096193940399203,-0.04795560580526945,14074471,18932129,11.848606481239074,28.356719853388796,NaN,NaN,-12.173179408087366,-1.644514821721634
2010-11-22T09:30:00-05:00,31.09,31.27,30.91,31.22,4288063,5913078.05,42.32058893775689,46.297188953158305,NaN,NaN,-116.05041857876076,-151.33658107672008,-0.07034548526709268,-0.1358874623891353,-0.06554197712204261,18362534,16864622,11.246527436482936,25.909654923673738,NaN,NaN,-12.756496855226787,-3.2319408265080845
2010-11-23T09:30:00-05:00,31,31,30.77,30.88,6308141,6033925.65,35.93364862688043,45.20629747345995,NaN,NaN,-155.48328654164337,-143.9951209304881,-0.07982275623956157,-0.16532042242149458,-0.08549766618193301,12054393,15390803.2,10.824279981939796,23.489325950103964,NaN,NaN,-15.363055675760261,-4.9649572335441094
2010-11-24T09:30:00-05:00,31.06,31.09,30.94,31.065,3310796,5899149.05,41.13895853892936,43.969475935426885,NaN,NaN,-102.54028879407036,-127.66003578513164,-0.06899275158814636,-0.17173860566711596,-0.1027458540789696,15365189,15660310.8,11.478776901662727,21.078775323360173,NaN,NaN,-15.852772307618611,-6.5203593869833245
2010-11-26T09:30:00-05:00,30.89999,31.11,30.8,30.86,1970614,5728867.05,37.50276718321854,42.49248016659804,NaN,NaN,-110.18559173048054,-124.94994462894394,-0.07073390718476721,-0.19116323805992863,-0.12042933087516142,13394575,14650232.4,11.148523657161633,18.865239304170217,NaN,NaN,-17.45256668538803,-8.082103286755425
2010-11-29T09:30:00-05:00,30.77,30.85001,30.50999,30.8,6140988,5827250.25,36.4862727375868,41.2887455559432,NaN,NaN,-132.3464510920209,-123.32120734739519,-0.0708483700914799,-0.2089897934895113,-0.1381414233980314,7253587,13286055.6,10.700742662668489,16.741517148368807,NaN,NaN,-19.049366803327324,-9.648855217694267
2010-11-30T09:30:00-05:00,30.53999,30.89011,30.53999,30.75999,5634551,5741371.95,35.78964451488635,40.23311084451622,NaN,NaN,-115.00633567229518,-123.1123907661021,-0.0685000603334181,-0.22376649881480404,-0.15526643848138594,1619036,9937356,9.67360883361394,14.956276343922022,NaN,NaN,-20.546928894350277,-11.205722885787983
2010-12-01T09:30:00-05:00,31.10001,31.16,30.92,31.12,5782430,5823689.15,45.81464075416184,40.133533593484294,NaN,NaN,-48.43566356468635,-101.70286617071068,-0.039046767284845574,-0.2040748975874429,-0.16502813030259733,7401466,9006770.6,9.403482719216612,13.467377849852657,NaN,NaN,-18.675294832588847,-12.27280459247382
2010-12-02T09:30:00-05:00,31.08,31.21001,30.968,31.21001,9448176,5864474.9,48.00058211087181,40.224199695713786,NaN,NaN,-32.61723328812026,-87.71825506952067,-0.01129035986121013,-0.17914108012911,-0.16785072026789988,16849642,9303661.2,10.26441235316986,12.465654354293088,NaN,NaN,-16.464258192932366,-12.871583678253613
2010-12-03T09:30:00-05:00,31.10001,31.31,31.02,31.27499,5911320,5718661.4,49.58189106682567,40.842026004864174,NaN,NaN,-11.876609468666958,-68.05645861715796,0.012375812672988096,-0.15238095442666477,-0.16475676709965287,22760962,11176938.6,15.707383339713758,12.171834951308,NaN,NaN,-14.180261422817269,-13.058537641762706
2010-12-06T09:30:00-05:00,31.27,31.31,31.14999,31.19,4160805,5658832.3,47.545323329866854,41.0983308844078,NaN,NaN,0.7344828392239778,-41.44027183090897,0.02263874332558022,-0.1364583379426776,-0.1590970812682578,18600157,13446252.6,21.888454204038993,12.508297557946642,NaN,NaN,-12.86850322912119,-13.031389868528205
2010-12-07T09:30:00-05:00,31.35001,31.42,30.95,30.98,9994387,5969630.7,42.86073399274117,41.52507142591151,NaN,NaN,-19.07873254547437,-22.254751205544807,0.015933337417994298,-0.13918040949576493,-0.15511374691375923,8605770,14843599.4,25.510576390511105,13.256923734361639,NaN,NaN,-13.121544303398396,-13.04426907350966
2010-12-08T09:30:00-05:00,31.05,31.11,30.8,30.87,8467063,5923172.5,40.603949577724094,41.80923658723522,NaN,NaN,-78.24642519389724,-28.21690353138697,0.005289466426438516,-0.1485019138807111,-0.15379138030714962,138707,13391047.6,24.251647448664215,14.032702052790611,NaN,NaN,-14.007109138552403,-13.181817654230052
2010-12-09T09:30:00-05:00,31.02,31.03999,30.8381,31,6411230,5856790.25,44.334331110049504,41.97134658041006,NaN,NaN,-59.36812594784871,-33.56708206333266,0.008039194678842648,-0.1437423869585963,-0.15178158163743896,6549937,11331106.6,22.551945413804276,14.749926273134852,NaN,NaN,-13.648956501134471,-13.248551775216397
2010-12-10T09:30:00-05:00,31.06,31.1741,31.03999,31.12,4496871,5836257.45,47.6055070559855,42.53705996696317,NaN,NaN,16.853229359570637,-27.82111429768515,0.01838312657251226,-0.12880267342179863,-0.1471857999943109,11046808,8988275.8,20.76907594025822,15.387102663064793,NaN,NaN,-12.373419127710061,-13.123532825572635
2010-12-13T09:30:00-05:00,31.17999,31.345,31.14999,31.265,6376566,5790039.65,51.32746831302748,43.180408493768205,NaN,NaN,90.72503512518591,-9.823003840492754,0.034498254913409965,-0.10406298135254843,-0.1385612362659584,17423374,8752919.2,20.592949630944887,16.054704248383505,NaN,NaN,-10.16263225505064,-12.70054702978378
2010-12-14T09:30:00-05:00,31.36,31.47,31.27991,31.35001,5066961,5862459.6,53.41677620296664,44.429203320631515,NaN,NaN,156.9105195041203,25.374846569426175,0.049478825570507035,-0.07671270430282462,-0.12619152987333165,22490335,11529832.2,28.316979309504674,17.304182771780994,NaN,NaN,-7.696084054456071,-11.985623747594106
2010-12-15T09:30:00-05:00,31.28999,31.39,31.07001,31.08,10642805,5930770.75,46.57778760069251,44.81769111075745,NaN,NaN,57.23305915972294,52.470743440150216,0.040193651922811796,-0.07594946496981692,-0.11614311689262871,11847530,13871596.8,34.13536868032219,18.922510755970958,NaN,NaN,-7.560851435273089,-11.353513417262532
2010-12-16T09:30:00-05:00,31.11,31.37,30.9601,31.3575,5598762,5940417.05,53.208350284312004,45.93951847512127,NaN,NaN,75.21473733306848,79.38731609633365,0.051035123649832786,-0.052349212330337735,-0.10338433598017052,17446292,16050867.8,39.09017329608594,20.91834287303698,NaN,NaN,-5.282471055987382,-10.486221651366082
2010-12-17T09:30:00-05:00,30.97,31.14999,30.82001,31.14999,6161109,6027106.7,48.37336110915281,46.788596215947415,NaN,NaN,-13.252223283199411,73.36622556777965,0.04285473441884771,-0.04981591795661089,-0.0926706523754586,11285183,16098542.8,39.19793309113293,22.953856475070157,NaN,NaN,-4.933221315121813,-9.692935889045472
2010-12-20T09:30:00-05:00,31.22,31.28,31.07001,31.19,4996164,6058390.1,49.32942247922228,47.75572321339998,NaN,NaN,54.39675768659904,66.10057008006227,0.03887911431479696,-0.0440717594819624,-0.08295087379675936,16281347,15870137.4,38.843375567222154,25.037411241756455,NaN,NaN,-4.359164742999647,-8.930968582467496
2010-12-21T09:30:00-05:00,31.22,31.31,31.16,31.2,3207440,6004358.95,49.58074100861576,48.0247303744324,NaN,NaN,71.4462114541409,49.00770847006639,0.0357435891577194,-0.03827138734961011,-0.07401497650732951,19488787,15269827.8,37.873725198796926,27.07099999029791,NaN,NaN,-3.8258237814813807,-8.201662182326622
2010-12-22T09:30:00-05:00,31.2,31.42,31.2,31.34,3389274,5858415.6,53.08873257979594,48.38816969364127,NaN,NaN,108.64809786238429,59.29071621059866,0.04151381807442739,-0.022122703914295272,-0.06363652198872266,22878061,17475934,43.45961980632859,29.4420862369521,NaN,NaN,-2.334495715488589,-7.363495544206903
2010-12-23T09:30:00-05:00,31.38,31.46001,31.3,31.36,2874006,5836576.1,53.58555579412497,48.67414574559122,NaN,NaN,121.2241325977867,68.49259526354231,0.044810778129899684,-0.0076230493263480525,-0.052433827456247736,25752067,19137089,47.301832178566656,31.698832582584455,NaN,NaN,-0.9735506441450945,-6.450646272769502
2010-12-27T09:30:00-05:00,31.36,31.5,31.24001,31.38,2141551,5845122.95,54.108960105877095,49.14297694387767,NaN,NaN,111.26033138927853,93.3951061980379,0.04628257625660378,0.005419392864506989,-0.04086318339209679,27893618,22458776,54.02910219586458,33.994593153429136,NaN,NaN,0.29918967376583316,-5.486383994693026
2010-12-28T09:30:00-05:00,31.42,31.49001,31.28,31.49001,1179062,5597026.65,56.98249336668494,50.15167404201651,NaN,NaN,129.0524302235186,108.32624070542181,0.05217198472272375,0.024351797511307893,-0.027820187211415853,29072680,25017042.6,58.43049357791055,36.346015809671954,NaN,NaN,2.201722391052407,-4.3880830824436785
2010-12-29T09:30:00-05:00,31.53999,31.53999,31.32001,31.38,1854769,5408037.55,53.38273124463713,51.064444161081724,NaN,NaN,121.94221403891666,118.42544122237696,0.04636146034302262,0.030131638217362422,-0.016229822125660195,27217911,26562867.4,60.86848840954346,38.96150444973476,NaN,NaN,2.879955456163175,-3.3497918626426992
2010-12-30T09:30:00-05:00,31.34,31.47,31.28999,31.33,2475625,5242697.3,51.781587803944554,51.59639106778851,NaN,NaN,84.10660060927077,113.51714177175427,0.0372462728699625,0.030328018961792935,-0.006918253908169568,24742286,26935712.4,61.455668293942814,41.74034179831608,NaN,NaN,3.0235593113297052,-2.4393131235037844
2010-12-31T09:30:00-05:00,31.33,31.46001,31.28999,31.34,2171295,4878853.25,52.09108765257531,51.91678968183064,NaN,NaN,75.56221651169012,104.38475855453494,0.030281787820463348,0.030933980867409616,0.0006521930469462686,26913581,27168015.2,61.8398751724975,44.6739703149046,NaN,NaN,3.2239504641260694,-1.630275468128091
2011-01-03T09:30:00-05:00,31.47,31.57001,31.33,31.49249,3536331,4760103.8,56.659520974826194,52.297650586244835,NaN,NaN,115.77098274220057,105.28688882511935,0.034054771796141234,0.04322065779212281,0.009165885995981577,30449912,27679274,62.720608569785334,47.68308881053606,NaN,NaN,4.646446282212566,-0.7336009323651401
2011-01-04T09:30:00-05:00,31.49001,31.71001,31.3,31.63499,4981414,4801134.25,60.454474913564624,52.800343351287545,NaN,NaN,137.38095266583292,106.9525933135822,0.043644851107858235,0.06372194988080437,0.02007709877294614,35431326,28951003.2,64.89125229646746,50.2955368810334,NaN,NaN,6.990785814047476,0.36988288855094786
2011-01-05T09:30:00-05:00,31.53999,31.57001,31.39999,31.44,4598801,4531354.95,53.54543909031718,53.298032743403596,NaN,NaN,90.5008838481151,100.6643272754219,0.03474094647002472,0.06350328186047705,0.028762335390452323,30832525,29673926,66.09963921673116,52.57869906220547,NaN,NaN,7.072348300213645,1.3273779473599046
2011-01-06T09:30:00-05:00,31.47,31.5,31.24001,31.47,5707063,4393354.95,54.408743875031554,53.3837751427407,NaN,NaN,53.81119201722779,94.6052455570133,0.028991282912700048,0.06500143903132738,0.03601015611862733,36539588,32033386.4,69.75815110127273,54.7692689054331,NaN,NaN,7.384604445986883,2.19269601859233
2011-01-07T09:30:00-05:00,31.52,31.60001,31.29359,31.5825,5091992,4327393.05,57.591508784291904,54.04221426239349,NaN,NaN,98.72025643438423,99.23685354155211,0.03071892368824162,0.07440881072892935,0.043689887040687735,41631580,34976986.2,73.58777322032313,57.22568605751811,NaN,NaN,8.57046388246985,3.1038057134319756
2011-01-10T09:30:00-05:00,31.5,31.5,31.23,31.41,6357180,4420408.5,51.63872910827782,54.20716473589746,NaN,NaN,25.42330155249336,81.16731730361067,0.018784579347002443,0.06717061122444079,0.04838603187743835,35274400,35941883.8,74.71795157995666,59.78815577271344,NaN,NaN,7.840971313923934,3.780543656359398
2011-01-11T09:30:00-05:00,31.53,31.59,31.36,31.455,3186643,4260912.35,53.003424312119186,54.45164211471913,NaN,NaN,80.59064898264597,69.80925656697327,0.012750313486418412,0.06432392373546136,0.05157361024904295,38461043,36547827.2,75.42900181804488,62.47067553123115,NaN,NaN,7.6313176391467845,4.330654225329025
2011-01-12T09:30:00-05:00,31.53999,31.77,31.53999,31.62,4189742,4217051.4,57.71513896816138,54.782099713888094,NaN,NaN,176.80349916605212,87.06977963056069,0.018359487816116446,0.0745229700191885,0.05616348220307206,42650785,38911479.2,78.0252602901977,64.93964985150751,NaN,NaN,8.856262252177522,4.977169657735953
2011-01-13T09:30:00-05:00,31.64,31.67,31.45,31.5925,6799789,4024900.6,56.69492703264564,55.00419765949671,NaN,NaN,119.70648700824081,100.2488386287633,0.018645757427705544,0.07947067898770399,0.06082492155999845,35850996,38773760.8,77.51135443155259,67.09747286957794,NaN,NaN,9.565428466910483,5.632635201903742
2011-01-14T09:30:00-05:00,31.55,31.7599,31.49001,31.74001,5501016,4020013.3,60.70717160678657,55.47549848099025,NaN,NaN,159.11395232939563,112.32757780776558,0.026706958649606233,0.09420861987200624,0.0675016612224,41352012,38717847.2,77.28878015743292,68.75887843826139,NaN,NaN,11.382001023804458,6.453973176460988
2011-01-18T09:30:00-05:00,31.74001,31.85001,31.67999,31.815,3594698,3891692.75,62.60405115756842,55.87703832319621,NaN,NaN,205.42503508105625,148.32792451347814,0.03452982734976151,0.1106639454096019,0.07613411805984038,44946710,40652309.2,79.4837796577388,70.26268458682055,NaN,NaN,13.470187311599355,7.456289481480754
2011-01-19T09:30:00-05:00,31.84,31.89,31.69,31.74001,4824832,3883126.15,59.51017873636792,56.31471314403412,NaN,NaN,173.48149317148813,166.9060933512466,0.03214315245804214,0.11631305863239305,0.08416990617435091,40121878,40984476.2,79.84400899970308,71.6180789146891,NaN,NaN,14.3475723476196,8.440758462357731
2011-01-20T09:30:00-05:00,31.78,32.0675,31.75,31.98,8613000,4153404.15,65.40287956275716,57.28766255537789,NaN,NaN,210.2164270776219,173.58867893356054,0.043510473879227546,0.13855799852338535,0.0950475246441578,48734878,42201294.8,81.14973830884493,73.02479820146782,NaN,NaN,17.002793623707984,9.663906342550625
2011-01-21T09:30:00-05:00,32.17999,32.17999,31.88,31.95,7604984,4364189.65,64.14612136503786,58.148736391982354,NaN,NaN,196.32507870139094,188.91239727219056,0.04557333973228077,0.15201419930950877,0.106440859577228,41129894,43257074.4,82.22564581364387,74.48092467583542,NaN,NaN,18.77569967131377,10.965591103802502
2011-01-24T09:30:00-05:00,32.02,32.21001,31.95,32.13,3660972,4403537.95,68.10614522801905,58.96635241006756,NaN,NaN,188.2324335024852,194.7360935068085,0.05499405279766603,0.17518342557431055,0.12018937277664452,44790866,43944845.2,82.90996036303451,75.92302123249608,NaN,NaN,21.5823254218467,12.482267434951673
2011-01-25T09:30:00-05:00,32.07001,32.2,31.94,32.0825,8516855,4722303.15,66.03346856746182,59.3648519567745,NaN,NaN,149.77480866259165,183.60604822311558,0.05388881151568123,0.18755038717124606,0.13366157565556483,36274011,42210305.4,75.06117387474961,76.64944420237337,NaN,NaN,23.257327254883776,14.021561694941973
2011-01-26T09:30:00-05:00,32.12,32.12,31.87,31.96001,5554578,4941078.95,60.887522083476526,59.88928645628589,NaN,NaN,104.94739152120405,169.89922789305874,0.04133553443299237,0.18533099369680528,0.1439954592638129,30719433,40329816.4,67.59060997883788,76.75594211395241,NaN,NaN,23.138946920130017,15.324045298540264
2011-01-27T09:30:00-05:00,31.87,32.16,31.87,32.08,3504398,5023560.4,63.858733939873346,60.56428574663173,NaN,NaN,105.72006669586895,148.99995581670817,0.03764520890192968,0.191051970391225,0.15340676148929533,34223831,37427607,57.996921641677936,75.91585429540994,NaN,NaN,23.935890037968132,16.554308832744244
2011-01-28T09:30:00-05:00,32.10001,32.14999,31.64,31.64999,5662391,5182898.7,49.381109221532434,59.97782863500605,NaN,NaN,34.726124376804,116.68016495179077,0.004517946516192056,0.1590541946345354,0.15453624811834335,28561440,34913916.2,51.21622108199338,74.31788628552923,NaN,NaN,19.544683325410904,16.98150518883948
2011-01-31T09:30:00-05:00,31.8,31.84,31.64999,31.72,4012818,5274974.85,51.31631289216254,59.95479890528353,NaN,NaN,6.4265336560079,80.31898498249531,-0.013423420819250548,0.13775697209428017,0.15118039291353072,32574258,32470594.6,45.631656472367226,72.24029377784429,NaN,NaN,16.746227003899325,16.947894019562316
2011-02-01T09:30:00-05:00,31.89,32.05,31.75999,32.03999,5294621,5362889.35,59.02669742760855,60.38503269924706,NaN,NaN,68.46702336274689,64.05742792252636,-0.004922312921945282,0.14502750176109913,0.1499498146830444,37868879,32789568.2,46.45253611190791,70.17054622740592,NaN,NaN,17.020316018946527,16.958240019474346
2011-02-02T09:30:00-05:00,31.9496,32.00999,31.84,31.86501,3144956,5271066.45,53.991095362387455,60.11902958454892,NaN,NaN,48.64963900721475,52.7978774197285,-0.011869826061019106,0.13511253210677054,0.14698235816778965,34723923,33590466.2,48.55293202253044,68.06537992257255,NaN,NaN,15.446218394246216,16.742236930156043
2011-02-03T09:30:00-05:00,31.84,32.03999,31.71001,31.995,7417785,5412015.65,56.930624108312465,60.1358650899537,NaN,NaN,46.990149106579885,41.05189390187069,-0.008646508788114848,0.13617422218264608,0.14482073097076092,42141708,35174041.6,52.51873183721165,66.28019259440534,NaN,NaN,15.196580958969836,16.5214289342723
2011-02-04T09:30:00-05:00,31.96001,32.02,31.60001,31.8,4927313,5373028.15,51.6042614227267,59.4856572196637,NaN,NaN,2.0998755811758603,34.52664414274508,-0.019937679093999655,0.11989863210326135,0.139836311197261,37214395,36904632.6,56.46802111955702,64.79299552027133,NaN,NaN,13.14427728090391,16.038978698076818
2011-02-07T09:30:00-05:00,31.78999,32.03,31.77,32.005,3722163,5304536.7,56.23948944920709,59.031045669066465,NaN,NaN,46.560898462730044,42.553517104089515,-0.014161839686011285,0.1221340115897469,0.1362958512757582,40936558,38577092.6,59.93615052924111,63.39673629680722,NaN,NaN,13.03718997171849,15.610151737168485
2011-02-08T09:30:00-05:00,32.03999,32.05,31.9101,32.0025,3741156,5173735.5,56.168836508843874,58.79237836710047,NaN,NaN,62.46072607661196,41.352257646862526,-0.01120139582305646,0.12229410649693762,0.13349550231999407,37195402,38442397.2,59.52484281974381,61.94536728395298,NaN,NaN,12.93237059033564,15.22761157333522
2011-02-09T09:30:00-05:00,31.96001,32.03999,31.83,32,4290137,5228910.2,56.092946987797646,58.127383183174786,NaN,NaN,42.264774282195724,40.07528470185872,-0.010135248456758894,0.12082644174904544,0.13096169020580434,32905265,38078665.6,58.360160630470205,60.31754030692622,NaN,NaN,12.826886309149597,14.884650821308703
2011-02-10T09:30:00-05:00,31.97,32.09,31.95,32.06,4245844,5231715.3,57.574473902219,57.657979792973435,NaN,NaN,79.39686177335899,46.55662723521455,-0.006300594372623675,0.12308594724002475,0.12938654161264843,37151109,37080545.8,55.17009769524039,58.38500115561168,NaN,NaN,13.168856446207803,14.639537339151431
2011-02-11T09:30:00-05:00,32,32.17999,31.94,32,9252832,5354367.45,55.55569604161382,56.76151913680163,NaN,NaN,81.24851947836456,62.38635601465228,-0.008575472145260332,0.11866720143107301,0.12724267357633334,27898277,35217322.2,49.70781203207373,56.013419131971624,NaN,NaN,12.884252792792752,14.388782403957334
2011-02-14T09:30:00-05:00,31.98,32.02,31.64999,31.77,4134387,5286036,48.530837121660085,55.51133117638722,NaN,NaN,-86.94606461596328,35.68496339891362,-0.025389890885858885,0.09550530996900974,0.12089520085486863,23763890,31782788.6,41.54284606942764,53.61925286016291,NaN,NaN,10.500376925367554,13.833295907015938
2011-02-15T09:30:00-05:00,31.77,31.91499,31.64999,31.87,3225554,5267578.8,51.40778852280714,54.834207350625135,NaN,NaN,-91.1895864646901,4.954900890653207,-0.029318274855567178,0.08424735728540966,0.11356563214097684,26989444,29741597,37.59088244508427,51.476415179180506,NaN,NaN,9.344985036012183,13.192108639729687
2011-02-16T09:30:00-05:00,31.92,31.96001,31.63,31.8,5413246,5296999.5,49.32918304547339,53.79638228673942,NaN,NaN,-105.31881290920552,-24.56181654762704,-0.03574619006595407,0.06888289455853425,0.10462908462448832,21576198,27475783.6,33.75250440066908,49.74467109053702,NaN,NaN,7.77286183795313,12.41793052519018
2011-02-17T09:30:00-05:00,31.87,31.96001,31.78,31.86,8173641,5275031.55,51.1523430154768,53.92289898630688,NaN,NaN,-46.11875952297833,-49.664940806894506,-0.03502603200290397,0.06084654462085837,0.09587257662376233,29749839,25995529.6,31.490266143636575,48.33567430922581,NaN,NaN,6.972613396187856,11.640028078189847
2011-02-18T09:30:00-05:00,31.88,31.96001,31.8,31.91,2978267,5043695.7,52.68030396119593,54.02032691980927,NaN,NaN,-24.86190740990018,-70.88702618454747,-0.030421697195132213,0.05784545512984707,0.08826715232497928,32728106,26961495.4,34.57207485637713,47.54570419379795,NaN,NaN,6.723530820717364,10.937671327122349
2011-02-22T09:30:00-05:00,31.69,31.88,31.63,31.77,6011887,5161241.45,48.13969056874458,53.24268357274756,NaN,NaN,-113.40340026498471,-76.17849331435175,-0.035680221415471086,0.043666875555640416,0.0793470969711115,26716219,27551961.2,36.453818838577305,46.83151010284576,NaN,NaN,5.205553528807185,10.118797355934468
2011-02-23T09:30:00-05:00,31.73,31.89,31.66499,31.7,5419094,5006353.4,46.004572289369285,52.67221763896054,NaN,NaN,-108.26894022877985,-79.59436406716972,-0.04229637516116262,0.02647662801965822,0.06877300318082084,21297125,26413497.4,34.39954093123417,45.8205535963246,NaN,NaN,3.3121470464357574,9.146418740291795
2011-02-24T09:30:00-05:00,31.63,31.77,31.49001,31.5775,7090445,5083146.75,42.4557979502412,51.63830148481259,NaN,NaN,-183.26909097357506,-95.18441968004362,-0.052670660435422914,0.0029346776365422045,0.05560533807196512,14206680,24939593.8,31.89368872439026,44.34733623112307,NaN,NaN,0.6274683661674678,7.9294258297026055
2011-02-25T09:30:00-05:00,31.64,31.778,31.56,31.755,3947919,5105322.8,48.6382931341623,51.42644660705799,NaN,NaN,-110.90817060249982,-108.14230189594791,-0.045591286333301284,-0.0013837698446614866,0.0442075164886398,18154599,22620545.8,28.389511465000993,42.34172839865479,NaN,NaN,0.06993636883851263,6.806641621007735
2011-02-28T09:30:00-05:00,31.86,32.2265,31.8,32.11,12307453,5437575.9,58.29023390019399,51.57292835355705,NaN,NaN,119.54797094553497,-79.26032622486089,-0.016511862064822448,0.02356768890761174,0.04007955097243419,30462052,22167335,27.747879038027833,40.042566149282415,NaN,NaN,2.802893977162583,6.234677671886999
2011-03-01T09:30:00-05:00,32,32.24001,31.78,31.785,12154613,5844665.65,49.17869220518597,51.0736323318672,NaN,NaN,41.21483942911431,-48.33667828604108,-0.018526001557854846,0.016922049025115626,0.03544805058297047,18307439,20485579,25.449337846942313,37.60860150836802,NaN,NaN,1.9701909738072132,5.62546528644703
2011-03-02T09:30:00-05:00,31.8,31.92999,31.72,31.84,5759797,5867924.45,50.586381281802055,50.68030621001037,NaN,NaN,-27.772338057987913,-32.2373578518827,-0.015630463158049022,0.015909971635409192,0.031540434793458215,24067236,21039601.2,27.577691187386407,35.4098536910049,NaN,NaN,1.801404092717062,5.0791708301998915
2011-03-03T09:30:00-05:00,31.99001,32.25999,31.99001,32.2,5779586,5999655.95,58.65825256763257,50.75771897182563,NaN,NaN,167.0442840292698,37.82531714868627,0.009690589772797534,0.043653672009455136,0.0339630822366576,29846822,24167629.6,38.28985056576901,34.204121753185504,NaN,NaN,4.582872143518822,5.008271017816882
2011-03-04T09:30:00-05:00,32.17,32.23,31.77,32.005,7340512,5995792.3,53.55502871927452,50.614814163087104,NaN,NaN,69.17828339274502,73.84260794773525,0.012299259088492553,0.049337156097273294,0.03703789700878074,22506310,25037971.8,40.90882536919522,33.57562270583704,NaN,NaN,5.020646651993169,5.010038965556351
2011-03-07T09:30:00-05:00,32.14,32.38,32.05,32.13,10805387,6289696,56.186413666891916,51.161641059175096,NaN,NaN,153.7988603054875,80.69278581972574,0.02092911553235912,0.06319929142422964,0.04227017589187052,33311697,25607900.8,42.625964624867635,33.6529883169399,NaN,NaN,6.275785477988845,5.19085989590385
2011-03-08T09:30:00-05:00,32.24001,32.56,32.13,32.49001,6721852,6439680.45,62.734852389491316,51.970717049652535,NaN,NaN,213.98522292641098,115.24686251918509,0.047830631569398215,0.10205846535361829,0.054227833784220074,40033549,29953122.8,53.67807862426282,34.802073758309795,NaN,NaN,9.759557577752162,5.843530993310752
2011-03-09T09:30:00-05:00,32.5,32.89,32.45,32.82001,13105762,6907910.75,67.5260890078388,53.270496046964375,NaN,NaN,271.6871286819942,175.1387558671815,0.08275006415960413,0.15766541398372524,0.07491534982412111,53139311,35767537.8,63.74282184397673,36.94423928997463,NaN,NaN,14.479400322902162,7.077226611823811
2011-03-10T09:30:00-05:00,32.7,32.71001,32.42999,32.44749,10856918,7236249.8,58.39830502805696,53.78806476214868,NaN,NaN,165.37027965598534,174.80395499252458,0.07584264783445424,0.1697186596171889,0.09387601178273466,42282393,38254652,67.04162436521528,39.48362202008736,NaN,NaN,14.954643801283579,8.202571924603777
2011-03-11T09:30:00-05:00,32.39999,32.64,32.34,32.52,5031848,7275550,59.54461761524295,54.278372880294896,NaN,NaN,132.51418546639832,187.47113540725525,0.07130898530057121,0.18301224340844868,0.11170325810787747,47314241,43216238.2,72.43052639849984,42.187797130238984,NaN,NaN,15.718589038695841,9.276288655188358
2011-03-14T09:30:00-04:00,32.16,32.2,31.87,32.09,18974032,7761610,50.634319278456736,54.45656064527434,NaN,NaN,9.860788070711617,158.6835209603001,0.036269265890515476,0.15703984047102182,0.12077057458050634,28340209,42221940.6,69.96178332801315,44.58122316519869,NaN,NaN,13.064949379835037,9.817525901566455
2011-03-15T09:30:00-04:00,31.5,31.64999,31.36501,31.48,14255969,8267689.1,41.21267678704643,54.11428239510841,NaN,NaN,-130.7121896965003,89.74403843571784,-0.027624063457791878,0.08624049525826649,0.11386455871605837,14084240,37032078.8,58.712846580473894,46.317887854430104,NaN,NaN,6.949206934986535,9.407766049197894
2011-03-16T09:30:00-04:00,31.42999,31.50999,30.74001,30.985,15344250,8873623.9,35.44847416645203,53.613759267694896,NaN,NaN,-204.05598049363425,-5.404583399407852,-0.09885089045749468,-0.009699054355809977,0.0891518361016847,-1260010,26152214.6,43.0762863072746,47.11664482463612,NaN,NaN,-0.3852888942504483,8.008758200133846
2011-03-17T09:30:00-04:00,31.28,31.3,30.78999,31.03,12025199,9204221.55,36.32044197940592,52.73391275664087,NaN,NaN,-182.24196463487928,-74.92703225758078,-0.1362535441071882,-0.08116509403230054,0.05508845007488765,10765189,19848773.8,36.93832469353877,47.72727434096025,NaN,NaN,-5.388284564227865,6.094894948082173
2011-03-18T09:30:00-04:00,31.07001,31.14999,30.75,30.88,9099730,9250526,34.64069463732693,51.04465995215037,NaN,NaN,-170.62865803884358,-135.55560095862916,-0.1626290473311205,-0.14819785908901295,0.014431188242107526,1665459,10719017.4,30.221447985509855,47.903957837208964,NaN,NaN,-9.86270544387939,3.815237749230521
2011-03-21T09:30:00-04:00,31.21001,31.343,31.09,31.24001,5087301,9355977.7,41.619321308649376,50.50470488811204,NaN,NaN,-102.50901016270417,-158.0295606053123,-0.14779198761814685,-0.17030879628057605,-0.022516808662429194,6752760,6401527.6,27.659926420924137,48.06185702106482,NaN,NaN,-11.144474845190695,1.6781359500274902
2011-03-22T09:30:00-04:00,31.28999,31.4399,31.16,31.285,7269688,9418867.75,42.44635177455446,49.92327420902292,NaN,NaN,-82.19167430019596,-148.32545752605145,-0.12766846768439122,-0.18210239326791822,-0.054433925583527,14022448,6389169.2,27.65270145299634,48.0672148971798,NaN,NaN,-11.858653772438528,-0.255691153181941
2011-03-23T09:30:00-04:00,31.25999,31.34,31.08,31.27,5621875,9429006.8,42.2315443533569,48.74993790800323,NaN,NaN,-82.70338116149112,-124.05493765962281,-0.10882384445736522,-0.19046373115523352,-0.0816398866978683,8400573,8321285.8,30.700395901996075,47.5251109926246,NaN,NaN,-12.483950310492535,-2.002585318512026
2011-03-24T09:30:00-04:00,31.48,31.48,31.19,31.39999,6197090,9384339.05,44.83686522372072,48.1272119440351,NaN,NaN,-60.51383692053504,-99.70931211675396,-0.08226772056735264,-0.1844745374070591,-0.10220681683970646,14597663,9087780.6,31.925558572485173,46.88344907857388,NaN,NaN,-12.223542503987707,-3.462722059294266
2011-03-25T09:30:00-04:00,31.39999,31.53,31.36,31.39,3405636,9357224.9,44.67012979015563,47.304620238553944,NaN,NaN,-47.20569288791481,-75.02471908656821,-0.06101598515957772,-0.17847679828917862,-0.1174608131296009,11192027,10993094.2,35.001704326045584,46.33885905722945,NaN,NaN,-12.05986967306293,-4.690886004118361
2011-03-28T09:30:00-04:00,31.41,31.58,31.28,31.28,4589793,8971341.9,42.7835242787447,45.87952537350061,NaN,NaN,-48.460681694966,-64.21505339302057,-0.05044632556225073,-0.18051872008241432,-0.1300723945201636,6602234,10962989,34.974811407477176,45.002911398887626,NaN,NaN,-12.442328236064885,-5.798234894396435
2011-03-29T09:30:00-04:00,31.3,31.62,31.205,31.58501,5438066,8635514.55,49.1913097154557,44.56989828118754,NaN,NaN,-33.03912787651685,-54.38454410828474,-0.020526117117176168,-0.15573004091663378,-0.13520392379945761,12040300,10566559.4,34.59784123582858,42.921127069734176,NaN,NaN,-10.909114913892745,-6.5283606114673365
2011-03-30T09:30:00-04:00,31.75,32.07001,31.67,31.95,5598016,8627425.5,55.5993825313939,44.36997524571161,NaN,NaN,23.98656109287804,-33.046555657410906,0.023828740344449206,-0.1054179983688961,-0.1292467387133453,17638316,12414108,37.95427403859563,40.84345918926135,NaN,NaN,-7.519656462115193,-6.66997430441703
2011-03-31T09:30:00-04:00,31.94,31.97,31.8,31.87,5503695,8613630.95,53.99202403220237,43.973361418351566,NaN,NaN,24.28700438137803,-16.086387397028297,0.04645326850143791,-0.0711801530865479,-0.11763342158798581,12134621,11921499.6,37.40310582369362,38.341500576775196,NaN,NaN,-5.2304303507159515,-6.464325168174019
2011-04-01T09:30:00-04:00,32.09,32.14999,31.95,32.12,6176758,8555443.25,58.07134963164124,44.504577872150456,NaN,NaN,50.11206667589647,3.377164515733935,0.07522558474984772,-0.023601440650676153,-0.09882702540052388,18311379,13345370,40.11035688480965,36.209255830832085,NaN,NaN,-1.9895073278344357,-5.825065476696936
2011-04-04T09:30:00-04:00,32.2,32.2,31.99001,32.10001,3974110,8213879.4,57.63133070289807,45.677338866139856,NaN,NaN,54.4852355508719,23.966347964901512,0.08894133773142945,0.012349646763762934,-0.07659169096766652,14337269,14892377,42.995019642706936,35.08655390670587,NaN,NaN,0.49952228043813696,-4.9215529399633535
2011-04-05T09:30:00-04:00,32.09,32.12,31.95,31.97,4024588,8079016.2,54.72691323109571,47.05437022790012,NaN,NaN,47.64017913030752,40.10220936626639,0.08527699144307148,0.03000454833617283,-0.05527244310689865,10312681,14546853.2,42.50260692278853,35.04557680781401,NaN,NaN,1.7945425712356144,-3.9621107240777866
2011-04-06T09:30:00-04:00,32.12,32.25999,32.02,32.2,3769890,7612222.6,58.69297998202209,48.65240865665843,NaN,NaN,78.16991433881748,50.93888001545428,0.09369186036600569,0.06184238235060846,-0.031849478015397226,14082571,13835704.2,41.45038581806625,35.36786688813741,NaN,NaN,4.0990076207857475,-2.810522389097282
2011-04-07T09:30:00-04:00,32.14999,32.2,31.95,32.07001,5339996,7336376.5,55.72191118709812,50.15820983878494,NaN,NaN,72.48702026903408,60.578883192985494,0.08604936253683629,0.07571222515564813,-0.010337137381188154,8742575,13157295,40.42230253738813,36.09649935612871,NaN,NaN,5.195654131342107,-1.6667828861773695
2011-04-08T09:30:00-04:00,32.22,32.24001,31.84109,31.98,5961836,7382875.9,53.69503968395919,51.02076115130706,NaN,NaN,72.43316040985366,65.04310193977692,0.07109835697137835,0.07853580883303479,0.007437451861656438,2780739,10051167,36.01750774610375,36.69346945078439,NaN,NaN,5.544590671472438,-0.6365866636559685
2011-04-11T09:30:00-04:00,31.92,31.98,31.49001,31.56,9345777,6901463.15,45.397079612364394,51.23152742543634,NaN,NaN,16.01873893735351,57.34980261707325,0.03112903834279913,0.04634874979015535,0.015219711447356222,-6565038,5870705.6,31.104793463349054,36.940047451523874,NaN,NaN,3.297097425201341,-0.07463179381921003
2011-04-12T09:30:00-04:00,31.48,31.63,31.35001,31.48,8531293,6615229.35,44.002199324306716,51.35800278050419,NaN,NaN,-19.29494245818794,43.96277829937416,-0.0007989601769352733,0.01422101122618713,0.015019971403122404,-15096331,788903.2,26.392184298772207,36.6323180512936,NaN,NaN,1.0386505710061906,0.08440854401299006
2011-04-13T09:30:00-04:00,31.60001,31.82001,31.56,31.56,5305324,6113283.05,45.795803537640005,51.42649837435556,NaN,NaN,5.575088062085846,29.44381304402783,-0.015800449395100023,-0.004730590340752627,0.011069859054347396,-9791007,-3985812.4,22.88401360225822,35.98649341056311,NaN,NaN,-0.3182602544800437,0.026884429942556673
2011-04-14T09:30:00-04:00,31.42,31.82001,31.39999,31.75,5781145,5801080.35,49.900118152630434,51.800068971675195,NaN,NaN,1.5688128951675153,15.260171569254519,-0.012350372210200583,-0.004368106208403333,0.00798226600179725,-4009862,-6536299.8,21.258473059780655,35.00483403440132,NaN,NaN,-0.2991665058092907,-0.019694275164850096
2011-04-15T09:30:00-04:00,31.84,32.198,31.8,32.10001,7161605,5704174.1,56.44310675704158,52.77575343441068,NaN,NaN,75.28988259803674,15.831516006891132,0.01272354396683641,0.023886695960342763,0.011163151993506353,3151743,-6462099,21.433326452307966,34.037585109032094,NaN,NaN,1.7610677097868361,0.23470029411396223
2011-04-18T09:30:00-04:00,31.91,32.00999,31.63,31.82001,7150227,5807320.4,50.7347955862573,52.886002425182234,NaN,NaN,20.9339099823097,16.814550215882367,0.009801681469912995,0.023415253830897598,0.013613572360984602,-3998484,-5948788.2,22.711939515602594,33.18859212901595,NaN,NaN,1.727127785238268,0.44790422141743447
2011-04-19T09:30:00-04:00,31.88,31.89,31.73,31.83,5657473,5726709.65,50.92549300503374,52.55215317329936,NaN,NaN,14.84287968930312,23.64211464538058,0.007969920444483674,0.023575972916589194,0.01560605247210552,1658989,-2597724.2,30.647045672748447,32.666647245741146,NaN,NaN,1.7573768240902101,0.6349717360849738
2011-04-20T09:30:00-04:00,32.09,32.27,32.03999,32.24001,5869578,5739094.8,58.09492559766217,52.84521757083221,NaN,NaN,105.64319231103403,43.65573549517022,0.03242761466190934,0.056140570799492195,0.023712956137582855,7528567,866190.6,37.76042712690035,32.692170195970206,NaN,NaN,4.099526299090709,1.1299081022286503
2011-04-21T09:30:00-04:00,32.23,32.26711,32.12,32.24001,4065724,5632526.5,58.09492559766217,52.84690156840513,NaN,NaN,104.78028207676466,64.29802933148964,0.04584112793374419,0.08101436605476309,0.0351732381210189,7528567,3173876.4,42.02655986417057,32.829041837353124,NaN,NaN,5.942663325093688,1.8174445626379414
2011-04-25T09:30:00-04:00,32.27,32.34,32.16991,32.28,2504823,5587485.85,58.77617085481681,52.92867586497075,NaN,NaN,112.20207678816404,71.68046816951511,0.05407679119253671,0.10276922711168979,0.04869243591915308,10033390,4550205.8,44.47120810765658,32.93448387056382,NaN,NaN,7.6436217976001934,2.6497555962039776
2011-04-26T09:30:00-04:00,32.3,32.5795,32.3,32.53999,5278805,5621936.45,62.98885867163532,53.5188148250093,NaN,NaN,161.00890326006038,99.69546682506525,0.07255198539210789,0.13938241765928794,0.06683043226718005,15312195,8412341.6,50.74752934232744,33.52340690053088,NaN,NaN,10.423164278852722,3.760242550868084
2011-04-27T09:30:00-04:00,32.64,32.86,32.56,32.8,6107984,5655432.35,66.65842809870925,54.08777540477265,NaN,NaN,220.1892050897623,140.76473190515708,0.09631253470674159,0.18722110065060704,0.09090856594386545,21420179,12364579.6,56.20299229516444,34.577164506037896,NaN,NaN,14.001429300880694,5.223269229441314
2011-04-28T09:30:00-04:00,32.78,33.12,32.75999,33.09,6760598,5713561.45,70.20653193103392,55.122391172196636,NaN,NaN,236.45964562690435,166.92802256833116,0.123834650944904,0.24570187962499546,0.12186722868009145,28180777,16495021.6,61.057702219687,36.0511216262021,NaN,NaN,18.27051722261049,7.087161799894053
2011-04-29T09:30:00-04:00,33.06,33.17999,32.96001,33.16,8737094,5875231.4,71.00851542530441,56.359068010864156,NaN,NaN,208.92487948719517,187.75694205041725,0.13794955938716688,0.29430417791405006,0.15635461852688318,36917871,22372882.4,66.71239313493882,38.24361343969032,NaN,NaN,21.968875944655025,9.213120963431335
2011-05-02T09:30:00-04:00,33.22,33.32001,33.12,33.17,5549859,5843886.45,71.12808113950958,58.19699669137453,NaN,NaN,183.95585818131048,202.1076983290465,0.1387776881201775,0.32982672867710505,0.19104904055692756,42467730,28859750.4,71.61162774143267,41.13695874526773,NaN,NaN,24.982798114374297,11.465931984994615
2011-05-03T09:30:00-04:00,33.17999,33.61,33.06,33.38,16424625,6466412.2,73.5912180708588,60.31049803041396,NaN,NaN,167.32898084231886,203.37171384549825,0.14368173920299693,0.37065121456067374,0.2269694753576768,58892355,37575782.4,76.59594058977407,44.72294133748214,NaN,NaN,28.35673974772884,13.878904522528076
2011-05-04T09:30:00-04:00,33.38,33.42999,33.13,33.34,8646410,6697503.3,72.32552076198746,62.205477832153065,NaN,NaN,132.3620036165737,185.8062735508605,0.13460152528772967,0.3952213819673389,0.26061985667960924,50245945,43340935.6,79.19762408647742,48.74534208635494,NaN,NaN,30.778324167826103,16.293107328999223
2011-05-05T09:30:00-04:00,33.2999,33.32001,32.96001,33.10001,5734297,6795723.65,65.09200619760416,63.290612692508326,NaN,NaN,94.56975876631932,157.4282961787435,0.10416256611955671,0.3908230643290551,0.2866604982094984,44511648,46607109.8,80.51888975091708,52.97822899286468,NaN,NaN,30.821698937504554,18.368620415928557
2011-05-06T09:30:00-04:00,33.42999,33.53999,33.16,33.28999,5740711,6815759.4,67.83451084473083,64.10428441305756,NaN,NaN,104.06061081110951,136.45544244352635,0.08913429310568516,0.39807836459160484,0.3089440714859197,50252359,49274007.4,81.54937093635462,57.27223217029659,NaN,NaN,31.665079217113345,20.268114530383528
2011-05-09T09:30:00-04:00,33.25,33.39,33.11,33.36,3922391,6713787.15,68.80706892239616,65.39516107992462,NaN,NaN,88.15903704576284,117.29607821641684,0.0766935863109538,0.40481105437461196,0.32811746806365816,54174750,51615411.4,82.42818632090365,61.53767837067523,NaN,NaN,32.642251419590664,22.035848371698833
2011-05-10T09:30:00-04:00,33.50999,33.92,33.45,33.84,8579219,6675459.25,74.49995159047539,67.07905097888474,NaN,NaN,121.83720362071878,108.19772277209681,0.09251668209224817,0.4437633206789684,0.35124663858672023,62753969,52387734.2,82.7205501014165,65.25721440129438,NaN,NaN,35.41053224244623,23.946517496091317
2011-05-11T09:30:00-04:00,33.84,33.84,33.55,33.73,4102129,6454001.05,71.28899332700806,68.02148438812374,NaN,NaN,108.64803977236873,103.45493000325582,0.08736222305494923,0.4604494174054068,0.37308719435045756,58651840,54068913.2,83.36921372773736,68.51498487278273,NaN,NaN,36.65757077924839,25.762382250828043
2011-05-12T09:30:00-04:00,33.73,34.10001,33.67,34.07001,5885020,6482985.85,74.89134282459568,69.22122847576183,NaN,NaN,123.283257672884,109.19762978456875,0.09784911503689664,0.49539858814657833,0.3975494731096817,64536860,58073955.6,84.83020367658489,71.5723880022409,NaN,NaN,38.93603849086388,27.644333142261733
2011-05-13T09:30:00-04:00,34.14999,34.17,33.73,33.91,6912555,6539556.35,70.41384286587132,70.05249076226573,NaN,NaN,114.3621296338779,111.25793354912241,0.0854568364197939,0.5043705186344241,0.41891368221463016,57624305,59548344.8,85.34075085237744,74.49164105543525,NaN,NaN,39.36357589685453,29.318510678632133
2011-05-16T09:30:00-04:00,33.99001,34.25,33.88,33.95,8112809,6587116.55,70.88250039720177,70.6163223140919,NaN,NaN,116.42414137004764,116.91095441397938,0.07194335816061492,0.5088428799153988,0.43689952175478386,65737114,61860817.6,86.12925690603454,77.01890730998575,NaN,NaN,39.84589581239693,30.822422840598534
2011-05-17T09:30:00-04:00,33.86,34.21001,33.86,34.2,8710844,6665147.4,73.6878563467994,71.11842433181263,NaN,NaN,117.95743335068097,116.13500035997181,0.0716732684831512,0.5264911073587228,0.45481783887557165,74447958,64199615.4,86.89691459525349,79.21133033142068,NaN,NaN,41.131756308604146,32.295184764599334
2011-05-18T09:30:00-04:00,34.17999,34.23,33.89999,34.09,5450398,6654793.65,70.4706456397314,71.1372895967196,NaN,NaN,109.43553231439216,116.29249886837651,0.0565803198975845,0.5255432387475523,0.46896291884996777,68997560,66268759.4,87.55322234228431,81.10386748303479,NaN,NaN,41.21300991657718,33.56915978631046
2011-05-19T09:30:00-04:00,34.10001,34.24001,34.00999,34.17,3202656,6521447.55,71.44702139739158,71.16861145186867,NaN,NaN,108.50165109502595,113.33617755280491,0.044984285950977365,0.5251932762886895,0.48020899033771214,72200216,67801430.6,88.03143281740927,82.62665603178267,NaN,NaN,41.56379074088877,34.71124992267879
2011-05-20T09:30:00-04:00,34.14,34.3,33.98,34.13,4473992,6541860.95,70.19722952462077,71.10212205080519,NaN,NaN,96.41732209346029,109.74721604472138,0.028427285669399782,0.5157430974244619,0.4873158117550621,67726224,69821814.4,88.65046034777248,83.84371550366409,NaN,NaN,41.49846253173433,35.68085172397244
2011-05-23T09:30:00-04:00,33.82001,34.09,33.72,33.73,6021648,6717702.2,59.069608118111276,70.06486419703751,NaN,NaN,48.767104758492955,96.21580872241043,-0.013410357395783112,0.4705528650103332,0.48396322240611633,61704576,69015306.8,86.72223610103056,84.56702232589669,NaN,NaN,37.959867660898915,36.00642542924765
2011-05-24T09:30:00-04:00,33.74001,33.88,33.67,33.7,4458527,6676688.3,58.32287189818964,69.06467499248052,NaN,NaN,27.27200010440105,78.07872207315444,-0.04525711867771526,0.42739182405897225,0.4726489427366875,57246049,65574925,78.8440154619199,84.54176456699973,NaN,NaN,34.885807382183394,35.8463371368099
2011-05-25T09:30:00-04:00,33.62,33.78999,33.35001,33.63,6271109,6684844.55,56.52721970145242,68.45290452846969,NaN,NaN,-8.438876084080901,54.50384039345984,-0.07162188538743891,0.3831215860023889,0.4547434713898278,50974940,61970401,71.51384974352057,83.89854742361425,NaN,NaN,31.808620793167968,35.269520516289624
2011-05-26T09:30:00-04:00,33.55,33.67,33.36,33.62,3801780,6536903.65,56.26073311704671,67.62620611934939,NaN,NaN,-23.82490726295204,28.03852872186427,-0.08917625887307462,0.3432731477984845,0.4324494066715591,47173160,56964989.8,62.78463891892067,82.55820942236896,NaN,NaN,29.205418553725433,34.403220235923314
2011-05-27T09:30:00-04:00,33.67999,33.81,33.56,33.62,4500855,6325091.7,56.26073311704671,66.73003927611015,NaN,NaN,-6.218061138261484,7.5114520755199194,-0.09944679193553757,0.3081409167521372,0.40758770868767474,47173160,52854377,56.667219962244694,80.71814039675048,NaN,NaN,27.042323786929966,33.351663600352836
2011-05-31T09:30:00-04:00,33.91,33.92999,33.67,33.87,6378688,6366533.15,61.52039371650251,65.8029279993978,NaN,NaN,26.558991044249797,3.0698293326712855,-0.08843248130855524,0.2970471070519807,0.3854795883605359,53551848,51223831.4,54.40284923876983,78.69544747799,NaN,NaN,26.477160994281885,32.369591799485555
2011-06-01T09:30:00-04:00,33.84,33.86,33.50999,33.52,7165734,5903588.6,52.07853129692973,64.43075214010648,NaN,NaN,-28.703753296600212,-8.125321347528962,-0.10274367415396768,0.2570499956680763,0.35979366982204397,46386114,49051844.4,51.45341456876543,76.41574753806344,NaN,NaN,23.043890485511582,31.03734875463213
2011-06-02T09:30:00-04:00,33.49001,33.5,33.19,33.42,6202211,5781378.65,49.730117175208065,62.6335217365788,NaN,NaN,-102.649905172088,-26.967527165130377,-0.1159895959915368,0.21480667483262295,0.33079627082415974,40183903,46893637,48.632042979694745,73.83016463114271,NaN,NaN,19.478059343372205,29.386021695880714
2011-06-03T09:30:00-04:00,33.11,33.38,32.98,33.19,6092824,5799305,44.73365236360572,60.79922241498839,NaN,NaN,-157.37419701474246,-53.67738511548846,-0.1359053860333012,0.16091453828253321,0.2968199243158344,34091079,44277220.8,45.38312448897187,70.97604846232802,NaN,NaN,14.785864286961491,27.30028492317797
2011-06-06T09:30:00-04:00,33.13,33.185,32.94,33.039,5288609,5776699.9,41.76672082793717,58.71952387432664,NaN,NaN,-178.6679881649817,-88.16737052083252,-0.1536063503181656,0.10481198641812739,0.258418336736293,28802470,40603082.8,41.218796507688026,67.7681584338747,NaN,NaN,9.901310170825452,24.814717101413326
2011-06-07T09:30:00-04:00,33.17,33.39,33.07001,33.08,10147012,6087930.95,42.87460404250788,56.51857728116296,NaN,NaN,-140.65790366786652,-121.61074946325577,-0.15638809953289448,0.0629332123201749,0.21932131185306938,38949482,37682609.6,38.216946659359905,64.29101786702516,NaN,NaN,6.2534773564518735,22.16311142356169
2011-06-08T09:30:00-04:00,33.13,33.25,33.011,33.16,8009656,6059452.8,45.07053615519185,54.704283746552996,NaN,NaN,-128.32365981837492,-141.5347307676107,-0.14682762088265583,0.03578678574974958,0.1826144066324054,46959138,37797214.4,38.40651364776213,60.78053867455928,NaN,NaN,3.8238249340717485,19.543213353634556
2011-06-09T09:30:00-04:00,33.22,33.33,33.03,33.19,5690043,6138848.5,45.91022962408528,52.88022719131683,NaN,NaN,-103.32885140802986,-141.67052001479908,-0.13288868234684678,0.01650355369884693,0.1493922360456937,52649181,40290270,42.536949311471325,57.53093270984943,NaN,NaN,2.0431278017335788,17.043201131934417
2011-06-10T09:30:00-04:00,33.09,33.17999,32.97,32.97,8339867,6261590.85,40.96471528384255,50.79219045983267,NaN,NaN,-117.53857903360142,-133.7033964185709,-0.13258764793740302,-0.01634232387606005,0.11624532406134296,44309314,42333917,45.74861621510686,54.46651527180188,NaN,NaN,-1.0054511163041135,14.464822239328914
2011-06-13T09:30:00-04:00,33.08,33.24001,32.94,33.12,5189652,6175445.7,45.291913478697644,49.808069414160265,NaN,NaN,-93.68546994945177,-116.7068927754649,-0.11693563866353192,-0.029924224268071953,0.08701141439545997,49498966,46473216.2,51.64382727835922,51.960914641611076,NaN,NaN,-2.3778392585270343,12.058727739635207
2011-06-14T09:30:00-04:00,33.39999,33.39999,33.03999,33.25,7116934,6125651.95,48.794950235587685,49.12750358111727,NaN,NaN,-61.13229029045055,-100.80177009998168,-0.09349227323448682,-0.029853927147648562,0.06363834608683826,56615900,50006499.8,56.0354730642522,50.331733041777674,NaN,NaN,-2.5193031759668623,9.976151894549197
2011-06-15T09:30:00-04:00,33.09,33.28999,32.75,32.84,7658191,6073019.3,40.07866219513977,47.95260661638065,NaN,NaN,-102.98304312696636,-95.73364676169999,-0.10064282732443947,-0.062165188068711075,0.03847763925572839,48957709,50406214,56.51659448860228,49.26050052356923,NaN,NaN,-5.491452287215893,7.766494154297042
2011-06-16T09:30:00-04:00,32.92,33.23,32.89,33.10001,8250941,6213046.45,46.594009169411,47.262126334406666,NaN,NaN,-73.85612539357666,-89.83910155880936,-0.0836063553091639,-0.06603030488072648,0.017576050428437417,57208650,51318107.8,57.6550939639544,48.89410445535735,NaN,NaN,-5.846661912438158,5.82175757333487
2011-06-17T09:30:00-04:00,33.11,33.17,32.91,32.99001,7803727,6443100,44.39475690598452,46.414556605045085,NaN,NaN,-79.02420340463462,-82.13622643301599,-0.07572562191976356,-0.07708097697126703,-0.0013553550515034742,49404923,52337229.6,58.94870195999072,49.05706745519635,NaN,NaN,-6.842309422083972,4.012605145417893
2011-06-20T09:30:00-04:00,32.91,33.19,32.765,33.17999,4195031,6429151.95,48.88237144336815,45.51184072839262,NaN,NaN,-69.67944761753874,-77.33502196663339,-0.05468003238940295,-0.06970539553825716,-0.015025363148854214,53599954,53157427.2,60.00760457680634,49.45740712219896,NaN,NaN,-6.213785801104778,2.551692153057511
2011-06-21T09:30:00-04:00,33.31,33.36,33.0899,33.2,5121172,6384128.15,49.3460711563925,45.31666500406853,NaN,NaN,-20.957647127357305,-69.30009333401475,-0.03720867211954758,-0.06153620329828868,-0.024327531178741108,58721126,53578472.4,60.56988387425563,50.108583501162535,NaN,NaN,-5.573541622324672,1.3909444708600565
2011-06-22T09:30:00-04:00,33.14,33.19,32.92999,32.98,5115875,6416995.55,44.56007527427651,44.94737629685914,NaN,NaN,-70.22285893482584,-62.74805649558665,-0.03812551848381557,-0.07198442928351056,-0.033858910799695,53605251,54507980.8,61.845243440831766,51.0523835341009,NaN,NaN,-6.499868019250584,0.26368554370139363
2011-06-23T09:30:00-04:00,32.75999,32.78999,32.42999,32.7,9552945,6581087.35,39.331532744533845,44.56151060978258,NaN,NaN,-185.81412557538275,-85.13965653194786,-0.054261837986603244,-0.10168620828294905,-0.04742437029634581,44052306,51876712,56.29431408139349,51.83175421927387,NaN,NaN,-9.00953517883159,-1.0610602738033181
2011-06-24T09:30:00-04:00,32.78,33.06,32.75999,32.8,5191969,6650596.8,41.9512490346518,44.57469119597648,NaN,NaN,-104.02866375231487,-90.14054860148391,-0.05471714991455922,-0.11582080768954484,-0.061103657774985616,49244275,51844582.4,56.227949489317886,52.90383657510457,NaN,NaN,-10.225771038282211,-2.370304668728874
2011-06-27T09:30:00-04:00,32.83,33.099,32.83,33.03999,3643749,6607741.5,47.77916014381888,44.9250166317844,NaN,NaN,-58.695359616190295,-87.94373100121423,-0.0362614956719427,-0.10643052736491398,-0.07016903169297128,52888024,51702196.4,55.913367250349495,54.16786661731811,NaN,NaN,-9.393554793637378,-3.3736261151443747
2011-06-28T09:30:00-04:00,33.05,33.27,33.02,33.19,5749461,6576280.15,51.08494320758727,45.35461713552694,NaN,NaN,26.77342891132993,-78.39751579347679,-0.012579956198560532,-0.08589397694117196,-0.07331402074261142,58637485,51685468.2,55.8738163026256,55.415531092665496,NaN,NaN,-7.645040761417849,-3.9838282074691564
2011-06-29T09:30:00-04:00,33.3,33.42,33.17931,33.41,5926879,6514337.4,55.53100008085997,46.04181502529656,NaN,NaN,137.8718822761225,-36.7785675512871,0.017630912019601236,-0.051275380718109886,-0.06890629273771112,64564364,53877290.8,59.87842504987999,56.65420793112326,NaN,NaN,-4.707460524132085,-4.087204252706718
2011-06-30T09:30:00-04:00,33.49001,33.50999,33.22,33.48,4462910,6427372.35,56.874167012234544,47.17820443446741,NaN,NaN,172.1835460906158,34.82096678191262,0.04073769938026681,-0.017984168512377607,-0.05872186789264442,69027274,58872284.4,67.18687854587533,58.185512383321004,NaN,NaN,-1.9159354511078655,-3.777022995335453
2011-07-01T09:30:00-04:00,33.48,33.92999,33.44,33.88,9083855,6576923.9,63.63372215970416,48.488333625967876,NaN,NaN,278.28085701834243,111.28287093604408,0.07914747011532855,0.04021246975151627,-0.03893500036381228,78111129,64645655.2,73.25175554496329,59.72893583093558,NaN,NaN,2.924268450363645,-2.819695645949867
2011-07-05T09:30:00-04:00,33.87,33.89999,33.63,33.67999,5957215,6610354.2,58.68088892872579,49.19447210404917,NaN,NaN,215.7842989676405,166.17880265281025,0.08666372114882234,0.06939465107221565,-0.017269070076606694,72153914,68498833.2,76.3884566105533,61.182720369957096,NaN,NaN,5.313950174275071,-1.6577462430605905
2011-07-06T09:30:00-04:00,33.64999,33.85001,33.53,33.75,4050260,6305516.6,59.85863473921957,50.607327285769145,NaN,NaN,166.86960136268283,194.19803714308082,0.09145701967438968,0.09705220451638041,0.005595184841990727,76204174,72012171,78.82657345096753,62.77629029584033,NaN,NaN,7.594597384417348,-0.33598286770659946
2011-07-07T09:30:00-04:00,33.98,33.99001,33.72,33.89,7832363,6296651.95,62.18015754899471,51.72062359859655,NaN,NaN,172.60873235841953,201.1454071595402,0.09855050093399553,0.12878331100948515,0.03023281007548961,84036537,75906605.6,81.15010352320937,64.45450526435853,NaN,NaN,10.216306826468866,1.1714870886041813
2011-07-08T09:30:00-04:00,33.71001,33.8,33.56,33.75999,5926898,6308494.7,58.78040879066237,52.748170161787826,NaN,NaN,110.11544452431217,188.73178684627948,0.08925781622655186,0.14180508035867945,0.05254726413212758,78109639,77723078.6,82.1348684764088,66.11066001553125,NaN,NaN,11.370620113004732,2.628506092089974
2011-07-11T09:30:00-04:00,33.53,33.53999,33.25,33.39999,7473867,6265194.7,50.54013194174948,52.86658162595792,NaN,NaN,31.862203542712813,139.4480561511536,0.05530087691193643,0.12167336027204811,0.06637248336011169,70635772,76228007.2,78.49982208900187,67.4315326949738,NaN,NaN,9.73136476935601,3.6432001888422647
2011-07-12T09:30:00-04:00,33.33,33.75,33.25999,33.55,6081395,6309781.85,53.4674407120859,53.1609651656503,NaN,NaN,54.83830517494229,107.25885739261393,0.04008654434456435,0.11648066379081712,0.07639411944625277,76717167,77140657.8,79.10767222114062,68.75566043403701,NaN,NaN,9.310718669536673,4.452845686084323
2011-07-13T09:30:00-04:00,33.67999,33.75,33.39999,33.46001,4458344,6176852.35,51.49834172270294,53.65655562625219,NaN,NaN,53.29814219163458,84.54456555840427,0.022009670375936513,0.1039062074161734,0.08189653704023689,72258823,76351587.6,77.07866119869874,69.84376170245608,NaN,NaN,8.360933834902584,5.01114399305836
2011-07-14T09:30:00-04:00,33.48,33.62,33.265,33.31,7400004,6163943,48.304755241072165,54.29750009029065,NaN,NaN,18.247451293063552,53.672309345333076,-0.0007942701555295334,0.08090369934582498,0.08169796950135451,64858819,72516044,67.95474008344038,70.67664927403085,NaN,NaN,6.583791862189338,5.2358079743627854
2011-07-15T09:30:00-04:00,33.34,33.46001,33.17999,33.36,6034359,6053113.9,49.43042048162962,54.83172662221763,NaN,NaN,-0.11608507425429214,31.626003425619786,-0.012599642943182637,0.0659484158223762,0.07854805876555884,70893178,71072751.8,64.84423610227142,71.29209831781326,NaN,NaN,5.460456583229987,5.267900632772386
2011-07-18T09:30:00-04:00,33.28999,33.33,32.97,33.03999,6543230,5990089.05,42.979802741835556,54.48891537921882,NaN,NaN,-56.76865298158105,13.899832120761015,-0.04047692605194844,0.027951901200623297,0.06842882725257174,64349948,69815587,62.17463200261539,71.73933151440369,NaN,NaN,2.423760174427464,4.8615948530088255
2011-07-19T09:30:00-04:00,33.14,33.38,32.89,33.33,8017156,6181195.3,49.42158872668491,54.37010434486865,NaN,NaN,-37.968023219922976,-4.661433558212032,-0.03794409155559928,0.02099871280807264,0.05894280436367192,72367104,68945574.4,60.32373720502463,72.05718300743219,NaN,NaN,1.8282041015326482,4.428253317083658
2011-07-20T09:30:00-04:00,33.35001,33.649,33.25999,33.53,3627585,6106515.95,53.33678833831386,54.21337493468678,NaN,NaN,31.450835708038895,-9.03089485493117,-0.02214130551612728,0.03126617246851282,0.0534074779846401,75994689,69692747.6,61.386861495528365,72.16492846783564,NaN,NaN,2.589383396297473,4.165557614114203
2011-07-21T09:30:00-04:00,33.64999,34.09,33.64999,34.03,7551035,6228273.95,61.38454097666066,54.53554450357437,NaN,NaN,133.42638801103834,14.004892488663788,0.020346184571140367,0.07884020869856556,0.058494024127425194,83545724,73430128.6,66.2572590387517,72.09852707446967,NaN,NaN,6.126738141113165,4.44572626082834
2011-07-22T09:30:00-04:00,34.11,34.11,33.77,33.82001,4430617,5972157.55,56.942810672727276,54.05762225450459,NaN,NaN,117.30057867495128,37.4882252385049,0.03197558954515911,0.09846351105887408,0.06648792151371496,79115107,75074514.4,68.16018078745502,71.73484316321908,NaN,NaN,7.468687589538948,4.877577879215569
2011-07-25T09:30:00-04:00,33.59,34.0589,33.59,33.94,4885465,5956832.35,58.77829324480044,54.064579705652775,NaN,NaN,98.33151621956559,68.50825907873423,0.04463978583521895,0.12228765380773865,0.0776478679725197,84000572,79004639.2,72.19602803925554,71.43538397955494,NaN,NaN,9.143061315459352,5.486932655821824
2011-07-26T09:30:00-04:00,33.99001,33.99001,33.74001,33.82001,4823047,6015797.25,56.198334752713244,53.803129706616616,NaN,NaN,85.27526629032054,93.15691698078294,0.04187198511422971,0.12998784936530683,0.08811586425107712,79177525,80366723.4,73.45199527721735,71.05148553857279,NaN,NaN,9.679620122919466,6.0858880082643445
2011-07-27T09:30:00-04:00,33.75999,33.89999,33.64999,33.72,13818473,6419247.85,54.06813563959091,53.22369957023062,NaN,NaN,51.43570498520122,97.1538908362154,0.030756442520716812,0.12656141740197313,0.09580497488125632,65359052,78239596,68.26579980243055,70.13117812994572,NaN,NaN,9.463357327244257,6.5683836252614745
2011-07-28T09:30:00-04:00,33.71001,33.73,33.47,33.50999,5639285,6404868.15,49.799374344414154,52.582197109784325,NaN,NaN,-9.960956500880139,68.4764219338317,0.007901348980622613,0.10568166110703459,0.09778031212641197,59719767,73474404.6,58.32988350676177,68.43082206068523,NaN,NaN,7.957251155200301,6.766793272395592
2011-07-29T09:30:00-04:00,33.22,33.46001,33.08099,33.17,10200551,6691750.2,43.77395698557681,52.09889889862914,NaN,NaN,-110.76782024760392,22.86274214932066,-0.029426794605900808,0.06099681886903596,0.09042361347493677,49519216,67555226.4,48.823791881211356,66.31110561727162,NaN,NaN,4.667418499150461,6.46688259050343
2011-08-01T09:30:00-04:00,33.48,33.50999,33.03,33.27,7551531,6615134,45.8492814768259,51.55474466753913,NaN,NaN,-90.46585745740184,-14.896732586072824,-0.045723359082840004,0.03326941462138677,0.07899277370422678,57070747,62169261.4,42.1004603512717,63.667733340852415,NaN,NaN,2.642948008718836,5.92060622167706
2011-08-02T09:30:00-04:00,33.13,33.21001,32.7,32.7,9369293,6785737.9,37.3799879173312,50.546290824298296,NaN,NaN,-179.54304383457986,-67.8603946110529,-0.09063706635821334,-0.034303559243539894,0.05633350711467344,47701454,55874047.2,35.88104241979795,60.72504628521665,NaN,NaN,-2.1977309170860173,4.7608437732823345
2011-08-03T09:30:00-04:00,32.74001,32.75999,32.28,32.7,12982609,7232355.35,37.3799879173312,49.76595030117394,NaN,NaN,-210.18076146926734,-120.18368790194661,-0.11455034499741226,-0.08685442413209188,0.027695920865320377,47701454,52342527.6,32.94111266609744,58.22407289826358,NaN,NaN,-5.912263189214691,3.236114207211331
2011-08-04T09:30:00-04:00,32.42,32.60001,31.63,31.63,17028288,7692151.6,26.65896497705208,48.139417765132684,NaN,NaN,-276.2181862428206,-173.4351338503347,-0.19207120510977865,-0.21239308552190295,-0.020321880412124294,30673166,46533207.4,28.765735080675128,55.6470371110067,NaN,NaN,-13.994014047670827,0.774667313656737
2011-08-05T09:30:00-04:00,31.89999,32.16,31.3,31.89,21967392,8494176.3,31.77918063612809,47.33937332901072,NaN,NaN,-236.66123901098388,-198.6138176030107,-0.21381322514789808,-0.2875884118469969,-0.07377518669909883,52640558,47157475.8,29.795535215372283,53.33424448334648,NaN,NaN,-18.307190907281814,-1.951312432191627
2011-08-08T09:30:00-04:00,31.44,31.7198,30.08,30.2,17827984,9011882.15,21.346983694096124,45.33404439811152,NaN,NaN,-280.70648967393316,-236.66194404631696,-0.32341151708017396,-0.47803958304931626,-0.1546280659691423,34812574,42705841.2,26.81820784223663,50.94099238600448,NaN,NaN,-27.566759784280382,-5.610662053918592
2011-08-09T09:30:00-04:00,30.8,31.25,29.45,31.19,24731344,9944379.6,34.840985454058895,44.012915620664735,NaN,NaN,-210.53682651061737,-242.86070058152444,-0.31056263531301026,-0.5428313601104051,-0.23226872479739485,59543918,45074334,30.781316478545122,48.75488202764853,NaN,NaN,-28.32869926382355,-8.856095941047872
2011-08-10T09:30:00-04:00,30.8,31.39999,30.48,30.60001,16835600,10563242.4,31.385216860164704,41.870106755200744,NaN,NaN,-155.44547512774443,-231.9136433132199,-0.3217632324700262,-0.6344727653849276,-0.3127095329149014,42708318,44075706.8,30.042585605619607,46.16811963956766,NaN,NaN,-30.417063720018888,-11.93623419518659
2011-08-11T09:30:00-04:00,30.69,32.21001,30.69,31.89,17466480,11066566.2,44.37618145611751,40.972490382585754,NaN,NaN,-83.63077027200968,-193.3961601190577,-0.22674112817306313,-0.5961359431312303,-0.3693948149581672,60174798,49976033.2,39.310276634422344,44.107412200065326,NaN,NaN,-26.053124381148262,-13.952932793181114
2011-08-12T09:30:00-04:00,32.11,32.27,31.55,31.7,9703758,11250036.15,43.082357740550016,39.85135213228215,NaN,NaN,-58.87330524455752,-157.83857336577245,-0.16405462358166234,-0.5744630944352451,-0.4104084708535828,50471040,49542129.6,38.90213292235162,41.72927683457219,NaN,NaN,-23.579572360875485,-15.328167017137453
2011-08-15T09:30:00-04:00,31.97,32.85001,31.9101,32.78,27836640,12314706.65,51.70233552795603,39.530209330513784,NaN,NaN,-10.563923301575642,-103.81006009130093,-0.04349922987583976,-0.4647825081983825,-0.42128327832254275,78307680,58241150.8,50.09019152558369,40.06057656659835,NaN,NaN,-17.927269308324075,-15.699467344449827
2011-08-16T09:30:00-04:00,32.53,32.84,32.36,32.74001,11301898,12478943.75,51.39197471369639,39.33905497866418,NaN,NaN,0.631444002919094,-61.57640598859361,0.0356315477185391,-0.37674384367436886,-0.41237539139290796,67005782,59733523.6,51.72345585117809,38.878980570080316,NaN,NaN,-14.043066451543185,-15.462838645463163
2011-08-17T09:30:00-04:00,32.92,33.28999,32.86,32.98,13994363,12997282.65,53.20732733805035,39.58248019249533,NaN,NaN,31.121769394863346,-24.262957084072063,0.10243647035444048,-0.28432980344985737,-0.38676627380429784,81000145,67391889,59.117059130112,38.93520740031961,NaN,NaN,-10.438396879098832,-14.74506125026826
2011-08-18T09:30:00-04:00,32.49001,32.69,32.09,32.59,22508240,13745142.9,49.94306993103766,40.023131117171104,NaN,NaN,-6.65303947772381,-8.86741092521489,0.1175757979941805,-0.23979652631157222,-0.3573723243057527,58491905,67055310.4,58.69162609378423,39.64005270121768,NaN,NaN,-8.671029806468935,-13.877342472582642
2011-08-19T09:30:00-04:00,32.32001,32.67,32.17999,32.39,15167285,14281976.3,48.30637595886508,40.198637865888195,NaN,NaN,-4.555802743922233,1.996089574912157,0.11139588014640012,-0.21812747412275257,-0.3295233542691527,43324620,65626026.4,56.82159625730598,40.69156240879155,NaN,NaN,-7.8054174222043695,-13.009924608242889
2011-08-22T09:30:00-04:00,32.88,32.88,32.13,32.31,19818208,15028613.45,47.63393618438961,40.93106274210665,NaN,NaN,3.814366355834848,4.8717475063942555,0.09958165966906735,-0.20504627968281852,-0.30462793935188587,23506412,54665772.8,44.98499916669815,41.341845033570145,NaN,NaN,-7.324865179022018,-12.197773261211335
2011-08-23T09:30:00-04:00,32.53,32.89999,32.11,32.89,15727414,15573831.8,52.767431710392145,42.03016587018243,NaN,NaN,28.05227138373445,10.355912982557319,0.1267479797915803,-0.1461929646124105,-0.2729409444039908,39233826,49111381.6,40.39282636510038,41.87411029778464,NaN,NaN,-5.303846795188733,-11.212926623208107
2011-08-24T09:30:00-04:00,32.83,33.60001,32.82001,33.60001,14305559,15598186.1,58.17299747185071,44.28116819123947,NaN,NaN,98.81313347352643,23.894185798289936,0.18493049438097775,-0.041777826427768616,-0.22670832080874637,53539385,43619229.6,36.432506010763284,42.42173679279093,NaN,NaN,-1.7802883128894136,-9.86540686459115
2011-08-25T09:30:00-04:00,33.71001,33.71001,32.89,33.05,14284875,16030465.6,53.10298176045328,45.80429684297699,NaN,NaN,90.2352657933996,43.27184685251462,0.17867030845404716,-0.0033704352411874083,-0.18204074369523457,39254510,39771750.6,33.92326641789673,42.716574735828395,NaN,NaN,-0.4504279878554612,-8.520409882200338
2011-08-26T09:30:00-04:00,32.91,33.17999,32.24001,33,12521805,16146528.3,52.653718389597394,48.04049217836994,NaN,NaN,53.264711373350494,54.83594967596916,0.16384909990802227,0.022770631189793278,-0.141078468718229,26732705,36453367.6,31.88361665017075,43.07838965068083,NaN,NaN,0.4605342713862039,-7.237417860259404
2011-08-29T09:30:00-04:00,33.34,33.67999,33.28999,33.655,14857023,16511802.9,57.702148941697914,49.67343242748701,NaN,NaN,123.94488267898079,78.86205294059836,0.18905696823128015,0.0952427415708712,-0.09381422666040895,41589728,40070030.8,36.37376222989856,43.47785006149179,NaN,NaN,2.847177510181297,-5.796761378767876
2011-08-30T09:30:00-04:00,33.62,33.8,33.47,33.67,7754594,16431067.95,57.81308759587765,51.561137480037935,NaN,NaN,125.43296337824268,98.3381913395,0.1967586444163965,0.15213407886008667,-0.04462456555630982,49344322,42092130,38.80272037685352,44.10357397372279,NaN,NaN,4.773204272612079,-4.286766285713597
2011-08-31T09:30:00-04:00,33.78999,33.99001,33.71001,33.89,9643699,16264122.45,59.49123348640378,52.64078405362981,NaN,NaN,131.5144261720191,104.87844987919853,0.20571821226039744,0.212523199769187,0.006804987508789544,58988021,43181857.2,40.129194869586115,44.16206813337734,NaN,NaN,6.8671534108946775,-2.6933491861981294
2011-09-01T09:30:00-04:00,33.94,34.08,33.66,33.67,10671105,15946263.3,57.047395142050405,53.63828672516554,NaN,NaN,113.87657321104423,109.60671136272745,0.18644788137737905,0.23986483923051338,0.053416957853134314,48316916,44994338.4,42.36678250987536,44.40954310391476,NaN,NaN,7.943024976666674,-1.1738671629317288
2011-09-02T09:30:00-04:00,33.24001,33.50999,33.2115,33.28999,8912414,15293514.4,52.9976028000902,53.73080581603227,NaN,NaN,67.15135812347042,112.38404071275144,0.13985736264023366,0.2282386611534264,0.08838129851319274,39404502,47528697.8,45.437491497886256,44.07720738765065,NaN,NaN,7.720962798854618,0.0968228316091777
2011-09-06T09:30:00-04:00,32.63,33.16,32.39999,33.13,11566520,14980441.2,51.344966427719925,53.72744808131967,NaN,NaN,21.933131982049805,91.98169057336523,0.092307830588969,0.203766086749404,0.11145825616043499,27837982,44778348.6,42.774007716723446,43.437961092332465,NaN,NaN,7.072776731319225,1.0933876744248987
2011-09-07T09:30:00-04:00,33.39999,33.53999,33.22,33.5,7569582,14122353.1,54.85134996886564,53.844878269235046,NaN,NaN,67.68477200617869,80.43205229895246,0.08026216804245004,0.21178596621349755,0.1315237981710475,35407564,41990997,40.20200166003685,42.08688555875567,NaN,NaN,7.490080418327268,2.0072009235538086
2011-09-08T09:30:00-04:00,33.42,33.8,33.30949,33.48,6843238,13622735,54.622203161503,54.179102071411144,NaN,NaN,73.73175780500956,68.87551862555054,0.06602927400722758,0.21406039068008198,0.1480311166728544,28564326,35906258,35.2228895252924,40.41054723243483,NaN,NaN,7.77182018031117,2.830717960233432
2011-09-09T09:30:00-04:00,33.25999,33.25999,32.60001,32.8,14075637,13453192.85,47.37545043388897,54.112607391055704,NaN,NaN,-18.403213409642994,42.4195613014131,0.008901425281197556,0.15915789827435134,0.15025647299315378,14488689,29140612.6,30.673806487797066,38.542847963184194,NaN,NaN,5.92212574840652,3.2723476442581587
2011-09-12T09:30:00-04:00,32.63,33.08,32.5,33.07001,7650320,13350520.95,50.20067703905513,54.29594602353182,NaN,NaN,-29.65276589993252,23.058736496732514,-0.011510283147513511,0.1358686190587619,0.14737890220627542,22139009,25687514,28.640670203431227,37.375395894379416,NaN,NaN,5.157537773161112,3.541660519815723
2011-09-13T09:30:00-04:00,33.17,33.28999,32.83,33.28999,7174723,12317425.1,52.44087690266881,54.27262068012301,NaN,NaN,6.8249230857652226,20.037094717475593,-0.011005574120342254,0.1336219345558476,0.14462750867618984,29313732,25982664,29.073409557300607,36.56686612239371,NaN,NaN,5.144329886740992,3.770613286519333
2011-09-14T09:30:00-04:00,33.42999,33.78999,33.03,33.52,7024641,12103562.25,54.73378030419345,54.02696231100464,NaN,NaN,54.67875766947428,17.43589185013471,0.0032478575663482945,0.1486873306341252,0.1454394730677769,36338373,26168825.8,29.364368645059272,36.06199916770056,NaN,NaN,5.7774854672872324,4.057309312343318
2011-09-15T09:30:00-04:00,33.85001,34.03999,33.60001,33.94,5910918,11699390,58.6536889305885,54.42344139458572,NaN,NaN,112.32794537811556,25.155129364755908,0.037488849241661376,0.19230053461985364,0.15481168537819226,42249291,28905818.8,33.672456552897984,36.044084177343514,NaN,NaN,7.47193430749848,4.54511288307977
2011-09-16T09:30:00-04:00,33.63,34.07001,33.63,33.98,8065539,10977254.95,59.017682419844924,54.878010253889116,NaN,NaN,109.04547089367212,50.64486622541893,0.05812653000892831,0.22746984788935265,0.16934331788042434,50314830,36071047,43.404110140863914,36.86697656953588,NaN,NaN,8.964633244253035,5.17647293467595
2011-09-19T09:30:00-04:00,33.61,33.91499,33.5,33.78999,7280707,10582926.05,56.47431575137062,54.79030788315145,NaN,NaN,77.04572748550541,71.9845649025065,0.05434487473661517,0.2372744113011933,0.18292953656457814,43034123,40250069.8,48.17964993542899,37.71025426278805,NaN,NaN,9.550240530509667,5.80129687693791
2011-09-20T09:30:00-04:00,34.07001,34.72,33.89,34.28,18209104,10502470.85,61.12685141831362,55.02700529903973,NaN,NaN,167.18241384111434,104.05606305357632,0.0787293181210324,0.2813411842158686,0.20261186609483622,61243227,46635968.8,54.49795357558263,38.83134234841155,NaN,NaN,11.41931193659893,6.603870456889484
2011-09-21T09:30:00-04:00,34.28,34.47,33.64999,33.64999,13772203,10404710.3,53.24623495816891,54.580933975594384,NaN,NaN,89.27901224283353,110.97611396824819,0.04783295378952465,0.26240305833174205,0.2145701045422174,47471024,48862499,56.489916695708565,39.999965335991725,NaN,NaN,10.712982725229567,7.190886495223782
2011-09-22T09:30:00-04:00,33.10001,33.22,32.73,33.08,27630048,11070934.75,47.30423474412822,53.88499394717137,NaN,NaN,-84.44685172818511,71.62115454698805,-0.012371396173994242,0.19910585932472458,0.21147725549871882,19840976,44380836,51.59388845258994,40.659044331899906,NaN,NaN,8.188199506125422,7.333359782495445
2011-09-23T09:30:00-04:00,32.99001,33.57001,32.94,33.41,12023695,10957875.75,50.732214051036344,53.723180465096085,NaN,NaN,-29.588617265764604,43.89433691510071,-0.030325956059940984,0.1735698104237926,0.2038957664837336,31864671,40690804.2,47.9118248328997,40.83578242725802,NaN,NaN,7.152891799481891,7.307578642064938
2011-09-26T09:30:00-04:00,33.53999,33.72,33.33,33.67999,10965902,10880080.6,53.40299867618593,53.87018276855794,NaN,NaN,16.172695494176946,31.719730516835018,-0.024618537359521797,0.17312259478433134,0.19774113214385314,42830573,40650094.2,47.871234432892244,41.19987004984149,NaN,NaN,7.116102063857264,7.280224845178127
2011-09-27T09:30:00-04:00,34.12,34.16,33.64999,33.8,9169859,10595722.4,54.58158721870785,53.85091400068952,NaN,NaN,71.04099671228262,12.491447091068673,-0.013894703802128039,0.1803727523911931,0.19426745619332114,52000432,38801535.2,45.96690205390474,41.61164864940349,NaN,NaN,7.4352053035639525,7.302364910661816
2011-09-28T09:30:00-04:00,33.96001,34.02,33.42,33.46001,12533508,10834668.1,50.671375020569364,53.56871199062284,NaN,NaN,23.710835516790365,-0.622188254139963,-0.029913296187400684,0.1568758359590703,0.18678913214647097,39466924,37200715.2,44.32257947221491,42.2616265027551,NaN,NaN,6.542719654583383,7.193844159793469
2011-09-29T09:30:00-04:00,33.89,34.069,33.61501,34,12232922,10964129.25,56.05602813294982,54.18875325484147,NaN,NaN,75.62876410780349,31.39293491305775,-0.005627355725242644,0.17975493748991767,0.1853822932151603,51699846,43572489.2,51.72489447936856,43.765275645010206,NaN,NaN,7.41749603131052,7.225794427153048
2011-09-30T09:30:00-04:00,33.7,34.037,33.61,33.62,10461457,10953646.85,51.77305749709657,54.30106614470157,NaN,NaN,48.58361895724269,47.02738215765921,-0.016051210686121198,0.1653182798575088,0.18136949054363,41238389,45447232.8,53.67634469784716,45.55353810889706,NaN,NaN,6.828735231751697,7.169071684952855
2011-10-03T09:30:00-04:00,33.60001,33.88,32.82001,32.82001,15331652,11274608.75,44.128871571767,53.70735147820859,NaN,NaN,-65.35250738729647,30.72234158136454,-0.07445025394682658,0.08830667311009677,0.16275692705692335,25906737,42062465.6,49.7649685201161,47.03150660624102,NaN,NaN,3.7358929802239036,6.678617584277291
2011-10-04T09:30:00-04:00,32.67999,32.73,31.94,32.66,22271056,11809835.55,42.768678647272424,52.852701359857086,NaN,NaN,-190.18021701010628,-21.52190116311324,-0.1188461257739375,0.014199269839501483,0.13304539561343898,3635681,32389515.4,40.648853683480475,47.83754125184254,NaN,NaN,0.8328667432437143,5.843510321272494
2011-10-05T09:30:00-04:00,32.67,32.81,32.22,32.67999,13081363,12085424.6,43.005033511257515,51.73494025847631,NaN,NaN,-140.9787596841336,-54.45982020329804,-0.14037972222319225,-0.04242925716555135,0.0979504650576409,16717044,27839539.4,37.19717144694503,48.08930660141733,NaN,NaN,-1.4014411034744345,4.808517260594361
2011-10-06T09:30:00-04:00,32.72,33.25999,32.675,33.25999,12192746,12352900,49.519173811847054,51.05647535790503,NaN,NaN,-54.896274230626695,-80.56482787098408,-0.11039637697564728,-0.040045006161918195,0.07035137081372908,28909790,23281528.2,34.075575622404614,47.42298270724166,NaN,NaN,-1.3668361299780332,3.9263239190840196
2011-10-07T09:30:00-04:00,33.32001,33.62,33.19,33.39999,10607973,12179516.8,50.97569490149859,50.663716725771316,NaN,NaN,-6.748137617112876,-91.63117918585519,-0.07752314363032473,-0.026552558724176833,0.05097058490614789,39517763,22937403,33.84464449093625,46.39905374692075,NaN,NaN,-0.9011257958630328,3.236688245520155
2011-10-10T09:30:00-04:00,33.66,34.07001,33.66,34.05,6796137,12136807.65,57.156585847078304,50.38012632782593,NaN,NaN,73.44373345425156,-63.87193101754558,-0.011837515974856647,0.03617368993757708,0.04801120591243373,46313900,27018835.6,39.1148940908712,45.300263783727075,NaN,NaN,1.4818701436323063,2.9859999452504624
2011-10-11T09:30:00-04:00,33.91,33.97,33.55,33.74001,12097371,12382940.05,53.68066520215132,50.41115705953896,NaN,NaN,39.771543291211295,-17.881578957282066,0.009732958438875151,0.060177403961027665,0.05044444552215251,34216529,33135005.2,46.050793865741866,44.55461215301517,NaN,NaN,2.3884562604488893,2.9006365617073806
2011-10-12T09:30:00-04:00,33.87,33.87,33.58,33.66,6452965,12354356.25,52.78834062674551,50.80287890829733,NaN,NaN,28.664437565260933,16.047060492596835,0.0171767524846705,0.07191538612799064,0.05473863364332014,27763564,35344309.2,48.340110472153434,44.322199440126845,NaN,NaN,2.8558136745070413,2.894233292107332
2011-10-13T09:30:00-04:00,33.56,33.72501,33.25999,33.66,7803820,12449001.35,52.78834062674551,50.94974509227656,NaN,NaN,4.369929062355578,27.900301151193293,0.020442902959596644,0.08029226234281595,0.0598493593832193,27763564,35115064,48.11196944594518,44.33649548391581,NaN,NaN,3.234041982221969,2.942777390695137
2011-10-14T09:30:00-04:00,33.78999,33.99001,33.7,33.98,9624867,12526967.75,56.16798841179703,51.147244359105926,NaN,NaN,66.03236665910832,42.45640200643753,0.041294429284387965,0.11146739598870425,0.07017296670431629,37388431,34689197.6,47.66195606971239,44.32154702940296,NaN,NaN,4.526422005083313,3.1690123356077335
2011-10-17T09:30:00-04:00,33.77,34.00999,33.77,33.84,4726805,12399272.65,54.33538836548076,51.129658726732565,NaN,NaN,60.97828573998955,39.963312463585126,0.04262481332759459,0.12345398336380953,0.08082917003621494,32661626,31958742.8,44.77053794367419,44.236092450100784,NaN,NaN,5.10864933865838,3.44610333604354
2011-10-18T09:30:00-04:00,33.72,34.27499,33.60001,34.08,10923527,12034993.8,56.92971389221129,51.576682931849845,NaN,NaN,86.14532350859764,49.2380685070624,0.05580354432520593,0.15058360044272234,0.09478005611751641,43585153,33832467.6,47.14037565638072,44.437363606112626,NaN,NaN,6.33572708625618,3.85890672893106
2011-10-19T09:30:00-04:00,34.06,34.59,34.03999,34.11,8798426,11786304.95,57.25660896204642,51.66243870535674,NaN,NaN,127.2072927699227,68.94663954799475,0.06218884183038369,0.17251610840549603,0.11032726657511234,52383579,38756470.6,52.864312419298365,44.5187506018219,NaN,NaN,7.443018295843283,4.370922667061378
2011-10-20T09:30:00-04:00,34.10001,34.44,34.07001,34.3,5656434,10687624.25,59.36037451931119,52.20438992122922,NaN,NaN,122.75918742242023,92.62449122000768,0.07405050424752607,0.20289039688451993,0.12883989263699386,58040013,44811760.4,58.77612758658829,44.88302080816055,NaN,NaN,8.970780182857279,5.028045169317935
2011-10-21T09:30:00-04:00,34.56,34.89999,34.56,34.88,7494586,10461168.8,65.02021934656551,53.696629048000545,NaN,NaN,188.54631434626836,117.12728075743969,0.11344295096314094,0.27064358134092004,0.1572006303777791,65534599,50440994,63.3749651413741,45.85516342396469,NaN,NaN,12.066879815125658,6.033592975861896
2011-10-24T09:30:00-04:00,34.95,34.95,34.64,34.73,8565539,10341150.65,62.59235687904514,55.112606064555735,NaN,NaN,162.70297990491883,137.47221959042554,0.12118068874805257,0.3086764913128448,0.18749580256479223,56969060,55302480.8,66.81774823087639,47.72437017735014,NaN,NaN,13.982275820921808,7.1691190965847404
2011-10-25T09:30:00-04:00,34.64999,34.74001,34.27,34.34,9675457,10366430.55,56.667625093768265,56.0885054633065,NaN,NaN,102.2150513371257,140.68616515613115,0.09307980860989845,0.3038455633271653,0.21076575471726683,47293603,56044170.8,67.3224319996442,49.87617450254294,NaN,NaN,13.943994539079826,8.13695844551261
2011-10-26T09:30:00-04:00,34.61,34.7,34.28999,34.48,8363480,10157929.15,58.19730235335955,56.708371787700244,NaN,NaN,96.22136364364637,134.4889793308759,0.07760028574975161,0.30776611190445635,0.23016582615470474,55657083,56698871.6,67.78816190142672,52.28421637961594,NaN,NaN,14.349181872094558,9.024418935024316
2011-10-27T09:30:00-04:00,35.07001,35.46561,35,35.3,13191797,10205872.9,65.81026291128819,57.7679837883995,NaN,NaN,171.4605618215645,144.22925421070474,0.11406219193003037,0.3727435660672427,0.2586813741372123,68848880,58860645,69.34191292945465,54.81973555379583,NaN,NaN,17.192315991066344,10.19126137160175
2011-10-28T09:30:00-04:00,35.28,35.28,34.83,35.00999,11931980,10279399.05,61.54150810721905,58.0811925212667,NaN,NaN,125.15153366056208,131.5502980735635,0.1100703703656668,0.3962693370942958,0.286198966728629,56916900,57137105.2,66.58429826591627,56.78183585201333,NaN,NaN,18.19686811808068,11.334919478241597
2011-10-31T09:30:00-04:00,34.8299,35.17999,34.8,34.85001,5709539,9798293.4,59.25805357324425,58.4795774049162,NaN,NaN,101.45473608620041,119.3006493098198,0.08897953203968811,0.3974233817782391,0.308443849738551,51207361,55984765.4,64.73079800603423,58.11612186203422,NaN,NaN,18.312272768254534,12.33168423395773
2011-11-01T09:30:00-04:00,34.35001,34.60001,34.05,34.12,12201965,9294838.85,50.119476829129646,58.28894427651506,NaN,NaN,17.984039448766858,102.45444693214804,0.021696192608323728,0.33556409049895564,0.3138678978906319,39005396,54327124,62.05476972570857,59.095740380145294,NaN,NaN,15.363618308828078,12.764817673224924
2011-11-02T09:30:00-04:00,34.56,34.98,34.55,34.72,9591961,9120368.75,56.11047498964025,58.52623958815041,NaN,NaN,73.08023493191052,97.82622118980086,0.01381607325748696,0.3311379894624906,0.31732191620500366,48597357,52915178.8,59.78750562121324,59.929707249807294,NaN,NaN,14.861783966156539,13.064384286500868
2011-11-03T09:30:00-04:00,34.82001,35.25,34.77,35.14,10420629,9031762.9,59.75439911719181,58.78241178139289,NaN,NaN,104.995727789249,84.53325438333778,0.03206316118632874,0.35740086768791457,0.32533770650158583,59017986,50949000,56.6817990489231,60.57398174832235,NaN,NaN,15.687958690087687,13.439180629870414
2011-11-04T09:30:00-04:00,34.95,35.045,34.56,34.98,5633059,8783017.2,57.786117059664754,59.02889240240603,NaN,NaN,69.94357677712398,73.49166300665016,0.028642410524537032,0.36114071965725714,0.3324983091327201,53384927,50242605.4,55.56503701925988,61.34501739657848,NaN,NaN,15.703665640545783,13.762678488538324
2011-11-07T09:30:00-05:00,35.00999,35.2,34.76151,35.17,5037641,8695092.4,59.49247998665771,59.21194712343792,NaN,NaN,88.0483373643517,70.8103832622804,0.03409090030097306,0.37511193450893643,0.34102103420796337,58422568,51685646.8,57.41103084967476,62.0786356246709,NaN,NaN,16.249518703294964,14.117941376360701
2011-11-08T09:30:00-05:00,35.25,35.39999,34.94009,35.39999,6099719,8395209.8,61.52011555205819,59.516483308438765,NaN,NaN,106.8038365453725,88.57434268160152,0.04728720763946992,0.40013004375730077,0.35284283611783085,64522287,56789025,63.22903580754665,62.818973009545786,NaN,NaN,17.3225508202795,14.575742725491958
2011-11-09T09:30:00-05:00,34.98,35.065,34.55499,34.63,8024934,8473808.25,52.114749280324745,58.998938648511164,NaN,NaN,27.9292498171239,79.54414565864421,0.0007237601133333049,0.3537475362594975,0.3530237761461642,56497353,58369024.2,64.83088700454562,63.25145582511416,NaN,NaN,15.19025945636581,14.663530829902509
2011-11-10T09:30:00-05:00,34.91,35.02,34.62,34.86,7519910,8459612.75,54.35934373324275,58.23744753327382,NaN,NaN,35.33035597092385,65.61107129497918,-0.017039635116019025,0.33172423225114045,0.3487638673671595,64017263,59368879.6,65.84488686042246,63.427878805046184,NaN,NaN,14.175580447994204,14.593823632487037
2011-11-11T09:30:00-05:00,35.17,35.36,35.13,35.36,4165887,8186663.75,58.8726396359074,57.97175344447827,NaN,NaN,112.77937033304684,74.17823000616376,0.0014490770210229265,0.35057521364343813,0.3491261366224152,68183150,62328524.2,68.71985045138474,63.56374324936821,NaN,NaN,14.772370400881279,14.619330313686214
2011-11-14T09:30:00-05:00,35.3,35.37,34.9115,34.94,8015395,8351093.25,54.03860225974969,57.78396609919122,NaN,NaN,68.67525860535001,70.30361425436341,-0.017024854557978475,0.3278450684249421,0.3448699229829206,60167755,62677561.6,69.05071054523921,63.68719171691071,NaN,NaN,13.696041199820927,14.487431868848317
2011-11-15T09:30:00-05:00,34.98,35.119,34.82001,35,4313496,8020591.7,54.61195855030228,57.52787011325855,NaN,NaN,41.111055372234766,57.16505801973587,-0.027026539392901727,0.31108674874179343,0.33811328813469516,64481251,62669354.4,69.03222062034375,63.77605305397622,NaN,NaN,13.019111208181924,14.277671774467404
2011-11-16T09:30:00-05:00,34.84,35,34.56,34.58,5745805,7867960.65,49.91768381543125,56.39268589212592,NaN,NaN,-36.49795995906681,44.27961606449774,-0.061764558939588154,0.26090758946021,0.32267214839979813,58735446,63116973,69.51173050149634,63.788182880550615,NaN,NaN,10.973288129252722,13.805616968008163
2011-11-17T09:30:00-05:00,34.59,34.73,34.12669,34.39999,5649371,7867607.5,48.01279443894883,55.42634920153518,NaN,NaN,-125.85534581093363,12.042475708126238,-0.09472943441155768,0.20426035538535103,0.2989897897969087,53086075,60930735.4,64.2767471477888,63.62335780068437,NaN,NaN,8.714429977304672,13.078304540764806
2011-11-18T09:30:00-05:00,34.58,34.73,34.4558,34.64,4829965,7734376.45,50.71340250203139,54.81601698216284,NaN,NaN,-65.48892193243246,-23.61118274496963,-0.09783426158537856,0.17669696281518554,0.2745312244005641,57916040,58877313.4,59.726939846475794,63.265939360715905,NaN,NaN,7.614317792670258,12.297735005322728
2011-11-21T09:30:00-05:00,34.41,34.41,33.9565,34.21001,6911383,7651668.65,46.09363860318139,54.52845710888082,NaN,NaN,-154.22988907747737,-68.1922122815351,-0.12459547948609115,0.11878687504295016,0.2433823545290413,51004657,57044693.8,55.92238706217179,62.82791202760614,NaN,NaN,5.24639545075906,11.290400783242205
2011-11-22T09:30:00-05:00,34.24001,34.24001,33.7,33.78999,15889855,7962388.55,42.06283303598031,53.52505411219082,NaN,NaN,-195.9843007795775,-115.61128351189754,-0.16386095712172313,0.038556158126887397,0.20241711524861053,35114802,51171404,45.84364601492242,61.83192205572822,NaN,NaN,1.9484286549930983,9.955833336349476
2011-11-23T09:30:00-05:00,33.56,33.61,33.17999,33.25999,6271691,7857799.1,37.595233600657174,51.942256575295495,NaN,NaN,-251.88490903996546,-158.68867332807727,-0.2155506956903674,-0.06702125436434869,0.1485294413260187,28843111,45192937,38.280662982876144,60.51755519386773,NaN,NaN,-2.3677320766813272,8.19532399163079
2011-11-25T09:30:00-05:00,33.19,33.61,33.19,33.42999,2689638,7332691.15,39.80376104243342,50.65780257406469,NaN,NaN,-189.8375850764231,-171.48512118117517,-0.22715441049561452,-0.13541357179349944,0.09174083870211507,31532749,40882271.8,33.933714283422105,58.972460712736456,NaN,NaN,-5.203940427346646,6.281143360348299
2011-11-28T09:30:00-05:00,33.99001,34.12,33.69099,33.85001,4865754,6979379.85,44.984326926562865,49.621505926915056,NaN,NaN,-99.68194080219418,-178.3237249551275,-0.19655127313915238,-0.15394825272182544,0.042603020417326956,36398503,36578764.4,30.24161789929437,57.031788359137856,NaN,NaN,-6.033965033618357,4.5218421612102055
2011-11-29T09:30:00-05:00,33.92,34.34,33.92,34.22,4731723,6930489.05,49.136883073044054,48.73698932127119,NaN,NaN,-53.454614671498014,-158.16867007393165,-0.1438427831709325,-0.13720045854633867,0.006642324624593833,41130226,34603878.2,28.698480023341887,54.56532008883751,NaN,NaN,-5.439485427220367,3.098795362862981
2011-11-30T09:30:00-05:00,34.96001,35.21001,34.8,35.21001,7202336,6680507.6,58.22338304119836,49.17332030419073,NaN,NaN,69.51681146018342,-105.06844762597947,-0.04014607785881073,-0.04354027269891958,-0.0033941948401088502,48332562,37247430.2,33.58391719655499,52.33339367398104,NaN,NaN,-1.7333481072182702,2.4084891528513737
2011-12-01T09:30:00-05:00,35.16,35.31,35.03,35.11,5685438,6485181.45,57.11339032397233,49.370037917814265,NaN,NaN,75.2728174178888,-39.63690233440864,0.02060207149947663,0.022358394534236936,0.0017563230347603072,42647124,40008232.8,38.33584272933923,50.36846195033223,NaN,NaN,0.804220089588715,2.1793078580995653
2011-12-02T09:30:00-05:00,35.32001,35.32001,34.7,34.75,11776109,6552955.45,53.18296966388692,48.96363291981281,NaN,NaN,45.56959996966228,7.444534674808443,0.03460746896249831,0.0450156592378832,0.010408190275384886,30871015,39875886,38.19476353610547,48.18809859924086,NaN,NaN,1.6681122094483125,2.1062799082922434
2011-12-05T09:30:00-05:00,35.27,35.27,34.85001,35.02,7172805,6629942.75,55.64820422882205,49.078604489032266,NaN,NaN,60.516832045575725,39.48428924436244,0.058707479800312865,0.08379254002577596,0.0250850602254631,38043820,40204949.4,38.797844320565424,46.027179583192726,NaN,NaN,3.1535554205097496,2.255890695751887
2011-12-06T09:30:00-05:00,35.10001,35.31,34.96001,35.12,5373094,6646715.4,56.560550328480055,49.21778961604496,NaN,NaN,70.85174332509011,64.34556084368005,0.07688842727402621,0.12119559431799587,0.044307167043969656,43416914,40662287,39.67881627944993,43.93050784455746,NaN,NaN,4.628188506878496,2.594790383055688
2011-12-07T09:30:00-05:00,35.07001,35.2,34.83369,35.07001,5277680,6605613.45,55.94104251717979,49.64802952331271,NaN,NaN,60.26873721349176,62.49594599434172,0.08065908951856925,0.14513102894218122,0.06447193942361197,38139234,38623621.4,37.11416219254739,41.61639582248967,NaN,NaN,5.655054103807678,3.0319709145916867
2011-12-08T09:30:00-05:00,34.94,35,34.48,34.56,6902516,6549492.55,49.93215951871636,49.78512702901039,NaN,NaN,12.040842617045788,49.849551034173125,0.045658759719429995,0.12154538907289947,0.07588662935346947,31236718,36341540.2,34.43132907700061,39.4845802460048,NaN,NaN,4.799150138190489,3.2844250893915157
2011-12-09T09:30:00-05:00,34.72,35.08,34.66,35,11489258,6747959.95,54.475421626607215,50.05384268076581,NaN,NaN,43.493044640261274,49.434239968292935,0.04871565160381691,0.1367811938582406,0.0880655422544237,42725976,38712532.4,39.3376603565599,38.02820313958224,NaN,NaN,5.428795735250674,3.590763753085681
2011-12-12T09:30:00-05:00,34.81,34.95,34.45,34.7,10144512,7046891.2,51.07251935968352,50.409477020515965,NaN,NaN,18.978331458521055,41.126539850882,0.028129721375440786,0.12322769397372468,0.0950979725982839,32581464,37620061.2,37.92934352696826,36.74298574421056,NaN,NaN,4.935393499181865,3.7828537168137073
2011-12-13T09:30:00-05:00,34.85001,35.23,34.75,34.83,6874969,6989869.9,52.45841123228837,51.15201832025225,NaN,NaN,54.48456506502427,37.853104198868834,0.02118155888010005,0.12157492119840896,0.1003933623183089,39456433,36827965,36.89789848880414,36.10400377805926,NaN,NaN,4.932198173602535,3.947045782069254
2011-12-14T09:30:00-05:00,34.8,34.968,34.58,34.61,6107105,7079550.35,49.88330175306946,52.029737473995986,NaN,NaN,25.363845860251608,30.872125928220804,0.0007610597582002748,0.10134468701605925,0.10058362725785898,33349328,35869983.8,35.6357220534438,35.91507942595695,NaN,NaN,4.188333544007797,3.981515462346189
2011-12-15T09:30:00-05:00,34.78999,35.14,34.78999,35.03,9144254,7249472.8,54.47757908100277,53.07786733389379,NaN,NaN,61.578360558617575,40.77962951653516,0.013808407582720408,0.11784413673625949,0.10403572915353908,42493582,38121356.6,40.764083864314536,36.40296296744926,NaN,NaN,4.889806126447683,4.111271271503545
2011-12-16T09:30:00-05:00,34.89999,34.92,34.47,34.53999,7767582,7355383.35,48.850952099290396,53.35405484623148,NaN,NaN,10.393125285283354,34.15964564553958,-0.010957394444115282,0.09033898609839497,0.10129638054251025,34726000,36521361.4,38.42114982544112,36.98721524788832,NaN,NaN,3.786311355109833,4.064848426304444
2011-12-19T09:30:00-05:00,34.72,34.78,34.22,34.28,6709316,7449350.9,46.128643278088596,53.13918057516322,NaN,NaN,-19.81118248924757,26.401742855985855,-0.043421168819812755,0.04701991951774431,0.09044108833755707,28016684,35608405.4,37.110475636405475,37.58807207739286,NaN,NaN,2.0345739911989953,3.7748092212893796
2011-12-20T09:30:00-05:00,34.55,35.05,34.55,35.00999,6544883,7431025.9,53.89714289463579,52.83016342183733,NaN,NaN,40.89383357309399,23.6835965575998,-0.015730901979493006,0.07077746086319081,0.08650836284268382,34561567,34629432.2,35.70395423273017,37.73950329426252,NaN,NaN,2.955262417319446,3.657731106436532
2011-12-21T09:30:00-05:00,35.05,35.57001,35.05,35.53,9672215,7120143.9,58.48931925826381,52.92844406000101,NaN,NaN,114.38978061738639,41.48878350902676,0.03484660383303036,0.13006661763397176,0.0952200138009414,44233782,36806323,41.05396828389254,37.93365511958775,NaN,NaN,5.265149681251949,3.8873623314101633
2011-12-22T09:30:00-05:00,35.63,35.64999,35.47301,35.57001,4085340,7010826.35,58.82911851399987,53.331740406437646,NaN,NaN,143.7283754398362,57.91878648527048,0.06640613011241975,0.1782276764414661,0.11182154632904634,48319122,37971431,43.75167347667887,38.330577258200144,NaN,NaN,7.186005844953907,4.35859711905927
2011-12-23T09:30:00-05:00,35.69,35.96001,35.67999,35.8,3219092,7037299.05,60.814800583875375,53.700783003227166,NaN,NaN,194.0596326790931,94.65208796403245,0.09636387951168826,0.23227639571865666,0.1359125162069684,51538214,41333873.8,50.75600363939695,39.18473149525954,NaN,NaN,9.386139486582284,5.076817457276843
2011-12-27T09:30:00-05:00,35.83,36.16,35.78,36.09,3243691,6956195.9,63.22340143783739,54.17670093960982,NaN,NaN,213.27246977463363,141.26881841680867,0.12735729669961107,0.29510913708148223,0.16775184038187116,54781905,46686918,59.41969410048091,40.594794196761754,NaN,NaN,11.976551631997397,6.062493767951208
2011-12-28T09:30:00-05:00,36.23,36.23,35.89999,35.96001,3152575,6877238.5,61.40152645688016,54.566735506731284,NaN,NaN,183.69686474665656,169.82942465152118,0.1302820705823738,0.3306044286098384,0.20032235802746462,51629330,50100470.6,63.79410322699707,42.500504270651014,NaN,NaN,13.586886828623424,7.1374070623329535
2011-12-29T09:30:00-05:00,36.02,36.24001,35.99001,36.24001,3962420,6715242.7,63.82000369193097,55.55872437624661,NaN,NaN,165.87308657832563,180.12608584370903,0.14132830593793444,0.37698274044988267,0.23565443451194823,55591750,52372064.2,66.39052105501744,44.783303697652215,NaN,NaN,15.673871079590851,8.356901921941224
2011-12-30T09:30:00-05:00,36.25999,36.27,35.96001,35.98,4092732,6635607.4,60.05685676044394,55.957398314377805,NaN,NaN,125.42040221742761,176.46449119922733,0.12210156166023739,0.388281386587245,0.2661798249270076,51499018,53008043.4,67.10183914299985,46.76645932525507,NaN,NaN,16.371145935394576,9.501793923863131
2012-01-03T09:30:00-05:00,36.17999,36.25,35.23,35.34,19185184,7006061.15,51.93865798895424,56.01926535932571,NaN,NaN,52.059188770787344,148.06440241756616,0.06037982970750605,0.34165461206139014,0.2812747823538841,32313834,49163167.4,58.97545279027455,48.269752844062666,NaN,NaN,14.483924834442538,10.21352691108876
2012-01-04T09:30:00-05:00,35.24001,35.45,35.13,35.14,5775195,6936180.65,49.67869181779794,55.82071397257639,NaN,NaN,-0.8205068739937605,105.24580708784067,0.0032007721583614535,0.28527574755183593,0.2820749753934745,26538639,43514514.2,49.49238816400997,49.169359249434514,NaN,NaN,12.234687976276271,10.502264206115548
2012-01-05T09:30:00-05:00,35.10001,35.32001,34.91,35.21001,12112570,7273154.45,50.490796324871724,55.864106441990835,NaN,NaN,-14.287406555716506,65.64895282736606,-0.030909492200001665,0.24343811014347239,0.27434760234347405,38651209,40918890,45.84446314024994,49.89855504134923,NaN,NaN,10.633776623635608,10.5210516943327
2012-01-06T09:30:00-05:00,35.27,35.3,34.98,35.02,7305488,7374544.85,48.2164515200168,55.41688304477755,NaN,NaN,-21.55097612843536,28.164140286013872,-0.06529598744176518,0.1927276180412676,0.25802360548303277,31345721,36069684.2,39.92400779681626,49.8385496079565,NaN,NaN,8.625616147203132,10.250275187599904
2012-01-09T09:30:00-05:00,35.13,35.2,34.9081,35.07001,4527301,7255784.1,48.869268100313846,55.41819133056494,NaN,NaN,-31.141650031472942,-3.148270163766243,-0.08258668351528553,0.15479025108892586,0.2373769346042114,35873022,32944485,36.63992174886644,49.7113190310583,NaN,NaN,7.138962077069381,9.805801886095544
2012-01-10T09:30:00-05:00,35.32001,35.37,35.09,35.12,4508516,6906747,49.55387013885092,55.66285039204796,NaN,NaN,-13.645947099125618,-16.28929733774884,-0.08806870160710023,0.1272910575953361,0.21535975920243633,40381538,34558025.8,39.41107518028277,49.87564756990668,NaN,NaN,6.070993976464288,9.272257899005364
2012-01-11T09:30:00-05:00,35.10001,35.14,34.89999,34.96001,6162973,6707670.05,47.367945852495076,55.1964791747522,NaN,NaN,-46.6969952690412,-25.464595016758317,-0.09906159932811603,0.09153276004229127,0.1905943593704073,34218565,36094011,42.01112296030839,50.32615962187656,NaN,NaN,4.564526160297855,8.599724793475719
2012-01-12T09:30:00-05:00,35.00999,35.17,34.8,34.91,6014434,6664643.3,46.67485649890823,54.352588977655365,NaN,NaN,-53.26871262590423,-33.26085623079586,-0.10568789568416093,0.05848448976520615,0.16417238544936708,28204131,34004595.4,39.52629311228041,50.21703996676141,NaN,NaN,3.106487943950234,7.814976672114936
2012-01-13T09:30:00-05:00,34.8199,34.89,34.62,34.89,6017242,6660150.15,46.382564278939064,53.46354938943674,NaN,NaN,-79.65092594733841,-44.88084619457648,-0.1070738773114483,0.030330038810056692,0.137403916121505,22186889,32172829,37.435796894528075,49.76590592517921,NaN,NaN,1.7935005733047162,6.954765800856333
2012-01-17T09:30:00-05:00,35.09,35.25,34.77499,34.86,6638121,6534843.5,45.91805574447088,52.39949618662213,NaN,NaN,-53.72669659470087,-49.39785550722207,-0.10549680935436512,0.005532904428548591,0.11102971378291371,15548768,28107978.2,33.23511590571616,48.51441394420202,NaN,NaN,0.5505209664475122,6.039873681655073
2012-01-18T09:30:00-05:00,34.88,34.91,34.66,34.85001,5943387,6443633.75,45.75373423915308,51.15166281528754,NaN,NaN,-80.75137875931092,-62.818941839259125,-0.10062779180856421,-0.014755025977791547,0.08587276583077266,9605381,21952746.8,28.094267570031178,46.276883477741315,NaN,NaN,-0.5599004389593297,5.0970488072815865
2012-01-19T09:30:00-05:00,34.88,34.91,34.53,34.56,7629574,6489646.65,41.14997448007682,49.70512338837302,NaN,NaN,-107.62779633616653,-75.0051020526842,-0.11159155711142817,-0.05361668055851254,0.057974876552915625,1975807,15504195.2,23.919828441319225,43.42872099305004,NaN,NaN,-2.7668994666123465,3.9736276252967393
2012-01-20T09:30:00-05:00,34.56,34.66,34.45,34.61,6336715,6479238.25,42.22925854050941,48.16292730612862,NaN,NaN,-117.09793181252536,-87.77094589000842,-0.10995128167196834,-0.0794642255370448,0.030487056134923543,8312522,11525873.4,21.770642107650914,40.24158678252386,NaN,NaN,-4.409828615470043,2.7759910194729134
2012-01-23T09:30:00-05:00,34.56,34.95,34.55,34.75,24398000,7215527.5,45.25661440524971,47.10576713790046,NaN,NaN,-81.03028938926917,-88.04681857839458,-0.09450283266965034,-0.0876414847021394,0.006861347967510954,32710522,13630600,25.580286737074687,37.27576161067207,NaN,NaN,-5.121960914433193,1.647712171772041
2012-01-24T09:30:00-05:00,34.58,34.62,34.39999,34.47,4996383,7261079.65,40.666656714616444,46.300624189733476,NaN,NaN,-110.60348909788743,-99.42217707903188,-0.09779754894276735,-0.11538558821094824,-0.017588039268180887,27714139,16063674.2,29.83416211900483,35.19424084843852,NaN,NaN,-7.000075449806406,0.4123139401179774
2012-01-25T09:30:00-05:00,34.4099,35.09,34.14,35.03999,12932320,7746741.05,51.459273992652356,46.42780863079451,NaN,NaN,-66.72185636863733,-96.61627260089716,-0.058200127158956665,-0.09033819821687672,-0.032138071057920055,40646459,22271889.8,39.35903133611119,34.470429646445744,NaN,NaN,-5.58335102076213,-0.4442096257220379
2012-01-26T09:30:00-05:00,35.11,35.27,34.94,35.16,7350445,7952078.75,53.38199606997054,46.63432289830157,NaN,NaN,-0.28998480732612514,-75.14871029512908,-0.022378528983598885,-0.06011123228741866,-0.037732703303819774,47996904,31476109.2,50.16109336319076,34.778760376655804,NaN,NaN,-3.828237742096489,-0.9276422137755309
2012-01-27T09:30:00-05:00,35.07001,35.07001,34.60001,34.73,8097871,8199343.55,46.30464827390985,46.497765523579645,NaN,NaN,-56.10508785369784,-62.95014150336358,-0.02585071934699737,-0.07004610248756649,-0.04419538314056912,39899033,37793411.4,55.959659070090474,35.92416403903253,NaN,NaN,-4.443741111111493,-1.4299420562520968
2012-01-30T09:30:00-05:00,34.60001,34.60001,34.3,34.50999,9475059,8474975.5,43.152272036796404,46.08940866189983,NaN,NaN,-124.405990897149,-71.62528180493953,-0.040309486919397244,-0.09458224178981567,-0.054272754870418424,30423974,37336101.8,55.45665775826812,37.268216611132665,NaN,NaN,-5.949791463156939,-2.075634828667074
2012-01-31T09:30:00-05:00,34.59,34.69,34.46001,34.67999,7359855,8638331.65,46.20007116386066,45.849851592257664,NaN,NaN,-84.68850396420592,-66.44228477820324,-0.03591507521291484,-0.09916659888656199,-0.06325152367364714,37783829,39350039.8,57.2778975737777,38.54441821066801,NaN,NaN,-6.26445647601456,-2.6740379211452865
2012-02-01T09:30:00-05:00,34.75999,34.8775,34.69,34.8,8196406,8088892.75,48.30703867241021,45.91692965082303,NaN,NaN,-25.365003283246207,-58.17091416112502,-0.02304260559725055,-0.09205478067021033,-0.06901217507295979,45980235,40416795,58.2516027930165,39.70445248443288,NaN,NaN,-5.891139894557761,-3.1336239173470686
2012-02-02T09:30:00-05:00,34.84,34.96001,34.67,34.74001,8038531,8202059.55,47.3096330178754,45.96227083074926,NaN,NaN,-19.475761374257722,-62.008069474511345,-0.0169657103873673,-0.0902193130571689,-0.0732536026698016,37941704,38405755,55.6754067814555,40.85796060365967,NaN,NaN,-5.869971963582105,-3.524530781094931
2012-02-03T09:30:00-05:00,34.78,34.98,34.62,34.83,9231488,8058005.45,49.01039345564747,46.149972914799854,NaN,NaN,-6.533028326294943,-52.09365756903077,-0.00585666894621098,-0.08057443885256532,-0.07471776990635434,47173192,39860586.8,57.151728770316886,42.2662414519303,NaN,NaN,-5.3722414722795255,-3.7884894512641587
2012-02-06T09:30:00-05:00,34.78,34.8,34.59,34.67999,6076969,7996579.5,46.32599301442318,46.17911129122503,NaN,NaN,-52.2539549367755,-37.66325037695607,-0.007478820828364291,-0.0840662959418097,-0.07658747511344541,41096223,41995036.6,59.29389759019805,44.127583000821865,NaN,NaN,-5.69300554080389,-4.060563178341263
2012-02-07T09:30:00-05:00,34.66,35.03999,34.5,34.92999,6928816,8116655.25,51.130023187379344,46.56313193038404,NaN,NaN,14.78628840255635,-17.76829190360361,0.008549147289957634,-0.06590104100099836,-0.074450188290956,48025039,44043278.6,61.29367795782571,46.498969457092905,NaN,NaN,-4.582403475880273,-4.135111792275407
2012-02-08T09:30:00-05:00,35.00999,35.00999,34.73,34.97,6418227,8212140.8,51.87244164982982,47.329022442509256,NaN,NaN,67.9726108656893,0.8992309261834983,0.02137909965014953,-0.047726313728269076,-0.0691054133784186,54443266,45735884.8,62.9150397727834,49.28434169505463,NaN,NaN,-3.4551495206089147,-4.0379743248944795
2012-02-09T09:30:00-05:00,34.91,34.97,34.75999,34.87,6858395,8246911.9,49.83467525945705,47.872266493862654,NaN,NaN,53.92527766987901,15.579438735010848,0.02254819198203288,-0.0409201734008775,-0.06346836538291038,47584871,47664518.2,64.72807259545974,52.352729587040976,NaN,NaN,-3.0488457034826806,-3.8966702361213654
2012-02-10T09:30:00-05:00,34.72,34.86,34.67,34.8,4558570,8174118.7,48.40130785408605,48.096887454493825,NaN,NaN,8.214073485884272,18.52885909744669,0.018210335428671287,-0.040705446097071274,-0.05891578152574256,43026301,46835140,63.29501072012489,55.046638442973126,NaN,NaN,-3.088055657579626,-3.7811538677582597
2012-02-13T09:30:00-05:00,34.95,35.00751,34.73,34.75999,6714852,8208999.2,47.559299241987674,48.58921906359177,NaN,NaN,40.81230359221415,37.14211080324462,0.012520614309740052,-0.043265013638567495,-0.05578562794830755,36311449,45878185.2,61.60036452099496,57.315652900258144,NaN,NaN,-3.341438705030243,-3.718337415939972
2012-02-14T09:30:00-05:00,34.75,34.86,34.61,34.77,5586566,8156421.45,47.80395040307026,48.32812452147876,NaN,NaN,-4.803306032089378,33.224191916315476,0.009445457785435526,-0.043978805716513136,-0.05342426350194866,41898015,44652780.4,59.40695515736891,58.74764745891941,NaN,NaN,-3.493901440584225,-3.686275133746294
2012-02-15T09:30:00-05:00,34.81,34.89,34.56,34.7,7347508,8226627.5,46.18141321519824,47.81379717470931,NaN,NaN,-21.37407868207614,15.35485400676239,0.003042685092012075,-0.04962090713693357,-0.05266359222894564,34550507,40674228.6,52.82970015581939,58.938262229821454,NaN,NaN,-4.03483991959071,-3.736070103152639
2012-02-16T09:30:00-05:00,34.75,35.17,34.67999,35.07001,7382188,8214258.2,54.895987161378834,48.42746423809996,NaN,NaN,129.34053191047184,30.437904854880948,0.022963346336700732,-0.023959409308069723,-0.046922755644770456,41932695,39543793.4,51.098601807857435,58.59104385394767,NaN,NaN,-2.1000181615087046,-3.5023483972035057
2012-02-17T09:30:00-05:00,35.14,35.27,34.96001,35.05,4629539,8128899.4,54.383130051847644,49.22966838203218,NaN,NaN,182.03020049559422,65.20113025682294,0.033396248670884365,-0.005177444806164999,-0.038573693477049364,37303156,38399164.4,49.33577633042906,58.153838037673445,NaN,NaN,-0.6314495767155934,-3.092219994276661
2012-02-21T09:30:00-05:00,35.13,35.13,34.87,34.92,5919664,7204982.6,51.04653864406561,49.57584463061824,NaN,NaN,96.71802266008966,76.38227407039804,0.030240075899099716,-0.0007735986031747188,-0.031013674502274435,31383492,37413573,47.80643814300225,57.477305221189475,NaN,NaN,-0.2534434707575893,-2.686680490916794
2012-02-22T09:30:00-05:00,34.88,35.09,34.83,34.96001,4567410,7183533.95,52.022177840429734,49.841211714048214,NaN,NaN,79.93672450438382,93.33028017769269,0.029512703682779494,0.005877205101199934,-0.02363549858157956,35950902,36224150.4,45.95504469050493,56.59897964243866,NaN,NaN,0.3269265048889612,-2.256165205801686
2012-02-23T09:30:00-05:00,35,35.06,34.81,34.92999,4838945,6778865.2,51.19769230531502,50.11893023457962,NaN,NaN,57.33503948111572,109.07210381033106,0.02580937023579068,0.00862621421315879,-0.01718315602263189,31111957,35536440.4,44.8729852087666,55.827378101532304,NaN,NaN,0.6062204979877804,-1.847252962403191
2012-02-24T09:30:00-05:00,34.98,35.19,34.88,35.08,3325110,6577598.45,55.03285695548261,50.54910619885356,NaN,NaN,131.63521409326825,109.53104024689033,0.03186516604375777,0.022648301532065318,-0.009216864511692449,34437067,34037314.8,42.52251757174983,54.7824344444918,NaN,NaN,1.8880212837075416,-1.3136423558159436
2012-02-27T09:30:00-05:00,35.03999,35.12,34.87,35.07001,4689555,6407182.65,54.72442820960658,51.14899442708094,NaN,NaN,99.1665774739926,92.95831564257,0.03343688681009639,0.03257924400092804,-0.0008576428091683491,29747512,32526186,40.234715774051125,53.421064314767015,NaN,NaN,2.8871916145320045,-0.7135232171948082
2012-02-28T09:30:00-05:00,35.06,35.11,34.8,34.89999,6827367,6274798.05,49.62679882358673,51.041621258238614,NaN,NaN,45.122300653563535,82.63917124126478,0.021826733842228586,0.026425774493617382,0.0045990406513887975,22920145,30833516.6,37.78257009168597,51.741699467185605,NaN,NaN,2.4231633282585623,-0.2654251392728981
2012-02-29T09:30:00-05:00,34.92,35.05499,34.69,34.89,6141699,6213890.25,49.33599435838895,50.860446451707126,NaN,NaN,0.116193647369394,66.67506506986189,0.012726054395753231,0.020506608646080338,0.0077805542503271066,16778446,26999025.4,32.892035193446375,49.597199140090105,NaN,NaN,1.9574615367600259,0.05213010016037667
2012-03-01T09:30:00-05:00,34.89999,35.10001,34.85001,34.98,5531988,6080669.35,52.06140421282476,51.01949851980482,NaN,NaN,62.90678217803642,67.78941360924604,0.012027459943593562,0.02281487917981906,0.010787419236225497,22310434,25238720.8,30.913782462410026,47.18189270201513,NaN,NaN,2.2615764947222434,0.36776529938350044
2012-03-02T09:30:00-05:00,34.99001,35.07001,34.85001,34.96001,4865484,5922017,51.40002491596556,51.23369259565336,NaN,NaN,46.17527016578141,50.69742482374867,0.009585033208575584,0.022768710746944976,0.013183677538369392,17444950,21840297.4,27.4778253703671,44.62352231988957,NaN,NaN,2.351087762606137,0.6510970798438771
2012-03-05T09:30:00-05:00,34.97,35.11,34.75999,35.03999,4669000,5693892.6,53.92222484155229,51.688187281336546,NaN,NaN,48.73283688181131,40.610676705312414,0.012535647849985811,0.028853237350851657,0.016317589500865846,22113950,20313585,26.075671983380374,42.086044281488526,NaN,NaN,3.0821892153508195,0.9983959563448688
2012-03-06T09:30:00-05:00,34.91,34.94,34.7,34.89999,7338125,5756950.4,49.11707155215918,51.78198164912861,NaN,NaN,-53.27340300157465,20.931535974284778,0.00464465928664521,0.02212341360917236,0.01747875432252715,14775825,18684721,24.63150821026339,39.6020837852667,NaN,NaN,2.452251431363534,1.2060895956332496
2012-03-07T09:30:00-05:00,34.97,34.97,34.64999,34.92,6244363,5722727.75,49.80556334000391,52.04084951518616,NaN,NaN,-55.09314793597543,9.889667657615819,0.0005729008004874241,0.01819488032313643,0.017621979522649007,21020188,19533069.4,26.90220586952138,37.750119907673984,NaN,NaN,2.099044250008182,1.3336545462582399
2012-03-08T09:30:00-05:00,34.92,35.10001,34.89999,35.03,5522879,5677960.35,53.52816659528354,51.94314804617935,NaN,NaN,73.05045962986874,11.918403147982282,0.0048500558541738695,0.023684549340366345,0.018834493486192476,26543067,20379596,29.194587872154145,36.18554748369518,NaN,NaN,2.7826273311311556,1.540650658382942
2012-03-09T09:30:00-05:00,35.13,35.21001,34.92,35.17,3890736,5529577.4,57.81618872121797,52.188366522562944,NaN,NaN,130.81938763622574,28.84722664207115,0.016039408289898832,0.038883753848566016,0.022844345558667184,30433803,22977366.6,35.84374498765874,35.22183095921159,NaN,NaN,4.608093828972657,1.978856825610044
2012-03-12T09:30:00-04:00,35.25999,35.64,35.17999,35.57001,8024004,5702849.1,67.14449595624222,53.338220616289846,NaN,NaN,337.27393477691675,86.55544622109224,0.04753130150225495,0.08225847243648587,0.03472717093423092,38457807,26246138,43.086205219788546,34.884671464696325,NaN,NaN,9.557896439893986,3.0615767705077497
2012-03-13T09:30:00-04:00,35.69,35.72,35.4601,35.69,6161289,5675170.95,69.33506978579301,54.574855755244364,NaN,NaN,309.8914963537138,159.18842609214994,0.07211902119480663,0.12487594742773922,0.052756926232932586,44619096,32214792.2,53.42512887306773,35.41824890630796,NaN,NaN,14.382849538163592,4.678901451601441
2012-03-14T09:30:00-04:00,35.62,35.74001,35.12,35.16,8634715,5827578.4,52.64020715134184,54.67789252996056,NaN,NaN,139.10407631267805,198.02787094188062,0.04944519264333139,0.11456341703709683,0.06511822439376544,35984381,35207630.8,57.58577589579349,36.32630538395273,NaN,NaN,12.735963270327883,5.8299102828480756
2012-03-15T09:30:00-04:00,35.23,35.28999,34.95,35.13,6394434,5779924.7,51.87874309660397,54.45259868289781,NaN,NaN,32.59066300054967,189.9359116160168,0.03013347713330064,0.10278507081039123,0.07265159367709059,29589947,35817006.8,58.400635226216224,37.46045664498604,NaN,NaN,11.231217984791517,6.6015256688399955
2012-03-16T09:30:00-04:00,34.75,34.81,34.62,34.78,7598719,5790751.25,43.90010370847361,53.679432647102594,NaN,NaN,-135.85248525760812,136.60153703725004,-0.0065489117305933126,0.06446545401384896,0.07101436574444227,21991228,34128491.8,55.23411148246199,38.53184205272968,NaN,NaN,6.9296848075539055,6.648405545799125
2012-03-19T09:30:00-04:00,34.75,34.88,34.53999,34.53999,11463949,6132471.75,39.42264928835185,52.95056482315725,NaN,NaN,-154.79655697353755,38.18743868715917,-0.045161719549954835,0.014562216306998721,0.059723935856953556,10527279,28542386.2,46.291655828867896,39.13963389109981,NaN,NaN,1.7475031714384286,5.9482766351761684
2012-03-20T09:30:00-04:00,34.52,34.67999,34.44,34.58,6933844,6183180.75,40.51187973192141,52.320270921266705,NaN,NaN,-166.69771566610666,-57.13040371680493,-0.06498717446528621,-0.021510032224654196,0.043477142240632004,17461123,23110791.6,39.58134205461979,39.617441524040764,NaN,NaN,-1.8202660076508188,4.838484829058028
2012-03-21T09:30:00-04:00,34.60001,34.7,34.5,34.50999,4357613,6172690.9,39.184190053325594,51.400469909873905,NaN,NaN,-144.8613629900918,-113.92349157735889,-0.07887089790227654,-0.055111480137213675,0.023759417765062865,13103510,18534617.4,34.98060593499565,39.90792891493974,NaN,NaN,-5.081675385783643,3.421319084080646
2012-03-22T09:30:00-04:00,34.49001,34.62,34.37,34.59,10250727,6443280,41.54209507358663,50.6963320639897,NaN,NaN,-139.02159278422698,-148.2459427343142,-0.0785489627785859,-0.07442678570816952,0.004122177070416386,23354237,17287475.4,33.82663814427997,40.361415541647794,NaN,NaN,-6.98665064884225,1.9344662650916609
2012-03-23T09:30:00-04:00,34.62,34.69,34.52,34.60001,5177387,6535893.85,41.84587900499038,49.833735932806704,NaN,NaN,-100.78928204735502,-141.23330209226359,-0.07362827994179114,-0.08791317285682254,-0.014284892915031402,28531624,18595554.6,36.203827625551696,41.08485523037432,NaN,NaN,-8.41812132386641,0.45552518095479355
2012-03-26T09:30:00-04:00,34.71001,34.94,34.64,34.84,7002898,6651561,48.72553106378843,49.805768755065934,NaN,NaN,-35.88197307661489,-117.45038531287905,-0.051238541388088726,-0.0783330696501423,-0.027094528262053583,35534522,23597003.2,44.42455099704414,42.498644000858654,NaN,NaN,-7.56492790771827,-0.6902538317127869
2012-03-27T09:30:00-04:00,34.85001,35.08,34.78999,35.005,4604281,6540406.7,52.85502532665351,50.023587468398055,NaN,NaN,9.006208029217639,-82.3096005738142,-0.02374214784451356,-0.05677221306769553,-0.03303006522318197,40138803,28132539.2,50.636639327409696,44.193960676422115,NaN,NaN,-5.537024907360417,-1.3826496996624482
2012-03-28T09:30:00-04:00,35,35.03,34.59,34.72,6668297,6566736.6,45.96847960671224,49.483609826357245,NaN,NaN,-41.57872738801073,-61.65307345339797,-0.023150243831296977,-0.061967870012303194,-0.03881762618100622,33470506,32205938.4,55.45267116008843,46.069538054131705,NaN,NaN,-5.987421277187047,-2.0404742107373908
2012-03-29T09:30:00-04:00,34.63,34.88,34.39,34.855,6731410,6626707.7,49.33583991871796,48.87787062617868,NaN,NaN,-56.841325358096874,-45.21701996817194,-0.01259639832365543,-0.05456312408557551,-0.04196672576192008,40201916,35575474.2,59.01479886492856,47.724613331079546,NaN,NaN,-5.267008122604403,-2.5014076267183922
2012-03-30T09:30:00-04:00,34.96001,35.06,34.85001,35.045,5370340,6651950.5,53.708522559746854,47.918158240714725,NaN,NaN,20.795130381460112,-20.90013748240892,0.007186830346645766,-0.03298318782861287,-0.040170018175258636,45572256,38983600.6,62.29859129244165,49.09692662198334,NaN,NaN,-3.229399183400293,-2.6054064205300924
2012-04-02T09:30:00-04:00,35.03,35.34,34.92999,35.22,12073871,7022194.05,57.35895319152357,47.06272134112405,NaN,NaN,65.21632298774304,-0.6804782695373206,0.03074414284593431,-0.0017398396178407438,-0.032483982463775055,57646127,43405921.6,66.09467508361834,50.00189420845125,NaN,NaN,-0.3278537980829089,-2.2800417601804948
2012-04-03T09:30:00-04:00,35.21001,35.235,34.96001,35.2,5757602,6943167.9,56.80760473100328,47.36039259681415,NaN,NaN,51.4597569304727,7.810231510713692,0.04291754816035348,0.021162952736666796,-0.021754595423686685,51888525,45755866,67.94185262788676,50.74161397502934,NaN,NaN,1.8021875410785686,-1.6968661457149143
2012-04-04T09:30:00-04:00,35.00999,35.21899,34.99001,35.14999,7970508,7029475.15,55.37428003303045,47.610073806558894,NaN,NaN,44.15175957510635,24.956328903337106,0.04530460510729868,0.034876160960436664,-0.010428444146862014,43918017,47845368.2,69.53136411111083,51.5366660382361,NaN,NaN,3.1282791838412183,-1.0075596700640381
2012-04-05T09:30:00-04:00,35,35.06,34.77499,34.89,4697320,6988197.2,48.52025544570495,47.94008464493256,NaN,NaN,-9.08331574307199,34.50793082634208,0.027928943613347773,0.024482735369822706,-0.003446208243525069,39220697,47649124.4,69.18441059780092,52.53311597504602,NaN,NaN,2.2054290721815244,-0.548561278314672
2012-04-09T09:30:00-04:00,34.66,34.78999,34.61,34.71291,5026477,7044984.25,44.4815723798165,48.3014362943229,NaN,NaN,-56.332598618020995,19.08238502644582,0.0043040825741010435,0.0019338949741012357,-0.002370187599999808,34194220,45373517.2,65.126219918824,53.878441981471454,NaN,NaN,0.14651311099411046,-0.449264936984846
2012-04-10T09:30:00-04:00,34.56,34.64,34.17,34.25999,7641285,7025848.3,36.18564165342968,47.99241928871635,NaN,NaN,-134.36330872856183,-20.833541316815154,-0.03961183750475404,-0.051884984480942364,-0.01227314697618832,26552935,39154878.8,55.53876922745648,55.018258208102644,NaN,NaN,-4.695233886179609,-1.055831929726955
2012-04-11T09:30:00-04:00,34.47,34.48,34.25999,34.34,4920871,6963827.4,38.37223906909245,47.93442278984255,NaN,NaN,-129.56577612188755,-57.03864792728721,-0.05984302421967679,-0.08707692725078431,-0.027233903031107516,31473806,35071935,50.30274400962408,56.11269664200468,NaN,NaN,-7.788417851835564,-2.017629918599613
2012-04-12T09:30:00-04:00,34.39,34.45,34.19,34.44501,5843863,6824284.8,41.21904669360648,47.91134790555826,NaN,NaN,-121.17585519014612,-90.1041708803377,-0.062436690720928556,-0.10527976643226822,-0.04284307571133966,37317669,33751865.4,48.704002531204395,57.175365526785,NaN,NaN,-9.388704838989085,-3.0706406215123945
2012-04-13T09:30:00-04:00,34.39,34.6499,34.31,34.33,5347328,6771929.5,39.08929395387857,47.71444897333598,NaN,NaN,-92.7405800035789,-106.83562373243907,-0.06773839350934678,-0.12751606759802314,-0.05977767408867636,31970341,32301794.2,46.93918702744362,57.942176912634416,NaN,NaN,-11.372673524779497,-4.256645321979123
2012-04-16T09:30:00-04:00,34.42999,34.769,34.36,34.655,7289488,6756467.95,47.365547599473395,47.61730729731348,NaN,NaN,-37.35170276077583,-103.03944456099005,-0.046224717201075224,-0.1175585705900204,-0.07133385338894517,39259829,33314916,48.347448989978815,58.22238391212976,NaN,NaN,-10.413763117697242,-5.136233578510283
2012-04-17T09:30:00-04:00,34.83,34.89,34.48,34.83,5592797,6462910.35,51.20980191802008,47.49979133955395,NaN,NaN,4.685769835119044,-75.22962884825387,-0.01849875732880636,-0.09445730004995312,-0.07595854272114676,44852626,36974854.2,53.1816270324417,58.40416874820347,NaN,NaN,-8.354553528080647,-5.59599357130605
2012-04-18T09:30:00-04:00,34.78999,34.9287,34.67,34.78,3588485,6295642.4,50.08426449016309,47.79377597408616,NaN,NaN,20.225567059923804,-45.271360211891604,-0.002649311051157635,-0.0792701815350938,-0.07662087048393616,41264141,38932921.2,55.57702138158643,58.41305090688189,NaN,NaN,-7.060163703451301,-5.8051607330410855
2012-04-19T09:30:00-04:00,34.74001,34.82001,34.55,34.67999,5015695,6328546.5,47.820261986647154,47.68552040750968,NaN,NaN,-17.125137681631557,-24.461216710188687,0.0017398293761178851,-0.0744460837637888,-0.07618591313990669,36248446,38719076.6,55.24458705762497,58.143750063503056,NaN,NaN,-6.67065842378427,-5.9288032602901115
2012-04-20T09:30:00-04:00,34.75,35.0775,34.66,35.02,7783977,6205209,55.22989445878787,47.794189828869754,NaN,NaN,54.311220086267426,4.949143307780574,0.02679286913545212,-0.04269482672059155,-0.06948769585604367,44032423,41131493,58.27658632885893,57.85646399467573,NaN,NaN,-3.9098943644696496,-5.640387703744331
2012-04-23T09:30:00-04:00,34.86,34.89999,34.7074,34.87,5590492,6225864.25,51.73929865487607,47.39278593339493,NaN,NaN,20.253487240893463,16.470181308114427,0.03215195911180626,-0.029297746966285843,-0.0614497060780921,38441931,40967913.4,57.98970914594101,57.27753785627021,NaN,NaN,-2.7313551164017964,-5.224811619838254
2012-04-24T09:30:00-04:00,34.83,35.13,34.83,35.11,6243277,6187883.2,56.478782538384955,47.3692986339222,NaN,NaN,79.69819095095572,31.47266553128177,0.04970193861776588,0.000677717194115246,-0.049024221423650635,44685208,40934429.8,57.92684985156002,56.562180515104004,NaN,NaN,-0.17577410339348157,-4.50352054606043
2012-04-25T09:30:00-04:00,35.21001,35.34,35.06,35.28999,6236922,6269515.25,59.67702787995374,47.676637765845285,NaN,NaN,133.55560992584324,54.13867410446566,0.0700299538009577,0.03851322082754649,-0.031516732973411204,50922130,42866027.6,60.581388964104434,55.92289657603212,NaN,NaN,2.994075626063939,-3.432435378614091
2012-04-26T09:30:00-04:00,35.21001,35.53999,35.205,35.49001,4265918,6149396.3,62.93663540237071,48.70637919132141,NaN,NaN,157.42975319537086,89.04965227986614,0.09215221515673558,0.08367353597250826,-0.00847867918422731,55188048,46653948,65.21618038187766,55.63945156060903,NaN,NaN,6.72156158155825,-1.9818643843037567
2012-04-27T09:30:00-04:00,35.55,35.66,35.44,35.61,4981215,6061886.55,64.77616076428355,50.15599264735477,NaN,NaN,167.21689029139387,111.63078632089143,0.10892202858345146,0.127673856545087,0.018751827961635555,60169263,49881316,68.60340329915121,55.88782180206098,NaN,NaN,10.357667925166735,-0.21907405437940075
2012-04-30T09:30:00-04:00,35.59,35.71001,35.46001,35.66,7046230,6145681.05,65.54359390489176,52.25298923674492,NaN,NaN,152.35016991740943,138.05012285619463,0.11674307638534288,0.16468067344331416,0.04793759705797128,67215493,55636028.4,73.5494770750571,57.17430093403245,NaN,NaN,13.527253997436794,1.7446870958800558
2012-05-01T09:30:00-04:00,35.7,35.94,35.57001,35.84,9260359,6005005.45,68.22735819678968,54.38549774586615,NaN,NaN,164.91474411543393,155.09343348909027,0.12657543422107187,0.20615688983431113,0.07958145561323925,76475852,61994157.2,77.72479950184662,59.13301918347692,NaN,NaN,17.071345992983385,3.9342097954662454
2012-05-02T09:30:00-04:00,35.78,35.82001,35.58,35.63,5505648,5992407.75,62.145764515947654,55.8802633046048,NaN,NaN,127.0974277827728,153.8017970604762,0.11197563386844928,0.21955099794880084,0.10757536408035157,70970204,66003772,79.88158759176866,61.3599895449458,NaN,NaN,18.273534182549163,5.982684707906662
2012-05-03T09:30:00-04:00,35.60001,35.8476,35.47,35.52,5859922,5886878.45,59.17052233576017,57.31463676045349,NaN,NaN,103.39312002598948,142.9944704265999,0.08895412701428057,0.2187680228482023,0.12981389583392172,65110282,67988218.8,80.86888420416363,63.78353934328294,NaN,NaN,18.373644101264468,7.752821764100634
2012-05-04T09:30:00-04:00,35.48,35.74001,35.48,35.57001,6873406,5995682.75,60.10565027037385,58.224644094089236,NaN,NaN,88.51499133404712,127.25409063513055,0.07186960304947365,0.2196508996457638,0.14778129659629013,71983688,70351103.8,82.00148882822128,66.18739933172883,NaN,NaN,18.724587277510444,9.320216837444892
2012-05-07T09:30:00-04:00,35.46001,35.5455,35.38,35.5,3876938,5938205.8,58.09952657917051,58.71676728417141,NaN,NaN,62.71071846848291,109.32620034534523,0.05157866254384286,0.2122546247760937,0.16067596223225084,68106750,70529355.2,82.08764092743797,68.25211460994285,NaN,NaN,18.450072387094764,10.624481915966303
2012-05-08T09:30:00-04:00,35.36,35.60001,35.33,35.56,5414129,5826848,59.35168928424421,59.37872619803435,NaN,NaN,59.09836877459815,88.16292527717806,0.03852106316723777,0.20882729119129806,0.17030622802406029,73520879,69938360.6,80.70826532012418,70.04720346269555,NaN,NaN,18.56093642752387,11.758261131903097
2012-05-09T09:30:00-04:00,35.34,35.72,35.28999,35.58,5278402,5844724.55,59.78312253274556,60.23321623704137,NaN,NaN,58.22718615226193,74.3888769510759,0.02804117896550326,0.20535770173093937,0.1773165227654361,78799281,71504176,81.59089625125574,71.92908269081204,NaN,NaN,18.767085504716746,12.759521756590761
2012-05-10T09:30:00-04:00,35.74001,36.03999,35.6801,35.91,4464953,5775779.05,66.16447405291565,61.014257636622,NaN,NaN,106.58629021286083,75.02751098845019,0.03944589380825042,0.22662389002574912,0.1871779962174987,83264234,75134966.4,83.47846804477365,73.72921709909167,NaN,NaN,20.834951196754613,13.913154533757025
2012-05-11T09:30:00-04:00,35.86,36.14,35.81,35.92999,3129893,5664907.3,66.51112186022532,62.069387865575514,NaN,NaN,113.51023839586229,80.02656040081322,0.04409557822829782,0.24229746900287097,0.19820189077457315,86394127,78017054.2,84.80990902662133,75.64494566199741,NaN,NaN,22.624349372301804,15.15761093926342
2012-05-14T09:30:00-04:00,35.75,36.02,35.67,35.89,5049273,5552896.55,65.07480035297993,62.68338913804659,NaN,NaN,91.42298413316657,85.76901353374994,0.04033931008736158,0.24862602838377512,0.20828671829641354,81344854,80664675,85.93154342723493,77.64528091740276,NaN,NaN,23.732925999329623,16.382655947844306
2012-05-15T09:30:00-04:00,35.81,35.92999,35.565,35.64,5724355,5559474.45,56.81459916509933,62.47892994412842,NaN,NaN,59.32140665531012,85.81362110989235,0.018016974488608728,0.23080793640717445,0.21279096191856572,75620499,81084599,86.10676752974248,79.46852224351976,NaN,NaN,22.3413650912301,17.233900111185132
2012-05-16T09:30:00-04:00,35.74001,35.8,35.59,35.69,7146281,5737364.25,57.96385145550684,62.123731090781,NaN,NaN,51.94339452402249,84.55686278424446,0.004332196025773172,0.2182062069507822,0.21387401092500902,82766780,81878098.8,86.45019979135138,80.98523791562504,NaN,NaN,21.50568507327971,17.84415510577007
2012-05-17T09:30:00-04:00,35.74001,35.78,35.48,35.49001,6345449,5803851.95,52.00273547461323,61.211343570090264,NaN,NaN,17.890985211862837,66.81780178404486,-0.01918500199034695,0.18989275843707532,0.20907776042742227,76421331,80509518.2,82.65516279538168,81.98893502249864,NaN,NaN,18.984208711072032,18.007019906527493
2012-05-18T09:30:00-04:00,35.56,35.7401,35.38,35.42,6890402,5759173.2,50.06179061831452,60.10550047819189,NaN,NaN,-13.488047530207792,41.418144598830835,-0.0392934132732273,0.15996099383588813,0.19925440710911543,69530929,77136878.6,74.03045001814226,82.023290232719,NaN,NaN,16.309142007361206,17.76446592093231
2012-05-21T09:30:00-04:00,35.45,35.52,35.3,35.46001,5466594,5752978.3,51.18316286325983,58.88805795436833,NaN,NaN,-66.3346356015118,9.86662065189517,-0.0491003699135599,0.13787894471716555,0.18697931463072545,74997523,75867412.4,71.02624610333693,81.54482213282547,NaN,NaN,14.390942852950605,17.28253405407778
2012-05-22T09:30:00-04:00,35.60001,35.8,35.55,35.71001,6954305,5788529.7,57.59125052023378,58.562735526103054,NaN,NaN,35.90543148328476,5.183425617490093,-0.03842349658387964,0.1389499439008759,0.17737344048475553,81951828,77133678.2,72.23651378372004,80.99874543225056,NaN,NaN,14.520833091575808,16.888005345148926
2012-05-23T09:30:00-04:00,35.64,35.78999,35.34,35.52,5736105,5763488.85,52.00378457455355,58.050825686016864,NaN,NaN,-45.17867340054151,-14.240987967422702,-0.04346029014478031,0.12304807780378013,0.16650836794856044,76215723,75823466.8,69.02376693856428,80.1526656275649,NaN,NaN,12.912308201536046,16.320048610347087
2012-05-24T09:30:00-04:00,35.55,35.86,35.465,35.66,6454199,5872902.9,55.434564031912444,57.7171766689839,NaN,NaN,10.714238622536962,-15.676337285287872,-0.03692254661820127,0.12035518467580886,0.15727773129401013,82669922,77073185,70.37709407738048,79.32235171679054,NaN,NaN,12.598197320456647,15.788355568934167
2012-05-25T09:30:00-04:00,35.69,35.88,35.67,35.78,4855797,5866632,58.19305838160874,57.723857512015215,NaN,NaN,71.31802109006551,1.2848764387667841,-0.024665026123950357,0.12644644863907217,0.15111147476302253,87525719,80672143,73.911903092966,78.7383704428997,NaN,NaN,13.176000500978338,15.41516198779762
2012-05-29T09:30:00-04:00,35.91,35.91,35.71989,35.89,4097848,5719212.9,60.60052616324828,57.81306014622978,NaN,NaN,96.13638409793586,33.77908037865632,-0.010046979770176712,0.13855275005030165,0.14859972982047837,91623567,83997351.8,76.68064033022463,78.45068294362115,NaN,NaN,14.391450085549165,15.268917430333554
2012-05-30T09:30:00-04:00,35.75,36.03999,35.60001,35.67,3960979,5454243.9,53.91361959814321,57.393809936615334,NaN,NaN,58.260666735931636,38.250127429185696,-0.01575263364432239,0.1289089377650754,0.14466157140939778,87662588,85139503.8,77.56153143052227,78.16287117071161,NaN,NaN,13.368833326639287,14.997476844091516
2012-05-31T09:30:00-04:00,35.64999,36.07001,35.60989,35.86,6017215,5479822.25,58.20313446632404,56.82514282328736,NaN,NaN,89.68883412883109,65.22362893506022,-0.0076965436778412555,0.13504089181209622,0.14273743548993748,93679803,88632319.8,80.0441617916203,77.91756358120065,NaN,NaN,13.857243188428845,14.83458632185399
2012-06-01T09:30:00-04:00,35.59,35.92999,35.56,35.71001,11160941,5744873.2,53.935350111209694,55.92687341264338,NaN,NaN,28.049171250816944,68.6906154607162,-0.013116998370921118,0.1263411875262861,0.1394581858972072,82518862,88602107.8,79.96174995535875,77.57126650468192,NaN,NaN,12.90910980805244,14.559518248453768
2012-06-04T09:30:00-04:00,35.75,35.87,35.66,35.83,5766277,5689516.75,56.67243227546967,55.326704264249784,NaN,NaN,51.03559835062619,64.63413091282834,-0.009440751810588871,0.12765724613397111,0.13709799794455999,88285139,88753991.8,80.07282662823036,77.15278673332445,NaN,NaN,12.976892669547022,14.333428880038518
2012-06-05T09:30:00-04:00,35.8,36.13,35.73,35.96001,4298734,5710606.55,59.48166693735059,55.51720910512488,NaN,NaN,119.76016795950034,69.35888768514124,0.000405386318088341,0.1376047308421704,0.13719934452408206,92583873,88946053,80.22212497361065,76.73245512217217,NaN,NaN,13.907107256042597,14.272525790896244
2012-06-06T09:30:00-04:00,36.12,36.46001,36.02,36.46001,8899109,5884855.55,68.05896687623128,56.23828877803377,NaN,NaN,259.4226718210856,109.59128870217202,0.03721351559894043,0.18371623902275758,0.14650272342381715,101482982,91710131.8,82.27978553845594,76.4345683898225,NaN,NaN,17.8634089753291,14.78550910295808
2012-06-07T09:30:00-04:00,36.60001,36.77,36.60001,36.74001,7374027,5989636.8,71.6750683429773,57.64345541148834,NaN,NaN,321.90889571929995,156.0353010202658,0.07486665246449714,0.2400860390044386,0.16521938653994145,108857009,94745573,84.22122350509939,76.54642986908804,NaN,NaN,22.487878521947398,15.885847591385126
2012-06-08T09:30:00-04:00,36.71001,36.88,36.53,36.82001,6729738,6102876.05,72.62853674068168,59.25536584880028,NaN,NaN,247.79064067059772,199.98359490422195,0.0981414150518137,0.2878961553547086,0.18975474030289488,115586747,101359150,87.44798737355568,77.50482539447471,NaN,NaN,26.407306040905866,17.388913084173804
2012-06-11T09:30:00-04:00,37,37.16,36.75,36.78999,7416918,6317227.3,71.65381171857197,60.71755505275115,NaN,NaN,215.31623977721839,232.8397231895404,0.10393908617228956,0.3196785980182568,0.21573951184596726,108169829,105336088,88.91587367362249,78.78265593520939,NaN,NaN,29.159395507148623,19.070410573170207
2012-06-12T09:30:00-04:00,36.75999,36.86,36.5,36.83009,4735781,6301552.7,72.19069917648433,61.76037281391191,NaN,NaN,142.80241459628974,237.4481725168983,0.10271652783333726,0.34413517163763885,0.24141864380430159,112905610,109400435.4,90.17981110732381,80.06432002975251,NaN,NaN,31.532260306437486,20.85067482077982
2012-06-13T09:30:00-04:00,36.71001,36.99001,36.59,36.84,6663625,6348516.2,72.33017820650389,63.21225807333693,NaN,NaN,128.1492484042395,211.19348783352908,0.09499714718696184,0.3601650777880039,0.26516793060104205,119569235,113017686,91.14735287345718,81.64457616795916,NaN,NaN,33.48881319007339,22.656123159250328
2012-06-14T09:30:00-04:00,36.89999,37.2,36.86,37.09,5843496,6283376.95,75.64834604558197,64.65609964574189,NaN,NaN,137.2313553433324,174.25797975833558,0.09871581206341729,0.38856269568031365,0.28984688361689637,125412731,116328830.4,91.9310546985481,83.18414478375685,NaN,NaN,36.2665794778578,24.60047406190854
2012-06-15T09:30:00-04:00,36.88,37,36.75999,36.92999,5953328,6263770.9,69.87281370980979,65.49036788347054,NaN,NaN,100.25020847420328,144.74989331905667,0.08301781007845044,0.3936191462149594,0.310601336136509,119459403,117103361.6,92.10707436564199,84.48379987466228,NaN,NaN,36.892587404593854,26.356490253720725
2012-06-18T09:30:00-04:00,36.78,37.13,36.78,37.07001,5172660,6177883.8,71.89492460283431,66.29711062915526,NaN,NaN,99.4357686766482,121.57379909894264,0.07493073196513789,0.40426475109293136,0.3293340191277935,124632063,120395808.4,92.82372580986872,85.63687740892257,NaN,NaN,38.03294177535499,28.024554756811334
2012-06-19T09:30:00-04:00,37.17,37.27,36.99001,36.99001,5585133,6183810.75,69.04355107719576,67.37782002051617,NaN,NaN,99.45100179235396,112.90351653815549,0.057826026796208185,0.40161655262305374,0.34379052582684555,119046930,121624072.4,93.0762870288716,86.7450742373761,NaN,NaN,38.1345041592566,29.468833242874943
2012-06-20T09:30:00-04:00,36.99001,37.03,36.5,36.63,7389672,6205579.1,57.9124725107222,67.35705845225888,NaN,NaN,48.39034475867161,96.9517358090419,0.01796452334076115,0.36624618000279696,0.3482816566620358,111657258,120041677,88.74307360647771,87.36642508129448,NaN,NaN,34.605976522503745,30.202710854250487
2012-06-21T09:30:00-04:00,36.67,36.86,36.21001,36.25,9589984,6398273.05,48.94314789312709,67.00047257953871,NaN,NaN,7.377222455099346,70.9809092313953,-0.03538755441133851,0.3040472136478627,0.3394347680592012,102067274,115372585.6,77.30665694208409,87.17677558034629,NaN,NaN,28.283016492235326,29.928468802534034
2012-06-22T09:30:00-04:00,36.35001,36.3887,36.2,36.25999,3455204,6248323.3,49.16604687987308,66.46430219413895,NaN,NaN,-20.117852539131242,46.90729702872839,-0.06942955259390993,0.2526478273168138,0.3220773799107237,105522478,112585200.6,71.39168860709134,86.55669429312206,NaN,NaN,23.490122416059698,29.0087050330377
2012-06-25T09:30:00-04:00,36,36.25,36,36.19,5324930,6271779.95,47.598213520731484,65.61548409295186,NaN,NaN,-45.25024607384221,17.970094078630304,-0.09452972196186255,0.20391522745839552,0.29844494942025807,100197548,107698297.6,62.380069468644194,85.28226175705304,NaN,NaN,19.1250898630917,27.5967600087597
2012-06-26T09:30:00-04:00,36.205,36.39,36.13,36.24001,3981538,6265964.45,48.85325521151565,64.24364754547217,NaN,NaN,-33.46431682421559,-8.612969644683607,-0.10483596189063193,0.16739999705696818,0.2722359589476001,104179086,104724728.8,57.61448862097887,83.52045483437611,NaN,NaN,15.934966551920743,25.93078951492556
2012-06-27T09:30:00-04:00,36.42999,36.77499,36.34,36.64999,5224680,6329149.5,57.78046948713648,63.2511761986264,NaN,NaN,16.12741545448792,-15.06555550552035,-0.08211799651790797,0.16958846330021515,0.2517064598181231,109403766,104274030.4,56.90489077241288,81.56928821061278,NaN,NaN,15.831281976868233,24.488002723774514
2012-06-28T09:30:00-04:00,36.48,36.78,36.3699,36.78,4230785,6239828,60.15547893754462,62.36024349840233,NaN,NaN,20.66620598571333,-12.40775879939756,-0.05757188014607628,0.17974160963552777,0.23731348978160405,113634551,106587485.8,59.65191982267443,79.58385481412128,NaN,NaN,16.509236062613425,23.348178915037217
2012-06-29T09:30:00-04:00,37.10001,37.175,36.77,36.99001,7620059,6062783.9,63.707061948832134,61.79261851484949,NaN,NaN,82.73917978673022,8.163647665774734,-0.02793003106007036,0.2024009509565161,0.23033098201658647,121254610,109733912.2,63.09728104535767,77.73966962638806,NaN,NaN,18.239891210829033,22.618423528721763
2012-07-02T09:30:00-04:00,37.11,37.298,36.91,37.22,11588590,6353899.55,67.15943444644365,61.433242462703724,NaN,NaN,115.78263329579593,40.370223539702366,0.004690584974039208,0.23619421323413547,0.23150362826009627,132843200,116263042.6,69.01078520876825,76.2275963479198,NaN,NaN,20.854387135567563,22.366418329699734
2012-07-03T09:30:00-04:00,37.17999,37.3,37.00999,37.13,2762659,6277095.8,64.5709191888694,60.87900967572983,NaN,NaN,113.3454734968331,69.7321816039121,0.01703650279042404,0.2527992567481263,0.23576275395770227,130080541,121443333.6,72.74285988795943,74.91298970609854,NaN,NaN,22.15404112904286,22.336078729605894
2012-07-05T09:30:00-04:00,37.08,37.14999,36.8761,36.91,8851707,6274725.7,58.62285658710299,59.662903285838475,NaN,NaN,61.32219289909269,78.77113709283306,0.007692313205227591,0.24537814546423675,0.23768583225900916,121228834,123808347.2,74.26656751488422,73.65124062155112,NaN,NaN,21.37007845753562,22.19807869073871
2012-07-06T09:30:00-04:00,36.74001,36.89999,36.64999,36.83,5470906,6179569.65,56.58174436293804,58.713541189633354,NaN,NaN,7.802969788979902,76.19848985348636,-0.005840037036794837,0.23038578596301562,0.23622582299981046,115757928,124233022.6,74.54177335684807,72.39657626378013,NaN,NaN,20.104739034899964,21.899030168476035
2012-07-09T09:30:00-04:00,36.75,36.825,36.56,36.71001,8701492,6278157.35,53.569059679618164,57.40455083797506,NaN,NaN,-18.368270754219793,55.97699974529637,-0.02382681482985502,0.20644230446249168,0.2302691192923467,107056436,121393387.8,69.21174183338223,70.71000597974539,NaN,NaN,18.133958527047966,21.361162791129168
2012-07-10T09:30:00-04:00,36.75,36.91,36.72,36.77,4029674,6108795.15,54.863041371767515,56.39165728758733,NaN,NaN,11.86363307667389,35.19319970147196,-0.03212243563709352,0.1901160747459798,0.22223851038307332,111086110,117041969.8,61.9067300700352,68.48360905411421,NaN,NaN,16.888805866278727,20.722254659007675
2012-07-11T09:30:00-04:00,36.84,37.035,36.75,36.96001,4113102,6077661.2,58.78133397642402,56.45371882085174,NaN,NaN,41.382578953874045,20.800620792880146,-0.025538170665858062,0.19031579705075075,0.2158539677166088,115199212,114065704,57.44103570996325,66.24774920436319,NaN,NaN,16.964694718281333,20.185460381761054
2012-07-12T09:30:00-04:00,36.92999,37.10001,36.83,37.00999,5267559,6007857.9,59.77059891296271,57.22710817941144,NaN,NaN,55.60041917651579,19.656266048364774,-0.018850820417336406,0.1922904421949383,0.2111412626122747,120466771,113913291.4,57.213430102380656,64.81251871581294,NaN,NaN,17.311810465018166,19.7749389650835
2012-07-13T09:30:00-04:00,37.09,37.39,37.03999,37.34,7063770,6068871.6,65.63531027341286,58.40348413609285,NaN,NaN,124.17552944973933,42.93077798051665,0.005464404967265968,0.21797176882135716,0.2125073638540912,127530541,116267814,59.859550509313344,63.98879456597165,NaN,NaN,19.46555036271773,19.730740593316963
2012-07-16T09:30:00-04:00,37.3,37.38,37.2403,37.32001,5139348,6028172.6,65.01700857894411,59.64768378310804,NaN,NaN,124.36357972889304,71.47714807713922,0.017205159864359942,0.2340138136845411,0.21680865382018116,122391193,119334765.4,63.06391360940416,64.03764057602594,NaN,NaN,21.013672263896854,19.914016546256946
2012-07-17T09:30:00-04:00,37.35001,37.50999,37.17,37.39999,5731559,6056117.55,66.38157157676491,60.899706380625844,NaN,NaN,122.98726271875181,93.7018740055548,0.026789648307760178,0.2502957142048814,0.22350606589712121,128122752,122742093.8,66.28413397604328,64.65690095853053,NaN,NaN,22.70584284123514,20.312848874110973
2012-07-18T09:30:00-04:00,37.37,37.56,37.25,37.52,5439508,6048836.3,68.3749449657957,61.65645462910151,NaN,NaN,129.9556538615772,111.41648898709543,0.037013758045121276,0.2697732634535228,0.23275950540840154,133562260,126414703.4,69.38261127481039,65.54816670870177,NaN,NaN,24.735254294683187,20.94462107704986
2012-07-19T09:30:00-04:00,37.61,37.66,37.28999,37.59,5405664,5949635.9,69.51054701916124,62.32467377778841,NaN,NaN,126.91598262637547,125.67960167706738,0.043826922081820985,0.28754315801067776,0.24371623592885677,138967924,130114934,72.15875159032818,66.44151183496277,NaN,NaN,26.76588721618545,21.7762305254978
2012-07-20T09:30:00-04:00,37.50999,37.78,37.42999,37.67,9016453,5920959.35,70.80099232394309,62.83138309029634,NaN,NaN,135.38611778094275,127.92171934330804,0.04868330033480761,0.30457036134736626,0.25588706101255865,147984377,134205701.2,74.87144909437343,67.28252383846389,NaN,NaN,28.85745980555608,22.78783470836327
2012-07-23T09:30:00-04:00,37.55,37.67,37.3,37.42,4515598,5973979.05,61.9736183224331,62.46096765286701,NaN,NaN,94.6923576829109,121.98747493411163,0.03088783564607478,0.29449685557015215,0.26360901992407737,143468779,138421218.4,77.32344899155731,67.87628553723454,NaN,NaN,28.172989878464904,23.55714258980636
2012-07-24T09:30:00-04:00,37.37,37.4099,36.903,37.09,10023457,6208905.4,52.64334668037889,61.60899818797483,NaN,NaN,19.138758559927957,101.21777410234685,-0.005348310425621672,0.25692363189205025,0.2622719423176719,133445322,139485732.4,77.90964241809984,68.24534143224456,NaN,NaN,24.530159712588162,23.696145035918047
2012-07-25T09:30:00-04:00,37.16,37.28,36.9045,37.07001,3573844,6188520.7,52.13134673235377,61.1453189126356,NaN,NaN,-2.2106078047014517,74.78452176909113,-0.03144685583689927,0.22296337252154785,0.2544102283584471,129871478,138747576,76.43416301104835,68.40016968197057,NaN,NaN,21.477723198136,23.37922763052061
2012-07-26T09:30:00-04:00,37.3,37.71001,37.3,37.64999,6126824,6233627.9,63.28771317639094,61.6243166850251,NaN,NaN,114.14410870664089,72.23014698514422,-0.011462863169744486,0.24008164939626653,0.251544512566011,135998302,138153651.6,75.20012659832746,68.44719491350482,NaN,NaN,22.37919569823128,23.236365925907847
2012-07-27T09:30:00-04:00,37.71001,38.19,37.71001,38.09,5244789,6284328.1,69.16014633901433,62.73796573212481,NaN,NaN,198.45100621864003,84.84312467268367,0.027450745459557113,0.2858579443904574,0.2584071989309003,141243091,136805394.4,72.3446845428393,68.67097653560889,NaN,NaN,25.38572230038596,23.54341683654758
2012-07-30T09:30:00-04:00,37.95,38.34,37.89,38.23,6785141,6242582.2,70.76263528503921,63.87365101164422,NaN,NaN,195.88355181301404,105.08136349870429,0.05698065185673895,0.32963301375182397,0.272652361895085,148028232,137717285,73.0889704020745,69.46970798789741,NaN,NaN,28.29277853412906,24.221897079059218
2012-07-31T09:30:00-04:00,38.36,38.36,37.91,37.92,4192223,5872763.85,62.96120700204658,64.17221337061726,NaN,NaN,149.1856429884705,131.09074038441278,0.050233209848629445,0.33544387420587185,0.2852106643572424,143836009,139795422.4,74.75633206840878,70.70651487064352,NaN,NaN,27.892169341318578,24.746221687953412
2012-08-01T09:30:00-04:00,38,38.53999,37.63,37.63,15694809,6519371.35,56.66725684294275,63.95054607990155,NaN,NaN,108.17729422847259,153.16832079104762,0.022263402358761564,0.31303991730569436,0.2907765149469328,128141200,139449366.8,73.93483706669764,71.90090108238044,NaN,NaN,25.285749184409095,24.82329704458994
2012-08-02T09:30:00-04:00,37.53,37.66,37.09,37.42,7947570,6474164.5,52.569115749336454,63.01724647103895,NaN,NaN,3.209868434695842,130.9814727366586,-0.012487278834975135,0.27516741640321385,0.287654695238189,120193630,136288432.4,66.72238728585054,72.39110370927595,NaN,NaN,21.749164034659895,24.384135186028505
2012-08-03T09:30:00-04:00,37.64999,37.89,37.60001,37.86,6819340,6541586.2,59.22316875021169,62.60340076898664,NaN,NaN,72.79774403621961,105.85082030017452,-0.00815644965212553,0.27745913317303206,0.2856155828251576,127012970,133442408.2,60.9565564535987,72.24057819814699,NaN,NaN,21.13527408670175,23.92001217183897
2012-08-06T09:30:00-04:00,38.02,38.06,37.72,37.77,6325328,6422778,57.447861932797416,61.96527865156039,NaN,NaN,78.23262899000314,82.32063573557234,-0.013361887746758838,0.26891322314170907,0.2822751108884679,120687642,127974290.2,51.71056342029747,71.19960887273659,NaN,NaN,20.053958746743817,23.367718825396803
2012-08-07T09:30:00-04:00,37.8,37.89,37.37,37.38,9218738,6682231.2,50.39769735388683,60.68118953642404,NaN,NaN,6.708669734156547,53.825241084709546,-0.04338644045650242,0.2280420603178399,0.27142850077434233,111468904,121500869.2,43.33114366215321,69.33878975754679,NaN,NaN,16.638784417592106,22.406442481424705
2012-08-08T09:30:00-04:00,37.39,37.45,37.2,37.42999,4914660,6722309.1,51.2239918369553,59.37500702340933,NaN,NaN,-45.460597809849745,23.097662677045072,-0.059215176337483744,0.19740953035248765,0.2566247066899714,116383564,119149342,40.7480377456905,67.09516734007266,NaN,NaN,14.27623323235295,21.244984017271598
2012-08-09T09:30:00-04:00,37.38,37.50999,37.34,37.42999,4546703,6686266.3,51.2239918369553,57.97664984576735,NaN,NaN,-36.72404031292569,15.110880927520757,-0.06837176240760706,0.17116000368046258,0.23953176608806964,116383564,118387328.8,39.917606416044144,64.59846429162057,NaN,NaN,12.432130425352469,19.986004932711722
2012-08-10T09:30:00-04:00,37.42999,37.60001,37.2975,37.53999,6133957,6639775.65,53.21300247710073,57.35089157110075,NaN,NaN,-26.379428586100847,-4.724553596943336,-0.06569059476831202,0.15741852262767964,0.22310911739599165,122517521,117488239,38.910016753806744,61.854647703209814,NaN,NaN,11.496047667072876,18.773153894763315
2012-08-13T09:30:00-04:00,37.46001,37.53999,37.37,37.5,3798470,6572731.75,52.37679665380422,57.331852283488274,NaN,NaN,-31.850175386627477,-26.74111447226946,-0.06515259292012776,0.14166837624583195,0.2068209691659597,118719051,117094520.8,38.4522876809398,59.036265221984095,NaN,NaN,10.493042400462276,17.59028082414888
2012-08-14T09:30:00-04:00,37.57001,37.62,37.36,37.46001,6661926,6619250.1,51.50516915216657,57.2871253134749,NaN,NaN,-31.269010489666165,-34.336650517034,-0.06583759287738591,0.12452397806922733,0.19036157094661324,112057125,117212165,38.684394454594,56.339853182237356,NaN,NaN,9.422082748404428,16.423395384756816
2012-08-15T09:30:00-04:00,37.42,37.44901,37.28,37.28,5521836,6623366.5,47.66032368085014,56.170883206650565,NaN,NaN,-70.3245169815495,-39.30943435137395,-0.07603892993915864,0.09531290852266494,0.17135183846182359,106535289,115242510,36.2214954575071,53.555665243607336,NaN,NaN,7.404959667055574,15.13504742508521
2012-08-16T09:30:00-04:00,37.35001,37.3765,37.14999,37.19,7882035,6747185.05,45.81869794151478,54.50363689254345,NaN,NaN,-90.55341760231465,-50.07530980925175,-0.08575261576761445,0.06416106875230554,0.14991368451992,98653254,111696448,32.24162801687987,50.69116120603881,NaN,NaN,5.182140917704484,13.713203638316536
2012-08-17T09:30:00-04:00,37.32001,37.32001,37.02,37.09,6404016,6616563.2,43.79381758308012,52.57729277097494,NaN,NaN,-105.8635884642272,-65.97214178487702,-0.09509417286903701,0.031045968433623727,0.12614014130266074,92249238,105642791.4,26.82324515018979,47.38646654518989,NaN,NaN,2.7201504738811573,12.142767471968625
2012-08-20T09:30:00-04:00,37.05,37.16,36.95,37.16,5328121,6657189.35,45.60595328842663,51.33763179143067,NaN,NaN,-108.59458572464924,-81.32102385248137,-0.09264704532969656,0.010331334640540035,0.1029783799702366,97577359,101414453,23.812990080823084,43.74765640321949,NaN,NaN,1.1043323128724376,10.565848163526313
2012-08-21T09:30:00-04:00,37.14999,37.22,36.89,36.89,8072797,6559656.35,40.21960056459802,50.162799200120325,NaN,NaN,-126.80701265688306,-100.42862428592476,-0.10442612545273115,-0.02755427684567735,0.0768718486070538,89504562,96903940.4,21.09353332313512,39.97327756439359,NaN,NaN,-1.924864049209344,8.781460704564077
2012-08-22T09:30:00-04:00,36.85001,36.97,36.75999,36.83,5606945,6661311.4,39.11405099757617,49.201723146423156,NaN,NaN,-154.5709715132772,-117.27791519227029,-0.11086472042218685,-0.06170905192067977,0.049155668501507085,83897617,92376406,18.775687158039787,36.548513269549964,NaN,NaN,-4.77091881815248,6.845406487033141
2012-08-23T09:30:00-04:00,36.83,36.84,36.41,36.45,7974383,6753689.35,32.938672425755314,47.3242591232477,NaN,NaN,-187.146993182891,-136.59663030838556,-0.13378745027038244,-0.11807864433647097,0.01570880593391147,75923234,87830402,16.781693395213154,33.39316590823672,NaN,NaN,-9.367080810924573,4.529336873039181
2012-08-24T09:30:00-04:00,36.35001,36.66499,36.35001,36.62,3276903,6655295.05,37.67906954679958,45.91220252424785,NaN,NaN,-167.97403056255672,-149.01871872805145,-0.13043582537185314,-0.14733597578090496,-0.016900150409051816,79200137,85220581.8,15.747716127699192,30.824391101622552,NaN,NaN,-11.828067631066187,2.1925648010241288
2012-08-27T09:30:00-04:00,36.60001,36.75999,36.57001,36.7,4070256,6519550.8,39.834413007459794,45.15768221378878,NaN,NaN,-125.26831370725876,-152.35346432457337,-0.1162379417655062,-0.16219757761593456,-0.045959635850428365,83270393,82359188.6,14.679777449421422,28.777864943570286,NaN,NaN,-13.217184310207458,-0.008827929151812075
2012-08-28T09:30:00-04:00,36.66,36.71001,36.52,36.63,3174088,6468644.05,38.57720804385848,44.254340514281864,NaN,NaN,-120.70489242545763,-151.13304027828826,-0.10529382963843673,-0.17757692289847427,-0.07228309326003754,80096305,80477537.2,14.007075747764233,26.86779622943269,NaN,NaN,-14.731043976394803,-2.112001650186525
2012-08-29T09:30:00-04:00,36.60001,36.64,36.48,36.57001,5388676,5953337.4,37.48532908170896,43.2730074603357,NaN,NaN,-116.39217398967367,-143.49728077356755,-0.09608402612921838,-0.19238812592156052,-0.09630409979234214,74707629,78639539.6,13.362914350981725,24.971032510499665,NaN,NaN,-16.301073352815287,-4.139011893419205
2012-08-30T09:30:00-04:00,36.50999,36.50999,36.33,36.39,2085523,5660235.05,34.34410868819671,41.92522933255684,NaN,NaN,-125.81088988573683,-131.23006011413673,-0.0958844478610098,-0.2161596596186044,-0.12027521175759459,72622106,77979314,13.129341550767165,23.129555710282553,NaN,NaN,-18.586524800902676,-6.202942308773986
2012-08-31T09:30:00-04:00,36.5,36.52,36.24001,36.35001,6148285,5626682.3,33.66910201002878,40.58896542943002,NaN,NaN,-117.76812836789132,-121.18887967520365,-0.09218847709955141,-0.23551080813203384,-0.14332233103248243,66473821,75434050.8,12.241032369680184,21.257323188049718,NaN,NaN,-20.673311829470002,-8.270137954587703
2012-09-04T09:30:00-04:00,36.28999,36.53999,36.24001,36.485,12968742,5958853,38.09229036161738,39.630902658676504,NaN,NaN,-98.13219792626163,-115.76165651900422,-0.07511785315237796,-0.23721964747295488,-0.16210179432057692,79442563,74668484.8,11.97851454822785,19.34976033759499,NaN,NaN,-21.256588946904508,-10.125345239204389
2012-09-05T09:30:00-04:00,36.48,36.53,36.31,36.33,3536698,5674751,35.19053861422678,38.74020372534626,NaN,NaN,-93.24820268712567,-110.27031857133781,-0.06889440156204518,-0.2482197962731334,-0.17932539471108822,75905865,73830396.8,11.683127446490943,17.59701976537955,NaN,NaN,-22.58833788259208,-11.905772759688345
2012-09-06T09:30:00-04:00,36.38,36.75,36.38,36.74001,5533172,5705676.6,46.74677717881526,38.80649509943915,NaN,NaN,-47.219120173278995,-96.43570780805888,-0.03358134856577308,-0.22130208041830457,-0.1877207318525315,81439037,75176678.4,15.296565025605602,16.386658123145676,NaN,NaN,-20.14814295177855,-13.083254215701231
2012-09-07T09:30:00-04:00,36.75,36.8,36.56,36.62,5114719,5734077.4,44.25913084268187,38.83973176083928,NaN,NaN,-35.91460164049927,-78.45645015901137,-0.015634765048058052,-0.20726418816260406,-0.191629423114546,76324318,75917120.8,17.300663031518354,15.70647368609772,NaN,NaN,-18.901567184436647,-13.914441782663433
2012-09-10T09:30:00-04:00,36.63,36.72,36.58,36.58,3711433,5612951.2,43.42956721325632,38.684275612612815,NaN,NaN,-37.25732566728821,-62.35428961889075,-0.0043722516442207815,-0.197094737669822,-0.19272248602560121,72612885,77144933.6,20.65319507157068,15.480774042579693,NaN,NaN,-18.13872341761294,-14.51791058765622
2012-09-11T09:30:00-04:00,36.56,36.61,36.46001,36.49001,3380242,5592039.8,41.54303598890323,38.77880671434891,NaN,NaN,-55.487468175415216,-53.82534366872146,-0.00106986322717878,-0.1940598150595747,-0.19298995183239592,69232643,75102949.6,19.255145485116103,15.349460625578335,NaN,NaN,-18.045438733486733,-15.021843179917722
2012-09-12T09:30:00-04:00,36.53999,36.53999,36.24001,36.28,3836922,5450789.6,37.45411734618233,38.660240024963635,NaN,NaN,-94.09069403225382,-53.99384193774709,-0.01058680117306987,-0.20622345329873326,-0.1956366521256634,65395721,73000920.8,17.911057879740312,15.287701391414087,NaN,NaN,-19.18959575764215,-15.617236405306926
2012-09-13T09:30:00-04:00,36.25,36.82001,36.25,36.78999,8450383,5597216.95,50.25795696227302,39.89733177757205,NaN,NaN,-14.762631631940858,-47.502544229479476,0.01833309649157347,-0.17272028151119656,-0.19105337800277003,73846104,71482334.2,16.98844404898756,15.302469295255117,NaN,NaN,-15.866848087373484,-15.65289521703072
2012-09-14T09:30:00-04:00,36.75999,36.83,36.44,36.53999,9104066,5658318.5,45.356307779675134,40.44570593706315,NaN,NaN,-12.094387118102771,-42.73850132500017,0.02128585808811706,-0.1644460553926237,-0.18573191348074075,64742038,69165878.2,15.663052203481357,15.2964218720967,NaN,NaN,-14.777749387680863,-15.527874384266454
2012-09-17T09:30:00-04:00,36.48,36.63,36.255,36.31,5183422,5597288.8,41.35989406593963,40.554668869811714,NaN,NaN,-92.76970928338834,-53.8409780482202,0.009036609898820075,-0.17443615110721566,-0.18347276100603574,59558616,66555024.4,14.308123191437062,15.269875139383531,NaN,NaN,-15.25195844892113,-15.488457822074265
2012-09-18T09:30:00-04:00,36.34,36.34,36.12,36.2,10369887,5849377.1,39.564313893891494,40.625176430528356,NaN,NaN,-165.1650561344825,-75.77649564003366,-0.004461952461765395,-0.18905020158324248,-0.1845882491214771,49188729,62546241.6,12.51761470830614,15.163485065136527,NaN,NaN,-16.222441443910903,-15.593312625193784
2012-09-19T09:30:00-04:00,36.17,36.36,36.14,36.24001,12557051,6073589.8,40.574860030757144,40.84585721260323,NaN,NaN,-136.74540347296747,-84.3074375281764,-0.008452486355905287,-0.19515385706635868,-0.1867013707104534,61745780,61816253.4,12.2177853197948,15.081690134337464,NaN,NaN,-16.675079926191632,-15.74785081105062
2012-09-20T09:30:00-04:00,36.22,36.44,36.2,36.39,4761363,6031310.7,44.332724337378146,41.55932975897333,NaN,NaN,-77.83682999638634,-96.92227720106548,0.0007635497652086765,-0.18574693350394256,-0.18651048326915123,66507143,60348461.2,11.615339564706915,14.97354713533316,NaN,NaN,-15.893123394911143,-15.76860403731641
2012-09-21T09:30:00-04:00,36.13,36.13,35.91,36.02499,7589313,6012057.2,38.030049369498364,41.870825998935445,NaN,NaN,-203.4694292004627,-135.1972856175375,-0.015093748874598023,-0.20537766936239876,-0.19028392048780074,58917830,59183619.6,11.145642809699922,14.895305023905996,NaN,NaN,-17.254757023600533,-15.98091160678557
2012-09-24T09:30:00-04:00,35.97,36.42999,35.97,36.37,8215188,6258971.45,45.86427462564426,42.42596773208022,NaN,NaN,-85.38338763111963,-133.72002128708374,-0.0004890428230509281,-0.1908952240166144,-0.19040618119356348,67133018,60698500,15.908150721955778,15.175993322029418,NaN,NaN,-15.75211630608552,-15.94822656382842
2012-09-25T09:30:00-04:00,36.44,36.55,36.28,36.28999,6727828,6391850.05,44.4605340607306,43.088110263973356,NaN,NaN,-28.383302399584327,-106.3636705401041,0.005320385949327211,-0.18375569875690445,-0.18907608470623166,60405190,62941792.2,22.53004815895666,15.950773372919826,NaN,NaN,-15.019986965327394,-15.815620906899703
2012-09-26T09:30:00-04:00,36.35001,36.66,36.28999,36.37,6329520,6549621.65,46.232742851774624,43.051393526327594,NaN,NaN,8.864305949770882,-77.24172865555643,0.015512541788401057,-0.16968540747073035,-0.1851979492591314,66734710,63939578.2,25.34595406962356,16.668586876063966,NaN,NaN,-13.877212178070659,-15.53870537420984
2012-09-27T09:30:00-04:00,36.42,36.45,36.17,36.22501,7002051,6630290.4,43.52251600060933,42.998778180465266,NaN,NaN,-68.23704190785793,-75.32177103785075,0.0135230858149534,-0.16829409199043965,-0.18181717780539305,59732659,62584681.4,24.066705356282128,17.151875613547094,NaN,NaN,-13.750033662342833,-15.283180843943125
2012-09-28T09:30:00-04:00,36.2,36.44501,36.03999,36.39,7965910,6924309.75,47.30786588999504,43.275799514518035,NaN,NaN,-57.56494055029552,-46.14087330781731,0.023754099706190496,-0.15212455317265494,-0.17587865287884544,67698569,64340829.2,29.064189349744666,17.75266091913095,NaN,NaN,-12.483684805989403,-14.883252838521164
2012-10-01T09:30:00-04:00,36.42999,36.59,36.21001,36.22,7193734,6976582.2,44.033060183639556,43.45365838557063,NaN,NaN,-31.522944508770873,-35.36878468334756,0.019675921104165384,-0.1512837514986387,-0.1709596726028041,60504835,63015192.6,27.58817607717816,18.347877389992526,NaN,NaN,-12.404865805673403,-14.529197548114341
2012-10-02T09:30:00-04:00,36.32001,36.47501,36.23,36.41,6198535,6638071.85,48.3375029526741,44.23104307174861,NaN,NaN,-14.060983817526827,-32.50432096693607,0.02977231629382021,-0.13374427723552884,-0.16351659352934905,66703370,64274828.6,31.165384155802172,19.2946149811398,NaN,NaN,-11.014501693785752,-14.027098140353115
2012-10-03T09:30:00-04:00,36.49001,36.67999,36.44501,36.59,4703316,6696402.75,52.09637340154599,44.36235853169668,NaN,NaN,77.87548882644327,-18.702084391601574,0.04751775624028859,-0.1041193982289883,-0.1516371544692769,71406686,65209223.8,33.77876214402818,20.493923416499847,NaN,NaN,-8.672330820659766,-13.262131380396921
2012-10-04T09:30:00-04:00,36.66,36.955,36.66,36.8,6686516,6754069.95,56.108662794970144,45.130383889932034,NaN,NaN,171.34342731776889,29.21400945352379,0.07093345130496648,-0.06297034033806881,-0.13390379164303529,78093202,68881332.4,42.94622796697029,22.442721685320482,NaN,NaN,-5.407986327637296,-12.140110658574118
2012-10-05T09:30:00-04:00,36.89,36.95,36.67999,36.74001,4594242,6728046.1,54.69921434794439,46.08319248150381,NaN,NaN,153.88661391028657,71.50432034564021,0.07928386026073864,-0.03479896631711199,-0.11408282657785063,73498960,70041410.6,45.512514831869495,24.671606802494228,NaN,NaN,-3.170523320199836,-10.858741038806363
2012-10-08T09:30:00-04:00,36.67999,36.86,36.59,36.8,5426770,6813812.95,55.8924250529234,47.24948613572037,NaN,NaN,128.49595490104528,103.50810022760342,0.08523003686051514,-0.007545280502206708,-0.09277531736272185,78925730,73725589.6,52.77711179051002,27.54728516550879,NaN,NaN,-0.9788141751582163,-9.447322915428057
2012-10-09T09:30:00-04:00,36.73,36.88,36.64999,36.73,5488570,6919229.35,54.10171089327098,48.21568976875706,NaN,NaN,115.3179819916973,129.38389338944825,0.08086766418039659,0.008309262862773892,-0.0725584013176227,73437160,75072347.6,55.13207574150292,30.612591624202228,NaN,NaN,0.3595405062172435,-8.046342426621585
2012-10-10T09:30:00-04:00,36.73,36.83501,36.57001,36.67,3819766,6918371.55,52.54766225136571,48.80247104832761,NaN,NaN,81.0896655653876,130.02672873723714,0.07072663817945761,0.015849896406699315,-0.054876741772758295,69617394,74714489.2,54.356384979981115,33.665523439578955,NaN,NaN,1.063422468003006,-6.744947441675215
2012-10-11T09:30:00-04:00,36.74001,36.92,36.63,36.71001,5926297,6792167.25,53.5067222079882,49.90794767964831,NaN,NaN,96.20081613447586,114.99820650057852,0.06371647781183419,0.024768855492034447,-0.03894762231979974,75543691,74204587,53.20765295082757,36.66995273537379,NaN,NaN,1.9114034421329549,-5.508325886845477
2012-10-12T09:30:00-04:00,36.8,36.84,36.41499,36.5,4181223,6546025.1,48.02052793132597,50.061965772911286,NaN,NaN,40.53252044390263,92.32738780730173,0.04293525250929821,0.014721443316823013,-0.02821380919247519,71362468,73777288.6,52.21186597165908,39.26307525320974,NaN,NaN,1.1509144784763496,-4.557005834656644
2012-10-15T09:30:00-04:00,36.5,36.67999,36.31,36.64999,4843086,6529008.3,51.82010857139009,50.58764966652983,NaN,NaN,24.977042027250345,71.62360523254273,0.03748847751410508,0.018646787700156153,-0.018841689813948924,76205554,73233253.4,50.90558033708439,41.289898980218865,NaN,NaN,1.5560947639202145,-3.683705749145665
2012-10-16T09:30:00-04:00,36.71001,36.88,36.64999,36.78999,8356672,6428347.55,55.11792970944824,51.22230587064937,NaN,NaN,90.1297727982176,66.58596339384681,0.04121558555456965,0.03267779212926314,-0.00853779342530651,84562226,75458266.6,55.77853466277525,43.463654736872556,NaN,NaN,2.8514729774338083,-2.7501087882057402
2012-10-17T09:30:00-04:00,36.88,37.28999,36.8,37.24139,9853953,6293192.65,63.73672404690853,52.66617787395645,NaN,NaN,175.07021430317954,85.38207314140519,0.07027620644818325,0.07930746463492255,0.009031258186739305,94416179,80418023.6,64.2877563237362,46.336586948833556,NaN,NaN,6.920651680481672,-1.3685715783932528
2012-10-18T09:30:00-04:00,37.25,37.42,37.14999,37.41,5445039,6327376.45,66.33707487036611,54.025407086840104,NaN,NaN,201.7561215033808,106.49313421518619,0.09548480579789961,0.12838726543411383,0.032902459636214215,99861218,85281529,70.31902363688067,49.283360826486124,NaN,NaN,11.157815597542362,0.4209123038832634
2012-10-19T09:30:00-04:00,37.37,37.44,37.05,37.11,7839023,6339861.95,58.323422155172096,55.04614722766386,NaN,NaN,149.63349311833431,128.31332875007251,0.08683433160821126,0.1414453741464783,0.05461104253826703,92022195,89413474.4,74.29147395163076,52.61931067466132,NaN,NaN,12.171194866281922,2.099524098511643
2012-10-22T09:30:00-04:00,37.07001,37.08099,36.83,37.00999,4743973,6166301.2,55.89912385432579,55.586263006353256,NaN,NaN,80.5699731327621,139.43191497117488,0.06998009981492329,0.14208616730692114,0.07210606749199786,87278222,91628008,76.13501905042892,55.831427452848935,NaN,NaN,12.200951016866254,3.5425850868480158
2012-10-23T09:30:00-04:00,36.75,36.851,36.53011,36.67,6892055,6174512.55,48.51606947096281,55.33052701131161,NaN,NaN,-5.496553779878389,120.30664965555566,0.03339297660383214,0.11384728824678803,0.08045431164295588,80386167,90792796.2,73.98029490924176,58.70296550750705,NaN,NaN,9.71305534134702,4.424080837490731
2012-10-24T09:30:00-04:00,36.64,36.73,36.375,36.39999,5776367,6146854.9,43.59187694983414,54.436470879516186,NaN,NaN,-62.05198960789101,72.88220887334157,-0.009254532436639429,0.0688861460971566,0.07814067853379603,74609800,86831520.4,64.63678395495906,60.252290935220536,NaN,NaN,5.911622840862729,4.636586837972445
2012-10-25T09:30:00-04:00,36.50999,36.61,36.3,36.58,5650539,6079279.3,47.4231692379361,53.916753371658444,NaN,NaN,-70.31503267766008,18.46797803713338,-0.02472460298757566,0.04723492479932645,0.07195952778690211,80260339,82911344.6,56.968721213407875,61.07059139104471,NaN,NaN,4.089187402577808,4.558386918630354
2012-10-26T09:30:00-04:00,36.57001,36.67999,36.42,36.58,7486051,6055286.35,47.4231692379361,53.311806527730774,NaN,NaN,-58.0477931287599,-23.06827921228546,-0.033780880238726,0.029733427488494613,0.06351430772722061,80260339,80558973.4,52.912260905866596,61.080244899284466,NaN,NaN,2.674725297257126,4.289292401291321
2012-10-31T09:30:00-04:00,36.78999,37.05,36.62,36.8952,11070063,6249102.8,53.79612598593662,53.28997903434975,NaN,NaN,37.18675162912478,-31.744923513012925,-0.01815004999253591,0.04082674523655072,0.05897679522908663,91330402,81369409.4,54.12423036814821,61.00825594404484,NaN,NaN,3.4888430406921453,4.174942492634296
2012-11-01T09:30:00-04:00,37.05,37.09,36.47,36.50999,8434930,6360922.55,46.39476519003879,52.850486387112106,NaN,NaN,-32.35161401482982,-37.11593556000322,-0.032522375265211526,0.01832382614757222,0.050846201412783745,82895472,81871270.4,54.898380832979285,61.04696993354471,NaN,NaN,1.6717273771751944,3.8173403332829956
2012-11-02T09:30:00-04:00,36.5,36.7,36.23,36.25999,4297516,6340632.55,42.324868971883525,52.051782584533214,NaN,NaN,-140.26990621676003,-52.759518881777026,-0.056243764722843904,-0.019458504490771134,0.03678526023207277,78597956,82668901.6,56.16449083662864,61.25817263967336,NaN,NaN,-1.231139921290692,3.0961288683438974
2012-11-05T09:30:00-05:00,36.19,36.19,35.62,35.67,8286023,6420607.9,34.608885433237035,51.093808120384,NaN,NaN,-274.44550297555526,-93.58561294135606,-0.10615062866165233,-0.09590302559499264,0.01024760306665969,70311933,80679220.4,52.225980789230256,61.25918084092844,NaN,NaN,-6.751013230035956,1.6893942828610613
2012-11-06T09:30:00-05:00,35.71001,35.87,35.5701,35.69,8265508,6604171.2,35.041203780169894,49.89531492101113,NaN,NaN,-238.7480282387802,-129.7256599633601,-0.13068376492654488,-0.15310710309152142,-0.022423338164976537,78577441,80342640.8,51.56721238185322,61.306440272697635,NaN,NaN,-10.740623462962452,-0.08632253797086897
2012-11-07T09:30:00-05:00,35.49001,35.58,34.7355,34.94,12003086,6932987,27.656969478031158,47.93381776162419,NaN,NaN,-285.239043963198,-194.2108190818247,-0.18686881911884845,-0.2560093620635371,-0.06914054294468865,66574355,75391431.4,42.978870170674426,60.39217852326187,NaN,NaN,-17.29781010287379,-2.5451064758141433
2012-11-08T09:30:00-05:00,34.97,35.36,34.87,34.882,9673715,7142244.25,27.179960356627305,45.32262035517554,NaN,NaN,-220.37621446051583,-231.81573917096188,-0.21535963368607908,-0.3383400850522875,-0.12298045136620843,56900640,70192465,36.167366790755956,58.38357927090614,NaN,NaN,-22.365646262287246,-5.376612159596014
2012-11-09T09:30:00-05:00,34.8,34.92999,34.63,34.67,9679652,7435238.55,25.45198962699736,42.40225712350634,NaN,NaN,-197.72766675044662,-243.3072912776992,-0.23433577186441004,-0.415900166196721,-0.18156439433231095,47220988,63917071.4,29.98917786035983,55.502876001154654,NaN,NaN,-27.0265209791037,-8.469456276668542
2012-11-12T09:30:00-05:00,34.61,34.69,34.28999,34.38,7119883,7494917.85,23.272396221074942,39.89861241392797,NaN,NaN,-178.58413315085394,-224.13501731275892,-0.25079721384465303,-0.49506091163812727,-0.2442636977934742,40101105,57874905.8,25.476623026372337,52.01610093506476,NaN,NaN,-31.62548710345377,-11.777460680495002
2012-11-13T09:30:00-05:00,34.25999,34.72,34.25,34.50999,12456492,7908681.3,26.318258476872586,37.78569345839559,NaN,NaN,-142.42504177118445,-204.8704200192398,-0.2374451587676536,-0.5410701462530412,-0.3036249874853876,52557597,52670937,22.356394264566774,48.17477059321747,NaN,NaN,-34.29963451806755,-14.994914085862508
2012-11-14T09:30:00-05:00,34.55,34.57001,34.17999,34.265,10372695,8185161.75,24.35586839634732,36.05996481020877,NaN,NaN,-130.42223704438285,-173.90705863547674,-0.22949568014025007,-0.5904945876607002,-0.3609989075204501,42184902,47793046.4,19.896566154361253,44.31164711072601,NaN,NaN,-37.16111517094138,-18.161514240873775
2012-11-15T09:30:00-05:00,34.25999,34.47,33.845,34.07001,15302887,8532472.5,22.892764719163594,34.5814567937323,NaN,NaN,-125.69078145164411,-154.9699720337024,-0.22163520630356587,-0.6380429153999074,-0.41640770909634156,26882015,41789321.4,17.36417609313213,40.93503226345265,NaN,NaN,-39.985712933233934,-21.27925691121094
2012-11-16T09:30:00-05:00,34.10001,34.42,33.92,34.36,12337469,8656648.3,29.660254971028905,33.31267720323893,NaN,NaN,-105.05292349944946,-136.43502338350297,-0.18278713590708445,-0.6448916289801971,-0.4621044930731127,39219484,40189020.6,16.752124712202757,38.062418227652294,NaN,NaN,-40.22150736461373,-23.98529269026848
2012-11-19T09:30:00-05:00,34.47,34.59,34.19099,34.39,16536910,9211241.85,30.34138535919756,32.092549783329034,NaN,NaN,-84.51991330046046,-117.62217941342426,-0.1427284659191972,-0.6405150754721092,-0.497786609552912,55756394,43320078.4,22.507424391028167,35.89064419087812,NaN,NaN,-40.20274899874784,-26.302072162908388
2012-11-20T09:30:00-05:00,34.42999,34.4599,34.0405,34.33,11329613,9385771.35,29.721495119570733,30.372933292874333,NaN,NaN,-83.14415200463357,-105.7660014601141,-0.10942923993396136,-0.6345731594703636,-0.5251439195364023,44426781,41693915.2,21.669506371826827,33.57244961971231,NaN,NaN,-40.363803205590635,-28.310890883291567
2012-11-21T09:30:00-05:00,34.36,34.39,33.85001,34.17999,14939215,9895533.45,28.1717953758439,29.071292591860413,NaN,NaN,-84.58616876937161,-96.59878780511185,-0.08760711949506272,-0.6346528189052307,-0.547045699410168,29487566,39154448,20.392731591798622,31.1077603881994,NaN,NaN,-40.93853002212116,-30.114839331695794
2012-11-23T09:30:00-05:00,34.17999,34.28,33.89999,34.09,3720049,9736933.15,27.25375459468175,27.994784422060288,NaN,NaN,-81.53647654916168,-87.76792682461536,-0.07009256754811433,-0.6346614088453109,-0.5645688412971965,25767517,38931548.4,20.279783226335425,28.54456698746417,NaN,NaN,-41.674631782797995,-31.766238253281823
2012-11-26T09:30:00-05:00,34.00999,34.67999,34.00999,34.52,16183914,10257310.5,37.7007036565726,28.21562858086997,NaN,NaN,-54.63502445811135,-77.68434701634773,-0.022851755686672193,-0.5931335359055367,-0.5702817802188646,41951431,39477937.8,21.428589390308147,26.34475331611259,NaN,NaN,-39.18529671798752,-32.82610374823978
2012-11-27T09:30:00-05:00,34.49001,34.81,34.49001,34.61,13662820,10657924.55,39.6540783438874,28.54511962113551,NaN,NaN,-32.45010005807766,-67.27038436787117,0.018898536651938524,-0.5466586094039414,-0.5655571460558799,55614251,39449509.2,21.41130081404326,24.190759632697592,NaN,NaN,-36.55592109603704,-33.3589347979251
2012-11-28T09:30:00-05:00,34.5,34.8,34.37,34.75,10529039,10810073.95,42.665612552365054,29.617165555016502,NaN,NaN,-27.071964599702955,-56.055946886885046,0.058166668012273326,-0.49284881104053824,-0.5510154790528116,66143290,43792811,30.62095237501606,23.308051218721996,NaN,NaN,-33.45072995871308,-33.372048392323386
2012-11-29T09:30:00-05:00,34.78,34.99001,34.67999,34.95,9566184,10734880,46.75366308348588,31.01528717836354,NaN,NaN,5.047351010264014,-38.129242930957915,0.09751701485220987,-0.4291192104875492,-0.5266362253397591,75709474,53037192.6,45.31106445735092,23.961172480621634,NaN,NaN,-29.557139017133526,-32.82706133872483
2012-11-30T09:30:00-05:00,35.03999,35.35001,34.94,35.32001,29063152,11766291.1,53.37690112333815,33.009923713816455,NaN,NaN,61.65964861564933,-9.490017897995713,0.14548346258038825,-0.34478189711427376,-0.490265359694662,104772626,68838214.4,60.64843157893047,26.15111917480525,NaN,NaN,-23.96090521876243,-31.560467607301632
2012-12-03T09:30:00-05:00,35.35001,35.38,34.92999,35.10001,12503910,12176610.8,49.439172994027096,34.87897919759875,NaN,NaN,72.66062648143415,15.969112289913392,0.15835118890444272,-0.2923263735641086,-0.45067756246855134,92268716,78901671.4,66.99670165131948,29.116839076587187,NaN,NaN,-20.411857519764713,-29.967809023367785
2012-12-04T09:30:00-05:00,35.13,35.19,34.88,34.92,5553234,12039971.35,46.42151305376914,36.31492595309137,NaN,NaN,64.4301367209686,35.345159645722646,0.15073632313621121,-0.26225715854828735,-0.41299348168449856,86715482,85121917.6,70.19705274351895,32.53402896794091,NaN,NaN,-18.349716130032608,-28.308081467177047
2012-12-05T09:30:00-05:00,35.05,35.64,34.85001,35.45,18669008,12560146.35,55.10947157809061,38.51161189464445,NaN,NaN,135.47977179537313,67.85550692473787,0.17565017022074858,-0.1934307689085628,-0.3690809391293114,105384490,92970157.6,73.66676795231173,36.37475766779452,NaN,NaN,-13.537077502973752,-26.197938043719432
2012-12-06T09:30:00-05:00,35.32001,35.6601,35.32001,35.42999,6488656,12284424.85,54.748514521588575,40.78702259481768,NaN,NaN,152.94411196254566,97.4348591151942,0.1841456637584996,-0.13889885943118685,-0.32304452318968646,98895834,97607429.6,75.48302175078481,40.526103786198284,NaN,NaN,-9.887060761519294,-23.867812717690843
2012-12-07T09:30:00-05:00,35.44,35.59,35.33479,35.455,7417020,12171590.1,55.14397344194207,42.607288199882895,NaN,NaN,137.37592003018437,112.57811339810121,0.18435846956863305,-0.09259643622889513,-0.2769549057975282,106312854,97915475.2,75.60339745571389,44.729766125020504,NaN,NaN,-6.842813788073297,-21.435670013459763
2012-12-10T09:30:00-05:00,35.38,35.51109,35.35001,35.47,4361305,11905672.75,55.395745235843094,44.396885333929006,NaN,NaN,115.74712034068287,121.19541216995094,0.1783096864823596,-0.0540677976945787,-0.2323774841769383,110674159,101596563.8,77.05329771264768,48.625899933707615,NaN,NaN,-4.291329204179973,-18.986478469276935
2012-12-11T09:30:00-05:00,35.48,35.7,35.42999,35.55,6449617,11872159.45,56.788793233890395,46.33026377066612,NaN,NaN,115.62576998010465,131.43453882177815,0.17239509229178945,-0.016883618812201462,-0.18927871110399092,117123776,107678222.6,79.24765078413448,52.738624534586734,NaN,NaN,-1.752454861592444,-16.524475096750578
2012-12-12T09:30:00-05:00,35.55,35.77991,35.46001,35.49001,10142316,11756450.65,55.39175442131507,48.27454655962835,NaN,NaN,104.01313400906774,125.14121126451707,0.15754789985714646,0.007656163717442155,-0.1498917361397043,106981460,107997616.6,79.35928577273154,56.95052126179623,NaN,NaN,0.025693770365239232,-14.160165258591176
2012-12-13T09:30:00-05:00,35.44,35.4899,35.22,35.35001,8360070,11655819.4,52.166448178411024,50.05402467275187,NaN,NaN,66.83643518319485,107.91967590864692,0.13241510744305476,0.015627148164114146,-0.11678795927894062,98621390,107942727.8,79.28035609608179,61.164847895349546,NaN,NaN,0.7181682655714452,-12.034689040853658
2012-12-14T09:30:00-05:00,35.37,35.37,35.16,35.21001,6292063,11205278.2,49.08830673953926,50.86742489296377,NaN,NaN,46.86063528584767,89.81661895977957,0.10185120192066066,0.010526043121885209,-0.09132515879877545,92329327,105146022.4,75.17757313631921,65.00406102006461,NaN,NaN,0.48595255023395173,-10.246025956412572
2012-12-17T09:30:00-05:00,35.3,35.75999,35.3,35.75,8594973,11018153.4,59.11029047642866,52.25715433100243,NaN,NaN,91.26297150445751,84.9197891925345,0.11264862407989051,0.04948562130108769,-0.06316300277880282,100924300,103196050.6,72.36559847954275,68.64365371045744,NaN,NaN,3.3599177306154777,-8.302319715408565
2012-12-18T09:30:00-05:00,35.69,36.07001,35.67999,36,10110484,10696832.1,62.76479785424867,53.692810423994125,NaN,NaN,126.45320513277908,87.08527622306939,0.13004127308516508,0.09938858857765354,-0.030652684507511553,111034784,101978252.2,70.58978754047104,71.49857050798994,NaN,NaN,6.986071702193662,-6.118263798608247
2012-12-19T09:30:00-05:00,35.99001,36.02,35.71001,35.73,6807242,10470713.55,56.854762163665065,54.41431750114979,NaN,NaN,106.34205157851152,87.55105973695814,0.11717435555473486,0.11581525993590702,-0.0013590956188278373,104227542,101427468.6,69.75603600543779,73.24463990428185,NaN,NaN,8.193143339500923,-4.073777064592651
2012-12-20T09:30:00-05:00,35.74001,35.89,35.61,35.84061,9677953,10207650.45,58.57562115612477,54.785654646348824,NaN,NaN,96.44577484771112,93.4729276698614,0.1100384099908556,0.13618891686974166,0.02615050687888606,113905495,104484289.6,71.75029851949576,74.03763040003652,NaN,NaN,9.708313288667627,-2.104907014126897
2012-12-21T09:30:00-05:00,35.22,35.44,35.07001,35.31,8669090,10455102.5,48.5680477058795,54.723431411481144,NaN,NaN,-2.537548118199127,83.59329098905205,0.06569664249826615,0.10827131000171875,0.042574667503452596,105236405,107065705.2,73.34852203684387,74.49133185614541,NaN,NaN,7.6798914700955345,-0.7070786592379781
2012-12-24T09:30:00-05:00,35.25,35.33,35,35.16,5865766,9939195.1,46.16677264137115,54.70523566773842,NaN,NaN,-38.790678188147496,57.58256105053103,0.024499360428898623,0.07319886803957587,0.04869950761067725,99370639,106754973,72.81450566426257,74.67829277905567,NaN,NaN,5.249882064020604,0.14391572979896217
2012-12-26T09:30:00-05:00,35.21001,35.3,34.83,34.86,5800621,9546085.15,41.72365058923552,53.749105597105924,NaN,NaN,-89.40609292641595,14.41070143869202,-0.022195878065422767,0.020954660028898786,0.04315053809432155,93570018,103262019.8,66.91671930967176,74.19614644743852,NaN,NaN,1.6922185890993233,0.36510185255615657
2012-12-27T09:30:00-05:00,34.78999,34.925,34.42999,34.8,17723984,9905832.4,40.87633469453794,52.75823560945945,NaN,NaN,-165.13325418353227,-39.88435971371674,-0.0545224593595817,-0.02500253610515557,0.02951992325442613,75846034,97585718.2,58.60881558411112,72.99084600696183,NaN,NaN,-1.3932083742721018,0.11391467729497684
2012-12-28T09:30:00-05:00,34.67,34.89,34.44,34.45,8510152,9853030.8,36.251553851710305,51.408777067300036,NaN,NaN,-184.18150729308888,-96.00981614187675,-0.0945312866727248,-0.08864418508647987,0.00588710158624493,67335882,88271795.6,48.06420745039682,71.02376100658203,NaN,NaN,-5.615517400027262,-0.7045756194653429
2012-12-31T09:30:00-05:00,34.39,34.97,34.22,34.9205,16312410,9215493.7,45.2235550044629,50.682192050772876,NaN,NaN,-137.24372425575226,-122.95105136938737,-0.08468001903508354,-0.0999629222076095,-0.015282903172525956,83648292,83954173,44.10295997659566,68.67016545400689,NaN,NaN,-6.287759490508107,-1.5021733153285948
2013-01-02T09:30:00-05:00,35.36,35.63,35.295,35.56,12795535,9230074.95,54.58038556214628,50.5244486456483,NaN,NaN,39.09444239237926,-107.37402725328202,-0.033115641483294794,-0.05667745502664445,-0.023561813543349658,96443827,83368810.6,43.57857762293882,66.12237451392149,NaN,NaN,-3.419084323588152,-1.7760177450799601
2013-01-03T09:30:00-05:00,35.56,35.69,35.45911,35.56,8141449,9359485.7,54.58038556214628,50.46649372713624,NaN,NaN,51.369133969375326,-79.21898187412378,0.001154696602245521,-0.02211844279054276,-0.02327313939278828,96443827,83943572.4,44.2791385466636,63.61664971205949,NaN,NaN,-1.2756589186757032,-1.7045379127364948
2013-01-04T09:30:00-05:00,35.56,35.77,35.53999,35.74001,6179273,8734998.95,56.97942078852576,50.81027748500158,NaN,NaN,71.17200866886277,-31.957929303644768,0.034274143916760896,0.01956954050316284,-0.014704603413598055,102623100,89298985.6,50.45239497909036,61.557509632274396,NaN,NaN,1.244294646954832,-1.2832761184948769
2013-01-07T09:30:00-05:00,35.63,35.72,35.31,35.39,8370066,8829069.45,51.3050018837558,50.96861285244562,NaN,NaN,23.216956866741295,9.52176352832127,0.031033303153367185,0.024087025528110928,-0.006946277625256258,94253034,94682416,55.758514166518935,60.17043399157438,NaN,NaN,1.5067443819302995,-0.8847017612912803
2013-01-08T09:30:00-05:00,35.33,35.38,35.14,35.28,6426523,8779544.6,49.632128095183496,50.291601253785245,NaN,NaN,-21.572870935152103,32.6559341924413,0.020418574784232407,0.018576940855034252,-0.0018416339291981556,87826511,95518059.8,56.53659524545583,59.039790903425306,NaN,NaN,1.1849514482151804,-0.5890370170760717
2013-01-09T09:30:00-05:00,35.34,35.35989,35.09,35.21001,7580313,8940495,48.54745729555915,49.276076928164564,NaN,NaN,-29.296335929455605,18.977778528074328,0.008245284788030757,0.008464972055840292,0.00021968726780953376,80246198,92278534,52.669380478349545,57.75976182755949,NaN,NaN,0.597385077431914,-0.4195481464320737
2013-01-10T09:30:00-05:00,35.28,35.38,35.21001,35.36,6301445,8933086.4,51.01794690370568,48.85916155245318,NaN,NaN,-5.041743797142703,7.695602974770722,0.009753079550073618,0.012411036705401557,0.0026579571553279383,86547643,90299297.2,50.401035535042126,56.377261793959796,NaN,NaN,0.8355770163141105,-0.24024455175404744
2013-01-11T09:30:00-05:00,35.31,35.46001,35.285,35.39999,8110469,8831494.05,51.68404855177697,48.36690636642833,NaN,NaN,12.64854052465703,-4.009090654070427,0.01271469983791504,0.01855133195272174,0.0058366321148066985,94658112,88706299.6,48.58729299719331,54.72276139950962,NaN,NaN,1.2186204649121268,-0.0318352636588797
2013-01-14T09:30:00-05:00,35.35001,35.45,35.28999,35.33,5643914,8695686.25,50.39241891380725,48.49721859556603,NaN,NaN,6.627811630103051,-7.326919701398076,0.009384650731192658,0.01756744552879752,0.008182794797604863,89014198,87658532.4,47.379585406251266,52.86783735446729,NaN,NaN,1.1845549463161194,0.14193476633754873
2013-01-15T09:30:00-05:00,35.28999,35.45,35.2,35.42999,6248270,8693496.6,52.22916680709992,48.93024675026094,NaN,NaN,6.139237589619293,-1.7844979964437968,0.013112008793052878,0.02457280578892096,0.011460796995868081,95262468,89145723.8,49.305712182801855,51.18863782007725,NaN,NaN,1.6513875352284162,0.3575708761791012
2013-01-16T09:30:00-05:00,35.34,35.4191,35.23,35.25999,4720527,8499774.3,48.913239775402694,49.44378883498717,NaN,NaN,-4.175436404240269,3.2396819085992705,0.003807402700267845,0.016220050371202888,0.012412647670935043,90541941,91204872.4,51.92942001749581,50.118116442064675,NaN,NaN,1.1534241959324023,0.4712642075724299
2013-01-17T09:30:00-05:00,35.38,35.52991,35.295,35.39999,5531973,8270848.75,51.63640647437187,50.212365390689584,NaN,NaN,31.47072711274514,10.54217609057684,0.006597174715523069,0.02065911606533888,0.01406194134981581,96073914,93110126.6,54.2868949818701,49.80940782761889,NaN,NaN,1.4647011313476057,0.6131837681117407
2013-01-18T09:30:00-05:00,35.48,35.71001,35.39,35.67999,6666637,8263818.5,56.6171957265923,51.66705409603829,NaN,NaN,88.94423566075187,25.80131511779581,0.02574066080176176,0.04623776735201801,0.02049710655025625,102740551,94726614.4,56.24743379671795,50.393923995213264,NaN,NaN,3.174886916364466,0.9791413607192728
2013-01-22T09:30:00-05:00,35.62,36.02901,35.60001,35.98,6674723,8113657,61.22499781908198,52.81001429708251,NaN,NaN,164.29168681352866,57.33409015448093,0.05534912815008052,0.0896835167378569,0.034334388587776384,109415274,98806829.6,60.8156127157797,51.58768490515498,NaN,NaN,6.092227398328264,1.709582223234843
2013-01-23T09:30:00-05:00,35.85001,35.98,35.72009,35.89,6173551,7988880.05,59.193837724221865,53.139546594373634,NaN,NaN,141.8019065475799,84.46662394607306,0.06494903930446591,0.11552068771835877,0.05057164841389286,103241723,100402680.6,62.46626396226388,52.93680535796392,NaN,NaN,7.924371789248383,2.59740930409392
2013-01-24T09:30:00-05:00,35.96001,36.16,35.92,36.05,6339508,8012567.15,61.63086052789188,53.64315194906975,NaN,NaN,164.0854676711439,118.11880476114989,0.07731111581682064,0.14721054318491866,0.06989942736809802,109581231,104210538.6,66.13233295199217,54.497747815487386,NaN,NaN,10.202299046899551,3.6838221244947245
2013-01-25T09:30:00-05:00,36.09,36.255,35.89999,36.23,8031449,8124108.55,64.2197550461618,54.160318681758035,NaN,NaN,159.9616936899816,143.81699807659717,0.09185656919035642,0.18472013885604355,0.09286356966568712,117612680,108518291.8,69.73388924669067,55.87499740603026,NaN,NaN,12.92551592266119,5.004064095661363
2013-01-28T09:30:00-05:00,36.25,36.3,36.00999,36.21001,7708074,7623313.05,63.705669547196,55.04608065771805,NaN,NaN,151.40662390335427,156.30947572511766,0.09403576989162825,0.21040828203022244,0.11637251213859419,109904606,109951102.8,70.84446630596297,56.95256541599054,NaN,NaN,15.014648512020576,6.434147583712679
2013-01-29T09:30:00-05:00,36.12,36.5,36.12,36.46001,8711820,7633396.45,67.23790960351603,56.303636479741805,NaN,NaN,168.78035331409296,157.2072090252305,0.10536561020339452,0.24807952489283736,0.14271391468944283,118616426,111791333.2,72.25271869142911,58.0751456621315,NaN,NaN,17.912570754476647,8.073922322393246
2013-01-30T09:30:00-05:00,36.41,36.57001,36.38,36.49001,8199723,7227762.1,67.64484071417976,57.66773529535756,NaN,NaN,166.04309352479356,162.05544642067326,0.10755692961604532,0.2771600767094995,0.16960314709345417,126816149,116506218.4,75.5158074795418,59.70703330507381,NaN,NaN,20.416110206826602,9.83709202016944
2013-01-31T09:30:00-05:00,36.33009,36.66,36.33009,36.58,6832211,6929595.9,68.89298642509814,58.94452383259988,NaN,NaN,145.3066224506917,158.2996773765828,0.10748880624040005,0.30396415489395423,0.19647534865355418,133648360,121319644.2,78.31901531566238,61.70117471797524,NaN,NaN,22.89570239266104,11.702607787668239
2013-02-01T09:30:00-05:00,36.7,36.81,36.64,36.67999,7112766,6878161.75,70.2655384801994,60.27177311320147,NaN,NaN,149.3672230842261,156.1807832554317,0.10640126694366023,0.32947693233312947,0.22307566538946924,140761126,125949333.4,80.61759429860281,63.98905338236164,NaN,NaN,25.40491218378612,13.660079844256508
2013-02-04T09:30:00-05:00,36.62,36.62,36.42,36.42999,6295230,6883959.6,62.8040376044493,61.15831730539019,NaN,NaN,100.26963909424025,145.9533862936089,0.082153733934277,0.32576783280731547,0.24361409887303848,134465896,130861591.4,82.71190703142409,66.51279064130256,NaN,NaN,25.55991600828439,15.360056439117633
2013-02-05T09:30:00-05:00,36.60001,36.73,36.52,36.53,6412063,6786059.45,64.43123665917885,62.02989372339583,NaN,NaN,103.33772120095904,132.86485987098212,0.06681063683214472,0.3271273949132194,0.2603167580810747,140877959,135313898,84.36129636352318,69.0167609399255,NaN,NaN,26.14532214714319,16.900808683121284
2013-02-06T09:30:00-05:00,36.49001,36.64999,36.295,36.64,7499285,6839697.55,66.18353109313483,63.263485960376684,NaN,NaN,84.52459364442896,116.56115989490918,0.05833824165824247,0.3332395601538778,0.2749013184956353,148377244,139626117,85.77668987400958,71.43442307253363,NaN,NaN,27.133674627659875,18.362646675198224
2013-02-07T09:30:00-05:00,36.67999,36.91,36.545,36.69,8043625,6862863.15,66.9798362725149,64.35944523167262,NaN,NaN,101.39077173468748,107.7779897517083,0.050654381817908045,0.33821929576802034,0.2875649139501123,156420869,144180618.8,87.10423228653146,73.77851859429515,NaN,NaN,28.1801885517743,19.765152657566237
2013-02-08T09:30:00-05:00,36.73,36.73,36.50999,36.69,4843047,6789943.25,66.9798362725149,65.09963384209566,NaN,NaN,83.89314343952562,94.68317382276821,0.04056122650462257,0.3382664470808905,0.2977052205762679,156420869,147312567.4,87.93796481793385,76.04212795295344,NaN,NaN,29.05110345522791,21.09171705723219
2013-02-11T09:30:00-05:00,36.71001,36.815,36.64,36.78,4822938,6625566.7,68.52698309760873,65.62120421913329,NaN,NaN,91.5546126604687,92.94016853601389,0.03513821384806953,0.34162798788635484,0.3064897740382853,161243807,152668149.6,89.22125399290981,78.0711023298913,NaN,NaN,30.214342494447934,22.394949262548725
2013-02-12T09:30:00-05:00,36.75999,36.96001,36.72,36.94,5205746,6603658.3,71.1178438729076,66.47291894403942,NaN,NaN,102.70876703325939,92.81437770247398,0.037313788787751656,0.3531320100229749,0.31581822123522324,166449553,157782468.4,90.28428183258828,80.05810360634302,NaN,NaN,31.959621399024122,23.761330996330923
2013-02-13T09:30:00-05:00,36.98,37.09,36.84,36.94,4741984,6528344,71.1178438729076,67.15056061154054,NaN,NaN,108.9527506788894,97.70000910936605,0.033842092107081334,0.3581208363690749,0.32427874426199355,166449553,161396930.2,90.9626392022171,81.83169690993053,NaN,NaN,33.41628004891547,25.14060943241443
2013-02-14T09:30:00-05:00,36.78,36.89999,36.53,36.64,10253750,6805005.15,60.31998673552516,66.87200573220936,NaN,NaN,60.79583270042101,89.58102130251277,0.0077903549385456294,0.3340166879351756,0.32622633299662995,156195803,161351917,90.87754085251039,83.34195773891766,NaN,NaN,31.71439522579829,26.079721688612125
2013-02-15T09:30:00-05:00,36.71001,36.78,36.64,36.72,5242465,6790529.75,61.977851367631175,66.74859014795473,NaN,NaN,61.69860095319604,85.14211280524685,-0.0068154825928988805,0.3177069797555063,0.3245224623484052,161438268,162355396.8,91.07793132850287,84.78720524052764,NaN,NaN,30.729899634748858,26.744032823774514
2013-02-19T09:30:00-05:00,36.67999,37.10001,36.67999,37.03999,9466930,6930544.4,67.77711420879078,66.78710476261722,NaN,NaN,111.97234298299561,89.22565886975224,0.001849545165725608,0.32683439380556223,0.3249848486398366,170905198,164287675,91.46664572801562,86.15962860028382,NaN,NaN,31.57431138587579,27.43407261836041
2013-02-20T09:30:00-05:00,37.06,37.28,36.96001,36.97,8172832,7005449.85,65.4265379350172,66.62865456410562,NaN,NaN,137.2253043849445,96.12896634008926,-0.0002457626399748336,0.3246776453398681,0.3249234079798429,162732366,163544237.6,89.84477099570704,87.18312599429564,NaN,NaN,31.562724842610873,28.02388007896762
2013-02-21T09:30:00-05:00,36.88,37.02,36.78,36.81,9037883,7148666.45,60.27980333432376,66.01342720047887,NaN,NaN,78.40188445309128,90.01879309492963,-0.01471926859499395,0.3065243222361005,0.32124359083109444,153694483,160993223.6,84.31971355392268,87.6117472970285,NaN,NaN,29.983600007684856,28.303840068784368
2013-02-22T09:30:00-05:00,36.94,37.19501,36.85001,37.17999,6091434,7136262.75,66.78633216686745,65.76491246381231,NaN,NaN,133.3457460778372,104.52877577041292,-0.0023361924087163533,0.318323350320199,0.32065954272891534,159785917,161711246.4,84.60665097095055,87.89667991648193,NaN,NaN,30.652173196688658,28.63931622991355
2013-02-25T09:30:00-05:00,37.28,37.569,36.81,36.85001,9812488,7225314.7,57.7070925562161,65.40084496036708,NaN,NaN,126.64397598162803,117.51785077609932,-0.018434197637864858,0.2976167956815843,0.31605099331944914,149973429,159418278.6,79.59735998222236,87.67421227011037,NaN,NaN,28.06316458831124,28.55700885254179
2013-02-26T09:30:00-05:00,36.89,37.16,36.7901,36.96001,9669328,7323377.4,59.67509221088683,65.06112035691764,NaN,NaN,80.08229341518553,111.13984086253731,-0.023419197901391853,0.28677699594270933,0.3101961938441012,159642757,157165790.4,74.90560499832907,86.99880574402508,NaN,NaN,26.652686723772455,28.28496283414617
2013-02-27T09:30:00-05:00,37,37.41,36.98,37.3,6007605,7188166.65,65.08325082948392,64.98252890951402,NaN,NaN,151.99325012362604,114.0934300102736,-0.006446658405356298,0.30213787083740584,0.30858452924276214,165650362,157749389.6,75.31164209318098,86.25130233110875,NaN,NaN,27.30269317411713,28.144638596999165
2013-02-28T09:30:00-05:00,37.35001,37.58,37.24001,37.42999,8977535,7227057.25,66.9104878502643,64.97757545078183,NaN,NaN,185.85529911973651,135.58411294360263,0.010011696894380251,0.32109915036073744,0.3110874534663572,174627897,161936072.4,78.05489977700366,85.60492143757105,NaN,NaN,28.43749072403249,28.186474615146782
2013-03-01T09:30:00-05:00,37.28999,37.52,37.12,37.5,5718477,7171370.55,67.88525389565136,65.04224813814872,NaN,NaN,153.28297054336454,139.5715578367081,0.021434395162168107,0.3378804474190673,0.3164460522568992,180346374,166048163.8,80.36286808752506,85.0638430996847,NaN,NaN,29.65148253908641,28.39576146142387
2013-03-04T09:30:00-05:00,37.44,37.92999,37.39999,37.88,7642367,7197850.6,72.60287652379088,65.33338338287601,NaN,NaN,214.04266822719728,157.05129628582196,0.04883602872544163,0.37749108816370125,0.3286550594382596,187988741,173651226.2,83.7630827073039,84.67397372214144,NaN,NaN,32.35226489848232,28.960976238146504
2013-03-05T09:30:00-05:00,37.96001,38.175,37.92,38.08,5813984,7173788.3,74.70869542333476,65.5898727793351,NaN,NaN,237.56586096020402,188.54800979482565,0.07321802378290443,0.4201775891668902,0.34695956538398576,193802725,180483219.8,86.09329778200907,84.37461771852863,NaN,NaN,35.28776964402894,29.86480386755828
2013-03-06T09:30:00-05:00,38.14999,38.19,37.95,38.06,5417586,7124064.45,74.09536882455224,65.802553133024,NaN,NaN,194.12171472635202,196.97370271537085,0.08022245872822759,0.44723763879427025,0.36701518006604267,188385139,185030175.2,87.39033897137816,84.11945341632585,NaN,NaN,37.384832050034184,30.939093607911982
2013-03-07T09:30:00-05:00,38.06,38.16,37.88,37.89,8003031,7149251.75,68.91636071102614,66.41657984555978,NaN,NaN,145.3935012168442,188.8813431347924,0.06621229881700236,0.44978055358729563,0.38356825477029327,180382108,186181017.4,87.70295422847475,83.89269722889472,NaN,NaN,37.52718089566679,31.880248934734098
2013-03-08T09:30:00-05:00,38,38.03999,37.69,37.97,11438324,7318986.7,69.97975780205061,66.98814459087546,NaN,NaN,113.15591813588436,180.85593265329638,0.055568538435331716,0.4530289278144579,0.3974603893791262,191820432,188475829,88.32453406800319,83.69602599600191,NaN,NaN,37.96272009397318,32.74917338605397
2013-03-11T09:30:00-04:00,37.99001,38.12,37.89999,38.06,3261248,7239896.75,71.17450913783574,67.23081565723582,NaN,NaN,115.69502689431009,161.18640438671892,0.04810426026669512,0.45759071471249513,0.4094864544458,195081680,189894416.8,88.70462766128699,83.49873899123557,NaN,NaN,38.67467175983253,33.59567315373662
2013-03-12T09:30:00-04:00,38.14,38.14,37.83,37.96001,5027828,7250141.25,67.93943664683087,67.41030842236536,NaN,NaN,95.20922177792472,132.71507655026306,0.030789752459763065,0.44797364502050385,0.4171838925607408,190053852,189144642.2,87.09083414881339,83.30202921645746,NaN,NaN,38.3358495937793,34.27284121659986
2013-03-13T09:30:00-04:00,37.86,38.14999,37.86,38.13,4639891,7221848.5,70.40245011237855,68.13335462079786,NaN,NaN,93.96055871672407,112.6828453483375,0.02536828345981995,0.4488942468855157,0.42352596342569576,194693743,190406363,87.50286466572051,83.52939715301444,NaN,NaN,38.758284644511214,34.913618849158624
2013-03-14T09:30:00-04:00,38.09,38.23,38.03999,38.20799,7328609,7351179.75,71.4848110744714,68.46896025705527,NaN,NaN,97.36448251000087,103.07704160696883,0.02175629862047157,0.4507213367012852,0.42896503808081365,202022352,194734411.8,88.8209666778028,83.8304197035039,NaN,NaN,39.42052190709938,35.55746214315016
2013-03-15T09:30:00-04:00,37.88,38.16,37.75999,38.13,13152656,7496125.05,68.77624458933775,69.25961397370682,NaN,NaN,69.59159775631095,94.36417753105414,0.009463943403572206,0.4407949673352789,0.4313310239317067,188869696,194144264.6,87.46630079036565,84.39248690408556,NaN,NaN,39.21719397814283,36.080280976720545
2013-03-18T09:30:00-04:00,37.92,38.09,37.86,37.92,5023063,7485154.95,61.96767350796875,69.42336978064125,NaN,NaN,55.06466967837628,82.23810608786735,-0.01607085426857835,0.41124245609598375,0.4273133103645621,183846633,191897255.2,82.31825862187543,84.9219621629103,NaN,NaN,37.037534030747,36.21703141301004
2013-03-19T09:30:00-04:00,37.94,38.14999,37.825,38.02,7788695,7401243.2,63.805181793066815,69.3320791351829,NaN,NaN,56.37444155448605,74.47115004317962,-0.02874707752356026,0.39137946346011177,0.420126540983672,191635328,192213550.4,82.4746241701019,85.43360373983322,NaN,NaN,35.71549323180768,36.145383101409706
2013-03-20T09:30:00-04:00,38.19,38.36,38.07001,38.3,6426660,7313934.6,68.40774493367363,69.43902606971211,NaN,NaN,90.28739390087253,73.73651708000934,-0.021146586984558402,0.393693307252974,0.4148398942375324,198061988,192887199.4,82.82303230618498,85.77418463477476,NaN,NaN,35.91227398196891,36.11208179863245
2013-03-21T09:30:00-04:00,38.19,38.28,38.06,38.11,6005105,7162295.7,62.59142303756826,69.06089529413474,NaN,NaN,71.26267055880115,68.51615468976938,-0.03118157998303117,0.3758629192587435,0.40704449924177466,192056883,190894105.6,77.88927949761809,85.59749973549569,NaN,NaN,34.2694333292984,35.8488463030133
2013-03-22T09:30:00-04:00,38.2,38.28,38.07001,38.17,2331745,6974311.25,63.642699926943294,68.4208826800742,NaN,NaN,72.91218291260077,69.18027172102737,-0.035718616409096626,0.3623962287304039,0.3981148451395005,194388628,191997892,78.64787345405652,85.23212764597801,NaN,NaN,33.24089808213016,35.476282271458565
2013-03-25T09:30:00-04:00,38.39999,38.4279,37.92999,38.09,6638977,6815635.7,61.174175253779374,67.45413123939167,NaN,NaN,66.72511708257449,71.512361201867,-0.04542486420468583,0.3413337648836432,0.38675862908832903,187749651,192778495.6,79.19159369107138,84.7391487823396,NaN,NaN,31.660907930188852,34.93122879413432
2013-03-26T09:30:00-04:00,38.14999,38.48,38.14999,38.45,5881883,6626263.45,67.31747464250637,66.96999594067411,NaN,NaN,130.295752054427,86.29662330185518,-0.029678951460376357,0.3496599397628586,0.37933889122323494,193631534,193177736.8,79.47940888414541,84.17408234753727,NaN,NaN,32.134971663463524,34.53176348975278
2013-03-27T09:30:00-04:00,38.31,38.64999,38.28,38.63,5406629,6596214.65,69.88338693802386,67.03906924260251,NaN,NaN,188.58345636998882,105.95583579567844,-0.010225079498252743,0.366557541850419,0.37678262134867174,199038163,193372971.8,79.62780404840977,83.59728590610405,NaN,NaN,33.357123239221295,34.36395773967685
2013-03-28T09:30:00-04:00,38.64999,39.14,38.63,39.10001,7197172,6507196.5,75.32987778803174,67.42122067017259,NaN,NaN,292.2348530967233,150.15027230326285,0.029064131060490328,0.4131127851742846,0.3840486541137943,206235335,196208662.2,81.69801198029872,83.12396289983944,NaN,NaN,36.41903457917019,34.657540145318755
2013-04-01T09:30:00-04:00,39.10001,39.1013,38.91,39.00999,4254820,6434013.65,72.62099966450094,67.52454142207725,NaN,NaN,250.49406727157876,185.66664917505847,0.04292009293583582,0.43769877028358906,0.39477867734775324,201980515,197727039.6,82.71110420337737,82.69585408141732,NaN,NaN,37.919328648182116,35.12350993144209
2013-04-02T09:30:00-04:00,39.14999,39.28,39.03999,39.14,8030281,6453409.35,74.0711970042891,67.96252430475283,NaN,NaN,218.41354858688243,216.00433547592007,0.05405261183909593,0.4623444421466232,0.40829183030752725,210010796,202179268.6,85.28349952035975,82.56675875081349,NaN,NaN,39.60966003980748,35.76438851835143
2013-04-03T09:30:00-04:00,39.2,39.3,38.97,39.03,5663570,6445888.65,70.66092181034742,67.98098656889347,NaN,NaN,161.47183005189652,222.23955107541397,0.047454470083805655,0.46760991791228435,0.4201554478284787,204347226,204322407,86.33731351896492,82.48350509747381,NaN,NaN,39.91626437974193,36.357513641407216
2013-04-04T09:30:00-04:00,39.12,39.42999,39.10001,39.39999,5271727,6438595.7,74.85447995797134,68.22167720342918,NaN,NaN,162.8146641685195,217.0857926351201,0.06061266134091092,0.4959212745046173,0.4353086131637064,209618953,206438565,87.3040480686102,82.37515376824578,NaN,NaN,41.59398828334241,37.10558144739796
2013-04-05T09:30:00-04:00,39.22,39.63,39.12,39.57001,7452891,6411088.7,76.51563345213259,68.7744906936288,NaN,NaN,150.58624911385988,188.7560718385474,0.07256419850833079,0.5260138612991199,0.4534496627907891,217071844,208605866.8,88.22313544674961,82.4292133865589,NaN,NaN,43.51767160256139,38.021594326707024
2013-04-08T09:30:00-04:00,39.62,39.89999,39.41,39.87,5843152,6131330.1,79.13480015222011,70.00071402536106,NaN,NaN,159.4916112758399,170.5555806393996,0.09126190222157737,0.5675270405677608,0.47626513834618345,222914996,212792763,89.76466260849799,82.96109938560338,NaN,NaN,46.05684306504211,39.16948700361203
2013-04-09T09:30:00-04:00,39.92999,39.98,39.72501,39.75,7403176,6338426.5,75.50710120310247,70.83656541179218,NaN,NaN,143.29547251043903,155.53196542411095,0.08619702294331166,0.584011417025323,0.49781439408201134,215511820,213892967.8,90.13025200392396,83.5079299451621,NaN,NaN,46.91965296736477,40.276653569862425
2013-04-10T09:30:00-04:00,39.85001,40.17,39.84,40.07001,4832945,6328682.35,78.3565288279887,71.54719283281467,NaN,NaN,143.3266572237948,151.9029308584906,0.09438767615004773,0.615798989269571,0.5214113131195233,220344765,217092475.6,91.12323224236324,84.10080136917483,NaN,NaN,48.620568521687865,41.468641420123205
2013-04-11T09:30:00-04:00,40.16,40.25999,40.06,40.16,7591965,6476286.05,79.09311270076789,72.72588495161465,NaN,NaN,137.60204176028296,146.8604063768433,0.09556280510257587,0.6408648194977431,0.5453020143951672,227936730,220756031,92.10295546464712,85.11606393824833,NaN,NaN,50.212886332753904,42.71781926478474
2013-04-12T09:30:00-04:00,40.08,40.33,40,40.33,5336859,6376698.55,80.44689950683369,73.92618492160682,NaN,NaN,127.94475479571669,142.33210751321465,0.09716738148321302,0.6667612412491835,0.5695938597659704,233273589,223996380,92.85418713961795,86.13080063007415,NaN,NaN,51.965549717672054,44.03892361519721
2013-04-15T09:30:00-04:00,40.17,40.39,39.75,39.75,10644574,6251294.45,64.98572094418566,74.19843818520727,NaN,NaN,93.67436269002768,129.1686577960522,0.0508723006661137,0.6331842355986126,0.5823119349324989,222629015,223939183.8,92.68658241983151,87.09472839641414,NaN,NaN,48.143988648160196,44.62536147704907
2013-04-16T09:30:00-04:00,39.92999,40.23,39.61,40.23,5570445,6278663.55,70.10621754462312,74.39763410678704,NaN,NaN,90.85499555297284,118.68056240455897,0.04451228270656271,0.6379522883157023,0.5934400056091396,228199460,226476711.8,93.26722293551778,88.07957225722646,NaN,NaN,46.717179051140896,44.924192559062185
2013-04-17T09:30:00-04:00,40.03999,40.14,39.73,40,8892797,6333868.65,65.18696691664893,74.06217553383169,NaN,NaN,76.24346400898864,105.26392376159774,0.018104197319524618,0.6160702522585453,0.5979660549390207,219306663,226269091.4,92.61928671110789,89.00753530456204,NaN,NaN,43.819820590777994,44.766425135021585
2013-04-18T09:30:00-04:00,40.03,40.23,39.94,40.13,6276262,6326348.75,66.61296979858318,73.43953924887107,NaN,NaN,83.28646063564513,94.40080753667019,0.003447822984390725,0.6022758336695091,0.5988280106851184,225582925,225798330.4,91.07433692042379,89.67727280028525,NaN,NaN,42.03322071339722,44.37596736050382
2013-04-19T09:30:00-04:00,40.14999,40.74001,40.14999,40.73,11669531,6609570.05,72.26062088442247,73.4137979074369,NaN,NaN,119.03361145834033,92.61857886919492,0.026911948537564956,0.6324679463570746,0.6055559978195096,237252456,226594103.8,91.33738525872943,90.29343573281041,NaN,NaN,42.49356678102757,44.10705299200721
2013-04-22T09:30:00-04:00,40.77,40.855,40.455,40.67999,7001344,6843050,71.1798407153399,73.20727245822626,NaN,NaN,121.784592547262,98.24062484064177,0.03149577923723956,0.6449257218660591,0.6134299426288196,230251112,228118523.2,91.83387559253427,90.76131973796574,NaN,NaN,42.47709408190257,43.87420171913512
2013-04-23T09:30:00-04:00,40.74001,40.8,40.46001,40.78,11785980,7100400.15,72.07920314945729,73.30857826816268,NaN,NaN,117.39833377812235,103.54929248567169,0.033507655589238405,0.6553145121153676,0.6218068565261292,242037092,230886049.6,92.6567304826907,91.21270666394615,NaN,NaN,42.75307398739056,43.71404061460019
2013-04-24T09:30:00-04:00,40.78,41.07001,40.58,40.91,10552980,7333955,73.24784580480846,73.19381868579389,NaN,NaN,131.77198559455758,114.65499680278545,0.03563953591320668,0.6663562764176376,0.6307167405044309,252590072,237542731.4,94.17667850983052,91.70360883831904,NaN,NaN,43.34107071882756,43.660759200918385
2013-04-25T09:30:00-04:00,41.02,41.09,40.77,40.92,9954141,7561330.6,73.34028385521995,72.96700800030014,NaN,NaN,134.38362979378246,124.87443063441292,0.029995526342993406,0.6682111484331728,0.6382156220901793,262544213,244934989,95.3321519311227,92.21139573005996,NaN,NaN,43.83735014352982,43.6859864784343
2013-04-26T09:30:00-04:00,40.8,41.16,40.8,40.98,5943086,7498626.3,73.9225126701078,72.59470175157783,NaN,NaN,130.7507592391925,127.21786019058337,0.02289612525796636,0.6668357786626373,0.643939653404671,268487299,251181957.6,96.04613504254768,92.66007233249209,NaN,NaN,44.41154250762428,43.78963733974716
2013-04-29T09:30:00-04:00,41.13,41.38499,40.92999,41.32001,5835902,7577680.4,76.98935899251316,72.70057730796431,NaN,NaN,143.94361128098166,131.6496639373273,0.033074074447859925,0.6852822464644959,0.652208172016636,274323201,259996375.4,96.7917971023946,93.13589698238286,NaN,NaN,45.84739303895128,44.08360243963346
2013-04-30T09:30:00-04:00,41.28,41.44,41.19,41.42999,7818211,7567076.9,77.89493473625191,72.66760630141168,NaN,NaN,141.46442058906177,136.4628812995152,0.038792227443530836,0.7006984563210494,0.6619062288775186,282141412,268017239.4,97.2922283842268,93.57653956394454,NaN,NaN,47.30970331724009,44.54447399357726
2013-05-01T09:30:00-04:00,41.37,41.42,40.96001,41.02,10367355,7802266.15,67.26713785392826,71.82289381235171,NaN,NaN,100.78966662353388,130.26641750531047,0.008143625567977097,0.6720857608374899,0.6639421352695128,271774057,271854036.4,97.49362880178346,93.96158765945428,NaN,NaN,45.34601659224656,44.65898007910145
2013-05-02T09:30:00-04:00,40.98,41.11,40.74001,40.97,8834391,7980399.35,66.08299213170812,70.79690042841416,NaN,NaN,68.26941999547992,117.04357554564994,-0.020737143537256086,0.6380207058479428,0.6587578493851989,262939666,271933127,97.49776039884631,94.29327146368487,NaN,NaN,43.40800814356559,44.480269802596325
2013-05-03T09:30:00-04:00,41.17,41.25,40.82001,40.89,14986891,8357099.35,64.13754601590928,70.73631650496586,NaN,NaN,68.27478357138236,104.54838041208791,-0.04886315744066305,0.5976789025843701,0.6465420600250331,247952775,267826222.2,89.26876977488152,94.0491419890456,NaN,NaN,41.24143019769954,44.01757843046821
2013-05-06T09:30:00-04:00,40.84,40.87,40.31,40.32001,14739559,8801919.7,52.31929248054878,69.46582185753198,NaN,NaN,-8.207548165748685,74.11814852274185,-0.10620034135497392,0.5137916333313157,0.6199919746862896,233213216,259604225.2,75.52542431731037,92.78187065917362,NaN,NaN,35.31726036580731,42.77467584980237
2013-05-07T09:30:00-04:00,40.37,40.71001,40.33,40.71001,7291629,8796342.35,58.01926839079543,68.95384339139959,NaN,NaN,-1.174686628071584,45.59032707931518,-0.11733443964332935,0.47332392513212795,0.5906583647754573,240504845,251276911.8,64.66654833616596,90.78524648953491,NaN,NaN,32.04807957014026,41.242304952707784
2013-05-08T09:30:00-04:00,40.62,40.73,40.22,40.35001,7172496,8913319.9,51.856750345740934,67.89982771619657,NaN,NaN,-32.57409331223005,18.917575092162394,-0.14652149007433768,0.40750650218253526,0.5540279922568729,233332349,243588570.2,56.5783071519145,88.32124436321283,NaN,NaN,27.16337693843624,39.231029522097565
2013-05-09T09:30:00-04:00,40.38989,40.42799,39.61,39.74001,19701888,9518816.05,43.437672583069954,65.8410456946714,NaN,NaN,-119.87673471740177,-18.711655850413944,-0.20111421159193354,0.30263522776695595,0.5037494393588895,213630461,233726729.2,48.24304713796979,85.24307735458713,NaN,NaN,19.737963703423585,36.44630583371557
2013-05-10T09:30:00-04:00,39.7399,39.86,39.46001,39.83,10528797,9778412.95,44.8599217924615,63.96105148589436,NaN,NaN,-142.7201471748246,-60.91064199965533,-0.22363876841964564,0.22420097883433243,0.44783974725397807,224159258,228968025.8,44.81235098230522,81.88439702528504,NaN,NaN,14.524574565125159,33.31462993820266
2013-05-13T09:30:00-04:00,39.6965,39.75,39.48,39.62,12325121,9862440.3,42.19364518529267,61.826368774168316,NaN,NaN,-149.37396783526742,-89.14392593355907,-0.24351778937231516,0.14344251053858414,0.3869602999108993,211834137,224692210,41.92726293795881,78.26086362923277,NaN,NaN,9.415160098996171,29.90041996117316
2013-05-14T09:30:00-04:00,39.64999,40.06,39.57001,39.89,12347559,10201296,46.58911794802495,59.92217392725521,NaN,NaN,-109.77006827794418,-110.8630022635336,-0.22950904363115354,0.10007399537195738,0.3295830390031109,224181696,221427580.2,39.81933858902755,74.37819649203256,NaN,NaN,6.617202548352561,26.574246045055933
2013-05-15T09:30:00-04:00,39.87,40.55,39.8,40.27,10773316,10295321.95,52.108528574419644,58.40561997862661,NaN,NaN,-56.59807934543973,-115.66779947017554,-0.18745142328625625,0.0952687598952906,0.28272018318154685,234955012,221752112.8,40.141514676748606,70.43600811672013,NaN,NaN,6.084253210360449,23.647104211528006
2013-05-16T09:30:00-04:00,40.16,40.21001,39.88,39.94,10055563,10484287,47.51632795338654,56.51946392743224,NaN,NaN,-86.38983338050151,-108.97041920279548,-0.1749013432914873,0.06409350406718772,0.23899484735867502,224899449,224005910.4,42.445893774676136,66.6074194547293,NaN,NaN,4.110667648885869,20.856184702579128
2013-05-17T09:30:00-04:00,39.98,40.36,39.91,40.32001,9051742,10353397.55,52.68712133845337,54.78358980928511,NaN,NaN,-51.75870611957411,-90.77813099174539,-0.13579409883603782,0.06925222381362772,0.20504632264966555,233951191,225964297,44.44715023415029,62.86851610699757,NaN,NaN,4.203954258119412,18.47729463908488
2013-05-20T09:30:00-04:00,40.37,40.39,40.05,40.12,11337637,10570212.2,49.90049223166827,52.78398677324343,NaN,NaN,-48.41724223903688,-70.58678587249928,-0.11879742371836036,0.05654954300171511,0.17534696672007546,222613554,228120180.4,46.64653194916844,59.250966361636245,NaN,NaN,3.372543543972326,16.3194730540688
2013-05-21T09:30:00-04:00,40.17,40.34,39.9127,40.2,9014215,10431623.95,51.01645039154313,51.62322338307306,NaN,NaN,-48.87754966255062,-58.408282149420565,-0.09840987149955088,0.052334627345636875,0.15074449884518776,231627769,229609395,48.17292939288359,55.72805926100055,NaN,NaN,3.058780438120627,14.425088394647634
2013-05-22T09:30:00-04:00,40.10001,40.53999,39.38,39.52,24962800,11152114.95,42.375972879108915,49.929864865030254,NaN,NaN,-88.36538319760791,-64.7617429198542,-0.12524286088010608,-0.005809077254944839,0.11943378362516124,206664969,223951386.4,43.124877077343506,51.844281880893206,NaN,NaN,-0.15153079654233578,12.342714224477639
2013-05-23T09:30:00-04:00,39.25999,39.41,38.67,39.25,24046352,11856725.5,39.514291728908425,48.17106098738734,NaN,NaN,-164.01782385740998,-80.2873410152359,-0.1538154452992722,-0.07283552299892904,0.08097992230034318,182618617,215495220,36.90109172581052,48.10373344881672,NaN,NaN,-3.7242584549430138,10.047432413131832
2013-05-24T09:30:00-04:00,39.16,39.16,38.7,38.83,9968922,12058017.3,35.49841201365571,46.9695695254664,NaN,NaN,-171.74010154239275,-104.28362009979962,-0.19120262515702344,-0.15802335914593613,0.03317926601108731,172649695,203234920.8,30.11497309780472,44.86012979028059,NaN,NaN,-8.10664293802496,7.45399307725229
2013-05-28T09:30:00-04:00,38.60001,38.84,38.21001,38.38,24036848,12968064.6,31.772552257158623,45.09480408734949,NaN,NaN,-196.21287167018147,-133.84274598602855,-0.23363346537654325,-0.25886256570959176,-0.02522910033304851,148612847,188434779.4,24.304425412091902,41.977121009989574,NaN,NaN,-13.088361801065318,4.519370951778346
2013-05-29T09:30:00-04:00,38.14,38.1799,37.455,37.81,31539312,14154119.65,27.79327397351676,43.37598434647633,NaN,NaN,-229.63408374313727,-169.99405280214586,-0.28412690117227263,-0.3803877267983893,-0.09626082562611667,117073535,165523932.6,18.389343373948705,39.24933788299203,NaN,NaN,-18.760355589911068,1.1936957315370016
2013-05-30T09:30:00-04:00,38.17999,38.53999,37.89,37.91,17133664,14492435.1,29.46237592173658,42.3777488706668,NaN,NaN,-165.7659873578861,-185.47417363420152,-0.29362144889730724,-0.46328763674775075,-0.1696661878504435,134207199,151032378.6,15.774273579536384,36.930139771675364,NaN,NaN,-22.601250208320668,-2.2055822598712367
2013-05-31T09:30:00-04:00,37.8,38.42,37.67,37.67999,28508752,15476153.15,27.866778321621382,41.16395290846394,NaN,NaN,-152.81584765187452,-183.23377839309444,-0.29731221254026147,-0.5413064535257703,-0.24399424098550887,105698447,135648344.6,13.568377996680852,34.69842741555934,NaN,NaN,-26.24076174230174,-5.639179328789879
2013-06-03T09:30:00-04:00,37.69,38.03999,37.28,37.75999,31993840,16326500.6,29.30093704204795,40.24304518394646,NaN,NaN,-143.7596152917956,-177.637681142975,-0.2767100521971079,-0.5898818062318938,-0.31317175403478587,137692287,128656863,12.699224550945473,32.610710387915525,NaN,NaN,-28.710724761504935,-8.935114390606316
2013-06-04T09:30:00-04:00,37.7,37.8,37.3716,37.63,14559820,16317513.65,28.31580281558756,38.93780838877236,NaN,NaN,-128.53345671118964,-164.10179815117664,-0.254731950063687,-0.6315866916143946,-0.37685474155070764,123132467,123560787,12.091242425107652,30.63013209049268,NaN,NaN,-31.03186016596662,-12.09179235851493
2013-06-05T09:30:00-04:00,37.55,37.56,37.2,37.3,15436184,16724741.4,25.932159532569017,37.0680677429259,NaN,NaN,-127.65704684417153,-143.7063907713835,-0.24522714800247136,-0.6833886765537969,-0.4381615285513255,107696283,121685336.6,11.866090514922888,28.61045893607656,NaN,NaN,-33.75815919729405,-15.18698762119766
2013-06-06T09:30:00-04:00,37.28999,37.75999,37.24001,37.74001,18762880,17304260.6,33.91977561569415,36.09688543309072,NaN,NaN,-98.88561713259564,-130.33031672632538,-0.1943394646176393,-0.6810858593233746,-0.48674639470573533,126459163,120135729.4,11.672681782193607,26.412372365184947,NaN,NaN,-33.668829138363094,-17.827250695078437
2013-06-07T09:30:00-04:00,37.67999,38.1799,37.64999,37.97,15375531,17087942.75,37.701551771527086,35.0264876068817,NaN,NaN,-67.02627120444178,-113.17240143683883,-0.13314145619402606,-0.6531732149482679,-0.5200317587542418,141834694,127362978.8,18.356521432510306,24.548756022210664,NaN,NaN,-32.424932993975474,-19.912633880635155
2013-06-10T09:30:00-04:00,38.10001,38.13,37.8,37.96001,9931473,17058076.55,37.600890211727496,34.147944605457354,NaN,NaN,-58.620941358400025,-96.1446666501597,-0.08370074315933584,-0.6246576877034116,-0.5409569445440757,131903221,126205165.6,18.119963006111433,22.511143954849448,NaN,NaN,-31.456703522381606,-21.561786686598936
2013-06-11T09:30:00-04:00,37.74001,38.035,37.58501,37.71001,11180004,17000820.7,35.07691533233036,33.00940638694216,NaN,NaN,-64.83479178676673,-83.40493366527514,-0.05934714554022846,-0.6151408764693613,-0.5557937309291329,120723217,125723315.6,18.015908175484768,20.357071010749536,NaN,NaN,-31.34243338855215,-22.95902192973511
2013-06-12T09:30:00-04:00,37.89999,37.99001,37.25,37.34,10092023,16888043.9,31.686736910217945,32.24588953202137,NaN,NaN,-75.35329557861292,-72.94418341216343,-0.05951781536041301,-0.6301910001296491,-0.5706731847692361,110631194,126310297.8,18.628925491882,18.60736018321657,NaN,NaN,-32.24445251589516,-24.28551201347226
2013-06-13T09:30:00-04:00,37.25,37.98,37.21001,37.94501,16737195,17186237.85,41.62209336899542,32.39644679202759,NaN,NaN,-58.26691292960741,-64.82044257156578,-0.012691722387607407,-0.5865378377537454,-0.5738461153661379,127368389,126492143,18.831410440153647,17.316668662812507,NaN,NaN,-29.85370575718535,-25.08096826257413
2013-06-14T09:30:00-04:00,37.91,38.201,37.89999,38,11424516,17254685.5,42.44148933342777,32.892380886297026,NaN,NaN,-29.621767882795247,-57.339541907236466,0.026064265404756037,-0.5412657836101928,-0.5673300490149489,138792905,125883785.2,18.664081431775344,16.498747829524696,NaN,NaN,-27.699291268139476,-25.455014406226322
2013-06-17T09:30:00-04:00,38.14999,38.41,37.94,38.12,12428793,17423538.05,44.27947742664038,33.78573268411715,NaN,NaN,-12.974414176120838,-48.21023647078063,0.061819795284304924,-0.4900553049095677,-0.5518751001938726,151221698,129747480.6,23.32397969880182,16.428715992861118,NaN,NaN,-25.379488080860586,-25.444224931174073
2013-06-18T09:30:00-04:00,38.2,38.42999,38.02,38.38,11686527,17440982.55,48.1432803907197,35.23930457106022,NaN,NaN,9.774388848063627,-33.28840034381456,0.10261390542928905,-0.4236077184072613,-0.5262216238365504,162908225,138184482.2,32.42795473166838,17.43147394698395,NaN,NaN,-22.233217459970607,-24.985509578145006
2013-06-19T09:30:00-04:00,38.3,38.45,37.49001,37.5,22777568,18129150.2,38.430031118824346,35.879851370852194,NaN,NaN,-41.14157488681807,-26.446056205455584,0.07144159080899215,-0.4369196353253102,-0.5083612261343023,140130657,144084374.8,37.97402950340966,19.01717079868919,NaN,NaN,-22.41870377466227,-24.618823034790328
2013-06-20T09:30:00-04:00,37.24001,37.265,36.36,36.44,25650160,18163518.2,30.458449117338603,36.064970713403426,NaN,NaN,-224.58767021384452,-59.710207662303006,-0.014853789714432852,-0.5269284632773434,-0.5120746735629106,114480497,141506796.4,36.56213369281707,20.659581919841774,NaN,NaN,-25.603393876002627,-24.759476012106372
2013-06-21T09:30:00-04:00,36.35001,36.75,35.8,36.53999,20070880,17964744.6,31.893598480810695,36.25016081617219,NaN,NaN,-251.41445227308782,-104.06874454036151,-0.0571137869480679,-0.5834669072479954,-0.5263531202999275,134551377,140658490.8,36.086593761898506,22.330108292052703,NaN,NaN,-27.50163131032261,-25.15121248328012
2013-06-24T09:30:00-04:00,36.24001,36.78999,35.98,36.50999,20405472,18486572.1,31.68233748799888,36.490627578487285,NaN,NaN,-201.23551371102187,-141.72096444734171,-0.07772340440276015,-0.6235073758033778,-0.5457839714006176,114145905,133243332.2,32.15025332923793,23.762894785204868,NaN,NaN,-29.028065717849564,-25.705048659647183
2013-06-25T09:30:00-04:00,36.83,37.10001,36.48,36.99001,9478887,17758674.05,38.68126856537734,37.401278223687875,NaN,NaN,-113.0555651033699,-166.28695523762843,-0.05095716078606016,-0.6094804223831929,-0.5585232615971327,123624792,125386645.6,28.591576639086497,24.95757236550227,NaN,NaN,-28.02445869396721,-26.03639295026433
2013-06-26T09:30:00-04:00,37.21001,37.58,37.12,37.46001,11212117,16742314.3,44.65940411447793,38.16839454502958,NaN,NaN,-26.63371114460331,-163.38538248918547,0.003576912693280754,-0.5540521207305318,-0.5576290334238125,134836909,124327896,28.139554337503455,26.133777548024398,NaN,NaN,-25.16895932250537,-25.912473860584477
2013-06-27T09:30:00-04:00,37.59,37.89999,37.46001,37.53999,8178926,16294577.4,45.630794517034424,38.73476902685153,NaN,NaN,15.844840093588894,-115.2988804276988,0.047758239983463846,-0.49793123344448276,-0.5456894734279466,143015835,130034963.6,34.180192301384295,27.26403975294397,NaN,NaN,-22.611862443175887,-25.44095794381182
2013-06-28T09:30:00-04:00,37.42,37.83,37.27,37.63,9761664,15357223,46.76333788245392,39.38922957476056,NaN,NaN,9.78014388291823,-63.05996119649758,0.08366584882424322,-0.4411071623976426,-0.5247730112218858,152777499,133680188,37.77795971896242,28.668182375290467,NaN,NaN,-20.20757088569247,-24.693331221223342
2013-07-01T09:30:00-04:00,37.62,37.95,37.03999,37.16,12558777,14385469.85,41.859989525579955,39.87373487427839,NaN,NaN,-19.512358018968754,-26.715330058086966,0.07657609373169727,-0.4290528940572642,-0.5056289877889615,140218722,138894751.4,42.61062111008535,30.424947584904796,NaN,NaN,-19.597556718039293,-23.965363435054194
2013-07-02T09:30:00-04:00,37.2,37.42,37,37.14999,10093066,14162132.15,41.759559388255205,40.5932221941382,NaN,NaN,-46.23102019646067,-13.350421076705118,0.07208903537243855,-0.4155176935734133,-0.48760672894585183,130125656,140194924.2,43.78302539275753,32.221669006395906,NaN,NaN,-19.139538579538247,-23.2759598842662
2013-07-03T09:30:00-04:00,36.97,37.19,36.88,37.00819,5707250,13675685.45,40.28508883513776,40.49772187029122,NaN,NaN,-66.52617171171863,-21.328913190128183,0.060893680508442016,-0.41148962831029934,-0.47238330881874135,124418406,138111223.6,42.29187404390091,33.89741640666357,NaN,NaN,-19.174284019249814,-22.69000618926386
2013-07-05T09:30:00-04:00,37.13,37.13,36.50999,36.89999,13631539,13419118.4,39.14919245045435,40.26255780722169,NaN,NaN,-82.72818341654431,-41.04351789215481,0.0480860588468654,-0.4122757352601596,-0.460361794107025,110786867,131665430,37.9824013087736,35.27729639787773,NaN,NaN,-19.51744241679124,-22.23678279319634
2013-07-08T09:30:00-04:00,37.00999,37.52499,36.94,37.42999,10398055,13170244.6,47.028214179926536,40.45889614674213,NaN,NaN,-14.574915274824875,-45.91452972370344,0.07555813147596002,-0.36591412976207494,-0.44147226123803496,121184922,125346914.6,34.29345920679535,36.06083064844869,NaN,NaN,-17.501150005605442,-21.5602638235405
2013-07-09T09:30:00-04:00,37.56,37.77499,37.48,37.7,7491273,13048234.6,50.54166672039105,40.63020945600437,NaN,NaN,41.427345904991746,-33.72658893891135,0.1100724380150056,-0.30388171371927797,-0.41395415173428357,128676195,123038409.2,33.03121188294108,36.103920444968175,NaN,NaN,-14.729418490886662,-20.584428776018523
2013-07-10T09:30:00-04:00,37.63,38,37.53,37.91,8828305,12930649.65,53.14465803036237,41.68125423539994,NaN,NaN,65.6842997376298,-11.343524952093253,0.14311080799980352,-0.23506564173452915,-0.3781764497343327,137504500,124514178,34.68625704632096,35.86907955517613,NaN,NaN,-11.618872280365261,-19.3036349909252
2013-07-11T09:30:00-04:00,38.25,38.53999,38.2001,38.52,10853203,12968708.65,59.768299999514554,43.77481501269823,NaN,NaN,137.52946251162518,29.46760189257551,0.19869305064541398,-0.12981013642756523,-0.3285031870729792,148357703,129302037.4,39.877619202172966,36.10589994870155,NaN,NaN,-6.658911397631023,-17.49724590616889
2013-07-12T09:30:00-04:00,38.44,38.69,38.25999,38.64,7823680,12523032.9,60.93814074220477,45.849425174226376,NaN,NaN,135.56800707070886,73.12683999002614,0.23376812599809993,-0.036293029575354296,-0.2700611555734542,156181383,138380940.6,48.273504394508095,36.97639356531652,NaN,NaN,-2.2730534871211687,-15.322361274876357
2013-07-15T09:30:00-04:00,38.63,39.32001,38.53999,39.27,12356961,12569655.15,66.4532355713643,48.333060751609615,NaN,NaN,177.51573915533615,111.54497087605834,0.2861652164740544,0.0876453650191138,-0.1985198514549406,168538344,147851625,55.28786922153675,38.62908041476643,NaN,NaN,3.5127048071007443,-12.63163754887963
2013-07-16T09:30:00-04:00,39.25999,39.31,38.86,39.05499,10368684,12466649.7,63.174942887558075,50.082608917479675,NaN,NaN,162.7977204414188,135.81904578334377,0.2920938758650615,0.1665974933763863,-0.12549638248867523,158169660,153750318,59.01566647121397,40.802229688489824,NaN,NaN,7.220296987701191,-9.795646900796655
2013-07-17T09:30:00-04:00,39.19,39.28999,38.88,39.03999,8810113,12322829,62.941657759397806,51.388484177831096,NaN,NaN,147.83024020989023,152.24823387779583,0.2806846626857675,0.22535944586853418,-0.05532521681723335,149359547,156121327.4,60.44327587683922,43.10963836987095,NaN,NaN,10.10198283341476,-6.953128367337881
2013-07-18T09:30:00-04:00,39.10001,39.45,39.08,39.38,7630375,11565469.35,66.00595024284053,52.843852443960095,NaN,NaN,144.35260464210523,153.61286230389186,0.2810226683864833,0.2959531186658708,0.014930450279387483,156989922,157847771.2,61.49502515024437,45.06069785907524,NaN,NaN,13.524260592490252,-4.027787087362434
2013-07-19T09:30:00-04:00,39.35001,39.50999,39.25,39.39,7016109,10633766.8,66.09474844890931,54.224667484421204,NaN,NaN,128.7303454786993,152.24532998548995,0.2670049097396253,0.3486865874539191,0.08168167771429381,164006031,159412700.8,62.46913409139806,46.824353171392076,NaN,NaN,16.313280387665095,-1.1219203052156441
2013-07-22T09:30:00-04:00,39.32001,39.5,39.3149,39.35001,5257969,9893121.25,65.3594799467999,55.90320251450834,NaN,NaN,111.72307279824348,139.08679671407143,0.24092526697551148,0.38283826143368316,0.14191299445817168,158748062,157454644.4,60.409862592033676,48.095727562959816,NaN,NaN,18.42206010366393,1.670076896052867
2013-07-23T09:30:00-04:00,39.35001,39.58,39.25999,39.45,4999762,9122835.75,66.36695667272228,57.66087374911313,NaN,NaN,101.84803148626033,126.89685892303972,0.2170366860560781,0.4132088520282693,0.1961721659721912,163747824,158570277.2,61.1947712703597,49.33942369707425,NaN,NaN,20.4835562867181,4.357716809005042
2013-07-24T09:30:00-04:00,39.44,39.44,38.69991,38.85001,8847637,9091273.25,55.867191517865855,58.77388108359371,NaN,NaN,61.33177457515819,109.59716579609331,0.15060794031015956,0.38443209135989065,0.2338241510497311,154900187,159678405.2,62.00063534427551,50.74719236138672,NaN,NaN,19.3438996782091,6.498600076034194
2013-07-25T09:30:00-04:00,38.85001,39.22,38.83,39.21001,10406402,9050987.5,59.96037194650378,60.2603939047401,NaN,NaN,62.252559985033926,93.17715686467905,0.12191920113874072,0.38622315247315697,0.26430395133441625,165306589,161341738.6,63.23482595074126,52.55093697867013,NaN,NaN,19.570064032811203,8.36595206985948
2013-07-26T09:30:00-04:00,39.09,39.36,38.86501,39.35001,7009629,8992522.65,61.45746839078342,61.2910549198013,NaN,NaN,64.80924000577801,80.39293577009478,0.10407131349504889,0.39439309320322735,0.29032177970817846,172316218,163003776,64.47639009236971,54.70686061335401,NaN,NaN,20.194965461035565,10.055811125741778
2013-07-29T09:30:00-04:00,39.21001,39.58,39.19,39.42,6508453,8829862.1,62.21803443711558,62.12508118528162,NaN,NaN,75.01324790131312,73.0509707907087,0.0892488031104684,0.40188278359626395,0.31263398048579555,178824671,167019097.8,67.3454552776891,57.15787799869315,NaN,NaN,20.92384351816529,11.60838718180228
2013-07-30T09:30:00-04:00,39.48,39.81,39.42999,39.55,8857891,8644817.8,63.65273247985394,62.87565793167387,NaN,NaN,85.00905740291235,69.68317597403912,0.0807258429982341,0.41354128423358816,0.33281544123535406,187682562,171806045.4,70.41336065881188,59.709813971013936,NaN,NaN,21.93765561838817,13.083996958457407
2013-07-31T09:30:00-04:00,39.39,39.48,39.07001,39.25999,16081629,8944245.95,58.3312622517609,62.7730123782629,NaN,NaN,53.251251539994236,68.06707136700632,0.04961005910133742,0.3948280151120258,0.3452179560106884,171600933,175146194.6,72.36437094524184,62.030296238376,NaN,NaN,21.30583660940946,14.258545480021986
2013-08-01T09:30:00-04:00,39.35001,39.64,39.25999,39.59,9674777,9142622.3,62.20352399085038,62.8633968960233,NaN,NaN,71.89364168704226,69.99528770740798,0.045419828320658606,0.40199274141151164,0.35657291309085304,181275710,178340018.8,74.12161057647984,63.876589537088265,NaN,NaN,21.87509487514377,15.346623965039385
2013-08-02T09:30:00-04:00,39.61,39.66,39.32001,39.53999,7813977,8851744.2,61.274243634006076,62.49346890049771,NaN,NaN,74.21494651594922,71.87642900944223,0.033970161839924295,0.3990356153907584,0.3650654535508341,173461733,178569121.8,74.24810613030311,65.23089217342871,NaN,NaN,22.0787245881859,16.308352625488887
2013-08-05T09:30:00-04:00,39.39999,39.47,39.28,39.28,5544258,8609054.35,56.54481146542439,62.01988808463102,NaN,NaN,50.944542477693815,67.06268792471838,0.005092774218900087,0.37143142132445917,0.3663386471055591,167917475,176387682.6,70.70421523079597,66.06578851339887,NaN,NaN,20.88785109036628,16.962566691899944
2013-08-06T09:30:00-04:00,39.31,39.31,39,39.08,10565094,8762745.4,53.14649584258129,61.32023366200127,NaN,NaN,1.4487882888897907,50.35063410191387,-0.029377356815258715,0.3296169510864857,0.3589943079017444,157352381,170321646.4,61.861921517888426,66.16712034490237,NaN,NaN,18.876131834166106,17.23593314079511
2013-08-07T09:30:00-04:00,38.86,39.33,38.80009,39.25999,7713859,8707023.1,55.72536330408827,60.585906023518966,NaN,NaN,-17.810068997876737,36.13836999433967,-0.041228898830643124,0.3074581843634405,0.34868708319408365,165066240,169014707.8,60.117484472583946,66.06872458221235,NaN,NaN,17.88365125976919,17.32846430064855
2013-08-08T09:30:00-04:00,39.28999,39.5396,39.17,39.41,7685895,8548657.7,57.809646042327614,59.994112994477405,NaN,NaN,48.26281029347903,31.412203715627026,-0.040101554588827804,0.29856013995804886,0.33866169454687667,172752135,167309992.8,57.82691636122293,65.73713760148556,NaN,NaN,17.624198957464284,17.370712108765083
2013-08-09T09:30:00-04:00,39.35001,39.47,39.12,39.14,6324984,8473722.9,52.97565137020432,59.10955381043487,NaN,NaN,-13.151291617435882,13.938956088950011,-0.05761105055724841,0.26664788135031614,0.32425893190756455,166427151,165903076.4,55.93278519928813,65.41734635914659,NaN,NaN,15.984923787314639,17.172742348557875
2013-08-12T09:30:00-04:00,38.96001,39.06,38.8,38.92999,5619996,8136874.65,49.50794996363851,57.905339045500305,NaN,NaN,-144.9479400598609,-25.239540418560942,-0.08192415131196051,0.22185374276761394,0.30377789407957445,160807155,164481012.4,54.00718085735808,64.90394704393219,NaN,NaN,13.553039919076346,16.655642001489085
2013-08-13T09:30:00-04:00,38.89999,38.96001,38.67,38.72,9840180,8110449.45,46.2480649771668,57.21825857830753,NaN,NaN,-182.82590216337675,-62.09447850901425,-0.10903908875626583,0.16747903313424217,0.276518121890508,150966975,163203931.2,52.26693077999151,64.20868243219762,NaN,NaN,10.495825530161298,15.775668219870829
2013-08-14T09:30:00-04:00,38.64,38.71001,38.27,38.47,8656113,8102749.45,42.6476808951946,55.981637788928296,NaN,NaN,-240.17210635998188,-106.56688598143528,-0.138793575920599,0.10302615198975928,0.24181972791035827,142310862,158652855.6,46.51476721157618,63.01439252225725,NaN,NaN,6.758766801385155,14.487539445801447
2013-08-15T09:30:00-04:00,38.13,38.33,37.91,37.98,10102383,8226349.85,36.62876473484796,54.20815895636148,NaN,NaN,-270.73492687532564,-170.3664334151962,-0.1836426030104214,0.012266474147331508,0.1959090771577529,132208479,150544124.4,38.40488979537696,61.15214250104349,NaN,NaN,1.3941444797666838,12.617054450653624
2013-08-16T09:30:00-04:00,37.92999,37.94,37.34,37.53999,16942064,8722647.6,32.22996796180185,52.06615420812477,NaN,NaN,-274.28136222224686,-222.5924475361584,-0.23199273153257027,-0.09408183725795993,0.13791089427461034,115266415,140311977.2,31.048528937509218,58.55950490531635,NaN,NaN,-4.789737837200319,10.13036983810306
2013-08-19T09:30:00-04:00,37.56,37.7,37.16499,37.22,12214094,9070453.85,29.45925271790874,49.623762796557266,NaN,NaN,-233.78493206245264,-240.35984593667678,-0.27181453459909816,-0.20185727397426234,0.0699572606248358,103052321,128761010.4,25.18395269972514,55.32883290823873,NaN,NaN,-10.90853381203776,7.124812173797229
2013-08-20T09:30:00-04:00,37.3,37.87,37.22,37.57001,13586973,9499814.4,35.945729112585724,48.02479614375904,NaN,NaN,-163.36691220612641,-236.4680479452267,-0.26082606870740205,-0.2560753252594168,0.004750743447985276,116639294,121895474.2,22.46756126841602,51.764775074179745,NaN,NaN,-13.899392906694608,4.121354305155538
2013-08-21T09:30:00-04:00,37.5,37.50999,36.98,37.14,12319668,9673415.95,32.04687281255619,45.87074963102374,NaN,NaN,-163.22031785637725,-221.07769024450576,-0.2677513228915699,-0.32993841016647707,-0.062187087274907196,104319626,114297227,19.908239167486357,47.892391402108785,NaN,NaN,-17.77879782857278,0.9927611431943499
2013-08-22T09:30:00-04:00,37.24001,37.485,37.10001,37.35001,8168605,9561526.1,35.714211417961664,44.04503304416342,NaN,NaN,-126.80064832038134,-192.2908345335169,-0.24408667588311334,-0.3672954321287989,-0.12320875624568554,112488231,110353177.4,18.716432741050355,43.925843302876444,NaN,NaN,-19.69449573329576,-1.9625612677328084
2013-08-23T09:30:00-04:00,37.45,37.75999,37.27,37.66,7581965,9590142.9,40.79350490546631,42.919939718452135,NaN,NaN,-90.36555682839817,-155.50767345474713,-0.19555259839566125,-0.3676495042402621,-0.17209690584460086,120070196,111313933.6,19.973225578710924,40.30220118487038,NaN,NaN,-19.612782621196363,-4.484021461084744
2013-08-26T09:30:00-04:00,37.61,37.72,37.345,37.38,6576434,9593541.95,37.88200786848423,41.82961914887377,NaN,NaN,-86.11834146411246,-125.9743553350791,-0.17118115977337714,-0.3860733555613223,-0.21489219578794513,113493762,113402221.8,22.768455795769782,37.50981077614761,NaN,NaN,-20.484430290149525,-6.769794150951141
2013-08-27T09:30:00-04:00,37.14,37.57001,37.09039,37.36,9117359,9606515.35,37.67516661497227,40.540319385365486,NaN,NaN,-87.11229702558128,-110.72343229897008,-0.14624923708604576,-0.3977037421455023,-0.25145450505945655,104376403,110949643.6,21.805162133819465,34.77321632337872,NaN,NaN,-21.233941192826045,-8.836100871218983
2013-08-28T09:30:00-04:00,37.36,37.617,37.19,37.49001,8254871,9215177.45,39.96975979396276,39.26604179619657,NaN,NaN,-71.60641803727897,-92.40065233515043,-0.1123663670866561,-0.3919124639177767,-0.2795460968311206,112631274,112611973.2,24.14762788967292,32.36755286112515,NaN,NaN,-21.171843558519623,-10.598349826547645
2013-08-29T09:30:00-04:00,37.45,37.5,37.2,37.27,6092961,9036086.65,37.45658281907628,38.15753689968742,NaN,NaN,-73.42375000619337,-81.72527267231284,-0.09673076576437312,-0.40045955403658695,-0.30372878827221383,106538313,111421989.6,23.60254503275705,30.058249992087212,NaN,NaN,-21.85376815092158,-12.206266730029636
2013-08-30T09:30:00-04:00,37.31,37.50999,37.16,37.3,7867090,9038742.3,38.028779194672055,37.33759613047554,NaN,NaN,-67.95981491680551,-77.24412428999429,-0.07717631988563439,-0.4001991881292568,-0.3230228682436224,114405403,110289031,23.068635466173262,27.84835389271687,NaN,NaN,-22.24914541360736,-13.640963684826453
2013-09-03T09:30:00-04:00,37.45,37.63,36.82001,36.87,11969766,9360017.7,33.32292472056106,36.414371826432266,NaN,NaN,-81.13138085553909,-76.2467321682796,-0.08537091943663622,-0.42973651753941766,-0.34436559810278145,102435637,108077406,22.021419370268674,25.687960220593805,NaN,NaN,-24.008600611205726,-15.122054674309206
2013-09-04T09:30:00-04:00,36.88,36.98,36.55,36.87,7318402,9197683.1,33.32292472056106,35.748317813958444,NaN,NaN,-103.29311740359323,-79.482896243882,-0.08289233558950987,-0.4479810175896688,-0.3650886820001589,102435637,107689252.8,21.834081450983533,23.92505409483719,NaN,NaN,-25.429006148729567,-16.594476313512114
2013-09-05T09:30:00-04:00,36.81,36.96001,36.63,36.72,8772805,9250630.4,31.734209822892097,35.39870674881873,NaN,NaN,-103.00902045614771,-85.76341672765575,-0.08323765979572834,-0.46913575674481933,-0.385898096949091,93662832,103895564.4,20.039700006172453,22.613254824179723,NaN,NaN,-27.086368805093837,-18.09331809802379
2013-09-06T09:30:00-04:00,36.96001,37.22,36.89999,36.98,10933363,9413003.8,37.313083599558844,35.76178643722995,NaN,NaN,-75.4394266808604,-86.16655206258915,-0.05897989476692411,-0.45962296540774616,-0.40064307064082205,104596195,103507140.8,19.859737520248544,21.81405543723253,NaN,NaN,-26.948777713924148,-19.358383757438126
2013-09-09T09:30:00-04:00,37.03,37.16,36.85001,37.11,6507848,9422147,39.955325623831754,36.51150593051017,NaN,NaN,-75.25368658925022,-87.62532639707808,-0.02873489135923507,-0.4365616848398659,-0.40782679348063083,111104043,102846868.8,19.538530797358376,21.4108110156349,NaN,NaN,-26.082080779908544,-20.318911903505327
2013-09-10T09:30:00-04:00,37.23,37.39999,37.09,37.39999,8344598,9558377.1,45.476180288153,37.192252443050684,NaN,NaN,-28.757661083540278,-77.15058244267831,0.01395298468019085,-0.39038556263039226,-0.4043385473105831,119448641,106249469.6,26.165896427995705,21.674977812747734,NaN,NaN,-23.68967364659689,-20.80044929537555
2013-09-11T09:30:00-04:00,37.39,37.42,36.85001,37.035,24753008,10304018.5,40.43665456991719,37.79152256857647,NaN,NaN,-64.64112243130596,-69.42018344822091,0.0203709481045532,-0.37887486217989164,-0.39924581028444484,94695633,104701468.8,25.150929531991522,22.049455695926675,NaN,NaN,-23.062920535100435,-21.123659472479105
2013-09-12T09:30:00-04:00,37.23,37.36,36.89,36.92999,18819152,10812170.45,39.09434106427141,38.03296040045574,NaN,NaN,-69.72400968751425,-62.76318129449421,0.020264079446852434,-0.3739157109758793,-0.3941797904227317,75876481,101144198.6,22.948042335285848,22.351713524086346,NaN,NaN,-22.939007309171103,-21.38299487772082
2013-09-13T09:30:00-04:00,37.03,37.3,37.03,37.21001,10382621,10826182.35,44.39506465218472,38.290214668078484,NaN,NaN,-22.71498802368212,-52.21829356305856,0.04059870384240205,-0.34343141061972915,-0.3840301144621312,86259102,97476780,20.914240526772517,22.418928877519317,NaN,NaN,-21.22686727616407,-21.360690934641283
2013-09-16T09:30:00-04:00,37.64,37.87,37.24001,37.31,25235808,11240869.55,46.19578395593602,38.88405581718219,NaN,NaN,85.15547346197191,-20.136461552814144,0.06109805877858021,-0.30765754098890596,-0.3687555997674862,111494910,97554953.4,21.074809572544453,22.297954147288937,NaN,NaN,-19.279922918022674,-21.063438360838624
2013-09-17T09:30:00-04:00,37.31,37.57001,37.31,37.53,9723598,11116344.75,50.03013320426977,39.76655343070344,NaN,NaN,79.87286892681911,1.589644449257736,0.08814555656686923,-0.25857365405889965,-0.3467192106257689,121218508,97908926.8,21.848552818395476,22.30105348190151,NaN,NaN,-16.45984266151537,-20.405781832363875
2013-09-18T09:30:00-04:00,37.4601,38.81,37.39,38.64999,29503744,11912183.3,64.0687387002449,41.48790906686644,NaN,NaN,301.4661256266005,74.81109406083903,0.17511378661415428,-0.12782697735807602,-0.3029407639722303,150722252,109114250.6,41.42493647525186,23.535146952300003,NaN,NaN,-8.281365514048318,-18.673722358318795
2013-09-19T09:30:00-04:00,38.75,38.89999,38.33,38.46899,20019296,12297164.7,61.082125158298474,43.17544780538231,NaN,NaN,286.49666933986964,146.0552298663158,0.21165489026490109,-0.03837215114110393,-0.250027041406005,130702956,120079545.6,53.658347150747375,25.681989960727886,NaN,NaN,-2.9311995531236192,-16.4247905290052
2013-09-20T09:30:00-04:00,38.13,38.17,37.50999,37.53,18840480,12830758.45,48.461133046406914,43.92061593764909,NaN,NaN,80.23135352331768,166.64449817571577,0.16581814768595532,-0.04275435679856088,-0.2085725044845162,111862476,125200220.4,58.06311032597734,28.181595307856746,NaN,NaN,-2.897946367313935,-14.492384220192163
2013-09-23T09:30:00-04:00,37.5399,38.13,37.35001,37.985,15388051,13221062.75,53.47737713701698,45.360219681681656,NaN,NaN,91.3319982605228,167.87980313542593,0.15933465688698445,-0.009404183375785635,-0.16873884026277008,127250527,128351343.8,60.54819300213743,30.933507710133085,NaN,NaN,-0.9595719023863681,-12.559125317648478
2013-09-24T09:30:00-04:00,38,38.08,37.83,37.959,11978801,13491181.1,53.15898151991481,46.77708088163549,NaN,NaN,105.05343845482035,172.91591704102618,0.14679744499623074,0.014757965982518328,-0.1320394790137124,115271726,127161987.4,59.124093270186215,33.59707998293328,NaN,NaN,0.367467338183243,-10.712469223958232
2013-09-25T09:30:00-04:00,38,38.10001,37.67999,37.7,13861848,13728405.55,49.9674767301261,48.07945708929507,NaN,NaN,71.53540318519251,126.9297725527446,0.115919002628561,0.012859274271988852,-0.10305972835657215,101409878,117299512.6,48.861354076218326,35.655769559365126,NaN,NaN,0.3550285467878013,-9.131398113851656
2013-09-26T09:30:00-04:00,37.75999,37.88,37.50999,37.64999,8567691,13744046.55,49.35136455919652,48.93933430069776,NaN,NaN,41.32206735564167,77.89485215589899,0.08823638200601829,0.00723574915095071,-0.08100063285506758,92842187,109727358.8,42.72884554131293,37.28927727515544,NaN,NaN,0.14999692150166788,-7.80548453737261
2013-09-27T09:30:00-04:00,37.5899,37.72,37.285,37.41,7637805,13821288.75,46.394958175795566,49.39930805440946,NaN,NaN,3.8346806484027707,62.61551758091601,0.05168282092130466,-0.016397106703436748,-0.06807992762474141,85204382,104395740,39.015743393341815,38.68050674629712,NaN,NaN,-0.9442683707100913,-6.825310799277965
2013-09-30T09:30:00-04:00,37.27,37.48,37.17999,37.369,9595750,13907721.75,45.88919086011512,49.42880880954961,NaN,NaN,-19.03805908674045,40.541506111463356,0.024066605607377015,-0.037996670615520145,-0.06206327622289716,75608632,94067361,33.02808645888989,39.17066317707527,NaN,NaN,-1.9729117669663745,-6.132110937519166
2013-10-01T09:30:00-04:00,37.49001,37.61,37.35001,37.48,7859477,13702207.3,47.55605101253124,49.937337126879186,NaN,NaN,1.93837188146811,19.918492796792904,0.013145265355737443,-0.04563169452822535,-0.058776959883962795,83468109,87706637.6,29.97693812096628,39.51537807628775,NaN,NaN,-2.354710939052374,-5.592482366309625
2013-10-02T09:30:00-04:00,37.36,37.61,37.22,37.52,9614336,13817004,48.175593604882295,50.585998022637106,NaN,NaN,-10.333959748779568,3.544620209998489,0.008699449212490405,-0.04790264836834979,-0.05660209758084019,93082445,86041151,29.21587936325031,39.96308072114236,NaN,NaN,-2.501263428152198,-5.150879660858564
2013-10-03T09:30:00-04:00,37.46001,37.46001,36.94,37.08,9304043,13843565.9,42.26138215886063,50.43359213025682,NaN,NaN,-74.8449358619369,-19.688780433517206,-0.022106883279720727,-0.0842357016804911,-0.06212881840077038,83778402,84228394,28.37157790785649,40.495747676934066,NaN,NaN,-4.368848233801717,-5.039160885564729
2013-10-04T09:30:00-04:00,37.12,37.28999,37.02699,37.14999,4456980,13519746.75,43.450611689100384,50.237508396911416,NaN,NaN,-78.04870116842332,-36.065456796882415,-0.035223801447974046,-0.10615857021073793,-0.07093476876276389,88235382,84834594,29.109360651457095,41.06964418257069,NaN,NaN,-5.580398421688327,-5.1164805335823855
2013-10-07T09:30:00-04:00,37,37.28999,36.91,36.97,5136070,13451157.85,41.10584340230093,49.60005912534221,NaN,NaN,-99.17551991281525,-52.092948962097374,-0.052438584326413504,-0.13648299917078077,-0.08404441484436727,83099312,86332730,31.000862467711045,41.72338058609323,NaN,NaN,-7.28387552907175,-5.426108390080866
2013-10-08T09:30:00-04:00,37.03999,37.52,36.99001,37.23,12256762,13646766.05,45.66702319035732,48.285650874635955,NaN,NaN,-58.38894106887051,-64.1584115521651,-0.04312075000774772,-0.13794535235405192,-0.0948246023463042,95356074,88710323,34.0101651191688,41.19375406065872,NaN,NaN,-7.483010567005392,-5.719951558212942
2013-10-09T09:30:00-04:00,37.28999,37.89999,37.21001,37.38,14319070,13125069.15,48.16139332943577,47.36274145828862,NaN,NaN,-10.721763774669112,-64.235972357343,-0.02458290363237213,-0.12555323188676937,-0.10097032825439724,109675144,92028862.8,38.07007997114618,40.08030640497292,NaN,NaN,-6.948098894772617,-5.8954011777214665
2013-10-10T09:30:00-04:00,37.59,38,37.201,37.94,11698398,12769031.45,56.23873914350213,47.91828475093828,NaN,NaN,30.489446570609708,-43.16909587083369,0.024983354714731135,-0.06974113486098332,-0.09472448957571446,121373542,99547890.8,46.1535254395101,39.22962177022526,NaN,NaN,-3.9337541997158207,-5.615165895149231
2013-10-11T09:30:00-04:00,37.89,38.19,37.78999,38.11501,6908602,12595330.5,58.419292664566484,48.27127871719181,NaN,NaN,90.43575060373047,-9.472205516402937,0.06677317088639542,-0.011258025967720187,-0.07803119685411561,128282144,107557243.2,53.16608890213892,38.702328620225366,NaN,NaN,-0.7592221087833467,-4.921459639954105
2013-10-14T09:30:00-04:00,38,38,37.38,37.91,26340832,12650581.7,54.96424490883471,48.400226102114665,NaN,NaN,28.17602272284133,15.99810301072838,0.07709399437183266,0.01833629611067522,-0.05875769826115744,101941312,111325643.2,56.06524760309597,38.48383964400464,NaN,NaN,0.8847155253162128,-4.092006044915489
2013-10-15T09:30:00-04:00,37.91,37.91,37.31,37.38,11996070,12764205.3,47.19345695085363,48.20208183216663,NaN,NaN,-23.461931758810522,22.983504872740372,0.046233812903997897,-0.0009654321311600711,-0.04719924503515797,89945242,110243476.8,55.01209458431176,38.923178251725595,NaN,NaN,-0.1233472504219387,-3.525054788559267
2013-10-16T09:30:00-04:00,37.53999,37.74001,37.38,37.72,12875102,11932773.2,51.892262330946096,48.383574530148735,NaN,NaN,2.0493700669011417,25.537731641054425,0.04659590835629397,0.0110456404102095,-0.03555026794608447,102820344,108872516.8,53.637478233663074,39.702366301179175,NaN,NaN,0.5449286612732533,-2.943628581440336
2013-10-17T09:30:00-04:00,37.61,38.41,37.42,38.33,16082164,11735916.6,58.94976385896124,49.280346364660566,NaN,NaN,131.53357979948402,45.746558286829284,0.0836331081944073,0.06899111729692464,-0.014641990897482648,118902508,108378310,53.122169216915374,40.709968145720154,NaN,NaN,3.5824796241298094,-2.0113274092160296
2013-10-18T09:30:00-04:00,38.46001,38.57001,38.28999,38.42999,10977309,11342758.05,59.9860016189578,50.28726141886362,NaN,NaN,197.84395058260716,67.22819828260462,0.10897773823566173,0.12158018189709452,0.012602443661432785,129879817,108697844.6,53.43367435855605,42.167510138553446,NaN,NaN,6.302110112555827,-0.8236934775343359
2013-10-21T09:30:00-04:00,38.42999,38.49001,38.17999,38.35001,7401887,10943449.85,58.70938411956125,51.08392806936576,NaN,NaN,153.78625910783794,92.35024555960395,0.11393143739755048,0.15501674040837088,0.041085303010820404,122477930,112805168.2,57.3563119218755,44.123179695761245,NaN,NaN,8.07809202252055,0.44799016533064795
2013-10-22T09:30:00-04:00,38.53,38.99001,38.37,38.84,19637744,11326397,63.79321753596744,52.19947263587185,NaN,NaN,203.07233510737524,137.6570989328411,0.14195929608092422,0.21853442311197568,0.07657512703105146,142115674,123239254.6,65.34315912009379,46.70369967839292,NaN,NaN,11.302339632178423,1.998611517737473
2013-10-23T09:30:00-04:00,38.77,39.295,38.77,38.87,14171336,11341871.4,64.08478372344553,53.75828703334219,NaN,NaN,198.32603691857614,176.9124323031761,0.15330128313492897,0.26820173094971267,0.1149004478147837,156287010,133932587.8,71.27992068496337,49.76858130532912,NaN,NaN,13.941587670952288,3.7047509681967323
2013-10-24T09:30:00-04:00,39.00999,39.00999,38.59,38.78999,7866633,11306818.5,62.63608026675351,55.128677646031704,NaN,NaN,138.99972667227803,178.4056616777349,0.14622033757706793,0.2976758697861186,0.15145553220905067,148420377,139836161.6,73.93459746626476,52.97038393495825,NaN,NaN,15.677862508799215,5.415195473997087
2013-10-25T09:30:00-04:00,38.75999,39.23,38.60001,39.2,6555043,11252680.4,66.78040492531152,56.96257489767532,NaN,NaN,140.33411485352917,166.90369453191929,0.15890211553371344,0.3500831766261925,0.19118106109247904,154975420,144855282.2,75.96838806960548,56.18235004937928,NaN,NaN,18.492664488860854,7.283405333263339
2013-10-28T09:30:00-04:00,39.18,39.35,38.98,39.12,9821192,11263952.5,65.25942047718155,58.36203184673419,NaN,NaN,134.8101253876438,163.10846778788047,0.15167252245435622,0.3807717141604243,0.2290991917060681,145154228,149390541.8,77.6642901143691,59.300501834750726,NaN,NaN,20.34851743853876,9.149849919731256
2013-10-29T09:30:00-04:00,39.11,39.27,39.02,39.175,7921965,11267076.9,65.83553358112036,59.624470436140236,NaN,NaN,118.45461094009706,146.18492295442485,0.14061154722906044,0.40486362574239365,0.2642520785133332,153076193,151582645.6,78.45568668650483,62.18518802870491,NaN,NaN,22.039031743200027,10.991161608798222
2013-10-30T09:30:00-04:00,39.24,39.45,38.88,38.92,12318995,11402309.85,60.80116755376104,59.95035817973015,NaN,NaN,97.51708009316698,126.02313158934301,0.1076250125572048,0.3987833442098392,0.2911583316526344,140757198,148476683.2,74.43156312918376,64.2050478636816,NaN,NaN,22.082624147984408,12.575656257253392
2013-10-31T09:30:00-04:00,38.78,39.04,38.325,38.78,16903045,11782259.95,58.17111541418666,59.932631233274456,NaN,NaN,53.65879891459941,108.95494603780728,0.06971890281318815,0.3783069601691196,0.3085880573559314,123854153,143563438.4,68.45047454266484,65.29678969514774,NaN,NaN,21.374525372603514,13.832637559446267
2013-11-01T09:30:00-04:00,38.82,39.18,38.8,39.06,12361918,12177506.85,61.736090198680614,60.41633446826346,NaN,NaN,77.76264296320112,96.44065165974166,0.05736091495283124,0.3802892010469705,0.32292828609413926,136216071,139811568.6,64.20747737778544,65.878377536197,NaN,NaN,21.767712450337953,14.966219686716508
2013-11-04T09:30:00-05:00,39.19,39.22,38.8,39.141,6215409,12231473.8,62.72578292753572,61.525786323740746,NaN,NaN,76.06988207331835,84.69260299687656,0.04883336885621958,0.3839699971644137,0.33513662830819413,142431480,139267019,63.59135255177,66.49118167672971,NaN,NaN,22.370940379885912,16.02403692859785
2013-11-05T09:30:00-05:00,39.09,39.4,38.86,38.86,10733813,12155326.35,57.19861647131805,61.9048116194816,NaN,NaN,68.60223835066,74.72212847898915,0.01994040207901915,0.36006213090696804,0.3401217288279489,131697667,134991313.8,58.818764060428606,66.86127352149869,NaN,NaN,21.30590470660581,16.778589468313275
2013-11-06T09:30:00-05:00,38.9,39.41,38.9,39.39,10117689,11945257.3,63.69633833579051,62.243852653540834,NaN,NaN,86.48515547038828,72.5157435544334,0.0315080783710841,0.37950682679180403,0.3479987484207199,141815356,135202945.4,58.982852816699946,67.27989377862615,NaN,NaN,22.336723868937916,17.57260866840251
2013-11-07T09:30:00-05:00,39.43,39.61,38.95,39.02,12396653,11980170.05,57.17118068437787,62.04279401535655,NaN,NaN,76.70146822546567,77.12427741660666,0.010321594460198258,0.36090074149596774,0.3505791470357695,129418703,136315855.4,59.88799749658475,67.74091685991392,NaN,NaN,21.11931183877926,18.079280549884903
2013-11-08T09:30:00-05:00,38.74,38.96,38.26,38.95,19988636,12634171.75,56.002317867220725,61.84943214018937,NaN,NaN,6.548746373746126,62.88149809871567,-0.011162157873067291,0.33662644969443534,0.34778860756750263,109430067,130958654.6,53.74026554216431,67.48262783279169,NaN,NaN,19.78397534694164,18.322808378035866
2013-11-11T09:30:00-05:00,38.95,39.1599,38.74,38.94,7466973,11690478.8,55.82672165204926,61.2803967199095,NaN,NaN,36.519001747431915,54.9713220335384,-0.02785151785219081,0.31297421025226413,0.34082572810445494,101963094,122864977.4,46.049149206307376,66.10448426752124,NaN,NaN,18.65989840554252,18.370964096251104
2013-11-12T09:30:00-05:00,38.84,38.94,38.415,38.61,11242176,11652784.1,50.22956816754591,60.29073846591666,NaN,NaN,-30.256347133910104,35.199604936624375,-0.06101913493725941,0.2645518094328807,0.3255709443701401,90720918,114669627.6,39.832783852839114,63.85826020808379,NaN,NaN,15.974205843793765,18.02857006018577
2013-11-13T09:30:00-05:00,38.37,38.8,38.18,38.8,9596503,11488854.15,53.142488808944165,59.61262479035885,NaN,NaN,-65.40574170955003,4.821425500636716,-0.069452042908351,0.23875589073470138,0.3082079336430524,100317421,106370040.6,34.72091449861556,61.05728285325171,NaN,NaN,14.555318528601422,17.532391269959437
2013-11-14T09:30:00-05:00,38.92,39.28,38.83,39.14,18830121,11626252,57.89183236750271,58.977726750515366,NaN,NaN,57.07400528357563,0.8959329122587008,-0.05220870260005078,0.2429470553929889,0.29515575799303967,119147542,104315808.4,33.57249530550423,58.02900479867305,NaN,NaN,14.75569717116055,17.13572068441674
2013-11-15T09:30:00-05:00,39.05,39.37,39,39.365,7791652,11466969.15,60.72857121307645,58.65409466022214,NaN,NaN,102.478944947952,20.081972627099873,-0.026995948839109052,0.2614108219441533,0.2884067707832624,126939194,107817633.8,37.37513955206594,55.151208329937106,NaN,NaN,15.794216895757854,16.944077286036897
2013-11-18T09:30:00-05:00,39.44,39.47,39.17,39.32,12206332,11707191.4,59.86000202521974,58.22727097765782,NaN,NaN,127.40764200372845,38.25970067835918,-0.015279055336146374,0.2693079516130794,0.2845870069492258,114732862,110371587.4,40.069696895376865,52.40935191628511,NaN,NaN,16.383624137236765,16.86401255049402
2013-11-19T09:30:00-05:00,39.15,39.2899,38.95,39.03,10079645,11229286.45,54.45473479041645,57.77395435170463,NaN,NaN,35.42325829320919,51.39562176378304,-0.02823582808087688,0.2492922218481297,0.2775280499290066,104653217,113158047.2,42.95368027611431,50.16093171249444,NaN,NaN,15.28527098980956,16.63847804182481
2013-11-20T09:30:00-05:00,38.99,39.21,38.56,38.6,15244048,11282922.05,47.59238221152373,57.01833055151442,NaN,NaN,-78.2841025335989,48.81994959897328,-0.06484847915474151,0.19646745098557972,0.26131593014032123,89409169,110976396.8,41.27877541286931,48.22009606036619,NaN,NaN,12.117812038789175,15.99266861281972
2013-11-21T09:30:00-05:00,38.63,38.9074,38.5,38.69,7972631,11288221.95,49.039908037200696,56.111460397123,NaN,NaN,-107.2943885249461,15.946270837268932,-0.08103589281927365,0.16002106411622918,0.24105695693550283,97381800,106623248.4,38.087425808614505,46.35437809113969,NaN,NaN,9.983550535195347,15.134223173159096
2013-11-22T09:30:00-05:00,38.64,38.78,38.48,38.66,6865086,11303724.1,48.55844812852882,55.09950791147965,NaN,NaN,-110.01254710704262,-26.552027573729994,-0.09104601487202973,0.12724943834546565,0.21829545321749538,90516714,99338752.4,33.42982370766731,44.199983173703785,NaN,NaN,8.113746122310662,14.13129788018075
2013-11-25T09:30:00-05:00,38.69,38.78,38.5,38.51,6967447,11161036.85,46.12031489857945,54.308200656284036,NaN,NaN,-108.27656257481796,-73.68886848943927,-0.1041101904511112,0.08815771515360638,0.19226790560471757,83549267,93102033.4,30.042489611582326,42.14453499878619,NaN,NaN,5.821974725605614,12.944251715241444
2013-11-26T09:30:00-05:00,38.47,38.53,38.11,38.13,11718904,11350883.8,40.56373467182506,52.65587182314365,NaN,NaN,-176.98576603057677,-116.17067335419647,-0.13284451643695117,0.026212260058528614,0.15905677649547978,71830363,86537462.6,26.947384455723935,39.85628725871648,NaN,NaN,2.0510673788709863,11.388082524331379
2013-11-27T09:30:00-05:00,38.17,38.22,37.89,38.05,8469250,11158396.55,39.485183972281355,51.39258634370818,NaN,NaN,-192.5523398267953,-139.02432081283575,-0.15044620959715527,-0.029000985500964305,0.12144522409619096,63361113,81327851.4,24.76670708829866,37.34762365812461,NaN,NaN,-1.3693668241700068,9.565589760259753
2013-11-29T09:30:00-05:00,38.02,38.27,37.93,38.03,2943538,10460421.2,39.20453488805326,50.192744702339084,NaN,NaN,-160.5072975645875,-149.66690262076403,-0.15597551716343716,-0.07352417235810549,0.08245134480533167,60417575,73935006.4,22.04090012870823,35.08338327144918,NaN,NaN,-4.251002455267362,7.591790872327308
2013-12-02T09:30:00-05:00,38.08,38.15,37.67,37.87,7179399,10201295.25,36.942347272568746,48.84386081809048,NaN,NaN,-169.03341269297607,-161.4710757379507,-0.1622272050613077,-0.12033266152130295,0.04189454354000474,53238176,66479298.8,19.687579493791418,33.20041400626947,NaN,NaN,-7.383379914153167,5.452480759972954
2013-12-03T09:30:00-05:00,37.82,38.12,37.68,38.06,9868183,10383933.95,41.27574110550974,48.20430174223075,NaN,NaN,-138.21820568982116,-167.45940436095137,-0.14589801219444892,-0.14047797170305643,0.005420040491392504,63106359,62390717.2,18.519810852285246,31.67805879194419,NaN,NaN,-8.906937055945512,3.401135357698888
2013-12-04T09:30:00-05:00,37.86,38.25,37.76,38.23,7393900,10216938.3,44.92279559973095,47.61718079871552,NaN,NaN,-102.14588724639445,-152.4914286041149,-0.11721538619582793,-0.1410991922533924,-0.023883806057564478,70500259,62124696.4,18.44315816524987,30.515361910989498,NaN,NaN,-9.192382311141687,1.6020614050073774
2013-12-05T09:30:00-05:00,38.05,38.12,37.87,37.92,9726494,10197378.55,40.03952209706017,46.3420157793982,NaN,NaN,-107.47599072746435,-135.4761587842487,-0.11265877934373297,-0.1647072802372307,-0.05204850089349772,60773765,61607226.8,18.284621130123,29.423370898462263,NaN,NaN,-10.889898395277925,-0.18250428074766578
2013-12-06T09:30:00-05:00,38.05,38.515,38,38.44,7415297,9948310.75,49.88124022692976,45.56720642324486,NaN,NaN,-40.640124023598624,-111.50272407605094,-0.07023732563933485,-0.13984515794266628,-0.06960783230333142,68189062,63161524.2,20.49528289870898,28.217666851793915,NaN,NaN,-9.25543730449811,-1.478637569854872
2013-12-09T09:30:00-05:00,38.5,38.5,38.05,38.21,7243034,9311030.65,46.2641480083651,44.59607399346954,NaN,NaN,-46.89411986704738,-87.07486551086518,-0.05400988498377768,-0.13712018853305352,-0.08311030354927584,60946028,64703094.6,22.728104341167224,26.978981669350368,NaN,NaN,-9.053617387963826,-2.5607775438704365
2013-12-10T09:30:00-05:00,38.22,38.23,37.77,37.83,9600791,9417721.55,40.97719976177211,43.63339291999495,NaN,NaN,-89.72946855832873,-77.3771180845667,-0.06450056361829874,-0.16373600807214927,-0.09923544445385053,51345237,62350870.2,21.725496980267977,25.462682862504206,NaN,NaN,-10.636351743773915,-3.7144310009995047
2013-12-11T09:30:00-05:00,37.78,37.83,37.465,37.52,8717968,9291511.15,37.238540214047106,42.893832777318046,NaN,NaN,-128.38852748344797,-82.6256461319774,-0.08657345679996759,-0.20745226545381001,-0.12087880865384243,42627269,56776272.2,19.52701449404468,23.908985654016732,NaN,NaN,-13.219752960537578,-5.072334138076372
2013-12-12T09:30:00-05:00,37.55,37.82,37.5,37.57,7757439,9199557.95,38.21764926336964,42.12081429347297,NaN,NaN,-111.27133026370068,-83.38471403922466,-0.09157708274628323,-0.23535016208669646,-0.14377307934041322,50384708,54698460.8,18.76480458607479,22.52879842383532,NaN,NaN,-14.942230105542523,-6.482319276285822
2013-12-13T09:30:00-05:00,37.62,38.1667,37.42,37.51,6196202,8567862,37.46238424223839,41.32823830159508,NaN,NaN,-95.14515416833576,-94.28572006817208,-0.09243094466015092,-0.25931176016560187,-0.16688081550545095,44188506,49898349.6,17.103833548419956,21.362656269603367,NaN,NaN,-16.55754303381291,-7.921636955932549
2013-12-16T09:30:00-05:00,37.6,37.97,37.6,37.71,9684192,8662489,41.604998572128686,41.0057157068486,NaN,NaN,-81.02520045819573,-101.11193618640176,-0.07383579260797407,-0.25917555626541855,-0.18533976365744448,53872698,48483683.6,16.636457796287218,20.405082568510856,NaN,NaN,-16.688585844848607,-9.1740582257777
2013-12-17T09:30:00-05:00,37.61,37.78,37.472,37.64,5691658,8336755.3,40.59150484907029,41.00769929093754,NaN,NaN,-99.29596195567281,-103.02523486587056,-0.06108764651347748,-0.26169932179929134,-0.20061167528581386,48181040,47850844.2,16.42029647441747,19.65314771270325,NaN,NaN,-17.087102289245244,-10.304493091987348
2013-12-18T09:30:00-05:00,37.66,38.18,37.25,38.14,19247172,8795131.65,49.966900553143745,41.756393332427706,NaN,NaN,-51.59257945795622,-87.66604526077222,-0.016157269882273395,-0.2208082626386556,-0.2046509927563822,67428212,52811032.8,24.68089711308204,19.647018428759203,NaN,NaN,-14.476475993531269,-10.900490649350765
2013-12-19T09:30:00-05:00,38.06,38.06,37.52,37.86,16082628,8837060.65,45.6246643114711,42.21497400552898,NaN,NaN,-56.280305422154406,-76.66784029246296,-0.003151971302448514,-0.20859095688444285,-0.20543898558199433,51345584,53003208,24.990220335081204,19.857684157785847,NaN,NaN,-13.625214430771274,-11.289736903839408
2013-12-20T09:30:00-05:00,37.5,37.99,37.5,37.83,15367893,9206823.75,45.171719213898335,42.80278628705253,NaN,NaN,-61.48854932989508,-69.93651932477482,0.0051231475391166625,-0.1990350511580985,-0.20415819869721516,35977691,51361045,24.080159650232787,20.17143988324594,NaN,NaN,-13.082980917112618,-11.545914620021295
2013-12-23T09:30:00-05:00,38.04,38.04,37.67,37.68,16915590,9709348.95,42.87952939425079,42.91734259339116,NaN,NaN,-49.86871239936568,-63.70522171300881,0.002329889608222724,-0.20124583668693674,-0.20357572629515946,19062101,44398925.6,20.647182233750314,20.323394981922018,NaN,NaN,-13.303726727202461,-11.79703063533289
2013-12-24T09:30:00-05:00,37.65,37.93,37.5,37.83,4937150,9607834.1,45.839266777730096,42.9828048203911,NaN,NaN,-58.11079481916438,-55.46818828570713,0.011885603598412009,-0.18871872179714444,-0.20060432539555645,23999251,39562567.8,18.65732217489291,20.338692411182233,NaN,NaN,-12.620597611245305,-11.914683060463235
2013-12-26T09:30:00-05:00,37.87,37.9,37.59,37.66,10308159,9537296.85,43.112742335417586,43.20232055170236,NaN,NaN,-66.21472821652006,-58.3926180374199,0.008231745515493882,-0.1903146435011891,-0.19854638901668298,13691092,28815143.8,15.160680808144946,20.115553816755234,NaN,NaN,-12.82938485340919,-12.0453547451698
2013-12-27T09:30:00-05:00,37.63,37.9,37.63,37.81,12797626,9753715.65,46.15598239229607,42.93623070637137,NaN,NaN,-36.24484512724108,-54.38552597843724,0.016892815456025362,-0.17743036969665127,-0.19432318515267663,26488718,23843770.6,13.86614468106444,19.642043944066337,NaN,NaN,-12.123522343736067,-12.05652154496498
2013-12-30T09:30:00-05:00,37.73,37.98,37.73,37.9,5664446,9889761.05,47.95500298665498,43.0570060619635,NaN,NaN,6.921494068948615,-40.7035172986685,0.028951054131284043,-0.15813436748857157,-0.1870854216198556,32153164,23078865.2,13.672696044377076,18.995229065724182,NaN,NaN,-11.021050315791712,-11.908597083654513
2013-12-31T09:30:00-05:00,37.87,38.035,37.83,37.97,7021817,9881881.95,49.371875358643436,43.656625747454314,NaN,NaN,39.617684035330555,-22.80623801172927,0.04116412097380395,-0.13563027040260067,-0.17679439137640462,39174981,27101441.2,19.994095033046534,18.871557498065506,NaN,NaN,-9.702355273349935,-11.59341968218243
2014-01-02T09:30:00-05:00,37.92,37.99,37.34,37.39,20415181,10409231.85,39.72243289431917,43.834046653188025,NaN,NaN,-115.53253191298595,-34.29058543049358,0.0112586991271999,-0.16272101746740475,-0.17397971659460465,18759800,26053551,19.59162669006851,18.876172654924353,NaN,NaN,-11.432041331738132,-11.570365632118959
2014-01-03T09:30:00-05:00,37.45,37.49,37.11,37.27,13766713,10727872.5,38.064815622174805,43.823129964531255,NaN,NaN,-214.88138971228364,-64.0239177296463,-0.01414761932605621,-0.19166424075217492,-0.1775166214261187,4993087,24313950,18.91106951370965,18.886620149755412,NaN,NaN,-13.362675086530254,-11.826409839892001
2014-01-06T09:30:00-05:00,37.28,37.44,37.16,37.33,11236061,10803350.85,39.42591542369013,43.96338219177782,NaN,NaN,-179.72857100619484,-92.72066290543705,-0.023882720965806625,-0.207370022633377,-0.18348730166757038,16229148,22262036,18.11187635940395,18.958623207682844,NaN,NaN,-14.539506914682432,-12.213995136290634
2014-01-07T09:30:00-05:00,37.48,37.69,37.36,37.66,8648161,10864994.05,46.402522432040826,44.30606246748583,NaN,NaN,-68.97537257053935,-107.90003623333465,-0.005999874611499978,-0.19098714493194535,-0.18498727032044537,24877309,20806865,17.545581031365742,19.023560581617023,NaN,NaN,-13.445901544795039,-12.389981766076978
2014-01-08T09:30:00-05:00,37.5835,37.63,37.36,37.46,14376371,11221660.9,43.158217694237855,44.48939909928351,NaN,NaN,-96.50716407317246,-135.12500585503525,-0.005553768754449517,-0.19192948126350728,-0.18637571250905777,10500938,15072056.4,15.490058791263891,18.957115032820337,NaN,NaN,-13.511601841651785,-12.550213205444807
2014-01-09T09:30:00-05:00,37.59,37.7,37.4,37.68,9369244,11210083.55,47.505993492158794,44.31362002349887,NaN,NaN,-38.608117485379005,-119.74012296951386,0.010756017324356881,-0.17293069085361168,-0.18368670817796856,19870182,15294132.8,15.900937600598255,18.329975067642923,NaN,NaN,-12.220657011223489,-12.503133749127477
2014-01-10T09:30:00-05:00,37.92,38.49,37.86,38.22,26524073,12100388.8,56.33460842548209,45.07861603164252,NaN,NaN,211.92507610914677,-34.37882980522778,0.05655100218116549,-0.1129979554515117,-0.1695489576326772,46394255,23574366.4,29.6373413854823,18.661912285528718,NaN,NaN,-8.018772359659247,-11.862510693489158
2014-01-13T09:30:00-05:00,38.19,38.23,37.79,37.83,12416962,12333364.95,49.81795955916069,45.410490342018406,NaN,NaN,97.18550937784619,21.003986271580423,0.05894677110648505,-0.09586549374957087,-0.15481226485605593,33977293,27123995.4,34.5710859907616,19.411264166995064,NaN,NaN,-6.680697306783283,-11.122251638245462
2014-01-14T09:30:00-05:00,37.89,38.04,37.76,37.88,7674099,12407259.8,50.606830603997174,45.962440428428856,NaN,NaN,66.93162255217538,48.18538529612337,0.06196058256731546,-0.07736153664691159,-0.13932211921422705,41651392,30478812,38.92957419288907,20.717149306933546,NaN,NaN,-5.384844860267596,-10.30262209853434
2014-01-15T09:30:00-05:00,37.85,37.99,37.77,37.81,5951840,12220642.2,49.435157815819004,46.21928978829235,NaN,NaN,49.039320822153414,77.29468227518853,0.057404441779936505,-0.06756656698930641,-0.12497100876924291,35699552,35518534.8,44.870730152300546,22.589535591034092,NaN,NaN,-4.708246569435696,-9.50342559437739
2014-01-16T09:30:00-05:00,37.76,38.08,37.76,38.07,8357450,12353931.8,53.7210450404676,46.977025695795916,NaN,NaN,86.15895009024881,102.2480957903141,0.06927143473175146,-0.03838171535455359,-0.10765315008630505,44057002,40355898.8,49.907999601213376,25.071486933396123,NaN,NaN,-2.789303194963622,-8.544265251603994
2014-01-17T09:30:00-05:00,38.08,38.15,37.97,38.06,4316267,11607386.55,53.53310218131532,47.503962823582995,NaN,NaN,112.24172267860966,82.31142510420668,0.073421389519818,-0.015876413186532545,-0.08929780270635054,39740735,39025194.8,48.592650867668254,27.551951661010683,NaN,NaN,-1.3121720221089301,-7.511109075961842
2014-01-21T09:30:00-05:00,38.2,38.5,38.16,38.48,5727672,11089638.75,59.88144830262537,48.355851774723746,NaN,NaN,194.10077836951194,101.69447890253984,0.09979116004651238,0.03544114735178994,-0.06435001269472244,45468407,41323417.6,50.994843751809896,30.217819354398745,NaN,NaN,2.0369011391558867,-6.1471076166593095
2014-01-22T09:30:00-05:00,38.5,38.64,38.4101,38.52,7474629,10694975.55,60.435836895373996,49.14613474163307,NaN,NaN,195.0709390783114,127.32234220776704,0.1142273771736979,0.07843420877239993,-0.03579316840129797,52943036,43581746.4,53.303943023390225,32.597094210851864,NaN,NaN,4.8935649071687175,-4.569868684683877
2014-01-23T09:30:00-05:00,38.45,38.5,38.19,38.41,9423808,10320386.45,58.059753895993786,50.455943384609824,NaN,NaN,130.8240539349632,143.679288830329,0.11059410699383515,0.10244946534099597,-0.008144641652839176,43519228,45145681.6,54.889192759777956,35.118348930116824,NaN,NaN,6.59087006216264,-2.975477435134375
2014-01-24T09:30:00-05:00,38.34,38.56,37.98,37.98,15017547,10824406.3,49.81483779223388,51.295230682471185,NaN,NaN,73.60981853218443,141.1694625187161,0.07515197549819716,0.08579532771990728,0.010643352221710117,28501681,42034617.4,51.16793085723767,37.42241045465454,NaN,NaN,5.570220795805979,-1.7546634021428957
2014-01-27T09:30:00-05:00,38.05,38.23,37.9301,38.07,8421795,10730088.1,51.37138288589272,52.1484783583428,NaN,NaN,45.282857848548446,127.77768955270388,0.05464449969957978,0.07894897684618485,0.024304477146605066,36923476,41471165.6,50.50015823048551,39.73585915973179,NaN,NaN,5.203950985680061,-0.7605756324539019
2014-01-28T09:30:00-05:00,38.17,38.23,38.015,38.21,7901521,10485282.85,53.77325509709045,52.6749592629892,NaN,NaN,58.0080592897226,100.559145736746,0.04763914985047298,0.0838534144596963,0.036214264609223314,44824997,41342483.6,50.33858200819415,42.0782163723624,NaN,NaN,5.605305007977073,0.14883588760766586
2014-01-29T09:30:00-05:00,38.05,38.37,38.03,38.19,11042587,10754189.9,53.36772479646138,53.404209770290876,NaN,NaN,62.89318469470718,74.12359486002518,0.039144497512004744,0.08514488649922924,0.0460003889872245,33782410,37510358.4,45.654007139456674,44.232784111519024,NaN,NaN,5.817747971162327,0.9586804709726174
2014-01-30T09:30:00-05:00,38.25,38.825,38.25,38.78,8401804,10823189.25,62.38080407115155,54.46669624021894,NaN,NaN,139.84469426466765,75.92772292596607,0.06900123963894733,0.13225193853590866,0.06325069889696133,42184214,37243355.6,45.337424669530556,46.335390330728465,NaN,NaN,8.914810514813315,2.095270477235574
2014-01-31T09:30:00-05:00,38.55,39.18,38.39,39.1,14013561,10503108.25,66.19695118228134,55.17114929427602,NaN,NaN,172.8496462695237,95.77568847343392,0.10394271605518127,0.1931790939659379,0.08923637791075664,56197775,42782574.4,52.67007776771326,47.980585786602106,NaN,NaN,12.833314689054731,3.629276793209739
2014-02-03T09:30:00-05:00,39.18,39.61,38.735,38.79,20555388,10842542,59.8617368577701,55.888561958462404,NaN,NaN,183.13167610139877,123.34545212400398,0.09979748080402395,0.21398322891578658,0.11418574811176263,35642387,42526356.6,52.320464342544724,49.248398526015194,NaN,NaN,14.057527395768748,5.119026879289597
2014-02-04T09:30:00-05:00,38.98,38.98,38.39,38.56,10911815,10826329.7,55.60944822313097,56.245891788400534,NaN,NaN,95.6268479189018,130.86920984983982,0.07624870645642767,0.20949663118229722,0.13324792472586955,24730572,38507471.6,47.045459955646095,49.82810465192641,NaN,NaN,13.671155613945041,6.340759555668947
2014-02-05T09:30:00-05:00,38.48,38.54,38.26,38.39,7811177,10784480.5,52.63339577038407,56.47433735658375,NaN,NaN,37.60742220615163,125.81205735212873,0.04542790897952678,0.19003281095027802,0.14460490197075124,16919395,35134868.6,43.11681954172959,49.70282532259991,NaN,NaN,12.399106399701985,7.206237676245095
2014-02-06T09:30:00-05:00,38.45,38.69,38.3175,38.67,10539047,10592614.3,56.73990892390361,56.68997049111489,NaN,NaN,64.22069975335913,110.68725844986702,0.040279234744628245,0.19495394540153654,0.1546747106569083,27458442,32189714.2,39.97728419082514,48.99348850757218,NaN,NaN,12.631874659357742,7.981328673832616
2014-02-07T09:30:00-05:00,38.7899,38.91,38.64,38.88,10060911,10627197.65,59.57091515348065,57.12124284626957,NaN,NaN,110.24179670409393,98.16568853678106,0.04693221102645362,0.21333997443997532,0.1664077634135217,37519353,28454029.8,36.36070674210988,48.11977821288944,NaN,NaN,13.722551962415311,8.801503429344429
2014-02-10T09:30:00-05:00,38.74,39.19,38.63,39.17,7326375,9667312.75,63.15663286108106,57.355184600444964,NaN,NaN,133.77399450524138,88.2941522175496,0.06563191830905063,0.24844766129983498,0.18281574299078435,44845728,30294698,39.2756965343791,47.282696268787234,NaN,NaN,15.802580298272781,9.801657267762765
2014-02-11T09:30:00-05:00,39.18,39.67,39.11,39.54,10098190,9551374.15,67.1587539229942,57.8353929595607,NaN,NaN,190.59827781494863,107.28843819675895,0.0958578383310274,0.3026380409045686,0.20678020257354118,54943918,36337367.2,47.738790128769814,46.885185347742926,NaN,NaN,18.922706458539075,11.104664295016523
2014-02-12T09:30:00-05:00,39.53,39.66,39.35,39.59,5818873,9458612.85,67.66983730688911,58.521827488910354,NaN,NaN,178.7153650703024,135.5100267695891,0.11108354069942766,0.3456346284478258,0.2345510877483981,60762791,45106046.4,57.08553431982357,47.04206688774618,NaN,NaN,21.548617667296583,12.596657633913674
2014-02-13T09:30:00-05:00,39.43,40.06,39.41,40.02,8209028,9571472.25,71.74258658028486,60.08809525948543,NaN,NaN,193.49543159024088,161.36497313696546,0.1401067711592151,0.409684551697417,0.2695777805382019,68971819,53408721.8,63.704656127513104,47.93754726419443,NaN,NaN,25.211284616466394,14.398747202849776
2014-02-14T09:30:00-05:00,39.93,40.31,39.85,40.28,7239391,9515569.3,73.884799913996,61.696196475778514,NaN,NaN,196.88804609042,178.69422301423066,0.16508824470366018,0.47593808641777713,0.31084984171411695,76211210,61147093.2,68.57042393425426,49.22828052874934,NaN,NaN,28.966735399960715,16.479888373865624
2014-02-18T09:30:00-05:00,40.38,40.55,40.3,40.42,9736108,9786561.35,74.98451118759262,63.21128619652867,NaN,NaN,192.1219144905837,190.36380701129912,0.17819246403056987,0.5335904217523293,0.3553979577217594,85947318,69367411.2,72.74965348820662,50.829071348750226,NaN,NaN,32.36490704456412,18.74917675539398
2014-02-19T09:30:00-05:00,40.39,40.63,40.1,40.19,10371655,10018760.5,69.78534128294018,64.38397308842002,NaN,NaN,148.286214010748,181.901394250459,0.1591466334010791,0.5543312494731083,0.3951846160720292,75575663,73493760.2,74.57710055081621,52.89500659241877,NaN,NaN,33.6044620495047,20.871360368838367
2014-02-20T09:30:00-05:00,40.18,40.64,40.16,40.5,9621622,10126110.15,72.54816032360807,65.11021282073834,NaN,NaN,136.43618943118494,173.44555912263553,0.15504699931418614,0.5889933652147619,0.4339463659005757,85197285,78380659,76.58022344710754,55.12663507653141,NaN,NaN,35.538657963604855,22.966688596662152
2014-02-21T09:30:00-05:00,40.53,40.919,40.51,40.55,9209695,10115404.5,72.9773562360086,65.59452746743314,NaN,NaN,133.77976163810405,161.50242513220815,0.1435842851906035,0.6134267223888301,0.4698424371982266,94406980,83467691.2,78.48095720887831,56.97026932232892,NaN,NaN,37.2175360858494,25.00252395226033
2014-02-24T09:30:00-05:00,40.6,40.935,40.43,40.45,7101652,9719609.75,70.59995106838005,66.361542768191,NaN,NaN,112.77142439979589,144.67910079408333,0.11820752235946463,0.6176018401475574,0.49939431778809273,87305328,85686514.8,79.27119147025385,58.89532126002242,NaN,NaN,37.913995066093186,26.847019825665022
2014-02-25T09:30:00-05:00,40.53,40.77,40.33,40.4,6571004,9627070.2,69.38286306701252,67.34535811418253,NaN,NaN,93.40098262740243,124.93491442144708,0.08836145953556707,0.6098461422075516,0.5214846826719846,80734324,84643916,77.82498245361172,61.09385858130569,NaN,NaN,38.14742150896871,28.461362923279836
2014-02-26T09:30:00-05:00,40.6,40.6266,40.23,40.27,9830924,9723540.35,66.1879816022716,68.31354281646021,NaN,NaN,74.91846117788113,110.26136385487371,0.051971899247073794,0.5864495567308268,0.534477657483753,70903400,83709463.4,76.47825903745976,63.47681854528641,NaN,NaN,37.45802858757421,29.74660087532189
2014-02-27T09:30:00-05:00,40.22,40.4466,40.04,40.17,6911319,9516976.95,63.75597496784431,68.81469039102741,NaN,NaN,54.67207631478564,93.90854123159383,0.015184677840911265,0.5534585047848921,0.5382738269439808,63992081,79468422.6,70.51427740803797,65.65803234651591,NaN,NaN,36.20315729401064,30.66896607799171
2014-02-28T09:30:00-05:00,40.24,40.53,40.22,40.45,8831981,9538485.8,67.37115577799742,69.37185043563575,NaN,NaN,64.89305628152889,80.13120016027878,0.004292760382649363,0.5436397774222925,0.5393470170396432,72824062,75151839,64.96154154068938,67.70094911784301,NaN,NaN,36.08203924444089,31.442262244627305
2014-03-03T09:30:00-05:00,40.29,40.405,39.99,40.05,14237104,9549662.95,58.40814965853742,69.03267306402547,NaN,NaN,36.9337192719972,64.96365913471905,-0.03320330539053018,0.49784288530148046,0.5310461906920106,58586958,69408165,58.37454039473967,69.06515225072592,NaN,NaN,33.21911557164773,31.69609843420165
2014-03-04T09:30:00-05:00,40.31,40.485,40.25,40.34,9735723,9008679.7,62.32188580235715,68.68718248397997,NaN,NaN,53.2005970298127,56.9235820152011,-0.0412988651088434,0.47942260930595637,0.5207214744147998,68322681,66925836.4,55.74377589928231,69.63693694861966,NaN,NaN,31.9378437610809,31.730633480898685
2014-03-05T09:30:00-05:00,40.28,40.38,40.03,40.07,9034571,8914817.5,56.948861586893706,67.92139850398031,NaN,NaN,27.960458877033613,47.5319815550316,-0.06618613786711258,0.43798880208090907,0.5041749399480216,59288110,64602778.4,53.32191230186337,69.36810680447965,NaN,NaN,29.134599905664476,31.359771541579512
2014-03-06T09:30:00-05:00,40.15,40.23,39.75,39.87,13764466,9212481.95,53.284249736519484,66.60294587228277,NaN,NaN,-5.899871947454696,35.41759190258354,-0.09567541102351751,0.3845806761686248,0.4802560871921423,45523644,60909091,49.629754996663316,68.36275672370466,NaN,NaN,25.63421756515602,30.5418352592333
2014-03-07T09:30:00-05:00,39.72,39.99,39.515,39.99,13812380,9376148.6,55.14912500138637,65.26468337852495,NaN,NaN,-37.42320542959121,14.95433956035951,-0.10586353640981949,0.34792666667986794,0.4537902030896874,59336024,58211483.4,47.066511792876376,66.82676299932054,NaN,NaN,23.31498751729386,29.509428438956235
2014-03-10T09:30:00-04:00,39.87,40.045,39.739,39.89,10984326,9422319.35,53.24172399436394,63.71162715043719,NaN,NaN,-44.262539599494126,-1.284912213938749,-0.11721859955776959,0.30726695364247547,0.42448555320024506,48351698,56164431.4,45.16043420858633,64.85610447934765,NaN,NaN,20.832879253130116,28.269921412409648
2014-03-11T09:30:00-04:00,39.94,40,39.6,39.78,7920917,9452046.45,51.14619311960815,62.3802594244849,NaN,NaN,-85.35795522257244,-28.996622664415774,-0.12908083725272068,0.26313450663434423,0.3922153438870649,40430781,50586051.4,40.36332703391369,62.41226351385462,NaN,NaN,18.145198426326587,26.823532414397782
2014-03-12T09:30:00-04:00,39.72,40.29,39.72,40.28,7797969,9337035.4,59.03813195938407,61.415257398468896,NaN,NaN,-23.52306178081465,-39.293326795985436,-0.10141614775949259,0.2654451591876992,0.36686130694719177,48228750,48374179.4,38.611950091349826,59.700243988443354,NaN,NaN,18.099478384316427,25.577238981529018
2014-03-13T09:30:00-04:00,40.31,40.79,40.25,40.7,21433680,10117775.75,64.26081755922716,60.79264749298451,NaN,NaN,100.41918639950593,-18.029515126593303,-0.055301239995809603,0.2977347569524298,0.3530359969482394,69662430,53201936.6,44.293521732163924,57.258284311535185,NaN,NaN,19.79949542067054,24.75184704426352
2014-03-14T09:30:00-04:00,40.57,41.02,40.54,40.89,12816190,10348133.85,66.35095962370173,60.48914810407892,NaN,NaN,152.44545266513262,19.944216492351465,-0.014591532492394532,0.33479658133274626,0.3493881138251408,82478620,57830455.8,49.152404319375975,55.106942372186765,NaN,NaN,21.873210057758012,24.340613189048447
2014-03-17T09:30:00-04:00,40.98,41.2,40.76,41.16,9633883,10467858.45,69.11517094040319,60.47002723789253,NaN,NaN,184.4615289429025,65.68903020083079,0.025734900226610957,0.3815567391084045,0.35582183888179353,92112503,66582616.8,56.82168006627257,53.60670648737682,NaN,NaN,24.523999312673965,24.366811206709237
2014-03-18T09:30:00-04:00,41.18,41.27,41,41.1,7974483,10379777.2,67.78260417636804,60.58392885032799,NaN,NaN,175.1131621959369,117.78325368453265,0.04258864139353696,0.40905764062371475,0.3664689992301778,84138020,75324064.6,62.848796384293664,52.633173440722096,NaN,NaN,26.230338396771703,24.63302937671816
2014-03-19T09:30:00-04:00,41.11,41.18,40.28,40.45,25565045,11139446.7,55.33554926502077,59.982469871554876,NaN,NaN,57.1087216248456,133.90961036566472,0.006097163494804048,0.37409045359868287,0.3679932901038788,58572975,77392909.6,64.12512781578641,52.17680561270413,NaN,NaN,23.58013996712835,24.482616603919617
2014-03-20T09:30:00-04:00,40.34,40.54,40.045,40.54,12603629,11288547.05,56.52594761383489,59.20781214554328,NaN,NaN,-0.6803747918949193,113.68969812738453,-0.014705946118752311,0.3496108574554384,0.3643168035741907,71176604,77695744.4,64.31836815603096,52.130864656657096,NaN,NaN,21.876472137869197,24.1103102516267
2014-03-21T09:30:00-04:00,40.42,40.91,40.36,40.51,13798985,11518011.55,55.99026656536254,59.03510621031649,NaN,NaN,49.850707812553566,93.17074915686874,-0.03220995887611472,0.32405435497904733,0.35626431385516205,57377619,72675544.2,58.67592354118943,52.15239202426066,NaN,NaN,20.36346713573304,23.575046949356178
2014-03-24T09:30:00-04:00,40.54,40.79,40.355,40.62,9994515,11662654.7,57.57774662096144,58.696239125931086,NaN,NaN,49.02640982645967,66.08372533358018,-0.037720686419236205,0.3091134558311168,0.34683414225035303,67372134,67727470.4,53.67759128364522,52.00480740885801,NaN,NaN,19.579234758484382,23.004216636374494
2014-03-25T09:30:00-04:00,40.7,40.85,40.395,40.79,10447642,11856486.6,59.98030648437065,58.9127709043223,NaN,NaN,65.42435364451117,44.14596362329503,-0.03151034079123882,0.30744621626130453,0.33895655705254335,77819776,66463821.6,52.44880683891414,51.94244273293306,NaN,NaN,19.615984750329112,22.52018350979658
2014-03-26T09:30:00-04:00,40.85,40.94,40.61,40.62,7816534,11755767.1,56.532346779730695,59.14477783598026,NaN,NaN,67.7816196707641,46.28054323247873,-0.039905197411896964,0.28907506028767216,0.3289802576995691,70003242,68749875,54.47900798497772,52.288817946384086,NaN,NaN,18.64388524497609,21.966426614822225
2014-03-27T09:30:00-04:00,40.6,40.98,40.49,40.95,13429560,12081679.15,61.19555376778529,59.57666560500875,NaN,NaN,76.39015496808861,61.69464918447543,-0.025014455670599955,0.29771218811131916,0.3227266437819191,83432802,71201114.6,56.61782226799418,52.971054408892506,NaN,NaN,19.191186672010677,21.569963765849145
2014-03-28T09:30:00-04:00,40.87,41.035,40.78,41.01,7701542,12025157.2,61.99390453726543,60.20182135807313,NaN,NaN,92.2475128103886,70.17401018404243,-0.013483105507287596,0.30587276189780965,0.31935586740509725,91134344,77952459.6,61.92421558898069,54.168467364634964,NaN,NaN,19.87130774457116,21.32729861995229
2014-03-31T09:30:00-04:00,41.24,41.6185,41.08,41.46,8702887,11748446.35,67.4095322134877,61.36348843620738,NaN,NaN,156.66756951967972,91.70224212268644,0.02025777028065051,0.3446780802559104,0.3244203099752599,99837231,84445479,66.20550976987464,56.01433756006067,NaN,NaN,22.204479786195066,21.45261021512983
2014-04-01T09:30:00-04:00,41.48,41.48,41.02,41.17,10137779,11768549.15,61.343124381006035,61.52813075203752,NaN,NaN,115.0144700764601,101.62026540907623,0.018879151215872747,0.34801924899510084,0.3291400977792281,89699452,86821414.2,67.63939824758589,58.08772671407753,NaN,NaN,22.282533826490198,21.571170731038453
2014-04-02T09:30:00-04:00,41.11,41.2596,40.94,41.11,11657303,11899685.75,60.13727797668026,61.233592210427034,NaN,NaN,87.14830705283106,105.49360288548962,0.010195615918100698,0.34188461767685396,0.33168900175875327,78042149,88429195.6,68.6099930877763,59.82461752519271,NaN,NaN,21.980670923665336,21.62967075855658
2014-04-03T09:30:00-04:00,41.12,41.37,41.0749,41.24,5476782,11485301.55,61.8854866284686,60.91462985362466,NaN,NaN,100.9108196165307,110.39773581517804,0.009490824168728373,0.34355253196966373,0.33406170780093536,83518931,88446421.4,68.62085233239112,61.215220954693784,NaN,NaN,22.245346008004603,21.717624365620583
2014-04-04T09:30:00-04:00,41.41,41.92,41.32,41.46,13620566,11475710.85,64.70637916409008,60.59971615531658,NaN,NaN,147.81812354045027,121.51185796119039,0.019545858885168577,0.3584940314073961,0.33894817252222753,97139497,89647452,69.41531157293618,62.114766062312604,NaN,NaN,23.315570469180216,21.945902380414818
2014-04-07T09:30:00-04:00,41.43,41.84,41.37,41.39,13384436,11595716.35,63.10598573394666,60.26567198085791,NaN,NaN,129.13354462975184,116.00505298320482,0.017266171369660133,0.36053088673430267,0.34326471536464254,83755061,86431018,64.69159743018224,62.246394708447504,NaN,NaN,23.739141413089197,22.202079385082587
2014-04-08T09:30:00-04:00,41.4,42.04,41.11,41.98,11863472,11792844.1,69.87016450493194,61.303858783708726,NaN,NaN,147.95766891729528,122.59369275137185,0.0494551289315418,0.4050836265290698,0.355628497597528,95618533,87614834.2,65.61894356473545,62.353095833372436,NaN,NaN,26.338326339473856,22.792971807138482
2014-04-09T09:30:00-04:00,41.94,42.07,41.45,41.89,18122488,12309070.05,67.82730313350746,62.11109846368534,NaN,NaN,149.1329479768745,134.99062093618053,0.05805223747559074,0.42819379444201644,0.3701415569664257,77496045,87505613.4,65.44815179401039,62.43379466465668,NaN,NaN,27.802409992922588,23.50860583367907
2014-04-10T09:30:00-04:00,41.92,42.22,41.59,41.73,16001174,12037444.75,64.23180228712337,62.699779586668264,NaN,NaN,138.43353206207047,142.4951634252885,0.046812208210199546,0.42865681722917515,0.3818446090189756,61494871,83100801.4,58.8010889703678,62.442735052455134,NaN,NaN,27.932438847523887,24.140581978514042
2014-04-11T09:30:00-04:00,41.72,41.98,41.6,41.69,17823529,12287811.7,63.327996154165945,63.11051169618286,NaN,NaN,107.80224008022648,134.49198673324372,0.031279291348904226,0.42094372320510587,0.38966443185620164,43671342,72407170.4,46.463578108296424,61.92744839707308,NaN,NaN,27.77613217141918,24.659946291786206
2014-04-14T09:30:00-04:00,41.88,42.08,41.65,41.94,9636714,12287953.25,66.50067379846581,63.57625221861823,NaN,NaN,113.72218109255735,131.40971402580482,0.03230576755333525,0.43004664129787074,0.3977408737445355,53308056,66317769.4,41.1666749519087,61.121581833715545,NaN,NaN,28.575879571299566,25.219365331716684
2014-04-15T09:30:00-04:00,41.94,42.52,41.94,42.52,15025137,12640485.95,72.4547083465708,64.71356375910682,NaN,NaN,154.83469544428897,132.78511933120356,0.06464373862459327,0.4785455470252771,0.4139018084006838,68333193,60860701.4,37.086365255090996,59.879250210152215,NaN,NaN,31.300486274615817,26.088096894987988
2014-04-16T09:30:00-04:00,42.51,42.83,42.43,42.83,12413978,11982932.6,75.01117161222639,65.70039360513832,NaN,NaN,176.54184544705504,138.26689882523968,0.09753383280721872,0.5358190994097072,0.43828526660248845,80747171,61510926.6,37.87648420517597,58.54058320566519,NaN,NaN,34.45783365221935,27.28377357459247
2014-04-17T09:30:00-04:00,42.7,42.92,42.24,42.3,17989268,12252214.55,64.06393184559916,65.84825269859074,NaN,NaN,134.33874709976436,137.44794183277844,0.07521669703342271,0.5323061378942668,0.45708944086084413,62757903,61763533,38.201192239048055,56.84608153781286,NaN,NaN,33.39591889909275,28.156937192378223
2014-04-21T09:30:00-04:00,42.3,42.6,42.05,42.25,11056316,12115081.1,63.127925023838706,65.54242361361581,NaN,NaN,100.90000393014527,136.06749460276222,0.049927684764461244,0.5194990468164207,0.46957136205195943,51701587,63369582,40.33642586039526,54.998289829992906,NaN,NaN,32.268257550946515,28.744268672173693
2014-04-22T09:30:00-04:00,42.32,42.35,42.04,42.31,10760758,12153393.25,63.81121547348443,65.71871583450714,NaN,NaN,84.02249495666359,130.12755737558345,0.03100779742143145,0.5083311088287488,0.4773233114073173,62462345,65200439.8,42.76422834536971,53.2214919798346,NaN,NaN,31.582787406687423,29.1497713485328
2014-04-23T09:30:00-04:00,42.31,42.79,42.26,42.33,17016138,12481818.05,64.05036289999204,65.99822190045796,NaN,NaN,105.45233893343048,120.25108607341176,0.014448386354405762,0.49538379435032454,0.4809354079959188,79478483,67429497.8,45.6632355673543,51.582437871233026,NaN,NaN,31.10253171547263,29.428737115238487
2014-04-24T09:30:00-04:00,42.36,42.73,42.13,42.62,11259400,12653961.35,67.41306163029795,66.39304868630292,NaN,NaN,101.09905897564505,105.16252877912976,0.017434386214082775,0.5027283907635223,0.4852940045494395,90737883,69427640.2,48.19622241597229,50.12353573434597,NaN,NaN,31.686180736648485,29.751229061154202
2014-04-25T09:30:00-04:00,42.6,43.11,42.6,43.11,16456297,12805298.2,72.15283151450711,66.92493813990413,NaN,NaN,145.98427840097938,107.49163503937275,0.0452383362090516,0.541841924810754,0.4966035886017024,107194180,78314895.6,57.65201291778226,49.28330011612069,NaN,NaN,33.75270624522935,30.322868658879223
2014-04-28T09:30:00-04:00,43.05,43.39,42.96,43.32,18619956,13351218.9,73.90463343395096,67.69627011847587,NaN,NaN,159.60235926484702,119.23210610631311,0.06916811435469195,0.5830637315450673,0.5138956171903754,125814136,93137405.4,68.10785309033045,49.52731837755986,NaN,NaN,36.02525693483359,31.137495555444133
2014-04-29T09:30:00-04:00,43.27,43.46,43.01,43.14,17466610,13789405.05,69.84861740006002,67.69473103955644,NaN,NaN,137.30876848722434,129.88936081242528,0.06436866111510231,0.5943564435842532,0.5299877824691509,108347526,102314441.6,72.61591418623381,50.027101993381166,NaN,NaN,36.6418781352891,31.923835923993412
2014-04-30T09:30:00-04:00,43.11,43.5,43.11,43.21,21828182,14373925.2,70.5260659562363,67.88749981260851,NaN,NaN,132.15828186304896,135.23054939834896,0.05762158424579278,0.6020147627763919,0.5443931785305991,130175708,112453886.6,76.55855209025063,50.82070201454119,NaN,NaN,37.34320338861576,32.69803127608232
2014-05-01T09:30:00-04:00,43.21,43.52,42.92,43.39,18903863,14736253.2,72.2525078856003,68.46040735535686,NaN,NaN,122.30836961565174,139.4724115263503,0.056896079309415315,0.6155132776673682,0.5586171983579529,149079571,124122224.2,80.10790134492211,52.34261718415221,NaN,NaN,38.448017047481436,33.519457814853624
2014-05-02T09:30:00-04:00,43.09,43.16,42.31,42.5,27932149,15859021.55,55.07468639036151,67.87088522937083,NaN,NaN,37.336070247458565,117.74276989564615,-0.008431766787568629,0.5480774898734921,0.5565092566610608,121147422,126912872.6,80.85454075617642,54.79911451614363,NaN,NaN,33.525100983759444,33.520263981840166
2014-05-05T09:30:00-04:00,42.46,42.91,42.44,42.88,14914170,15923701.75,59.501877984659785,67.3709712426704,NaN,NaN,43.72697304634076,94.5676926519449,-0.029758864376630556,0.5193106761902726,0.5490695405669032,136061592,128962363.8,81.40651241971086,57.67338862098665,NaN,NaN,30.984889971790576,33.158067694690224
2014-05-06T09:30:00-04:00,42.8,42.945,42.64,42.67,10544712,15781715.55,56.2055043599994,66.21031381505816,NaN,NaN,39.073625630822626,74.92066408066455,-0.05997373872100886,0.47410236716564214,0.534076105886651,125516880,132396234.6,82.3259246430722,60.90478572012817,NaN,NaN,27.834073145333253,32.397497044782085
2014-05-07T09:30:00-04:00,42.76,43.39,42.72,43.36,13660274,15871555.65,63.383415379136245,65.37975979840886,NaN,NaN,93.01301301300897,67.09161031065656,-0.036602795992049963,0.48832261089658857,0.5249254068886385,139177154,134196523.8,82.80595691427689,64.11403377077822,NaN,NaN,27.626495742545814,31.715925430176902
2014-05-08T09:30:00-04:00,43.35,43.38,42.795,42.89,15161102,15723486.35,56.580727866266784,64.84524522845655,NaN,NaN,65.14593649046651,55.65912368561952,-0.05481550954025116,0.45640601996332464,0.5112215295035758,124016052,129183820,76.56995055733039,66.85465936494126,NaN,NaN,24.96867179420438,30.752032053609398
2014-05-09T09:30:00-04:00,42.84,42.98,42.24,42.26,12174063,15532130.8,48.99066165567627,63.83544070215923,NaN,NaN,-32.607015917174905,41.670506452692834,-0.10822320327094681,0.37594252541489226,0.48416572868583907,111841989,127322733.4,74.3317522536538,69.28289696445972,NaN,NaN,19.870769305995697,29.19756594680744
2014-05-12T09:30:00-04:00,42.35,42.4,41.82,41.87,13615743,15321741.5,44.9690554626515,62.489572129956876,NaN,NaN,-125.84738955823877,7.75563393177693,-0.1653278072947738,0.27750596956737184,0.44283377686214564,98226246,119755664.2,65.89735614657404,70.9352632359743,NaN,NaN,14.337618550037837,27.074716318697497
2014-05-13T09:30:00-04:00,41.96,42.168,41.79,41.97,8628453,15271328.45,46.18882775894513,61.21374819131067,NaN,NaN,-138.81189407249013,-27.82147000888562,-0.1901085745796089,0.20519805863763452,0.3953066332172434,106854699,116023228,62.15125991126784,72.11297926053956,NaN,NaN,10.528433265786326,24.710961596853046
2014-05-14T09:30:00-04:00,42.05,42.45,41.92,42.18,20111967,15525669.95,48.75748532130577,59.881207026382654,NaN,NaN,-94.94949494949964,-65.41397160138735,-0.185877099527458,0.16296025880792087,0.3488373583353789,126966666,113581130.4,59.757616178080816,72.93879310069016,NaN,NaN,8.317129397575213,22.368985568384787
2014-05-15T09:30:00-04:00,42.19,42.4,41.97,42.01,11562502,15483096.15,46.809515545795854,58.07097017147471,NaN,NaN,-93.74776705967045,-97.19271231141474,-0.18751019469524843,0.11444961496631834,0.30195980966156677,115404164,111858752.8,58.05925114652033,72.96788154560002,NaN,NaN,5.917905886695165,20.018831328143413
2014-05-16T09:30:00-04:00,42.05,42.18,41.86,42.14,10091037,15088184.6,48.50383356454873,56.25662732366027,NaN,NaN,-96.3388532161823,-109.93907977121621,-0.17316080650561394,0.08550880152954932,0.25866960803516326,125495201,114589395.2,60.00021128459568,72.38876427376184,NaN,NaN,4.481849726345145,17.79926252788652
2014-05-19T09:30:00-04:00,42.03,42.1,41.46,41.49,13459087,15208323.15,41.40246755796275,54.22475947779618,NaN,NaN,-143.55719248753098,-113.4810403570747,-0.19892923529275802,0.010008063919215715,0.20893729921197374,112036114,117351368.8,61.91984563620032,71.62475937733088,NaN,NaN,0.8646420800435918,15.38003103533753
2014-05-20T09:30:00-04:00,41.49,41.75,41.23,41.49,10785941,15209582.3,41.40246755796275,52.14450244934807,NaN,NaN,-154.53060440088822,-116.62478242275431,-0.2065570294843942,-0.04925898764351899,0.1572980418408752,112036114,118387651.8,62.64421850577532,70.6308784070112,NaN,NaN,-1.9684656714507878,12.901674362939199
2014-05-21T09:30:00-04:00,41.61,41.625,41.38,41.52,6903905,14703970.65,41.85811840201016,49.97347462909163,NaN,NaN,-131.5015083695489,-123.93518510676418,-0.2000294486112868,-0.0927387689232333,0.1072906796880535,118940019,116782322.4,60.717372898315425,69.24584066082501,NaN,NaN,-4.125584806173664,10.469208767351647
2014-05-22T09:30:00-04:00,41.54,41.98,41.52,41.86,5209973,14401499.3,46.897848877063495,49.389414806713205,NaN,NaN,-84.42720127272038,-122.07107194937416,-0.16473235609980552,-0.0986247654367034,0.06610759066310212,124149992,118531488,62.08579271063065,67.90521580042888,NaN,NaN,-4.538388528821943,8.325266296469707
2014-05-23T09:30:00-04:00,41.76,41.99,41.745,41.76,8916760,14024522.45,45.64466719018143,48.39961403567904,NaN,NaN,-70.9736705421741,-116.99803541457251,-0.14095773668487438,-0.11008958019299087,0.03086815649188352,115233232,116479094.2,59.468107631507976,66.33818688698582,NaN,NaN,-5.234078441685272,6.388217048161852
2014-05-27T09:30:00-04:00,42.14,42.345,42.03,42.09,9453551,13566202.2,50.358801962280175,47.98199243584195,NaN,NaN,-27.385648546961406,-93.76372662645859,-0.097888618378567,-0.09149261648132523,0.006396001897241772,124686783,119009228,61.61661064015339,64.85895017249162,NaN,NaN,-4.466951176237685,4.83747873039049
2014-05-28T09:30:00-04:00,42.09,42.38,42.04,42.34,12528078,13319275.6,53.63916448503391,47.28597451483465,NaN,NaN,-9.67934979263789,-64.79347570480851,-0.049866141456969444,-0.05593667492397003,-0.006070533467000589,137214861,124044977.4,65.5326923973669,63.625145564140915,NaN,NaN,-2.8404231715979535,3.7406356015349984
2014-05-29T09:30:00-04:00,42.33,42.47,42.15,42.46,9816344,12718683.7,55.17049675511289,47.18524372118079,NaN,NaN,13.009292726108166,-35.89131548567711,-0.009439054184448285,-0.017869351197560945,-0.00843029701311266,147031205,129663214.6,69.29641927334853,63.10560761528507,NaN,NaN,-1.041982007669862,3.0574045145057327
2014-05-30T09:30:00-04:00,42.33,42.76,42.33,42.74,8278661,12187423.6,58.60619489368992,47.87206752389606,NaN,NaN,63.368570146929535,-6.332161201747141,0.03434047501039515,0.03449529674988128,0.000154821739486128,155309866,135895189.4,72.83933945953528,62.999006701419454,NaN,NaN,1.5347128864955581,2.839877139075708
2014-06-02T09:30:00-04:00,42.62,42.825,42.54,42.73,7245091,11153070.7,58.43395133899635,48.83384580077783,NaN,NaN,77.83388822454268,23.429350551596205,0.05934086319588755,0.07433090073434556,0.014990037538458015,148064775,142461498,75.98386894384483,63.71947190122451,NaN,NaN,3.594379500469734,2.947663190703426
2014-06-03T09:30:00-04:00,42.65,42.965,42.61,42.89,8003681,10807546.25,60.43744710401769,49.85160432542586,NaN,NaN,97.29873835240832,48.36622793147015,0.08197404096763043,0.11745758874799606,0.035483547780365624,156068456,148737832.6,78.54121738908958,64.89018314964035,NaN,NaN,5.924208693315213,3.372883976790824
2014-06-04T09:30:00-04:00,42.82,42.9,42.63,42.87,7030734,10631847.35,60.0478267135769,50.658057282016664,NaN,NaN,92.57240405986113,68.81657870196996,0.09026301362598058,0.14831231481284135,0.058049301186860774,149037722,151102404.8,79.42991521363763,66.29534736646585,NaN,NaN,7.7662262225750345,4.00050429761714
2014-06-05T09:30:00-04:00,42.83,43.295,42.8,43.23,8414481,10369557.7,64.48589180724332,51.920655586405765,NaN,NaN,146.0799870672907,95.43071757020645,0.11317177935338948,0.19951402537859764,0.08634224602520815,157452203,153186604.4,80.20797105326838,67.87739878837642,NaN,NaN,10.71660582181216,4.959947372502143
2014-06-06T09:30:00-04:00,43.27,43.47,43.05,43.08,8087260,10015865.6,61.424168186812885,52.8435366308532,NaN,NaN,156.0370695800584,113.96441745683224,0.11123808286520445,0.2253898496067137,0.11415176674150926,149364943,151997619.8,78.38643733118936,69.1907006488474,NaN,NaN,12.408512857101305,6.024028156016309
2014-06-09T09:30:00-04:00,43,43.15,42.72,42.79,8497552,9832040.05,55.89840680879723,53.878960863055674,NaN,NaN,95.24107799996258,117.4458554119162,0.08464697287747483,0.2199604828383528,0.13531350996087796,140867391,150558143,76.1321921810078,70.20586825919078,NaN,NaN,12.34355289530783,6.926817404486526
2014-06-10T09:30:00-04:00,42.69,42.92,42.6,42.69,8922683,9597387.05,54.09136794560562,54.78531089074445,NaN,NaN,64.10761751715236,110.80763124486502,0.055927452278839274,0.20522282530942704,0.14929537303058776,131944708,145733393.4,68.97255037515637,70.65789196414657,NaN,NaN,11.783413450822428,7.620616839677369
2014-06-11T09:30:00-04:00,42.64,42.64,42.13,42.15,10302272,9681078,45.53164269171523,55.04770548286625,NaN,NaN,-3.7135833464132917,91.55043376361013,-0.0008278321864775839,0.14826058279749077,0.14908841498396835,121642436,140254336.2,61.85818931278015,70.73937885089406,NaN,NaN,8.60658348051482,7.761469216939862
2014-06-12T09:30:00-04:00,42.05,42.41,41.63,42.28,16646874,9507823.35,47.678230030351656,55.103446993815396,NaN,NaN,-34.21663618558871,55.49110911303425,-0.029420462950261905,0.11231283629614097,0.14173329924640288,138289310,136421757.6,57.39825725255803,70.40455488960315,NaN,NaN,6.618165372013897,7.598140096236152
2014-06-13T09:30:00-04:00,42.24,42.62,42.05,42.55,8416541,9350525.3,51.916650998767906,55.55144583728586,NaN,NaN,10.444619836878466,26.37261916439827,-0.02986088690278646,0.10440719061791981,0.13426807752070627,146705851,135889939.2,56.786424758463205,70.2130061129571,NaN,NaN,6.179818031300373,7.395522658388184
2014-06-16T09:30:00-04:00,42.59,43.19,42.51,42.84,19735733,9832760.1,56.03607970752021,55.95696567623157,NaN,NaN,72.09781209780697,21.743965983967147,-0.011288552995692258,0.12015738627609096,0.13144593927178322,166441584,141004777.8,61.083035844355514,70.17489362754296,NaN,NaN,7.07105216085758,7.349169730169526
2014-06-17T09:30:00-04:00,42.75,42.855,42.53,42.78,11426253,9731118.4,54.986450506304934,56.05320039203665,NaN,NaN,46.99763593379991,18.321969667296656,-0.004083436673725738,0.12634164342962606,0.1304250801033518,155015331,145618902.4,64.51103889236782,70.1019183771859,NaN,NaN,7.4872166593960605,7.368890720059031
2014-06-18T09:30:00-04:00,42.76,43.75,42.74,43.75,35859381,10984790.4,66.05612300659232,56.83074512428517,NaN,NaN,146.24410722273475,48.31350778112626,0.061360724492367374,0.20712598571881102,0.14576526122644365,190874712,159465357.6,72.37495975827605,70.32181412610929,NaN,NaN,11.82425408908995,8.005371201349162
2014-06-19T09:30:00-04:00,43.76,44.165,43.73,44.11,22224585,11750824.4,69.09386993275234,57.57986476993249,NaN,NaN,221.71093626957236,99.49902227215847,0.12080867118739913,0.29677610021069256,0.17596742902329343,213099297,174427355,78.03803878482455,70.69314979220137,NaN,NaN,16.46587857806319,9.214015112308308
2014-06-20T09:30:00-04:00,43.79,43.85,43.43,43.47,9600994,11970375.45,58.98716025056909,57.619379692187685,NaN,NaN,140.86001242348166,125.58210078947911,0.10928893600273701,0.3125785990267147,0.2032896630239777,203498303,185785845.4,81.19045601924641,71.06504886901578,NaN,NaN,16.784265064089176,10.295479391134146
2014-06-23T09:30:00-04:00,43.59,43.63,43.123,43.32,9380204,11993547.65,56.88687483417364,57.36576738719883,NaN,NaN,93.30326808134403,129.82319198618652,0.08491347992082515,0.30943151292500914,0.224518033004184,194118099,191321148.4,82.50814780559806,71.34840104162352,NaN,NaN,16.30186991586835,11.153535180381889
2014-06-24T09:30:00-04:00,43.36,43.585,43.31,43.45,9196098,11980675,58.27353239843664,57.239032078974525,NaN,NaN,95.78021158279773,139.57970711598608,0.07143351959552721,0.313809932498593,0.2423764129030658,203314197,200980921.6,84.5431578544921,71.71363265882742,NaN,NaN,16.37510573845579,11.899473831535303
2014-06-25T09:30:00-04:00,43.36,43.67,43.33,43.61,12141148,11961328.5,59.97962344748024,56.917155767562875,NaN,NaN,96.52270319275036,129.6354263099892,0.0672410051983468,0.3264276694009993,0.2591866642026525,215455345,205897048.2,85.4696618416565,72.08946771514084,NaN,NaN,16.97222024108818,12.624151890042857
2014-06-26T09:30:00-04:00,43.61,43.779,43.47,43.74,12947130,12117867.8,61.361959792889856,56.91271231085409,NaN,NaN,103.27057908067545,105.94735487220983,0.06702167474683668,0.34296375763619835,0.2759420828893617,228402475,208957683.8,86.03105035634802,72.63551150265218,NaN,NaN,17.87942597105666,13.374905330187685
2014-06-27T09:30:00-04:00,43.7,44.019,43.558,43.91,7691087,12088489.1,63.15425739087311,57.43098735243094,NaN,NaN,114.32138938287031,100.63963026408756,0.07170410728267884,0.36557221699271025,0.2938681097100314,236093562,215476735.6,87.16823668969985,73.42380039613019,NaN,NaN,19.16986475046156,14.202756675941096
2014-06-30T09:30:00-04:00,43.95,44.36,43.81,44.26,12659647,12359216.9,66.59039236045948,58.32377481063479,NaN,NaN,140.9600527605015,110.17098719991904,0.09053716036761561,0.4070395601695509,0.3165023998019353,248753209,226403757.6,88.81227433331891,74.84092353599894,NaN,NaN,21.348901354264786,15.223634487130195
2014-07-01T09:30:00-04:00,44.21,44.28,43.81,43.82,9821557,12450110.7,59.125446698486535,59.29476081111846,NaN,NaN,104.03111819713035,111.82116852278557,0.06662998158856659,0.39978987678764355,0.33315989519907696,238931652,233527248.6,89.73556064355878,76.83216434534027,NaN,NaN,20.90439578207586,16.035171814979574
2014-07-02T09:30:00-04:00,43.7,43.72,42.82,42.97,17368858,12967016.9,47.943952475118174,59.31374098574464,NaN,NaN,-7.306097030801586,91.05540847807518,-0.009129798061737748,0.3217476476219048,0.3308774456836425,221562794,234748738.4,89.8896394408329,79.15297735878848,NaN,NaN,16.52102488341107,16.10457939618407
2014-07-03T09:30:00-04:00,42.6,42.88,42.31,42.5,12201259,13156355.8,43.091305719033954,58.68335918004935,NaN,NaN,-84.06188893994073,53.588914873951964,-0.08914680964270083,0.21944393363026649,0.3085907432729673,209361535,230940550.4,85.57667125429931,81.20942353706248,NaN,NaN,11.150016643344362,15.39678471720697
2014-07-07T09:30:00-04:00,42.48,42.88,42.47,42.7,12250444,13364515,45.61391207574056,57.93891863492223,NaN,NaN,-61.51779377471622,18.421078242434668,-0.1246765293830393,0.15274508154416822,0.2774216109272075,221611979,228044233.8,82.34077991904172,82.72783382811151,NaN,NaN,7.764927080017979,14.306519340465686
2014-07-08T09:30:00-04:00,42.74,43.045,42.7,42.99,13318214,13605548.1,49.134740143163796,57.52093932326928,NaN,NaN,-32.82389479580992,-16.335711268827616,-0.12443219706734795,0.12188136459302257,0.24631356166037052,234930193,225279630.6,79.25997685690767,83.78132939700721,NaN,NaN,6.163751445483951,13.143266784039724
2014-07-09T09:30:00-04:00,42.99,43.08,42.67,42.87,10440508,13681439.35,47.757016485074026,56.21386028601798,NaN,NaN,-39.072172690895734,-44.95636944643284,-0.12765982630331088,0.08673877878123193,0.2143986050845428,224489685,222391237.2,76.05811394407107,84.04441183884971,NaN,NaN,4.452721620384616,11.901760332088994
2014-07-10T09:30:00-04:00,42.79,43.2,42.75,43.16,10440550,13688353.25,51.31016370400523,54.94359555539319,NaN,NaN,-24.467606219056055,-48.38867128408373,-0.10643821138650883,0.08135084085140676,0.1877890522379156,234930235,225064725.4,76.98487698125254,83.96918599573743,NaN,NaN,4.126053964578509,10.790945136730354
2014-07-11T09:30:00-04:00,43.13,43.22,42.771,42.83,9133039,13312661.5,47.36266506866489,54.113274470971454,NaN,NaN,-47.716531452982764,-41.119599786692135,-0.11032911336928194,0.04987766052631315,0.1602067738955951,225797196,228351857.6,78.10699688514485,83.74893891473018,NaN,NaN,2.6148314580554466,9.622928896919653
2014-07-14T09:30:00-04:00,42.96,43.06,42.32,42.34,8307081,13307188.5,42.17427055336314,53.06237416519927,NaN,NaN,-106.65430095061924,-50.14690122187274,-0.1397154507672325,-0.014437539563445512,0.12527791120378698,217490115,227527484.8,77.09185758287012,83.36206104167819,NaN,NaN,-0.3822486168219259,8.193617823528
2014-07-15T09:30:00-04:00,42.33,42.6702,42.325,42.56,8945675,12767685.6,45.083073918036696,52.12019855945642,NaN,NaN,-108.4801286537551,-65.27814799346177,-0.13791237170536183,-0.047112553427915316,0.09079981827744651,226435790,225828604.2,74.93054065481694,82.67544552741568,NaN,NaN,-1.9243345443141657,6.748196056693405
2014-07-16T09:30:00-04:00,42.7,42.7499,42.35,42.7,7493686,12571057.25,46.91315445486096,51.186879345697896,NaN,NaN,-94.14877141951669,-76.29346773918596,-0.12144597394325289,-0.0610076491516196,0.06043832479163329,233929476,227716562.4,75.7443760902978,81.98078225946146,NaN,NaN,-2.626742887731383,5.4089190646327205
2014-07-17T09:30:00-04:00,42.87,42.87,42.29,42.31,8061385,11181157.45,42.6493466567863,49.8502641216905,NaN,NaN,-98.2598541699894,-91.05191732937264,-0.130198649758387,-0.10230998740635044,0.02788866235203654,225868091,225904133.6,73.28480802487144,81.07033637864171,NaN,NaN,-4.5505056066535,3.986144111591832
2014-07-18T09:30:00-04:00,42.36,42.77,42.19,42.74,5216628,10330759.6,48.2356240596968,48.784647455177904,NaN,NaN,-80.70270506194124,-97.64915205116434,-0.10167208919799245,-0.09920144914545403,0.002470640052538421,231084719,226961638.2,73.81900399963698,80.11681975792294,NaN,NaN,-4.45216636898762,2.7806711857947675
2014-07-21T09:30:00-04:00,42.69,42.83,42.46,42.7,5578957,10129657.75,47.769489878037724,47.44029727786206,NaN,NaN,-61.23574544195085,-88.56544094943067,-0.08103760567559751,-0.09882636704195846,-0.017788761366360956,225505762,228564767.6,74.64665745585286,79.10498998096107,NaN,NaN,-4.511970251188604,1.7388652662257145
2014-07-22T09:30:00-04:00,42.78,42.87,42.61,42.61,4683673,9894831.2,46.67651870373492,46.55108813537981,NaN,NaN,-51.97721167501135,-77.26485755368189,-0.06943759896411203,-0.104585760071501,-0.03514816110738897,220822089,227442027.4,72.90831707081796,77.9030440114796,NaN,NaN,-4.87319271737243,0.7942855542831223
2014-07-23T09:30:00-04:00,42.61,42.73,42.54,42.65,7497065,9809879.55,47.25414717113607,46.50181632795251,NaN,NaN,-56.02979094974603,-69.64106145972777,-0.0556537601806079,-0.10471536133314885,-0.04906160115254095,228319154,226319963,71.12563536682967,76.56275800619365,NaN,NaN,-5.012249936797723,-0.035219515871284024
2014-07-24T09:30:00-04:00,42.57,42.85,42.5,42.78,6040261,9504835.2,49.18089616108443,46.936787073813264,NaN,NaN,-41.610998192480366,-58.31129026422597,-0.03535327344732492,-0.0932531929616971,-0.05789991951437218,234359415,228018227.8,72.23228264817858,75.60958739147074,NaN,NaN,-4.608729962774923,-0.6885781511432324
2014-07-25T09:30:00-04:00,42.78,42.88,42.381,42.44,5947413,9154849.35,44.592902488329464,46.86385781756961,NaN,NaN,-62.16248839920316,-54.60324693167835,-0.04194618781997757,-0.11033265428934413,-0.06838646646936657,228412002,227483684.4,71.30591245344047,74.82138257249922,NaN,NaN,-5.527660759689735,-1.3798756666498755
2014-07-28T09:30:00-04:00,42.34,43.117,42.27,43.03,8606854,9200637.7,52.81831354154278,47.12697020316811,NaN,NaN,-11.026759850457935,-44.56144981337976,-0.0056037223310709955,-0.07539111938320531,-0.06978739705213431,237018856,229786303.2,72.91719125968856,74.36832645841214,NaN,NaN,-3.8647352111961677,-1.73485560158506
2014-07-29T09:30:00-04:00,43.13,43.31,42.565,42.63,8185665,8976938.6,47.653231439399164,47.1195569856199,NaN,NaN,13.312061301934328,-31.503595217990636,-0.00742203979825487,-0.0790649467999529,-0.07164290700169804,228833191,231388523.6,74.01078576382658,74.22208873125182,NaN,NaN,-4.030954501626551,-2.062869730162416
2014-07-30T09:30:00-04:00,42.51,42.731,41.7201,41.91,14749487,9223335.1,40.059497383012115,46.31593796269182,NaN,NaN,-227.07102141750005,-65.71184131154143,-0.05346821361047589,-0.1384781740147929,-0.085009960404317,214083704,228541433.6,68.70199524632186,73.63045432161391,NaN,NaN,-6.763302440252628,-2.73436011731816
2014-07-31T09:30:00-04:00,41.65,41.92,41.22,41.25,15052425,9107513.45,34.61428834271774,45.40533962512417,NaN,NaN,-373.1430809546543,-132.0182578639762,-0.12087080972147271,-0.2360984725561579,-0.11522766283468519,199031279,221475806.4,57.65014088697628,72.16925032174473,NaN,NaN,-11.076246809957777,-3.926058216266677
2014-08-01T09:30:00-04:00,41.12,41.73,41.02,41.41,15537703,9274335.65,36.85511353359662,45.025399837997995,NaN,NaN,-278.78686567166613,-175.3431333184688,-0.1455198687655572,-0.2971274987916317,-0.1516076300260745,214568982,218707202.4,53.985450103693445,70.51879264466068,NaN,NaN,-13.695743841693938,-5.321727591327714
2014-08-04T09:30:00-04:00,41.4,41.46,40.49,41.185,30182493,10170938.1,35.03668853013362,44.30780088171921,NaN,NaN,-245.64154376014073,-222.2660901004054,-0.1663178259972623,-0.3595049125226524,-0.19318708652539007,184386489,208180729,42.836017044793074,68.22632667251612,NaN,NaN,-16.403262517663062,-6.904804009375621
2014-08-05T09:30:00-04:00,41.2,41.22,40.51,40.69,14765985,10243326.65,31.36965600918228,43.19755099274216,NaN,NaN,-207.5122303721214,-266.4309484352165,-0.20046342119881144,-0.4437663630239044,-0.24330294182509293,169620504,196338191.6,34.26277408701202,65.26335510085285,NaN,NaN,-19.943932062261723,-8.767536588359349
2014-08-06T09:30:00-04:00,40.53,40.57,40.07,40.17,49891265,12215864.5,28.048534864272312,42.15463586470544,NaN,NaN,-207.185217880779,-262.4537877278723,-0.24232363367870524,-0.5462074839234745,-0.30388385024476927,119729239,177467298.6,25.503498670443037,61.85040443267939,NaN,NaN,-24.086665988323812,-10.95598364549713
2014-08-07T09:30:00-04:00,40.35,40.79,40.35,40.63,12588220,12323248,34.64060964498488,41.18356340651174,NaN,NaN,-142.63872566266204,-216.35291666947387,-0.22373122218328118,-0.5835478779738708,-0.3598166557905896,132317459,164124534.6,21.347857900732365,58.10246542561477,NaN,NaN,-25.31387079795816,-13.00711038156299
2014-08-08T09:30:00-04:00,40.79,41.46,40.78,41.44,20010139,12867103,44.31517026441382,40.93682629125289,NaN,NaN,-72.13355954794002,-175.02225544472861,-0.1453768110274486,-0.5415376695749003,-0.39616085854745176,152327598,151676257.8,18.344588296835937,54.08088905711356,NaN,NaN,-22.91309009596188,-14.422250340762831
2014-08-11T09:30:00-04:00,41.51,41.62,41.23,41.29,8570624,12880280.15,43.0445028939992,40.67739659055748,NaN,NaN,-51.78027379632112,-136.25000145196472,-0.09460581808004498,-0.514418131147508,-0.419812313067463,143756974,143550354.8,16.693623848886403,50.06555382697559,NaN,NaN,-21.476300979607853,-15.429971860597835
2014-08-12T09:30:00-04:00,41.28,41.46,41.18,41.26,6880055,12776999.15,42.7802997642679,40.35783606149547,NaN,NaN,-52.61939731906494,-105.27143484135345,-0.05591133117714325,-0.4897014770388921,-0.43379014586174885,136876919,137001637.8,15.48417605945177,46.091163876448604,NaN,NaN,-20.439681575936643,-16.145644677074806
2014-08-13T09:30:00-04:00,41.31,41.54,41.18,41.45,6793266,12741978.15,45.07947448136043,40.06487737008662,NaN,NaN,-40.04906389902162,-71.84420404500199,-0.012647273971856998,-0.4495992383265701,-0.4369519643547131,143670185,141789827,20.045383352506533,42.363528212472026,NaN,NaN,-18.88704400985009,-16.53727315318556
2014-08-14T09:30:00-04:00,41.39,41.84,41.39,41.81,6018708,12639844.3,49.24118133758576,40.39689728789064,NaN,NaN,-11.548216502080434,-45.62610221288567,0.042090756547174424,-0.3843385186707451,-0.4264292752179195,149688893,145264113.8,23.280761949466225,38.93316031933101,NaN,NaN,-16.280926297743246,-16.500652173836656
2014-08-15T09:30:00-04:00,41.84,42.22,41.74,41.97,9713870,12864706.4,51.01773302736967,40.26828439402113,NaN,NaN,18.91103007220729,-27.417184288856163,0.08829152712955823,-0.31606486630597175,-0.40435639343553,159402763,146679146.8,24.61868415630572,35.48326695480366,NaN,NaN,-13.602418527275242,-16.086618795756454
2014-08-18T09:30:00-04:00,42.005,42.19,41.79,41.86,8190824,12995299.75,49.729085338121585,40.41655967250131,NaN,NaN,20.62404045036,-12.93632143951994,0.10928738436013719,-0.2677471629853585,-0.3770345473454957,151211939,148170139.8,26.081446463763285,32.05974271908486,NaN,NaN,-11.753268253770246,-15.467568718329852
2014-08-19T09:30:00-04:00,41.91,42.4,41.89,42.39,7718748,13147053.5,55.55428490262429,41.52333020961646,NaN,NaN,53.25945678877559,8.23944938204816,0.1539788694598716,-0.18456096052065618,-0.3385398299805278,158930687,152580893.4,30.385070370115457,29.322819513641544,NaN,NaN,-8.319673712249063,-14.446440860318312
2014-08-20T09:30:00-04:00,42.37,42.52,42.22,42.48,5586999,13051550.2,56.47657679443508,43.08492224188198,NaN,NaN,74.84988242136977,31.219238646126446,0.18274879247929476,-0.11010383938140933,-0.2928526318607041,164517686,156750393.6,34.28029359666603,27.653544707190814,NaN,NaN,-5.238592109151862,-13.131033895865961
2014-08-21T09:30:00-04:00,42.48,42.82,42.45,42.58,8549068,13176990.55,57.53108942749642,44.561777662874825,NaN,NaN,98.61528477705876,53.25193890195428,0.20025287710781187,-0.042536535475939274,-0.24278941258375114,173066754,161425965.8,38.44001208726825,26.543156277446162,NaN,NaN,-2.3769450879332394,-11.594735494732715
2014-08-22T09:30:00-04:00,42.75,42.75,42.21,42.45,6889884,13224114.1,55.64365267453317,46.03370367318907,NaN,NaN,84.05066650063445,66.27986618763971,0.1946436799561218,0.0005151873614011038,-0.1941284925947207,166176870,162780787.2,39.63236401641119,26.31432391827602,NaN,NaN,-0.4657036798606558,-10.00487380689385
2014-08-25T09:30:00-04:00,42.54,42.847,42.51,42.74,6878625,13137702.65,58.8841966454005,47.999028004347515,NaN,NaN,110.59329893025082,84.27371788361788,0.20120135543116296,0.05737320169423299,-0.14382815373692998,173055495,167149498.4,43.4368459219296,26.969614763627277,NaN,NaN,2.12533339505772,-8.271987063757912
2014-08-26T09:30:00-04:00,42.76,42.88,42.23,42.23,6534860,13055162.4,51.727096320566666,49.69035382265427,NaN,NaN,88.00380377592555,91.22258728104786,0.16352851713068906,0.06058249267643134,-0.10294602445425771,166520635,168667488,44.74001937874097,28.343651957077128,NaN,NaN,2.3864468015493356,-6.7493536544283055
2014-08-27T09:30:00-04:00,42.38,42.7,42.27,42.69,5242706,12579823.35,56.824489892263095,51.274916697459844,NaN,NaN,93.97367687184169,95.04734617114225,0.16163814145246763,0.09910165236132684,-0.06253648909114079,171763341,170116619,46.01862348849775,30.105849499060366,NaN,NaN,4.179904276555991,-5.18803109285912
2014-08-28T09:30:00-04:00,42.63,43,42.51,43,10312184,12342811.3,59.89776781791383,52.3879593798527,NaN,NaN,109.27621760954696,97.1795327376399,0.17233356114807363,0.15288046234395125,-0.019453098804122382,182075525,171918373.2,47.640774062779506,32.198434196627765,NaN,NaN,6.648367946971712,-3.497116944311858
2014-08-29T09:30:00-04:00,42.97,43.3,42.93,43.28,5863721,11859112.2,62.49457370033747,53.777250151734,NaN,NaN,125.92387375768314,105.55417418904963,0.18804952902294883,0.21560881247456365,0.027559283451614826,187939246,176270848.4,51.43721169604951,34.68011904285371,NaN,NaN,9.528406114427405,-1.636327935920535
2014-09-02T09:30:00-04:00,43.22,43.35,42.63,42.89,12781660,10989070.55,56.96176521551595,54.7902119696803,NaN,NaN,96.98807290002166,102.8331289830038,0.1629019845540209,0.23118676414414097,0.06828477959012005,175157586,176691266.6,51.800752527953954,37.27416021917529,NaN,NaN,10.298184992406032,0.06860248241183164
2014-09-03T09:30:00-04:00,42.9,43.26,42.9,43.1,8466979,10674120.25,59.06338720511173,55.78906287851968,NaN,NaN,100.61427161256883,105.35522255033246,0.15137956975730923,0.2575092417867566,0.10612967202944737,183624565,180112052.6,54.76781205165023,39.75433369768556,NaN,NaN,11.573708809094608,1.712189100509371
2014-09-04T09:30:00-04:00,42.96,43.195,42.85,43.08,9236748,8641394.4,58.76905064300653,56.46962497176401,NaN,NaN,91.827234308738,104.9259340377117,0.13397805896156495,0.27360224573140357,0.13962418676983862,174387817,180636947.8,55.223292288662535,42.03594300762815,NaN,NaN,12.517457903592588,3.2557989295212586
2014-09-05T09:30:00-04:00,43.23,43.64,43.11,43.62,9054199,8464693.35,63.987354214731816,57.396026485147026,NaN,NaN,132.05779085215178,109.48224868623268,0.14923638928174054,0.3261696733720143,0.17693328409027376,183442016,180910246,55.4746994562855,44.23994410048385,NaN,NaN,14.967413529626281,4.928886729536262
2014-09-08T09:30:00-04:00,43.66,43.66,43.16,43.36,6788388,7803605.8,60.04677583346454,58.13300437767151,NaN,NaN,118.17761573972112,107.93299708264026,0.13277113742580102,0.34289720587252503,0.21012606844672402,176653628,178653122.4,52.836180804871006,46.15099655342011,NaN,NaN,15.839177957816194,6.487499762147681
2014-09-09T09:30:00-04:00,43.24,43.25,42.79,42.86,13415010,8045825.1,53.254664306026505,57.96874576362881,NaN,NaN,58.83796261904739,100.30297502644541,0.08166644296433859,0.31220912215214724,0.23054267918780866,163238618,176269328.8,50.124649928599396,47.56096652188325,NaN,NaN,14.455939876088895,7.625848349853568
2014-09-10T09:30:00-04:00,42.77,42.91,42.53,42.67,10540442,8228844.45,50.8985891512714,57.570318074831405,NaN,NaN,15.782750236943201,83.33667075132028,0.031126750925975888,0.26945111784527853,0.23832436691930264,152698176,170084051,43.838128684987176,48.2436690281919,NaN,NaN,12.588381867164927,8.334781709469476
2014-09-11T09:30:00-04:00,42.71,43.095,42.6,43.03,9360484,8357205.35,54.96417549960565,57.386967079982064,NaN,NaN,40.87934948999699,73.14709378757209,0.018619336568086314,0.26159853762941054,0.24297920106132423,162058660,167618219.6,41.598257582276034,48.46925799212103,NaN,NaN,12.236640688148343,8.89219013499503
2014-09-12T09:30:00-04:00,42.79,42.85,42.16,42.26,17442530,8928396.45,46.16035351709564,56.70958856873653,NaN,NaN,-57.249110862975456,35.28571344454665,-0.04155092096748386,0.1910405498519694,0.23259147081945325,144616130,159853042.4,35.45472921520634,48.170855506320684,NaN,NaN,8.93057071581533,8.897673075112216
2014-09-15T09:30:00-04:00,42.44,42.63,42.26,42.39,10828172,8984111.55,47.68392896672358,55.90956944883103,NaN,NaN,-64.8993479371756,-1.3296792908327006,-0.07091050050778686,0.1439533451847197,0.21486384569250655,155444302,155611177.2,32.620568766794065,47.39826428095386,NaN,NaN,6.791813107506381,8.596835936882812
2014-09-16T09:30:00-04:00,42.4,43.04,42.35,42.93,12227817,9185961.2,53.562426926026646,56.04066449207817,NaN,NaN,-1.133377167790277,-13.323947248200236,-0.05309260476915445,0.1484980897310635,0.20159069450021794,167672119,156497877.4,33.81163669042043,46.617665517502395,NaN,NaN,6.864537080406667,8.349364671671934
2014-09-17T09:30:00-04:00,43.02,43.15,42.63,42.85,15543421,9577194.85,52.61911419808214,55.74028051392239,NaN,NaN,17.019905946005736,-13.076516106387725,-0.046084767823708184,0.1439847347205827,0.1900695025442909,152128698,156383981.8,33.72916031977806,45.7398467197367,NaN,NaN,6.628040151741754,8.103461168824765
2014-09-18T09:30:00-04:00,42.89,43,42.39,42.54,12497584,9922724.1,49.016682524547754,54.96306013582481,NaN,NaN,-48.367425009573175,-30.925871006301758,-0.06079285486697544,0.1140784339605716,0.17487128882754704,139631114,151898472.6,30.566856356941216,44.52028116931968,NaN,NaN,5.310043840647674,7.704401550513752
2014-09-19T09:30:00-04:00,42.34,42.58,42.22,42.54,9657364,9978138.9,49.016682524547754,54.000353623268396,NaN,NaN,-95.87765668169006,-38.65158017004468,-0.06841900513539428,0.08934753240830418,0.15776653754369846,139631114,150901469.4,29.895922775754812,42.98161767501291,NaN,NaN,4.2585557824529126,7.212137869362203
2014-09-22T09:30:00-04:00,42.43,42.48,42.13,42.22,12310735,10249181.45,45.30353691546671,53.16762303040774,NaN,NaN,-132.7087132406994,-52.21345323074944,-0.09147227090377147,0.04342619891398414,0.1348984698177556,127320379,145276684.8,26.378154785390578,41.165717836258395,NaN,NaN,2.2494206298751958,6.5031782637212014
2014-09-23T09:30:00-04:00,42.22,42.27,41.98,42.1,9807859,10395643.15,43.95873234425499,52.08871911177511,NaN,NaN,-149.2351274787626,-81.8338032929439,-0.11001444693747513,-0.002619588854088306,0.10739485808338682,117512520,135244765,21.515535862603983,38.790555251326516,NaN,NaN,0.19318954456802723,5.6017513038421765
2014-09-24T09:30:00-04:00,42.11,42.17,41.81,41.95,8346848,10486242.55,42.26965152145239,50.91019060309268,NaN,NaN,-161.5424700364882,-117.5462784894427,-0.12642093254896597,-0.05063130760282064,0.07578962494614533,109165672,126652159.8,18.388716882065523,36.159514150855294,NaN,NaN,-2.021276769278673,4.512747293396341
2014-09-25T09:30:00-04:00,41.97,42.1001,41.69,41.7,9645222,10706368.35,39.54253783502525,49.16413229025649,NaN,NaN,-164.1512439157617,-140.7030422706804,-0.1467223811969791,-0.10761335155007856,0.03910902964690055,99520450,118630027,16.044365096307416,33.34306169657115,NaN,NaN,-4.721256732673436,3.1936038611006587
2014-09-26T09:30:00-04:00,41.66,41.9251,41.4,41.76,6809676,10531242.95,40.53414165821115,47.77037270630983,NaN,NaN,-157.00385860440508,-152.9282826552234,-0.14828299596452918,-0.14624471530876093,0.0020382806557682556,106330126,111969829.4,14.402657056232215,30.5978100002398,NaN,NaN,-6.702353975428781,1.7798955987393101
2014-09-29T09:30:00-04:00,41.67,42.06,41.535,42.03,5575091,10516811.45,44.912754384145586,47.17452199760404,NaN,NaN,-112.0393112732358,-148.79440226173068,-0.12427573277710209,-0.15330638531560936,-0.029030652538507267,111905217,108886797,13.703644264746686,27.996309595678895,NaN,NaN,-7.24108573268173,0.49118397996487584
2014-09-30T09:30:00-04:00,42.08,42.54,41.95,42.09,11610388,10458247.85,45.86666092959178,46.81509855319836,NaN,NaN,-56.21619104534065,-130.1906149750463,-0.0986199792943197,-0.1523056266564069,-0.0536856473620872,123515605,110087414,15.42509696744115,25.966807330139893,NaN,NaN,-7.435858869506873,-0.6412507128168026
2014-10-01T09:30:00-04:00,42.27,42.73,42.12,42.33,17635704,10916684.1,49.62434409643897,46.43368202440074,NaN,NaN,-20.855329678711126,-102.05318690349087,-0.06156394665390512,-0.1306405806794686,-0.06907663402556348,141151309,116484541.4,24.11156867372135,24.717758122385984,NaN,NaN,-6.576635737363359,-1.4891628591805963
2014-10-02T09:30:00-04:00,42.3,42.59,42.2,42.27,13245009,11117097.15,48.713941875078596,46.616081192828084,NaN,NaN,-23.16379657446338,-73.85569743523119,-0.03830996081856032,-0.11696408504876388,-0.07865412423020356,127906300,122161711.4,30.894907864689884,24.392056597349093,NaN,NaN,-6.092363195103337,-2.1467629071695593
2014-10-03T09:30:00-04:00,42.27,42.61,42.01,42.54,9176165,11123195.45,52.90134020617029,46.98875342421714,NaN,NaN,-9.492809244896366,-44.353487563329445,-0.003778697683590085,-0.08337749633469116,-0.07959879865110107,137082465,128312179.2,37.42105864424923,24.734948731453038,NaN,NaN,-4.504519234691696,-2.4835852396727214
2014-10-06T09:30:00-04:00,42.59,42.78,42.35,42.54,5522131,11059882.6,52.90134020617029,46.9415329442274,NaN,NaN,39.19452157259828,-14.106720994162647,0.018788601697476884,-0.05611304652925497,-0.07490164822673186,137082465,133347628.8,42.23117288383627,25.33634417383988,NaN,NaN,-3.1859374263702946,-2.583921266343803
2014-10-07T09:30:00-04:00,42.55,42.95,42.38,42.48,12225750,11000419.6,51.811094032340115,46.88381721810297,NaN,NaN,57.604197396282,8.657356694161889,0.028802222400972535,-0.03889887022551619,-0.06770109262648873,124856715,133615850.8,42.48477381129102,25.961745137519383,NaN,NaN,-2.3344947886597516,-2.5482889123889385
2014-10-08T09:30:00-04:00,42.55,43.49,42.48,43.44,17576545,11352224.75,64.43911133003937,47.98541927563809,NaN,NaN,173.63876734444258,47.55617609879264,0.0954508809736094,0.05161250859052302,-0.043838372383086376,142433260,133872241,42.74351980960806,26.831506812709872,NaN,NaN,2.647502649931823,-1.806032974914544
2014-10-09T09:30:00-04:00,43.48,43.67,42.695,42.73,15774144,11672907.75,53.31194822401149,48.29222396845692,NaN,NaN,144.49941215090513,81.08881784386634,0.08731040082458408,0.06529962864764371,-0.022010772176940356,126659116,133622804.2,42.542997506225774,27.734869293457795,NaN,NaN,3.3642181768978943,-1.0674256675127671
2014-10-10T09:30:00-04:00,42.83,43.34,42.83,42.93,18274732,11714517.85,55.63587867310793,49.030248379717015,NaN,NaN,124.63927727103857,107.91523514705332,0.09059535086163874,0.09123341640010807,0.0006380655384693318,144933848,135193080.8,44.31407734097764,29.01600661885687,NaN,NaN,4.718698851483154,-0.2408364505133499
2014-10-13T09:30:00-04:00,43.02,43.48,42.87,42.89,17113572,12028787.85,55.04573772507701,49.82217733549002,NaN,NaN,115.37986133739803,123.15230310001327,0.08534661223649628,0.10732133083408968,0.021974718597593403,127820276,133340643,42.64411588764308,30.525190906359665,NaN,NaN,5.593948976978579,0.5927043248426399
2014-10-14T09:30:00-04:00,43.03,43.79,42.89,43.28,22008705,12517832.25,59.55079286499906,51.05654457431478,NaN,NaN,143.11980262194902,140.2554241451467,0.10227134368323385,0.1498138982016357,0.047542554518401864,149828981,138335096.2,48.30098348327359,32.661781377874526,NaN,NaN,7.80361836402705,1.622834901868984
2014-10-15T09:30:00-04:00,43.16,43.5902,41.9,42.71,22855732,12883447.8,51.437389183057086,51.90617681345991,NaN,NaN,43.95153008830335,114.31797669391884,0.07070869986571819,0.1359284293505496,0.06521972948483142,126973249,135243094,45.320869995935084,34.7529602992765,NaN,NaN,7.007198828789152,2.392029748571865
2014-10-16T09:30:00-04:00,42.29,42.84,41.94,42.75,20875582,13302347.7,51.93231325566351,52.72033192756364,NaN,NaN,5.856600481019131,86.58941435994163,0.04917729003171813,0.12669134202447907,0.07751405199276094,147848831,139481037,49.884870526708816,37.287404118596264,NaN,NaN,6.542597530071384,2.984968003071796
2014-10-17T09:30:00-04:00,42.94,43.08,42.38,43,15615687,13600263.85,55.01792139629826,53.44212957128884,NaN,NaN,55.882682769022715,72.83809545953845,0.048351599813938245,0.13795355176018376,0.08960195194624551,163464518,143187171,53.53727961165422,40.13266378623251,NaN,NaN,7.119726792369116,3.5756478301142702
2014-10-20T09:30:00-04:00,43.13,43.63,42.96,43.6,10474615,13508457.85,61.419047967337356,54.55301435969924,NaN,NaN,134.35301915555664,76.63272702317018,0.08277311682045145,0.19306834797180983,0.11029523115135838,173939133,152410942.4,61.12999690173039,43.397299495824605,NaN,NaN,9.778266099999183,4.461736154383543
2014-10-21T09:30:00-04:00,43.7,43.82,43.46,43.75,10087953,13522462.55,62.842642803416275,55.49717855305476,NaN,NaN,153.0891935820776,78.6266052151959,0.10857586226846075,0.24601505898693432,0.13743919671847357,184027086,159250563.4,65.61689200233731,46.3619654478686,NaN,NaN,12.366741553077226,5.591022639911213
2014-10-22T09:30:00-04:00,43.7,44.36,43.69,44.02,13948554,13802547.85,65.32298903398055,56.683539064404904,NaN,NaN,174.65381363097606,104.76706192373044,0.13503455942892623,0.30623239600463137,0.17119783657570514,197975640,173451041.6,72.67059453505047,49.34594306718007,NaN,NaN,15.315715751911732,6.980264513054144
2014-10-23T09:30:00-04:00,44.14,44.38,43.935,44.1,9462706,13793422.05,66.04620290290275,57.62245782845722,NaN,NaN,165.2535332603556,136.64644847959772,0.14808425858780852,0.3563031598104658,0.20821890122265727,207438346,185368944.6,76.94535686603183,52.169107225878825,NaN,NaN,17.91117628521497,8.541823337648548
2014-10-24T09:30:00-04:00,44.17,44.66,44.12,44.53,10623994,13984137.95,69.70365374534774,58.82262308125561,NaN,NaN,178.43055316568183,161.15602255892955,0.17404403913773808,0.4257739501448299,0.2517299110070918,218062340,196288509,80.02781705521363,54.86886752383435,NaN,NaN,21.34924725023712,10.3714553251612
2014-10-27T09:30:00-04:00,44.52,44.74,44.3249,44.43,8312758,14121021.3,67.87260094181798,59.969873574789744,NaN,NaN,161.72064121268556,166.62954697035534,0.17251471060676332,0.46737329926554594,0.2948585886587826,209749582,203450598.8,81.75123888505925,57.673615029103516,NaN,NaN,23.596136410510685,12.260695480211126
2014-10-28T09:30:00-04:00,44.48,44.76,44.2078,44.74,10774141,14079208.95,70.46295290430916,60.40014797295187,NaN,NaN,143.9424094443781,164.80019014281544,0.17960795722874046,0.5193685351947082,0.3397605779659677,220523723,210749926.2,83.33004316311022,60.57265241149652,NaN,NaN,26.3216006856571,14.269396223846265
2014-10-29T09:30:00-04:00,44.77,44.93,44.03,44.48,15309422,13962894.85,65.67982972296953,61.2835680800203,NaN,NaN,116.90443080586458,153.25031357779312,0.15494839595903676,0.5334460729147636,0.3784976769557269,205214301,212197658.4,83.63250268437722,63.50761706707876,NaN,NaN,27.1893390500277,16.115102341872184
2014-10-30T09:30:00-04:00,44.53,45.49,44.51,45.46,33867404,14994014.6,73.09366165365888,62.53055257863108,NaN,NaN,156.26585844781917,151.45277861528584,0.19046022920337402,0.6165729634599444,0.42611273425657037,239081705,218526330.2,84.92053768588129,66.40807852028617,NaN,NaN,30.614056527870336,18.186381511300493
2014-10-31T09:30:00-04:00,45.57,45.63,45.1,45.47,16099158,15340164.25,73.15738180291211,63.82424144133359,NaN,NaN,153.11849591750456,146.3903671656504,0.1994875065446533,0.675472117437387,0.4759846108927337,255180863,225950034.8,86.28406429835798,69.52521769248008,NaN,NaN,33.258431973927415,20.33953157739005
2014-11-03T09:30:00-05:00,45.52,45.91,45.47,45.77,13128476,15720481.5,75.06518786255626,64.93241251258767,NaN,NaN,154.45790662983396,144.93782024908006,0.2094940026694505,0.7378521142295469,0.5283581115600964,268309339,237661986.2,88.11061020084475,72.36876245802088,NaN,NaN,36.07560859471245,22.587542579864678
2014-11-04T09:30:00-05:00,45.79,46.02,45.31,45.53,15186224,15868505.2,70.73395097484239,66.31073835485806,NaN,NaN,129.59753336223616,142.0688450326517,0.1846506794254188,0.7591714608418698,0.574520781416451,253123115,244181864.6,88.98963623099213,75.48796004623924,NaN,NaN,37.04430597054133,24.652794492818487
2014-11-05T09:30:00-05:00,45.5,46.61,45.5,46.56,21545124,16066934.15,76.89539576690217,68.0938156770894,NaN,NaN,152.61971074194838,149.21190101986844,0.21989406940932832,0.8493883681781114,0.629494298768783,274668239,258072652.2,90.58649210218915,78.39521873020213,NaN,NaN,40.1607605870267,26.868218220562518
2014-11-06T09:30:00-05:00,46.5,46.5,45.5,45.77,37091101,17132782,65.50435982294128,68.84284699327817,NaN,NaN,116.52147866533876,141.26302506337237,0.17430179921921096,0.8473715477927968,0.6730697485735858,237577138,257771738.8,90.28102820473072,81.01977220113618,NaN,NaN,38.561246698223336,28.538650860228348
2014-11-07T09:30:00-05:00,45.89,46.26,45.73,46.25,11786950,16808392.9,68.55258257676444,69.35238517966583,NaN,NaN,114.83613002781728,133.6065518854349,0.16108448941039577,0.8744253603365806,0.7133408709261848,249364088,256608383.8,89.03107577855982,83.01270640662399,NaN,NaN,38.390288327586994,29.94602764127958
2014-11-10T09:30:00-05:00,46.19,46.53,46.025,46.48,9434868,16424457.7,69.924012645211,69.8581973112226,NaN,NaN,118.8344141853012,126.48185339652835,0.1525304906922914,0.904003984291549,0.7514734935992576,258798956,254706307.2,86.91233021276,84.53380913593989,NaN,NaN,38.731500433110945,31.201095182969777
2014-11-11T09:30:00-05:00,46.47,46.56,46.135,46.31,5562986,15602171.75,67.57815955755945,70.01928092004967,NaN,NaN,103.9440371195206,121.35115414798524,0.12147306640101097,0.9033148266005213,0.7818417601995103,253235970,254728878.2,86.91630922191459,85.55136018500161,NaN,NaN,38.222606893603114,32.20416828448882
2014-11-12T09:30:00-05:00,46.37,46.37,45.29,45.5,18059357,15362353,57.65339652013877,69.41979474985224,NaN,NaN,57.87457242876786,102.40212648534911,0.03681884589247075,0.8278653175650987,0.791046471672628,235176613,246830553,77.98172511223625,85.62538648830193,NaN,NaN,34.28262902118305,32.50109124687371
2014-11-13T09:30:00-05:00,45.56,45.745,45,45.13,15116320,15074389.9,53.76880331708099,68.28159114783318,NaN,NaN,22.43833824120387,83.58549840052214,-0.04899523953674123,0.7298024222517014,0.7787976617884427,220060293,243327184,74.33180547847238,85.21852851853471,NaN,NaN,29.765190830527445,32.110248330252816
2014-11-14T09:30:00-05:00,45.02,45.16,44.84,44.94,7847804,14685995.75,51.83728232273875,67.13621124647038,NaN,NaN,-10.416723003393814,58.534927794279916,-0.11943894011985567,0.6294989866386231,0.7489379267584788,212212489,235896864.2,67.15285060607678,84.17578649860738,NaN,NaN,25.547119250860707,31.17265846176823
2014-11-17T09:30:00-05:00,44.99,45.61,44.865,45.53,8562380,14590384,57.00257148682717,66.17475543093595,NaN,NaN,13.461382899136206,37.46032153704694,-0.12650600278569135,0.5908054232763646,0.717311426062056,220774869,228292046.8,60.69207718075222,82.55878892843894,NaN,NaN,23.627845192435455,30.09482799472069
2014-11-18T09:30:00-05:00,45.64,45.89,45.38,45.66,6686745,14420323.6,58.06963033093364,65.63116976007625,NaN,NaN,38.06447604760711,24.28440932266423,-0.1225471420980132,0.5641274984395395,0.6866746405375527,227461614,223137175.6,56.70928247261291,80.63570177045578,NaN,NaN,22.43998593507617,29.001279129057185
2014-11-19T09:30:00-05:00,45.54,45.75,45.32,45.62,12133414,14329566.6,57.59599997238087,64.52419392569924,NaN,NaN,23.237911530696525,17.35707714304997,-0.12245466940236649,0.5336063037845946,0.6560609731869611,215328200,219167493,53.78231394870221,78.41154293208585,NaN,NaN,21.35191501475142,27.908512827013503
2014-11-20T09:30:00-05:00,45.48,45.74,45.33,45.52,8315127,14272187.65,56.358418050496056,63.32426794338381,NaN,NaN,12.102880342135123,15.289985563236224,-0.128340382234706,0.49563549539357865,0.6239758776282847,207013073,216558049,51.886502347133586,75.9545742212841,NaN,NaN,20.103813324846666,26.793555755275385
2014-11-21T09:30:00-05:00,45.72,45.93,45.29,45.7,14876724,14484824.15,58.103502854152616,62.11271901421212,NaN,NaN,21.27997888829838,21.62932594157466,-0.11950310758629301,0.47459699314541837,0.5941001007317114,221889797,218493510.6,53.20410574325097,73.46125247431313,NaN,NaN,19.535629922989934,25.756709207806036
2014-11-24T09:30:00-05:00,45.76,45.8259,45.27,45.32,11731260,14655749.25,53.26149817139919,60.864686671109034,NaN,NaN,-14.067629379026089,16.123523485942204,-0.13736653413929745,0.4223919330575896,0.559758467196887,210158537,216370244.2,51.53670855095581,70.78604335431054,NaN,NaN,17.644547460692152,24.59782895821834
2014-11-25T09:30:00-05:00,45.34,45.4,45.0432,45.32,13110640,14772574.2,53.26149817139919,59.17655112857311,NaN,NaN,-65.01055126902865,-4.491481977384942,-0.14646521422057013,0.37667694942117436,0.5231421636417445,210158537,212909628.8,48.849580933382036,67.80483541368145,NaN,NaN,16.099646992742073,23.383802963150302
2014-11-26T09:30:00-05:00,45.3,45.66,45.3,45.52,6826506,14348428.4,55.52387824062968,58.463659586979425,NaN,NaN,-32.76183564423546,-15.691431412371339,-0.13649599655639755,0.3525221679462476,0.4890181645026451,216985043,213240997.4,49.1231296631106,64.86498551785144,NaN,NaN,15.375830892735125,22.23980695309099
2014-11-28T09:30:00-05:00,45.56,46.21,45.56,46,7794600,13044788.2,60.46948090099758,57.886295181567505,NaN,NaN,57.788651039498326,-6.5542772728987,-0.09691794499985285,0.36787073325282904,0.4647886782526819,224779643,216794311.4,52.082418230416984,62.22579569298409,NaN,NaN,16.132327368831877,21.3673098696254
2014-12-01T09:30:00-05:00,45.91,46.47,45.625,46.09,19175258,13198593.2,61.33757608062845,57.27297828409731,NaN,NaN,79.7459947117118,5.138925891783986,-0.06552439012797384,0.3828831905927146,0.4484075807206884,243954901,221207332.2,55.54111557215322,59.984994647226465,NaN,NaN,17.004261789458187,20.74401728674437
2014-12-02T09:30:00-05:00,46.01,46.54,45.81,46.4,13333136,13208826.2,64.24975291481401,57.03523495247265,NaN,NaN,105.22208712113341,28.996869191815883,-0.026717191860562317,0.41501109089498556,0.4417282827555479,257288037,230633232.2,61.8716105102447,58.1960875963929,NaN,NaN,18.599761343668835,20.43769500916215
2014-12-03T09:30:00-05:00,46.43,46.45,46,46.27,8177458,12858387.9,62.1360749388102,57.35542626809204,NaN,NaN,90.5724196379853,60.11346337321868,-0.013316481193191732,0.42508268126405824,0.43839916245724997,249110579,238423640.6,66.16032704960827,57.35170202049091,NaN,NaN,19.366243487715536,20.28463050609835
2014-12-04T09:30:00-05:00,46.25,46.47,46.02,46.23,13866563,12474459.85,61.46603012936937,57.90522818325549,NaN,NaN,90.17689619582227,84.70120974123022,-0.01076861144700142,0.4249383981484982,0.43570700959549963,235244016,242075435.2,67.97856402332403,56.89789905940888,NaN,NaN,19.8284759046182,20.219465563029758
2014-12-05T09:30:00-05:00,45.76,46.07,45.64,45.87,17074411,11473625.35,55.64968783966219,58.17754286303573,NaN,NaN,18.660815282772216,76.875642589885,-0.03555376425589096,0.3912648042756359,0.4268185685315269,218169605,240753427.6,66.58378596574155,56.85725158509923,NaN,NaN,18.636655926720668,19.993349900699886
2014-12-08T09:30:00-05:00,45.87,46.42,45.86,46.24,12105964,11489576.05,59.854403339429396,58.38124513822161,NaN,NaN,76.84466541136503,76.29537672981564,-0.029503518600469847,0.3899391702809396,0.41944268888140945,230275569,238017561.2,63.67220656507311,57.07011796969357,NaN,NaN,18.776257683810275,19.81947958400137
2014-12-09T09:30:00-05:00,45.97,46.579,45.97,46.47,10511554,11543410.35,62.2502800414948,58.67986297469026,NaN,NaN,108.48613821928402,76.94818694944577,-0.01331063489100659,0.4028043952676512,0.4161150301586578,240787123,234717378.4,60.249710845953274,57.32300571064644,NaN,NaN,19.58745380560115,19.78633304422991
2014-12-10T09:30:00-05:00,46.45,46.79,45.87,45.89,9414434,11735982.75,53.568291925194686,58.3921695427484,NaN,NaN,82.2425243444943,75.28220789074757,-0.043271369929272274,0.36202581774706744,0.4052971876763397,231372689,231169800.4,56.720239129827846,57.532857509298275,NaN,NaN,17.647401801858166,19.480771438176802
2014-12-11T09:30:00-05:00,45.75,46.71,45.4,46.35,9716789,11318854.35,58.510597356543485,58.545896636037504,NaN,NaN,68.67298410484487,70.98142547255209,-0.034120713240622824,0.3626462961255612,0.39676700936618403,241089478,232338892.8,57.601703404577556,57.941086156258564,NaN,NaN,17.528871113338862,19.201928534628525
2014-12-12T09:30:00-05:00,46.24,46.609,45.91,45.91,10963137,11111195.2,52.729046298791246,58.16200688208312,NaN,NaN,60.69830205258911,79.38892282651548,-0.05829361590399251,0.32389998948619336,0.3821936053901859,230126341,234730240,59.422187848072916,58.38523487803156,NaN,NaN,15.540424266890392,18.67885649638022
2014-12-15T09:30:00-05:00,46.02,46.19,45.2767,45.52,11037096,11270659.8,48.18427746332108,57.79934826007754,NaN,NaN,-41.72406042032338,55.675177660177795,-0.09876215035002422,0.2587409174526556,0.3575030678026798,219089245,232492975.2,56.95811464356099,58.7724781703605,NaN,NaN,12.368988980650963,17.77744685127604
2014-12-16T09:30:00-05:00,45.45,46.2,45.13,45.48,14841746,11584628.1,47.729883737598925,57.40423294337752,NaN,NaN,-59.73017322672679,22.031915370975625,-0.12476176239747294,0.20155086480583861,0.32631262720331156,204247499,225185050.4,49.70730434050047,58.833744128011816,NaN,NaN,9.725194230711272,16.627125048338215
2014-12-17T09:30:00-05:00,45.63,46.4,45.54,46.29,18697436,12185162.65,56.645832041293176,57.484372500567765,NaN,NaN,41.33724361311828,13.850859224700423,-0.08580022003102128,0.21906235216453496,0.30486257219555624,222944935,223499499.6,48.183729441452726,58.76664411217911,NaN,NaN,10.273822461386047,15.719510393059334
2014-12-18T09:30:00-05:00,46.5,47.22,46.31,47.2,14663679,12311675.9,64.06241730374262,57.741010815049556,NaN,NaN,197.4637003023672,39.60900246420488,-0.0015873905775631303,0.3028783339736023,0.30446572455116544,237608614,222803326.8,47.535657835439764,58.44187551253788,NaN,NaN,13.493422480912724,15.401497834181248
2014-12-19T09:30:00-05:00,46.96,47.17,46.61,46.86,17981988,12795018.95,59.93680036761716,57.64095540697732,NaN,NaN,171.33400095718812,61.736142245124675,0.026805031496012655,0.33797201392118126,0.3111669824251686,219626626,220703383.8,45.545694607559454,57.72791687220975,NaN,NaN,14.595812248401488,15.286399893355568
2014-12-22T09:30:00-05:00,46.99,47.02,46.58,46.98,11300706,12616218.05,60.89402896712876,57.40126083928551,NaN,NaN,151.45271006887748,100.37149634296485,0.04801695723076749,0.371188178963628,0.3231712217328605,230927332,223071001.2,48.17968560446746,56.7499222360828,NaN,NaN,15.770341045466447,15.355534343657123
2014-12-23T09:30:00-05:00,46.71,47.35,46.71,47.1,9581141,12508712.1,61.87501846941736,57.382613948614605,NaN,NaN,171.11006953335482,146.53954489498116,0.06350688241326125,0.40255482474943705,0.3390479423361758,240508473,230323196,55.31037324301079,55.974925535611554,NaN,NaN,17.01449274115659,15.592528400442761
2014-12-24T09:30:00-05:00,47,48.0865,47,47.97,14412378,12573799,68.11917193983396,57.85783836364778,NaN,NaN,233.18109734636698,184.9083156416309,0.12231686386132046,0.4919440221628264,0.36962715830150594,254920851,236718379.2,60.475342033762956,55.438981107785764,NaN,NaN,20.297155614168222,16.26461800240354
2014-12-26T09:30:00-05:00,47.95,48.76,47.95,48.55,19854060,13225176.7,71.4735021140595,58.98811081181901,NaN,NaN,254.69950953079348,196.35547748731616,0.18641019353926724,0.60263990022559,0.41622970668632275,274774911,244151638.6,65.47063081878731,55.35947002586045,NaN,NaN,24.23427091172022,17.40313984659164
2014-12-29T09:30:00-05:00,48.58,49.33,48.55,49.11,24520945,14061493.95,74.28657427592299,60.018980164425706,NaN,NaN,240.28787200422497,210.14625169672354,0.24875392546698583,0.7271721135200551,0.47841818805306924,299295856,260085484.6,73.26941571557649,56.04498496518213,NaN,NaN,28.502772139267744,18.988801602688227
2014-12-30T09:30:00-05:00,49.07,49.08,48.02,48.09,13015365,13753499.3,62.246151219920506,60.01868524859896,NaN,NaN,149.22855487310747,209.70142065756954,0.20533401262862327,0.7350857038388483,0.529751691210225,286280491,271156116.4,77.13371218358687,57.25098506072738,NaN,NaN,27.807571913701203,20.248625932832937
2014-12-31T09:30:00-05:00,48.21,48.29,47.16,47.22,15156539,13844669.45,54.17987356925679,60.06236965174626,NaN,NaN,66.97507269326245,188.87442128955107,0.10700429163523861,0.6635070557542733,0.5565027641190347,271123952,277279212.2,78.9465870429501,58.83858134023611,NaN,NaN,24.163550216398086,20.8079008304851
2015-01-02T09:30:00-05:00,47.67,47.67,46.905,47.44,16914688,14281530.95,55.74173729058513,59.86459393274923,NaN,NaN,43.56372428000461,150.95094667627856,0.04873014226255079,0.6174154419472231,0.5686852996846723,288038640,283902770,80.72664611923952,60.49036296271197,NaN,NaN,21.939654130692926,20.96957987337193
2015-01-05T09:30:00-05:00,47.6,47.6,46.65,46.86,23911847,14783795.15,50.82317017786437,59.72845992411159,NaN,NaN,14.91387920309263,102.99382061073841,-0.03254832052552259,0.527999899027769,0.5605482195532916,264126793,281773146.4,78.4305330159087,61.84810190327166,NaN,NaN,18.387816600891078,20.60075654873181
2015-01-06T09:30:00-05:00,46.88,47.72,46.86,46.89,19393661,14899757.65,51.063699033188044,59.93413289338781,NaN,NaN,20.700233562205874,59.076292922334574,-0.08498173083400629,0.45432105601078376,0.53930278684479,283520454,278618066,75.02582847158439,63.138652890987615,NaN,NaN,15.746352006150202,19.907270185505865
2015-01-07T09:30:00-05:00,47.18,47.545,46.8,47.35,14322260,15010572.45,54.72071983122196,60.43347832864659,NaN,NaN,23.467941149968194,33.92417017770672,-0.08895168906313178,0.42811317551587535,0.5170648645790071,297842714,280930510.6,75.85319791252142,65.00621671756053,NaN,NaN,14.712112236641655,19.16510476423955
2015-01-08T09:30:00-05:00,47.63,47.86,47.51,47.68,14027702,15186379.85,57.192215399355305,60.47250571136532,NaN,NaN,60.14287934878945,32.557731508812154,-0.07043114005543466,0.4290259395097138,0.49945707956514845,311870416,289079803.4,78.55010963533867,67.17524387426667,NaN,NaN,14.63801750550266,18.518378012991423
2015-01-09T09:30:00-05:00,47.69,47.81,47.13,47.38,8922696,15161792.95,54.290998811864576,59.774547247659754,NaN,NaN,32.11338038349152,30.267662729509546,-0.07882945599815916,0.4009202595674495,0.47974971556560864,302947720,292061619.4,79.45432747720722,69.45514884867865,NaN,NaN,13.685886918876195,17.828022142403533
2015-01-12T09:30:00-05:00,47.43,47.59,46.96,47.27,10875034,15219705.2,53.22485971132528,59.29512291506747,NaN,NaN,10.878462479688542,29.460579384828726,-0.09135471698631231,0.36555631933271826,0.4569110363190306,292072686,297650798,81.06553972894696,71.99228064306347,NaN,NaN,12.600169881366577,17.08118610511254
2015-01-13T09:30:00-05:00,47.52,48.14,47.16,47.4,15979465,15470521.6,54.36541282991089,58.828793190980484,NaN,NaN,36.487024604728916,32.61793759333332,-0.09028561710331029,0.34405401493989274,0.43433963204320303,308052151,302557137.4,82.37237397183745,74.43461552644703,NaN,NaN,12.024475678181181,16.358798901265203
2015-01-14T09:30:00-05:00,47.4,47.88,47.09,47.81,15463036,15691818.6,57.8557244135208,58.54170075841644,NaN,NaN,32.138381598049996,34.35202568294968,-0.06267715412204627,0.35599318939064517,0.41867034351269145,323515187,307691632,83.64457082685803,76.45848678243613,NaN,NaN,12.525630455704121,15.811203409042191
2015-01-15T09:30:00-05:00,47.89,48.32,47.75,48.19,14540238,15676743.2,60.844845049173,58.022105980512094,NaN,NaN,86.26749519005361,39.576948851202516,-0.021653289755997673,0.3916037313176943,0.413257021073692,338055425,312928633.8,84.84589569301593,78.1992406152399,NaN,NaN,13.831010305691875,15.528318679992147
2015-01-16T09:30:00-05:00,48.18,48.64,48.04,48.62,12988726,15391307.7,63.95986479175081,57.48541760034719,NaN,NaN,122.1932669430031,57.592926163104835,0.028868784957977234,0.4493430022711635,0.4204742173131863,351044151,322547920,86.7683550507214,79.72050663180663,NaN,NaN,15.89202443287561,15.580276644689784
2015-01-20T09:30:00-05:00,48.76,48.91,48.27,48.74,11238778,15220062.65,64.80144244834625,56.80790818409169,NaN,NaN,129.53230574089147,81.32369481534542,0.06284642968288828,0.49903225441679666,0.4361858247339084,362282929,336589968.6,88.96842599992624,80.84186450926018,NaN,NaN,17.83526595362084,15.902417974537078
2015-01-21T09:30:00-05:00,48.69,49.28,48.28,49.21,13822176,15012072.05,67.95743754522763,57.215857207327915,NaN,NaN,139.55034148123408,101.93635819064646,0.10686612453806921,0.5697684804064949,0.46290235586842565,376105105,350200559.4,90.59992033667814,81.80373652019526,NaN,NaN,20.484055171857698,16.55693757415431
2015-01-22T09:30:00-05:00,49.34,49.48,48.651,49,17531147,15323594.1,65.14676390204113,57.999206516812514,NaN,NaN,131.3366002027598,121.7760019115884,0.11123281581402322,0.6019433756359547,0.49071055982193146,358573958,357212313.6,91.31271819664695,82.68703160260218,NaN,NaN,21.909459026302446,17.321583495889758
2015-01-23T09:30:00-05:00,49.16,49.38,48.98,49.14,7095287,15199301.4,66.15184667746126,58.74278575873224,NaN,NaN,126.09036394676974,129.74057566293163,0.11259952372941162,0.631459964483696,0.5188604407542844,365669245,362735077.6,91.83772003624513,83.48067973953117,NaN,NaN,23.38415658865008,18.18766536628409
2015-01-26T09:30:00-05:00,49.1,49.15,48.66,49.11,8129107,14885137.85,65.71452800863801,59.80645417521607,NaN,NaN,93.4572046485337,123.99336320403776,0.10090861516630723,0.6449962097121684,0.5440875945458612,357540138,364034275,91.96080159940246,84.44712749549501,NaN,NaN,24.490481288311393,19.088067640859418
2015-01-27T09:30:00-05:00,48.99,49.44,48.89,49.18,8746036,14329736.65,66.2747659101696,60.892958952143324,NaN,NaN,103.64300900598877,118.81550385705722,0.0877980775438314,0.6538351914756504,0.566037113931819,366286174,364834924,92.04045811313847,85.66245818417744,NaN,NaN,25.572602223986674,20.01442972416331
2015-01-28T09:30:00-05:00,49.21,49.78,48.63,48.76,13695256,13788452.2,59.94547979498268,61.26615609241195,NaN,NaN,92.1085694944097,109.32714945969235,0.043014255126923695,0.6198049328404736,0.5767906777135499,352590918,360132086.6,86.61185172839015,86.43093345673948,NaN,NaN,24.842833427033472,20.704201681716192
2015-01-29T09:30:00-05:00,48.64,49.5,48.4801,49.41,12044792,13739923.55,65.4454519703429,61.855672990339635,NaN,NaN,90.39691072043412,101.1392115632272,0.04891273548379638,0.6379315970682953,0.5890188615844989,364635710,361344437,86.82754137787607,87.02217858120643,NaN,NaN,25.76979652239438,21.427858087527362
2015-01-30T09:30:00-05:00,49.35,49.35,48.26,48.32,14915879,13727890.55,52.44134328006402,61.72355473806817,NaN,NaN,41.874562379237396,84.29605124972075,-0.024885523808114707,0.5579119568243556,0.5827974806324703,349719831,358154554.2,83.03691277301311,87.27807753090687,NaN,NaN,22.297155815984716,21.552043477306984
2015-02-02T09:30:00-05:00,48.31,48.71,47.81,48.53,22399250,14002118.65,54.324397746753846,61.8020931691702,NaN,NaN,11.432995234778328,67.89120936696966,-0.061747846725988764,0.5056126722249843,0.5673605189509731,372119081,361070342.8,83.73586993725111,87.46881540292858,NaN,NaN,20.112732347447473,21.346427601612767
2015-02-03T09:30:00-05:00,48.44,48.88,48.22,48.71,16159479,13614500.25,55.93491652632455,61.91420057605689,NaN,NaN,30.571234971583923,53.276854560088694,-0.07530085049470148,0.47323445583259627,0.5485353063272977,388278560,365468820,84.75626434368904,87.63909328663226,NaN,NaN,18.836992001587173,20.98793680160911
2015-02-04T09:30:00-05:00,48.57,48.8,48,48.12,13859042,13337769.3,49.74360119575099,61.33476320335905,NaN,NaN,-6.8401757756086266,33.48710550608503,-0.1225015290139615,0.39540839505984593,0.5179099240738074,374419518,369834540,85.71429028338612,87.78693039067,NaN,NaN,15.724933750980375,20.23607922294786
2015-02-05T09:30:00-05:00,48.26,48.66,47.98,48.56,13165348,13279923.7,53.84649230422221,60.834880864434,NaN,NaN,-3.15052535353096,14.777618291292011,-0.12230618114335973,0.3650271976446078,0.4873333787879675,387584866,374424371.2,86.66327776650697,87.91674339591934,NaN,NaN,14.409287400975476,19.403680391237522
2015-02-06T09:30:00-05:00,48.25,48.35,46.27,46.56,32184203,14187748.75,38.47188343151928,59.0143107672746,NaN,NaN,-162.53902874614033,-26.10509993378353,-0.24785050179165313,0.17752025154840112,0.42537075334005425,355400663,375560537.6,86.8953451792448,87.92581411938531,NaN,NaN,6.9552183759005155,17.625328674760805
2015-02-09T09:30:00-05:00,46.46,46.79,45.93,46.15,19742158,14728721.85,36.19059140147713,56.97067854964109,NaN,NaN,-220.94740092989986,-72.58117916671918,-0.343589783046201,-0.004116475467697001,0.339473307578504,335658505,368268422.4,77.56635376077918,87.11138038801765,NaN,NaN,0.401205266945339,15.164739616501453
2015-02-10T09:30:00-05:00,46.11,47.17,46.05,47.1,20891073,15229523.8,44.415244127867396,55.28909330554393,NaN,NaN,-157.73373040784034,-110.24217224260403,-0.3280538982946347,-0.0705940652897894,0.2574598330048453,356549578,361922626,70.47557247871003,85.67392696959136,NaN,NaN,-1.897826780064027,12.727230131277814
2015-02-11T09:30:00-05:00,46.91,46.91,45.97,46.08,19543113,15407706.2,38.65432020753707,53.39677589879364,NaN,NaN,-174.51746432715038,-143.77762995291238,-0.36856040852725364,-0.2032406776542217,0.16531973087303192,337006465,354440015.4,63.145401025473404,83.66197574307897,NaN,NaN,-6.022218187266161,10.04873751434296
2015-02-12T09:30:00-05:00,46.17,46.21,45.71,45.87,20581996,15663654.2,37.57376101711792,51.35548406591197,NaN,NaN,-174.67678871928996,-178.0828826260642,-0.3895374565986759,-0.3216020898753129,0.06793536672336295,316424469,340207936,52.055197514208906,80.82036699150497,NaN,NaN,-9.502000369638031,7.255774959488533
2015-02-13T09:30:00-05:00,45.77,45.84,44.81,45.17,32654264,16569355.5,34.147124146040085,49.10066950429784,NaN,NaN,-174.67709134633174,-180.51049514610244,-0.4275569852249204,-0.4665108648077876,-0.03895387958286717,283770205,325881844.4,43.729568885839676,77.37527894053619,NaN,NaN,-13.559377059525495,4.2821818139151
2015-02-17T09:30:00-05:00,45.03,45.6,44.73,45.13,26373673,17238602.85,33.956554526577705,46.79222583404128,NaN,NaN,-147.65265280485292,-165.85154552109307,-0.43117121700546696,-0.5779179008397008,-0.1467466838342339,257396532,310229449.8,36.80359396444682,73.42978864420108,NaN,NaN,-16.712045713270566,1.2830064528885767
2015-02-18T09:30:00-05:00,45.1,46.26,45.02,46.2,32104015,18281864.7,43.10381688768259,45.58924991209127,NaN,NaN,-96.11074273811958,-153.52694798714893,-0.34121107800417866,-0.5732605313394572,-0.23204945333527854,289500547,296819643.6,32.11125483102907,69.53688886581816,NaN,NaN,-16.323397342568413,-1.2321940893195649
2015-02-19T09:30:00-05:00,46.1,46.23,45.52,45.68,14286392,18305075.5,40.190491583632635,43.785324170183394,NaN,NaN,-85.73229945692775,-135.76991501310437,-0.2980085917755958,-0.6045601930547733,-0.30655160127917747,275214155,284461181.6,28.504333567193697,65.37094545076941,NaN,NaN,-16.983329329628248,-3.4823562665065193
2015-02-20T09:30:00-05:00,45.84,45.84,45.1,45.69,13870137,18122025,40.27409371318339,42.91623491540621,NaN,NaN,-88.45751842297787,-118.52606095384196,-0.2518750584905468,-0.621395424392361,-0.36952036590181414,289084292,278993146.2,27.056234373505788,61.372325565090314,NaN,NaN,-17.467978140575056,-5.48030224851631
2015-02-23T09:30:00-05:00,45.77,46.03,45.64,46,8988450,18216683.15,42.936954316682474,42.102846098972535,NaN,NaN,-65.41647135044491,-96.67393695466458,-0.18660342438848765,-0.6027746463874237,-0.4161712219989361,298072742,281853653.6,29.085863472129148,57.468753674724454,NaN,NaN,-17.05386467188707,-7.133668308997847
2015-02-24T09:30:00-05:00,46.06,46.59,45.86,46.34,14332512,18526853.4,45.79161228778559,41.37832436764832,NaN,NaN,-42.56380566013566,-75.65616752572113,-0.11041820951213654,-0.5541939838891068,-0.44377577437697024,312405254,292855398,36.41399415571468,54.01573437558342,NaN,NaN,-15.850350044884856,-8.378908556981706
2015-02-25T09:30:00-05:00,46.3,46.34,45.53,45.58,11891939,18684148.55,40.86984088488938,40.74448434544392,NaN,NaN,-60.52971820319287,-68.53996261873579,-0.10133409325622145,-0.570443390947247,-0.4691092976910256,300513315,295057951.6,37.79979811908335,50.5932706495618,NaN,NaN,-16.297646849699767,-9.510156884512858
2015-02-26T09:30:00-05:00,45.8,45.8,45.18,45.28,14258857,18712328.6,39.084062552939685,39.69002507749517,NaN,NaN,-77.57468598500414,-66.90843992435106,-0.1051967637837844,-0.6006052524207561,-0.49540848863697173,286254458,297266012.2,39.22968257199774,47.20515670709684,NaN,NaN,-17.20340105991464,-10.609191766713112
2015-02-27T09:30:00-05:00,45.27,45.385,45.015,45.23,12484398,18734308.9,38.779928507154075,39.71202829718337,NaN,NaN,-86.12388714059244,-66.44171366787397,-0.10077756121627057,-0.62138044015731,-0.5206028789410394,273770060,294203165.8,37.92723791484586,43.70743475963978,NaN,NaN,-18.02268969632876,-11.668262899515348
2015-03-02T09:30:00-05:00,45.2,45.2,44.05,44.36,27530000,19365014.95,33.844871827530696,39.54447689904434,NaN,NaN,-126.9981090635763,-78.75804121050024,-0.1434998948235502,-0.6999777474704771,-0.556477852646927,246240060,283836629.4,33.83295744636587,40.58362073718168,NaN,NaN,-20.267532935325853,-12.896730047488276
2015-03-03T09:30:00-05:00,44.33,44.679,44.06,44.63,18556753,19172890.1,36.54378253685442,38.982229642543416,NaN,NaN,-126.9493250697019,-95.6351450924135,-0.14045085265938828,-0.7320414184711623,-0.591590565811774,264796813,274314941.2,30.568809319385366,37.73313765437278,NaN,NaN,-21.329171437292157,-14.101364531745974
2015-03-04T09:30:00-05:00,44.53,44.53,44.23,44.38,12061968,18968014.55,35.11527668434674,38.72944081945839,NaN,NaN,-131.3452317772062,-109.79824780721614,-0.14173810401082698,-0.7687631958253078,-0.6270250918144809,252734845,264759247.2,27.68234776087705,35.200062421187326,NaN,NaN,-22.62785047798293,-15.319433952636967
2015-03-05T09:30:00-05:00,44.49,44.93,44.49,44.73,11557931,18852959,38.726496763301355,38.81177908704292,NaN,NaN,-97.4678477058085,-113.77688015137703,-0.10706213218663851,-0.760852757047779,-0.6537906248611405,264292776,260366910.8,26.44620492084576,33.37084866451853,NaN,NaN,-22.69547473639428,-16.373154064602296
2015-03-06T09:30:00-05:00,44.01,44.12,43.22,43.39,26797045,19534543.85,31.49843421059886,38.62258694879712,NaN,NaN,-187.3492212132048,-134.0219469658995,-0.1592707161378918,-0.8528790200335052,-0.6936083038956135,237495731,253112045,24.500158881812,31.997319378516558,NaN,NaN,-25.09421225643496,-17.61901952057839
2015-03-09T09:30:00-04:00,43.5,43.69,43.375,43.47,13030094,18576838.4,32.310710022466836,38.50502662707492,NaN,NaN,-168.83118887443968,-142.3885629280722,-0.17221590337399728,-0.9088781831131101,-0.7366622797391128,250525825,253969198,25.20048797121933,31.168526093286022,NaN,NaN,-26.7466442055383,-18.922965904144093
2015-03-10T09:30:00-04:00,43.35,43.91,43.27,43.39,13621964,18270828.7,31.903307776119675,37.70499026196328,NaN,NaN,-144.53331951259574,-145.90536181665098,-0.16969125743295443,-0.9487763515303058,-0.7790850940973514,236903861,248390607.6,23.6621188012888,30.565016376876006,NaN,NaN,-28.202086258087412,-20.248554526135994
2015-03-11T09:30:00-04:00,43.24,43.64,43.01,43.11,9988222,17725686.15,30.45586760593453,37.009659977841984,NaN,NaN,-143.5048342915368,-148.3372823195171,-0.169979537931797,-0.9915595165120976,-0.8215799785803006,226915639,243226766.4,22.30479654605375,30.12219230393743,NaN,NaN,-29.845388369592513,-21.619530789486927
2015-03-12T09:30:00-04:00,43.4,44.11,43.34,43.93,17078981,17602479.55,39.1612121527286,36.93016843780949,NaN,NaN,-88.4246374541725,-146.52864026918988,-0.10142894613790254,-0.9483661612526788,-0.8469372151147763,243994620,239167135.2,21.271724918014243,29.70901305711661,NaN,NaN,-28.692885479057672,-22.630010030854177
2015-03-13T09:30:00-04:00,43.87,43.87,43.08,43.48,13984125,17272586,36.463664484918596,36.4677905926835,NaN,NaN,-101.66843324304638,-129.3924826751582,-0.07414227408103358,-0.9396150577160682,-0.8654727836350347,230010495,237670088,20.887528927983993,29.123417732534815,NaN,NaN,-28.523769373741313,-23.471975651266625
2015-03-16T09:30:00-04:00,43.8,44.55,43.73,44.23,12807895,16280267.55,43.45472061392702,36.30086975883646,NaN,NaN,-42.925602953889644,-104.2113654910482,0.002600741882599733,-0.8622218562817849,-0.8648225981643847,242818390,236128601,20.4774059371929,27.985090002640398,NaN,NaN,-26.15886633370339,-23.85581717732902
2015-03-17T09:30:00-04:00,44.11,44.42,44.01,44.16,9188401,15421003.95,42.97938291269691,36.45155133225128,NaN,NaN,-37.10095248578354,-82.72489208568575,0.05398262842244095,-0.7973443126363335,-0.8513269410587745,233629989,235473826.6,20.29511916067463,26.734755791325487,NaN,NaN,-24.40658854624366,-23.934498801459682
2015-03-18T09:30:00-04:00,44.15,45.63,44.02,45.35,23726478,15002127.1,52.49319789604713,37.40934671390182,NaN,NaN,30.967502537237085,-47.83042471993098,0.16706234604973402,-0.6424990084966069,-0.8095613545463409,257356467,241561992.2,26.818337922725973,25.848231173520357,NaN,NaN,-19.62471750682699,-23.318815759369297
2015-03-19T09:30:00-04:00,45.1,45.65,44.81,44.93,13161527,14945883.85,49.36273192016582,38.165261243402654,NaN,NaN,46.77154902618085,-20.79118742386033,0.20975803563730566,-0.5473638099997089,-0.7571218456370146,244194940,241602056.2,26.860758835615457,25.057768382146755,NaN,NaN,-16.687748706908913,-22.37152046616067
2015-03-20T09:30:00-04:00,44.94,45.11,44.51,44.98,13879158,14946334.9,49.746946472781794,39.30112371806344,NaN,NaN,28.14286979113681,5.171073182976322,0.2356164224167332,-0.46260131761609813,-0.6982177400328313,258074098,247214776.8,32.74270366236313,24.979893111860843,NaN,NaN,-14.24174343119629,-21.210123746880047
2015-03-23T09:30:00-04:00,44.95,45.22,44.85,45.01,10260224,15009923.6,49.992122441254146,40.26171942552056,NaN,NaN,49.864048584308485,23.729003490615945,0.24775260386148845,-0.38852698520597073,-0.6362795890674592,268334322,252317963.2,37.65227734858221,25.485855113946336,NaN,NaN,-12.194927423812443,-19.92223855787039
2015-03-24T09:30:00-04:00,44.99,45.22,44.4,44.51,10629292,14824762.6,45.96686414509753,41.03683281557419,NaN,NaN,29.833903962155645,37.115974780203786,0.21626373403759325,-0.36594992152046757,-0.5822136555580608,257705030,257132971.4,41.95745527397612,26.505505650596266,NaN,NaN,-11.565964798810297,-18.728485163718947
2015-03-25T09:30:00-04:00,44.61,44.81,43.95,43.99,14157940,14938062.65,42.164472295039786,41.28240249641266,NaN,NaN,-13.384897771686665,28.245494718419042,0.15731296375336412,-0.3855724508663556,-0.5428854146197197,243547090,254371096,40.24100562074134,27.490848557731663,NaN,NaN,-12.144026482709718,-17.787848209289056
2015-03-26T09:30:00-04:00,43.88,44.17,43.49,43.62,12700114,14860125.5,39.65113551894132,41.8647383041514,NaN,NaN,-65.54724791957838,5.781735329267195,0.09345400458297048,-0.42606790889100665,-0.5195219134739771,230846976,251701503.2,38.59737101163961,28.497792281290778,NaN,NaN,-13.38004287917753,-17.15816173355884
2015-03-27T09:30:00-04:00,43.7,44.14,43.57,43.88,6778419,14574826.55,42.25589701387006,42.57510880353734,NaN,NaN,-46.450431130775634,-9.136924855115293,0.06985840749266903,-0.4321989041081409,-0.5020573116008099,237625395,247611762.6,36.16063792893973,29.280660135413665,NaN,NaN,-13.668389565378359,-16.6596228523902
2015-03-30T09:30:00-04:00,44.12,44.59,43.87,44.42,8477542,13622203.65,47.339684762591965,43.67770715971393,NaN,NaN,13.134574431535817,-16.482819685669828,0.09044575033993435,-0.389000123675892,-0.47944587401582633,246102937,243165485.6,33.6717712499765,29.99563531031993,NaN,NaN,-12.416788497535482,-16.053503658839524
2015-03-31T09:30:00-04:00,44.29,44.84,44.1,44.43,10209652,13204848.6,47.431982762726435,44.8902868137705,NaN,NaN,35.57158394870193,-15.335283688360567,0.10361737545958027,-0.34992415469135096,-0.45354153015093124,256312589,242886997.4,33.51616935125939,30.796447653548906,NaN,NaN,-11.375931883730681,-15.38527911953826
2015-04-01T09:30:00-04:00,44.3,44.59,43.77,44.47,17289675,13466233.95,47.8259031436976,45.50919331312543,NaN,NaN,11.666290894158172,-10.3250459551916,0.11312885897624103,-0.31213045643063,-0.425259315406871,273602264,248898032.2,39.96499463723012,32.13168120492147,NaN,NaN,-10.407271846942725,-14.674135223453185
2015-04-02T09:30:00-04:00,44.4,44.75,44.35,44.55,11268647,13451769.75,48.654613865892415,46.37997541176642,NaN,NaN,51.55129582972667,13.094662794669409,0.12214249196143934,-0.27258120045507184,-0.3947236924165112,284870911,259702819.2,49.4555145941069,34.17225160964453,NaN,NaN,-9.372259108931846,-13.916724349950137
2015-04-06T09:30:00-04:00,44.74,45.44,44.69,45.17,12495131,12736674.05,54.66458027473637,47.180679673252804,NaN,NaN,116.4672562279561,45.67820026641576,0.16455472335854787,-0.18903028821832635,-0.3535850115768742,297366042,271650948.6,57.463380875422054,36.81410696237519,NaN,NaN,-6.730838944005549,-12.890169291958053
2015-04-07T09:30:00-04:00,45.16,45.18,44.62,44.65,6920044,12431171.55,49.43788869935105,47.642001515156664,NaN,NaN,69.26712280453364,56.90470994101533,0.15255003969647218,-0.16289746195628396,-0.31544750165275615,290445998,280519560.8,62.24483346755528,39.81051512715238,NaN,NaN,-5.8705240293125325,-11.887362825865836
2015-04-08T09:30:00-04:00,44.65,44.71,44.29,44.52,8958036,12197975.15,48.19718738406789,47.33514362144386,NaN,NaN,19.906883100532394,53.771769771381415,0.1316083897512219,-0.15093701446372876,-0.28254540421495067,281487962,285554635.4,64.67279128816435,42.51440465325512,NaN,NaN,-5.501636150235607,-10.97511615791866
2015-04-09T09:30:00-04:00,44.5,44.52,44.06,44.33,11409126,12269020.35,46.365719681405146,47.12107131867525,NaN,NaN,-21.25107112254534,47.18829736804071,0.10203399640111038,-0.1550029087135627,-0.2570369051146731,270078836,284849949.8,64.05196319106444,45.170919250072906,NaN,NaN,-5.694468853875012,-10.22073797162671
2015-04-10T09:30:00-04:00,44.49,44.84,44.29,44.66,9270730,11878607.8,49.924857348406285,47.133779238362706,NaN,NaN,23.732965855141252,41.62463137312363,0.10155173436567594,-0.13009723715757815,-0.2316489715232541,279349566,283745680.8,63.030865727810266,47.33435939760484,NaN,NaN,-4.873363765351167,-9.456827370730203
2015-04-13T09:30:00-04:00,44.57,44.663,44.18,44.22,8476376,11603220.35,45.581602266074334,46.81874208299272,NaN,NaN,-32.7779893870832,11.775582250115765,0.06995807951881078,-0.1442013721247406,-0.21415945164355138,270873190,278447110.4,58.23377218820964,48.80446617186395,NaN,NaN,-5.394096842824851,-8.876437295315153
2015-04-14T09:30:00-04:00,44.33,44.59,44.2,44.44,11025621,11514106.65,48.016703433054204,46.96515917498963,NaN,NaN,-24.49241160069631,-6.976324630930222,0.06248080748405721,-0.13605844228847985,-0.19853924977253706,281898811,276737673,56.733588816585716,49.85990428205035,NaN,NaN,-5.148326518698973,-8.343850041512841
2015-04-15T09:30:00-04:00,44.56,44.9428,44.49,44.55,9681079,11538740.55,49.239768439619,47.470537471031,NaN,NaN,25.47920682494583,-5.861859886047534,0.06334883852086928,-0.11935320162145047,-0.18270204014231975,291579890,278756058.6,58.10591623953666,51.13596932625001,NaN,NaN,-4.606372158237626,-7.809924629616382
2015-04-16T09:30:00-04:00,44.4,44.45,43.89,44.26,13567873,11030810.3,46.15651829214568,47.93520766911702,NaN,NaN,-70.5233336017059,-15.716312381879646,0.04373058988203635,-0.1280388027897743,-0.17176939267181066,278012017,280342694.8,59.20141004270822,52.60768639989777,NaN,NaN,-4.990643394054714,-7.407170167393287
2015-04-17T09:30:00-04:00,44.07,44.46,43.95,44.1,8500532,10797760.55,44.500870575944404,48.09556292355091,NaN,NaN,-71.07688303992119,-34.67828216089213,0.020496984475134428,-0.1461481620778926,-0.16664514655302703,269511485,278375078.6,57.20371506611075,54.110763338267134,NaN,NaN,-5.7728186674048185,-7.173691381680649
2015-04-20T09:30:00-04:00,44.28,45.11,44.25,44.76,9269354,10567270.35,52.128969336355006,48.43765467881969,NaN,NaN,65.0344766282606,-15.115788957823373,0.04849905503099633,-0.10602132776428164,-0.15452038279527797,278780839,279956608.4,58.41828138978479,55.8783712053963,NaN,NaN,-4.2540916115342915,-6.7566057002311695
2015-04-21T09:30:00-04:00,44.76,45.1,44.2,44.36,11699086,10639213.45,47.837560418290195,48.46662451135996,NaN,NaN,35.28404676500132,-3.160497284683845,0.03938947706707982,-0.10528353646142818,-0.144673013528508,267081753,276993196.8,55.253978832112175,57.431071882600065,NaN,NaN,-4.225642908218648,-6.395039587086524
2015-04-22T09:30:00-04:00,44.49,44.57,44.17,44.45,8748252,10545161.45,48.85771985058917,48.54032570470936,NaN,NaN,-4.332197108555499,-9.122778071384111,0.038677454597550454,-0.09632619528156994,-0.1350036498791204,275830005,273843219.8,52.02796549116327,58.292712657881005,NaN,NaN,-3.9081407410044795,-6.0397683233605175
2015-04-23T09:30:00-04:00,44.3,44.92,44.3,44.7,9218169,10298172.9,51.684418725796164,48.75674033755963,NaN,NaN,61.181206352903416,17.21812991953773,0.05338885508678848,-0.0682675810206348,-0.12165643610742327,285048174,275250451.2,53.338663365232314,58.570080427247106,NaN,NaN,-2.824177197229347,-5.580398162484636
2015-04-24T09:30:00-04:00,44.7,45.46,44.59,45.15,14541245,10390229.45,56.36005619561596,48.8778457604796,NaN,NaN,170.0681083175426,65.44712819103049,0.08963801112547679,-0.009608922200577297,-0.09924693332605408,299589419,281266038,58.551993941251006,58.64783850337774,NaN,NaN,-0.4671669436599089,-4.849936559795389
2015-04-27T09:30:00-04:00,45.27,45.34,44.47,44.61,10506597,10576638.35,50.095141542453554,48.92479239212979,NaN,NaN,85.0387684492983,69.44798655523803,0.07410258408970975,-0.006618703213916888,-0.08072128730362664,289082822,283326434.6,60.19250966637727,58.501243946150744,NaN,NaN,-0.31121499418183063,-4.201547764707738
2015-04-28T09:30:00-04:00,44.42,44.935,44.261,44.93,9747799,10640151.2,53.40083642055219,49.29648160902152,NaN,NaN,47.57792913034467,71.9067630283067,0.08163827247789322,0.02132655329373989,-0.06031171918415333,298830621,289676208.2,64.81453338157026,58.51136838139405,NaN,NaN,0.8396431163635575,-3.48137763884041
2015-04-29T09:30:00-04:00,44.6,44.89,44.37,44.74,13330960,10796216.6,51.2309325040197,49.64399681063685,NaN,NaN,30.34354811263298,78.84191207254439,0.07050637713087207,0.027821252229436766,-0.042685124901435306,285499661,291610139.4,66.10535412075487,58.65803916208622,NaN,NaN,1.1384726987941158,-2.821399019178335
2015-04-30T09:30:00-04:00,44.64,44.65,43.88,44.22,17588163,10811141,45.7515380163915,49.345902572635794,NaN,NaN,-105.74250083159347,45.457170635645014,0.02703702694321619,-0.008888841222415067,-0.03592586816563126,267911498,288182804.2,61.779729143422635,58.56867226320139,NaN,NaN,-0.3133192455172978,-2.4631019086553296
2015-05-01T09:30:00-04:00,44.12,44.49,43.94,44.47,12507400,10873078.65,48.597976930729295,49.56135790582544,NaN,NaN,-80.36395957604705,-4.62924294307291,0.014655899994753432,-0.01760599317218947,-0.032261893166942904,280418898,284348700,57.26536801307626,58.49950053640616,NaN,NaN,-0.6550983711912588,-2.204815689017605
2015-05-04T09:30:00-04:00,44.48,45.14,44.41,44.8,13323122,10914478.2,52.16586313732173,49.85772645613026,NaN,NaN,78.98567645581042,-5.839861341770492,0.02748131757187743,0.0020897537979038816,-0.025391563773973547,293742020,285280539.6,58.06734986893172,58.5947691830023,NaN,NaN,0.1437517926687188,-1.8693060487767017
2015-05-05T09:30:00-04:00,44.73,44.73,43.68,43.8,18621205,11499536.25,42.53169508447781,49.37857835933446,NaN,NaN,-137.95897775467506,-42.94724271877444,-0.029506749015813682,-0.06227500004374065,-0.032768251027926965,275120815,280538578.4,52.65228894184836,58.20522437602455,NaN,NaN,-2.398781601446407,-1.9449454134438025
2015-05-06T09:30:00-04:00,43.79,44.0002,43.13,43.56,16976140,11900441.45,40.59399934028507,48.98125557705871,NaN,NaN,-231.242534395505,-95.26445922040205,-0.07869646999618944,-0.13113883852316377,-0.05244236852697433,258144675,275067581.2,47.18504000285585,57.34691223032082,NaN,NaN,-5.078660995897622,-2.3926190680800623
2015-05-07T09:30:00-04:00,43.71,44.015,43.6,43.72,12687008,11964335.55,42.47556206999624,48.8365906837767,NaN,NaN,-153.48398144790372,-104.8127553436641,-0.09471330187216229,-0.17083399586717718,-0.0761206939950149,270831683,275651618.2,47.8080764433456,56.67579518583759,NaN,NaN,-6.643612611207401,-2.9999038599553964
2015-05-08T09:30:00-04:00,44.28,44.52,43.85,44.03,14383171,12219957.6,46.04150669659435,48.40177192379379,NaN,NaN,-63.94376848648632,-101.52871712575194,-0.07930986038350685,-0.17525801947439845,-0.0959481590908916,285214854,276610809.4,48.87477385949182,55.99411607653095,NaN,NaN,-6.849034536823854,-3.5497796709366045
2015-05-11T09:30:00-04:00,44.02,44.39,43.69,43.73,12639290,12428103.3,43.24749987892194,48.073910456696055,NaN,NaN,-97.22728539876589,-136.77130949666721,-0.08376828583178897,-0.20065851638062782,-0.11689023054883885,272575564,272377518.2,44.54745879975447,55.22936464564826,NaN,NaN,-7.879957267399407,-4.168376470431291
2015-05-12T09:30:00-04:00,43.5,43.7299,43.24,43.68,13535210,12553582.75,42.781519560960675,47.63989615029402,NaN,NaN,-151.01063922162226,-139.38164179005665,-0.08429668583623987,-0.22226108784413867,-0.1379644020078988,259040354,269161426,41.53847833205426,54.480115562854756,NaN,NaN,-8.848862056680794,-4.8370172684669335
2015-05-13T09:30:00-04:00,43.83,43.97,43.1,43.25,13979633,12768510.45,38.89969504484768,46.72670160165484,NaN,NaN,-149.66557427318554,-123.06624976559274,-0.10639270548059329,-0.2709552838586404,-0.16456257837804714,245060721,266544635.2,39.21734635651627,53.47145006223218,NaN,NaN,-10.86436400172911,-5.698066801790102
2015-05-14T09:30:00-04:00,43.47,43.87,43.43,43.75,12242708,12702252.2,45.13375742522136,45.924823118055215,NaN,NaN,-95.50168522972527,-111.46979052195707,-0.08125566357205594,-0.26613215784311706,-0.18487649427106112,257303429,263838984.4,36.92013997655174,51.92631763618224,NaN,NaN,-10.71830952638797,-6.415244333875512
2015-05-15T09:30:00-04:00,43.87,44.41,43.8,44.32,17791698,13166810.5,51.241336436676875,46.00669418192832,NaN,NaN,-13.893710121283693,-101.45977884891654,-0.02317914445162428,-0.21385042483559147,-0.1906712803839672,275095127,261815039,35.256451017237154,50.14517058981509,NaN,NaN,-8.62744001891981,-6.73127228888184
2015-05-18T09:30:00-04:00,44.1,44.57,44.1,44.49,10243631,13215524.35,52.92446723740592,45.97266781170358,NaN,NaN,24.49377431832878,-77.1155669054976,0.027024498174114703,-0.15689065766632382,-0.18391515584043852,285338758,264367677.8,38.990512217462694,48.30059764952169,NaN,NaN,-6.407269457467003,-6.684986170108292
2015-05-19T09:30:00-04:00,44.29,44.7,44.14,44.59,12908034,13275971.75,53.9318683707855,46.16559180218685,NaN,NaN,41.02817762349529,-38.707803536474096,0.06513298566684428,-0.10249892375688319,-0.16763190942372747,298246792,272208965.4,48.76576290139169,47.06205541956717,NaN,NaN,-4.301389891007576,-6.344472415951047
2015-05-20T09:30:00-04:00,44.59,44.9751,44.49,44.66,9068664,13291992.35,54.66324378736632,46.80214221439934,NaN,NaN,75.70906249126769,6.367123816416549,0.0915997731947257,-0.05313219293032034,-0.14473196612504605,307315456,284659912.4,59.78433791428599,46.91952747462884,NaN,NaN,-2.362785914390609,-5.77566005858527
2015-05-21T09:30:00-04:00,44.77,44.82,44.43,44.64,8062554,13234211.6,54.397516915927234,47.21639507048491,NaN,NaN,62.74815560025829,38.017091982413255,0.10342997182991323,-0.015444501337654515,-0.11887447316756775,299252902,293049807,65.21330417280583,47.487237200323804,NaN,NaN,-0.8340042043269627,-5.069709222262655
2015-05-22T09:30:00-04:00,44.48,44.7,44.285,44.57,8923864,12953342.55,53.41873397082289,47.30588584430642,NaN,NaN,51.9191723871124,51.179668484092474,0.10203946052565878,0.008674852489505724,-0.09336460803615305,290329038,296096589.2,66.95776386149588,48.12226677122124,NaN,NaN,0.2036057119870426,-4.3163785173698415
2015-05-26T09:30:00-04:00,44.5,44.55,44,44.29,10563852,12956205.3,49.57613831908026,47.80906036106374,NaN,NaN,14.910932134022701,49.26310004723126,0.07880107928664787,0.005136741072156781,-0.07366433821449109,279765186,294981874.8,65.66041063004597,49.05141832037822,NaN,NaN,0.10010481770021977,-3.6854523266455472
2015-05-27T09:30:00-04:00,44.33,44.55,44.24,44.47,7637755,12850703.1,51.96813043734798,48.621498296568234,NaN,NaN,46.160741654355995,50.2896128534034,0.07226359253687567,0.016665152456603494,-0.05559844008027217,287402941,292813104.6,63.09880063015607,50.188115508042515,NaN,NaN,0.6491805241718519,-3.0662190622430616
2015-05-28T09:30:00-04:00,44.45,44.68,44.29,44.57,9986942,12683502.2,53.29372600265091,49.39422429175785,NaN,NaN,67.61069101147864,48.6699385574456,0.07126649231074512,0.03348467530815924,-0.037781817002585885,297389883,290827990,60.76212152957547,51.113404442773216,NaN,NaN,1.466775701424732,-2.418648381719091
2015-05-29T09:30:00-04:00,44.48,44.7,44.33,44.5,9160483,12262118.2,52.207556408571016,49.834656414041895,NaN,NaN,62.08891160337865,48.53808975806966,0.06278283506328855,0.04069672682652481,-0.022086108236763744,288229400,288623289.6,58.18498414502689,51.778419463168575,NaN,NaN,1.8863521213081178,-1.8036483098580613
2015-06-01T09:30:00-04:00,44.62,44.83,44.42,44.56,8839059,12078701.15,53.09007564928104,50.53769754049612,NaN,NaN,74.41169862802982,53.036595006253165,0.05820467776059133,0.05066973896397542,-0.007534938796615912,297068459,289971173.8,59.32094453300863,52.8336684441153,NaN,NaN,2.4682191132033555,-1.1933815351350017
2015-06-02T09:30:00-04:00,44.32,44.36,43.66,43.97,12151348,12020112.45,44.40652770281925,50.653769550628866,NaN,NaN,-34.072384512540125,43.23993167694059,0.014700265016317878,0.010840392473781435,-0.0038598725425364427,284917111,291001558.8,60.210816603643536,54.167406892085964,NaN,NaN,0.5759596547362494,-0.9406185080105373
2015-06-03T09:30:00-04:00,43.8,43.98,43.08,43.32,23362547,12257179.55,37.18961331345905,50.53162085552968,NaN,NaN,-122.12265201263406,9.583252943542579,-0.054784362014753056,-0.07234032506097776,-0.017555963046224705,261554564,285831883.4,53.84635780761756,55.21233628145034,NaN,NaN,-3.5051320914212565,-1.3069775913549257
2015-06-04T09:30:00-04:00,43.37,43.56,43.175,43.26,13300890,12073417.05,36.59833943120432,49.92194814167131,NaN,NaN,-138.13954700655722,-31.56679466006459,-0.09913309877832366,-0.14147233651912927,-0.04233923774080562,248253674,276004641.6,44.267295430541076,55.73713309959243,NaN,NaN,-6.978310850679606,-2.117168056972737
2015-06-05T09:30:00-04:00,42.7,42.9,42.55,42.72,15918777,12235005.5,31.711666314359462,48.52697170436293,NaN,NaN,-201.4428012817336,-84.27313723708704,-0.15580884666919648,-0.2371002960773012,-0.08129144940810473,232334897,264825741,36.34631125256603,55.81498025925878,NaN,NaN,-11.706403993815929,-3.487058905093193
2015-06-08T09:30:00-04:00,42.76,42.76,42.44,42.47,7917693,11911731.6,29.732363363622085,46.87039285623551,NaN,NaN,-181.65152290088074,-135.48578154286915,-0.19837764757851986,-0.32926350888125455,-0.1308858613027347,224417204,250295490,29.06613158424743,55.10609592831482,NaN,NaN,-16.28488579227529,-5.31531988897635
2015-06-09T09:30:00-04:00,42.4,42.63,42.37,42.37,10268423,11793188.25,28.953888172926327,45.086251413531286,NaN,NaN,-158.30590253193068,-160.33248514674727,-0.21984816817235525,-0.40569607151817877,-0.18584790334582352,214148781,236141824,24.01926350836564,53.33848882881296,NaN,NaN,-20.245880539735577,-7.448257124799096
2015-06-10T09:30:00-04:00,42.75,42.9,42.57,42.58,11091005,11670978,32.925586092817426,43.53356157820637,NaN,NaN,-119.07840603811273,-159.723635951843,-0.20668462100872512,-0.4442036796067299,-0.2375190585980048,225239786,228878868.4,21.916302885513346,50.63362918390063,NaN,NaN,-22.415327487057173,-9.586410033693108
2015-06-11T09:30:00-04:00,42.93,43.01,42.74,42.92,8976873,11420840,38.88280568381971,42.425367918770114,NaN,NaN,-91.23080538222722,-150.34188762697698,-0.16373579368658303,-0.44218880070623356,-0.27845300701965053,234216659,226071465.4,21.145633326478773,47.48593840916298,NaN,NaN,-22.492890109096912,-11.430192901607937
2015-06-12T09:30:00-04:00,42.74,42.88,42.53,42.54,8629277,11240168.45,35.12767159522265,41.11886346337009,NaN,NaN,-100.26476318840957,-130.10628000831218,-0.14994510925020488,-0.46588439358240663,-0.31593928433220175,225587382,224721962.4,20.767590671534933,44.18664032416577,NaN,NaN,-23.723542130115764,-13.186385648537627
2015-06-15T09:30:00-04:00,42.42,42.67,42.29,42.47,10076120,10854389.55,34.46732109483206,40.03966223306666,NaN,NaN,-100.63694155234889,-113.9033637386058,-0.13502788333547694,-0.48472413850154794,-0.349696255166071,215511262,222940774,20.25292113137435,40.943248217117805,NaN,NaN,-24.915404319229147,-14.8619597443507
2015-06-16T09:30:00-04:00,42.39,42.67,42.21,42.67,8036782,10744047.1,38.05058656843417,39.04555195671566,NaN,NaN,-86.99447391122874,-99.64107801446542,-0.10264802358862696,-0.4780062846518547,-0.3753582610632277,223548044,224820626.6,22.43762252730312,38.03887835262831,NaN,NaN,-24.86588407578089,-16.29109179169787
2015-06-17T09:30:00-04:00,42.69,43.1,42.56,43.03,18291918,11013241.3,43.98753080394586,38.380823728236734,NaN,NaN,-51.696552384360416,-86.16470728371498,-0.050575547196205106,-0.4385776950584841,-0.388002147862279,241839962,228140661.8,26.27887481302247,35.575789301445944,NaN,NaN,-23.008794612215176,-17.250763623200342
2015-06-18T09:30:00-04:00,43.08,43.71,43.08,43.6,20717048,11595660.5,51.854983638653394,38.3556399589569,NaN,NaN,-1.3523535313935056,-68.18901691354823,0.024627135846252146,-0.3572182280544638,-0.38184536390071594,262557010,233808732,32.431276061767065,33.73623872407025,NaN,NaN,-18.740776545136796,-17.463622612048407
2015-06-19T09:30:00-04:00,43.29,43.32,42.77,42.79,13375489,11861307.25,42.68063658620034,37.612108597308286,NaN,NaN,-40.269491081207455,-56.1899624921078,0.02226062910622767,-0.35401957751793134,-0.376280206624159,249181521,238527559.8,37.13503409590857,32.15153083570596,NaN,NaN,-18.051784658569225,-17.547645761551383
2015-06-22T09:30:00-04:00,42.86,42.96,42.63,42.73,10273804,11928804.25,42.08664555088688,37.44640272931311,NaN,NaN,-52.38345965935375,-46.53926611350877,0.019211824555907198,-0.352265425929275,-0.3714772504851822,238907717,243206850.8,41.485104613880935,30.81397997929435,NaN,NaN,-17.717898164090627,-17.571967533342704
2015-06-23T09:30:00-04:00,42.57,42.66,42.09,42.15,16276894,12214456.35,36.76072700135727,37.41576799273441,NaN,NaN,-91.47087924066773,-47.434547179396574,-0.01733378049066464,-0.393144476098513,-0.37581069560784836,222630823,243023406.6,41.364261612512685,29.922401679644004,NaN,NaN,-19.256149056778817,-17.812564893833578
2015-06-24T09:30:00-04:00,42.2,42.285,41.8,41.82,12229870,12444062.1,34.11544555798537,37.23841843036163,NaN,NaN,-118.83696008360864,-60.86262871924622,-0.056964826995714035,-0.4470167293524909,-0.3900519023567769,210400953,236735604.8,37.34838231184809,29.428193599737362,NaN,NaN,-21.408851941585137,-18.326320186369514
2015-06-25T09:30:00-04:00,41.85,41.95,41.53,41.54,11687278,12529078.9,32.0106448026045,37.25977403666485,NaN,NaN,-148.3231722139591,-90.25679245575934,-0.09313152593260032,-0.5064663097725273,-0.41333478383992694,198713675,223966937.8,30.807414305120915,29.03255810349128,NaN,NaN,-23.85998202235231,-19.116843305795626
2015-06-26T09:30:00-04:00,41.45,41.86,41.31,41.79,8770711,12509590.3,35.81813618159988,37.69447209509183,NaN,NaN,-147.5532712281863,-111.71354848515512,-0.09119529339889293,-0.5273289005885431,-0.43613360718965016,207484386,215627510.8,27.428704731914877,28.91559904261038,NaN,NaN,-24.63925249095303,-19.905758903675256
2015-06-29T09:30:00-04:00,41.72,42.26,41.54,41.57,16171494,12876212.05,34.01299869865066,38.05583713264358,NaN,NaN,-127.10689529369701,-126.65823561202376,-0.0952648315784837,-0.5552146466627548,-0.4599498150842711,191312892,206108545.8,24.170228408518014,28.926382249764124,NaN,NaN,-25.844210085130292,-20.754109072454547
2015-06-30T09:30:00-04:00,41.77,41.81,41.37,41.46,11108737,12824081.5,33.114373623015254,38.06932195622913,NaN,NaN,-148.09561138279085,-137.9831820404484,-0.09564826773289004,-0.5795101497503836,-0.4838618820174936,180204155,197623212.2,21.695933374582026,28.91064157041189,NaN,NaN,-27.09226675268451,-21.659560169630257
2015-07-01T09:30:00-04:00,41.51,41.72,41.4,41.71,11251781,12218543.2,37.17680147894487,37.947464513023775,NaN,NaN,-121.67964485846599,-138.55171899541986,-0.07050886546858182,-0.5719979638532209,-0.5014890983846391,191455936,193834208.8,20.677998517929097,28.87723908408691,NaN,NaN,-26.936022949971584,-22.413340566821876
2015-07-02T09:30:00-04:00,41.99,42.355,41.9,42.23,9575445,12032270.95,44.700358199171525,38.63122784187727,NaN,NaN,-34.243113469811135,-115.73570724659025,-0.013298618352916458,-0.5181123713257847,-0.5048137529728682,201031381,194297750,21.165310442003317,28.905647639120364,NaN,NaN,-24.42618522951742,-22.70088980434981
2015-07-06T09:30:00-04:00,42.17,42.51,42.02,42.4,13998153,11936239.75,46.93763648331789,39.52196465534054,NaN,NaN,-8.83568476557777,-87.99218995406855,0.03870808521590147,-0.4564286464529914,-0.4951367316688929,215029534,195806779.6,22.8274606434517,29.089543318554462,NaN,NaN,-21.67804998977801,-22.554769830839554
2015-07-07T09:30:00-04:00,42.54,43.6225,42.54,43.45,26118315,12846270.85,58.18916634225661,40.960434639185,NaN,NaN,117.18178978366358,-39.13445293859643,0.1407983517643514,-0.3191387919634536,-0.45993714372780503,241147849,205773771,32.891683745411754,29.83626197699079,NaN,NaN,-15.042107093274188,-21.481532296901644
2015-07-08T09:30:00-04:00,43.3,43.5699,43.14,43.22,15496809,13107690.15,55.417170621480174,41.77683748329461,NaN,NaN,116.59630898639114,13.803931135239969,0.1869207672290928,-0.22628618469143902,-0.4132069519205318,225651040,214863148,40.5108888010115,30.852834404704293,NaN,NaN,-10.685938222687836,-19.939304572013956
2015-07-09T09:30:00-04:00,43.35,43.45,42.6,42.74,15575996,13331939.7,50.05772785026435,41.64846206983824,NaN,NaN,62.507417221610766,50.64134355125532,0.1791653584865709,-0.1892502538123182,-0.3684156122988891,210075044,218586969.6,43.348694613969926,31.63265001557593,NaN,NaN,-8.820309712282283,-18.35087673490943
2015-07-10T09:30:00-04:00,42.76,43.28,42.62,42.97,12405102,13503351.15,52.431640555127,42.344962353333,NaN,NaN,65.18745671052906,70.52745758732335,0.18294911187645047,-0.13972922245332597,-0.32267833432977644,222480146,222876722.6,46.51398486244088,32.30257507032824,NaN,NaN,-6.544287324144708,-16.664221104800184
2015-07-13T09:30:00-04:00,43.09,43.27,42.73,42.99,8584709,13501122.75,52.642441520329214,43.09894777972174,NaN,NaN,66.1268812543836,85.51997079131563,0.17994835050067504,-0.09774289620393262,-0.27769124670460765,231064855,226083786.8,48.816455125345364,32.82624296400427,NaN,NaN,-4.689506675813914,-14.953547614945002
2015-07-14T09:30:00-04:00,42.94,43.23,42.8,42.93,6821231,13338378.3,51.89938378268832,44.180280406959675,NaN,NaN,59.05172692947183,73.89395822047729,0.1673369397815022,-0.06852007197772991,-0.2358570117592321,224243624,222702941.8,46.5418814307792,33.196072951023304,NaN,NaN,-3.400029343587386,-13.303045004751057
2015-07-15T09:30:00-04:00,42.88,43.15,42.695,43.14,9900796,13431579,54.32922368226085,45.62412170155078,NaN,NaN,55.00288329574962,61.57527308234897,0.16621224572860677,-0.028091704598473655,-0.19430395032708042,234144420,224401617.8,47.8565122917244,33.946653663871615,NaN,NaN,-1.6079247536530399,-11.632313540308484
2015-07-16T09:30:00-04:00,43.14,43.85,43.08,43.78,12592698,13146618,60.82436271257669,47.68224440940593,NaN,NaN,112.29435543450715,71.53266072492825,0.19940892558046647,0.05495720664850268,-0.1444517189319638,246737118,231734032.6,53.20588158935237,35.54654418417386,NaN,NaN,2.06467847160619,-9.675600395749246
2015-07-17T09:30:00-04:00,43.78,43.84,43.33,43.35,10492258,12635378.5,55.14938812420164,49.06304811959178,NaN,NaN,104.68683957360473,79.43253729754338,0.183637959304999,0.08509573019928496,-0.09854222910571403,236244860,234486975.4,55.06958903907731,37.52089306325689,NaN,NaN,3.447084576785057,-7.800931113958631
2015-07-20T09:30:00-04:00,43.17,43.37,42.91,43.13,9812517,12457229.9,52.45292211595581,50.38018550654214,NaN,NaN,61.97088391279035,78.60133782922473,0.15098492255663412,0.09018892409007861,-0.0607959984665555,226432343,233560473,54.285964416992556,39.672017063862214,NaN,NaN,3.7552000531788288,-6.150055232938994
2015-07-21T09:30:00-04:00,43.05,43.15,42.56,42.74,10284757,12457777.55,47.97481790305799,51.44164581225948,NaN,NaN,26.718054935169917,72.13460343036436,0.09826912921021969,0.0620404130462191,-0.03622871616400058,216147586,231941265.4,52.870019442901636,41.89873749731362,NaN,NaN,2.616048535174849,-4.897754694637017
2015-07-22T09:30:00-04:00,42.81,43.15,42.7,42.93,8252158,12056540.75,50.20521429395802,52.37224672761756,NaN,NaN,35.39611418988303,68.21324960919102,0.07253210749525757,0.05443641820507139,-0.018095689290186182,224399744,229992330.2,51.140970320625826,44.07466405464909,NaN,NaN,2.3486454918651987,-3.8625546679938436
2015-07-23T09:30:00-04:00,42.89,42.92,42.08,42.29,13947266,12142410.55,43.448247767381034,52.28281026820395,NaN,NaN,-22.36281418759668,41.28181568477027,0.011920058066546127,-0.0031956167070035235,-0.01511567477354965,210452478,222735402.2,45.21185031231887,45.79227404538592,NaN,NaN,-0.08372359479460698,-3.32272165753681
2015-07-24T09:30:00-04:00,42.31,42.48,42.1799,42.33,8589088,11987501.05,43.95593619243314,52.0698316759979,NaN,NaN,-40.280215527770316,12.28840466449526,-0.02400475613135672,-0.04512161993774555,-0.02111686380638883,219041566,219294743.4,42.68505205599645,47.21067343199626,NaN,NaN,-1.8594692822926842,-3.1136856039305063
2015-07-27T09:30:00-04:00,42.33,43.06,42.21,42.87,11952839,12146607.45,50.42619828646614,51.51533395772715,NaN,NaN,0.27237983958054984,-0.05129615014669647,-0.010609307830908986,-0.034378498595025064,-0.02376919076411608,230994405,220207155.8,43.585468725936195,47.97451521631943,NaN,NaN,-1.3997447213642051,-2.8688369064210346
2015-07-28T09:30:00-04:00,42.87,43.11,42.71,43.07,8742640,11775164.75,52.608494402541616,51.31471422780297,NaN,NaN,30.047633648772553,0.6146195925738276,0.011323089036991158,-0.009615329467877132,-0.02093841850486829,239737045,224925047.6,48.12369494877614,48.518287084016904,NaN,NaN,-0.35196987436426885,-2.509284473270068
2015-07-29T09:30:00-04:00,43.07,43.27,42.75,43.23,13500760,11894765.9,54.340184897856005,51.62060401691666,NaN,NaN,44.3251833943175,2.4004334334607207,0.0348780332303584,0.02265912303307971,-0.012218910197278691,253237805,230692659.8,53.09165428788559,49.21421277501088,NaN,NaN,1.0278109966660969,-2.0039851204220445
2015-07-30T09:30:00-04:00,43.19,43.69,43.005,43.55,11315355,11897944.6,57.67151145636206,51.994880509862014,NaN,NaN,110.67096494294633,29.007189259569326,0.06834650167404167,0.07321421689527341,0.004867715221231731,264553160,241512796.2,60.69607721149449,50.22721937137185,NaN,NaN,3.21279780677034,-1.2587304165374182
2015-07-31T09:30:00-04:00,43.95,44.339,43.9,43.99,12054155,12021880.1,61.798650883680544,52.64889546438711,NaN,NaN,228.88617383278765,82.84046713168092,0.11377644679683865,0.14708827371728006,0.0333118269204414,276607315,253025946,66.85351136932657,51.51558053165622,NaN,NaN,6.403179215707268,-0.16417189764532014
2015-08-03T09:30:00-04:00,44.05,44.47,44,44.22,13197348,11981839.85,63.78634079325987,53.49796382228508,NaN,NaN,214.77626030339837,125.7412432244445,0.15066107203845533,0.22163816696851057,0.07097709493005525,289804663,264787997.6,71.72670733127029,53.314496667405585,NaN,NaN,9.670634077707152,1.24080038454789
2015-08-04T09:30:00-04:00,44.11,44.17,43.42,43.51,12033555,11277601.85,54.379933112042394,53.50158592441233,NaN,NaN,97.58644628058303,139.2490057508066,0.11992411227740456,0.22088223527681095,0.10095812299940639,277771108,272394810.2,74.35285802752198,55.207092791391126,NaN,NaN,9.59698873159848,2.4345415769836887
2015-08-05T09:30:00-04:00,43.68,43.93,43.49,43.62,11156553,11060589.05,55.47543914399332,53.1195199552278,NaN,NaN,85.2179824986282,147.4275655716687,0.10047168832602593,0.2265477334069388,0.12607604508091286,288927661,279532781.4,76.5536326867136,56.874789298345505,NaN,NaN,9.875803403450691,3.497578980764689
2015-08-06T09:30:00-04:00,43.73,43.89,43.23,43.85,17145137,11139046.1,57.75950034434136,53.30595654238065,NaN,NaN,71.70707591091617,139.6347877652627,0.09654104536659372,0.246752351789155,0.15021130642256128,306072798,287836709,78.82956730322877,58.57193060292775,NaN,NaN,10.799125550486437,4.54065706215351
2015-08-07T09:30:00-04:00,43.81,44.58,43.58,44.39,21163253,11576953.65,62.609285136114394,54.03141104382053,NaN,NaN,132.69208585423542,120.39597016955224,0.1221086440379007,0.30284711146993715,0.18073846743203645,327236051,297962456.2,81.22308511919843,60.496010653085314,NaN,NaN,13.150484288910627,5.77063238026167
2015-08-10T09:30:00-04:00,44.4,44.61,44.1206,44.21,12089532,11752194.8,60.13097805876187,54.899708197799384,NaN,NaN,131.03984294648836,103.64868669817024,0.11859784506812016,0.32898577376718663,0.21038792869906647,315146519,303030827.4,82.30169553360716,62.598273230992845,NaN,NaN,14.31450438459699,6.991185523738144
2015-08-11T09:30:00-04:00,44.38,44.77,44.1,44.43,15122310,12167248.75,62.10535069520787,55.74971794074581,NaN,NaN,129.53695442186606,110.03878832642685,0.12230206873067889,0.3632655146124151,0.24096344588173618,330268829,313530371.6,84.31213470863251,64.96764211585047,NaN,NaN,15.877685836765664,8.260685568456362
2015-08-12T09:30:00-04:00,44.38,45.3,44.28,45.22,23459770,12845197.45,68.19600925545896,57.51741518989426,NaN,NaN,166.2155184325886,126.23829551321892,0.16643166449790353,0.4490030265041156,0.2825713620062121,353728599,326490559.2,86.37026231906873,67.90752868776117,NaN,NaN,19.325515522208974,9.841375561849592
2015-08-13T09:30:00-04:00,45.04,45.36,44.7,45.23,10778928,12754508.95,68.26553971028446,59.25381544116935,NaN,NaN,155.64890729675082,143.02666179038584,0.18342864479308535,0.5118571679975688,0.3284285232044834,364507527,338177505,87.91051091064676,71.13791860595047,NaN,NaN,22.048561484338077,11.585259265062232
2015-08-14T09:30:00-04:00,45.05,45.6,44.95,45.57,10334314,12746611.75,70.61757928728443,60.6960569412278,NaN,NaN,155.68977065561498,147.62619875066176,0.20317017563779383,0.5823912427517257,0.3792210671139319,374841841,347698663,89.00101970549825,74.38188653306204,NaN,NaN,25.092182500350795,13.514819727246312
2015-08-17T09:30:00-04:00,45.72,45.99,45.49,45.79,9159738,12713972.8,72.06055724067053,62.08549000109415,NaN,NaN,159.66984566041052,153.3521992934462,0.21547586834245153,0.6485659025419963,0.4330900341995448,384001579,361469675,90.3560170023223,77.39848096545822,NaN,NaN,28.063707700451683,15.593232294847079
2015-08-18T09:30:00-04:00,45.64,45.76,45.49,45.68,11741333,12786801.6,70.20408194232597,63.21862550427057,NaN,NaN,131.95409987806994,153.83562838468697,0.20092489486121373,0.6842461527760619,0.4833212579148482,372260246,369867958.4,91.07789328107404,80.11178375068596,NaN,NaN,29.97027798276689,17.64709596454991
2015-08-19T09:30:00-04:00,45.57,46.01,45.33,45.87,9245573,12836472.35,71.56667091398418,64.21113689410072,NaN,NaN,124.57410173468392,145.50734504510604,0.18899082005595214,0.7195597829847884,0.5305689629288363,381505819,375423402.4,91.52956705601066,82.31417588243711,NaN,NaN,31.97174247050941,19.693474036829837
2015-08-20T09:30:00-04:00,45.68,46.14,45.44,45.6,12775956,12777906.85,66.88569719020504,64.57449734456675,NaN,NaN,112.422476870534,136.86205895986268,0.14953569690051416,0.7174885840544789,0.5679528871539647,368729863,376267869.6,91.59918601501852,84.08172407141511,NaN,NaN,32.35529960784421,21.50230626126046
2015-08-21T09:30:00-04:00,45.45,45.65,45.02,45.05,18747414,13285823.15,58.49280837519212,64.19638788613335,NaN,NaN,67.16311290423508,119.1567274095867,0.07668944859265692,0.6638146978947859,0.587125249302129,349982449,371295991.2,87.06213536940089,85.17711178842444,NaN,NaN,30.12608747852759,22.734275006584337
2015-08-24T09:30:00-04:00,44.16,44.57,43.15,43.37,35100462,14443204.3,41.4028856718227,63.26945592611766,NaN,NaN,-63.06113208731646,74.61053186004129,-0.08555574023811474,0.48018057400448555,0.5657363142426003,314881987,357472072.8,75.8174674801082,85.28172674932345,NaN,NaN,21.157896920146186,22.509078137093173
2015-08-25T09:30:00-04:00,43.9,44.18,41.99,42.03,28632725,15437708.55,33.09668649057441,61.67097359373059,NaN,NaN,-141.4262860460174,19.93445467522383,-0.2734362876112308,0.2239409547285618,0.4973772423397926,286249262,340269876,64.6309415274495,84.43010595223316,NaN,NaN,9.75420180914687,20.68695294738656
2015-08-26T09:30:00-04:00,42.32,42.88,41.965,42.78,21869934,15856167.25,40.31414502682642,60.424876785336664,NaN,NaN,-150.56636007482413,-35.09363768667779,-0.3335334383392291,0.08046044441575617,0.4139938827549853,308119196,325592551.4,56.91482095332868,82.8647669272403,NaN,NaN,3.7977479231067957,18.27420937248945
2015-08-27T09:30:00-04:00,43.02,43.3,42.69,43.28,17045454,16142672.2,44.60460411202519,59.13882814075886,NaN,NaN,-103.20046593350345,-78.21822624748529,-0.3255822654604047,0.007016050929479434,0.33259831638988413,325164650,316879508.8,52.87884901494803,80.84017863407955,NaN,NaN,0.9210212928519881,15.795182503969814
2015-08-28T09:30:00-04:00,43.22,43.35,42.56,43.15,9680746,16024001.75,43.72453738842364,57.966939521448985,NaN,NaN,-98.96931655612899,-111.4447121395581,-0.31485959564454913,-0.06097617816580225,0.2538834174787469,315483904,309979799.8,49.86341124371852,78.52315832765893,NaN,NaN,-1.5352959469455179,13.319399868124766
2015-08-31T09:30:00-04:00,43.09,43.09,42.11,42.46,12078424,15968055.55,39.29311825940213,56.33749434746287,NaN,NaN,-116.99120437513284,-122.23072659712139,-0.3379821683413753,-0.16859429294797224,0.16938787539340305,303405480,307684498.4,48.86511163087029,75.99122810781877,NaN,NaN,-5.145606394959781,10.68154183054126
2015-09-01T09:30:00-04:00,42,42.075,41.08,41.31,19406217,16336688.65,33.24550545350429,53.84102979018039,NaN,NaN,-163.32290935628305,-126.6100512591745,-0.40969195551253285,-0.342727068997263,0.06696488651526983,283999263,307234498.6,48.65942636423514,73.2975969681878,NaN,NaN,-10.543518419080689,7.649390366309554
2015-09-02T09:30:00-04:00,41.6,41.73,40.99,41.34,9121700,16234946,33.53290249606995,51.360127132022214,NaN,NaN,-147.10990290379738,-125.91875982496916,-0.43185750774351644,-0.47285699816412574,-0.0409994904206093,293120963,304234852,47.23222533268005,70.39200514119018,NaN,NaN,-14.465540206704116,4.490114570164744
2015-09-03T09:30:00-04:00,41.25,41.74,41.25,41.53,8585161,15806947.2,35.428981585283864,48.8466558675936,NaN,NaN,-120.96735740361916,-129.4721381189923,-0.41061262164377077,-0.5542652674753228,-0.14365264583155202,301706124,299543146.8,45.008612858053134,67.24969036637268,NaN,NaN,-16.937866612379075,1.428974401229913
2015-09-04T09:30:00-04:00,41.2,41.29,40.8015,40.96,13429630,15420266.05,32.43928606973688,46.01656506966977,NaN,NaN,-125.13961515102336,-134.70619783797116,-0.4108381611114333,-0.6572003472208436,-0.24636218610941035,288276494,294101664.8,42.5090000153639,63.83204629587565,NaN,NaN,-19.988581479471964,-1.630676438870355
2015-09-08T09:30:00-04:00,41.34,41.83,41.3,41.83,11206911,15376135,40.668905158816884,43.906909585133405,NaN,NaN,-85.89267896949148,-128.4864927568429,-0.3316753050512756,-0.6609563174235049,-0.3292810123722293,299483405,293317249.8,42.14563501189882,60.336884990934564,NaN,NaN,-19.86721373513028,-4.235896052621772
2015-09-09T09:30:00-04:00,41.93,42.05,41.23,41.31,11542506,15197144.8,37.712022421886246,41.488720407126415,NaN,NaN,-82.24760968969395,-112.27143282352509,-0.29485378600350465,-0.6978482448766101,-0.4029944588731055,287940899,294105577,42.6759626773278,56.847341821028635,NaN,NaN,-20.742103642660837,-6.593925708341638
2015-09-10T09:30:00-04:00,41.29,41.65,41.115,41.24,6766424,14362477.5,37.318674185989906,39.37679019253962,NaN,NaN,-82.93192475413878,-99.43583719359336,-0.25711126144119933,-0.7243835356746047,-0.46727227423340534,281174475,291716279.4,41.43620572708549,53.264271800462,NaN,NaN,-21.54972627613691,-8.730468646598105
2015-09-11T09:30:00-04:00,41.19,41.57,41,41.55,7477909,14197426.55,40.28897377947309,38.076516292845405,NaN,NaN,-75.82033578648112,-90.40643287016574,-0.1959332731455532,-0.7121888656653468,-0.5162555925197936,288652384,289105531.4,40.0665404059422,49.907443588786386,NaN,NaN,-21.314121689729145,-10.528133367045395
2015-09-14T09:30:00-04:00,41.7,41.93,41.56,41.65,8372591,14099340.4,41.256022643663435,38.06602607654832,NaN,NaN,-56.47529001480452,-76.67356784292198,-0.13622857927950116,-0.6865413166191701,-0.5503127373396689,297024975,290855227.6,41.46305949703943,47.45355730428147,NaN,NaN,-20.84163029939659,-12.001490071666995
2015-09-15T09:30:00-04:00,41.7,41.965,41.435,41.87,6579144,13970310.7,43.42678416407061,38.80389019608376,NaN,NaN,-50.17335958770659,-69.52970396656501,-0.07260852438274512,-0.6410733928181003,-0.5684648684353552,303604119,291679370.4,42.14685930378831,45.84755143116281,NaN,NaN,-19.82795853490216,-13.119556994986304
2015-09-16T09:30:00-04:00,41.99,42.42,41.85,42.29,8619804,13814234.25,47.42134920852307,39.31154763763352,NaN,NaN,-22.169492708169503,-57.51408057026013,0.003059556827860521,-0.5646404224005295,-0.56769997922839,312223923,296535975.2,46.13970614516357,45.07790037343674,NaN,NaN,-17.79615811014039,-13.787642868579745
2015-09-17T09:30:00-04:00,42.17,43.42,42.17,42.87,22723109,14488111.05,52.41785123509437,39.86963671785275,NaN,NaN,27.797046574569713,-35.36828630451843,0.09251631453222153,-0.4520545860631131,-0.5445709005953346,334947032,307290486.6,53.751634659813426,45.14024220521282,NaN,NaN,-14.50626040032477,-13.890302515971891
2015-09-18T09:30:00-04:00,42.29,42.72,42.13,42.23,14358703,14567248.4,47.09914154893588,40.11067987217505,NaN,NaN,9.511700272372181,-18.301879092747757,0.10785766322017243,-0.40974882157011905,-0.5176064847902915,320588329,313677675.6,57.5855586636279,45.691824163777774,NaN,NaN,-13.207906424614329,-13.792817360063667
2015-09-21T09:30:00-04:00,42.2,42.62,42.2,42.4,8770879,14068421.65,48.59130795090345,40.77483627871086,NaN,NaN,31.531448648691644,-0.7005313600485209,0.1273871688025901,-0.35837252378705386,-0.48575969258964397,329359208,320144522.2,61.10154322902871,46.565854992217666,NaN,NaN,-11.702809758600281,-13.494244845568899
2015-09-22T09:30:00-04:00,42.21,42.39,41.75,41.87,10972165,12862006.8,44.387641587320026,41.57070314541198,NaN,NaN,-2.270518183047011,8.880036920883402,0.10355525523691955,-0.35631562354349455,-0.4598708787804141,318387043,323101107,62.62691134398275,47.56353249077107,NaN,NaN,-11.643745942706813,-13.229887859445743
2015-09-23T09:30:00-04:00,41.88,42.08,41.73,41.98,5266549,11693698,45.4425749183677,42.421394032718965,NaN,NaN,-6.7314322680063015,11.967649008916041,0.0944018339585454,-0.3418685863322324,-0.4362704202907778,323653592,325387040.8,63.808606855769554,48.747559742420314,NaN,NaN,-11.292127681452078,-12.953064976875218
2015-09-24T09:30:00-04:00,41.97,42.4,41.83,42.32,11326049,11166503.75,48.68288694529965,43.368101558434375,NaN,NaN,29.553740428605447,12.318987779723185,0.10939134654786581,-0.29953123710594554,-0.40892258365381134,334979641,325393562.6,63.81212244574723,50.09066757011276,NaN,NaN,-10.059015926881454,-12.539629398304681
2015-09-25T09:30:00-04:00,42.4,43.15,42.2,42.73,9505005,10789481.3,52.35754336020628,44.79083422203933,NaN,NaN,105.61089837459913,31.53882740016858,0.1429453188010309,-0.23024093515252275,-0.37318625395355365,344484646,330172826,66.38877263391225,51.79636561429477,NaN,NaN,-7.91913749875839,-11.879559126940926
2015-09-28T09:30:00-04:00,42.73,42.99,42.44,42.52,9506950,10780791.5,50.36810602550509,45.48363428394563,NaN,NaN,106.60019255415844,46.552576181261934,0.14648342718396484,-0.1900819699735976,-0.33656539715756245,334977696,331296523.6,66.98400953931932,53.57053522339624,NaN,NaN,-6.681211354764651,-11.13693801663003
2015-09-29T09:30:00-04:00,42.6,42.7835,42.355,42.53,8681435,10610942.05,50.464629247242314,46.394534771471065,NaN,NaN,92.7404028886283,65.554760395597,0.1447287207878491,-0.15565449617275107,-0.30038321696060016,343659131,336350941.2,69.59251821017276,55.49314633288517,NaN,NaN,-5.6379445384654066,-10.351367519749369
2015-09-30T09:30:00-04:00,42.62,43.34,42.61,43.29,9637983,10122530.35,57.26662600073513,47.81938847252429,NaN,NaN,146.57823094453914,96.21669303810609,0.1872819470688593,-0.06628078312452601,-0.2535627301933853,353297114,342279645.6,72.3518700277169,57.70140806864455,NaN,NaN,-2.66130462695446,-9.252787106492953
2015-10-01T09:30:00-04:00,43.39,43.45,42.455,42.78,15645955,10448743.1,52.09682825168169,48.66280664911062,NaN,NaN,108.19988680626663,111.9459223136383,0.1739005302380107,-0.036187067395871964,-0.21008759763388266,337651159,342813949.2,72.59324774818859,60.024744307376444,NaN,NaN,-1.5950958415722871,-8.158831211504285
2015-10-02T09:30:00-04:00,43.1,43.35,42.705,43.35,13198358,10679402.95,56.79174647619792,49.77250120857737,NaN,NaN,125.38803794028665,115.90135022677582,0.19468856115898572,0.03327310381484949,-0.16141545734413623,350849517,344086923.4,73.19370811340868,62.29121920854567,NaN,NaN,0.7904924069371541,-6.880356408869794
2015-10-05T09:30:00-04:00,43.47,43.98,43.31,43.91,12011182,10608480.55,60.85130584802008,51.01710990028805,NaN,NaN,179.23744927354406,130.42880157065295,0.23472168577662453,0.13198664987664444,-0.10273503589998009,362860699,349663524,75.704900976911,64.68822218519729,NaN,NaN,4.138268766980879,-5.306267098033984
2015-10-06T09:30:00-04:00,43.82,43.95,43.34,43.61,11521938,10624231.9,57.722523141284626,51.75290803834245,NaN,NaN,146.56931851345612,141.19458469561852,0.2293004906554566,0.18389057741934067,-0.04540991323611593,351338761,351199450,76.36171839723934,66.84693734605985,NaN,NaN,5.948099136333155,-3.6985004931243926
2015-10-07T09:30:00-04:00,43.66,43.75,43.39,43.46,9528416,10523527.4,56.16747064493705,52.02073799618835,NaN,NaN,120.13200361944818,135.9053392306003,0.20472362389659407,0.21049461663462665,0.005770992738032589,341810345,348902096.2,73.17508924864353,68.23432695954772,NaN,NaN,6.96597466964641,-2.1750040412999923
2015-10-08T09:30:00-04:00,43.43,44.07,43.295,44,10530352,10711723.8,60.31261290081869,52.96455737846569,NaN,NaN,135.37046974025205,141.3394558173974,0.21299629471309037,0.27201636112939553,0.059020066416305174,352340697,351840003.8,74.63296487321742,69.45199883166126,NaN,NaN,9.118396353051152,-0.5616611278212575
2015-10-09T09:30:00-04:00,43.99,44.03,43.6501,43.79,13095140,10992585.35,58.01491572101189,53.63767221918772,NaN,NaN,125.24242628190316,141.31033348572072,0.19307604270276535,0.3003651197947619,0.10728907709199652,339245557,349519211.8,71.33484322965627,70.18294883170607,NaN,NaN,10.22110781286069,0.9787344351333063
2015-10-12T09:30:00-04:00,43.95,44.44,43.801,44.18,7493026,10948607.1,60.987399820075844,54.82336923581314,NaN,NaN,142.29031238600302,133.9209061082125,0.1943798043133157,0.3502638324836411,0.15588402817032543,346738583,346294788.6,66.91067256283253,70.48893177590963,NaN,NaN,12.051178382617735,2.5605121419167958
2015-10-13T09:30:00-04:00,44.14,44.325,43.99,44.08,9573413,11098320.55,59.817964470296765,55.85018277523665,NaN,NaN,124.5679949138132,129.5206413882839,0.17720433498229343,0.3773894468981922,0.20018511191589877,337165170,343460070.4,63.19970022329993,70.44543844501895,NaN,NaN,13.220429983133899,4.083357547804953
2015-10-14T09:30:00-04:00,44.28,44.395,44.01,44.07,7845465,11059603.6,59.69469471928525,56.63674047337848,NaN,NaN,113.23770084059889,128.14178083251403,0.15468651340215253,0.39354325366858944,0.2388567402664369,329319705,340961942.4,60.03947049710736,70.17596330583038,NaN,NaN,14.14645385997028,5.520942735257142
2015-10-15T09:30:00-04:00,44.24,44.8,44.03,44.72,8284123,10337654.3,64.77586005096191,57.52376309414674,NaN,NaN,129.39961719834892,126.94761032413344,0.17176772661273804,0.45356639853235947,0.28179867191962144,337603828,338014568.6,56.45277781162331,69.46624938995261,NaN,NaN,16.47933773216016,7.086427734814716
2015-10-16T09:30:00-04:00,44.76,45.06,44.64,44.78,9408665,10090152.4,65.21182872829692,58.58402900148901,NaN,NaN,138.80162201896368,129.65944947154554,0.17472950720109215,0.5002105559209866,0.3254810487198945,347012493,339567955.8,57.880900688619285,68.81602732918832,NaN,NaN,18.520472848765497,8.719862751093398
2015-10-19T09:30:00-04:00,44.74,44.83,44.36,44.81,10216241,10162420.5,65.44214064548865,59.653851244220895,NaN,NaN,112.11015606260563,123.62341820686606,0.16637346572255696,0.5334478808730907,0.36707441515053374,357228734,341665986,59.79852616373146,68.11645646872823,NaN,NaN,20.276205027799854,10.370768790622892
2015-10-20T09:30:00-04:00,44.67,45.145,44.64,44.96,9763097,10101967.1,66.63166684431525,60.322782733048044,NaN,NaN,124.88731539464128,123.68728230303168,0.15864059101299927,0.5653751539167828,0.40673456290378357,366991831,347631318.2,64.71727271083566,67.571128088951,NaN,NaN,22.099274192625572,12.04626956233756
2015-10-21T09:30:00-04:00,45.09,45.33,44.84,44.87,8411038,10259191.55,65.18192623903568,61.25743258928761,NaN,NaN,125.20586045847134,126.08091422660618,0.13602586191888882,0.5767668903023946,0.44074102838350576,358580793,353483535.8,68.75604187813835,67.29704195537597,NaN,NaN,23.282693616944854,13.65147299871003
2015-10-22T09:30:00-04:00,45.06,45.52,44.9,45.39,13110028,10348390.5,69.33355554322128,62.153276094075,NaN,NaN,136.0958475219598,127.42016029132837,0.14388772074840445,0.6206006793190113,0.47671295857060686,371690821,360300934.4,72.67941634820656,67.26030682929012,NaN,NaN,25.53280489419486,15.348806126636434
2015-10-23T09:30:00-04:00,45.35,45.37,44.5631,44.59,12585194,10502399.95,57.8959890482443,61.94218203694816,NaN,NaN,85.5225793849375,116.76435176452313,0.08587231736748469,0.5840533552799627,0.49818103791247803,359105627,362719561.2,73.93015623596094,67.13353934779367,NaN,NaN,24.156756258020014,16.607084716834088
2015-10-26T09:30:00-04:00,44.69,44.72,44.081,44.43,11113530,10582728.95,55.909481129334644,61.81267903609459,NaN,NaN,37.7551413466467,101.89334882133133,0.030255170060692116,0.5360000004883432,0.5057448304276511,347992097,360872233.8,71.24725397158606,66.76822046024701,NaN,NaN,22.42469672023357,17.438172145891155
2015-10-27T09:30:00-04:00,44.39,44.49,44.125,44.27,8496249,10573469.65,53.917185773843705,61.65194440244506,NaN,NaN,18.714179119522765,80.65872156630763,-0.02101221168854228,0.47947956581697326,0.5004917775055155,339495848,355373037.2,63.8222698119726,66.10016192905623,NaN,NaN,20.396415763328967,17.8607783769537
2015-10-28T09:30:00-04:00,44.28,44.45,43.31,43.8,17421132,10962627.1,48.45496665055759,60.80496967028355,NaN,NaN,-42.209809986519474,47.175587477309456,-0.08660130849132719,0.3922401418913566,0.4788414503826838,322074716,348071821.8,55.54556629876127,64.73677631659507,NaN,NaN,16.927493868197192,17.727452018559912
2015-10-29T09:30:00-04:00,43.58,43.72,42.965,43.55,16289822,10994820.45,45.79725312422016,59.93227948479842,NaN,NaN,-107.66884469485261,-1.5773509660530265,-0.14349142205713478,0.2994771728112653,0.44296859486840007,305784894,334890636.4,44.360767112826295,62.81005659396436,NaN,NaN,13.195935937730269,17.08009257844139
2015-10-30T09:30:00-04:00,43.6,43.92,43.44,43.75,11631691,10916487.1,48.24301143232124,59.02196602853024,NaN,NaN,-75.88574178055202,-33.85901519915093,-0.16290191300358547,0.2393412036139182,0.40224311661750367,317416585,326552828,39.00977443119092,60.817135298847106,NaN,NaN,10.768527368330243,16.17844040556837
2015-11-02T09:30:00-05:00,43.72,43.89,43.46,43.8,17436751,11187765.55,48.86422619178342,58.23955615149357,NaN,NaN,-73.73824889888347,-56.157693248256955,-0.16700473574469338,0.19348719693663696,0.36049193268133034,334853336,323925075.8,37.47551059373919,58.97969318244991,NaN,NaN,8.945518566922644,15.14516585719041
2015-11-03T09:30:00-05:00,43.64,43.98,43.52,43.93,12433217,11233329.5,50.52687357732241,57.584711784210505,NaN,NaN,-62.7265714733202,-72.44584336682554,-0.15581188118606754,0.1657270811987459,0.32153896238481344,347286553,325483216.8,39.00734279416857,57.4773983465257,NaN,NaN,7.853635649606333,14.103518684678399
2015-11-04T09:30:00-05:00,43.88,44.295,43.88,44.16,10718938,11292855.6,53.412961717251264,56.77307618894546,NaN,NaN,-24.442455163436275,-68.8923724022089,-0.12888184717726248,0.16043665341323532,0.2893185005904978,358005491,332669371.8,45.62405664606611,56.70391826327161,NaN,NaN,7.695574519787537,13.18809808969399
2015-11-05T09:30:00-05:00,44.07,44.2,43.78,43.78,13762878,11454481.9,48.39024694520236,55.57153463301013,NaN,NaN,-55.77861581727122,-58.51432662669263,-0.1321347979803712,0.12415000311503377,0.25628480109540497,344242613,340360915.6,51.66776251790246,56.26012267964899,NaN,NaN,6.115246639803009,12.177690739709563
2015-11-06T09:30:00-05:00,43.07,43.17,41.89,42.25,32359008,12417675.3,34.3743964709637,53.352410049115484,NaN,NaN,-241.51325889381178,-91.63983004934457,-0.22722448532325137,-0.027745805558659242,0.19947867976459213,311883605,339254319.6,50.793058458337185,55.61687498640653,NaN,NaN,-0.6878923299114716,10.339750301192272
2015-11-09T09:30:00-05:00,42.06,42.56,41.97,42.36,13333302,12709689.1,35.813821579336164,51.15113538733126,NaN,NaN,-209.85888092740478,-118.86395645504885,-0.26971204219143197,-0.13766137297469783,0.13205066921673414,325216907,337327033.8,49.22986809723324,54.510631799720656,NaN,NaN,-5.43704570268571,8.085922300638273
2015-11-10T09:30:00-05:00,42.38,42.87,42.3,42.74,8504582,12656247.55,40.656282317873085,49.399303678676795,NaN,NaN,-142.24456142635665,-134.76755444565615,-0.25915683728024075,-0.19189537738356677,0.06726145989667395,333721489,334614021,47.03543148167811,52.95915962854492,NaN,NaN,-7.7414459422443755,5.824869694512181
2015-11-11T09:30:00-05:00,42.86,43.19,42.77,43.11,10973445,12812646.55,45.006757795010174,47.661675268090285,NaN,NaN,-91.08923881403071,-148.096911175775,-0.21595628396187017,-0.20268389505566375,0.013272388906206405,344694934,331951909.6,44.91956165962936,50.97631286507512,NaN,NaN,-8.205902803248371,3.820473623403531
2015-11-12T09:30:00-05:00,43,43.41,42.67,42.7,8839646,12840422.7,41.386132088470134,46.48239977096357,NaN,NaN,-90.17305405470171,-154.97579882326113,-0.20384447282101295,-0.2415332021200598,-0.03768872929904684,335855288,330274444.6,43.58894756053922,48.809083673973575,NaN,NaN,-9.782078130876224,1.8772519442207087
2015-11-13T09:30:00-05:00,42.75,43.0465,42.41,42.54,9516370,12845807.95,40.03268455160476,45.348342872554284,NaN,NaN,-102.57771092544634,-127.18868922958805,-0.19543438540035415,-0.28198171104948955,-0.08654732564913539,326338918,333165507.2,46.52879820985053,47.043479690992456,NaN,NaN,-11.47318388906602,-0.02995317482025217
2015-11-16T09:30:00-05:00,42.62,43.27,42.47,43.26,9175613,12793776.55,48.23636197704407,44.94256974421146,NaN,NaN,-64.96555597934054,-98.21002423997518,-0.13318035871661793,-0.2530227740449078,-0.11984241532828988,335514531,335225032,48.58445097625078,45.95506405986947,NaN,NaN,-10.237970832628575,-1.4882414116500124
2015-11-17T09:30:00-05:00,43.24,43.495,42.36,42.48,13494004,12980321.9,41.59731084862656,44.45273718693067,NaN,NaN,-75.80924937995916,-84.92296183069568,-0.13586440373127529,-0.289672919992384,-0.1538085162611087,322020527,332884839.6,46.40156206458597,45.30192090028553,NaN,NaN,-11.465720610992868,-2.913595582984706
2015-11-18T09:30:00-05:00,42.51,42.8399,42.1301,42.75,15462533,13332896.65,44.44759512423711,44.35633304407474,NaN,NaN,-85.6148564588093,-83.8280853596514,-0.11179146248492736,-0.2935478443672679,-0.18175638188234053,337483060,331442464.8,45.057820470189974,45.351710425811504,NaN,NaN,-11.48137036898847,-4.137563409556672
2015-11-19T09:30:00-05:00,42.85,43.295,42.81,43.21,12364822,13295636.35,49.0131374355565,44.41134204430582,NaN,NaN,-28.58183392008412,-71.50984133272787,-0.05982955249648711,-0.2565433225029494,-0.1967137700064623,349847882,334240983.6,48.19261865545201,46.00762787040158,NaN,NaN,-9.959429235800188,-4.96925852759146
2015-11-20T09:30:00-05:00,43.28,43.7,43.2,43.39,12519953,13292374.3,50.71985189829496,44.54388673762808,NaN,NaN,14.829889530935517,-48.02832124145151,-0.010843888600725438,-0.21026863075736912,-0.1994247421566437,362367835,341446767,55.26954501878857,47.27863032933368,NaN,NaN,-8.195519579972206,-5.4301529636458525
2015-11-23T09:30:00-05:00,43.44,43.491,42.92,42.99,11896973,13331546.45,46.9581391579508,44.28897713624439,NaN,NaN,-14.136923072721915,-37.86259466012779,-0.003281117141404305,-0.20352613858339907,-0.20024502144199477,350470862,344438033.2,57.84391996195371,48.62410012703261,NaN,NaN,-7.902370592278245,-5.783326910593337
2015-11-24T09:30:00-05:00,42.8,42.985,42.59,42.93,8791663,13346317.15,46.40220645072005,43.788208902920736,NaN,NaN,-48.21389832960199,-32.34352445005636,-0.00037238111557288955,-0.2007104978364609,-0.200338116720888,341679199,348369767.6,61.019544747895864,49.72377784859189,NaN,NaN,-7.834697991273316,-6.076379922119049
2015-11-25T09:30:00-05:00,42.92,42.92,42.51,42.67,7678239,12859172.5,43.97278903568894,43.47267619509835,NaN,NaN,-62.92451866605682,-27.805456891505862,-0.013295869116380366,-0.21695795311636346,-0.2036620839999831,334000960,347673347.6,60.155147246877036,50.33001961494721,NaN,NaN,-8.49509188772542,-6.4219102029199595
2015-11-27T09:30:00-05:00,42.79,42.95,42.69,42.75,3980309,12243696.85,44.92820839290146,44.22651990380819,NaN,NaN,-44.016728817077954,-30.89243587090463,-0.013736908146680354,-0.22083321918333354,-0.20709631103665319,337981269,345300025,57.18227535140175,50.78639225016611,NaN,NaN,-8.765956843253342,-6.756774008681871
2015-11-30T09:30:00-05:00,42.8,43.13,42.73,42.82,11373031,12230763.85,45.799159528264376,44.93975832873163,NaN,NaN,-24.65750535230879,-38.7899148475535,-0.0069379374385598325,-0.21576873283485298,-0.20883079539629315,349354300,342697318,54.02885165478795,51.12917678999145,NaN,NaN,-8.752811800492653,-7.04192226465484
2015-12-01T09:30:00-05:00,42.92,43.25,42.75,43.16,12551543,11986503.45,49.94028612861591,45.6029014580704,NaN,NaN,8.86742067231314,-34.189046098546484,0.02128910002561321,-0.18221942036427663,-0.20350852038988984,361905843,344984314.2,56.308873375006605,51.79156549665777,NaN,NaN,-7.58211082234051,-7.119092058609936
2015-12-02T09:30:00-05:00,42.99,43.1,42.19,42.2,12566056,11993145.4,40.525369661720724,45.282802305692584,NaN,NaN,-91.01236845702562,-42.7487401240312,-0.02154435847326594,-0.23043896848147227,-0.20889461000820633,349339787,346516431.8,57.8182229795675,52.71289844808193,NaN,NaN,-9.412760900613021,-7.446759036038948
2015-12-03T09:30:00-05:00,42.13,42.14,41.74,41.88,14879220,12201159.5,37.95664978511278,45.0378392840242,NaN,NaN,-201.78668660078412,-70.52117371097667,-0.0657793497035202,-0.2911187971376066,-0.22533944743408638,334460567,346608353.2,57.9121655403338,53.73598544663868,NaN,NaN,-11.748718396166577,-8.061324658914323
2015-12-04T09:30:00-05:00,42.03,42.53,41.9,42.47,10961473,12061089.25,44.89232242777907,45.384956275179505,NaN,NaN,-110.10698757844467,-83.73922546325001,-0.050349924644610966,-0.2882768532398501,-0.23792692859523912,345422040,348096507.4,59.485301022791404,54.66144993327732,NaN,NaN,-11.5434078929238,-8.558765120915677
2015-12-07T09:30:00-05:00,42.37,42.68,42.1701,42.66,13515101,11118893.9,46.9490318263573,45.29300412155902,NaN,NaN,-62.00206582621257,-91.20813755803076,-0.023745143169040694,-0.26760835755654,-0.2438632143874993,358937141,350013075.6,61.482094880900014,55.58271021218083,NaN,NaN,-10.732798557796833,-8.869341326184413
2015-12-08T09:30:00-05:00,42.49,42.66,42.26,42.6,10638145,10984136.05,46.36060528421198,45.63323943838655,NaN,NaN,-66.65137787039038,-106.31189726657146,-0.007430827371385146,-0.25315174860173073,-0.24572092123034558,348298996,347291706.2,57.17324502897885,56.3521161382089,NaN,NaN,-10.254234725657147,-9.067183240394804
2015-12-09T09:30:00-05:00,42.41,43.06,42.27,42.61,10675803,11092697.1,46.48099989231096,45.77848263610611,NaN,NaN,-30.56779332007552,-94.22298223918145,0.006062573332475452,-0.23814270456475128,-0.24420527789722674,358974799,349218708.6,59.345927227042594,57.3726951922698,NaN,NaN,-9.832034910685742,-9.17644776472208
2015-12-10T09:30:00-05:00,42.55,42.63,41.87,41.905,9683649,11028207.3,39.713408461068646,45.11421628078555,NaN,NaN,-141.6848326309284,-82.2026114452103,-0.02856291471651623,-0.27990892129287204,-0.2513460065763558,349291150,352184825.2,62.49953942147913,58.39461810412888,NaN,NaN,-11.491997252574325,-9.507240548700972
2015-12-11T09:30:00-05:00,41.81,42.13,41.5,41.79,14352723,11303861.15,38.72298503276669,44.257297218962094,NaN,NaN,-185.12416206175223,-97.20604634187183,-0.053815742405839306,-0.31861568458365497,-0.26479994217781566,334938427,350088102.6,59.014555288376016,58.662118837670846,NaN,NaN,-13.142751710404294,-10.02659928608716
2015-12-14T09:30:00-05:00,41.95,42.005,41.505,42,16404552,11648270.25,41.587780297305315,43.87370015748742,NaN,NaN,-148.65401891662077,-114.53643695995348,-0.051006775501037604,-0.3285584115541127,-0.2775516360530751,351342979,348569270.2,56.55450082710231,58.57001747089574,NaN,NaN,-13.712737683335835,-10.553190485694113
2015-12-15T09:30:00-05:00,42.06,42.59,42.035,42.33,10110919,11695035.55,45.87040570882372,43.835714390209105,NaN,NaN,-51.63011706387019,-111.53218479864941,-0.022982095661587376,-0.3062792556300593,-0.28329715996847193,361453898,351200250.6,59.689223934794136,58.47499455567419,NaN,NaN,-12.956706428073304,-10.896549906033998
2015-12-16T09:30:00-05:00,42.49,43.47,42.36,43.4,18300516,11935361.15,56.903612706229154,44.75934465239056,NaN,NaN,86.76360736723925,-88.06590466118647,0.06665565657986755,-0.1999775892436375,-0.26663324582350506,379754414,355356173.6,64.09609770055766,58.756491016651374,NaN,NaN,-8.505957095122527,-10.55503664733236
2015-12-17T09:30:00-05:00,43.48,43.73,43.1577,43.49,13161660,11820317.5,57.68489120266495,45.67053628165938,NaN,NaN,135.04724346120287,-32.719489442760214,0.1275190976017646,-0.1072343738212993,-0.2347534714230639,392916074,364081158.4,71.21164316934068,59.75858871793273,NaN,NaN,-4.745312492832151,-9.72507605383233
2015-12-18T09:30:00-05:00,42.99,43.04,42.18,42.51,18407238,12122438.3,47.57182081949198,45.797154945318496,NaN,NaN,-7.792972393219375,2.7467484909463615,0.09858125354905542,-0.11152690448674463,-0.21010815803580005,374508836,371995240.2,75.88090377625727,61.31944958375197,NaN,NaN,-4.748276249731572,-9.014104653246507
2015-12-21T09:30:00-05:00,42.61,42.78,42.26,42.48,9031500,11948015.65,47.298452773399696,45.60845256280305,NaN,NaN,-13.330344903762368,29.81148329351804,0.07527676736334471,-0.11601219883161917,-0.19128896619496388,365477336,374822111.6,77.29734355427114,62.81862602512801,NaN,NaN,-4.838506786916798,-8.417590672342262
2015-12-22T09:30:00-05:00,42.6,42.95,42.21,42.84,8125824,11759458.2,50.94160438306107,46.35246932861308,NaN,NaN,24.04554471322565,44.946615648937204,0.08144213833622566,-0.08948629327468183,-0.17092843161090748,373603160,377251964,78.46787350785463,64.2936010628628,NaN,NaN,-3.7546603900834254,-7.751457774876714
2015-12-23T09:30:00-05:00,42.91,43.595,42.85,43.5,8581656,11748957.85,56.833163260318926,47.70079171969923,NaN,NaN,143.81190446084057,56.35627506765748,0.12471512195390103,-0.015034529168531208,-0.13974965112243223,382184816,377738044.4,78.70441553696456,65.77876177690787,NaN,NaN,-0.8501331983597155,-6.765554263945715
2015-12-24T09:30:00-05:00,43.35,43.6,43.35,43.47,2715807,11500836.25,56.50101260407582,48.52998387514901,NaN,NaN,148.67935327601793,59.08269703062049,0.14465955795255614,0.04107479631826294,-0.1035847616342932,379469009,375048631.4,73.86916837315216,66.8061808733622,NaN,NaN,1.3234452512230872,-5.609982904635887
2015-12-28T09:30:00-05:00,43.21,43.605,43.21,43.55,5036782,11553659.9,57.21903384150523,49.26355544765958,NaN,NaN,127.77507966463695,86.19630744219175,0.1556268265867616,0.09094877159915882,-0.06467805498760279,384505791,377048022.4,75.09419379568503,67.7784736529897,NaN,NaN,3.294280000972205,-4.337945346691874
2015-12-29T09:30:00-05:00,43.76,43.94,43.68,43.79,9223927,11446204.7,59.38499465666418,50.1938689742633,NaN,NaN,154.68193981414993,119.7987643857742,0.17024857948217126,0.14813266936511127,-0.022115910117059975,393729718,382698498.8,78.20404611807434,69.28067373078224,NaN,NaN,5.592833448046034,-2.9192626617293156
2015-12-30T09:30:00-05:00,43.82,43.94,43.66,43.75,7831482,11210201.65,58.85020692679199,51.07738376244051,NaN,NaN,133.57055855852576,141.70376715483422,0.16813741904596902,0.18805586369040128,0.01991844464443228,385898236,385157514,79.40901836479861,70.71375166919339,NaN,NaN,7.330765697496099,-1.4549728961256851
2015-12-31T09:30:00-05:00,43.68,43.8,42.89,43.28,10431667,11103482.2,52.83004412476934,52.014286309847705,NaN,NaN,66.70094014731343,126.28157429212881,0.12782424859220196,0.17969875538468472,0.05187450679248277,375466569,383813864.6,76.90707825740581,71.7428615860453,NaN,NaN,7.154597834174527,-0.22503422036851228
2016-01-04T09:30:00-05:00,43.03,43.2,42.67,43.19,14846729,11101857.65,51.73859325103241,52.9439726111524,NaN,NaN,24.548346172470144,101.45537287141924,0.08963945629687131,0.1639238271635719,0.07428437086670059,360619840,380044030.8,70.22207441467773,72.5433986664954,NaN,NaN,6.70210356072512,0.7645568912162923
2016-01-05T09:30:00-05:00,43.17,43.61,42.555,43.5,10948045,11101186.25,55.17384504641998,53.91440580751773,NaN,NaN,44.74734623506848,84.84982618550555,0.08011315918117737,0.1744258198431723,0.09431266066199492,371567885,377456449.6,65.98251541864548,73.21682828017707,NaN,NaN,7.273726330268582,1.6944382396523336
2016-01-06T09:30:00-05:00,43.24,43.6,43.07,43.42,12719000,11061381.2,54.103564930334585,54.502488609054225,NaN,NaN,57.159396321785024,65.34531748703257,0.06397735288914241,0.17428435177342294,0.11030699888428053,358848885,370480283,56.14152568140242,72.96342126207766,NaN,NaN,7.4570409918278475,2.5176672042488355
2016-01-07T09:30:00-05:00,42.95,43.3499,42.8695,43.13,12273707,11143159.3,50.29483410767483,54.030432994871774,NaN,NaN,22.52769512865179,43.136744801057766,0.030997173191595895,0.1490534653737754,0.1180562921821795,346575178,362615671.4,47.53431774073501,71.78043697923319,NaN,NaN,6.55479682008324,3.0944000065108934
2016-01-08T09:30:00-05:00,43.16,43.46,43.03,43.11,11680794,11193408.85,50.03323895165915,53.48388640551422,NaN,NaN,30.50746568696079,35.89804990898725,0.0063482624931129605,0.1259916202985707,0.11964335780545773,334894384,354501234.4,40.615448343955414,69.59499449170566,NaN,NaN,5.736308052792648,3.4718154416940012
2016-01-11T09:30:00-05:00,43.14,43.535,43.12,43.34,16389587,11528705.75,53.05707989489514,53.875690625185875,NaN,NaN,44.31824372476451,39.85202941944612,0.004153313409017589,0.12483499956672972,0.12068168615771213,351283971,352634060.6,39.2014747198476,66.9750352733907,NaN,NaN,5.8253682369892115,3.808037269593317
2016-01-12T09:30:00-05:00,43.37,43.4997,42.83,43.17,14360145,11529076.85,50.618736788790365,54.112853769142355,NaN,NaN,11.858180695481321,33.27419631152869,-0.00938939645118557,0.10894494059373017,0.11833433704491574,336923826,345705248.8,34.413637852009046,63.91191343751483,NaN,NaN,5.246390866672502,4.013516354890344
2016-01-13T09:30:00-05:00,43.33,43.515,43.02,43.15,17478889,11582793.7,50.32571012416545,54.06886132207838,NaN,NaN,13.280534515576665,24.498423950287023,-0.019740681787614484,0.09365848481039762,0.11339916659801211,319444937,337824459.2,29.935305819220616,60.445301459755264,NaN,NaN,4.6845104888408,4.109372659740409
2016-01-14T09:30:00-05:00,43.14,44.045,43,43.8,23082955,12231395.5,58.69464586333894,54.20182436515124,NaN,NaN,98.4889534155063,39.690675607657916,0.01525381518607316,0.13246643558060356,0.1172126203945304,342527892,337015002,29.510518651325214,56.93145168220959,NaN,NaN,6.562165488725594,4.459771635309721
2016-01-15T09:30:00-05:00,43.36,43.68,42.89,43.41,18939056,12263322.5,52.93234854230903,53.94691978931075,NaN,NaN,20.868145105573273,37.76281149138041,0.01043056376021978,0.13025082509480512,0.11982026133458534,323588836,334753892.4,28.302363256987604,53.67667988819784,NaN,NaN,6.493269760113554,4.7502713674245545
2016-01-19T09:30:00-05:00,43.64,44.18,43.47,44.06,17884638,12499471.4,59.98363343989418,54.14439118919567,NaN,NaN,154.9695174715663,59.89306624074078,0.047249758850969326,0.17888245989829699,0.13163270104732766,341473474,332791793,27.259452473728416,50.259912650915226,NaN,NaN,8.72308905884927,5.317816751913799
2016-01-20T09:30:00-05:00,43.88,43.95,42.45,43.07,19900140,12574116.5,48.15152151075295,53.34200025020202,NaN,NaN,-39.38267491990667,49.64489511766318,0.003470849203548315,0.13597126255176306,0.13250041334821475,321573334,329721694.6,25.66579441895186,46.5071803866922,NaN,NaN,6.500665824109701,5.4867951907989285
2016-01-21T09:30:00-05:00,43.2,43.36,42.65,43.03,14087880,12826935.5,47.74175415953275,52.54853933825493,NaN,NaN,-96.93526828586208,27.60173455737543,-0.02791155840468787,0.09761096534235492,0.12552252374704279,307485454,327329798,24.465713082981026,42.58265858084808,NaN,NaN,4.675426555154629,5.3708853857068855
2016-01-22T09:30:00-05:00,43.29,43.83,43.08,43.8,15060464,13173667.5,55.57850325753444,52.74485784773815,NaN,NaN,66.2937645849633,21.162696791266832,0.0018769627487084939,0.1278687271829284,0.12599176443421992,322545918,323333403.2,22.567076121575923,38.70122985686022,NaN,NaN,5.844613489065377,5.438560829043813
2016-01-25T09:30:00-05:00,43.78,43.89,43.27,43.43,13521364,13420652.9,51.576061915673975,52.733248466641115,NaN,NaN,47.76141115406527,26.54135000096523,-0.004311741259887494,0.12060208785936055,0.12491382911924805,309024554,320420546.8,21.27134644130588,35.20474928733367,NaN,NaN,5.394095135342006,5.432208587086412
2016-01-26T09:30:00-05:00,43.53,44.16,43.53,43.73,11459638,13857844.45,54.440883849115856,52.680894095405115,NaN,NaN,119.19459483557371,19.386365473766713,0.010041811173473414,0.1374660930860898,0.1274242819126164,320484192,316222690.4,19.53092247230576,31.886778362595116,NaN,NaN,5.997482999010678,5.512962074504164
2016-01-27T09:30:00-05:00,43.65,44.15,43.46,43.83,13732107,14292610.7,55.388319108212684,52.772662250967834,NaN,NaN,105.98500315460491,48.45990108866903,0.02373199495588732,0.15708927560747554,0.13335728065158822,334216299,318751283.4,23.586619677435053,29.5614279337403,NaN,NaN,6.7745058165286185,5.693182609079086
2016-01-28T09:30:00-05:00,43.77,44.8185,43.53,44.53,15564037,14609616.2,61.43419679896141,53.56833101463116,NaN,NaN,203.1556261000948,108.47807996586042,0.07452523833724112,0.22651382857313962,0.1519885902358985,349780336,327210259.8,35.32930892207045,28.68964158954997,NaN,NaN,9.498002025470047,6.236728239992081
2016-01-29T09:30:00-05:00,44.82,45.46,44.82,45.42,17940362,15115060.2,67.47042686728838,54.81384443717611,NaN,NaN,312.6266138633372,157.74464982153518,0.15786679295188444,0.34932208142575405,0.1914552884738696,367720698,336245215.8,45.043566378900906,29.005935734903222,NaN,NaN,14.092764155373064,7.359019085046507
2016-02-01T09:30:00-05:00,45.21,46.06,45.18,45.85,29610948,16074024.25,69.92007279991381,56.01834393039173,NaN,NaN,277.4918161865921,203.69073082804053,0.2275241607632541,0.47586048942793724,0.24833632866468314,397331646,353906634.2,58.246702667216454,30.366309159715282,NaN,NaN,18.661341660542625,8.973636595831666
2016-02-02T09:30:00-05:00,45.68,46.1,45.46,46.05,15970061,16130190.85,71.01344439788636,57.475108759612866,NaN,NaN,225.26580965965218,224.90497379285625,0.2697563548052145,0.5855317721712012,0.31577541736598674,413301707,372470137.2,67.17360515005942,32.70630682386173,NaN,NaN,22.62014156655253,10.923137305934645
2016-02-03T09:30:00-05:00,46.21,46.83,46.2,46.62,32952417,17230409.45,73.92270780284642,59.16060859380436,NaN,NaN,219.02279119223542,247.51253140038233,0.31558280615919104,0.7102539250649755,0.3946711189057845,446254124,394877702.2,74.31276089432038,35.87612504351172,NaN,NaN,26.958266607288394,13.213870063270894
2016-02-04T09:30:00-05:00,46.58,46.83,46.295,46.42,27602570,17974587.95,71.22162358816678,60.05539271700635,NaN,NaN,168.33303052683513,240.5480122857304,0.31140089186873116,0.7839222337416984,0.4725213418729673,418651554,408651945.8,77.54559225072207,39.30720172918292,NaN,NaN,29.550126630541396,15.547621001452395
2016-02-05T09:30:00-05:00,46.15,46.75,45.74,46.57,27386322,18730218.7,72.04659873204376,61.420696301987405,NaN,NaN,130.5020362615569,204.12309676537433,0.29772036238645283,0.8446717948560334,0.5469514324695806,446037876,424315381.4,80.54419405117599,43.03876107162495,NaN,NaN,31.89128531382591,17.882430188934325
2016-02-08T09:30:00-05:00,46.47,47,45.98,46.41,29012354,19596796.7,69.74975899464748,62.1182766987555,NaN,NaN,116.03844928528915,171.83242338511374,0.2583414001701694,0.8698781826822923,0.611536782512123,417025522,428254156.6,81.2232362844415,46.89331705810445,NaN,NaN,33.128798148396214,20.060482754571737
2016-02-09T09:30:00-05:00,46.25,46.75,46.14,46.57,22620865,19908360.6,70.75384445685239,63.7327283377626,NaN,NaN,101.45374703999745,147.0700108611828,0.22475230856118933,0.8924771682136097,0.6677248596524203,439646387,433523092.6,82.12213276489615,50.92591265424333,NaN,NaN,34.444251797490196,22.11530690356009
2016-02-10T09:30:00-05:00,46.46,46.77,45.715,46.52,25920640,20486385.35,69.97221277693652,65.32061823900574,NaN,NaN,82.78027481117658,119.82150758497104,0.18263902599027504,0.8960236421402641,0.713384616149989,413725747,427017417.2,77.20737756751862,54.69317440313887,NaN,NaN,35.31114826724206,24.000427098371798
2016-02-11T09:30:00-05:00,46.23,46.61,45.68,45.7,25390041,20881942.95,58.54873902433522,65.53277793663436,NaN,NaN,58.640476860361964,97.88299685167641,0.08783472110280732,0.8231780175284982,0.7353432964256909,388335706,420954247.6,72.83256657313868,58.2835665782505,NaN,NaN,32.62901917327531,25.2330831090723
2016-02-12T09:30:00-05:00,45.67,45.93,45.19,45.56,21018740,20778732.2,56.84248189564554,65.90895079234662,NaN,NaN,31.65242121026492,78.11307384141801,0.008170320840422574,0.745556197476219,0.7373858766357965,367316966,405210065.6,62.870439877358194,61.25493039511138,NaN,NaN,29.920147074168028,25.902663675514546
2016-02-16T09:30:00-05:00,45.79,45.95,45.37,45.85,14638647,20563711.75,59.47689736539524,66.26866604350943,NaN,NaN,36.007439400043936,62.10687186436896,-0.030405567383000598,0.6993789174070457,0.7297844847900463,381955613,398196083.8,58.998767483912594,64.07406218165472,NaN,NaN,28.372940694721006,26.25556039254404
2016-02-17T09:30:00-05:00,46,46,45.46,45.76,19080334,20623496.55,58.28775371737412,66.47576851559239,NaN,NaN,33.27187610983357,48.47049767833617,-0.0653871722850976,0.6480505194336743,0.7134376917187719,362875279,382841862.2,51.51931156508768,66.06925445934421,NaN,NaN,26.758306759684064,26.32738130213547
2016-02-18T09:30:00-05:00,45.67,46.67,45.63,46.51,18884259,20572702.5,64.63348551638018,66.70428913826515,NaN,NaN,61.15632706563513,44.145708129227884,-0.04252628830194993,0.6602798313413345,0.7028061196432844,381759538,376448620.4,48.748141733601635,67.02774251731071,NaN,NaN,27.186022361236823,26.450044310578523
2016-02-19T09:30:00-05:00,46.31,46.44,45.9,46.2,17020139,20719315.45,60.534236353403124,66.20884695870193,NaN,NaN,51.864099208667994,42.7904325988891,-0.05215905582847424,0.6376072998576916,0.6897663556861658,364739399,371729359,46.74917913863399,67.1495720001488,NaN,NaN,26.287119776197372,26.4267693770955
2016-02-22T09:30:00-05:00,46.45,46.74,46.1899,46.74,12436748,20588129.65,64.73050021918266,65.83816320293542,NaN,NaN,79.06932055907264,52.27381246865063,-0.02728935373954644,0.6556546635117328,0.6829440172512793,377176147,373701195.2,47.71392762809798,66.39723092592604,NaN,NaN,26.82157744307414,26.483170529378164
2016-02-23T09:30:00-05:00,46.59,46.885,46.38,46.78,11788834,20501503.15,65.02713658058731,65.41056978741405,NaN,NaN,88.64862930862886,62.80205045036762,-0.013944516949896069,0.6655133710639092,0.6794578880138052,388964981,375103068.8,48.429269730821,65.05834982455187,NaN,NaN,27.336224181268776,26.605035336791108
2016-02-24T09:30:00-05:00,46.78,47.089,46.575,47,16750863,20766064.4,66.68668638819267,64.89371111493878,NaN,NaN,107.5078541190784,77.64924605221658,0.0029961610100959213,0.6832030892764251,0.6802069282663292,405715844,383671181.8,52.68961917877977,63.51383970201325,NaN,NaN,28.25485043078783,26.840723207362068
2016-02-25T09:30:00-05:00,47.15,47.48,47.01,47.48,12161923,20687555.2,70.0284210423719,64.80848236166773,NaN,NaN,159.18320659461008,97.25462195801158,0.03788834795641982,0.727567363211854,0.6896790152554342,417877767,390894827.6,55.99060232525372,61.9741975644798,NaN,NaN,30.081896696818394,27.303747991570113
2016-02-26T09:30:00-05:00,47.21,47.32,46.16,46.17,32953633,21557035,54.08317996024779,63.52538102082515,NaN,NaN,50.36142148719111,96.9540864137162,-0.032116886582109316,0.6495329070277975,0.6816497936099069,384924134,394931774.6,57.76417556452086,60.34705338686157,NaN,NaN,26.23617739124799,27.151237905809808
2016-02-29T09:30:00-05:00,46.1,46.74,46.06,46.3,20137793,21666906.55,55.1739763983326,62.48425369251695,NaN,NaN,12.00906413402803,83.54203512870728,-0.07222936585537809,0.5913630862906842,0.6635924521460623,405061927,400508930.6,60.15330892941558,58.8420585757883,NaN,NaN,23.613080656359585,26.64578687017406
2016-03-01T09:30:00-05:00,46.54,46.65,45.78,46.07,23641743,21368446.3,52.78479084633031,61.20074986319394,NaN,NaN,-34.60434193098552,58.8914408807844,-0.11431261644012802,0.5207016815959022,0.6350142980360303,381420184,398999971.2,59.17794046520328,57.203187697238796,NaN,NaN,20.72688392768451,25.800229306961267
2016-03-02T09:30:00-05:00,45.95,46.33,45.08,46.31,30224174,22081151.95,54.97573022914784,60.129572538351894,NaN,NaN,-91.12437438836888,19.164995179294944,-0.12517019119756922,0.47855155903906876,0.603721750236638,411644358,400185674,59.73048659775895,55.954838342255975,NaN,NaN,19.0381960868846,24.834224561236027
2016-03-03T09:30:00-05:00,46.38,46.59,45.76,46.59,21274288,21497245.5,57.45610424455038,60.05152719693869,NaN,NaN,-1.2130258097232178,-12.914251301571715,-0.1130489505404687,0.46241056206105213,0.5754595126015208,432918646,403193849.8,61.16660753797325,55.121555554029875,NaN,NaN,18.38650717238849,23.913122077114952
2016-03-04T09:30:00-05:00,46.29,47.26,46.18,47.11,22128436,21223538.8,61.6783603599543,60.39694708724647,NaN,NaN,108.39395487754662,-1.3077446235005936,-0.0715865482778455,0.4859763272542139,0.5575628755320594,455047082,417218439.4,67.06396646449289,55.421093167396634,NaN,NaN,19.144863132370478,23.23194222786574
2016-03-07T09:30:00-05:00,47.03,47.47,46.88,47.37,18492787,20778862.05,63.62236146959718,60.69305166611803,NaN,NaN,158.37410754386158,27.96526405846611,-0.030336634362211123,0.5196420825792956,0.5499787169415067,473539869,430914027.8,71.59972558612279,56.321161603268784,NaN,NaN,20.37266961668087,22.823474711982186
2016-03-08T09:30:00-05:00,47.46,47.875,47.205,47.84,16374777,20146983.2,66.89196452843933,61.30763815262268,NaN,NaN,187.65207038322137,72.41654652130748,0.022088560052290318,0.5775894170068696,0.5555008569545793,489914646,452612920.2,77.00334658344609,58.141449818865816,NaN,NaN,22.45957593918618,22.77148917301133
2016-03-09T09:30:00-05:00,47.74,48.21,47.7,48.06,14256618,19728770.85,68.32698924799512,61.571459847738026,NaN,NaN,193.16094644525182,129.27361068803162,0.06276522821176045,0.6339573922192798,0.5711921640075194,504171264,471118301.4,80.42415005601542,60.40402184189538,NaN,NaN,24.619698096656446,23.035519019246344
2016-03-10T09:30:00-05:00,48.04,48.26,47.64,48.0992,19471354,19406306.55,68.58824522698207,62.14674619585081,NaN,NaN,160.23322533818165,161.5628609176126,0.0822645212919959,0.6740228156225143,0.5917582943305184,523642618,489263095.8,83.08158085334063,62.999193392945855,NaN,NaN,26.44136500991843,23.522068446485214
2016-03-11T09:30:00-05:00,48.33,48.45,48.05,48.15,15695449,18921576.95,68.94573243766669,62.447834211456815,NaN,NaN,155.13520869711874,170.91111168152702,0.08802084819803846,0.7017843545780664,0.613763506380028,539338067,506121292.8,85.10475285552701,65.6699666234765,NaN,NaN,28.042141024922667,24.16779310054771
2016-03-14T09:30:00-04:00,48.14,48.3,47.94,48.21,11724815,18456880.7,69.38885122188879,62.759385257264064,NaN,NaN,129.44335358363836,165.12496088948237,0.08524809917259701,0.7203236303457743,0.6350755311731773,551062882,521625895.4,86.68215095153786,68.40231528209912,NaN,NaN,29.501020268893214,24.929682696025637
2016-03-15T09:30:00-04:00,48.16,48.455,48.1,48.3,13737001,18411798.4,70.07854688231515,63.00166100684424,NaN,NaN,123.54582924410686,152.3037126616595,0.0789950749272249,0.7338193748322084,0.6548242999049835,564799883,536602942.8,88.00372159595715,70.92475116904036,NaN,NaN,30.923818551543064,25.78598781824241
2016-03-16T09:30:00-04:00,48.12,49.04,47.795,49.04,27868155,18851189.45,75.05514664097583,63.360712835315944,NaN,NaN,135.0292293549739,140.6773692436039,0.11218991118836119,0.7950616888904349,0.6828717777020737,592668038,554302297.6,89.34886365898508,73.30748412144975,NaN,NaN,33.7709590230274,26.92669799035455
2016-03-17T09:30:00-04:00,48.85,49.42,48.67,49.31,17534900,18783721.5,76.58536746389834,64.96801194271956,NaN,NaN,155.03878206244397,139.6384805884564,0.1381197685186707,0.8555214883504121,0.7174017198317414,610202938,571614361.6,90.47400727407002,75.64390067213183,NaN,NaN,36.66016475879542,28.31719324298896
2016-03-18T09:30:00-04:00,48.94,49.09,48.61,48.63,16990654,18782247.25,65.66069425972057,65.71706321853299,NaN,NaN,111.0116118136092,130.8137612117545,0.09719520831486084,0.8388957302253175,0.7417005219104567,593212284,582389205,91.10388900228278,77.85465639162234,NaN,NaN,35.89042559559317,29.399083579075278
2016-03-21T09:30:00-04:00,48.48,48.82,48.111,48.58,15743228,18947571.25,64.92730289587962,66.58438550778651,NaN,NaN,80.10353311989681,120.94579711900617,0.05649652812128014,0.8123211820620568,0.7558246539407767,577469056,587670439.8,91.40391484664096,80.15651170458217,NaN,NaN,35.054038832554475,30.206934329572306
2016-03-22T09:30:00-04:00,48.52,48.78,48.36,48.42,11457382,18930998.65,62.520783348426185,67.12331787344924,NaN,NaN,73.9389074150686,111.0244127531985,0.010924207173622635,0.7694799129078049,0.7585557057341823,566011674,587912798,91.41821836437123,82.41992111648305,NaN,NaN,33.65489101717041,30.69949957065775
2016-03-23T09:30:00-04:00,48.42,48.97,48.2,48.78,15239636,18855437.3,65.60943247876293,67.70569846160728,NaN,NaN,76.83992977494842,99.3865528371934,-0.0021535543045223537,0.7558637628535294,0.7580173171580518,581251310,585629452.4,89.90045985016587,84.47233913878253,NaN,NaN,33.3359575223894,31.07613642090513
2016-03-24T09:30:00-04:00,48.76,48.98,48.62,48.91,15073453,19001013.8,66.6773629250224,68.06277007339786,NaN,NaN,82.868545293742,84.95250548345301,-0.008851951856930107,0.7469523773368891,0.7558043291938192,596324763,582853817.4,87.98810156910965,85.96692021768374,NaN,NaN,33.37556321572653,31.404625963022472
2016-03-28T09:30:00-04:00,48.99,49.25,48.63,48.73,11244554,17915559.85,63.726574727625824,68.07021387754277,NaN,NaN,80.02467304481402,78.75511772969396,-0.030964047015854868,0.7170992704240007,0.7480633174398555,585080209,581227402.4,86.82265038890188,87.0542719893108,NaN,NaN,32.57241904845941,31.57145354665632
2016-03-29T09:30:00-04:00,48.88,49.49,48.685,49.45,17553613,17786350.85,69.53440551076496,68.2589596619946,NaN,NaN,103.09525770418028,83.35346264655065,-0.004071525892429095,0.7429739100743191,0.7470454359667482,602633822,586260355.6,87.37972720584295,87.79544203376771,NaN,NaN,33.61440759834372,31.863304125468805
2016-03-30T09:30:00-04:00,49.45,49.56,49.15,49.33,14516907,17330109.05,67.59193819670956,68.20645601547419,NaN,NaN,111.52410104611386,90.87050137275972,-0.0014711688312341042,0.7452064749277056,0.7466776437589397,588116915,590681403.8,87.86502997132213,88.32693345628964,NaN,NaN,33.88174364621659,32.15165262843277
2016-03-31T09:30:00-04:00,49.4,49.67,49.22,49.62,14703418,16554071.25,69.78842583557719,68.29218320180242,NaN,NaN,123.62667928550944,100.22785127487192,0.011935610655743112,0.7615971570786186,0.7496615464228755,602820333,594995208.4,88.33633175640605,88.7022728065086,NaN,NaN,34.767946926696105,32.5254089567561
2016-04-01T09:30:00-04:00,49.42,49.88,49.26,49.81,17872603,16383987,71.16722931139051,68.45086154992553,NaN,NaN,136.2861189376505,110.91136600365363,0.025003870776875936,0.7809163848939704,0.7559125141170945,620692936,599868843,88.86261644150665,88.97069163407856,NaN,NaN,35.91682566227899,33.00989705754509
2016-04-04T09:30:00-04:00,49.82,49.88,49.345,49.6,15286137,16041872.05,67.50043968673975,68.31597501170062,NaN,NaN,124.2854734451914,119.76352608372909,0.011590839321546031,0.770401063269027,0.758810223947481,605406799,603934161,89.29646585452036,89.15742841286303,NaN,NaN,35.8229865239051,33.411766981310805
2016-04-05T09:30:00-04:00,49.49,49.57,48.63,48.67,18658430,16050154.2,54.18554541944794,67.18076062149582,NaN,NaN,33.392768058960364,105.8230281546851,-0.06369215520928395,0.679195029935876,0.74288718514516,586748369,600757070.4,86.461812652232,89.0472920597398,NaN,NaN,31.29863439942789,33.10989089818467
2016-04-06T09:30:00-04:00,48.6,48.68,48.31,48.61,20294480,16246139.35,53.4529640029465,65.63774757592229,NaN,NaN,-37.202142855263695,76.0777793744096,-0.1181410501762249,0.5952108724248788,0.7133519226011037,566453889,596424465.2,82.61053102969389,88.56598258621901,NaN,NaN,27.499358644841642,32.30838629056424
2016-04-07T09:30:00-04:00,48.54,48.91,48.46,48.59,15280570,16297336.95,53.194794456256446,63.966992361090725,NaN,NaN,-25.291263062237576,46.294190904860194,-0.1538552602098643,0.5210328473387733,0.6748881075486376,551173319,586095062.4,74.13240600437825,87.39872535266959,NaN,NaN,24.38333593870492,31.176236240298625
2016-04-08T09:30:00-04:00,48.74,49.165,48.69,48.85,16437195,16145629,56.15921348679678,63.288315163024734,NaN,NaN,10.342061983706744,21.105379514071444,-0.15773512164489456,0.47771920549251945,0.635454327137414,567610514,575478578,66.57041958359684,85.64633467990632,NaN,NaN,22.578155535331724,29.947938996731924
2016-04-11T09:30:00-04:00,48.85,49.16,48.6,48.64,11125030,15917108.05,53.226920214301884,62.45257354291204,NaN,NaN,-15.256392145794635,-6.802993604125757,-0.17109323311007985,0.42158778574981426,0.5926810188598941,556485484,565694315,60.45032014960475,83.435363630118,NaN,NaN,20.191942088399273,28.554225152684403
2016-04-12T09:30:00-04:00,48.65,49.04,48.57,48.98,13427647,16002249.65,57.12980846608443,62.06750390845906,NaN,NaN,-10.554050979451185,-15.592357411808061,-0.1542022026071338,0.39992826560097683,0.5541304682081106,569913131,562327267.4,58.458586256591914,81.08110419384808,NaN,NaN,19.258443158454927,27.226256296365907
2016-04-13T09:30:00-04:00,49.12,49.12,48.42,48.68,13320464,15981422.8,52.932780364241964,61.162028757421844,NaN,NaN,-45.0905316081186,-17.17003516237905,-0.1597288985035642,0.35446934507865535,0.5141982435822195,556592667,560355023,57.26832217836884,78.75023721729113,NaN,NaN,17.20078727268546,25.79404643584013
2016-04-14T09:30:00-04:00,48.56,48.79,48.46,48.62,12090787,15192554.4,52.108261919239034,60.121378685580176,NaN,NaN,-72.1704579780257,-26.54587414553667,-0.16333657868650409,0.3100275202240894,0.4733640989105935,544501880,559020735.2,56.43120204570644,76.4961729656195,NaN,NaN,15.280622976648866,24.292128798812808
2016-04-15T09:30:00-04:00,48.72,49,48.55,48.89,10962869,14863952.85,55.469724263280234,59.531603652412635,NaN,NaN,-25.213324977110485,-33.65695153770012,-0.1441202302788951,0.29321381106197464,0.43733404134086973,555464749,556591582.2,54.85898981181742,74.2130543529706,NaN,NaN,14.58139535016191,22.90488116329125
2016-04-18T09:30:00-04:00,48.86,49.08,48.5301,49.0792,9124107,14470625.5,57.70973504746423,58.68698433360544,NaN,NaN,-6.713141321139981,-31.948301372769187,-0.11643356374181157,0.29179208666360523,0.4082256504054168,564588856,558212256.6,55.744882173628135,71.95342256495526,NaN,NaN,14.628878873568155,21.722595121902238
2016-04-19T09:30:00-04:00,49.13,49.23,48.84,49.16,10495446,14208236.4,58.665997488601136,58.04941714016912,NaN,NaN,30.846402464814073,-23.66821068391614,-0.09154170582241106,0.293798518127403,0.38534022394981404,575084302,559246490.8,56.33381095657354,69.70119263533034,NaN,NaN,14.934979530943584,20.752935751765285
2016-04-20T09:30:00-04:00,49.2,49.26,47.9,47.93,26068701,14938802.35,42.80022616711056,56.121688592421506,NaN,NaN,-141.62483504344507,-42.97507137098144,-0.15315000379175353,0.19390271921012214,0.3470527230018757,549015601,557731077.6,55.175193681496985,67.332539915694,NaN,NaN,9.814808670659046,19.190346168750107
2016-04-21T09:30:00-04:00,47.75,47.88,46.725,46.93,32065681,15780104.6,34.60603417579016,53.510174654164345,NaN,NaN,-341.1875538410457,-96.77849054358543,-0.25071819238745746,0.03365498251755383,0.2843731749050113,516949920,552220685.6,51.06265170217909,64.63254243431345,NaN,NaN,2.0262271771230997,16.738329169946248
2016-04-22T09:30:00-04:00,47.06,47.41,47.03,47.3492,12309022,15641883.05,39.80841134049038,51.532172629432246,NaN,NaN,-243.1921915177287,-140.3742638517091,-0.2745691921333939,-0.05883831526173111,0.2157308768716628,529258942,546979524.2,47.4406640957633,61.642842308687946,NaN,NaN,-2.2260867116355016,14.029126901148855
2016-04-25T09:30:00-04:00,47.15,47.45,47.12,47.44,12742883,15716799.5,40.905050580797685,50.583565855242945,NaN,NaN,-181.73173164930495,-175.37798191734208,-0.27129729929818236,-0.12339074725106514,0.14790655204711722,542001825,542462118,44.51011750906946,58.6462926556049,NaN,NaN,-5.084733629516203,11.298575396768133
2016-04-26T09:30:00-04:00,47.47,47.71,47.38,47.51,13021794,15490208.55,41.7856030788617,49.750182932094035,NaN,NaN,-130.964105482897,-207.74008350688428,-0.2519058868643292,-0.16697580653329425,0.08493008033103493,555023619,538449981.4,42.02699871341383,55.74746891872777,NaN,NaN,-7.033552504299036,8.679699982329966
2016-04-27T09:30:00-04:00,47.65,48.475,47.5,48.2,24559219,15992324.15,49.7361400103902,49.50313618596073,NaN,NaN,-59.49420628234684,-191.31395775466464,-0.18328650567717147,-0.14417805176542942,0.03910845391174205,579582838,544563428.8,46.88903403014439,53.801513777711065,NaN,NaN,-6.066592447334607,6.57308677809217
2016-04-28T09:30:00-04:00,47.78,48.25,47.5,48.13,20158019,16265054.2,49.00493442252956,48.99211625279878,NaN,NaN,-61.60872550742447,-135.3981920879404,-0.13549280620959891,-0.1302575538502566,0.005235252359342316,559424819,553058408.6,52.81133978865759,52.818722363786826,NaN,NaN,-5.538216022216094,4.842900663762419
2016-04-29T09:30:00-04:00,47.93,48.47,47.5681,48.42,20177234,16380285.75,52.14391910025872,48.91475903036712,NaN,NaN,-31.989360808993787,-93.15762594619342,-0.07997449079771367,-0.09473286113779977,-0.014758370340086105,579602053,563127030.8,58.69089874679663,52.693049406443386,NaN,NaN,-4.1091537815346735,3.5640357430056913
2016-05-02T09:30:00-04:00,48.45,49.05,48.39,48.81,16366582,16434308,56.06099967865835,48.83841554555097,NaN,NaN,48.97752196896114,-47.0157752225402,-0.015960853172700316,-0.0347094368059615,-0.018748583633261186,595968635,573920392.8,63.885582343073146,53.08069198404918,NaN,NaN,-1.6467108317324504,2.8196433751859566
2016-05-03T09:30:00-04:00,48.77,49.03,48.5,48.77,15746653,16288719.15,55.55870616861173,49.02598167443453,NaN,NaN,53.15938240569026,-10.19107764482274,0.022616569743274733,0.009522128545832231,-0.013094441197442502,580221982,578960065.4,66.03339202882168,53.70676840193867,NaN,NaN,0.1745686617464621,2.4417755589803147
2016-05-04T09:30:00-04:00,48.79,49.65,48.64,49.34,17603930,16154191.65,60.93066086924084,49.65615302800609,NaN,NaN,101.6766991800936,22.043103447665363,0.08210600099704146,0.08953806004885934,0.007432059051817867,597825912,582608680.2,67.53858771844762,54.50015309284875,NaN,NaN,3.5044865787679194,2.5935914189499725
2016-05-05T09:30:00-04:00,49.2,49.745,48.97,49.15,15826480,16181487.15,58.39671410261061,49.865223730815394,NaN,NaN,102.61317046829299,54.88748264280887,0.10289557897002438,0.13605153276434834,0.03315595379432396,581999432,587123602.8,69.34866516444171,55.53512990375049,NaN,NaN,5.4846946482427885,3.006606165991803
2016-05-06T09:30:00-04:00,48.91,49.08,48.39,48.83,20053586,16362306.7,54.300817128999235,49.621729593782185,NaN,NaN,41.54456481513394,69.59426776763442,0.0898081984824588,0.14541620189739746,0.05560800341493866,561945846,583592361.4,66.23768889154545,56.28461609788743,NaN,NaN,5.935732022414799,3.4250527169093736
2016-05-09T09:30:00-04:00,48.86,49.18,48.76,49.11,11231779,16367644.15,57.13394922285478,49.5122975748003,NaN,NaN,69.28904961464602,73.65657329677138,0.09425936608852811,0.1734322110255988,0.07917284493707069,573177625,579034159.4,62.3495416659115,56.71431114855444,NaN,NaN,7.173795678630501,3.9605874257266773
2016-05-10T09:30:00-04:00,49.16,49.34,48.98,49.16,13257927,16359158.15,57.63898414740225,50.57220885910685,NaN,NaN,82.79102600014012,79.58290201566135,0.09457711946034705,0.19739424426250451,0.10281712480215746,586435552,580276873.4,62.98743638106504,57.27232848423786,NaN,NaN,8.325544180009754,4.584152676338546
2016-05-11T09:30:00-04:00,49.17,49.38,48.9,49.34,12173944,16301832.15,59.48937741457564,52.349590519020104,NaN,NaN,82.8081187166977,75.80918592298218,0.10036820762092621,0.22827738432831524,0.12790917670738902,598609496,580433590.2,63.07240504861018,58.13016800898294,NaN,NaN,9.82732977097403,5.333177975572186
2016-05-12T09:30:00-04:00,49.26,49.71,49.08,49.63,17727710,16583678.3,62.34334837607603,53.95922887870479,NaN,NaN,102.1758978830026,75.7217314059241,0.11607748115265648,0.2730060281482096,0.15692854699555314,616337206,587301145,66.68201016856682,59.504549871326084,NaN,NaN,11.956814929319558,6.279411826107524
2016-05-13T09:30:00-04:00,49.5,49.61,49.15,49.39,12626636,16666866.65,58.66017698624177,55.22745219337937,NaN,NaN,86.41487095049689,84.69579263299669,0.1030918491680029,0.28579335845555676,0.18270150928755385,603710570,595654089.8,70.46370784574464,61.358377752517164,NaN,NaN,12.740339974060397,7.2024015615293635
2016-05-16T09:30:00-04:00,49.22,49.46,49.04,49.45,11087144,16765018.5,59.3074263830839,56.47901100082381,NaN,NaN,75.45481275007167,85.9289452600818,0.09171186657246175,0.29734134250313105,0.2056294759306693,614797714,603978107.6,73.670881046774,63.61865506204289,NaN,NaN,13.56842633231431,8.111833671641499
2016-05-17T09:30:00-04:00,49.29,49.41,48.35,48.6108,17532997,17116896.05,47.989894117245974,56.35427915131351,NaN,NaN,24.60768862713325,74.29227778548044,0.024340958199435547,0.23605567367996372,0.21171471548052817,597264717,606143940.6,74.44831348850948,65.58717502335467,NaN,NaN,10.827828783063024,8.499832973273145
2016-05-18T09:30:00-04:00,48.33,48.7096,47.5406,47.7,27257599,17176340.95,39.23816969324249,55.65665309922157,NaN,NaN,-53.7828811898047,46.974077804179956,-0.07921710608111093,0.11269333287913952,0.19191043896025045,570007118,600423465,68.68000467057465,66.72065108634875,NaN,NaN,5.197266874418328,8.028037816293885
2016-05-19T09:30:00-04:00,47.52,48.19,47.25,48.18,19582762,16552195,44.937248358609125,55.14189090338946,NaN,NaN,-72.50405021745773,12.038088184087888,-0.11108973512526821,0.05304827005366519,0.1641380051789334,589589880,595073999.8,63.70886017556082,67.07907690268905,NaN,NaN,2.502451353364381,7.23866832158967
2016-05-20T09:30:00-04:00,48.29,48.35,47.92,48.29,15185693,16696028.55,46.18299425791284,54.436319087621925,NaN,NaN,-48.7273550568555,-14.990357017382589,-0.11971984589445075,0.014488197810869963,0.13420804370532072,604775573,595287000.4,63.8211488580298,67.07447451090023,NaN,NaN,0.8066535810465489,6.319809072940653
2016-05-23T09:30:00-04:00,48.28,48.4,47.8,47.86,12690241,16693396.45,42.16690180389174,53.479761632999065,NaN,NaN,-77.2699972092351,-45.53531900924394,-0.14751826454009304,-0.05018978696979559,0.09732847757029744,592085332,590744524,59.58684241024927,66.61400668100221,NaN,NaN,-1.9433038055051766,5.13936437601982
2016-05-24T09:30:00-04:00,47.94,48.395,47.87,48.34,13383311,16711472.3,47.64051891182159,52.530465778897685,NaN,NaN,-63.672591220907,-63.19137497885199,-0.12746347013191178,-0.06200086009459227,0.0654626100373195,605468643,592385309.2,60.60360118028313,66.11865049970474,NaN,NaN,-2.4581045515866964,4.054011672076032
2016-05-25T09:30:00-04:00,48.08,48.35,47.86,48.2,14350595,16201041.1,46.26513705744766,51.663924561386054,NaN,NaN,-73.57330625006642,-67.14945999090433,-0.11774295084955287,-0.0817160785246216,0.03602687232493128,591118048,596607495.2,63.17134291827519,65.67741319640713,NaN,NaN,-3.3022127032335917,3.003122475603229
2016-05-26T09:30:00-04:00,48.14,48.81,48.14,48.745,13154450,15850862.65,52.06660798249019,51.50433819377826,NaN,NaN,-21.456877356077925,-56.94002541862837,-0.07102586097402028,-0.05275545389259406,0.01827040708142621,604272498,599544018.8,64.8855432944745,65.58083136804493,NaN,NaN,-2.1452381961500353,2.267642379638477
2016-05-27T09:30:00-04:00,48.74,48.92,48.58,48.83,15105465,15597274.2,52.92034160272293,51.2033662209117,NaN,NaN,5.201042305646321,-46.15434594612801,-0.03276326749288684,-0.022683677284682346,0.010079590208204496,619377963,602464496.8,66.55293941532591,65.88107406443167,NaN,NaN,-0.9601541180769433,1.8065285942505598
2016-05-31T09:30:00-04:00,48.75,49.19,48.74,49.15,15586188,15558254.5,56.091027573623755,51.09279789421323,NaN,NaN,41.40172280784773,-22.420001942711444,0.013266248173927929,0.026662400425614408,0.013396152251686479,634964151,611040260.6,70.91966406577534,66.4476617561967,NaN,NaN,1.019081971478783,1.6940362195688774
2016-06-01T09:30:00-04:00,49.14,49.34,49.035,49.28,11283102,15335076.95,57.34775159177493,50.939824621156035,NaN,NaN,64.79062347948074,3.272640997366105,0.04959538433659005,0.07539038267242404,0.025794998335833992,646247253,619195982.6,74.34946256651332,67.25316586461835,NaN,NaN,3.014932294023213,1.8827356587766395
2016-06-02T09:30:00-04:00,49.24,49.3,48.81,49.3,7703686,14840064.75,57.54905232564175,50.59737490326787,NaN,NaN,53.64968756668639,28.717239760716666,0.07080709627197085,0.11430386867579756,0.04349677240382671,653950939,631762560.8,78.54782417956672,68.1007240082612,NaN,NaN,4.695467519779251,2.284554496062727
2016-06-03T09:30:00-04:00,49.95,50.35,49.71,50.08,18718896,14984685.55,64.57172903866129,51.019628621297876,NaN,NaN,169.6702691539826,66.94266906272875,0.12977158739073552,0.2057112566422461,0.07593966925151059,672669835,645442028.2,82.00133286656968,68.92484008117728,NaN,NaN,8.492747842248443,3.1714392598035435
2016-06-06T09:30:00-04:00,50.1,50.27,49.8,50.01,10842755,14524144,63.55558073041027,51.32306821753547,NaN,NaN,142.91398304030506,94.4852572096605,0.15476698310735665,0.26939839813570643,0.11463141502834977,661827080,653931851.6,83.74981669638954,69.64476405614981,NaN,NaN,11.261613364494954,4.327178417616602
2016-06-07T09:30:00-04:00,50.05,50.31,49.87,49.97,7904117,14357760.9,62.946002467639694,52.39136167113502,NaN,NaN,128.26702974412578,111.85831859691612,0.15872269262413768,0.3130347808085219,0.1543120881843842,653922963,657723614,84.47521097317585,70.36097101934027,NaN,NaN,13.352959972906561,5.616575782658025
2016-06-08T09:30:00-04:00,49.96,50.31,49.885,50.27,6765142,14033121.65,65.61011434698185,54.27507200354497,NaN,NaN,124.98417311030886,123.89702852308173,0.17062001418316233,0.3675871059133371,0.19696709173017476,660688105,660611784.4,85.02360111564238,71.52837076541654,NaN,NaN,15.943896419724451,7.091907302238942
2016-06-09T09:30:00-04:00,50.3,50.79,50.23,50.7,9702772,13909563.05,69.04548270398736,55.997088742500566,NaN,NaN,147.2603455622773,142.61916012219993,0.1947787258312457,0.4404404990192319,0.24566177318798618,670390877,663899772,85.64525884782536,73.095256384864,NaN,NaN,19.27896143374944,8.83291503531187
2016-06-10T09:30:00-04:00,50.65,50.91,50.37,50.57,12911292,13668742.15,66.87059253166416,57.4747743334828,NaN,NaN,134.77540897175606,135.6401880857546,0.18917436780584218,0.48212973294528894,0.29295536513944676,657479585,660861722,82.24807453195965,74.41146536157328,NaN,NaN,21.42885542087363,10.632335090392122
2016-06-13T09:30:00-04:00,50.65,50.835,50.47,50.51,13149692,13694894.95,65.83977223315023,59.165693649858405,NaN,NaN,118.19112198378453,130.69561587445054,0.16924495384098603,0.5045115574406793,0.3352666035996933,644329893,657362284.6,78.39089882074369,75.75461224803716,NaN,NaN,22.924789065253588,12.38839994394376
2016-06-14T09:30:00-04:00,50.53,50.81,50.26,50.78,11606446,13720860.05,68.21429753415171,60.63524926573913,NaN,NaN,104.46209255714662,125.93462843705467,0.1620556907228649,0.5378362170032744,0.37578052628040953,655936339,657764959.8,78.5157535927132,77.03405170606788,NaN,NaN,24.901201556202913,14.175943031409354
2016-06-15T09:30:00-04:00,50.76,50.86,50.28,50.46,10891343,13388777.35,62.655437865000046,61.80598503770716,NaN,NaN,86.54292139714708,118.24637809442231,0.1252068010380119,0.5322890275779244,0.4070822265399125,645044996,654636338,74.89495892381157,77.87145284932048,NaN,NaN,25.051740997632372,15.729628455155499
2016-06-16T09:30:00-04:00,50.4,50.89,50.36,50.78,10027115,12527253.15,65.6683703617764,62.77753949337046,NaN,NaN,87.04279579445846,106.20286814085856,0.11225744492776968,0.5474040326996246,0.4351465877718549,655072111,651572584.8,71.42150543378675,78.33830728784278,NaN,NaN,26.05767408843043,17.205063545623346
2016-06-17T09:30:00-04:00,50.32,50.56,50.04,50.55,19211334,12508681.75,61.8084995281089,63.41240791661232,NaN,NaN,60.153603523732194,91.2785070512538,0.07961110757223,0.5346604722371424,0.4550493646649124,635860777,647248823.2,66.71877980133789,78.35015302970078,NaN,NaN,25.789610515728157,18.43142739849546
2016-06-20T09:30:00-04:00,50.47,50.62,49.98,50.36,15937898,12546292,58.73707870578655,63.60141156890966,NaN,NaN,50.50244270563988,77.74077119562487,0.03870171565064584,0.5034265092282197,0.4647247935775739,619922879,642367420.4,61.773504527245365,77.69685591980578,NaN,NaN,24.672023900384342,19.32294118447959
2016-06-21T09:30:00-04:00,50.39,50.67,50.07,50.43,8669142,12345237.05,59.53489142518312,63.75763584272453,NaN,NaN,51.80227365449434,67.20880741509443,0.011262122687207832,0.4788024469365837,0.46754032424937586,628592021,636898556.8,56.702631675488426,76.4363679990183,NaN,NaN,23.963139245982404,19.985826621837134
2016-06-22T09:30:00-04:00,50.43,50.51,50.14,50.19,7980292,12075086.1,55.56788642572948,63.6161239927308,NaN,NaN,37.825059101651156,57.46523495599524,-0.026105576876897296,0.43490835315325427,0.46101393003015156,620611729,632011903.4,52.5515158025289,74.57948882922987,NaN,NaN,22.222108067002647,20.30529539971792
2016-06-23T09:30:00-04:00,50.1,50.35,49.99,50.33,8425192,11778815.95,57.35306033518766,63.10050479962554,NaN,NaN,26.549963530265714,45.36666850315669,-0.04342693261952746,0.4067302642557422,0.45015719687526967,629036921,626804865.4,48.47885804869459,72.1850263422388,NaN,NaN,21.22820476836503,20.437139595238936
2016-06-24T09:30:00-04:00,50.22,50.86,49.79,50.61,24190968,12330641.85,60.74964055201284,62.90008050116858,NaN,NaN,47.43601762444281,42.823151323298816,-0.03824216262858815,0.40235449358953446,0.4405966562181226,653227889,630278287.8,51.19592471018462,69.85974834322418,NaN,NaN,21.30470999661534,20.561078224006994
2016-06-27T09:30:00-04:00,50.35,51.17,50.28,51.03,17095697,12430153.45,65.22380560503512,63.06278072526824,NaN,NaN,109.31248394082613,54.58515957033603,-0.01020114869561145,0.4278452203486083,0.43804636904421973,670323586,640358429.2,58.10159733953656,67.97591879796423,NaN,NaN,22.707928666407817,20.86777114434997
2016-06-28T09:30:00-04:00,51.05,51.25,50.63,51.22,13207265,12311207.3,67.05345244063656,63.16587630338644,NaN,NaN,146.1097708081973,73.44665900107663,0.016040947658549465,0.45809755361740656,0.4420566059588571,683530851,651346195.2,64.0697225939131,66.47921318926929,NaN,NaN,24.434655491095715,21.377326051027932
2016-06-29T09:30:00-04:00,51.46,51.6,51.18,51.36,14013443,12447724.35,68.37380898326829,63.11789960904936,NaN,NaN,205.28087896507733,106.93782297376185,0.0365524195159056,0.48774713035373907,0.45119471083783347,697544294,666732708.2,70.42314758296614,65.39191952749363,NaN,NaN,26.26605330162834,22.075715658256563
2016-06-30T09:30:00-04:00,51.59,52.53,51.36,52.47,17372378,12931158.95,76.43678658054242,63.80119918396924,NaN,NaN,307.4972418449028,163.12727863668928,0.11421662525620391,0.5939654924080884,0.4797488671518845,714916672,683908658.4,75.60823232771249,64.9176450843331,NaN,NaN,30.998805149527097,23.35044272843807
2016-07-01T09:30:00-04:00,52.76,52.76,51.9431,52.48,17480829,12869255.6,76.49492616024433,64.5622816073331,NaN,NaN,262.65562525111676,206.17120016202406,0.15317201837091754,0.6712138901155313,0.5180418717446138,732397501,699742580.8,79.2241258537373,64.97716130097551,NaN,NaN,34.644177658570385,24.963833432742685
2016-07-05T09:30:00-04:00,52.64,52.95,52.48,52.87,12553428,12954789.25,78.7020396983263,65.3114060476313,NaN,NaN,231.47355605357308,230.60341458457347,0.1897249738057616,0.7551980890018157,0.5654731151960541,744950929,714668049.4,81.94165630731281,65.22186863773263,NaN,NaN,38.47628191492374,26.894183215911408
2016-07-06T09:30:00-04:00,52.81,53.02,52.5,52.98,15102661,13314716.45,79.29264910431124,66.49977827901066,NaN,NaN,184.36684640307436,238.25482970354886,0.20455459405935295,0.8211663577702453,0.6166117637108923,760053590,729972597.2,84.22082567082478,65.888001976805,NaN,NaN,41.731932234355824,29.013861647117754
2016-07-07T09:30:00-04:00,52.8,52.83,51.9,52,22718617,14112390.2,62.62943078261507,66.28271116621343,NaN,NaN,106.9227011368055,218.5831941378945,0.13496358061555058,0.7853162394803306,0.65035265886478,737334973,737930733,85.26242398720852,66.87663901633513,NaN,NaN,38.90911674727425,30.42746951856868
2016-07-08T09:30:00-04:00,51.55,52.57,51.44,52.54,16092381,14431870.65,66.77295637947552,66.63731522702531,NaN,NaN,87.57450739610688,174.59864724813534,0.11280266509039294,0.7913559902277711,0.6785533251373782,753427354,745632869.4,86.21112501704467,68.26894938888562,NaN,NaN,38.03165947493274,31.513782369477834
2016-07-11T09:30:00-04:00,52.38,52.54,51.89,52.5,14506048,14511608.45,66.18753652807908,67.16949078576049,NaN,NaN,85.79875406633934,139.22727301117982,0.0842603827723345,0.7838788036027964,0.6996184208304619,738921306,746937630.4,86.37117883983638,70.02592612549925,NaN,NaN,37.16782834154415,32.32150322263016
2016-07-12T09:30:00-04:00,52.15,52.36,51.75,51.78,18002289,14754238.3,56.572907578207854,66.95792051097655,NaN,NaN,52.17930486355223,103.36842277317564,0.009626559126638234,0.7116516197387597,0.7020250606121214,720919017,742131248,82.56905240215562,71.87352760597548,NaN,NaN,33.001806086780086,32.41868934608015
2016-07-13T09:30:00-04:00,52,52.19,51.88,52.19,14604721,14904152.05,60.12506604304604,67.28343334078487,NaN,NaN,55.69899185327131,77.63485186321503,-0.017892102081179195,0.6796599330106474,0.6975520350918266,735523738,737225277.6,78.75801043953265,73.74542008004718,NaN,NaN,30.82334368286088,32.19078282276311
2016-07-14T09:30:00-04:00,51.67,52.09,51.61,51.85,17361300,15227649.9,56.03201146436044,67.18907270715435,NaN,NaN,32.963815239628474,62.843074683779626,-0.0622597866957636,0.6197273017221221,0.6819870884178857,718162438,733390770.6,75.81265683420422,75.69783427901216,NaN,NaN,27.6605950802735,31.543613145264594
2016-07-15T09:30:00-04:00,51.79,52.13,51.75,52,12951718,15373880.05,57.40954221642242,66.9504942546122,NaN,NaN,37.3983321582565,52.80783963620955,-0.08344972750187618,0.5776749290405405,0.6611246565424167,731114156,728928131,72.41829628107097,77.2137179626469,NaN,NaN,25.595568691724242,30.693892509044545
2016-07-18T09:30:00-04:00,52.06,52.31,52.05,52.15,11168128,14971719.75,58.799655631531,66.49162639936189,NaN,NaN,49.58703140071208,45.56549510308411,-0.0888112969954511,0.5501105352981028,0.6389218322935539,742282284,729600326.6,72.61717260228778,78.25054476712913,NaN,NaN,24.35504325711195,29.78834261591132
2016-07-19T09:30:00-04:00,52.1,52.21,51.82,52.06,10682045,14708927.1,57.58519154704154,65.81532204981939,NaN,NaN,33.223629813746165,41.774360093122894,-0.09908470807011938,0.5150659472059047,0.6141506552760241,731600239,731736571,73.27663952031929,78.90818169044385,NaN,NaN,22.98913830434471,28.817027714258945
2016-07-20T09:30:00-04:00,51.99,52.11,51.68,51.76,11599633,14855451.65,53.6103317326343,64.76078796048839,NaN,NaN,10.95787669647422,32.826137061763475,-0.1250740924143401,0.45780803975809903,0.5828821321724391,720000606,728631944.6,70.6149672531973,78.92188309546036,NaN,NaN,20.636368376438313,27.648362094570285
2016-07-21T09:30:00-04:00,51.53,52.1075,51.47,52.07,13259155,15119394.8,56.91948589953883,63.36669505470242,NaN,NaN,7.133201864272631,27.660014386692307,-0.12033769377689174,0.43246001495132447,0.5527977087282162,733259761,731651409.2,71.69193930432996,78.64214787950446,NaN,NaN,19.59634285017563,26.498073631085333
2016-07-22T09:30:00-04:00,51.94,52.81,51.89,52.76,13220716,15359171,63.210141774940226,62.41778188432355,NaN,NaN,84.1636408989926,37.01307613483954,-0.07206627327032789,0.4627148671403063,0.5347811404106342,746480477,734724673.4,72.78523461792095,78.18222707694615,NaN,NaN,20.661660029847244,25.66430025947989
2016-07-25T09:30:00-04:00,52.69,52.74,52.35,52.67,7155298,14507387.5,61.9396785451882,61.22047037338512,NaN,NaN,98.28713326711149,46.75309650811941,-0.04865193626091391,0.47396622008449185,0.5226181563454058,739325179,734133252.4,72.2072850912144,77.48691484722484,NaN,NaN,21.12904392292182,25.016406497114453
2016-07-26T09:30:00-04:00,52.69,52.73,52.06,52.21,12509095,14278057.4,55.7698279710721,59.540268863868036,NaN,NaN,45.54859590945336,49.21808972726086,-0.06554660387069777,0.44068490150703354,0.5062315053777313,726816084,733176421.4,71.22195063552512,76.55842377327487,NaN,NaN,19.608310151969317,24.243821304950863
2016-07-27T09:30:00-04:00,52.09,52.15,51.16,51.61,22559750,14745681.65,48.924279641801135,58.56132949666704,NaN,NaN,-123.47255283849864,22.332003820266284,-0.11560560723292285,0.36172449633657777,0.4773301035695006,704256334,730027567,67.93640689970283,75.32085112416733,NaN,NaN,16.01929618934495,23.06888914557859
2016-07-28T09:30:00-04:00,51.58,51.9,51.46,51.81,9115780,14500798.5,51.07984021569655,57.440392627825695,NaN,NaN,-114.63243487260324,-2.0211235271088897,-0.13250957845236883,0.3116931305040396,0.4442027089564084,713372114,726050037.6,63.92488779233244,73.72897703668788,NaN,NaN,13.788330545663353,21.743095059876413
2016-07-29T09:30:00-04:00,51.82,52.29,51.73,52.12,15474671,14405913.15,54.299313575711714,56.591233845513734,NaN,NaN,-30.41738280592974,-24.93732826809336,-0.12042452458745562,0.2936720532220889,0.4140965778095445,728846785,722523299.2,60.51296454756214,71.88196173009688,NaN,NaN,12.926172429464422,20.483534684103272
2016-08-01T09:30:00-04:00,51.99,52.27,51.96,52.15,11658477,14114795.55,54.61062525448252,56.4510708223905,NaN,NaN,-7.101656870344508,-46.01508629558455,-0.10839770392164466,0.2785994479074887,0.38699715182913336,740505262,722759315.8,60.66427551853482,70.31733480983824,NaN,NaN,12.328819559476468,19.31857538058516
2016-08-02T09:30:00-04:00,51.88,52.01,51.57,51.81,13705516,14172399.95,50.4187610487541,55.75776332279822,NaN,NaN,-88.36290500660738,-72.79738647879671,-0.12040332382824637,0.23649299704382543,0.3568963208720718,726799746,722756048.2,60.66080978544313,69.02467762026042,NaN,NaN,10.565381685204681,18.06811913838795
2016-08-03T09:30:00-04:00,51.81,51.9,51.34,51.5,11405346,13987534.2,46.88504344999305,55.104408464629124,NaN,NaN,-143.48135220736415,-76.7991463525698,-0.14465370402141164,0.1760791908453072,0.32073289486671885,715394400,724983661.4,62.244386853077295,68.05551547875136,NaN,NaN,7.997085565578893,16.629400056558083
2016-08-04T09:30:00-04:00,51.56,51.86,51.325,51.47,12272015,13465204.1,46.54506020821919,54.328374035471754,NaN,NaN,-133.32115677322113,-80.53689073269338,-0.15710897681935015,0.12434667384253117,0.28145565066188133,703122385,722933715.6,59.85650718259456,67.15824482886019,NaN,NaN,5.815419056524248,15.084545627981822
2016-08-05T09:30:00-04:00,51.18,51.29,50.7,50.73,26952063,14008188.2,39.02732360102764,52.916064604721505,NaN,NaN,-254.6760161416679,-125.38861739984102,-0.2064708370022276,0.02336710440909684,0.22983794141132444,676170322,712398423,49.373317161154745,65.49796944020783,NaN,NaN,1.3954491377306077,13.128960415088791
2016-08-08T09:30:00-04:00,50.71,51.17,50.575,50.71,13526678,13959219.7,38.84471199570429,51.577458922483125,NaN,NaN,-225.4332935672955,-169.05494473923122,-0.22995809413017032,-0.057609676251388464,0.17234841787878186,662643644,696826099.4,38.60947181742875,63.02174317571564,NaN,NaN,-2.187184596348365,10.940939699169197
2016-08-09T09:30:00-04:00,50.78,50.97,50.57,50.7,10094190,13563814.75,38.74708872142615,50.515798707396826,NaN,NaN,-191.0512428413061,-189.59261230617096,-0.2348341128577048,-0.12119422319334916,0.11363988966435565,652549454,681976041,31.54652289776125,60.231140007470195,NaN,NaN,-5.126916460868288,8.6455316763067
2016-08-10T09:30:00-04:00,50.82,50.94,50.58,50.71,8490838,13258120.6,38.912421535271285,49.22957982423486,NaN,NaN,-157.6194236083805,-192.4202265863742,-0.2259777712349149,-0.16883232437928797,0.05714544685562692,661040292,671105219.4,27.57044510491336,57.07960470751186,NaN,NaN,-7.513441497621655,6.337106937174077
2016-08-11T09:30:00-04:00,50.7,50.86,50.55,50.83,9481474,12864129.3,40.971440911905106,47.64110119116093,NaN,NaN,-131.68313362764678,-192.09262195725938,-0.20144352417566327,-0.1946589583639522,0.006784565811711087,670521766,664585095.6,25.49488820482324,53.701722820862024,NaN,NaN,-9.025136149337376,4.142500781958155
2016-08-12T09:30:00-04:00,51.01,51.27,50.89,50.9,12161445,12824615.65,42.1954124192444,46.23079646787924,NaN,NaN,-82.55571108001402,-157.6685609449286,-0.17110054814355433,-0.20709111936773184,-0.0359905712241775,682683211,665887673.4,26.68238301612645,50.44994410121289,NaN,NaN,-10.00124279283363,2.121965985559329
2016-08-15T09:30:00-04:00,50.9,51.08,50.12,50.12,12634445,12897931.5,33.78814717640168,44.66067641111706,NaN,NaN,-136.14628576090246,-139.81115938365,-0.19256244375374487,-0.2766936259163586,-0.08413118216261373,670048766,667368697.8,28.085853252001215,47.368794288104034,NaN,NaN,-13.483379583208388,-0.10736909569320163
2016-08-16T09:30:00-04:00,50,50.03,49.53,49.53,20181642,13372911.35,29.06995183208339,43.24251013899437,NaN,NaN,-182.02787079671486,-138.00648497473173,-0.23280531636415375,-0.3751378276178059,-0.14233251125365215,649867124,666832231.8,27.877684167690504,44.50745695010316,NaN,NaN,-18.170844418179524,-2.687865570334105
2016-08-17T09:30:00-04:00,49.47,50.365,49.09,50.27,28456588,14215759.1,40.32545791596378,42.47433997472775,NaN,NaN,-135.77867013063457,-133.63833427918252,-0.1973020403447125,-0.3889600616845428,-0.1916580213398303,678323712,670288915.8,31.405609395009918,42.184651350294416,NaN,NaN,-18.528419696170417,-4.950801874025006
2016-08-18T09:30:00-04:00,50.26,50.89,50.17,50.89,13944452,14250023.95,47.799478162656186,42.010066016652345,NaN,NaN,-58.93311416383407,-119.08833038641998,-0.1233921146042373,-0.3458981645951269,-0.2225060499908896,692268164,674638195.4,35.66952682552203,40.4101200844344,NaN,NaN,-16.149465264486203,-6.550610929805178
2016-08-19T09:30:00-04:00,50.54,50.75,50,50.27,14698042,14323890.25,42.11850421527721,41.11777165670912,NaN,NaN,-80.73660705240029,-118.72450958089726,-0.10813679286180869,-0.35767704106815046,-0.24954024820634177,677570122,673615577.6,35.11679338567032,38.58529993208693,NaN,NaN,-16.192762914784716,-7.928061213373683
2016-08-22T09:30:00-04:00,50.35,50.62,50.25,50.4,9101763,14421213.5,43.63127863473307,40.63295148427904,NaN,NaN,-67.54279267368594,-105.00381096345396,-0.08233503626280092,-0.3524590435348429,-0.270124007272042,686671885,676940201.4,38.45581522668393,36.999228892175566,NaN,NaN,-15.709062805822713,-9.03963286943783
2016-08-23T09:30:00-04:00,50.48,50.72,50.15,50.18,9578718,14274694.65,41.647525434486106,40.25884305459998,NaN,NaN,-70.63807712260449,-82.72585222863187,-0.07342407346425517,-0.361904099102361,-0.2884800256381058,677093167,682385410,43.577317612532944,35.66586680356525,NaN,NaN,-15.964426271827984,-10.02888906977928
2016-08-24T09:30:00-04:00,50.1,50.24,49.77,50.16,8048328,13549123.55,41.46296354061383,39.89583614977102,NaN,NaN,-97.00471190881504,-74.97106058426796,-0.06263617930623788,-0.36677524977090314,-0.30413907046466526,669044839,680529635.4,42.28580010902021,34.41081629830994,NaN,NaN,-16.221193334014753,-10.913503964670062
2016-08-25T09:30:00-04:00,50.11,50.36,50.1,50.19,7222778,13454473.45,41.87902897741029,40.09952939094121,NaN,NaN,-73.29740222195106,-77.84391819589136,-0.047903736458703716,-0.3640187410380449,-0.31611500457934116,676267617,677329526,40.0798765431494,33.746999111309556,NaN,NaN,-16.307617973334185,-11.684091680193507
2016-08-26T09:30:00-04:00,50.22,50.56,49.11,49.15,20911235,13726301.65,33.0966573608716,39.68895405988173,NaN,NaN,-139.0991571374949,-89.51642821291027,-0.09964694388903872,-0.4406736844406396,-0.34102674055160087,655356382,672886778,37.18001658702857,33.64489516628097,NaN,NaN,-19.30492368792457,-12.77278196701223
2016-08-29T09:30:00-04:00,49.3,49.67,49.25,49.55,13015722,13794163.9,38.443534636755494,39.667271625262394,NaN,NaN,-141.4742205239023,-104.30271378295353,-0.09821878519203214,-0.46380022204164106,-0.3655814368496089,668372104,669226821.8,34.93742380869867,33.88710237420508,NaN,NaN,-20.02270173935288,-13.808484791632322
2016-08-30T09:30:00-04:00,49.51,49.75,48.97,49.03,12261517,13721963.95,34.5750309693091,39.35745801340795,NaN,NaN,-159.0921889958961,-121.99353615761189,-0.12202710097894898,-0.5181153130732952,-0.3960882120943462,656110587,665030305.8,32.5156635930731,34.24033226621648,NaN,NaN,-21.927539848815663,-14.96834979980137
2016-08-31T09:30:00-04:00,48.98,49.25,48.87,49.23,11502087,13726801,37.192852911794944,39.087558870542935,NaN,NaN,-155.51116641562254,-133.69482705897337,-0.11417823641030661,-0.5388110076072294,-0.42463277119692283,667612674,664743872.8,32.350830447117715,34.73004242638037,NaN,NaN,-22.60738340183595,-16.059640314377738
2016-09-01T09:30:00-04:00,49.1,49.2675,48.92,48.98,15981961,13912298.3,35.29192095336839,38.59445233726608,NaN,NaN,-142.58136853574538,-147.55162032173223,-0.1153564283679055,-0.5688283066568047,-0.45347187828889923,651630713,659816492,29.573471616419297,34.936548754972726,NaN,NaN,-23.759720455077897,-17.15965176304919
2016-09-02T09:30:00-04:00,49.16,49.68,49.06,49.63,16270965,13378243.4,43.39287566005243,39.28050437181256,NaN,NaN,-81.41589225273565,-136.0149673447804,-0.0644320236333688,-0.5340119078306103,-0.46957988419724145,667901678,662325551.2,32.73999653702383,35.268987561045776,NaN,NaN,-22.104399728539967,-17.866044329547872
2016-09-06T09:30:00-04:00,49.89,50.23,49.75,50.17,15259141,13464866.55,49.094604968226285,40.71083673867991,NaN,NaN,-2.430410722735048,-108.20620538454693,0.009606648463162282,-0.4575715736182886,-0.4671782220814509,683160819,665283294.2,36.37186438665536,35.87571471954326,NaN,NaN,-18.776233590757286,-17.996071366863504
2016-09-07T09:30:00-04:00,50.2,50.29,49.89,50.18,11490670,13534690.55,49.196656310763736,41.34449376687991,NaN,NaN,11.755347357250072,-74.03669811391771,0.06040640869157998,-0.39167021121697587,-0.45207661990855585,694651489,672991474.6,44.745547985047594,36.82856747597452,NaN,NaN,-16.15473973230553,-17.73302399049808
2016-09-08T09:30:00-04:00,49.84,50.41,49.84,50.35,12841630,13752230.15,50.99522454507459,41.57276136562408,NaN,NaN,28.211210357898437,-37.292222759213516,0.1040506095862635,-0.3220133579257265,-0.42606396751199,707493119,680967563.6,51.812392239143286,37.98162929123318,NaN,NaN,-13.46001219257921,-17.122593733652526
2016-09-09T09:30:00-04:00,49.85,49.91,48.4438,48.46,25759114,14566112.15,35.81453484894783,41.1224778394577,NaN,NaN,-137.59617574317323,-36.29518420069908,0.009220403536355337,-0.41453846309154585,-0.4237588666279012,681734005,686988222,56.35051317339196,39.49832356178474,NaN,NaN,-16.30266850004957,-17.005461557423533
2016-09-12T09:30:00-04:00,48.38,49.42,48.38,49.32,25532258,15234652.8,43.98567126289049,41.147791598611796,NaN,NaN,-109.92811255632004,-41.997628261415954,0.008045838343077982,-0.4137015686990537,-0.4217474070421317,707266263,694861139,61.46157391021317,41.14159203917968,NaN,NaN,-15.503054847975516,-16.79083202750239
2016-09-13T09:30:00-04:00,49.16,49.22,48.42,48.64,22296877,15717774.4,39.68382899518687,41.00752756723329,NaN,NaN,-131.42377646226828,-67.79630140932261,-0.03266315329651781,-0.46257634866277897,-0.42991319536626116,684969386,695222852.4,61.683562489401666,42.43489524467031,NaN,NaN,-16.49339025047877,-16.748340345070446
2016-09-14T09:30:00-04:00,48.82,49.22,48.61,48.83,15229846,15470184.6,41.40811807343923,41.00361003386367,NaN,NaN,-100.68598201203365,-90.28456728317934,-0.04042171145857748,-0.480440334689483,-0.4400186232309055,700199232,696332401,62.39904973028963,43.871555931903835,NaN,NaN,-16.635221083037273,-16.73218045049428
2016-09-15T09:30:00-04:00,48.78,49.29,48.66,49.2,30969756,15595843,44.722175738028135,41.20669194533638,NaN,NaN,-72.66414611297117,-110.45963857735326,-0.01554155108956351,-0.4594455620928599,-0.4439040110032964,731168988,701067574.8,65.37093357400406,45.6780600055363,NaN,NaN,-15.620524816062625,-16.57337250271833
2016-09-16T09:30:00-04:00,48.85,49.33,48.49,49.26,21724181,15984829.45,45.262854078354316,42.07570599658514,NaN,NaN,-69.63168750371247,-96.86674092946112,0.00874361317379918,-0.4329744945360474,-0.4417181077098466,752893169,715299407.6,72.42524029732445,48.19557598484316,NaN,NaN,-14.659989618568027,-16.300032090696856
2016-09-19T09:30:00-04:00,49.42,49.77,49.3,49.75,12530771,15876465.9,49.59856617061635,42.87249396328949,NaN,NaN,9.920097144805956,-72.8970989892359,0.05880444394364337,-0.3682125527802924,-0.4270169967239358,765423940,726930943,76.61764093336505,51.172734350890764,NaN,NaN,-12.469348834808718,-15.75279162556998
2016-09-20T09:30:00-04:00,49.95,50.03,49.63,49.66,12857900,16064272.75,48.83345099511467,43.89095253656131,NaN,NaN,40.50454503586387,-38.511434689609494,0.08524841941463734,-0.32045647245563913,-0.4057048918702765,752566040,740450273.8,80.35602014607299,54.589902676105034,NaN,NaN,-10.944873788642678,-15.06594622029465
2016-09-21T09:30:00-04:00,49.75,50.71,49.65,50.67,19405131,16555593.4,56.87360547931939,45.29672057709877,NaN,NaN,125.91128676440896,6.808019065679028,0.16550870243564553,-0.19881901382571954,-0.36432771626136506,771971171,754804661.6,83.3921633743454,58.23571217090701,NaN,NaN,-6.901705007924072,-13.899626047098854
2016-09-22T09:30:00-04:00,51.08,51.09,50.61,50.98,12035330,16754943.5,59.002996346335735,46.99036881945358,NaN,NaN,183.06406361487143,57.95366101124755,0.23024303528989726,-0.0765239221489935,-0.30676695743889076,784006501,765372164.2,85.20507976328835,62.209398467111946,NaN,NaN,-2.9257040518317434,-12.331922904917839
2016-09-23T09:30:00-04:00,50.83,51.08,50.59,50.94,11003441,16943976.65,58.60092815979836,48.076658283721144,NaN,NaN,163.50941759434392,104.58188203085884,0.25899156988364375,0.016972504915663933,-0.2420190649679798,773003060,769394142.4,85.83868719047747,66.00216208521577,NaN,NaN,0.11625059895117171,-10.553612404365124
2016-09-26T09:30:00-04:00,50.94,51.02,50.64,50.81,8052839,16301056.85,57.23583677748163,48.6581748415251,NaN,NaN,132.34889256458408,129.06764111481445,0.2573439736804086,0.07966090213253096,-0.17768307154787766,764950221,769299398.6,85.74553031951665,69.52885250899158,NaN,NaN,2.228865033559775,-8.727544198947282
2016-09-27T09:30:00-04:00,50.98,51.23,50.1,50.15,17939557,16547248.6,50.76967085128762,48.770533022991096,NaN,NaN,84.21780522740593,137.81029315312287,0.20232114048531197,0.07521835405876232,-0.12710278642654965,747010664,768188323.4,84.58619609092774,72.37461308798302,NaN,NaN,2.187974455305412,-7.168184391196897
2016-09-28T09:30:00-04:00,50.18,50.34,49.65,50.08,16619187,16765132.1,50.122895078171275,48.70822377535514,NaN,NaN,31.294889796888988,118.88701375961887,0.15391942147879986,0.06529649042195018,-0.08862293105684968,730391477,759872384.6,76.27382009253668,74.12185793465399,NaN,NaN,1.9687308894586772,-5.862910779674673
2016-09-29T09:30:00-04:00,49.97,49.99,49.08,49.33,19247313,17152393.4,43.699382190584295,49.2714271569006,NaN,NaN,-30.04043310475603,76.26611441569338,0.06845816177150492,-0.0030502288424685275,-0.07150839061397345,711144164,745299917.2,64.34153563533297,74.69264525336405,NaN,NaN,-0.20154446482219124,-5.054144163267176
2016-09-30T09:30:00-04:00,49.37,49.73,48.74,48.99,14836286,17095109.65,41.12627340612424,49.067184452845865,NaN,NaN,-65.04188492161404,30.555853912501778,-0.009742067465638604,-0.0836859749460217,-0.0739439074803831,696307878,729960880.8,54.65008835947609,74.20611057116855,NaN,NaN,-2.8125237077697114,-4.733912669624681
2016-10-03T09:30:00-04:00,49.01,49.01,48.01,48.3,19492687,17256195.75,36.4372413982833,48.835285338781325,NaN,NaN,-126.84821502102125,-21.2835676046193,-0.10160581643106714,-0.20095117801921702,-0.09934536158814988,676815191,712333874.8,46.06352227677545,73.09039341312382,NaN,NaN,-6.61975432369319,-5.003318620205897
2016-10-04T09:30:00-04:00,48.27,48.31,47,47.29,25691831,17777830.25,30.88608278610772,48.08371138968622,NaN,NaN,-183.0254824244474,-74.73222513498996,-0.21740801755067257,-0.3711053835264906,-0.153697365975818,651123360,693156414,38.902104931044576,71.41204021317775,NaN,NaN,-11.970355049376408,-5.998609538658827
2016-10-05T09:30:00-04:00,47.4,47.77,47.01,47.19,28171937,18611893.6,30.39237934134492,47.06015450420885,NaN,NaN,-172.0628289907613,-115.40376889252002,-0.28357424305568046,-0.5081651697954186,-0.22459092673973813,622951423,671668403.2,32.75692313653508,69.08246803907282,NaN,NaN,-16.321495787648345,-7.473307574228758
2016-10-06T09:30:00-04:00,47.03,47.42,46.79,47.18,20195654,18979594.8,30.340151058379007,45.99424714563918,NaN,NaN,-163.06491277131963,-142.00866482583274,-0.3087711449739389,-0.6105548579571618,-0.3017837129832229,602755769,649990724.2,27.9587054819567,65.90628698083228,NaN,NaN,-19.78329640101471,-9.23187740662675
2016-10-07T09:30:00-04:00,47.51,47.96,47.1,47.12,17215813,18552429.75,30.006955718757894,44.59484639907786,NaN,NaN,-127.15882252969972,-154.43205234744988,-0.3094555366347721,-0.688603133776688,-0.3791475971419159,585539956,627837139.8,24.07721134815361,62.153399153317174,NaN,NaN,-22.70174775410595,-11.15614459912378
2016-10-10T09:30:00-04:00,47.15,47.55,47.15,47.51,9774767,17764555.2,35.003494122859294,43.6069923367739,NaN,NaN,-111.63143631436613,-151.38869660611886,-0.26531682432835746,-0.7107936275523628,-0.4454768032240053,595314723,611537046.2,21.691082563294373,57.963046468832985,NaN,NaN,-23.818374941761906,-12.965034648072082
2016-10-11T09:30:00-04:00,47.48,47.48,46.89,46.97,14346968,17367059.75,31.63597965401175,41.804304777823354,NaN,NaN,-115.70148535691014,-137.9238971926114,-0.2541433996976753,-0.7631560528460994,-0.5090126531484241,580967755,597505925.2,19.865990127503423,53.425462665487125,NaN,NaN,-25.803749478351452,-14.799136766683421
2016-10-12T09:30:00-04:00,47,47.52,46.92,47.43,15427287,17376931.8,37.180233949226434,40.24553603517269,NaN,NaN,-92.38227146814789,-121.98778568808874,-0.19982080008723557,-0.7587886532574686,-0.558967853170233,596395042,592194649,19.207182673209687,48.711327159052935,NaN,NaN,-25.85868560191588,-16.379072314573772
2016-10-13T09:30:00-04:00,47.51,48.33,47.41,48.02,30542148,17355551.4,43.50840549052233,39.167498701652974,NaN,NaN,-52.060392177677315,-99.78688156936028,-0.11254908565405597,-0.6996542102378029,-0.587105124583747,626937190,597030933.2,21.75178737894585,44.133691458229244,NaN,NaN,-23.938261506759375,-17.458956484886002
2016-10-14T09:30:00-04:00,47.77,48.23,47.68,47.75,17948345,17166759.6,41.45057804194093,38.03998022054293,NaN,NaN,-49.06885357936342,-84.168887779293,-0.06382710061131724,-0.6668890003478936,-0.6030618997365763,608988845,601720711,24.243470332947737,39.74068717347432,NaN,NaN,-22.961427720936374,-18.245023804321768
2016-10-17T09:30:00-04:00,47.9,48.13,47.84,48.01,11439932,17112217.65,44.18809550307135,37.56986769567033,NaN,NaN,-39.57851452069096,-69.75830342055797,-0.007852589386792563,-0.612877636470067,-0.6050250470832744,620428777,606743521.8,26.927286866891976,35.62219365747176,NaN,NaN,-21.328294554476667,-18.685491054343895
2016-10-18T09:30:00-04:00,48.22,48.52,47.8,48.42,14761051,17207375.2,48.29366347534553,37.4392082954685,NaN,NaN,-23.352425399521326,-51.28849142908022,0.059323935584087106,-0.5308701276031655,-0.5901940631872526,635189828,617587936.4,32.48832191594293,32.494658073429356,NaN,NaN,-18.68706586941646,-18.68571602792569
2016-10-19T09:30:00-04:00,48.39,48.46,48.085,48.31,8502547,16662246,47.28859346880368,37.69558052962702,NaN,NaN,-17.137359108611005,-36.23950895717284,0.09667976487481655,-0.4693443570937319,-0.5660241219685485,626687281,623646384.2,35.44412899816864,30.430557599346184,NaN,NaN,-16.80396910510456,-18.416895038951242
2016-10-20T09:30:00-04:00,48.4,48.655,48.19,48.28,8930782,16507018.6,47.001297678065214,38.11522512047994,NaN,NaN,-5.499895292577113,-26.927409580152794,0.11827136590205978,-0.41818491459097373,-0.5364562804930335,617756499,621810246,34.94477547791227,29.02303525066306,NaN,NaN,-15.334525137517863,-17.976556481603616
2016-10-21T09:30:00-04:00,48.07,48.25,47.7901,48,18153641,16864528.6,44.29633004582079,38.676588595304054,NaN,NaN,-23.496770379088417,-21.812992940097796,0.11262640633218479,-0.3956732725778025,-0.5082996789099873,599602858,619933048.6,34.4110099917049,28.190712944586586,NaN,NaN,-14.794661228046069,-17.52200001680968
2016-10-24T09:30:00-04:00,48.21,48.355,47.89,48.18,10744703,16999121.8,46.430688911524136,39.78691760426238,NaN,NaN,-3.752139814485943,-14.647717998856788,0.11930544334251919,-0.3591678747318383,-0.4784733180743575,610347561,617916805.4,33.81359348749346,27.827247841475792,NaN,NaN,-13.753244564504547,-16.98360638076609
2016-10-25T09:30:00-04:00,48.12,48.48,48.06,48.48,9886251,16596456.5,49.877739935502944,41.178729075273665,NaN,NaN,30.572855896514568,-3.862661739649611,0.14074499491690085,-0.30254207442823144,-0.4432870693451323,620233812,614925602.2,32.901001607177506,27.8375391608074,NaN,NaN,-11.889692474162619,-16.255904394108452
2016-10-26T09:30:00-04:00,48.35,48.66,48.11,48.6,10851006,16308047.45,51.229602738832114,42.6708327667346,NaN,NaN,61.94508493006786,11.953827068086161,0.1585042885402631,-0.24515670866980344,-0.40366099721006654,631084818,615805109.6,33.46957149904354,28.23117244774217,NaN,NaN,-9.945062010471336,-15.354355482160292
2016-10-27T09:30:00-04:00,48.32,48.51,47.97,48.31,15554929,16123428.25,47.869429563624706,43.94672375565366,NaN,NaN,49.48232979417246,22.95027208543608,0.1464993907598388,-0.22053675876026801,-0.3670361495201068,615529889,615359787.6,33.31563724131182,28.89106001153919,NaN,NaN,-9.139909599844014,-14.466577498972253
2016-10-28T09:30:00-04:00,48.28,48.69,48.2,48.46,16463866,16204807.25,49.706927194414966,44.99696897505049,NaN,NaN,88.88025352424657,45.4256768661031,0.14421406134897813,-0.18676857283388415,-0.3309826341828623,631993755,621837967,37.79747996882371,30.041516969076998,NaN,NaN,-7.957257284813866,-13.536674611235341
2016-10-31T09:30:00-04:00,48.58,49.72,48.45,49.43,22715832,16365964.5,59.619220921494595,46.99577192272784,NaN,NaN,189.1638273319741,84.0088702953951,0.20014236115004774,-0.08080468274530261,-0.28094704389535036,654709587,630710372.2,43.40750182321625,31.72305351877077,NaN,NaN,-3.699518913815611,-12.131366654461093
2016-11-01T09:30:00-04:00,49.29,49.39,48.4,48.53,24154431,16289094.5,49.80993439856963,47.897893383395214,NaN,NaN,113.42229443982089,100.57875800405637,0.16983078579830643,-0.06865856164746731,-0.23848934744577374,630555156,632774641,44.658106791152335,33.54097667005239,NaN,NaN,-3.0752477088314705,-10.837635376514005
2016-11-02T09:30:00-04:00,48.3,48.43,47.515,47.92,26491745,16205084.9,44.46940345110723,47.96653609486556,NaN,NaN,-12.095172971704706,85.77070642370185,0.10517475410530525,-0.10702090481414217,-0.21219565891944742,604063411,627370359.6,42.03890437743566,34.9900564556588,NaN,NaN,-4.391892941654763,-9.91681502867697
2016-11-03T09:30:00-04:00,47.8,48.29,47.6314,48.1,11820510,15786327.7,46.299093135665714,48.312858601560194,NaN,NaN,-12.038732161377757,73.46649403259183,0.07255789843733784,-0.12149828587277511,-0.19405618431011296,615883921,627441166,42.086829732263105,36.26458212703847,NaN,NaN,-4.837009696800338,-9.191128552694593
2016-11-04T09:30:00-04:00,48.29,48.75,47.92,47.95,14557212,15653397.65,44.96935775880624,48.368663048398396,NaN,NaN,17.45429220413126,59.18130176856876,0.04050720388346979,-0.14342217945577573,-0.18392938333924552,601326709,621307756.8,39.072994172016315,37.13213264883307,NaN,NaN,-5.611118629391311,-8.679698563651268
2016-11-07T09:30:00-05:00,48.15,48.8,47.69,48.79,17728111,16051064.85,53.093834193053425,48.71153238537753,NaN,NaN,54.32509742034832,32.2135557862436,0.07357868158540398,-0.09195603135749053,-0.1655347129428945,619054820,614176803.4,35.85793509102943,37.37281930419639,NaN,NaN,-3.6024426619915872,-7.954376291985599
2016-11-08T09:30:00-05:00,48.85,49.36,48.77,49.17,18847911,16276112,56.24118632558322,49.351003303718926,NaN,NaN,184.72765152248525,46.47462720277647,0.11620998766708329,-0.020272228359040412,-0.1364822160261237,637902731,615646318.4,37.00822476647052,37.484540430503664,NaN,NaN,-0.9138500962859629,-6.94858683545708
2016-11-09T09:30:00-05:00,48.31,48.35,47.28,47.36,42810214,17645258.35,41.84028445365763,48.98235950197553,NaN,NaN,-145.96928156738264,19.699805483640876,0.022572855633410105,-0.10826614648436106,-0.13083900211777116,595092517,613852139.6,36.1556799871813,37.57103360973717,NaN,NaN,-3.8717068460789323,-6.509032551260201
2016-11-10T09:30:00-05:00,47.11,47.16,45.61,46.22,53123432,18774322.55,35.64884486297852,48.36468198891537,NaN,NaN,-342.1203029004322,-46.316508664170016,-0.10885969360956804,-0.2669136191297312,-0.15805392552016317,541969085,599069172.4,30.01944267407052,37.25735022990614,NaN,NaN,-8.831657655545728,-6.840836137586705
2016-11-11T09:30:00-05:00,46.12,46.655,45.85,46.03,30951469,19424478.75,34.72650387867047,47.52866877228296,NaN,NaN,-275.3692290694525,-104.88121291888676,-0.19621687283855724,-0.40332501656835973,-0.2071081437298025,511017616,581007353.8,24.53950150669374,36.59491508842044,NaN,NaN,-12.835360417766417,-7.697196749040949
2016-11-14T09:30:00-05:00,45.68,46.1,45.325,46,28190802,20262022.25,34.57439555555936,46.43557274514414,NaN,NaN,-239.78724929082802,-163.70368226112205,-0.24071101218389301,-0.5079969089596688,-0.26728589677577574,482826814,553761752.6,18.926818738331562,35.59675916921716,NaN,NaN,-15.894416075344747,-8.868228081370063
2016-11-15T09:30:00-05:00,46.26,46.85,46.24,46.74,25191815,20783560.45,41.39357747085819,45.73299951171742,NaN,NaN,-124.64091616818031,-225.57739579925516,-0.2063187419904685,-0.5251843242638614,-0.3188655822733929,508018629,527784932.2,15.327298262365986,34.300882509454475,NaN,NaN,-16.14938405820226,-9.90839322091752
2016-11-16T09:30:00-05:00,46.85,46.97,46.115,46.42,16817428,21199304.5,39.477398792352595,45.13356874234085,NaN,NaN,-112.25272186798121,-218.83408385937486,-0.191461379715676,-0.5581923069179879,-0.36673092720231193,491201201,507006669,13.169784268499882,32.86189301139648,NaN,NaN,-16.982849509677216,-10.919029833597476
2016-11-17T09:30:00-05:00,46.2,46.678,46.2,46.43,19199784,21712754.6,39.571539893430554,44.40961250655624,NaN,NaN,-100.46086756855183,-170.5021967929988,-0.1681307584784405,-0.5768943753003626,-0.4087636168219221,510400985,500693049,12.589870838254114,31.06134950207008,NaN,NaN,-17.605557464871296,-11.874248066636593
2016-11-18T09:30:00-05:00,46.56,46.66,46.09,46.29,10698464,21339995.75,38.66478479840813,42.91286706919293,NaN,NaN,-93.05469037716622,-134.03928905454154,-0.14990173795985118,-0.5961407892717361,-0.4462390513118849,499702521,498430030,12.37945402385354,28.845060373544168,NaN,NaN,-18.37882904865755,-12.803473921211015
2016-11-21T09:30:00-05:00,46.42,46.79,46.35,46.78,12298269,21417674.05,43.5411043777578,42.465093496277795,NaN,NaN,-64.09066505285298,-98.89997220694652,-0.09527911272694489,-0.565337942220566,-0.4700588294936211,512000790,504264825.2,16.265309859949937,26.817003449886858,NaN,NaN,-17.599628867352006,-13.488638913516871
2016-11-22T09:30:00-05:00,46.8,47.0275,46.56,46.96,10642964,21455509.7,45.26268307838398,42.52175632679756,NaN,NaN,-44.54939721897631,-82.88166841710571,-0.040275404807302906,-0.5204030855027497,-0.4801276806954468,522643754,507189850.2,18.223249184267857,25.11588522180344,NaN,NaN,-16.45674342266099,-13.912653843394603
2016-11-23T09:30:00-05:00,46.3,46.92,46.3,46.49,14153403,21620629.55,41.688166367875084,42.192404414812515,NaN,NaN,-57.02613304925626,-71.83635065336073,-0.029305912587926253,-0.5167600714303546,-0.4874541588424284,508490351,510647680.2,20.587224437048192,23.580199129288086,NaN,NaN,-16.50039282656666,-14.28233084099061
2016-11-25T09:30:00-05:00,46.56,47.32,46.56,47.16,7866207,21236193.45,47.993347482169824,42.40840368076705,NaN,NaN,-23.601135271435208,-56.4644041939374,0.026307678261579592,-0.45456956101545387,-0.48087723927703346,516356558,511838794.8,21.429793603653323,22.31997051726216,NaN,NaN,-14.613804208269759,-14.329684179173347
2016-11-28T09:30:00-05:00,47.3,48.18,47.29,48.07,23431731,21584586.7,55.095387201363636,42.551371752789215,NaN,NaN,37.64893667830074,-30.323678782844013,0.12224424769909076,-0.32807192965317,-0.45031617735226076,539788289,519855948.4,27.040869897128317,21.690180146269224,NaN,NaN,-10.594348768813928,-13.796064834836287
2016-11-29T09:30:00-05:00,47.95,48.5,47.87,48.27,14447687,21171179.45,56.501348218632835,42.56995474514991,NaN,NaN,71.76451889704198,-3.152641992865017,0.19283616475354742,-0.20927097141032647,-0.4021071361638739,554235976,528302985.6,32.50974767432676,21.368860353973243,NaN,NaN,-6.916311156528092,-12.81324288079226
2016-11-30T09:30:00-05:00,47.56,47.67,46.75,46.75,23467383,21136827.05,44.97584427719215,42.79392330397379,NaN,NaN,-11.057328138277796,3.545771823274683,0.13363610536961512,-0.235062004451855,-0.3686981098214701,530768593,529927953.4,33.54177768538395,21.182153046702002,NaN,NaN,-7.437282526591758,-12.045248544477902
2016-12-01T09:30:00-05:00,46.36,46.57,46.0438,46.38,18366065,20730543.05,42.69287865823525,43.29706857506356,NaN,NaN,-66.99913021522889,1.551172390080157,0.0692740442532715,-0.28210555450488073,-0.3513795987581522,512402528,530710388.8,34.06460503969866,21.471093215675438,NaN,NaN,-8.625866309376997,-11.556765368034915
2016-12-02T09:30:00-05:00,46.65,47.1283,46.49,46.8,16399407,20959487.9,46.04110888218483,44.10525464674316,NaN,NaN,-22.320979225009502,1.807203599365304,0.055308570909024135,-0.28224388512187204,-0.3375524560308962,528801935,533199464.2,35.79502884727371,22.275059454288293,NaN,NaN,-8.49152719282253,-11.118874200147431
2016-12-05T09:30:00-05:00,46.6,46.87,46.17,46.86,14888299,20976042.25,46.52180443841754,44.95864099551875,NaN,NaN,-34.099991391211006,-12.54258201453705,0.05056237723050355,-0.27434948449276675,-0.3249118617232703,543690234,533979853.2,36.35896363096153,23.520212660904722,NaN,NaN,-8.237822472629542,-10.70729538193059
2016-12-06T09:30:00-05:00,46.84,47.03,46.66,46.77,8421968,20510735.1,45.86181906586501,45.27780110944781,NaN,NaN,-8.108389686507401,-28.517163731246928,0.04215556129659431,-0.2722174101025274,-0.31437297139912174,535268266,530186311.2,34.76063397626787,24.908308069040572,NaN,NaN,-8.226141374095944,-10.352844809382784
2016-12-07T09:30:00-05:00,46.94,47.38,46.89,47.38,12902391,20213459.1,50.94179252686327,46.09668637619857,NaN,NaN,64.94537404205333,-13.3166232951807,0.07647132105488913,-0.21878382008051034,-0.29525514113539947,548170657,533666724,37.476262349290764,26.64448507481135,NaN,NaN,-6.68862172751018,-9.82938436911527
2016-12-08T09:30:00-05:00,47.08,47.545,46.74,47.46,14395480,18792722.4,51.58344008867585,46.954679247287515,NaN,NaN,77.03934589294902,15.491071926454882,0.10176821931998464,-0.16804486698541865,-0.2698130863054033,562566137,543699445.8,44.63109144047433,28.93314368925565,NaN,NaN,-5.2533324753357205,-9.175662670003906
2016-12-09T09:30:00-05:00,47.42,47.98,47.42,47.96,16018916,16937496.6,55.500868828105524,48.157256677980186,NaN,NaN,140.48035970996574,48.051339713449934,0.14665763316331665,-0.08649104485125747,-0.23314867801457412,578585053,553656069.4,50.66486064723195,31.66781559092553,NaN,NaN,-2.850176499425371,-8.272021788492687
2016-12-12T09:30:00-05:00,47.76,48.51,47.75,48.46,21980069,16488926.6,59.06751457440334,49.26628597774059,NaN,NaN,171.07755982394477,89.08684995648109,0.20113981653930887,0.018276092659561982,-0.1828637238797469,600565122,565031047,56.49744040523239,34.541539201302854,NaN,NaN,0.3028696059133298,-7.047037303577541
2016-12-13T09:30:00-05:00,48.7,49,48.52,48.96,20216974,16090235.2,62.319921838222136,50.48466017487188,NaN,NaN,202.67044694427992,131.24261728263855,0.25832007760714526,0.1400363731291847,-0.11828370447796056,620782096,582133813,63.48703402808331,37.774666690146816,NaN,NaN,4.013400350318363,-5.466974781592413
2016-12-14T09:30:00-05:00,49.18,49.44,47.89,47.95,28353928,16248340.85,53.13539526792217,51.302319382018105,NaN,NaN,131.20455219249084,144.49445291272605,0.21724052165638474,0.15326694759252035,-0.06397357406386438,592428168,590985315.2,66.48807422488602,41.05329881784951,NaN,NaN,4.448472313984566,-4.05048233936713
2016-12-15T09:30:00-05:00,47.85,48.335,47.595,48.29,17821563,16298547.6,55.512301453253414,51.83938752280979,NaN,NaN,82.11192495796948,145.50896872573014,0.20238578527279188,0.18900865752712548,-0.0133771277456664,610249731,600522034,69.40571418619533,44.48015028803109,NaN,NaN,5.552026604821888,-2.6786953473401267
2016-12-16T09:30:00-05:00,47.95,48.58,47.84,48.41,20118992,16344508,56.35369956397368,51.92926697728194,NaN,NaN,89.74542446245744,135.36198167622848,0.19024580337927807,0.2244301264784312,0.034184323099153126,630368723,610878768,72.23300051779219,47.708159618078504,NaN,NaN,6.692597734888548,-1.3399391927360302
2016-12-19T09:30:00-05:00,48.7,48.72,48.17,48.59,11650212,16392095.4,57.64764250455674,52.01114514056222,NaN,NaN,98.06504000475442,120.7594777123904,0.18383922607822664,0.26398335569693643,0.08014412961870979,642018935,619169530.6,74.28191766617533,50.69188604606769,NaN,NaN,8.0092935384576,-0.004334516851225878
2016-12-20T09:30:00-05:00,48.45,48.79,48.39,48.65,8663138,16210338.85,58.09361829190609,52.948128998756076,NaN,NaN,97.60956734525459,99.74730179258535,0.17328495262851182,0.29675032040434957,0.12346536777583775,650682073,625149526,75.6761004029776,53.70148052589581,NaN,NaN,9.21493603244128,1.3127041330477036
2016-12-21T09:30:00-05:00,48.66,48.89,48.44,48.45,8444189,16100400.1,55.9776376686037,53.897040356639536,NaN,NaN,87.06877391612157,90.92014613731149,0.14369671198980852,0.3030862577630984,0.15938954577328987,642237884,635111469.2,77.83203164489822,56.82772528341006,NaN,NaN,9.66433362522115,2.505794060501053
2016-12-22T09:30:00-05:00,48.42,48.71,48.33,48.62,7465247,15765992.3,57.39805605479226,54.70825086896864,NaN,NaN,77.29285879672926,89.95633290506345,0.12701443567185378,0.3181575903631071,0.19114315469125331,649703131,643002149.2,79.3902538870684,59.941669929109686,NaN,NaN,10.426022573756741,3.637255276680437
2016-12-23T09:30:00-05:00,48.68,48.8,48.45,48.61,7778511,15761607.5,57.280974333173035,55.47676300430832,NaN,NaN,77.43887087344655,87.49502218726128,0.10751920917235838,0.3255421661567013,0.2180229569843429,641924620,645313328.6,79.83730380826952,63.047265656060254,NaN,NaN,11.032910508430161,4.693777452644683
2016-12-27T09:30:00-05:00,48.42,48.77,48.37,48.65,13134359,15246738.9,57.65307331998016,56.31899545103083,NaN,NaN,68.41652310054714,81.56531880641981,0.09022867714668828,0.33080880341770325,0.24058012627101497,655058979,647921337.4,80.35513999625763,66.30401608605952,NaN,NaN,11.641582557561735,5.686321039061405
2016-12-28T09:30:00-05:00,48.68,48.71,48.12,48.19,8829348,14965821.95,52.0393437958104,56.39739197024134,NaN,NaN,43.30624128308767,70.70465359398644,0.04311192184977525,0.294470028583234,0.25135810673345876,646229631,647030849,79.60338002590997,69.31309592010375,NaN,NaN,10.724341560264106,6.4060382563760765
2016-12-29T09:30:00-05:00,48.38,48.915,48.26,48.84,14677819,14526343.75,58.228721635812015,56.872054937893914,NaN,NaN,69.28480925227846,67.14786066121782,0.050509951852902524,0.3144955465495869,0.26398559469668437,660907450,650764762.2,80.43012985430848,71.87017009252048,NaN,NaN,11.606675686069378,7.1489864606179765
2016-12-30T09:30:00-05:00,48.93,48.9499,48.42,48.57,14027748,14309427.9,55.05067947952483,56.839898555852436,NaN,NaN,64.34394171857755,64.55807724558747,0.032861603088133795,0.3050625985568516,0.2722009954687178,646879702,650200076.4,79.90265175331477,73.95858374295496,NaN,NaN,11.461892175458956,7.765115848452402
2017-01-03T09:30:00-05:00,48.5,48.63,48.1399,48.45,18880685,14433491.8,53.64919663346377,56.45287584578533,NaN,NaN,32.73144375331207,55.616591821560576,0.009937576277392501,0.28462296581545843,0.2746853895380659,627999017,647414955.8,77.21298886733496,75.43826577596231,NaN,NaN,10.952261749474212,8.220422405741232
2017-01-04T09:30:00-05:00,48.52,48.8801,48.4301,48.63,14550500,14416601.85,55.480058706015576,55.96431419348486,NaN,NaN,63.089012256278046,54.551089652706764,0.0040312214386728495,0.279724416336407,0.27569319489773414,642549517,644913063.4,74.77787603762513,76.24475449092957,NaN,NaN,11.01086817754258,8.619057515998568
2017-01-05T09:30:00-05:00,48.74,48.76,48.16,48.68,16306401,14810823.5,55.999975047077285,56.168927034853084,NaN,NaN,40.19995834200422,53.92983306449007,0.0007953503199756295,0.27668738279770366,0.27589203247772803,658855918,647438320.8,75.61385171712564,76.89659574037525,NaN,NaN,11.196166009728804,8.987215872245745
2017-01-06T09:30:00-05:00,48.44,48.92,48.35,48.83,10967168,14714062.35,57.59972993399653,56.31802906919188,NaN,NaN,75.23453146410274,55.11977750685493,0.005782869989695738,0.2831206199648477,0.277337749975152,669823086,649221448,76.21337515475514,77.38285723812953,NaN,NaN,11.77202623593183,9.3850459242009
2017-01-09T09:30:00-05:00,49.01,49.03,48.18,48.19,13847156,14686646.15,49.35453405980503,55.818088676036986,NaN,NaN,-3.2648644614996476,41.598016270839494,-0.03476593707695097,0.23388032862896324,0.2686462657059142,655975930,651040693.6,76.83899995322977,77.71185719780364,NaN,NaN,9.955980127659044,9.46660795326635
2017-01-10T09:30:00-05:00,48.18,48.2,47.85,48.04,11224177,14446909.2,47.63350180922003,55.102792912084354,NaN,NaN,-185.93012467580664,-2.134297414984256,-0.07038050221286457,0.1806706379398335,0.2510511401526981,644751753,654391240.8,77.98732049260666,77.97652882826301,NaN,NaN,7.935987379696291,9.247947871327769
2017-01-11T09:30:00-05:00,48.03,48.59,48.02,48.54,13397707,14017791.1,53.45933404745795,54.77177260890949,NaN,NaN,-47.73278210361931,-24.298656286963727,-0.05939351286150535,0.1768092490758164,0.23620276193732176,658149460,657511229.4,79.02994366474539,78.21608906124644,NaN,NaN,7.809033459036392,9.042388669571858
2017-01-12T09:30:00-05:00,48.57,48.66,48.29,48.58,9410404,13477462.6,53.90117802432231,54.623454062889394,NaN,NaN,14.511021373584498,-29.43644368064767,-0.048994283642839115,0.17495990738377287,0.223954191026612,667559864,659252018.6,79.61023299489617,78.34310344338915,NaN,NaN,7.829284735604109,8.869088107576465
2017-01-13T09:30:00-05:00,48.48,48.65,48.2,48.51,12173599,12668446.15,52.95372948542562,54.30600216507749,NaN,NaN,-12.70823005439718,-47.024995984347655,-0.046416871005093896,0.1659331022702446,0.2123499732753385,655386265,656364654.4,75.86049661231678,78.09097792376404,NaN,NaN,7.587984882598059,8.686073361150978
2017-01-17T09:30:00-05:00,48.67,49.2,48.625,49.04,15325970,12543666.5,58.851334009558485,54.41817071339074,NaN,NaN,211.26127230955032,-4.119768630137662,-0.0104807419671554,0.19924904581639424,0.20972978778354964,670712235,659311915.4,77.0488302221119,77.8918012390385,NaN,NaN,9.082490330014984,8.742704356702978
2017-01-18T09:30:00-05:00,48.9,49.22,48.9,48.98,13230909,12199262.35,57.96544425683056,54.44048292316576,NaN,NaN,216.37467184065287,76.34119067315423,0.00685161905744433,0.21829431160535506,0.21144269254791073,657481326,661857830,78.05385819139349,77.72742396726248,NaN,NaN,10.068720262891029,8.932135200444128
2017-01-19T09:30:00-05:00,48.7,48.98,48.43,48.55,13800486,12306776.05,51.932062246323966,54.4328199553453,NaN,NaN,38.10963967677324,93.50967502923274,-0.012013244137419776,0.196426137376136,0.2084393815135558,643680840,658964106,74.08295258581882,77.33310772154168,NaN,NaN,9.19037888960744,8.969027156038887
2017-01-20T09:30:00-05:00,48.62,48.78,48.33,48.64,11874247,12467331.5,53.03394274218496,54.061764320086226,NaN,NaN,6.699625745027445,91.94739590352134,-0.019364333116293597,0.1842339651181888,0.2035982982344824,655555087,656563150.6,70.86174508680712,76.64965166672016,NaN,NaN,8.772098312753714,8.940894464141005
2017-01-23T09:30:00-05:00,48.71,48.82,48.34,48.39,10625505,12576397.3,49.63056314247743,53.67461315315427,NaN,NaN,-22.120012509263923,90.06503941254799,-0.04076732570992511,0.152639141097076,0.1934064668070011,644929582,654471814,68.08475194753917,75.80551596630762,NaN,NaN,7.435522754392678,8.725841362748387
2017-01-24T09:30:00-05:00,48.38,48.59,48.29,48.38,11049442,12755607.05,49.493742556653416,53.37779500481067,NaN,NaN,-60.538427313790365,35.70509948787985,-0.054446642722220134,0.12534816340422594,0.17979480612644608,633880140,647105395,59.2734456088118,74.52412001927026,NaN,NaN,6.297621832596049,8.37895285844091
2017-01-25T09:30:00-05:00,48.16,48.43,48.111,48.38,19230002,13328181.6,49.49374255665341,52.950200994141944,NaN,NaN,-98.0451294638207,-27.17886077301486,-0.06180554556045853,0.1025378741758729,0.16434341973633143,633880140,642385157.8,54.41393367874865,73.06955270792193,NaN,NaN,5.3491735574371,7.946127244011794
2017-01-26T09:30:00-05:00,48.36,48.63,48.18,48.4,11488239,13245875.6,49.814649098216385,52.50839199779473,NaN,NaN,-53.16361425122543,-45.4335115586146,-0.06339994877771304,0.08509348376419013,0.14849343254190317,645368379,642722665.6,54.69991401954517,71.5757000152376,NaN,NaN,4.624727810486323,7.471641610651012
2017-01-27T09:30:00-05:00,48.49,48.64,48.29,48.39,7228797,13165848.05,49.644800549660225,51.94018275605642,NaN,NaN,-41.20338258683943,-55.014113224987966,-0.06306772266495261,0.0696587792107124,0.132726501875665,638139582,639239564.6,51.13469151771402,69.78436546973467,NaN,NaN,3.9643380032030078,6.97059823815844
2017-01-30T09:30:00-05:00,48.41,48.59,48.14,48.43,9319923,12897953.25,50.373689601167335,52.01297958043945,NaN,NaN,-58.530962494943715,-62.296303222123925,-0.05821071116683256,0.059963112917124306,0.11817382408395687,647459505,639745549.2,51.627922838020396,67.9835742472197,NaN,NaN,3.564069678003485,6.483951300993446
2017-01-31T09:30:00-05:00,48.47,49.22,48.42,49.18,15916468,12992389.25,61.59794473817925,53.010439789650825,NaN,NaN,153.61897757580815,-19.464822244204225,-0.005329049121283208,0.11151251268235285,0.11684156180363606,663375973,645644715.8,57.068712767115706,66.48938798111321,NaN,NaN,6.398595974280314,6.47175768289157
2017-02-01T09:30:00-05:00,48.92,48.94,48.19,48.33,24379533,13267331.65,48.272356526728686,52.63994139531302,NaN,NaN,-21.68338831618297,-4.192474014676679,-0.027214726739285683,0.08282315337952895,0.11003788011881463,638996440,646667975.8,57.952180554781975,64.98383347325868,NaN,NaN,4.7341380656708925,6.223526309002902
2017-02-02T09:30:00-05:00,48.48,48.84,48.19,48.84,15661096,13322861.45,54.61625765068045,52.69101851148145,NaN,NaN,32.193106333994976,12.8788701023674,-0.00796179032998709,0.10008564220633076,0.10804743253631785,654657536,648525807.2,59.578602112250195,63.55300269592684,NaN,NaN,5.514183407261943,6.122191608754194
2017-02-03T09:30:00-05:00,48.98,49.1,48.7921,48.9,11336644,13074373.6,55.31064776412862,52.85936981710311,NaN,NaN,127.65939072790651,46.651424765316584,0.007366959436398465,0.11725613183181594,0.10988917239541747,665994180,654096726.8,64.06697286767567,62.71060814273818,NaN,NaN,6.347446610118546,6.154370894663387
2017-02-06T09:30:00-05:00,49.09,49.12,48.75,48.8,7041999,12878115.15,53.8322901152587,52.500866681795976,NaN,NaN,104.16578330227526,79.19077392476038,0.009204929645251825,0.12139533445198225,0.11219040480673043,658952181,656395262,65.7564974924367,61.90401294776138,NaN,NaN,6.556702744566165,6.211846873220927
2017-02-07T09:30:00-05:00,48.88,49,48.75,48.92,6109128,12491213.75,55.37373238065325,52.31574440492617,NaN,NaN,91.13835972446873,66.6946503544925,0.016509697295096215,0.1328275264256007,0.11631782913050448,665061309,656732329.2,66.00889555358239,61.04365847363202,NaN,NaN,7.192469004120065,6.351935749063661
2017-02-08T09:30:00-05:00,49.04,49.49,48.95,49.4,15881993,12724104.55,60.98504783264899,52.962386232520814,NaN,NaN,178.3438189345793,106.70009180464494,0.04979474971537795,0.1785612662747269,0.12876651655934895,680943302,665121701.6,71.61643611471604,60.86747872569611,NaN,NaN,9.551657299814027,6.809038827742285
2017-02-09T09:30:00-05:00,49.35,49.47,48.86,48.98,14496034,12779020.9,54.524643632742375,53.068864867560634,NaN,NaN,110.14383379599072,122.29023729704411,0.040069494116252574,0.17885338420466468,0.1387838900884121,666447268,667479648,72.96633492821674,61.01780657151108,NaN,NaN,9.49270496839789,7.1924197049788
2017-02-10T09:30:00-05:00,48.85,49.355,48.84,49.29,9479582,12782479.8,58.05646281832442,53.670714844406845,NaN,NaN,109.22839700172031,118.60403855180687,0.05039159277201283,0.20177338105342812,0.1513817882814153,675926850,669466182,74.08458569298017,61.44636612475687,NaN,NaN,10.59253925683037,7.678151069529024
2017-02-13T09:30:00-05:00,49.33,49.58,49.1601,49.53,13042814,12825940.55,60.607242583764545,54.464536274914785,NaN,NaN,150.21542289702438,127.81396647075667,0.06815579412461026,0.23657653093717812,0.16842073681256786,688969664,675469678.6,77.1594988421739,62.723941355711304,NaN,NaN,12.31888606449253,8.341113211666668
2017-02-14T09:30:00-05:00,49.46,49.48,48.91,49.17,18784269,12998855.5,55.18584168128753,54.87111478381723,NaN,NaN,89.43114645753074,127.47252381736908,0.05120739334933244,0.23242997849923341,0.18122258514990097,670185395,676494495.8,77.64706776799947,64.38345093351494,NaN,NaN,12.03821971060278,8.869271282943256
2017-02-15T09:30:00-05:00,48.82,49.0666,48.65,49.05,18925381,13283579.1,53.46891481410144,55.1321337635233,NaN,NaN,32.67805689092422,98.33937140863806,0.028589796538314977,0.21695983082279469,0.1883700342844797,651260014,670557838.2,68.5219146817013,65.37073669509752,NaN,NaN,11.27807499767058,9.213386099332874
2017-02-16T09:30:00-05:00,49.06,49.56,49.06,49.54,14001079,13293608.75,59.06878863299266,55.805275769475614,NaN,NaN,120.80957947046421,100.47252054353275,0.04246812228065153,0.24145518713529412,0.1989870648546426,665261093,670320603.2,68.17710843824578,66.58805218942122,NaN,NaN,12.413239845544917,9.670508063077452
2017-02-17T09:30:00-05:00,49.67,49.72,49.29,49.57,9973464,13198569.6,59.3910194005041,56.449370755142525,NaN,NaN,134.17186548534914,105.46121424025856,0.04904094167043718,0.26028824194268907,0.2112473002722519,675234557,670182144.6,67.9621578450334,67.75478326135071,NaN,NaN,13.410248376063215,10.204756679218276
2017-02-21T09:30:00-05:00,49.5,50.2,49.33,50.09,11358452,13235216.95,64.5940400961459,56.663377566425865,NaN,NaN,178.7546064919908,111.16905095925183,0.08184913420077164,0.31355871802321644,0.2317095838224448,686593009,669706813.6,67.17909769564278,68.47695361338836,NaN,NaN,15.978123616796594,11.029523384586607
2017-02-22T09:30:00-05:00,50.09,50.4,49.89,50.3,16018632,13483676.45,66.46283013605913,57.96269710994947,NaN,NaN,197.587773702633,132.80037640827229,0.10941126416984603,0.36847366403475235,0.2590623998649063,702611641,676192062.8,71.93102445898369,69.4754424636885,NaN,NaN,18.683688440384415,12.122975535414865
2017-02-23T09:30:00-05:00,50.52,51,50.41,50.82,15003582,13272355.45,70.60080884615935,59.10445076676939,NaN,NaN,236.47798556644756,173.56036214337695,0.1517745167422187,0.4487805457926797,0.297006029050461,717615223,689463104.6,78.72058823794784,70.8427271869526,NaN,NaN,22.43992582556799,13.59682557686531
2017-02-24T09:30:00-05:00,50.99,51.59,50.99,51.59,18629698,13629428.4,75.43431973430495,60.54185590749626,NaN,NaN,253.89315581625436,200.17707741253497,0.21680256564507966,0.5680092361068105,0.3512066704617309,736244921,703659870.2,83.35811897596746,72.22066619468774,NaN,NaN,27.558131969060152,15.591297918607431
2017-02-27T09:30:00-05:00,51.49,51.529,51.23,51.3,13982858,13967131.45,70.7185496755796,61.74801730466204,NaN,NaN,197.51553391926058,212.84581109931727,0.22448673147209564,0.6318150848018504,0.4073283533297548,722262063,713065371.4,85.59756375948291,73.63788521376247,NaN,NaN,30.03835703359503,17.655163506462802
2017-02-28T09:30:00-05:00,51.29,51.9,51.2,51.77,14410423,14221656.45,73.59916848061746,63.0498341689452,NaN,NaN,177.7792591838815,212.6507416376954,0.24381581948406794,0.7120981276848397,0.46828230820077177,736672486,723081266.8,87.52304416859525,75.1746101148348,NaN,NaN,33.10606330104472,19.86243490568879
2017-03-01T09:30:00-05:00,51.03,51.685,50.98,51.31,29121553,14881910.7,66.684624045005,63.456946755542056,NaN,NaN,126.29984168076447,198.3931552333217,0.20952432346664274,0.7301877125340752,0.5206633890674325,707550933,724069125.2,87.69773805752342,76.32327453932105,NaN,NaN,33.255161255820795,21.775681527136218
2017-03-02T09:30:00-05:00,51.13,52,51.06,51.68,17372834,14531575.75,69.19180400848927,64.50460106809541,NaN,NaN,124.95297765926789,176.08815365188576,0.19591321372124415,0.7655549062189877,0.5696416924977435,724923767,725530834,87.96622417816475,77.39469520003162,NaN,NaN,34.22460550050456,23.55409923761741
2017-03-03T09:30:00-05:00,51.68,51.705,51.09,51.52,17575040,14627272.95,66.84898598835872,65.13263843738358,NaN,NaN,99.52063955636832,145.21365039990854,0.16170779864303586,0.7717764408015384,0.6100686421585025,707348727,719751595.2,80.48699178694487,77.8520099210291,NaN,NaN,34.23127511786497,25.079410077652778
2017-03-06T09:30:00-05:00,51.43,51.53,51.24,51.42,7616801,14441280.8,65.35942990996953,65.47208038925535,NaN,NaN,85.54899425343028,122.82034246674247,0.11984787138621289,0.7598784813912687,0.6400306100050558,699731926,715245567.8,75.12376347814954,77.70660025217022,NaN,NaN,33.77604791861634,26.321786912076146
2017-03-07T09:30:00-05:00,51.36,51.58,51.32,51.39,17951673,14986764.5,64.8922749419645,66.16539705073228,NaN,NaN,78.47948646522859,102.9603879230119,0.07957868967104664,0.7395039720938641,0.6599252824228174,681780253,704267121.2,63.9440104657193,76.7278104448645,NaN,NaN,33.27368552460925,27.31491528529516
2017-03-08T09:30:00-05:00,50.95,51,50.551,50.65,18393940,15601005.1,54.53745137506872,66.24172109080138,NaN,NaN,26.731131016341983,83.04664579012741,-0.0030743837507077876,0.6560823027344327,0.6591566864851405,663386313,695434197.2,56.64052117895437,75.87913948038256,NaN,NaN,29.484000445249166,27.624784593860017
2017-03-09T09:30:00-05:00,50.77,50.95,50.5,50.54,12842758,15449043.35,53.17902616487884,65.82102377165039,NaN,NaN,17.763002668023557,61.60865079187854,-0.0677479133476484,0.57447179480058,0.6422197081482284,650543555,680558154.8,46.92061971579339,74.36081885735025,NaN,NaN,26.01120882791318,27.394273770153326
2017-03-10T09:30:00-05:00,50.81,51.06,50.64,50.96,11491797,15298831.5,57.528891198154334,65.68801461433968,NaN,NaN,29.666122658630126,47.6377474123309,-0.08378414688555402,0.5374895245412858,0.6212736714268399,662035352,671495479.8,42.17253940880042,72.51870325476219,NaN,NaN,24.332962661892825,26.956943611830397
2017-03-13T09:30:00-04:00,50.92,51.14,50.86,51.11,14057982,15527751.5,58.99412873341303,65.28802094557305,NaN,NaN,37.1861863112288,37.965185823890614,-0.08553462786621113,0.514355386594076,0.5998900144602871,676093334,666767761.4,39.90397875748409,70.57048047346514,NaN,NaN,23.39421827626577,26.44798284960688
2017-03-14T09:30:00-04:00,51.05,51.2,50.89,51.06,11670519,15459136.75,58.272454538233625,64.70299411715695,NaN,NaN,34.29522967521247,29.128334465887388,-0.09080789484421647,0.48638014590501655,0.577188040749233,664422815,663296273.8,38.2758304378938,68.16653804338728,NaN,NaN,22.42332513148936,25.873031747018665
2017-03-15T09:30:00-04:00,51.24,52.14,51.14,51.88,22619164,15650881.5,65.6860885525592,64.35194266761405,NaN,NaN,93.45861539328457,42.473831341275904,-0.04228440538673661,0.5243325340158123,0.5666169394025489,687041979,668027407,41.76328739881088,65.52673084059178,NaN,NaN,23.857576378608826,25.585109551531545
2017-03-16T09:30:00-04:00,51.78,51.78,51.21,51.31,18728354,15641030.15,57.97532819179749,63.104871843149226,NaN,NaN,59.83164779264307,50.88756036619981,-0.05119601070390911,0.5026219260226625,0.5538179367265716,668313625,671581421,44.30881999847758,62.737495199342504,NaN,NaN,22.554439668592725,25.152156711111715
2017-03-17T09:30:00-04:00,51.1,51.52,51.04,51.23,15128544,15697403.4,56.964613052420745,62.122447798637886,NaN,NaN,33.29596277409318,51.613528389292426,-0.0642523183117456,0.47350253883688964,0.5377548571486352,653185081,669811366.8,43.29383417801206,59.715800229237445,NaN,NaN,21.207687086677886,24.58866105047831
2017-03-20T09:30:00-04:00,51.35,51.45,50.75,50.9038,7148024,15556131.4,52.913878330602266,60.6449270736368,NaN,NaN,-13.118241236950801,41.552642879656496,-0.09478747660138609,0.41927051139690263,0.5140579879982887,646037057,663800111.4,39.94712042605679,56.31751996191327,NaN,NaN,18.805113802482612,23.762440015050355
2017-03-21T09:30:00-04:00,50.92,51.8,50.89,51.61,25417115,16259064.55,59.61010061944235,60.1396039718109,NaN,NaN,52.26671975870426,45.146940896354856,-0.06857594046420273,0.4283380624180353,0.496914002882238,671454172,665206382.8,41.09431834999988,52.98870426851873,NaN,NaN,18.856665541484915,23.06161509025529
2017-03-22T09:30:00-04:00,51.82,52.23,51.65,51.86,25252761,16720771,61.68729317197796,59.60356748348865,NaN,NaN,154.39197435699006,57.33361268909594,-0.037128047457084645,0.4505039435608822,0.48763199101796684,696706933,667139373.6,42.71424910812082,49.75642033494416,NaN,NaN,19.569261487705663,22.5627074327482
2017-03-23T09:30:00-04:00,51.85,52.17,51.56,51.7,22565328,17098858.3,59.575570640126685,59.0840378157578,NaN,NaN,123.57420270179672,70.08212367092668,-0.030127277760451043,0.449972893817403,0.48010017157785406,674141605,668304969.6,43.71933102948643,47.13015885226855,NaN,NaN,19.493580126339506,22.124260674689815
2017-03-24T09:30:00-04:00,51.73,52.08,51.6,51.89,12407130,16787729.9,61.27105993845203,58.79201138922083,NaN,NaN,120.89074971141933,87.60108105839191,-0.016411634754747495,0.4595856281344197,0.4759972628891672,686548735,674977700.4,49.21283064444296,45.279377935575226,NaN,NaN,19.941898227063838,21.812494610743247
2017-03-27T09:30:00-04:00,52.1,52.21,51.49,51.69,11821399,16679656.95,58.49010082987718,58.33471323835745,NaN,NaN,95.2775550608386,109.2802403179498,-0.0240577193715647,0.4459251136747113,0.469982833046276,674727336,680715756.2,53.42306792783575,44.527882040012116,NaN,NaN,19.497520136962308,21.481783971631685
2017-03-28T09:30:00-04:00,51.68,51.74,51.42,51.65,8477840,16383027.8,57.923846826918606,58.576598627775304,NaN,NaN,52.34303303046055,109.29550297230105,-0.03442644200692563,0.426949780537619,0.46137622254454463,666249496,679674821,52.57164036732397,44.237247696324225,NaN,NaN,18.975413622828434,21.123731064659793
2017-03-29T09:30:00-04:00,51.63,51.675,51.29,51.51,6953461,15274623.2,55.88458190444521,58.7698526091729,NaN,NaN,25.283815034490896,83.47387110780122,-0.052261417388678344,0.3960494508086967,0.44831086819737503,659296035,672192641.4,46.798170872211266,44.22850135035407,NaN,NaN,17.971083901299366,20.673352898465446
2017-03-30T09:30:00-04:00,51.43,51.43,50.97,51.11,19711220,15391542.5,50.42251068862921,58.26225400134968,NaN,NaN,-41.4313281463574,50.472764938170386,-0.09031463471706647,0.33541757480104195,0.4257322095181084,639584815,665281283.4,42.18917495077902,44.22968960335255,NaN,NaN,15.497226895328655,19.93390632658876
2017-03-31T09:30:00-04:00,51.17,51.56,51.13,51.31,9991039,15012342.45,52.90124222719667,57.82704782233423,NaN,NaN,-4.327010748739889,25.42921284613854,-0.10054899826097224,0.3000459616918931,0.40059495995286537,649575854,657886707.2,37.88954199384926,44.085801263092925,NaN,NaN,14.08919618424587,19.09894773482549
2017-04-03T09:30:00-04:00,51.31,51.31,50.83,51.3,15475829,15405293.85,52.75920639994321,57.43324438388491,NaN,NaN,-41.85007905552552,-1.9963139771342768,-0.10598307884075936,0.26811611140191616,0.3740991902426755,634100025,649761245,33.81181367909622,43.7669429231788,NaN,NaN,12.89335427462158,18.21243438336779
2017-04-04T09:30:00-04:00,51.25,51.65,51.15,51.46,10134305,15014425.45,54.8480835042168,56.65910116614617,NaN,NaN,17.352626053815776,-8.99439537246323,-0.09703301184833424,0.2528079254322577,0.34984093728059196,644234330,645358211.8,31.813780131954445,43.05626383268906,NaN,NaN,12.421936892819803,17.385220456146648
2017-04-05T09:30:00-04:00,51.4,51.8,51.29,51.75,12649545,14727205.7,58.43549363789457,56.69197012658168,NaN,NaN,53.31995223690639,-3.387167931980133,-0.07101896296786858,0.26106723357075623,0.3320861965386248,656883875,644875779.8,31.593487129182293,42.14802577059653,NaN,NaN,12.994918352956713,16.75803444140523
2017-04-06T09:30:00-04:00,51.69,51.71,51.42,51.62,9388774,14554506.5,56.27692798702674,56.642849764767824,NaN,NaN,40.5003983559104,12.999177368473426,-0.062314792473886604,0.25419270594626653,0.31650749842015313,647495101,646457837,33.226392528612195,41.4289227956394,NaN,NaN,12.898512564071252,16.20667417321466
2017-04-07T09:30:00-04:00,51.82,51.89,51.36,51.4,19917957,14975814.5,52.72725979818141,56.6295198695949,NaN,NaN,25.12995263946686,18.890570046114778,-0.0705179671312936,0.22836003950603612,0.2988780066373297,627577144,642058095,31.009483759404077,40.790520176592786,NaN,NaN,11.839193422431709,15.58274835167424
2017-04-10T09:30:00-04:00,51.43,51.55,51.14,51.49,8484887,14697159.75,54.00537205114063,56.22918211471621,NaN,NaN,-27.377711013070293,21.785043654605822,-0.06894411371434805,0.21269786449439465,0.2816419782087427,636062031,642450496.2,31.448790182934403,40.101553878945246,NaN,NaN,11.284606534177957,14.968728092031915
2017-04-11T09:30:00-04:00,51.52,51.57,51.13,51.47,9844223,14605844.95,53.65818273625739,55.65567422645046,NaN,NaN,-36.5528402361694,11.00395039660879,-0.06818751794852157,0.19640758077309073,0.2645950987216123,626217808,638847191.8,29.585774906053118,39.1638057216547,NaN,NaN,10.729479065852477,14.363121088291996
2017-04-12T09:30:00-04:00,51.4,51.88,51.24,51.85,10520961,14000934.8,59.04546435701386,55.6178094919424,NaN,NaN,55.92160896289856,11.524281741807226,-0.0423003467723832,0.21171966525613328,0.2540200120285165,636738769,634818170.6,27.615830942785948,38.013555715461806,NaN,NaN,11.706264817055462,13.983570192401062
2017-04-13T09:30:00-04:00,51.91,51.92,51.45,51.68,10856111,13607322.65,55.913865375356245,55.235152737435556,NaN,NaN,58.87017731442689,15.198237533510525,-0.037022170131726956,0.2077422993638578,0.24476446949558475,625882658,630495682,25.64313129488255,36.330005761921775,NaN,NaN,11.688696459421575,13.655731087689707
2017-04-17T09:30:00-04:00,51.8,51.93,51.66,51.91,7272573,13214524.1,59.076276576916406,55.27702243365265,NaN,NaN,98.8391332401287,29.94007365364289,-0.019326556202997225,0.2206062742418382,0.23993283044483543,633155231,631611299.4,27.090741509973512,34.44912530350304,NaN,NaN,12.566273306282744,13.500094261774427
2017-04-18T09:30:00-04:00,51.99,52.14,51.83,52.03,14707362,13592491,60.661786777709686,55.47258957299487,NaN,NaN,143.91122640147717,64.19786113655239,-0.0017514603595993328,0.23774350499533625,0.23949496535493559,647862593,633971411.8,30.187216600655518,32.850237891598155,NaN,NaN,13.755265801081427,13.536547338818284
2017-04-19T09:30:00-04:00,51.97,51.99,51.485,51.67,12517048,12947487.65,53.91344705123619,55.33179422633708,NaN,NaN,40.97355979686375,79.70314114315902,-0.015801705182888842,0.21974283387632454,0.23554453905921338,635345545,635796959.2,32.572643717623905,31.83412880912763,NaN,NaN,12.872273684486526,13.441651102485176
2017-04-20T09:30:00-04:00,51.61,51.61,51.1,51.47,13470466,12358372.9,50.549052380469625,55.34083291861139,NaN,NaN,-64.04971022288159,55.70887730600299,-0.038690722307524905,0.18718113617480725,0.22587185848233216,621875079,632824221.2,30.731198110907783,31.015701891993967,NaN,NaN,11.128487853371965,13.111199209754718
2017-04-21T09:30:00-04:00,51.4,51.95,51.4,51.73,13259067,11893059.85,54.52222202746285,55.45661719005897,NaN,NaN,46.911986227654765,53.31723908864857,-0.03647552123660214,0.18027745693657948,0.21675297817318162,635134146,634674518.8,33.2602632179737,30.68503912228857,NaN,NaN,10.787693147276487,12.779269772257827
2017-04-24T09:30:00-04:00,51.78,52.06,51.43,52,18106693,12178038,58.271680003673204,55.85036530461111,NaN,NaN,98.47429827002853,53.244272094628535,-0.01792029532149292,0.19435260902131546,0.21227290434280838,653240839,638691640.4,38.509413929980006,31.020581997351695,NaN,NaN,11.627563818676572,12.614740350317648
2017-04-25T09:30:00-04:00,51.85,52.01,51.64,51.93,10891611,12131548.6,56.96050092044378,56.00125226291304,NaN,NaN,106.744653628205,45.8109575399741,-0.011753315716530599,0.19758125969714513,0.20933457541367573,642349228,637588967.4,37.63441766553597,31.43634182117895,NaN,NaN,11.937415495366093,12.51797965675314
2017-04-26T09:30:00-04:00,51.92,52.16,51.72,51.77,9597402,12187526.7,53.97117692720739,55.68237249786396,NaN,NaN,103.03755627740752,58.22375683608285,-0.019391133719510206,0.18509565826428798,0.20448679198379818,632751826,637070223.6,37.20612114383881,31.837244250797266,NaN,NaN,11.34137686110217,12.349893543088715
2017-04-27T09:30:00-04:00,51.75,52.2,51.71,51.95,9466542,12313180.75,56.72283935229766,55.714223309669016,NaN,NaN,112.38855944167487,93.51141076899414,-0.013538942364995005,0.18756311402755443,0.20110205639254944,642218368,641138881.4,42.71291709022544,32.51485314805536,NaN,NaN,11.622117924329684,12.245925597551711
2017-04-28T09:30:00-04:00,51.88,51.95,51.54,51.7,9405749,11797907.2,52.067176748584565,55.6670745204121,NaN,NaN,34.469983254025024,91.0230101742682,-0.02694899348450089,0.16741581453692334,0.19436480802142422,632812619,640674576,42.257486094965095,33.31828188630971,NaN,NaN,10.500578588368475,11.996590310525534
2017-05-01T09:30:00-04:00,51.82,51.82,51.26,51.39,10692520,11832981.25,46.92406955777359,55.16126719945731,NaN,NaN,-56.26232971405179,60.07568457745212,-0.055496905598020896,0.1249936760238981,0.180490581621919,622120099,634450428,36.62048293502152,33.6876885114588,NaN,NaN,7.941755578436414,11.417328205941374
2017-05-02T09:30:00-04:00,51.45,51.64,51.24,51.45,9438626,11531121.1,47.994805814167094,54.75674027645086,NaN,NaN,-87.1408303848008,21.298587774850972,-0.06829738270104829,0.09511885324560865,0.16341623594665694,631558725,632292327.4,34.88294527805108,34.066057823744366,NaN,NaN,6.159649878828529,10.66623130206811
2017-05-03T09:30:00-04:00,51.52,51.58,51.24,51.27,10507208,11549766.25,45.058079292136526,53.75764134324534,NaN,NaN,-116.5618448637591,-22.621292453382356,-0.08571722622239783,0.056269703168659646,0.14198692939105748,621051517,629952265.6,33.051708918807634,34.454334822031626,NaN,NaN,3.772893224607029,9.68146871957367
2017-05-04T09:30:00-04:00,51.12,51.51,51.11,51.45,14039080,11619243,48.45467041931796,53.22484170352833,NaN,NaN,-105.12000247271233,-66.1230048362598,-0.08194949626871295,0.03955005905516629,0.12149955532387924,635090597,628526711.4,31.951283398818532,34.90491711516991,NaN,NaN,2.71069632530321,8.685644091820748
2017-05-05T09:30:00-04:00,51.6,51.92,51.55,51.73,10785296,11689069.1,53.291951917222626,52.81167565640734,NaN,NaN,31.747500925558302,-66.66750130195314,-0.05853077050199422,0.04833609219638646,0.10686686269838068,645875893,631139366.2,36.147225512916386,35.55180882966583,NaN,NaN,3.227578111736466,7.905920380380136
2017-05-08T09:30:00-04:00,51.77,51.83,51.45,51.71,8789722,11132657.35,52.91000196004982,52.25797674086021,NaN,NaN,3.8572498764513052,-54.64358538385252,-0.043034725244784716,0.05307345614239978,0.0961081813871845,637086171,634132580.6,40.66148674679664,36.299970982961625,NaN,NaN,3.5393354834726267,7.282122537964778
2017-05-09T09:30:00-04:00,51.67,51.71,51.24,51.33,7758919,11096358.95,46.14309991462499,51.70295194538797,NaN,NaN,-88.41330557307687,-54.89808042150774,-0.05619306507199229,0.025866850047194134,0.08205991511918642,629327252,633686286,40.2050755533414,36.84514468551288,NaN,NaN,1.7753357954924471,6.495438717611588
2017-05-10T09:30:00-04:00,51.37,51.52,51.13,51.41,8439821,11026138.85,47.66074670727348,51.49664439730254,NaN,NaN,-114.523138640848,-54.490339176925524,-0.05713743570744159,0.010638120484884439,0.06777555619232603,637767073,637029397.2,45.16992146725905,37.87648206810939,NaN,NaN,0.7683852450851444,5.677288221536382
2017-05-11T09:30:00-04:00,51.28,51.48,51.07,51.48,7699155,10885048.55,49.014588817597605,51.10324202516931,NaN,NaN,-101.61829071645337,-53.78999682567373,-0.05088477047267681,0.004169593101480018,0.05505436357415683,645466228,639104523.4,48.05314986181504,38.933116828383774,NaN,NaN,0.3165711099529634,4.91147149131018
2017-05-12T09:30:00-04:00,51.6,51.84,51.53,51.73,7523074,10718396.7,53.62800783789381,50.77155115618507,NaN,NaN,21.263774104661348,-55.88674218985314,-0.028845761455840432,0.018997161754356284,0.04784292321019672,652989302,640527205.2,49.994594785533664,39.753486889494745,NaN,NaN,1.270743899240232,4.391367549585902
2017-05-15T09:30:00-04:00,51.74,52.04,51.68,51.95,6351125,10672324.3,57.29043875220929,50.79511814416831,NaN,NaN,84.72316768775732,-39.71355862759192,0.00008371615161927026,0.04794756839972081,0.04786385224810154,659340427,644978056.4,55.58696931159204,41.035812007070184,NaN,NaN,3.1979219801455105,4.220875325380132
2017-05-16T09:30:00-04:00,51.87,52.02,51.51,51.57,7653070,10319609.7,49.95187485635758,50.50802513910761,NaN,NaN,26.800821851560276,-16.670733142664496,-0.006475314135402241,0.03976970957884873,0.046245023714250974,651687357,649450077.4,60.3812702121925,42.69117979766687,NaN,NaN,2.6426410741365407,3.9954132894881904
2017-05-17T09:30:00-04:00,51.7,51.94,51.47,51.7,15032839,10445399.25,52.207332331193086,50.18548892331442,NaN,NaN,28.29274203318279,11.892442992141667,-0.002372251340348519,0.043279709538815325,0.045651960879163844,666720196,655240702,65.56478079922685,44.32345577688126,NaN,NaN,2.8782589946602752,3.8358198187984884
2017-05-18T09:30:00-04:00,51.81,52.145,51.435,51.88,16875978,10615674.85,55.216709793684025,50.41045556939296,NaN,NaN,65.92430443195062,45.400962021822465,0.011394805539309737,0.05989546780330102,0.04850066226399128,683596174,662866691.2,70.95441226040388,46.37323621726974,NaN,NaN,3.9984512804071533,3.8590528847425833
2017-05-19T09:30:00-04:00,51.87,52.08,51.58,52.08,9901328,10447787.9,58.354511711888634,51.22691572325832,NaN,NaN,93.17166560305029,59.78254032150026,0.03174775702750498,0.0881853585483725,0.05643760152086753,693497502,670968331.2,75.36563535075354,49.140747104107746,NaN,NaN,5.915912461805371,4.1528899671801245
2017-05-22T09:30:00-04:00,52,52.61,51.97,52.53,7779269,9931416.7,64.39875472333347,52.39862635962735,NaN,NaN,224.05711794200406,87.64933037234961,0.07104374071191878,0.145242277410766,0.07419853669884723,701276771,679355600,78.93276361304638,52.28716269946455,NaN,NaN,9.658714769836068,4.939436367559545
2017-05-23T09:30:00-04:00,52.62,52.98,52.53,52.67,15290193,10151345.8,66.04964599311107,53.898023981125526,NaN,NaN,269.88310020945124,136.2657860439278,0.10020749075190799,0.1994579001387322,0.09925040938682422,716566964,692331521.4,83.0274966354352,55.85686182208081,NaN,NaN,13.236936149875703,6.124793479318996
2017-05-24T09:30:00-04:00,52.72,53.06,52.67,52.97,7602342,10051592.8,69.33153045658558,55.38922826950178,NaN,NaN,239.50432646082308,178.50810292945584,0.13147417413915313,0.26359312706076565,0.13211895292161252,724169306,703821343.4,85.68136521378311,59.694724808863995,NaN,NaN,17.38554284753384,7.733471960492546
2017-05-25T09:30:00-04:00,53.08,53.49,52.945,53.4,16777277,10417129.55,73.313536300415,56.81934143972982,NaN,NaN,238.43988741453236,213.01121952597222,0.17041652425791898,0.34513960824401124,0.17472308398609226,740946583,715291425.2,87.741959368053,63.38006294137375,NaN,NaN,22.39882185065681,9.828521944801725
2017-05-26T09:30:00-04:00,53.43,53.52,53.3,53.4,7649643,10329324.25,73.313536300415,58.2767367497559,NaN,NaN,195.5930614158259,233.49549868852733,0.18429840206710732,0.4050960865699764,0.2207976845028691,740946583,724781241.4,89.13509316261295,66.84246339964633,NaN,NaN,26.280489871037478,12.178803077121119
2017-05-30T09:30:00-04:00,53.44,53.7,53.2934,53.57,6292291,10109312.8,74.81300035038635,60.32458678088171,NaN,NaN,165.08869010960998,221.7018131220485,0.19217409987217066,0.46101530934308244,0.2688412094709118,747238874,733973662,90.28667892095855,70.41972078304757,NaN,NaN,29.97978789181721,14.72180090779199
2017-05-31T09:30:00-04:00,53.63,54.03,53.57,53.84,12620691,10268416.05,77.02135570433057,62.421773137814355,NaN,NaN,159.12762803392448,199.55071868694316,0.2018161460521143,0.5211113920360546,0.3192952459839403,759859565,742632182.2,91.22962510444162,73.7096996142749,NaN,NaN,33.85841037268117,17.455602259919015
2017-06-01T09:30:00-04:00,53.7,54.23,53.64,54.22,11118558,10298983.55,79.71681725762298,64.61478945495902,NaN,NaN,149.62315802931812,181.57448500064217,0.21861981637997363,0.5925700164589074,0.37395020007893376,770978123,751993945.6,92.1203153004439,76.85735428846267,NaN,NaN,38.1501283574361,20.411963130992884
2017-06-02T09:30:00-04:00,54.63,54.63,54.12,54.28,9956578,10094858.45,80.11347861879759,66.50660879645216,NaN,NaN,148.78565409250777,163.64363833623725,0.21811144660927928,0.6465895083405329,0.4284780617312536,780934701,759991569.2,92.79362285054977,79.9144277216781,NaN,NaN,41.69488265534086,23.452380205899736
2017-06-05T09:30:00-04:00,54.28,54.33,54.03,54.11,7350014,9923094.35,75.60219086287238,67.81459109007095,NaN,NaN,116.21757810555636,147.76854167418335,0.1916036922938883,0.6679826770986139,0.4763789848047256,773584687,766519190,93.29706361978752,82.60800588654921,NaN,NaN,43.29004492837478,26.286332309110456
2017-06-06T09:30:00-04:00,54.23,54.23,53.92,53.99,7501231,9858669.8,72.49875690317826,69.42508266484386,NaN,NaN,96.4437989255341,134.03956343736814,0.1529437873395577,0.6675587189791727,0.514614931639615,766083456,770288106.4,93.57610961045141,84.97906584356771,NaN,NaN,43.69075987111265,28.772679103682197
2017-06-07T09:30:00-04:00,53.99,54.295,53.9,54.17,7881330,9864790.35,74.20897933682677,70.99662887953198,NaN,NaN,91.79253922208163,120.57254567499959,0.12749047520779733,0.6739780256493617,0.5464875504415644,773964786,773109150.6,93.78467981441685,86.99477291608127,NaN,NaN,44.530155250078806,31.023747124596
2017-06-08T09:30:00-04:00,54.06,54.1,53.39,53.72,13292648,10107431.7,63.566280644277185,71.59302679743149,NaN,NaN,58.77882799101919,102.40367966733982,0.07115339949776067,0.6354292998137652,0.5642759003160045,760672138,771047953.6,91.44840161086844,88.45862929825732,NaN,NaN,41.89216549471247,32.576378320326924
2017-06-09T09:30:00-04:00,53.55,53.71,53.285,53.67,13938193,10419383.6,62.493836531356976,71.88869285596493,NaN,NaN,40.15293997353459,80.67713684354518,0.02377715423286353,0.593997343107084,0.5702201888742204,746733945,764207802.4,83.97254668262674,89.07340867910541,NaN,NaN,39.449380096779564,33.55823571696302
2017-06-12T09:30:00-04:00,53.74,53.96,53.27,53.57,12821145,10684287.15,60.30255459761411,71.59610713269927,NaN,NaN,38.885217373973155,65.21066469722854,-0.018744151181832258,0.5467899998969301,0.5655341510787624,733912800,756273425,76.19174246925292,88.87762145454873,NaN,NaN,36.77620477501197,34.01794558239858
2017-06-13T09:30:00-04:00,53.51,53.741,53.38,53.7,8914879,10812474.85,62.16009856953245,71.31828231672937,NaN,NaN,35.14277117319688,52.95045914676109,-0.04127265287112114,0.513943334989861,0.5552159878609821,742827679,751622269.6,71.98119200674482,88.08859969535656,NaN,NaN,35.04579948866755,34.16478185472272
2017-06-14T09:30:00-04:00,54.04,54.28,53.82,53.99,15832103,11221426.5,65.98394005224608,71.0791687164194,NaN,NaN,70.02538886923767,48.59702907619229,-0.03978417628983899,0.5054857674986835,0.5452699437885224,758659782,748561268.8,69.26817814619011,86.91622919052848,NaN,NaN,34.638385099047255,34.232439461054796
2017-06-15T09:30:00-04:00,53.84,54.355,53.84,54.3,15549451,11247257.1,69.52871766611726,70.80882452825527,NaN,NaN,81.58873251989154,53.159009981966754,-0.02195332195510402,0.5178282913446424,0.5397816132997464,774209233,751268687.8,70.33325178696771,85.67275007759383,NaN,NaN,35.37194915844486,34.39522656068195
2017-06-16T09:30:00-04:00,54.02,54.2199,53.92,54.11,17695762,11288246.3,65.05409694754604,70.21886457447893,NaN,NaN,69.93599739736142,59.115621466732115,-0.026672900544686073,0.5064404876188888,0.5331133881635749,756513471,753224593,71.11215498558181,84.38539735066304,NaN,NaN,34.60972239294129,34.42586882243328
2017-06-19T09:30:00-04:00,54.16,54.19,53.74,53.93,17822337,11684296.75,61.04587362841869,69.23549838005266,NaN,NaN,45.87046300046428,60.51267059203035,-0.04458027593445635,0.47738804324550443,0.5219683191799608,738691134,754180259.8,71.50580772052106,83.04390655063177,NaN,NaN,32.73949324286601,34.184958025352245
2017-06-20T09:30:00-04:00,53.99,54.03,53.86,53.96,7588505,11674758.55,61.47195026095027,68.12482656266836,NaN,NaN,38.63562844651785,61.211242046694544,-0.05631145579181329,0.4515789994401942,0.5078904552320075,746279639,754870651.8,71.80472321314062,81.65641355839601,NaN,NaN,31.34789004280052,33.77966259927343
2017-06-21T09:30:00-04:00,53.95,54.04,53.36,53.64,10076574,11414077.6,54.61038928336579,66.33151027879285,NaN,NaN,-27.284195164442888,41.74932523995844,-0.08576438524705676,0.40068497367318656,0.4864493589202433,736203065,750379308.4,66.88874112892566,79.85415826043041,NaN,NaN,28.00591009008069,32.9548408122459
2017-06-22T09:30:00-04:00,53.56,53.7565,53.35,53.39,7931165,11430518.75,49.92210894323297,64.17498387339538,NaN,NaN,-84.89634917573531,8.452308900833069,-0.12011828194265217,0.33630150649192814,0.4564197884345803,728271900,741191841.8,58.12263421767609,77.37765907236802,NaN,NaN,23.660474429690183,31.62707418616651
2017-06-23T09:30:00-04:00,53.4,53.6,53.1,53.21,8643119,11023810.85,46.80637417642293,62.118139824363276,NaN,NaN,-136.16733445350735,-32.768357469340685,-0.15100211159585808,0.26766714893975774,0.4186692605356158,719628781,733814903.8,52.206434606972294,74.44261414288121,NaN,NaN,19.037957545097616,29.828628951728096
2017-06-26T09:30:00-04:00,53.33,53.87,53.14,53.57,10355006,11159079,53.109642303349894,60.73320306723268,NaN,NaN,-81.89228529841755,-58.32090712911705,-0.1432862862512878,0.23956140272150606,0.38284768897279386,729983787,732073434.4,50.889541675163,71.3935735760749,NaN,NaN,16.935957880881872,27.986818798750065
2017-06-27T09:30:00-04:00,53.33,53.48,52.82,52.97,10478793,11368404.1,43.79503591884399,58.56077853737677,NaN,NaN,-176.6373709423949,-101.37550700689961,-0.17271980010281035,0.16694793884428094,0.3396677389470913,719504994,726718505.4,46.96638111295506,68.04940938311333,NaN,NaN,11.726303807512654,25.66388808571615
2017-06-28T09:30:00-04:00,53.13,53.25,52.41,52.46,9288817,11201810.4,37.7366361843861,56.715803933098826,NaN,NaN,-213.41687196489337,-138.6020423669897,-0.21775759352182633,0.06747074704480838,0.2852283405666347,710216177,721521127.8,43.46408157307522,64.62195795184239,NaN,NaN,5.022369134466522,22.71509966410906
2017-06-29T09:30:00-04:00,52.15,52.22,51.84,52.04,20595651,11675665.05,33.61279896830192,54.6528726785949,NaN,NaN,-270.0933011532802,-175.6414327624987,-0.26397498816910614,-0.044740394644747994,0.21923459352435815,689620526,713790853,38.82651701583005,61.39724154707119,NaN,NaN,-2.0273616352010646,19.180462335636186
2017-06-30T09:30:00-04:00,52.1,52.38,51.96,51.96,15112943,11933483.3,32.87584454988408,52.6938219608999,NaN,NaN,-211.04244259018293,-190.61645438983382,-0.28620928372285687,-0.13852701112921295,0.14768227259364392,674507583,704766613.4,34.23431045994691,58.400282117835054,NaN,NaN,-7.663691800429544,15.345583173341081
2017-07-03T09:30:00-04:00,52.04,52.18,51.65,51.72,12704710,12201218.1,30.70115811549266,50.44675478561134,NaN,NaN,-191.46697394212276,-212.53139211857487,-0.30180437624030865,-0.2295731977067419,0.07223117853356675,661802873,691130430.6,28.708773373192415,55.30939507258132,NaN,NaN,-12.981723369959248,11.298825095726748
2017-07-05T09:30:00-04:00,51.89,51.89,51.3344,51.47,14002597,12526286.4,28.580352983219427,47.77506999496658,NaN,NaN,-178.5933486278586,-212.92258765566757,-0.31237092781388165,-0.31823248123378534,-0.005861553419903673,647800276,676789487,24.271820104609446,52.095369498182706,NaN,NaN,-18.05552836119578,7.105346030452101
2017-07-06T09:30:00-04:00,51.26,51.51,51.255,51.45,14058002,12835120,28.411265578807715,44.838109131587316,NaN,NaN,-158.03485875414006,-201.84618501351693,-0.3038417520402798,-0.38566374347025345,-0.08182199142997364,633742274,661494706.4,20.612852815693174,48.543912428805946,NaN,NaN,-22.090186671628302,2.934555644440615
2017-07-07T09:30:00-04:00,51.44,51.74,51.39,51.49,13262983,12833636.75,29.312014915213226,42.285103272134975,NaN,NaN,-123.22319899335378,-172.47216458153164,-0.2792692811562082,-0.43090859287523386,-0.15163931171902567,647005257,652971652.6,18.90276584293842,44.81467034718856,NaN,NaN,-25.086096246488655,-1.0683946256921377
2017-07-10T09:30:00-04:00,51.64,51.755,51.41,51.45,16313813,12952417.75,28.920142780999996,39.99040821160507,NaN,NaN,-105.96736013472743,-151.45714809044054,-0.2503982151582913,-0.4646370806668898,-0.2142388655085985,630691444,644208424.8,17.312420493782298,40.94371411670722,NaN,NaN,-27.65695730743997,-4.866760723084685
2017-07-11T09:30:00-04:00,51.53,51.53,51.17,51.42,9055879,12764154.45,28.6111981156228,37.643211629795964,NaN,NaN,-103.2085745891822,-133.80546821985243,-0.21913745718654204,-0.48816068699177606,-0.269023229805234,621635565,636174963.2,15.984736063220808,36.95657217742723,NaN,NaN,-29.876117323460612,-8.439525951709816
2017-07-12T09:30:00-04:00,51.87,52.01,51.77,51.86,12142987,12925559.85,38.91770949437358,36.522305930582235,NaN,NaN,-61.07775876867424,-110.30235024801554,-0.15752386658428547,-0.46592806303559087,-0.3084041964513054,633778552,633370618.4,15.536804021855161,33.28857666977934,NaN,NaN,-28.93975282032238,-11.368129790083039
2017-07-13T09:30:00-04:00,51.83,51.965,51.64,51.68,6920975,12480003.45,36.59040442522187,35.57004132215287,NaN,NaN,-62.64636066652972,-91.22465063049349,-0.11932351756351023,-0.45755859340569316,-0.33823507584218293,626857577,631993679,15.309948945142452,30.230527721741225,NaN,NaN,-28.80654405316521,-13.859331827666207
2017-07-14T09:30:00-04:00,52.02,52.16,51.86,51.92,12607547,12332908.25,41.60467264157072,35.19849121252057,NaN,NaN,-41.90533963810073,-74.96107875944287,-0.07072527895828273,-0.4266416745400363,-0.3559163955817536,639465124,630485652.4,15.050755523614399,27.576550644358516,NaN,NaN,-27.1895363654852,-15.763646761640349
2017-07-17T09:30:00-04:00,51.95,52.16,51.84,52.16,7668995,11831569.9,46.18737293300519,34.704043400353086,NaN,NaN,-31.41547064690279,-60.05070086187794,-0.017996247357590645,-0.37841170477874186,-0.3604154574211512,647134119,633774187.4,18.299050681878498,25.248658430552478,NaN,NaN,-24.398268787389828,-16.997164193890274
2017-07-18T09:30:00-04:00,52.28,52.365,52.14,52.31,7890497,11334977.9,48.88721053527686,35.06777015866972,NaN,NaN,-7.675743593875351,-40.94413466281658,0.028855169643210776,-0.3243464953671378,-0.35320166501034855,655024616,640451997.6,24.603718073430898,23.651325356300756,NaN,NaN,-21.241708198961575,-17.603527623186174
2017-07-19T09:30:00-04:00,52.4,52.55,52.25,52.53,10669353,11489020.3,52.640216550603064,36.1323116133995,NaN,NaN,17.313339536665787,-25.26591500174857,0.07396805268245654,-0.2607415991572779,-0.33470965183973445,665693969,646835081,30.152138030251592,22.70047224609907,NaN,NaN,-17.385489655680264,-17.5723793421139
2017-07-20T09:30:00-04:00,52.67,52.92,52.54,52.91,8462529,11408318.05,58.33141845671214,37.89792729114309,NaN,NaN,64.32861500051027,0.12908013165943402,0.12566860249773704,-0.17762389871756312,-0.30329250121530016,674156498,656294865.2,37.493550421091456,22.60526034647489,NaN,NaN,-12.11631529030332,-16.792941620426674
2017-07-21T09:30:00-04:00,52.92,53.29,52.74,53.29,9265195,11475019.55,63.105994133010164,40.05722368993781,NaN,NaN,107.75383409421588,30.06091487812275,0.17850152180625745,-0.08016559895747832,-0.25866712076373577,683421693,665086179,43.442917154730914,23.26301796753089,NaN,NaN,-5.914422170152194,-15.238867413244606
2017-07-24T09:30:00-04:00,53.32,53.32,52.71,52.79,10534756,11569601.4,54.290948152726614,41.74220869259738,NaN,NaN,93.48810144565236,55.04162929663378,0.17270821420820245,-0.042781853003482695,-0.21549006721168515,672886937,670236742.6,46.646907246897165,24.54431324422409,NaN,NaN,-3.418901914231725,-13.550300913385623
2017-07-25T09:30:00-04:00,52.68,52.83,52.43,52.49,10568057,11580253.95,49.7963827980444,43.2576393936563,NaN,NaN,61.032744668300225,68.7833269490689,0.14284271392921474,-0.03693667480016671,-0.17977938872938146,662318880,671695595.4,47.55319190487621,26.20726837281457,NaN,NaN,-2.887718845785206,-12.02707490372842
2017-07-26T09:30:00-04:00,52.48,52.99,52.4,52.99,8631220,11487875.3,56.29114346027997,45.2490592423329,NaN,NaN,96.37015738468119,84.59469051867197,0.15018339212368975,0.007949851425230747,-0.142233540698459,670950100,672746821.6,48.2355401852559,28.180317470640485,NaN,NaN,-0.13318166342478477,-10.32794729797076
2017-07-27T09:30:00-04:00,52.84,53.12,52.775,53.12,9586920,11502780.45,57.81906948960448,47.28527742621799,NaN,NaN,120.46374473827964,95.82171646622585,0.1565045377588572,0.053397131500112494,-0.1031074062587447,680537020,674022926,49.10124319448039,30.337351567179194,NaN,NaN,2.537595781157707,-8.490012572380978
2017-07-28T09:30:00-04:00,53.04,53.19,52.79,53.04,9638979,10954946.85,56.50992101898312,49.25597587178821,NaN,NaN,104.5898709289671,95.18892383317609,0.14809688033720453,0.08201369416276094,-0.06608318617444357,670898041,671518195.6,47.42475014795265,32.48823225676279,NaN,NaN,4.2374475492757195,-6.671803983572879
2017-07-31T09:30:00-04:00,52.98,53.34,52.9,53.22,11861324,10792365.9,58.77184944974251,51.41030810993961,NaN,NaN,107.81425373148664,98.05415429034295,0.14715328764429914,0.11785842338093033,-0.02929486426336879,682759365,673492681.2,48.90576308758984,34.83973418707486,NaN,NaN,6.343353367603469,-4.812495790547686
2017-08-01T09:30:00-04:00,53.3,53.62,53.25,53.52,10823091,10698284.95,62.29195816325039,53.07989730057368,NaN,NaN,126.50715419227845,111.14903619513862,0.15826021835811604,0.16853040868427627,0.01027019032616023,693582456,679745396.4,53.38404523136811,37.54310855918293,NaN,NaN,9.252477473451576,-2.8032138956906487
2017-08-02T09:30:00-04:00,53.41,53.76,53.09,53.75,8015869,10398948.55,64.7751092370093,55.09309050141563,NaN,NaN,120.9320185964825,116.06140843749886,0.17150999650685333,0.2246576859597269,0.05314768945287357,701598325,685875041.4,57.332174828368586,40.544696122270516,NaN,NaN,12.468866263254466,-0.6214881586984897
2017-08-03T09:30:00-04:00,53.82,54.02,53.58,54.02,10464730,10219284.95,67.48224668196787,56.94148864715829,NaN,NaN,142.99008845399317,120.56667718064156,0.1875700952269234,0.2876103084865278,0.10004021325960441,712063055,692180248.4,60.99199129253802,43.82621296290792,NaN,NaN,16.049295241017454,1.7600523269752166
2017-08-04T09:30:00-04:00,53.74,53.9,53.49,53.78,17465441,10429407.85,62.857877242408215,58.132238954972784,NaN,NaN,116.03883778653426,122.856470552155,0.17157523278763673,0.3145092542441503,0.1429340214565136,694597614,696920163,63.52485421887332,47.056627501264686,NaN,NaN,17.637435260872873,4.028249888960596
2017-08-07T09:30:00-04:00,53.84,53.97,53.7,53.95,5161451,9871789.75,64.70299144822049,59.26193759161162,NaN,NaN,123.5632183908017,126.00626348401802,0.1621016063243969,0.3455610293620097,0.1834594230376128,699759065,700320103,65.26700431069129,49.96114794678325,NaN,NaN,19.515288469834218,6.240683971942542
2017-08-08T09:30:00-04:00,53.9,54.17,53.83,54.17,7568674,9797429.5,66.98848711595883,60.28681406056561,NaN,NaN,134.17529431920673,127.53989150940367,0.16003340822752404,0.3835011833220179,0.22346777509449384,707327739,703069159.6,66.65385981764493,52.56841378873992,NaN,NaN,21.79591571559051,8.462859935320823
2017-08-09T09:30:00-04:00,54.26,54.4,53.85,53.89,8852236,9632891.95,61.52795440978385,60.51513805721358,NaN,NaN,121.36030228938947,127.62554824798505,0.1304416271078686,0.3865198089793296,0.256078181871461,698475503,702444595.2,66.00899259165732,54.60523108663748,NaN,NaN,22.089323946586887,10.409497651215975
2017-08-10T09:30:00-04:00,53.81,54.16,53.69,54.06,9614750,9767580.7,63.474678757609986,60.54147267325643,NaN,NaN,101.53721682847161,119.33497392288075,0.1135704932984748,0.3980412984945545,0.2844708051960797,708090253,701650034.8,65.14548983273781,56.15541484935226,NaN,NaN,22.91451883721037,12.195929249215174
2017-08-11T09:30:00-04:00,53.94,54.0531,53.55,53.74,9336334,9604020.05,57.56944658899282,60.77565113298973,NaN,NaN,70.00485300641414,110.12817696685673,0.07402732209794155,0.3770049578185066,0.3029776357205651,698753919,702481295.8,65.65173466852187,57.512902522325454,NaN,NaN,21.81242664716015,13.569714591778743
2017-08-14T09:30:00-04:00,53.75,54.08,53.74,54.05,11827815,9811961.05,61.323339132115635,61.59900515685196,NaN,NaN,83.54176826573467,102.12388694184332,0.06238308043119878,0.3809564862595636,0.3185734058283648,710581734,704645829.6,66.99598469009437,58.901673435555324,NaN,NaN,22.022997193216433,14.777326391984127
2017-08-15T09:30:00-04:00,53.68,54.3899,53.65,54.35,9582262,9896549.3,64.58841137595425,62.1916671508287,NaN,NaN,98.12490610872919,94.91380929974783,0.06805539739625222,0.40364265257368004,0.3355872551774278,720163996,707213081,68.56723900811289,60.35393763718797,NaN,NaN,23.225802134312595,15.984251498031051
2017-08-16T09:30:00-04:00,54.26,54.6,54.26,54.57,7131761,9719669.7,66.8017369105601,62.83328625232553,NaN,NaN,134.48153937769237,97.53805671740841,0.07902352048358391,0.4343666557819077,0.3553431352983238,727295757,712977131.8,71.81203576865346,61.97613710677176,NaN,NaN,24.91795831133887,17.2604953285036
2017-08-17T09:30:00-04:00,54.45,54.63,54.1401,54.18,8956452,9744365.85,59.680448546168826,63.05975250426736,NaN,NaN,102.7116584967166,97.7729450510574,0.05362709959856837,0.42237700979653425,0.3687499101979659,718339305,715026942.2,72.88404957026633,63.794658494079876,NaN,NaN,24.10489578993404,18.238266822993662
2017-08-18T09:30:00-04:00,54,54.76,54,54.5,14848784,10023545.3,63.15149732779402,63.37258449555675,NaN,NaN,107.06217140808943,105.18440873139245,0.05195772370127277,0.43369706482455683,0.38173934112328406,733188089,721913776.2,76.16395596830921,65.74167227127411,NaN,NaN,24.528509191690336,19.136872875664615
2017-08-21T09:30:00-04:00,54.66,54.79,54.445,54.7,5655972,9779606.1,65.16970950630463,63.57813816291777,NaN,NaN,129.37635509687695,114.3513260976209,0.05747096955568182,0.45357805306788634,0.3961070835122045,738844061,727566241.6,78.46624271486908,67.5332578058099,NaN,NaN,25.51159294247114,20.04754717092269
2017-08-22T09:30:00-04:00,54.73,54.83,54.54,54.82,8150270,9658716.75,66.36022749317601,63.6913608955011,NaN,NaN,136.07960840503466,121.94226655688199,0.061960729045439256,0.4735579948190036,0.41159726577356437,746994331,732932308.6,80.40154955355692,69.18107028618049,NaN,NaN,26.67403409326552,20.99418815982881
2017-08-23T09:30:00-04:00,54.8,55.02,54.62,55,7046459,9579478.7,68.12044777154232,63.73694668761357,NaN,NaN,148.86121381314712,124.81820144397295,0.06926146529284061,0.49817409738961516,0.42891263209677455,754040790,738281315.2,82.12601006136133,70.69064305538215,NaN,NaN,28.174042874083383,22.019881690436605
2017-08-24T09:30:00-04:00,54.97,55.09,54.86,54.96,7017355,9451000.45,67.27796891326307,64.05266752124605,NaN,NaN,146.9535811245362,133.66658596953687,0.06374360372682364,0.5085921367553041,0.4448485330284805,747023435,744018141.2,83.7749360480449,72.13707747175155,NaN,NaN,29.155847312285744,23.03930535070077
2017-08-25T09:30:00-04:00,55.09,55.3369,54.955,55.14,7861816,9362142.3,69.12825905771504,64.36875806478137,NaN,NaN,152.10789980731016,142.67573164938102,0.06437515028298713,0.5253174708822144,0.46094232059922724,754885251,748357573.6,84.90901471687897,73.54007821505067,NaN,NaN,30.52332985872676,24.108451708990195
2017-08-28T09:30:00-04:00,55.33,55.33,54.98,55.24,7872678,9162710,70.13849643373469,64.5937587303368,NaN,NaN,138.91184055684167,144.58282874137396,0.06357578290757371,0.5404120492336943,0.47683626632612064,762757929,753140347.2,86.06510572167493,74.92659577962424,NaN,NaN,31.955148447245357,25.22940838588379
2017-08-29T09:30:00-04:00,55.33,55.42,55.11,55.12,7930279,9018069.4,67.29274800876084,65.0055297016923,NaN,NaN,127.55968215116275,142.8788434905996,0.0477366624507824,0.5365070943895986,0.48877043193881625,754827650,754707011,86.43177796613358,76.3853661635154,NaN,NaN,32.396444496885145,26.253270687455412
2017-08-30T09:30:00-04:00,55.09,55.14,54.88,54.96,5751081,8904830,63.588161497685746,65.01363561169771,NaN,NaN,85.69146593614064,130.24489391519828,0.02063972093570332,0.5145700831084454,0.4939303621727421,749076569,753714166.8,84.90699577330074,77.79690230212704,NaN,NaN,31.757898683843077,27.03964611551079
2017-08-31T09:30:00-04:00,55.01,55.115,54.93,54.97,10469469,8905066.95,63.72258416884028,65.45314543882968,NaN,NaN,78.64837277519149,116.58385224532935,-0.0012909775186769612,0.4923166402743959,0.4936076177930729,759546038,756218687.4,85.59724833270779,79.22158184956889,NaN,NaN,31.262120746943832,27.642856777144083
2017-09-01T09:30:00-04:00,55.05,55.14,54.64,54.8,11268708,8595230.3,59.6884197102805,65.33636548012716,NaN,NaN,50.73879405242652,96.31003109435261,-0.03031816854590824,0.4557099071106876,0.48602807565659584,748277330,754897103.2,83.429023055518,80.39537030424201,NaN,NaN,29.739705346150984,27.942406572716497
2017-09-05T09:30:00-04:00,54.9,54.98,54.63,54.94,9040406,8789178.05,61.83145639710998,65.13944012449544,NaN,NaN,43.860186633868416,77.29970030975797,-0.04241907329475586,0.433004234038151,0.4754233073329069,757317736,753809064.6,81.59649657054456,81.32603155870142,NaN,NaN,28.977050911103667,28.090212906771807
2017-09-06T09:30:00-04:00,55,55.09,54.59,54.69,11428672,8982177.95,56.09647503717817,64.374778562111,NaN,NaN,29.75339760412722,57.73844340035087,-0.0680687675385997,0.39033734790965724,0.45840611544825693,745889064,752021347.4,78.54379613569492,81.80687158491867,NaN,NaN,26.67754612835965,27.88840336699864
2017-09-07T09:30:00-04:00,54.74,55.16,54.685,55.1,12351732,9157152.75,62.27616763686035,64.56018706858897,NaN,NaN,58.254153674448105,52.250980948012355,-0.05859118058808238,0.38516713971315397,0.44375832030123635,758240796,753854192.8,79.39493112723696,82.27193455327371,NaN,NaN,26.38299104186754,27.673344463408483
2017-09-08T09:30:00-04:00,55.02,55.4,54.92,55.36,9019928,9127411.65,65.58440692020343,64.73396632518964,NaN,NaN,98.71632496899085,56.26457138677222,-0.03703243350270308,0.3974677784228575,0.4345002119255606,767260724,755397130,80.11022185736935,82.55381068820658,NaN,NaN,27.14473013050816,27.59782813013701
2017-09-11T09:30:00-04:00,55.26,55.9,55.25,55.83,10091614,9165175.65,70.60311183898858,65.12206649180993,NaN,NaN,179.72553610584123,82.06191979745516,0.004454519366452525,0.44006836113362624,0.4356138417671737,777352338,761212131.6,82.56650912512367,82.84668686036763,NaN,NaN,29.4978615152018,27.86926147086055
2017-09-12T09:30:00-04:00,55.79,55.79,54.6,54.9,18895311,9518550.45,53.86481251276835,64.22953685035223,NaN,NaN,53.98467933703929,84.08681833808933,-0.03309761117139548,0.3942418278029294,0.42733943897432486,758457027,761439989.8,82.65688982671139,83.00778259416438,NaN,NaN,25.347350122995067,27.50898842116548
2017-09-13T09:30:00-04:00,54.85,54.89,54.585,54.63,10729070,9575890.85,50.14771356127928,62.94577012104774,NaN,NaN,-57.052517716252645,66.72563527401336,-0.07602626894202696,0.33230660279679114,0.4083328717388181,747727957,761807768.4,82.8117817192454,83.05676628401322,NaN,NaN,20.726291134157776,26.540031665878665
2017-09-14T09:30:00-04:00,54.6,55.115,54.44,55.09,10195378,9729071.7,55.75029411141742,62.12236477805876,NaN,NaN,-13.917073023004606,52.29138993452282,-0.07331426481259518,0.31669004072307416,0.39000430553566934,757923335,761744276.2,82.67450657191166,82.97816417857514,NaN,NaN,18.994788229745787,25.46213974643111
2017-09-15T09:30:00-04:00,54.83,54.91,54.5,54.75,8515142,9707006.2,51.172604735429694,60.83981804075267,NaN,NaN,-75.94684182304455,17.358756576115738,-0.09302477876327114,0.2737233320815804,0.36674811084485154,749408193,758173770,75.13195041543463,82.2798024427577,NaN,NaN,15.94368587958766,24.10236062259633
2017-09-18T09:30:00-04:00,54.71,54.75,53.83,54.19,15803499,9754741.95,44.66710379308631,59.020432852134924,NaN,NaN,-218.77274049872477,-62.34089874479746,-0.13958389869093157,0.19226823748118704,0.3318521361721186,733604694,749424241.2,60.55311084235952,80.45751709423516,NaN,NaN,10.95776096887424,22.2245606720646
2017-09-19T09:30:00-04:00,54.28,54.315,53.995,54.08,15779995,10260943.1,43.49734764174841,57.32076139734833,NaN,NaN,-223.45227659833475,-117.82828993187226,-0.17149441004113591,0.11748412362069871,0.2889785336618346,717824699,741297775.6,50.71073550095045,77.9060140610078,NaN,NaN,6.750806050781575,20.014024297595597
2017-09-20T09:30:00-04:00,54.17,54.287,53.47,53.68,19747006,10840779.9,39.45138568132836,55.596705981894225,NaN,NaN,-249.28056081624084,-156.2738985518699,-0.2106669076479887,0.02564489910184875,0.23631180674983746,698077693,731367722.8,41.7752685347782,74.82517640111334,NaN,NaN,1.857770699516713,17.420273783584328
2017-09-21T09:30:00-04:00,53.73,54.02,53.6,53.67,10712328,11024073.35,39.35283497617367,53.856009610989474,NaN,NaN,-199.14621648013608,-193.3197272432962,-0.22696854911347242,-0.04739887964200307,0.17956966947146935,687365365,717256128.8,32.90255972397003,71.06127007191778,NaN,NaN,-1.9327592230560138,14.655554782635708
2017-09-22T09:30:00-04:00,53.82,53.89,53.23,53.23,11241874,11235299.3,35.18772885698061,52.1059602643252,NaN,NaN,-198.5238740774382,-217.8351336941749,-0.25500491025600247,-0.13918646834853377,0.11581844190746872,676123491,702599188.4,26.58645474623127,67.00108662125443,NaN,NaN,-6.571607642285274,11.623103007646996
2017-09-25T09:30:00-04:00,53.31,53.775,53.22,53.72,11723269,11428371.95,42.4879643994418,50.72428226449176,NaN,NaN,-145.91451888881386,-203.26348937219274,-0.2289950188507283,-0.17042533165594165,0.05856968719478665,687846760,693447601.6,23.547016609451234,62.85469519546205,NaN,NaN,-8.107325182605814,8.804470409039453
2017-09-26T09:30:00-04:00,53.7,53.8075,53.52,53.62,10011103,11535293.2,41.46157067892648,49.67893195318806,NaN,NaN,-114.32916150878135,-181.43886635428208,-0.20760396056870428,-0.2009352635160937,0.00666869705261057,677835657,685449793.2,21.259590612332858,58.762966229507605,NaN,NaN,-9.645179428838679,6.168806146485434
2017-09-27T09:30:00-04:00,53.25,53.46,52.64,52.9,12350842,11756321.35,34.920539918277015,47.72495854471783,NaN,NaN,-159.95295687956897,-163.5733455669477,-0.2293230321757107,-0.2799850931670278,-0.05066206099131711,665484815,678931217.6,19.58928428697186,54.49113431234581,NaN,NaN,-13.273351643818017,3.3913550335849405
2017-09-28T09:30:00-04:00,52.71,53.225,52.57,53.09,14182498,12177892.2,37.713102585114115,45.73415109221145,NaN,NaN,-139.54022788978713,-151.65214784887792,-0.21832740074076806,-0.32357131191727717,-0.10524391117650912,679667313,677391607.2,19.205480532116326,50.1407956462563,NaN,NaN,-15.245337082321534,0.7289704455983017
2017-09-29T09:30:00-04:00,53.11,53.265,52.86,53.05,12127097,12260773.6,37.34974212411162,43.35891039829166,NaN,NaN,-114.55683996332442,-134.85874102605516,-0.20158368676617824,-0.35722351963423193,-0.1556398328680537,667540216,675674952.2,18.764038347642753,45.58347630500767,NaN,NaN,-16.909016789970455,-1.7907420166258063
2017-10-02T09:30:00-04:00,53.02,53.385,52.96,53.14,16614279,12528052.15,38.77900782124253,42.28135292032554,NaN,NaN,-93.51711337540578,-124.37925992337355,-0.17335917287419475,-0.37233879896079713,-0.19897962608660238,684154495,674936499.2,18.56634160626234,41.00558000354703,NaN,NaN,-17.84036587423712,-4.083545424855993
2017-10-03T09:30:00-04:00,53.17,53.18,52.66,52.99,9557477,12553905.7,37.25358036535681,41.36034340633107,NaN,NaN,-101.50189994951324,-121.81380761151993,-0.15433941036536838,-0.39190388904331286,-0.23756447867794447,674597018,674288771.4,18.38338293639103,36.40355151905743,NaN,NaN,-19.055555473938103,-6.222404003296294
2017-10-04T09:30:00-04:00,53.02,53.54,52.86,53.52,12140499,12589497.05,45.42271554573515,40.622659223068055,NaN,NaN,-63.06769456372204,-102.43675514835054,-0.09833827294533093,-0.36048731985960814,-0.2621490469142772,686737517,678539311.8,23.697163716556062,32.19088417224632,NaN,NaN,-17.64689513029243,-7.854474164295742
2017-10-05T09:30:00-04:00,53.5,53.575,53.23,53.47,12639232,12603872.05,44.82974621517014,40.16959790019238,NaN,NaN,-47.82392196648126,-84.09349396368935,-0.05888371053869479,-0.3357536850876457,-0.2768699745489509,674098285,677425506.2,23.26963571904099,28.48643312250391,NaN,NaN,-16.679492018307137,-9.115191000583085
2017-10-06T09:30:00-04:00,53.22,53.45,53.02,53.43,10418156,12673783.45,44.33115700762143,40.145601701230596,NaN,NaN,-55.22197070816051,-72.22652011265659,-0.03109610962151843,-0.3157401115758489,-0.2846440019543305,663680129,676653488.8,22.96042784617933,25.801241479919604,NaN,NaN,-16.02324726271867,-10.102056180888168
2017-10-09T09:30:00-04:00,53.53,53.63,53.43,53.5,7340653,12536235.4,45.474042258078725,40.28679417382562,NaN,NaN,-26.22318762981132,-58.76773496353769,-0.004986988752383792,-0.2908777378948102,-0.2858907491424264,671020782,674026746.2,21.894398666774165,23.742931706049866,NaN,NaN,-15.162412137349074,-10.824964174668297
2017-10-10T09:30:00-04:00,53.63,54.03,53.46,54.02,8326790,12007809.35,53.166072744642456,41.26641467834805,NaN,NaN,23.176774521419063,-33.83200006935123,0.04743072515505692,-0.22660234269860524,-0.27403306785366216,679347572,674976857,23.281884203221125,22.421975682367215,NaN,NaN,-12.073332140021913,-11.003302455433099
2017-10-11T09:30:00-04:00,53.96,54.515,53.95,54.25,15469103,12244811,56.11499308522588,42.4637116861375,NaN,NaN,88.35213352132148,-3.5480344523425287,0.09497510559355982,-0.15531418586171242,-0.25028929145527223,694816675,676592688.6,25.69926959337515,21.907454958753288,NaN,NaN,-8.553692208416782,-10.653358134430768
2017-10-12T09:30:00-04:00,54.31,54.67,54.22,54.53,13668313,12418457.75,59.46145224538525,44.197549071023545,NaN,NaN,133.41127539945495,32.699005020844716,0.13994703575369655,-0.07535549676315156,-0.2153025325168481,708484988,683470029.2,35.07620609395498,22.51386576930499,NaN,NaN,-4.499431619709165,-9.774225775184824
2017-10-13T09:30:00-04:00,54.68,54.77,53.99,54.15,12712686,12628334.95,53.49899558523716,44.984051298580354,NaN,NaN,116.1524930442131,66.97389777131943,0.13851047530188532,-0.042164438389491465,-0.18067491369137678,695772302,689888463.8,42.38426842911441,23.859383756423785,NaN,NaN,-2.738402313401644,-8.769108137787228
2017-10-16T09:30:00-04:00,54.13,54.25,53.59,54.03,11246364,12400478.2,51.73476818202398,45.71785112023017,NaN,NaN,63.36295189360328,84.89112567600235,0.12433817809065903,-0.025252191078052988,-0.14959036916871202,684525938,692589495,45.18077845412298,25.568040030837363,NaN,NaN,-1.8104863725165243,-7.775019314177127
2017-10-17T09:30:00-04:00,54,54.46,53.845,54.35,9599609,12091458.9,55.91019194813686,47.21711197950588,NaN,NaN,106.83697255328708,101.62316528237595,0.13072268327015207,0.013812984918978088,-0.11690969835117399,694125547,695545090,48.14664862716655,27.607851769422695,NaN,NaN,0.26220291341970986,-6.626844710234722
2017-10-18T09:30:00-04:00,54.12,54.355,54.04,54.25,8691008,11538659,54.32847636645032,48.403924392458464,NaN,NaN,97.23988483410112,103.40071554493188,0.12255574538422853,0.03628498337911168,-0.08627076200511685,685434539,693668662.8,46.429206873232545,29.552403650930994,NaN,NaN,1.509434226116196,-5.464519147898876
2017-10-19T09:30:00-04:00,54.35,54.82,54.29,54.82,10285925,11517338.85,61.08620218058469,50.09938582506368,NaN,NaN,142.52443863722635,105.22334819248617,0.14817487469603297,0.09894783136492435,-0.04922704333110861,695720464,691115758,44.123149827815695,31.363768756657635,NaN,NaN,4.805088905234319,-3.997432283165563
2017-10-20T09:30:00-04:00,54.6,54.97,54.58,54.86,11231373,11516813.8,61.516529693967826,51.72349453025834,NaN,NaN,139.7206887112693,109.93698732589742,0.15946637695486246,0.15010592786246946,-0.009360449092392996,706951837,693351665,46.623675102576385,33.36786400639435,NaN,NaN,7.570973548264076,-2.3448028786756145
2017-10-23T09:30:00-04:00,54.85,55,54.655,54.89,10611019,11461201.3,61.85721534206671,53.48089702859476,NaN,NaN,125.4986496196533,122.36412687110742,0.16018404817443355,0.19086961112564893,0.03068556295121539,717562856,699959048.6,53.277694541966135,35.860314835364,NaN,NaN,9.918736065586241,-0.5928687437810636
2017-10-24T09:30:00-04:00,54.8,55,54.665,54.94,11335695,11527430.9,62.453809400431744,54.69740373250166,NaN,NaN,112.18028480574259,123.4327893215985,0.155147886865175,0.22462042153268413,0.06947253466750913,728898551,706913649.4,59.06244543555318,38.386406386720935,NaN,NaN,12.034021090277259,1.2109726610844107
2017-10-25T09:30:00-04:00,54.71,54.81,54.05,54.7,18331253,11826451.45,57.782000972931996,55.62256478662751,NaN,NaN,67.14184770494217,117.41318189576673,0.12790860277032898,0.22935828813042036,0.10144968536009139,710567298,711940201.2,62.66083092097573,41.20006318685913,NaN,NaN,12.603106560919047,2.838420361060787
2017-10-26T09:30:00-04:00,54.96,55.245,54.69,54.71,17329571,11983805.1,57.92323582125278,56.59342755902974,NaN,NaN,99.60659904632206,108.82961397758586,0.10384364611793132,0.23125424300750552,0.1274105968895742,727896869,718375482.2,66.6968494141193,44.32409329885487,NaN,NaN,13.111492473252914,4.306002091373948
2017-10-27T09:30:00-04:00,54.65,55.18,54.55,55.05,10366116,11895756.05,62.51486589414354,57.810629247320094,NaN,NaN,97.73176736488622,100.43182970830924,0.10385296958760454,0.2572268088740799,0.15337383928647536,738262985,724637711.8,70.08542719103029,47.766309622016024,NaN,NaN,14.866856763884458,5.814695616018306
2017-10-30T09:30:00-04:00,55.03,55.17,54.88,55.06,10057424,11567913.3,62.64398510523871,58.48762298736268,NaN,NaN,105.4766517754631,96.4274301394712,0.0976545657049867,0.27544204641770875,0.17778748071272205,748320409,730789222.4,72.99248843535057,51.317067067168125,NaN,NaN,16.350259235533677,7.31977613309193
2017-10-31T09:30:00-04:00,55.02,55.23,54.88,55.12,9532028,11566640.85,63.45731765181134,59.01207474211878,NaN,NaN,103.39880444063625,94.67113406644994,0.09085851783766646,0.2913606280098051,0.20050211017213865,757852437,736579999.6,75.41457092838554,54.86816001966887,NaN,NaN,17.82356098135611,8.820316825701099
2017-11-01T09:30:00-04:00,55.21,55.21,54.7147,54.81,10879168,11503574.3,56.60049428230305,58.807720601898616,NaN,NaN,74.30854964975552,96.10447445541261,0.06022451780469251,0.2757827574280043,0.21555823962331178,746973269,743861193.8,78.07687284432741,57.93963621612404,NaN,NaN,17.273310451315186,10.027887343645968
2017-11-02T09:30:00-04:00,54.81,55.24,54.67,55.01,14726947,11607960.05,59.63117603792998,59.245733491376676,NaN,NaN,78.0125912547189,91.78567289709198,0.04866498076293713,0.2763894655769832,0.22772448481404606,761700216,750621863.2,80.21879651897459,60.64210250825691,NaN,NaN,17.637550081487106,11.114982020480417
2017-11-03T09:30:00-04:00,54.94,55.48,54.82,55.21,11632235,11668664,62.45472621678315,60.011444779573765,NaN,NaN,103.49329804768641,92.93797903365203,0.04955600028820939,0.2896694851743078,0.2401134848860984,773332451,757635756.4,82.16556770840643,63.283873169277165,NaN,NaN,18.75708743965894,12.206711366077348
2017-11-06T09:30:00-05:00,55.28,55.31,54.97,55,11996476,11901455.15,57.877199342580425,60.151945307748306,NaN,NaN,85.8991855402989,89.02248578661917,0.03192588843242844,0.28002084542663397,0.24809495699420553,761335975,760238869.6,82.8405376986475,65.76200810295437,NaN,NaN,18.405883301903106,13.092307356909599
2017-11-07T09:30:00-05:00,55.09,55.74,54.89,55.66,11324509,12051341.1,66.24965930173666,61.00345837455448,NaN,NaN,142.96437326715358,96.93559955192265,0.059059891800492315,0.3219198217448209,0.2628599299443286,772660484,763200479,83.600973660579,68.41713430205054,NaN,NaN,20.814211732511342,14.195436553424134
2017-11-08T09:30:00-05:00,55.63,55.845,55.31,55.7,9584911,11757131.5,66.68189130552838,61.403150454907596,NaN,NaN,167.7306819807116,115.62002601811386,0.0731272050655134,0.35426893627622036,0.28114173121070696,782245395,770254904.2,85.27489798641423,71.35654488480759,NaN,NaN,22.850730204615413,15.431907075022888
2017-11-09T09:30:00-05:00,55.54,55.87,55.41,55.77,10762608,11611846.25,67.46709853381017,61.828191086324914,NaN,NaN,163.43175192224223,132.70385815161853,0.08001499653339794,0.38116047687745436,0.3011454803440564,793008003,776516461.6,86.58392511647804,74.21084845722915,NaN,NaN,24.741561027074887,16.761857639601747
2017-11-10T09:30:00-05:00,55.47,55.635,55.32,55.51,11036800,11528051.95,61.655008888180134,61.81374776819016,NaN,NaN,114.66326132166606,134.93785080641447,0.06079953399669591,0.37714489783992633,0.3163453638432304,781971203,778244212,86.92920839388627,76.61452801808058,NaN,NaN,24.620773900713022,17.884559962617644
2017-11-13T09:30:00-05:00,55.57,56.22,55.57,56.17,9822834,11456875.45,68.9640524595442,62.27876512955533,NaN,NaN,189.25378713558123,155.60877112547095,0.08480404012800224,0.42235041400323325,0.337546373875231,791794037,784335824.4,88.09278800017395,78.6881239155535,NaN,NaN,26.98108437641544,19.184063450303043
2017-11-14T09:30:00-05:00,56.01,56.91,55.99,56.87,12373761,11595583.05,74.51298737932036,63.473835587154504,NaN,NaN,242.02259675553765,175.42041582314778,0.13699905042467708,0.5087951869060774,0.3717961364814003,804167798,790637287.2,89.167105211879,80.58142922204658,NaN,NaN,31.17141601046522,20.89654238746907
2017-11-15T09:30:00-05:00,57.09,57.23,56.32,56.38,12065239,11764294.6,65.66290275974481,64.02666893990393,NaN,NaN,199.56172058501127,181.7866235440077,0.12787190541246207,0.5316360182469779,0.40376411283451585,792102559,792608720,89.48669078795389,82.20927503446333,NaN,NaN,31.30501848559789,22.383467544344615
2017-11-16T09:30:00-05:00,56.24,56.37,56.03,56.2,11441094,11822053.05,62.716070628119674,64.04104070661651,NaN,NaN,116.39649341569374,172.379571842698,0.10027971132885216,0.5291137519955811,0.4288340406667289,780661465,790139412.4,86.06191951759145,83.35045305778912,NaN,NaN,30.35665751009856,23.522494682309464
2017-11-17T09:30:00-05:00,56.08,56.2201,55.76,55.81,16650353,12093002.05,56.77122762540119,63.621558029485264,NaN,NaN,71.1301132189153,163.67294222214784,0.04893014347421165,0.48999672000949346,0.4410665765352818,764011112,786547394.2,81.19398212621283,83.93627403570788,NaN,NaN,27.458259857754864,24.084746850230236
2017-11-20T09:30:00-05:00,55.84,55.9056,55.55,55.64,9291900,12027046.1,54.35269670846424,62.971227962103335,NaN,NaN,35.58898876016834,132.93998254706528,-0.0006898924598636169,0.44020421096045226,0.4408941034203159,754719212,779132429.2,72.12469399749536,83.70128282635858,NaN,NaN,24.352485811604318,24.122995273283674
2017-11-21T09:30:00-05:00,55.8,55.945,55.64,55.79,7755956,11848059.15,56.12864936411343,62.937524753661215,NaN,NaN,42.892719642040745,93.11400712436588,-0.02620150218972117,0.4081422256831644,0.43434372787288555,762475168,770793903.2,63.53065088869112,82.66226697238456,NaN,NaN,22.43762444637087,23.88222801229613
2017-11-22T09:30:00-05:00,55.75,55.895,55.575,55.79,5578891,11210441.05,56.12864936411343,62.687344276960026,NaN,NaN,31.31020545636825,59.463704098637265,-0.04477798774377095,0.37837124319317184,0.4231492309369428,762475168,764868425,58.22160455903872,81.09103897524628,NaN,NaN,20.931725308430472,23.46072762602961
2017-11-24T09:30:00-05:00,55.82,56.1,55.79,55.88,5002244,10594074.7,57.285071922056034,62.3180832559081,NaN,NaN,51.188790978266574,46.422163611151845,-0.05218821391585482,0.35791396354212424,0.41010217745797906,767477412,762231614.4,55.97976516066942,79.22062450755077,NaN,NaN,20.026201368745173,22.97008101784612
2017-11-27T09:30:00-05:00,55.95,56.215,55.81,56.12,7196750,10435606.4,60.2909956927612,62.49049728092101,NaN,NaN,64.8187554152833,45.15989205042544,-0.04251959166421093,0.3569526878777154,0.3994722795419263,774674162,764364224.4,57.408209789834615,77.40402965692128,NaN,NaN,20.118286808789428,22.562681845123734
2017-11-28T09:30:00-05:00,56.26,56.49,56.14,56.38,9185561,10392013.25,63.30376950699057,62.280076581296285,NaN,NaN,102.45356316703796,58.53280693179936,-0.021279859221335684,0.3728724555152567,0.3941523147365924,783859723,770192326.6,61.121203933378396,75.7983318192641,NaN,NaN,21.088068147843984,22.35202274551234
2017-11-29T09:30:00-05:00,56.19,56.65,55.99,56.41,15569361,10693879.9,63.646502818187734,62.06326311791481,NaN,NaN,95.07069120598362,68.96840124458794,-0.00853056252632739,0.38348911157868315,0.39201967410501054,799429084,777583109.8,65.25746430747317,74.36851512791115,NaN,NaN,21.97621510584397,22.29833593984543
2017-11-30T09:30:00-05:00,56.48,56.72,56.365,56.6,15891462,10944494.6,65.82360183693308,61.945870496709304,NaN,NaN,118.28374171412803,86.3631084961399,0.00845902341740501,0.4025934533767668,0.39413442995936177,815320546,788152185.4,70.14841884252525,73.19455039405739,NaN,NaN,23.359472397097463,22.449926862310004
2017-12-01T09:30:00-05:00,56.79,56.9,56.1,56.41,24075907,11411942.6,61.83560087233681,61.95876992414907,NaN,NaN,94.72960711145464,95.07127172277751,0.0029457262688906694,0.39781658779547513,0.39487086152658446,791244639,792905630.8,72.05391993103444,72.13202978956797,NaN,NaN,23.429517931672404,22.58986844364749
2017-12-04T09:30:00-05:00,56.44,56.66,55.995,56.09,13055758,11483118.75,55.71331413554751,61.012288615292164,NaN,NaN,48.52629216810195,91.81277907334125,-0.024685936104066386,0.3640134413965015,0.3886993775005679,778188881,793608574.6,72.33515333760283,71.00648445652718,NaN,NaN,21.690016463862268,22.46131816082103
2017-12-05T09:30:00-05:00,56.18,56.18,55.11,55.38,19875778,11877083.85,45.054551215236415,58.90811460357187,NaN,NaN,-92.41369191956906,52.83932805601982,-0.08956508854205603,0.27674301682299784,0.36630810536505387,758313103,788499250.6,67.0532171458998,69.42692102324294,NaN,NaN,16.450698242891974,21.60265817254545
2017-12-06T09:30:00-05:00,55.47,55.695,55.29,55.59,9444803,11783098.55,48.21053568389906,57.66151695529718,NaN,NaN,-101.05489505216474,13.614210804390158,-0.11547278610431438,0.2219671227346609,0.3374399088389753,767757906,782165015,61.0968930301059,67.3990783262538,NaN,NaN,13.184477009482931,20.400060863536517
2017-12-07T09:30:00-05:00,55.49,55.7,55.25,55.69,11475237,11877614.85,49.692379052304936,56.731253271310415,NaN,NaN,-94.96441743497363,-29.035421025430175,-0.12235256361902447,0.18449920431519473,0.3068517679342192,779233143,774947534.4,55.09177480806716,65.18692513271635,NaN,NaN,11.01359369753308,19.059136982678883
2017-12-08T09:30:00-05:00,55.62,55.875,55.4,55.87,9975325,11838250.7,52.336054050648514,56.41445515882808,NaN,NaN,-61.532908775996646,-60.28792420292043,-0.11156108082710137,0.16740041690034246,0.27896149772744383,789208468,774540300.2,54.76470048251145,63.299119301023396,NaN,NaN,10.005910870676157,17.765818966678495
2017-12-11T09:30:00-05:00,55.82,56.24,55.6595,56.21,15435445,12058182.95,56.939130369155855,56.599200420306055,NaN,NaN,-1.993966896947001,-70.39197601593023,-0.07979420530369896,0.1792187410978201,0.25901294640151906,804643913,779831306.6,58.23414387425641,62.30693714936348,NaN,NaN,10.564376209661784,16.73704142996182
2017-12-12T09:30:00-05:00,56,56.07,55.22,55.25,21550519,12644567.2,44.01420501611794,55.7338829668778,NaN,NaN,-103.82604021001511,-72.67444567401944,-0.11932672791267002,0.10985453651068156,0.22918126442335157,783093394,784787364.8,61.23345954050477,62.14285205306446,NaN,NaN,6.4415859090409535,15.266262069830269
2017-12-13T09:30:00-05:00,55.4,55.71,55.24,55.4,17385098,12895134.05,46.073982339810954,55.01569246514191,NaN,NaN,-106.92237890458476,-73.84794244450345,-0.1303663952247336,0.06622327039243459,0.19658966561716817,800478492,791331482,64.82540135362,62.61455182410598,NaN,NaN,3.939624240902427,13.648170951412006
2017-12-14T09:30:00-05:00,55.35,55.58,54.9,55.33,13143563,12949050.25,45.23754593886054,54.155154894913665,NaN,NaN,-132.8637601216516,-81.42781098183903,-0.13671132988711196,0.025700503258278218,0.16241183314539018,787334929,792951839.2,65.67349957834848,63.306961425368776,NaN,NaN,1.7140017282746252,11.943289633820951
2017-12-15T09:30:00-05:00,55,55.22,54.84,55.02,13637635,13058877.3,41.63290335724717,52.82243401380553,NaN,NaN,-160.58203363249265,-101.23763595313824,-0.15478573165880688,-0.031070331428118436,0.12371540023068844,773697294,789849604.4,62.563320610614504,63.67518362685304,NaN,NaN,-1.3195279740138077,10.048601404130272
2017-12-18T09:30:00-05:00,55.07,55.225,54.33,54.41,19403521,13196535.7,35.61851100189503,50.84491554915585,NaN,NaN,-196.18436159007285,-140.07571489176343,-0.19805695732259357,-0.12385579642255351,0.07420116090004006,754293773,779779576.4,53.6769618351315,63.14345204840684,NaN,NaN,-6.085453071739332,7.743736479006043
2017-12-19T09:30:00-05:00,54.41,54.48,53.39,53.42,14887519,13476316.65,28.438147860816102,48.33003305220073,NaN,NaN,-266.51881278206366,-172.61426940617312,-0.27865201528891365,-0.274113858211102,0.004538157077811647,739406254,771042148.4,47.38760255365622,61.86703335170563,NaN,NaN,-13.217277689570691,4.749305883495081
2017-12-20T09:30:00-05:00,53.38,53.57,52.97,53,15756030,13876320.35,26.03982579945381,45.488334763809355,NaN,NaN,-263.4440622367844,-203.91860607261304,-0.3414048294596351,-0.4222178797467322,-0.08081305028709712,723650224,755676494.8,38.78168364882757,59.626552266441514,NaN,NaN,-19.767999892819198,1.2468336297358986
2017-12-21T09:30:00-05:00,52.63,52.64,52.16,52.37,19934865,14594119.05,22.917682481114213,42.708483450150595,NaN,NaN,-249.49644852714437,-227.2451437537116,-0.40230844340430927,-0.5836986045424837,-0.1813901611381744,703715359,738952580.8,31.975270466306696,56.76379159038952,NaN,NaN,-26.355824634709112,-2.6964032651848173
2017-12-22T09:30:00-05:00,52.43,52.65,52.4,52.45,11472095,14917611.6,24.161167394489624,40.45475868293217,NaN,NaN,-185.5244139024504,-232.23361980770315,-0.4126328627591483,-0.6971812395871098,-0.28454837682796147,715187454,727250612.8,28.240456101878465,53.614170359266346,NaN,NaN,-30.885501450061337,-6.723417291595749
2017-12-26T09:30:00-05:00,52.51,52.67,52.13,52.14,8243715,14969959.85,22.637235573343176,38.85352185136837,NaN,NaN,-159.41623592007892,-224.87999467370437,-0.41466241483164645,-0.8028763953675195,-0.3882139805358731,706943739,717780606,25.631292188361144,50.655461433727886,NaN,NaN,-35.05508376217284,-10.770798215963904
2017-12-27T09:30:00-05:00,52.33,52.46,52.22,52.36,10616415,15041502.55,26.195014770430063,37.28098464326344,NaN,NaN,-130.93278068939537,-197.7627882551707,-0.37661805097219503,-0.8589865442511169,-0.48236849327892184,717560154,713411386,24.506309408658268,48.041848317910194,NaN,NaN,-37.25324163777187,-14.554004419079327
2017-12-28T09:30:00-05:00,52.46,52.67,52.37,52.65,4910764,14508572.7,30.718022079073307,35.92567343088975,NaN,NaN,-103.17201495104979,-165.70837879802374,-0.3101248561988008,-0.8700245635274229,-0.559899707328622,722470918,713175524.8,24.44393824807888,45.85271713505389,NaN,NaN,-37.62304524680786,-17.8495816801834
2017-12-29T09:30:00-05:00,52.81,52.91,52.57,52.68,7030124,14065505.8,31.187824037947678,34.41508557283969,NaN,NaN,-83.43442234504319,-132.49597356160353,-0.24517192381232178,-0.8663646120940243,-0.6211926882817025,729501042,718332661.4,28.715974638095133,43.99209386045273,NaN,NaN,-37.77534378612309,-20.69611912388907
2018-01-02T09:30:00-05:00,52.67,52.74,52.03,52.19,12270014,13475211.15,27.86427697763982,32.33831033058854,NaN,NaN,-91.10410806112927,-113.6119123933393,-0.21721572687307567,-0.8927123468730471,-0.6754966199999715,717231028,718741376.2,29.058319265540533,41.9081063884016,NaN,NaN,-38.92318411647666,-23.299985551401583
2018-01-03T09:30:00-05:00,52,52.38,51.6,51.78,20807877,13862817.1,25.423005337332626,31.010367496389595,NaN,NaN,-98.80767847986797,-101.49020090529712,-0.20831338532009114,-0.9358883516500853,-0.7275749663299942,696423151,716637258.6,28.304679390691703,39.55605066341495,NaN,NaN,-40.664966121956695,-25.780697061480886
2018-01-04T09:30:00-05:00,51.62,51.96,51.25,51.35,14971830,13617619.7,23.133800783508008,29.371783099510814,NaN,NaN,-106.08498353412787,-96.5206414742436,-0.21262187157706358,-0.9933523058013236,-0.78073043422426,681451321,709415492,25.828663463323508,36.770569385536625,NaN,NaN,-42.87684144574666,-28.22300340209028
2018-01-05T09:30:00-05:00,51.53,51.61,51.07,51.33,23416313,14316195.2,23.029929250862097,27.785524764653783,NaN,NaN,-103.99067397569895,-96.68437327917344,-0.19833494038047683,-1.028649109699856,-0.8303141693193792,658035008,696528310,22.11149313808842,33.65899749694662,NaN,NaN,-44.66129855414051,-30.5713312809546
2018-01-08T09:30:00-05:00,51.42,51.85,51.315,51.81,14300509,14457458.8,31.033497879922905,27.028424373416335,NaN,NaN,-82.52084133262345,-96.5016570766895,-0.14078082896147082,-1.0062902055212177,-0.8655093765597469,672335517,685095205,19.43868208656245,30.57866617380005,NaN,NaN,-43.757754280351726,-32.45510599515419
2018-01-09T09:30:00-05:00,51.8,51.82,51.22,51.3,15438688,14730626.95,27.733727949166806,26.46522558393575,NaN,NaN,-87.45151421823024,-95.77113830810968,-0.12198338802111508,-1.0179886115861407,-0.8960052235650257,656896829,673028365.2,17.090560731772115,27.96535180927438,NaN,NaN,-44.00059294003369,-34.10446127299412
2018-01-10T09:30:00-05:00,51,51.08,50.63,50.74,15562040,14736956.7,24.636111594294817,26.193651564898513,NaN,NaN,-114.7501771393261,-98.95963804000131,-0.13137612858557834,-1.0602253842969986,-0.9288492557114203,641334789,662010692.8,15.276101376827867,25.671673153786635,NaN,NaN,-45.216072678465544,-35.69183433091861
2018-01-11T09:30:00-05:00,50.685,50.92,50.38,50.55,16545506,14486706.05,23.670126951446363,26.02438736146941,NaN,NaN,-123.11893383989975,-102.3664281011557,-0.13403357741728938,-1.096391227483032,-0.9623576500657427,624789283,650678285.2,13.668664156285601,23.877886047176496,NaN,NaN,-46.49920360483457,-37.23574422719232
2018-01-12T09:30:00-05:00,50.4,50.67,50.11,50.26,18635306,14549216.45,22.236942112601824,25.97576304943281,NaN,NaN,-136.60094387950082,-108.88848208191607,-0.13840644476284025,-1.135365706019293,-0.9969592612564527,606153977,640302079,12.383748282079154,22.478491605445953,NaN,NaN,-48.01010840782834,-38.77493911014032
2018-01-16T09:30:00-05:00,50.46,50.6,49.86,50.15,27292798,15256678.2,21.700225261603265,25.79998146851236,NaN,NaN,-134.96569872855815,-119.37745356110301,-0.13182263449607245,-1.1617375543765434,-1.029914919880471,578861179,621607211.4,10.473428855685285,21.209418230717866,NaN,NaN,-49.39525765828109,-40.29212747416043
2018-01-17T09:30:00-05:00,50.23,50.6,50.16,50.46,23451607,15747376.8,27.044421108592957,26.114780435315918,NaN,NaN,-111.43578643579303,-124.17430800461557,-0.09161265592902423,-1.1444307397917513,-1.052818083862727,602312786,610690402.8,9.54725914653379,20.060558727730204,NaN,NaN,-48.98250739328187,-41.53361031974921
2018-01-18T09:30:00-05:00,50.46,50.47,49.88,50.14,21329681,15843684.8,25.137156420838565,26.039219124630815,NaN,NaN,-119.09341967432303,-125.04295651161496,-0.0724306444697489,-1.143356389449913,-1.0709257449801641,580983105,598620066,8.637743138917017,18.92708970846297,NaN,NaN,-49.19103923119267,-42.6275287356697
2018-01-19T09:30:00-05:00,50.34,50.45,49.93,49.99,18631857,16030901.7,24.27301856587445,25.578861730830898,NaN,NaN,-111.9204646126651,-122.80326266616802,-0.0564200212127115,-1.1414507714960536,-1.085030750283342,562351248,586132459,7.8089109247131745,17.738873471079703,NaN,NaN,-49.61208105363911,-43.62532192395104
2018-01-22T09:30:00-05:00,50.23,50.55,49.98,50.06,20536515,16269925.95,25.559104347889786,25.176810324398193,NaN,NaN,-95.7229126116761,-114.62765641260307,-0.029067987287443975,-1.121365734392647,-1.092297747105203,582887763,581479216.2,7.519370635324449,16.224830328024655,NaN,NaN,-49.59961893614673,-44.478792925693284
2018-01-23T09:30:00-05:00,50.25,50.895,50.1,50.54,26673943,16606879.85,33.85467602260488,25.604695970467127,NaN,NaN,-63.22333620167061,-100.27918390722557,0.030190278297701045,-1.0545598992330767,-1.0847501775307777,609561706,587619321.6,12.148228588225777,15.016966708216458,NaN,NaN,-47.140180199522206,-44.85899110766884
2018-01-24T09:30:00-05:00,50.46,50.5,50.15,50.23,19531444,17009847.3,31.419454306153654,26.033013753954343,NaN,NaN,-72.69905533064109,-92.53183768619519,0.05585557139215114,-1.014930713290589,-1.07078628468274,590030262,585162816.8,11.891782251542935,13.844616912562975,NaN,NaN,-45.72826981087023,-44.983173779554754
2018-01-25T09:30:00-05:00,50.25,51.05,50.22,51.01,26284974,17911910.25,42.60617095577501,27.4238973376877,NaN,NaN,-30.174345404500876,-74.74802283223076,0.1285539704751959,-0.9100938215887453,-1.0386477920639412,616315236,592229243,17.300020790841387,13.235428150242825,NaN,NaN,-40.752335111958615,-44.37876825561245
2018-01-26T09:30:00-05:00,51.15,51.3,50.53,51.04,23949955,18578587.25,42.99134219694319,28.849712548122064,NaN,NaN,-8.162375188878901,-53.9964049474735,0.17876459063511485,-0.8151920537700477,-0.9939566444051625,640265191,607812031.6,27.821510739893725,13.643286550371775,NaN,NaN,-36.70537661193796,-43.282569449373234
2018-01-29T09:30:00-05:00,50.8,50.89,50.325,50.39,18061038,19236100.95,37.17075475324101,29.288088039073354,NaN,NaN,-42.874173810908644,-43.426657187320025,0.1684447308903626,-0.7834007307922093,-0.9518454616825719,622204153,615675309.6,32.489062248666954,14.575456561950668,NaN,NaN,-34.91574566941613,-42.08730890937936
2018-01-30T09:30:00-05:00,50.35,50.69,50.33,50.48,13089056,19539047.55,38.414069704759996,30.050969593044297,NaN,NaN,-41.41750068960587,-39.06549008490708,0.1675676747227144,-0.7423858682791789,-0.9099535430018932,635293209,620821610.2,35.43195977432151,15.885556493561339,NaN,NaN,-33.103414156126924,-40.80389537320044
2018-01-31T09:30:00-05:00,50.54,51.09,50.2642,51.04,27445244,20297809.05,45.624376797169845,31.550131393249654,NaN,NaN,6.431509259820901,-23.239377166814677,0.2022675430014227,-0.6571191142501149,-0.8593866572515376,662738453,635363248.4,42.993776370045076,17.865390421648282,NaN,NaN,-29.184918657686488,-39.14404155669845
2018-02-01T09:30:00-05:00,50.98,51.18,50.085,50.24,28519608,20683395.6,38.66083578373464,32.620896309841676,NaN,NaN,-31.949519863436436,-23.59441205860179,0.17019428241251566,-0.6466438042358931,-0.8168380866484087,634218845,638943970.2,44.71085559174191,20.08268980989516,NaN,NaN,-28.02951684321055,-37.55625231191446
2018-02-02T09:30:00-05:00,49.99,50.36,49.815,49.88,21806419,21025125.05,35.998203363062146,33.60384354201741,NaN,NaN,-112.15713356961373,-44.39336373474877,0.12564211646187473,-0.6597854410710653,-0.78542755753294,612412426,633373417.2,42.56296409322815,22.23834808212009,NaN,NaN,-27.984398265018996,-36.1888445909294
2018-02-05T09:30:00-05:00,49.8,50.325,48.97,49.06,33472349,21527926.85,30.79555936745912,34.25351026386426,NaN,NaN,-204.56180302581936,-76.73088957773089,0.04596142339083742,-0.7279757782943932,-0.7739372016852306,578940077,624720602,39.39699779276377,24.304317291911413,NaN,NaN,-29.79737413448924,-35.27577738286652
2018-02-06T09:30:00-05:00,48.48,48.74,47.37,48.33,41671583,22896480.55,27.047821052819174,34.25375311702327,NaN,NaN,-354.8039856503017,-139.40818656987005,-0.04592132196707277,-0.8313388541440716,-0.7854175321769988,537268494,605115659,33.34500916767254,26.00415657913561,NaN,NaN,-32.6948831023967,-34.90707819994226
2018-02-07T09:30:00-05:00,48.3,48.87,48.08,48.1,27880238,23518558.05,25.97523936180623,34.31361618423525,NaN,NaN,-251.91875200802218,-191.07823882343865,-0.10862193607413917,-0.9211949522696727,-0.8125730161955336,509388256,574445619.6,26.48946923664448,27.279279871830425,NaN,NaN,-35.321418898816304,-34.96626972835284
2018-02-08T09:30:00-05:00,47.96,48.61,47.51,47.56,26041897,24042550.9,23.60816979390853,34.26612698623769,NaN,NaN,-225.8255350056521,-229.85344185188177,-0.1692807902848662,-1.0241740040516163,-0.8548932137667501,483346359,544271122.4,21.751337044198294,28.275167451793653,NaN,NaN,-38.321385263745015,-35.44557194769458
2018-02-09T09:30:00-05:00,47.69,48.925,47.55,48.56,36422510,25036401.1,35.35629638669745,34.96592641758109,NaN,NaN,-141.60839395862243,-235.74369392968356,-0.1268150441340542,-1.0134120189343179,-0.8865969748002637,519768869,525742411,19.450648355896774,29.127401574691675,NaN,NaN,-36.696829411073395,-35.624323013891555
2018-02-12T09:30:00-05:00,48.66,49.2,48.22,48.93,26504387,25429855.15,39.08884072398166,35.33979532482228,NaN,NaN,-87.41338343554442,-212.31401001162854,-0.06185501198417487,-0.9639157397804823,-0.9020607277963074,546273256,519209046.8,18.699578966205863,29.595355173118826,NaN,NaN,-34.10849200529819,-35.407775726949644
2018-02-13T09:30:00-05:00,48.91,49.335,48.4,49.15,25064161,25318423.3,41.260610637559246,36.04273506277982,NaN,NaN,-64.09299097597311,-154.17181107676282,0.004367021128163673,-0.8966019513861028,-0.9009689725142664,571337417,526022831.4,22.07895830929033,30.323010605815064,NaN,NaN,-31.35076417956056,-34.8282026487512
2018-02-14T09:30:00-05:00,48.73,49.055,48.46,48.6,20341062,25162896.05,37.64676724576131,35.68849194063599,NaN,NaN,-74.0030134763357,-118.58866337042555,0.01875902912816174,-0.8775201861040642,-0.896279215232226,550996355,534344451.2,26.118075929899547,30.952871687176362,NaN,NaN,-30.232436717749927,-34.171664658608165
2018-02-15T09:30:00-05:00,48.72,49.7,48.65,49.68,16504078,24921615.9,47.39084522712569,36.0027421570776,NaN,NaN,-23.497327399718145,-78.12302184923875,0.10389056506202743,-0.7664160089046916,-0.8703065739667191,567500433,551175266,33.61345764343143,31.3665821802862,NaN,NaN,-25.77633624681769,-32.97233202835238
2018-02-16T09:30:00-05:00,49.71,50.24,49.52,50.12,20066535,24993349.8,50.7664859341044,36.97386581285355,NaN,NaN,23.243227610932554,-45.15269753532778,0.18781743840961285,-0.635534775954703,-0.8233522143643158,587566968,564734885.8,38.984093196149026,31.830512962249205,NaN,NaN,-21.04154174062404,-31.267933415819762
2018-02-20T09:30:00-05:00,49.95,50.13,49.231,49.47,16773288,24805188.45,46.06425154169995,37.52030737263498,NaN,NaN,-0.8443320730262013,-27.838887262824137,0.19660033970789315,-0.5776017897294494,-0.7742021294373426,570793680,569638970.6,40.84794181176196,32.217368822066376,NaN,NaN,-18.721408978608032,-29.47557278193237
2018-02-21T09:30:00-05:00,49.5,49.83,48.81,48.82,22461432,24594562.9,41.88612106566616,37.25328910609901,NaN,NaN,-31.746170319435937,-21.369523131516683,0.15737594896485885,-0.577482193231269,-0.7348581421961279,548332248,565037936.8,39.62496398890174,31.97673936627043,NaN,NaN,-18.233763977381642,-27.869600095567982
2018-02-22T09:30:00-05:00,48.98,49.44,48.8,49.07,20128866,24624434,43.99034619497922,37.6339684211879,NaN,NaN,-31.765528743768748,-12.922026185003295,0.14719493081844637,-0.5508644786730699,-0.6980594094915162,568461114,568530888.6,41.06749499621657,31.716499323732904,NaN,NaN,-17.161740462079063,-26.339905862212422
2018-02-23T09:30:00-05:00,49.21,50.41,49.15,50.35,20642430,24342306.8,53.31162934939754,38.87064170592614,NaN,NaN,44.29505623030988,0.6364505410023114,0.22114814845691289,-0.42162422392037513,-0.642772372377288,589103544,572851510.8,42.885327354016184,31.739525270932052,NaN,NaN,-12.899509518076469,-24.41984924162157
2018-02-26T09:30:00-05:00,50.55,50.64,50.1,50.2,13604910,23825054.55,52.2149648739571,40.400599242104576,NaN,NaN,79.88877982019373,11.965560982854546,0.25219502464056587,-0.32752859157658065,-0.5797236162171465,575498634,570437844,42.10399123345512,31.932881945267145,NaN,NaN,-9.967219962636054,-22.35518791605221
2018-02-27T09:30:00-05:00,50.24,50.54,49.38,49.4,18201199,23832062.6,46.697621746679886,41.80415643452319,NaN,NaN,36.77759090937032,19.489945579333853,0.2126652237257889,-0.3138920865599104,-0.5265573102856993,557297435,567738595,41.19997456929073,32.49395090252558,NaN,NaN,-9.325228064274892,-20.49376508008402
2018-02-28T09:30:00-05:00,49.58,49.71,49.06,49.06,11946100,23774914.8,44.543392547731486,43.13045309066071,NaN,NaN,-4.736013980054955,24.891976847210046,0.15984296468051545,-0.32675360443505497,-0.4865965691155704,545351335,567142412.4,40.990631393423776,33.529748199438394,NaN,NaN,-9.51018924550558,-18.924682818001386
2018-03-01T09:30:00-05:00,49.16,49.86,48.84,49.07,21591640,23482234.6,44.62430625343196,44.63160569491238,NaN,NaN,1.2495463415056758,31.494991864264932,0.12343014838732047,-0.33230888363141986,-0.45573903201874033,566942975,566838784.6,40.876715381850524,34.89584665212784,NaN,NaN,-9.631078792562455,-17.597025100081538
2018-03-02T09:30:00-05:00,49.04,49.53,48.5301,48.94,16857097,22899109.05,43.73102849536158,45.22980084553125,NaN,NaN,-21.614829772227207,18.313014663757514,0.08999547769681115,-0.3432446848977264,-0.43324016259453757,550085878,559035251.4,37.95708765829111,36.217735173727434,NaN,NaN,-9.989318787097162,-16.51020991251234
2018-03-05T09:30:00-05:00,48.82,50.05,48.72,49.94,15500587,22583817.45,51.73473364747843,46.1330789114953,NaN,NaN,55.69845876983496,13.474950453685759,0.132088993875636,-0.2681289202499926,-0.40021791412562857,565586465,557052817.6,37.22958961197662,37.54130736271106,NaN,NaN,-7.8352214118078605,-15.27092584098313
2018-03-06T09:30:00-05:00,49.88,49.99,49.16,49.27,20708004,21945600.2,46.91932301385106,46.537272652659006,NaN,NaN,42.70348229418235,14.660128730648164,0.1124389465742997,-0.25966923090775396,-0.37210817748205366,544878461,554569022.8,36.2910761670894,38.55645863826813,NaN,NaN,-7.508454962601426,-14.162001429785743
2018-03-07T09:30:00-05:00,49.12,49.33,48.71,48.9,16678777,20695959.9,44.45830058078363,47.023810748017745,NaN,NaN,-30.356978083289395,9.535935910001275,0.07400834584690219,-0.27959774517342595,-0.35360609102032814,528199684,551138692.6,34.979566287053046,39.189422235207665,NaN,NaN,-8.004422534188754,-13.282347301843316
2018-03-08T09:30:00-05:00,49.01,49.37,48.93,49.26,12258780,19914887,47.351859513661736,47.021026054198884,NaN,NaN,-7.313446007990439,7.8233374401020495,0.07223926826186744,-0.2633070056929938,-0.33554627395486125,540458464,545841790.4,32.99661597035984,39.145362115702554,NaN,NaN,-7.540725454512502,-12.462115609367485
2018-03-09T09:30:00-05:00,49.16,49.41,49.02,49.4,13098506,19267717.45,48.476031332325284,46.857422154071806,NaN,NaN,-4.714305837707155,11.203442227006061,0.0793371271562534,-0.23637486500954452,-0.31571199216579793,553556970,546536008.8,33.52846937201228,38.75567469969279,NaN,NaN,-6.835821401897434,-11.658359294014621
2018-03-12T09:30:00-04:00,49.42,49.674,49.355,49.61,16231825,18258183.2,50.1939695051664,47.15240200860512,NaN,NaN,36.98849965252343,7.461450403543758,0.09590693966913133,-0.1958283175793838,-0.2917352572485151,569788795,547376474.8,34.20934552372289,38.281489250547146,NaN,NaN,-5.760540641749229,-10.815813772262423
2018-03-13T09:30:00-04:00,49.79,50.02,49.34,49.72,18872544,17876591.05,51.11345657688365,47.81149740226351,NaN,NaN,58.760942532371494,10.672942451181587,0.11094461455835763,-0.15305448905056807,-0.2639991036089257,588661339,556133050.4,40.9911943356886,38.37907713246049,NaN,NaN,-4.614310061063617,-9.929884670662593
2018-03-14T09:30:00-04:00,49.87,50.4,49.84,50.23,19132328,17579999.4,55.23938697389372,48.615000315043126,NaN,NaN,135.44617430363297,43.833572928566056,0.14950787580993513,-0.0771142588465068,-0.22662213465644193,607793667,572051847,50.900089109982076,39.08140528344374,NaN,NaN,-2.4329272475080703,-8.85889075306909
2018-03-15T09:30:00-04:00,50.2,50.66,49.9,50.2,21067842,17616338.4,54.945621051694204,48.731714008064316,NaN,NaN,138.9900555340153,73.09427323696721,0.16599267179667304,-0.019131294910600616,-0.18512396670727366,586725825,581305319.2,55.570537967989175,39.98749175587038,NaN,NaN,-0.7109784796494906,-7.694903285437719
2018-03-16T09:30:00-04:00,49.81,50.375,49.78,50.25,19756272,17778948.1,55.37160891673334,48.95718858254833,NaN,NaN,101.80210455338792,94.39755531518622,0.17250203547042733,0.030503577630760503,-0.14199845783966683,606482097,591890344.6,60.230668398436286,41.28225441051189,NaN,NaN,0.8455342023489606,-6.474840787182479
2018-03-19T09:30:00-04:00,50.22,50.39,49.645,49.94,21689754,17860109.05,52.08356723257984,49.341898974398326,NaN,NaN,74.64655065733781,101.9291655161491,0.149050233819876,0.04431433443517818,-0.10473589938469782,584792343,594891054.2,61.464634547546,42.72973012324441,NaN,NaN,1.3596065177192456,-5.355634029339376
2018-03-20T09:30:00-04:00,49.95,50.1613,49.59,49.71,14968219,17769855.6,49.724338692585256,49.71196655617359,NaN,NaN,39.93121497814452,98.16322000530371,0.11281443385584404,0.03628214293510723,-0.07653229092073681,569824124,591123611.2,58.98983766018611,44.015387713727435,NaN,NaN,1.1861941963698048,-4.42108713995235
2018-03-21T09:30:00-04:00,49.75,50.22,49.37,49.54,19235930,17608580.5,47.99388121187058,49.95265048177636,NaN,NaN,15.97970357517776,74.26992585961267,0.0740373448413423,0.01601439013094108,-0.058022954710401226,550588194,579682516.6,52.12589912035462,44.818900837906305,NaN,NaN,0.584028708892923,-3.706070590117311
2018-03-22T09:30:00-04:00,49.59,50.56,49.45,49.76,25332408,17868757.6,50.39955075338067,50.42897350020629,NaN,NaN,50.26620997269706,56.525156747349016,0.06042032696898227,0.017502454000826617,-0.042917872968155656,575920602,577521472,50.92066589304911,45.74487071181759,NaN,NaN,0.6778105527246485,-3.0798018554256026
2018-03-23T09:30:00-04:00,49.76,50.21,48.96,49.06,17334269,17703349.55,43.503975338812616,49.84106219244445,NaN,NaN,-44.615399711526614,27.241655894366108,0.004437019975678441,-0.037371597998557604,-0.041808617974236045,558586333,567942319.2,45.85903467495733,46.36125964488764,NaN,NaN,-1.2001241290867135,-2.8112764659486187
2018-03-26T09:30:00-04:00,49.22,49.64,49.12,49.57,13759948,17711101.45,48.98086233785314,49.988315001301736,NaN,NaN,-32.23662275113782,5.865021212670977,0.002043341546723254,-0.03925444104083198,-0.04129778258755523,572346281,565453106.8,44.61788281494784,46.95603154830609,NaN,NaN,-1.276547678566869,-2.5920294963226542
2018-03-27T09:30:00-04:00,49.64,50.8,49.48,50.28,21455993,17873841.15,55.45507523357644,50.77379890507266,NaN,NaN,114.2079240529906,20.720363027640197,0.04612296025171601,0.016355917727089775,-0.029767042524626232,593802274,570248736.8,47.562381529874166,47.85480406565046,NaN,NaN,0.6707409003249333,-2.125919439658713
2018-03-28T09:30:00-04:00,50.34,50.54,49.93,50.26,23173078,18435190.05,55.24241667673201,51.33741013100625,NaN,NaN,111.0343882199402,39.73129995659268,0.07032839666922619,0.05814345331190651,-0.012184943357319684,570629196,574256937.2,49.95719610234102,49.066274075077686,NaN,NaN,2.1651919611121104,-1.5129035252628813
2018-03-29T09:30:00-04:00,50.41,50.77,50.32,50.53,15465120,18128864.05,57.605966460969114,51.98954835448081,NaN,NaN,146.1939510332987,58.91684816871301,0.09915502154638096,0.11175883357565652,0.012603812029275557,586094316,576291680,51.17620052912375,50.32682630058565,NaN,NaN,4.122735381466721,-0.7078122528729383
2018-04-02T09:30:00-04:00,50.62,50.86,49.78,50.14,17792607,18175639.55,53.23310749384216,52.20662963938622,NaN,NaN,86.78579836857939,85.19708778473421,0.08702132604217973,0.12138046958200022,0.03435914353982049,568301709,578234755.2,52.36940380476895,51.62397332066037,NaN,NaN,4.535064416926686,0.041170128527008076
2018-04-03T09:30:00-04:00,50.05,50.545,49.92,50.31,13798787,18090549.55,54.842267134162235,52.472973250620406,NaN,NaN,78.09539236373884,107.26349080770956,0.08539011615777367,0.14109678873703757,0.055706672579263906,582100496,580185598.2,53.5955985020089,52.52428790396896,NaN,NaN,5.340072955763977,0.7981562467037179
2018-04-04T09:30:00-04:00,50.3,50.55,49.89,50.42,16357323,17873015.5,55.89964722418765,52.52013469706997,NaN,NaN,75.57141194734417,99.53618838658026,0.086403490334054,0.16371103549683141,0.07730754516277741,598457819,581116707.2,54.201617782590645,52.76011138058386,NaN,NaN,6.305215024281058,1.5848789292147663
2018-04-05T09:30:00-04:00,50.41,50.97,49.85,50.82,14286349,17753394.1,59.60382039963233,52.85286322192269,NaN,NaN,115.54110122641825,100.43753098787587,0.1073315072916422,0.21147192927733016,0.10414042198568796,612744168,589539701.6,59.37074051065955,53.03155441934603,NaN,NaN,8.218348716313791,2.5325174702289126
2018-04-06T09:30:00-04:00,50.89,51,50.31,50.42,14312005,17856055.35,54.65957359459817,52.80200355605589,NaN,NaN,113.84665250006901,93.96807128122994,0.08834579403280882,0.214572664526699,0.12622687049389017,598432163,592007271,60.767744140420795,53.06991697234492,NaN,NaN,8.456035695857452,3.378734359604418
2018-04-09T09:30:00-04:00,50.46,50.87,50.29,50.52,11756054,17788932.75,55.65004941167902,53.05675228313441,NaN,NaN,104.58496574196677,97.52790475590741,0.07704566436691856,0.22253395095253836,0.1454882865856198,610188217,600384572.6,65.14895263030743,53.333082549685024,NaN,NaN,8.931005542713295,4.1719159571914
2018-04-10T09:30:00-04:00,50.53,50.59,50.02,50.13,14114214,17683052.2,50.973238676408116,53.14595942483604,NaN,NaN,32.122986991759205,88.33342368151149,0.039708823147769357,0.1951243155203315,0.15541549237256214,596074003,603179274,66.49326053740855,53.86904132662948,NaN,NaN,7.993312659912004,4.717829771865772
2018-04-11T09:30:00-04:00,50.11,50.29,49.89,50.06,8024101,17140630.05,50.158447268299,53.30057128600949,NaN,NaN,-13.493959679039301,70.52034935623479,0.008341082436305491,0.165841845417944,0.1575007629816385,588049902,601097690.6,64.49767626033174,54.7527396937707,NaN,NaN,6.98871151985042,5.042241450149294
2018-04-12T09:30:00-04:00,50.07,50.2,49.3,49.4,12078776,16787952.45,43.15425006222971,52.78304980807014,NaN,NaN,-111.17222718220461,25.177683674510213,-0.055312425583324665,0.08836023100248269,0.14367265658580736,575971126,593743082.2,57.887300292913544,55.25035643661816,NaN,NaN,3.923143572593499,4.88237032478418
2018-04-13T09:30:00-04:00,49.49,50.005,49.49,49.79,10437316,16256426.15,47.793465116603045,53.08944193505517,NaN,NaN,-72.03599447613087,-11.998845720729761,-0.06873058978463917,0.05775941935500839,0.12649000913964756,586408442,591338338,55.870967109064736,55.96549446762584,NaN,NaN,2.678433125883538,4.56752215351266
2018-04-16T09:30:00-04:00,49.9,50.495,49.87,50.47,15397640,16038494.55,54.73060129282788,53.50013757469623,NaN,NaN,42.091008312152255,-24.49763720669267,-0.031295037937056125,0.0873712117183274,0.11866624965538353,601806082,589661911,54.44714875173185,56.667584891681834,NaN,NaN,3.796940747770049,4.45743909554943
2018-04-17T09:30:00-04:00,50.59,51.16,50.38,50.98,13194521,15613732.9,59.11824021113987,53.76179221595076,NaN,NaN,145.13545366735784,-1.895143871572941,0.025274529315402194,0.15025941129963627,0.12498488198423408,615000603,593447231,57.105271074530066,57.34921985915725,NaN,NaN,6.199381111723549,4.706287955002876
2018-04-18T09:30:00-04:00,51.04,51.49,50.78,50.79,14120045,15571324.2,56.905411339449344,53.880577549002,NaN,NaN,163.9660112637015,33.59685031697522,0.046141486106818175,0.18266173961775678,0.1365202535109386,600880558,596013362.2,58.857965100342795,57.98498907330024,NaN,NaN,7.440150444531818,5.096839739221296
2018-04-19T09:30:00-04:00,50.61,50.875,50.351,50.76,15167725,15367913.95,56.545515491614864,53.80483105119098,NaN,NaN,87.6356555111807,73.35842685565228,0.05364251841027029,0.20357340152377645,0.14993088311350616,585712833,597961703.6,60.18807119279525,58.62869412070535,NaN,NaN,8.322795052391943,5.557690498245674
2018-04-20T09:30:00-04:00,50.7,50.82,50.14,50.3,14080012,14805294.15,51.19860785900329,53.65950964870249,NaN,NaN,33.79338739414241,94.52430322970693,0.024808974085618052,0.18094210072052874,0.1561331266349107,571632821,595006579.4,57.16911146448057,58.97153038211332,NaN,NaN,7.461173274665704,5.829616609162821
2018-04-23T09:30:00-04:00,50.37,50.62,50.14,50.33,11937035,14535432.45,51.5205739170562,53.422245847480625,NaN,NaN,12.912450014497228,88.68859157017593,0.005927233687244238,0.163542168743966,0.15761493505672175,583569856,591359334.2,53.59594898350093,58.97155541650561,NaN,NaN,6.85859501787762,5.976613524693507
2018-04-24T09:30:00-04:00,50.37,50.975,50.285,50.67,16904422,14692656.15,55.13337173849332,53.367511884216746,NaN,NaN,73.51551752381401,74.36460434146717,0.01404286964259907,0.17516852210997058,0.1611256524673715,600474278,588454069.2,50.868565014961824,58.73348021881783,NaN,NaN,7.387903745520107,6.178226413383021
2018-04-25T09:30:00-04:00,50.49,50.86,50.3,50.68,13407493,14290231.15,55.23902708350968,53.055740933065124,NaN,NaN,58.98476481935145,53.36835505259715,0.017562667422826472,0.18307898674590461,0.16551631932307814,613881771,591054311.8,53.16572337544735,58.29026470915982,NaN,NaN,7.84871334254989,6.416867403264002
2018-04-26T09:30:00-04:00,50.73,51.26,50.5,51.19,11767067,13719930.6,60.36526603297607,53.46329039294926,NaN,NaN,137.02674325240145,63.2465726008413,0.049886172292443354,0.22787403468863232,0.17798786239618897,625648838,599041512.8,59.43913923422288,58.19536435871711,NaN,NaN,9.773060276130181,6.89632352795917
2018-04-27T09:30:00-04:00,51.13,51.9,51.03,51.71,17157296,13804539.4,64.79268014591656,54.116335445394796,NaN,NaN,222.2997241163745,100.94783994528771,0.09909330716841755,0.3018544963567109,0.20276118918829336,642806134,613276175.4,67.73420567813118,58.38002529070452,NaN,NaN,12.859395969100266,7.748191019550755
2018-04-30T09:30:00-04:00,51.79,51.96,51.51,51.56,12745989,13552208.5,62.61969022821669,54.948224841952545,NaN,NaN,207.31643745302947,139.82863743299419,0.11331956647158622,0.34441064727777615,0.23109108080618992,630060145,622574233.2,71.79220191360403,58.758521103289915,NaN,NaN,14.757872892492557,8.749574144256727
2018-05-01T09:30:00-04:00,51.56,51.65,51.31,51.4,10971329,13410835.6,60.29674463051558,55.67238893925373,NaN,NaN,142.32058115734995,153.58965015970134,0.10397827178509078,0.36106392053755343,0.25708564875246265,619088816,626297140.8,73.2432358462051,59.3832039308523,NaN,NaN,15.670198416863714,9.738234754629154
2018-05-02T09:30:00-04:00,51.41,51.59,51.1452,51.35,12980587,13241998.8,59.553266130674594,56.843747229856945,NaN,NaN,109.85325739019915,163.7633486738709,0.087137932446395,0.3660080643104564,0.2788701318640614,606108229,624742432.4,71.58710534701619,60.36176143471677,NaN,NaN,16.215702579526454,10.663587301043053
2018-05-03T09:30:00-04:00,51.25,51.52,50.7,51.28,16480129,13351687.8,58.46635684174191,57.60609663879543,NaN,NaN,70.07241947510775,150.37248391841214,0.06500517736522438,0.3601266035705919,0.2951214262053675,589628100,617538284.8,64.32856588543731,60.9658756330291,NaN,NaN,16.38069806353499,11.480317409970473
2018-05-04T09:30:00-04:00,51.37,51.74,51.37,51.51,11743383,13223256.7,60.98591082116728,58.05290446224825,NaN,NaN,108.3741700164841,127.58737309843409,0.05971261341868683,0.36976219297872603,0.3100495795600392,601371483,609251354.6,57.15016525421824,61.15894824034956,NaN,NaN,17.20625747292216,12.298308847534999
2018-05-07T09:30:00-04:00,51.48,51.585,51.17,51.24,8522029,13061555.45,56.64198206764405,57.87602888056997,NaN,NaN,71.84181395479337,100.49244839878686,0.033207670940809286,0.3515591682360508,0.31835149729524154,592849454,601809216.4,51.58317308612102,60.76451266974891,NaN,NaN,16.73140088424647,12.931607709922352
2018-05-08T09:30:00-04:00,51.03,51.12,49.87,49.96,23147880,13513238.75,41.537026000408446,56.778287070638484,NaN,NaN,-61.4812235718791,59.73208745294105,-0.0697348740215562,0.23118290476829628,0.3009177787898525,569701574,591931768,45.278954888646446,59.79458336891346,NaN,NaN,11.010167901524479,12.657116308722655
2018-05-09T09:30:00-04:00,49.97,50.06,49.42,49.61,22150453,14219556.35,38.51270551482393,55.49022921515341,NaN,NaN,-135.31217755158627,10.699000464583957,-0.15568124183309368,0.10631622649848538,0.26199746833157905,547551121,580220346.4,39.16684320758104,58.293067084255306,NaN,NaN,5.283975504635114,11.603810479567292
2018-05-10T09:30:00-04:00,50.03,50.32,49.76,50.31,13961716,14313703.35,46.848095475298116,55.17947833060305,NaN,NaN,-87.73128002073949,-20.86173943458549,-0.1591059084070879,0.06311508282271916,0.22222099122980707,561512837,574597293.8,36.61144288035761,56.824662185389386,NaN,NaN,3.218635485778545,10.405928337597471
2018-05-11T09:30:00-04:00,50.36,50.515,50.18,50.38,6478906,14115782.85,47.612898491890356,54.900358657376906,NaN,NaN,-65.23511171074463,-55.58359578003124,-0.15047053833165147,0.03413281831524273,0.1846033566468942,567991743,567921345.8,33.79250056501634,55.41013015549762,NaN,NaN,1.8762547385767077,9.187403537737362
2018-05-14T09:30:00-04:00,50.46,50.55,49.97,50.19,8512777,13771539.7,45.69112220329897,54.225912262005885,NaN,NaN,-81.76788845444622,-86.30553626187915,-0.15097849109339867,-0.0041197572198541366,0.14685873387354453,559478966,561247248.2,31.205674603296785,54.00563798323583,NaN,NaN,0.1810965501676208,7.900788253798828
2018-05-15T09:30:00-04:00,49.89,50.12,49.53,49.77,11070733,13665350.3,41.68572203900372,53.25781904454117,NaN,NaN,-123.44300623548544,-98.69789279460042,-0.1715246259078139,-0.06754704851122284,0.10397757739659105,548408233,556988580,29.646187911241796,52.32567116436401,NaN,NaN,-2.5496120956860198,6.407873918158135
2018-05-16T09:30:00-04:00,49.79,49.86,49.1925,49.38,13541426,13636419.35,38.325969888364945,51.68358360564037,NaN,NaN,-145.65162865092705,-100.76578301446857,-0.20124777345806108,-0.1475821394259853,0.053665634032075776,534866807,554451717.2,28.725271734416665,50.13182348580642,NaN,NaN,-5.938657115421864,4.644083770503849
2018-05-17T09:30:00-04:00,49.39,49.53,48.88,48.98,11276030,13441834.6,35.192999677616115,49.56932071504748,NaN,NaN,-159.66834218658394,-115.15319544763747,-0.23534425054731717,-0.2405146791520707,-0.00517042860475353,523590777,546867305.2,26.11355066996039,47.15891955665137,NaN,NaN,-9.81509620143553,2.5784866316553665
2018-05-18T09:30:00-04:00,49.12,49.28,48.61,48.99,11810352,13328351.6,35.33531608192682,47.620436847455345,NaN,NaN,-152.17009812304212,-132.54019273009698,-0.24369281287788708,-0.30978644470211236,-0.0660936318242253,535401129,540349182.4,24.08668492600019,43.75138262896538,NaN,NaN,-12.83342877913231,0.3767844301142702
2018-05-21T09:30:00-04:00,49.05,49.3751,48.83,49.24,10742001,13268599.9,38.94507687294759,46.09531772191478,NaN,NaN,-117.82900427150521,-139.75241589350875,-0.2195937710942289,-0.34058584569201145,-0.12099207459778254,546143130,537682015.2,23.29008100168386,40.18330014007101,NaN,NaN,-14.308995925296719,-1.7211841920872994
2018-05-22T09:30:00-04:00,49.22,49.705,49.22,49.42,11026096,12974683.6,41.47814308518099,44.80423750437952,NaN,NaN,-81.91101610481267,-131.44601786737422,-0.18038724910205475,-0.346476135975351,-0.16608888687329623,557169226,539434213.8,25.043921277420353,36.858786992242734,NaN,NaN,-14.804892372554502,-3.590285360725471
2018-05-23T09:30:00-04:00,49.59,49.98,49.465,49.87,13582881,12983453,47.35819691135652,44.010797509351995,NaN,NaN,-50.174298042198004,-112.3505517456284,-0.11612501360419333,-0.3112451538785379,-0.19512014027434457,570752107,546611273.8,31.910876132343788,34.54323772416463,NaN,NaN,-13.462824770096748,-5.000648133492796
2018-05-24T09:30:00-04:00,49.94,50.315,49.77,50.28,12897818,13039990.55,52.08225869158439,43.37482235723893,NaN,NaN,-18.230651562102,-84.06301362073201,-0.04181510902093616,-0.24738902655051476,-0.2055739175295786,583649925,558623103.4,41.56051351859641,33.429691171620206,NaN,NaN,-10.82997417537998,-5.833408996619537
2018-05-25T09:30:00-04:00,50.35,50.63,50.245,50.5,13871593,12875705.4,54.444628648596236,43.21786854159266,NaN,NaN,16.67596287237711,-50.293801421648155,0.02286698086624156,-0.17699019144677663,-0.1998571723130182,597521518,571047181.2,49.52803343090775,33.28289548196212,NaN,NaN,-7.9145104879179975,-6.130709209662174
2018-05-29T09:30:00-04:00,50.41,50.8375,50.14,50.5,17280742,13102443.05,54.44462864859625,44.13984015932035,NaN,NaN,27.860368026347604,-21.155926962077583,0.06403179647490548,-0.11981742671938633,-0.1838492231942918,597521518,581322858.8,54.9934523724795,33.97678815937876,NaN,NaN,-5.566515968209732,-6.050110175168968
2018-05-30T09:30:00-04:00,50.36,51,50.23,50.91,13885862,13248169.7,58.8314293458507,45.59117757582227,NaN,NaN,57.522025445587154,6.730681348002382,0.11431781326404997,-0.040951956614229346,-0.1552697698782793,611407380,592170489.6,59.92674583670702,35.459638347173474,NaN,NaN,-2.1711235699606446,-5.495969231567779
2018-05-31T09:30:00-04:00,50.85,51.288,50.54,50.99,15108242,13354552.45,59.64794549332824,46.50545257711014,NaN,NaN,87.34597995385225,34.23473694721243,0.14636436367192002,0.027685684711620695,-0.11867867896029931,626515622,603323192.6,64.26384185287552,37.43480970235331,NaN,NaN,0.8643997723602868,-4.587345088149484
2018-06-01T09:30:00-04:00,50.86,50.88,49.97,50.21,17180044,13389548.2,49.36715737372064,46.63075678295517,NaN,NaN,27.926107634453746,43.466088786523585,0.1100820519079368,0.018923885924621686,-0.09115816598331511,609335578,608460323.2,66.08465674220272,39.74139228643805,NaN,NaN,0.5435694937431867,-3.8543572907362456
2018-06-04T09:30:00-04:00,50.31,50.52,49.77,49.81,14364509,13520604.5,45.07643375842982,46.58685046546451,NaN,NaN,-1.737659298088884,39.78336435243038,0.05687432480811974,-0.02006525997316544,-0.07693958478128518,594971069,607950233.4,65.72655246895064,42.207169276841896,NaN,NaN,-1.1026509685170638,-3.4612563875620768
2018-06-05T09:30:00-04:00,49.9,49.965,49.36,49.55,14914625,13840234.3,42.49125814520189,46.64438875876437,NaN,NaN,-48.85139908642631,24.441010929875592,0.004652157095505885,-0.07112438841190283,-0.07577654550740871,580056444,604457218.6,63.20091674009433,44.60393562175993,NaN,NaN,-3.281673034949293,-3.4356016229031074
2018-06-06T09:30:00-04:00,49.54,49.6,48.37,48.37,26127933,13989236.95,33.188337076903636,46.27741498651714,NaN,NaN,-147.31541124184812,-16.526476407611465,-0.10293756268144467,-0.20444849885921457,-0.10151093617776989,553928511,592961444.8,55.62519716487283,46.52535886679251,NaN,NaN,-8.769293189897196,-4.19755756104512
2018-06-07T09:30:00-04:00,48.45,49.185,48.345,48.71,21525793,13958003.95,37.43852669781612,46.43780977367428,NaN,NaN,-132.7998440351143,-60.555641205404775,-0.14235309601997226,-0.2794523062027352,-0.13709921018276294,575454304,582749181.2,49.90261181229287,48.22457751981626,NaN,NaN,-11.663448772976505,-5.264113448463889
2018-06-08T09:30:00-04:00,48.89,48.91,48.535,48.69,11241244,13821980.35,37.28825959938704,46.57730573920715,NaN,NaN,-119.84031802226033,-90.1089263367476,-0.15962205013713476,-0.3366267728541814,-0.17700472271704665,564213060,573724677.6,45.45256012727485,49.75071146276445,NaN,NaN,-13.934120092880079,-6.502685826237631
2018-06-11T09:30:00-04:00,48.8,48.98,48.45,48.59,17335210,14364795.55,36.499425159860124,46.40261633112947,NaN,NaN,-109.93559245940958,-111.74851296901174,-0.16684629250339406,-0.3855625883462892,-0.21871629584289515,546877850,564106033.8,41.23216493047447,51.03228888624949,NaN,NaN,-15.994420556832084,-7.858647930608267
2018-06-12T09:30:00-04:00,48.55,49.21,48.52,49.15,16661331,14772223.25,43.684252163376726,46.5601955510006,NaN,NaN,-71.39947354944204,-116.25812786161487,-0.12489606285045096,-0.37483637440595885,-0.2499403115555079,563539181,560802581.2,39.86315877633152,52.090805850457436,NaN,NaN,-15.52415642418701,-8.953720572548088
2018-06-13T09:30:00-04:00,49.21,49.5,48.87,49.02,16725749,15054974.05,42.482570445977125,46.211936517759206,NaN,NaN,-48.357665287074774,-96.4665786706602,-0.09807285180465702,-0.37253137631132915,-0.27445852450667213,546813432,559379565.4,39.25847404476237,52.61563427277304,NaN,NaN,-15.507961361117731,-9.890040685200894
2018-06-14T09:30:00-04:00,49.1,49.74,49.04,49.63,16138550,15184830.25,49.502114553832186,46.02764050791976,NaN,NaN,-12.073709172501921,-72.32135169813773,-0.034688480916621134,-0.3178191256524485,-0.2831306447358274,562951982,556879101,38.16301631737241,52.37295590125705,NaN,NaN,-13.240741420500532,-10.368712218815128
2018-06-15T09:30:00-04:00,49.13,49.56,48.74,49.54,21715292,15706793.35,48.56046430309612,45.607343054669755,NaN,NaN,-33.473090206276105,-55.04790613494089,0.0036957005859108993,-0.2785110190034388,-0.2822067195893497,541236690,552283827,36.165753809425226,51.41850735686544,NaN,NaN,-11.706494784262453,-10.559824013879032
2018-06-18T09:30:00-04:00,49.51,49.86,49.41,49.7,17226652,15977608.35,50.36801174755297,45.31615613316666,NaN,NaN,3.4963161193174774,-32.361524419195476,0.04034407819976543,-0.23177662183964287,-0.2721207000394083,558463342,554600925.4,37.92973442725399,50.19967036077791,NaN,NaN,-9.90283278689824,-10.465968124310347
2018-06-19T09:30:00-04:00,49.79,50.37,49.7,50.19,16647391,16272877.85,55.5225878595365,45.079810312715644,NaN,NaN,46.654958092779005,-8.750638090751263,0.09495119579605632,-0.15343170529433792,-0.24838290109039424,575110733,556915235.8,39.72143243616,48.756433689310256,NaN,NaN,-6.720394302812388,-9.93088614981064
2018-06-20T09:30:00-04:00,50.27,50.355,50.01,50.23,12317683,16337457.2,55.925001032511304,44.81388570837158,NaN,NaN,53.64482472885571,11.649859912434838,0.12901754665652984,-0.08711096776973193,-0.21612851442626177,587428416,565038232.6,45.65135825984727,47.426970575522525,NaN,NaN,-4.032375256970985,-9.088241736547833
2018-06-21T09:30:00-04:00,50.28,50.66,50.12,50.4,12703675,16293496.9,57.677576857852635,45.40748710009529,NaN,NaN,68.16303244883254,27.697208236701737,0.15642576767358693,-0.0205963048342781,-0.17702207250786503,600132091,572474254.4,50.45625667313181,46.310656284874604,NaN,NaN,-1.2654759012926062,-7.970703760082801
2018-06-22T09:30:00-04:00,50.43,50.88,50.33,50.75,12977387,16297475.35,61.10655506004177,46.55249576449614,NaN,NaN,88.85627923893269,52.16308212574349,0.18935467117952204,0.05967126646653753,-0.1296834047129845,613109478,586848812,58.15736238505757,45.76999985031082,NaN,NaN,2.166813265802756,-6.52248704209915
2018-06-25T09:30:00-04:00,50.76,51.695,50.76,51.59,21466164,16677203.9,67.84088272896601,48.36318323476501,NaN,NaN,144.45110554712357,80.35404001130472,0.254856721654414,0.18888749735503296,-0.06596922429938101,634575642,602071272,64.45795891770577,45.85978857728306,NaN,NaN,7.619325109356814,-4.502228163319726
2018-06-26T09:30:00-04:00,51.45,51.95,51.34,51.65,19908731,16808603.35,68.26358285320018,50.8685579330719,NaN,NaN,154.5023696682401,101.92352232639693,0.28698261608117354,0.2927590458020859,0.005776429720912371,654484373,617946000,69.59905615923675,46.85792136259477,NaN,NaN,12.090134197187243,-2.1318906832473026
2018-06-27T09:30:00-04:00,51.59,52,51.45,51.9,21764677,17202544.1,70.03113406915543,53.196601316739,NaN,NaN,151.18408930796542,121.43137524221888,0.307976154721875,0.39074662312325614,0.08277046840138114,676249050,635710126.8,74.11177241009854,48.58714711958089,NaN,NaN,16.38606851416929,0.5135320592407817
2018-06-28T09:30:00-04:00,51.95,52.365,51.795,51.88,15037810,17199022.5,69.69670729314477,55.51149043772169,NaN,NaN,155.34363278020845,138.86749530849406,0.3029589232551733,0.46146912247034777,0.15851019921517445,661211240,647925956.6,76.67579369462796,50.81737808867755,NaN,NaN,19.768831109261573,3.264289066386609
2018-06-29T09:30:00-04:00,51.79,52.17,51.5,51.96,14379021,17058971.35,70.30751030785652,57.926353662578585,NaN,NaN,127.6844070961652,146.63312087994058,0.28759291827494543,0.5180013470588563,0.23040842878391082,675590261,660422113.2,78.97030618869456,53.512959607121836,NaN,NaN,22.758353858246878,6.04915546522379
2018-07-02T09:30:00-04:00,51.99,52.36,51.745,52.33,15702804,17125886.1,73.01649263019803,60.021513695922955,NaN,NaN,124.58084059265933,142.65906788904772,0.284397653989998,0.5859054962714083,0.3015078422814103,691293065,671765597.8,80.81529364939595,56.43811209805501,NaN,NaN,26.206623866831585,8.928793808310617
2018-07-03T09:30:00-04:00,52.35,52.79,52.11,52.48,10605554,16910432.55,74.05013173781666,62.27633950248292,NaN,NaN,123.95002200408955,136.5485983562176,0.27431018939909646,0.6443955790302809,0.3700853896311844,701898619,681248447,82.21965148170163,59.50676762926496,NaN,NaN,29.415286937898827,11.855435683966075
2018-07-05T09:30:00-04:00,52.51,52.8,52.29,52.76,11030959,16155583.85,75.9055388094834,64.16229837788659,NaN,NaN,116.92928736897139,129.6976379684188,0.2681027166305464,0.7052137854193674,0.437111068788821,712929578,688584552.6,83.24168333273633,62.72667241607666,NaN,NaN,32.75093241738663,14.840506645883297
2018-07-06T09:30:00-04:00,52.87,53.29,52.78,53.17,12396658,15699127.1,78.34691315488699,66.28990186730022,NaN,NaN,125.56548604214471,123.74200862080605,0.27233778952169885,0.7775333056909446,0.5051955161692457,725326236,701407551.8,84.8779142067322,66.20611244445573,NaN,NaN,36.45610606173292,17.9284494195761
2018-07-09T09:30:00-04:00,53.16,53.165,51.35,51.53,27936766,16533903.2,54.540996800340444,66.5879722282136,NaN,NaN,62.11935557067921,110.62899831570883,0.15144911447073273,0.6945069092576617,0.543057794786929,697389470,705767393.6,85.39987346954292,69.59683666176208,NaN,NaN,31.458273955413762,19.861281496124338
2018-07-10T09:30:00-04:00,51.04,52.3,50.89,52.02,27109051,17022595.25,58.589635158266,66.80704703526571,NaN,NaN,41.40212605511794,93.99325540820055,0.09405892312944664,0.6606314486987372,0.5665725255692906,724498521,712408484.8,86.18224970163992,72.91546646643921,NaN,NaN,28.9380247864663,21.157959109030333
2018-07-11T09:30:00-04:00,52,52.58,51.96,52.49,21772312,17278144.3,62.078330071228365,67.24657053803122,NaN,NaN,71.41003684674487,83.48525837673162,0.0779861072819028,0.6640551596716691,0.5860690523897663,746270833,721282927.6,87.1715318299114,75.88119315001522,NaN,NaN,28.169678936752057,22.159633370133438
2018-07-12T09:30:00-04:00,52.49,52.635,52.25,52.53,17136743,17298694,62.368898007142946,67.58166490583767,NaN,NaN,75.18945820608081,75.1372925441535,0.061033443954000566,0.662360857332267,0.6013274133782665,763407576,731378527.2,88.20600552072725,78.57760378198633,NaN,NaN,27.68348214382364,22.948754623517754
2018-07-13T09:30:00-04:00,52.6,52.72,52.19,52.54,10959274,17039730.2,62.44636859756543,67.67736587280365,NaN,NaN,71.89742543277447,64.40368042227945,0.04236435841639108,0.6542828613987552,0.6119185029823642,774366850,741186650,89.123634076269,80.78948033135858,NaN,NaN,27.32897657364836,23.574500616393554
2018-07-16T09:30:00-04:00,52.5,52.63,52.225,52.49,10493196,16478625.4,61.76172580574876,67.24314037828813,NaN,NaN,66.91257361029707,65.36232403020301,0.019672500232120305,0.6365091282725146,0.6168366280403943,763873654,754483486.8,90.23309059482811,82.63056116543873,NaN,NaN,26.841696908971286,24.04124294390466
2018-07-17T09:30:00-04:00,52.57,52.66,52.4,52.45,11053491,16169967.35,61.18380542900025,66.73744199084528,NaN,NaN,68.73418564388787,70.828735947957,-0.0037578701796734393,0.6121392903158025,0.6158971604954759,752820163,760147815.2,90.66971322112052,84.13560809843044,NaN,NaN,26.280736256398118,24.361170559975154
2018-07-18T09:30:00-04:00,52.39,52.48,51.96,52.18,10361284,15855662,57.28713106772723,65.82715606217184,NaN,NaN,33.201535062208315,63.187035591049685,-0.04109236474626887,0.5645317045626399,0.6056240693089088,742458879,759385424.4,90.0859722796303,85.27662237482556,NaN,NaN,24.689319552108895,24.40804898742283
2018-07-19T09:30:00-04:00,52.23,52.97,52.23,52.66,11119379,15795746.8,61.92920193583447,65.27233425093537,NaN,NaN,78.3881417159815,63.826772293029855,-0.03722765339330125,0.5590895025672822,0.5963171559605834,753578258,757419560.8,88.50370523437759,86.1214731990934,NaN,NaN,24.612531438330773,24.437260766123966
2018-07-20T09:30:00-04:00,52.5,52.64,51.94,52.29,13828495,15851987.8,56.804366609465326,64.30782398676459,NaN,NaN,25.338304335805194,54.51494807363599,-0.061902837379011144,0.5189386092368196,0.5808414466158307,739749763,750496143.4,82.97621420772826,86.40760948616722,NaN,NaN,23.000906904597663,24.232067357334493
2018-07-23T09:30:00-04:00,52.3,52.4,51.74,51.92,14763727,15941304.8,52.15626514870947,62.817807738086834,NaN,NaN,-37.87395208308481,33.55764293495962,-0.10303167184697115,0.4520518568071168,0.5550835286540879,724986036,742718619.8,77.14723552188346,86.14560533420206,NaN,NaN,20.185095101051086,23.65392846357972
2018-07-24T09:30:00-04:00,51.78,52.26,51.18,52.1,15698804,15652936.8,54.12299365642811,61.39444073227337,NaN,NaN,-84.882005899725,2.834404626237043,-0.11698274909101702,0.4088550922903167,0.5258378413813337,740684840,740291555.2,75.36793162667166,85.65619677312849,NaN,NaN,18.425743955593294,22.907044962438803
2018-07-25T09:30:00-04:00,52.09,52.51,51.93,52.25,13468701,15330935.3,55.75523606595492,59.9551333934499,NaN,NaN,-7.225964482568065,-5.251095282718228,-0.11481589867173775,0.3823179680416615,0.49713386671339926,754153541,742630487.6,75.94374118043294,85.13491519082109,NaN,NaN,17.42862390587679,22.124413382929944
2018-07-26T09:30:00-04:00,52.5,52.9599,52.41,52.81,19071002,15196251.55,61.292175818768875,58.73693786944147,NaN,NaN,104.21115102035452,-0.08649342184363107,-0.07623330250559213,0.4018422385814091,0.47807554108700123,773224543,746559744.6,76.91984099516908,84.56648138999516,NaN,NaN,18.21639567086836,21.56612513834972
2018-07-27T09:30:00-04:00,52.84,53.07,52.43,52.64,15748099,15231766,58.883133620034755,59.04709049941964,NaN,NaN,91.4880964468767,13.143465000370673,-0.0632617293113581,0.3989983794478036,0.4622601087591617,757476444,750105080.8,77.7953134037631,84.02329852815375,NaN,NaN,18.150402257171326,21.078164726752807
2018-07-30T09:30:00-04:00,52.57,52.57,52.15,52.32,9476372,14986633.55,54.53780372205642,58.75767396826181,NaN,NaN,-4.989469472732487,19.720361522441138,-0.0764511037443138,0.3666962290787694,0.4431473328230832,748000072,754707888,78.91360740955318,83.50410979300469,NaN,NaN,16.78777476086111,20.465251874482565
2018-07-31T09:30:00-04:00,52.55,52.93,52.36,52.79,15219786,14962482.65,59.289717175014935,58.55848733281799,NaN,NaN,80.25710596123258,52.748183894632646,-0.05475604258018241,0.3747022795978552,0.4294583221780376,763219858,759214891.6,79.9769922604998,82.9902141094753,NaN,NaN,17.059354126195046,19.978695053298633
2018-08-01T09:30:00-04:00,52.49,52.6,52,52.45,19985360,15431472.95,54.825299063023735,58.01965883680948,NaN,NaN,-9.944864978442757,52.20440379545771,-0.06390089155848538,0.34958220772993087,0.41348309928841626,743234498,757031083,77.92637777501484,82.25595498478155,NaN,NaN,15.899911813277686,19.39601173329564
2018-08-02T09:30:00-04:00,52.43,52.87,52.12,52.71,17291919,15744520.95,57.46303374535596,57.66370634736594,NaN,NaN,49.32915224618299,41.2280040406234,-0.053459969302857735,0.3466581376598441,0.40011810696270184,760526417,754491457.8,75.50190883695787,81.28297461054505,NaN,NaN,15.73906954233077,18.87359142030066
2018-08-03T09:30:00-04:00,52.73,53.4352,52.55,53.3,15416611,15895518.6,62.774770616938234,57.73606669102232,NaN,NaN,191.6885548825711,61.26809572776229,-0.010108720330976761,0.3874822065489809,0.3975909268799577,775943028,758184774.6,76.64014878638092,80.31205019565597,NaN,NaN,17.313490039106778,18.65071979441582
2018-08-06T09:30:00-04:00,53.35,53.65,53.24,53.34,12199055,15108633.05,63.11109508691539,57.87373023801627,NaN,NaN,232.97570615609155,108.86113085352709,0.01652086446072698,0.41824200745586637,0.4017211429951394,788142083,766213176.8,78.93169403729318,79.47362025395402,NaN,NaN,18.664360049266122,18.652668402251578
2018-08-07T09:30:00-04:00,53.24,53.345,52.84,53.26,13108200,14408590.5,61.9064158542227,58.203679151337376,NaN,NaN,149.96640197683382,122.80299005664733,0.023577893208627743,0.43119350950592406,0.4076156162972963,775033883,768575981.8,79.56698724882585,78.72226418032513,NaN,NaN,19.417961419468345,18.761995976139687
2018-08-08T09:30:00-04:00,53.08,53.159,52.79,52.98,17006025,14170276.15,57.75132621599109,57.90525945706285,NaN,NaN,95.21439799214158,143.83484265076422,0.005180010352065723,0.4140906292373785,0.40891061888531277,758027858,771534653.8,80.36538730841512,78.1409557570421,NaN,NaN,18.85665627984976,18.775518876669697
2018-08-09T09:30:00-04:00,52.97,53.25,52.785,53.22,8681114,13747494.7,60.216169042426216,58.148959630845766,NaN,NaN,104.32171678556207,154.83335555864002,0.004965308359608844,0.4151172543348238,0.410151945975215,766708972,772771164.8,80.70471952680678,77.97870613697627,NaN,NaN,19.091804322154353,18.820702511738933
2018-08-10T09:30:00-04:00,53.29,53.66,52.97,52.99,13300549,13864558.45,56.79638915045696,58.48039705954202,NaN,NaN,112.9780290059805,139.0912503833219,-0.013846892037195968,0.39284333092872004,0.406690222965916,753408423,768264243.8,75.57772098428218,77.86659795571904,NaN,NaN,18.30332234689981,18.74679105961906
2018-08-13T09:30:00-04:00,53.08,53.16,52.81,53.06,17273381,14203567.7,57.58588585286024,58.72774650214431,NaN,NaN,67.33100907587861,105.96231096727931,-0.024152618496750322,0.3764994498449781,0.4006520683417284,770681804,764772188,71.77309600998363,77.60982398309845,NaN,NaN,17.869362506804567,18.621444123502705
2018-08-14T09:30:00-04:00,53.08,53.3752,53.02,53.17,9943892,14148087.75,58.85819583896109,58.94938648593047,NaN,NaN,90.39231073891904,94.04749271969635,-0.02597865342397132,0.3681787515617643,0.3941574049857356,780625696,765890550.6,72.25481288936632,77.34632910516514,NaN,NaN,17.847944512112573,18.510944179018402
2018-08-15T09:30:00-04:00,53.34,53.98,53.2301,53.66,19265574,14593302.25,64.03384286944876,59.145219846693315,NaN,NaN,147.01413002175806,104.40743912561966,0.0019158646474166652,0.3965522357950064,0.39463637114758976,799891270,774263233,75.61061357671632,77.25281286098993,NaN,NaN,19.33958400717075,18.62932129732588
2018-08-16T09:30:00-04:00,53.54,54.275,53.43,54.24,13273020,14700984.3,69.00432989863086,59.86816243802161,NaN,NaN,172.4178552522549,118.0266668189582,0.052715595925253544,0.4605308660541567,0.4078152701289032,813164290,783554296.6,78.69070173929819,77.31676917067102,NaN,NaN,22.276289072042083,19.150316693713908
2018-08-17T09:30:00-04:00,54.21,54.755,54.11,54.52,14115082,14715313.65,71.08205040015301,61.049894343599945,NaN,NaN,207.31365020041764,136.89379105784565,0.09594341658533123,0.5277445408605672,0.431801124275236,827279372,798328486.4,82.47971671202778,77.57149126370493,NaN,NaN,25.400408481264297,20.043186949078247
2018-08-20T09:30:00-04:00,54.63,54.66,54.195,54.33,9574616,14455858.1,67.7626712186295,61.65510534671528,NaN,NaN,176.57482257140424,158.74255375695077,0.10194626012483032,0.5592339494312739,0.4572876893064436,817704756,807733076.8,84.38328223213742,77.88622626167901,NaN,NaN,26.982611204490976,21.034533271280065
2018-08-21T09:30:00-04:00,54.25,54.28,53.775,53.94,11850849,14263460.35,61.42224709970418,62.12631592076388,NaN,NaN,112.1268115020784,163.08945390958266,0.07130664128327197,0.5464209909105335,0.47511434962726157,805853907,812778719,85.30571837875561,78.41332201908908,NaN,NaN,26.38645980193034,21.799094204230105
2018-08-22T09:30:00-04:00,53.99,54,53.335,53.54,12652563,14222653.45,55.66890091927593,61.99816357604387,NaN,NaN,53.90180497661515,144.46698890055407,0.018505717455463144,0.49824649644659047,0.4797407789911273,793201344,811440733.8,83.89064286397047,79.01251730673285,NaN,NaN,24.040448117656556,22.119287620433884
2018-08-23T09:30:00-04:00,53.52,53.88,53.395,53.5,11168073,13827507,55.11295418958409,61.45089097409001,NaN,NaN,43.31090748713479,118.64559934753004,-0.022485390624505996,0.45163404071049484,0.47411943133500084,782033271,805214530,77.45204820691488,79.07051012248527,NaN,NaN,21.99876520199535,22.102070132085522
2018-08-24T09:30:00-04:00,53.44,53.78,53.23,53.73,7846320,13432418.05,57.727130018384706,61.06632204062354,NaN,NaN,36.44785382564953,84.4724400725764,-0.03664349538340966,0.4283150621057388,0.46495855748914844,789879591,797734573.8,70.45595371748885,78.4651000996421,NaN,NaN,21.03814755305815,21.95008119222447
2018-08-27T09:30:00-04:00,53.77,53.92,53.13,53.4,12384078,13577803.35,52.96125321811347,60.42738185233002,NaN,NaN,16.585694853906727,52.47461452907693,-0.06889537605540075,0.3788393374198975,0.44773471347529825,777495513,789692725.2,63.785070742508736,77.33782034919089,NaN,NaN,18.762681993492894,21.49473844954853
2018-08-28T09:30:00-04:00,53.27,53.47,53.13,53.29,10066151,13320121.6,51.436847336938854,59.976347646683436,NaN,NaN,-17.34013486923108,26.58122525481503,-0.09660047551848211,0.3269841190771956,0.4235845945956777,767429362,782007816.2,58.12174206894418,75.74898854637152,NaN,NaN,16.43920900657843,20.77251995769566
2018-08-29T09:30:00-04:00,53.42,53.68,53.34,53.68,11911219,12916414.55,56.24548288704026,59.692727207013,NaN,NaN,18.602047272033598,19.521273713898726,-0.0878743895784369,0.3137416076226316,0.4016159972010685,779340581,779235663.6,56.18385981957784,73.99749856728374,NaN,NaN,15.822058810622455,20.065311222399487
2018-08-30T09:30:00-04:00,53.77,53.99,53.51,53.7,13475708,12725604,56.483451404554025,59.67037451087708,NaN,NaN,42.16343610053627,19.291779436579013,-0.0801836303647282,0.3013864592451583,0.3815700896098865,792816289,781392267.2,57.3745415785428,72.69727146687379,NaN,NaN,15.390400528122386,19.39746683750276
2018-08-31T09:30:00-04:00,53.78,54,53.265,53.47,12132467,12561396.8,52.91901488534886,59.337026584626265,NaN,NaN,6.7015982173080495,13.342528314910709,-0.08931661743317737,0.26992431781841475,0.3592409352515921,780683822,779553113.4,55.97750578651912,71.56901502234061,NaN,NaN,13.996746436999427,18.625935351716567
2018-09-04T09:30:00-04:00,53.53,54,53.48,53.71,12965095,12599698.8,56.03667172626843,59.13548914800537,NaN,NaN,35.81051912332211,17.18749316879379,-0.07831776383515082,0.2613437304576536,0.3396614942928044,793648917,782783794.2,57.9160063685959,70.5448145565713,NaN,NaN,13.687188089612551,17.920400028558852
2018-09-05T09:30:00-04:00,53.65,54.49,53.65,54.46,14834843,12686030.95,64.04854311078796,59.13653916524389,NaN,NaN,121.44388055755275,44.94429625415056,-0.02255173003345512,0.3114718317509855,0.3340235617844406,808483760,790994673.8,62.4425592474611,69.60423924733877,NaN,NaN,15.992254696256564,17.64495069537281
2018-09-06T09:30:00-04:00,54.49,54.94,54.33,54.77,12352821,12453370.75,66.74610283389723,58.97523723204863,NaN,NaN,182.66292851624303,77.75647250299244,0.030321785269331436,0.3719257933711049,0.34160400810177344,820836581,799293873.8,66.37890903862498,68.72482548300498,NaN,NaN,18.801255603568947,17.8101371108294
2018-09-07T09:30:00-04:00,54.24,54.5,53.975,54.1,16183467,12828488.4,56.82243523472829,57.95669329166115,NaN,NaN,80.31206982725999,85.38619924833718,0.01600018894948385,0.36160424428862825,0.3456040553391444,804653114,801661238.8,67.42763182241055,67.64967656231804,NaN,NaN,17.91468651385582,17.825072739833175
2018-09-10T09:30:00-04:00,54.21,54.59,54.17,54.37,9932444,12660083.15,59.43954964569487,57.36218460788011,NaN,NaN,99.43994687837836,103.93386898055124,0.020264896516084874,0.3709351759842505,0.35067027946816565,814585558,808441586,70.28637975948801,66.64275495712879,NaN,NaN,18.072978900117523,17.86048790558808
2018-09-11T09:30:00-04:00,54.35,54.57,54.12,54.23,9046926,12248760.4,57.49359382596621,57.081566516898825,NaN,NaN,77.46530905120194,112.2648269661272,0.009744146300865952,0.3628504623442481,0.35310631604338216,805538632,810819529,71.23973254504409,65.63804168329226,NaN,NaN,17.57782630255313,17.82010767658309
2018-09-12T09:30:00-04:00,54.22,54.52,54.06,54.18,9809863,12242058.95,56.77865445459024,57.16083462656413,NaN,NaN,60.761064713698644,100.12826379735638,-0.0037709464359537703,0.3483926329984399,0.3521635794343937,795728769,808268530.8,68.69344885640663,64.55252782560912,NaN,NaN,16.966905564389336,17.698221660555408
2018-09-13T09:30:00-04:00,54.16,54.61,53.905,54.59,8774233,11717491.9,61.05524143256038,57.58528371534816,NaN,NaN,74.94141528138884,78.58396115038555,0.010910368544480131,0.3658015401149939,0.35489117157051375,804503002,805001815,65.46651818004233,63.69641853797536,NaN,NaN,17.7570649278112,17.70662784159195
2018-09-14T09:30:00-04:00,54.37,54.42,53.84,54.3,13067644,11707223.1,56.7760379963202,57.51734857091498,NaN,NaN,37.856913699054516,70.09292992474445,-0.002202204773322447,0.3521384156038607,0.35434062037718317,791435358,802358263.8,62.891801731994136,63.156121967582884,NaN,NaN,17.103450700489773,17.62045967857735
2018-09-17T09:30:00-04:00,54.2,54.56,54.14,54.48,14259109,11714424.45,58.710408909547226,57.92800254887454,NaN,NaN,77.02204041383267,65.60934863183533,-0.0020487447941065495,0.35177968938454995,0.3538284341786565,805694467,800580045.6,61.14964933524106,62.96787758134949,NaN,NaN,17.145057567649143,17.552545091301894
2018-09-18T09:30:00-04:00,54.4,54.56,54.12,54.38,9767516,11724069.45,57.179436961285596,58.33818752204217,NaN,NaN,70.37759811664051,64.19180644492305,-0.011452713140923887,0.33951254275250164,0.35096525589342553,795926951,798657709.4,59.23922240258471,63.047697605180964,NaN,NaN,16.73435481834258,17.435660766593422
2018-09-19T09:30:00-04:00,54.36,54.36,52.95,53.2,25510011,12407027.55,42.94767978559532,57.38834444336753,NaN,NaN,-78.12522778629716,36.41454794492388,-0.09525109471746696,0.23190138749659184,0.3271524822140588,770416940,793595343.6,54.417686570791005,62.92154237312476,NaN,NaN,11.32396964514994,16.56256203495864
2018-09-20T09:30:00-04:00,53.13,53.3551,52.69,53.31,17814538,12665126.3,44.33849351183614,56.52084745103054,NaN,NaN,-132.2487823748977,-5.02349158633343,-0.13874372077764718,0.1537228312419998,0.292466552019647,788231478,790341038.8,51.515006348900116,62.503004142436,NaN,NaN,7.560056184306324,15.276489770579737
2018-09-21T09:30:00-04:00,52.75,53.25,52.51,53.06,20355957,13124520.5,41.841947610653946,55.72962835998091,NaN,NaN,-144.57179665325253,-41.509233656794834,-0.17735165877591613,0.07077697854975185,0.24812863732566798,767875521,785629071.4,47.55930620542176,61.90170417235761,NaN,NaN,3.671211258638121,13.618592840302362
2018-09-24T09:30:00-04:00,52.88,53.07,52.541,52.59,13526848,13408546.9,37.56012931257765,54.40987533043157,NaN,NaN,-154.57906406870256,-87.82945455330187,-0.22450974275763885,-0.032508541121380574,0.19200120163625828,754348673,775359912.6,40.296928585508454,60.6431986164228,NaN,NaN,-1.0841264796599253,11.518204366022037
2018-09-25T09:30:00-04:00,52.44,52.47,51.7837,51.87,20023832,13790534.6,32.13495859549754,52.130333579339386,NaN,NaN,-209.16563269207703,-143.7381007150454,-0.28999750074759667,-0.17049567429823753,0.11950182644935911,734324841,763039490.6,33.65660785623041,58.58705923133489,NaN,NaN,-7.195561014400245,8.844809311675997
2018-09-26T09:30:00-04:00,52.12,52.14,51.34,51.36,24082197,14491336.9,28.945680055458865,49.4303033808795,NaN,NaN,-214.91626853582827,-171.0963088649516,-0.34947829444751677,-0.3173460416100369,0.032132252837479905,710242644,751004631.4,28.684266136231656,55.8945847383068,NaN,NaN,-13.406518835630882,5.666048147775014
2018-09-27T09:30:00-04:00,51.49,52.17,51.37,51.89,16456829,14718617.4,36.04886819489176,47.94647716374832,NaN,NaN,-159.47159569291426,-176.54087152855493,-0.33490905571597,-0.3865040668074826,-0.0515950110915126,726699473,738698230.4,24.670569600798544,52.84050886533451,NaN,NaN,-16.08150989233394,2.5592541420451638
2018-09-28T09:30:00-04:00,52,52.69,51.93,52.65,15427428,14816203.4,44.60121795156353,46.886596328453216,NaN,NaN,-91.49116640969854,-165.92474547984412,-0.25924904665156545,-0.37565631940596944,-0.11640727275440398,742126901,733548506.4,23.20717755554938,49.477708707910324,NaN,NaN,-15.249945334846151,0.01508278820354736
2018-10-01T09:30:00-04:00,52.49,52.59,52.27,52.47,12582913,14838725.7,43.130054845658165,45.86062925843122,NaN,NaN,-79.29789620991177,-150.86851190808596,-0.2086624719354096,-0.377235362673666,-0.16857289073825638,729543988,728587569.4,21.861835912949346,45.95071609133213,NaN,NaN,-15.105453976652658,-2.144993892490196
2018-10-02T09:30:00-04:00,52.57,53.32,52.57,53.18,15833225,14982132.2,50.11911507682361,45.384947874305034,NaN,NaN,-31.86236351316207,-115.40785807230297,-0.11916996717322187,-0.3175353497047837,-0.19836538253156183,745377213,730798043.8,23.976609870328744,42.756656163755146,NaN,NaN,-12.50564276940482,-3.6250865891922848
2018-10-03T09:30:00-04:00,53.09,53.37,52.09,52.54,24676296,15474204.85,44.77717543079887,44.22222887417921,NaN,NaN,-52.78357259586403,-82.98131888431013,-0.09586555786333481,-0.31819732986073035,-0.22233177199739554,720700917,732889698.4,26.017039495663212,39.938836257728056,NaN,NaN,-12.219719434819469,-4.85289128142474
2018-10-04T09:30:00-04:00,52.41,52.93,52.02,52.82,24075922,16060359.9,47.41774451577602,43.55377933985462,NaN,NaN,-52.88645426810332,-61.66429059934794,-0.05633747244096471,-0.29275361254860144,-0.23641614010763673,744776839,736505171.6,29.53744456496662,37.556382174368956,NaN,NaN,-11.09312411513039,-5.744353114811261
2018-10-05T09:30:00-04:00,52.74,53.8033,52.7,53.63,30389980,16770685.55,54.23519790705928,43.234121411105484,NaN,NaN,12.504335435983178,-40.86519023021159,0.025238937627927477,-0.20486746807272738,-0.23010640570065485,775166819,743113155.2,35.57173057709683,35.729387977358655,NaN,NaN,-7.705367528652538,-6.024498031074301
2018-10-08T09:30:00-04:00,53.84,54.44,53.595,54.08,21489265,17348526.6,57.52963443038834,43.2591355160414,NaN,NaN,69.98403209533353,-11.00880456916254,0.10586216914087626,-0.09777869427455954,-0.2036408634154358,796656084,756535574.4,45.73697897535174,34.76494201827058,NaN,NaN,-3.8225745986771136,-5.709937540731845
2018-10-09T09:30:00-04:00,54.03,54.54,53.95,54.3,18113753,17801867.95,59.08050196047156,44.411479957103985,NaN,NaN,89.42860047624023,13.249388228717908,0.16674221980635956,0.004786911342513633,-0.16195530846384593,814769837,770414099.2,53.84567665277124,34.72408416698345,NaN,NaN,-0.23867737274654932,-4.928328945305374
2018-10-10T09:30:00-04:00,54.21,54.885,53.98,54,30583966,18840573.1,56.07352684468545,45.24969662373608,NaN,NaN,91.17413911621846,42.0409305711344,0.17849096991762434,0.0611584039331845,-0.11733256598443983,784185871,783111090,59.76881821432054,35.31364215737063,NaN,NaN,1.7311740202602024,-3.976971378796006
2018-10-11T09:30:00-04:00,54.15,54.28,52.74,53.01,42894793,20546601.1,47.484630796846204,45.65274542274981,NaN,NaN,16.89738004885384,55.99769743452583,0.11438827871860358,0.025652782413814634,-0.08873549630478894,741291078,782413937.8,59.31868329265127,36.15359766360131,NaN,NaN,0.5838041247841053,-3.3254320211417046
2018-10-12T09:30:00-04:00,52.94,53.11,52.505,52.95,21869069,20986672.35,47.014614311509426,46.32806577981636,NaN,NaN,-22.929298401308106,48.91097066706758,0.06519345591509866,-0.0072436764109156115,-0.07243713232601427,719422009,771264975.8,52.5080784892019,37.02582265672227,NaN,NaN,-0.4566568018874033,-2.9156069898196617
2018-10-15T09:30:00-04:00,52.94,53.535,52.88,53.2,18353436,21191388.7,49.267900239300204,47.551847325802264,NaN,NaN,18.62882010162549,38.63992826832597,0.047556356820608624,-0.012991686300253491,-0.060548043120862115,737775445,759488848,46.44261983428314,37.93910922658318,NaN,NaN,-0.6147976752838749,-2.586919944885978
2018-10-16T09:30:00-04:00,53.14,54.045,52.975,53.75,17937849,21599905.35,53.91155208750182,49.335123899519616,NaN,NaN,68.37269401237364,34.428746975552656,0.0696605020391259,0.02652758442804526,-0.04313291761108064,755713294,747677539.4,41.29069093264456,38.83956814061268,NaN,NaN,0.704220438255579,-2.1167570330086125
2018-10-17T09:30:00-04:00,53.68,53.91,53.36,53.65,14258474,21037328.5,52.962334175349405,50.54322861240945,NaN,NaN,72.46838101547966,30.68759535540489,0.07387470160297074,0.0492104593926328,-0.024664242210337948,741454820,739131329.2,38.005505412060565,39.79206355570282,NaN,NaN,1.4843069777251325,-1.6023193171895063
2018-10-18T09:30:00-04:00,53.79,54.06,53.45,53.73,16519079,20972555.55,53.665189838088644,51.19065517573267,NaN,NaN,76.78540107314684,42.6651995602635,0.07797371861044226,0.07280290605271489,-0.0051708125577273785,757973899,742467893.4,40.012200017908654,40.99242230301418,NaN,NaN,2.3217862194579406,-1.041732811954157
2018-10-19T09:30:00-04:00,53.74,54.86,53.57,54.57,29925455,21451030.45,60.36250278482376,52.4215443142445,NaN,NaN,120.55533539145229,71.36212631881558,0.13010937080245946,0.15746590094534696,0.027356530142887494,787899354,756163362.4,47.521079884627206,42.82522544384832,NaN,NaN,5.168238596374045,-0.15459403933584237
2018-10-22T09:30:00-04:00,54.63,54.69,54.09,54.22,12249984,21387187.25,56.68593990183021,52.8906032303164,NaN,NaN,107.18763301923727,89.07388890233793,0.1333808527483893,0.19408259607837408,0.060701743329984806,775649370,763738147.4,51.162288886092185,44.76705965926,NaN,NaN,6.442805461087331,0.7878916035817538
2018-10-23T09:30:00-04:00,54.32,54.67,53.7,53.92,18924588,21332225.05,53.66854287624466,53.5257009049911,NaN,NaN,78.21287839102845,91.04192577806889,0.10874060419818735,0.196627498577719,0.08788689437953165,756724782,763940445,51.259553602234604,46.57009638115795,NaN,NaN,6.605113604644823,1.6189233180193352
2018-10-24T09:30:00-04:00,54.16,55.49,53.9328,55.23,29163390,21586284.7,62.94425701012172,54.63473751173008,NaN,NaN,142.14026886307468,104.9763033475879,0.17039610317167286,0.30088202334412273,0.13048592017244987,785888172,772827115.4,55.45635837652775,48.421447367698036,NaN,NaN,9.923892882898878,2.805347541573555
2018-10-25T09:30:00-04:00,54.87,54.87,54.1,54.37,29911242,22259005.35,55.139709803295574,54.69934550431839,NaN,NaN,91.95813647009493,108.0108504269775,0.1440353240584419,0.31053007524550225,0.16649475118706034,755976930,772427721.6,55.226202865669556,49.82533824545323,NaN,NaN,10.026169806462166,3.8368935794147854
2018-10-26T09:30:00-04:00,54.66,54.82,53.0012,53.37,36893032,23332285.55,47.728994672085605,53.999299807296765,NaN,NaN,9.989488740497587,85.89768109678657,0.05462676402601041,0.23477820621957335,0.18015144219356294,719083898,758664630.4,47.85561269466127,49.97666922540391,NaN,NaN,7.404957029158668,4.346616929378197
2018-10-29T09:30:00-04:00,53.49,54.355,53.49,54.12,24973238,23951801.8,52.84753353207991,53.554087776697365,NaN,NaN,34.09288404904215,71.27873130274754,0.04194442704528506,0.23258197600016928,0.19063754895488422,744057136,752346183.6,44.89338484972318,49.33721981090048,NaN,NaN,7.115080013556714,4.742111655689413
2018-10-30T09:30:00-04:00,54.33,54.66,53.69,54.33,25065461,24413413.6,54.19989969437129,53.42025726596064,NaN,NaN,58.360278323962326,67.30821128933432,0.04346029100526444,0.24496291271146475,0.2015026217062003,769122597,754825746.6,46.29821493250089,48.375033862199075,NaN,NaN,7.350724855444445,5.114770684225847
2018-10-31T09:30:00-04:00,53.88,54.2101,53.37,53.69,25143008,24436749.2,49.53691293819638,53.56684884748565,NaN,NaN,-11.768628431630642,36.526431830393264,-0.0005482208829473145,0.20081734560251618,0.2013655664854635,743979589,746444030,42.36647401387959,47.16416177085824,NaN,NaN,5.9657524734359635,5.2363395112558635
2018-11-01T09:30:00-04:00,53.77,53.8,53.1,53.45,27027370,24584321.6,47.87358604101657,53.62820397102188,NaN,NaN,-69.8335310592254,4.168098324529204,-0.04525521565193427,0.14479654692054567,0.19005176257247994,716952219,738639087.8,39.04163907319642,46.202273241143565,NaN,NaN,4.3282968463862455,5.106619130560204
2018-11-02T09:30:00-04:00,53.6,53.74,52.8,53.15,24136562,24271650.7,45.80325537969627,53.38072933819303,NaN,NaN,-102.53919475320498,-18.337638374211302,-0.09178230545652444,0.07532388075182439,0.16710618620834883,692815657,733385439.6,36.94017166829064,45.52352694357267,NaN,NaN,2.3465808501688343,4.712327947647151
2018-11-05T09:30:00-05:00,53.39,54.09,53.26,53.9,21253302,24259852.55,51.455354621799145,53.20528666207141,NaN,NaN,-17.376232156201098,-28.63146161525996,-0.06979343119007675,0.07986439722075289,0.14965782841082964,714068959,727387804.2,34.64735931593572,45.049003256664896,NaN,NaN,2.4288072610312392,4.386110706702021
2018-11-06T09:30:00-05:00,53.85,54.38,53.78,54.26,13068145,24007572.15,53.938491475698406,53.27501218352491,NaN,NaN,47.19483658869029,-30.864549962314364,-0.03074258668409477,0.11122959505571117,0.14197218173980594,727137104,718990705.6,31.682382441169935,44.597351615886986,NaN,NaN,3.272562517936616,4.227032394021249
2018-11-07T09:30:00-05:00,54.66,54.96,54.23,54.88,20725363,23514642,57.92973680940769,53.579622681476266,NaN,NaN,127.05961766599349,-3.098900742789536,0.033617921591505534,0.18399458372918787,0.15037666213768233,747862467,719767281.2,32.259729909598676,44.0436037510077,NaN,NaN,5.257094983859742,4.374184192569605
2018-11-08T09:30:00-05:00,54.93,55.11,54.33,54.79,20584134,22399109.05,57.15551761838558,53.35055231244497,NaN,NaN,119.6893957777105,34.805684624597646,0.06508098923967987,0.23172789868728216,0.1666469094476023,727278333,721832504,33.86051566506934,43.067849163896426,NaN,NaN,6.615376337468907,4.694354498983791
2018-11-09T09:30:00-05:00,54.6,55.11,54.49,54.87,20015192,22306415.2,57.696730926930606,53.42275167138071,NaN,NaN,120.98153190556665,79.50982995635198,0.08497590254553797,0.27286678762952477,0.1878908850839868,747293525,732728077.6,41.68942847539185,42.391216277417826,NaN,NaN,7.876605419763437,5.148961773380883
2018-11-12T09:30:00-05:00,54.47,55.405,54.07,54.84,27664145,22771950.65,57.40389062464692,53.68956222483802,NaN,NaN,103.49596233714193,103.68426885502058,0.08936357630104302,0.2995953554602906,0.21023177915924757,719629380,733840161.8,42.43836673173657,41.76113150095368,NaN,NaN,8.834452535028356,5.675460453616236
2018-11-13T09:30:00-05:00,54.83,55.19,54.41,55.07,23758185,23062967.45,59.11710816477471,53.41619445017037,NaN,NaN,109.34839953819535,116.1149814449216,0.1001905185487971,0.33546992734524395,0.23527940879644685,743387565,737090254,44.67484187275368,40.991023179255535,NaN,NaN,10.11749991197697,6.310037519096341
2018-11-14T09:30:00-05:00,54.6,54.96,54.3132,54.5,27577820,23728934.75,53.38644021659196,53.29096090826298,NaN,NaN,57.19154548017158,102.14136700775721,0.06320341782247058,0.3142836810745351,0.2510802632520645,715809745,730679709.6,41.26889606765943,39.994072693683385,NaN,NaN,9.677304537641554,6.7910756646028005
2018-11-15T09:30:00-05:00,54.22,54.27,53.565,54.05,34281190,24617040.3,49.32153010700147,53.4047134393284,NaN,NaN,-45.69236476599309,69.06501489901649,0.005700392494463136,0.25820575387014344,0.2525053613756803,681528555,721529754,36.93997145871711,39.21438403397308,NaN,NaN,8.12789148672558,6.982049353477484
2018-11-16T09:30:00-05:00,54.88,55.14,54.47,54.88,21406379,24191086.5,55.979278803385284,53.62840953013592,NaN,NaN,86.5951567466054,62.18773986722424,0.020026404031604605,0.27753836641518603,0.2575119623835814,702934934,712658035.8,33.293369533206814,38.38581151136477,NaN,NaN,8.72679785723933,7.231299139729176
2018-11-19T09:30:00-05:00,54.8,55.17,54.57,55.12,14571955,24307185.05,57.70935811881277,53.879085131881745,NaN,NaN,94.06533547107824,60.301614494011496,0.04092440524061114,0.3086674689343454,0.26774306369373424,717506889,712233537.6,33.12486996920215,37.444858299700584,NaN,NaN,9.736814320149755,7.589229879789259
2018-11-20T09:30:00-05:00,55.28,55.67,54.56,54.89,24428443,24582377.8,55.45984370911335,54.30215161551866,NaN,NaN,95.15635215083906,57.463205016540236,0.03475851750765874,0.3111912105783077,0.27643269307064894,693078446,702171713.8,29.33509002011141,36.51404515728857,NaN,NaN,9.929295449466343,7.923524961171699
2018-11-21T09:30:00-05:00,54.7,54.77,53.93,54.08,18909702,24069693.4,48.316810636798564,54.33381051521739,NaN,NaN,-7.704853495316923,44.483925221442526,-0.02514073218241275,0.24500677784263303,0.2701475100250458,674168744,693843513.6,26.62032470290376,35.62680841655338,NaN,NaN,7.897005288629878,7.919736436522868
2018-11-23T09:30:00-05:00,54.15,54.24,53.75,54.11,8117894,22980026,48.580959597457024,54.53221795934314,NaN,NaN,-36.86384606603517,46.24962896143412,-0.06191485609050307,0.19275393991191692,0.25466879600242,682286638,693995130.2,26.753221243837515,34.899169100521014,NaN,NaN,6.342762888892936,7.694454501147163
2018-11-26T09:30:00-05:00,54.17,54.4601,53.88,54.43,16101081,21940428.45,51.43237117063066,54.53057628425968,NaN,NaN,-9.360400849634203,27.0585174421862,-0.06361859983671811,0.17514554620652234,0.23876414604324045,698387719,693085687.2,26.443852782937824,34.31320434816402,NaN,NaN,5.838502360651094,7.429318481076296
2018-11-27T09:30:00-05:00,54.39,54.9,54.17,54.84,13190848,21351308.95,54.88445039913136,54.5981447787906,NaN,NaN,42.6673654525131,16.778923438473168,-0.037363006259826,0.19206038821845794,0.22942339447828394,711578567,691900022.8,26.02137758386462,33.9088468583565,NaN,NaN,6.40813266456997,7.2834347930039645
2018-11-28T09:30:00-05:00,54.9,55.06,54.6143,54.8,12062215,20701146.65,54.47762055695607,54.35156504647262,NaN,NaN,64.27527531773386,10.602708071852126,-0.02359219418072092,0.1999331517523828,0.22352534593310372,699516352,693187604,27.37825525978083,33.560170097655224,NaN,NaN,6.761582411834626,7.208884452836916
2018-11-29T09:30:00-05:00,54.88,54.88,54.22,54.78,17489582,20318475.35,54.26104654779913,54.14481711285931,NaN,NaN,31.10679629631413,18.36503803017834,-0.01703836533928807,0.20222738925899364,0.2192657545982817,682026770,694759209.2,29.08790939176201,33.219269649561845,NaN,NaN,6.997000601512545,7.178615331219149
2018-11-30T09:30:00-05:00,54.91,55.64,54.77,55.59,18166880,19875450.85,61.01987123485044,54.38218427771072,NaN,NaN,135.55968912727656,52.84974506884068,0.037655930537193405,0.26633566776977347,0.22867973723258006,700193650,698340611.6,32.961048887505626,32.59581396471283,NaN,NaN,9.197626439930621,7.467045489606502
2018-12-03T09:30:00-05:00,55.41,56.15,55.09,56.15,17906948,19563970.15,64.88340769819479,54.91643549724985,NaN,NaN,214.42073893269992,97.6059730253075,0.10361633171040296,0.35820015187058374,0.2545838201601808,718100598,702283187.4,37.037977744601854,32.21007189420321,NaN,NaN,12.32223965071095,8.160644655478565
2018-12-04T09:30:00-05:00,56.29,56.805,56.045,56.19,22267960,19614703.05,65.14912029191746,55.34729350633148,NaN,NaN,272.3636220574255,143.54522434628998,0.13975900843439398,0.42928258070317327,0.2895235722687793,740368558,708041185.6,42.53451475853678,32.05719138604486,NaN,NaN,14.93083041491498,9.127814049683767
2018-12-06T09:30:00-05:00,56.42,56.44,55.1,56.25,24697925,20196192.05,65.56995668022634,56.21754468230536,NaN,NaN,167.88588611350934,164.2673465054451,0.15627566852791525,0.4848681579286733,0.3285924894007581,765066483,721151211.8,52.66652453758055,32.87130770532493,NaN,NaN,17.20457152231178,10.281636545773484
2018-12-07T09:30:00-05:00,56.17,56.785,55.79,56.46,19729807,20146414.25,67.06881184160514,57.48520766334848,NaN,NaN,182.49712741208424,194.5454127285991,0.16884175671474722,0.5396446852941921,0.37080292857944486,784796290,741705115.8,63.52481534391794,34.77022512569643,NaN,NaN,19.569995300032435,11.608544939239048
2018-12-10T09:30:00-05:00,56.46,56.75,55.48,56.57,21148439,20174629.5,67.85812861408398,58.33369693554124,NaN,NaN,140.74624012920432,195.58272292898465,0.17150637696004117,0.5851858997794963,0.41367952281945514,805944729,762855331.6,70.91787722195724,37.45768996060717,NaN,NaN,21.786736847278462,13.06257235467325
2018-12-11T09:30:00-05:00,56.64,56.99,56.34,56.8,26093465,20478543.15,69.50403865163972,59.176174116457446,NaN,NaN,153.89589551894287,183.47775424623325,0.17509248705940927,0.6325451316437167,0.45745264458430746,832038194,785642850.8,76.4550857910448,40.55270537645307,NaN,NaN,24.16461224306582,14.648578053015045
2018-12-12T09:30:00-05:00,56.74,57.11,56.41,56.44,18297528,20010212.3,63.98138368594747,59.78485554337417,NaN,NaN,125.12325036647957,154.02967990804405,0.14101668648190768,0.6337235026866921,0.4927068162047844,813740666,800317272.4,79.20138483710704,44.11458357766704,NaN,NaN,24.77884303931347,16.09575876534339
2018-12-13T09:30:00-05:00,56.48,57.175,56.47,56.93,18072011,19725903.6,67.73885683141356,61.17214455727524,NaN,NaN,122.29566233845259,144.9116351530327,0.13904504839024656,0.6665131266925926,0.527468078302346,831812677,813666511.2,81.33430708145542,48.02272517613502,NaN,NaN,26.411834489567525,17.56948386880398
2018-12-14T09:30:00-05:00,56.98,57.11,56.49,56.82,25155565,19604790.85,66.07248921312647,62.42153952982306,NaN,NaN,103.58635356078987,129.12948038277386,0.1186915238286721,0.6758324830881861,0.557140959259514,806657112,818038675.6,81.98590214705648,51.967916669222085,NaN,NaN,27.309360740167865,18.960894850427394
2018-12-17T09:30:00-05:00,56.93,56.965,54.77,54.99,30217828,19401622.75,45.8603136129556,62.02353541856055,NaN,NaN,5.726958309579986,102.12562401884898,-0.022153349423820856,0.5294492724797379,0.5516026219035588,776439284,812137586.6,78.02679025043719,55.652412202614904,NaN,NaN,20.960136410219036,19.246500787540487
2018-12-18T09:30:00-05:00,55.3,55.69,54.46,54.62,23635568,19513082.2,42.99640066527728,61.17438900899954,NaN,NaN,-47.60023251749605,61.82639841156119,-0.13791226360114306,0.37921229240212995,0.517124556003273,752803716,796290691,68.46529534529206,58.684120614145435,NaN,NaN,14.888226662337331,18.62389019822575
2018-12-19T09:30:00-05:00,54.73,55.17,54.21,54.53,27928445,20180906.7,42.30435721613163,60.304870198940655,NaN,NaN,-68.30014662503855,23.14171901325757,-0.21369623524775416,0.2500042619435803,0.46370049719133444,724875271,778517612,59.63834299238731,60.988412595045894,NaN,NaN,9.947895979150786,17.384462452643614
2018-12-20T09:30:00-05:00,54.58,55.28,53.88,54.5,39428821,20930925.6,42.06133401784723,59.43346216108695,NaN,NaN,-70.94072406315077,-15.505558267063112,-0.25613584956316365,0.14353068523737988,0.39966653480054354,685446450,749244366.6,48.538443893033794,62.37773648799388,NaN,NaN,5.977644136125719,15.754916978855343
2018-12-21T09:30:00-05:00,54.45,55.42,53.65,53.81,35661949,21768537.95,36.82193200607084,57.705037930459845,NaN,NaN,-91.39788703684933,-54.50240638659095,-0.31698698468791686,0.0034328039406474886,0.32041978862856435,649784501,717869844.4,39.95509833770424,62.87731144872235,NaN,NaN,0.7324201903663585,13.608846009071202
2018-12-24T09:30:00-05:00,53.71,54.11,51.35,51.56,22665349,22495910.7,25.616356806631032,54.90024858106243,NaN,NaN,-215.27650646338765,-98.70309934118447,-0.48502126540814305,-0.2858567931316145,0.19916447227652856,627119152,688005818,33.82384038903513,62.64773020903901,NaN,NaN,-9.355530763747504,10.328220755811387
2018-12-26T09:30:00-05:00,51.57,52.33,50.81,52.26,30839144,23232813.85,32.49875176703911,52.56807940071398,NaN,NaN,-215.13630945604828,-132.21031472889493,-0.5220596608104926,-0.4534101037365872,0.06864955707390541,657958296,669036734,30.610675721666468,61.79602742069113,NaN,NaN,-14.511051804299049,6.779753247224182
2018-12-27T09:30:00-05:00,52.28,52.77,51.4,52.7,29730674,24059805.15,36.477349897840064,50.49003605911495,NaN,NaN,-158.35722265271374,-150.22172993442996,-0.49045347224138247,-0.5444172832278227,-0.05396381098644021,687688970,661599473.8,29.430206480946126,60.136290416645814,NaN,NaN,-16.974256291912273,3.3863233130618315
2018-12-28T09:30:00-05:00,52.82,53.36,52.625,52.83,21087605,24511074.65,37.646722504415905,48.38845824931571,NaN,NaN,-107.86228138467837,-157.6060413987355,-0.4361446700487804,-0.5991446485474157,-0.1629999784986353,708776575,666265498.8,31.222249756341085,57.82896430324747,NaN,NaN,-18.433779647439184,0.26916574727597187
2018-12-31T09:30:00-05:00,52.85,53.07,52.37,52.92,16302162,24451703.65,38.490926366485155,46.290800945915805,NaN,NaN,-102.93159609120951,-159.9127832096075,-0.372011911238335,-0.628014867546554,-0.256002956308219,725078737,681324346,36.80020074248236,55.391987411856405,NaN,NaN,-19.294492809355106,-2.525642617957039
2019-01-02T09:30:00-05:00,52.71,52.76,51.7,52.01,25173884,24802053.85,33.545478722038865,43.72233237951574,NaN,NaN,-114.38502365294048,-139.73448664751805,-0.3680534053543766,-0.7160697130011897,-0.34801630764681313,699904853,695881486.2,41.72070946262722,52.91096053125516,NaN,NaN,-21.70295950948608,-5.265259316746902
2019-01-03T09:30:00-05:00,52.01,52.44,51.7576,52,21587458,24986079.35,33.49454977694077,41.54470138601526,NaN,NaN,-104.21006321359746,-117.54923739902793,-0.3437437012590487,-0.777695934220624,-0.4339522329615753,678317395,699953306,43.056191303626846,50.32916099314942,NaN,NaN,-23.586978252175328,-7.882647736093819
2019-01-04T09:30:00-05:00,51.76,52.795,51.69,52.77,19003613,24822862,40.93100058554379,39.62985451131028,NaN,NaN,-79.95922261374737,-101.86963739123465,-0.25739137604646606,-0.7556914530196579,-0.49830007697319184,697321008,701879713.6,43.71335477061653,47.64195011380379,NaN,NaN,-22.825890427546312,-10.017396692015604
2019-01-07T09:30:00-05:00,52.44,52.67,52.12,52.41,16296477,24402789.6,38.74942534087296,37.678207091863605,NaN,NaN,-72.31024180251026,-94.759229474801,-0.20820598256402356,-0.7585575551782213,-0.5503515726141978,681024531,696329304.8,42.20215123337347,44.80025361996928,NaN,NaN,-22.88102624892529,-11.855058057288415
2019-01-08T09:30:00-05:00,52.46,53.12,52.17,53.06,16643536,24248476.05,44.50114125255608,37.58112335183506,NaN,NaN,-51.23352727535228,-84.41961571162956,-0.11996409744242498,-0.7003066944172289,-0.580342596974804,697668067,690847170.8,40.70533157025633,42.134435142813516,NaN,NaN,-21.075426658984814,-13.172253571816473
2019-01-09T09:30:00-05:00,53.03,53.25,52.59,52.74,18074713,24094789.75,42.390672756109076,37.53785707260876,NaN,NaN,-43.07877692423919,-70.1583663658893,-0.07349785690108612,-0.6722149181011616,-0.5987170612000755,679593354,686784871,39.584934840304705,40.071552249600124,NaN,NaN,-20.245491292300702,-14.18271610331422
2019-01-10T09:30:00-05:00,52.8,53.53,52.73,53.43,25458134,24063023.2,48.10561552720734,37.952232666257025,NaN,NaN,-22.37718796728416,-53.79179131662662,0.008971738773884796,-0.5875023877327195,-0.5964741265066043,705051488,692131689.6,41.8535051204669,38.80120668732009,NaN,NaN,-17.694427262861613,-14.684389126106705
2019-01-11T09:30:00-05:00,53.36,53.4737,52.9,53.23,24842487,24390271.15,46.6607210982111,38.28076031485445,NaN,NaN,-17.913104640274035,-41.382567721931956,0.05286617826071538,-0.53039140368071,-0.5832575819414254,680209001,688709288.2,40.79751257347825,38.248283021637555,NaN,NaN,-16.066458906998864,-14.881827666234157
2019-01-14T09:30:00-05:00,52.6,53.2399,51.54,52.03,23489878,24661164.5,39.07677864151676,38.44182078881487,NaN,NaN,-64.06474122061765,-39.73346760555343,0.006343281592103955,-0.5753284799512954,-0.5816717615433994,656719123,683848206.6,39.281496880509465,38.200168631837926,NaN,NaN,-17.070846212070073,-15.194544601353574
2019-01-15T09:30:00-05:00,51.81,52.96,51.76,52.67,27093114,24758041.95,44.278529673102845,39.77483313642,NaN,NaN,-48.63010913933806,-39.21278397835058,0.022997401217601743,-0.5529250100213972,-0.5759224112389989,683812237,681077040.6,38.40535170770407,38.52741944031428,NaN,NaN,-16.176262969128757,-15.334790082464314
2019-01-16T09:30:00-05:00,52.57,52.88,52.27,52.86,18348187,24164559.9,45.75917586166678,40.72200628603627,NaN,NaN,-26.616885350226447,-35.92040566354804,0.04960624979643191,-0.513914598993459,-0.563520848789891,702160424,685590454.6,40.72430505254432,39.24982153537699,NaN,NaN,-14.995737234021064,-15.286353961258136
2019-01-17T09:30:00-05:00,52.82,53.2,52.74,53.08,20786010,24022082,47.49878562928342,41.50925169542508,NaN,NaN,16.909024029977154,-28.06316326409577,0.082861117053459,-0.45994445247306714,-0.5428055695265261,722946434,689169443.8,42.57069114663442,40.18842758292614,NaN,NaN,-13.50539825350367,-15.031931717293212
2019-01-18T09:30:00-05:00,53.15,53.32,52.9,53.14,14154692,23333394.35,47.98871826196896,42.24796567810744,NaN,NaN,45.48011754588906,-15.38451882686319,0.10813862151285125,-0.4076322926354621,-0.5157709141483133,737101126,700547868.8,48.10516624882285,41.394350189531984,NaN,NaN,-12.158619872813775,-14.621458596653293
2019-01-22T09:30:00-05:00,53.13,53.5321,52.72,53.24,16914429,22207674.75,48.84552734784782,42.987580033919066,NaN,NaN,70.68939177303244,11.566307771866828,0.12939721772511986,-0.3540243919919135,-0.48342160971703335,754015555,720007155.2,55.927555605301,42.76058982259046,NaN,NaN,-10.806405180850184,-14.076450965824277
2019-01-23T09:30:00-05:00,53.25,53.81,53.156,53.78,14211146,21135134.6,53.3176871608577,44.39988063669183,NaN,NaN,154.6835482717098,52.229039254076405,0.1748072790118721,-0.26491251095219326,-0.43971978996406536,768226701,736890048,61.368359702484156,44.16399341115167,NaN,NaN,-8.322553540599635,-13.254465619363614
2019-01-24T09:30:00-05:00,53.74,54.11,53.34,54.06,21924130,21098073.65,55.49056227352795,45.971024386448065,NaN,NaN,170.7128213341641,91.69498059095451,0.21598352652512132,-0.1697403818076637,-0.385723908332785,790150831,754488129.4,66.070319040508,45.80785967807175,NaN,NaN,-5.591410388377637,-12.159743443508475
2019-01-25T09:30:00-05:00,53.89,54.14,53.24,53.32,18154332,20463833.05,48.99928031106127,46.54733008112788,NaN,NaN,118.05714177330346,111.92460413961979,0.18676128741263903,-0.15227229906698625,-0.3390335864796253,771996499,764298142.4,68.38066687776548,47.5698105428681,NaN,NaN,-5.031156959899419,-11.141373945850038
2019-01-28T09:30:00-05:00,53.33,53.53,52.83,53.07,14183789,19686488.8,46.99899081866682,47.13658475811315,NaN,NaN,43.83002797862838,111.59458622616765,0.1457915073089302,-0.15679420234346253,-0.30258570965239273,757812710,768440459.2,69.33032052915745,49.50753692113839,NaN,NaN,-5.145677663836266,-10.284845905562356
2019-01-29T09:30:00-05:00,53.32,53.47,53.04,53.22,12618520,19263034.55,48.36111267603298,47.41229700264722,NaN,NaN,55.95103402500948,108.64691467656306,0.12480107686330533,-0.1465843635732611,-0.2713854404365664,770431230,771723594.2,70.09690288969728,51.60693487252702,NaN,NaN,-4.857794447407212,-9.509552840111622
2019-01-30T09:30:00-05:00,53.08,53.86,53,53.63,18578898,19376871.35,51.992854656302825,48.098167138375345,NaN,NaN,86.89330513379004,95.0888660489791,0.13374181446180744,-0.10420817235930713,-0.23794998682111457,789010128,775880279.6,71.08239906492157,53.856753745713945,NaN,NaN,-3.5717158804031155,-8.66129041729612
2019-01-31T09:30:00-05:00,53.61,54.92,53.37,54.76,23081709,19272262.6,60.28350019931051,48.968016043525566,NaN,NaN,195.5155174480042,100.0494052717471,0.20661803338887844,0.02032255491498347,-0.18629547847389497,812091837,780268480.8,72.12675922795661,56.01912903910607,NaN,NaN,0.2989556577211255,-7.381255263722228
2019-02-01T09:30:00-05:00,54.53,54.76,54.077,54.55,15562362,18971007.8,58.26954579922666,49.797217807883825,NaN,NaN,192.47879459184887,114.93373583545619,0.22976088774989337,0.10090563121347174,-0.12885525653642163,796529475,785175076,73.28838583589501,58.33990570070726,NaN,NaN,2.8334968400845324,-5.922004963178406
2019-02-04T09:30:00-05:00,54.31,54.67,53.93,54.64,18065691,18924111.7,58.90322120757328,51.21339227688786,NaN,NaN,157.59291349917146,137.6863129395648,0.23914027363519746,0.17007008550757519,-0.06907018812762228,814595166,796531567.2,75.80204490764999,60.94851627407444,NaN,NaN,5.07555197048561,-4.350925401226403
2019-02-05T09:30:00-05:00,54.64,54.85,54.33,54.75,12296230,18724099.35,59.70852867753293,52.31553506291858,NaN,NaN,158.0530474134227,158.10671561724743,0.24013260543544876,0.23109556866668868,-0.009037036768760082,826891396,807823600.4,78.01718967739082,63.777933271909205,NaN,NaN,7.156737671611002,-2.7069735336782026
2019-02-06T09:30:00-05:00,54.67,54.94,54.45,54.72,9204507,18352147.9,59.366855220503545,53.28751215997835,NaN,NaN,141.30645575824138,168.98934574213771,0.2263342908306131,0.2738808267695063,0.04754653593889321,817686889,813558952.6,79.06542830098047,66.51658493251179,NaN,NaN,8.78754884219002,-1.064898908554171
2019-02-07T09:30:00-05:00,54.64,55.44,54.4711,55.44,16075627,18252193.6,64.60221869953028,54.50918595071027,NaN,NaN,158.75886232842225,161.6380147182213,0.25133620228544845,0.3617167887957038,0.11038058651025534,833762516,817893088.4,79.84747644252755,69.17921245364701,NaN,NaN,11.821894743029533,0.776071613100644
2019-02-08T09:30:00-05:00,55.31,55.71,55.19,55.68,14633681,17710970.95,66.16705748904025,55.80763875264393,NaN,NaN,163.31474414018956,155.80520462788945,0.26814137755946865,0.4455573084595912,0.17741593090012253,848396197,828266432.8,81.61748476466738,71.57294949049306,NaN,NaN,14.839121999299534,2.7850788111290568
2019-02-11T09:30:00-05:00,55.68,55.95,55.47,55.66,14729079,17205300.55,65.90558906774501,57.02621458977945,NaN,NaN,149.57341792242784,154.20130551254073,0.2617243013039361,0.5045713075300426,0.24284700622610655,833667118,832080823.2,82.23534971594995,73.45207764125368,NaN,NaN,17.251591995518865,4.851723551756172
2019-02-12T09:30:00-05:00,55.67,56.07,55.35,55.79,14753324,16768472.85,66.82330564134828,57.99090162410021,NaN,NaN,133.7183584984374,149.33436772954366,0.2500644883690885,0.5554276166874672,0.3053631283183787,848420442,836386632.4,82.93272590197866,74.99238951264614,NaN,NaN,19.54797252768757,6.951187691174943
2019-02-13T09:30:00-05:00,55.62,55.77,55.395,55.63,13381784,16082906.35,64.5213848393283,58.635960378800235,NaN,NaN,110.60554439020372,143.19418545593615,0.2166527862543356,0.5761791111362982,0.35952632488196257,835038658,839856986.2,83.49510212064857,76.23701687551333,NaN,NaN,20.922445866118895,8.947081716166936
2019-02-14T09:30:00-05:00,55.67,55.8269,55.34,55.54,19094014,16120197.7,63.20250888465408,59.65047670548544,NaN,NaN,99.30267206225824,131.30294740270335,0.17533235898383126,0.5786917736117516,0.40335941462792035,815944644,836293411.8,80.55963621124386,77.10694325647607,NaN,NaN,21.757797351962314,10.77718394985199
2019-02-15T09:30:00-05:00,55.72,55.92,55.51,55.71,9344553,15548124.85,64.67149153937297,60.91279818553586,NaN,NaN,101.25183263786153,118.89036510223772,0.1474139557598343,0.5876268593277132,0.4402129035678789,825289197,831672011.8,76.78922483247308,77.63972213528434,NaN,NaN,22.860645388273717,12.503392726769379
2019-02-19T09:30:00-05:00,55.75,56.1,55.58,56.04,14489396,15564860.05,67.39270686561525,62.272197770506025,NaN,NaN,104.89046745292413,109.95377500833699,0.13923405038468967,0.614255466548741,0.4750214161640513,839778593,832894306.8,77.0945740226095,78.13955578763522,NaN,NaN,24.570529631876635,14.227269427498987
2019-02-20T09:30:00-05:00,56.02,56.39,55.715,56.29,14358395,15437058.35,69.3206512203672,63.50989752508206,NaN,NaN,110.6192462765158,105.33395256395268,0.13843190154897467,0.6480612931002696,0.5096293915512949,854136988,834037616,77.39414545970578,78.59039481583409,NaN,NaN,26.591143938673284,15.993537214809601
2019-02-21T09:30:00-05:00,56.12,56.79,55.93,56.7,19100276,15681514.85,72.22145149399043,64.36260833184491,NaN,NaN,121.70033383186399,107.5529104522847,0.1521913494540328,0.6998685783688359,0.5476772289148031,873237264,841677337.2,79.33869197950584,79.10553286951617,NaN,NaN,29.2293450029357,17.884366898827615
2019-02-22T09:30:00-05:00,56.8,57.06,56.54,57.05,15247538,15347685.25,74.44297474999709,65.51785325689994,NaN,NaN,135.94073210070468,114.880522459974,0.17018049639600918,0.7604028494098145,0.5902223530138053,888484802,856185368.8,82.42965230446919,79.75848047441433,NaN,NaN,32.19451201379247,19.928673343822595
2019-02-25T09:30:00-05:00,57.1,57.14,56.4516,56.68,13080110,15093974.15,68.23084618334751,66.18411218374095,NaN,NaN,116.57728230949454,117.94561239430061,0.1435411222190981,0.7696487557876779,0.6261076335685798,875404692,866208467.8,84.18944293406969,80.35758033344429,NaN,NaN,32.984352014946744,21.793770296840332
2019-02-26T09:30:00-05:00,56.8,56.88,56.3201,56.61,13702740,15069921.7,67.09018489139115,66.71137334187368,NaN,NaN,99.62814128720973,116.89314716115773,0.10914407550920957,0.7625377279550918,0.6533936524458822,861701952,870593139.6,84.9018436045171,80.84934132823903,NaN,NaN,33.31403918940579,23.439522995778255
2019-02-27T09:30:00-05:00,56.48,56.86,56.415,56.68,11956341,15036812.75,67.67220332017925,67.30461249185052,NaN,NaN,100.93226629132268,114.9557511641191,0.08037353148250426,0.7538605667990126,0.6734870353165083,873658293,874497400.6,85.52718419176426,81.31089532043788,NaN,NaN,33.745689885929536,24.911832551514152
2019-02-28T09:30:00-05:00,56.71,57.15,56.41,57.01,12808086,14748272.15,70.33566523193626,67.71414438702239,NaN,NaN,114.04927168659103,113.42553873506452,0.07304717484955481,0.7647960038784518,0.691748829028897,886466379,877143223.6,85.95182263347947,81.74692004836301,NaN,NaN,34.86550099417803,26.33378518618042
2019-03-01T09:30:00-05:00,57.03,57.165,56.65,57.13,13418045,14265088.95,71.26284954640147,68.07812953397675,NaN,NaN,112.857760013328,108.80894431758918,0.06597748046387908,0.7742206796087459,0.7082431991448668,899884424,879423148,86.32418337269148,82.08311280607901,NaN,NaN,36.06583110479891,27.724077460268777
2019-03-04T09:30:00-05:00,57.2,57.35,56.665,57.23,12337582,14103849.95,72.04693664576888,68.51679721812131,NaN,NaN,109.90573445934032,107.47463474755834,0.05801253276402496,0.780758865099898,0.722746332335873,912222006,886786610.8,87.47855266926592,82.45762730274444,NaN,NaN,37.29414739481166,29.091230308060616
2019-03-05T09:30:00-05:00,57.23,57.37,57.06,57.16,12045578,13802844.3,70.59490301248107,68.7861970303451,NaN,NaN,109.9137348874364,109.53175346760368,0.038922768204764924,0.7713997925918292,0.7324770243870643,900176428,894481506,88.56482703669191,82.85992024093824,NaN,NaN,37.95728021990065,30.357808866894906
2019-03-06T09:30:00-05:00,57.22,57.37,56.96,57.16,11304354,13753250.5,70.59490301248108,69.22001975699887,NaN,NaN,97.38754341583393,108.82280889250595,0.018239424569311713,0.7552763050987039,0.7370368805293922,900176428,899785133,89.25662710052747,83.27145773950102,NaN,NaN,38.51616223775862,31.523287919875436
2019-03-07T09:30:00-05:00,57.26,57.7099,57.19,57.35,15128505,14049450.4,72.34916455028215,69.87335230454372,NaN,NaN,114.6836278705431,108.94968012929635,0.009725296279938123,0.7491935008793149,0.7394682045993768,915304933,905552843.8,89.96745453796305,83.94344476283811,NaN,NaN,39.45889021777759,32.656945391004314
2019-03-08T09:30:00-05:00,57.42,57.6,57.01,57.55,18044062,14147872.15,74.10070717054211,70.54686770677009,NaN,NaN,104.77613639597193,107.33335540582512,0.009900931807202973,0.7518443693583805,0.7419434375511775,933348995,912245758,90.73363227444263,84.93947386583594,NaN,NaN,40.75326985192621,33.81356317113601
2019-03-11T09:30:00-04:00,57.57,57.98,57.53,57.96,14458845,14139130.35,77.27825873138684,71.2529785543252,NaN,NaN,142.0973354306611,113.7716756000893,0.028893079016837242,0.7780597863222241,0.7491667073053868,947807840,919362924.8,91.47886577271382,85.96692327655767,NaN,NaN,42.85016870993415,35.10450681953574
2019-03-12T09:30:00-04:00,58.06,58.42,57.95,58.36,17102050,14257778.9,79.8727380715785,72.00669904369744,NaN,NaN,170.66777137841132,125.92248289828429,0.057979421663087005,0.8216409843842456,0.7636615627211586,964909890,932309617.2,92.63864878942483,87.0558163715376,NaN,NaN,45.52368502007572,36.59296084818431
2019-03-13T09:30:00-04:00,58.25,58.56,58.21,58.42,15887625,14314493.95,80.23726663182369,72.5792572678284,NaN,NaN,167.98398600620138,140.0417714163578,0.07003770377950991,0.851208692445546,0.7811709886660361,980797515,948433834.6,93.77502348483351,88.08698290763243,NaN,NaN,47.82929738480427,38.198151781987164
2019-03-14T09:30:00-04:00,58.39,58.74,58.19,58.41,15155384,14403173.95,79.97728244225515,72.97456496013254,NaN,NaN,154.8212771081308,148.0693012638753,0.06616414580896435,0.8638761709272416,0.7977120251182772,965642131,958501274.2,94.36040255697085,88.9391793542397,NaN,NaN,49.65836914601629,39.83532569113418
2019-03-15T09:30:00-04:00,58.07,58.38,57.74,58.19,17714892,14334217.85,74.27534004782662,73.40631452188104,NaN,NaN,107.08210244047987,148.5304944727769,0.03895536655886844,0.8464062333168627,0.8074508667579943,947927239,961416923,94.521094515626,89.677154467208,NaN,NaN,49.68626726287158,41.24260305852524
2019-03-18T09:30:00-04:00,58.22,58.3,57.72,57.97,15008763,14617428.35,68.97920500438751,73.54124452995221,NaN,NaN,85.55118114599625,137.22126361584392,-0.0015419353024623828,0.8055234476299162,0.8070653829323786,932918476,958439050.2,91.64880340464883,90.15908016721743,NaN,NaN,48.201573517268706,42.23674169548859
2019-03-19T09:30:00-04:00,57.88,57.97,57.1,57.31,22636223,15024769.7,56.06392469147243,72.71208177075887,NaN,NaN,18.89889658987931,106.86748865813752,-0.07632154791018575,0.7116634480446464,0.7879849959548322,910282253,947513522.8,81.82445441518566,89.89459946889039,NaN,NaN,42.56104746267594,42.283071090801066
2019-03-20T09:30:00-04:00,57.42,57.92,57.17,57.46,18880460,15250872.95,57.989139679283326,71.83018708842651,NaN,NaN,19.028022474061594,77.07629595170957,-0.11680231793642049,0.6419820985343065,0.758784416470727,929162713,937186562.4,73.77442277871556,89.0247851935501,NaN,NaN,38.51703452119207,41.74506586657121
2019-03-21T09:30:00-04:00,57.5,58.19,57.41,58.07,15371776,15064447.95,64.75311448486163,71.36520601260224,NaN,NaN,60.950244508283966,58.30208943174019,-0.10404082759011601,0.628733381983082,0.732774209573198,944534489,932965034,70.71183555228156,87.90961749209225,NaN,NaN,37.05007617436007,41.07435305339819
2019-03-22T09:30:00-04:00,58.29,58.8967,58.0747,58.49,20452512,15324696.65,68.51223601343142,71.1127273960067,NaN,NaN,123.5303412725675,61.59173719815773,-0.07046532436159869,0.6446925541211996,0.7151578784827983,964987001,936376986.4,71.73319202837182,86.78494887488553,NaN,NaN,37.090963607001605,40.50529741819868
2019-03-25T09:30:00-04:00,58.54,58.72,58.3001,58.54,13762955,15358838.9,68.9369678946239,70.99430345901692,NaN,NaN,112.06371761063518,66.89424449108552,-0.04905601533771975,0.6538378593106486,0.7028938746483684,978749956,945543282.4,74.3237449605551,85.76772872659004,NaN,NaN,37.25922172648956,40.04157231938309
2019-03-26T09:30:00-04:00,58.57,58.995,58.49,58.96,15699774,15458690.6,72.31512314857035,71.11717632588044,NaN,NaN,132.3956453819835,89.59359424950635,-0.012670208304690123,0.6870561142675058,0.6997263225721959,994449730,962376777.8,78.2635092796051,84.98250602509559,NaN,NaN,38.520866021545714,39.824328562549184
2019-03-27T09:30:00-04:00,59.02,59.07,58.28,58.55,17323640,15727055.55,64.89568789060854,70.58478513590374,NaN,NaN,101.69088503957839,106.12616676260973,-0.02174460959288871,0.6725455605810851,0.6942901701739738,977126090,971969453.2,80.13417148421958,84.28012866411392,NaN,NaN,37.09216307991107,39.43401920788659
2019-03-28T09:30:00-04:00,58.54,58.74,57.66,57.86,24748769,16324089.7,54.72051469111671,69.20048567308766,NaN,NaN,27.730368095093112,99.48219147997155,-0.07665627914118045,0.5984698212474981,0.6751261003886786,952377321,973538019.6,80.43074211462925,83.54420793841295,NaN,NaN,32.14213631388767,38.39232165160103
2019-03-29T09:30:00-04:00,57.78,58.24,57.64,58.17,21835137,16744944.3,57.91328916518148,67.81727356121584,NaN,NaN,12.322200213247962,77.24056326810765,-0.09342692098069649,0.558342449162808,0.6517693701435044,974212458,975383111,80.79395320500373,82.78099989786223,NaN,NaN,29.279164152395843,37.09044200885743
2019-04-01T09:30:00-04:00,58.17,58.17,57.425,57.77,26693942,17462762.3,52.74517087373164,65.87959018994107,NaN,NaN,-29.560307637979324,48.91575821838473,-0.13050996326875253,0.48863191605756384,0.6191418793263164,947518516,969136823,75.67340097230829,81.56919648235392,NaN,NaN,25.110396667773788,35.37900696013119
2019-04-02T09:30:00-04:00,57.89,57.96,57.4936,57.85,24978101,18109388.45,53.63631276720516,63.97952205675403,NaN,NaN,-40.68441064640761,14.299747012706504,-0.14745053304958644,0.43482871301433335,0.5822792460639198,972496617,964746200.4,72.20907681611162,80.02877172030234,NaN,NaN,22.15846740950587,33.490358452899
2019-04-03T09:30:00-04:00,57.73,58,57.33,57.76,15450528,18316697.15,52.43823250258635,62.012447061063405,NaN,NaN,-62.26610650908139,-18.491651297025452,-0.1613910718845607,0.38054040620821894,0.5419314780927796,957046089,960730200.2,69.09331946735884,78.22398007104435,NaN,NaN,19.429097223424666,31.481606848688383
2019-04-04T09:30:00-04:00,57.86,57.91,57.22,57.56,16264598,18373501.8,49.77731950105981,60.262588450580054,NaN,NaN,-90.68183368564388,-42.17409165317285,-0.1793725634826061,0.317715773739522,0.4970883372221281,940781491,958411034.2,67.28768346543367,76.27873642460204,NaN,NaN,16.34679228065242,29.3194904818261
2019-04-05T09:30:00-04:00,57.56,58.13,57.38,58.1,15419351,18242266.25,56.234759734664756,59.352270931314145,NaN,NaN,-38.43855815903485,-52.32624332762941,-0.15131032890312557,0.3079504260932211,0.45926075499634667,956200842,954808711,64.46940854304569,74.33735107734469,NaN,NaN,15.649315408620978,27.366608328511084
2019-04-08T09:30:00-04:00,57.97,58.05,57.54,57.69,14681743,18253411.15,50.88510267485125,58.98235507298407,NaN,NaN,-59.976900066787515,-58.40956181339105,-0.15614176125835388,0.2640835534234043,0.42022531468175817,941519099,953608827.6,63.51514977489951,73.02954360303853,NaN,NaN,13.314368729578717,25.359145528663603
2019-04-09T09:30:00-04:00,57.74,57.885,57.565,57.83,12993931,18048005.2,52.545187289138006,58.593501330830826,NaN,NaN,-54.979341534002586,-61.268547990910044,-0.14588144136654924,0.23787351297357162,0.38375495434012086,954513030,950012110.2,60.6186678952136,72.08984682564554,NaN,NaN,11.950005993174976,23.44355416645094
2019-04-10T09:30:00-04:00,57.95,58.34,57.515,57.65,16891151,18098181.5,50.19601237503891,57.553708322986346,NaN,NaN,-35.58757211424962,-55.932841111943695,-0.14678892557323697,0.20026879737357461,0.3470577229468116,937621879,946127268.2,57.56512070002057,71.15079576476975,NaN,NaN,10.110156881336401,21.538783125720293
2019-04-11T09:30:00-04:00,57.64,57.96,57.57,57.94,17420015,18211413.05,53.781195121226624,56.501491116400295,NaN,NaN,-33.56927248524562,-44.51032887186405,-0.12431973756285142,0.1916580509932473,0.3159777885560987,955041894,948979348.8,59.19042051379693,70.25488351372867,NaN,NaN,9.635941184704842,19.838377134146658
2019-04-12T09:30:00-04:00,57.73,58.27,57.44,58.21,15926624,18121999.65,56.89255277095734,55.64117575042411,NaN,NaN,2.4383067868768786,-36.3349558826817,-0.0893693796994241,0.20426606393181856,0.29363544363124267,970968518,951932884,60.862174054967646,69.29334273475814,NaN,NaN,10.184587930764923,18.45926439080641
2019-04-15T09:30:00-04:00,58.26,58.455,58.05,58.2,15253376,18134230.3,56.74020257195341,54.528681423522904,NaN,NaN,58.39142110210213,-12.661291648903765,-0.06609347685953015,0.21101859755682995,0.2771120744163601,955715142,954772092.6,62.4544151896447,68.1641217283324,NaN,NaN,10.582620000601153,17.334029477919945
2019-04-16T09:30:00-04:00,58.2,58.33,57.29,57.48,19688846,17986861.45,46.98448432060633,53.24930973995131,NaN,NaN,-66.29186852068912,-14.923797046241068,-0.0965149584525265,0.156468376350702,0.2529833348032285,936026296,951074745.8,59.08344052432875,66.6604980883402,NaN,NaN,7.8637292832064025,15.981129450103724
2019-04-17T09:30:00-04:00,57.42,57.57,57.21,57.26,15194799,17802578.4,44.46856697492174,52.51702776022311,NaN,NaN,-143.01574338656187,-36.40943130070352,-0.12686936696050802,0.09439662610259347,0.2212659930631015,920831497,947716669.4,56.120655469498764,64.92406332797374,NaN,NaN,4.831033940367294,14.38825866299852
2019-04-18T09:30:00-04:00,57.4,57.69,57.26,57.29,16039368,17835958,44.90184060033225,51.5876385770196,NaN,NaN,-115.26464823717235,-52.74850645108886,-0.1393469302012041,0.047082330311596365,0.18642926051280045,936870865,944082463.6,53.021859713711976,62.94034236431004,NaN,NaN,2.5292393556300383,12.694113047660165
2019-04-22T09:30:00-04:00,57.27,57.46,57.12,57.24,10685482,17347606.5,44.28171277902493,50.98310585596911,NaN,NaN,-136.8638718408132,-80.60894217662687,-0.14475335194163486,0.005487570585756885,0.15024092252739174,926185383,935125836.6,46.24464395083294,60.83828829134751,NaN,NaN,0.46636361785669317,10.947291700545383
2019-04-23T09:30:00-04:00,57.26,57.58,56.98,57.4,17068171,17512867.3,46.813087918597546,50.49573265249713,NaN,NaN,-122.62474606956101,-116.8121756109595,-0.1317126740477848,-0.014399920032339253,0.11731275401544554,943253554,932633519,44.538651900878556,58.861829368830854,NaN,NaN,-0.5893021424295662,9.299206865834677
2019-04-24T09:30:00-04:00,57.54,57.966,57.45,57.77,16428356,17549296.4,52.21912786224334,50.48008232104406,NaN,NaN,-15.114830852574906,-106.57676807733667,-0.09409141613815691,-0.0003015161572506031,0.09378989998090631,959681910,937364641.8,48.42798536092109,57.385734075513874,NaN,NaN,0.040092528570817576,7.976476246225554
2019-04-25T09:30:00-04:00,57.51,58.24,57.45,58.01,15253408,17445784.8,55.386744326801995,50.880755522882794,NaN,NaN,55.08219024373333,-66.95718135127763,-0.05111753831160501,0.02989297709140004,0.08101051540300505,974935318,948185406,56.023896868022454,56.581177889984495,NaN,NaN,1.5158318418751822,7.053527045604072
2019-04-26T09:30:00-04:00,58.33,58.68,58.035,58.1,14517404,16934216.55,56.550023665120605,50.90327437505821,NaN,NaN,175.33604237259834,-8.83704322932349,-0.01649764606805515,0.060388457817936114,0.07688610388599126,989452722,958701777.4,61.89758598577622,56.397476278750965,NaN,NaN,3.0752827938612772,6.485206438212245
2019-04-29T09:30:00-04:00,58.05,58.07,57.52,57.76,20775908,16881255.1,51.12643551328,50.92051243494597,NaN,NaN,15.175775438159691,21.57088622647108,-0.01633269607148255,0.05647023379663807,0.07280292986812062,968676814,967200063.6,65.86530052193083,56.5653441892532,NaN,NaN,2.8907253325621043,5.971709137405082
2019-04-30T09:30:00-04:00,57.77,58.75,57.67,58.71,22016749,16647395.45,62.072099011188904,51.60100612937818,NaN,NaN,189.09646592686238,83.91512862575577,0.044589928519352576,0.12854034051731134,0.08395041199795876,990693563,976688065.4,69.66352891141196,57.211405690410224,NaN,NaN,6.480300340080994,6.044365023501641
2019-05-01T09:30:00-04:00,58.54,58.695,58.06,58.11,26412895,16719135.15,53.866682419835165,51.86319684686363,NaN,NaN,136.21400315357445,114.18089542698564,0.04138161343911004,0.1356774287968463,0.09429581535773626,964280668,977607817,70.01187804697356,58.10045978662116,NaN,NaN,6.670282539057043,6.133781811438126
2019-05-02T09:30:00-04:00,58,58.31,57.55,57.98,23464020,17119809.75,52.25489425629474,51.75417535651135,NaN,NaN,37.83586515210755,110.7316304086605,0.028045437900427905,0.12935261273327114,0.10130717483284324,940816648,970784083,64.12837313658717,58.45317068824903,NaN,NaN,6.277803640157281,6.154356358398005
2019-05-03T09:30:00-04:00,57.98,58.4,57.89,58.3,16071256,17110142.65,55.763688863109444,51.67354222023649,NaN,NaN,95.1821648002712,94.70085489419506,0.03771444748634592,0.14845023419077563,0.11073578670442971,956887904,964271119.4,59.029494207109124,58.32226498483056,NaN,NaN,7.119522092997893,6.292237177626561
2019-05-06T09:30:00-04:00,58.3,58.455,57.855,57.98,13389683,17008659.25,51.67403854646525,51.31167336127306,NaN,NaN,62.35036378810853,104.13577256418482,0.020366532266110876,0.1361939520370683,0.11582741977095742,943498221,959235400.8,55.364103811331745,57.81581417209393,NaN,NaN,6.477936254194735,6.3187656171363
2019-05-07T09:30:00-04:00,57.89,58.03,57.53,57.8,12542240,16901684.1,49.475994345568196,51.489638363056045,NaN,NaN,-16.88313346873109,62.939852685066136,-0.004117608148174037,0.11068040958573988,0.11479801773391392,930955981,947287884.4,47.783105307125986,57.008647370865155,NaN,NaN,5.262154575773928,6.1678211826559615
2019-05-08T09:30:00-04:00,57.73,57.79,56.96,57.01,28692351,17686605.1,41.193963144266235,51.2557380894378,NaN,NaN,-134.49689586508495,8.797672881334261,-0.07071048723069252,0.026409908695548268,0.09712039592624079,902263630,934884476.8,41.4391889643333,55.959971191924765,NaN,NaN,1.2850308825614738,5.470279711213892
2019-05-09T09:30:00-04:00,57.01,57.26,56.66,56.94,16173941,17650744.6,40.546299987310505,50.94462804565053,NaN,NaN,-168.79778059104765,-32.529056267296774,-0.11409551771523728,-0.04549900121780581,0.06859651649743147,886089689,923939085,36.79654765798355,54.80102033080131,NaN,NaN,-2.0195830700486934,4.400299313890665
2019-05-10T09:30:00-04:00,56.93,57.99,56.82,57.96,25157994,18037643.55,52.31186460365938,51.51821031883871,NaN,NaN,-35.97885693447258,-58.76126061424553,-0.070838702995663,-0.01995186224714729,0.05088684074851571,911247683,914811040.8,33.432558390730435,53.88587136222255,NaN,NaN,-0.8766460802035086,3.6464499718772116
2019-05-13T09:30:00-04:00,57.78,58.705,57.7,58.58,20096262,18246125.45,57.780992800636554,52.30163209612721,NaN,NaN,101.6284310674644,-50.90564715837436,-0.0009096617334686252,0.04974976358167993,0.050659425315148554,931343945,912380185.6,32.57839059730716,53.031566983396026,NaN,NaN,2.084884783788643,3.423369230721702
2019-05-14T09:30:00-04:00,58.59,58.635,58.08,58.19,17609426,18363927.95,53.61559491999117,52.401379743109196,NaN,NaN,94.98567468944061,-28.53188552674002,0.017617451350774173,0.07268123950361627,0.055063788152842096,913734519,908935893.2,31.355973335726233,51.81213755302497,NaN,NaN,2.9719825471111663,3.35888541877734
2019-05-15T09:30:00-04:00,58.22,58.44,58.015,58.09,14577531,18108362.2,52.56913547228594,52.20012196778662,NaN,NaN,65.38226025656516,11.44394569759,0.02142257856328421,0.08184201135694735,0.060419432793663144,899156988,908314564.8,31.12905911336003,50.033934856263365,NaN,NaN,3.3099082518290595,3.351888680641871
2019-05-16T09:30:00-04:00,58.03,58.66,57.87,58.48,13908648,18044054.65,56.16269169636595,52.172455398589854,NaN,NaN,84.85296792941647,62.17409540168283,0.047022608068262514,0.11919769287899129,0.07217508481072878,913065636,913709754.2,35.49431395652411,48.14798685417393,NaN,NaN,4.774158702163909,3.5550701122878765
2019-05-17T09:30:00-04:00,58.22,59.01,58.14,58.78,10477144,17765943.45,58.751572926402865,52.717108070955774,NaN,NaN,126.79186658336266,94.72824010524987,0.07909050046497014,0.17103821039194145,0.09194770992697131,923542780,916168773.6,37.440597549349214,46.11765092756095,NaN,NaN,6.811017881288679,4.02020550785942
2019-05-20T09:30:00-04:00,58.91,59.23,58.71,58.86,9118825,17687610.6,59.439472837815266,52.52906334428622,NaN,NaN,160.33498595774827,106.46955108330664,0.09931112282096591,0.2160866134531787,0.11677549063221279,932661605,916432305.6,37.65769118485035,43.83151966137798,NaN,NaN,8.646281081773006,4.681073446989933
2019-05-21T09:30:00-04:00,58.95,59.452,58.81,58.97,11504381,17409421.1,60.416967304990116,52.996940836083006,NaN,NaN,169.4669685595431,121.36580985732715,0.11273428717535261,0.25769334960140355,0.14495906242605094,944165986,922518599,42.610915605120326,41.874308058388465,NaN,NaN,10.433896645575283,5.5029053325021255
2019-05-22T09:30:00-04:00,59.06,59.47,58.88,59.41,9257875,17050897.05,64.13975790696966,53.84585966827404,NaN,NaN,175.7927969048772,143.44791718698954,0.14199615690234504,0.32245425855398224,0.1804581016516372,953423861,933371973.6,50.20821756916662,40.880011232144135,NaN,NaN,13.130076281681314,6.592501182384867
2019-05-23T09:30:00-04:00,59.47,59.93,59.41,59.92,15164644,17046458.85,67.90737662805549,54.71326593719875,NaN,NaN,214.37907553636953,169.3531387083802,0.18379506324892597,0.41020193071279465,0.22640686746386868,968588505,944476547.4,56.54656436227892,40.70265910037055,NaN,NaN,16.684048358526017,8.034150778976459
2019-05-24T09:30:00-04:00,59.96,60.27,59.76,59.83,8712444,16756210.85,66.57801965249531,55.7778360162009,NaN,NaN,193.1272596459894,182.6202173209055,0.19255126910814224,0.46709595384904645,0.2745446847409042,959876061,951743203.6,60.12381468532468,41.042638448512896,NaN,NaN,19.168508443807816,9.624773302523796
2019-05-28T09:30:00-04:00,59.91,59.96,58.75,58.85,16397885,16537309.7,54.14791806062499,56.11154485299067,NaN,NaN,87.19246642495403,167.99171341434666,0.12290135157613691,0.4281713742110753,0.3052700226349384,943478176,953906517.8,61.14921784102306,41.99736077236269,NaN,NaN,17.412954749576105,10.737370652102697
2019-05-29T09:30:00-04:00,58.99,59.045,57.93,58.07,20119139,16442429.2,46.67809760424927,56.50326874298945,NaN,NaN,-8.207877247954988,132.45674425284705,0.02024257437250665,0.3305732406005717,0.31033066622806504,923359037,949745128,58.05653329512413,43.18431393884775,NaN,NaN,13.24932043808397,11.096220621528593
2019-05-30T09:30:00-04:00,58.08,58.4,57.8,57.98,16822644,15962916.65,45.89142765774448,56.88506357659187,NaN,NaN,-39.19014763207797,89.460155345456,-0.05373592273627131,0.24316076280772592,0.29689668554399723,906536393,940367634.4,51.70979494024857,44.249545887580965,NaN,NaN,9.764308270395386,10.905947428509563
2019-05-31T09:30:00-04:00,58,58.41,57.74,58.25,18256977,15702564.5,48.68542559126689,56.62603221856384,NaN,NaN,-32.360181574273156,40.11230392332747,-0.08276326683691643,0.19344260199785168,0.2762058688347681,924793370,931608607.4,46.58688267355471,45.189140479211275,NaN,NaN,7.7960434790052116,10.461675435723228
2019-06-03T09:30:00-04:00,58.44,58.91,58.14,58.83,20335357,15915769.55,54.16116182136869,56.36747286290184,NaN,NaN,21.077336221861465,5.70231923850189,-0.062122327727555715,0.19855295917532345,0.26067528690287917,945128727,928659140.6,44.97121852426651,46.07434247399408,NaN,NaN,7.870989360259372,10.091577424942678
2019-06-04T09:30:00-04:00,58.89,58.955,57.785,58.88,18529201,16172745.45,54.61081828007935,56.43856024576529,NaN,NaN,8.947749960297845,-9.946624054429346,-0.04511407554476671,0.20428269247192077,0.24939676801668748,963657928,932695091,47.64679695773866,47.23797273270925,NaN,NaN,8.067859580458869,9.802474875730704
2019-06-05T09:30:00-04:00,59.1,60.335,58.8895,60.14,31755266,17133396.75,64.15365232286403,57.26602573509229,NaN,NaN,132.7651917635574,18.247989747873113,0.046047875488238854,0.306956612376986,0.26090873688874716,995413194,947105922.4,55.89314695321608,49.006836149841824,NaN,NaN,11.605886846802168,10.060105157312341
2019-06-06T09:30:00-04:00,60.22,60.62,60.045,60.51,25511179,16974338.15,66.38840758556036,57.996434012891896,NaN,NaN,169.33942127436572,59.953903529161856,0.12200639503305755,0.4134167306800691,0.2914103356470116,1020924373,969983518.4,65.25084091564086,51.132302361207344,NaN,NaN,15.21562323039557,10.796607739181374
2019-06-07T09:30:00-04:00,60.82,61.19,60.03,60.06,18993119,17115297.05,61.37671771294099,58.18394435478748,NaN,NaN,151.96278139018648,96.81849612205379,0.13184526556633774,0.45621691760493377,0.324371652038596,1001931254,985411095.2,69.89005802729093,53.450120966774605,NaN,NaN,16.50657032347084,11.612316679794155
2019-06-10T09:30:00-04:00,59.88,60,59.35,59.65,13700645,16542429.6,57.14400639861848,58.01998246627342,NaN,NaN,68.43304021419517,106.28963692052052,0.10197805572126178,0.45184422169017324,0.34986616596891146,988230609,994031471.6,72.12911122478259,55.91236525534119,NaN,NaN,16.170165050657555,12.263437875631784
2019-06-11T09:30:00-04:00,59.63,59.79,58.945,59.29,18036072,16439420.1,53.64573486805627,57.536323006492424,NaN,NaN,30.833867780048177,110.66686048447059,0.05174798699679328,0.41455114971490303,0.36280316271810975,970194537,995338793.4,72.46353993953323,58.044695564942124,NaN,NaN,14.76111368498815,12.620248705539836
2019-06-12T09:30:00-04:00,59.59,60.15,59.515,60.06,12350232,16176460.4,59.37442415598234,57.19594202427904,NaN,NaN,81.4030972394044,100.39444157963999,0.06338403200870096,0.44203320272898594,0.378649170720285,982544769,992765108.4,70.66582936291806,59.50595355021009,NaN,NaN,15.448641322963228,13.024304793743179
2019-06-13T09:30:00-04:00,60.2,60.36,59.779,60.18,16212082,16258187.95,60.19993829646609,56.6454107148798,NaN,NaN,92.63083321305972,85.0527239673788,0.07156063134589369,0.4680999599026521,0.3965393285567584,998756851,988331604,67.55665689564717,60.29238873116496,NaN,NaN,16.251723065060457,13.485364546788505
2019-06-14T09:30:00-04:00,60.25,60.92,60.23,60.81,14242691,16274890.1,64.3012432729767,56.48278383062848,NaN,NaN,132.83031903912138,81.22623149716577,0.10952419369926719,0.5334445706808424,0.4239203769815752,1012999542,990545261.6,68.30647156208693,60.876864222362265,NaN,NaN,18.276263780148312,14.169778722982763
2019-06-17T09:30:00-04:00,60.81,60.99,60.26,60.64,11462105,16324138.15,62.431695762575515,57.07448223791066,NaN,NaN,115.27043538220252,90.59371053076724,0.11286377588540575,0.5650000968383324,0.45213632095292666,1001537437,993206627.2,69.22728762129154,61.45386920666715,NaN,NaN,19.325215818851095,14.906269736678238
2019-06-18T09:30:00-04:00,60.91,61.01,59.98,60.39,23145284,17025461.1,59.68350287626107,58.00343975734007,NaN,NaN,89.08465631539556,102.24386823783672,0.08896399918344083,0.5633413199322277,0.47437732074878686,978392153,994846150.4,69.80922238647348,62.29334699890639,NaN,NaN,19.363665701919516,15.543040588855563
2019-06-19T09:30:00-04:00,60.12,61.11,60.1,60.85,21596059,17530045,62.918006620241094,59.21962396894697,NaN,NaN,99.9607526930908,105.955399328574,0.09435176019254593,0.5923170209894693,0.4979652607969233,999988212,998334839,71.06319603576448,63.67573279144324,NaN,NaN,20.380053506020896,16.234042434164895
2019-06-20T09:30:00-04:00,61.17,61.38,60.54,61.24,19137840,18024043.25,65.4489236415584,60.41701668682494,NaN,NaN,120.24304609170777,111.47784190430362,0.11313166389599094,0.639379840666912,0.5262481767709211,1019126052,1002408679.2,72.49960941011867,65.52664184405496,NaN,NaN,22.01256536930623,17.05954571061366
2019-06-21T09:30:00-04:00,60.7,61.1,60.265,60.99,15058321,18018727.1,62.50394370922691,61.012929678814814,NaN,NaN,87.36078336542947,102.38393476956523,0.09821987481737948,0.6490230202926455,0.550803145475266,1004067731,1000622317,70.83905970355968,67.37434478543304,NaN,NaN,22.496808542916234,17.83629754379974
2019-06-24T09:30:00-04:00,61.1,61.19,60.78,61.01,9887207,18077465.25,62.64874077103312,61.58706699959722,NaN,NaN,95.41810429797802,98.41346855272033,0.07997939231180862,0.6507773858650268,0.5707979935532181,1013954938,1003105817.2,71.80589799533828,69.0999948595473,NaN,NaN,22.929919941758694,18.563957886365305
2019-06-25T09:30:00-04:00,61.06,61.06,60.5,60.64,12145391,17864840.55,58.17312339855294,61.15988636214643,NaN,NaN,68.55409091327793,94.3073554722968,0.035537567385502955,0.6152199527850968,0.5796823853995938,1001809547,1007789296,73.58458218902808,70.36366880496244,NaN,NaN,22.030798713884693,19.05922086172522
2019-06-26T09:30:00-04:00,60.49,60.6243,59.3,59.32,16888504,17703308.8,45.64489397327639,59.678206818411866,NaN,NaN,-16.501380074854136,71.01492891870781,-0.08370481539786334,0.4750513661522646,0.558756181550128,984921043,1004775862.2,70.502645095585,70.73879767495845,NaN,NaN,16.95465967922613,18.75856926422535
2019-06-27T09:30:00-04:00,59.51,59.68,59.165,59.4,14135667,17568959.95,46.398329987258485,58.60832198086312,NaN,NaN,-57.18122133687848,35.53007543299056,-0.15404434642344245,0.36620074852082496,0.5202450949442674,999056710,1000761993.8,66.50696917810527,70.49714847144519,NaN,NaN,13.189070589759075,17.962926596444454
2019-06-28T09:30:00-04:00,59.42,59.96,59.3,59.63,16133243,17462773.25,48.60408445451711,57.99832755628444,NaN,NaN,-49.51384112540942,8.155150534822782,-0.18012145512788236,0.2950932760344145,0.47521473116229684,1015189953,1002986438.2,67.60278027822343,70.17383911811953,NaN,NaN,10.75200367431372,16.932794750425778
2019-07-01T09:30:00-04:00,59.67,59.73,58.94,59.48,17961489,17344079.85,47.2387918586156,57.54068876989582,NaN,NaN,-86.68328548532635,-28.265127421838088,-0.2009289089180304,0.22405359501475886,0.42498250393278925,997228464,999641143.4,64.20089359649279,69.58365009361664,NaN,NaN,8.347549322708513,15.70633111789474
2019-07-02T09:30:00-04:00,59.7,60.39,59.69,60.29,21359553,17485597.45,54.647355663945994,57.20304102046465,NaN,NaN,-10.015391380840112,-43.9790238806617,-0.15561976909559727,0.23045779256329268,0.38607756165888996,1018588017,1002996837.4,66.04663456737305,69.25370760822057,NaN,NaN,8.45704415161113,14.67071869413994
2019-07-03T09:30:00-04:00,60.47,61.08,60.42,60.71,15786570,16687162.65,57.94487377599878,57.04196498328842,NaN,NaN,67.4922007980522,-27.18030770608044,-0.09577940922384559,0.266353300129083,0.3621327093529286,1034374587,1012887546.2,70.82178477610682,69.4869310282534,NaN,NaN,9.58598704753895,13.944328458911226
2019-07-05T09:30:00-04:00,60.33,60.77,59.75,60.68,15946419,16208924.65,57.622593280413206,56.56491855524816,NaN,NaN,21.331376355597175,-11.477788167585308,-0.05846774075781791,0.2890480334056562,0.3475157741634741,1018428168,1016761837.8,72.45589890889244,69.78331869588237,NaN,NaN,10.392677221938639,13.436949710772286
2019-07-08T09:30:00-04:00,60.72,60.96,60.39,60.77,9418172,15730177.3,58.37063314926692,56.27484265429756,NaN,NaN,59.81813900776255,10.388607859049086,-0.029441179461109246,0.31071429983708754,0.3401554792981968,1027846340,1019293115.2,73.50013672312302,70.08852220315605,NaN,NaN,11.268575423927295,13.127181955508716
2019-07-09T09:30:00-04:00,60.67,60.87,60.34,60.85,17482740,15919282.05,59.062376756883424,56.23047650291344,NaN,NaN,52.26813537064382,38.17889203024312,-0.00770025737105573,0.3305301575843771,0.3382304149554328,1045329080,1028913238.4,77.0596912257412,70.60641283453232,NaN,NaN,12.187117238386245,12.992886995919791
2019-07-10T09:30:00-04:00,60.92,61.32,60.71,60.99,11486336,15591795.25,60.30545623171268,56.0438657608757,NaN,NaN,92.41922747757151,58.66581580192544,0.012181082422620282,0.3534567679837082,0.3412756855610879,1056815416,1036558718.2,79.42506257268515,71.20368901574093,NaN,NaN,13.302941993058326,13.037180566939583
2019-07-11T09:30:00-04:00,60.92,61.235,60.49,61.01,19998068,15974187.05,60.490029845680176,55.68965906117011,NaN,NaN,72.89255806744434,59.74588725580387,0.02216877656574534,0.36898665626826954,0.3468178797025242,1076813484,1045046497.6,81.68307654421835,71.8596509538909,NaN,NaN,14.286082941580771,13.215595191888324
2019-07-12T09:30:00-04:00,60.99,61.06,60.3899,60.61,11245327,15725849.3,54.98340936320858,55.15247803645452,NaN,NaN,34.63984096928116,62.40758017854067,-0.0014221920734857063,0.34504013961066704,0.34646233168415275,1065568157,1054474495.4,83.80867213738105,72.78605184202101,NaN,NaN,13.70949581506807,13.286152423771146
2019-07-15T09:30:00-04:00,60.62,60.94,60.39,60.85,9345294,15480979.45,57.48425602463504,54.783586268854656,NaN,NaN,40.24561055407051,58.49307448780227,-0.00397639215288581,0.34149184149304546,0.34546823364593127,1074913451,1063887917.6,85.6048783651027,73.77169329700418,NaN,NaN,13.879149014917056,13.370866222506276
2019-07-16T09:30:00-04:00,60.7,60.91,60.18,60.5,14374603,15626604.35,52.8713329802267,54.404886953259926,NaN,NaN,9.657423424802374,49.97093209863398,-0.03085461651049276,0.3068999630078153,0.33775457951830806,1060538848,1066929871.2,86.13996937186319,74.66850666720669,NaN,NaN,12.75038025362742,13.282225369809296
2019-07-17T09:30:00-04:00,60.71,61.08,60.5011,60.73,13354700,15137075.15,55.40394250717185,55.101961848538174,NaN,NaN,45.03673635327477,40.494433873774625,-0.03448509818951828,0.29464820678141024,0.3291333049709285,1073893548,1070345497.6,86.73615855784232,75.82804334308221,NaN,NaN,12.474518291051783,13.16683864427251
2019-07-18T09:30:00-04:00,60.74,61.27,60.4,61.26,14733306,14793937.5,60.651358982492496,56.120035348197746,NaN,NaN,73.85349575588816,40.68662141146339,-0.004130131632841039,0.3239706404298772,0.32810077206271826,1088626854,1072708171.6,87.1479804279475,77.30240128949951,NaN,NaN,13.76706190385758,13.252584824213233
2019-07-19T09:30:00-04:00,61.12,61.29,60.3401,60.37,15308265,14602458.75,50.00984546989045,56.22044684929584,NaN,NaN,29.605394151860185,39.67973204797919,-0.04467667125132346,0.27225493299856396,0.3169316042498874,1073318589,1074258258,87.42386291636906,78.71819290650991,NaN,NaN,11.513362282244406,13.004124461074829
2019-07-22T09:30:00-04:00,60.52,60.58,59.887,60.24,13176460,14508365.7,48.666670684450644,56.322438193998345,NaN,NaN,-34.24530760323151,24.781548416518795,-0.07893413307081659,0.21826393791136667,0.29719807098218326,1060142129,1071303993.6,83.73463060485648,80.11345983567875,NaN,NaN,9.286113713455984,12.47298006855785
2019-07-23T09:30:00-04:00,60.31,60.35,59.75,59.86,16790570,14853533.85,44.872779125281525,55.62425415552231,NaN,NaN,-64.52069448385163,9.945924834787997,-0.12322839910764832,0.14316257209762284,0.26639097120527117,1043351559,1067866535.8,79.52924734841757,81.07650360575336,NaN,NaN,6.196651801321381,11.576361744666926
2019-07-24T09:30:00-04:00,60.03,60.18,59.45,59.91,13560676,14924298.1,45.47508810761963,54.73355517920952,NaN,NaN,-75.84283393052102,-14.229989221971163,-0.14376910307454618,0.08667959236208844,0.23044869543663463,1056912235,1064470273.2,75.49495846294411,81.41030172624174,NaN,NaN,3.8939030025022694,10.478867638643404
2019-07-25T09:30:00-04:00,59.72,60.145,59.46,59.76,14148321,14787288.95,43.924604983571676,53.75512744372083,NaN,NaN,-85.23823848272816,-46.04833606969443,-0.1607806107712457,0.0294729319725775,0.1902535427438232,1042763914,1055297685.2,65.78841015253275,80.93405252935891,NaN,NaN,1.5261440556314125,9.199907126784549
2019-07-26T09:30:00-04:00,59.81,60.21,59.675,59.98,13879023,14774456.75,46.790114931043966,52.92794757099062,NaN,NaN,-69.46700871607347,-65.86281664328115,-0.15070932812698012,0.0018668825850980397,0.15257621071207816,1056642937,1051962554.8,62.635075311923565,80.15797671427322,NaN,NaN,0.32485272509182517,7.9320422122570164
2019-07-29T09:30:00-04:00,60.15,60.375,59.81,60.29,16621679,14798878.55,50.619334042800425,52.32487309141327,NaN,NaN,-44.29602237415798,-67.87295959746645,-0.11810394366830321,0.004946281126699148,0.12305022479500236,1073264616,1054587052.2,64.09358963749177,79.23182660082684,NaN,NaN,0.3890044791309194,6.8544653932390025
2019-07-30T09:30:00-04:00,60.15,60.43,59.53,59.83,18995582,14850583.2,45.39849640372573,51.260090246557056,NaN,NaN,-96.07163524581364,-74.18314774985885,-0.12195426724362697,-0.029392609259531355,0.09256165798409562,1054269034,1056770547.2,65.3069230183815,78.2233880612337,NaN,NaN,-1.1183009566855222,5.715498771821213
2019-07-31T09:30:00-04:00,59.85,60.14,59.19,59.55,24380965,15001653.8,42.52349788869941,49.97676653534415,NaN,NaN,-137.77942693381016,-86.57046635051668,-0.1366873440950173,-0.078297522134676,0.058389821960341294,1029888069,1051365714,59.91027325629488,76.66818782638204,NaN,NaN,-3.262040857119798,4.432993110543926
2019-08-01T09:30:00-04:00,59.45,60.495,59.25,60.16,29493118,15686981.2,49.95852780605905,49.61784642411918,NaN,NaN,-69.91704403324927,-83.5062274606209,-0.10035992872815432,-0.0670600889498516,0.03329983977830271,1059381187,1054689168.6,61.990221319058804,75.10972705364473,NaN,NaN,-2.8320008440747193,3.3951368313126906
2019-08-02T09:30:00-04:00,60.25,60.65,60.02,60.15,14939274,15636623.95,49.84469532953108,49.07216351732604,NaN,NaN,-16.63382435058966,-72.93959058752414,-0.07327134017539359,-0.05828933544093928,0.014982004734454313,1044441913,1052248963.8,59.54733674610495,73.24847408085918,NaN,NaN,-2.5245159777650286,2.5494721443015878
2019-08-05T09:30:00-04:00,60.28,60.44,58.97,59.29,26576768,16494553.75,41.159001482431265,48.23556841034065,NaN,NaN,-120.83429389830273,-88.2472448923531,-0.10747151189708991,-0.11935738513690808,-0.011885873239818167,1017865145,1041169069.6,49.92664754386207,70.66180823600196,NaN,NaN,-5.092100035059717,1.4578189758214015
2019-08-06T09:30:00-04:00,59.35,60.26,58.69,60.03,27036103,16972221.9,49.3393901255588,47.802386097368284,NaN,NaN,-96.33548160892062,-88.30001416497448,-0.0759402502603347,-0.10681118606523654,-0.030870935804901842,1044901248,1039295512.4,48.49972900283269,67.93063469635841,NaN,NaN,-4.505123022719052,0.6059701188870512
2019-08-07T09:30:00-04:00,60.05,60.54,59.2,60.18,24954683,17645639.25,50.831580966561326,47.10097338194463,NaN,NaN,-41.086368466066915,-68.96140247142584,-0.042342058922870074,-0.08379850945848943,-0.04145645053561936,1069855931,1047289084.8,54.477648999425874,65.59703959432116,NaN,NaN,-3.5507336763152244,0.01215529100101187
2019-08-08T09:30:00-04:00,60.15,60.96,59.82,60.8,17057521,17498611.9,56.530862296136654,47.56676029810507,NaN,NaN,60.860533119896985,-42.805887040796584,0.02088117931114062,-0.015354976396693587,-0.03623615570783421,1086913452,1052795537.8,58.08681575114971,63.50153622537692,NaN,NaN,-0.7826069467412551,-0.10138217153359769
2019-08-09T09:30:00-04:00,60.85,61.135,60.645,60.87,11813461,17527018.6,57.13498871397732,48.17164015735698,NaN,NaN,120.49068369327934,-15.380985432022788,0.06421124885650425,0.044027905362796105,-0.020183343493708147,1098726913,1063652537.8,64.1260758582329,62.10092517204665,NaN,NaN,1.5768452041740777,0.13836459642464163
2019-08-12T09:30:00-04:00,60.88,61.04,60.44,60.75,13446466,17732077.2,55.70571808699096,48.94542151176479,NaN,NaN,95.33577956059489,27.853029259756738,0.08052952526732801,0.08047856309045187,-0.00005096217687614035,1085280447,1077135598.2,69.92225362604482,61.41471133473431,NaN,NaN,3.0522082423126653,0.554627974408645
2019-08-13T09:30:00-04:00,60.74,61.01,60.38,60.79,17913240,17909009.05,56.09994009360991,49.7043395107641,NaN,NaN,88.13310324526947,64.74674623059475,0.08908918516598685,0.11131051928060742,0.022221334114620572,1103193687,1088794086,73.85573953547811,61.297624268486736,NaN,NaN,4.360522669440065,1.0983272165559907
2019-08-14T09:30:00-04:00,60.87,61.18,60.125,60.29,20290469,18255797.5,50.097794793047335,50.14528164001236,NaN,NaN,58.6989565843514,84.7038112406784,0.05767259229271948,0.09431207448051993,0.03663948218780044,1082903218,1091403543.4,74.65469487209171,61.93093031988379,NaN,NaN,3.736102510432078,1.475152258538289
2019-08-15T09:30:00-04:00,60.5,61.275,60.14,61.07,24285172,18733390.8,57.700803779103246,50.92461655773088,NaN,NaN,115.21630614757049,95.5749658462131,0.08440173054541553,0.14214164536956986,0.05773991482415433,1107188390,1095458531,75.8878185747153,62.877554838654646,NaN,NaN,5.6323279107163495,2.0690344945637262
2019-08-16T09:30:00-04:00,61.1,61.57,61.01,61.38,16518395,18793897.3,60.29029364704326,51.61539938660536,NaN,NaN,180.85893730590467,107.64861656873818,0.11598763039190743,0.2027244528140386,0.08673682242213118,1123706785,1100454505.4,77.34997287327708,63.82443935549645,NaN,NaN,8.029943796348613,2.9205929662472814
2019-08-19T09:30:00-04:00,61.25,61.98,61.15,61.77,14234068,18846777.7,63.331609627624694,52.89633604545529,NaN,NaN,184.82167542159476,125.54579574093813,0.1538029230849711,0.27899047627834506,0.12518755319337396,1137940853,1110986586.6,80.09084185950456,64.88043355843381,NaN,NaN,11.025074117989716,4.078375987924772
2019-08-20T09:30:00-04:00,61.91,61.92,61.41,61.67,15526521,18783575.25,62.01996418129064,54.288940780640374,NaN,NaN,157.7258700672185,139.46434910532795,0.16191913515760079,0.32758647214037495,0.16566733698277417,1122414332,1114830715.6,80.99482406631253,66.3864729020065,NaN,NaN,13.035301561315512,5.357936784123449
2019-08-21T09:30:00-04:00,61.57,62.08,61.52,62.08,14400448,18825563.85,65.2020918999893,55.37776678734968,NaN,NaN,158.6801649793661,159.46059078433092,0.1831730357010066,0.3946336316090324,0.21146059590802582,1136814780,1125613028,83.28705612249041,67.9076753879659,NaN,NaN,15.750239862198054,6.8425515095626785
2019-08-22T09:30:00-04:00,62.04,62.22,61.61,62.14,14917127,18864004.15,65.65558474584722,56.50711603137227,NaN,NaN,146.68713830162875,165.75475721514255,0.18879354953503763,0.44745253282682285,0.2586589832917852,1151731907,1134521731.4,84.9068301118738,69.7190677712351,NaN,NaN,18.07844017675313,8.447678462018457
2019-08-23T09:30:00-04:00,62.26,62.46,61.17,61.48,21298197,19234962.85,56.875128856026976,57.629696558057674,NaN,NaN,103.55937921726195,150.294845597414,0.13794170618890234,0.43108611602791314,0.2931444098390108,1130433710,1135867116.4,85.14104075256195,72.23438157185653,NaN,NaN,17.467373333156637,9.736206300752482
2019-08-26T09:30:00-04:00,61.63,62.21,61.48,62.19,12849145,19046336.15,62.66028963632236,58.58118938025507,NaN,NaN,114.18905138386108,136.16832078986727,0.14147562344955827,0.46998893915095863,0.32851331570140035,1143282855,1136935516.8,85.335648960734,74.86551871170661,NaN,NaN,18.820406286758548,11.033949155896206
2019-08-27T09:30:00-04:00,62.49,62.74,62.23,62.3,19225278,19057820.95,63.47774533015638,59.48448683479757,NaN,NaN,137.12692146657963,132.04853106973948,0.14029917819493665,0.5038872884450711,0.3635881102501345,1162508133,1144954277,86.73941085578441,77.16993027287508,NaN,NaN,20.15124186368577,12.336419542723286
2019-08-28T09:30:00-04:00,62.37,62.59,61.91,62.13,15896520,18633598.7,61.24616215843461,59.82129396781886,NaN,NaN,104.25755594382704,121.16400926263168,0.11804332409919871,0.5111422653741329,0.39309894127493417,1146611613,1146913643.6,87.06523429635114,79.23981731181804,NaN,NaN,20.566864303858793,13.512197365742644
2019-08-29T09:30:00-04:00,62.48,62.58,61.98,62.56,17734003,18045642.95,64.63299730670906,60.35686601015684,NaN,NaN,105.99396291504029,113.02537418531396,0.12176354724288208,0.5453033753285368,0.4235398280856547,1164345616,1149436385.4,87.49139193441933,80.90876846011709,NaN,NaN,21.96332012414164,14.7195006169425
2019-08-30T09:30:00-04:00,62.75,62.8,62.39,62.58,12082979,17902828.2,64.78714138559701,61.00553910291442,NaN,NaN,112.20091825039495,114.75368199194057,0.11512728619577811,0.5674489358303774,0.45232164963459925,1176428595,1158635362.4,88.92434668524893,82.26606082148881,NaN,NaN,23.129403612957613,15.920915330658945
2019-09-03T09:30:00-04:00,62.56,63.7,62.49,63.69,21364845,17642232.05,72.06435284259742,62.145854299270674,NaN,NaN,157.34134168245606,123.3841400516596,0.17164652045448087,0.6668798002027003,0.49523327974821946,1197793440,1169537479.4,90.3371585522486,83.4433050369724,NaN,NaN,26.698482212476687,17.460567742347195
2019-09-04T09:30:00-04:00,63.87,64.03,63.35,63.75,15816622,17081258,72.39643220414325,63.73861411434895,NaN,NaN,179.0383529513893,131.76642634862156,0.19738779984296606,0.7419680295519271,0.544580229708961,1213610062,1179757865.2,91.43958794912531,84.64222597104624,NaN,NaN,29.60667641602206,19.195726124300748
2019-09-05T09:30:00-04:00,63.33,63.47,62.84,63.06,29333136,17300180.65,63.10599240902973,64.12469901648656,NaN,NaN,117.02584610826278,134.3200843815087,0.1541755183993374,0.7372996277081327,0.5831241093087953,1184276926,1187290927.8,92.15044149269887,85.80384189375934,NaN,NaN,29.136665562086346,20.61586032969869
2019-09-06T09:30:00-04:00,63.22,63.36,62.62,62.81,12663215,17080465.35,60.096825730957626,64.1108798796233,NaN,NaN,91.17067999393281,131.35542779728718,0.09773811496362672,0.7052967530133287,0.607558638049702,1171613711,1188744546.8,92.28359848546381,86.87052943748697,NaN,NaN,27.791074693684436,21.640890953125226
2019-09-09T09:30:00-04:00,62.68,62.79,62.38,62.5,16824965,17331040.55,56.49913513039198,63.62284598696381,NaN,NaN,51.17636956894096,119.1505180609964,0.03191817845950662,0.6474563611240853,0.6155381826645787,1154788746,1184416577,87.52302387998111,87.40139958180671,NaN,NaN,25.53813557000834,22.19764018410853
2019-09-10T09:30:00-04:00,62.4,62.58,62.0438,62.58,19168054,17617119.95,57.211031973320374,63.279350829251655,NaN,NaN,30.746938565004243,93.83163743750603,-0.011516017264386336,0.6011431610840958,0.6126591783484822,1173956800,1179649249,82.47597174791322,87.5071958447782,NaN,NaN,23.93327884402588,22.445588564096724
2019-09-11T09:30:00-04:00,62.49,63.25,62.21,63.2,22688457,17855880.8,62.35306837249224,63.075849148716145,NaN,NaN,72.71299334878103,72.56656551698438,-0.004154586245319503,0.6074659455418328,0.6116205317871523,1196645257,1176256288,78.98498242475921,87.19990486636883,NaN,NaN,24.091479527912462,22.680715844641828
2019-09-12T09:30:00-04:00,63.58,63.77,63.05,63.34,23599650,18021339.85,63.42198658935249,62.916306423252244,NaN,NaN,118.00130447788017,72.76165719090785,0.004035651673172769,0.6166650963786182,0.6126294447054454,1220244907,1183449884.2,80.83696635096355,86.9092003120181,NaN,NaN,24.54051437749846,22.946401349335634
2019-09-13T09:30:00-04:00,62.98,63.4,62.75,62.94,24999131,18057037.8,58.32637282760615,63.01996670693647,NaN,NaN,70.83965497129019,68.69545218637931,-0.022154712633878804,0.584936053913097,0.6070907665469758,1195245776,1188176297.2,81.96175770016175,86.68210866541808,NaN,NaN,23.37714708812923,23.007936454877576
2019-09-16T09:30:00-04:00,63.04,63.09,62.641,62.99,11962988,17829267.45,58.7722761570171,62.742251458414664,NaN,NaN,49.03162582738242,68.26650343806762,-0.03975278638897728,0.5573997835607543,0.5971525699497315,1207208764,1198660300.8,84.17993450256571,86.59955763269178,NaN,NaN,22.562717598398553,22.94433376109486
2019-09-17T09:30:00-04:00,63.1,63.69,63.07,63.54,17400992,17987613.65,63.410135590612896,62.73742219130442,NaN,NaN,106.0879542912077,83.3347065833083,-0.01904342223058131,0.573348292161505,0.5923917143920863,1224609756,1208790892,85.97469524772667,86.54493508925908,NaN,NaN,23.227852159743144,22.984836389473188
2019-09-18T09:30:00-04:00,63.78,64.01,63.375,63.81,21937748,18308175,65.46406359936967,63.038700865656914,NaN,NaN,129.71048629438727,94.73420517242955,0.006765140726213148,0.6008481402998527,0.5940829995736395,1246547504,1218771341.4,87.48148014112381,86.57466693531428,NaN,NaN,24.403178527628445,23.187456694923938
2019-09-19T09:30:00-04:00,64.01,64.17,63.77,64.11,15058725,18341088.85,67.63778945005117,63.25332887589564,NaN,NaN,149.26127121155872,100.98619851916526,0.036315965975487474,0.6394779570429989,0.6031619910675114,1261606229,1227043605.8,88.57690302119872,86.65220344151281,NaN,NaN,26.052505320861563,23.59674935577217
2019-09-20T09:30:00-04:00,63.7,63.94,63.38,63.87,18518196,18521142.3,64.15871394148209,63.208441201316006,NaN,NaN,104.1342921960538,107.64512596411798,0.032118955746077815,0.6433106857501087,0.6111917300040309,1243088033,1236612057.2,89.6996519670898,86.70758239021572,NaN,NaN,26.42115043327728,24.000235223987186
2019-09-23T09:30:00-04:00,63.85,64.12,63.72,63.88,8815014,17896983.15,64.24124743925,62.64964795821976,NaN,NaN,115.46450138621503,120.9317010758845,0.02287068061157771,0.639780080768503,0.6169094001569253,1251903047,1245550913.8,90.62653309719056,86.7282520005687,NaN,NaN,26.743834012295032,24.392177908031165
2019-09-24T09:30:00-04:00,64.11,64.85,64.06,64.63,26965701,18602810.95,69.84905978676647,62.46769278555,NaN,NaN,170.43780868726432,133.80167195509586,0.058114124676116874,0.6895520560020714,0.6314379313259545,1278868748,1256402712.2,91.61320467119803,86.74065319500248,NaN,NaN,28.767397209214206,25.0172092367716
2019-09-25T09:30:00-04:00,64.58,64.66,64.24,64.59,16234864,18453290.25,69.22552486591694,62.904802246756226,NaN,NaN,146.93182516506712,137.2459397292318,0.06884818855051589,0.7174981670140994,0.6486499784635835,1262633884,1259619988.2,91.8859038325446,86.7217576478486,NaN,NaN,30.21883734879298,25.76029896706037
2019-09-26T09:30:00-04:00,64.75,65.11,64.625,64.93,13403342,18328631.35,71.55030279542947,63.722907751361355,NaN,NaN,169.58857753389015,141.3114009936981,0.08775134368429272,0.7583391580689494,0.6705878143846566,1276037226,1262506187.6,92.13302956631647,86.71100272505237,NaN,NaN,32.1642262032872,26.67514571509277
2019-09-27T09:30:00-04:00,65.02,65.06,64.34,64.7,16614848,18272673.6,67.81806085135332,64.53140244571574,NaN,NaN,130.1141819224793,146.50737893898318,0.07420772089115835,0.7633474654986045,0.6891397446074462,1259422378,1265773056.6,92.41463709154829,87.06040366873573,NaN,NaN,32.727720257085274,27.5397992210917
2019-09-30T09:30:00-04:00,64.75,65.07,64.56,64.74,10845533,18210801.3,68.12942247646149,65.31128748165439,NaN,NaN,124.28281195152944,148.27104105204606,0.05809870020274743,0.7617631198608805,0.7036644196581331,1270267911,1269446029.4,92.72974343844967,87.79281593234548,NaN,NaN,33.276554427754625,28.359335679186405
2019-10-01T09:30:00-04:00,64.52,64.7,64.24,64.59,23809563,18333037.2,65.56754843677754,65.54089320053191,NaN,NaN,85.0535824277238,131.19419580013795,0.02896842448170589,0.7398749502602655,0.7109065257785596,1246458348,1262963949.4,85.9442856783949,88.28990902189089,NaN,NaN,33.04183939799935,29.02826478187397
2019-10-02T09:30:00-04:00,64.45,64.56,63.57,63.73,19871548,18535783.5,53.21286589883906,64.81167029406666,NaN,NaN,26.151413808903495,107.03811352890523,-0.05217283065100964,0.6456904874647975,0.6978633181158072,1226586800,1255754532.6,79.0186428465012,88.16002877157214,NaN,NaN,28.936537580091127,29.01516089590499
2019-10-03T09:30:00-04:00,63.75,63.91,63.42,63.88,34803196,18809286.5,54.81220759830733,64.5606584919739,NaN,NaN,1.2141754451525577,73.36323311115771,-0.09708524849485212,0.576506757497242,0.6735920059920941,1261389996,1252825086.6,76.32715630563443,87.75755724339163,NaN,NaN,26.048838397549922,28.591400538997124
2019-10-04T09:30:00-04:00,63.96,64.91,63.87,64.77,18802381,19116244.8,62.912884411343,64.85641622442576,NaN,NaN,76.0061765291798,62.541632032497816,-0.06948940169289908,0.5867302538759702,0.6562196555688693,1280192377,1256979086.4,77.49761695407156,87.28024884707062,NaN,NaN,26.01720792040058,28.223658736340475
2019-10-07T09:30:00-04:00,64.71,64.79,64.36,64.52,13648836,18957438.35,59.676654732588425,64.58973902028114,NaN,NaN,73.70767787996444,52.42660521818482,-0.07048715556823648,0.5681107111085737,0.6385978666768102,1266543541,1256234212.4,76.76467625742097,86.62239034776307,NaN,NaN,24.93830647488159,27.754322698989206
2019-10-08T09:30:00-04:00,64.48,64.53,63.89,63.92,21656258,19081848.55,52.67358369999767,63.676133313183136,NaN,NaN,15.788967595104587,38.57368225166098,-0.11153004834169378,0.49918530624969293,0.6107153545913867,1244887283,1255919999.4,76.43627409001353,85.83344705839806,NaN,NaN,21.640452059595187,26.880912607647204
2019-10-09T09:30:00-04:00,64.09,64.48,63.935,64.23,9008209,18397836.15,55.57435148989131,62.81445917317172,NaN,NaN,22.306717363741498,37.80474296262857,-0.11719264849943611,0.46422454396709156,0.5814171924665277,1253895492,1261381737.8,78.18339585016632,85.0910536890386,NaN,NaN,19.896247237668653,25.88310326907884
2019-10-10T09:30:00-04:00,64.08,64.3,63.6,64.16,15612446,17998475.95,54.75818377892926,62.14299273298938,NaN,NaN,-10.302847368964414,35.501338399805185,-0.12436633031768696,0.4259592795694189,0.5503256098871059,1238283046,1256760347.8,73.23542827813219,83.91503771125592,NaN,NaN,18.262199167485466,24.79440268313693
2019-10-11T09:30:00-04:00,64.1,64.32,63.7,63.92,16110856,17554062.2,51.94162743395396,61.2644484468968,NaN,NaN,-26.191817369118493,15.061739620145522,-0.14267661941685983,0.3719798356160311,0.5146564550328909,1222172190,1245156310.4,62.533832476119905,81.9084162383223,NaN,NaN,16.043888487185693,23.54432922657247
2019-10-14T09:30:00-04:00,64.1,64.13,63.32,63.51,10013168,17456571.2,47.4513301189428,59.664610613480825,NaN,NaN,-95.4830413117006,-18.776404218187484,-0.17753107656971495,0.29274260932074725,0.4702736858904622,1212159022,1234279406.6,54.49545410411527,79.25714834067352,NaN,NaN,12.737716276666996,22.00052737658597
2019-10-15T09:30:00-04:00,63.55,63.7,63.145,63.31,15905664,17381804.8,45.38998637445616,57.96207214980505,NaN,NaN,-143.4745556367309,-50.62910886455458,-0.2071216308705522,0.21137164730227198,0.41849327817282417,1196253358,1224552621.6,48.492356549145526,76.15760924900215,NaN,NaN,9.375845607801399,20.197001409616746
2019-10-16T09:30:00-04:00,63.27,63.48,62.98,63.45,16230696,17096452.2,47.121646575181465,56.21716813407305,NaN,NaN,-146.7299783901865,-84.43644801534018,-0.20969160929881742,0.15637876654930238,0.3660703758481198,1212484054,1216270334,44.04336768833968,72.72263340057523,NaN,NaN,7.097333838643957,18.325620328049204
2019-10-17T09:30:00-04:00,63.45,63.74,63.295,63.61,13230050,17005018.45,49.107824000410695,54.88072264472,NaN,NaN,-94.9640287769912,-101.36868429694553,-0.1934366088595954,0.12427461477362556,0.31771122363322096,1225714104,1213756545.6,42.7610389618591,69.17594781988315,NaN,NaN,5.749102253030633,16.528974888760835
2019-10-18T09:30:00-04:00,63.46,63.9599,63.3,63.82,14552882,16806752.75,51.673542887296996,53.7053026740654,NaN,NaN,-70.53664367162305,-110.23764955744643,-0.16260282599913833,0.11445769113429805,0.2770605171334364,1240266986,1217375504.8,45.23319517039133,65.78333722930755,NaN,NaN,5.323278824025856,14.928161165227268
2019-10-21T09:30:00-04:00,63.83,64.09,63.63,64.07,11479358,16939969.95,54.60746058844851,52.922439256327614,NaN,NaN,-32.045364144227705,-97.55011412395186,-0.12132439131863268,0.12540502798514552,0.2467294193037782,1251746344,1225292969.2,50.29146768370102,63.236707372543705,NaN,NaN,5.791201910834381,13.62288127174257
2019-10-22T09:30:00-04:00,64.22,64.63,64.03,64.34,15805857,16381977.75,57.60127069168754,53.23589674153107,NaN,NaN,36.549419105705844,-61.54531917546451,-0.07411045887361253,0.15409134571176253,0.22820180458537506,1267552201,1239552737.8,57.843449389081584,61.72419355415659,NaN,NaN,7.059267977710079,12.685222229737928
2019-10-23T09:30:00-04:00,64.49,64.76,64.315,64.6,12933120,16216890.55,60.31554922330421,53.62899257188799,NaN,NaN,73.27062037270015,-17.545199422887187,-0.026120567686990948,0.19555109497663636,0.2216716626636273,1280485321,1253152991.2,63.53380767953321,60.8103829380065,NaN,NaN,8.9426216949461,12.150565010481952
2019-10-24T09:30:00-04:00,64.63,64.93,64.53,64.82,11480620,16120754.45,62.50297059178077,53.59971301334783,NaN,NaN,109.92196777648495,23.431999887808047,0.01734679751521956,0.24335515955765175,0.2260083620424322,1291965941,1266403358.6,68.0576459177836,60.13609929255737,NaN,NaN,11.18912472844523,12.01321639876242
2019-10-25T09:30:00-04:00,64.87,64.96,63.9,64.16,16925130,16136268.55,53.05489288862911,53.1267300244936,NaN,NaN,43.64347881553496,46.26802438523964,-0.0004981810840181122,0.22538563568740955,0.22588381677142766,1275040811,1273358123.6,70.15074311233894,59.66367549648006,NaN,NaN,10.364624798234802,11.777703312972761
2019-10-28T09:30:00-04:00,63.83,64,63.2005,63.28,25068608,16847422.3,43.59291142772551,52.47811057647416,NaN,NaN,-98.44321588186419,32.988454037712344,-0.06987583627932192,0.13853902142227525,0.20841485770159718,1249972203,1273003295.4,69.89908304626759,59.19673327906964,NaN,NaN,6.332227764671833,10.999778234644058
2019-10-29T09:30:00-04:00,63.24,63.48,63.06,63.34,19772413,16645564.8,44.32202195313523,51.674372752420155,NaN,NaN,-121.72033715151713,1.3345027862677512,-0.1077684183308115,0.0737043347880828,0.1814727531188943,1269744616,1273441778.4,70.04210825594647,58.61521273662537,NaN,NaN,3.4308213715541482,9.918498682774072
2019-10-30T09:30:00-04:00,63.39,64.06,63.382,63.9,19680340,16636004.4,50.72403143261669,51.38621901339783,NaN,NaN,-31.657250802267505,-19.65107144872578,-0.09178591680380749,0.06674035711413495,0.15852627391794244,1289424956,1275229705.4,70.65439884447899,58.430853491364424,NaN,NaN,3.034997209808158,8.935141329493227
2019-10-31T09:30:00-04:00,63.96,64.33,63.745,64.25,17245867,15758137.95,54.26366964038918,51.55207917100035,NaN,NaN,23.085725924663013,-37.018319819090166,-0.05606589649442503,0.08844390329991114,0.14450979979433617,1306670823,1278170681.8,71.67974369910742,59.08413286443495,NaN,NaN,3.8754911262202505,8.212334157597088
2019-11-01T09:30:00-04:00,64.29,64.49,63.98,64.09,15690936,15602565.7,52.410238471195306,51.90628691044696,NaN,NaN,41.6885690902343,-37.4093017641503,-0.042266507308614615,0.09167666565856791,0.13394317296718253,1290979887,1281358497,72.78955433268291,60.390854309332646,NaN,NaN,3.9709908235773494,7.60642796702284
2019-11-04T09:30:00-05:00,64.03,64.065,63.04,63.27,24342788,16137263.3,44.09724703842569,51.81394838644478,NaN,NaN,-84.14695194189831,-34.55004897615712,-0.0849532560212625,0.027751602940604414,0.11270485896186691,1266637099,1284691476.2,73.93945251408178,62.208504021113804,NaN,NaN,1.2356488630160973,6.696316666450448
2019-11-05T09:30:00-05:00,62.96,63.16,62.4529,62.62,21996855,16154293.15,38.838440780768344,51.22229082970098,NaN,NaN,-180.72515855365327,-46.35101325658435,-0.1497640832425397,-0.0745002450913077,0.07526383815123198,1244640244,1279670601.8,69.19557474427846,64.00509023939514,NaN,NaN,-2.946397886114556,5.318786016084019
2019-11-06T09:30:00-05:00,62.73,63.12,62.63,62.86,17771929,16592479.15,41.60739705060595,50.686546047572065,NaN,NaN,-140.58845762693113,-68.13725462151709,-0.1679053001630581,-0.13461778705259064,0.03328751311046745,1262412173,1274268045.2,64.40711585294375,65.55123858875834,NaN,NaN,-5.33845418813748,3.796323129766662
2019-11-07T09:30:00-05:00,62.53,62.8497,61.6,62.01,22844714,16954092.55,35.48075185917237,49.52991811699174,NaN,NaN,-208.22327934716992,-114.39905567588366,-0.22502248033818115,-0.24799058731225898,-0.02296810697407784,1239567459,1260847372.4,54.346028869441994,66.20215528154768,NaN,NaN,-9.61863521488857,1.8799005091016288
2019-11-08T09:30:00-05:00,61.82,62.09,61.48,61.75,15971627,16947131.1,33.83935584046395,48.04648206356427,NaN,NaN,-211.4015510631991,-165.01707970657034,-0.26540956882247313,-0.3547300680021692,-0.08932049917969612,1223595832,1247370561.4,46.49208786581008,65.93077100884118,NaN,NaN,-13.556362283018142,-0.32527988977262434
2019-11-11T09:30:00-05:00,61.77,61.84,61.31,61.37,9274318,16910188.6,31.54260910663335,46.18514909320326,NaN,NaN,-195.5858903277984,-187.30486738375038,-0.30024659959978195,-0.4646287486794236,-0.16438214907964163,1214321514,1236907444.4,41.48001525393068,64.76195428490182,NaN,NaN,-17.541903490152418,-2.7847975469697372
2019-11-12T09:30:00-05:00,61.38,61.64,61.34,61.52,12668515,16748331.15,33.462385265577495,44.26706595336564,NaN,NaN,-159.76019923490483,-183.11187552000067,-0.2952710624525374,-0.5334709771453134,-0.238199914692776,1226990029,1233377401.4,39.91652690818914,63.07500565837724,NaN,NaN,-20.110549134498694,-5.259904916616731
2019-11-13T09:30:00-05:00,61.74,62.57,61.66,62.43,17293102,16801451.45,43.765487361544494,42.92867429406304,NaN,NaN,-86.30404617276962,-172.25499322916838,-0.2164281979267873,-0.5087351621012601,-0.2923069641744728,1244283131,1229751593,38.31888959493294,60.950808778173624,NaN,NaN,-18.92976737964775,-7.212742411335448
2019-11-14T09:30:00-05:00,62.63,62.97,62.45,62.65,16836021,16981750,45.94472614382069,42.420805240862435,NaN,NaN,-44.419922807937446,-139.49432192132187,-0.13896070128041543,-0.46600784077499213,-0.3270471394945767,1261119152,1234061931.6,41.32542696610468,58.89185762487118,NaN,NaN,-17.27515125061248,-8.650229388375024
2019-11-15T09:30:00-05:00,62.68,62.88,62.49,62.85,9966727,16752442.25,47.92060280065644,42.72992605321464,NaN,NaN,-36.513279228976835,-104.51666755447744,-0.06737586648798516,-0.41126697260455813,-0.343891106116573,1271085879,1243559941,47.40866121582951,57.28539892269703,NaN,NaN,-15.315547515040006,-9.602417692184307
2019-11-18T09:30:00-05:00,62.98,63.5,62.87,62.98,16490830,17003015.85,49.21991414226132,43.07977549529509,NaN,NaN,-5.0725333971358815,-66.41399616834491,-0.007544438746429849,-0.3533216545496103,-0.34577721580318044,1287576709,1258210980,55.135592525111505,56.22064779906596,NaN,NaN,-13.33344781190122,-10.135421995001009
2019-11-19T09:30:00-05:00,62.8,63.1663,62.49,62.82,18052433,17115344.65,47.64440649449341,42.85980228542913,NaN,NaN,-23.269582000865384,-39.11587272153703,0.023293791642872985,-0.3166599762495892,-0.3399537678924622,1269524276,1266717829.4,58.91051889538529,55.38179923127355,NaN,NaN,-12.143198972569907,-10.422247277510852
2019-11-20T09:30:00-05:00,62.91,63.29,62.76,63.2,19679533,17452665.3,51.60641798103602,42.66999859547534,NaN,NaN,4.671306614049973,-20.920802164173104,0.06875150382713441,-0.25401438810854415,-0.32276589193567856,1289203809,1275701965,62.49923356410505,54.72604850734481,NaN,NaN,-9.940491475527065,-10.353425020084597
2019-11-21T09:30:00-05:00,63.19,63.25,62.77,62.98,14209045,17589086.55,49.28123061309412,42.44649803418239,NaN,NaN,5.79639400107287,-10.877538802371026,0.0825421587112124,-0.21958819354666304,-0.30213035225787543,1274994764,1278477087.4,63.55800198923255,54.06665191138408,NaN,NaN,-8.748625674090523,-10.124167970656872
2019-11-22T09:30:00-05:00,63.12,63.15,62.545,63,11485205,17317090.3,49.50397329498315,42.832692766793635,NaN,NaN,3.068469216824428,-2.961189113210768,0.09088969569535771,-0.18851823263867828,-0.279407928334036,1286479969,1281555905.4,64.74716513528718,53.41005995575589,NaN,NaN,-7.711023235052675,-9.7794330084277
2019-11-25T09:30:00-05:00,63.06,63.24,62.65,62.79,20399303,17083625.05,47.16190241339695,43.42722574055283,NaN,NaN,6.2950941330563,-0.6876636071723375,0.0805027814685429,-0.1787794514983574,-0.2592822329669003,1266080666,1277256696.8,61.718549525283876,52.8759867258277,NaN,NaN,-7.451845927907118,-9.446920568353331
2019-11-26T09:30:00-05:00,62.89,63.09,62.75,63,16157005,16902854.65,49.723493217525736,44.00694689533282,NaN,NaN,15.419114212026718,7.050075635406083,0.08553791205706926,-0.1523598428955637,-0.23789775495263296,1282237671,1279799375.8,62.82606458429381,52.7630544923527,NaN,NaN,-6.530540753913268,-9.030294880576179
2019-11-27T09:30:00-05:00,62.85,63.18,62.8,63.11,12528286,16545251.95,51.06183890215013,45.11988168411694,NaN,NaN,32.562401526561224,12.628294617908308,0.0933986071097016,-0.12114949606550596,-0.21454810317520756,1294765957,1280911805.4,63.325967425581375,53.40447867493408,NaN,NaN,-5.390877260063268,-8.510378077645763
2019-11-29T09:30:00-05:00,63.23,63.47,62.985,63.05,5121473,15939032.25,50.275690563700245,46.29390559291953,NaN,NaN,62.06546520706364,23.88210885910646,0.09155636343711243,-0.10010264887881704,-0.19165901231592947,1289644484,1283841749.4,64.6734398401052,54.70314667309805,NaN,NaN,-4.627084757217924,-7.955621889013215
2019-12-02T09:30:00-05:00,62.75,62.91,62.51,62.64,18700616,16089516.25,45.15920633110542,47.26651968038182,NaN,NaN,3.424456466374815,23.95330630901654,0.06118422139779106,-0.11517873556869063,-0.1763629569664817,1270943868,1280734529.2,62.06889047050751,56.17378061713924,NaN,NaN,-5.313242208229154,-7.578139077472635
2019-12-03T09:30:00-05:00,62.8,62.93,62.554,62.81,12926016,15518677.65,47.54299018905197,48.272277174915715,NaN,NaN,22.35580345638729,27.16544817368274,0.05139704344885235,-0.11211665265541626,-0.1635136961042686,1283869884,1284292372.8,63.86343014415045,57.884273705422196,NaN,NaN,-5.261441755553258,-7.247182317198438
2019-12-04T09:30:00-05:00,62.79,63.39,62.74,63.29,19597699,15398719.85,53.66693381382075,48.9795233500783,NaN,NaN,79.65103196613741,40.01183172450488,0.07469151376027494,-0.07014930390392493,-0.14484081766419987,1303467583,1288538355.2,65.93474078255551,59.85683450453811,NaN,NaN,-3.4508268090366374,-6.704845816032466
2019-12-05T09:30:00-05:00,63.19,63.41,63.03,63.4,12450190,15132632.9,54.964468791440126,49.623790682051116,NaN,NaN,96.67163910664998,52.833679240522635,0.09371701299631079,-0.027694551418811386,-0.12141156441512217,1315917773,1292768718.4,67.90840711536778,61.75561880091406,NaN,NaN,-1.570207096501307,-5.971325998956586
2019-12-06T09:30:00-05:00,63.16,63.58,63.16,63.21,9582247,14469509.55,52.243009642236004,49.932534027878226,NaN,NaN,98.0082148594004,60.022229170989974,0.08971055658298845,-0.009273368686386618,-0.09898392526937506,1306335526,1296106926.8,69.41432264259569,63.32745175996878,NaN,NaN,-0.7068559588958266,-5.219258850376478
2019-12-09T09:30:00-05:00,63.35,63.36,62.88,62.99,12025007,14272178.55,49.20504192833731,49.93147172688366,NaN,NaN,54.569398774619394,70.2512176326389,0.06935914321776028,-0.012284996247174718,-0.081644139464935,1294310519,1300780257,71.43519249194665,64.491708900457,NaN,NaN,-0.8048814735733916,-4.58863351083318
2019-12-10T09:30:00-05:00,62.98,63.11,62.82,62.98,12598784,14438401.85,49.06537547810154,50.0329695114271,NaN,NaN,25.879553799617685,70.95596770128498,0.05307350809163759,-0.015302254350388012,-0.0683757624420256,1281711735,1300348627.2,70.96879382309109,65.353014252436,NaN,NaN,-0.9233342294355872,-4.065019327776381
2019-12-11T09:30:00-05:00,63.06,63.26,62.83,63.15,11990090,14404480.6,51.58147408431412,50.03118780451838,NaN,NaN,48.107250789697254,64.64721146599695,0.0515561581291948,-0.003930564780532109,-0.05548672290972691,1293701825,1298395475.6,68.78043166547309,65.80167125967657,NaN,NaN,-0.35651960951405565,-3.5352336537389055
2019-12-12T09:30:00-05:00,63.07,63.32,62.61,62.88,24118701,14745760.55,47.562811079060666,49.90844355208743,NaN,NaN,-20.637890177708556,41.18530560912524,0.03117754619755716,-0.016514790162780457,-0.047692336360337616,1269583124,1289128545.8,59.418637955149066,65.50600240009918,NaN,NaN,-0.9522282414061577,-3.166232880548513
2019-12-13T09:30:00-05:00,62.91,63.48,62.665,63.37,19334589,14870688.95,54.49214104487151,50.264741248508024,NaN,NaN,78.72341269364992,37.328345175975144,0.04847570574558177,0.012902295821639598,-0.03557340992394217,1288917713,1285644983.2,56.31554428522635,64.90374376795197,NaN,NaN,0.5369601957685356,-2.637205298217506
2019-12-16T09:30:00-05:00,63.37,64.2,63.37,64.16,20774681,15411086.65,62.98486284889839,51.3949527081867,NaN,NaN,332.2928440150296,92.87303422405719,0.10751695083562322,0.09882277862058686,-0.008694172215036364,1309692394,1288721358.2,58.382578655315655,64.66546013438281,NaN,NaN,4.800903525971755,-1.574618323333326
2019-12-17T09:30:00-05:00,64.2,64.772,64.14,64.37,16847277,15428909,64.86207555958195,52.476280018333576,NaN,NaN,345.60471732734953,156.81806692960353,0.15236761572314717,0.1817653474388976,0.029397731715750434,1326539671,1297686945.4,63.76387238857216,64.73244640611698,NaN,NaN,8.880873387717605,-0.08097665032605028
2019-12-18T09:30:00-05:00,64.42,64.72,64.08,64.63,12808112,15166692.95,67.08760021332662,53.62097725484618,NaN,NaN,251.77511600297598,197.5516399722593,0.18881636046519654,0.2654181822972461,0.07660182183204958,1339347783,1306816137,68.26379268763296,65.08514821054924,NaN,NaN,12.984170949342792,1.7854730067694986
2019-12-19T09:30:00-05:00,64.63,64.74,64.25,64.65,16901621,15027797.35,67.25938490915573,54.83409827952158,NaN,NaN,197.87705770397048,241.2546295485951,0.20234165100886803,0.32952888559313465,0.12718723458426662,1356249404,1324149393,74.6903890447455,65.80064458230926,NaN,NaN,16.29921895100559,3.8588652845175115
2019-12-20T09:30:00-05:00,64.13,64.94,64.13,64.59,22971226,15465906.4,66.14400871553534,56.33301273555228,NaN,NaN,155.6445941746705,256.63886584479917,0.19522335582475084,0.37121642936520516,0.17599307354045432,1333278178,1333021486,77.23185483631978,66.88371346558156,NaN,NaN,18.69666373289462,5.978550777142813
2019-12-23T09:30:00-05:00,64.7,64.73,63.82,63.99,16477952,15715543.75,56.12138270233185,56.94575505792941,NaN,NaN,90.72780853363268,208.32585874851983,0.14063272185605868,0.3517839758605277,0.211151254004469,1316800226,1334443052.4,77.61964037344967,67.86629991053151,NaN,NaN,17.803128590630777,7.667776179069665
2019-12-24T09:30:00-05:00,64.06,64.11,63.74,64.08,4512821,14921219.65,57.16975965992962,57.19595690408005,NaN,NaN,57.892663366749204,150.78344795639978,0.1028627344826199,0.33972967210774385,0.23686693762512395,1321313047,1333397727.6,76.58667454277372,68.62715232197567,NaN,NaN,17.387340186616022,9.05628532300486
2019-12-26T09:30:00-05:00,64.14,64.25,63.9247,64.19,6658664,14446302.6,58.47563695743771,57.446754630222735,NaN,NaN,66.00846267682606,113.6301172911698,0.07865747597253925,0.335188782590798,0.25653130661825874,1327971711,1331122513.2,74.26990437966263,69.08154498371101,NaN,NaN,17.417658705763436,10.250767234827514
2019-12-27T09:30:00-05:00,64.19,64.38,64.07,64.38,10301681,14334972.35,60.7042906651436,58.0511318461447,NaN,NaN,74.33276589709985,88.92125892979566,0.06914934317683635,0.3429679855893042,0.27381864241246784,1338273392,1327527310.8,70.63386633476797,69.16865524743761,NaN,NaN,18.08020781035597,11.369258745617293
2019-12-30T09:30:00-05:00,64.11,64.38,64.025,64.37,11934365,14675616.95,60.520183398313,58.859356236857245,NaN,NaN,65.107311756288,70.81380244611917,0.05643037797675893,0.3443566148834165,0.2879262369066576,1326339027,1326139480.6,69.22497965586457,69.01078290200317,NaN,NaN,18.573027832435454,12.398368615162743
2019-12-31T09:30:00-05:00,64.36,64.7,64.28,64.62,10808397,14281006,63.50050474063323,59.890436898466646,NaN,NaN,86.87657253603477,70.0435552465996,0.05882965074914559,0.3614633003430896,0.302633649593944,1337147424,1330208920.2,71.04852566389631,69.01647803348926,NaN,NaN,19.83775017736672,13.46113740976331
2020-01-02T09:30:00-05:00,64.73,64.75,63.565,63.81,19108607,14590135.55,50.26155386237277,59.796156882613694,NaN,NaN,27.443849486277596,63.953792470505256,0.0027981600296009823,0.30613134963094524,0.30333318960134426,1318038817,1329554074.2,70.32637821099007,69.12690278674047,NaN,NaN,16.78516686021285,13.93599875982753
2020-01-03T09:30:00-05:00,63.86,64.17,63.71,63.94,17989252,14509713.2,51.99151909204906,60.11249316925572,NaN,NaN,11.18476834257814,52.98905360365568,-0.02693711150762218,0.2696618002168165,0.2965989117244387,1336028069,1331165345.8,71.10461813833912,69.96161565696833,NaN,NaN,14.848664806489753,14.066379623636418
2020-01-06T09:30:00-05:00,63.86,64.19,63.76,64,10444528,14409430.1,52.807372071910194,59.99215252832992,NaN,NaN,13.171822065247012,40.75686483728511,-0.04303749157590542,0.2428020472545569,0.2858395388304623,1346472597,1332805186.8,71.9120044292361,71.07564852439761,NaN,NaN,13.523348263495102,13.988803715044801
2020-01-07T09:30:00-05:00,63.84,63.94,63.55,63.91,13085961,14584615.8,51.39645007010186,59.16440875841588,NaN,NaN,-16.947562068334534,24.3458900723606,-0.05922233571916147,0.21181161918151048,0.27103395490067195,1333386636,1334214708.6,72.62017574031185,72.09261974475449,NaN,NaN,12.018351174326918,13.707310494942247
2020-01-08T09:30:00-05:00,63.94,64.16,63.78,63.88,12741672,14620449.05,50.90818072814974,58.16770198474215,NaN,NaN,-2.767505605088661,6.417074444135918,-0.07064764452248828,0.18272439924756156,0.25337204377004985,1320644964,1330914216.6,68.27910398138343,72.41513628709814,NaN,NaN,10.641469252109923,13.269333174537628
2020-01-09T09:30:00-05:00,63.8,64.3,63.79,64.23,11643556,14572687.65,56.142946523371215,57.38594100688819,NaN,NaN,18.474993419171554,4.623303230714706,-0.05407910269223662,0.18577316540475408,0.2398522680969907,1332288520,1333764157.2,69.94955003904504,72.53554752648472,NaN,NaN,10.892420299452601,12.929774192382624
2020-01-10T09:30:00-05:00,64.32,64.625,64.29,64.4,10582934,14502329.85,58.45991977764603,56.757407783208926,NaN,NaN,78.6721134318403,18.12077224856714,-0.03219703022989073,0.19960598030962728,0.23180301053951802,1342871454,1335132834.2,70.74629215316202,72.25382631994304,NaN,NaN,11.771263035992519,12.764272598612608
2020-01-13T09:30:00-05:00,64.38,64.98,64.38,64.79,12671092,13929949.4,63.25582351672249,56.551108840436584,NaN,NaN,134.60000533421862,42.40640890236146,0.005981635480137637,0.23928005488969006,0.23329841940955243,1355542546,1336946824,71.81297329275247,71.86676335254538,NaN,NaN,14.0187223022104,12.943479699126579
2020-01-14T09:30:00-05:00,64.79,65,64.5,64.98,11495039,13537971.9,65.35440040582102,57.21061010497153,NaN,NaN,151.4207387181784,76.08006905966405,0.0395961352558043,0.2827935884793078,0.2431974532235035,1367037585,1343677013.8,75.3973434662851,71.70802785917647,NaN,NaN,16.549794857958414,13.458667578959698
2020-01-15T09:30:00-05:00,65.12,65.995,65.11,65.89,15886117,13293543.7,73.23803996433915,58.35834441242935,NaN,NaN,283.02502621531744,133.23857542374526,0.11444624696983824,0.3862552619358013,0.27180901496596305,1382923702,1356132761.4,80.37203387292011,71.97841066847265,NaN,NaN,21.84752041419693,14.657075126850732
2020-01-16T09:30:00-05:00,65.94,66.37,65.92,66.3,10898788,12996119.25,75.89901399686798,59.60287134381723,NaN,NaN,287.9224000224758,187.12805674440614,0.17904859678450635,0.495619760946596,0.31657116416208964,1393822490,1368439555.4,83.84730612106911,72.66251079285881,NaN,NaN,27.19923916554278,16.44881284666388
2020-01-17T09:30:00-05:00,66.28,66.85,66.1,66.76,13258773,13018652.3,78.48391878959,60.872844781277685,NaN,NaN,254.23721583830178,222.24107722569843,0.23662408126619583,0.6123512657448344,0.3757271844786386,1407081263,1381281517.2,86.52784303659669,73.79779484298945,NaN,NaN,32.597981835491765,18.755836987925008
2020-01-21T09:30:00-05:00,66.91,67.4,66.64,67.37,23876905,13367416.5,81.34175434238753,62.36009984871158,NaN,NaN,231.18090891772275,241.55725794239925,0.29581039608198934,0.7454901795811253,0.44967978349913595,1430958168,1396364641.6,88.8651058331648,75.2006609985109,NaN,NaN,38.24849485964621,21.540502398170894
2020-01-22T09:30:00-05:00,67.5,67.7697,67.4,67.58,10841565,12760933.45,82.21742894844836,63.69702300641266,NaN,NaN,203.03765201276812,251.8806406013172,0.3267024264648054,0.8580578165801427,0.5313553901153373,1441799733,1411317071.2,90.60516733302201,76.59756397487702,NaN,NaN,42.959954903341206,24.600424184623794
2020-01-23T09:30:00-05:00,67.57,68.2,67.5,68.18,12969299,12585500.8,84.4613242632626,66.13986374933336,NaN,NaN,177.72124434206395,230.8198842266665,0.362385004210955,0.984336645379031,0.621951641168076,1454769032,1425686137.2,91.91303946205029,78.13946834995274,NaN,NaN,47.77740352023754,27.911421232568614
2020-01-24T09:30:00-05:00,68,68.61,67.89,68.36,14401627,13079941.1,85.06998356445455,68.50261121164803,NaN,NaN,158.966710680234,205.02874635821814,0.3715702970170285,1.0864145124393616,0.7148442154223331,1469170659,1440755771,93.01179420856568,79.7042666406832,NaN,NaN,51.74499968432894,31.31621815424866
2020-01-27T09:30:00-05:00,68.32,68.8,68,68.19,11272166,13310616.2,81.81063272847737,70.57427268711712,NaN,NaN,135.2947816559155,181.24025952174088,0.34048303052949114,1.140448003584197,0.7999649730547059,1457898493,1450919217,93.63946517931313,81.25622812283156,NaN,NaN,53.84080632582629,34.534016464474036
2020-01-28T09:30:00-05:00,68.26,68.76,68.09,68.47,17528385,13671951.4,82.96810732096293,72.82939106217863,NaN,NaN,121.08314564002995,159.2207068662023,0.31372526898312025,1.1921215592836063,0.878396290300486,1475426878,1459812959,94.13583014939057,82.79306058062289,NaN,NaN,55.938014757128606,37.591730506281834
2020-01-29T09:30:00-05:00,68.51,68.75,68.235,68.65,10801222,13615294.25,83.68678251966895,75.17071976157285,NaN,NaN,109.60355069261644,140.53388660217198,0.28398703360290956,1.233380082304123,0.9493930487012134,1486228100,1468698632.4,94.59007425170762,84.67241559993178,NaN,NaN,57.86917113788632,40.48850773936819
2020-01-30T09:30:00-05:00,68.61,69.33,68.44,69.29,14404318,13795090.3,85.95589473647001,77.30021606250848,NaN,NaN,113.40383981333511,127.67040569642623,0.2826484838656349,1.302703653533257,1.020055169667622,1500632418,1477871309.6,95.01900693647474,86.46309109260531,NaN,NaN,60.339860976794604,43.32441534471482
2020-01-31T09:30:00-05:00,69.16,69.44,68.62,68.98,20474558,13863387.85,80.14105428908319,78.84886852761113,NaN,NaN,101.62753064240303,116.20256968886001,0.23790948218966657,1.3174420224047054,1.0795325402150389,1480157860,1480068749.8,95.1188517416047,88.20398820606552,NaN,NaN,60.485417879931404,45.77598713546005
2020-02-03T09:30:00-05:00,69.09,69.275,68.925,69.2,13547916,13641321.05,81.11732727799506,80.1246902248449,NaN,NaN,96.53031254172005,108.44967586602093,0.2015943284298618,1.3315254507523662,1.1299311223225044,1493705776,1487230206.4,95.43968084470434,89.89161017406207,NaN,NaN,60.9053086330932,47.93731877797907
2020-02-04T09:30:00-05:00,69.16,69.37,68.44,68.51,20692192,14153704.25,69.56619794460988,80.42553290618696,NaN,NaN,75.74317640440457,99.38168201889584,0.11392923138798694,1.272342661557488,1.158413430169501,1473013584,1486747547.6,94.98653567549054,91.29083818900531,NaN,NaN,57.38226313316394,49.28659654300548
2020-02-05T09:30:00-05:00,68.36,68.955,68.21,68.79,16305145,14314663.45,71.34915882661541,80.29061282492098,NaN,NaN,65.74072768327073,90.6091174170267,0.06031800009655108,1.2338109302901898,1.1734929301936388,1489318729,1487365673.4,95.0191518486086,92.33706090155451,NaN,NaN,55.08466867815041,50.1148925623119
2020-02-06T09:30:00-05:00,68.86,69.2,68.64,68.81,14954496,14425304.65,71.47769544317822,79.97480435680028,NaN,NaN,70.4415971678039,82.01666888792047,0.014131391941254012,1.1911571701202064,1.1770257781789524,1504273225,1488093834.8,95.0599240505049,93.13796218222849,NaN,NaN,53.31851272403008,50.5725525854145
2020-02-07T09:30:00-05:00,68.97,69.07,68.57,68.59,10696372,14377945.45,67.87067168782953,79.21671527810311,NaN,NaN,60.17105808471525,73.7253743763829,-0.040328875568884426,1.1266146837178468,1.1669435592867312,1493576853,1490777633.4,95.21538274582,93.7585007328873,NaN,NaN,50.75445062774511,50.59853802003316
2020-02-10T09:30:00-05:00,68.7,68.85,68.45,68.85,8139848,14255791.15,69.80968779000727,78.39299623864737,NaN,NaN,54.90025342895349,65.39936255382959,-0.06639561896342538,1.0839490355824495,1.1503446545458749,1501716701,1492379818.4,95.31026331354967,94.21886912434334,NaN,NaN,49.14966649356708,50.39155637339515
2020-02-11T09:30:00-05:00,68.97,69.325,68.93,69.1,10269690,14135721.05,71.58540030428462,77.6335656212071,NaN,NaN,76.52827509643414,65.5563822922355,-0.07378623734637069,1.0581118578629116,1.1318980952092823,1511986391,1500174379.8,95.75164524605911,94.58647468956029,NaN,NaN,48.30737395023828,50.09381602722988
2020-02-12T09:30:00-05:00,68.99,69.36,68.77,69.15,8047398,13963339,71.94086300773832,76.73924696009821,NaN,NaN,74.5955094084137,67.32733863726409,-0.08167895296387728,1.0297994040044358,1.111478356968313,1520033789,1506317391.8,96.06590267757838,94.88310777638371,NaN,NaN,47.718045049085525,49.754420173209255
2020-02-13T09:30:00-05:00,69.21,69.96,69.1,69.92,13587631,13848414.7,76.76206598296918,76.1458242757064,NaN,NaN,126.35940521324758,78.51090024635285,-0.043337743401531625,1.0573061777163986,1.1006439211179302,1533621420,1512187030.8,96.34417195081907,95.12113475797324,NaN,NaN,48.66204480088438,49.598366548591414
2020-02-14T09:30:00-05:00,70.05,70.45,69.95,70.39,10554068,13831178.7,79.12035014353826,75.95366123392503,NaN,NaN,187.8472304376398,104.04613471693774,0.002925561540705335,1.1043008730438117,1.1013753115031064,1544175488,1522306757.8,96.76855584856484,95.34464123434837,NaN,NaN,50.23909710883152,49.68989948576857
2020-02-18T09:30:00-05:00,70.66,71.1,70.46,70.98,15036218,13920050.95,81.63933656604672,75.8587490371453,NaN,NaN,236.45550383880453,140.35718479890798,0.05938053521060627,1.1756009805163643,1.116220445305758,1559211706,1533805758.8,97.17049442418711,95.56140296826241,NaN,NaN,52.46081479516093,50.08574452996748
2020-02-19T09:30:00-05:00,70.7,70.795,70.21,70.21,11195677,13285989.55,69.80340093158352,74.86707892371064,NaN,NaN,164.74804904181264,158.00113958798366,0.03233662334315479,1.1566412244847015,1.1243046011415467,1548016029,1541011686.4,97.3896144904615,95.76137012817341,NaN,NaN,50.23182832366477,50.10661364335281
2020-02-20T09:30:00-05:00,70.23,70.5,69.89,70.46,14405069,13464164.75,71.26026762434502,73.81739127284456,NaN,NaN,131.61579389526818,169.40519648535457,0.019395229599535213,1.1485486381409657,1.1291534085414305,1562421098,1549489148.2,97.622847135375,95.94735871380915,NaN,NaN,48.955887546582844,49.9422242009571
2020-02-21T09:30:00-05:00,70.33,70.785,70.26,70.33,11729023,13402150.95,69.38562152891943,73.04914607569,NaN,NaN,125.3186030057368,169.1970360438524,-0.008323487652754036,1.1187490489754879,1.127072536628242,1550692075,1552903279.2,97.71152788096987,96.13254986662093,NaN,NaN,47.34571028444385,49.571293641455206
2020-02-24T09:30:00-05:00,70.03,70.42,69.482,69.51,20442139,13704176.55,58.86617596979413,71.45977812510422,NaN,NaN,50.31718313248353,141.69102658282114,-0.08786650115675454,1.0172394101822988,1.1051059113390533,1530249936,1550118168.8,94.61082624608846,96.0733459667198,NaN,NaN,42.277092586129996,48.52926491926589
2020-02-25T09:30:00-05:00,69.58,69.7,67.925,68.05,28138344,14547485.45,45.60789821540388,69.7484710015895,NaN,NaN,-78.4527657121668,78.70937267262687,-0.2363652426549956,0.8096493580203088,1.0460146006753044,1502111592,1538698146,82.98267096392709,95.21592705875098,NaN,NaN,32.28764715961944,46.20903381074497
2020-02-26T09:30:00-05:00,68.05,68.66,67.35,67.36,26192261,14980679.25,40.91748466985647,67.57477999039244,NaN,NaN,-148.95947789107922,15.967867286048506,-0.37062122381431506,0.5827380709074106,0.9533592947217256,1475919331,1524278806.4,71.10026726072496,93.50743530247357,NaN,NaN,22.50691961073931,42.82301749645845
2020-02-27T09:30:00-05:00,67.09,67.46,64.31,64.33,43603144,16620775.35,27.52882768577335,64.43557515057782,NaN,NaN,-320.7107299942043,-74.497437491846,-0.637400810936757,0.1566082810507794,0.7940090919875364,1432316187,1498257824.2,55.621884232272144,90.6904324583141,NaN,NaN,6.301094456396475,37.60559991930674
2020-02-28T09:30:00-05:00,62.86,62.93,60.695,62.18,90272218,20414170.35,22.022366447171876,61.16069620481655,NaN,NaN,-390.94111572806247,-177.74938123860585,-0.9156462905380662,-0.35054877118504635,0.5650975193530199,1342043969,1456528203,40.423594352507784,86.77673328736321,NaN,NaN,-9.182097451200736,30.921643152091388
2020-03-02T09:30:00-05:00,62.5,65.927,62.3501,65.84,42175843,21499234.6,42.94463125215715,59.241763594970124,NaN,NaN,-177.90049318900265,-223.39291650290306,-0.8136247117013703,-0.45193337027369296,0.36169134142767734,1384219812,1427322178.2,33.52012571543507,82.36315203035504,NaN,NaN,-10.665995753841342,24.980551879815284
2020-03-03T09:30:00-05:00,65.88,67.24,64.77,65.03,63278995,23985788.55,40.363466546821265,57.01162546943703,NaN,NaN,-109.6539898160499,-229.63316132367967,-0.7620177893457861,-0.5908308952545553,0.17118689409123078,1320940817,1391088023.2,27.29269128666641,77.47322674754128,NaN,NaN,-12.856360177229648,19.575278728808865
2020-03-04T09:30:00-05:00,65.89,68.81,65.85,68.72,31428173,24522587.6,53.94405451483247,55.72613914851519,NaN,NaN,-21.663013294771666,-204.1738684044182,-0.45579883726288334,-0.3985616524873734,0.05723718477550993,1352368990,1366377955,24.015939166795505,72.32680078248535,NaN,NaN,-7.724477898001429,15.675313496407394
2020-03-05T09:30:00-05:00,67.59,68.58,66.86,67.66,33535107,25384085.7,50.3938917600706,53.84269813259386,NaN,NaN,-23.063786912153713,-144.64447978800803,-0.30814154645776787,-0.3279397482966999,-0.01979820183893205,1318833883,1343681494.2,21.46659081066032,66.97840212961687,NaN,NaN,-5.862937411989936,12.59842050949349
2020-03-06T09:30:00-05:00,65.87,67.38,64.61,67.11,35499067,26411314.25,48.60641749292987,51.663131514693255,NaN,NaN,-66.66482489374724,-79.789221621145,-0.2343587468058153,-0.3127466353462012,-0.07838788854038588,1283334816,1331939663.6,20.267916835834313,61.5140707715647,NaN,NaN,-5.29772805785696,10.041827857014855
2020-03-09T09:30:00-04:00,63.55,65.245,62.455,63.46,37169703,27734980.8,38.776581400986856,48.60150614576042,NaN,NaN,-138.6531541700775,-71.93975381735997,-0.4080474701448946,-0.5884472262215041,-0.18039975607660952,1246165113,1304328723.8,17.756973021016435,55.841676385623934,NaN,NaN,-9.12922148013921,7.303106523135703
2020-03-10T09:30:00-04:00,64.5,65.24,61.19,64.05,40808442,29368410.5,40.858616162689906,46.53402151941087,NaN,NaN,-124.34301094454034,-74.87755804305804,-0.45622458257933063,-0.7506804843007728,-0.2944559017214422,1286973555,1297535271.4,17.192603489367713,50.113318456974376,NaN,NaN,-11.01506940171591,4.6862242481569005
2020-03-11T09:30:00-04:00,62.62,62.66,59.97,60.83,32153981,30462625.05,34.05238782982852,43.87631581980255,NaN,NaN,-158.80571457280507,-102.30609829866474,-0.6653133960568478,-1.126097646792502,-0.46078425073565416,1254819574,1278025388.2,15.653864329747265,44.25839111371526,NaN,NaN,-15.40496754368091,1.8160539921800711
2020-03-12T09:30:00-04:00,57.5,58.54,54.01,54.69,38883207,32004415.5,25.372958772810392,40.732554194366195,NaN,NaN,-232.28266345322547,-144.1498736068791,-1.1491289598040018,-1.8971954504906563,-0.7480664906866545,1215936367,1257445885,14.209227365285756,38.293941076880685,NaN,NaN,-23.368188733234273,-1.7816949685934063
2020-03-13T09:30:00-04:00,57.77,57.77,53.65,57.67,27138616,32681964.75,34.14614531949013,38.96683771934448,NaN,NaN,-181.38517990931533,-167.0939446099927,-1.1951393255982559,-2.2419906476844744,-1.0468513220862186,1243074983,1249393918.4,13.677374317913731,32.5129802248682,NaN,NaN,-25.309288201161845,-5.142779716103183
2020-03-16T09:30:00-04:00,52.46,56.51,50.92,51.12,28146746,33561598.65,26.7127201431733,37.61718214275658,NaN,NaN,-201.13468721217976,-179.59025121841316,-1.5697883075157795,-3.009086706480943,-1.4392983989651635,1214928237,1243146543.2,13.26258304296374,27.53297394479939,NaN,NaN,-30.451018675529856,-8.758242424592709
2020-03-17T09:30:00-04:00,52.61,58.15,52.04,57.66,38972997,34758437.6,40.61394058023355,37.59550042206923,NaN,NaN,-128.84097751254822,-180.48984453201473,-1.2918308040595892,-3.05408690403965,-1.762256099980061,1253901234,1236532079,12.819308053551609,23.37004828714415,NaN,NaN,-27.666837090767558,-11.459470234046258
2020-03-18T09:30:00-04:00,54.21,56.01,52.23,55.15,42846371,36340972.3,37.66136489234139,38.31925307968123,NaN,NaN,-130.76346067556022,-174.88139375256577,-1.1940087041308312,-3.2547669801436,-2.060758276012769,1211054863,1227779136.8,12.236473284183518,20.271090362280685,NaN,NaN,-27.046545159143363,-13.686195223345845
2020-03-19T09:30:00-04:00,54.64,54.88,51.7799,51.94,32729513,37257194.5,34.2337187332147,39.19149252868429,NaN,NaN,-130.8701978869995,-154.59890063932056,-1.2561709587645233,-3.630971974468423,-2.3748010157038997,1178325350,1220256933.4,11.742375913473495,18.22243190234966,NaN,NaN,-28.03567193702534,-15.736120468157202
2020-03-20T09:30:00-04:00,52.42,52.42,47.48,47.82,28179207,38079703.7,30.408378589256117,38.29604590990565,NaN,NaN,-152.35421373457837,-148.79270740437317,-1.4705606656815933,-4.2130018478058915,-2.742441182124298,1150146143,1201671165.4,10.60314656731147,16.585504820340827,NaN,NaN,-30.376909670088054,-17.827661782718753
2020-03-23T09:30:00-04:00,47.19,47.19,43.435,44.93,32009032,38658048.35,28.04136656214665,37.41589591100031,NaN,NaN,-168.16263573019222,-142.1982971079757,-1.6872774961386234,-4.8515380522975775,-3.164260556158954,1118137111,1182312940.2,9.562514941352418,15.319063652818397,NaN,NaN,-33.08060926061409,-20.006654279560944
2020-03-24T09:30:00-04:00,46.6499,49.97,46.33,49.76,27451353,38623698.8,36.8839824568975,36.197319335433534,NaN,NaN,-113.18621020205183,-139.0673436458764,-1.3975742567992682,-4.911228377158039,-3.5136541203587712,1145588464,1160650386.2,8.55113398699892,14.214434711404351,NaN,NaN,-31.770149235624285,-21.687153558998563
2020-03-25T09:30:00-04:00,49.83,53.17,48.33,51.03,30627494,38845460.45,39.006364899381815,35.38392455967004,NaN,NaN,-81.26178332712861,-129.16700817619008,-1.029648979976157,-4.8007153453289675,-3.7710663653528105,1176215958,1153682605.2,8.24892356255954,13.270315622254293,NaN,NaN,-30.017774962638004,-22.877242330947055
2020-03-26T09:30:00-04:00,51.58,55.975,51.06,55.38,30897212,38210163.85,45.73702798898455,35.17896816653109,NaN,NaN,-41.55755946388023,-111.30448049156621,-0.43307771358932845,-4.312413507339471,-3.8793357937501427,1207113170,1159440169.2,11.046473607684192,12.611641105957858,NaN,NaN,-26.104876534562948,-23.33833293146361
2020-03-27T09:30:00-04:00,53.71,57.685,53.4411,55.68,25093123,34951209.1,46.17813983362738,35.7076509117197,NaN,NaN,-22.657492478924926,-85.36513624043553,0.018056711126182456,-3.8567649048424144,-3.874821615968597,1232206293,1175852199.2,18.659891282987545,12.676135267527226,NaN,NaN,-23.0130383717741,-23.291862280079396
2020-03-30T09:30:00-04:00,56.16,58.09,55.92,57.74,29759553,34330394.6,49.23012147065357,36.30561557657425,NaN,NaN,-0.05563167958040252,-51.743735430313166,0.4666628624760145,-3.291493037873579,-3.7581559003495935,1261965846,1204617946.2,29.97295704923158,13.589017664660357,NaN,NaN,-19.510915421048043,-22.751727014503487
2020-03-31T09:30:00-04:00,57.29,57.29,55.23,55.41,33729203,32852905,46.04943471801255,37.16254749715882,NaN,NaN,-10.55109660111604,-31.216712710126046,0.6089445021014348,-2.9969752727228,-3.6059197748242346,1228236643,1221147582,35.52248644807236,15.008204958826434,NaN,NaN,-17.640539299408413,-22.021557340918477
2020-04-01T09:30:00-04:00,53.22,53.95,51.075,52.08,26710260,32617009.35,41.884429123976666,38.34193823652784,NaN,NaN,-54.92360121548023,-25.94907628779638,0.4865636620967715,-2.99771519720327,-3.4842788593000416,1201526383,1226209667,37.164756241342566,16.647885592830495,NaN,NaN,-17.397826186764718,-21.36102431889651
2020-04-02T09:30:00-04:00,51.52,54.075,51.23,53.71,26560837,32268295.85,44.52917509531571,39.08358322051538,NaN,NaN,-38.61787749013652,-25.361139893047653,0.520139548610036,-2.8341044235374966,-3.3542439721475326,1228087220,1230404477,38.56127244974635,18.425306887961394,NaN,NaN,-16.373497115871825,-20.64852043275013
2020-04-03T09:30:00-04:00,53.12,53.775,51.39,51.79,15936449,31290164.95,42.09887314755796,40.182594149399996,NaN,NaN,-43.70907887276421,-29.571457171815506,0.42196777667090535,-2.8267842513089008,-3.248752027979806,1212150771,1226393372.6,37.69848672995991,20.170728579889694,NaN,NaN,-16.26887755078787,-20.022857163898376
2020-04-06T09:30:00-04:00,53.69,56.35,53.69,55.79,20689809,30466170.25,48.41540973903288,40.73984194645709,NaN,NaN,25.38052760447083,-24.48422531500526,0.6232042711785435,-2.4697466890066266,-3.09295096018517,1232840580,1220568319.4,36.42393045989576,21.856773037485702,NaN,NaN,-14.175420023967458,-19.1875090010511
2020-04-07T09:30:00-04:00,57.29,57.38,55.015,55.09,24581622,29654829.25,47.44006090220276,41.43832023287575,NaN,NaN,52.26829804412181,-11.92034638595769,0.7001914884850633,-2.2177115995788412,-2.9179030880639045,1208258958,1216572782.4,35.53642950166591,23.52105562444873,NaN,NaN,-12.789328345099193,-18.27348319305797
2020-04-08T09:30:00-04:00,55.42,58.57,54.96,58.09,32462753,29670267.85,51.91129434250203,42.70100420496771,NaN,NaN,98.62766326995508,18.789906511129374,0.9297953468927878,-1.7556589044479196,-2.6854542513407074,1240721711,1224411848,38.692657299174385,25.446075723427363,NaN,NaN,-10.226099064335088,-17.123856888954702
2020-04-09T09:30:00-04:00,58.97,61.7788,58.75,60.83,43861993,29919207.15,55.624348036728996,44.5021448797872,NaN,NaN,165.7859573458864,59.67067347833398,1.2243083613405523,-1.1550687996650169,-2.379377161005569,1284583704,1235711144.8,43.02302869105705,27.761781589409193,NaN,NaN,-6.895891257768777,-15.662718941642428
2020-04-13T09:30:00-04:00,60.52,60.52,58.305,58.9,13915587,29258055.7,52.54665938922099,46.25252293886394,NaN,NaN,125.95611315787262,93.60371188446135,1.2432473819817442,-0.8253179335283889,-2.068565315510133,1270668117,1247414614,47.18427818574384,30.44905039258001,NaN,NaN,-5.0386590152289195,-14.144996095011926
2020-04-14T09:30:00-04:00,60.17,60.72,59.59,60.63,17087822,28705109.5,54.95269494459173,47.54314525941353,NaN,NaN,132.75395787445393,115.07839793845797,1.3192081846091852,-0.41955508474865155,-1.7387632693578368,1287755939,1258397685.8,50.81467292132924,33.46787460217503,NaN,NaN,-2.7690193070538176,-12.519856553875053
2020-04-15T09:30:00-04:00,58.96,59.68,58.295,58.63,12836005,27398259.9,51.68976052137424,48.44910208955584,NaN,NaN,93.49632951994565,123.32400423362273,1.1858805163561135,-0.2564126239126949,-1.4422931402688084,1274919934,1271729881,54.86993659393829,36.79794696155923,NaN,NaN,-1.8051422954411804,-10.9891830883845
2020-04-16T09:30:00-04:00,58.88,59.13,58.06,58.64,10399987,25775940.7,51.705201484871935,48.87540019640494,NaN,NaN,78.94481679776561,119.38743493918484,1.0539347885277202,-0.12487465460915814,-1.1788094431368783,1285319921,1280649523,57.40050690385502,40.10894933985714,NaN,NaN,-1.0210408532102682,-9.565162769073895
2020-04-17T09:30:00-04:00,59.89,60.85,59.075,60.53,10777575,24678343.8,54.65511955806925,49.480898748150786,NaN,NaN,99.17642396405724,106.06552826281902,1.047347124672678,0.13037446270396913,-0.9169726619687089,1296097496,1282952281.4,58.05442632788404,42.922844700206895,NaN,NaN,0.4815995328392531,-8.12991101165773
2020-04-20T09:30:00-04:00,60.15,60.15,58.145,58.24,14380866,23988426.75,50.62057056507462,49.58021654060944,NaN,NaN,68.9826308372732,94.67083179869914,0.8505318522402335,0.14619215333158309,-0.7043396989086504,1281716630,1285161984,58.70942567193333,44.97544960182845,NaN,NaN,0.6516033611996919,-6.875408958392384
2020-04-21T09:30:00-04:00,57.19,57.97,56.64,57.28,20391576,23407553.95,48.987991537419646,49.79011345628138,NaN,NaN,29.097922613823872,73.93962474657312,0.6277419406167349,0.08033772686226825,-0.5474042137544667,1261325054,1279875807,56.43890297462993,46.46947935372542,NaN,NaN,0.34037642775034316,-5.8445824746577095
2020-04-22T09:30:00-04:00,58.36,59.43,57.97,58.95,15596973,22814834.95,51.89450151412394,50.50511862700618,NaN,NaN,59.597480295550774,67.15985490169413,0.5667603486494825,0.1610462220573865,-0.40571412659209605,1276922027,1280276225.6,56.57589840571762,47.85598950832364,NaN,NaN,0.8736975169096866,-4.884828190148082
2020-04-23T09:30:00-04:00,59.13,59.29,57.63,57.96,12415172,21904218.85,50.07309357499179,50.901112804125894,NaN,NaN,40.52869227483337,59.47662999710768,0.4393470852795371,0.14346973000732532,-0.29587735527221176,1264506855,1276113612.4,54.651710281263,49.00530649628911,NaN,NaN,0.8291217948768547,-4.068549620858805
2020-04-24T09:30:00-04:00,58.06,58.57,57.31,58.32,11986870,20958701.75,50.75002378360525,51.51905213527214,NaN,NaN,29.387096990806402,45.51876460245752,0.36212743635173383,0.1567819401674555,-0.2053454961842783,1276493725,1272192858.2,52.82916608422013,50.086069307307696,NaN,NaN,0.9691610690635984,-3.348876665155605
2020-04-27T09:30:00-04:00,58.66,59.355,58.6,58.93,12740482,20341069.7,51.939109251356975,51.770744957580995,NaN,NaN,54.41574102326653,42.60538663965619,0.3355452084166922,0.21408601433658703,-0.12145919408010522,1289234207,1273696373.6,53.46997791026943,51.30364412519153,NaN,NaN,1.3943661543377055,-2.671270548085132
2020-04-28T09:30:00-04:00,59.76,60.4,58.8778,59.15,14321728,19569178.45,52.385610620292454,52.123998508873115,NaN,NaN,65.45947145999641,49.8776964088907,0.31644135497076226,0.2740924996333476,-0.042348855337414656,1303555935,1282142549.8,57.00364433778548,52.83701661348579,NaN,NaN,1.8669597624580845,-2.0229519322932443
2020-04-29T09:30:00-04:00,60.11,60.14,58.37,58.61,11787761,18472106.35,51.12997868420994,52.068190247566534,NaN,NaN,47.229234574867014,47.40404726475394,0.25380359898077165,0.27490564338854995,0.02110204440777827,1291768174,1285111779.2,58.205304747046064,54.23077714547662,NaN,NaN,1.9669443941277163,-1.4529667428045356
2020-04-30T09:30:00-04:00,58.19,58.28,56.73,57.26,19367176,18104952.15,48.03047661317983,51.52577086017016,NaN,NaN,-17.8889410328592,35.720520603215434,0.1148924335074167,0.16471758629204913,0.04982515278463244,1272400998,1286690607.8,58.86364711797443,55.36224989025644,NaN,NaN,1.2736136040494008,-1.0634552646825448
2020-05-01T09:30:00-04:00,56.59,56.63,55.56,55.88,13459349,17449877.75,45.025735001268,50.98856197531637,NaN,NaN,-90.15227066080105,11.812647072893942,-0.06671986754553613,-0.03357468164728772,0.03314518589824841,1258941649,1283180192.6,56.72417316622178,56.04367096029058,NaN,NaN,-0.1249197250834269,-0.929378759025528
2020-05-04T09:30:00-04:00,55.59,56.44,55.25,56.3,12050683,17255589.45,46.13029601818734,50.35839062343035,NaN,NaN,-117.51334781051004,-22.573170693861375,-0.15055213325404632,-0.1550449806693095,-0.004492847415263179,1270992332,1279531817.6,54.50681274117196,56.30739523313649,NaN,NaN,-1.0507515975906343,-0.9467177359634004
2020-05-05T09:30:00-04:00,56.5,57.44,56.43,56.76,11826794,16812438.7,47.37738075996939,50.05036349761572,NaN,NaN,-81.2111313307784,-51.90729125201633,-0.16580729591007715,-0.2117519673028596,-0.045944671392782466,1282819126,1275384455.8,52.01752588852194,56.10365161132103,NaN,NaN,-1.5454780036287914,-1.0322549170584563
2020-05-06T09:30:00-04:00,56.96,57,54.75,54.83,24075161,16787115.65,42.89094781830369,49.4207739500037,NaN,NaN,-155.60587481082803,-92.47431312915533,-0.2894262662551677,-0.4077275042117421,-0.11830123795657439,1258743965,1268779614,48.239199834285984,55.449272534923246,NaN,NaN,-3.182505233909917,-1.3394335337515222
2020-05-07T09:30:00-04:00,55.46,55.95,54.96,55.05,21133234,16220639.7,43.547192405768534,48.62735058198222,NaN,NaN,-147.75459904514122,-118.44744473161174,-0.33661762299409315,-0.5390732666991909,-0.2024556437050977,1279877199,1270274854.2,49.139859114325226,54.81251773395475,NaN,NaN,-4.408224464764711,-1.7778322381819778
2020-05-08T09:30:00-04:00,55.72,56.38,55.46,56.16,13276609,14691370.5,46.864822048844076,48.35908283082289,NaN,NaN,-98.9054744483689,-120.1980854891253,-0.27586684282205953,-0.5472891972326721,-0.2714223544106126,1293153808,1277117286,53.156756193208345,54.41589848547439,NaN,NaN,-4.6487097057401146,-2.187957590690283
2020-05-11T09:30:00-04:00,55.72,56.13,54.925,55.92,15663258,14778754.05,46.23217766975725,48.162238983132724,NaN,NaN,-101.83287117339732,-117.06199016170277,-0.2361697685203848,-0.5666345650610936,-0.33046479654070876,1277490550,1278416929.6,53.901485685639244,54.23465439340363,NaN,NaN,-5.013592764088721,-2.591619758318631
2020-05-12T09:30:00-04:00,56.06,56.31,55.32,55.43,21867158,15017720.85,44.899504210572054,47.662596318593295,NaN,NaN,-90.81275825731021,-118.98231554700912,-0.2271658726911151,-0.6144221374046026,-0.3872562647134875,1255623392,1272977782.8,50.297452573155944,53.786193976792084,NaN,NaN,-5.664524147029767,-3.0306060995630792
2020-05-13T09:30:00-04:00,55.32,55.32,54.33,54.96,19822618,15367051.5,43.601235311649646,47.200320728354576,NaN,NaN,-116.22775405241708,-111.10669139532695,-0.2360777553491274,-0.6823534588998967,-0.44627570355076934,1235800774,1268389144.6,47.417005625186356,53.269429358500894,NaN,NaN,-6.5557980913621225,-3.534204955534371
2020-05-14T09:30:00-04:00,54.41,55.71,53.66,55.55,23116616,16002882.95,45.72290861369349,46.84124107336088,NaN,NaN,-99.30558232011931,-101.41688805032256,-0.18756693265674917,-0.6807343693717058,-0.49316743671495666,1258917390,1264197182.8,44.88793089846633,52.7021982738042,NaN,NaN,-6.818756394318859,-4.003426589646441
2020-05-15T09:30:00-04:00,55.16,55.18,53.97,54.81,34674031,17197705.75,43.51194396910785,46.23930069605736,NaN,NaN,-105.02084868167015,-102.6399628969828,-0.1900576780963651,-0.730739534335413,-0.540681856239048,1224243359,1250415093,37.757535428232096,51.57988095365868,NaN,NaN,-7.606691449003962,-4.518178712411801
2020-05-18T09:30:00-04:00,56.1,57.42,56.1,57.06,22997897,17628557.3,51.233502912549305,46.15700728836142,NaN,NaN,3.575037269820879,-81.55838120833917,-0.03313665467692806,-0.582102674585208,-0.54896601990828,1247241256,1244365234.2,35.1202537240634,50.016781624107104,NaN,NaN,-6.242636016675494,-4.764529755878043
2020-05-19T09:30:00-04:00,56.82,56.98,56.11,56.12,16327854,17425371.2,48.26517248979893,45.952378274474924,NaN,NaN,-17.39632464859089,-66.8750944865953,0.011971695357370415,-0.534001400711567,-0.5459730960689374,1230913402,1239423236.2,33.08717329610509,48.22262937761132,NaN,NaN,-5.869144880148825,-4.922331916488155
2020-05-20T09:30:00-04:00,56.7,57.06,56.21,56.43,11791574,17235101.25,49.30824392662841,46.04364736829268,NaN,NaN,-3.7521994495483,-44.379983566021544,0.06437816749523484,-0.4655003866998939,-0.5298785541951287,1242704976,1240804076.6,34.23277081113697,46.46328106998008,NaN,NaN,-5.272679887865702,-4.972381626684948
2020-05-21T09:30:00-04:00,56.28,56.68,55.745,55.86,16934288,17461057.05,47.41525956951007,46.21432769459568,NaN,NaN,-25.805302578120735,-29.679927617621825,0.06230545228680717,-0.4519967388366197,-0.5143021911234269,1225770688,1234174736.2,31.448955436091907,44.6579083749708,NaN,NaN,-5.260922859164753,-5.013601802753492
2020-05-22T09:30:00-04:00,55.86,56.53,55.68,56.48,11918990,17457663.05,49.67826009734546,46.46775370024984,NaN,NaN,-13.23168680539885,-11.322095242367567,0.10199590625736032,-0.3868073083017265,-0.4888032145590868,1237689678,1236864000,33.800749128532956,43.17890383121087,NaN,NaN,-4.6487458612895,-4.961479525401493
2020-05-26T09:30:00-04:00,57.5,57.95,56.79,56.85,17536287,17697453.3,51.03259699460001,46.72884057415202,NaN,NaN,62.53473663217417,0.4698446301030792,0.14959518114332793,-0.3018092381299269,-0.4514044192732548,1255225965,1238460941.8,35.2219433262286,41.97921936247563,NaN,NaN,-3.768043015281344,-4.790988595384329
2020-05-27T09:30:00-04:00,57.85,57.95,56.74,57.53,16492343,17805984.05,53.50905684039469,47.48727693287281,NaN,NaN,99.04325181159825,23.757759922140906,0.2190988372218231,-0.1775308727459759,-0.396629709967799,1271718308,1246621923,42.06682088972243,41.53833515214966,NaN,NaN,-2.3389058619379224,-4.440691062034842
2020-05-28T09:30:00-04:00,58.27,59.48,58.22,59.23,21292278,18281209.9,59.08063013489278,48.59680819923883,NaN,NaN,233.76567966550616,71.2613357451518,0.3632828850972728,0.05747389640379197,-0.30580898869348083,1293010586,1256683045,49.1943428404207,41.54222684687077,NaN,NaN,0.5779186019728536,-3.7237468243194574
2020-05-29T09:30:00-04:00,59.09,60,58.74,59.69,14756551,18050678.65,60.461409438609955,49.567993012793536,NaN,NaN,231.2105353676861,122.66450333431317,0.4667548913953589,0.27763462555071783,-0.1891202658446411,1307767137,1273082334.8,58.21767789168374,41.90372125390473,NaN,NaN,3.440570502297461,-2.7002729205170404
2020-06-01T09:30:00-04:00,59.67,60.765,59.33,60.4,14556423,18105532.35,62.56132120122023,50.73436040789803,NaN,NaN,216.33431990991602,168.57770467737615,0.5541757923486541,0.5035994745911765,-0.05057631775747756,1322323560,1290009111.2,65.10634732091623,42.704068513567336,NaN,NaN,6.511996237781038,-1.3842344693316007
2020-06-02T09:30:00-04:00,60.63,60.83,59.98,60.79,13992595,18202627.95,63.701720252726155,52.07737583948047,NaN,NaN,188.4266800317449,193.75609335729027,0.6052686921986115,0.7060095474907868,0.10074085529217533,1336316155,1306227149.2,70.17938519238153,44.12420655779773,NaN,NaN,9.438999964575105,0.16194187836935714
2020-06-03T09:30:00-04:00,61.12,61.95,61.07,61.52,12841423,18253359.4,65.80155732725613,53.663113126309504,NaN,NaN,185.1697808997161,210.98139917491386,0.6512320064253952,0.9147808633239194,0.26354885689852414,1349157578,1321715003.2,74.05820270486066,46.02714920634589,NaN,NaN,12.582039660672873,1.9362415615555737
2020-06-04T09:30:00-04:00,61.19,61.32,59.64,60.42,21839585,18141580.6,60.154500129897094,54.69394109175262,NaN,NaN,120.37093498318603,188.3024502384498,0.5733001086179568,0.98017399267097,0.40687388405301333,1327317993,1328576484.6,75.57401744226003,48.21901253090259,NaN,NaN,13.800284839149585,3.6311048869261464
2020-06-05T09:30:00-04:00,60.97,62.36,60.91,61.19,22130073,18191422.55,62.57565696730677,56.05563487733826,NaN,NaN,132.94617447827514,168.64957806056765,0.5398307754408163,1.0816623533540337,0.5418315779132175,1349448066,1336912670.4,77.3087727599515,51.04410091173968,NaN,NaN,15.542379824903433,5.332715592351473
2020-06-08T09:30:00-04:00,61.3,63.025,60.86,62.83,15959458,18325565,67.15358929646396,57.19278390476073,NaN,NaN,133.08438754255062,151.99959158709453,0.5902752181291223,1.2796756005746204,0.6894003824454981,1365407524,1345529463.2,78.9712744141986,54.17631667532078,NaN,NaN,18.515558910521182,7.215978923518574
2020-06-09T09:30:00-04:00,62.26,62.285,60.89,61.57,18642221,18474513.15,60.98159723084161,58.10109995769234,NaN,NaN,99.30027203561306,134.17430998786818,0.5042542271149503,1.319718166339186,0.8154639392242357,1346765303,1347619292.8,79.36612680133229,57.48195621140843,NaN,NaN,19.19514657595355,8.927288588152143
2020-06-10T09:30:00-04:00,61.57,61.98,61.01,61.21,12526260,18007468.25,59.30449183302209,58.81511766529189,NaN,NaN,84.32453064243057,114.00525993641106,0.39349530857492276,1.307333074942889,0.9138377663679663,1334239043,1344635585.8,77.13909542196876,60.546693683610705,NaN,NaN,19.248654288276914,10.401769402455681
2020-06-11T09:30:00-04:00,60.16,60.33,58.39,58.82,34710417,18751858.2,49.55974223430042,58.96829499849121,NaN,NaN,15.71423804426882,93.07392054862763,0.14259058889126885,1.0920760024820524,0.9494854135907835,1299528626,1339077712.4,73.02835702055623,63.51665093964386,NaN,NaN,16.07482815867823,11.212206367630332
2020-06-12T09:30:00-04:00,59.94,60.01,57.95,58.67,23202597,18756157.25,49.01537315381985,58.92094593109652,NaN,NaN,0.39869001851170127,66.56442365667493,-0.04037538971127608,0.8990161764516884,0.9393915661629645,1276326029,1324453305,63.447312856343736,65.6342626344875,NaN,NaN,13.388154556112635,11.52305610884209
2020-06-15T09:30:00-04:00,57.63,59.5,57.125,59.07,16717633,17858337.35,50.57445631801693,58.88822159705487,NaN,NaN,-18.956092118892677,36.15632772438627,-0.13597556388106424,0.7694221113116342,0.9053976751926984,1293043662,1309980532.6,55.66416706318185,67.09442147284129,NaN,NaN,11.637495593707808,11.53940460668005
2020-06-16T09:30:00-04:00,60.5,60.83,59.015,59.34,17113413,17564113.15,51.64924177647185,58.755377663917514,NaN,NaN,21.129693061993418,20.522211929662344,-0.1797914057686878,0.6806584179818387,0.8604498237505265,1310157075,1302658887,52.17707573454644,67.81658253318587,NaN,NaN,10.497448410906946,11.390553721569606
2020-06-17T09:30:00-04:00,59.59,59.6,58.59,59.16,12187158,17357078.35,50.85527962920497,58.16785262779696,NaN,NaN,-9.7892888498667,1.69944803120289,-0.21716110031323832,0.5889984483589785,0.8061595486722168,1297969917,1295405061.8,48.90810163875982,67.79613673306723,NaN,NaN,9.329400681850048,11.096103287323956
2020-06-18T09:30:00-04:00,58.79,59.31,58.48,59.15,13253810,17430190.15,50.80855080715273,57.47836272555002,NaN,NaN,-22.905738356380134,-6.024547248926895,-0.23718753652345637,0.5096751280178964,0.7468626645413527,1284716107,1292442558,47.596554886865846,67.03748508986595,NaN,NaN,8.346687312978975,10.703329576703245
2020-06-19T09:30:00-04:00,59.62,59.87,57.4,57.49,29265750,18046763.25,43.640071844311656,56.126844914342264,NaN,NaN,-67.47098200445832,-19.5984816535209,-0.35005228245151376,0.3092973114769606,0.6593495939284744,1255450357,1288267423.6,45.735115175428504,65.65382565090255,NaN,NaN,5.32941434107849,9.935627400185423
2020-06-22T09:30:00-04:00,56.98,57.93,56.45,57.57,12953366,18098482.05,44.04976499604605,54.7231338245794,NaN,NaN,-122.94861626710774,-40.39698648316391,-0.4033491508493393,0.15516315536680025,0.5585123062161396,1268403723,1283339435.8,43.569221643321825,63.75309968311257,NaN,NaN,2.95538674611043,8.938450163888994
2020-06-23T09:30:00-04:00,58.16,58.23,56.83,56.99,12622200,17852777.7,41.68395489909315,53.00044793685346,NaN,NaN,-122.25476332490987,-69.07387776054456,-0.4577164615381851,-0.013633270706591816,0.4440831908315933,1255781523,1272464325.4,39.161671323370875,61.26049029872045,NaN,NaN,0.23484942565591047,7.695078629855697
2020-06-24T09:30:00-04:00,56.56,56.82,55.79,56.47,14269159,17741618.5,39.62896789263928,51.53433849133505,NaN,NaN,-166.23080317265442,-100.3621806251021,-0.5050323922216777,-0.18720729944550385,0.3178250927761739,1241512364,1261172814.8,35.182050612556566,58.37534981088448,NaN,NaN,-2.688866724947744,6.211657864883777
2020-06-25T09:30:00-04:00,56.35,56.38,55.12,55.77,21751306,17764569.9,36.98563067222213,49.70647947025757,NaN,NaN,-169.28947216280068,-129.6389273863862,-0.5557843837611973,-0.3769053869253227,0.17887899683587455,1219761058,1248181805,31.247691888972625,55.085272605814566,NaN,NaN,-6.001669866518911,4.466896760397678
2020-06-26T09:30:00-04:00,55.69,56.32,54.81,55.18,28747908,18464137.75,34.87417298815352,47.40080687680682,NaN,NaN,-155.74872854500066,-147.29447669449468,-0.597742840363376,-0.5682995536183455,0.029443286745030522,1191013150,1235294363.6,27.912917108348992,51.438247083968164,NaN,NaN,-9.472785294269999,2.4755136097308674
2020-06-29T09:30:00-04:00,55.62,56.25,55.03,56.22,14865697,18479601.45,41.241882430656574,45.990827248222175,NaN,NaN,-122.2833961170661,-147.16143266448634,-0.5266049791308337,-0.6288129371685116,-0.1022079580376779,1205878847,1222789388.4,25.112403657130685,47.562981145096614,NaN,NaN,-10.741741848185358,0.5873342585999781
2020-06-30T09:30:00-04:00,56.23,56.735,55.895,56.43,16872114,18623577.4,42.46517799159636,44.78801911669177,NaN,NaN,-90.83282062755036,-140.87704412501444,-0.44007812285479675,-0.6523056116061738,-0.2122274887513771,1222750961,1216183276,23.75639996232863,43.74993146940803,NaN,NaN,-11.450916925574163,-1.132415910567756
2020-07-01T09:30:00-04:00,56.48,58,56.38,57.75,19888850,18975948.75,49.57198782756783,44.788893801925155,NaN,NaN,-46.6744081027016,-116.9657651110239,-0.27660098950648015,-0.5579787256344773,-0.2813777361279971,1242639811,1216408765.4,23.90743568050398,40.24129423083287,NaN,NaN,-9.96046707147565,-2.393566076411741
2020-07-02T09:30:00-04:00,58.16,58.52,57.75,57.9,12147629,18491350.95,50.32292218195876,44.88229016107794,NaN,NaN,-16.36082543523368,-86.38003576551048,-0.14749889178807762,-0.46575135086309416,-0.31825245907501654,1254787440,1223414041.8,28.63712318712031,37.75485211160263,NaN,NaN,-8.521739825530558,-3.269019469143
2020-07-06T09:30:00-04:00,58.11,58.49,56.72,57.19,15387651,18154229.85,46.772557118599785,44.61072593254814,NaN,NaN,-34.59283765743649,-62.14885758799765,-0.10125715681374664,-0.4448239050921998,-0.3435667482784532,1239399789,1233091369.6,34.677549057841986,36.25580796836407,NaN,NaN,-8.289088152735875,-3.9861721382276967
2020-07-07T09:30:00-04:00,56.56,57.1716,56.29,56.96,11340909,17923302.4,45.64900645758365,44.1821376954847,NaN,NaN,-56.96186170925728,-49.08455070643587,-0.07851149591854373,-0.44170611817663286,-0.36319462225808913,1228058880,1237527376.2,37.29754819123809,35.19298457241347,NaN,NaN,-8.4088538768349,-4.617983815171582
2020-07-08T09:30:00-04:00,56.87,57.66,56.76,57.47,12179461,17600164.4,48.597581095193576,44.02087351448389,NaN,NaN,-26.216795808902912,-36.16134574270638,-0.024281069385576948,-0.3935459589900603,-0.36926488960448334,1240238341,1241024852.2,39.362579484893246,34.511161561423,NaN,NaN,-7.681544077704107,-5.055635281247658
2020-07-09T09:30:00-04:00,57.19,57.22,55.905,56.7,17875328,17867617.8,44.658340962908376,43.581572811323575,NaN,NaN,-59.06959387863126,-38.64038289789232,-0.034790718500440465,-0.41275328773003395,-0.3779625692295935,1222363013,1236969492.6,37.8077517542622,33.8119613376656,NaN,NaN,-8.163702371662595,-5.499644865592649
2020-07-10T09:30:00-04:00,56.7,57.93,56.68,57.77,13583290,16811261.45,50.64527256244802,44.08194429119046,NaN,NaN,0.7091765970800697,-35.226382491429575,0.03217653687469102,-0.3377418981362297,-0.3699184350109207,1235946303,1233201265.2,36.37015751043842,33.14303579016631,NaN,NaN,-6.790821560175836,-5.684098679104533
2020-07-13T09:30:00-04:00,57.77,58.4,57.56,57.83,17765772,16539420.2,50.96560806377642,44.57593308174263,NaN,NaN,39.35815292283415,-20.436184375375447,0.07966510353016137,-0.27033705559821897,-0.35000215912838034,1253712075,1236063722.4,38.2897084975509,32.76592770832553,NaN,NaN,-5.583150873724855,-5.669677564050294
2020-07-14T09:30:00-04:00,57.84,58.71,57.77,58.37,33947094,17400893.25,53.86768395802759,45.4461994430951,NaN,NaN,67.95626670636247,4.547441307748502,0.1429062820727784,-0.17136930653740734,-0.31427558861018573,1287659169,1247983780.2,45.64354503593514,33.228918687794405,NaN,NaN,-3.7056225322681393,-5.3890982737957005
2020-07-15T09:30:00-04:00,58.92,59.345,58.03,58.14,13469576,17218701.4,52.44397144037578,46.36155683936199,NaN,NaN,96.00800909175507,28.9924022878801,0.16324037202374975,-0.11022512358049852,-0.27346549560424827,1274189593,1254774030.6,49.34657560310224,34.24067047283338,NaN,NaN,-2.523192659042613,-4.979683185973831
2020-07-16T09:30:00-04:00,58.19,59.04,58.04,58.88,15063314,17362509.2,56.43361495992636,47.750698574198005,NaN,NaN,112.69109139477023,63.344539342560395,0.21714625957334813,-0.0020326711375631135,-0.21917893071091124,1289252907,1268152009.4,55.74351822290938,35.99037235382887,NaN,NaN,-0.32574587538528754,-4.314834998746896
2020-07-17T09:30:00-04:00,59.2,60.37,59.15,60.21,22950829,17847360.15,62.51967781683346,49.72537749053229,NaN,NaN,203.4085460031868,103.88441322378176,0.3264259651660445,0.18885352574664438,-0.13757243941940012,1312203736,1283403496,61.684337496959806,38.40261666730107,NaN,NaN,3.6054301214293156,-3.1833685530074374
2020-07-20T09:30:00-04:00,60,60.17,59.32,59.42,12127635,16990454.4,57.391179773216614,50.87889872928657,NaN,NaN,161.99528562593642,128.4118397644022,0.3286468462984652,0.27323611845368134,-0.05541072784478382,1300076101,1292676301.2,64.77992689116567,41.23601118401785,NaN,NaN,5.388957078661629,-1.9587506056261421
2020-07-21T09:30:00-04:00,59.57,60.38,59.38,59.69,15108157,17098193.95,58.639931407057205,52.03423825896234,NaN,NaN,145.17097168456758,143.8547807600432,0.33054657908007534,0.35777249600531036,0.02722591692523503,1315184258,1298181319,66.50981052557162,44.289826224249495,NaN,NaN,7.223399726466484,-0.6470148438986243
2020-07-22T09:30:00-04:00,59.42,60.8346,58.84,60.61,14847081,17209438,62.656041907422036,52.968813550380496,NaN,NaN,136.92230178770475,152.03763929923315,0.37287353413056284,0.4933178345884386,0.12044430045787576,1330031339,1309349668.2,69.75537189811192,47.56467881122149,NaN,NaN,10.076760158348849,0.8849530135653003
2020-07-23T09:30:00-04:00,60.59,61.11,60.32,60.68,19139015,17452930.8,62.95082181497761,53.87080638131041,NaN,NaN,148.3965089151461,159.17872280330832,0.3832257715141514,0.599476514850565,0.2162507433364136,1349170354,1321333157.6,72.80117206284913,50.71925373091641,NaN,NaN,12.463069150785214,2.5389696045967165
2020-07-24T09:30:00-04:00,60.8,61.42,59.94,60.28,17698595,17250295.25,60.03456648912982,54.8180927649197,NaN,NaN,124.43006937567071,143.38302747780511,0.3421264428812519,0.6439087969379784,0.30178235405672654,1331471759,1325186762.2,73.71778026295277,53.507841674138604,NaN,NaN,13.64417435054033,4.125427425445804
2020-07-27T09:30:00-04:00,60.3,60.34,59.12,59.55,11319349,16378867.3,55.02466591122661,55.48778272589419,NaN,NaN,71.04393682068294,125.19275771675441,0.24909315974383034,0.6131488037365145,0.36405564399268414,1320152410,1329202024,74.67543070855045,56.1776904253752,NaN,NaN,13.201529583615962,5.422013448041541
2020-07-28T09:30:00-04:00,59.4,60.955,59.35,60.45,18895999,16580382.4,59.51079076259939,56.26729770213746,NaN,NaN,92.26645610409288,114.61185460065947,0.23184069680851382,0.6538565150033264,0.4220158181948126,1339048409,1333974854.2,75.8040176787862,58.78065029636755,NaN,NaN,14.167091872689024,6.671310365848324
2020-07-29T09:30:00-04:00,60.56,60.89,60.275,60.73,9102795,16191916.45,60.8201532551541,57.4217128658693,NaN,NaN,100.94478269232846,107.4163507815842,0.22289522306130805,0.7006348470214476,0.4777396239601396,1348151204,1337598827.2,76.6547352825813,61.55543483410463,NaN,NaN,15.349598097681442,7.911065756110198
2020-07-30T09:30:00-04:00,60.29,60.74,59.99,60.73,12736961,15834322,60.82015325515411,58.14849005820545,NaN,NaN,83.51345389391068,94.43973977733712,0.2012483765502343,0.7293000946479324,0.5280517180976981,1348151204,1337394997.2,76.49183378819772,64.42126885394457,NaN,NaN,16.310491413328577,9.110983707141395
2020-07-31T09:30:00-04:00,60.57,60.99,59.98,60.83,12113982,15832639.65,61.33801765252443,58.88937645740174,NaN,NaN,81.0557837727088,85.76488265674476,0.17869839974432733,0.7514247177781073,0.5727263180337799,1360265186,1343153682.6,77.91952542630598,67.25197006314137,NaN,NaN,17.252076974677117,10.27399703107507
2020-08-03T09:30:00-04:00,60.79,60.8,59.85,60.17,9651977,15545855.95,56.07038502379714,59.04671224781384,NaN,NaN,58.5732585986683,83.27074701234184,0.1078557511109921,0.7075460069225201,0.599690255811528,1350613209,1349245842.4,79.3484242365617,69.6594614346147,NaN,NaN,16.62814006950421,11.18173175085066
2020-08-04T09:30:00-04:00,60.13,61.1003,59.98,60.83,20831793,16020400.15,59.789267161294156,59.57137622787945,NaN,NaN,74.55350050969884,79.72815589346303,0.09445137122958391,0.7177544698485079,0.623303098618924,1371445002,1355725161,80.77349414019649,71.90424133012142,NaN,NaN,17.128538946805865,12.031275635987118
2020-08-05T09:30:00-04:00,60.96,61,59.81,60.05,11829269,16002890.55,53.97393591946633,59.39568486784658,NaN,NaN,49.88206798669993,69.51561295233732,0.025638155502760607,0.6553507929973748,0.6297126374946141,1359615733,1358018066.8,81.26615875390243,73.72728708233522,NaN,NaN,15.842391376990811,12.575720741844789
2020-08-06T09:30:00-04:00,59.99,60.5001,59.6799,60.4,13787989,15798523.6,56.04010563699921,58.93285828357272,NaN,NaN,38.92525644834455,60.59797346322409,-0.002241417036084048,0.6269108661995091,0.6291522832355931,1373403722,1363068570.4,82.33961495378318,75.20266404353688,NaN,NaN,15.356686749800282,12.973001600124144
2020-08-07T09:30:00-04:00,60.16,61.725,60.15,61.49,15471310,15892924.6,61.79256056597307,59.24724262591246,NaN,NaN,117.12600711611728,67.81201813190579,0.0442270980880306,0.6844361558456313,0.6402090577576007,1388875032,1368790539.6,83.49361289263747,76.53935590078488,NaN,NaN,16.69313316703517,13.50444896682572
2020-08-10T09:30:00-04:00,61.69,61.95,61.27,61.47,10604359,15534853.95,61.63319318539255,59.4610470386507,NaN,NaN,158.64327910726828,87.82602223362579,0.06392118850871586,0.7201105433934956,0.6561893548847797,1378270673,1374322032.4,84.54498355787466,77.82758254594937,NaN,NaN,17.716252856434263,14.106135236769797
2020-08-11T09:30:00-04:00,61.54,61.66,59.975,60.14,25498039,15112401.2,52.02425422695719,58.70163363290321,NaN,NaN,49.20257068396194,82.75583626847842,-0.017945637450372254,0.6337573080718144,0.6517029455221867,1352772634,1370587558.8,80.80299040302276,78.61669815344301,NaN,NaN,15.59096860460188,14.318254289317236
2020-08-12T09:30:00-04:00,60.32,61.42,60.3,61.01,17285518,15303198.3,56.77190886277888,58.26028270774616,NaN,NaN,86.03663795497253,89.98675026213293,-0.01873752180246524,0.628281043269105,0.6470185650715703,1370058152,1372676042.6,81.30142709752296,79.22385922734827,NaN,NaN,15.30070705261204,14.458604684073636
2020-08-13T09:30:00-04:00,60.76,61.035,60.44,60.91,15813709,15340718.05,56.08488995853262,57.97816295556064,NaN,NaN,63.13585298149711,94.82886956876345,-0.03053211885239282,0.6088534165060793,0.6393855353584721,1354244443,1368844186.8,77.33399414354331,79.48216021881902,NaN,NaN,14.85866533028374,14.515756204960795
2020-08-14T09:30:00-04:00,60.78,60.86,60.22,60.38,8668329,14626593.05,52.461333214007375,57.79506776290212,NaN,NaN,4.164457447586786,72.23655963505736,-0.07597671736306855,0.5444146386546365,0.620391356017705,1345576114,1360184403.2,69.1243378192656,79.08565358387011,NaN,NaN,13.373322955283825,14.352551455006942
2020-08-17T09:30:00-04:00,60.43,60.825,60.07,60.3,9510292,14495725.9,51.91609036915311,57.252589163370246,NaN,NaN,-22.703434152651106,35.96721698307345,-0.11123908890758627,0.4813424948832221,0.5925815837908084,1336065822,1351743433,62.193732494056704,78.11349035638943,NaN,NaN,12.011515402015243,14.018117733150985
2020-08-18T09:30:00-04:00,60.26,60.5,59.7159,60.03,12147583,14347697.2,50.02632572732019,56.48160148281068,NaN,NaN,-98.51803953154285,6.423094939972492,-0.15014274580793607,0.4049031515308883,0.5550458973388244,1323918239,1345972554,57.91820629362046,76.77516685717795,NaN,NaN,10.327035552394648,13.490820278757223
2020-08-19T09:30:00-04:00,60.18,60.21,59.73,59.85,9021655,14056425.9,48.75225404400816,55.61960868201454,NaN,NaN,-127.54886598543968,-36.29400584810995,-0.18320350041390365,0.32604152182144475,0.5092450222353484,1314896584,1334940240.4,50.737294827707316,74.93555693142864,NaN,NaN,8.560022193744338,12.786420552326812
2020-08-20T09:30:00-04:00,59.61,59.91,59.16,59.32,12966079,13747779.1,45.10933337386841,54.46041694782482,NaN,NaN,-189.064165060823,-86.73400945657397,-0.23278756217131386,0.2182605695212061,0.45104813169251995,1301930505,1324477452.8,45.0346449770138,72.58663689933634,NaN,NaN,5.969513368200392,11.81257666888018
2020-08-21T09:30:00-04:00,59.37,59.53,58.82,59.42,9466679,13336183.3,45.930285634491796,53.73612413430301,NaN,NaN,-186.25273123036538,-124.8174471921644,-0.24939313614309228,0.1393067115136546,0.38869984765674687,1311397184,1317641666.8,41.734237136393226,69.8999092493243,NaN,NaN,4.029376447204359,10.70069092292649
2020-08-24T09:30:00-04:00,59.59,59.96,59.04,59.94,7492918,13144861.75,50.10888412035436,53.04466820280731,NaN,NaN,-121.09272371280308,-144.4953051041948,-0.21708610503557213,0.1173422163622817,0.33442832139785383,1318890102,1314206522.8,40.14216468555038,66.99767143113529,NaN,NaN,3.461243360364709,9.666484128274808
2020-08-25T09:30:00-04:00,60.05,60.06,59.17,59.37,11786558,12789389.7,45.91967917300351,52.469364149488534,NaN,NaN,-121.94285817387156,-149.18026883266054,-0.2248816590303383,0.05332624760993099,0.2782079066402693,1307103544,1310843583.8,38.590116626669065,63.94938270776148,NaN,NaN,1.7611246922775345,8.537147065989483
2020-08-26T09:30:00-04:00,59.16,59.2,58.49,58.71,11664937,12917496.8,41.5845445481993,51.43682407171712,NaN,NaN,-189.2788415812204,-161.5262639518167,-0.26263511958287084,-0.05008599283831927,0.21254912674455156,1295438607,1306951988.4,36.816186330233364,60.69770923465079,NaN,NaN,-1.0339104907101229,7.169853129318111
2020-08-27T09:30:00-04:00,58.88,59.315,58.54,58.9,19453388,13253318.15,43.24565015957986,50.11204475697475,NaN,NaN,-145.25852946584175,-152.76513683282045,-0.2623429039897557,-0.11537950324264301,0.14696340074711264,1314891995,1309544286.4,38.833241839585625,57.50768273086136,NaN,NaN,-2.883762533431893,5.733622320353825
2020-08-28T09:30:00-04:00,59.02,59.125,58.461,59.07,8497900,13072514.05,44.75924313088547,48.90676261022425,NaN,NaN,-127.69785445133908,-141.05416147701516,-0.23889813481167246,-0.15165926776747796,0.0872388670441945,1323389895,1311942828.6,40.71895228848761,54.37725192590515,NaN,NaN,-4.01366299061837,4.3411529902149395
2020-08-31T09:30:00-04:00,58.98,59.6127,58.97,59.25,9987842,13089307.3,46.38954384593482,48.50428329729408,NaN,NaN,-76.45235906743054,-132.12608854794067,-0.2009881333154586,-0.16399629960012874,0.03699183371532986,1333377737,1314840355.6,43.00487764691052,51.67738672903999,NaN,NaN,-4.52693700180355,3.0742829913551555
2020-09-01T09:30:00-04:00,59.06,59.1,58.34,58.57,13311201,12713277.7,41.416701432472955,47.40748276655795,NaN,NaN,-120.5910781433607,-131.8557325418385,-0.21042400763373886,-0.2260381758268437,-0.015614168193104863,1320066536,1317432954,45.046765452162326,49.087768040085656,NaN,NaN,-6.416012853174024,1.7185264421367015
2020-09-02T09:30:00-04:00,58.7,60.66,58.46,60.39,18649448,13054286.65,55.24511109496361,47.3474985620173,NaN,NaN,-7.866731798222327,-95.57331058523889,-0.08901695712474846,-0.12688536459904043,-0.037868407474291974,1338715984,1326088429.4,51.31735932379304,47.22943698153206,NaN,NaN,-3.6053973084066366,0.9579659063447961
2020-09-03T09:30:00-04:00,60.41,61.04,59.15,59.71,19435483,13336661.35,50.45319407033435,47.204060051754944,NaN,NaN,5.9014920920651575,-65.3413062736575,-0.05130572627861635,-0.10200056532256241,-0.05069483904394606,1319280501,1326966130.6,51.91653151750295,46.00030795997759,NaN,NaN,-2.891761411521281,0.4080048609353565
2020-09-04T09:30:00-04:00,59.83,60.17,58.6,59.37,17896264,13457909.05,48.20188981907329,46.938760012463526,NaN,NaN,-46.04439882123963,-49.01061514763761,-0.046215356949229625,-0.10846403523048309,-0.06224867828125347,1301384237,1322564999,48.68104383391402,45.03511591282455,NaN,NaN,-3.0546466621361725,-0.08665964236057622
2020-09-08T09:30:00-04:00,59.43,59.5,58.475,59.04,14495308,13652456.5,46.05390270722002,46.65501551102779,NaN,NaN,-79.30894290162128,-49.58193191447576,-0.061094446434040786,-0.13861673632380445,-0.07752228988976366,1286888929,1313267237.4,42.635880345371376,43.943521202235324,NaN,NaN,-3.8667742517082964,-0.6266760151245362
2020-09-09T09:30:00-04:00,59.48,60.585,59.42,59.82,15434778,13149293.45,51.54968541191225,46.85483203730666,NaN,NaN,34.78379355618835,-18.506957574565956,-0.01673316593439736,-0.09843874730776037,-0.081705581373363,1302323707,1309718671.6,40.565436473919554,43.21695989125049,NaN,NaN,-2.7811318514390018,-0.934455420312317
2020-09-10T09:30:00-04:00,59.59,59.66,58.72,58.79,18140199,13192027.5,45.02643054617085,46.84891040675683,NaN,NaN,-68.17878900940381,-30.569369016802256,-0.05303849407254699,-0.14800369896404675,-0.09496520489149976,1284183508,1298812176.4,34.94811792634523,42.49649367334559,NaN,NaN,-4.031971378303498,-1.3769577000253428
2020-09-11T09:30:00-04:00,58.92,59.12,58.47,58.93,12666401,13034662.1,46.026193115147066,46.85576094108934,NaN,NaN,-91.05736034886485,-49.96113950498826,-0.0632133523170024,-0.17398189528775276,-0.11076854297075037,1296849909,1294326058,32.928299171018935,41.86749810439028,NaN,NaN,-4.696204514789015,-1.851135816420153
2020-09-14T09:30:00-04:00,59.22,60.05,59.16,59.74,10463434,13124417.35,51.519702590951844,46.95653368898917,NaN,NaN,35.58451501763335,-33.63535673721366,-0.013574844606576847,-0.12773709872897143,-0.11416225412239459,1307313343,1295511879.2,34.01390999648562,41.42976562659994,NaN,NaN,-3.475586082402895,-2.0832001401319733
2020-09-15T09:30:00-04:00,60.35,61.03,59.82,60.14,11671273,13232466.4,54.009122610970955,47.534351077415415,NaN,NaN,145.78632636706382,11.383697116523372,0.04481708716050152,-0.05814089517176768,-0.1029579823322692,1318984616,1301931016.6,39.70335781216439,41.50928285413532,NaN,NaN,-1.6820106220699609,-2.0258873518374
2020-09-16T09:30:00-04:00,59.93,60.4798,59.67,60.06,11541882,13202181.35,53.41832618800714,48.37962119454455,NaN,NaN,104.20986655178804,25.26891171564331,0.0748998681532885,-0.009333147140658582,-0.08423301529394708,1307442734,1302954822,40.58329508505419,41.778362050908235,NaN,NaN,-0.4247448578912911,-1.7971527098450988
2020-09-17T09:30:00-04:00,59.68,59.9,59.1,59.57,11387721,13320484.65,49.82336221082106,48.849457769633204,NaN,NaN,20.45638356884403,42.995946231292876,0.05932607867560502,-0.010075416949440807,-0.06940149562504583,1296055013,1305329123,42.6727023453628,42.05260922989231,NaN,NaN,-0.42406847258229585,-1.6009978188075555
2020-09-18T09:30:00-04:00,59.56,59.6,58.39,58.52,15984770,13471419.2,43.12576558878929,48.73278080234063,NaN,NaN,-85.54267799109014,44.098882702847824,-0.019921068750953536,-0.09430283156373775,-0.07438176281278422,1280070243,1301973189.8,40.504593744660646,42.03729790533324,NaN,NaN,-2.560671033464598,-1.73809399232999
2020-09-21T09:30:00-04:00,57.6,57.93,56.905,57.66,15186006,13757385.55,38.554326734571205,48.17312243724323,NaN,NaN,-235.86523119410114,-10.191066539499076,-0.12275241669347572,-0.22782228367962887,-0.10506986698615314,1264884237,1293487368.6,35.581676400582154,41.50706924488122,NaN,NaN,-5.913011007580687,-2.3345107087943755
2020-09-22T09:30:00-04:00,57.69,58.41,57.645,58.02,10623847,13913932,41.356683064931595,48.16883541099027,NaN,NaN,-143.0341873851358,-67.955169289939,-0.15683796799216004,-0.3011173269763532,-0.14427935898419314,1275508084,1284792062.2,31.373816154326022,40.530430009321485,NaN,NaN,-7.7538655952188495,-3.108704263997872
2020-09-23T09:30:00-04:00,58.09,58.19,57.08,57.13,10788483,13864028.25,36.87872394802975,46.856950614780715,NaN,NaN,-178.80122744581536,-124.55738808945966,-0.22546277917707544,-0.42610783295553745,-0.200645053778462,1264719601,1276247435.6,27.88414062411846,38.85662867363044,NaN,NaN,-10.817118757435935,-4.209906334489023
2020-09-24T09:30:00-04:00,57.07,58.18,56.72,57.77,15664053,14063984.05,41.76204410774657,46.236154188881585,NaN,NaN,-148.03729125771994,-158.25612305477247,-0.21398380240138715,-0.46812480678019597,-0.2541410043788088,1280383654,1273113163.8,26.710518548362984,37.05619917583473,NaN,NaN,-11.794584776110018,-5.293431826149165
2020-09-25T09:30:00-04:00,57.52,58.7799,57.31,58.72,11287952,13655712.25,48.17169990011187,46.23399776609863,NaN,NaN,-70.03592686445762,-155.15477282944596,-0.132627881977311,-0.4199258568504476,-0.2872979748731366,1291671606,1275433436.4,29.08991098030488,35.65683254343408,NaN,NaN,-10.492838949315525,-6.036204272315787
2020-09-28T09:30:00-04:00,58.98,59.46,58.77,58.87,10179778,13739806.15,49.12382792731144,46.4532781389623,NaN,NaN,2.0783700555873708,-107.56605257950825,-0.06249110408195191,-0.3654118549755765,-0.3029207508936246,1301851384,1282826865.8,36.19796264836423,35.19698127936214,NaN,NaN,-9.164084054611694,-6.483044241215203
2020-09-29T09:30:00-04:00,59.05,59.4508,58.58,58.85,9222049,13701516.5,48.99458704740491,46.27077111292606,NaN,NaN,-3.4678516987673906,-79.65278544223459,-0.013769526147628386,-0.3201326585781601,-0.3063631324305317,1292629335,1286251116,39.2360002295439,35.10202154762102,NaN,NaN,-8.144955889994417,-6.720460191040805
2020-09-30T09:30:00-04:00,59.22,59.67,58.88,59.38,12104071,13641160,52.55674169369296,46.80865048060622,NaN,NaN,27.695130265435964,-38.35351389998432,0.05410645234367034,-0.2387300670009438,-0.29283651934461413,1304733406,1294253877,45.73888888721391,35.87279090196879,NaN,NaN,-6.207988849100742,-6.647249999335082
2020-10-01T09:30:00-04:00,59.53,60.13,59.41,59.98,13070959,13362235.55,56.279317092037225,47.54101647895551,NaN,NaN,79.68309615838798,7.190563583237255,0.13477378398715933,-0.12436928936066494,-0.25914307334782427,1317804365,1301738019.2,51.01824736452587,37.16493005864786,NaN,NaN,-3.4085248479490784,-6.18457497770851
2020-10-02T09:30:00-04:00,59.5,61,59.37,60.69,16944929,13237707.85,60.25359830815323,48.164866173041325,NaN,NaN,124.70945106643299,46.13963916941537,0.22594253945985843,0.023285100976998763,-0.20265743848285966,1334749294,1310353556.8,56.290468915428136,38.75611283857233,NaN,NaN,0.25863135845758417,-5.264116929684782
2020-10-05T09:30:00-04:00,60.85,61.62,60.44,61.45,11038352,12894812.25,64.02350368749259,48.88017910707858,NaN,NaN,170.3520691353854,79.79437898537496,0.32159008157119084,0.19933016348112886,-0.12225991809006195,1345787646,1319140809.2,60.911736449547796,40.270997026956856,NaN,NaN,4.634417873715389,-3.8500405291990436
2020-10-06T09:30:00-04:00,61.49,62.665,61.22,61.97,16388345,12989464.1,66.37360900847708,49.80555645139787,NaN,NaN,191.25540054718343,118.73902943456513,0.3989816300084297,0.37646711942047517,-0.02251451058795452,1362175991,1333050140.4,66.88075842394693,42.14938726544919,NaN,NaN,9.046032668335897,-2.0077443581226238
2020-10-07T09:30:00-04:00,62.29,62.61,61.885,62.35,12201521,12827801.25,68.01776207227108,51.10515644150144,NaN,NaN,181.86027191783216,149.57205776504438,0.45102984966062054,0.5412728014878212,0.09024295182720063,1374377512,1346978961.6,71.56373653403429,44.21303256464,NaN,NaN,13.213083564187528,0.16665963077882617
2020-10-08T09:30:00-04:00,62.62,63.59,62.58,63.49,13617922,12601687.4,72.38071352404761,53.19479557973419,NaN,NaN,194.39537215193303,172.5145129637534,0.5319383443725254,0.7551658822928573,0.22322753792033195,1387995434,1361017175.4,75.34720471857375,46.70179049134809,NaN,NaN,18.402059274005374,2.771716722668333
2020-10-09T09:30:00-04:00,63.84,63.87,63.05,63.48,8545228,12395628.75,72.28755664972104,55.60431200224489,NaN,NaN,171.22472076360714,181.8175669031882,0.5520918349104746,0.9133423315584253,0.3612504966479506,1379450206,1369957357.8,77.40868105711716,49.68943368110059,NaN,NaN,22.458243395117687,5.584077675875383
2020-10-12T09:30:00-04:00,63.52,64.31,63.36,63.88,7485117,12246712.9,73.7432747522009,57.91763997990698,NaN,NaN,155.99269783414255,178.94569264293963,0.5580156997729295,1.0587701213641125,0.500754421591183,1386935323,1378186893.2,79.13802444917152,53.101162845018116,NaN,NaN,26.302839368392135,8.543900774806346
2020-10-13T09:30:00-04:00,63.44,63.6099,62.7325,63.44,10105223,12168410.4,69.42326368441694,60.24224996107749,NaN,NaN,113.61498882610229,163.41761029872342,0.4998315038892478,1.1255438014527428,0.625712297563495,1376830100,1381117715,79.7330383027369,56.804655536348,NaN,NaN,28.289703419362127,11.3647297240286
2020-10-14T09:30:00-04:00,63.52,63.79,63.03,63.36,11169352,12149783.9,68.63597100029395,62.161816167688016,NaN,NaN,102.60375290066912,147.5663064952908,0.42635087107393643,1.1586508864059155,0.7323000153319791,1365660748,1379374362.2,78.30240833248305,60.48979052092801,NaN,NaN,29.6916812213601,13.982865652218813
2020-10-15T09:30:00-04:00,62.76,63.67,62.6,63.32,9562007,12058498.2,68.21939548179628,63.59379442352262,NaN,NaN,84.64952520290989,125.61713710548615,0.3487156707998854,1.1681946038318358,0.8194789330319504,1356098741,1372995023.6,73.13148107866488,63.635616956525155,NaN,NaN,30.73733046090503,16.37636062488827
2020-10-16T09:30:00-04:00,63.4,64.24,63.33,64,8040669,11661293.15,71.3975749815248,65.18477635596642,NaN,NaN,94.11000010000126,110.19419297276497,0.3177001580115374,1.2166041305463722,0.8989039725348348,1364139410,1369932864.4,70.71737561753852,66.10128931146618,NaN,NaN,32.573809991798655,18.690281963018325
2020-10-19T09:30:00-04:00,63.97,64.31,63.28,63.46,13301869,11567086.3,65.77247813785685,66.38319714814158,NaN,NaN,81.19694253351516,95.2350419126395,0.23894919381506619,1.1975904648036675,0.9586412709886013,1350837541,1362713308,65.24859542588922,67.95933182549085,NaN,NaN,32.56325947085969,20.67213589270995
2020-10-20T09:30:00-04:00,63.72,64.19,63.48,63.84,12489737,11660380.8,67.70093954517637,67.46492556610467,NaN,NaN,78.84562345926264,88.28116883927159,0.1925744663034259,1.1993593538678837,1.0067848875644578,1363327278,1360012743.6,63.27734724750677,69.21207885122604,NaN,NaN,33.09973100373973,22.44750662285706
2020-10-21T09:30:00-04:00,63.7,64.09,63.485,63.67,7099958,11475954.55,65.91178210871242,68.15295878158148,NaN,NaN,70.69909076296076,81.90023641172989,0.1333849452984448,1.1735160691875137,1.040131123889069,1356227320,1358126058,61.87101777702924,69.98727673783343,NaN,NaN,33.04742159018731,23.961780189618523
2020-10-22T09:30:00-04:00,63.76,64.68,63.58,64.57,7604761,11072989.95,70.37537873211537,68.87594309757877,NaN,NaN,84.92618474853796,81.9555683208555,0.1372470615063317,1.2116899507719836,1.074442889265652,1363832081,1359672726,62.6047498530108,70.43829680480361,NaN,NaN,34.316599438914444,25.441040082375082
2020-10-23T09:30:00-04:00,64.89,65,64.39,64.75,7242308,10870707.75,71.18796459436328,69.38769030521239,NaN,NaN,97.26343129978876,82.586254560813,0.13416473212846158,1.242148804426229,1.1079840722977674,1371074389,1361059721.8,63.287032786367625,70.60796082886218,NaN,NaN,35.598393596162765,26.89209058434475
2020-10-26T09:30:00-04:00,64.25,64.85,63.83,64.73,10381537,10880795.7,70.95507927161077,69.71493818115052,NaN,NaN,83.31842544433974,83.01055114297792,0.11382201826621707,1.2502615951305387,1.1364395768643216,1360692852,1363030784,64.284312414135,70.4225003995899,NaN,NaN,36.584055032426676,28.27665693407074
2020-10-27T09:30:00-04:00,64.85,65.34,64.37,64.68,9801043,10909745.4,70.3355877657402,69.88049715925544,NaN,NaN,97.81904571369857,86.8052355938651,0.08155327515579902,1.2383811708090704,1.1568278956532714,1350891809,1360543690.2,61.99588651362126,69.73908254098896,NaN,NaN,37.2432192280094,29.557594404633406
2020-10-28T09:30:00-04:00,63.78,64.6,62.67,62.8,17012215,11155152.6,51.96461639669941,68.422204507302,NaN,NaN,14.580485711346649,75.58151458354229,-0.07347109240332017,1.0649890301491212,1.1384601225524413,1333879594,1356074145,57.99997803533665,68.49999492075774,NaN,NaN,31.890897974606425,29.890923486058124
2020-10-29T09:30:00-04:00,62.57,63.74,61.76,62.97,14924039,11247806.6,53.15609392631405,67.05567145563008,NaN,NaN,-38.37716383323954,50.92084486718677,-0.16631600737469787,0.9305651133340689,1.0968811207087668,1348803633,1353068455.4,55.41335818173733,66.92890042965918,NaN,NaN,27.974918504548473,29.617208488699603
2020-10-30T09:30:00-04:00,62.62,63.01,61.78,62.38,17411755,11271147.9,48.64624789335517,65.26302667999823,NaN,NaN,-97.28065738109761,12.012027131009498,-0.26344331889685124,0.7675769720877028,1.031020290984554,1331391878,1345131953.2,49.176930494883116,64.78882229006716,NaN,NaN,23.1826494794253,28.697985773088988
2020-11-02T09:30:00-05:00,63.23,63.84,62.6,63.75,14955891,11467024.85,57.63448267181164,64.42097089338357,NaN,NaN,-11.810866019935077,-7.013831161845465,-0.23248011775247368,0.7404201437939619,0.9729002615464356,1346347769,1342262936.6,47.11274631521385,62.45880143381551,NaN,NaN,21.82243219493533,27.71576383335275
2020-11-03T09:30:00-05:00,64.55,65.37,64.29,64.67,15078663,11401540.75,62.394470860530575,63.97514945482904,NaN,NaN,135.08061162662003,0.4384820207388316,-0.15104348646625598,0.7840959034636157,0.9351393899298717,1361426432,1344369861.2,48.81199085336794,60.35234304245014,NaN,NaN,22.349577752983887,26.949165821871482
2020-11-04T09:30:00-05:00,64.29,65.29,63.63,63.7,18331516,11708040.5,55.335148255267114,63.05484608150554,NaN,NaN,60.67296971572877,9.656978821615253,-0.16251125573642666,0.7320003202593384,0.894511575995765,1343094916,1346212925.6,50.315822337838185,58.72265313239109,NaN,NaN,20.26072114523098,25.993673725208552
2020-11-05T09:30:00-05:00,64.37,65.445,64.215,64.27,15762591,11815273.95,58.3194207355116,62.1206922067903,NaN,NaN,104.09490673024632,38.151392934312426,-0.13295894569960232,0.7283128938712622,0.8612718395708645,1358857507,1348223700.4,51.97357155583838,57.38380998512679,NaN,NaN,19.62410744415874,25.083735685058578
2020-11-06T09:30:00-05:00,64.31,64.88,63.96,64.13,9477816,11861903.35,57.30664010438465,61.51598949011372,NaN,NaN,58.29295273983626,69.2661149584992,-0.12425272654761821,0.7059559313863417,0.8302086579339599,1349379691,1351821263,54.87459631250975,56.64281004845683,NaN,NaN,18.79963908639351,24.186007599534996
2020-11-09T09:30:00-05:00,65.99,67.93,65.255,65.32,23036146,12639454.8,63.16256126523442,61.19181961297501,NaN,NaN,219.73599276081322,115.5754867146489,-0.04390813772561253,0.7753234857769442,0.8192316235025567,1372415837,1357034876.6,58.762198456019206,56.320299420493434,NaN,NaN,20.078168683350682,23.59917346865152
2020-11-10T09:30:00-05:00,65.67,66.45,65.4,66.26,15585987,12913493,67.01167486446168,61.27038338124286,NaN,NaN,174.88119484046916,123.53560335741872,0.06127185680369096,0.8958214445071704,0.8345495877034794,1388001824,1362349955,62.325583590832665,56.35276840719367,NaN,NaN,22.494731257772184,23.441396009954474
2020-11-11T09:30:00-05:00,66.6,67.1,66.25,66.51,9729550,12841502.9,67.9702404200849,61.0985877875264,NaN,NaN,192.20249030415005,149.841507475103,0.132330654383769,0.9999629056831907,0.8676322512994217,1397731374,1373277246.6,68.37584022101493,56.7649891477654,NaN,NaN,24.70737512303066,23.62225016896536
2020-11-12T09:30:00-05:00,66.12,66.27,64.925,65.44,26510435,13688924.3,59.94198589919872,60.29530359501464,NaN,NaN,93.0839785904926,147.63932184715225,0.09373700259687112,0.9848035045455106,0.8910665019486395,1371220939,1375749933,69.56685008656648,57.21354752635103,NaN,NaN,23.908507293802806,23.663144043942136
2020-11-13T09:30:00-05:00,65.76,66.27,65.64,66.09,13162731,13945027.4,62.81528628384665,59.713889810174344,NaN,NaN,113.25898621546511,158.632528542278,0.09799119904377851,1.0135555007533625,0.915564301709584,1384383670,1382750728.8,72.70155928107303,57.81477944541803,NaN,NaN,24.208357257886746,23.741031645934225
2020-11-16T09:30:00-05:00,66.91,66.95,65.97,66.76,13687483,13964308.1,65.55768197473836,59.37261082510279,NaN,NaN,134.90381527863607,141.6660930458426,0.12993159616754268,1.0779787969190124,0.9480472007514698,1398071153,1387881792,74.75407406175522,58.72607855599903,NaN,NaN,25.360285386013175,23.972353608802646
2020-11-17T09:30:00-05:00,66.33,66.65,65.35,65.45,8405577,13760100.1,56.745590940959175,59.71410900683562,NaN,NaN,74.30271540157246,121.55039715806325,0.05089568435940195,1.0116668062007221,0.9607711218413202,1389665576,1388214542.4,74.88594865580883,59.93221931460419,NaN,NaN,23.32669194094301,23.880116227679842
2020-11-18T09:30:00-05:00,65.79,65.87,64.15,64.17,12790752,14044639.8,49.7139453431045,59.46824125089209,NaN,NaN,-3.7701974865285854,82.35585959992751,-0.09175630646651722,0.8460757387581737,0.9378320452246909,1376874824,1384043232.4,69.95291357968578,60.97075898588622,NaN,NaN,19.083066209403682,23.194823367926105
2020-11-19T09:30:00-05:00,64.1,64.15,63.0755,63.53,13498099,14339306.7,46.60433579474576,59.3223903867057,NaN,NaN,-80.84247533910198,47.570568814008595,-0.22575113406605496,0.6556431276421222,0.8813942617081771,1363376725,1382474389.6,68.13498964469338,62.32490606801553,NaN,NaN,14.614175647053898,21.969016550658647
2020-11-20T09:30:00-05:00,63.42,63.98,63.22,63.54,9316267,14443004.65,46.66047696587054,58.538532836281334,NaN,NaN,-73.07965266188846,10.302841038537878,-0.3052995752129135,0.49976979269203525,0.8050693679049488,1372692992,1380136254,65.40684103907026,63.63162711971955,NaN,NaN,11.196325152637746,20.43006063665566
2020-11-23T09:30:00-05:00,63.79,63.905,63.26,63.55,8466163,14347235.95,46.7208048111627,57.41898526132648,NaN,NaN,-67.67528081927036,-30.21297818104341,-0.345856175912877,0.3727491480138525,0.7186053239267295,1381159155,1376753854.4,61.56639675500109,64.54265611269335,NaN,NaN,8.511466290258324,18.72740430145604
2020-11-24T09:30:00-05:00,64.06,64.39,63.74,64.23,10903538,14402360.7,50.79612372445628,57.09476922341143,NaN,NaN,-30.481952256058463,-51.1699117125696,-0.3163012914506612,0.323228709613403,0.6395300010640642,1392062693,1377233277.8,61.90780444278749,65.37065483447545,NaN,NaN,7.416788931090351,17.111602105689514
2020-11-25T09:30:00-05:00,64.15,64.42,63.59,64.4,11492618,14126380.85,51.78895439900809,56.62830734223261,NaN,NaN,-33.03520320357528,-57.02291285597894,-0.2761772961772331,0.29430838084252287,0.5704856770197559,1403555311,1382569375.2,65.57340751994889,66.34207168905476,NaN,NaN,6.805981529301583,15.639370594776953
2020-11-27T09:30:00-05:00,64.38,64.44,63.5,63.76,6036647,13682011.25,47.872628051776566,55.95444933847489,NaN,NaN,-54.20297243915577,-51.6950122759897,-0.2825949969084224,0.21724193088422794,0.4998369277926503,1397518664,1389397763,69.60429573563974,67.39419307642119,NaN,NaN,5.136578997730747,14.138971795198923
2020-11-30T09:30:00-05:00,63.58,63.62,62.59,62.84,13445064,13483676.7,42.855648410682726,54.503955563149766,NaN,NaN,-119.07374459728099,-60.89383066306821,-0.3350725592636368,0.0809962287131043,0.41606878797674113,1384073600,1391673884.6,70.83032347050296,68.25620200602717,NaN,NaN,2.1323171236524123,12.423735413549423
2020-12-01T09:30:00-05:00,63.31,64.17,63.24,63.28,15092967,13490530.5,45.78213803848254,52.987560075579836,NaN,NaN,-82.37596637131819,-63.833967773477774,-0.32611286909048565,0.008427701613634042,0.3345405707041197,1399166567,1395275367,72.7062742032523,68.99767990691429,NaN,NaN,0.483839635965652,10.718036016751741
2020-12-02T09:30:00-05:00,62.98,63.73,62.58,63.7,12199018,13346548.25,48.493675073592385,51.59637683654466,NaN,NaN,-88.27204530491645,-75.39198638324936,-0.2796482571158255,-0.015019750690662192,0.26462850642516333,1411365585,1399135945.4,74.59255592636605,69.44173102872507,NaN,NaN,-0.10727650738228764,9.171562799018309
2020-12-03T09:30:00-05:00,63.6,63.658,62.87,63.04,9376831,12898814,44.70965203881663,50.5083529893745,NaN,NaN,-90.79275007715785,-86.94349575796588,-0.2803977404639867,-0.08586866915482005,0.19452907130916663,1401988754,1398822634,74.14470612608652,69.76872074583365,NaN,NaN,-1.7402910088411174,7.612726540752677
2020-12-04T09:30:00-05:00,63.1,63.245,62.055,62.41,10502539,12635811.4,41.38962612194102,48.97794869209553,NaN,NaN,-114.66136653857376,-99.03517457784947,-0.3081472018322109,-0.19065493098109698,0.11749227085111391,1391486215,1397616144.2,72.34347920832337,69.7431435977801,NaN,NaN,-4.138678027587447,5.933954459561231
2020-12-07T09:30:00-05:00,62.2,63.065,62.19,62.76,8695875,12596714.35,43.88277684773974,47.4297411830242,NaN,NaN,-98.09806331077338,-94.84003832054796,-0.28812141338212705,-0.2426594958765449,0.04546191750558215,1400182090,1400837842.2,74.14942357767421,69.6999542774886,NaN,NaN,-5.411942585256682,4.313112024587243
2020-12-08T09:30:00-05:00,62.35,62.98,62.09,62.57,10502974,11970055.75,42.81797114515591,46.43491119760968,NaN,NaN,-98.81069193804385,-98.12698343389309,-0.27300566030739193,-0.29579515787865773,-0.022789497571265832,1389679116,1398940352,71.20046253204895,69.43670526864861,NaN,NaN,-6.767229844753632,2.7302060432528323
2020-12-09T09:30:00-05:00,62.62,62.72,62.04,62.46,11484971,11765004.95,42.17984720702784,45.89676133074706,NaN,NaN,-101.54523705075317,-100.78162178306043,-0.2560321668078882,-0.34282970608112606,-0.08679753927323788,1378194145,1392306064,61.92702156410567,68.86342726753574,NaN,NaN,-8.066946213325869,1.1877557208844465
2020-12-10T09:30:00-05:00,62.43,62.63,61.85,62.14,10800865,11818570.7,40.29833089967063,45.44633240967027,NaN,NaN,-109.87230321477685,-104.59753241058422,-0.25160221648073705,-0.4013003098741592,-0.14969809339342216,1367393280,1385386969.2,54.02413794900602,67.85550928927236,NaN,NaN,-9.694491989431235,-0.3668510948749364
2020-12-11T09:30:00-05:00,61.88,62.315,61.82,62.24,6675869,10826842.4,41.18131523438284,45.05496371456401,NaN,NaN,-109.33190286511746,-103.53163967589296,-0.22788967017281975,-0.43456018110944683,-0.20667051093662708,1374069149,1381903556,50.52808028392533,66.79274066390487,NaN,NaN,-10.834219869601638,-1.862189491264465
2020-12-14T09:30:00-05:00,62.68,63.2,61.86,61.92,13604428,10848927.25,39.18416041312522,44.51663197184705,NaN,NaN,-90.97098846333455,-102.1062247064052,-0.21961822927846558,-0.4811932975347091,-0.2615750682562435,1360464721,1373960082.2,43.599250081084236,65.50937304433937,NaN,NaN,-12.353232691375203,-3.3609099484231417
2020-12-15T09:30:00-05:00,62.21,63.3,61.9,63.14,11178892,10723497.7,49.282769983534145,44.40853527606689,NaN,NaN,-48.638583989416965,-92.07180311667982,-0.12267882006507197,-0.41492359333758344,-0.29224477327251147,1371643613,1370352981.6,40.85925351282488,64.00590512077062,NaN,NaN,-10.849175031504343,-4.430662103149027
2020-12-16T09:30:00-05:00,63.26,63.58,62.33,62.41,12156475,10911042.6,44.519126780842356,43.88926187476934,NaN,NaN,-41.60462183163378,-80.08368007285594,-0.09941060470719348,-0.4165080291565033,-0.31709742444930983,1359487138,1366611580.2,38.17911298021295,62.04916979650376,NaN,NaN,-10.954693241035477,-5.36266655141852
2020-12-17T09:30:00-05:00,62.63,63.285,62.62,62.83,12695074,10906258.7,47.654127686873274,43.87365470584768,NaN,NaN,-19.076126702082117,-61.924444770316995,-0.049920934440574216,-0.3794985925000276,-0.3295776580594534,1372182212,1367569366.6,39.27720301776296,59.882948888083995,NaN,NaN,-10.097092377832272,-6.039013098049056
2020-12-18T09:30:00-05:00,62.84,63.065,61.99,62.29,10438697,10753288.6,44.196254947924864,43.96941231565069,NaN,NaN,-70.09549764093617,-54.077163725480716,-0.04774167188173467,-0.38925474791162173,-0.34151307602988706,1361743515,1365104239.8,37.43419793792585,57.49751135004277,NaN,NaN,-10.397508727000648,-6.661655330756426
2020-12-21T09:30:00-05:00,61.28,61.28,60.32,61.02,13957407,10985345.6,37.33479013467363,43.36603032252149,NaN,NaN,-226.70251657679782,-81.22346934817338,-0.12180797852314257,-0.49377304918381526,-0.3719650706606727,1347786108,1362568517.2,35.58452754768521,54.84595801750226,NaN,NaN,-12.91541718405719,-7.555049881227964
2020-12-22T09:30:00-05:00,61,61.155,60.72,60.9,12088592,11166467.05,36.7541593307274,42.52749348374541,NaN,NaN,-191.78875309064577,-109.85350316841914,-0.16611291422163288,-0.5796062134377138,-0.4134932992160809,1335697516,1355379297.8,30.919791744016862,51.72647486162018,NaN,NaN,-15.093015224952634,-8.63190207318863
2020-12-23T09:30:00-05:00,61.19,61.67,60.77,60.78,5771715,10909875.9,36.14872913834919,41.91599899085488,NaN,NaN,-158.16311446185566,-133.16520169446352,-0.18906285631422665,-0.6498218696088642,-0.4607590132946376,1329925801,1349467030.4,27.703486292030803,48.409244873473334,NaN,NaN,-17.035066419461636,-9.832354122656202
2020-12-24T09:30:00-05:00,60.91,61.24,60.5799,61.21,3636193,10517054.65,39.96495702023293,41.81423691216145,NaN,NaN,-145.5849994661847,-158.46697624728404,-0.16189420064939963,-0.6631267641063872,-0.5012325634569875,1333561994,1341742986.8,24.16666738604465,44.96804402902486,NaN,NaN,-17.57203685084379,-10.938023083825858
2020-12-28T09:30:00-05:00,61.53,61.875,61.25,61.48,5869518,10508698.2,42.29703400777672,41.70096956644981,NaN,NaN,-80.52796483676875,-160.55346968645054,-0.114578241272551,-0.6444553650476763,-0.5298771237751253,1339431512,1337280586.2,22.388351011833464,41.27082456003624,NaN,NaN,-17.350713937908413,-11.854121777266222
2020-12-29T09:30:00-05:00,61.63,61.92,61.295,61.47,7582479,10215568.95,42.23160105437801,41.65908598853709,NaN,NaN,-68.44541647919876,-128.90204966693074,-0.07472252190388307,-0.6232802761549792,-0.5485577542510961,1331849033,1334093171.2,21.188970836761527,37.69857515322999,NaN,NaN,-17.187040134540833,-12.61596725687688
2020-12-30T09:30:00-05:00,61.51,61.98,61.41,61.78,5923550,9757098.1,45.06856570757868,41.86542302429073,NaN,NaN,-44.616320467212304,-99.46756314224403,-0.021040078947348162,-0.5748578529352812,-0.5538177739879331,1337772583,1334508184.6,21.77656816836874,34.83068562496307,NaN,NaN,-16.26931989804187,-13.137874777043308
2020-12-31T09:30:00-05:00,61.79,62.79,61.625,62.7,9091977,9601746.05,52.52067100931215,42.73844731783655,NaN,NaN,29.979328777480546,-61.8390744943768,0.07747129364475658,-0.45697865693198736,-0.5344499505767439,1346864560,1337895936.4,26.58820465928835,32.870976104268955,NaN,NaN,-13.197397950021388,-13.146378087468747
2021-01-04T09:30:00-05:00,62.81,62.81,60.77,61.12,12630390,9764424,41.98608704454975,42.79593101856276,NaN,NaN,-51.310689439486545,-42.98421248903716,0.03919570962493779,-0.4854553135455717,-0.5246510231705095,1334234170,1338030371.6,26.780676744398036,31.174732994302712,NaN,NaN,-13.717133270243856,-13.227914542150906
2021-01-05T09:30:00-05:00,61.25,61.43,60.6073,61.11,8333287,9655961.4,41.92876432545081,42.99197415515744,NaN,NaN,-96.5497058993649,-46.1885607015564,0.01729557780923585,-0.5030315509089647,-0.5203271287182005,1325900883,1335324245.8,25.340434231530097,29.8705318621917,NaN,NaN,-14.139123950748175,-13.358087314807658
2021-01-06T09:30:00-05:00,61.46,63.04,61.32,62.63,17980947,10120215,52.536234954893935,43.224364510254574,NaN,NaN,44.55151052955794,-23.58917529980507,0.10440890880853432,-0.38981599270753264,-0.49422490151606696,1343881830,1337730805.2,28.99740579056531,29.02325702488745,NaN,NaN,-10.84937268338889,-12.999699510319262
2021-01-07T09:30:00-05:00,62.97,63.09,61.75,61.81,12379409,10214036.75,47.495874382036185,43.43698933891127,NaN,NaN,34.69603406667748,-7.726704393027115,0.1057118392433472,-0.36208510246188297,-0.4677969417052302,1331502421,1336476772.8,28.221666769559974,28.312010866983666,NaN,NaN,-9.852703086273742,-12.550128592598474
2021-01-08T09:30:00-05:00,61.89,62.455,61.775,62.33,13465449,10313060.65,50.72443152916238,43.656296756217635,NaN,NaN,33.09882453402492,-7.102805241718239,0.13843690211240234,-0.29475081406472725,-0.4331877161771296,1344967870,1336097434.8,27.977844694615357,27.504913843901697,NaN,NaN,-7.954555877691462,-11.893618204754615
2021-01-11T09:30:00-05:00,62.1,62.35,61.29,61.75,8329200,10189477.4,47.235496622825046,43.87338544728193,NaN,NaN,-9.690871340864636,1.2211583780061424,0.11862629106992645,-0.2849048523397215,-0.40353114340964796,1336638670,1336578334.8,28.817453518106433,26.889432099628884,NaN,NaN,-7.552470982580795,-11.273454315872641
2021-01-12T09:30:00-05:00,61.65,61.86,60.68,61.42,12309526,10471160.25,45.325262342849605,44.44413346215165,NaN,NaN,-59.70725092223793,8.589649373431536,0.08260988501260458,-0.30026878714389227,-0.38287867215649685,1324329144,1336263987,28.582891669842112,26.389315251211517,NaN,NaN,-7.837906485986713,-10.78266176874608
2021-01-13T09:30:00-05:00,61.61,62.82,61.5,62.62,13343439,10458110.8,52.80024044015866,45.590282112825314,NaN,NaN,54.724906679212296,10.624328603362407,0.13577678112102615,-0.21315769575521415,-0.3489344768762403,1337672583,1335022137.6,27.626212513283164,26.1540595918734,NaN,NaN,-5.57147703540527,-10.038206806840249
2021-01-14T09:30:00-05:00,62.64,62.69,62.015,62.38,13033481,10550840.25,51.289917239113535,46.6717955485942,NaN,NaN,65.29858318923391,16.744838427873695,0.1498480480647023,-0.16162441679536244,-0.31147246486006475,1324639102,1333649473.8,26.56770458714911,26.072932327238995,NaN,NaN,-4.255392341586407,-9.212090454661128
2021-01-15T09:30:00-05:00,62.25,63.18,62.015,62.99,13782436,10632138.3,54.82678083555192,47.73335439254555,NaN,NaN,110.04718189977382,32.13450990102348,0.1925807732235948,-0.07074649833057123,-0.263327271554166,1338421538,1332340207.4,25.56167534132605,26.172575752616233,NaN,NaN,-2.0237659145707774,-8.185186948933936
2021-01-19T09:30:00-05:00,63.33,63.3932,62.655,62.75,9496671,10472218.15,53.190347341315714,48.511448202084054,NaN,NaN,134.27034931264532,60.92675403172548,0.1963538802794786,-0.017884921204817772,-0.21423880148429636,1328924867,1330797446.8,24.389700626749658,26.315529296538816,NaN,NaN,-0.7135461866989262,-7.117809697186077
2021-01-20T09:30:00-05:00,62.73,63.399,62.36,63.12,22398101,11070188.35,55.40044422297075,49.45207985698353,NaN,NaN,127.94421662981003,98.45704754213507,0.21399130569230115,0.05325033063108009,-0.16074097506122106,1351322968,1336196211.6,35.52935014586974,27.33984210433226,NaN,NaN,1.0400379792675671,-5.952402886264128
2021-01-21T09:30:00-05:00,62.97,63.1,62.64,62.75,6987968,10721716.4,52.71982847150494,49.99859862583541,NaN,NaN,101.73398076741204,107.858862359775,0.19168123357343728,0.07886056690557552,-0.11282066666786175,1344335000,1337528695,37.958880225038705,28.495721536951542,NaN,NaN,1.7270692687472222,-4.855335435548221
2021-01-22T09:30:00-05:00,62.57,63.05,62.33,62.84,9380075,10586290.55,53.3116023028704,50.05509371823242,NaN,NaN,83.92814448683914,111.58477461929606,0.1744216198111504,0.10520635809607626,-0.06921526171507414,1353715075,1343343889.6,47.29377218555461,29.97469064597056,NaN,NaN,2.456270987887212,-3.810820232200302
2021-01-25T09:30:00-05:00,62.62,64.19,62.55,64.1,18924251,11243917.35,60.72339656848038,51.393472969941755,NaN,NaN,170.40757091294282,123.65685242192986,0.23550143748995667,0.2251615351473717,-0.010339902342584972,1372639326,1350187447.2,55.734785722638335,32.04284128727344,NaN,NaN,5.4381414656405225,-2.489539989651613
2021-01-26T09:30:00-05:00,64.01,64.08,63.2,63.46,9736754,11548945.4,55.871630591328966,52.38939198893304,NaN,NaN,153.61150387464463,127.52508333432972,0.22069067147006524,0.2655234369949966,0.044832765524931345,1362902572,1356982988.2,62.20722821459919,34.67618371463551,NaN,NaN,6.476573441782072,-1.2086666423039436
2021-01-27T09:30:00-05:00,62.95,63.415,61.47,61.75,19643682,12237653.6,45.42767300186169,51.88163756371646,NaN,NaN,-13.711094676263887,99.19402107311494,0.09030166369483268,0.1577098451434722,0.06740818144863951,1343258890,1355370172.6,59.96614928254819,36.88823682120572,NaN,NaN,3.818635015374552,-0.49048069120701576
2021-01-28T09:30:00-05:00,61.96,63.44,61.8,62.49,12732858,12495172.55,49.80078844409029,52.0462742824346,NaN,NaN,27.50812568317381,84.3488500562673,0.050453120950756214,0.13047458263708478,0.08002146168632857,1355991748,1357701522.2,62.09210095957694,39.30755354906408,NaN,NaN,3.1320101059000653,0.027017994093995856
2021-01-29T09:30:00-05:00,62.17,62.78,61.76,62.15,13879842,12892987.15,47.90146408732991,51.84463375087514,NaN,NaN,-23.04464095361134,62.9542929681772,0.00040444429381528146,0.08052701705359766,0.08012257275978238,1342111906,1355380888.4,58.747827897616766,41.505409492135605,NaN,NaN,1.9626488082036726,0.30353668182394966
2021-02-01T09:30:00-05:00,62.55,63.01,61.93,62.45,8054672,12841121.9,49.72349208093252,52.02234771216853,NaN,NaN,8.712781838803918,30.615335153349417,-0.012571461325454683,0.06440824610296403,0.07697970742841871,1350166578,1350886338.8,52.81469103433785,43.21949788615213,NaN,NaN,1.5902342954539133,0.48735062662823014
2021-02-02T09:30:00-05:00,62.66,63.925,62.4,62.96,14349266,12927065.7,52.74884183034093,52.552603389846475,NaN,NaN,86.49888278156203,17.19281093473291,0.011799708442000373,0.09172934298091917,0.0799296345389188,1364515844,1351208993.2,53.18025025140871,44.97645207054975,NaN,NaN,2.213936221385852,0.7340057115936047
2021-02-03T09:30:00-05:00,62.89,63.175,62.62,62.76,8133376,12917070.15,51.4415603161905,52.45555480956303,NaN,NaN,44.79308383337326,28.89364663666034,0.012964289305195359,0.09613499617041299,0.08317070686521763,1356382468,1353833708.8,56.155961776597174,47.01429130364362,NaN,NaN,2.3340069888016526,0.9625773226233258
2021-02-04T09:30:00-05:00,62.73,63.34,62.55,63.25,11351064,12585576,54.42188332057211,52.67926667252436,NaN,NaN,68.03462287982506,36.99894607599059,0.04352702037277274,0.13757948233118356,0.09405246195841081,1367733532,1356182065.6,58.68599129995652,49.308454640272714,NaN,NaN,3.3158801738365273,1.2987634442252118
2021-02-05T09:30:00-05:00,63.53,63.94,63.27,63.59,5959960,12264603.55,56.420583023734956,52.793109685966,NaN,NaN,134.89781250523671,68.5874367677602,0.0812419371298701,0.19560488337074844,0.11436294624087834,1373693492,1362498382.8,64.60257770186766,52.09709052316858,NaN,NaN,4.720754221297679,1.7876192695212785
2021-02-08T09:30:00-05:00,63.73,63.75,62.86,63.1,10765522,12129607.2,52.8252852227953,52.767033820357405,NaN,NaN,75.53279743967634,81.95143988793468,0.06830879928200706,0.19974894534338716,0.1314401460613801,1362927970,1365050661.2,66.67911258114307,55.11776280562526,NaN,NaN,4.886018925784525,2.230247791844599
2021-02-09T09:30:00-05:00,63.21,63.42,62.67,63.19,6193724,12022833.4,53.41250112430123,52.625037884738155,NaN,NaN,48.76421915600297,74.40450716282287,0.061166973923843126,0.20789886346618403,0.1467318895423409,1369121694,1365971831.2,67.42194219114056,57.39580509457318,NaN,NaN,5.184902461751287,2.652341316116983
2021-02-10T09:30:00-05:00,63.56,63.7,63.01,63.44,9810552,11897884.7,55.08498617577641,52.79397772075754,NaN,NaN,90.49097940917318,83.54408627798287,0.0681008316288883,0.23185792907845126,0.16375709744956296,1378932246,1370481786.8,70.84844814332888,59.74505994587962,NaN,NaN,5.8952749449041635,3.115617548800866
2021-02-11T09:30:00-05:00,63.41,63.6199,62.9836,63.08,8710793,11666252.4,52.17999981177196,52.713148971393366,NaN,NaN,55.90894691734819,81.1189510854875,0.044409580008657606,0.21926907246038496,0.17485949245172736,1370221453,1370979371,71.20825815161294,61.45323751488378,NaN,NaN,5.717715512317121,3.4873458293031883
2021-02-12T09:30:00-05:00,62.89,63.18,62.29,62.62,10107994,11519978.05,48.64955262910938,51.85073154715258,NaN,NaN,-52.35741361330337,43.66790586177947,-0.003717947069563604,0.17021205861477284,0.17393000568433645,1360113459,1368263364.4,66.39131259181954,62.214418005539585,NaN,NaN,4.580627165422847,3.6435288773202825
2021-02-16T09:30:00-05:00,62.55,62.63,61.825,61.92,15861647,11623938.6,43.79373343281077,50.988024607258424,NaN,NaN,-148.20776399043152,-1.0802064242421139,-0.079946499061921,0.0739968818569352,0.1539433809188562,1344251812,1364528132.8,60.34546226423278,62.08143472337055,NaN,NaN,2.14505011437545,3.429460482613878
2021-02-17T09:30:00-05:00,61.99,62.08,61.55,61.97,10188796,11658544.85,44.221989303992274,50.90190434312489,NaN,NaN,-162.49199770880162,-43.331449797203035,-0.12174674029987129,0.0017599555440170889,0.12350669584388838,1354440608,1361591915.6,56.02635645730695,61.80002095013903,NaN,NaN,0.26116459606785947,2.9768467845358755
2021-02-18T09:30:00-05:00,61.87,62.61,61.87,62.34,7710054,10924142.5,47.41497570507216,50.73148914748074,NaN,NaN,-86.25088454107512,-78.67982258725269,-0.11907760775722112,-0.02534031385263802,0.0937372939045831,1362150662,1358235598.8,51.489765809745506,61.04271129657965,NaN,NaN,-0.4968756531653561,2.4806007220071282
2021-02-19T09:30:00-05:00,62.35,62.38,61.36,61.41,8966563,11023072.25,41.05359802030334,50.24235585697885,NaN,NaN,-144.45028575303536,-118.7516691213294,-0.17136741459020882,-0.12047197433317791,0.0508954402570309,1353184099,1354828128,47.30210444491704,60.22515962138681,NaN,NaN,-3.1045755704856774,1.682718394508156
2021-02-22T09:30:00-05:00,61.24,61.31,59.64,60.21,17801265,11444131.75,34.60259432391419,49.16229173147753,NaN,NaN,-247.90278293773613,-157.86074298621594,-0.27220349004212024,-0.28935892229561944,-0.017155432253499178,1335382834,1349882003,41.96663742513269,59.450298649300734,NaN,NaN,-7.638723802389926,0.3510837949512875
2021-02-23T09:30:00-05:00,60.45,60.92,60.14,60.71,13106649,11153251.65,38.91003572520946,48.173805581111004,NaN,NaN,-189.89097855908983,-166.19738589994762,-0.28907099716301754,-0.3784941787072711,-0.08942318154425356,1348489483,1350729537.2,43.14995046958881,58.73384866488502,NaN,NaN,-10.024844590387563,-1.1311916886685482
2021-02-24T09:30:00-05:00,60.56,60.668,59.94,60,11836756,11258251.75,35.34950139118712,47.02437280075361,NaN,NaN,-190.553218663039,-171.8096300907951,-0.3289849317438054,-0.5006543462240103,-0.1716694144802049,1336652727,1347171961,39.50834865404086,57.54473344184528,NaN,NaN,-13.218581949781028,-2.8579617259703305
2021-02-25T09:30:00-05:00,59.88,60.17,59.17,59.46,15680102,11060072.75,32.884776043672716,45.486007995260806,NaN,NaN,-193.47562049721063,-193.25457728202218,-0.3696527401123273,-0.633735339620614,-0.2640825995082867,1320972625,1338936353.6,32.64083511229738,55.684365142726776,NaN,NaN,-16.674286120364403,-4.831722353740912
2021-02-26T09:30:00-05:00,59.66,60.03,58.34,58.36,19006147,11373737.2,28.522122819643627,43.4932608378257,NaN,NaN,-190.18799946047355,-202.4021200235098,-0.44355656662110476,-0.8185283077846677,-0.3749717411635629,1301966478,1328692829.4,26.4762302784373,52.961054612481746,NaN,NaN,-21.208559555544163,-7.171270525427091
2021-03-01T09:30:00-05:00,59.1,60.315,59.09,59.65,15714700,11465480.1,38.77946075839826,42.48998766179734,NaN,NaN,-120.55828594416873,-176.93322062479635,-0.38088275304384067,-0.8510751824683638,-0.4701924294245231,1317681178,1325152498.2,24.737325119689444,49.96521265094935,NaN,NaN,-21.530878939774073,-9.222643156048088
2021-03-02T09:30:00-05:00,59.74,59.895,59.135,59.47,14651945,11795343.75,37.96087033919782,41.386299748575674,NaN,NaN,-111.79116788489404,-161.31325848995715,-0.32883404245362613,-0.8812349824915557,-0.5524009400379296,1303029233,1316060448.2,20.93465864193041,46.64469239743433,NaN,NaN,-22.050666876078942,-11.055217973195353
2021-03-03T09:30:00-05:00,59.38,59.38,58.27,58.77,22924899,12224125.4,34.877534135613274,39.94291031713545,NaN,NaN,-124.47854520944067,-148.0983237992375,-0.3186091258749493,-0.9506623473816163,-0.632053221506667,1280104334,1304750769.6,17.359837716337267,42.82407736693494,NaN,NaN,-23.500082963046225,-12.833055828888334
2021-03-04T09:30:00-05:00,58.81,59.815,58.4,58.72,22086307,12921771.95,34.66097220769507,38.69155120255853,NaN,NaN,-102.12934653901816,-129.829069007599,-0.29292690401674637,-0.9982118515276,-0.7052849475108536,1258018027,1292159850,14.409739876316223,38.76704034727088,NaN,NaN,-24.7023904774452,-14.528675064396458
2021-03-05T09:30:00-05:00,58.97,59.96,58.45,59.68,16803342,13194385.85,42.09521441789584,38.223384187471844,NaN,NaN,-76.878529337909,-107.1671749830861,-0.19377916705165676,-0.9475089063254245,-0.7537297392737677,1274821369,1286730828.2,13.35581428914152,34.978790468508166,NaN,NaN,-23.362849733305026,-15.79070001709768
2021-03-08T09:30:00-05:00,59.85,61.045,59.69,60.52,19212108,13856993.25,47.70232541196894,38.50256932884029,NaN,NaN,-26.71238339767959,-88.39799447378826,-0.06099861442559529,-0.8299780073057619,-0.7689793928801666,1294033477,1282001288,12.498216098748102,31.561130028116402,NaN,NaN,-20.372093595859436,-16.445184814063644
2021-03-09T09:30:00-05:00,60.85,61.52,60.765,61.32,11112382,13874336.25,52.4270862666944,39.088647683319,NaN,NaN,14.863856566078221,-63.066989583593816,0.08348808113104633,-0.6646192914663587,-0.748107372597405,1305145859,1282424613.2,13.036474117331181,28.49042414668956,NaN,NaN,-16.27342373104618,-16.42064751648972
2021-03-10T09:30:00-05:00,61.3,61.93,61.13,61.74,13710719,14250186,54.73896940986126,39.61179009080394,NaN,NaN,40.75300426447794,-30.020679688810116,0.20329673048136276,-0.4939864594957015,-0.6972831899770643,1318856578,1290175062,22.443053331179854,26.415658969649154,NaN,NaN,-12.194174620627354,-15.816865674223667
2021-03-11T09:30:00-05:00,61.63,62.355,61.55,61.58,8584233,14188870.05,53.668967041914335,40.51288787806187,NaN,NaN,61.005684623831286,2.6063265437597836,0.2638794918036924,-0.3674338252224487,-0.6313133170261411,1310272345,1300625925.6,32.97149555390767,25.39204404886277,NaN,NaN,-9.241774109060836,-14.877566879200405
2021-03-12T09:30:00-05:00,61.85,62.6,61.56,62.41,10021908,14254425.8,58.23030469990616,42.20058147634701,NaN,NaN,88.66809791479919,35.715651994301425,0.34674281788975936,-0.19788479466394193,-0.5446276125537013,1320294253,1309720502.4,40.53649527329717,25.289891038017373,NaN,NaN,-5.232240399041347,-13.499663096320539
2021-03-15T09:30:00-04:00,62.5,63.37,62.5,63.21,12209303,14359491.25,62.10306731980571,43.857226590246746,NaN,NaN,135.19026106472197,68.09618088678174,0.43652251090951283,0.0010255260831897317,-0.4354969848263231,1332503556,1317414518.2,46.080811543469075,25.49923825758025,NaN,NaN,-0.5404962745446069,-11.64835355035255
2021-03-16T09:30:00-04:00,63.06,63.45,62.89,63.29,14621781,14297497.95,62.47772395479571,45.79495677336165,NaN,NaN,135.63851327742353,92.25111222905079,0.4789872078185061,0.16323702494680958,-0.31575018287169654,1347125337,1325810413.8,51.405378985991106,26.34902613843384,NaN,NaN,3.3175652982524078,-9.510365143408984
2021-03-17T09:30:00-04:00,63.24,63.25,62.2,62.26,17203519,14648234.1,54.94595460319461,47.37075524189892,NaN,NaN,95.07745269869,103.11600191589321,0.41764039665413905,0.20630031294597728,-0.21134008370816176,1329921818,1328023461.8,52.730425624246664,27.783996889287355,NaN,NaN,4.418087049061607,-7.5205862587703285
2021-03-18T09:30:00-04:00,62.2,62.45,61.595,62.03,14812765,15003369.65,53.397951928417974,49.14760017823994,NaN,NaN,67.16282578577334,104.34743014828162,0.34454468871473104,0.21934077718525202,-0.12520391152947902,1315109053,1328990803.4,53.32947056845647,29.702085481431588,NaN,NaN,4.845647416727479,-5.753981447984928
2021-03-19T09:30:00-04:00,62.05,62.74,61.39,62.2,19355600,15522821.5,54.42010300843575,50.264788910385484,NaN,NaN,69.4904048855043,100.51189154242265,0.29265857617306534,0.24061930868685266,-0.05203926748621268,1334464653,1331824883.4,55.123833901263126,31.872550394401138,NaN,NaN,5.490337725254267,-4.147650137522186
2021-03-22T09:30:00-04:00,61.6,61.93,61.205,61.65,12820519,15273784.2,50.55655748384783,51.164480849289056,NaN,NaN,38.17566232363875,81.108971794206,0.21017043684316067,0.21067377856773817,0.0005033417245774927,1321644134,1329652999,53.428520138353846,34.193540501288524,NaN,NaN,4.919225558212129,-2.8523821809887124
2021-03-23T09:30:00-04:00,61.63,62.805,61.5,62.57,13058628,15271383.15,56.162884944690525,52.68486304993743,NaN,NaN,67.80329077971449,67.54192729466419,0.2061586494243302,0.25820165350499025,0.052043004080660045,1334702762,1327168484,51.47812332451089,36.63056090187235,NaN,NaN,6.110149303479627,-1.5720205403503782
2021-03-24T09:30:00-04:00,62.37,63.035,62.15,62.59,11029205,15231005.6,56.2789461917818,54.229004048800775,NaN,NaN,75.79695296166229,63.68582734725866,0.1936388488698857,0.29409156516801715,0.10045271629813146,1345731967,1330330513.8,53.79015289291469,39.4434475459151,NaN,NaN,7.100214102696774,-0.33312987705792785
2021-03-25T09:30:00-04:00,62.79,63.47,62.51,63.26,14154900,15154745.5,60.090892489285864,55.51440962532863,NaN,NaN,92.96824752039896,68.84691169418377,0.2174828385184961,0.3723062644462516,0.1548234259277555,1359886867,1339286076.6,59.653826106524015,42.75044839001385,NaN,NaN,9.093414249656103,1.0135192839012195
2021-03-26T09:30:00-04:00,63.25,63.53,62.635,63.47,10384729,14723674.6,61.23182686202428,56.48080258604687,NaN,NaN,94.74754320569618,73.89833935822216,0.2330171933076231,0.44609491756228437,0.21307772425466126,1370271596,1346447465.2,63.62836780871328,46.40260208358279,NaN,NaN,11.074206260843328,2.450760280607235
2021-03-29T09:30:00-04:00,63.34,64.45,63.305,64.15,16387878,14757333.5,64.74635464705241,57.360750327501016,NaN,NaN,127.61214823070861,91.78563653963613,0.2719921020800872,0.5530678518547703,0.2810757497746831,1386659474,1359450533.2,69.50293668428942,50.435920838365526,NaN,NaN,13.86030776579493,4.080695635634049
2021-03-30T09:30:00-04:00,63.95,63.95,63.1,63.57,11055606,14577516.55,59.76928763002673,57.72005877179855,NaN,NaN,98.34187578388486,97.8933535404702,0.2425857854202289,0.5843079815499692,0.3417221961297403,1375603868,1367630754.4,72.51093179112978,54.01219787121909,NaN,NaN,14.793635186244522,5.611115571435545
2021-03-31T09:30:00-04:00,63.6,64.16,63.47,64.04,11129754,13987759.3,62.298423850473796,58.336448543838515,NaN,NaN,115.98368102010714,105.93069915215918,0.23831661406833043,0.6396179637151533,0.4013013496468229,1386733622,1375831085.4,75.15630147995725,57.02539829450835,NaN,NaN,16.336613633070368,7.14332958024052
2021-04-01T09:30:00-04:00,63.94,64.09,63.55,63.98,10523341,13409611,61.76460702663637,58.588898710033526,NaN,NaN,108.63097942985874,109.06324553405113,0.2156601818314519,0.6708765769361378,0.45521639510468587,1376210281,1379095768.2,76.14071609078269,59.56855692432873,NaN,NaN,17.44350656766961,8.614783435587533
2021-04-05T09:30:00-04:00,64.21,65.09,64.15,64.68,14644276,13301657.7,65.48087057127094,58.83017037085248,NaN,NaN,153.86492274007912,120.8867214409277,0.2306765496316011,0.7435620821441873,0.5128855325125862,1390854557,1383212360.4,77.35897454143232,61.80271142418325,NaN,NaN,19.516039246387244,10.172105694273206
2021-04-06T09:30:00-04:00,64.61,65.03,64.135,65.02,8629451,12772524.85,67.15092143808229,59.16397019108723,NaN,NaN,145.2374016894917,124.41177213268432,0.2450181983460522,0.8191582804451514,0.5741400820990992,1399484008,1385777267.2,78.10898338398054,63.71011173832535,NaN,NaN,21.75226904235913,11.826414743999766
2021-04-07T09:30:00-04:00,64.97,65.285,64.605,64.94,7899229,12611867.2,66.33766816510553,59.977664016938,NaN,NaN,146.62288326573315,134.067973629054,0.23082326844546497,0.8626691676559304,0.6318458992104654,1391584779,1388973449.4,79.04071611806307,65.58941820216937,NaN,NaN,23.3709430218436,13.475633069406028
2021-04-08T09:30:00-04:00,65.11,65.31,64.75,64.89,9954978,12424080.15,65.80128771932323,60.86361657343124,NaN,NaN,133.2504520795744,137.52132784094744,0.2008747225907619,0.8829393024489178,0.6820645798581559,1381629801,1387952685.2,77.90035229904711,67.34448118292586,NaN,NaN,24.576059468667335,15.0614082693005
2021-04-09T09:30:00-04:00,64.95,65.225,64.69,64.82,7875401,12388638.55,65.0087908726555,61.61995142087551,NaN,NaN,112.30828965250143,138.25678988547597,0.16088788031369794,0.8831744302502784,0.7222865499365805,1373754400,1387461509,77.32226464192713,68.93008337868757,NaN,NaN,25.39040235122021,16.536978852431886
2021-04-12T09:30:00-04:00,64.83,65.34,64.6625,64.88,7100673,12242576.8,65.39352298205617,62.67973467074753,NaN,NaN,103.46934840327398,128.17767501811494,0.1246350049332845,0.8780803061031861,0.7534453011699016,1380855073,1385461612.2,74.88553598085957,70.46272736743798,NaN,NaN,26.180055115897904,17.914561175784176
2021-04-13T09:30:00-04:00,64.62,65.765,64.495,65.65,9125628,12088393.05,69.9585607717248,63.66514008696426,NaN,NaN,112.25684450562912,121.58156358134242,0.1376494162204459,0.925507071445459,0.787857655225013,1389980701,1383560950.8,72.54564405070941,71.96755027645216,NaN,NaN,28.170639135016113,19.379715169960168
2021-04-14T09:30:00-04:00,65.49,65.94,65.32,65.94,7562681,11735438.05,71.48424220305162,64.75123265919783,NaN,NaN,123.57664129481165,116.97231518715812,0.14991516188426146,0.9752516075803399,0.8253364456960784,1397543382,1384752671.4,73.11292191928533,73.34774806405005,NaN,NaN,30.312080107451873,20.94148158960184
2021-04-15T09:30:00-04:00,65.95,66.7,65.91,66.67,11931692,11471846.7,74.9350412214817,65.81152899721181,NaN,NaN,148.0541392186837,119.93305261497999,0.18880675288466686,1.061344886801912,0.8725381339172451,1409475074,1390321726,75.6454612672897,74.49000771839046,NaN,NaN,33.29086136858131,22.705678700884622
2021-04-16T09:30:00-04:00,66.92,67.47,66.78,67.21,11187961,11290606.5,77.13891709329243,66.94774972801667,NaN,NaN,166.8065399579245,130.83270267606463,0.22979246154128585,1.1597787108438524,0.9299862493025666,1420663035,1399703453,79.19985094670261,75.60225651396114,NaN,NaN,36.56455504324489,24.68551817836466
2021-04-19T09:30:00-04:00,67.25,67.36,66.705,66.87,10751912,10860422.1,72.79867975000494,67.52291580679899,NaN,NaN,141.95081881259486,138.52899675792878,0.21325889633995343,1.1965598697275084,0.983300973387555,1409911123,1405514663,81.04517782315347,76.42670230959428,NaN,NaN,38.05398611478103,26.595299312138426
2021-04-20T09:30:00-04:00,66.87,67.89,66.83,67.72,14774449,10958118.6,76.3771465283302,68.7091914423921,NaN,NaN,158.7534482550977,147.82831750782253,0.23699704120664533,1.2795472748958616,1.0425502336892163,1424685572,1412455637.2,82.98666632699987,77.17496906215642,NaN,NaN,40.52359522534825,28.5850558711684
2021-04-21T09:30:00-04:00,67.79,68.05,66.9019,67.15,9615131,10785943.75,69.75048412756885,69.24148146218461,NaN,NaN,137.62189122071587,150.63736749300335,0.19357107415441677,1.2845140763822371,1.0909430022278204,1415070441,1415961049,83.88443401227497,77.79840710017912,NaN,NaN,40.51423754032505,30.289224681047923
2021-04-22T09:30:00-04:00,67.1,67.33,66.605,66.67,8991761,10684071.55,64.66261702020859,69.4484821760112,NaN,NaN,94.9919246659478,140.02492458245618,0.11562680599754205,1.235476509724748,1.119849703727206,1406078680,1415281770.2,82.97075574454425,78.28626707544781,NaN,NaN,38.87743181733865,31.516111414803742
2021-04-23T09:30:00-04:00,66.7,66.92,66.41,66.58,8440769,10398365,63.72402323205549,69.32299308035294,NaN,NaN,72.19825048098778,121.10326668706882,0.04475845478161111,1.1757977722042199,1.1310393174226088,1397637911,1410676745.4,76.85887937629194,78.2505459922235,NaN,NaN,37.27956126996641,32.339461394112696
2021-04-26T09:30:00-04:00,66.61,66.65,66,66.2,6289232,10193590.15,59.77858030491158,68.79639728512647,NaN,NaN,44.93083749305661,101.69927042316118,-0.03656894878318173,1.0853281314436316,1.1218970802268133,1391348679,1406964256.6,72.23891535484753,77.831255418714,NaN,NaN,34.7289476528951,32.680816573938756
2021-04-27T09:30:00-04:00,66.1,66.13,65.58,65.69,10471078,9897750.15,54.86851729364293,67.97717222287915,NaN,NaN,11.131297254937165,72.17484022312908,-0.1284015151175688,0.9613951863298524,1.0897967014474212,1380877601,1398202662.4,62.66533136446822,76.6615850791715,NaN,NaN,31.011610241225906,32.44235852640835
2021-04-28T09:30:00-04:00,65.72,65.9,65.29,65.6,7579080,9723923.85,54.02519261502328,67.136022572572,NaN,NaN,-9.260284991545802,42.79840498067674,-0.1949084272544117,0.8461611673794067,1.0410695946338184,1373298521,1389848278.4,55.158878761874924,75.03719411223064,NaN,NaN,27.73673218876429,31.770126192459198
2021-04-29T09:30:00-04:00,65.6,66.24,65.6,66.2,9611118,9647992.05,58.59424102093123,66.67784044030599,NaN,NaN,13.73538804808779,26.547097657104747,-0.19757688398220274,0.794098489656065,0.9916753736382677,1382909639,1385214470.2,51.47573819906026,73.19101365202586,NaN,NaN,26.18204606179359,30.971829030935538
2021-04-30T09:30:00-04:00,66.34,66.74,65.945,66.72,10242312,9633940.6,62.10887510173262,66.4432227345686,NaN,NaN,41.84686590191528,20.476820741290208,-0.1647478441260276,0.7857405684807333,0.9504884126067609,1393151951,1384317278.2,50.76887972894481,71.46839534831766,NaN,NaN,25.90022895779855,30.247314734773113
2021-05-03T09:30:00-04:00,66.87,67.33,66.6,66.71,10772317,9440342.65,61.999883864659864,65.87474581263538,NaN,NaN,68.87373923371091,25.265401089421072,-0.144838481790033,0.7694403103692196,0.9142787921592526,1382379634,1382523469.2,49.3109103823927,69.80877151486646,NaN,NaN,25.642216175598293,29.589443512033853
2021-05-04T09:30:00-04:00,66.64,66.76,66.015,66.46,11722758,9595008,59.2028038762741,64.99750021786556,NaN,NaN,23.322582204596078,27.703658079352856,-0.1490567278186754,0.7279578823859083,0.8770146102045837,1370656876,1380479324.2,47.63221545453952,67.9887210530989,NaN,NaN,24.627801814139968,28.880637555191868
2021-05-05T09:30:00-04:00,66.46,66.46,64.97,65.34,11781422,9789117.65,48.62018182188156,63.11786740360842,NaN,NaN,-58.71962764572967,17.81178954851608,-0.22335820100127035,0.5978168589529957,0.8211750599542661,1358875454,1377594710.8,45.289154578166716,65.82041343244727,NaN,NaN,20.263706110463918,27.649647348802162
2021-05-06T09:30:00-04:00,65.52,65.9,65.08,65.84,11652703,9874003.9,52.68625336124665,61.37124856560514,NaN,NaN,-63.307012857801055,2.403309367338315,-0.23379778331922862,0.5289278308052303,0.7627256141244589,1370528157,1375118414.4,43.3191709361571,63.2575077174083,NaN,NaN,17.862112261485613,26.251428050614084
2021-05-07T09:30:00-04:00,65.8,66.54,65.78,66.04,9055371,9933002.4,54.24600742028543,60.0460576849109,NaN,NaN,-18.737865372551795,-9.7136368875551,-0.2222751362026283,0.4848816938711735,0.7071568300738018,1379583528,1372404729.8,41.20398266697262,60.41170806339538,NaN,NaN,16.388527341964114,24.84244223509266
2021-05-10T09:30:00-04:00,66.18,67.375,66.18,66.71,13221146,10239026.05,59.10922416407584,58.812634658892726,NaN,NaN,47.82975249262324,-13.922434235772633,-0.1670901133663184,0.4982941883659038,0.6653843017322222,1392804674,1374489737.8,43.487207603452426,57.59031815457057,NaN,NaN,16.638878583464336,23.670504570574327
2021-05-11T09:30:00-04:00,66.64,66.73,65.4301,65.89,14105064,10487997.85,51.845938846381316,57.53373856737933,NaN,NaN,-53.15757819895101,-29.21846631648205,-0.1821387363167939,0.4377108813362298,0.6198496176530237,1378699610,1376098284.6,45.25352052150561,54.830967190944186,NaN,NaN,14.456896995952686,22.354274917056948
2021-05-12T09:30:00-04:00,65.82,65.82,64.32,64.35,14776866,10848707.1,41.52576450490216,55.88110624485744,NaN,NaN,-188.68605245867738,-55.211751279071585,-0.2859531610386338,0.2624081663547315,0.5483613273933653,1363922744,1377107742.6,46.386020387990484,52.217771808333204,NaN,NaN,8.597768645243049,20.389059735369248
2021-05-13T09:30:00-04:00,64.42,65.9781,64.37,65.59,14111369,10957690.95,50.13312667496473,54.91032791935096,NaN,NaN,-112.22933872847103,-64.99621645320559,-0.26189729643278925,0.22098970685237873,0.482887003285168,1378034113,1378608933.8,48.10526510907874,50.163942217817976,NaN,NaN,6.924517059182592,18.465553638771155
2021-05-14T09:30:00-04:00,65.75,66.325,65.75,65.91,9455400,10871062.9,52.09295436935186,54.36135463823956,NaN,NaN,-30.287332647767336,-67.3061099082487,-0.21707119370591704,0.21154801115277166,0.4286192048586887,1387489513,1380190130.8,49.926646874634564,48.57020875494562,NaN,NaN,6.3595882927625285,16.736130017912778
2021-05-17T09:30:00-04:00,65.88,66.26,65.27,65.37,12562009,10961567.75,48.6203724622536,53.915058578854605,NaN,NaN,-66.64018840564466,-90.20009808790228,-0.2159650082114561,0.15866294459436858,0.37462795280582467,1374927504,1376614696.8,45.99548975759514,47.37950578302611,NaN,NaN,4.698463048715618,15.01646330802747
2021-05-18T09:30:00-04:00,65.23,65.58,65.06,65.36,9766197,10711155.15,48.55582105189449,53.52438918148827,NaN,NaN,-96.92989311846401,-98.95456107180487,-0.20800401815192865,0.11462293011591385,0.3226269482678425,1365161307,1373907036.2,43.220100410622415,46.52673590079378,NaN,NaN,3.406326070365128,13.357872274075707
2021-05-19T09:30:00-04:00,65.05,65.305,64.49,65.25,13119040,10886350.6,47.803975154087254,52.75365590528512,NaN,NaN,-128.15672390200024,-86.84869536046945,-0.20207158079399784,0.07003747227534518,0.272109053069343,1352042267,1371530940.8,40.88844892207246,45.77050095243751,NaN,NaN,2.1481140485798544,11.756478241862013
2021-05-20T09:30:00-04:00,65.37,66.22,65.35,65.82,12839761,11078750.6,51.95541573162448,52.02840880742025,NaN,NaN,-15.891948866898513,-67.58121738815495,-0.15386501573550498,0.07977778339996178,0.23364279913546676,1364882028,1368900523.8,38.41756088774852,44.888263892352064,NaN,NaN,2.345303001243695,10.412024636059396
2021-05-21T09:30:00-04:00,65.98,66.405,65.695,66.16,10243938,11168909.05,54.290776525049964,51.4777582831624,NaN,NaN,32.7939353609773,-54.96496378640602,-0.0960162874016873,0.11362243988335763,0.20963872728504493,1375125966,1366427814.4,36.20279564446248,43.951969982499904,NaN,NaN,3.215415045279587,9.38393755166228
2021-05-24T09:30:00-04:00,66.48,66.59,66,66.04,9671517,11338023.3,53.30592215072365,51.05655244562308,NaN,NaN,53.1364420052485,-31.009637704227384,-0.06429384867143878,0.12927141644574647,0.19356526511718525,1365454449,1364533203.4,34.5588449501401,43.01815780361422,NaN,NaN,3.6451119053756122,8.56410531647847
2021-05-25T09:30:00-04:00,66.11,66.11,65.0925,65.24,10213669,11325152.85,47.163427986529285,50.95249860024078,NaN,NaN,-57.33594577284668,-23.09084823510392,-0.0938592774810322,0.076241168265895,0.1701004457469272,1355240780,1362549098,32.87522235330489,42.131448358981245,NaN,NaN,2.1827769658281624,7.652486980671283
2021-05-26T09:30:00-04:00,65.28,65.525,65.055,65.25,8420815,11367239.6,47.24526042106153,50.56385624737042,NaN,NaN,-82.94200052609118,-14.047903559922114,-0.10838265371707093,0.03462212860058855,0.14300478231765948,1363661595,1364872963.6,36.76119832184811,41.66302174367346,NaN,NaN,1.0290995408721098,6.706288774985687
2021-05-27T09:30:00-04:00,65.48,65.48,64.79,64.81,8498267,11311597.05,44.01505981196796,49.833074275347734,NaN,NaN,-105.94820875641315,-32.05915553782504,-0.1411875461585272,-0.03347965038049949,0.10770789577802768,1355163328,1362929223.6,34.93922359386596,41.21553895273727,NaN,NaN,-0.8995138993020019,5.619745535801732
2021-05-28T09:30:00-04:00,65.2,65.4,64.96,65.16,9782719,11288617.4,47.11264424150305,48.976175709449684,NaN,NaN,-78.20592562642908,-54.25912773530631,-0.1329935027234629,-0.05853398262630094,0.07445952009716195,1364946047,1360893239.8,33.089270524134136,40.47282916135739,NaN,NaN,-1.6640098246546866,4.579209055736529
2021-06-01T09:30:00-04:00,65.31,65.46,64.61,64.76,11026162,11301309.65,44.10895283563836,48.42353385153947,NaN,NaN,-105.3661879152542,-85.95965371940686,-0.1470917946279749,-0.10940522318780666,0.03768657144016822,1353919885,1358586327,31.081166028244837,39.460518126124484,NaN,NaN,-3.1844322885763576,3.470117435120402
2021-06-02T09:30:00-04:00,64.86,65.46,64.6,65.1,10245865,11227465,47.19093364603832,48.82818879019205,NaN,NaN,-81.20159131814147,-90.73278282846582,-0.12686311151243734,-0.12089231795037847,0.005970793562058881,1364165750,1360371321,34.39860146049898,38.60427391701795,NaN,NaN,-3.6040981646663557,2.459515206579437
2021-06-03T09:30:00-04:00,64.8,65.7,64.5802,65.49,11853846,11231086.2,50.5587434504114,48.85858998843825,NaN,NaN,-44.80914130329238,-83.10621098390604,-0.08269933658979385,-0.09740337717518344,-0.014704040585389582,1376019596,1362842921.2,38.79198385865366,37.93903954198758,NaN,NaN,-2.996038487074798,1.6801503932002606
2021-06-04T09:30:00-04:00,65.66,65.76,65.3099,65.39,7234803,11010191.2,49.68381194923969,48.686508387001666,NaN,NaN,-8.30319097441809,-63.57720742750704,-0.056930814635071915,-0.08586755887922948,-0.028936744244157563,1368784793,1365567214.2,43.29945944422346,37.465669011243925,NaN,NaN,-2.731873142814012,1.0498613166267932
2021-06-07T09:30:00-04:00,65.45,65.61,65.34,65.51,6911208,10902983.05,50.78445379454492,48.84108562502247,NaN,NaN,-3.6877411272270053,-48.67357052766663,-0.029873266484348564,-0.06627832734959327,-0.036405060865244705,1375696001,1367717205,46.63921557145539,37.51164942651966,NaN,NaN,-2.2122055866306787,0.583851759018583
2021-06-08T09:30:00-04:00,65.65,65.7,64.67,64.95,9181908,10701021.15,45.75450447488084,48.64099158380721,NaN,NaN,-63.39299834376689,-40.278932613369165,-0.046754107250038805,-0.09484769492779321,-0.04809358767775441,1366514093,1370236046.6,50.33041117565659,38.01952876687925,NaN,NaN,-3.146571375000245,0.050934168444464745
2021-06-09T09:30:00-04:00,65.11,65.65,64.97,65.53,9380404,10464788.15,51.1510148788499,48.88006584986169,NaN,NaN,-2.4299946743737006,-24.524613284615615,-0.01743105857335702,-0.06988241089445069,-0.052451352321093665,1375894497,1372581796,53.55274373185777,38.924121253292476,NaN,NaN,-2.4029275814810203,-0.2996175101163188
2021-06-10T09:30:00-04:00,65.58,66.03,65.42,65.96,8327314,10142310.55,54.745496656473,49.07935734449372,NaN,NaN,80.28481607889071,0.4941781918210051,0.029781609557841912,-0.015224340373791279,-0.04500594993163319,1384221811,1374222239,55.716393637543675,40.15975216399214,NaN,NaN,-0.6905014366885962,-0.3554580710552156
2021-06-11T09:30:00-04:00,65.96,66.16,65.65,66.11,9099544,9891719.3,55.96282484966247,49.198789367680334,NaN,NaN,103.86065308425741,22.926947003556105,0.0677953543235941,0.03973824297285944,-0.028057111350734663,1393321355,1379129551.4,61.494863328532844,41.96632842714002,NaN,NaN,1.0804109935144506,-0.15033391897383475
2021-06-14T09:30:00-04:00,66.12,66.415,65.85,66.25,6866569,9762277.75,57.12213721338302,49.47137615787029,NaN,NaN,139.40403299224502,51.54530182745051,0.09725795285702452,0.09351532972054599,-0.0037426231364785303,1400187924,1384027936,66.23155177486757,44.228664628906266,NaN,NaN,2.888113798371214,0.2837300406468865
2021-06-15T09:30:00-04:00,66.33,66.81,66.14,66.45,16390527,9953703.65,58.79114442078703,50.301927331745844,NaN,NaN,163.9617972622785,97.01626094865959,0.12342376977674421,0.15053708908445174,0.027113319307707523,1416578451,1394040807.6,73.42738247286962,47.125247494589466,NaN,NaN,4.892489397300202,0.9421242344545031
2021-06-16T09:30:00-04:00,66.62,66.86,65.42,65.45,23138794,10622333.5,48.60401321037478,50.39898110241108,NaN,NaN,59.47082387219741,109.39642465797381,0.06928906817178826,0.11372465452244285,0.04443558635065459,1393439657,1397549839.6,75.40536975901391,49.88554545438702,NaN,NaN,3.714898782832749,1.338234884222824
2021-06-17T09:30:00-04:00,65.4,66.17,65.21,65.81,12854421,10609102.55,51.83935009347301,50.957858979661445,NaN,NaN,24.184312065989353,98.17632385539353,0.05429548673654709,0.11230494477133846,0.058009458034791364,1406294078,1401964293,77.65845043212376,52.936918799976866,NaN,NaN,3.70694597928797,1.676622183517845
2021-06-18T09:30:00-04:00,65.43,65.48,64,64.1,18039865,10869107.75,39.21254178335055,50.393565946936256,NaN,NaN,-161.54990816625596,45.094211605290866,-0.06760552505096676,-0.02649744827891709,0.04110807677204967,1388254213,1400950864.6,75.93856449643698,55.99758265514135,NaN,NaN,-0.8862115972372459,1.3105030719814035
2021-06-21T09:30:00-04:00,63.81,64.59,63.4501,64.43,13943310,11054076.35,42.141439313818275,50.25302926680626,NaN,NaN,-192.75131614933187,-21.336858223024514,-0.119781669717601,-0.10861901037495159,0.011162659342649414,1402197523,1401352784.4,76.16402725637866,59.21778702857949,NaN,NaN,-3.483087364843191,0.6257044381493186
2021-06-22T09:30:00-04:00,64.43,64.62,64.01,64.04,8304327,10985716.85,39.70650523158009,49.7184272372021,NaN,NaN,-161.5415350498334,-86.4375246854469,-0.17119617004167714,-0.20283255320944704,-0.031636383167769885,1393893196,1396815733.4,68.37521987140192,61.64468834364398,NaN,NaN,-6.39515618453393,-0.37727565080543113
2021-06-23T09:30:00-04:00,64,64,63.17,63.36,12833238,11116695.3,35.820216692223,48.66567532590292,NaN,NaN,-213.56811218091605,-141.0453118960696,-0.23755498518809925,-0.32858011465289394,-0.0910251294647947,1381059958,1394339793.6,64.49885901373517,63.48089371186409,NaN,NaN,-10.173558080696,-1.7767445693612267
2021-06-24T09:30:00-04:00,63.44,63.46,63.02,63.3,7607881,11076048.6,35.490145080889576,47.65184197816363,NaN,NaN,-195.499508228548,-184.98207595497706,-0.26969358117232917,-0.4281421059302062,-0.15844852475787702,1373452077,1387771393.4,55.50828392343498,64.35295260323635,NaN,NaN,-13.22372991871837,-3.4120281906979613
2021-06-25T09:30:00-04:00,63.33,64.03,63.2599,63.98,9136818,11107976.15,42.011855656612845,47.025227825454195,NaN,NaN,-122.84989168714311,-177.2420726591545,-0.2308590909835367,-0.4470223884872979,-0.2161632975037612,1382588895,1386638329.8,54.107182022942176,64.88637877834255,NaN,NaN,-13.749703949222166,-4.888839013344276
2021-06-28T09:30:00-04:00,64.24,64.71,64.15,64.39,8367681,11037224.25,45.58394364585596,47.01304490909528,NaN,NaN,-54.942075873362846,-149.68022460396068,-0.16628040816974082,-0.4240138077159372,-0.2577333995461964,1390956576,1384390140.4,51.33822592969029,64.95836554648781,NaN,NaN,-13.044363017201901,-6.0539138710382225
2021-06-29T09:30:00-04:00,64.19,64.57,63.16,63.35,12344175,11103124.9,39.01819467861619,46.14641489479287,NaN,NaN,-103.61143926209729,-138.09420544641347,-0.18110771128111813,-0.48411803864759406,-0.30301032736647593,1378612401,1381333981.4,47.76011155565475,64.54460610533046,NaN,NaN,-14.622026706532484,-7.277929990394545
2021-06-30T09:30:00-04:00,63.3,63.54,62.99,63.23,9538828,11067773.05,38.332125560105354,44.97403124505233,NaN,NaN,-118.92754695889442,-119.16609240200914,-0.18580284447017714,-0.5352638829541974,-0.3494610384840202,1369073573,1378936704.4,45.10452516771558,63.786615500342734,NaN,NaN,-16.078116097120912,-8.535099434212597
2021-07-01T09:30:00-04:00,63.35,64.135,63.1,63.92,11496656,11049913.55,44.3873069106151,44.14720853512036,NaN,NaN,-76.01007310426249,-95.26820537715203,-0.13178541324565674,-0.5141928050410911,-0.38240739179543437,1380570229,1380360334.8,46.98956355707732,62.75052265952447,NaN,NaN,-15.362846760716927,-9.510491909427502
2021-07-02T09:30:00-04:00,64.09,64.09,63.695,64.02,9314768,11153911.8,45.22671386904573,43.29753543909628,NaN,NaN,-55.287457997239436,-81.7557186391713,-0.08115182314062797,-0.4838471707212193,-0.40269534758059133,1389884997,1381819555.2,48.925521492722766,61.514377639371276,NaN,NaN,-14.535826060400355,-10.22839678813791
2021-07-06T09:30:00-04:00,64.01,64.33,63.28,64.29,9078315,11262267.15,47.52954410756409,42.493135416723206,NaN,NaN,-48.53222226179097,-80.47374791685691,-0.024259491285498425,-0.43301971168746434,-0.4087602204019659,1398963312,1383420902.4,51.03870274321448,59.915186230110194,NaN,NaN,-13.15956131946521,-10.647134578327524
2021-07-07T09:30:00-04:00,64.32,64.72,63.96,64.71,12099604,11408151.95,50.981931561715314,42.66298672753326,NaN,NaN,-11.145299769607455,-61.980520018358945,0.04320125046112355,-0.35475865732556144,-0.397959907786685,1411062916,1389911005.4,58.52796329240501,58.70965719678099,NaN,NaN,-10.949355144412381,-10.690308944911076
2021-07-08T09:30:00-04:00,64.35,64.91,64.25,64.52,10256477,11451955.6,49.39847120631068,42.488638235593086,NaN,NaN,-1.142547299522177,-38.42352008648449,0.07472242391038425,-0.30455687789870467,-0.3792793018090889,1400806439,1396257578.6,64.28169095486992,57.75417437697714,NaN,NaN,-9.570979591755133,-10.530404751603085
2021-07-09T09:30:00-04:00,64.61,64.78,64.07,64.6,10742140,11572696.9,50.10122286742922,43.266401170170134,NaN,NaN,-2.1787659612457815,-23.657258657881165,0.09912544192939998,-0.25537249939733897,-0.35449794132673895,1411548579,1402453248.6,68.82830440064224,57.246298655848946,NaN,NaN,-8.237748020635308,-10.20288236146483
2021-07-12T09:30:00-04:00,64.53,64.865,64.215,64.81,8661480,11550793.7,51.986251064846854,43.96960200952932,NaN,NaN,18.028362177914293,-8.994094622850415,0.1258580608608194,-0.19717536525071466,-0.32303342611153407,1420210059,1408518261,72.5163752108554,56.98575208116871,NaN,NaN,-6.583998017768149,-9.685898883793875
2021-07-13T09:30:00-04:00,64.7,64.91,64.09,64.32,11246587,11769794.6,47.479196860445995,44.52479426873403,NaN,NaN,9.32528798683577,2.577407426874929,0.10769023980279674,-0.18842062635803813,-0.2961108661608349,1408963472,1410518293,73.624599885278,57.36070779644558,NaN,NaN,-6.367814834475985,-9.211886876748462
2021-07-14T09:30:00-04:00,64.34,65.16,64.04,64.88,10360014,11468268.95,52.54304613297476,45.71928208593058,NaN,NaN,54.84906872190015,15.776281125176457,0.12909517919474972,-0.13474189216739774,-0.26383707136214746,1419323486,1412170407,74.53794519649972,58.077785380928766,NaN,NaN,-4.694620973650492,-8.566563176305895
2021-07-15T09:30:00-04:00,64.66,65.66,64.64,65.61,14287266,11025692.55,58.20071793391091,47.34146586114639,NaN,NaN,145.6116416552966,45.12711891614022,0.1847362447144182,-0.0329167654691247,-0.2176530101835429,1433610752,1418731269.6,77.82235268975842,59.67164743566615,NaN,NaN,-1.4360033276272344,-7.5479117693518
2021-07-16T09:30:00-04:00,65.68,66.61,65.61,66.27,16553278,11210635.4,62.548007587341736,48.808333856198466,NaN,NaN,248.9440452863065,95.35168116565066,0.2540307664926812,0.09988544793230858,-0.1541453185603726,1450164030,1426454359.8,80.93922486148945,61.58822192413381,NaN,NaN,2.802886585286971,-6.06922629011769
2021-07-19T09:30:00-04:00,66,66.525,64.48,65.22,22792935,11448288.9,53.08828320390259,49.34435811034465,NaN,NaN,133.06277869632584,118.35856446933299,0.21854328417685318,0.11903378666069386,-0.09950949751615931,1427371095,1427886567,81.45960641947367,63.739749101975484,NaN,NaN,3.4263491906903933,-4.7127155071451075
2021-07-20T09:30:00-04:00,65.28,66.16,65.28,65.5,16889571,11595601.95,55.04098189999189,50.48884291187149,NaN,NaN,139.53890256206566,144.40128738437895,0.20362017264898788,0.15501571829507554,-0.048604454353912335,1444260666,1434946005.8,83.80639463489551,66.31448360763554,NaN,NaN,4.560876982629986,-3.38791658003438
2021-07-21T09:30:00-04:00,65.54,65.69,64.73,64.78,11228405,11741805.85,49.35219657881735,51.27599084177949,NaN,NaN,69.08308536219432,147.24809071243777,0.13808694911924027,0.124004232045138,-0.014082717074102268,1433032261,1437687760.8,84.62060628916396,69.13706083059614,NaN,NaN,3.6362294558295516,-2.3844671463395324
2021-07-22T09:30:00-04:00,64.85,65.17,64.665,64.88,11437761,11672032,50.123248666759665,51.68570096721838,NaN,NaN,46.44518844349432,127.41480007007733,0.09628340397480228,0.10627153789440058,0.009988133919598303,1444470022,1439859614.8,85.25313484721855,71.87017306560622,NaN,NaN,3.1474357579814387,-1.5941953028651081
2021-07-23T09:30:00-04:00,65.04,65.77,64.92,65.71,8108552,11697065.55,56.09739878329083,52.462178461093025,NaN,NaN,98.15054689760333,97.2561003923367,0.11791201766865855,0.1573781560054215,0.03946613833676294,1452578574,1440342523.6,85.39694968009992,74.47527507899031,NaN,NaN,4.659817285965563,-0.7007649330321553
2021-07-26T09:30:00-04:00,65.58,65.93,65.27,65.73,8968380,11688643.65,56.23343577337771,53.083885008651144,NaN,NaN,104.54532955701664,91.55261056447486,0.12620381893608545,0.19722091200686975,0.0710170930707843,1461546954,1447177695.4,87.2868016719689,77.06442500247276,NaN,NaN,5.889991208186066,0.2407716585704477
2021-07-27T09:30:00-04:00,65.68,66.975,65.3,66.86,17143089,12127414.05,63.176147257685834,53.95490041550619,NaN,NaN,154.19110177551522,94.48305040716477,0.1962516574334657,0.31633166486261644,0.12008000742915073,1478690043,1454063570.8,88.85201960680757,79.23042902493009,NaN,NaN,9.324776675838981,1.538486661037381
2021-07-28T09:30:00-04:00,66.83,66.95,65.86,66.35,12474075,12133909.05,58.65384519204341,54.61599855734424,NaN,NaN,136.55463002987022,107.97735934069996,0.19622669432484485,0.3653633753352068,0.16913668101036194,1466215968,1460700312.2,90.11520753915163,81.07568020952165,NaN,NaN,10.690544846433134,2.8459235446653457
2021-07-29T09:30:00-04:00,66.47,66.72,66.145,66.53,15123853,12413160.3,59.74898675090189,55.30512454902087,NaN,NaN,129.72066075530566,124.63245380306223,0.19586971301799486,0.4139738222828555,0.21810410926486065,1481339821,1468074272,91.29539595110512,82.68047246312612,NaN,NaN,12.1240280801131,4.1713670497293105
2021-07-30T09:30:00-04:00,66.49,67.045,65.82,65.97,12632551,12469955.05,54.878858396050965,55.51173935839258,NaN,NaN,101.3733428594108,125.27701299542373,0.14765184476533189,0.4026689152215255,0.2550170704561936,1468707270,1471300011.2,91.75892891130292,84.05494058458667,NaN,NaN,11.817099206964055,5.263614500762845
2021-08-02T09:30:00-04:00,66.12,66.72,66.04,66.48,11782054,12593319.35,58.2189333887221,56.278863396126596,NaN,NaN,104.3552104816205,125.23898918034449,0.13991173198832935,0.4299067354416053,0.28999500345327595,1480489324,1475088485.2,92.2789575736284,85.38739470518313,NaN,NaN,12.599255321415658,6.311563189427533
2021-08-03T09:30:00-04:00,66.58,67.17,66.27,66.86,12997273,12789267.25,60.561513657145404,56.8516110764245,NaN,NaN,125.61281229564463,119.52333128437037,0.1493328582259964,0.4766610762357715,0.3273282180097751,1493486597,1478047796,92.66815320232166,86.68240956274182,NaN,NaN,13.970595280405856,7.4057106309958645
2021-08-04T09:30:00-04:00,66.59,66.84,65.93,66.76,16188992,12993736.65,59.614260189701824,56.95257838040957,NaN,NaN,90.503427852826,110.31309084896152,0.1380436071812654,0.49988272698635683,0.3618391198050914,1477297605,1480264123.4,92.95458841335204,87.76328354299854,NaN,NaN,14.80269996614899,8.462423393160597
2021-08-05T09:30:00-04:00,66.85,67.58,66.675,67.49,15895396,13275682.6,64.03646995974856,57.05889712129577,NaN,NaN,142.45570031816806,112.860098761534,0.1670193257415168,0.5706132769819874,0.4035939512404706,1493193001,1482634759.4,93.25799014052393,88.64319534864384,NaN,NaN,16.894158626495116,9.666956997922671
2021-08-06T09:30:00-04:00,67.42,67.94,67.26,67.45,10000468,13238599,63.62535495335423,57.81154510339946,NaN,NaN,149.92942574845782,122.57131533934341,0.17019312017353883,0.6163353514573942,0.44614223128385533,1483192533,1485531812,93.61959646298331,89.51176606603738,NaN,NaN,18.459834800558138,10.923082398299167
2021-08-09T09:30:00-04:00,67.5,67.68,67.06,67.43,8432664,13227158.2,63.40616425746135,58.40905812893299,NaN,NaN,123.30058880746108,126.36039100451153,0.15791684160871206,0.6435382832947454,0.48562144168603333,1474759869,1484385921,91.52849754806448,90.06334484554945,NaN,NaN,19.68042083010273,12.174130745699676
2021-08-10T09:30:00-04:00,67.49,67.73,67.19,67.5,7917174,13060687.55,63.87524705937408,59.44641887754419,NaN,NaN,123.01290443239283,125.84040943186116,0.14198396473332364,0.6631013976026878,0.5211174328693642,1482677043,1482224010.2,87.55504410271033,90.27294754651705,NaN,NaN,20.826274847203184,13.410151331628748
2021-08-11T09:30:00-04:00,67.65,68.44,67.65,68.13,9244446,13004909.15,67.86746104536581,60.71386261887319,NaN,NaN,164.9236289808548,140.72444965746692,0.16000871217247226,0.7211283230849546,0.5611196109124823,1491921489,1485148787,88.29534785120505,90.49024847537324,NaN,NaN,22.999586441970564,14.78007063310615
2021-08-12T09:30:00-04:00,68.01,68.435,67.976,68.2,9460128,12763552.25,68.28682473805165,61.584535901356105,NaN,NaN,155.1695816309475,143.2672259200228,0.16226996965885032,0.7639570729860452,0.6016871033271949,1501381617,1486786510.2,88.70067125972834,90.72622858820384,NaN,NaN,24.921708914009365,16.22887610180661
2021-08-13T09:30:00-04:00,68.34,68.76,68.2,68.68,11790722,12525424.45,71.0745723609144,62.64461708618016,NaN,NaN,152.95484052620938,143.8723088755731,0.18032783425894583,0.8270968961508771,0.6467690618919313,1513172339,1492782471.4,90.05809593285996,90.92417817826747,NaN,NaN,27.426103233580683,17.828479977774332
2021-08-16T09:30:00-04:00,68.68,69.59,68.61,69.1,12898406,12030698,73.28728253903571,63.36684103484801,NaN,NaN,165.19316598914358,152.25082431190964,0.20310001962534385,0.9006440864236112,0.6975440667982673,1526070745,1503044646.6,91.86041151620796,91.13906331465321,NaN,NaN,30.260605347157043,19.604497887686147
2021-08-17T09:30:00-04:00,68.91,69.15,68.4524,69.14,11518743,11762156.6,73.49523501101129,64.42694030763143,NaN,NaN,131.03908562694127,153.85606055081934,0.20291967605195804,0.9511936618632149,0.7482739858112568,1537589488,1514027135.6,93.26713091145128,91.36420069838891,NaN,NaN,32.65679519327302,21.469111788484273
2021-08-18T09:30:00-04:00,69.13,69.28,68.56,68.79,15705801,11986026.4,68.47234191485391,65.05003710505657,NaN,NaN,115.53906754573394,143.97914826379514,0.16301120203458697,0.9520379883544905,0.7890267863199035,1521883687,1520019575.2,93.88783897288037,91.54937519994428,NaN,NaN,33.375012646897225,23.16995476825755
2021-08-19T09:30:00-04:00,68.82,69.63,68.7464,69.07,13861522,12107214.45,70.22547263034795,66.14622383607778,NaN,NaN,122.18680027090564,137.3825919917868,0.14012756637224988,0.9641862442852158,0.8240586779129659,1535745209,1526892293.6,94.5126638969544,91.74607055606225,NaN,NaN,34.47850653167271,24.785462163031145
2021-08-20T09:30:00-04:00,68.95,69.98,68.59,69.93,11790774,12291325.55,74.8510643754043,67.33423319226937,NaN,NaN,130.14148039783487,132.81991996611185,0.1658092335053366,1.0313202197946367,0.8655109862893001,1547535983,1533765022.4,95.05685591553758,91.94449186619862,NaN,NaN,36.92462704602821,26.519628574887868
2021-08-23T09:30:00-04:00,69.88,69.9,68.9,69.03,10915365,12388674.8,63.69837693799328,67.55829485518707,NaN,NaN,102.26894874227726,120.2350765167386,0.10788741503427657,1.0003702550821458,0.8924828400478693,1536620618,1535874997,95.21378922380615,92.12632301059037,NaN,NaN,35.48154168794075,27.799901876752564
2021-08-24T09:30:00-04:00,69,69.06,68.12,68.58,12665778,12164809.25,58.96742635547306,67.51209243845645,NaN,NaN,50.73053902998508,104.17336719734737,0.029072960366425704,0.9288240405059014,0.8997510801394757,1523954840,1533148067.4,91.18462597732305,91.9998971223026,NaN,NaN,32.721194303207476,28.502943651960408
2021-08-25T09:30:00-04:00,68.57,68.93,68.18,68.71,8164906,11949350.8,59.89413550145401,67.21621140572111,NaN,NaN,46.71356984914182,90.40826765802896,-0.021757028106840437,0.8725547950059251,0.8943118231127656,1532119746,1535195279.2,91.47624737376864,91.87262978182007,NaN,NaN,30.79815924506982,28.83083159383318
2021-08-26T09:30:00-04:00,68.71,68.74,68.39,68.54,8315886,11608952.45,58.04788204004993,66.81782048334223,NaN,NaN,38.40446086264578,73.65179977637698,-0.07147801380745589,0.8049643058534457,0.8764423196609016,1523803860,1532807009.4,87.82612312204515,91.45881025746735,NaN,NaN,28.66688029084917,28.80740997912118
2021-08-27T09:30:00-04:00,68.61,68.835,68.3929,68.52,10502540,11502451.9,57.82205999327243,66.41895589304303,NaN,NaN,35.12020425558698,54.64754454792741,-0.10816187940002231,0.7412399704108736,0.849401849810896,1513301320,1525960076.8,78.19305091144649,90.50627835485179,NaN,NaN,26.87446406033407,28.531274847865877
2021-08-30T09:30:00-04:00,68.5,68.82,68.27,68.62,11845893,11505643.85,58.687459320148974,66.04839962595551,NaN,NaN,28.278999459179303,39.84955469130781,-0.1268466593681128,0.690843525600755,0.8176901849688678,1525147213,1523665395.8,75.21549864983233,89.6248822510748,NaN,NaN,25.610332128471434,28.113997316523815
2021-08-31T09:30:00-04:00,68.59,68.9265,68.2536,68.54,11290081,11420284.25,57.66806724070682,65.3198714970513,NaN,NaN,22.832611711220963,34.26996922755499,-0.14446854441798695,0.6371045044463841,0.7815730488643711,1513857132,1521645854.2,72.5954124568403,88.50345829433445,NaN,NaN,24.273783235785938,27.56539530498983
2021-09-01T09:30:00-04:00,68.73,69.67,68.64,69.44,13333732,11277521.25,65.02771684790353,65.08707807632643,NaN,NaN,98.44537781974299,44.61633082167522,-0.09762987561470948,0.6595357043459842,0.7571655799606937,1527190864,1520660077.8,71.290001776529,87.2598390455345,NaN,NaN,25.156729119272597,27.221300135601656
2021-09-02T09:30:00-04:00,69.59,70.07,69.52,70.07,10299702,10997736.55,69.08009458340294,64.94461537793276,NaN,NaN,170.9955469696493,71.13454804307594,-0.029852191876371448,0.7198503401152294,0.7497025319916009,1537490566,1523397419,72.75507330637603,86.02390885792852,NaN,NaN,27.21849406883686,27.22089926892097
2021-09-03T09:30:00-04:00,69.86,69.96,69.3201,69.49,9472721,10971349.2,61.96170986715399,64.13564590136978,NaN,NaN,115.6935525514839,87.24921770225532,-0.029654691447352888,0.7126341676824097,0.7422888591297626,1528017845,1526340724,74.2751633239152,84.76781970133617,NaN,NaN,26.718588829396854,27.14914063470324
2021-09-07T09:30:00-04:00,69.43,69.44,68.45,68.57,13145232,11206977.6,52.68743241132597,62.64937428710654,NaN,NaN,2.0491607133398837,82.00324995308743,-0.09345591062740755,0.6254689708455032,0.7189248814729108,1514872613,1524285804,71.2847935541056,83.19765274724004,NaN,NaN,23.06634441417032,26.565884031769965
2021-09-08T09:30:00-04:00,68.53,69.99,68.37,69.8,14588135,11540525.65,61.07581429950437,62.12105088601015,NaN,NaN,82.12135358432859,93.86099832770893,-0.056604739928771686,0.6481689565619462,0.7047736964907179,1529460748,1527406527.2,73.05875414369724,81.70986097372699,NaN,NaN,22.897613369758048,26.041845365768264
2021-09-09T09:30:00-04:00,69.58,69.825,69.365,69.42,8177517,11487179.2,57.67374616730171,61.22449899579256,NaN,NaN,96.03109090761832,93.378140945284,-0.061215825570877014,0.6282539145271215,0.6894697400979986,1521283231,1526225000.6,71.26371702959405,80.04922191177268,NaN,NaN,21.55104176047066,25.400301993582893
2021-09-10T09:30:00-04:00,69.37,69.45,68.43,68.45,12327205,11630533.05,50.01516579022397,59.450506239708254,NaN,NaN,-41.72251680544743,50.834528190264656,-0.1290858279044249,0.5281124552174674,0.6571982831218923,1508956026,1520518092.6,63.18805377869097,77.77287890199793,NaN,NaN,17.579861281390443,24.2830961775554
2021-09-13T09:30:00-04:00,69.03,69.11,68.13,68.33,13118235,11696908.7,49.14570524391573,58.41102969013128,NaN,NaN,-87.69225871788407,10.15736593639106,-0.17850820906091303,0.43406302179575107,0.6125712308566641,1495837791,1514082081.8,55.54363292959623,74.93929630955436,NaN,NaN,14.263196746584617,22.851681973131
2021-09-14T09:30:00-04:00,68.55,68.77,67.93,68.1,14051785,11754577.65,47.44333261357947,57.58788013713889,NaN,NaN,-119.25801067765786,-14.104068341808494,-0.22039026246961102,0.3370834027696503,0.5574736652392613,1481786006,1507464760.4,48.98220865523131,71.92483792940496,NaN,NaN,11.076103581951397,21.169456488676772
2021-09-15T09:30:00-04:00,68,68.455,67.63,68.01,9906403,11673960.65,46.76075827233816,56.64978176363061,NaN,NaN,-139.35634281877915,-58.39960762243004,-0.24591387115689578,0.2500813262931416,0.4959951974500374,1471879603,1495948531.4,40.10334839336755,68.2553451450906,NaN,NaN,8.335137054342688,19.3359822837719
2021-09-16T09:30:00-04:00,68,68.28,67.34,67.44,15732054,11675273.3,42.58225754161846,55.545094299456935,NaN,NaN,-165.66704623951478,-110.73923505185667,-0.28991832504223825,0.13359729114723962,0.42351561618947786,1456147549,1482921395,32.849465828664464,64.32844105270625,NaN,NaN,4.663971269723391,17.2399807103364
2021-09-17T09:30:00-04:00,67.3,67.66,66.34,66.4,12554274,11609910.9,36.22225127773251,54.00225081977551,NaN,NaN,-241.34584558609512,-150.66390080798618,-0.3725329479647496,-0.04215056876645917,0.33038237919829044,1443593275,1469848844.8,27.478225242053,60.705953504892435,NaN,NaN,-0.7999519957015079,14.6628474666167
2021-09-20T09:30:00-04:00,65.76,66.355,65.06,65.78,22839313,12162337.85,33.05282616829638,52.17120559464319,NaN,NaN,-299.78604439724086,-193.08265794385755,-0.44736438504120857,-0.22882310210322032,0.21854128293798827,1420753962,1454832079,22.855148400483387,56.96592848708179,NaN,NaN,-6.435893895230903,11.648741557781328
2021-09-21T09:30:00-04:00,65.97,66.42,65.56,65.6,13208782,12277008.7,32.17267409986057,50.35010608458274,NaN,NaN,-212.48118976351796,-211.72729376102956,-0.4842952784243014,-0.3868278150923885,0.09746746333191292,1407545180,1439983913.8,19.382686625329896,53.16501949911676,NaN,NaN,-11.189958930390267,8.3860700594711
2021-09-22T09:30:00-04:00,65.84,66.09,65.31,65.56,12394050,12263422.3,31.968946621171526,47.98876535410188,NaN,NaN,-178.43737545552716,-219.54350028837916,-0.48549658698251763,-0.5094032703962341,-0.02390668341371649,1395151130,1424638219.2,16.57910638751342,49.25709839990137,NaN,NaN,-15.031177417150039,5.040748991382366
2021-09-23T09:30:00-04:00,65.56,66.05,65.15,65.21,9666588,12338506.4,30.168779098637202,45.209385676618616,NaN,NaN,-153.7052316164853,-217.15113736377324,-0.4829172402457832,-0.6275532337209455,-0.14463599347516232,1385484542,1410505617.8,14.499118283030697,45.095958755376714,NaN,NaN,-18.813448599110806,1.6330064784547704
2021-09-24T09:30:00-04:00,65.2,65.63,64.98,65.14,11830347,12514229.45,29.807268154502466,42.91263984000066,NaN,NaN,-137.22025009791778,-196.32601826613782,-0.45913385368816106,-0.7185533105853636,-0.2594194568972026,1373654195,1396517801.8,12.788921314825416,40.704084326156014,NaN,NaN,-22.00870665086453,-1.7443811114479866
2021-09-27T09:30:00-04:00,65.03,65.69,64.275,64.37,10891686,12533686.75,26.102035679538346,41.01368293058725,NaN,NaN,-134.91053789696522,-163.3509169660827,-0.46693285593143197,-0.8430855268114925,-0.37615267088006055,1362762509,1384919511.2,11.570276777921237,36.43876169928569,NaN,NaN,-26.039751409480672,-5.215148296881227
2021-09-28T09:30:00-04:00,64.31,64.41,63.37,63.56,20235837,12953183.95,22.880013402585703,38.2854114379502,NaN,NaN,-149.26149706549862,-150.70697842647883,-0.495606723160972,-0.9956610748312755,-0.5000543516703035,1342526672,1371915809.6,10.376429526587728,31.961452798063586,NaN,NaN,-30.66917663273444,-8.851438059145972
2021-09-29T09:30:00-04:00,63.75,64.84,63.58,64.39,15433849,13160372.35,32.12566463153209,36.46054847110951,NaN,NaN,-112.1782105930863,-137.45514545399067,-0.4300708632150734,-1.0376429306891453,-0.6075720674740719,1357960521,1364477687.8,9.756315136154186,27.56806694853217,NaN,NaN,-31.68730554295348,-12.113704842547044
2021-09-30T09:30:00-04:00,64.63,64.67,63.79,63.88,13572380,13172304.75,29.764401014448794,35.01406527283985,NaN,NaN,-104.97754580290788,-127.70960829127519,-0.39345712051658244,-1.0993934681197999,-0.7059363476032174,1344388141,1356258407.6,9.108535058986305,23.705244182838975,NaN,NaN,-33.29246683142401,-15.139242269529467
2021-10-01T09:30:00-04:00,64.27,64.39,63.66,63.88,14500638,13382351.55,29.764401014448794,33.6296863993065,NaN,NaN,-99.93762455700721,-120.25308318309305,-0.34344677657497535,-1.1352448183219366,-0.7917980417469612,1344388141,1350405196.8,8.667202688825938,20.356927737069665,NaN,NaN,-34.55082286461678,-17.912325211684795
2021-10-04T09:30:00-04:00,63.81,64.945,63.78,64.76,20201307,13918780.85,38.77046771162412,33.01019604916683,NaN,NaN,-74.08524326497792,-108.0880242566956,-0.2307189985415763,-1.0801967899239315,-0.8494777913823552,1364589448,1350770584.6,8.963737870532412,17.4984655381626,NaN,NaN,-32.773697551734394,-20.03537840312045
2021-10-05T09:30:00-04:00,64.84,65.07,64.52,64.6,13065220,13914780.25,37.82088766581426,32.37163386298655,NaN,NaN,-59.9718319085522,-90.23009122530631,-0.15043503935942248,-1.0375215905816333,-0.8870865512222108,1351524228,1352570095.8,10.504849734299569,15.384287062514886,NaN,NaN,-31.62920970651696,-21.69164001789138
2021-10-06T09:30:00-04:00,64.4,65.6464,64.015,65.6,16576393,14014193.15,46.620607882755735,32.66008745878207,NaN,NaN,-41.45991375372219,-76.0864318574335,-0.020323493182218266,-0.9124909176999836,-0.8921674245177653,1368100621,1354598115.8,12.30657732840173,13.91693788392469,NaN,NaN,-27.690248030111515,-22.548584019637115
2021-10-07T09:30:00-04:00,65.72,66.24,65.175,65.25,13770128,14293823.7,44.259666465494284,33.234188543622196,NaN,NaN,-14.647075488145562,-58.02033779448102,0.048090832151103546,-0.8320538843288858,-0.8801447164799894,1354330493,1356586586.2,14.131955206024259,12.963632881351208,NaN,NaN,-25.210268819777284,-22.928824705371426
2021-10-08T09:30:00-04:00,65.24,65.37,64.725,64.77,8898224,14122374.65,41.179684521373886,33.81467842598487,NaN,NaN,-40.87072281767055,-46.206957446613686,0.06584223771943676,-0.7978419193306934,-0.8636841570501301,1345432269,1356795411.8,14.333627125517737,12.354952790282232,NaN,NaN,-24.09058198771014,-23.094790031419812
2021-10-11T09:30:00-04:00,64.5,64.63,63.8,63.89,12710055,14101965.65,36.205310584311015,34.10272388915991,NaN,NaN,-86.59940632621553,-48.7097900588612,0.025231415364896592,-0.8321448878440094,-0.857376303208906,1332722214,1350421965,13.306436748545735,11.92093494194051,NaN,NaN,-24.727933357187954,-23.32809622081526
2021-10-12T09:30:00-04:00,63.98,64.505,63.81,64.32,10498046,13924278.7,40.01812707457213,34.67766535011709,NaN,NaN,-75.26483223585713,-51.76839012432218,0.033712797728296495,-0.8152353060485353,-0.8489481037768318,1343220260,1348761171.4,13.04411432442592,11.668435508862833,NaN,NaN,-24.021603279642616,-23.4271686577906
2021-10-13T09:30:00-04:00,64.34,65.12,64,65.07,13103679,14084142.5,46.07224916146492,35.81362749746193,NaN,NaN,-29.37379672844242,-49.35116671926623,0.09286442899278691,-0.7328675675358483,-0.8257319965286352,1356323939,1346405835,12.662849232458285,11.537273433821946,NaN,NaN,-21.42014043382369,-23.140450340081042
2021-10-14T09:30:00-04:00,65.29,66,65.13,65.87,10699069,13832493.25,51.67517471204016,37.37562082300034,NaN,NaN,73.22317671460661,-31.777116278715805,0.18365359074096277,-0.5961650081024317,-0.7798185988433944,1367023008,1348944338,15.528556234899185,11.732961642398648,NaN,NaN,-17.31067457638034,-22.307625230980943
2021-10-15T09:30:00-04:00,65.97,66.2,65.57,65.68,14801270,13944843.05,50.337524101557165,39.10672713885883,NaN,NaN,101.7743958336862,-3.2480925484444585,0.22591515493259307,-0.4974246551776531,-0.7233398101102462,1352221738,1350302231.8,17.095607180875874,12.12762809975255,NaN,NaN,-14.47111615613098,-21.188123934573806
2021-10-18T09:30:00-04:00,65.24,65.41,64.7,65.05,10351028,13320428.8,46.07831501948997,40.76374868292341,NaN,NaN,20.92599662753488,18.256988042305625,0.2069504616669402,-0.4646517330265709,-0.6716021946935111,1341870710,1352131931,19.268872711182155,12.762802612937865,NaN,NaN,-13.409480716339381,-20.076889189111746
2021-10-19T09:30:00-04:00,65.55,65.96,65.37,65.87,10706827,13195331.05,51.795505107549225,42.16873728835321,NaN,NaN,103.99037804004887,54.108030097486825,0.2426684275071167,-0.3682666603096152,-0.6109350878167319,1352577537,1354003386.4,21.534550680008934,13.604105151784633,NaN,NaN,-10.616917149013135,-18.725464611954802
2021-10-20T09:30:00-04:00,66.14,67.17,66.07,66.91,13899912,13270624.15,57.89332135773767,44.17794588430242,NaN,NaN,197.2560114192212,99.43399172701955,0.3242748255120238,-0.20559155592670209,-0.5298663814387259,1366477449,1356034088.4,24.02611941738573,14.669646891670302,NaN,NaN,-6.092514044895992,-16.920757388089257
2021-10-21T09:30:00-04:00,66.95,67.18,66.82,66.91,8686365,13221613,57.89332135773767,46.18715448025163,NaN,NaN,191.72604300267562,123.13456498463336,0.36325580326775064,-0.07579662735403758,-0.4390524306217882,1366477449,1355924976.6,23.98205469855479,15.76356489236522,NaN,NaN,-2.6031732928270093,-14.875388231623221
2021-10-22T09:30:00-04:00,67.09,67.37,66.94,67.25,10699990,13165095.15,59.820433501356995,47.690723465232544,NaN,NaN,174.85461966865708,137.75060975162754,0.39434661837922463,0.05388084235224255,-0.3404657760269821,1377177439,1360916116.8,30.281045446920388,17.286229719250077,NaN,NaN,0.8635532045136652,-12.626968026460808
2021-10-25T09:30:00-04:00,67.15,67.37,66.795,66.96,7580258,12999523.75,57.407057160540646,49.08973557199871,NaN,NaN,135.56806722357612,160.67902387083578,0.37775827658329664,0.1317320697021387,-0.24602620688115792,1369597181,1366461411,36.56974448272331,19.14800791556606,NaN,NaN,3.013446994369237,-10.392623023485088
2021-10-26T09:30:00-04:00,67.02,67.84,66.91,67.32,9695696,12472516.7,59.58671743308933,50.0158862541654,NaN,NaN,137.4457793629505,167.3701041354161,0.37277564518097095,0.2199433495950558,-0.15283229558591516,1379292877,1371804479,41.998496326773655,21.268859272592625,NaN,NaN,5.465513122060018,-8.12717500269293
2021-10-27T09:30:00-04:00,67.48,67.65,66.8,66.87,11131983,12257423.4,55.746436727169716,50.836369844285066,NaN,NaN,106.7296841002874,149.26483867162932,0.3227865071924656,0.25065083840466684,-0.07213566878779876,1368160894,1372141168,42.333423671794904,23.283249877290526,NaN,NaN,6.43578984030469,-6.04675145369327
2021-10-28T09:30:00-04:00,66.81,67.315,66.73,67.31,7721836,11964896.2,58.55879551274688,52.07773491509743,NaN,NaN,96.61136791305914,130.24190365370606,0.30327070106798504,0.3069527075471825,0.0036820064791975027,1375882730,1374022224.2,44.2696695188607,25.421538619672166,NaN,NaN,8.088985144785227,-4.027360511053486
2021-10-29T09:30:00-04:00,67.29,67.57,66.58,66.91,13333570,11906542.8,55.128803979568985,53.42941301475871,NaN,NaN,80.31701658196098,111.33438303636683,0.24957998691479416,0.3156569901226902,0.06607700320789606,1362549160,1371096568.4,41.9125245417632,27.464830604901984,NaN,NaN,8.493231339975166,-2.238704532335107
2021-11-01T09:30:00-04:00,66.89,67.32,66.68,67.15,8091403,11301047.6,56.76513423861071,54.62562781219004,NaN,NaN,73.20301316394428,98.86137222444046,0.2175581200110955,0.33802465322176545,0.12046653321066994,1370640563,1371305244.8,42.1491299668899,29.543760293649417,NaN,NaN,9.296256441189552,-0.5908529646887273
2021-11-02T09:30:00-04:00,67.4,67.53,66.73,67.21,9932623,11144417.75,57.185491899418466,55.41943086490101,NaN,NaN,72.34342360049877,85.84090107195011,0.1888134674945866,0.3564833675789032,0.1676699000843166,1380573186,1371561306.6,42.458855375582175,31.67204644672969,NaN,NaN,10.073332166461572,0.9326020540470297
2021-11-03T09:30:00-04:00,67.1,67.365,66.415,66.96,10484797,10839837.95,54.794936981213624,55.64227102698482,NaN,NaN,50.70322825587481,74.63560990306759,0.1434159317800577,0.34693981480938874,0.20352388302933103,1370088389,1371946805.6,42.95402623968137,33.63100858992842,NaN,NaN,10.092241189829485,2.24112193058738
2021-11-04T09:30:00-04:00,66.86,67,65.9,66.59,16091550,10955909.05,51.37209729210659,55.71616911202407,NaN,NaN,19.413610603718354,59.19605844119942,0.0819755117582894,0.3059932727271928,0.22401776096890338,1353996839,1367569627.4,38.864394973710795,35.185922003702345,NaN,NaN,9.167937505251968,3.2306670126823214
2021-11-05T09:30:00-04:00,66.81,67.51,66.74,67.22,10792226,11050609.15,56.36965980635726,56.45126516822887,NaN,NaN,61.24056144902033,55.380767414611284,0.07733135604248847,0.320681956022014,0.24335059997952552,1364789065,1368017608.4,39.499273900234975,36.630950660063256,NaN,NaN,9.74941076162888,4.161916119674687
2021-11-08T09:30:00-05:00,67.3,67.31,65.9,66.22,9835117,10906862.25,47.946521447556606,56.176337763943685,NaN,NaN,2.472655988950803,41.23469597961259,0.004330406958180488,0.2487636086772511,0.24443320171907063,1354953948,1364880285.4,36.63033126028061,37.709220701511235,NaN,NaN,7.6552981217107074,4.660970691394119
2021-11-09T09:30:00-05:00,66.34,66.745,66.13,66.56,8244712,10794195.55,50.646793345279804,55.6587286201967,NaN,NaN,-9.25262326111334,24.91548660729017,-0.02218262589673964,0.21670491934814606,0.2388875452448857,1363198660,1361405380.2,33.709827967650384,38.400914169387285,NaN,NaN,6.733048992439344,4.956981877257722
2021-11-10T09:30:00-05:00,66.61,67.155,66.57,67.1,12916571,10784840.15,54.66889949540543,55.428412772887256,NaN,NaN,35.92947754129217,21.960736464373664,-0.005353985031689434,0.2321950639552739,0.23754904898696333,1376115231,1362610748.6,35.62709020694638,39.23270241998667,NaN,NaN,7.177997116710479,5.274269768608116
2021-11-11T09:30:00-05:00,67.06,67.09,66.3436,66.69,7873715,10643572.45,51.253537227402376,54.816491610461924,NaN,NaN,-2.627807221428219,17.552452899344352,-0.022856385720763178,0.20897856683600935,0.23183495255677253,1368241516,1365459684,40.04110208645809,39.9298493228108,NaN,NaN,6.503882340688739,5.449928707476777
2021-11-12T09:30:00-05:00,66.67,66.83,66.36,66.65,9089539,10357985.9,50.91931157014808,54.353081211148165,NaN,NaN,-26.272526704639166,0.04983526861244982,-0.03729468344871972,0.1852165982458729,0.2225112816945926,1359151977,1364332266.4,38.9042237185091,40.096597839652645,NaN,NaN,5.8635990058183,5.509024464382708
2021-11-15T09:30:00-05:00,66.94,67.56,66.8,67.53,9501863,10315527.65,57.48742596507717,54.20313182057588,NaN,NaN,95.9903165122363,18.75336737326955,0.00974167146262156,0.23468837102286955,0.224946699560248,1368653840,1367072244.8,43.13028730279156,40.17744005222535,NaN,NaN,7.3056640351955915,5.76568726021312
2021-11-16T09:30:00-05:00,67.56,67.69,67.165,67.21,6606697,10110521.15,54.62475424259809,54.123011643106466,NaN,NaN,114.12258210402636,43.42840844629749,0.016240024417016524,0.24524673008151865,0.22900670566450212,1362047143,1366841941.4,42.861917080885306,40.2151895814461,NaN,NaN,7.636385352748598,6.032929844861045
2021-11-17T09:30:00-05:00,67.05,67.37,66.71,67.27,9500942,9890572.65,55.0764630745228,53.87427361180475,NaN,NaN,41.53738334551214,44.549989607141484,0.021202986646540606,0.2555104389726779,0.23430745232613728,1371548085,1365928512.2,41.75225403086572,40.03537418944645,NaN,NaN,8.034354407922592,6.318847639584123
2021-11-18T09:30:00-05:00,67.16,67.29,66.695,66.92,7652841,9838896.45,51.83483777722577,53.63899031163738,NaN,NaN,-2.861915567497257,44.50316793792767,-0.0012701390265096868,0.2327197785430002,0.23398991756950988,1363895244,1365059257.8,40.673099853096645,39.946843854541704,NaN,NaN,7.4414102659457315,6.4792137290643534
2021-11-19T09:30:00-05:00,67.01,67.45,66.83,67.3,10303126,9819053.25,54.936015092752015,53.50833894407605,NaN,NaN,64.31807807233287,62.62128889332208,0.006828194801954318,0.24252516107195277,0.23569696626999845,1374198370,1368068536.4,45.887467102895904,40.21386793568498,NaN,NaN,7.822372441730464,6.671093545159512
2021-11-22T09:30:00-05:00,67.25,68.07,67.07,67.71,11577006,10018890.65,58.07273034912166,53.57171311905485,NaN,NaN,165.25361709970807,76.47394901081643,0.03556256621461645,0.28015017403826903,0.24458760782365258,1385775376,1371492843.6,51.14906707133212,40.83459734252426,NaN,NaN,9.065012522522325,7.013081970497057
2021-11-23T09:30:00-05:00,67.7,68.18,67.37,67.78,9520349,10010123.3,58.602537832235626,53.84368460841357,NaN,NaN,189.3794811282019,91.52532881565153,0.05394584298783889,0.3120199115584512,0.2580740685706123,1395295725,1378142560,59.40407497246139,42.00960082343712,NaN,NaN,10.23575857973484,7.473464343245311
2021-11-24T09:30:00-05:00,67.75,67.9575,67.4,67.82,7965786,9851813.45,58.92196934325629,54.38296118349569,NaN,NaN,152.0958174876087,113.63701564407086,0.06284008902689109,0.3366241798542262,0.2737840908273351,1403261511,1384485245.2,65.4084683834231,43.90560606698801,NaN,NaN,11.293943191645669,8.019247035873933
2021-11-26T09:30:00-05:00,67.34,67.78,66.591,66.76,10927274,10012085.35,48.2884332428146,53.80573071467121,NaN,NaN,-2.654147954654017,113.6785691666395,-0.0050221121131479585,0.2675064506859002,0.27252856279904814,1392334237,1390173043.8,69.7318912910975,46.0650787377639,NaN,NaN,9.103582343081253,8.174152079760693
2021-11-29T09:30:00-05:00,67.28,67.935,66.74,67.75,11411138,9915963.75,56.23286110665889,54.39761211889281,NaN,NaN,85.67277487381995,117.94950852693691,0.013401338630778192,0.28928023608752085,0.27587889745674266,1403745375,1396082444.8,73.44537884083758,48.694724993517966,NaN,NaN,9.68522656042719,8.39001986271305
2021-11-30T09:30:00-05:00,67.43,67.44,65.71,65.77,24311478,10726967.5,42.251928434588514,53.79797891098629,NaN,NaN,-141.27719464356062,56.64334617828318,-0.10462782928661368,0.14509411084847557,0.24972194013508925,1379433897,1394814149,71.42012679157548,51.38831776665547,NaN,NaN,4.83025672485858,7.881482271590983
2021-12-01T09:30:00-05:00,66.21,67.48,65.85,65.89,23012358,11380954.25,43.17406092455428,52.976919013068354,NaN,NaN,-106.82560500867537,-2.5976710490922725,-0.16774000903415093,0.040046928842400575,0.2077869378765515,1402446255,1396244255,72.34611017008274,54.011104906879496,NaN,NaN,1.5423461363670687,6.975891395130423
2021-12-02T09:30:00-05:00,66.05,67.35,66.05,66.73,17525101,11732969.45,49.27956506900461,52.83592100175422,NaN,NaN,-49.34545829538859,-42.88592620569174,-0.14679180840576253,0.024297177369348333,0.17108898577511086,1419971356,1399586224,74.43096625448561,56.46752377602432,NaN,NaN,0.9886249589213792,6.120567618529131
2021-12-03T09:30:00-05:00,67.06,67.42,66.085,67.4,21385733,11997678.6,53.56505107434717,53.0249023949113,NaN,NaN,-8.984176073873526,-44.15193182953564,-0.0847687637948385,0.06512803103156273,0.14989679482640123,1441357089,1409390794.4,79.34973420461196,59.35648881074595,NaN,NaN,2.055888410280941,5.539899160207962
2021-12-06T09:30:00-05:00,67.84,69.14,67.81,68.43,23610955,12638615.05,59.26339951043854,53.15175764815139,NaN,NaN,214.7114998987973,-18.34418682454016,0.022915410919644996,0.17854105847595747,0.15562564755631247,1464968044,1421635328.2,83.59431461602232,62.24677647597672,NaN,NaN,5.028002154644059,5.466771016555976
2021-12-07T09:30:00-05:00,68.44,69.105,68.26,68.94,10894513,12691584.85,61.76535038785805,53.66180022995568,NaN,NaN,213.75006855837927,52.66126581584782,0.12033670095976898,0.3060465237560237,0.18570982279625473,1475862557,1440921060.2,87.83546149620211,65.45917250564221,NaN,NaN,8.264560261152875,5.866455194355533
2021-12-08T09:30:00-05:00,69,69.335,68.5,68.87,12997248,12929211.65,61.20966808400571,54.0998863020616,NaN,NaN,190.68080036947464,112.16254689147782,0.1689299120088326,0.39687221280729545,0.22794230079846287,1462865309,1453004871,89.6422482755699,68.87988638026394,NaN,NaN,10.577141931350802,6.539410442497714
2021-12-09T09:30:00-05:00,69.03,69.165,68.31,68.78,11891860,12877976.1,60.45656525389402,54.71572397896647,NaN,NaN,144.2143347577191,150.87450550209937,0.1827099139668784,0.45632969325706085,0.27361977929018244,1450973449,1459205289.6,90.42788362083829,72.43379950653119,NaN,NaN,12.182224714951843,7.345526767134018
2021-12-10T09:30:00-05:00,69.06,69.479,68.79,69.15,11702008,13069390.75,62.4993247631356,55.255960383993866,NaN,NaN,155.48768219169483,183.76887715521303,0.20288699294139023,0.5272285204669203,0.32434152752553,1462675457,1463468963.2,90.93695344171142,75.65161995930373,NaN,NaN,14.138541091225662,8.315957384861395
2021-12-13T09:30:00-05:00,69.08,70.34,69.08,70,13750147,13302421.15,66.74894538358382,55.87569002931259,NaN,NaN,180.60620277369432,176.94781773019244,0.25618597817268907,0.6445740002413913,0.38838802206870227,1476425604,1465760475.2,91.20759829453283,78.51294361810379,NaN,NaN,17.209011831187855,9.586393734336603
2021-12-14T09:30:00-05:00,69.99,70.13,69.25,69.58,17502693,13702462.65,62.95281371924407,56.18642402124176,NaN,NaN,139.36897532804167,162.0715990841249,0.2458187789757923,0.6956614957884426,0.4498427168126503,1458922911,1462372546,87.0677925004308,80.48892344153016,NaN,NaN,18.602224712094433,10.874369588302008
2021-12-15T09:30:00-05:00,69.5,70.78,69.5,70.72,22682461,14506250.85,68.233667892817,56.85154534621035,NaN,NaN,155.89784787574828,155.11500858537966,0.29508559934538714,0.8186997159943843,0.5236141166489972,1481605372,1466120558.6,87.73123196677204,82.08340655462652,NaN,NaN,21.598069149885212,12.40632666852818
2021-12-16T09:30:00-05:00,70.65,71.51,70.59,71.08,15104625,14786435,69.70239005710964,58.38111369008857,NaN,NaN,168.57751470138743,159.9876445741133,0.32869688219460846,0.9344852193922577,0.6057883371976492,1496709997,1475267868.2,89.188950023182,83.47319646406113,NaN,NaN,24.498314125134257,14.133753448043334
2021-12-17T09:30:00-05:00,70.81,71.16,69.86,70.01,21837076,15495646.75,60.716785393569964,58.701393996296495,NaN,NaN,112.31660079691989,151.3534282951583,0.2587251924949461,0.9291948278163318,0.6704696353213857,1474872921,1477707361,89.54569557445085,84.62321908789065,NaN,NaN,24.06307545874783,15.552228021001119
2021-12-20T09:30:00-05:00,68.8,69.6,68.235,69.53,15045766,15732778.75,57.1570973045042,59.766048915576185,NaN,NaN,39.94381311114199,123.22095036264787,0.16456046853806738,0.8761702209939699,0.7116097524559025,1459827155,1474387671.2,85.41514249377887,85.62286306661947,NaN,NaN,22.5440702858861,16.5510626302704
2021-12-21T09:30:00-05:00,69.75,70.205,69.06,69.43,16177936,15962825.25,56.41503312379305,60.71183264409325,NaN,NaN,59.42346564901801,107.23184842684311,0.08404393549114719,0.8166646718198365,0.7326207363286893,1443649219,1471332932.8,81.68137116593277,86.28966742346589,NaN,NaN,21.11171471173782,17.20258435619432
2021-12-22T09:30:00-05:00,69.32,69.83,69.22,69.73,9483878,15961001.7,58.169597413468864,61.346834954412124,NaN,NaN,55.94301509674837,87.24088187104314,0.04163814620449824,0.7846684190843121,0.7430302728798138,1453133097,1465638477.8,75.09164609684564,86.33685884077734,NaN,NaN,20.44535881814042,17.66583785075805
2021-12-23T09:30:00-05:00,69.77,70.08,69.645,69.72,7252838,15925354.3,58.085658197320896,61.66973546319597,NaN,NaN,63.39588687715752,66.20455630619716,0.005464036784445736,0.749860318860371,0.7443962820759252,1445880259,1455472530.2,65.00852519498093,85.31248676866082,NaN,NaN,19.882935706289405,17.982566115833958
2021-12-27T09:30:00-05:00,69.75,70.06,69.54,70.06,7853685,15771674.85,60.18911815631638,61.735858223615814,NaN,NaN,62.742109800970454,56.28965810700728,-0.0025841411411646753,0.7411661056494694,0.7437502467906341,1453733944,1451244734.8,61.3207728470834,83.72151949945089,NaN,NaN,19.985557812498655,18.268707786786056
2021-12-28T09:30:00-05:00,70.16,70.71,70.11,70.69,8052724,15603754.15,63.812973193634264,61.88211699545697,NaN,NaN,92.81095944707346,66.86308737419357,0.025931380977447183,0.7761644730124431,0.7502330920349959,1461786668,1451636637.4,61.53857674705945,81.84317058879785,NaN,NaN,21.119958831476886,18.67602936459903
2021-12-29T09:30:00-05:00,70.77,71.18,70.65,71.07,6877849,14732072.7,65.8332040645814,62.212369565498086,NaN,NaN,116.29022783629557,78.23643981164908,0.05985597232102602,0.8250530574362784,0.7651970851152524,1468664517,1456639697,64.30215684410484,80.03316405797891,NaN,NaN,22.6706293681144,19.24668650795837
2021-12-30T09:30:00-05:00,71.26,71.4,70.81,71.33,9336214,14048265.5,67.18315911256775,62.69284055540335,NaN,NaN,126.33483626008656,92.31480404431672,0.08759793680112149,0.8746945061166542,0.7870965693155327,1478000731,1461613223.8,66.85202201145779,78.34917394302316,NaN,NaN,24.361635075069135,19.97739344611705
2021-12-31T09:30:00-05:00,71.18,71.83,71.04,71.58,9309400,13637480.45,68.47303681994183,63.119534273746645,NaN,NaN,143.27809963672775,108.29124659623076,0.10917264086571432,0.9235623703976756,0.8143897295319613,1487310131,1469899198.2,70.61755901558756,76.89778862687146,NaN,NaN,26.156540095052556,20.860128681679264
2022-01-03T09:30:00-05:00,71.55,71.5674,70.055,70.87,21649843,13650685.95,61.12496469682089,62.71782136754929,NaN,NaN,82.72362753431587,112.28755014289985,0.06423706014713204,0.8946860547158764,0.8304489945687443,1465660288,1472284467,71.61710992121337,75.49846802877721,NaN,NaN,25.644343771288565,21.54358798019488
2022-01-04T09:30:00-05:00,70.87,71.555,70.63,70.65,14661086,13203192.5,59.011760767981805,62.436317585316274,NaN,NaN,82.72866058186649,110.27109036985844,0.01109396485535119,0.8443164506379333,0.8332224857825821,1450999202,1470126973.8,69.3200480606757,74.23077199736612,NaN,NaN,24.61218643066929,21.981959187405508
2022-01-05T09:30:00-05:00,70.6,71.405,70.54,70.61,22243223,13770628,58.61497746859633,61.74926826930051,NaN,NaN,66.84615456525671,100.38227571565068,-0.032945698597743545,0.7920403625354027,0.8249860611331462,1428755979,1462145266.2,61.46554524127949,72.3546515169738,NaN,NaN,23.652324199098725,22.220582760504538
2022-01-06T09:30:00-05:00,70.61,70.9,69.8,69.88,18129909,14027261.05,51.773221878997,60.46861339943532,NaN,NaN,-0.807605263654046,74.95378741090255,-0.11292997352967449,0.6838235942210531,0.7967535677507276,1410626070,1448670334,50.96629340263948,69.62446175836361,NaN,NaN,20.78420701360875,22.015386225233712
2022-01-07T09:30:00-05:00,69.73,70.75,69.3,70.41,19636027,14414469.4,55.80647339239433,60.11787682792278,NaN,NaN,-13.592098742666325,43.57974773502374,-0.1305830800507014,0.6335247176873509,0.7641077977380523,1430262097,1437260727.2,44.097651867906016,66.37817292218185,NaN,NaN,19.44670926377472,21.648432373596712
2022-01-10T09:30:00-05:00,70.35,70.45,69.605,69.95,15585002,14608619.1,51.76042100214411,59.73239994918276,NaN,NaN,-38.939390165949,19.247144194970765,-0.17112467467877912,0.5502019543895784,0.7213266290683575,1414677095,1427064088.6,39.03463930888205,63.06527983754636,NaN,NaN,17.086046627719686,20.996662981328566
2022-01-11T09:30:00-05:00,69.89,70.15,68.855,69.32,16826875,14762455.5,46.76018456040453,59.04276790894073,NaN,NaN,-102.89266067382295,-17.877120056167122,-0.23434604794688296,0.42839406913475386,0.6627401170816368,1397850220,1416434292.2,34.57764977691632,59.70072830975948,NaN,NaN,13.472739650536427,19.921816791215402
2022-01-12T09:30:00-05:00,69.1,69.724,68.9,69.54,14056795,14590160.6,48.62655665002822,58.36112214012354,NaN,NaN,-105.23577962410755,-52.29350689403998,-0.25368936193953906,0.34562841465721306,0.5993177765967521,1411907015,1413064499.4,33.28034447960307,56.71420676567072,NaN,NaN,11.038814783211537,18.65281650435771
2022-01-13T09:30:00-05:00,69.51,70.15,69.47,69.88,16974483,14304761.7,51.458692489652954,57.887767446718684,NaN,NaN,-48.433176823098165,-61.8186212059288,-0.23628042092474555,0.3039672504408202,0.5402476713655657,1428881498,1416715585,36.07865635881549,54.647787563087476,NaN,NaN,9.80329266211175,17.388598812608286
2022-01-14T09:30:00-05:00,69.88,70.01,69.05,69.4,16273792,14363220.05,47.47921596877781,56.97991729046593,NaN,NaN,-81.21406936014736,-75.34301532942501,-0.2485404373922641,0.22957212462523557,0.4781125620174997,1412607706,1413184706.8,34.56867875341847,52.736923699254255,NaN,NaN,7.547125769818745,15.98267409220978
2022-01-18T09:30:00-05:00,68.89,69.01,68.03,68.57,17767514,14159741.95,41.50249544227963,55.38631173679774,NaN,NaN,-164.05092777305333,-100.36532285084589,-0.3005233997093336,0.1024583123808327,0.4029817120901663,1394840192,1409217326.2,32.90237851104823,50.69148096811061,NaN,NaN,3.6250899404892762,14.21730492767828
2022-01-19T09:30:00-05:00,68.59,69.4888,68.57,68.88,16025789,14208743.1,44.32162012678254,53.849770026954964,NaN,NaN,-115.31780003132171,-102.85035072234564,-0.30124181177142145,0.02642944737588948,0.32767125914731093,1410865981,1411820478.4,35.11247908646202,48.60650398542183,NaN,NaN,1.2460702838964155,12.364271407138013
2022-01-20T09:30:00-05:00,69.09,69.97,68.89,68.97,14764809,14138086.75,45.14810344404201,52.27583747920312,NaN,NaN,-81.07643900245684,-98.01848259801548,-0.28314423156155233,-0.026259030304629505,0.2568852012569228,1425630790,1414565233.4,37.45189674624801,46.50649503790685,NaN,NaN,-0.4405434919521581,10.535012135839416
2022-01-21T09:30:00-05:00,69.31,69.67,68.705,68.84,24271460,14877465.85,44.12914025594824,50.53698772463215,NaN,NaN,-95.95801647090832,-107.52345052757751,-0.2675964000433752,-0.0776102987972962,0.189986101246079,1401359330,1409060799.8,34.746381986224534,43.94426810723807,NaN,NaN,-2.125498115556418,8.72636781421144
2022-01-24T09:30:00-05:00,68.76,68.98,66.43,68.18,28801130,15954880.45,39.281878249618636,48.976767264117704,NaN,NaN,-180.76287546034231,-127.4332117476165,-0.2876752001265357,-0.1696078989120906,0.11806730121444509,1372558200,1401050898.6,31.21285223739376,41.05824970125094,NaN,NaN,-5.0828816410785524,6.753617892027155
2022-01-25T09:30:00-05:00,67.12,67.92,66.8,67.11,26109257,16867659.05,32.96077396725089,47.115982492636924,NaN,NaN,-187.939322562311,-132.21089070546805,-0.35454109100931513,-0.32510906254719885,0.02943202846211629,1346448943,1391372648.8,27.565190839740637,38.07575989975559,NaN,NaN,-9.898439004171147,4.374752621141683
2022-01-26T09:30:00-05:00,67.24,67.965,66.19,66.56,24617081,17695876.9,30.26487740951903,45.090975345559976,NaN,NaN,-179.96512729855354,-145.1403561589144,-0.41323374745010577,-0.487110155850516,-0.07387640840041018,1321831862,1373565825,22.38241600262826,35.2841078112805,NaN,NaN,-14.832807114329707,1.6308155160743412
2022-01-27T09:30:00-05:00,67.18,67.99,66.82,67.15,22490975,18476533.2,36.285204938988585,43.98468842127365,NaN,NaN,-135.94472692010822,-156.11401374244468,-0.3900328327977139,-0.5614174493975526,-0.17138461659983867,1344322837,1357304234.4,18.88953459161982,32.99291075335052,NaN,NaN,-17.03423692165239,-1.0356205464580492
2022-01-28T09:30:00-05:00,66.97,68.0161,66.46,67.96,25025224,19260983.7,43.497211639002145,43.105455438888505,NaN,NaN,-111.39912521559688,-159.2022354913824,-0.30178999484863794,-0.5486221101606361,-0.24683211531199817,1369348061,1350901980.6,17.717263466337442,31.10859729609562,NaN,NaN,-16.498038844774157,-3.2445374462174934
2022-01-31T09:30:00-05:00,67.56,69.31,67.42,69.25,26289979,20110012.65,52.68310578414448,43.17136149474567,NaN,NaN,-30.88483302502618,-129.22662700431914,-0.14608565575175975,-0.42943918500169787,-0.2833535292499381,1395638040,1355517948.6,21.499875018106195,29.85611413246877,NaN,NaN,-12.671371662139178,-4.591228048492019
2022-02-01T09:30:00-05:00,69.06,69.43,67.695,68.33,20510121,20053026.55,46.83512376388457,43.17671429499425,NaN,NaN,-36.42328562116435,-98.92341961608983,-0.0969641117040495,-0.40455866888,-0.3075945571759505,1375127919,1361253743.8,26.049145355220574,29.24693524520479,NaN,NaN,-11.606651887857817,-5.593431454115705
2022-02-02T09:30:00-05:00,68.28,69.44,68.16,69.34,22861871,20463065.8,53.002841494165466,43.489306069575484,NaN,NaN,5.399567485893223,-61.85048065920049,0.006167460742725617,-0.2998852312475435,-0.30605269199026913,1397989790,1376485329.4,36.562755526114366,29.481393177098454,NaN,NaN,-8.432854127406014,-5.999063264585749
2022-02-03T09:30:00-05:00,69.14,69.46,68.84,69.03,17144858,20208147.55,51.045432524873895,43.459787500662685,NaN,NaN,23.842132762758716,-29.893108722627098,0.05349177206748712,-0.2391879769059102,-0.2926797489733973,1380844932,1383789748.4,40.90193095795573,29.825912791322754,NaN,NaN,-6.658963607993494,-6.093334742215427
2022-02-04T09:30:00-05:00,68.43,69.09,67.79,68.48,18514553,20227379.75,47.68098818599862,43.47419980189274,NaN,NaN,-24.59394257097172,-12.532072193702064,0.04791819680286735,-0.2327820029698131,-0.28070019977268046,1362330379,1382386212,40.33107649725783,30.23751263016842,NaN,NaN,-6.35717288270459,-6.131025905142451
2022-02-07T09:30:00-05:00,68.36,68.66,67.96,68.38,13771924,19934174.6,47.07347637507231,43.872127011377934,NaN,NaN,-28.994743702526083,-12.154054329202033,0.03809016050624825,-0.23308749913987015,-0.2711776596461184,1348558455,1372970295,36.63685139281358,30.504260693151657,NaN,NaN,-6.313276303459673,-6.157061676330626
2022-02-08T09:30:00-05:00,68.66,68.88,68.26,68.43,19426621,20126255.55,47.43411162514616,44.09444783268962,NaN,NaN,-4.782323331641685,-5.8258618712975005,0.03559654675210988,-0.22668197620598107,-0.26227852295809095,1367985076,1371541726.4,36.096628060501196,30.574557048440173,NaN,NaN,-6.170758825838204,-6.159018411974565
2022-02-09T09:30:00-05:00,68.92,69.08,68.52,68.73,17615853,20165704.45,49.65089127545442,44.41607553493337,NaN,NaN,25.80811247422113,-1.7441528736319192,0.05370401053363,-0.19514850979105347,-0.24885252032468347,1385600929,1369063954.2,35.129092177802065,30.408642436408318,NaN,NaN,-5.404451283161682,-6.051223107858439
2022-02-10T09:30:00-05:00,68.05,68.375,66.8499,66.99,22530023,20589365.85,39.29913221606124,44.07107496065572,NaN,NaN,-106.21658812712539,-27.75589705160874,-0.04653582905852338,-0.3070223066478377,-0.2604864775893143,1363070906,1365509149,33.732134084238965,30.336196157695067,NaN,NaN,-8.114357762899068,-6.3459566300071
2022-02-11T09:30:00-05:00,67.28,67.78,66.735,67.03,18029856,20642134.5,39.610835625623466,44.09457191608464,NaN,NaN,-111.69385619004858,-45.175879775424114,-0.10199722144401147,-0.38798300439432865,-0.2859857829503172,1381100762,1369263225.6,36.5994875082649,30.720955819900148,NaN,NaN,-10.128059021379023,-6.88625697163166
2022-02-14T09:30:00-05:00,67.25,67.36,65.82,66.46,18556133,20756251.55,36.71737346271608,44.362900451475014,NaN,NaN,-147.4047622096662,-68.85788347685214,-0.16518127541781025,-0.49246237722258,-0.32728110180476977,1362544629,1372060460.4,38.72693250462649,31.518223081677707,NaN,NaN,-12.735112546012529,-7.721807767971784
2022-02-15T09:30:00-05:00,66.87,67.13,65.85,66.15,17087517,20722251.7,35.210930054594385,44.716189926123256,NaN,NaN,-137.7737144901997,-95.45616170856374,-0.21292445741430754,-0.5934366735726542,-0.38051221615834663,1345457112,1367554867.6,36.59675473825738,32.533532991365504,NaN,NaN,-15.338409463389713,-8.809893724460059
2022-02-16T09:30:00-05:00,66.24,66.585,65.65,66.3,16092297,20725577.1,36.567087508640014,44.73632439538407,NaN,NaN,-134.73113678505248,-127.56401156041845,-0.2186454002379528,-0.6538189664557876,-0.4351735662178348,1361549409,1362744563.6,34.41995576190227,33.64284878924282,NaN,NaN,-17.073503544135356,-9.990409412985102
2022-02-17T09:30:00-05:00,66,66.655,65.53,66.34,14579934,20716333.35,36.946117537237484,44.268389102400874,NaN,NaN,-120.98368396536516,-130.51743072806642,-0.20424932230326315,-0.6904852190969137,-0.4862358967936506,1376129343,1365356251,36.6240668019075,34.993334741783535,NaN,NaN,-18.38898543981091,-11.190205988245932
2022-02-18T09:30:00-05:00,66.12,66.77,65.92,66.22,16843509,20344935.8,36.246388897479186,43.0943378962105,NaN,NaN,-101.38393523450888,-128.45544653695848,-0.1877442523723467,-0.720916212259084,-0.5331719598867373,1359285834,1360993265.4,34.535833689224546,35.92447464686342,NaN,NaN,-19.680560098764357,-12.403113718319993
2022-02-22T09:30:00-05:00,66.46,66.62,65.7,66.15,17210858,19765422.2,35.82021144907962,42.307558445153,NaN,NaN,-101.01930581379183,-119.1783552577836,-0.16716373983647892,-0.7421266346823359,-0.5749628948458569,1342074976,1356899334.8,32.65437303652274,36.396276624099286,NaN,NaN,-20.878982829602325,-13.613952162788898
2022-02-23T09:30:00-05:00,66.27,66.47,64.96,65.03,17291770,19324547.85,29.785745286419782,40.64919443031402,NaN,NaN,-132.66877930608794,-118.15736822096126,-0.21173523033679387,-0.8396319327668493,-0.6278967024300555,1324783206,1352764553.6,30.827691098017056,35.986629164949484,NaN,NaN,-23.806436233253788,-15.070021315712454
2022-02-24T09:30:00-05:00,64.61,65.675,64.2835,65.55,28659993,19526693.45,35.24060398436674,39.520278105992084,NaN,NaN,-136.73744444010046,-118.55862975197086,-0.1896626668726823,-0.8649750360209083,-0.675312369148226,1353443199,1351143311.6,30.116308369607353,35.216227551496026,NaN,NaN,-24.740948266202814,-16.451582308639647
2022-02-25T09:30:00-05:00,66.13,67.66,65.98,67.58,21264120,19465350.7,51.184469036438834,39.77052673816638,NaN,NaN,-16.657775716110415,-97.6934481021199,-0.030179029796230328,-0.7130361563935139,-0.6828571265972836,1374707319,1350858906.8,29.985586387746935,34.47726397224525,NaN,NaN,-20.027027942922842,-16.96236025639439
2022-02-28T09:30:00-05:00,67.17,68.03,67.09,67.93,18352588,19131718.9,53.3184605110526,40.216597033593544,NaN,NaN,20.245768388718414,-73.36750737747444,0.09992591923562455,-0.557949727552753,-0.6578756467883775,1393059907,1357613721.4,36.98195973166942,34.501914567877805,NaN,NaN,-15.577294011309577,-16.764493649953703
2022-03-01T09:30:00-05:00,67.79,68.38,66.835,67.34,16732393,18653839.6,49.3982041022688,40.35688935338802,NaN,NaN,14.388724902225857,-50.2859012342709,0.1445802039729367,-0.47715039182220664,-0.6217305957951433,1376327514,1364464229,43.18291336569178,35.00807780396285,NaN,NaN,-13.2067245821192,-16.256240925977345
2022-03-02T09:30:00-05:00,67.37,68.41,67.335,68.16,14629875,18359827.3,54.41478066707758,40.69716716707539,NaN,NaN,46.31694837128503,-14.488755698796314,0.22298819484373167,-0.3429953522404787,-0.5659835470842104,1390957389,1377699065.6,52.83818720138672,36.27301316279032,NaN,NaN,-9.49870821562453,-15.290879110212657
2022-03-03T09:30:00-05:00,68.43,69.7,68.37,69.36,20735614,18253514.45,60.57462116293163,42.216844948994705,NaN,NaN,122.70726222312713,37.400185633849205,0.34218455540534076,-0.1382528528275344,-0.4804374082328752,1411693003,1389349026.4,59.38153110974968,38.105112950326806,NaN,NaN,-4.085618157369199,-13.690127545520735
2022-03-04T09:30:00-05:00,69.18,70.95,69.04,70.89,24342246,18613383.85,66.74482514478566,44.15498705750629,NaN,NaN,183.74280383436238,77.48030154394378,0.5009777269450424,0.14578475044842776,-0.3551929764966146,1436035249,1401614612.4,64.90270498229238,40.12677134132877,NaN,NaN,2.957999638551074,-11.311823662081906
2022-03-07T09:30:00-05:00,71.05,71.965,70.45,71.81,30972041,19236258.25,69.80495852944678,46.5183859908442,NaN,NaN,212.94108909632675,116.01936568546543,0.6361946075368938,0.44005028292450277,-0.1961443246123911,1467007290,1416404089,70.16817232109624,42.372574185362325,NaN,NaN,9.761929899832603,-8.301287438951263
2022-03-08T09:30:00-05:00,72,72.37,70.67,70.7,26564855,19875904.8,62.35011986962982,48.45689954906101,NaN,NaN,172.21795692451389,147.58521208992303,0.6185461596459735,0.5770383749450758,-0.04150778470089769,1440442435,1429227073.2,73.83362653180976,45.03235074204463,NaN,NaN,12.602333712162531,-5.315055845935007
2022-03-09T09:30:00-05:00,71.21,71.31,70.07,70.2,25476875,20178417.5,59.279082121710424,50.079184878566046,NaN,NaN,122.24296447419765,162.77041531050557,0.543528829268644,0.6379032518849073,0.0943744226162633,1414965560,1434028707.4,75.06892957154668,47.93584887130494,NaN,NaN,13.73940084349607,-2.59299060458771
2022-03-10T09:30:00-05:00,69.67,70.81,69.62,70.67,17019884,20148619.05,61.213036310915776,51.81253621954307,NaN,NaN,104.67575491844522,159.1641138495692,0.49715064894405053,0.7158127337963265,0.21866208485227595,1431985444,1438087195.6,76.09613657733651,50.75528242669274,NaN,NaN,15.287557227538901,-0.03862662856962329
2022-03-11T09:30:00-05:00,70.78,71.25,70.36,70.43,12494214,19646828.6,59.65501410369832,53.48458087713015,NaN,NaN,101.08173894473302,142.63190087164332,0.424710505686193,0.7495502169600172,0.3248397112738242,1419491230,1434778391.8,73.43946444656406,53.53411319507412,NaN,NaN,16.01694120599734,2.255025919225657
2022-03-14T09:30:00-04:00,70.88,71.24,69.99,70.35,20502285,19770450.05,59.11489434139724,55.148486798009976,NaN,NaN,83.42806077479321,116.7292952073366,0.34897548603538586,0.7610590688180565,0.41208358278267065,1398988945,1421174722.8,63.607243076214495,55.74503248362354,NaN,NaN,16.43557004600178,4.280817937336531
2022-03-15T09:30:00-04:00,71.03,71.4,70.62,71.25,14502212,19567754,63.156393194006604,57.53210450569475,NaN,NaN,90.87538232522347,100.46078028747853,0.3368913813882844,0.8331978095180261,0.49630642812974174,1413491157,1415784467.2,60.1697761428698,57.84089570111302,NaN,NaN,18.038392363449706,6.2461857124955555
2022-03-16T09:30:00-04:00,71.16,71.47,70.11,71.12,20005940,19713675.15,62.19996362923619,59.45777305175685,NaN,NaN,75.95227603134765,91.20264259890853,0.2988358685395158,0.8698512638041365,0.5710153952646206,1393485217,1411488398.6,57.50251623191566,59.79705340556361,NaN,NaN,19.05444357179257,8.075936835252271
2022-03-17T09:30:00-04:00,71.16,71.93,71.02,71.42,15915221,19704821.35,63.57098944940984,60.34252450982621,NaN,NaN,85.77195460699848,87.42188253661917,0.27325740109590946,0.9125871466345075,0.639329745538598,1409400438,1406971397.4,54.75419181319634,61.56623950738143,NaN,NaN,20.293776609431884,9.82134251727793
2022-03-18T09:30:00-04:00,71.42,71.74,70.65,70.81,18519033,19901776.3,58.8934877461206,60.740740740902496,NaN,NaN,67.24241952045786,80.65401865176413,0.19814328655607338,0.8870088537336898,0.6888655671776164,1390881405,1401249432.4,51.4026377642028,62.59628793827667,NaN,NaN,20.018419497243737,11.278067800130188
2022-03-21T09:30:00-04:00,70.44,71.1401,70.42,70.81,18147161,19966958.9,58.8934877461206,61.418975286891914,NaN,NaN,52.927815036019155,74.55396950400934,0.1343959603841074,0.8568605176577506,0.7224645572736432,1390881405,1399627924.4,50.46002163048218,63.116081385761696,NaN,NaN,19.793950464205288,12.49462246642663
2022-03-22T09:30:00-04:00,71.08,71.08,70.345,70.91,14643197,19838575.85,59.460603606208714,61.779391211115566,NaN,NaN,48.20622330568742,66.02013770010213,0.08719030792776405,0.8314524421833482,0.7442621342555842,1405524602,1398034613.4,49.499479892200945,62.877602292248426,NaN,NaN,19.754376869419403,13.53173023828274
2022-03-23T09:30:00-04:00,70.84,71.42,70.49,71.01,13994982,19673736.45,60.05409996294608,61.742211125402314,NaN,NaN,52.64187240585114,61.35805697500282,0.0526285300477477,0.8100477968152688,0.7574192667675211,1419519584,1403241486.8,52.67024597040668,62.39822478229536,NaN,NaN,19.87189488916615,14.4374680455518
2022-03-24T09:30:00-04:00,71.16,71.83,71.015,71.74,13295707,18905522.15,64.17706360244561,61.55879958666373,NaN,NaN,80.77786110188501,60.35923827398011,0.06788865044621228,0.8422800798252865,0.7743914293790742,1432815291,1407924457.4,55.383514667154195,61.71828261692834,NaN,NaN,21.091148176336855,15.387993778521093
2022-03-25T09:30:00-04:00,72,72.81,71.83,72.78,14466704,18565651.35,69.07430901874459,61.50661033589929,NaN,NaN,143.24239536328994,75.55923344254653,0.1332049545642845,0.9408976225844299,0.8076926680201454,1447281995,1419204575.4,61.15943264038294,61.07480121116311,NaN,NaN,23.670937243903246,16.57127141643283
2022-03-28T09:30:00-04:00,72.85,73.25,72.415,73.25,15479887,18422016.3,71.00354267251484,62.12471196467679,NaN,NaN,180.1818947930303,101.01004939394876,0.18979184688431006,1.044932476625533,0.855140629741223,1462761882,1433580670.8,67.01941149466319,60.58807156565261,NaN,NaN,26.4455062518876,17.981876392926367
2022-03-29T09:30:00-04:00,73.22,73.93,73.09,73.93,19057344,18538263.85,73.57228622910952,63.145655115205294,NaN,NaN,222.49687027475954,135.86817878776318,0.25091006999701215,1.168778217237488,0.9178681472404759,1481819226,1448839595.6,71.87050922396652,60.359612969396885,NaN,NaN,29.64846856104503,19.64853241694332
2022-03-30T09:30:00-04:00,74,74.56,73.775,74.54,17614604,18687500.3,75.65571403328948,64.1772749525177,NaN,NaN,230.65766300485723,171.47133690756442,0.3066254139448178,1.3011499146714982,0.9945245007266804,1499433830,1464822444.8,75.87354988507595,60.34371391994971,NaN,NaN,33.04287841003988,21.562010415957115
2022-03-31T09:30:00-04:00,74.49,75.14,74.42,74.46,17850559,18543247.55,74.82261509774108,65.26067502352076,NaN,NaN,203.13212199332403,195.94218908585222,0.31130059813173383,1.3836502483913478,1.072349650259614,1481583271,1474576040.8,77.93697378551603,60.66496458701771,NaN,NaN,35.55533015211062,23.561056092550473
2022-04-01T09:30:00-04:00,74.4,75.55,73.96,75.5,19006860,18276478.25,78.1856082892652,66.6228688769399,NaN,NaN,174.76706176972186,202.2471223671386,0.35450598455528004,1.515482130953714,1.160976146398434,1500590131,1485237668,79.95507472856627,61.83266684789998,NaN,NaN,38.89542571030176,25.751680323657798
2022-04-04T09:30:00-04:00,75.19,75.19,74.15,74.92,14195451,17437648.75,72.37918868559171,67.2816399834817,NaN,NaN,132.61101994563643,192.73294739765984,0.31540385130424964,1.5552309605287462,1.2398271092244966,1486394680,1489964227.6,80.79381082826404,63.305812182570996,NaN,NaN,39.93703565030394,27.778159656035818
2022-04-05T09:30:00-04:00,74.95,76.25,74.94,75.39,19070266,17062919.3,74.06031680772841,68.12880806765972,NaN,NaN,140.90997435764487,176.41556821423688,0.29305243555284877,1.6061426536655574,1.3130902181127087,1505464946,1494693371.6,81.62238634176578,65.0286600475603,NaN,NaN,41.321483282146325,29.712920174051604
2022-04-06T09:30:00-04:00,75.63,76.94,75.29,76.89,28244630,17201307.05,78.54789800531411,69.1985872502243,NaN,NaN,149.55737986768196,160.19551158680184,0.34743601111569866,1.747385232007332,1.3999492208916333,1533709576,1501548520.8,82.78194829408854,67.0306426533383,NaN,NaN,44.11448154521553,31.77028608421788
2022-04-07T09:30:00-04:00,76.86,76.89,76,76.7,21016896,17401157.65,76.73697758021862,70.47312223837416,NaN,NaN,133.93693297458847,146.35647378305472,0.33842098693462086,1.8229754545599093,1.4845544676252884,1512692680,1507770402.6,83.78215012149151,69.34346496457322,NaN,NaN,45.740409552853606,33.7660180083087
2022-04-08T09:30:00-04:00,76.98,77.23,76.31,76.96,17194275,17636160.7,77.50138520444978,71.80225777111197,NaN,NaN,126.34195982461642,136.67145339403368,0.31808814996643275,1.8821646550833293,1.5640765051168966,1529886955,1513629767.4,84.68444764423757,71.7880668226986,NaN,NaN,47.292492304273175,35.69837147916077
2022-04-11T09:30:00-04:00,77.01,77.115,75.795,75.91,23167902,17769441.55,67.81063661000849,72.3986886999548,NaN,NaN,96.1718735416292,129.3836241132322,0.2074012812805146,1.8233281067175398,1.6159268254370251,1506719053,1517694642,85.29564810687526,74.34493598088963,NaN,NaN,45.539780788670335,37.104287094804995
2022-04-12T09:30:00-04:00,75.7,76.595,75.43,76.2,22656871,18177174.5,68.9648730226063,73.03517248993053,NaN,NaN,81.46730808624761,117.49509085895276,0.13092760456295616,1.7795863311407203,1.6486587265777641,1529375924,1522476837.6,86.00333390278081,76.72587083320205,NaN,NaN,44.47014861142673,38.15655302575096
2022-04-13T09:30:00-04:00,76.21,76.41,75.55,76.05,17656461,18059700.55,67.61435849715991,73.28069355383869,NaN,NaN,72.15132127694393,102.01387914080516,0.05152878767728475,1.71306971117437,1.6615409234970853,1511719463,1518078815,82.09040639774436,78.63350595681564,NaN,NaN,43.200695443090844,38.877144799656655
2022-04-14T09:30:00-04:00,76.2,76.595,75.98,76.09,14213548,17974616.9,67.79546820246483,73.18934778124729,NaN,NaN,73.50598221380783,89.92768898864902,-0.013533321619865868,1.644624271472253,1.6581575930921189,1525933011,1520726881.2,82.60362379567115,80.1652338964791,NaN,NaN,42.217710994688346,39.35436854180404
2022-04-18T09:30:00-04:00,76.18,76.61,75.32,75.68,14939088,17795619.65,63.85376193988544,72.67864915748804,NaN,NaN,56.51410117514189,75.96211725875412,-0.09488590060979485,1.5395502173298752,1.63443611793967,1510993923,1516948274.8,79.11955304409744,81.02952972143869,NaN,NaN,40.25274282043195,39.48270772446517
2022-04-19T09:30:00-04:00,75.9,76.32,75.68,76.17,16515181,17714020.65,66.37029994477567,72.16422156574993,NaN,NaN,59.51904791977949,68.63155213438418,-0.12453223218804976,1.4787708277046079,1.6033030598926576,1527509104,1521106285,80.11354706108327,81.61831813837559,NaN,NaN,39.24310193579739,39.44847832608406
2022-04-20T09:30:00-04:00,76.98,77.165,76.56,76.79,18326195,17898170.55,69.28424817516644,71.70911686159829,NaN,NaN,88.51158040802284,70.0404065987392,-0.11163584947185345,1.4637582480528408,1.5753940975246943,1545835299,1524398160,80.88919635013306,81.97657860016538,NaN,NaN,39.19399278156847,39.41212324829612
2022-04-21T09:30:00-04:00,76.54,76.76,75.46,75.52,18408551,18118849,58.166249572151884,70.51937646691334,NaN,NaN,39.365703928372156,63.483283129024834,-0.1931115112502888,1.3340047084618334,1.5271162197121222,1527426748,1527539617,81.6257268037535,82.24006095861093,NaN,NaN,35.574301935877415,38.86386306080773
2022-04-22T09:30:00-04:00,75.42,75.5,74.2,74.25,27341725,18821149.9,49.59549567304486,68.47722556575475,NaN,NaN,-45.13418124690953,39.75525043688136,-0.3290265132084944,1.1158330782015042,1.4448595914099986,1500085023,1522370019.4,76.40710520842327,81.986634564315,NaN,NaN,29.370817547356324,37.50771370174324
2022-04-25T09:30:00-04:00,74.51,74.55,72.515,73.74,29835333,19589581.35,46.624427524752356,66.63759976855194,NaN,NaN,-124.63007104939174,3.526415991974646,-0.44268680745431466,0.8915010820921054,1.33418788954642,1470249690,1514221172.8,68.92646389896484,81.13896692650792,NaN,NaN,23.34219499098603,35.484068171635066
2022-04-26T09:30:00-04:00,73.48,74.385,72.97,73,20553083,19843241.15,42.63355250201341,64.3928308895723,NaN,NaN,-140.85627129105717,-36.54864785019269,-0.5501091115097831,0.646551500159191,1.1966606116689742,1449696607,1498658673.4,57.37370145986358,79.40691800637205,NaN,NaN,16.955166067798118,32.837082156801216
2022-04-27T09:30:00-04:00,73.05,73.73,72.41,72.65,24533994,20117073.65,40.85243107105077,61.70029753712491,NaN,NaN,-167.70482317301983,-87.79192856640122,-0.621847610648717,0.41935109835807793,1.041198709006795,1425162613,1474524136.2,44.82577505857052,76.69576277526362,NaN,NaN,11.232345665054364,29.750691229408808
2022-04-28T09:30:00-04:00,73,73.72,72.62,73.46,19951294,20233908.15,46.430236885656505,59.53553034465619,NaN,NaN,-132.9479460244288,-122.2546585569614,-0.5920137349890202,0.3011815402705196,0.8931952752595398,1445113907,1458061568,38.621001702926,73.4699664596518,NaN,NaN,8.145376700815984,26.664217725324118
2022-04-29T09:30:00-04:00,73.14,73.27,71.15,71.26,27169053,20699832.85,36.392048540138134,56.59914915434822,NaN,NaN,-182.72698833315272,-149.77321997421004,-0.6908220526867437,0.029667709401110187,0.7204897620878539,1417944854,1441633534.2,33.619884664754196,69.82249767540299,NaN,NaN,1.4855929839941764,23.067271333705555
2022-05-02T09:30:00-04:00,71.6,71.93,69.64,70.53,32916092,21395294.45,33.78213346082683,54.16854178654953,NaN,NaN,-195.02812267855555,-163.85283030004283,-0.7696946206717733,-0.24162851375186278,0.5280661069199105,1385028762,1424589348.6,29.37046471005857,65.8278417184875,NaN,NaN,-4.737604469471613,19.09514621896596
2022-05-03T09:30:00-04:00,70.79,71.96,70.475,70.8,21076417,21739342.75,35.62116251732752,51.78684817902962,NaN,NaN,-147.30475004447842,-165.14252605072707,-0.766365263060631,-0.42989047190587826,0.33647479115475276,1406105179,1415871063,27.458623920518022,61.64607671975445,NaN,NaN,-8.933796994848574,15.091011474135314
2022-05-04T09:30:00-04:00,71.24,72.51,70.94,72.38,28290142,22200336.55,45.21050276200408,50.18657276937563,NaN,NaN,-98.58050445085858,-151.31766230629484,-0.6263400203738083,-0.44645023431250763,0.17988978606130068,1434395321,1417717604.6,28.519924966795486,57.819613760400955,NaN,NaN,-9.202870334902913,11.620456929986997
2022-05-05T09:30:00-04:00,71.9,72.5004,71,71.64,27424792,22159344.65,42.05125371814605,48.34770030621,NaN,NaN,-94.23226475822392,-143.57452605305383,-0.5546062242183026,-0.5133679942115776,0.041238230006725024,1406970529,1410088929,26.776959437789472,53.831994877695124,NaN,NaN,-10.50706560088424,8.459382282719677
2022-05-06T09:30:00-04:00,71.22,72.44,71.2,72.21,27680024,22492501.05,45.2262610536604,47.017164528622494,NaN,NaN,-77.23542337727227,-122.47621306187776,-0.4445713884809709,-0.5144760055944886,-0.0699046171135177,1434650553,1413430068.8,28.82848445385224,50.239775692677604,NaN,NaN,-10.480639583409506,5.753664873272651
2022-05-09T09:30:00-04:00,71.77,72.4,71.0706,71.67,25709712,22918272.9,42.83199410635271,45.33585696873514,NaN,NaN,-78.05049007268332,-99.08068654070328,-0.3861227497771929,-0.5525580543350088,-0.1664353045578159,1408940841,1418212484.6,31.775008024587123,46.78702290435645,NaN,NaN,-11.231117575983578,3.327267380521761
2022-05-10T09:30:00-04:00,71.77,72.75,69.961,70.8,32789286,23399342.1,39.22872837391885,43.189034125788886,NaN,NaN,-89.85773822239825,-87.59128417628725,-0.38325109141446156,-0.6454991688258929,-0.2622480774114313,1376151555,1412221759.8,30.09425455561309,43.158812776176454,NaN,NaN,-13.028415130230961,0.9907413075570868
2022-05-11T09:30:00-04:00,70.75,72.5,70.685,71.31,36050854,24069041.25,42.29343446750441,42.05526161831407,NaN,NaN,-72.10102584080146,-82.29538845427584,-0.3264226618716039,-0.6702764047509362,-0.3438537428793323,1412202409,1407783177.4,28.875550596488708,39.39094304708612,NaN,NaN,-13.522337827464955,-1.0825557117317763
2022-05-12T09:30:00-04:00,71.23,71.405,69.84,70.59,24946002,24433518.3,39.28162846011555,41.31855681739055,NaN,NaN,-96.90568569650597,-82.83007264193226,-0.3165059568713788,-0.7394861889685558,-0.422980232097177,1387256407,1403840353,27.798624810218286,35.91890873292863,NaN,NaN,-14.878710377429726,-3.053434949688626
2022-05-13T09:30:00-04:00,71.21,71.535,70.29,71.43,15104512,24478066.5,44.268058044700645,41.15024471167256,NaN,NaN,-73.1710682590972,-82.01720161829724,-0.23623552539218973,-0.7182746388374142,-0.48203911344522443,1402360919,1397382426.2,26.082773547644294,32.858645136405734,NaN,NaN,-14.445616577216988,-4.6808894679069635
2022-05-16T09:30:00-04:00,71.46,71.96,71.16,71.65,11606773,24311450.75,45.52976047162543,41.357116709502,NaN,NaN,-47.7842736851637,-75.96395834079331,-0.15510517281195513,-0.6759205794601684,-0.5208154066482132,1413967692,1398387796.4,26.839865095566523,30.677656824670226,NaN,NaN,-13.71324816605221,-5.971226424784856
2022-05-17T09:30:00-04:00,71.99,72.4,70.88,72.39,14950886,24233236,49.65810596806674,41.98609348786028,NaN,NaN,-29.228674557502256,-63.83814560781411,-0.04415012424026188,-0.5760030619485406,-0.5318529377082787,1428918578,1408941201,34.43171828932478,29.935224198295533,NaN,NaN,-11.822708610320527,-6.8071524512899515
2022-05-18T09:30:00-04:00,72.51,72.66,71.5,71.69,18728311,24253341.8,46.09886046972841,41.96242374386542,NaN,NaN,-17.89384674040863,-52.996709787735554,-0.012114789845782847,-0.5469964250155073,-0.5348816351697244,1410190267,1408538772.6,34.28561299978813,29.625553576642826,NaN,NaN,-11.283531668915074,-7.446635196664969
2022-05-19T09:30:00-04:00,71.36,71.86,70.53,71.54,18276064,24246717.45,45.34877414483095,42.602189858486334,NaN,NaN,-58.21168396478727,-45.25790944139182,0.0039031786228400644,-0.5300026618911744,-0.5339058405140145,1391914203,1409470331.8,34.97347968824654,29.722238935463707,NaN,NaN,-11.061392033098425,-7.963029030441177
2022-05-20T09:30:00-04:00,71.73,71.945,70.75,71.74,15679048,23663583.6,46.59648603096106,43.517500756353066,NaN,NaN,-38.37623940345298,-38.29894367026297,0.031369370264103025,-0.49469412768388565,-0.5260634979479887,1407593251,1410516798.2,35.78662622793662,30.18053618674071,NaN,NaN,-10.526210960672078,-8.32919787761702
2022-05-23T09:30:00-04:00,72.56,72.93,71.88,72.6,13541056,22848869.75,51.702608414218425,44.66617546327385,NaN,NaN,80.39605586545744,-12.662877760138738,0.10661942422891668,-0.3927892176618428,-0.4994086418907595,1421134307,1411950121.2,36.9495991951834,30.858462992073953,NaN,NaN,-8.558123914283138,-8.36190159714075
2022-05-24T09:30:00-04:00,72.74,74.19,72.185,74.05,16155684,22628999.8,58.847166374979196,45.640222864200645,NaN,NaN,197.71438827306505,32.72573480597472,0.24528415961496497,-0.19280344237205327,-0.43808760198701824,1437289991,1413624403.8,38.35408644767068,31.56090309785076,NaN,NaN,-4.464390254983716,-7.805114262546889
2022-05-25T09:30:00-04:00,74.13,74.24,73.52,74,13861900,22095395.1,58.525663604481345,46.8169664275103,NaN,NaN,222.71604674475813,80.84771350300807,0.32014140626558596,-0.03791084415503576,-0.3580522504206217,1423428091,1416271968.6,40.607115970077515,32.54877142158562,NaN,NaN,-1.2958902420533853,-6.875225116762103
2022-05-26T09:30:00-04:00,74.46,74.7526,74.15,74.21,11645183,21680089.55,59.52582737259736,47.83836402172009,NaN,NaN,241.46407473606664,140.78286524317886,0.3669441401379415,0.10062792475180515,-0.26631621538613637,1435073274,1424903782.8,47.361782763172265,33.872578443679906,NaN,NaN,1.6089676133131507,-5.66319758389421
2022-05-27T09:30:00-04:00,74.15,75.37,73.83,75.37,11620628,20902668.3,64.6036091398756,49.39347938125743,NaN,NaN,211.10846822953886,190.67980676977723,0.45349981296590947,0.3005585508212505,-0.15294126214465897,1446693902,1432723913,52.61915689283818,35.361446219983556,NaN,NaN,5.816226330351533,-4.023279881859104
2022-05-31T09:30:00-04:00,74.67,74.95,74.01,74.33,15520704,20032898.9,57.6235930989576,50.70739829018878,NaN,NaN,144.5115701762438,203.5029096319345,0.41900198818654594,0.37081122308852343,-0.04819076509802249,1431173198,1434731691.2,53.89244373315103,37.061316875521975,NaN,NaN,7.339583499587185,-2.400013684509634
2022-06-01T09:30:00-04:00,74.6,74.6,73.53,74.21,11211029,19539629.5,56.86021321117167,51.747882486165004,NaN,NaN,105.26226450209452,185.0124848777404,0.3681958697085479,0.4120540720376624,0.0438582023291145,1419962169,1431266126.8,51.32840738239568,38.665092360229615,NaN,NaN,8.334835366361618,-0.866463820099455
2022-06-02T09:30:00-04:00,74.57,74.78,73.06,74.71,12519111,18751077.95,59.28076001033907,53.17639188260954,NaN,NaN,94.7121111587458,159.41169776053792,0.34855912806965894,0.47955711241618815,0.13099798434652923,1432481280,1433076764.6,52.59734781201071,40.4364297175005,NaN,NaN,9.891571187889985,0.6703983238990363
2022-06-03T09:30:00-04:00,74.4,74.81,74.21,74.35,8845578,17822117.25,56.809199002169386,54.07218766528588,NaN,NaN,95.36426923178134,130.19173665968088,0.2938105107849134,0.498261122827671,0.2044506120427576,1423635702,1430789250.2,50.795541079185845,42.201627398324895,NaN,NaN,10.483576683888836,2.072280946754722
2022-06-06T09:30:00-04:00,75.02,75.2561,74.59,74.68,10172896,16946760.85,58.51657171008201,54.999817039461355,NaN,NaN,100.71049869592527,108.11214275295815,0.2632889975096232,0.5335618589297866,0.2702728614201634,1433808598,1428212189.4,48.768649131514266,43.76796911517831,NaN,NaN,11.465519965004201,3.4141722350760757
2022-06-07T09:30:00-04:00,74.49,75.2,74.03,75.13,9909986,16156774.55,60.79265310663469,55.79514183507335,NaN,NaN,87.48865140522733,96.70755899875485,0.25661058260567743,0.5910360896772602,0.33442550707158275,1443718584,1430721266.6,50.8260282899807,44.938991258082304,NaN,NaN,12.951938392651009,4.77671025758678
2022-06-08T09:30:00-04:00,74.8,74.8018,73.545,73.66,9985740,15016597.25,50.95693732286846,56.14214732458335,NaN,NaN,45.52432227205254,84.75997055274645,0.14211187143348786,0.5120653463634426,0.36995347492995473,1433732844,1433475401.6,53.054604129288016,46.27963348161801,NaN,NaN,11.288213963954952,5.706925072782233
2022-06-09T09:30:00-04:00,73.62,73.975,71.84,71.89,12883764,13858242.75,42.12030145666093,55.911542132571206,NaN,NaN,-28.00207535679228,60.217133249638835,-0.0534335018201752,0.3031615976547357,0.3565950994749109,1420849080,1431148961.6,50.95391863999613,47.42109340674299,NaN,NaN,6.687757553826273,5.847043998645667
2022-06-10T09:30:00-04:00,71.18,71.98,70.74,71.34,16400323,13430958.8,39.81009415125622,55.42679985544943,NaN,NaN,-94.55257925389304,22.233763552503962,-0.2115472055256834,0.09216109256780669,0.3037082980934901,1404448757,1427311572.6,47.60561532044243,48.26530691335055,NaN,NaN,2.203524553508745,5.326541220768964
2022-06-13T09:30:00-04:00,70.43,70.59,67.725,68.06,26360670,13993766.7,29.439815897587877,53.83660038997583,NaN,NaN,-202.74576610086518,-38.45748940685413,-0.5116509456608301,-0.33585538398254755,0.17579556167828256,1378088087,1416167470.4,39.48989415919455,48.44675655363705,NaN,NaN,-6.3791936239613,3.6542933858074975
2022-06-14T09:30:00-04:00,68.14,68.39,65.59,66.34,25671385,14696997.3,25.66437873050998,51.466401272513735,NaN,NaN,-241.71716427424732,-104.29865254274905,-0.7842976443130945,-0.8045764937130855,-0.020278849399991056,1352416702,1397907094,30.35750625887978,47.87557225443771,NaN,NaN,-14.860889020667125,1.0092673277396944
2022-06-15T09:30:00-04:00,66.93,67.79,65.96,66.77,25832439,15241074.95,28.145294738838572,49.29637492496783,NaN,NaN,-195.9486517626614,-152.59324734969184,-0.8864466606380421,-1.1283371751975437,-0.2418905145595016,1378249141,1386810353.4,26.366988068202872,46.85842026144666,NaN,NaN,-20.26681997469073,-2.030173715464652
2022-06-16T09:30:00-04:00,65.94,65.94,64.96,65.48,24097001,15509509.45,25.40589435708236,46.85923685243103,NaN,NaN,-191.38439984103778,-185.26971224654093,-0.9841222030573012,-1.4720432683811282,-0.48792106532382695,1354152140,1373470965.4,22.532572848348025,45.084905267530644,NaN,NaN,-25.661302022352988,-5.4060491878772705
2022-06-17T09:30:00-04:00,65.58,66.04,64.33,64.87,21564716,15673942.05,24.20611966960692,43.97370189026898,NaN,NaN,-164.96985804312095,-199.35316800438653,-1.0282345203990342,-1.7732142158226196,-0.7449796954235854,1332587424,1359098698.8,19.27940618360502,42.70349450258542,NaN,NaN,-30.287318077968294,-8.960516172175987
2022-06-21T09:30:00-04:00,64.58,65.94,64.42,65.58,18633102,15821644.75,28.44193476751188,41.88929772373715,NaN,NaN,-132.6430953669264,-185.33263385759875,-0.949879134685303,-1.9323286137802143,-0.9824494790949112,1351220526,1353725186.6,18.220232683399118,40.15547942760313,NaN,NaN,-32.56929212961568,-12.33319845181023
2022-06-22T09:30:00-04:00,65.23,66.755,65.21,66.27,14291053,15859144.6,32.39605884249147,40.14185812597428,NaN,NaN,-100.15252006770434,-157.01970501629017,-0.7979822706729571,-1.9799273174361076,-1.1819450467631505,1365511579,1356344162,20.51231989720688,37.95433032151822,NaN,NaN,-33.12565648434031,-15.303549599314527
2022-06-23T09:30:00-04:00,66.66,67.95,66.57,67.83,20570115,16079866.15,40.412914071772086,38.79415484464806,NaN,NaN,-65.28771672446949,-130.8875180086518,-0.5506135868759743,-1.8702120303581182,-1.319598443482144,1386081694,1357910672.6,21.921936172227035,35.763229490105104,NaN,NaN,-30.888950862289654,-17.53003549402526
2022-06-24T09:30:00-04:00,68.19,69.15,67.92,69.01,15037628,16138652.55,45.661934811839814,37.99792168819596,NaN,NaN,-37.55072376926043,-100.12078279429632,-0.279368243705044,-1.6688087481134488,-1.3894405044084048,1401119322,1367304109,29.944599183081905,34.273876497526246,NaN,NaN,-27.24031020618486,-18.917217595762345
2022-06-27T09:30:00-04:00,68.86,69.73,68.59,69.57,11638486,16138317.7,48.002905220113355,37.24694551034106,NaN,NaN,-22.378803193221763,-71.60257182431647,-0.046306816936140915,-1.447324025578581,-1.4010172086424402,1412757808,1383338185.8,41.074621592103476,33.72430310185405,NaN,NaN,-23.549665856526477,-19.57899591872865
2022-06-28T09:30:00-04:00,69.8,70.34,69.22,69.31,13186151,16216593.85,46.99068836489678,36.2610908859312,NaN,NaN,-11.832068441115084,-47.44036643915422,0.09837926394260177,-1.278043128714188,-1.3764223926567898,1399571657,1393008412,46.5863065180139,33.42146583242784,NaN,NaN,-20.909834962127984,-19.769115782071413
2022-06-29T09:30:00-04:00,69.42,69.63,68.92,69.36,15164949,16198806.1,47.22117571434576,35.994250771036725,NaN,NaN,-14.051776594562362,-30.220217744525836,0.1996479562311586,-1.1268624473678415,-1.326510403599,1414736606,1402853417.4,51.55450989898616,33.31431624454914,NaN,NaN,-18.72575822996349,-19.620064703198853
2022-06-30T09:30:00-04:00,68.93,70.65,68.84,70.13,18868945,16581701.9,50.771110480597045,36.61216570131787,NaN,NaN,3.1931044317691253,-16.524053513278112,0.3138884781694613,-0.9341498058871736,-1.2480382840566349,1433605551,1412358188.8,55.8263989211306,33.66235055034446,NaN,NaN,-15.804559053263672,-19.07499246749383
2022-07-01T09:30:00-04:00,70.49,71.965,70.205,71.85,17128123,16812152.5,57.6271150715332,37.88481005276623,NaN,NaN,43.90103147099734,-0.2337024652265484,0.4901821799845276,-0.6353105590759753,-1.125492739060503,1450733674,1422281059.2,59.81074363125227,34.534145429688024,NaN,NaN,-10.961897382457678,-17.915978883917237
2022-07-05T09:30:00-04:00,71.69,71.74,68.31,69.4,22026775,17471212.35,47.48305072655895,39.173612540549875,NaN,NaN,12.603976209675174,6.762853415352845,0.4288911231543111,-0.5893788351176141,-1.0182699582719252,1428706899,1425470877.4,61.02766854767038,36.07255788600772,NaN,NaN,-9.925032091969552,-16.77441505649614
2022-07-06T09:30:00-04:00,69.74,70.76,69.19,70.12,14259082,17675521.65,50.25439771696097,40.93004246815352,NaN,NaN,27.737980154661038,14.676863134508068,0.4232239855411615,-0.48923997634547334,-0.9124639618866348,1442965981,1434149742.2,64.20362498497457,38.4901377950145,NaN,NaN,-8.171760097384638,-15.545464348051638
2022-07-07T09:30:00-04:00,70.48,70.71,69.975,70.05,8399807,17600012.7,49.978261868617246,42.48954012028057,NaN,NaN,45.90640229436567,26.66849891229368,0.4013373561086423,-0.4107922667508319,-0.8121296228594742,1434566174,1438115655.8,65.5838364028993,41.29134124749281,NaN,NaN,-6.88647157504485,-14.308465380479241
2022-07-08T09:30:00-04:00,69.98,70.13,69.59,69.82,6282316,17414841.5,49.02506765004693,44.1766239269209,NaN,NaN,43.31740644119513,34.69335931417888,0.35930644148071544,-0.36299657100857985,-0.7223030124892953,1428283858,1437051317.2,64.86104701235337,44.314803687778905,NaN,NaN,-6.126625130062931,-13.139631058991197
2022-07-11T09:30:00-04:00,69.55,70.385,69.39,70.26,6616503,17101478.45,50.95227585374103,46.08706365435904,NaN,NaN,57.138356730787066,37.34082436613683,0.34879171184702806,-0.28631337268051027,-0.6351050845275383,1434900361,1433884654.6,62.64879628831377,47.412617266686674,NaN,NaN,-4.937324235276307,-11.967872941317642
2022-07-12T09:30:00-04:00,69.85,70.81,69.625,69.92,9570553,16759989.95,49.398124323602964,47.583934336936984,NaN,NaN,65.4412222789081,47.90827357998341,0.3080091712575497,-0.25009362045560124,-0.5581027917131509,1425329808,1433209236.4,62.16179558164262,50.55130033084692,NaN,NaN,-4.376914976862616,-10.883450374966925
2022-07-13T09:30:00-04:00,69.27,70.38,69.205,69.63,19079595,16395936.2,48.05181958242763,48.702202961218134,NaN,NaN,47.22407916346703,51.80549338174461,0.2528821092993077,-0.2420001550890163,-0.494882264388324,1406250213,1425866082.8,56.97613176830303,53.155858321639506,NaN,NaN,-4.272757071453543,-9.939065617322155
2022-07-14T09:30:00-04:00,68.51,69.73,68.35,69.63,9462616,15585497.75,48.05181958242763,49.24783906912211,NaN,NaN,23.942428431236507,47.41269860911878,0.20958478395492708,-0.23290128444466518,-0.44248606839959226,1406250213,1420202890.6,53.28428774690552,55.396026291259396,NaN,NaN,-4.1863486829128345,-9.117248912406538
2022-07-15T09:30:00-04:00,69.7,69.86,68.56,69.76,8742209,14730986.25,48.777603814021404,49.47038685499222,NaN,NaN,27.027027027025248,44.1546227262848,0.18379043585903493,-0.21274802357579858,-0.3965384594348335,1414992422,1417544603.4,51.594323231449856,56.94243515185711,NaN,NaN,-3.929707067792466,-8.3761715060331
2022-07-18T09:30:00-04:00,69.6,69.7,68.76,68.79,7711084,13911690.4,43.85424088345732,49.17405368808822,NaN,NaN,5.706592449284789,33.86826986998434,0.09970047138408283,-0.27191287020473,-0.3716133415888128,1407281338,1412020798.8,48.175139103570004,57.44961497410471,NaN,NaN,-5.0120854907802155,-7.895587789568402
2022-07-19T09:30:00-04:00,69.24,69.61,69,69.23,11357797,13401344.45,46.49252447589333,49.1384705531594,NaN,NaN,6.560893854747016,22.092204185152124,0.07323574726763166,-0.28006865750427323,-0.3533044047719049,1418639135,1410682664.2,47.35640019992688,57.50462166566992,NaN,NaN,-5.251508184782183,-7.517862131741799
2022-07-20T09:30:00-04:00,69.35,69.38,68.225,68.31,17042608,13321819.75,42.04388517663235,48.76866408617987,NaN,NaN,-66.95805966544766,-0.7442235806308204,-0.002682209883573372,-0.35665716712637163,-0.35397495724279826,1401596527,1409751927,46.76112287979387,57.16223687858476,NaN,NaN,-6.713266293191839,-7.4029198690918046
2022-07-21T09:30:00-04:00,68.5,68.52,67.845,68.49,13014884,13258011.3,43.189250281087475,48.22710264335776,NaN,NaN,-131.34799146488868,-31.802307559855855,-0.03541120717197799,-0.3982389662077708,-0.3628277590357928,1414611411,1411424166.6,48.02524553718762,56.60501163687455,NaN,NaN,-7.63169834634438,-7.435602508699315
2022-07-22T09:30:00-04:00,69.04,69.7,68.88,69.43,9771585,12718084.8,48.87182324874772,47.601724656015946,NaN,NaN,-29.40204823257868,-43.08812261177665,0.009227640797914993,-0.35129320803839903,-0.360520848836314,1424382996,1413302281.4,49.47623529561401,55.86683247004324,NaN,NaN,-6.862592812143796,-7.353743980619955
2022-07-25T09:30:00-04:00,69.32,70.32,69.13,70.3,8645956,12398501.2,53.50711504373104,48.032014964385375,NaN,NaN,41.769445814827925,-35.87555193866802,0.09553084501149961,-0.24110729257193952,-0.33663813758343913,1433028952,1418451804.2,53.32388998643725,55.31656257281231,NaN,NaN,-4.824611302033141,-6.99243931225041
2022-07-26T09:30:00-04:00,70.24,70.9399,70.16,70.72,8967203,12264937.05,55.59985783409659,48.413833544180775,NaN,NaN,122.95836197359833,-12.596058314897757,0.17448862113413138,-0.11852736116577489,-0.2930159822999063,1441996155,1423123208.2,56.55606360213507,54.770308188323774,NaN,NaN,-2.4972360660008373,-6.350267419929042
2022-07-27T09:30:00-04:00,70.39,70.975,70.195,70.78,10342202,12122739.6,55.90521158918022,48.837187095649554,NaN,NaN,113.94798139553092,23.58514989729796,0.2213312743007126,-0.016351889424015553,-0.23768316372472814,1452338357,1433271574.2,62.613012091275145,54.55810645177919,NaN,NaN,-0.49752838045548964,-5.514161842861392
2022-07-28T09:30:00-04:00,72.03,73.47,71.97,73.32,14857768,12107380.55,66.43044320289454,50.08042820656724,NaN,NaN,304.57168404780055,110.76908499983581,0.40335256881192233,0.2665075472901748,-0.13684502152174755,1467196125,1443788517,67.64705190118141,54.7571068009812,NaN,NaN,5.058797086198944,-4.003739138709916
2022-07-29T09:30:00-04:00,73.18,74.26,73.17,73.95,12273787,11777622.65,68.4424924638508,51.32972939300365,NaN,NaN,276.37226636360265,171.92394791907208,0.5377482998523622,0.5353403532937051,-0.0024079465586570037,1479469912,1454805900.2,71.91350810928309,55.41887193105043,NaN,NaN,10.282674502811382,-1.9628229042068734
2022-08-01T09:30:00-04:00,73.72,74.09,73.245,74.03,11574379,11499935.45,68.69904992110818,52.70836693568259,NaN,NaN,223.7116731954119,208.31239339518888,0.5989226518198918,0.7462453682162078,0.14732271639631597,1491044291,1466408968,75.56774020102912,56.376439403863756,NaN,NaN,14.502902479692487,0.38942357920732107
2022-08-02T09:30:00-04:00,74.36,74.79,73.82,73.88,11458286,10971511,67.5894992702525,54.103915484812944,NaN,NaN,187.36493757296728,221.19370851506264,0.5949532727512303,0.8910143073353538,0.29606103458412353,1479586005,1473926938,77.60120099808346,57.84965863456235,NaN,NaN,17.620990831918462,2.851076043880341
2022-08-03T09:30:00-04:00,73.77,74.515,72.62,74.34,10980218,10807567.8,69.2307128161853,55.616693572938495,NaN,NaN,138.8215945979527,226.168431155547,0.5879339025962653,1.0309784128294552,0.4430445102331899,1490566223,1481572511.2,79.47233884143621,59.720233712743116,NaN,NaN,20.746145977603238,5.407514605840754
2022-08-04T09:30:00-04:00,74.38,75.04,74.14,74.5,8664175,10820786.2,69.80348641253156,57.118542329974936,NaN,NaN,137.8758796588927,192.82927027776546,0.5588855046628989,1.1416513910618136,0.5827658863989147,1499230398,1487979365.8,80.91138575408013,61.81430960721672,NaN,NaN,23.50190022323888,7.992426836897629
2022-08-05T09:30:00-04:00,74.3,74.64,73.53,74.23,11025102,11057925.5,67.51934880512738,58.80890718152279,NaN,NaN,103.71298967692762,158.29741494043046,0.488837095353451,1.1938122555907285,0.7049751602372775,1488205296,1489726442.6,81.29643101235428,64.18011617212987,NaN,NaN,25.223801566066307,10.45405179820744
2022-08-08T09:30:00-04:00,74.87,75.22,73.99,74.34,8449462,11149573.45,67.97906808883286,60.343660296732764,NaN,NaN,100.67270504419662,133.6896213101874,0.4198992802100331,1.2298492604998188,0.8099499802897857,1496654758,1490848536,81.55379402191653,66.62278715941486,NaN,NaN,26.79346764326706,12.788254061787384
2022-08-09T09:30:00-04:00,74.57,75.31,74.52,75.17,8107026,11076397.1,71.28194989787963,62.43209349110757,NaN,NaN,101.0269103693403,116.422015869462,0.40026308071047734,1.3102788311778824,0.910015750467405,1504761784,1495883691.8,82.70390138060071,69.19012848090107,NaN,NaN,29.140438542707876,15.124280416204597
2022-08-10T09:30:00-04:00,75.51,75.67,74.95,75.5,7889278,10516881.25,72.49663961872882,64.52547844379623,NaN,NaN,99.29571897599004,108.51684074506946,0.3797364283558551,1.384686285912224,1.004949857556369,1512651062,1500300659.6,83.66600060990919,71.73589670038118,NaN,NaN,31.483066977650214,17.461249924982543
2022-08-11T09:30:00-04:00,75.61,76.25,75.27,75.49,8024160,10444958.45,72.396708678502,66.20582740306439,NaN,NaN,97.3430673591829,100.41027828512749,0.33716419660672736,1.426405103314778,1.0892409067080506,1504626902,1501379960.4,83.90164449628551,74.19485450042914,NaN,NaN,33.404178954181255,19.738811214868072
2022-08-12T09:30:00-04:00,76,76.73,75.85,76.72,7899397,10402817.85,76.65857030969237,67.85950277920449,NaN,NaN,108.42583373910244,101.35284709756245,0.361371367251063,1.5409551157718795,1.1795837485208165,1512526299,1506244161,84.95507826504392,76.45422509175819,NaN,NaN,36.481027316390296,22.13055637222839
2022-08-15T09:30:00-04:00,76.57,77.44,76.43,77.36,7785475,10406537.4,78.51718439156862,69.49645467616678,NaN,NaN,118.15712011010491,104.8497301107441,0.3876895336016868,1.664195665522925,1.2765061319212383,1520311774,1510975564.2,85.9202068160837,78.55166389275452,NaN,NaN,39.7111148977194,24.64206473301282
2022-08-16T09:30:00-04:00,77.19,77.865,77.105,77.58,7788900,10228092.55,79.13230962678978,71.1555331074246,NaN,NaN,122.90087935278908,109.22452390743385,0.38626414772338613,1.759336316575471,1.3730721688520848,1528100674,1515643342.2,86.8185907785216,80.28063379898641,NaN,NaN,42.569862870553735,27.203178752661522
2022-08-17T09:30:00-04:00,77.26,77.785,77.2,77.45,10642958,9908110.05,77.71622440099989,71.96166033586071,NaN,NaN,119.43982283359078,113.253344678954,0.34430780541096473,1.8034569256157909,1.4591491202048261,1517457716,1516604673,87.00252897350846,81.6631678755812,NaN,NaN,44.554364220665896,29.681919533805004
2022-08-18T09:30:00-04:00,77.52,77.98,77.465,77.74,8279460,9671338.85,78.63473295363987,72.68967751370279,NaN,NaN,122.2396166292072,118.23265453295888,0.305165537282893,1.8406060418084422,1.5354405045255493,1525737176,1520826727.8,87.80725363242455,82.79843541294846,NaN,NaN,46.50235709036138,32.08483918474163
2022-08-19T09:30:00-04:00,77.64,78.05,77.35,77.7,8643272,9614923.2,78.15620800532083,73.36518880543227,NaN,NaN,112.03221347288365,118.95393047971511,0.2480836156627706,1.8455450241040126,1.597461408441242,1517093904,1521740248.8,87.98065345994996,83.68507207429994,NaN,NaN,48.00350304645657,34.35893402212948
2022-08-22T09:30:00-04:00,77.33,77.475,76.44,76.64,13226610,9843955.9,66.59138991712325,73.29389528020874,NaN,NaN,73.31266055274504,109.98503856824314,0.11709034560114362,1.7438243404426714,1.6267339948415278,1503867294,1518451352.8,83.38295291918246,84.09805435437843,NaN,NaN,46.065078951544805,36.03124044061739
2022-08-23T09:30:00-04:00,76.5,76.67,75.87,76.18,7873502,9789270.85,62.28423854626422,72.79771854664295,NaN,NaN,42.063190638958986,93.81750082547713,-0.01533851638208561,1.6075608493639209,1.6228993657460065,1495993792,1512029976.4,75.12794185545474,83.7877402839512,NaN,NaN,43.120525752746424,37.04399548520725
2022-08-24T09:30:00-04:00,76.08,76.52,75.8899,76.42,7501140,9647217.75,63.60684270253215,72.35510113878586,NaN,NaN,35.9073497829471,77.1110062153484,-0.09701771554239125,1.5016272213180173,1.5986449368604085,1503494932,1509237419.6,71.79891835239783,83.1368497552596,NaN,NaN,41.01193408444786,37.61084385652733
2022-08-25T09:30:00-04:00,76.6,76.89,76.02,76.89,7300910,9269374.85,66.1130166539633,72.25464884227414,NaN,NaN,45.922924954596596,61.847667880426265,-0.12770706496472606,1.439011105654501,1.566718170619227,1510795842,1506249152.8,68.31068104306415,82.2092961860246,NaN,NaN,39.878960607441705,37.93486053522938
2022-08-26T09:30:00-04:00,76.92,77.175,75.635,75.71,8866203,9098995.65,55.73552472891586,71.3801100308515,NaN,NaN,18.175400312640143,43.07630524837756,-0.22983625306599298,1.2794228542867359,1.5092591073527288,1501929639,1503216299.8,64.86620411527939,81.01732547840766,NaN,NaN,35.50919877011781,37.58833742592773
2022-08-29T09:30:00-04:00,75.32,76.5,74.88,75.94,11238756,9082214.5,57.14745283628503,70.37050309788044,NaN,NaN,-11.42043761271381,26.12968561528579,-0.28088201793607026,1.158156584932641,1.4390386028687112,1513168395,1505076520,65.99867787552381,79.82409522804502,NaN,NaN,32.362557909309956,36.84179749498234
2022-08-30T09:30:00-04:00,75.92,75.98,74.55,74.83,10280511,9023325.75,49.02070727529758,68.69365078763535,NaN,NaN,-58.53343397034216,6.010360693425573,-0.3821092620117652,0.9614020253540048,1.34351128736577,1502887884,1506455338.4,66.85156872014818,78.62306437877638,NaN,NaN,26.82151893107383,35.41032912870969
2022-08-31T09:30:00-04:00,74.87,75.33,74.305,74.34,11006397,9024634.7,45.916529234450685,66.80220939877455,NaN,NaN,-96.31718396668113,-20.434546056500075,-0.4690449298043733,0.7572051251103034,1.2262500549146766,1491881487,1504132649.4,63.941846711272014,77.1973645369897,NaN,NaN,21.219305052398273,33.38303997495092
2022-09-01T09:30:00-04:00,74.05,75.515,74.05,75.41,14080045,9295428.2,52.926495977654504,65.10706123220042,NaN,NaN,-76.54226791522376,-44.92758463046414,-0.44184099926791665,0.6739488058297809,1.1157898050976975,1505961532,1503165787.4,62.71810175839636,75.60900907222916,NaN,NaN,18.606391414908348,31.272090180659124
2022-09-02T09:30:00-04:00,75.6,76.31,74.38,74.6,12768352,9382590.7,47.86840870711855,62.91786296902541,NaN,NaN,-76.84437989632008,-63.93154067225619,-0.4634928177059857,0.5364237829652154,0.9999166006712011,1493193180,1501418495.6,60.46592701155066,73.79084622904823,NaN,NaN,14.685132718218766,28.90252482888193
2022-09-06T09:30:00-04:00,75.02,75.835,74.6,74.79,16450203,9782627.75,49.097282851349966,60.77250391363685,NaN,NaN,-83.49642885868217,-78.34673892144986,-0.44975739130351444,0.4377198615418081,0.8874772528453225,1509643383,1500713493.2,59.53694866343733,71.84215750654221,NaN,NaN,11.982101380516355,26.48532147911542
2022-09-07T09:30:00-04:00,75.15,77.2399,75.07,77.13,15754860,10165019.45,61.221301459936264,59.5942951321323,NaN,NaN,21.999693966999452,-62.240113333981526,-0.2763288938692601,0.5420661355087475,0.8183950293780076,1525398243,1505215565,63.403638124269534,70.15652244588229,NaN,NaN,13.876304805630848,24.684033382903337
2022-09-08T09:30:00-04:00,76.84,77.5771,76.66,77.07,12575330,10399322.05,60.82128185705975,58.32190576809087,NaN,NaN,67.13929049096136,-29.548818442453033,-0.16443186541136845,0.612855197613797,0.7772870630251655,1512822913,1509403850.2,66.60120728501086,68.64180484963846,NaN,NaN,15.157960129222586,23.323165775234656
2022-09-09T09:30:00-04:00,77.53,77.82,76.85,77.38,10590700,10527649.05,62.19568828899095,57.18186864549589,NaN,NaN,79.62633938869813,1.6849030183313403,-0.07298008768307984,0.6860619534213157,0.7590420411043955,1523413613,1512894266.4,69.02978448112987,67.2881713511513,NaN,NaN,16.625958260154977,22.366421844508988
2022-09-12T09:30:00-04:00,77.59,78.22,77.35,78.12,11340293,10699693.85,65.32293403356623,57.09126465381324,NaN,NaN,109.78394509523267,39.01056801664189,0.028470881496558187,0.7946306429750933,0.7661597614785352,1534753906,1521206411.6,73.8974872325225,66.61063808781844,NaN,NaN,18.88899591766135,21.86964671210218
2022-09-13T09:30:00-04:00,77.33,77.65,75.67,76.04,17578088,11189324.5,52.24156609705289,56.37393090744099,NaN,NaN,1.9900670258399213,56.107867193546305,-0.04915978014659128,0.704710036295296,0.7538698164418873,1517175818,1522712898.6,74.67440739003132,66.57824276885962,NaN,NaN,16.234613081694157,21.064641907758176
2022-09-14T09:30:00-04:00,76.07,77.09,75.99,76.66,11148721,11357315.55,55.12621660326525,55.76817190035051,NaN,NaN,16.505047161775284,55.008937832501466,-0.0625460736491924,0.6756872243803969,0.7382332980295893,1528324539,1523298157.8,74.98589911524655,66.80588425192025,NaN,NaN,15.153595026968366,20.22020663907392
2022-09-15T09:30:00-04:00,76.05,76.05,74.56,74.75,18054991,11727917.2,45.92370443334324,54.32607817030622,NaN,NaN,-93.84977461287558,22.81112481173408,-0.19627964450138902,0.49288374240285293,0.689163386904242,1510269548,1522787484.8,74.12914691073665,67.221488956754,NaN,NaN,10.734765211853228,18.865143578042392
2022-09-16T09:30:00-04:00,74.48,75.05,74.34,74.47,16111225,12119505.45,44.74447852678256,53.541003441582404,NaN,NaN,-117.97054545300915,-16.70825215660738,-0.29396386947788733,0.3217085500568828,0.6156724195347701,1494158323,1516936426.8,64.9698214638246,67.2288901959358,NaN,NaN,6.970979043494004,17.165977215964052
2022-09-19T09:30:00-04:00,73.74,74.97,73.54,74.96,10731447,12223914.2,47.29503172827105,52.837259076724266,NaN,NaN,-113.21699599479953,-61.30844037461382,-0.3141226901016656,0.2230190569076882,0.5371417470093538,1504889770,1510963599.6,57.2001621087028,66.60042478402002,NaN,NaN,4.836880180429881,15.40467763945917
2022-09-20T09:30:00-04:00,74.47,74.47,73.335,73.87,11704192,12147793.3,42.58591174513328,52.37763082456967,NaN,NaN,-138.88184168109035,-89.48282211599988,-0.38474929018653636,0.056205134276183344,0.4409544244627197,1493185578,1506165551.6,51.83723991819148,65.52797272673739,NaN,NaN,1.440716864771258,13.409826100218039
2022-09-21T09:30:00-04:00,74.35,74.85,72.83,72.86,15230571,12515646.75,38.73706590455371,51.864812015291314,NaN,NaN,-142.54216057292405,-121.29226366293975,-0.47732341906835457,-0.15569984937272352,0.32162356969563105,1477955007,1496091645.2,42.77023452000312,64.01571471307533,NaN,NaN,-2.698105359839603,11.108693034495518
2022-09-22T09:30:00-04:00,72.8,73.09,72.22,72.6,17350354,13008107.45,37.790217151055174,50.783649241962785,NaN,NaN,-171.16242965262987,-136.7547946708906,-0.529849780510437,-0.34068865594241515,0.18916112456802178,1460604653,1486158666.2,36.07072295647864,62.11233051293834,NaN,NaN,-6.263496210321705,8.626951713807344
2022-09-23T09:30:00-04:00,71.89,71.99,70.84,71.76,16210300,13453576.95,34.828275606426075,49.8522111633419,NaN,NaN,-205.6276334058137,-154.2862122614515,-0.5903280686998569,-0.5487489613067993,0.04157910739305756,1444394353,1476205872.2,30.85538290100159,59.997291647899125,NaN,NaN,-10.213675635598117,5.935433521035136
2022-09-26T09:30:00-04:00,71.58,71.67,69.3287,70.03,17969497,13908741.65,29.670388531328427,48.46457585476893,NaN,NaN,-221.7992939230159,-176.00267184709477,-0.7080723424356129,-0.8435113206514586,-0.1354389782158457,1426424856,1460512889.4,24.77324965569227,57.51417029020305,NaN,NaN,-15.519231914150744,2.8704813160085814
2022-09-27T09:30:00-04:00,70.49,70.6,68.51,68.85,19143029,14303955.3,26.759422235943333,46.00301305305514,NaN,NaN,-212.97967807318085,-190.82223912551288,-0.8188239218964661,-1.1589688805864284,-0.3401449586899623,1407281827,1443332139.2,20.101541877853506,54.42116341545904,NaN,NaN,-20.96292831960789,-0.5342914890794859
2022-09-28T09:30:00-04:00,69.65,70.017,68.74,69.59,22941309,14936995.2,31.310740185859885,43.89511721939801,NaN,NaN,-165.7998699939467,-195.4737810097174,-0.7949906553742034,-1.3338832779077165,-0.5388926225335131,1430223136,1433785765,18.0632364093061,50.95416549576584,NaN,NaN,-23.845941909583093,-3.864527263437144
2022-09-29T09:30:00-04:00,69.23,69.39,66.655,66.8,20330971,15403223.9,25.002293579758472,41.23844616873855,NaN,NaN,-180.3249983680373,-197.30629475279892,-0.9115160027078533,-1.6782876259183297,-0.7667716232104764,1409892165,1423643267.4,16.185412695320395,47.17956751106517,NaN,NaN,-28.8648031598443,-7.435995248638166
2022-09-30T09:30:00-04:00,67.12,67.38,65.37,65.51,22776486,15838045.95,22.722691427370933,38.195571696867454,NaN,NaN,-178.77406499382164,-191.93558107040047,-1.0121029336745302,-2.031900290303639,-1.019797356629109,1387115679,1412187532.6,14.36850242506847,42.9274971676756,NaN,NaN,-33.73031964634903,-11.192327305454004
2022-10-03T09:30:00-04:00,66.58,67.795,66.12,67.43,25446957,16471976.2,32.57615519569002,36.79089948962724,NaN,NaN,-129.54536339050338,-173.484794963898,-0.8902655527396093,-2.1326292975536205,-1.2423637448140112,1412562636,1409415088.6,13.960068537912647,38.59075867823855,NaN,NaN,-34.08739627470481,-14.463051443918404
2022-10-04T09:30:00-04:00,67.9,68.92,67.48,68.86,16996514,16499291.75,38.83193129694663,35.627021967747346,NaN,NaN,-89.33561391980317,-148.75598213322246,-0.6646453990088526,-2.073170493575077,-1.4085250945662244,1429559150,1413870553.2,17.99437426684277,34.51993547478113,NaN,NaN,-32.049466043785046,-16.975396386756497
2022-10-05T09:30:00-04:00,67.98,67.98,66.575,67.33,17205726,16571835.05,35.081463336947905,34.85257617514768,NaN,NaN,-99.24386822917151,-135.44478178026742,-0.5731890187662811,-2.125011368024076,-1.5518223492577947,1412353424,1410296610.8,17.29388644559802,30.460274012985515,NaN,NaN,-31.755386954921395,-19.086823610780055
2022-10-06T09:30:00-04:00,67.04,67.15,65.04,65.11,25671039,17226620.5,30.48127304308528,33.83377578345502,NaN,NaN,-115.07550882845119,-122.39488387235022,-0.6133459614549188,-2.3185048010764433,-1.7051588396215245,1386682385,1405654654.8,16.400851623751976,26.99106188155176,NaN,NaN,-33.21876582229002,-21.10567249813862
2022-10-07T09:30:00-04:00,64.92,65.16,63.32,63.76,21083381,17751254.55,28.07071778175319,32.460610501560886,NaN,NaN,-131.59186858958063,-112.95844459150199,-0.6769711848564559,-2.5513728206920945,-1.8744016358356386,1365599004,1401351319.8,15.596771512588106,24.019391124686425,NaN,NaN,-35.25286992087387,-23.12670070138651
2022-10-10T09:30:00-04:00,63.89,64.63,63.775,63.87,16517775,18010128.65,28.56643036559244,31.459218974450827,NaN,NaN,-120.39274879694285,-111.12792167278988,-0.6572537891650319,-2.695968872291928,-2.0387150831268963,1382116779,1395262148.4,14.512558465218817,21.353342449474095,NaN,NaN,-36.62144133112879,-25.054520791349695
2022-10-11T09:30:00-04:00,63.63,64.47,63.3,63.64,17160126,17989230.55,28.129902196712592,30.70156442389075,NaN,NaN,-115.22003478380545,-116.30480584559034,-0.6065324642682803,-2.7968806634622467,-2.1903481991939664,1364956653,1382341649,12.523247534519982,19.19284337908244,NaN,NaN,-37.83119898897795,-26.87976053386802
2022-10-12T09:30:00-04:00,63.54,63.66,61.48,61.52,20916475,18477618.25,24.424949394584615,29.74690244128571,NaN,NaN,-133.4955010871542,-123.15513241718686,-0.65827034729609,-3.013186133314079,-2.354915786017989,1344040178,1368678999.8,10.832335248030546,17.390101399907575,NaN,NaN,-40.12317070147985,-28.77167627209828
2022-10-13T09:30:00-04:00,60.59,63.31,60.35,63.06,30714907,19110614.05,31.48443775994484,29.50805688082276,NaN,NaN,-121.45641205156997,-124.43131306181063,-0.536442510716638,-3.0254689244137865,-2.4890264136971485,1374755085,1366293539.8,10.564134526285912,15.94072651599931,NaN,NaN,-39.698191240487375,-30.33260698186815
2022-10-14T09:30:00-04:00,63.71,64.17,61.835,62.15,19652926,19287699.1,29.717917941231548,29.51145183867299,NaN,NaN,-102.94144417783717,-118.70122817946194,-0.46734407547875056,-3.073206508045587,-2.6058624325668363,1355102159,1364194170.8,10.32192028454844,14.908488703774749,NaN,NaN,-39.91963996889423,-31.702183122871876
2022-10-17T09:30:00-04:00,63,64.05,63,63.45,14123718,19457312.65,35.30257147151781,30.121676784071166,NaN,NaN,-80.81736393488433,-110.78615120705021,-0.2928154528993798,-2.971881748691061,-2.679066295791681,1369225877,1361615990.4,10.018138323085111,14.188245592719861,NaN,NaN,-38.29287114650119,-32.64370998339035
2022-10-18T09:30:00-04:00,64.71,64.955,63.97,64.61,16041900,19674198.05,39.89224155835423,30.734641167820765,NaN,NaN,-52.70014090579358,-98.28217243144786,-0.06962139749385043,-2.7660930426589942,-2.696471645165144,1385267777,1365678215.2,14.297981597094122,13.919298820419007,NaN,NaN,-35.45932873158886,-33.04594123313299
2022-10-19T09:30:00-04:00,63.77,64.2,63.215,63.77,12843411,19554840.05,37.80100220090767,31.64883464075999,NaN,NaN,-64.5278741778832,-84.48864704959365,0.044898360818499405,-2.64034869414202,-2.685247054960519,1372424366,1371355052.8,20.022856246118067,14.193401931190266,NaN,NaN,-33.77582807188293,-33.15021078152584
2022-10-20T09:30:00-04:00,63.79,63.79,61.86,62.16,15518350,19463239.85,34.11012276157375,32.46222259320305,NaN,NaN,-86.59957880675515,-77.5172804006307,0.036057926532264695,-2.640174646795188,-2.676232573327453,1356906016,1367785239,19.156274073082855,14.535385620334148,NaN,NaN,-33.49195853570839,-33.19903188926621
2022-10-21T09:30:00-04:00,62.39,63.78,61.96,63.31,15543750,19429912.35,38.713218499248356,32.900584257742935,NaN,NaN,-69.4404429769789,-70.81708016045904,0.1264157124111298,-2.5182129328135403,-2.64462864522467,1372449766,1371254760.4,22.659741086534027,15.156790802378534,NaN,NaN,-31.794662204268914,-32.99840764855231
2022-10-24T09:30:00-04:00,63.65,64.34,63.145,63.84,10030535,19032964.25,40.76701605784867,33.03880459780736,NaN,NaN,-41.99039007046122,-63.05168538757442,0.23435723790886342,-2.351682097838591,-2.5860393357474543,1382480301,1373905645.2,25.32259237242799,15.680234952777473,NaN,NaN,-29.78728921122819,-32.539676443220294
2022-10-25T09:30:00-04:00,64.05,65.285,63.9,65.12,14201795,18785902.55,45.51577756732361,33.784112757119914,NaN,NaN,-2.6817021096641676,-53.04799762834854,0.3949905379270007,-2.0923011633387034,-2.487291701265704,1396682096,1376188509,27.633345846520342,16.418767767129072,NaN,NaN,-26.60160990478733,-31.691381223444157
2022-10-26T09:30:00-04:00,65.47,65.8,64.81,65.09,13534606,18315567.4,45.4238603736436,34.851440423588365,NaN,NaN,26.375362128954137,-34.867350366981064,0.49572795544889914,-1.8676317569545802,-2.3633597124034793,1383147490,1378333133.8,29.830049916288928,17.377996216595996,NaN,NaN,-24.07844416589362,-30.603818786651225
2022-10-27T09:30:00-04:00,65.56,66.35,65.42,65.61,12257304,17911884.05,47.40645536288182,36.23256453652613,NaN,NaN,59.03798659296771,-5.739837287036494,0.587612823124823,-1.6288436834974505,-2.2164565066222734,1395404794,1386032889.4,37.20058410833921,18.92112568772108,NaN,NaN,-21.397269838499863,-29.288597508343887
2022-10-28T09:30:00-04:00,65.88,67.55,65.79,67.41,13592892,17452704.35,53.67924426266989,38.02633695774595,NaN,NaN,106.19797465669879,29.387846239699048,0.7494796486644257,-1.2796069457917412,-2.029086594456167,1408997686,1393342473.4,43.290407886232224,20.976686360650604,NaN,NaN,-17.073349250894815,-27.54356204299402
2022-10-31T09:30:00-04:00,67.24,67.52,66.3775,66.78,10894801,16725096.55,51.36989491727034,39.68633643778578,NaN,NaN,106.57517074270685,59.100958402332665,0.7899393443497327,-1.041662414019001,-1.8316017583687336,1398102885,1396466990.2,45.71374530039866,23.347436201070508,NaN,NaN,-14.129123607915558,-25.62721369512567
2022-11-01T09:30:00-04:00,67.18,67.43,66.51,67.04,10739673,16412254.5,52.28228460307494,41.676146095535096,NaN,NaN,121.50697615925336,83.93869405611616,0.8071797282286977,-0.8226270980828616,-1.6298068263115593,1408842558,1398899082.6,47.591091503337154,25.973061647878122,NaN,NaN,-11.443430636523521,-23.60095897246822
2022-11-02T09:30:00-04:00,66.82,68.21,66.365,66.39,21340346,16618985.5,49.76835486092136,42.98214017417627,NaN,NaN,123.53148357510332,103.36991834534601,0.7490491279385603,-0.6934954163883589,-1.4425445443269191,1387502212,1399770027,48.28085603762065,28.667113184402034,NaN,NaN,-9.842840316817233,-21.635513450232366
2022-11-03T09:30:00-04:00,65.76,67.27,65.4,66.68,14328191,16051843.1,50.90264970607739,44.49533530023668,NaN,NaN,92.70667289891358,110.10365560653517,0.7050061265822802,-0.5612868860990687,-1.266293012681349,1401830403,1401055148.8,49.34034519067031,31.45414353483931,NaN,NaN,-8.19189384797499,-19.7149963641956
2022-11-04T09:30:00-04:00,66.82,67.36,65.921,67.09,12149193,15605133.7,52.53456119080612,45.72619170875728,NaN,NaN,95.29931407056723,107.92392348930886,0.6781530343118594,-0.41860171979152483,-1.0967547541033842,1413979596,1402051530.8,50.19228337728683,34.32372532442515,NaN,NaN,-6.3462626058677,-17.805177255863043
2022-11-07T09:30:00-05:00,66.96,67.07,64.765,65.81,14296399,15494064.9,47.25391427756818,46.25202547441542,NaN,NaN,49.706796261083944,96.55024859298427,0.5540844277087311,-0.4041492194674703,-0.9582336471762014,1399683197,1402367593.2,50.47678603285578,36.907925641265265,NaN,NaN,-6.139586437273515,-16.138664281778826
2022-11-08T09:30:00-05:00,65.9,66.68,65.69,66.27,12413944,15256755.8,49.2290189719058,47.06831238662958,NaN,NaN,58.00053997900809,83.84896135693523,0.48536676602335616,-0.3515251896470062,-0.8368919556703623,1412097141,1403018509.8,51.096324659530104,39.12745909936613,NaN,NaN,-5.424179156255341,-14.608023549561185
2022-11-09T09:30:00-05:00,66,66.505,65.62,65.75,12890858,14855474.95,47.08271334911522,47.994926000025394,NaN,NaN,41.60651781958997,67.46396820583257,0.39129673808185594,-0.34777103306804236,-0.7390677711498983,1399206283,1405359324,53.35617661205614,41.57030928072136,NaN,NaN,-5.396299296306118,-13.292062941953319
2022-11-10T09:30:00-05:00,67.73,68.975,66.73,68.85,17915188,14215489,58.655358696174,49.419364585520086,NaN,NaN,132.749023016083,75.47243822926644,0.516395743038669,-0.09357309235156208,-0.6099688353902311,1417121471,1408417537.6,56.203664086615646,43.96630378072719,NaN,NaN,-1.6722032053625973,-11.632082979583215
2022-11-11T09:30:00-05:00,68.85,69.03,67.4339,68.08,15312147,13998450.05,55.41370949888349,50.46555697416543,NaN,NaN,123.64043104729565,81.14066162461214,0.5241564259213967,0.045226697011514716,-0.4789297289098819,1401809324,1405983483.2,53.40900207260051,45.972475902168085,NaN,NaN,0.3863434898165627,-9.915164912526103
2022-11-14T09:30:00-05:00,68.12,68.49,67.24,67.27,10245526,13804540.45,52.148725934453296,50.939339000388976,NaN,NaN,92.97117258102944,89.79353688860124,0.45421752885518396,0.08884218215909812,-0.36537534669608585,1391563798,1404359603.4,51.56677599866479,47.68200662732126,NaN,NaN,1.090391347125966,-8.342942589718666
2022-11-15T09:30:00-05:00,67.98,68.48,67.19,68.01,13620997,13683495.3,54.7706237317978,51.606964954542846,NaN,NaN,95.73094809660712,97.33961851212105,0.4371264782110888,0.18103275106777517,-0.25609372714331363,1405184795,1402977134.2,49.98602546961111,49.12171916684427,NaN,NaN,2.4744810694895194,-6.797596352688926
2022-11-16T09:30:00-05:00,68.04,68.97,68.04,68.62,13231319,13702890.7,56.86859095079876,52.2828317822512,NaN,NaN,119.25800702511351,112.86991635322575,0.4447627790261245,0.299859746639342,-0.14490303238678248,1418416114,1406819100.4,54.18890363200064,50.335170561391514,NaN,NaN,4.2532100143432885,-5.218909728827181
2022-11-17T09:30:00-05:00,67.87,68.06,67.09,67.42,11623688,13508157.6,51.780227249637335,52.14718770989173,NaN,NaN,61.588631333702345,98.63783801674963,0.3509737213305841,0.2938141192764476,-0.05715960205413645,1406792426,1404753291.4,51.67440046426528,50.93402717410816,NaN,NaN,4.2475256787686675,-3.8665618134563453
2022-11-18T09:30:00-05:00,68.05,68.92,68.02,68.85,11741523,13318046.25,56.74686765089161,52.53125719086468,NaN,NaN,122.0006278065075,98.30987736859197,0.3655703069746506,0.3998032816641768,0.0342329746895262,1418533949,1408098216.4,55.29190350651625,51.61818133168799,NaN,NaN,5.794736549605616,-2.4863763330189226
2022-11-21T09:30:00-05:00,68.74,69.365,68.69,69.16,11438614,13388450.2,57.762521870876505,52.92270270999337,NaN,NaN,144.31840453282433,108.57932375895095,0.3750267447933343,0.5030164056811941,0.1279896608878598,1429972563,1415779969.4,62.27597010866754,52.66710123206873,NaN,NaN,7.351934292055019,-1.0809033865797881
2022-11-22T09:30:00-05:00,69.49,70.18,69.305,69.75,7452793,13051000.1,59.702008182168406,53.63224937579673,NaN,NaN,165.87840954794348,122.60881604921822,0.39777989949723436,0.6252145352594027,0.22743463576216838,1437425356,1422228081.6,66.94396039182752,54.00018011451208,NaN,NaN,9.226194500733486,0.3915391687506795
2022-11-23T09:30:00-05:00,69.55,70.56,69.55,70.53,7166774,12732608.5,62.17485179467992,54.43740666783977,NaN,NaN,172.79508646631544,133.3162319374586,0.4388931560490139,0.7760510808234358,0.33715792477442186,1444592130,1427463284.8,70.17121391366128,55.48809930901143,NaN,NaN,11.552116420800715,1.9859073476149702
2022-11-25T09:30:00-05:00,70.79,71.16,70.74,70.94,4491483,12344317.45,63.44465966986035,55.216699416343644,NaN,NaN,186.1233462900727,158.22317492873267,0.46474608200573614,0.918090527281592,0.4533444452758559,1449083613,1435921522.2,74.50244888473827,57.224539702400826,NaN,NaN,13.856678625399423,3.6817318158698917
2022-11-28T09:30:00-05:00,70.45,70.72,69.91,70.21,9131974,12121271.55,59.60773158470921,56.09911493828229,NaN,NaN,127.21489801606482,159.26602897064413,0.4058674882071307,0.9606788055347693,0.5548113173276386,1439951639,1440205060.2,76.37348938348224,59.07430422744557,NaN,NaN,14.741120117654969,5.261644430410617
2022-11-29T09:30:00-05:00,69.78,69.84,69.28,69.69,9502405,12051651.75,56.96494882075043,56.651681356056905,NaN,NaN,80.88650265452324,146.57964859498392,0.30944398782492777,0.9416163021087982,0.6321723142838704,1430449234,1440300394.4,76.41497064197956,60.88277894047768,NaN,NaN,14.74181937648759,6.615955136993042
2022-11-30T09:30:00-05:00,69.56,71.58,69.49,71.43,16473161,12338326.15,62.89339263001505,57.7810155904069,NaN,NaN,127.79484083632005,138.96293485265923,0.3380653813697394,1.0547540409960448,0.7166886596263053,1446922395,1442199802.2,77.2711865192314,62.590993933847344,NaN,NaN,16.533490277829166,8.032745871398202
2022-12-01T09:30:00-05:00,72.13,72.51,71.185,71.37,15353131,12038965.4,62.57328646741958,58.060867574067295,NaN,NaN,147.1051750678458,133.8249525729653,0.3279197969020812,1.1265884057539068,0.7986686088518257,1431569264,1439595229,73.33942308964612,63.81497671977809,NaN,NaN,17.88570926185068,9.44031207003427
2022-12-02T09:30:00-05:00,70.61,71.215,70.32,71.03,10354316,11840271.65,60.68830800504451,58.43762461022165,NaN,NaN,96.63935007146166,115.9281533292431,0.27539132854251513,1.1429077695299696,0.8675164409874545,1421214948,1434021496,65.64199173503607,64.68876169566634,NaN,NaN,18.48860633376042,10.732925536280863
2022-12-05T09:30:00-05:00,70.49,70.9,70.36,70.63,11451526,11805388.3,58.45719703292367,58.888229688683815,NaN,NaN,77.7687668266195,106.03892709135403,0.1945949863902372,1.110760173975251,0.9161651875850139,1409763422,1427983852.6,58.48164729764553,65.18268107416496,NaN,NaN,18.38276282820843,11.825759435127658
2022-12-06T09:30:00-05:00,70.53,71.11,70.261,71.07,12824769,11731806.8,60.190904505495475,59.27539260109079,NaN,NaN,78.80197438768315,105.62202143798602,0.15347968261999778,1.108014790860011,0.9545351082400133,1422588191,1426411644,56.74579316927889,65.66552162414123,NaN,NaN,18.76010371950343,12.81638004718134
2022-12-07T09:30:00-05:00,71.13,71.61,70.48,70.74,14148963,11818557.75,58.22818068631628,59.372506153627754,NaN,NaN,78.35801733711195,95.7346567381444,0.08990160473957398,1.0669121141644808,0.9770105094249069,1408439228,1418715010.6,49.06752771135423,65.29970905838078,NaN,NaN,18.553180629355865,13.635922987491986
2022-12-08T09:30:00-05:00,70.75,71.46,70.49,71.2,9960058,11672017.75,60.177510413940375,59.97231209393511,NaN,NaN,78.99593168117909,82.11280806081103,0.0657882135969492,1.0592457764210934,0.9934575628241442,1418399286,1416081015,46.73682140185196,64.94702483963697,NaN,NaN,18.88995798704715,14.386499415999866
2022-12-09T09:30:00-05:00,70.95,71.45,70.76,70.83,11918637,11372190.2,57.8394556059289,60.05035409072349,NaN,NaN,70.5844407970592,76.90182620593055,0.014555981737706114,1.0116525399962768,0.9970965582585707,1406480649,1413134155.2,44.20686958358228,64.15523670228455,NaN,NaN,18.55737675497932,14.982339035854073
2022-12-12T09:30:00-05:00,71.21,72.47,70.945,72.45,11381915,11175678.6,64.36726675020333,60.52212158210396,NaN,NaN,115.70780888118128,84.4896346168429,0.07597583911822747,1.0920663571563551,1.0160905180381277,1417862564,1414753983.6,45.9391962638218,62.98832428479557,NaN,NaN,20.13948703376239,15.71907446412669
2022-12-13T09:30:00-05:00,73.47,73.79,71.875,72.67,13694210,11348112.8,65.15626923391704,60.911711657228864,NaN,NaN,156.12938136269807,99.95511601184589,0.11526621953479332,1.1601732924566193,1.044907072921826,1431556774,1416547700.2,47.86943487836505,61.6258581766911,NaN,NaN,21.672926852020254,16.569624805254342
2022-12-14T09:30:00-05:00,72.92,73.695,72.05,72.58,13318723,11332999.1,64.52680091069476,61.0797080226585,NaN,NaN,146.7548112993176,113.63447480428704,0.11858041503010464,1.1931325917094568,1.0745521766793522,1418238051,1418507464.8,49.97119615019146,60.18299976501469,NaN,NaN,22.772613473904965,17.455766043633
2022-12-15T09:30:00-05:00,72.3,72.42,71.36,71.7,13154293,11329147.8,58.568696926107485,60.73142496953329,NaN,NaN,81.27521970970923,114.09033240999307,0.04848547601883024,1.13515902170289,1.0866735456840597,1405083758,1415844359.2,47.18710500808283,58.23190377382502,NaN,NaN,22.074576073761165,18.115596047937025
2022-12-16T09:30:00-05:00,71.16,71.16,69.6,70.48,19631707,11729548.75,51.472795961893254,60.15035813933215,NaN,NaN,-32.934097874892565,93.38662467560269,-0.08575490770600336,0.9794799110515555,1.0652348187575589,1385452051,1411638639.6,43.10290626525466,55.855433551094485,NaN,NaN,19.289519756061843,18.283299434811997
2022-12-19T09:30:00-05:00,69.55,70.3,69.18,69.63,9832285,11634086.85,47.183591423876386,59.451689753841144,NaN,NaN,-105.86982856723421,49.071097185919605,-0.22935532234331424,0.778540665828416,1.0078959881717302,1375619766,1403190080,36.304975688884575,52.990433911587694,NaN,NaN,15.551102841556391,17.89298563577548
2022-12-20T09:30:00-05:00,69.59,70.03,69.14,69.65,7982036,11461257.95,47.294879225526785,58.33751022494913,NaN,NaN,-121.21341556501181,-6.3974621996223675,-0.31525053730411334,0.6138328165415885,0.9290833538457018,1383601802,1393599085.6,30.436440866903325,49.6450949364214,NaN,NaN,12.571723145767564,17.132805280060065
2022-12-21T09:30:00-05:00,70.07,70.645,69.84,70.62,8242364,11500736.5,52.52021131093341,57.619433428057256,NaN,NaN,-54.0328553903113,-46.55499553754815,-0.2991291815698932,0.5551718768833354,0.8543010584532286,1391844166,1388320308.6,27.77525084051757,46.39051120434079,NaN,NaN,11.460858223388023,16.322527129106916
2022-12-22T09:30:00-05:00,70.51,70.51,69.03,70.19,7051952,11494995.4,50.14673370313897,56.866463835064,NaN,NaN,-95.9062854060321,-81.99129656069643,-0.30857387725261354,0.4685837118874616,0.7771575891400752,1384792214,1384261999.8,25.90032662078707,43.55182083903729,NaN,NaN,9.829303392907907,15.394923738221344
2022-12-23T09:30:00-05:00,70.06,70.955,70.05,70.91,5674747,11554158.6,53.90318944001128,56.5411775784274,NaN,NaN,-23.57083069767038,-80.11864312525199,-0.2594541564377898,0.45283989359283794,0.7122940500306277,1390466961,1385264981.8,27.20812669650661,41.31799793895594,NaN,NaN,9.52315014120446,14.556098938647503
2022-12-27T09:30:00-05:00,71.07,71.5,70.62,71.35,6105651,11402842.45,56.08110446720668,56.24762043283534,NaN,NaN,22.297772986752197,-54.48512281445471,-0.1934799282394516,0.47044413973131327,0.6639240679707649,1396572612,1389455551,32.56344171774755,39.590687120989415,NaN,NaN,9.900710544575482,13.891043453780071
2022-12-28T09:30:00-05:00,71.51,71.81,70.555,70.67,7215662,11288505.3,51.99270444743418,55.8022292729152,NaN,NaN,1.398560493057104,-29.962727602840932,-0.19143490298094723,0.42463043924458077,0.616065342225528,1389356950,1390606580.6,33.999744178356934,38.514416868632466,NaN,NaN,9.023277301136204,13.195648289116662
2022-12-29T09:30:00-05:00,71.02,71.5756,70.97,71.18,5777647,10753729.6,54.66228133463064,55.40828433867879,NaN,NaN,23.513928971246905,-14.453370730529286,-0.15318732840375104,0.42458118172083914,0.5777685101245902,1395134597,1391264666.8,34.85406075274547,37.66564825083915,NaN,NaN,9.057161089367067,12.604435832009576
2022-12-30T09:30:00-05:00,71.11,71.23,69.84,70.5,7350107,10353578.4,50.62039460316609,54.89263712419572,NaN,NaN,-47.31571795781931,-4.735257240886726,-0.16984757336894474,0.3654590434134093,0.535306616782354,1387784490,1391863122,35.6695594716345,37.05584038570002,NaN,NaN,7.890675679762328,11.931041524545684
2023-01-03T09:30:00-05:00,70.7,70.94,69.5371,70.5,12887119,10480218.55,50.62039460316609,53.91071768512164,NaN,NaN,-63.29359249388065,-12.679809600128776,-0.17626648993890842,0.3149735043587185,0.49123999429762694,1387784490,1391326627.8,35.24363296087121,36.29187157834641,NaN,NaN,6.944005450024441,11.218607799614077
2023-01-04T09:30:00-05:00,70.82,71.775,70.705,71.14,10436349,10429459.7,54.308255672666625,53.135859573603746,NaN,NaN,25.43679436141624,-12.052005325195967,-0.13468479823596718,0.32288399650266797,0.45756879473863515,1398220839,1391656273.2,35.75128721491021,35.426289602385346,NaN,NaN,7.160509200488074,10.638879428310362
2023-01-05T09:30:00-05:00,70.6,70.87,69.385,69.6,9786430,10277542.75,45.502143339321975,51.77695546136283,NaN,NaN,-94.39015171177614,-31.209747766162593,-0.20401256940684864,0.20255308298007435,0.406565652386923,1388434409,1391471765,35.58314251229281,34.39857148539259,NaN,NaN,4.599171366437209,9.776063990899912
2023-01-06T09:30:00-05:00,70.39,71.34,70.29,71,9810287,10060608.95,52.96835851476503,51.37693128912407,NaN,NaN,-3.8898284805805763,-36.69049925652809,-0.15113304937306626,0.21764934067059016,0.3687823900436564,1398244696,1392093784.8,36.66460438940153,33.64696429834392,NaN,NaN,4.789155406388796,9.063648478826895
2023-01-09T09:30:00-05:00,70.99,72.02,70.78,71.48,11719360,10148574.05,55.232888314261515,51.645509314293236,NaN,NaN,46.53380226650975,-17.920595211662278,-0.08279618650197518,0.2652871569161874,0.3480833434181626,1409964056,1396529698,43.898167000061456,33.70376863654441,NaN,NaN,5.676419223942957,8.579758585272046
2023-01-10T09:30:00-05:00,71.29,71.54,70.66,71.5,8607476,9983016,55.329400716135815,52.22735283516891,NaN,NaN,26.758232575852396,0.08976980228433291,-0.037520707971096356,0.30118245845429215,0.3387031664253885,1418571532,1402687106.4,52.079542350836334,34.83052339811239,NaN,NaN,6.406329178441828,8.269268670010586
2023-01-11T09:30:00-05:00,71.5,72.18,71.49,72.08,10685922,9948216.35,58.147328837987054,53.0025278074875,NaN,NaN,90.91940719610477,13.18629236922204,0.026750335250847912,0.3721410854889484,0.3453907502381005,1429257454,1408894429.4,58.629403817842366,36.844306466036606,NaN,NaN,7.876549754419146,8.213165967783237
2023-01-12T09:30:00-05:00,72.17,72.27,71.53,71.59,12898878,9908449.75,54.991204291902605,53.179027306128155,NaN,NaN,90.51991914321714,50.16830654022069,0.031212366417374404,0.3844062082598185,0.3531938418424441,1416358576,1414479262.8,63.467565060539286,39.39375748175245,NaN,NaN,8.183509860799127,8.20892938107122
2023-01-13T09:30:00-05:00,71.29,71.57,70.8,71.33,11896793,9837353.25,53.336904843033864,53.406896673263496,NaN,NaN,46.69205752297423,60.284683740931655,0.01256028385515412,0.3688941966613868,0.35633391280623267,1404461783,1415722680.2,64.46399900452492,42.14830550916223,NaN,NaN,7.9623644074577244,8.17370581341215
2023-01-17T09:30:00-05:00,71.38,71.89,71.11,71.23,9765234,9667900.3,52.68048456196778,53.31956061054611,NaN,NaN,71.1676388299411,65.21145105361794,-0.009419305625201768,0.3445597807747305,0.35397908639993225,1394696549,1412669178.8,60.12685121362579,44.499642974670735,NaN,NaN,7.598383576754358,8.091516922461038
2023-01-18T09:30:00-05:00,71.54,71.54,69.43,69.52,14510234,9411826.65,42.94700982074412,52.381410992941646,NaN,NaN,-70.55238423792295,45.749327690862856,-0.1350572758207938,0.18515749162394002,0.3202147674447338,1380186315,1404992135.4,50.861593637015325,45.80665382604701,NaN,NaN,4.188249250912833,7.5339072550970085
2023-01-19T09:30:00-05:00,69.49,69.56,68.65,68.82,14196975,9630061.15,39.71233807397317,51.50424196626586,NaN,NaN,-185.46117533202906,-9.52678881476391,-0.2543164975408859,0.002319145518626442,0.25663564305951236,1365989340,1392338512.6,39.93769613456369,46.230793251490354,NaN,NaN,0.27330262821407086,6.496678022685161
2023-01-20T09:30:00-05:00,68.78,69.255,67.84,69.23,13310481,9896483.4,42.44659190781374,50.631692721493216,NaN,NaN,-192.03177300908092,-66.03712724522352,-0.2919086322458965,-0.10825014724785831,0.18365848499803822,1379299821,1384926761.6,35.17249294418207,46.253538408021534,NaN,NaN,-2.128468569827605,5.264514223754766
2023-01-23T09:30:00-05:00,68.99,69.92,68.69,69.25,9826438,9975687.1,42.583389596899444,50.05762093533132,NaN,NaN,-124.792503938977,-100.33403953761376,-0.30056634721389963,-0.1920494490193363,0.10851689819456331,1389126259,1381859656.8,33.3966917565853,46.09119071408945,NaN,NaN,-4.0201907775213295,3.938127795001038
2023-01-24T09:30:00-05:00,69.32,69.81,68.43,69.6,10329355,10139557.25,45.045099500731645,49.65938557087172,NaN,NaN,-116.7503549908933,-137.91763830178064,-0.26888979615534747,-0.22759534699962103,0.04129444915572643,1399455614,1382811469.8,34.501858650698594,46.03820683479141,NaN,NaN,-4.924804805299928,2.6719945663866147
2023-01-25T09:30:00-05:00,68.58,68.82,67.96,68.66,12991485,10505394.15,40.075486008745045,48.64275916630589,NaN,NaN,-153.3180062659197,-154.47076270738,-0.2953049777939767,-0.3278367730867444,-0.03253179529276774,1386464129,1384067032.6,36.010249785916265,46.05670416129184,NaN,NaN,-7.219156227069287,1.2589730244643431
2023-01-26T09:30:00-05:00,68.3,69,68.17,68.89,10180042,10709113.7,41.76833771658724,48.376058764681986,NaN,NaN,-118.81862297025597,-141.1422522350254,-0.2814064781476883,-0.38428989297737814,-0.10288341482968982,1396644171,1390197998.8,42.9225802509572,46.58094971405358,NaN,NaN,-8.631773627737442,-0.15399078299305446
2023-01-27T09:30:00-05:00,68.74,69.185,68.47,68.89,7712884,10733974.8,41.76833771658724,47.576057279097846,NaN,NaN,-95.01185997468289,-121.73826962814579,-0.25700540678711914,-0.4241401733135888,-0.16713476652646964,1396644171,1393666868.8,46.44741151042052,47.27972165126922,NaN,NaN,-9.786920303702699,-1.5301235716658608
2023-01-30T09:30:00-05:00,68.64,69.36,68.525,68.58,7780521,10834118.5,40.00190034731044,46.48812956717278,NaN,NaN,-86.59487083946286,-114.09874300824295,-0.24649837990082527,-0.4752577414025012,-0.22875936150167595,1388863650,1393614347,46.40068808435712,47.458473157290335,NaN,NaN,-11.25819837444904,-2.919848543492029
2023-01-31T09:30:00-05:00,68.77,69.11,67.96,69.09,9721153,10952670.8,44.18407659951636,45.69203498741424,NaN,NaN,-82.98891447336628,-107.34645490473754,-0.1923583626302594,-0.4692073147895002,-0.27684895215924077,1398584803,1393440184.8,46.234599703908536,47.04097725393836,NaN,NaN,-11.402361508211962,-4.131636109880591
2023-02-01T09:30:00-05:00,68.76,69.7,68.27,69.21,15472490,11081939.35,45.15283344962439,44.76385674538834,NaN,NaN,-56.594867208269,-88.0018270932074,-0.1381586067361701,-0.44954721057945335,-0.31138860384328326,1414057293,1398958817.6,52.086957361486064,46.573659649912905,NaN,NaN,-11.263260490229651,-5.1504395927876
2023-02-02T09:30:00-05:00,69.25,70.1299,68.71,69.36,12498540,11185048.9,46.40503816497277,44.15055916489335,NaN,NaN,-32.21108905377765,-70.68032030991174,-0.08453322726908297,-0.417055137929637,-0.33252191066055403,1426555833,1404941150,57.4889449861224,46.146615358883125,NaN,NaN,-10.815465133437483,-5.959728955737583
2023-02-03T09:30:00-05:00,68.74,69.01,67,67.91,12681143,11329784.55,37.493734142622586,43.01890411486397,NaN,NaN,-107.07291692034937,-73.09253169904501,-0.1359945806063414,-0.5025151364184808,-0.3665205558121394,1413874690,1408387253.8,60.26791396571533,45.84689499896815,NaN,NaN,-13.032321101477745,-6.9700992622718925
2023-02-06T09:30:00-05:00,67.66,68.545,67.54,68.49,15707067,11624623.55,42.269328294013924,42.27525009572441,NaN,NaN,-87.51921746563005,-73.27740102427845,-0.12076475631130668,-0.5174765012012728,-0.3967117448899661,1429581757,1416530875.2,65.93504818389926,46.261766211130535,NaN,NaN,-13.486819202634292,-7.901059253752235
2023-02-07T09:30:00-05:00,68.18,68.68,67.51,68.46,10562306,11566770.85,42.0902005745853,42.214049435284494,NaN,NaN,-82.27730368621975,-73.13507886684916,-0.10318609407574142,-0.5256943624846429,-0.42250826840890143,1419019451,1420617804.8,68.37310047085802,47.51258812783359,NaN,NaN,-13.905034321618743,-8.758769977733165
2023-02-08T09:30:00-05:00,68.06,68.09,66.97,67.31,11235848,11698189.45,35.8231587033431,41.93625090881091,NaN,NaN,-126.5514999867031,-87.12640542253597,-0.15629732974033705,-0.6178799305843228,-0.4615826008439857,1407783603,1419363066.8,66.79256610646753,49.43079312582672,NaN,NaN,-16.2459141730871,-9.82836200564087
2023-02-09T09:30:00-05:00,67.47,67.84,66.275,66.39,10357755,11681781.1,31.750260428318427,41.1722272317041,NaN,NaN,-166.56966001221417,-113.99811961422328,-0.2358971492739076,-0.7564540374363702,-0.5205568881624626,1397425848,1413537069.8,59.87196139991064,51.19504087266447,NaN,NaN,-19.624716366936514,-11.227841200111676
2023-02-10T09:30:00-05:00,66.46,67.77,66.38,67.71,15481739,11810924.15,41.94847422333868,41.126876133592624,NaN,NaN,-131.01515329783783,-118.78656688972096,-0.18443752166316263,-0.7511037902414159,-0.5666662685782533,1412907587,1413343649.2,59.65098257010615,53.07034735934453,NaN,NaN,-19.114716640687675,-12.354537691622532
2023-02-13T09:30:00-05:00,67.74,68.29,67.74,68.12,8091932,11620681.1,44.71190959809638,41.103076854832956,NaN,NaN,-60.79236174982886,-113.44119574656072,-0.1111836739924621,-0.705645861068831,-0.5944621870763689,1420999519,1411627201.6,57.61861387463606,54.72154416105435,NaN,NaN,-17.780899182392325,-13.129732190303931
2023-02-14T09:30:00-05:00,68.05,68.52,67.47,67.83,7075222,11486180.5,43.147362116080046,41.322496576785454,NaN,NaN,-61.937997669345485,-109.37333454318586,-0.07252867374271954,-0.6851230292547683,-0.6125943555120488,1413924297,1410608170.8,56.390240799486655,56.1772578048808,NaN,NaN,-17.205634644505512,-13.712003969475585
2023-02-15T09:30:00-05:00,67.44,68.315,67.44,68.27,5510009,11036169.25,46.22210423116053,41.640622756397825,NaN,NaN,-46.98829788898469,-93.46069412364218,-0.010833717647422914,-0.6261365025713275,-0.6153027849239046,1419434306,1412938311.4,58.5654908163313,57.29460855955038,NaN,NaN,-15.764559193556533,-14.005226144344292
2023-02-16T09:30:00-05:00,67.6,68.0675,67.025,67.75,9199783,10786309.65,43.24541500222705,41.74612827680067,NaN,NaN,-82.85375432960029,-76.71751298711942,0.0008278198381441726,-0.6142680101262243,-0.6150958299643685,1410234523,1415500046.4,60.87598895584602,58.32522123422364,NaN,NaN,-15.467707708307316,-14.214152082053294
2023-02-17T09:30:00-05:00,67.77,68.8,67.41,68.48,10936729,10667622.05,48.280875018810235,42.337483610479225,NaN,NaN,-10.425551416395487,-52.59959261083095,0.060288255785969413,-0.5397355102319068,-0.6000237660178762,1421171252,1417152779.4,62.33524581051254,59.46340392894903,NaN,NaN,-13.62327048904502,-14.129740425909254
2023-02-21T09:30:00-05:00,67.98,68.17,67.15,67.2,8484534,10600526.85,41.352768141036094,42.135247292016345,NaN,NaN,-88.4466157467244,-58.130443410210056,0.01818018756180728,-0.5772985315656172,-0.5954787191274244,1412686718,1415490219.2,59.91433667600446,60.44052799838445,NaN,NaN,-14.271152530882173,-14.1499421551911
2023-02-22T09:30:00-05:00,67.19,67.705,66.755,66.94,13375058,10752812,40.0942215605381,41.773917871367324,NaN,NaN,-121.60373223889495,-70.06359032411994,-0.020329096082767117,-0.6208900892308833,-0.6005609931481162,1399311660,1412567691.8,55.81105843939787,60.706535218235295,NaN,NaN,-15.188547689191106,-14.298314374333959
2023-02-23T09:30:00-05:00,67.24,67.24,66.295,66.59,10703345,10638405,38.399980917074615,41.202128067946035,NaN,NaN,-150.31314293487353,-90.72855933329771,-0.0602612666121376,-0.6758875764132881,-0.6156263098011505,1388608315,1406402493.6,48.29671652822906,60.04994747124292,NaN,NaN,-16.463137554457994,-14.607574828637393
2023-02-24T09:30:00-05:00,66.01,66.845,65.74,66.61,11575185,10708162.15,38.55975006474466,41.27827206238332,NaN,NaN,-157.99667661053462,-105.75714378948457,-0.07524208148232125,-0.7096789116540521,-0.6344368301717308,1400183500,1404392289,46.116474557771134,59.03913037067547,NaN,NaN,-17.43717126322852,-15.01180289072184
2023-02-27T09:30:00-05:00,66.94,67.58,66.0204,66.16,10860321,10865534,36.279707028628366,40.850441971998634,NaN,NaN,-120.75301392626683,-127.82263629145885,-0.10362136101399999,-0.7639635314392308,-0.6603421704252308,1389323179,1398022674.4,39.96076083122351,57.18382413119864,NaN,NaN,-18.931841831125748,-15.571808453636685
2023-02-28T09:30:00-05:00,65.86,66.18,65,65,20575936,11505304.75,31.164136355866816,40.07000881351875,NaN,NaN,-201.03380256433474,-150.34007365498093,-0.18398521716484917,-0.8903236918812922,-0.7063384747164431,1368747243,1389234779.4,33.34716538843519,54.68197162531129,NaN,NaN,-21.91078985376955,-16.477377225084236
2023-03-01T09:30:00-05:00,64.66,64.72,63.625,63.93,23637951,12201144.65,27.335316788830582,39.46373439105356,NaN,NaN,-250.96905979227964,-176.21313916565785,-0.2865562634277038,-1.0645338040010728,-0.777977540573369,1345109292,1378394305.8,27.336814092637127,51.8637036243234,NaN,NaN,-25.804527550112105,-17.809827271516788
2023-03-02T09:30:00-05:00,63.84,65.18,63.75,65.14,15347486,12194894.45,36.79255477218135,39.823898272758065,NaN,NaN,-172.44727977651684,-180.6399665339865,-0.25151200929927175,-1.0923675521974587,-0.840855542898187,1360456778,1372763998.4,24.833332143072383,49.3609443916921,NaN,NaN,-25.986744579271708,-18.977958315481775
2023-03-03T09:30:00-05:00,65.4,66.29,64.76,66.25,15087612,12324348.05,43.99367851927197,39.969984293896154,NaN,NaN,-86.2688946252054,-166.29441013692067,-0.1378587482832211,-1.0131789782522134,-0.8753202299689923,1375544390,1367836176.4,22.860082858771648,46.73302298373964,NaN,NaN,-23.614521827405657,-19.640324531470903
2023-03-06T09:30:00-05:00,66.29,66.77,66.2,66.57,12121716,12296376.7,45.90698655722113,40.05534693383363,NaN,NaN,-29.630793960726855,-148.06996614381268,-0.030994522847765493,-0.9140633835286991,-0.8830688606809336,1387666106,1367504761.8,22.729274996621015,44.24092734959571,NaN,NaN,-21.110431419758648,-19.850339801226294
2023-03-07T09:30:00-05:00,66.63,66.795,65.155,65.48,12027644,12112405.55,40.794725057444346,39.88730142964537,NaN,NaN,-71.44690626524441,-122.1525868839946,-0.023899795866625162,-0.912943605514215,-0.8890438096475899,1375638462,1368883005.6,24.660001459901366,41.97448168248247,NaN,NaN,-20.687028583404103,-19.969866770108837
2023-03-08T09:30:00-05:00,65.46,66.11,65.21,65.98,13703768,12269478.65,43.88192818279145,39.72014599761901,NaN,NaN,-66.95281129325073,-85.34933718418884,0.021813982967172074,-0.8617763309386248,-0.8835903139057969,1389342230,1377729593.2,35.756138624898355,40.34524224023726,NaN,NaN,-19.328742682273994,-19.87827761470386
2023-03-09T09:30:00-05:00,66.16,66.77,65.23,65.45,17033557,12559364.1,41.416626494996464,39.58951824710254,NaN,NaN,-57.04711586044003,-62.26930440097347,0.023555131290082132,-0.8541463997931942,-0.8777015310832763,1372308673,1380099972.2,38.37510020418862,38.73803590083316,NaN,NaN,-19.00289543111336,-19.75322301704807
2023-03-10T09:30:00-05:00,65.77,65.77,64.09,64.42,20833347,13083143.7,37.059232505206836,38.78797235327372,NaN,NaN,-115.78958844589135,-68.17344316511065,-0.034318705989789144,-0.9205999135705127,-0.8862812075807236,1351475326,1375286159.4,35.23377593912082,36.802216624305174,NaN,NaN,-20.150201125810092,-19.809934175442645
2023-03-13T09:30:00-04:00,64.34,66.85,64.25,65.41,33835732,14000843.35,43.240445897593425,38.922806478742096,NaN,NaN,-59.85577778544424,-74.21843993005413,0.0024656810555150344,-0.8831991062613298,-0.8856647873168448,1385311058,1374815149.8,34.93246305683218,35.01779708007858,NaN,NaN,-19.0676116643682,-19.70388810243201
2023-03-14T09:30:00-04:00,65.9,66.81,65.62,66.27,17559235,14474208.5,48.01635820520399,39.48867338193252,NaN,NaN,-6.395630143082272,-61.208184705621704,0.08834979483887362,-0.7752275437682528,-0.8635773386071264,1402870293,1380261516,41.19479446571692,33.97377822481565,NaN,NaN,-16.57132534147102,-19.256379136580442
2023-03-15T09:30:00-04:00,66.08,67.6,65.76,67.17,24168380,15328866.4,52.518986451623356,40.49717377725743,NaN,NaN,43.258947532194476,-39.16583294053267,0.20285781845951534,-0.6100050655327323,-0.8128628839922476,1427038673,1387800804.6,48.573302112566935,33.993534337982645,NaN,NaN,-12.975959900308323,-18.359176388541567
2023-03-16T09:30:00-04:00,66.92,68.01,66.66,67.62,15826197,15844675.8,54.634797737367734,41.645391468159076,NaN,NaN,92.6264821455081,-9.231113339343057,0.30012375169502137,-0.43770819437347086,-0.7378319460684922,1442864870,1401912044,58.95431523160404,34.91052295754214,NaN,NaN,-9.391194720896651,-17.07803615030658
2023-03-17T09:30:00-04:00,67.46,67.6,66.47,66.97,17907693,16280071.3,51.09315159819196,42.70349465169933,NaN,NaN,64.6262483531657,26.85205402046836,0.3106003628290377,-0.34958149253219517,-0.6601818553612329,1424957177,1416608414.2,66.53162915394847,36.808442123451066,NaN,NaN,-7.525162274602,-15.713339882348784
2023-03-20T09:30:00-04:00,66.58,67.22,66.56,67,19419074,16704188.55,51.250224414058906,44.13821522728448,NaN,NaN,67.68609941409164,52.36042946037554,0.30881799733214366,-0.27415935869605335,-0.582977356028197,1444376251,1428421452.8,71.14304694514307,39.50814794893021,NaN,NaN,-5.997645800772282,-14.325383584980713
2023-03-21T09:30:00-04:00,67.11,67.19,64.77,65.65,25932537,17576588.7,44.34781416640792,45.35339361139715,NaN,NaN,-17.949470070509975,50.04966147489,0.2106731425716264,-0.319635927813664,-0.5303090703852904,1418443714,1431536137,72.22952338186386,42.714770041017836,NaN,NaN,-6.792719898488474,-13.249288772624679
2023-03-22T09:30:00-04:00,65.56,65.905,64.33,64.36,17896642,17802667.9,38.94961622950584,45.50746942977747,NaN,NaN,-101.68124672382483,21.061622623686134,0.06062395497790829,-0.454529126662905,-0.5151530816408133,1400547072,1426237816.8,67.56908529028172,45.76732383724707,NaN,NaN,-9.281908118181628,-12.682520107704242
2023-03-23T09:30:00-04:00,64.38,65,63.38,63.7,16884505,18111725.9,36.50153078056276,44.97231601986967,NaN,NaN,-159.4272140192647,-29.349116609268428,-0.07402508257469376,-0.6076844348591806,-0.5336593522844868,1383662567,1414397356.2,58.48698474210649,48.31210254319956,NaN,NaN,-12.127694546914096,-12.60325931330565
2023-03-24T09:30:00-04:00,63.77,65.71,63.71,65.69,18056218,18435777.55,47.26425679729948,45.06926389416098,NaN,NaN,-62.23735876646724,-54.72183803319501,-0.022677552132780443,-0.5620062924504623,-0.5393287403176819,1401718785,1409749677.8,55.34250203245975,50.64161876004518,NaN,NaN,-10.949525264638474,-12.367011592067481
2023-03-27T09:30:00-04:00,65.89,66.365,65.59,65.77,14136940,18599608.5,47.64841530473964,45.558813197539216,NaN,NaN,17.720350016650173,-64.71498791268331,0.0207172502190216,-0.5134321775439048,-0.5341494277629264,1415855725,1404045572.6,51.67076940900814,52.57095932783852,NaN,NaN,-9.921120984829772,-12.01759864817638
2023-03-28T09:30:00-04:00,65.61,66.6453,65.61,65.95,11019485,18121785.95,48.55645220597323,45.89270777062363,NaN,NaN,29.533402198714015,-55.21841345883852,0.06318715700593869,-0.45516548150550307,-0.5183526385114418,1426875210,1405731871.8,52.670484184679815,53.77912686782292,NaN,NaN,-8.824016290049189,-11.561372597015353
2023-03-29T09:30:00-04:00,66.3,67.015,66.3,66.91,9904018,17435089.3,53.21707981714919,46.73559729363454,NaN,NaN,84.98949208009813,-17.884265698053916,0.15248477594453547,-0.3277466685807724,-0.48023144452530786,1436779228,1412978303,56.80542812771394,55.09557886236045,NaN,NaN,-6.417408621383094,-10.826520600496458
2023-03-30T09:30:00-04:00,67.07,67.53,66.82,67.2,10292845,17182357.25,54.55643970741043,47.98539780807765,NaN,NaN,113.66692749922953,36.73456260564493,0.2233465905074744,-0.20104820639096488,-0.4243947968984393,1447072073,1425660204.2,62.91222192462539,57.07261071846791,NaN,NaN,-4.055991989955751,-9.859302227562072
2023-03-31T09:30:00-04:00,67.42,67.72,67.03,67.69,11722150,17014084.15,56.80658356230348,48.954407641271224,NaN,NaN,122.64672315846964,73.71137899063231,0.291192987341048,-0.06040356272212932,-0.3515965500631773,1458794223,1437075291.8,67.38231696262059,59.39045742602423,NaN,NaN,-1.4072930920622,-8.65187235106209
2023-04-03T09:30:00-04:00,67.44,67.73,66.85,67.23,12035815,17009789.1,54.098455269109735,49.38884314583593,NaN,NaN,95.52092825453452,89.27149463820918,0.2923022901801114,0.01378131266196192,-0.27852097751814947,1446758408,1443255828.4,69.52409365784219,61.41397879689032,NaN,NaN,0.039553476208155046,-7.410240090023484
2023-04-04T09:30:00-04:00,67.19,67.695,67.01,67.57,10807005,16948757.15,55.77659645510583,49.621529574656094,NaN,NaN,95.84130154059515,102.5330745065854,0.3019118389360593,0.09886882115192464,-0.20304301778413464,1457565413,1449393869,71.52390820106177,63.05330780321138,NaN,NaN,1.7298184467500133,-6.104517441912984
2023-04-05T09:30:00-04:00,67.86,69.51,67.85,69.32,18837182,17205427.85,63.22834493556981,50.235354374527674,NaN,NaN,176.34672194838856,120.8045204802435,0.4056402165622632,0.30400725291869435,-0.10163296364356883,1476402595,1457318542.4,73.9047515811024,64.12119611388984,NaN,NaN,5.691130827155842,-4.419424832046009
2023-04-06T09:30:00-04:00,69.88,69.955,69.1,69.81,16675228,17187511.4,65.00636943586147,51.229155648646994,NaN,NaN,190.6544852758281,136.2020320355632,0.48158804726504195,0.5003520954377336,0.018764048172691672,1493077823,1466519692.4,76.37462437500767,64.82426720110834,NaN,NaN,9.510491820598995,-2.4294367388110087
2023-04-10T09:30:00-04:00,69.41,69.69,68.715,69.67,10231468,16657417.45,64.05339044790855,52.143667508207685,NaN,NaN,158.69297292624955,143.4112819891192,0.49483949379148834,0.6373134154120521,0.14247392162056377,1482846355,1471330118.8,77.56990638702749,65.28332858981437,NaN,NaN,12.322606857578839,-0.32200193932674503
2023-04-11T09:30:00-04:00,69.57,69.925,69.39,69.73,8637039,15397482.8,64.29497250960907,53.56846453272205,NaN,NaN,156.9312569363652,155.69334772548532,0.4797350920845701,0.7421427867262764,0.2624076946417063,1491483394,1480275116,79.63334988880047,65.81217334030984,NaN,NaN,14.68739927048559,1.8221982335035882
2023-04-12T09:30:00-04:00,69.86,70.16,69.41,69.66,12554719,15147257,63.756623976276316,55.34039365749137,NaN,NaN,138.4618281138832,164.21745304014294,0.438259882133766,0.8102325473089138,0.3719726651751478,1478928675,1484547768.4,80.55359366513379,66.73963822422785,NaN,NaN,16.508366452919347,3.9202222648486966
2023-04-13T09:30:00-04:00,69.35,69.855,68.35,69.67,16446211,14761148.55,63.80325153979481,57.29051656886509,NaN,NaN,100.2521913486136,148.99854692018795,0.38653668968647886,0.8551435272832464,0.4686068375967675,1495374886,1488342226.6,81.35913217532718,68.37336304088647,NaN,NaN,18.042997391583203,5.937761568667911
2023-04-14T09:30:00-04:00,69.16,69.3,68.565,68.89,9064724,14423074.9,57.58067670727457,58.027403705291874,NaN,NaN,73.2957896812525,125.52680780127282,0.27980472584332494,0.8183627449009236,0.5385580190575987,1486310162,1486988694.4,80.08474829747324,70.14066634553029,NaN,NaN,17.77421133942588,7.628682964490478
2023-04-17T09:30:00-04:00,69.01,69.39,68.58,69.27,7806851,13918032.8,59.645545563371634,58.88434158090845,NaN,NaN,72.33568984623614,108.25535118527014,0.21758015415672782,0.8105332117535085,0.5929530575967806,1494117013,1489242826,80.6289287754938,72.20910630027927,NaN,NaN,18.08959160654206,9.123098484783561
2023-04-18T09:30:00-04:00,69.3,69.44,68.65,68.91,7783227,13336240.45,56.823523001947166,59.47484663776373,NaN,NaN,61.64821372396582,89.19874254279026,0.13879288808309953,0.766444167700655,0.6276512796175555,1486333786,1488212904.4,79.55924017545188,74.12973172819156,NaN,NaN,17.601561977475196,10.334307555168081
2023-04-19T09:30:00-04:00,69.08,69.65,68.98,69.44,10317288,12555478,59.83634675925015,59.94765141934237,NaN,NaN,69.34569565153363,75.37551605032033,0.1102359884486166,0.7654462651783263,0.6552102767297097,1496651074,1491757384.2,80.51720751963931,75.82343025618623,NaN,NaN,17.983974881997018,11.4271171732865
2023-04-20T09:30:00-04:00,69.5,69.695,69.01,69.42,7368739,12029082.85,59.66714666380645,60.3127019162278,NaN,NaN,63.94382227841321,68.11384223628026,0.07930854402532783,0.7543459567613695,0.6750374127360417,1489282335,1490538874,79.14400982355238,76.98284367753816,NaN,NaN,18.257851397632503,12.402936348193073
2023-04-21T09:30:00-04:00,69.87,70.11,69.21,69.62,7037804,11536747.8,60.85907808190003,60.6021658104847,NaN,NaN,71.86851764027527,67.8283878280848,0.062375681620918555,0.7530070147621899,0.6906313331412713,1496320139,1492540869.4,79.75492694899268,77.8666015337076,NaN,NaN,18.798985464979868,13.316657650591187