time,open,high,low,close,Volume,Volume MA,RSI,RSI-based MA,Upper Bollinger Band,Lower Bollinger Band,CCI,Smoothing Line,Histogram,MACD,Signal,OnBalanceVolume,Smoothing Line,RSI,RSI-based MA,Upper Bollinger Band,Lower Bollinger Band,True Strength Index,Signal
1998-12-22T09:30:00-05:00,24.813,25.063,24.813,25.03101,5700,NaN,NaN,NaN,NaN,NaN,NaN,NaN,NaN,NaN,NaN,NaN,NaN,NaN,NaN,NaN,NaN,NaN,NaN
1998-12-23T09:30:00-05:00,25.1875,25.59375,25.1875,25.59375,18100,NaN,NaN,NaN,NaN,NaN,NaN,NaN,NaN,NaN,NaN,18100,NaN,NaN,NaN,NaN,NaN,NaN,NaN
1998-12-24T09:30:00-05:00,25.625,25.75,25.51601,25.75,4900,NaN,NaN,NaN,NaN,NaN,NaN,NaN,NaN,NaN,NaN,23000,NaN,NaN,NaN,NaN,NaN,NaN,NaN
1998-12-28T09:30:00-05:00,25.67187,25.75,25.375,25.375,15500,NaN,NaN,NaN,NaN,NaN,NaN,NaN,NaN,NaN,NaN,7500,NaN,NaN,NaN,NaN,NaN,NaN,NaN
1998-12-29T09:30:00-05:00,25.375,25.9375,25.375,25.9375,5300,NaN,NaN,NaN,NaN,NaN,NaN,NaN,NaN,NaN,NaN,12800,NaN,NaN,NaN,NaN,NaN,NaN,NaN
1998-12-30T09:30:00-05:00,26,26.03125,25.71875,25.71875,17300,NaN,NaN,NaN,NaN,NaN,NaN,NaN,NaN,NaN,NaN,-4500,11380,NaN,NaN,NaN,NaN,NaN,NaN
1998-12-31T09:30:00-05:00,25.8125,26,25.75,26,6600,NaN,NaN,NaN,NaN,NaN,NaN,NaN,NaN,NaN,NaN,2100,8180,NaN,NaN,NaN,NaN,NaN,NaN
1999-01-04T09:30:00-05:00,26.25,26.375,25.78125,25.9375,249200,NaN,NaN,NaN,NaN,NaN,NaN,NaN,NaN,NaN,NaN,-247100,-45840,NaN,NaN,NaN,NaN,NaN,NaN
1999-01-05T09:30:00-05:00,26,26.34375,26,26.34375,4400,NaN,NaN,NaN,NaN,NaN,NaN,NaN,NaN,NaN,NaN,-242700,-95880,NaN,NaN,NaN,NaN,NaN,NaN
1999-01-06T09:30:00-05:00,26.53125,26.78125,26.46875,26.78125,38500,NaN,NaN,NaN,NaN,NaN,NaN,NaN,NaN,NaN,NaN,-204200,-139280,NaN,NaN,NaN,NaN,NaN,NaN
1999-01-07T09:30:00-05:00,26.53125,26.6875,26.34375,26.65625,15900,NaN,NaN,NaN,NaN,NaN,NaN,NaN,NaN,NaN,NaN,-220100,-182400,NaN,NaN,NaN,NaN,NaN,NaN
1999-01-08T09:30:00-05:00,26.71899,26.98399,26.71899,26.98399,24400,NaN,NaN,NaN,NaN,NaN,NaN,NaN,NaN,NaN,NaN,-195700,-221960,NaN,NaN,NaN,NaN,NaN,NaN
1999-01-11T09:30:00-05:00,26.96875,27.25,26.8125,27.04687,7700,NaN,NaN,NaN,NaN,NaN,NaN,NaN,NaN,NaN,NaN,-188000,-210140,NaN,NaN,NaN,NaN,NaN,NaN
1999-01-12T09:30:00-05:00,27.125,27.25,26.90625,26.9375,270700,NaN,NaN,NaN,NaN,NaN,NaN,NaN,NaN,NaN,NaN,-458700,-253340,NaN,NaN,NaN,NaN,NaN,NaN
1999-01-13T09:30:00-05:00,25.78125,26.875,25.78125,26.6875,7100,NaN,71.03356502350343,NaN,NaN,NaN,NaN,NaN,NaN,NaN,NaN,-465800,-305660,NaN,NaN,NaN,NaN,NaN,NaN
1999-01-14T09:30:00-05:00,26.78125,26.85937,26.375,26.46875,12200,NaN,67.0238267052194,NaN,NaN,NaN,NaN,NaN,NaN,NaN,NaN,-478000,-357240,NaN,NaN,NaN,NaN,NaN,NaN
1999-01-15T09:30:00-05:00,26.5625,26.90625,26.5625,26.82812,7700,NaN,70.01809106699474,NaN,NaN,NaN,NaN,NaN,NaN,NaN,NaN,-470300,-412160,NaN,NaN,NaN,NaN,NaN,NaN
1999-01-19T09:30:00-05:00,27.28125,27.65625,27.125,27.59375,22700,NaN,75.18731604723165,NaN,NaN,NaN,NaN,NaN,NaN,NaN,NaN,-447600,-464080,NaN,NaN,NaN,NaN,NaN,NaN
1999-01-20T09:30:00-05:00,27.75,28.125,27.59375,27.75,25800,NaN,76.09320161323149,NaN,NaN,NaN,NaN,NaN,NaN,NaN,NaN,-421800,-456700,NaN,NaN,NaN,NaN,NaN,NaN
1999-01-21T09:30:00-05:00,27.6875,27.6875,26.71875,26.78125,23200,39145,61.1795982202047,NaN,NaN,NaN,74.10179678178505,NaN,NaN,NaN,NaN,-445000,-452540,4.574651417828619,NaN,NaN,NaN,NaN,NaN
1999-01-22T09:30:00-05:00,26.59375,26.875,26.40625,26.67187,67100,42215,59.75554624750512,NaN,NaN,NaN,22.671250765154756,NaN,NaN,NaN,NaN,-512100,-459360,4.509786450444025,NaN,NaN,NaN,NaN,NaN
1999-01-25T09:30:00-05:00,26.6875,26.90625,26.6875,26.89062,495300,66075,61.676762432433975,NaN,NaN,NaN,39.50754293053073,NaN,NaN,NaN,NaN,-16800,-368660,20.628315004472228,NaN,NaN,NaN,NaN,NaN
1999-01-26T09:30:00-05:00,26.9375,27.03125,26.67187,27.01562,187400,75200,62.77047775727994,NaN,NaN,NaN,45.086413100625066,NaN,NaN,NaN,NaN,170600,-245020,36.39074672651458,NaN,NaN,NaN,NaN,NaN
1999-01-27T09:30:00-05:00,27.09375,27.09375,26.75,26.75,6800,74765,58.922282411256155,NaN,NaN,NaN,32.87976926518434,42.84935456865598,NaN,NaN,NaN,163800,-127900,47.10637625867646,NaN,NaN,NaN,NaN,NaN
1999-01-28T09:30:00-05:00,27,27.34375,27,27.25,25800,75790,63.46303705680605,NaN,NaN,NaN,81.7771520774252,44.38442562778401,NaN,NaN,NaN,189600,-980,55.79669688196991,NaN,NaN,NaN,NaN,NaN
1999-01-29T09:30:00-05:00,27.28125,27.28125,26.90625,27.25,13800,75615,63.46303705680606,NaN,NaN,NaN,66.93084364099167,53.2363442029514,NaN,0.3972913237735156,NaN,189600,139360,63.02974029414139,NaN,NaN,NaN,NaN,NaN
1999-02-01T09:30:00-05:00,27.375,27.46875,27.15625,27.40625,34000,76985,64.87042558911998,NaN,NaN,NaN,99.31320685235201,65.19747698731565,NaN,0.4053009864320707,NaN,223600,187440,65.13462521282264,NaN,NaN,NaN,NaN,NaN
1999-02-02T09:30:00-05:00,26.96875,27.04687,26.625,27,141700,71610,58.554987432402584,65.28658247571396,NaN,NaN,-6.955530798224107,54.78908820754582,NaN,0.3745501410912553,NaN,81900,169700,63.69368464592922,NaN,NaN,NaN,NaN,NaN
1999-02-03T09:30:00-05:00,26.9375,27.51562,26.9375,27.51562,38900,73335,63.422349066074844,64.74292419304048,NaN,NaN,87.58058522470519,65.72925139944999,NaN,0.3873213005411458,NaN,120800,161100,62.96645278627128,NaN,NaN,NaN,NaN,NaN
1999-02-04T09:30:00-05:00,27.34375,27.4375,27.125,27.3125,7400,71780,60.41242707871666,64.270681362576,NaN,NaN,71.74474210782307,63.72276940552956,NaN,0.3767099718988547,NaN,113400,145860,61.62370172160765,NaN,NaN,NaN,NaN,NaN
1999-02-05T09:30:00-05:00,27.3125,27.3125,26.8125,27,16900,71830,56.00841768634699,63.269990406815445,NaN,NaN,3.559946078312617,51.04858989299375,NaN,0.33917448681559037,NaN,96500,127240,59.941819454445834,NaN,NaN,NaN,NaN,NaN
1999-02-08T09:30:00-05:00,27.125,27.125,26.875,26.98437,6500,70935,55.78935574178504,61.884421813569254,NaN,NaN,-10.832615050327849,29.01942551245778,NaN,0.3046542693080099,NaN,90000,100520,57.51589564734206,NaN,NaN,NaN,NaN,NaN
1999-02-09T09:30:00-05:00,27.0625,27.09375,26.5,26.5,220800,81590,49.34788391532165,59.974041978004266,NaN,NaN,-83.26492530409278,13.75754661128405,NaN,0.23549746904642532,NaN,-130800,57980,53.783866952258386,46.906882818194596,NaN,NaN,NaN,NaN
1999-02-10T09:30:00-05:00,26.3125,26.5625,26.1875,26.5625,17800,68945,50.14772953710976,59.1860513577832,NaN,NaN,-130.24656168308732,-29.807882770274453,-0.15017393750203328,0.183616813923571,0.33379075142560427,-113000,11220,49.94739826008969,50.14779330692753,NaN,NaN,NaN,NaN
1999-02-11T09:30:00-05:00,26.46875,27.28125,26.375,27.28125,5300,68855,58.30233318118258,59.08225042447445,NaN,NaN,-8.931965464393857,-45.943224284717836,-0.10846199311154786,0.19821326003616946,0.3066752531477173,-107700,-33000,46.564684729701035,53.15171461258874,NaN,NaN,NaN,NaN
1999-02-12T09:30:00-05:00,27.125,27.125,26.71875,26.875,8400,68665,53.02296308817491,58.46412189988451,NaN,NaN,-34.315056629595674,-53.51822482629949,-0.10535382322811204,0.17498297411257724,0.2803367973406893,-116100,-75520,43.513059668452776,54.786339231444494,NaN,NaN,NaN,NaN
1999-02-16T09:30:00-05:00,27,27.3125,27,27.125,18500,69205,55.68248106274491,57.95783642170345,NaN,NaN,27.377146835887732,-45.87627244905637,-0.08448422217323187,0.17473151962414946,0.2592157417973813,-97600,-113040,40.962059168265554,55.112861548712424,NaN,NaN,NaN,NaN
1999-02-17T09:30:00-05:00,27.0625,27.25,26.8125,26.84375,12900,68715,52.108416515642375,57.471131714873884,NaN,NaN,-17.441632113736937,-32.71161381098521,-0.08728669640027059,0.1501073712970431,0.2373940676973137,-110500,-108980,41.36266112048504,54.70259618169875,NaN,NaN,14.830061953613209,NaN
1999-02-18T09:30:00-05:00,26.9375,27.20312,26.76562,27.1875,11500,68000,55.839323251365464,56.926580728770986,NaN,NaN,25.224264264264235,-1.6174486215148989,-0.06469447455643906,0.15652597450176486,0.22122044905820393,-99000,-106180,41.656689741690016,53.69259567167876,NaN,NaN,14.427352049882,NaN
1999-02-19T09:30:00-05:00,27.1875,27.375,27.1875,27.26562,13900,67535,56.66553776306134,56.44104506493208,NaN,NaN,100.86143696506026,20.341231864375924,-0.04417410503935973,0.16600281775900427,0.210176922798364,-85100,-101660,42.16088882533452,52.20196342390683,NaN,NaN,14.348199101509618,NaN
1999-02-22T09:30:00-05:00,27.375,27.85937,27.3125,27.84375,17800,65070,62.288654292397524,56.2566328294519,NaN,NaN,206.42096106212327,68.48843540271972,0.005982107705731182,0.21765455743052797,0.2116724497247968,-67300,-91900,43.30031887421484,50.642370114006276,NaN,NaN,16.046144961423416,NaN
1999-02-23T09:30:00-05:00,27.90625,27.90625,27.5,27.79687,15000,41055,61.590733990045095,56.47347186928351,NaN,NaN,186.67252319966903,100.34751067547597,0.032183908796944605,0.25190233572097753,0.21971842692403293,-82300,-88840,43.674967206240936,49.21246172545712,NaN,NaN,17.192579787584112,NaN
1999-02-24T09:30:00-05:00,27.875,27.98437,27.46875,27.46875,28000,33085,56.794168153001024,56.00003037549252,NaN,NaN,137.833904585479,131.40261801531915,0.023976573617587926,0.24968914394601782,0.2257125703284299,-110300,-88800,43.680205954061265,47.834872666013545,NaN,NaN,16.729342031648468,NaN
1999-02-25T09:30:00-05:00,27.34375,27.34375,26.875,27.20312,98900,37690,53.18323939801338,55.483659826870856,NaN,NaN,-0.968557515757419,126.16405365931482,-0.0014341811376059055,0.2239198439064225,0.2253540250440284,-209200,-110840,41.39557407808325,46.3900064057618,NaN,NaN,15.246376913825726,NaN
1999-02-26T09:30:00-05:00,27.3125,27.35937,26.89062,27.28125,10800,36940,54.10747462786944,55.34787817983675,NaN,NaN,9.801085008278045,107.9519832679584,-0.014354403340884364,0.20741102086792296,0.22176542420880732,-198400,-133500,39.12952589958012,44.90341400898568,NaN,NaN,14.29621307438825,NaN
1999-03-01T09:30:00-05:00,27.21875,27.25,26.90625,27.23437,8800,36690,53.425940207401965,55.17906278452367,NaN,NaN,-3.4358037248719926,65.98063031055935,-0.026713631889938333,0.1883733843463844,0.21508701623632273,-207200,-161480,36.47445268619556,43.400453797475215,NaN,NaN,13.32372204800221,NaN
1999-03-02T09:30:00-05:00,27.40625,27.64062,27.04687,27.21875,11500,35565,53.18555797739287,55.453182360385895,NaN,NaN,46.907516661876286,38.02762900300078,-0.036017523359946124,0.17006511203639008,0.2060826353963362,-218700,-188760,34.04866210186702,41.990796308161535,NaN,NaN,12.452780057531879,NaN
1999-03-03T09:30:00-05:00,27.3125,27.3125,27,27.04687,13100,29135,50.49332196758619,55.47786753399136,NaN,NaN,-9.60945274910856,8.538957536083268,-0.05280872030252892,0.14007173501817505,0.19288045532070397,-231800,-213060,32.00668084049728,40.70931649247637,NaN,NaN,10.975835687143977,NaN
1999-03-04T09:30:00-05:00,27.4375,27.53125,27.23437,27.53125,10400,27710,57.086027376942866,55.39098854797424,NaN,NaN,80.84753926947602,24.902176893129962,-0.03141125115959048,0.15361639137121585,0.18502764253080634,-221400,-215500,31.800450193055383,39.65472831128739,NaN,NaN,11.461712208202421,NaN
1999-03-05T09:30:00-05:00,27.9375,28.21875,27.84375,28.15625,25400,28610,63.78706566590413,56.15985301781204,NaN,NaN,211.98151297191617,65.33826248585758,0.021846075839510204,0.2123352373301941,0.1904891614906839,-196000,-215020,31.893419102944534,38.82475398517967,NaN,NaN,14.021312437871172,14.257817870202036
1999-03-08T09:30:00-05:00,28.09375,28.1875,27.9375,28.1875,62700,30900,64.08900900769592,56.76031929959425,NaN,NaN,175.88162908302053,101.2017490474361,0.054339177912400366,0.25841313388118436,0.204073955968784,-133300,-200240,34.83894092923926,38.38738839667779,NaN,NaN,16.158608213205152,14.52935934777391
1999-03-09T09:30:00-05:00,27.84375,28.25,27.8125,27.96875,12200,31185,60.29888232767363,57.345352571882195,NaN,NaN,132.71088682670694,118.36242308040224,0.05603605803589767,0.2741190285136561,0.21808297047775843,-145500,-185600,37.71253329368826,38.12666498047802,NaN,NaN,16.86248697213819,14.862663294111664
1999-03-10T09:30:00-05:00,27.9375,28.21875,27.78125,28.21875,10700,20680,62.99250344073905,57.85629401398031,NaN,NaN,123.8777064888419,145.05985492799232,0.06812832200678048,0.30324337298623405,0.23511505097945357,-134800,-166200,41.4004143735635,38.108359597040405,NaN,NaN,18.26146321530748,15.348206139996782
1999-03-11T09:30:00-05:00,28.21875,28.5625,28.21875,28.40625,23600,20970,64.91514953830072,58.44555199792599,NaN,NaN,156.0395602751937,160.09825912913584,0.081958432506882,0.3375630916130561,0.2556046591061741,-111200,-144160,45.3585697846483,38.336765379848536,NaN,NaN,20.00713434163857,16.013767311659894
1999-03-12T09:30:00-05:00,28.53125,28.65625,28.25,28.25,24600,21935,62.02334926045449,58.42660163850149,NaN,NaN,132.9090796491807,144.28377246458876,0.0740286725147356,0.3481404997495936,0.274111827234858,-135800,-132120,47.44688633061148,38.63294876959115,NaN,NaN,20.6497593498843,16.676051888549093
1999-03-15T09:30:00-05:00,28.4375,28.54687,28.21875,28.34375,144800,28755,63.0859018394643,58.53339934203144,NaN,NaN,116.23807509068172,132.355061666121,0.06866162801417769,0.3599388622525801,0.2912772342384024,9000,-103660,52.10644161337605,39.235196941529374,NaN,NaN,21.483169765401993,17.362783013813793
1999-03-16T09:30:00-05:00,28.4375,28.4375,28.23437,28.28125,9100,28285,61.84361450373793,58.89407408136979,NaN,NaN,97.26756381442424,125.26639706366446,0.055054189566469014,0.3600949711964887,0.3050407816300197,-100,-74580,56.36377248277478,40.14116597929462,NaN,NaN,21.845322584408308,18.00314580961301
1999-03-17T09:30:00-05:00,28.1875,28.35937,28.01562,28.125,2700,27775,58.72993468407952,59.29026660180308,NaN,NaN,67.22583447354002,113.9360226606041,0.030886770627051585,0.3436492449138342,0.3127624742867826,-2800,-48180,59.85283971693811,41.45954209635568,NaN,NaN,21.315473037531955,18.47633541360143
1999-03-18T09:30:00-05:00,27.96875,28.51562,27.96875,28.51562,9500,27675,63.6563074481692,59.97232608896735,NaN,NaN,83.77685824158571,99.48348225388249,0.03619702514577827,0.3580087557190055,0.3218117305732272,6700,-24600,62.720065165643376,43.1445806153602,NaN,NaN,22.236654445742776,19.01352384676448
1999-03-19T09:30:00-05:00,28.53125,28.65625,28.28125,28.39062,6900,27325,61.141145766141044,60.523412200305856,NaN,NaN,91.50945756310202,91.20355783666673,0.026716777834104644,0.355207702865858,0.32849092503175337,-200,2520,65.74977481299362,45.23567505298863,NaN,NaN,22.301578762535527,19.483245977588915
1999-03-22T09:30:00-05:00,28.3125,28.59375,28.28125,28.3125,40900,28480,59.55735867366042,60.97854082146783,NaN,NaN,76.69663383126746,83.29526958478388,0.01139397988305968,0.34273339988557794,0.33133942000251826,-41100,-7500,63.690275219505516,47.352933132819956,NaN,NaN,21.918701738161943,19.831168229099347
1999-03-23T09:30:00-05:00,28.25,28.25,27.4375,27.53125,15400,28500,46.56623234198129,60.69803441963891,NaN,NaN,-22.3215563488939,59.377445552120264,-0.05168565237644629,0.2667323545319604,0.3184180069084067,-56500,-18780,61.360146616614955,49.44960925968551,NaN,NaN,17.30384342382148,19.470121828345366
1999-03-24T09:30:00-05:00,27.46875,27.65625,27.34375,27.65625,12800,27740,48.501798866249466,60.08487524030367,NaN,NaN,-49.35516668145268,36.06124532112172,-0.08343904472821828,0.21411920099813386,0.29755824572635214,-43700,-26960,59.65568399250417,51.43926881678899,NaN,NaN,14.157831549710881,18.71122321711187
1999-03-25T09:30:00-05:00,27.90625,28.125,27.75,28.125,9700,23280,55.073936136967596,59.462508845379624,NaN,NaN,12.237342006859187,21.75334207417642,-0.0717656951006223,0.20785112685057427,0.2796168219511966,-34000,-35100,57.931160531412175,53.29910749025097,NaN,NaN,13.497619405990275,17.966422672665928
1999-03-26T09:30:00-05:00,27.92187,28.03125,27.84375,27.90625,6600,23070,51.754573041392746,58.5814777049294,NaN,NaN,-6.86255427919412,2.0789397057171914,-0.07719631653173653,0.18312142628652595,0.2603177428182625,-40600,-43180,56.194624921268804,54.82451348968165,NaN,NaN,11.885302156695815,17.097691170384483
1999-03-29T09:30:00-05:00,27.9375,28.32812,27.9375,28.25,8100,23035,56.22000690794475,58.290129460663046,NaN,NaN,34.24644423588525,-6.41109821335925,-0.0569893115963537,0.18908110332282035,0.24607041491917406,-32500,-41460,56.49359411586532,56.166017834122876,NaN,NaN,11.96054082224132,16.363812549221173
1999-03-30T09:30:00-05:00,28.21875,28.35937,28.09375,28.15625,37300,24325,54.7321429845159,57.700103713789964,NaN,NaN,35.92406383682227,5.238025823783981,-0.049562761478358586,0.18411696307122583,0.2336797245495844,-69800,-44120,55.85866179030585,57.19874979246161,NaN,NaN,11.559719660628078,15.677513565136445
1999-03-31T09:30:00-05:00,28.25,28.25,28,28,6300,23985,52.25018958851132,56.795463717376435,NaN,NaN,-8.12579701746321,13.483899756581874,-0.05441170530000586,0.1656650929245771,0.22007679822458295,-76100,-50600,54.25882145558529,57.8344820546714,NaN,NaN,10.476159420895737,14.93446297310206
1999-04-01T09:30:00-05:00,28,28.07812,27.65625,28,22500,24590,52.25018958851132,56.09738088366621,NaN,NaN,-79.58860076800377,-4.881288798390718,-0.05660497600530684,0.14932057821794942,0.20592555422325626,-76100,-59020,52.168022574709866,58.17170607210699,NaN,NaN,9.604324389310143,14.173014603988928
1999-04-05T09:30:00-04:00,28.4375,28.75,28.4375,28.625,12400,23940,60.5493583963711,55.91619920915956,NaN,NaN,145.8340249336778,25.658027044183665,-0.017003693299275785,0.18467093759916153,0.20167463089843732,-63700,-63640,51.006619395574056,58.093147342264,NaN,NaN,11.41031408942283,13.778343101908057
1999-04-06T09:30:00-04:00,28.75,28.875,28.5625,28.65625,14500,21530,60.91514361778975,55.849879860163256,NaN,NaN,150.42376012841402,48.89349022268942,0.008864658077243959,0.21275545349499225,0.2038907954177483,-49200,-66980,50.13759629896936,57.648420471992175,NaN,NaN,12.96081588338687,13.661553499262173
1999-04-07T09:30:00-04:00,28.84375,29.34375,28.84375,29.20312,15700,21705,66.72891340046196,56.42123548276198,NaN,NaN,225.02470705849666,86.7136188670243,0.05765487189170576,0.2759593852823805,0.21830451339067475,-33500,-59720,52.04995194643371,57.09107134552759,NaN,NaN,16.279696225021105,14.035573888656305
1999-04-08T09:30:00-04:00,29.125,29.5,29.09375,29.5,29600,22650,69.39076201710789,56.83083938054332,NaN,NaN,231.99630092728333,134.7380384559736,0.10216921648863814,0.3460160340014724,0.24384681751283427,-3900,-45280,55.69004136853119,56.58892678859099,NaN,NaN,19.941530629159818,14.879281994442522
1999-04-09T09:30:00-04:00,29.5,29.59375,29.28125,29.59375,6600,21800,70.20150957665787,57.47800822415166,NaN,NaN,208.30619811063423,192.3169982317012,0.12847386723477539,0.4044391515563035,0.2759652843215281,2700,-29520,59.3198156681227,56.129643992528784,NaN,NaN,23.13738653692688,16.05901121479743
1999-04-12T09:30:00-04:00,29.28125,30.34375,29.28125,30.34375,87300,24935,75.73799842038127,58.63376820606029,NaN,NaN,223.49035994021233,207.84826523300814,0.18357362534646116,0.5054323160046046,0.32185869065814343,90000,1220,65.29208207172407,56.24405876768726,NaN,NaN,28.07031528081462,17.77491179565703
1999-04-13T09:30:00-04:00,30.4375,30.46875,30.03125,30.03125,23600,18875,69.9095852249731,60.30115055484543,NaN,NaN,191.7707811787627,216.11766944307783,0.1856085093011326,0.5538693272845592,0.3682608179834266,66400,24340,68.98064861138212,56.78838033874205,NaN,NaN,30.139976921216206,19.541349670736913
1999-04-14T09:30:00-04:00,30.25,30.3125,29.75,29.75,96900,23265,65.0571605092806,61.48367638649051,NaN,NaN,136.06810299763674,198.32634863090587,0.1558479488491084,0.5630707540448121,0.4072228051957037,-30500,24940,69.07250764510036,57.461010599641774,NaN,NaN,30.212625795104163,21.065817688503664
1999-04-15T09:30:00-04:00,29.8125,29.8125,28.78125,29,17800,24020,54.24452824664452,61.42443296575315,NaN,NaN,53.22154257019794,162.5713969594888,0.0774489786642229,0.5040340285259823,0.42658504986175944,-48300,16060,65.95927598198985,58.034447417540186,NaN,NaN,26.368904083649074,21.823401459238724
1999-04-16T09:30:00-04:00,29,29,28.53125,28.71875,10400,24065,50.83263891393075,61.35858052807729,NaN,NaN,6.291602609558956,122.16847785927374,0.002412207132443389,0.4296003087773137,0.4271881016448703,-58700,3780,61.81033374378268,58.43556947629118,NaN,NaN,22.110657589485232,21.86443804927394
1999-04-19T09:30:00-04:00,28.9375,29.09375,27.875,27.9375,32700,25355,42.78275013088313,60.398776472572884,NaN,NaN,-38.28149618757162,69.81410663371693,-0.09849798168092494,0.3040656245437141,0.40256360622463905,-91400,-32500,51.50297444371008,58.0790966425658,NaN,NaN,15.369529940784563,20.936594033775457
1999-04-20T09:30:00-04:00,28.125,28.46875,27.90625,28.46875,15700,24095,48.72862523849097,59.96995377642825,NaN,NaN,-39.49801509627253,23.560347378709896,-0.1263500677661965,0.2446260215168934,0.3709760892830899,-75700,-60920,45.151173909529106,57.314276079653176,NaN,NaN,12.048182015381851,19.666820888290655
1999-04-21T09:30:00-04:00,28.40625,29.125,28.40625,29.125,16000,24125,54.95569523934367,60.16320418005913,NaN,NaN,16.080819859480453,-0.4371092489213687,-0.09868551271653125,0.24761919838742585,0.3463047111039571,-59700,-66760,43.95163851533011,56.57804872677781,NaN,NaN,11.619502430135283,18.51720396569703
1999-04-22T09:30:00-04:00,29.25,29.84375,29.25,29.71875,20200,24495,59.72213606129999,60.696914642401175,NaN,NaN,81.90446287591531,5.299474812222113,-0.04143810397186709,0.2945070811391233,0.33594518511099036,-39500,-65000,44.43077896244743,56.02538846875906,NaN,NaN,13.05284035550659,17.73658059281268
1999-04-23T09:30:00-04:00,29.90625,30.39062,29.90625,30.39062,9800,24500,64.32271442131903,60.96644007275461,NaN,NaN,129.5650324478294,29.95416077987621,0.036430142308913005,0.38148286299713163,0.34505272068821863,-29700,-59200,46.06704581092178,55.67256178414105,NaN,NaN,15.960644001613176,17.482875365498465
1999-04-26T09:30:00-04:00,30.53125,30.53125,30.1875,30.34375,36200,25980,63.775454115553586,61.17074796545203,NaN,NaN,126.22704294478582,62.8558686063477,0.07718980856841762,0.4415399813987406,0.364350172830323,-65900,-54100,47.530088571567255,55.48631123218375,NaN,NaN,17.947594688560258,17.549263840221577
1999-04-27T09:30:00-04:00,30.57812,30.59375,30.09375,30.375,13900,26270,63.995405782431526,60.975497421307,NaN,NaN,113.30076610646466,93.41562484689514,0.09736335143558206,0.4860543621248006,0.3886910106892185,-52000,-49360,48.917072526111575,55.26253413073216,NaN,NaN,19.551748317795823,17.835333051303614
1999-04-28T09:30:00-04:00,30.25,30.25,29.5625,29.5625,25500,25680,54.69631647120963,59.92589416802855,NaN,NaN,53.03385695843046,100.80623226668514,0.04950831590895993,0.45057640557541845,0.4010680896664585,-77500,-52920,47.8930951756681,54.70560940267052,NaN,NaN,17.84017361161734,17.83602455991986
1999-04-29T09:30:00-04:00,29.625,29.8125,29.03125,29.21875,9800,25855,51.299964382615016,58.57578379702549,NaN,NaN,3.686410688277126,85.1626218291575,-0.008675384135241049,0.39022385949740723,0.3988992436326483,-87300,-62480,45.15927804850003,53.694142429840326,NaN,NaN,15.322514664934712,17.476951717779123
1999-04-30T09:30:00-04:00,29.4375,29.59375,29,29,5800,25020,49.20603035501225,56.6806432209277,NaN,NaN,-22.775978212611275,54.694419697069364,-0.06228582436675073,0.32104196317420985,0.3833277875409606,-93100,-75160,41.754811095431954,52.0129087886766,NaN,NaN,12.626452185572868,16.78402321317823
1999-05-03T09:30:00-04:00,29.34375,29.59375,29.25,29.5625,13000,25050,54.36436141324604,55.57027009151862,NaN,NaN,5.326581359374662,30.514327379987133,-0.06021997423203562,0.30805281975091603,0.36827279398295165,-80100,-78000,41.00910752869588,50.01494156848472,NaN,NaN,11.973948240151175,16.096869645602936
1999-05-04T09:30:00-04:00,29.6875,29.6875,29,29,23000,25475,49.00489890372106,54.4236799768358,NaN,NaN,-30.953629936569367,1.6634481713803246,-0.09502321749482273,0.24949377211442325,0.344516989609246,-103100,-88220,38.354540360048226,47.82080104812385,NaN,NaN,9.650415450069582,15.1759476176696
1999-05-05T09:30:00-04:00,29.09375,29.3125,28.8125,29.25,17100,25545,51.30270789137304,54.213549951459264,NaN,NaN,-45.207431830878804,-17.984809586481532,-0.09904242171891958,0.2207139624605965,0.3197563841795161,-86000,-89920,37.91489152413059,45.817630729705336,NaN,NaN,8.499741214014769,14.22220384571891
1999-05-06T09:30:00-04:00,29.375,29.59375,29.3125,29.375,17500,24940,52.4562503513434,54.32952219698874,NaN,NaN,-4.175644351555737,-19.557220594448108,-0.0913075635965494,0.2056219296838293,0.2969294932803787,-68500,-86160,39.56495851534579,44.22867535624556,NaN,NaN,7.923360184716451,13.322369037004274
1999-05-07T09:30:00-04:00,29.625,29.625,29.1875,29.28125,8000,25010,51.47146573657569,54.95014474025249,NaN,NaN,-11.891950912638505,-17.380415134453553,-0.09036296650651959,0.18397578514722923,0.2743387516537488,-76500,-82840,41.05465759418951,43.482367009851224,NaN,NaN,7.1688171212477405,12.443290191896198
1999-05-10T09:30:00-04:00,29.3125,29.5625,29.15625,29.21875,27300,22010,50.78694046444856,55.09716725639232,NaN,NaN,-15.208244262818338,-21.487380258892152,-0.0915236333491532,0.15993420996730734,0.25145784331646054,-103800,-87580,39.555519105460256,43.082677380989175,NaN,NaN,6.358261732110525,11.574000411926816
1999-05-11T09:30:00-04:00,29.5625,29.75,29.5,29.6875,51000,23380,55.5604575012393,55.14036456081344,NaN,NaN,39.596002348838375,-7.3774538018106055,-0.059831259988378405,0.17666876833098755,0.23650002831936595,-52800,-77520,44.2116695772748,43.10125102827094,NaN,NaN,7.007720295466324,10.92167468100389
1999-05-12T09:30:00-04:00,29.46875,30.0625,29.40625,29.96875,8100,18940,58.181434310017906,55.03031443572185,NaN,NaN,67.50436695598627,15.164905955562409,-0.02103804849967622,0.2102024676947707,0.2312405161944469,-44700,-69260,47.769316264676924,43.33971797843019,NaN,NaN,8.321480202426766,10.550218326921444
1999-05-13T09:30:00-04:00,30.09375,30.09375,29.75,29.78125,9600,18530,55.817907281178165,54.42282821142607,NaN,NaN,69.52046402681042,29.904127631235646,-0.009694353433903347,0.21912257440206773,0.22881692783597107,-54300,-66420,48.97416505859354,43.54736935326388,NaN,NaN,8.766596556235793,10.295415216823494
1999-05-14T09:30:00-04:00,29.125,29.3125,29.125,29.25,4600,18240,49.66211804383308,53.41473277773175,NaN,NaN,-34.17302589577586,25.447912634608173,-0.038065365261314266,0.18123522125932823,0.2193005865206425,-58900,-62900,50.49834268516021,43.7593875042348,NaN,NaN,7.347853473029831,9.874334967710114
1999-05-17T09:30:00-04:00,28.90625,29.0625,28.6875,29.0625,5800,16895,47.664147706908366,52.24821434376582,NaN,NaN,-92.29392577177654,10.030776332816533,-0.0678174500421933,0.13452877396790086,0.20234622401009417,-64700,-55080,53.80002991343642,44.108170174758015,NaN,NaN,5.581072975944055,9.261011826029248
1999-05-18T09:30:00-04:00,28.9375,29.21875,28.75,28.75,8500,16535,44.45411677528034,51.51662865119943,NaN,NaN,-110.1532868278683,-19.9190815025248,-0.10469814943777306,0.07147353721287786,0.17617168665065092,-73200,-59160,51.85664555035596,44.391280915807144,NaN,NaN,3.120084928151953,8.383736554903921
1999-05-19T09:30:00-04:00,28.96875,29.1875,28.90625,29.09375,12100,16340,48.558154067524875,51.32078505726442,NaN,NaN,-84.70107150040832,-50.36016919380372,-0.10199460902368557,0.04867842537104394,0.1506730343947295,-61100,-62440,50.28409298423268,44.757339125502334,NaN,NaN,2.1925330152448996,7.499278906381203
1999-05-20T09:30:00-04:00,29.25,29.625,29.25,29.48437,15300,16095,52.823746185092794,51.5791933308416,NaN,NaN,-10.119981848414893,-66.28825836884877,-0.07139855777846651,0.061424837171646374,0.1328233949501129,-45800,-60740,51.11158997977068,45.425680474383675,NaN,NaN,2.663492091858324,6.808452218592221
1999-05-21T09:30:00-04:00,29.375,29.375,29.0625,29.15625,8400,16025,49.137859926348725,51.20587179606322,NaN,NaN,-54.96614013386749,-70.44688121646712,-0.07062949261256588,0.04453652918440554,0.11516602179697141,-54200,-59800,51.59138674524244,46.18155756127986,NaN,NaN,1.9644208377095265,6.116447735608979
1999-05-24T09:30:00-04:00,29.21875,29.25,28.46875,28.46875,14000,14915,42.45361849888793,50.737923195718,NaN,NaN,-151.37618054598258,-82.26333217130832,-0.11136953326550107,-0.02404589478490493,0.08732363848059614,-68200,-60500,51.188503961175186,47.09826924707465,NaN,NaN,-0.8076291624000224,5.127293893036264
1999-05-25T09:30:00-04:00,28.5,28.75,28.1875,28.1875,7200,14580,40.05324872538245,49.934390398147244,NaN,NaN,-217.5008324837274,-103.73284130248014,-0.149811257409941,-0.09994043328183011,0.049870824128110884,-75400,-60940,50.91933588003072,48.02715812963894,NaN,NaN,-3.8567087037094034,3.843864950644026
1999-05-26T09:30:00-04:00,28.375,28.375,27.96875,28.21875,9300,13770,40.45609829075947,49.0772366795341,NaN,NaN,-220.92726725030147,-130.97808045245876,-0.16451279248869988,-0.15577016648276398,0.008742626005935908,-66100,-61940,50.27232424160261,48.79196996722872,NaN,NaN,-6.1738062120845445,2.4127690702542304
1999-05-27T09:30:00-04:00,28.10937,28.10937,27.73437,27.90625,6600,13610,37.72585691512506,48.09540747800192,NaN,NaN,-214.74159567627453,-171.90240321803068,-0.18512612222873992,-0.222665026779989,-0.03753890455124907,-72700,-67320,46.825059340269654,49.204141520520146,NaN,NaN,-8.97041510817928,0.7865999019065861
1999-05-28T09:30:00-04:00,28,28.125,27.95312,28.10937,6000,13620,40.53495034241217,47.36312246928503,NaN,NaN,-153.77587194697136,-191.66434958065147,-0.1750366618277031,-0.25633473183587796,-0.08129807000817485,-66700,-69820,45.27155136664913,49.612429539176496,NaN,NaN,-10.504765678072719,-0.826452323804743
1999-06-01T09:30:00-04:00,27.96875,28.1875,27.84375,28.1875,4400,13190,41.625711941867166,46.367783500758456,NaN,NaN,-128.72171127607777,-187.13345572667052,-0.15380981940638122,-0.2735603442661514,-0.11975052485977017,-62300,-68640,46.17918812691873,49.75296657843678,NaN,NaN,-11.467466597678182,-2.3465972200723773
1999-06-02T09:30:00-04:00,28.34375,28.34375,27.78125,28.09375,9200,12500,40.66189662979093,45.11638795217082,NaN,NaN,-111.28402171525863,-165.89009357297675,-0.13733344422313212,-0.2914173301386853,-0.1540838859155532,-71500,-67860,46.80717315389252,49.6842420705236,NaN,NaN,-12.536817224348479,-3.802342934968963
1999-06-03T09:30:00-04:00,28.28125,28.4375,28.28125,28.3125,4900,11890,43.92451767754108,44.2668601233396,NaN,NaN,-68.15558190864259,-135.33575650464496,-0.10444225804378757,-0.28463670847028766,-0.1801944504265001,-66600,-67960,46.73188919251425,49.5240795086608,NaN,NaN,-12.575999800602581,-5.055722487202337
1999-06-04T09:30:00-04:00,28.875,29.03125,28.8125,29,1200,11075,52.72273425443137,44.48547556695377,NaN,NaN,9.240905623163767,-90.53925624475733,-0.03283422172234632,-0.22123722757943298,-0.18840300585708666,-65400,-66500,48.04574796704919,49.348894171652866,NaN,NaN,-9.945753642743984,-5.75429836656543
1999-06-07T09:30:00-04:00,28.75,28.75,28.53125,28.75,4200,10885,49.67080263991968,44.62880806216886,NaN,NaN,-21.284809313072593,-64.04104371797756,-0.00046724938858330733,-0.1889870675928158,-0.1885198182042325,-69600,-67080,47.54405566393494,48.90203886811704,NaN,NaN,-8.622995554489195,-6.164112250554539
1999-06-08T09:30:00-04:00,28.625,28.76562,28.51562,28.51562,6400,9840,46.9281218133212,44.80552270774321,NaN,NaN,-27.414878866443683,-43.77967723605074,0.006605350954525441,-0.1802631295110757,-0.18686848046560114,-76000,-69820,45.14573913896361,48.422688410160454,NaN,NaN,-8.308975912253896,-6.470521345083019
1999-06-09T09:30:00-04:00,28.53125,28.75,28.48437,28.53125,3000,7440,47.137746716631234,44.70406503982223,NaN,NaN,-23.480330458815605,-26.218938984762133,0.013393170770512358,-0.1701270170024607,-0.18352018777297305,-73000,-70120,44.878803281090946,48.036596288507475,NaN,NaN,-7.994550442057985,-6.688239787508014
1999-06-10T09:30:00-04:00,28.21875,28.29687,27.9375,28.29687,13300,7700,44.31131002090306,44.09603388523725,NaN,NaN,-76.33458136338865,-27.854738875711355,0.003661087061717583,-0.17894382894582606,-0.18260491600754364,-86300,-74060,41.415336738825744,47.344006771297124,NaN,NaN,-8.513782797164094,-6.949031646030311
1999-06-11T09:30:00-04:00,28.4375,28.46875,27.96875,27.96875,2500,7345,40.63767401524334,43.48887774872971,NaN,NaN,-76.44283249855768,-44.99148650005564,-0.021905792387415662,-0.2099871564918132,-0.18808136410439755,-88800,-78740,37.69417703401103,46.351348934780596,NaN,NaN,-10.029743343856547,-7.389133317148344
1999-06-14T09:30:00-04:00,28.25,28.25,28.0625,28.125,12700,7750,43.0586009017701,43.532090777507015,NaN,NaN,-67.21406148175004,-54.17733693379114,-0.025096067412338496,-0.21945144836982067,-0.19435538095748217,-76100,-80040,36.707546276417794,45.316994814440775,NaN,NaN,-10.626183826316169,-7.851569104172319
1999-06-15T09:30:00-04:00,28.3125,28.6875,28.3125,28.4375,3600,7640,47.65639066667925,44.075172344742505,NaN,NaN,-5.059461868621978,-49.706253534226796,-0.004065171816986984,-0.1994368457287159,-0.1953716739117289,-72500,-79340,37.65384752405214,44.369459931870885,NaN,NaN,-9.817740623823152,-8.132450749836725
1999-06-16T09:30:00-04:00,28.9375,29,28.90625,29,13500,7890,54.74053752044005,45.09548943257683,NaN,NaN,84.15090620235179,-28.180006201993315,0.047008291285370596,-0.13661130980501568,-0.18361960109038628,-59000,-76540,41.42630845278044,43.73760166124073,NaN,NaN,-6.863353393524922,-7.951151127506467
1999-06-17T09:30:00-04:00,29.0625,29.26562,28.96875,29.14062,12300,7900,56.331646607198984,46.42447441058211,NaN,NaN,111.16592605961392,9.320095282607202,0.08720396093311086,-0.07461464992399769,-0.16181861085710855,-46700,-68620,50.54224556873051,44.00311496327365,NaN,NaN,-3.952181799815229,-7.379869794979148
1999-06-18T09:30:00-04:00,29,29.15625,28.9375,29,6200,7445,54.27675406921676,47.40603181963958,NaN,NaN,104.58330518876252,45.525322820071246,0.10032768171965453,-0.03640900870754038,-0.1367366904271949,-52900,-61440,57.06582289047047,44.845562929260886,NaN,NaN,-2.126882569401559,-6.6294430484680635
1999-06-21T09:30:00-04:00,29.09375,29.09375,28.84375,28.85937,14100,7730,52.22497554038945,48.163122076676885,NaN,NaN,91.85761269652124,77.3396576557255,0.09556595704376851,-0.017279244122484272,-0.11284520116625278,-67000,-59620,58.55801121112644,45.729764578132865,NaN,NaN,-1.1777912684457292,-5.8506356513220155
1999-06-22T09:30:00-04:00,29.09375,29.09375,28.8125,28.8125,3900,7225,51.525868629504565,48.93912007665643,NaN,NaN,82.38000509306565,94.82755104806301,0.08560932913901607,-0.005833539742482685,-0.09144286888149876,-70900,-59300,58.82895280430466,46.58846312459088,NaN,NaN,-0.5828388177241277,-5.098093246522318
1999-06-23T09:30:00-04:00,28.70312,28.875,28.46875,28.875,7900,7260,52.44014112420955,49.5473788942756,NaN,NaN,45.09678336917605,87.01672648142787,0.07970319633336781,0.008186126535211002,-0.07151706979815681,-63000,-60100,57.81136243559297,47.37985407052508,NaN,NaN,0.16228803215904108,-4.346610206710695
1999-06-24T09:30:00-04:00,28.5625,28.65625,28.20312,28.34375,14100,7500,44.71930592665106,48.9757054422913,NaN,NaN,-22.877946169773825,60.20795203555032,0.038572047027322885,-0.0233020110140032,-0.061874058041326084,-77100,-66180,50.64184875764179,47.5652898412817,NaN,NaN,-1.387239383277682,-3.9238429462202644
1999-06-25T09:30:00-04:00,28.625,28.625,28.375,28.375,3000,7320,45.23013762951744,48.65851508440543,NaN,NaN,-18.355649561614687,35.620161085474884,0.013328225013359077,-0.045213776774627235,-0.05854200178798631,-74100,-70420,46.32707222146118,47.478362452533574,NaN,NaN,-2.5161462968610744,-3.7227434248832374
1999-06-28T09:30:00-04:00,28.4375,28.6875,28.40625,28.6875,3000,7170,50.187258232776784,48.891310542937966,NaN,NaN,5.620923811172176,18.37282330840507,0.01728393504869709,-0.036937082977114954,-0.05422101802581204,-71100,-71240,45.51932175400658,47.505046925036645,NaN,NaN,-2.0967425139400664,-3.490457580462784
1999-06-29T09:30:00-04:00,28.75,29.03125,28.65625,28.96875,2100,7055,54.20458388454981,49.396084626360725,NaN,NaN,67.40726601144766,15.378275492081475,0.03730028564858828,-0.007595660965076689,-0.04489594661366497,-69000,-70860,45.98929875653575,47.58436803042555,NaN,NaN,-0.546402330154918,-3.069878258990232
1999-06-30T09:30:00-04:00,29.03125,29.46875,28.75,29.34375,22500,7720,58.95743790126657,50.44223661781526,NaN,NaN,126.86950342873837,31.732819503993944,0.07223173552097024,0.04539372278754783,-0.02683801273342241,-46500,-67560,50.021415345180905,48.19908793087949,NaN,NaN,2.288426770314663,-2.3044061119466757
1999-07-01T09:30:00-04:00,29.21875,29.5,29.125,29.4375,3900,7670,60.07307518513913,51.8304795585221,NaN,NaN,145.974978967225,65.50340453139371,0.09656716765511636,0.09387094683547303,-0.002696220819643321,-42600,-60660,57.21385544454841,49.59335067448931,NaN,NaN,4.94731408410281,-1.2684460839396066
1999-07-02T09:30:00-04:00,29.53125,29.53125,29.21875,29.4375,17700,8495,60.07307518513913,53.04579915019132,NaN,NaN,139.64565441879196,97.10366532747504,0.10678251549352037,0.13078192354725715,0.023999408053736775,-42600,-54360,62.51774159218028,51.436936054186624,NaN,NaN,7.108780288960628,-0.071699459239573
1999-07-06T09:30:00-04:00,29.125,29.40625,29.125,29.375,7100,8640,58.836519614745164,53.844379789338895,NaN,NaN,104.71800971354745,116.92308250795008,0.1033801796917996,0.1532246326684863,0.04984445297668669,-49700,-50080,65.63448992723141,53.43555336869942,NaN,NaN,8.593392277265416,1.1661707888325683
1999-07-07T09:30:00-04:00,29.375,29.5625,29.34375,29.5625,3200,8480,61.403306507795925,54.320291859864305,NaN,NaN,124.43873998414415,128.32937730248938,0.10733969128088099,0.18401906707778792,0.07667937579690694,-46500,-45580,68.59164814515798,55.37593477529782,NaN,NaN,10.599794284245704,2.513831288177302
1999-07-08T09:30:00-04:00,29.375,29.57812,29.3125,29.5,9600,8810,60.05893657015619,54.586526857218395,NaN,NaN,107.87571435305051,124.53061948735183,0.09950683722811385,0.20106292233204925,0.1015560851039354,-56100,-47500,65.98275893826049,56.47882858740711,NaN,NaN,11.941411169699753,3.8606284141090805
1999-07-09T09:30:00-04:00,29.40625,29.625,29.40625,29.625,17000,8995,61.85759930724018,55.12801580279149,NaN,NaN,115.65082979294401,118.46578965249562,0.09643238375535754,0.22209656479813233,0.1256641810427748,-39100,-46800,66.48328573053101,57.15150450455429,NaN,NaN,13.585389924934384,5.249880058512695
1999-07-12T09:30:00-04:00,29.6875,29.78125,29.5,29.6875,4700,9105,62.76059876766159,55.88056031902522,NaN,NaN,123.52807060530708,115.24227288979864,0.09229317861449518,0.24103065431089377,0.14873747569639859,-34400,-45160,67.68303182206292,57.80329169104976,NaN,NaN,15.22588710164835,6.675023921817789
1999-07-13T09:30:00-04:00,29.625,29.75,29.5625,29.625,5300,8735,61.20026519140989,56.5715886448756,NaN,NaN,111.65780865782469,116.6302326786541,0.07951602892866971,0.24813251185723573,0.168616482928566,-39700,-43160,69.13406765599353,58.53937132331324,NaN,NaN,16.239601223901794,8.04139210782979
1999-07-14T09:30:00-04:00,29.75,29.75,29.4375,29.6875,19700,9540,62.212005158635016,57.269578933048855,NaN,NaN,98.40273280966811,111.42303124375887,0.06979055710946555,0.25585467931539796,0.1860641222059324,-20000,-37860,72.63993306841803,59.598554939943604,NaN,NaN,17.371638061774526,9.374284386964751
1999-07-15T09:30:00-04:00,29.90625,29.90625,29.65625,29.82812,12700,9500,64.45763529429027,58.679459602165934,NaN,NaN,117.35670884557295,113.31923014226338,0.06731401226018513,0.2702066375311638,0.20289262527097868,-7300,-28100,77.66990008915741,61.52913003505187,NaN,NaN,18.958564377795685,10.743467242797742
1999-07-16T09:30:00-04:00,29.84375,29.9375,29.65625,29.84375,4900,9130,64.70867872795372,60.07078396633995,NaN,NaN,106.3496947658529,111.45900313684515,0.06138078692315907,0.2796186089249275,0.21823782200176844,-2400,-20760,80.56383921126366,63.97461339146633,NaN,NaN,20.373164203942192,12.119138237246949
1999-07-19T09:30:00-04:00,30.03125,30.03125,29.6875,29.71875,7000,9170,60.99799591782197,60.84297951527175,NaN,NaN,96.06485537352724,105.96636009048919,0.04447743340766391,0.2738346137613483,0.2293571803536844,-9400,-15760,82.2512652680344,66.59832364246832,NaN,NaN,20.69758678796069,13.344630887348911
1999-07-20T09:30:00-04:00,29.625,29.78125,29.53125,29.59375,18900,9410,57.4501315320494,61.07480434723601,NaN,NaN,60.911217962099435,95.81704195134414,0.02148294473176393,0.2562108612683893,0.2347279165366254,-28300,-13480,82.97703523729814,69.24030481966562,NaN,NaN,20.065697547103536,14.304783267313857
1999-07-21T09:30:00-04:00,29.4375,29.65625,29.375,29.53125,16200,10025,55.70549808649586,60.842522931895246,NaN,NaN,37.36765335886757,83.61002606118403,-0.00018430035279221046,0.23449754109563514,0.23468184144842735,-44500,-18380,75.8029939618761,71.08184614942958,NaN,NaN,19.067101660070545,14.985114466279098
1999-07-22T09:30:00-04:00,29.375,29.5,29.03125,29.0625,12100,10235,44.73337280872344,59.746829905008404,NaN,NaN,-28.147062359622215,54.50927182014501,-0.04580932794466136,0.17742018151760064,0.223229509462262,-56600,-28240,63.84175207181444,71.55526733709144,NaN,NaN,14.751999719746006,14.951812359631514
1999-07-23T09:30:00-04:00,29,29.1875,28.75,28.8125,27300,10895,40.18703151930835,58.32639821459191,NaN,NaN,-98.82920793206952,13.4734912805605,-0.08999436744981426,0.11073655014999417,0.20073091759980843,-83900,-44540,49.840479793512394,70.64974863718659,NaN,NaN,9.503874313636183,14.173535495917896
1999-07-26T09:30:00-04:00,28.5625,28.96875,28.5625,28.84375,17400,11615,40.994301939203254,57.05195409491035,NaN,NaN,-139.25764684727213,-33.591009163599374,-0.1128067642201179,0.05972246232466105,0.17252922654477895,-66500,-55960,42.76418263013173,69.01615525882232,NaN,NaN,5.477725067391768,12.931276863271307
1999-07-27T09:30:00-04:00,29.28125,29.46875,29.03125,29.375,16300,12280,52.6853386310397,56.429242103713484,NaN,NaN,-34.33473938856897,-52.64020063373306,-0.08886139770376403,0.061452479415073924,0.15031387711883795,-50200,-60340,40.39528025424807,67.0021289809002,NaN,NaN,5.440167722605725,11.861118414604796
1999-07-28T09:30:00-04:00,29.28125,29.34375,29.09375,29.15625,7400,12545,48.43024123477643,55.59862100832921,NaN,NaN,-69.28406147916401,-73.97054360133939,-0.08452514145143744,0.04465745030454116,0.1291825917559786,-57600,-62960,39.00346360513064,65.0750364571052,NaN,NaN,3.989831895195401,10.736648911832026
1999-07-29T09:30:00-04:00,28.84375,28.875,28.5625,28.65625,10500,11945,40.398779413260876,54.065848158759266,NaN,NaN,-187.46998003856072,-105.83512713712707,-0.11046287739274947,-0.008896004984958239,0.10156687240779123,-68100,-65260,37.77306767318998,63.02430659586655,NaN,NaN,-0.21789060825866627,9.171714694676213
1999-07-30T09:30:00-04:00,28.6875,28.84375,28.46875,28.46875,2800,11890,37.86301385714755,52.28744923657969,NaN,NaN,-174.26904668926062,-120.92309488856529,-0.13382127897328133,-0.06570972630881045,0.0681115526644709,-70900,-62660,40.07442530980096,61.052263273562126,NaN,NaN,-4.466603195434426,7.22338356751755
1999-08-02T09:30:00-04:00,28.5,28.65625,28.25,28.28125,87600,15385,35.46565254254163,50.449262618803395,NaN,NaN,-176.3595230016086,-128.3434701194326,-0.15403351197366694,-0.12443033730261277,0.029603174671054167,-158500,-81060,31.26269344795955,58.347165115845414,NaN,NaN,-8.719193005440088,4.9458726285236025
1999-08-03T09:30:00-04:00,28.3125,28.3125,27.92187,28.15625,5500,15305,33.92355075637779,48.42865873292788,NaN,NaN,-180.91334613653848,-157.6591914690265,-0.16687455128624848,-0.17899001443675644,-0.01211546315050796,-164000,-103820,24.180114284033124,54.88574948838935,NaN,NaN,-12.637466959046384,2.4339669731564615
1999-08-04T09:30:00-04:00,28.09375,28.15625,27.75,27.75,86400,19465,29.442787000751608,45.927598140532254,NaN,NaN,-177.88501386913194,-179.37938194702008,-0.19199069779057812,-0.2521038353887306,-0.06011313759815249,-250400,-142380,17.108409376032043,50.55992872316612,NaN,NaN,-17.62033470724969,-0.43093326690156
1999-08-05T09:30:00-04:00,27.75,27.75,27.1875,27.67187,31900,20580,28.658784155680294,43.352605671084156,NaN,NaN,-180.1516380738042,-177.91571355406876,-0.20210657628428683,-0.312746357953511,-0.1106397816692242,-282300,-185220,12.673691227822019,45.71063243863456,NaN,NaN,-21.805198567103957,-3.484399738359045
1999-08-06T09:30:00-04:00,27.40625,27.53125,27.25,27.375,11700,20315,25.84290961188215,40.84152807780273,NaN,NaN,-164.34628719527782,-175.9311616552722,-0.21578912034025294,-0.3803761820945404,-0.16458706175428744,-294000,-229840,9.818850803770488,40.536888548330005,NaN,NaN,-26.310940234987452,-6.745334095020246
1999-08-09T09:30:00-04:00,27.375,27.5,27.3125,27.40625,6200,20390,26.659804160723397,38.64221897985088,NaN,NaN,-139.7869146150606,-168.61663997796262,-0.20955824079733998,-0.4265348627509624,-0.21697662195362244,-287800,-255700,8.608552350222325,35.22485405639602,NaN,NaN,-29.615496648581065,-10.012500174100362
1999-08-10T09:30:00-04:00,27.15625,27.15625,26.6875,26.85937,6000,20425,22.076573743650385,36.240152955361914,NaN,NaN,-159.9909454959352,-164.43215984984195,-0.22758992649431298,-0.5014640300715136,-0.27387410357720066,-293800,-281660,7.596287695609618,30.352946465948413,NaN,NaN,-34.23646283866961,-13.473066269038826
1999-08-11T09:30:00-04:00,26.79687,27.125,26.79687,27.125,11700,20025,28.505753853959206,35.0810373157359,NaN,NaN,-129.84184544049864,-154.82352616411532,-0.20751245377178024,-0.533264670791926,-0.32575221702014573,-282100,-288000,7.368407371008587,26.319136130176563,NaN,NaN,-35.88884876762943,-16.675320911694627
1999-08-12T09:30:00-04:00,27.1875,27.3125,27.03125,27.125,10000,19890,28.505753853959206,34.246660339639526,NaN,NaN,-104.24054047449755,-139.64130664425397,-0.18108031632784194,-0.5521026124299482,-0.37102229610210624,-282100,-287960,7.387284305165551,23.286765023866078,NaN,NaN,-37.16911421159453,-19.603005668823183
1999-08-13T09:30:00-04:00,27.5,27.6875,27.46875,27.59375,8000,20045,38.83409315359577,34.09235971209614,NaN,NaN,-62.74554248846057,-119.32115770289053,-0.12172356588446442,-0.5231767534576868,-0.40145318757322235,-274100,-283980,9.366391713516705,20.90120852982215,NaN,NaN,-34.851685744467666,-21.781388536772393
1999-08-16T09:30:00-04:00,27.625,27.84375,27.5625,27.59375,18400,20615,38.83409315359577,33.10298503513586,NaN,NaN,-49.54287109870555,-101.27234899961952,-0.0744789820951457,-0.49455191519215447,-0.42007293309700877,-274100,-281240,10.779948913162968,18.785827719744642,NaN,NaN,-33.049474644278945,-23.391115123559043
1999-08-17T09:30:00-04:00,27.875,28.03125,27.73437,27.9375,15100,20425,45.52695487004794,32.89560743765525,NaN,NaN,-23.924532414823172,-74.0590663833971,-0.015195634260071256,-0.4390674759220978,-0.42387184166202657,-259000,-274280,14.430726063482254,17.03063218105547,NaN,NaN,-29.30278397832946,-24.235639245669102
1999-08-18T09:30:00-04:00,28.0625,28.26562,27.92187,28.125,7900,20010,48.81678336169932,33.49689343397229,NaN,NaN,1.6980572004108425,-47.75108585521521,0.03858877054739707,-0.37563587847778024,-0.4142246490251773,-251100,-268080,17.662834346996377,15.594186943470207,NaN,NaN,-25.143829623674918,-24.365380728241362
1999-08-19T09:30:00-04:00,27.75,28,27.70312,28,4900,19650,46.788072375137936,34.134397613828746,NaN,NaN,-13.739761636399926,-29.65093008759568,0.06607610546605952,-0.3316295171926029,-0.39770562265866244,-256000,-262860,20.389317990365583,14.188107849224824,NaN,NaN,-22.341324242589383,-24.076229801719652
1999-08-20T09:30:00-04:00,28.0625,28.125,27.9375,27.9375,2700,18420,45.764002224913575,34.86999401971246,NaN,NaN,2.824396422472229,-16.53694230540912,0.07947801809864913,-0.298358100035351,-0.37783611813400014,-258700,-259780,22.029907499266855,13.52862313860392,NaN,NaN,-20.351646471122756,-23.54414646877724
1999-08-23T09:30:00-04:00,28.21875,28.25,28.07812,28.20312,8700,17985,50.702396910984284,36.06848303075578,NaN,NaN,30.33071601750529,-0.562224882166948,0.10410761588834522,-0.24770159827356864,-0.35180921416191385,-250000,-254960,24.646947965346357,13.561968401554866,NaN,NaN,-17.111123234385424,-22.62514314957841
1999-08-24T09:30:00-04:00,28.125,28.125,27.625,27.8125,14300,17885,44.312384911983514,37.13059716727235,NaN,NaN,-3.10212960548732,3.602255679700228,0.09236639898437288,-0.23635121543144777,-0.32871761441582065,-264300,-256020,24.45256850005181,14.086551196127703,NaN,NaN,-16.20879136662116,-21.7085214662988
1999-08-25T09:30:00-04:00,27.65625,28.375,27.64062,28.375,22100,18620,53.4168558774045,38.89903086168122,NaN,NaN,52.601162233427864,13.782876686303627,0.11905952407253301,-0.1798932093251544,-0.2989527333976874,-242200,-254240,25.5148889092048,15.003779601940758,NaN,NaN,-12.241329476711986,-20.3560654677864
1999-08-26T09:30:00-04:00,28.1875,28.34375,28.03125,28.15625,6000,18395,49.99373748446176,40.62408999543691,NaN,NaN,68.66069656461998,30.26296832650761,0.11831434180282374,-0.1510598061441577,-0.26937414794698145,-248200,-252680,26.490481911689386,16.194610395363533,NaN,NaN,-10.168000673111958,-18.900627639975767
1999-08-27T09:30:00-04:00,28.1875,28.1875,27.82812,27.95312,6500,18580,46.98285573527071,42.07573653647599,NaN,NaN,43.20578114078382,38.33924527016993,0.10113759332682096,-0.14295215628845526,-0.2440897496152762,-254700,-251880,27.018395313160227,17.509599178430527,NaN,NaN,-9.462405185656989,-17.552310146501654
1999-08-30T09:30:00-04:00,27.92187,27.92187,27.28125,27.28125,18000,15100,38.684202679887356,43.26199574620721,NaN,NaN,-45.014218709704394,23.27025832472799,0.044417886252275385,-0.18856739179993198,-0.23298527805220737,-272700,-256420,25.882405848930404,18.815750475096298,NaN,NaN,-11.795154552835443,-16.72985934740648
1999-08-31T09:30:00-04:00,27.1875,27.32812,26.875,27.1875,18100,15730,37.68398230094055,43.91758349242017,NaN,NaN,-105.12450220144827,2.865783805535801,0.0026797900309810108,-0.22963554051348112,-0.23231533054446213,-290800,-261720,24.5829729578505,20.04536230272786,NaN,NaN,-13.936923710717503,-16.3308685421652
1999-09-01T09:30:00-04:00,27.0625,27.34375,27.03125,27.21875,3800,11600,38.257059051157206,44.614105292220025,NaN,NaN,-82.23186974312317,-24.100822589774406,-0.01950904258301639,-0.25670163377323263,-0.23719259119021624,-287000,-270680,22.524169787576113,21.12656840861433,NaN,NaN,-15.431288904890408,-16.20235716541166
1999-09-02T09:30:00-04:00,26.9375,27.10937,26.90625,26.9375,8600,10435,35.12614742031879,44.349252025557384,NaN,NaN,-108.71952803882994,-59.57686751046439,-0.04818015511789536,-0.29741778508758543,-0.24923762996969007,-295600,-280160,20.562023895507465,21.92625642161367,NaN,NaN,-17.694451111339042,-16.415513443401284
1999-09-03T09:30:00-04:00,27.57812,27.89062,27.5625,27.79687,6200,10160,48.88993603513373,45.06752651709581,NaN,NaN,21.951336635866685,-63.82775641144782,-0.006509732005649194,-0.25737479497675153,-0.25086506297110234,-289400,-287100,19.240614877450795,22.530589704777082,NaN,NaN,-14.923628691252619,-16.20238705023719
1999-09-07T09:30:00-04:00,28.04687,28.21875,28.04687,28.125,11500,10425,52.99102785695514,45.60067458758918,NaN,NaN,81.36378004011824,-38.55215666148329,0.04317731174109066,-0.19689342329473902,-0.24007073503582968,-277900,-288140,19.043114496495548,22.86004602142089,NaN,NaN,-11.229581805220587,-15.491986300949103
1999-09-08T09:30:00-04:00,28,28.25,28,28,14300,10840,51.30222849166205,45.77820638258652,NaN,NaN,68.13758283773608,-3.899739653646418,0.06626823322360231,-0.1572354435063268,-0.2235036767299291,-292200,-288420,18.98660704402468,22.95460121406577,NaN,NaN,-8.905527152692132,-14.55106356548382
1999-09-09T09:30:00-04:00,27.96875,28.04687,26.75,27.8125,6900,10600,48.79042171449729,45.921231335397906,NaN,NaN,-43.548509857944744,3.8369323233892674,0.06733911356654626,-0.1393297847717463,-0.20666889833829255,-299100,-290840,18.476307764002826,22.81795762646843,NaN,NaN,-7.833054864632438,-13.591348036790766
1999-09-10T09:30:00-04:00,27.95312,28.0625,27.79687,27.96875,11300,10665,50.94582913679575,46.29136182910377,NaN,NaN,35.25184267502692,32.63120646616064,0.07633596388137912,-0.11124894348656866,-0.18758490736794778,-287800,-289280,19.969538195643537,22.670788390495336,NaN,NaN,-6.2880803562317,-12.548024082425185
1999-09-13T09:30:00-04:00,27.9375,27.98437,27.76562,27.92187,5500,10540,50.262275526332076,46.259924587342894,NaN,NaN,20.68049869420298,32.3770388778279,0.0766917617087974,-0.09172020523195101,-0.16841196694074842,-293300,-290060,19.774507328750914,22.3227569164528,NaN,NaN,-5.2472639944927675,-11.505058355577697
1999-09-14T09:30:00-04:00,27.73437,27.85937,27.64062,27.64062,6100,9925,46.25276584628964,46.398523225507624,NaN,NaN,-21.458492071607814,11.812584455482694,0.05648112182503534,-0.09781056465945426,-0.1542916864844896,-299400,-294360,18.690777013836325,21.911200381723123,NaN,NaN,-5.545651991284763,-10.653714589250136
1999-09-15T09:30:00-04:00,27.8125,27.84375,27.3125,27.375,7300,9535,42.781720477295835,45.638870696928436,NaN,NaN,-61.788770158616295,-14.17268614378778,0.025308050545099686,-0.122656623303115,-0.14796467384821468,-306700,-297260,17.975283780288592,21.37265715822911,NaN,NaN,-6.851434422859108,-10.110531708337131
1999-09-16T09:30:00-04:00,27.21875,27.39062,27.0625,27.39062,7000,9490,43.05236746439501,45.14305855263795,NaN,NaN,-99.42926710872004,-25.34883759394284,0.006788481156775217,-0.13947907240224566,-0.14626755355902088,-299700,-297380,17.94467248952148,20.76224219950283,NaN,NaN,-7.829273728724481,-9.78463771124961
1999-09-17T09:30:00-04:00,27.51562,28.17187,27.51562,28.17187,9800,9735,54.61537560771181,45.6882385435266,NaN,NaN,44.154639880470555,-23.568278152854113,0.04601595367151398,-0.0887476114696284,-0.13476356514114238,-289900,-297800,17.83022259941295,20.10594414852088,NaN,NaN,-5.015664659601244,-9.103355846728416
1999-09-20T09:30:00-04:00,28.3125,28.3125,27.3125,27.82812,7600,9980,49.82187703033981,46.483786711416066,NaN,NaN,17.594907693372004,-24.18539635302031,0.047482032914072714,-0.07541102399855149,-0.1228930569126242,-297500,-298640,17.588606452502944,19.513529905918922,NaN,NaN,-4.218072398814861,-8.405458211312194
1999-09-21T09:30:00-04:00,27.59375,28.42187,27.26562,27.32812,9600,10025,43.80009890064795,46.92065218282374,NaN,NaN,-9.25658158484065,-21.745014255666877,0.015123416987760319,-0.1039887856779238,-0.11911220266568412,-307100,-300180,17.130295576001004,18.981195807215386,NaN,NaN,-5.580124184468545,-8.001839064620244
1999-09-22T09:30:00-04:00,27.35937,27.4375,27.09375,27.26562,4800,9550,43.098861360658425,47.26649520493096,NaN,NaN,-90.53635471883383,-27.49453116771039,-0.008853811866466194,-0.13017946749876685,-0.12132565563230066,-311900,-301220,16.81170149406543,18.573162357678907,NaN,NaN,-6.869598680282044,-7.840090438286215
1999-09-23T09:30:00-04:00,27.32812,27.48437,26.96875,26.96875,4000,8645,39.836429491296755,47.602943924286535,NaN,NaN,-104.02408913385848,-28.41349557273808,-0.04125758996208931,-0.1728976430849123,-0.13164005312282298,-315900,-304460,15.824300150453936,18.234753518746512,NaN,NaN,-8.997588558053579,-8.005447312538696
1999-09-24T09:30:00-04:00,27.01562,27.01562,26.53125,26.54687,5500,8620,35.7006354008721,46.66085102183928,NaN,NaN,-171.3033369750981,-71.5050909438518,-0.08512811804112597,-0.23805020067423044,-0.15292208263310447,-321400,-310760,14.091247669026941,17.866941575287665,NaN,NaN,-12.190906359302605,-8.603370033504968
1999-09-27T09:30:00-04:00,26.875,26.875,26.70312,26.75,5200,8555,38.98524091526516,45.66043766886143,NaN,NaN,-136.92684030278272,-102.40944054308275,-0.09380531502404468,-0.2701787264131603,-0.17637341138911564,-316200,-314500,13.169182226062546,17.44737498454245,NaN,NaN,-13.764097242475776,-9.340616777643655
1999-09-28T09:30:00-04:00,26.625,26.73437,26.21875,26.5,20000,8655,36.51308590386548,44.604070341161666,NaN,NaN,-157.71531869456555,-132.10118796502772,-0.10867303759770472,-0.31221470838624654,-0.20354167078854182,-336200,-320320,11.867762972852262,16.938886122315846,NaN,NaN,-15.852634460308638,-10.270905018024367
1999-09-29T09:30:00-04:00,26.65625,26.84375,26.57812,26.57812,3900,7945,37.839553099046235,43.821865440058026,NaN,NaN,-116.7742069565575,-137.34875841257247,-0.10545393140933806,-0.3353590850502144,-0.22990515364087633,-332300,-324400,11.043815678989375,16.407993830529172,NaN,NaN,-17.145387603372804,-11.252973958788429
1999-09-30T09:30:00-04:00,26.625,26.90625,26.46875,26.8125,9600,8235,41.77050999050022,43.16648550103691,NaN,NaN,-97.71490499288063,-136.08692158437688,-0.0808546032297856,-0.33097340767810834,-0.25011880444832274,-322700,-325760,10.775267593395185,15.751260216082866,NaN,NaN,-17.076884802624246,-12.084961222193545
1999-10-01T09:30:00-04:00,26.76562,26.85937,26.35937,26.71875,9900,8300,40.6628229158625,42.480810314574796,NaN,NaN,-103.17997110498862,-122.462248410355,-0.06490030957404608,-0.33124419141588035,-0.2663438818418343,-332600,-328000,10.329728702019352,15.076633171316322,NaN,NaN,-17.33739879484476,-12.835309446858004
1999-10-04T09:30:00-04:00,26.75,27.125,26.75,27.125,6400,8310,47.19729172816082,42.548276448994166,NaN,NaN,-48.365721445968035,-104.75002463899207,-0.023144153670003165,-0.29527407392933824,-0.2721299202593351,-326200,-330000,9.934743456400284,14.451202202928034,NaN,NaN,-15.60395049379637,-13.230829596420627
1999-10-05T09:30:00-04:00,27,27.09375,26.76562,26.76562,9200,8195,42.71585073738908,42.54357146757225,NaN,NaN,-59.77606449434147,-85.16217379894724,-0.016212784806054925,-0.29239590126690373,-0.2761831164608488,-335400,-329840,10.230473578216916,13.898001474208629,NaN,NaN,-15.463496646138372,-13.54978203209459
1999-10-06T09:30:00-04:00,26.8125,27.4375,26.8125,27.4375,21700,8565,51.90940149527941,43.17621675549257,NaN,NaN,-1.9567264520554772,-62.198677698046836,0.03437728460470113,-0.23321151070497237,-0.2675887953096735,-313700,-326120,17.05011733126166,13.834104677190073,NaN,NaN,-12.24722329590729,-13.363702212639263
1999-10-07T09:30:00-04:00,27.39062,27.51562,27.15625,27.1875,12600,8850,48.7727991004547,42.758889862117066,NaN,NaN,9.486535174592797,-40.75838966455214,0.05076918596832297,-0.20412731284926977,-0.25489649881759274,-326300,-326840,16.784344020350773,13.759399064399917,NaN,NaN,-10.642987331819814,-12.975028658236484
1999-10-08T09:30:00-04:00,27.07812,27.48437,27.07812,27.48437,4300,8500,52.44730988103221,42.946420780023665,NaN,NaN,26.42727649869505,-14.836940143815406,0.0796513001403914,-0.1553323736421035,-0.2349836737824949,-322000,-324720,20.703788194424433,13.981912045965739,NaN,NaN,-8.115252568874633,-12.28077493118479
1999-10-11T09:30:00-04:00,27.3125,27.5625,27.3125,27.40625,3600,8405,51.40243757278866,43.48944497089085,NaN,NaN,46.89675424859203,4.215554995096608,0.0907354623950202,-0.12156434578871966,-0.21229980818373986,-325600,-324600,20.930804384685942,14.253376960871805,NaN,NaN,-6.4169808887890865,-11.443090067985404
1999-10-12T09:30:00-04:00,27.1875,27.25,26.9375,26.9375,4300,8315,45.53977843037098,43.66379619015604,NaN,NaN,-19.953198624705607,12.180128169023774,0.0649472646005447,-0.131115727433059,-0.1960629920336037,-329900,-323500,23.10402648453055,14.702828745905027,NaN,NaN,-6.788590766789014,-10.77816159638592
1999-10-13T09:30:00-04:00,26.89062,26.9375,26.34375,26.34375,12900,8595,39.408538826005746,43.63323257120668,NaN,NaN,-105.75888996327456,-8.580304533220044,0.009274809874253637,-0.18446947969078664,-0.19374428956504028,-342800,-329320,19.97568934654265,14.99935654562565,NaN,NaN,-9.18866388928965,-10.551090495372167
1999-10-14T09:30:00-04:00,26.17187,26.40625,26.09375,26.25,5200,8505,38.52653659948955,43.835082656822216,NaN,NaN,-140.55734385454264,-38.58908033904713,-0.030322383330478986,-0.231647268728139,-0.20132488539766002,-348000,-333660,18.016616687005055,15.279740046909804,NaN,NaN,-11.364987719048663,-10.667361527325951
1999-10-15T09:30:00-04:00,25.8125,26,25.625,25.79687,7100,8370,34.50661212171778,43.515180600140255,NaN,NaN,-193.91084617094538,-82.65670487297521,-0.08063384492161604,-0.3021171915496801,-0.22148334662806404,-355100,-340280,15.516821260889529,15.447428549397445,NaN,NaN,-14.563130049814047,-11.223899887681394
1999-10-18T09:30:00-04:00,25.54687,25.75,25.32812,25.67187,3900,8185,33.46914481284061,43.29775623649562,NaN,NaN,-204.02766752357027,-132.84158922740767,-0.11389912154350135,-0.3638572485574407,-0.24995812701393938,-359000,-346960,13.48378060245382,15.56285838008327,NaN,NaN,-17.458294290550462,-12.114527659519833
1999-10-19T09:30:00-04:00,26.04687,26.15625,25.6875,25.6875,6300,8020,33.737416051493156,43.00474644738468,NaN,NaN,-145.48915426112947,-157.94878035469247,-0.12550208169726096,-0.4068357291355156,-0.2813336474382546,-352700,-351520,12.299128799481323,15.65252360297555,NaN,NaN,-19.693103232252103,-13.1971813127673
1999-10-20T09:30:00-04:00,26.15625,26.375,25.95312,26.3125,46400,10100,43.54109695552257,43.131216944886276,NaN,NaN,-76.15520469146915,-152.02804330033138,-0.08374466078214587,-0.386014473415937,-0.3022698126337911,-306300,-344220,23.835618042832834,16.585405777935385,NaN,NaN,-18.65971418372741,-13.977543151475887
1999-10-21T09:30:00-04:00,26.17187,26.35937,26.09375,26.35937,4200,10110,44.20774154867281,43.384425418658445,NaN,NaN,-59.47259569598159,-135.81109366861915,-0.047435014741848525,-0.36156358106110176,-0.31412856631925323,-302100,-335040,35.35229926088472,18.372732246425766,NaN,NaN,-17.633583051217265,-14.499834565724655
1999-10-22T09:30:00-04:00,26.5,26.71875,26.5,26.6875,25900,11130,48.76847679625799,43.496652923522525,NaN,NaN,0.4270491173618473,-96.94351461095772,0.0016141300226438782,-0.3121109037909484,-0.3137250338135923,-276200,-319260,49.4905852126048,21.19814951472609,NaN,NaN,-15.358312480877197,-14.622474267889304
1999-10-25T09:30:00-04:00,26.625,26.6875,26.4375,26.6875,24600,12100,48.76847679625799,43.92898335629888,NaN,NaN,-3.3259716518369093,-56.803175436611056,0.035132739606620056,-0.2698091093053172,-0.30494184891193726,-276200,-302700,59.50051803452912,24.717438404462676,NaN,NaN,-13.53064799742986,-14.466499086395098
1999-10-26T09:30:00-04:00,26.75,26.8125,26.5,26.5,30800,12640,46.262293779626624,43.52561851946653,NaN,NaN,-4.391520886712698,-28.583648761727698,0.04511412312864399,-0.24854919500113226,-0.29366331812977625,-307000,-293560,63.76843943914264,28.054461412168457,NaN,NaN,-12.67407036956948,-14.210437841134295
1999-10-27T09:30:00-04:00,26.54687,26.57812,26.21875,26.5,33200,14105,46.26229377962663,43.34629671083595,NaN,NaN,-30.772616643370956,-19.507131152108048,0.051682576482757925,-0.22906009752632883,-0.28074267400908676,-307000,-293700,63.65778089215396,31.402564045868683,NaN,NaN,-11.971012833215115,-13.890519982860127
1999-10-28T09:30:00-04:00,26.95312,27.65625,26.95312,27.64062,8000,14025,60.56128560612953,43.92586640548576,NaN,NaN,115.67258134358403,15.521904255805063,0.12844145080597963,-0.1201908605016122,-0.24863231130759184,-299000,-293080,63.95608515979079,34.49201382910914,NaN,NaN,-6.423633014334838,-12.82382184449937
1999-10-29T09:30:00-04:00,28.1875,28.5,28.10937,28.17187,39400,15500,65.20519128685305,44.91177738506178,NaN,NaN,192.6684407617306,53.97018258467881,0.20598918030017893,0.008854164067631842,-0.1971350162325471,-259600,-289760,65.58510205198543,37.68160651963053,NaN,NaN,-0.03987731946156529,-10.997544055208255
1999-11-01T09:30:00-05:00,28.29687,28.29687,28.125,28.1875,22400,16300,65.33452226107438,46.32568765868346,NaN,NaN,158.0516254937526,86.24570201379672,0.24659101398435151,0.11110375124789229,-0.13548726273645922,-237200,-281960,69.11660717601164,40.9682194261649,NaN,NaN,4.92549684231142,-8.72282392699116
1999-11-02T09:30:00-05:00,28.03125,28.32812,27.79687,27.82812,19900,16835,59.82806047740817,47.78422491949791,NaN,NaN,115.45007359544167,110.2140209102276,0.23741316781330507,0.16127919703017213,-0.07613397078313294,-257100,-271980,72.94241389700458,44.751556894055035,NaN,NaN,7.376810726015397,-6.4228761194187936
1999-11-03T09:30:00-05:00,28.03125,28.03125,27.73437,27.95312,7400,16120,61.05746531327217,49.393576970482385,NaN,NaN,98.46743157668874,136.06203055423953,0.22788638793042854,0.2087240141299027,-0.01916237380052581,-249700,-260520,76.53679494775615,48.931569626965825,NaN,NaN,9.736181869994288,-4.114439263788354
1999-11-04T09:30:00-05:00,28.125,28.375,28.125,28.26562,8800,15930,64.02185678479037,51.50180873213043,NaN,NaN,118.29058277033006,136.58563083958873,0.2300867254917105,0.2684460330641123,0.038359307572401816,-240900,-248900,79.50915328454592,53.50245048579843,NaN,NaN,12.661654451255497,-1.7178544473535182
1999-11-05T09:30:00-05:00,28.65625,28.65625,28.14062,28.14062,23600,16895,61.98916378145981,53.53895294417465,NaN,NaN,111.20522065663476,120.29298681856957,0.21107740563473756,0.3022060646158238,0.09112865898108621,-264500,-249880,78.60473945892839,58.15394754697518,NaN,NaN,14.455092566952265,0.5925665546901651
1999-11-08T09:30:00-05:00,28,28.25,28,28.1875,16600,17545,62.47042344645453,55.59131061524333,NaN,NaN,89.85527640667574,106.6537170011542,0.19025867531863255,0.3289520031293769,0.13869332781074434,-247900,-252020,76.55685004449275,62.743784778761714,NaN,NaN,16.05566172587134,2.80158015057319
1999-11-09T09:30:00-05:00,28.3125,28.32812,27.9375,28,10000,17830,59.23981667700068,56.712647738206044,NaN,NaN,75.92540440404707,98.74878316287528,0.15400597177333383,0.33120079252741164,0.1771948207540778,-257900,-252180,76.39659096612878,66.49813998756856,NaN,NaN,16.512287367440923,4.760252610125723
1999-11-10T09:30:00-05:00,27.67187,28.1875,27.67187,28.17187,21300,18250,61.219546913289726,57.927776692821546,NaN,NaN,63.182756593674725,91.69184816627248,0.13256312252259786,0.3428987239073251,0.21033560138472726,-236600,-249560,77.23689430996848,69.48989677678883,NaN,NaN,17.452486373529922,6.5734288620406085
1999-11-11T09:30:00-05:00,28.42187,28.59375,28.34375,28.5,8000,18390,64.74062047179304,59.0686440982169,NaN,NaN,88.08721144223279,85.65117390065302,0.13119688259664902,0.37433170463053855,0.24313482203388953,-228600,-247100,78.0278504551765,71.52827286554395,NaN,NaN,19.300162371395018,8.391533649091238
1999-11-12T09:30:00-05:00,28.89062,29.125,28.53125,29.0625,33500,19710,69.80232707118311,60.57106197499727,NaN,NaN,110.07824454589715,85.42577867850551,0.15714381463654792,0.4395645903295744,0.2824207756930265,-195100,-233220,81.8582138285471,73.12525113654523,NaN,NaN,22.584730547829356,10.419133206053827
1999-11-15T09:30:00-05:00,29,29.34375,29,29.1875,15700,20300,70.80532071428752,62.32413532747305,NaN,NaN,122.09971084002183,91.87466556517471,0.1705715422070539,0.49563520345184386,0.32506366124478997,-179400,-219520,84.69439359867468,74.61996214794037,NaN,NaN,25.57409745494081,12.584128098751966
1999-11-16T09:30:00-05:00,29.25,29.60937,29.25,29.5625,17700,20870,73.63453638003136,64.27929551321624,NaN,NaN,138.51252187325565,104.39208905901641,0.1910142201925742,0.5638314364855077,0.3728172162929335,-161700,-200280,87.62124057981039,76.33163783991584,NaN,NaN,29.062670900457444,14.938205641852749
1999-11-17T09:30:00-05:00,29.5,29.5,29.25,29.26562,3300,18715,68.01498903171122,64.8117029007578,NaN,NaN,123.85746776125505,116.52703129253248,0.17146892222429228,0.5871533690732988,0.4156844468490066,-165000,-185960,89.26643129864414,78.1395197069768,NaN,NaN,30.28569033283058,17.13070345484958
1999-11-18T09:30:00-05:00,29.28125,29.65625,29.28125,29.45312,8200,18915,69.593305205801,65.12513960925408,NaN,NaN,129.71668895029643,124.85292679414522,0.15840572008222564,0.6136915969517887,0.455285876869563,-156800,-171600,90.61363338453212,79.92727194501585,NaN,NaN,31.77708026301092,19.22304299887263
1999-11-19T09:30:00-05:00,29.46875,29.46875,29.26562,29.3125,8700,18055,66.92599902854013,65.23881652121591,NaN,NaN,110.4652321045385,124.93032430587348,0.12878927413706875,0.616272469540899,0.4874831954038302,-165500,-165680,91.1090696187652,81.49816211949825,NaN,NaN,32.22122745973529,21.07992649328158
1999-11-22T09:30:00-05:00,29,29.09375,28.875,29,15700,17610,61.3029200782108,65.34416363555896,NaN,NaN,67.06999696137557,113.92438153014423,0.07908760183693098,0.5863426976999939,0.5072550958630629,-181200,-166040,90.79522208114372,82.77336270407962,NaN,NaN,30.90425485727153,22.48340197385157
1999-11-23T09:30:00-05:00,28.90625,28.90625,28.46875,28.51562,7000,16420,53.76274214290783,64.82311198053294,NaN,NaN,21.593635651386297,90.54060428577036,0.00825310586373229,0.5175714781927283,0.509318372328996,-188200,-171340,86.09320665037939,83.45596353998128,NaN,NaN,27.31100570656763,23.173059649953863
1999-11-24T09:30:00-05:00,28.4375,28.92187,28.4375,28.92187,21400,15830,58.385843194795086,64.42053958124757,NaN,NaN,26.671929270218207,71.103496587563,-0.015294657821307234,0.490200050052362,0.5054947078736692,-166800,-171700,85.76829957474233,83.90304541785245,NaN,NaN,25.687608042188476,23.532280848844522
1999-11-26T09:30:00-05:00,28.8125,28.8125,28.6875,28.6875,9400,15900,54.97101838133713,63.9192434812388,NaN,NaN,15.408146972786197,48.241788192060945,-0.048817613297069073,0.4444726912523329,0.493290304549402,-176200,-175580,82.16904605094935,84.15763874585393,NaN,NaN,23.25510112606831,23.492683745590778
1999-11-29T09:30:00-05:00,28.51562,28.71875,28.51562,28.51562,31700,15515,52.543898795111794,63.21020600614288,NaN,NaN,-8.419218841139518,24.464898002925338,-0.08273626598812123,0.38986997206425045,0.4726062380523717,-207900,-184060,74.7826080671631,84.03090717604468,NaN,NaN,20.50318307328153,23.065612220975172
1999-11-30T09:30:00-05:00,28.5625,28.8125,28.40625,28.5,7500,14770,52.31782644294366,62.71577813228167,NaN,NaN,-13.26307897080591,8.39828281648904,-0.10496414137164739,0.34140106133781245,0.44636520270945984,-215400,-190900,69.36610431476603,83.52872955809019,NaN,NaN,18.229478258467243,22.374735940616898
1999-12-01T09:30:00-05:00,28.46875,28.59375,28.375,28.4375,40700,15810,51.365511827814586,62.011918483319164,NaN,NaN,-35.114541290363256,-2.9433525718608706,-0.12145177963890447,0.29455047816082924,0.4160022577997337,-256100,-204480,60.06437392571856,82.30212095921522,NaN,NaN,16.081133044933335,21.475649812662102
1999-12-02T09:30:00-05:00,28.5,28.6875,28.5,28.6875,20800,16480,54.90170177761626,61.30913857659225,NaN,NaN,-16.634984284067666,-11.604735282718048,-0.11325740613007257,0.274430500137143,0.38768790626721555,-235300,-218180,52.426495350017646,80.47345273741814,NaN,NaN,15.194120995045662,20.57828855300261
1999-12-03T09:30:00-05:00,28.9375,29.65625,28.9375,29.25,24600,17270,61.657000006422265,60.7273295005379,NaN,NaN,89.23398281435428,3.1604318855955844,-0.06982123192870088,0.30041136635633947,0.37023259828504035,-210700,-225080,49.043871198407565,78.1295711209796,NaN,NaN,16.45012393931321,19.988550751046983
1999-12-06T09:30:00-05:00,29.35937,29.4375,29.25,29.42187,40700,18125,63.45809962956051,60.20252799448597,NaN,NaN,92.43739723129994,23.331755100083477,-0.03134313313303888,0.33105368186874173,0.3623968150017806,-170000,-217500,52.657618789339075,75.84123006316993,NaN,NaN,18.040161134459236,19.710209377248734
1999-12-07T09:30:00-05:00,29.4375,29.5625,29.34375,29.34375,11500,17870,62.03179325534141,59.373760628436685,NaN,NaN,90.56197450177378,44.09676579459941,-0.013872085906007525,0.3450567076192712,0.35892879352527873,-181500,-210720,55.684936071741944,73.56006545545074,NaN,NaN,18.929874458778215,19.598732960324373
1999-12-08T09:30:00-05:00,29.40625,29.73437,29.40625,29.625,38900,19315,65.07529456258399,59.16378245207045,NaN,NaN,108.9716265281833,72.91399935830873,0.012482058342815516,0.37453136645379814,0.3620493081109826,-142600,-188020,63.987961912906975,71.75446049932667,NaN,NaN,20.60664891135471,19.742720953328707
1999-12-09T09:30:00-05:00,29.82812,30.125,29.82812,30.07812,12100,18855,69.33949917362035,59.145653449771835,NaN,NaN,163.94667209853628,109.03033063482951,0.053962320665545016,0.4295022089429139,0.3755398882773689,-130500,-167060,69.64364138707991,70.25660392808007,NaN,NaN,23.45208915227806,20.27263069603576
1999-12-10T09:30:00-05:00,30.25,30.25,29.76562,29.89062,18800,19395,65.76142591000686,59.06246965559088,NaN,NaN,140.66285954061198,119.31610598008106,0.061743014022429266,0.4527186558054055,0.3909756417829762,-149300,-154780,72.38045590654781,68.91884580577883,NaN,NaN,24.72770221911379,20.909069485046906
1999-12-13T09:30:00-05:00,29.6875,29.95312,29.6875,29.6875,10700,18255,62.02731178499787,59.11421192036139,NaN,NaN,97.82102195982623,120.3928309257863,0.046856036890795816,0.449545687896471,0.40268965100567516,-160000,-152780,72.81040276219136,67.6342158544251,NaN,NaN,24.672116406521173,21.446647616686086
1999-12-14T09:30:00-05:00,29.53125,29.82812,29.53125,29.75,16000,18270,62.72861195680192,59.754631192782405,NaN,NaN,77.59391501674281,117.79921902878012,0.03538625646068677,0.44692247158153364,0.41153621512084687,-144000,-145280,74.41859728035583,66.80031518513769,NaN,NaN,24.828546884161884,21.929776083468344
1999-12-15T09:30:00-05:00,29.5625,29.90625,29.45312,29.5,8400,17805,58.10589333744432,59.734634774400206,NaN,NaN,62.62505490839729,108.52990470482291,0.00663590118465468,0.4198310916016652,0.4131951904170105,-152400,-147240,73.20009336409527,65.90258617009148,NaN,NaN,23.60966157947014,22.169759725754314
1999-12-16T09:30:00-05:00,29.625,29.73437,29.375,29.73437,9500,18115,61.00700888773465,60.1657769534286,NaN,NaN,58.221891424578814,87.38494857003143,-0.0005422052309004277,0.412517433878385,0.41305963910928545,-142900,-149720,71.60254432887334,65.14783604708605,NaN,NaN,23.406336968892656,22.34641361763122
1999-12-17T09:30:00-05:00,29.96875,30.25,29.8125,30.25,485300,41970,66.50292199796263,61.162850039346516,NaN,NaN,119.88072878529006,83.22852241896705,0.02412763613570207,0.44321918427891305,0.419091548143211,342400,-51380,85.30135836963217,65.89917535440527,NaN,NaN,24.95330589767878,22.718826800495158
1999-12-20T09:30:00-05:00,30.15625,30.40625,29.96875,29.96875,301300,56600,61.41795978247095,61.812859563598465,NaN,NaN,108.52096197156158,85.36851042131411,0.01655590861917039,0.439786433917174,0.4232305252980036,41100,-11160,87.87712108797379,67.22139083820582,NaN,NaN,24.652705474440133,22.995095182487297
1999-12-21T09:30:00-05:00,29.8125,30.0625,29.71875,29.78125,558700,83750,58.22181693581126,62.30259564274108,NaN,NaN,67.72246316367931,83.3942200507014,-0.004882115463974712,0.4171278809680352,0.4220099964320099,-517600,-85880,65.06539288750824,67.57860647833365,NaN,NaN,23.411259217911333,23.054547187547875
1999-12-22T09:30:00-05:00,29.85937,30,29.78125,29.8125,153500,91075,58.60842964970102,62.56736191931856,NaN,NaN,64.0805927229165,83.68532761360525,-0.019916207664366026,0.3971147368515524,0.41703094451591843,-364100,-128220,56.1678720778189,67.8458476731766,NaN,NaN,22.525062594734518,22.978906531431683
1999-12-23T09:30:00-05:00,30,30.53125,30,30.4375,445400,112275,65.48734060528471,62.84095767638017,NaN,NaN,117.43189907046786,95.52732914278305,0.007788803488023133,0.42676694887594735,0.4189781453879242,81300,-83380,62.081683087353106,68.77711995095844,NaN,NaN,23.905889430589845,23.111332659882848
1999-12-27T09:30:00-05:00,30.75,30.75,30.4375,30.4375,500800,136845,65.48734060528471,62.98590346036047,NaN,NaN,138.62439290088736,99.27606196590253,0.020925722018234283,0.44513529791071704,0.42420957589248276,81300,-135600,53.09703442481352,68.80850678206374,NaN,NaN,24.9928327875302,23.380118392403897
1999-12-28T09:30:00-05:00,30.40625,30.67187,30.40625,30.5,112800,140900,66.13996684344514,63.279344430939304,NaN,NaN,128.74255121096593,103.32037981378339,0.028183893381922065,0.45943944261988534,0.4312555492379633,194100,-105000,57.02214251014519,68.90402152766397,NaN,NaN,26.070801980826,23.764501762178483
1999-12-29T09:30:00-05:00,30.3125,30.48437,30.3125,30.48437,27900,141920,65.8048412511516,63.33145490869413,NaN,NaN,107.13804159066055,111.20349549917964,0.026326583707345086,0.46416377887214466,0.4378371951647996,166200,31760,69.36248479824145,69.28791601947357,NaN,NaN,26.862863774252236,24.20712490676045
1999-12-30T09:30:00-05:00,30.40625,30.75,30.40625,30.71875,7300,140250,68.39125020847132,63.26372283975491,NaN,NaN,131.77475827108324,124.74232860881298,0.034748280877858195,0.48127254626212235,0.44652426538426415,173500,139280,75.35407846458801,69.69580438215273,NaN,NaN,28.288305750752084,24.790150741616397
1999-12-31T09:30:00-05:00,30.59375,30.89062,30.59375,30.89062,7200,139570,70.17284375558056,63.578824114438746,NaN,NaN,147.79124368821746,130.8141975323629,0.04510274059332875,0.5029026911259251,0.45779995053259637,180700,159160,76.27782971662573,69.97418822572972,NaN,NaN,30.020691123694736,25.537370796199017
2000-01-03T09:30:00-05:00,31,31,30.0625,30.29687,246700,150675,58.008673831054814,63.29177854629996,NaN,NaN,77.61587145618118,118.61249324342165,0.00716294249869226,0.4667536286559617,0.45959068615726945,-66000,129700,71.97276942084747,69.91435727277658,NaN,NaN,27.869357509681407,25.87051175526793
2000-01-04T09:30:00-05:00,30.1875,30.20312,29.53125,29.60937,35300,150405,47.698384847277396,62.218190895619635,NaN,NaN,-53.56991343470004,82.15000031428846,-0.06505712564518212,0.3782692791007918,0.4433264047459739,-101300,70620,64.15305840397428,69.18110449589219,NaN,NaN,22.270791203314168,25.35626596213168
2000-01-05T09:30:00-05:00,29.78125,29.78125,29.21875,29.34375,137600,156710,44.41388378758073,61.24019021348652,NaN,NaN,-119.54757017543965,36.81287796106842,-0.12790583326617438,0.2834441131632559,0.4113499464294303,-238900,-10400,55.28257673817982,67.90128187975536,NaN,NaN,16.592168180426768,24.10425199331669
2000-01-06T09:30:00-05:00,29.3125,29.5625,29.15625,29.4375,50000,157265,45.831656060727504,60.156236440128865,NaN,NaN,-126.42181678883186,-14.826437050914588,-0.1583604434459303,0.21339939212201742,0.3717598355679477,-188900,-82880,48.78400499668155,66.27138621317023,NaN,NaN,12.557212240106441,22.454674885715228
2000-01-07T09:30:00-05:00,29.46875,29.79687,29.35937,29.79687,22100,157765,50.991824831226474,59.04830092821914,NaN,NaN,-68.99890787447654,-58.18446736345338,-0.14960239659111035,0.18475683982905977,0.3343592364201701,-166800,-152380,43.50317813140522,63.28580191043973,NaN,NaN,10.780229260848708,20.786896939305727
2000-01-10T09:30:00-05:00,32.25,32.9375,31.625,32.84375,31800,158415,73.78953666420713,59.93198499120031,NaN,NaN,313.24890476123943,-11.057860702441724,0.05512585653935076,0.40326655709435855,0.3481407005550078,-135000,-166180,42.51897170674168,60.04593409749458,NaN,NaN,19.947851839119664,20.66703335356486
2000-01-11T09:30:00-05:00,32.53125,32.53125,31.95312,31.96875,17900,158775,64.50886300345383,60.381059710317636,NaN,NaN,213.8811796776659,42.432357920031464,0.12154138271200371,0.5000674289450124,0.37852604623300873,-152900,-176500,41.758134756906045,58.38112994530871,NaN,NaN,22.11273836990135,20.87356264161293
2000-01-12T09:30:00-05:00,32.21875,32.21875,31.3125,31.4375,12400,158595,59.60703768338137,60.45238885558052,NaN,NaN,135.88667756531967,93.51920746818332,0.11944386410270957,0.5278308763613957,0.4083870122586861,-165300,-161780,43.31618239031576,57.46315211048705,NaN,NaN,21.477471523460952,20.95983533901979
2000-01-13T09:30:00-05:00,31.71875,32.4375,31.59375,32.375,600000,188175,64.7040977151937,60.396442934859735,NaN,NaN,157.7470950341866,150.35298983278702,0.16797360873871392,0.6183540231820785,0.45038041444336463,434700,-37060,54.43770034672513,56.91715334329934,NaN,NaN,23.200250913418017,21.279894706790966
2000-01-14T09:30:00-05:00,32.59375,32.59375,31.90625,32.09375,23600,188880,62.16956550702575,60.15945899926981,NaN,NaN,137.05473703492794,191.5637188146679,0.1675309081487124,0.6597940496292551,0.49226314148054273,411100,78520,61.89839861034168,57.5458222136942,NaN,NaN,23.4343070460958,21.587667898120227
2000-01-18T09:30:00-05:00,31.875,31.875,31.46875,31.5,417300,185480,57.08575286264596,59.51272942921273,NaN,NaN,75.1204488948587,143.93802764139176,0.11609157797072345,0.6373776139439471,0.5212860359732236,-6200,104280,63.33926228262412,57.997045054585556,NaN,NaN,21.670675002737386,21.599526055922677
2000-01-19T09:30:00-05:00,31.59375,32.25,31.5,32.25,10400,170935,61.381595427954004,59.19678329898433,NaN,NaN,92.77525839836576,119.71684338553173,0.12087547258914721,0.6723803767096577,0.5515049041205105,4200,135700,65.07415106622159,57.69073550229842,NaN,NaN,21.877868240889093,21.639289225203594
2000-01-20T09:30:00-05:00,32.40625,32.5,31.875,32,64200,146210,59.25239664604738,58.54400804452548,NaN,NaN,89.30688882679003,110.40088563782578,0.09655505215389648,0.6721987193128811,0.5756436671589846,-60000,156760,66.22778199991575,57.03885718339326,NaN,NaN,21.284352827914912,21.588584025590926
2000-01-21T09:30:00-05:00,31.875,32.04687,31.6875,31.9375,37300,140400,58.7041555665065,57.72481603102018,NaN,NaN,64.16849969807257,91.685166570603,0.06701327098496157,0.6594102558901866,0.5923969849052251,-97300,50360,56.1387282433164,55.60034993529974,NaN,NaN,20.651101908229087,21.45465800882495
2000-01-24T09:30:00-05:00,32.03125,32.1875,30.98437,30.98437,72100,121735,50.960343500098354,57.2213638645233,NaN,NaN,23.907210742261274,69.05566131206966,-0.021243191678812168,0.5658429953067099,0.5870861869855221,-169400,-65740,47.61500508745977,53.860509625772046,NaN,NaN,17.450283567416598,20.882604517195187
2000-01-25T09:30:00-05:00,31.25,31.4375,31,31.20312,24400,97915,52.508733357695874,57.56496018669605,NaN,NaN,8.899404634622934,55.81145246002251,-0.06683926819589103,0.5035371017406582,0.5703763699365493,-145000,-93500,45.823464656196265,52.55125292950219,NaN,NaN,15.42327063182349,20.1026996764278
2000-01-26T09:30:00-05:00,31.1875,31.29687,31,31.0625,10500,92800,51.38553237679669,58.06293508592576,NaN,NaN,-0.49300102734624823,37.15780057488011,-0.10608823310400828,0.43776607855653893,0.5438543116605472,-155500,-125440,43.78228453066808,51.72980348610849,NaN,NaN,13.461149371291862,19.153906775694097
2000-01-27T09:30:00-05:00,31.20312,31.39062,30.875,30.875,10700,91940,49.85420998739383,58.350260366401926,NaN,NaN,-9.053869661482084,17.48564887722569,-0.14205143136037857,0.366290022460074,0.5083414538204526,-166200,-146680,42.428784461348855,51.27585916215615,NaN,NaN,11.402922834076113,18.046623355462955
2000-01-28T09:30:00-05:00,30.9375,31.03125,30.25,30.25,18100,92480,45.03636792334232,57.924870587267336,NaN,NaN,-52.26870494369374,-5.801792051127573,-0.2016663884304532,0.2562584682823861,0.4579248567128393,-184300,-164080,41.30232950637683,51.11865568893984,NaN,NaN,8.129312383235993,16.629864645144817
2000-01-31T09:30:00-05:00,30.375,30.375,29.85937,30.10937,27500,93495,44.00587729452772,55.79746634657595,NaN,NaN,-78.20571357124909,-26.224376913829644,-0.24160969484007616,0.1559127381627441,0.39752243300282025,-211800,-172560,40.73472051283224,50.99120917508917,NaN,NaN,5.155515603740902,14.990671924944259
2000-02-01T09:30:00-05:00,30.21875,30.53125,30.15625,30.5,161600,89240,47.59296950408091,54.589188239477885,NaN,NaN,-55.82512608796677,-39.169283058347595,-0.23267484814682332,0.10667887281929112,0.33935372096611444,-50200,-153600,42.63301637121325,51.05370071896825,NaN,NaN,3.647450847496745,13.370211771023186
2000-02-02T09:30:00-05:00,30.71875,31.25,30.71875,31.25,7700,87860,53.722788258162026,54.168884709105086,NaN,NaN,-9.002957361634857,-40.87127432520532,-0.17010803455330437,0.12671867777448398,0.29682671232778834,-42500,-131000,44.89860445220206,51.16673086624585,NaN,NaN,4.169327811659309,12.055799776828346
2000-02-03T09:30:00-05:00,31.20312,31.60937,31.01562,31.53125,31500,82555,55.81014467839799,53.533602349333954,NaN,NaN,10.455352486149897,-36.96942989567892,-0.10673241818035084,0.1634111896023498,0.27014360778270063,-11000,-99960,47.939656956542045,50.702584909804195,NaN,NaN,5.229778558001272,11.080653888424479
2000-02-04T09:30:00-05:00,31.73437,31.8125,31.4375,31.64062,11300,80620,56.62939250422649,53.137875706276866,NaN,NaN,26.939168804637163,-21.12785514601274,-0.05689782971407242,0.19902132064011013,0.25591915035418256,300,-63040,51.3770359091482,49.95105900257609,NaN,NaN,6.333480155193105,10.402486212248569
2000-02-07T09:30:00-05:00,31.625,31.625,30.98437,31.125,36400,81335,51.75765853590076,52.757297540080785,NaN,NaN,-28.667043879823318,-11.220121207727589,-0.05791862672778453,0.1835208669444519,0.24143949367223644,-36100,-27900,54.459133763959976,49.316764108385804,NaN,NaN,5.884052126292975,9.756995628540627
2000-02-08T09:30:00-05:00,31.1875,31.53125,31.1875,31.46875,265000,92995,54.563993155874535,52.27032594921796,NaN,NaN,-2.6381200535472136,-0.5827200008436779,-0.03578608824053994,0.1967068833715615,0.23249297161210145,228900,27920,58.914341910620415,48.87677774012857,NaN,NaN,6.320130149490309,9.266014845819154
2000-02-09T09:30:00-05:00,31.4375,31.4375,30.76562,30.90625,19000,93050,49.490602339244084,51.57305492730344,NaN,NaN,-48.0211847996315,-8.386365488443008,-0.058054905956605174,0.15992433916634496,0.21797924512295014,209900,78400,62.48828647928737,48.609670917226545,NaN,NaN,5.189062673016249,8.68359310684731
2000-02-10T09:30:00-05:00,30.875,31.0625,30.625,30.64062,5000,92680,47.256058168071114,50.75533368455806,NaN,NaN,-77.80290342709326,-26.03801667109164,-0.0879083965900144,0.10809374938543215,0.19600214597544655,204900,121580,65.27117393404389,49.26198846656422,NaN,NaN,3.5863397871345364,7.955414061174056
2000-02-11T09:30:00-05:00,30.64062,30.875,30.57812,30.65625,9200,63140,47.40653323403222,50.50149009412477,NaN,NaN,-81.0557658233561,-47.63700359669029,-0.1028011268156985,0.06750073745582341,0.1703018642715219,214100,164340,67.81736006494256,50.70501382209871,NaN,NaN,2.3248899976035036,7.151053480663977
2000-02-14T09:30:00-05:00,30.3125,30.46875,29.90625,30.09375,14900,62705,42.686640123622205,49.799912005976644,NaN,NaN,-146.63548201862767,-71.23069122445116,-0.1441966421487761,-0.009943938414448183,0.1342527037343279,199200,211400,70.39031806477598,52.45978906556869,NaN,NaN,-0.17612271987513023,6.104314023444105
2000-02-15T09:30:00-05:00,30.03125,30.03125,29.625,29.85937,23100,42995,40.86111873482462,49.048168174407216,NaN,NaN,-165.4242668659784,-103.78792058693739,-0.17876506325900024,-0.08920362533942239,0.08956143791957785,176100,200840,69.0561514151633,54.26506527160406,NaN,NaN,-2.809649966744759,4.830890596274267
2000-02-16T09:30:00-05:00,29.625,29.75,29,29.01562,35000,44225,35.04998685313906,47.99072366481759,NaN,NaN,-198.68445211050673,-133.92057404911245,-0.24572338827788098,-0.21759279742777338,0.028130590850107606,141100,187080,67.26703485292887,56.039226013859775,NaN,NaN,-7.049453690101262,3.1336985553634777
2000-02-17T09:30:00-05:00,29.15625,29.29687,28.875,29,15300,41780,34.950889822176634,47.27033237187718,NaN,NaN,-187.46427178837013,-155.85284772136782,-0.27606363628517566,-0.31694895450636196,-0.04088531822118631,125800,171260,65.17630122649078,57.74450970815362,NaN,NaN,-10.475513773524572,1.1895253655223281
2000-02-18T09:30:00-05:00,28.9375,28.98437,28.20312,28.20312,109900,45410,30.251735956626007,46.28789370488419,NaN,NaN,-204.60044097013449,-180.5617827507235,-0.33109088026138755,-0.45474891854792077,-0.12365803828653321,15900,131620,60.13293322307545,59.130096330313854,NaN,NaN,-15.078051195964923,-1.1344141432615644
2000-02-22T09:30:00-05:00,28.45312,28.45312,27.84375,28,35300,43570,29.17498201655434,44.97232317006087,NaN,NaN,-193.2727173353819,-189.88922981407435,-0.36005983682959386,-0.5737328343235255,-0.21367299749393168,-19400,87900,55.071334203272286,60.01854760403235,NaN,NaN,-19.182861608314393,-3.712763781126254
2000-02-23T09:30:00-05:00,27.9375,28.625,27.9375,28.4375,17500,43225,34.576433010076386,43.604726366626174,NaN,NaN,-145.3547757755274,-185.87533159598416,-0.3294738421155202,-0.625515300138332,-0.2960414580228118,-1900,52300,51.285801327062615,60.47477595223667,NaN,NaN,-21.078696358939357,-6.193611292242412
2000-02-24T09:30:00-05:00,28.46875,28.59375,27.75,28.21875,172800,51340,33.21253933262484,41.99061169907095,NaN,NaN,-133.4152438950743,-172.82148995289768,-0.30429273044117455,-0.67640737107428,-0.3721146406331054,-174700,-10860,45.33213605105775,60.2885244589878,NaN,NaN,-23.05336931649887,-8.602148152850477
2000-02-25T09:30:00-05:00,28.15625,28.1875,27,27.34375,21200,51865,28.38872208764434,39.973420955029376,NaN,NaN,-149.41971100528522,-165.21257779628067,-0.32500612742550894,-0.7783722999149916,-0.45336617248948263,-195900,-75200,40.21111037855333,59.49095834965959,NaN,NaN,-26.396250119666725,-11.144162719538512
2000-02-28T09:30:00-05:00,27.46875,27.82812,27.28125,27.82812,103600,56140,34.09509766097925,38.711809463963554,NaN,NaN,-120.8297956487844,-148.45844873201068,-0.2859069104453301,-0.8107498105461453,-0.5248429001008151,-92300,-96840,38.63044002530199,58.36033736832688,NaN,NaN,-27.400755538784065,-13.466533122287878
2000-02-29T09:30:00-05:00,27.9375,28.35937,27.82812,28.14062,15500,55540,37.55251155345469,37.496703635219276,NaN,NaN,-83.8007428416967,-126.56405383327362,-0.22168465355599642,-0.8019487170458106,-0.5802640634898142,-76800,-108320,37.78194582521727,56.85088050508379,NaN,NaN,-27.14624295349225,-15.420777383888502
2000-03-01T09:30:00-05:00,28.26562,28.53125,28.03125,28.375,26700,48795,40.091032202939836,36.82530576834041,NaN,NaN,-65.89983437163588,-110.67306555249533,-0.14956257052394317,-0.7672172766447432,-0.6176547061208,-50100,-117960,37.0461087775114,55.03358209781408,NaN,NaN,-26.162584724011296,-16.95532128962033
2000-03-02T09:30:00-05:00,28.34375,28.4375,28.15625,28.25,47600,50790,39.176363145747416,36.248184695317285,NaN,NaN,-61.36295514956139,-96.26260780339274,-0.09886369695049879,-0.7412343273089235,-0.6423706303584247,-97700,-102560,39.08707198235752,53.16328910126506,NaN,NaN,-25.618886263713307,-18.19297342877647
2000-03-03T09:30:00-05:00,28.46875,28.70312,28.34375,28.64062,372700,67850,43.51338346985532,35.97010256930464,NaN,NaN,-42.138613485914284,-74.80638829951855,-0.031119200576728234,-0.6812696310793349,-0.6501504305026067,275000,-8380,49.804692252732835,51.87666997182151,NaN,NaN,-23.868300286128953,-19.003734408398252
2000-03-06T09:30:00-05:00,28.45312,28.60937,28.07812,28.07812,316300,83100,39.18081645561722,35.71968659301858,NaN,NaN,-54.332384248217714,-61.5069060194052,-0.01699708128769495,-0.6713967821122253,-0.6543997008245304,-41300,1820,50.81407505602288,50.478366899767714,NaN,NaN,-23.615735108775137,-19.662591651309235
2000-03-07T09:30:00-05:00,28.09375,28.25,27.5,27.5625,635200,113040,35.6743446611254,35.34920273061149,NaN,NaN,-78.60542584924697,-60.467842620915235,-0.034194222079946934,-0.697142478424464,-0.662948256344517,-676500,-118120,40.50064219096681,48.43868766946797,NaN,NaN,-24.47111120049761,-20.349523015479004
2000-03-08T09:30:00-05:00,27.3125,27.6875,27.3125,27.42187,184000,108990,34.76061602021497,35.32853338540262,NaN,NaN,-94.61288848649217,-66.2104534438865,-0.04611124449511139,-0.7205873119634063,-0.6744760674682949,-860500,-280200,31.265646430761308,45.86715992502742,NaN,NaN,-25.438709732016257,-21.076549689270042
2000-03-09T09:30:00-05:00,27.46875,28.15625,27.375,28.0625,15400,108810,42.043112262346774,35.83512070255763,NaN,NaN,-64.10241166051416,-66.75834474607704,-0.004130796109719892,-0.6796395626054448,-0.6755087664957249,-845100,-429680,25.492359203225533,43.03259263765135,NaN,NaN,-24.042237150765022,-21.500219326626468
2000-03-10T09:30:00-05:00,28,28.20312,27.8125,27.82812,165300,116825,40.27190043695716,36.55084673686701,NaN,NaN,-54.6952308220707,-69.26966821330834,0.013599179234987324,-0.6585097924519907,-0.672108971686978,-1010400,-686760,18.995801943545544,40.09422611768492,NaN,NaN,-23.41586456000456,-21.773882931394766
2000-03-13T09:30:00-05:00,27.21875,27.84375,27.21875,27.625,64200,119575,38.74838765255877,37.234661425153035,NaN,NaN,-96.59742715000051,-77.72267679366489,0.01716393817318962,-0.6506540489704911,-0.6678179871436807,-1074600,-893420,15.56241305976097,37.27216032171983,NaN,NaN,-23.33869639197382,-21.99742771147749
2000-03-14T09:30:00-05:00,27.8125,28.09375,27.70312,27.70312,36200,120640,39.69332623954625,37.6001537986866,NaN,NaN,-58.379996701535866,-73.67759096412267,0.02957230302469238,-0.6308526083628152,-0.6604249113875076,-1038400,-965800,14.569188257283912,34.64954510244992,NaN,NaN,-23.008854586497748,-22.141917265051813
2000-03-15T09:30:00-05:00,27.84375,28.0625,27.5625,27.84375,42200,121595,41.444597633634615,38.18815796304443,NaN,NaN,-53.77617211983037,-65.51024769079031,0.05079504264895651,-0.596931108076312,-0.6477261507252685,-996200,-992940,14.203146088527788,32.42604581941207,NaN,NaN,-22.24886068817246,-22.157194896926192
2000-03-16T09:30:00-05:00,28.125,29.28125,28.125,29.28125,168500,128270,55.62877262265952,40.133875858402654,NaN,NaN,153.28367634318607,-22.03303009005027,0.15907737203618755,-0.4488794356800341,-0.6079568077162216,-827700,-989460,14.499777469592644,30.58952204020059,NaN,NaN,-16.73847012167143,-21.383091357604084
2000-03-17T09:30:00-05:00,29.15625,29.59375,29.0625,29.3125,62000,130605,55.87898538273445,41.68986783852802,NaN,NaN,224.11945774671426,33.72990762370672,0.22614446777526565,-0.32527622299713954,-0.5514206907724052,-765700,-940520,18.753971334345223,29.169774276560815,NaN,NaN,-12.33866874906595,-20.09103098495578
2000-03-20T09:30:00-05:00,29.8125,30,29.70312,29.875,8200,125520,60.22666206599373,43.309450017995104,NaN,NaN,255.95750544126074,104.24089414195896,0.29725059047043656,-0.1798574526843595,-0.47710804315479605,-757500,-877100,24.029227234903487,28.187437234395542,NaN,NaN,-7.123982027020947,-18.238595419536516
2000-03-21T09:30:00-05:00,30,30.125,29.71875,30.0625,18100,124660,61.585508159962956,44.84476972921103,NaN,NaN,211.7953146627859,158.2759564148233,0.34255167840883266,-0.04891844514375521,-0.39147012355258787,-739400,-817300,28.728360576598774,27.59331236290179,NaN,NaN,-2.454045698008954,-15.983659745032579
2000-03-22T09:30:00-05:00,30.3125,31.04687,30.3125,30.82812,29900,125280,66.60295673947547,46.803812128763035,NaN,NaN,223.38549245075242,213.70828932893988,0.40541743584214285,0.11530167125009072,-0.2901157645920521,-709500,-759960,33.007334783401234,27.159045420119195,NaN,NaN,3.375551690307404,-13.218058111412581
2000-03-23T09:30:00-05:00,30.625,31.15625,30.625,30.95312,24900,117885,67.35270668939305,48.50662093015859,NaN,NaN,186.05737334681294,220.26302872966525,0.4341899608066087,0.25262168641620875,-0.18156827439039996,-684600,-731340,35.101702094103246,26.10883183735994,NaN,NaN,8.282438301118042,-10.146558623908208
2000-03-24T09:30:00-05:00,31,31.375,31,31.21875,9200,117285,68.94803232605227,50.63285063518966,NaN,NaN,167.6032999353091,208.9597971673842,0.44807027616669426,0.37851957081796783,-0.06955070534872641,-675400,-713280,36.451788994915084,25.082954261566528,NaN,NaN,12.857155383296462,-6.860313765736112
2000-03-27T09:30:00-05:00,31.04687,31.35937,31,31,14400,112825,66.08415047365114,52.804979621798644,NaN,NaN,136.56803642586306,185.08190336430465,0.4199555711948064,0.4553937586447816,0.03543818744997519,-689800,-699740,37.5015329532559,24.868732173158605,NaN,NaN,15.832533723447353,-3.618478410138475
2000-03-28T09:30:00-05:00,31,31.17187,30.875,31.03125,13700,112735,66.29950605439515,55.05775748138295,NaN,NaN,111.98051535658517,165.11894350306454,0.38199027260893775,0.5129260282111474,0.13093575560220966,-676100,-687080,38.52408351475707,25.38719196487258,NaN,NaN,18.32090538757632,-0.4842807247506471
2000-03-29T09:30:00-05:00,30.78125,30.82812,30.40625,30.5625,6800,111740,60.13167235303301,56.349797487860535,NaN,NaN,77.99999373644341,136.04184376020277,0.30706155146129643,0.5147626949288302,0.20770114346753377,-682900,-681760,38.97591791418493,26.350303301369685,NaN,NaN,18.75376381616567,2.2640113525231125
2000-03-30T09:30:00-05:00,30.5,30.625,29.98437,30.125,14000,110060,54.98974941654837,57.40107241497419,NaN,NaN,53.16102333825412,109.46257375849098,0.2141872071351864,0.4754351523865168,0.2612479452513304,-696900,-684220,38.83378581538332,27.767302149358095,NaN,NaN,17.60064596603881,4.454959154453927
2000-03-31T09:30:00-05:00,30.34375,30.67187,30.0625,30.67187,14400,92145,59.63604389848117,58.8930478611115,NaN,NaN,59.113211925106896,87.76455615645054,0.17726553822397206,0.48282986803129546,0.3055643298073234,-682500,-685640,38.745952337876076,29.423269240652036,NaN,NaN,17.98467256347932,6.387775355743269
2000-04-03T09:30:00-04:00,30.92187,30.92187,30.65625,30.65625,11200,76890,59.447284347972776,60.30404486885625,NaN,NaN,66.90962877757315,73.83287462679255,0.1410485954343086,0.48187507410020913,0.34082647866590055,-693700,-686420,38.69418129058924,31.14648302874527,NaN,NaN,18.23836177825888,8.0807162732455
2000-04-04T09:30:00-04:00,30.82812,31.125,29.4375,30.3125,7600,45510,55.299042388165766,61.29364806560848,NaN,NaN,38.647006081562004,59.16617277178791,0.08590994500283317,0.448213909919442,0.3623039649166088,-701300,-691460,38.33772395730511,32.87038144794365,NaN,NaN,17.241783274167695,9.389440130520098
2000-04-05T09:30:00-04:00,30,30.34375,29.92187,30.10937,7100,36665,52.94780714221426,61.10215053129095,NaN,NaN,24.4930853338868,48.46479109127658,0.03058022770736446,0.40052924955081437,0.3699490218434499,-708400,-696560,37.95668056089232,34.54587452589362,NaN,NaN,15.721515621338778,10.294022343494195
2000-04-06T09:30:00-04:00,30.28125,30.84375,30.28125,30.6875,29000,37345,58.37271846969146,61.28027432321646,NaN,NaN,50.3556753942056,47.90372150246688,0.02781971812127315,0.40472366949504135,0.3769039513737682,-679400,-693060,38.40910616194553,35.94981272786507,NaN,NaN,15.963287737096646,11.103917399723116
2000-04-07T09:30:00-04:00,30.8125,30.90625,30.54687,30.76562,6000,29380,59.05960689107522,61.196913239293714,NaN,NaN,56.039452232311234,47.28896956390775,0.026180403116238093,0.4096294552690658,0.3834490521528277,-673400,-691240,38.65959410077387,36.9948389325701,NaN,NaN,16.357484658368847,11.854427008101078
2000-04-10T09:30:00-04:00,30.8125,30.85937,30.5625,30.5625,16000,26970,56.45130837578866,60.83018468328125,NaN,NaN,46.072397934456994,43.12152339528452,0.0073220165483312005,0.3926015728382417,0.3852795562899105,-689400,-690380,38.78628074323472,37.71326180161552,NaN,NaN,15.947901064247475,12.439209016121993
2000-04-11T09:30:00-04:00,30.5,30.82812,30.48437,30.82812,10100,25665,59.001249379243475,60.287205586121836,NaN,NaN,46.5613496449707,44.70439210796626,0.008556840680647493,0.3959756071407199,0.3874187664600724,-679300,-685980,39.47502455747338,38.175239642620674,NaN,NaN,16.313748820302376,12.992714702433476
2000-04-12T09:30:00-04:00,30.875,30.9375,30.26562,30.26562,13100,24210,52.0505743395769,59.19419613256353,NaN,NaN,8.27761526835521,41.46129809485994,-0.030547218043247282,0.3492347439060133,0.37978196194926056,-692400,-682780,40.00373168825939,38.52538461363183,NaN,NaN,14.549342692036504,13.215090129519623
2000-04-13T09:30:00-04:00,30.01562,30.0625,29.375,29.5,17500,16660,44.386012476726556,57.43976614332598,NaN,NaN,-142.95340954133115,2.7994811077525994,-0.10577802825834326,0.24755942662633146,0.3533374548846747,-709900,-688880,39.298995559531804,38.72875651110445,NaN,NaN,10.424171508705063,12.816387469403258
2000-04-14T09:30:00-04:00,28.46875,28.59375,27.71875,27.71875,9800,14050,32.423588761874655,55.03544030677052,NaN,NaN,-339.5114503896066,-76.31069941663097,-0.2642827074121848,0.02298407061944374,0.28726677803162853,-719700,-698140,38.19886968813808,38.77856627788175,NaN,NaN,1.5174062262764767,11.202247291813718
2000-04-17T09:30:00-04:00,27.78125,28.0625,27.14062,27.95312,16900,14485,34.90931732572716,52.79328396900853,NaN,NaN,-282.2334123463444,-141.97186147279123,-0.33743824384284504,-0.13453102677192774,0.20290721707091727,-702800,-700820,37.86846430710883,38.7317363344783,NaN,NaN,-4.294861108624406,8.9883746631797
2000-04-18T09:30:00-04:00,27.89062,28.71875,27.89062,28.71875,50900,16125,42.36741830094582,51.52440867957373,NaN,NaN,-165.45136299050282,-184.37440399988594,-0.3185907949045641,-0.19533127655978788,0.12325951834477623,-651900,-695340,39.029765606285416,38.73558259819976,NaN,NaN,-6.372267937434489,6.793997148806245
2000-04-19T09:30:00-04:00,29.1875,29.5,29.09375,29.46875,7200,14990,48.58250704540254,51.066748510206175,NaN,NaN,-69.95871480082637,-200.02167001372226,-0.24333700876791955,-0.18091174261512322,0.062425266152796345,-644700,-685800,41.093935006201384,38.89702182611534,NaN,NaN,-5.776451175089236,4.9982188168211765
2000-04-20T09:30:00-04:00,29.46875,29.59375,29.25,29.59375,4000,13945,49.55883958027325,50.34694820176274,NaN,NaN,-51.33976913826225,-181.69894193310847,-0.17600517668899684,-0.15758120470844972,0.018423971980547134,-640700,-671960,44.053143465336284,39.27610690664822,NaN,NaN,-4.987984365879917,3.571618362149592
2000-04-24T09:30:00-04:00,29,29.3125,28.875,29.17187,18000,14385,46.35930099951549,49.41209224830151,NaN,NaN,-70.89280147478524,-127.97521215014422,-0.15166777042659668,-0.17116074105269874,-0.019492970626102044,-658700,-659760,46.59978029348743,39.84079254971237,NaN,NaN,-5.413419754079653,2.2880414884025573
2000-04-25T09:30:00-04:00,29.3125,29.90625,29.3125,29.90625,3600,13845,52.15040156603294,49.187189332434876,NaN,NaN,-17.192104493514286,-74.9669505795782,-0.08141875088362958,-0.12126640923063903,-0.03984765834700944,-655100,-650220,48.57116437109937,40.57175257926911,NaN,NaN,-3.796614953419536,1.4188048538565439
2000-04-26T09:30:00-04:00,30,30.46875,30,30.21875,15500,13935,54.40613091613684,49.2913553162865,NaN,NaN,32.06573762867883,-35.46353045574186,-0.01281361748641626,-0.05586468020502977,-0.04305106271861351,-639600,-647760,49.093051613392454,41.36720765444768,NaN,NaN,-1.756664890171775,0.9651663189953555
2000-04-27T09:30:00-04:00,29.625,30.1875,29.625,30.03125,5200,13855,52.79785375229437,48.89315069361527,NaN,NaN,10.248414040399496,-19.42210468749668,0.0192851383820645,-0.018944639741032887,-0.038229778123097385,-644800,-647780,49.08869016232281,42.13003508304606,NaN,NaN,-0.6236139448477684,0.7381977098749093
2000-04-28T09:30:00-04:00,30.57812,30.57812,30.1875,30.3125,4900,13400,54.949111068673915,48.59954384915803,NaN,NaN,47.42782599404454,0.33141433896467587,0.05669030942146487,0.0326331086537337,-0.024057200767731168,-639900,-647620,49.12762762406397,42.87775176328107,NaN,NaN,0.969023256276349,0.7711727879322579
2000-05-01T09:30:00-04:00,30.40625,30.5625,30.28125,30.40625,3500,12855,55.67429750093592,48.54404307238284,NaN,NaN,53.07840292784913,25.125655219491552,0.08336557716439957,0.0801497706877683,-0.0032158064766312743,-636400,-643160,50.269392530587155,43.69797403380625,NaN,NaN,2.4739647000260634,1.01442877537423
2000-05-02T09:30:00-04:00,29.9375,29.9375,29.64062,29.79687,3800,12485,50.0362041229192,47.90368269693111,NaN,NaN,-0.07609623373513451,28.548856871447377,0.05685506680640846,0.0678530270313793,0.010997960224970842,-640200,-640180,51.059756106447956,44.525454858733,NaN,NaN,2.1186167383218777,1.1721699129381797
2000-05-03T09:30:00-04:00,29.3125,29.40625,28.6875,28.96875,10600,12635,43.57770462986553,47.298477717666,NaN,NaN,-66.86085359704572,8.763538626302472,-0.015690594107310257,-0.00861528240916698,0.0070753116981432775,-650800,-642420,50.411201365778,45.26884554998433,NaN,NaN,-0.26158274938451026,0.9673481040349383
2000-05-04T09:30:00-04:00,28.875,29.0625,28.76562,28.875,18600,13210,42.90256558577291,47.192517225455035,NaN,NaN,-69.85579810541041,-7.257303802859511,-0.06638569230354252,-0.07590680368128488,-0.009521111377742357,-669400,-647340,48.94078410173966,45.9575447315706,NaN,NaN,-2.3705224476016626,0.4905094538011382
2000-05-05T09:30:00-04:00,28.78125,29.03125,28.78125,28.84375,4700,11995,42.66528242053263,47.92406677250204,NaN,NaN,-63.56215318720734,-29.45529963910989,-0.09658784987726508,-0.1302559237243237,-0.033668073847058624,-674100,-654180,46.89294091010991,46.578549818854306,NaN,NaN,-4.142922439215736,-0.17140938805841532
2000-05-08T09:30:00-04:00,28.67187,28.90625,28.57812,28.90625,5800,11985,43.34023476906348,48.52627516131177,NaN,NaN,-64.42255220599354,-52.955490665878415,-0.10615913304583138,-0.16636699015434786,-0.06020785710851648,-668300,-660560,45.0014613485675,47.088049607529925,NaN,NaN,-5.424181310618561,-0.921805376995579
2000-05-09T09:30:00-04:00,28.9375,28.9375,28.65625,28.70312,6200,11495,41.625133344936245,48.473254807311086,NaN,NaN,-60.46164434899323,-65.03260028893004,-0.1190075692461017,-0.2089673186661436,-0.0899597494200419,-674500,-667420,42.993368560533376,47.37116410426192,NaN,NaN,-6.986315774050654,-1.788164005146304
2000-05-10T09:30:00-04:00,28.9375,29.09375,28.46875,28.65625,9100,11445,41.2198021589902,47.947347315424494,NaN,NaN,-56.479883141148974,-62.956406197750695,-0.122993134749769,-0.24370116785725315,-0.12070803310748415,-683600,-673980,41.10446175170049,47.37191601465471,NaN,NaN,-8.402748231594149,-2.7331046089245676
2000-05-11T09:30:00-04:00,28.65625,28.75,28.5625,28.625,3800,10980,40.93359923501057,47.33125871933429,NaN,NaN,-60.04059066642584,-60.99336470995378,-0.11993753653172462,-0.27062995377213994,-0.15069241724041532,-687400,-677580,40.06418541368372,47.08699043953668,NaN,NaN,-9.673173811561506,-3.7245430664441304
2000-05-12T09:30:00-04:00,28.875,29.21875,28.84375,29.125,5100,10360,47.245138866984284,47.39453285272492,NaN,NaN,-12.065737836610197,-50.69408163983435,-0.07845235700088904,-0.24875786349152662,-0.17030550649063758,-682300,-679220,39.57284436073826,46.585066444340306,NaN,NaN,-9.16784325730359,-4.5021573794240535
2000-05-15T09:30:00-04:00,29,29.625,29,29.60937,8000,10270,52.536270674036096,47.422094931868,NaN,NaN,20.654002527244696,-33.678770693186706,-0.015873643364509776,-0.1901475606962748,-0.17427391733176503,-674300,-680420,39.194079841705886,45.91527469224077,NaN,NaN,-7.2141442875491775,-4.889584080584785
2000-05-16T09:30:00-04:00,29.84375,30.15625,29.84375,30,11200,9985,56.33946236595412,47.56019003542637,NaN,NaN,83.49326869366818,-4.887788084654426,0.05069952066219047,-0.11089951650402696,-0.16159903716621743,-663100,-678140,40.36205334116346,45.29163195851013,NaN,NaN,-4.389745504897393,-4.818178569772301
2000-05-17T09:30:00-04:00,29.65625,29.90625,29.59375,29.65625,6600,7770,52.36320595686655,47.52914376432438,NaN,NaN,41.02790756953694,14.613770057482759,0.06930448312550222,-0.07496843325933966,-0.14427291638484188,-669700,-675360,41.82924370712605,44.77310006885322,NaN,NaN,-3.080147687850117,-4.569888443783418
2000-05-18T09:30:00-04:00,29.8125,29.8125,29.5625,29.625,2200,7520,52.00387931078801,47.31877006733253,NaN,NaN,31.208716837212446,32.863631558210415,0.07665366427892134,-0.04845583603619019,-0.12510950031511153,-671900,-672260,43.49850866557087,44.37102014324656,NaN,NaN,-2.1043505658667008,-4.217668746938172
2000-05-19T09:30:00-04:00,29.15625,29.15625,28.8125,28.84375,5500,7595,43.89433641901842,46.47734427576699,NaN,NaN,-60.24087817938301,23.228603489655853,0.02852472647843407,-0.08945359221706894,-0.11797831869550301,-677400,-671280,44.045156107510024,43.92643182731248,NaN,NaN,-3.642070655716298,-4.13544044819219
2000-05-22T09:30:00-04:00,28.8125,28.8125,28.375,28.51562,47300,9060,41.00226462928719,45.832062883364706,NaN,NaN,-98.95150428979834,-0.6924978737527538,-0.023001776836338014,-0.14673053974092554,-0.12372876290458752,-724700,-681360,39.78180559555098,43.12086393367698,NaN,NaN,-5.829966659493767,-4.377515621235273
2000-05-23T09:30:00-04:00,28.5625,28.65625,28.28125,28.28125,6600,9210,39.02448228134309,45.5068327156131,NaN,NaN,-105.74873569098288,-38.54089875068297,-0.06792073408467714,-0.20862968051043396,-0.14070894642575682,-731300,-695000,34.86402715315465,42.01035148991817,NaN,NaN,-8.254512843938997,-4.931372367335805
2000-05-24T09:30:00-04:00,28.8125,28.8125,28.07812,28.46875,7800,8825,41.45739555041943,45.403606284516435,NaN,NaN,-93.28182465061622,-65.40284519471359,-0.07926592057730816,-0.23979134714739203,-0.16052542657008387,-723500,-705760,31.550618999269673,40.76819683974174,NaN,NaN,-9.575045860205789,-5.594754294888659
2000-05-25T09:30:00-04:00,28.5,28.6875,28.25,28.25,112100,14170,39.478324803461355,45.17596645472563,NaN,NaN,-93.88976929917787,-90.42254242199166,-0.09471824742839635,-0.2789232358555793,-0.18420498842718297,-835600,-738500,24.058337507929124,39.137153739585976,NaN,NaN,-11.264867370188963,-6.404770448502989
2000-05-26T09:30:00-04:00,28.5,28.5,27.96875,28.03125,139600,20905,37.5479982850841,44.76223527729853,NaN,NaN,-120.81789406641829,-102.53794559939872,-0.11171893173492156,-0.3238536530958349,-0.21213472136091335,-975200,-798060,16.419505340231765,37.09558545327628,NaN,NaN,-13.255913528789826,-7.383505174258251
2000-05-30T09:30:00-04:00,28.28125,29.25,28.28125,29.1875,52200,23340,51.14564399574309,45.442271752356156,NaN,NaN,-9.43426610738065,-84.63449796291518,-0.04079497474107091,-0.263128439787252,-0.22233346504618107,-923000,-837720,13.374308354705562,34.97993829571715,NaN,NaN,-10.720294388600294,-7.860189347735686
2000-05-31T09:30:00-04:00,29.25,29.5,29.125,29.5,41100,25205,54.057153531573256,46.35922542182639,NaN,NaN,78.87142390369966,-47.71046604397867,0.027767319167850996,-0.18762431608636732,-0.2153916352542183,-881900,-867840,11.612819362339536,32.8733924107628,NaN,NaN,-7.687918954268483,-7.835579291526085
2000-06-01T09:30:00-04:00,29.5625,29.65625,29.25,29.3125,19300,25640,52.05270832556799,47.153447499723335,NaN,NaN,75.86639718385666,-13.880821677084095,0.05928310042166121,-0.1412877597271418,-0.20057086014880302,-901200,-903380,9.947919875072358,30.722230586576273,NaN,NaN,-5.855905743374471,-7.5527687846472835
2000-06-02T09:30:00-04:00,29.84375,30.25,29.8125,30.03125,26900,26055,58.41786462305235,47.951499339442485,NaN,NaN,149.06238687336952,34.70960955742539,0.12362637557994155,-0.04603789067387609,-0.16966426625381764,-874300,-911120,9.62430538120546,28.58304923089536,NaN,NaN,-2.1039229729725517,-6.774362240122322
2000-06-05T09:30:00-04:00,30.15625,30.20312,29.875,29.9375,8100,26225,57.34845324021922,48.29522666559842,NaN,NaN,123.53330040138799,83.57984845098665,0.1530386857684387,0.021634090956730745,-0.13140459481170796,-882400,-892560,16.6281547030258,26.971197435275347,NaN,NaN,0.5381149242911465,-5.729722645206112
2000-06-06T09:30:00-04:00,29.875,29.96875,29.59375,29.6875,22800,27075,54.48412665473707,48.16270268622578,NaN,NaN,79.48178724555798,101.36305912157437,0.148694785844585,0.05446388749402331,-0.0942308983505617,-905200,-889000,17.94175750627248,25.369747732783136,NaN,NaN,1.8588784317349516,-4.645636777071674
2000-06-07T09:30:00-04:00,29.59375,29.8125,29.40625,29.60937,9400,27235,53.58339882418737,48.24985931960584,NaN,NaN,55.69071171669075,96.7269166841726,0.1340502981862771,0.07333197438228467,-0.060718323803992426,-914600,-895540,17.399393092660745,23.624758403178472,NaN,NaN,2.670263385156937,-3.6005081824675873
2000-06-08T09:30:00-04:00,29.75,29.75,29.375,29.375,9500,27255,50.86679182995815,48.168638785260846,NaN,NaN,37.88521327875069,89.13067990315139,0.10344089039345146,0.0685827891878219,-0.03485810120562956,-924100,-900120,17.01156183830699,21.732833629802478,NaN,NaN,2.575355156016973,-2.7182419912555074
2000-06-09T09:30:00-04:00,29.59375,29.96875,29.59375,29.8125,14300,27780,55.411254413595714,48.99127578487351,NaN,NaN,68.82310896144251,73.082824320766,0.10707098676438212,0.0989806322498481,-0.008090354514534027,-909800,-907220,16.401234536052442,19.7582678032698,NaN,NaN,3.8375804842787438,-1.7816959233220429
2000-06-12T09:30:00-04:00,29.75,29.75,29.375,29.53125,17200,28385,52.07661186167297,49.78230058718678,NaN,NaN,34.92791752882987,55.361747746254366,0.08585846305949876,0.09923272430983943,0.013374261250340663,-927000,-916140,15.641956440626956,18.033992863632367,NaN,NaN,3.9263009052261952,-0.9662678049580089
2000-06-13T09:30:00-04:00,29.28125,29.40625,29.125,29.125,4100,28190,47.6188605996811,50.396184752782354,NaN,NaN,-7.0374439361268335,38.05790150991741,0.0420141651353678,0.06589196766955041,0.02387780253418261,-931100,-921320,15.201837551590998,16.629550749234966,NaN,NaN,2.655975893415162,-0.44880441947612737
2000-06-14T09:30:00-04:00,29.6875,29.84375,29.46875,29.625,10100,28135,52.956332438876004,51.21753738767212,NaN,NaN,52.19210436960242,37.35818004049973,0.04402209918120919,0.0789054265106941,0.03488332732948491,-921000,-922600,15.088857908620554,15.453710671331455,NaN,NaN,3.192215610601318,0.07134129910636478
2000-06-15T09:30:00-04:00,30,30.46875,30,30.46875,57000,30655,60.30666101751967,52.70527568867628,NaN,NaN,131.0615376884461,55.99344492243881,0.09650105136838091,0.15550964153996105,0.05900859017158014,-864000,-910580,21.02460131889005,15.237015229257233,NaN,NaN,6.155717788463499,0.9405379404430981
2000-06-16T09:30:00-04:00,30.3125,30.5,30.0625,30.125,1318500,96470,56.4377488683011,54.05454358747749,NaN,NaN,112.02397305527936,64.63361774120617,0.10185980534972099,0.18633334685873137,0.08447354150901039,-2182500,-1165120,8.104419732986287,14.643080543025414,NaN,NaN,7.308107593818362,1.8501907480681359
2000-06-19T09:30:00-04:00,30.3125,30.40625,30.15625,30.3125,21100,97250,58.019767776853016,54.54555242898534,NaN,NaN,109.29886452607184,79.50780714065456,0.11107459202958031,0.22331678154598578,0.11224218951640547,-2161400,-1412000,4.936054021368193,14.040348090644173,NaN,NaN,8.736037230112355,2.8338831026458813
2000-06-20T09:30:00-04:00,30.0625,30.375,29.9375,30.26562,5300,95150,57.45791538332612,54.788463989824834,NaN,NaN,90.75604511141916,99.06650495016376,0.10701246544773463,0.24600777132607377,0.13899530587833914,-2166700,-1659120,3.472610127848071,13.458904573894783,NaN,NaN,9.709604567746947,3.8161290262317475
2000-06-21T09:30:00-04:00,30.03125,30.25,30,30.125,134600,101550,55.71505348816409,55.05006007286742,NaN,NaN,77.54222572059844,104.13652922036297,0.08861539937635424,0.24976455509878193,0.1611491557224277,-2301300,-1935180,2.5596419135443824,12.93117043378564,NaN,NaN,10.012434182577946,4.701315477138348
2000-06-22T09:30:00-04:00,30,30.21875,30,30.0625,25200,102420,54.917714190761835,54.8000493277038,NaN,NaN,68.11623692924888,91.54746906852353,0.06698133902723608,0.2448758295064728,0.17789449047923672,-2326500,-2227680,1.9689705455228363,12.384360802665453,NaN,NaN,10.041067007842631,5.464137124381817
2000-06-23T09:30:00-04:00,30.0625,30.0625,29.3125,29.5,2900,96960,48.22814205026506,54.14859852842137,NaN,NaN,-11.32574258776365,66.87752593991493,0.012390990638516064,0.1933832287773818,0.18099223813886572,-2329400,-2257060,1.921018314680964,11.333851060640821,NaN,NaN,8.085815203977836,5.838662564324105
2000-06-26T09:30:00-04:00,29.5,29.5,29.125,29.21875,6600,90310,45.25954815125081,53.48970006388663,NaN,NaN,-92.67026598379798,26.483699837940968,-0.042073527980604514,0.1284003281631101,0.1704738561437146,-2336000,-2291980,1.8629449815900898,10.185364451734936,NaN,NaN,5.534660683874422,5.795233724259864
2000-06-27T09:30:00-04:00,29.15625,29.375,29.0625,29.15625,59200,90660,44.60252320915854,52.84820894852743,NaN,NaN,-116.82178707502449,-15.03186659934776,-0.07954805083252209,0.071038792603062,0.1505868434355841,-2395200,-2337680,1.7868157127475115,9.070180353169704,NaN,NaN,3.252005331511369,5.431915382438651
2000-06-28T09:30:00-04:00,29.34375,29.48437,29.03125,29.03125,42100,90710,43.250218296857206,52.30416798187736,NaN,NaN,-114.96455132050792,-53.53322200756903,-0.10821639496670125,0.015316349727207523,0.12353274469390878,-2437300,-2364880,1.741207858956372,7.979440783216087,NaN,NaN,0.9508874743660458,4.791768538428278
2000-06-29T09:30:00-04:00,29,29.46875,28.90625,29.46875,31900,91340,49.070419813423015,51.85125122472217,NaN,NaN,-92.05359752321715,-85.56718889806224,-0.0937182719614395,0.0063849047421093985,0.1001031767035489,-2405400,-2380660,1.7138764412131309,6.930343776441849,NaN,NaN,0.5356008724798185,4.183744586149927
2000-06-30T09:30:00-04:00,29.375,29.5625,29.32812,29.5625,16600,90825,50.24792526125073,51.720630753263436,NaN,NaN,-46.9368359491239,-92.68940757033428,-0.0746479782298255,0.006793203916267032,0.08144118214609253,-2388800,-2392540,1.6923390526688564,5.933942534444843,NaN,NaN,0.5176873324785596,3.6600221213397317
2000-07-03T09:30:00-04:00,29.25,29.5,29.25,29.5,2400,90540,49.427470501753106,51.849817174840005,NaN,NaN,-55.46709091682656,-85.24877255694,-0.06351300490356859,0.0020499260166317868,0.06556293092020038,-2391200,-2403580,1.6713201280064993,4.967477004188807,NaN,NaN,0.28193291739499676,3.1774379493476266
2000-07-05T09:30:00-04:00,29.5625,29.78125,29.40625,29.6875,83100,93555,51.96161203955993,51.778765717746005,NaN,NaN,-11.83424887021831,-64.25126491597877,-0.04183627543616737,0.013267586624991168,0.05510386206115854,-2308100,-2386160,3.7036614718307277,4.154248687275247,NaN,NaN,0.7596819294042749,2.832044232212862
2000-07-06T09:30:00-04:00,29.71875,29.84375,29.40625,29.625,12400,93705,51.04344936252391,51.117107742389166,NaN,NaN,-12.014365731306478,-43.66122779813848,-0.03054757004511771,0.0169193995047614,0.04746696954987911,-2320500,-2362800,6.494676355549032,3.116396904179461,NaN,NaN,0.9243115928738315,2.559510998021572
2000-07-07T09:30:00-04:00,29.5,29.90625,29.5,29.875,14400,93950,54.50629402327985,50.9791466820305,NaN,NaN,13.193372895465888,-22.611833714401875,-0.00634900545166954,0.039530712735292184,0.045879718186961724,-2306100,-2342940,8.911836437969072,3.174069525963947,NaN,NaN,2.000670391886211,2.4796766257165204
2000-07-10T09:30:00-04:00,29.84375,29.84375,29.40625,29.625,23200,94395,50.648215761279346,50.452607252346674,NaN,NaN,-13.236322882943927,-15.871731101165878,-0.007221681199042998,0.03685261668815798,0.04407429788720098,-2329300,-2331040,10.406346093655756,3.5648046739844874,NaN,NaN,1.9042550878342814,2.3974735488762007
2000-07-11T09:30:00-04:00,29.28125,29.5,29.21875,29.29687,6400,93855,46.04175996381481,49.63716757952444,NaN,NaN,-69.29612293910553,-18.637537505621673,-0.028732391978526298,0.008158807914043109,0.03689119989256941,-2335700,-2319940,11.85904375574654,4.163835647405807,NaN,NaN,0.5102607957870804,2.1278717270063265
2000-07-12T09:30:00-04:00,29.73437,30,29.5625,29.84375,98400,98570,53.6139414631227,49.487088149164336,NaN,NaN,20.15202972824345,-12.240281785929323,-0.006144415336754971,0.029210680721625693,0.035355096058380664,-2237300,-2305780,13.779625738620197,4.965263063482651,NaN,NaN,1.5315687320097784,2.0426855848639627
2000-07-13T09:30:00-04:00,29.65625,30.0625,29.65625,29.9375,5600,98345,54.78534460165661,49.47763317851396,NaN,NaN,34.46424422803706,-2.944559794060615,0.013995971546433728,0.05285006049142282,0.038854088944989096,-2231700,-2288020,16.244709789270075,5.984958723750312,NaN,NaN,2.7148073145503138,2.1387029748191555
2000-07-14T09:30:00-04:00,30.15625,30.40625,29.96875,30.40625,4000,95695,60.197650210827746,50.332598047125586,NaN,NaN,113.55612104803275,17.12798983645276,0.0554461885071829,0.10816182457896772,0.052715636071784824,-2227700,-2272340,18.461240278257236,7.166403149720045,NaN,NaN,5.468914656463823,2.6144475007683936
2000-07-17T09:30:00-04:00,30.4375,30.4375,30,30.03125,26200,31080,54.56994579552971,50.997626450288365,NaN,NaN,93.76034774516306,38.527323962074156,0.054107578328844705,0.12035010898284071,0.066242530653996,-2253900,-2257260,20.636554223099466,8.507375238399286,NaN,NaN,6.073396921321476,3.1085831322759767
2000-07-18T09:30:00-04:00,29.78125,29.90625,29.54687,29.5625,56600,32855,48.47008134037985,51.27388060251847,NaN,NaN,-2.2749771400565857,51.93155312188394,0.01991370431580196,0.09113466104874846,0.0712209567329465,-2310500,-2252220,21.391371685992297,9.907700665059625,NaN,NaN,4.600640725404777,3.3217342170086623
2000-07-19T09:30:00-04:00,29.6875,29.96875,29.625,29.75,7600,32970,50.8373451790959,51.81581823696409,NaN,NaN,30.992221236988186,54.09959142363289,0.00875424134194204,0.08216375841037404,0.073409517068432,-2302900,-2265340,20.83582556645186,11.271601929880733,NaN,NaN,4.14964331636995,3.4400069454888462
2000-07-20T09:30:00-04:00,29.90625,30.28125,29.90625,30.21875,2000,26340,56.248665067321596,52.32855004081398,NaN,NaN,121.82063884990272,71.57087034800603,0.030546063707867,0.11159209670326575,0.08104603299539875,-2300900,-2279180,20.238719539032175,12.594805008296378,NaN,NaN,5.526771375997754,3.7381161498472615
2000-07-21T09:30:00-04:00,30.09375,30.09375,29.4375,29.46875,6500,25405,47.28135024232817,52.11665182517665,NaN,NaN,7.507265941284925,50.36109932665646,-0.005998648421211561,0.0735477224688843,0.07954637089009586,-2307400,-2295120,19.54402843369212,13.86992567836947,NaN,NaN,3.610936966221763,3.719947695043619
2000-07-24T09:30:00-04:00,29.5,29.5,29.15625,29.1875,61200,28320,44.42140053865667,51.759075399241205,NaN,NaN,-90.3953083289914,13.529968111825568,-0.04726363396051436,0.02046682843945291,0.06773046239996727,-2368600,-2318060,18.556834710279432,15.076033862817535,NaN,NaN,1.0930668122704041,3.3446789975045883
2000-07-25T09:30:00-04:00,29.4375,29.4375,29.09375,29.20312,42500,30115,44.621746669915744,51.23479930140947,NaN,NaN,-98.70238421544703,-5.755513303252522,-0.07027074345753234,-0.02010796692194816,0.05016277653558418,-2326100,-2321180,18.420553232918607,16.127240417180953,NaN,NaN,-0.7934635623264565,2.753515774671582
2000-07-26T09:30:00-04:00,29.25,29.28125,28.96875,28.96875,26900,28500,42.16569072734658,50.60067368461109,NaN,NaN,-138.07031243696352,-39.56802003804286,-0.09642171580693286,-0.0703643682230819,0.026057347583850962,-2353000,-2331200,17.964264048867236,16.946496680989398,NaN,NaN,-3.124350562036359,1.913820583713305
2000-07-27T09:30:00-04:00,29.125,29.34375,29.07812,29.15625,2000,26495,44.784112945321205,49.90623217904261,NaN,NaN,-107.9411231398205,-85.52037243598751,-0.09602980087328182,-0.09397990350775132,0.0020498973655305036,-2351000,-2341220,17.497499170856358,17.559758304767062,NaN,NaN,-4.263385864419182,1.0313625196943783
2000-07-28T09:30:00-04:00,29.21875,29.21875,28.625,28.84375,7800,25290,41.418372748052285,49.24695767809782,NaN,NaN,-164.28367825960964,-119.87856127616642,-0.11071182380803445,-0.13633988239451256,-0.02562805858647811,-2358800,-2351500,17.009203587845505,18.031390982923472,NaN,NaN,-6.265509215104435,-0.011047728134023549
2000-07-31T09:30:00-04:00,29,29.125,28.9375,29.125,33800,26150,45.3958649604362,49.200822320713634,NaN,NaN,-110.40038349706906,-123.87957630978194,-0.09592817053197036,-0.14553827175144107,-0.04961010121947071,-2325000,-2342780,19.07226545103545,18.54662110401554,NaN,NaN,-6.758009360231281,-0.974899389862203
2000-08-01T09:30:00-04:00,29.03125,29.59375,29.03125,29.375,6200,26340,48.72827185005657,48.85184591978033,NaN,NaN,-50.347689263939394,-114.20863731948043,-0.06522664807491821,-0.13114341131311846,-0.06591676323820025,-2318800,-2341320,19.4333912009227,18.95046149418,NaN,NaN,-6.166024401641726,-1.7164886772592778
2000-08-02T09:30:00-04:00,29.3125,29.625,29.3125,29.5,9500,22660,50.35953134437988,48.53571640140343,NaN,NaN,-17.739734758990043,-90.14252178388573,-0.03398608138690451,-0.10839936497183089,-0.07441328358492638,-2309300,-2332580,21.68629226293713,19.33914595658479,NaN,NaN,-5.197936764541873,-2.2138384040139343
2000-08-03T09:30:00-04:00,29.4375,29.65625,29.28125,29.65625,18400,22960,52.39827437589645,47.97861812747977,NaN,NaN,-5.830509572443808,-69.7203990704104,-0.0019735711978666054,-0.07688024758225964,-0.07490667638439304,-2290900,-2320560,24.80072122765091,19.791966024398626,NaN,NaN,-3.7958725392572337,-2.439843280477263
2000-08-04T09:30:00-04:00,30.15625,30.5,30.03125,30.26562,57300,25105,59.40128288437057,48.32371363382554,NaN,NaN,133.2821268268837,-10.207238053111718,0.057766187537347025,-0.002698941962709256,-0.06046512950005628,-2233600,-2295520,30.960339922539134,20.529379288644318,NaN,NaN,-0.29651259196141866,-2.1336531821178566
2000-08-07T09:30:00-04:00,30.28125,30.34375,30.03125,30.03125,3500,24120,55.98955335754441,48.860818777908726,NaN,NaN,95.6645885245216,31.00575635120641,0.07777601513124961,0.03675488941400573,-0.04102112571724388,-2237100,-2277940,34.986691114995736,21.500473533573135,NaN,NaN,1.5893418410040687,-1.6017967502432957
2000-08-08T09:30:00-04:00,30.28125,30.3125,30.03125,30.125,4000,24000,57.052163604072284,49.30473437969276,NaN,NaN,89.64599122373326,59.00449244874094,0.09259752793620382,0.0747257842030109,-0.017871743733192922,-2233100,-2260800,38.73798359089946,22.779199106747964,NaN,NaN,3.4442553709107253,-0.8809321615070069
2000-08-09T09:30:00-04:00,29.96875,30.0625,29.84375,29.84375,7900,19475,52.92382433435934,49.067245755909745,NaN,NaN,45.537394925695146,71.65991838567797,0.07924746492483703,0.08118758742285337,0.0019401224980163355,-2241000,-2247140,41.62868160071196,24.307053539725093,NaN,NaN,3.822784405089007,-0.20897265199329063
2000-08-10T09:30:00-04:00,29.78125,29.90625,29.65625,29.90625,28700,20630,53.72517067306575,49.52751864381956,NaN,NaN,29.911057095642384,78.80823171929521,0.07069653726354952,0.09031079407745324,0.019614256813903715,-2212300,-2231420,44.85357473365073,26.11487827543642,NaN,NaN,4.3612864851669295,0.4439215104581694
2000-08-11T09:30:00-04:00,29.875,30.34375,29.875,30.09375,10400,20950,56.13740420423449,50.36437604850369,NaN,NaN,82.36344233451261,68.624494820821,0.07341794469108046,0.11138668767775428,0.037968742986673826,-2201900,-2225080,46.145853974996335,28.085522508630486,NaN,NaN,5.504711186349942,1.1668914641569939
2000-08-14T09:30:00-04:00,30.34375,30.4375,30.15625,30.4375,3400,19810,60.230490295624705,51.4792863074829,NaN,NaN,120.93793353440292,73.67916382279725,0.09286614832123263,0.15405142838821462,0.061185280066981984,-2198500,-2217360,47.75141300762891,30.180583921109793,NaN,NaN,7.720704284591608,2.1031504385047954
2000-08-15T09:30:00-04:00,30.28125,30.65625,30.0625,30.28125,32800,18620,57.59939560275115,52.58169379858323,NaN,NaN,104.53301531695439,76.65656864144148,0.08965838414262431,0.17325826024526236,0.08359987610263805,-2231300,-2217000,47.82952214347683,32.313816642153334,NaN,NaN,8.836639327848136,3.0650774226967012
2000-08-16T09:30:00-04:00,30.40625,30.40625,29.78125,29.84375,3700,18425,50.89529625445591,53.01820689209285,NaN,NaN,49.02567075597332,77.3542238074971,0.05426538701713704,0.15143160987405935,0.09716622285692231,-2235000,-2215800,48.108000289398646,34.5002810077635,NaN,NaN,7.814305332365786,3.7435385526494276
2000-08-17T09:30:00-04:00,29.90625,30.21875,29.90625,30.125,60400,21345,54.55704262126799,53.95668331160825,NaN,NaN,61.30033707981092,83.63207980433083,0.04629993288076942,0.15504113895788407,0.10874120607711465,-2174600,-2208260,49.91697155916794,36.850835862857956,NaN,NaN,8.048326414697021,4.358508247227655
2000-08-18T09:30:00-04:00,30.03125,30.125,29.95312,30.125,2100,21125,54.55704262126799,54.61105314452482,NaN,NaN,53.722093769074014,77.90381009124312,0.037888848737024736,0.15610226699839558,0.11821341826137084,-2174600,-2202800,51.2424691622746,39.1487075565179,NaN,NaN,8.236309509379586,4.912479856106502
2000-08-21T09:30:00-04:00,30.125,30.3125,30.125,30.21875,3800,18255,55.83036133703636,55.118345250737654,NaN,NaN,70.64342906277388,67.84490919691731,0.0355359248999281,0.16263332438628098,0.12709739948635287,-2170800,-2197260,52.61287908094721,41.51867097651965,NaN,NaN,8.747910944826552,5.460398583066509
2000-08-22T09:30:00-04:00,29.96875,29.96875,29.8125,29.84375,3800,16320,49.817302937786714,55.07961465026671,NaN,NaN,13.332506737873587,49.60480748110115,0.007107959256975632,0.1359823485575724,0.12887438930059678,-2174600,-2185920,55.37759034108889,43.92519226781621,NaN,NaN,7.44933800585864,5.744532786322528
2000-08-23T09:30:00-04:00,29.78125,30.04687,29.71875,29.875,41100,17030,50.29770500015669,54.929573980571014,NaN,NaN,8.458488860068988,41.49137110192028,-0.010263371049406056,0.11604517548883919,0.12630854653824525,-2133500,-2165620,59.88907796280376,46.431503463184264,NaN,NaN,6.517760784198917,5.854993928876298
2000-08-24T09:30:00-04:00,30,30,29.75,29.79687,2100,17035,49.033844060254175,54.18904263599127,NaN,NaN,-4.139684281275462,28.403366829703003,-0.026750966459711062,0.09286983846360641,0.11962080492331748,-2135600,-2157820,61.49977288929549,48.61289153223829,NaN,NaN,5.38756868601326,5.788218894181578
2000-08-25T09:30:00-04:00,30,30.29687,30,30.29687,5300,16910,56.5571141445102,54.22958269220311,NaN,NaN,66.56116137913027,30.971180351714246,-0.00486447011544644,0.11354021727900943,0.11840468739445587,-2130300,-2148960,63.3024245778293,50.635443922440686,NaN,NaN,6.549177463153688,5.896927261177594
2000-08-28T09:30:00-04:00,30.21875,30.21875,29.95312,30,13100,15875,51.679329354042466,53.84580881720098,NaN,NaN,22.72695490774014,21.3878855207075,-0.010916457448212125,0.10475911558419071,0.11567557303240283,-2143400,-2143480,64.41231421295292,52.469324681158795,NaN,NaN,6.081071328829111,5.923233556556382
2000-08-29T09:30:00-04:00,30.14062,30.34375,30.04687,30.14062,23800,16755,53.71559998168509,53.9023642205814,NaN,NaN,55.082287043081564,29.737841581749098,-0.006218019356655807,0.10790304883658308,0.11412106819323889,-2119600,-2132480,66.59622448217876,54.25272060126357,NaN,NaN,6.293984142943241,5.976197926040219
2000-08-30T09:30:00-04:00,30.14062,30.45312,30.14062,30.34375,9500,16755,56.563157159675725,54.10507754105354,NaN,NaN,102.78963391025886,48.60407059178708,0.008975691521081047,0.1253406825945902,0.11636499107350914,-2110100,-2127800,67.50976077044137,55.87101960389147,NaN,NaN,7.317806670952845,6.167856318170594
2000-08-31T09:30:00-04:00,30.25,30.4375,30.125,30.15625,3700,16020,53.30326301766121,53.90263888486974,NaN,NaN,67.34446798052515,62.900901044147204,0.005001605189682776,0.12261699756061262,0.11761539237092984,-2113800,-2123440,68.37742714732829,57.4589891162009,NaN,NaN,7.231879954666637,6.3198596948128865
2000-09-01T09:30:00-04:00,30.03125,30.28125,30.03125,30.125,68400,16575,52.75752065606557,53.368855339186936,NaN,NaN,25.28320976173908,54.64531072066897,-0.0008180466165388922,0.11659283410025623,0.11741088071679512,-2182200,-2133820,63.99569178115215,58.61929474288113,NaN,NaN,7.008126044260184,6.418183459019644
2000-09-05T09:30:00-04:00,30,30,29.26562,29.53125,436100,38205,43.61948778431424,52.37029049501287,NaN,NaN,-202.70377280857988,9.559165177404958,-0.043384958747363145,0.06317968228259119,0.10656464102995433,-2618300,-2228800,39.22577954743232,58.00474170030652,NaN,NaN,3.91717041313264,6.060895881035786
2000-09-06T09:30:00-04:00,29.53125,29.78125,29.40625,29.40625,36400,39825,41.971281222387965,51.73286084986516,NaN,NaN,-185.53449338512567,-38.56419090823649,-0.07673950085313326,0.01064026496353776,0.08737976581667102,-2654700,-2335820,26.6902273887966,56.47490077883494,NaN,NaN,0.8747336540812473,5.320015562899424
2000-09-07T09:30:00-04:00,29.59375,29.59375,29.125,29.17187,37500,41305,38.995883272535885,50.62134946781287,NaN,NaN,-215.58424007599214,-102.23896570548668,-0.10937687891064073,-0.04934133282162989,0.060035546089010836,-2692200,-2452240,19.419750934073477,54.296527877042486,NaN,NaN,-2.6349627496635417,4.183590089676143
2000-09-08T09:30:00-04:00,29.3125,29.46875,29.1875,29.1875,956100,87675,39.30489121217246,49.531910081448906,NaN,NaN,-182.80864398531847,-152.26958809865542,-0.12364950098522864,-0.09452633014252498,0.029123170842703668,-1736100,-2376700,32.305210427341464,52.94386653883298,NaN,NaN,-5.378675254705264,2.817552183335942
2000-09-11T09:30:00-04:00,29.15625,29.5,29.0625,29.29687,536300,113970,41.536505745860914,48.51092039636494,NaN,NaN,-149.27965503256223,-187.18216105751566,-0.11939916532989647,-0.12012578581966693,-0.0007266204897704506,-1199800,-2180220,53.24676851247859,52.989144355370925,NaN,NaN,-7.065400559061674,1.405701791564854
2000-09-12T09:30:00-04:00,29.40625,29.53125,29.125,29.28125,561400,141870,41.30293743111937,47.90275143160299,NaN,NaN,-124.58037146184728,-171.55748078816913,-0.11146624318798609,-0.14005942447475306,-0.028593181286766974,-1761200,-2008800,63.77564881404403,53.58900567486773,NaN,NaN,-8.52343059558961,-0.012745692314355184
2000-09-13T09:30:00-04:00,29.3125,29.59375,29.14062,29.59375,14300,140945,47.645850414461904,47.7133332469105,NaN,NaN,-84.69643987979236,-151.38987008710248,-0.080447098099676,-0.12915205391136197,-0.04870495581168598,-1746900,-1827240,71.17892697234886,54.395423461263825,NaN,NaN,-8.052415242770463,-1.1612699138080846
2000-09-14T09:30:00-04:00,29.67187,29.67187,29.28125,29.28125,43100,142915,42.679100155939054,47.25942296803085,NaN,NaN,-80.08939940092124,-124.2909019520883,-0.07628671524195499,-0.14406334986412972,-0.06777663462217473,-1790000,-1646800,76.35167344409102,55.45627350089209,NaN,NaN,-9.095709762529761,-2.294761320768324
2000-09-15T09:30:00-04:00,29.51562,29.51562,29.15625,29.15625,21900,140990,40.84496860623018,46.13712685815371,NaN,NaN,-94.138660177485,-106.55690519052162,-0.0770392935327201,-0.16407575153807485,-0.08703645800535476,-1811900,-1661960,75.13160338156705,56.30121484401621,NaN,NaN,-10.505070354962985,-3.4676626113675617
2000-09-18T09:30:00-04:00,29.375,29.5,28.96875,29.10937,50300,143400,40.14811325216324,45.31346856516234,NaN,NaN,-97.67672914634954,-96.23632001327908,-0.07567074526305868,-0.1816248895841781,-0.10595414432111942,-1862200,-1794440,65.31001369258115,56.365336235418226,NaN,NaN,-11.865285482734174,-4.667323021562792
2000-09-19T09:30:00-04:00,28.96875,29.03125,28.76562,28.92187,13000,143860,37.399767726019114,44.14805197547191,NaN,NaN,-134.18273345047768,-98.15679241100516,-0.08184602847105515,-0.20826167990993838,-0.12641565143888323,-1875200,-1817240,63.76507512031666,56.163111280999495,NaN,NaN,-13.83196039210483,-5.976556931640226
2000-09-20T09:30:00-04:00,28.67187,28.67187,28.125,28.35937,14700,144405,30.62635624673719,42.29542333883344,NaN,NaN,-193.04215232863902,-119.82593490077447,-0.11617100082800089,-0.27162940247388434,-0.15545840164588345,-1889900,-1845840,61.79052044362063,55.75459411479801,NaN,NaN,-17.895483195728083,-7.679260683652776
2000-09-21T09:30:00-04:00,28.40625,28.625,28.14062,28.625,12100,142955,36.47706388564286,41.0935519722607,NaN,NaN,-158.17223198593786,-135.4425014177778,-0.11322618207593721,-0.29699112924080495,-0.18376494716486774,-1877800,-1863400,60.55072846364957,55.195544208820955,NaN,NaN,-19.469291283179466,-9.363550769299446
2000-09-22T09:30:00-04:00,28.34375,28.375,28,28.375,4800,143090,33.60456579258981,39.72548376772671,NaN,NaN,-166.4749316540489,-149.9097557130906,-0.1197239891797009,-0.33341993363949385,-0.21369594445979295,-1882600,-1877540,59.51519435835911,54.87550867862145,NaN,NaN,-21.716352828330916,-11.128236777732512
2000-09-25T09:30:00-04:00,28.65625,28.9375,28.65625,28.79687,7100,143180,41.91673229793393,39.6038583758424,NaN,NaN,-82.75812155528418,-146.9260341948775,-0.0886495764721506,-0.3245079150499812,-0.23585833857783062,-1875500,-1880200,59.309705767176766,56.310074837174625,NaN,NaN,-20.892326165770434,-12.523106690309358
2000-09-26T09:30:00-04:00,28.96875,28.96875,28.6875,28.79687,5400,142795,41.91673229793393,39.59996202409569,NaN,NaN,-73.75952902018207,-134.8413933088184,-0.062375303861901765,-0.3138274684052078,-0.25145216454330604,-1875500,-1880260,59.30473179328071,58.63968229463778,NaN,NaN,-20.251916687104384,-13.62722240413722
2000-09-27T09:30:00-04:00,28.625,28.6875,28.3125,28.3125,7200,141965,35.927502133377615,39.380791942727235,NaN,NaN,-115.71049578656755,-119.37506200040409,-0.0712562027455132,-0.34052241797519756,-0.26926621522968436,-1882700,-1878820,59.39275095463773,61.494896581820946,NaN,NaN,-21.64856184966073,-14.773128039212006
2000-09-28T09:30:00-04:00,28.5625,29.14062,28.5,29.14062,56300,144305,49.2727251593252,40.09278008180957,NaN,NaN,-35.25273042137246,-94.79116168749101,-0.017783677774406537,-0.2914958124476925,-0.273712134673286,-1826400,-1868540,60.05693735455953,63.47716279090794,NaN,NaN,-17.946586797224565,-15.226479290356657
2000-09-29T09:30:00-04:00,29.03125,29.0625,28.875,29.0625,2600,144250,48.25173683450523,40.57243944528417,NaN,NaN,-15.410322970388963,-64.57823995075901,0.014174060104929553,-0.255994559542124,-0.2701686196470536,-1829000,-1857820,60.777396211203914,64.01506476938832,NaN,NaN,-15.493271879903755,-15.264592517434814
2000-10-02T09:30:00-04:00,29.25,29.4375,29.21875,29.4375,4000,141030,53.25864064636971,41.42641824637348,NaN,NaN,60.88025256124614,-35.85056512745298,0.05985622309750477,-0.1953483407751726,-0.25520456387267737,-1825000,-1847720,61.48231529597957,63.851255232383714,NaN,NaN,-11.697018393486793,-14.754939071156524
2000-10-03T09:30:00-04:00,29.625,29.8125,29.4375,29.54687,15900,120020,54.637198403986226,41.92580024562522,NaN,NaN,106.08784844293899,0.11891036517122303,0.09465754491449724,-0.1368826327295558,-0.23154017764405305,-1809100,-1834440,62.43821098146176,63.22691837589178,NaN,NaN,-8.261407123228114,-13.827291650023895
2000-10-04T09:30:00-04:00,29.625,29.78125,29.40625,29.78125,1700,118285,57.52809395469469,42.98644265982205,NaN,NaN,114.07686579437558,46.076382681359846,0.1285767259451887,-0.07081927021256718,-0.19939599615775588,-1807400,-1819380,63.54315676393828,62.31202432730944,NaN,NaN,-4.488462204228102,-12.493173157767353
2000-10-05T09:30:00-04:00,29.9375,30.46875,29.875,30.04687,19900,117405,60.593089354419945,44.39702271326418,NaN,NaN,177.20595113796006,88.56811899322636,0.16186551015335165,0.002935891533933699,-0.15892961861941796,-1787500,-1811600,64.13019052393706,61.52620912319302,NaN,NaN,-0.3458856533680527,-10.757846371424597
2000-10-06T09:30:00-04:00,30.125,30.125,29.34375,29.34375,3700,69785,50.25459657294083,45.118914379034,NaN,NaN,81.191773946627,107.88853837662955,0.13082247288428195,0.0045984724859344794,-0.12622400039834747,-1791200,-1804040,64.72459612602674,61.48439358272485,NaN,NaN,-0.15341594787436963,-9.24292773948885
2000-10-09T09:30:00-04:00,29.28125,29.28125,29.07812,29.15625,9400,43440,47.90717444485619,45.86944343037951,NaN,NaN,10.814518276870194,97.87539151975434,0.09369231647690039,-0.009108604802221976,-0.10280092127912237,-1800600,-1799160,65.12632609944642,61.58162579551983,NaN,NaN,-0.7893057549909063,-8.035267455989144
2000-10-10T09:30:00-04:00,29.15625,29.57812,29.15625,29.1875,2000,15470,48.34028705137685,47.13472420213949,NaN,NaN,33.55361848049252,83.36854552726507,0.06843986609312068,-0.017251088662721514,-0.0856909547558422,-1798600,-1797060,65.30941332430393,61.83297528699721,NaN,NaN,-1.1511508853160954,-7.0518222316072805
2000-10-11T09:30:00-04:00,28.90625,29.04687,28.4375,28.45312,29100,16210,39.9369256331439,47.38185718410385,NaN,NaN,-69.50196329734683,46.652779708920576,0.0029392006648423508,-0.08201695392478925,-0.0849561545896316,-1827700,-1801120,64.60324843902035,62.12244099952369,NaN,NaN,-4.3846580794655745,-6.670798781301323
2000-10-12T09:30:00-04:00,28.59375,28.59375,27.375,27.5,7900,14450,32.130203539670845,47.27654559460964,NaN,NaN,-175.51463008235356,-23.89133653514215,-0.09832078791569232,-0.207857139484247,-0.10953635156855468,-1835600,-1810740,62.868652950649924,62.36197375611589,NaN,NaN,-10.32777857192703,-7.1932244656764235
2000-10-13T09:30:00-04:00,27.25,28.32812,27.09375,28.01562,5700,13640,39.069216630145675,47.07315161833905,NaN,NaN,-152.83510673766253,-70.69671267200005,-0.12273016302979115,-0.2629490553557936,-0.14021889232600246,-1829900,-1818480,61.43929612489404,62.5140873530957,NaN,NaN,-12.516941833296672,-7.953755518193602
2000-10-16T09:30:00-04:00,27.84375,27.9375,27.65625,27.75,6400,11445,36.9721530247796,46.71996738454231,NaN,NaN,-135.55867494829073,-99.97135131703223,-0.14726866750247175,-0.32430472670409216,-0.1770360592016204,-1836300,-1825620,60.08224994454749,62.56962436390046,NaN,NaN,-14.96682580901191,-8.955622702596218
2000-10-17T09:30:00-04:00,27.65625,27.84375,26.125,26.375,13500,11470,28.456997498054832,46.18635991059068,NaN,NaN,-208.37305542579014,-148.35668609828878,-0.24106414360645823,-0.4783662387096932,-0.23730209510323497,-1849800,-1835860,58.10020945688158,62.47729997120359,NaN,NaN,-20.713059362294405,-10.63525651112453
2000-10-18T09:30:00-04:00,25.375,27,25.1875,26.8125,8700,11170,33.6900666832624,45.07331287658619,NaN,NaN,-207.40063401148024,-175.93642024111546,-0.25713268433633535,-0.5587179505236541,-0.3015852661873188,-1841100,-1838540,57.56497486461126,62.299302650493004,NaN,NaN,-23.072433775471183,-12.411996120316909
2000-10-19T09:30:00-04:00,27.0625,27.1875,26.84375,27.125,8100,10970,37.22231524106281,44.28549704848315,NaN,NaN,-122.2839701657616,-165.29028825779704,-0.23103229891464266,-0.5903756398306221,-0.35934334091597947,-1833000,-1838020,57.646503276141814,62.07566744084571,NaN,NaN,-23.584182089020516,-14.008022687274567
2000-10-20T09:30:00-04:00,27.39062,28.28125,27.39062,27.6875,11400,11300,43.09798648657427,43.55973603706919,NaN,NaN,-59.045245978156004,-146.53231610589575,-0.1633884875649766,-0.5635789503722002,-0.4001904628072236,-1821600,-1836360,57.924413245176176,61.821531580074044,NaN,NaN,-21.864806545365354,-15.130420381287536
2000-10-23T09:30:00-04:00,27.9375,28.1875,27.84375,28.09375,4000,11145,46.95915004560161,43.011304011470294,NaN,NaN,-35.466462287275355,-126.51387357369268,-0.08285117659886537,-0.5037544335558053,-0.4209032569569399,-1817600,-1832620,58.58378966066932,61.546215771446,NaN,NaN,-19.13427181408818,-15.702399157401913
2000-10-24T09:30:00-04:00,28.3125,28.8125,28.0625,28.15625,103300,16040,47.54883094878377,42.298499511048085,NaN,NaN,-10.549606317508431,-86.94918375203632,-0.020202856130984714,-0.44615682712067084,-0.4259539709896861,-1714300,-1805520,63.096645361049084,61.51432209981107,NaN,NaN,-16.843057999759083,-15.865350420595794
2000-10-25T09:30:00-04:00,28.25,28.26562,27.65625,27.65625,5800,15970,43.392623930160084,41.06989483788667,NaN,NaN,-44.34042567010381,-54.33714208376104,-0.007902526322123016,-0.4358321288923399,-0.4279296025702169,-1720100,-1781320,66.59689257196234,61.690515103241445,NaN,NaN,-16.26482217697482,-15.922417814364227
2000-10-26T09:30:00-04:00,28.0625,28.1875,27.64062,28.04687,4800,13395,47.27038530379538,40.85673689009057,NaN,NaN,-33.44525775146819,-36.569399600902344,0.02905115393571711,-0.3916156601505705,-0.4206668140862876,-1715300,-1757780,69.61584209551431,62.03988981534769,NaN,NaN,-14.532940731195618,-15.723921088197283
2000-10-27T09:30:00-04:00,27.9375,28.29687,27.9375,28.29687,3000,13415,49.64775703042252,40.981064217631015,NaN,NaN,-14.313609391965839,-27.62307228366431,0.0704796503157259,-0.3325672511916302,-0.4030469015073561,-1712300,-1735920,72.13447351528549,62.54047177362192,NaN,NaN,-12.376053231749154,-15.245654251561836
2000-10-30T09:30:00-05:00,28.5625,28.84375,28.25,28.84375,3700,13400,54.48234121712921,41.419782372327624,NaN,NaN,26.123062647672057,-15.305167296674844,0.13132667516648588,-0.23888855754924876,-0.37021523271573464,-1708600,-1714120,74.41239171950204,63.19068451613607,NaN,NaN,-8.97202178007844,-14.349421041349922
2000-10-31T09:30:00-05:00,29.03125,29.5,28.6875,29.5,22700,13740,59.50674931437553,42.817626920987024,NaN,NaN,77.12336307781918,2.2294265823906843,0.20783557371006084,-0.11042076557815861,-0.31825633928821945,-1685900,-1708440,74.98614867326805,63.93232024715376,NaN,NaN,-4.362695654199785,-12.92274598604276
2000-11-01T09:30:00-05:00,29.54687,29.70312,29.34375,29.70312,5900,13950,60.943771103123446,44.87573888980506,NaN,NaN,107.59026450427938,32.61556461726732,0.2607589110577612,0.007692299533982094,-0.25306661152377913,-1680000,-1700420,75.81091041570623,64.85676720894351,NaN,NaN,-0.20106310531847207,-11.10536271736786
2000-11-02T09:30:00-05:00,29.625,29.96875,29.625,29.96875,16200,13765,62.80285682395187,46.57099890364837,NaN,NaN,134.0832907927207,66.1212743261051,0.29951986664154434,0.12133322177815131,-0.17818664486339303,-1663800,-1690120,76.86589981327478,65.95866747239927,NaN,NaN,3.8037514625693625,-8.975489263091115
2000-11-03T09:30:00-05:00,30,30.07812,29.84375,29.85937,5400,13850,61.504595396980825,48.32331621594846,NaN,NaN,135.84677103496117,96.15335041149049,0.30275727389450674,0.2002599475047404,-0.10249732638976633,-1669200,-1681500,77.74086656341261,67.21999723088963,NaN,NaN,6.681993471320702,-6.738706015317998
2000-11-06T09:30:00-05:00,29.8125,30.1875,29.8125,30.0625,9100,13835,63.0329305771093,50.7930257215952,NaN,NaN,132.30762720210387,117.39026332237685,0.30281311207239975,0.27601906370073337,-0.02679404837166638,-1660100,-1671800,78.71638070887194,68.69258089174609,NaN,NaN,9.533849081467876,-4.414055287205731
2000-11-07T09:30:00-05:00,29.96875,30.1875,29.84375,30.1875,29100,15190,63.98062116700622,52.95663675614833,NaN,NaN,126.50423827505065,127.26643836182316,0.2951956308524387,0.342200490193882,0.0470048593414433,-1631000,-1660820,79.79578133975905,70.28049563997094,NaN,NaN,12.176990616433384,-2.0439058724001433
2000-11-08T09:30:00-05:00,30.25,30.375,29.9375,29.9375,14800,14475,60.63271527526783,54.628808187162974,NaN,NaN,111.1111642924924,127.97061831946576,0.2585635481573706,0.37020929453815654,0.11164574638078596,-1645800,-1653980,80.46057580049835,71.91007224885354,NaN,NaN,13.52960774599624,0.18088178737076843
2000-11-09T09:30:00-05:00,29.15625,29.15625,28.15625,28.5625,14700,14815,46.28677332231827,54.8565786754304,NaN,NaN,8.829849045746084,102.91992997007085,0.1332817992473152,0.27824799543992995,0.14496619619261475,-1660500,-1653320,80.52715632723597,73.5245538975721,NaN,NaN,10.150662485169121,1.605136172770533
2000-11-10T09:30:00-05:00,28.375,28.67187,28.375,28.45312,11200,15090,45.36720504584347,54.742868318304815,NaN,NaN,-2.3659649674489214,75.27738276958883,0.039468768779569174,0.19430215716707622,0.15483338838750704,-1671700,-1653820,80.30391072475712,75.07599111643552,NaN,NaN,7.183752473048834,2.402081358524576
2000-11-13T09:30:00-05:00,27.875,28,27.53125,27.84375,21200,15830,40.53559913481084,54.24192318873531,NaN,NaN,-53.501567495845634,38.115543829998934,-0.06170059558307486,0.07770764390866347,0.13940823949173833,-1692900,-1660380,77.2769348747476,76.08886893884255,NaN,NaN,3.027570003980532,2.4914368793039983
2000-11-14T09:30:00-05:00,28.1875,28.5625,28.15625,28.51562,8600,15585,47.211060412708726,54.51466865177451,NaN,NaN,-15.936701396021142,9.627355895784568,-0.08027093053301144,0.03906957632547403,0.11934050685848548,-1684300,-1671040,72.49484809009309,76.51015147585188,NaN,NaN,1.6249208931258154,2.3676488812785434
2000-11-15T09:30:00-05:00,28.625,28.75,28.35937,28.65625,4000,15350,48.51390202948161,54.60349127503781,NaN,NaN,-12.075205564302452,-15.009918075574404,-0.07981584845074702,0.019570696295051704,0.09938654474579872,-1680300,-1677940,69.49699622443957,76.50166248506083,NaN,NaN,0.9187496251844816,2.160663273265106
2000-11-16T09:30:00-05:00,28.65625,28.67187,28.3125,28.3125,3700,15130,45.554337374634386,54.31110415676723,NaN,NaN,-33.75927401669014,-23.527742688061647,-0.09818994324731212,-0.023350884313341425,0.07483905893397069,-1684000,-1682640,67.45090836639284,76.1671221172828,NaN,NaN,-0.5915061080740691,1.7674962187880812
2000-11-17T09:30:00-05:00,28.25,28.64062,27.96875,28.125,11500,15135,43.97838128045702,53.56082130414779,NaN,NaN,-54.47165836980105,-33.94888136853207,-0.11720729620481282,-0.07167006132204534,0.04553723488276748,-1695500,-1687400,65.35238661748755,75.51997889571032,NaN,NaN,-2.304056057967666,1.1858458935372602
2000-11-20T09:30:00-05:00,27.96875,28.09375,27.71875,27.96875,3500,15110,42.654104849738495,52.35706098524514,NaN,NaN,-83.56326639034954,-39.96122114743285,-0.13336946871793784,-0.12117460101465483,0.01219486770328302,-1699000,-1688620,64.79595585257988,74.79210797994689,NaN,NaN,-4.104501744951066,0.4300819451817851
2000-11-21T09:30:00-05:00,27.0625,27.3125,27,27.3125,8200,10355,37.54105676621257,50.68543853260866,NaN,NaN,-138.18487892327263,-64.41085665288315,-0.1784996775644547,-0.21092972925228537,-0.03243005168783066,-1707200,-1693200,62.639750923187755,73.85131087333842,NaN,NaN,-7.30270607210781,-0.6746020572881569
2000-11-22T09:30:00-05:00,27.125,27.14062,26.9375,27.04687,3500,10240,35.6768338602469,48.747865463772584,NaN,NaN,-143.8962844299662,-90.7750724260159,-0.21408539754635425,-0.3000367986207735,-0.08595140107441923,-1710700,-1699280,59.79509040448036,72.63196734413881,NaN,NaN,-10.535667999799173,-2.083325763361159
2000-11-24T09:30:00-05:00,26.71875,27.1875,26.71875,27.17187,9400,10470,37.25583436490462,47.01581110433857,NaN,NaN,-135.53243293948773,-111.12970421057541,-0.2164063166281994,-0.3564592968596685,-0.1400529802314691,-1701300,-1702740,58.17596233459606,71.23447418493764,NaN,NaN,-12.739776915427633,-3.605675927942084
2000-11-27T09:30:00-05:00,27.59375,27.59375,27.3125,27.34375,5000,10570,39.45663853814297,45.331790244412396,NaN,NaN,-96.82429897434623,-119.60023233148445,-0.19427083068889964,-0.3828915185925936,-0.188620687903694,-1696300,-1702900,58.09761890566055,69.76170548470824,NaN,NaN,-13.970974730757177,-5.086432899772811
2000-11-28T09:30:00-05:00,27.375,27.59375,27,27,19800,11375,36.685225293350236,43.38211911057983,NaN,NaN,-101.36612682612066,-123.16080441863869,-0.1904304421059573,-0.4266587405361406,-0.2362282984301833,-1716100,-1706320,56.35079216241753,68.08706340061242,NaN,NaN,-15.834709973104221,-6.621901053105869
2000-11-29T09:30:00-05:00,27.0625,27.21875,26.84375,27.0625,120200,16250,37.54419141276747,41.73293883468695,NaN,NaN,-101.95052305594736,-115.91393324517362,-0.17189843020289647,-0.4511013361838039,-0.2792029059809074,-1595900,-1684060,63.94873098903471,66.90764591407931,NaN,NaN,-17.142908467027546,-8.124902112237537
2000-11-30T09:30:00-05:00,26.75,27,26.375,26.8125,6100,16260,35.471226963727645,40.96039980907334,NaN,NaN,-111.36840517792392,-109.40835739476518,-0.16468070076259556,-0.48505378193415183,-0.3203730811715563,-1602000,-1662320,69.52758898291427,66.12196253234205,NaN,NaN,-18.847320247280255,-9.656676131529354
2000-12-01T09:30:00-05:00,26.875,27.34375,26.875,27,7400,15820,38.22609075668546,40.45032021699062,NaN,NaN,-79.12312313397084,-98.12649543366179,-0.13663734113112325,-0.49116975758546033,-0.3545324164543371,-1594600,-1640980,73.81162285270415,65.65822768433827,NaN,NaN,-19.561601579281024,-11.071665481208164
2000-12-04T09:30:00-05:00,26.9375,27.125,26.90625,27.01562,25500,16825,38.46178882994695,40.30219090950034,NaN,NaN,-76.46520502974526,-94.05467664474159,-0.1076685151243108,-0.4891180603597256,-0.3814495452354148,-1569100,-1615540,77.81567459032412,65.69670909259374,NaN,NaN,-20.095555045192558,-12.360792561777362
2000-12-05T09:30:00-05:00,27.09375,27.84375,27.09375,27.71875,14600,17100,48.06749877687773,40.363365078369554,NaN,NaN,-29.667183999452003,-79.71488807940784,-0.03551753807434266,-0.4258464678283431,-0.39032892975400046,-1554500,-1583220,81.653485629166,66.35089748824181,NaN,NaN,-17.81680916199339,-13.140223504665366
2000-12-06T09:30:00-05:00,28.125,28.21875,27.90625,28.01562,10700,16180,51.50909752832164,40.577307614000986,NaN,NaN,24.870323404619253,-54.350718787294525,0.034071288782560494,-0.34773981877579985,-0.38181110755836034,-1543800,-1572800,82.69302191796918,67.29347075206535,NaN,NaN,-14.838191469956966,-13.382790356849881
2000-12-07T09:30:00-05:00,27.8125,27.8125,27.5,27.54687,5000,15690,46.292457347130515,40.63003046917928,NaN,NaN,-6.63201205961298,-33.40344016363234,0.04946851311050082,-0.3199754661702343,-0.36944397928073514,-1548800,-1562160,83.70813733133225,68.45470139241816,NaN,NaN,-13.751208331536766,-13.435421496090864
2000-12-08T09:30:00-05:00,28.125,28.375,27.9375,28.14062,45300,17220,52.81158330723259,41.260973471091816,NaN,NaN,63.686212623981994,-4.841573012041771,0.09778586195554906,-0.24721165183629878,-0.34499751379184784,-1503500,-1543940,85.29833835870171,69.87941223107632,NaN,NaN,-10.699695604615926,-13.044603511594444
2000-12-11T09:30:00-05:00,28.09375,28.5,27.90625,28.4375,6600,16990,55.70662526995179,42.19329635824992,NaN,NaN,83.57524855155394,27.16651770421807,0.1450356081950434,-0.16370300354804357,-0.308738611743087,-1496900,-1529500,86.42891345103256,71.42462348810865,NaN,NaN,-7.241045641348739,-12.215523815845057
2000-12-12T09:30:00-05:00,28.125,28.5625,28.125,28.5,7600,16310,56.31426044833249,43.53423947840133,NaN,NaN,88.80193774390463,50.86034205288939,0.1738511424955495,-0.09142468362365008,-0.2652758261191996,-1489300,-1516460,87.37323554456131,73.1913009610639,NaN,NaN,-4.275437348705345,-11.081225749110812
2000-12-13T09:30:00-05:00,28.65625,28.8125,28.53125,28.65625,7200,16240,57.87028813171897,45.11948621207791,NaN,NaN,117.35482133703653,69.35724163937284,0.1951885760219731,-0.021290106091733207,-0.2164786821137063,-1482100,-1504120,88.209349636675,75.22089090622066,NaN,NaN,-1.3492393749337674,-9.690941981371235
2000-12-14T09:30:00-05:00,28.40625,28.59375,28.1875,28.40625,9300,16505,54.52395158493941,46.35292315636611,NaN,NaN,87.8652050288854,88.25668505707253,0.18434953716092645,0.013958239337451772,-0.17039129782347467,-1491400,-1492640,88.9428939440514,77.41852887832462,NaN,NaN,0.19752655762405413,-8.278303618657622
2000-12-15T09:30:00-05:00,27.71875,28.01562,27.46875,27.6875,10300,16835,46.24458049762491,46.83777615347196,NaN,NaN,11.281983556920014,77.77583924366013,0.12357640929723454,-0.01592078620193149,-0.13949719549916603,-1501700,-1492280,88.96607663520032,79.62341871614888,NaN,NaN,-0.9620745024834279,-7.233128030632737
2000-12-18T09:30:00-05:00,27.92187,28,27.3125,27.53125,12800,16900,44.65703295002474,47.40719098609157,NaN,NaN,1.1671247264792108,61.29421447864517,0.070307169879901,-0.05161323314928978,-0.12192040302919079,-1514500,-1495800,87.04436646328992,81.81581688049691,NaN,NaN,-2.394857321951548,-6.541946500821139
2000-12-19T09:30:00-05:00,27.6875,28.09375,27.5625,27.5625,29600,18205,45.06323643679381,47.94426563066487,NaN,NaN,20.387000000002047,47.611226929864664,0.03633925162374757,-0.07649633849950632,-0.11283559012325389,-1484900,-1494920,87.11927450902894,83.47085570335365,NaN,NaN,-3.4380377559631365,-6.098530965841424
2000-12-20T09:30:00-05:00,26.625,26.90625,26.15625,26.3125,94400,22515,34.23805909162982,47.856182211229324,NaN,NaN,-145.59219834710552,-4.9781770069637705,-0.06559952432450583,-0.19483499552888617,-0.12923547120438034,-1579300,-1514360,76.5848471306778,83.97494557105104,NaN,NaN,-8.244840215830774,-6.405146572982759
2000-12-21T09:30:00-05:00,26.21875,26.53125,25.96875,26.5,25800,23630,36.69462907377028,47.7467920910211,NaN,NaN,-146.3414334362198,-51.819504699984805,-0.11290991165553349,-0.2703728607737972,-0.1574629491182637,-1553500,-1526780,70.70261475213213,83.75287356386731,NaN,NaN,-11.262454900246524,-7.099047762591868
2000-12-22T09:30:00-05:00,26.71875,27.03125,26.625,26.95312,10200,23670,42.303796437208014,48.021221205825455,NaN,NaN,-78.20540711284265,-69.71698283393734,-0.1062916022572026,-0.29032745193976695,-0.18403584968256434,-1543300,-1535100,66.99068166872269,82.97965978375294,NaN,NaN,-11.966529544327706,-7.7944023028398455
2000-12-26T09:30:00-05:00,27.15625,27.28125,26.71875,27,16500,24245,42.86782057049373,47.649815619655165,NaN,NaN,-57.53693519218745,-81.45779481767066,-0.09190180092344183,-0.2989131008368666,-0.2070112999134248,-1526800,-1537560,65.88920476971288,81.85363972236344,NaN,NaN,-12.346959412421327,-8.444767604208629
2000-12-27T09:30:00-05:00,26.75,27.09375,26.75,27.09375,14400,23975,44.045836634576624,47.11672555581624,NaN,NaN,-57.48143603778394,-97.03148202522786,-0.07019471947004699,-0.2947546992509835,-0.22455997978093653,-1512400,-1543060,63.38005895228698,80.47414236767183,NaN,NaN,-12.308098864517643,-8.99667206996706
2000-12-28T09:30:00-05:00,26.875,27.5625,26.875,27.5625,10400,18485,49.63740001057466,47.355650031776534,NaN,NaN,-19.374831237397903,-71.78800860328633,-0.02094761777974699,-0.25074450200562026,-0.22979688422587327,-1502000,-1527600,67.16516425620091,79.29250143373392,NaN,NaN,-10.565180765102497,-9.220744740700693
2000-12-29T09:30:00-05:00,27.40625,27.65625,27.25,27.25,34100,19885,46.31454300374512,46.89157572438457,NaN,NaN,-18.278147553553012,-46.17535142675298,-0.00683038539075656,-0.23833486596431896,-0.2315044805735624,-1536100,-1524120,67.96776941226318,78.05460365184545,NaN,NaN,-10.091610511607785,-9.345154136544563
2001-01-02T09:30:00-05:00,27,27.28125,26.14062,26.14062,9400,19985,36.876753246138044,45.54658486554074,NaN,NaN,-116.19921817438953,-53.77411363906235,-0.06631137526368322,-0.31439369965316644,-0.24808232438948322,-1545500,-1524560,67.74230128413588,76.71984563992426,NaN,NaN,-12.900753748290164,-9.853096938222507
2001-01-03T09:30:00-05:00,26.53125,28.625,26.53125,28.20312,177400,27580,55.16788121375447,45.464700634499444,NaN,NaN,29.753837406300764,-36.315959119364706,0.03376889530855237,-0.20587120525379277,-0.23964010056234514,-1368100,-1492820,74.3519142337234,75.78975126057868,NaN,NaN,-8.013516298344669,-9.590299703954244
2001-01-04T09:30:00-05:00,28.4375,29.125,28.3125,29.03125,44300,29065,60.15974282018369,45.628233112246924,NaN,NaN,135.8693311484076,2.354194317873586,0.1497611237245461,-0.0524386959066625,-0.20219981963120862,-1323800,-1455100,79.68043340505443,75.18054295832007,NaN,NaN,-2.1487488497546865,-8.527221010497165
2001-01-05T09:30:00-05:00,28.40625,28.53125,28.125,28.25,43300,30695,54.045925898532,45.59408842036068,NaN,NaN,74.94399485476643,21.217959536306445,0.16659794708012127,0.006047614218942954,-0.1605503328611783,-1367100,-1428120,82.48361371560365,74.71916579914524,NaN,NaN,-0.054008364742390964,-7.316762061103626
2001-01-08T09:30:00-05:00,28.1875,28.1875,27.39062,27.84375,9500,30920,51.13575078593411,45.943457726668484,NaN,NaN,19.359903844620693,28.745569815941188,0.143955382912339,0.01939389577924544,-0.12456148713309356,-1376600,-1396220,85.10079143444932,74.4430739990916,NaN,NaN,0.4226065096540478,-6.211137979566815
2001-01-09T09:30:00-05:00,28,28.25,27.89062,28.1875,12600,29285,53.42123460155285,46.56947213034906,NaN,NaN,52.43434147425598,62.472281745670294,0.14529000854289845,0.05705102354552949,-0.08823898499736896,-1364000,-1359920,87.40664072758804,74.46895073225575,NaN,NaN,1.6050886564543867,-5.094534174420929
2001-01-10T09:30:00-05:00,28.09375,28.59375,28.09375,28.40625,8300,29370,54.867881944184134,47.26980395230551,NaN,NaN,79.19992004292685,72.36149827299552,0.15327475564695975,0.10335445956133071,-0.04992029608562902,-1355700,-1357440,87.5484229626979,74.4996041932321,NaN,NaN,3.009466836575519,-3.936819744278579
2001-01-11T09:30:00-05:00,29.125,29.34375,28.84375,29.04687,36500,30815,58.894257769097436,49.030961000696045,NaN,NaN,145.2812214768984,74.24387633869367,0.19158251008132787,0.18955784151603083,-0.0020246685652970456,-1319200,-1356520,87.60417701277466,75.28669918481044,NaN,NaN,5.536806010389658,-2.5834446364688306
2001-01-12T09:30:00-05:00,29.29687,29.53125,29.0625,29.4375,39900,32450,61.169122527297965,50.77913910451945,NaN,NaN,161.51554286702898,91.55818594114618,0.2304975491966382,0.2860972679305007,0.05559971873386251,-1279300,-1338960,88.64892252972238,76.56857831178117,NaN,NaN,8.329124707941507,-1.0245061586959254
2001-01-16T09:30:00-05:00,29.3125,29.75,29.125,29.75,50600,34515,62.93626428772474,52.2528868081278,NaN,NaN,161.88662704824299,120.06353058187065,0.2622418073168689,0.3834019778799487,0.12116017056307976,-1228700,-1309380,90.15428400041064,78.22312133547317,NaN,NaN,11.156268777642135,0.7156045464952261
2001-01-17T09:30:00-05:00,30.09375,30.25,29.75,29.96875,47900,36395,64.16561792051428,53.77415804741497,NaN,NaN,164.38551714953374,142.45376571692617,0.28124686425709344,0.4727187508844466,0.19147188662735315,-1180800,-1272740,91.63424661559192,80.0620528958931,NaN,NaN,13.829374958149884,2.5890003195887488
2001-01-18T09:30:00-05:00,29.75,29.90625,29.625,29.875,10100,36260,63.19814269708574,55.14217990902277,NaN,NaN,127.3261303864434,152.0790077856295,0.27068692177080156,0.5298305388408551,0.2591436170700535,-1190900,-1239780,92.69761680470965,82.15616417106615,NaN,NaN,15.719224379255401,4.464746613826842
2001-01-19T09:30:00-05:00,29.6875,29.6875,29.14062,29.14062,19200,35740,56.066709954043276,55.60141633355625,NaN,NaN,83.50931819464316,139.72462712917846,0.20064931982723672,0.5099552668540994,0.3093059470268627,-1210100,-1217960,93.3043841224222,84.02325130436768,NaN,NaN,15.252070837916861,6.005792931553987
2001-01-22T09:30:00-05:00,28.78125,29.125,28.78125,28.9375,11000,31570,54.24349989122709,56.16777039694782,NaN,NaN,52.66366051827979,117.95425065942861,0.13045021172783156,0.4723687116866522,0.3419184999588206,-1221100,-1206320,93.60943999898335,85.85479920341912,NaN,NaN,14.329548723775265,7.194900901871312
2001-01-23T09:30:00-05:00,29.125,29.60937,29,29.60937,13000,30930,58.99357807754467,57.747543599191154,NaN,NaN,77.04976759743514,100.98687876926704,0.1193723231878594,0.49113390394364487,0.37176158075578547,-1208100,-1202200,93.71852855027738,87.7102440081435,NaN,NaN,14.945856093784723,8.3021802150018
2001-01-24T09:30:00-05:00,29.39062,29.6875,29.1875,29.32812,24700,31655,56.35614642604136,57.83241968578307,NaN,NaN,69.28024315451519,81.96582397026333,0.0848332255130192,0.47780311264705944,0.39296988713404024,-1232800,-1212600,89.56241998231575,88.79670870447153,NaN,NaN,14.67287575840312,9.212279578344845
2001-01-25T09:30:00-05:00,29.25,29.40625,29.01562,29.28125,7700,31215,55.90757230387752,57.528693220332634,NaN,NaN,51.33182813363823,66.7669635197023,0.05216392500950606,0.4581747933959228,0.40601086838641676,-1240500,-1222520,85.66027068753303,89.22383993893428,NaN,NaN,14.32378940366634,9.942495267676486
2001-01-26T09:30:00-05:00,29.03125,29.03125,28.53125,28.98437,221300,41560,53.02837191815459,57.45601079316282,NaN,NaN,15.653725689601389,53.19584501869396,0.006305209597013917,0.41389238038268417,0.40758717078567025,-1461800,-1272860,69.18672583382232,88.27406223309276,NaN,NaN,13.213245721806743,10.409745332552237
2001-01-29T09:30:00-05:00,29.11,29.49001,28.91,29.46001,34900,42785,56.8614601098666,57.86499003058657,NaN,NaN,49.112704588697646,52.485653832777516,0.00386966488519902,0.412424251892169,0.40855458700697,-1426900,-1314020,59.16743070571397,86.42167932389738,NaN,NaN,13.326961254865315,10.826490464311249
2001-01-30T09:30:00-05:00,29.39999,29.67999,29.03999,29.39999,229800,52570,56.23780588253694,58.06617369351401,NaN,NaN,53.388682676880585,47.75343684866661,-0.005414791949299225,0.40178609707034596,0.4072008890196452,-1656700,-1403740,44.15650012702261,83.33238356671414,NaN,NaN,13.249030358806843,11.172567592096334
2001-01-31T09:30:00-05:00,29.3,29.52,29.22,29.22,20200,53110,54.31394236407877,58.026606580649336,NaN,NaN,41.68609286146199,42.23460679005597,-0.026149171369772406,0.3745144248074297,0.4006635961772021,-1676900,-1492560,34.755830956608605,79.56148413770777,NaN,NaN,12.661880769476042,11.385326617436291
2001-02-01T09:30:00-05:00,29.5,29.64,29.3,29.61,22400,45360,57.69129592467203,57.940680734618944,NaN,NaN,63.822579530376146,44.73275706940356,-0.016538180563692995,0.37999087047258584,0.39652905103627883,-1654500,-1575360,28.63552043141091,75.34943723903892,NaN,NaN,13.068365989560071,11.625760813453974
2001-02-02T09:30:00-05:00,29.64999,29.64999,29.06,29.25999,123200,49305,53.84420589880993,57.417472404012656,NaN,NaN,31.74766510843987,47.95154495317125,-0.03559913914946866,0.35203012709944304,0.3876292662489117,-1777700,-1638540,25.015660809338087,70.80420425901147,NaN,NaN,12.349617630335368,11.729168930151316
2001-02-05T09:30:00-05:00,29.23,29.46001,29.17999,29.24001,15100,47895,53.62437738078688,56.75233762494567,NaN,NaN,22.1998404939917,42.568972134230066,-0.050489031971455045,0.3245179762845929,0.37500700825604794,-1792800,-1711720,21.60839086469737,65.90806903503196,NaN,NaN,11.695922993421492,11.724419510618484
2001-02-06T09:30:00-05:00,29.48,29.57001,29.27,29.27,21100,48475,53.92842651148168,56.021109667157624,NaN,NaN,29.24920236430576,37.7410760717151,-0.058679985415846736,0.3016570264862395,0.3603370119020862,-1771700,-1734720,20.65611386295207,60.8382024098434,NaN,NaN,11.224197207036436,11.652959181535333
2001-02-07T09:30:00-05:00,29.48,29.85001,29.46001,29.55,19100,48800,56.7776630578681,55.56250397864208,NaN,NaN,91.9541565218269,47.794688803788084,-0.04615399243636231,0.30264452135663333,0.34879851379299565,-1752600,-1749860,20.03034769484833,55.64768318771045,NaN,NaN,11.545970740849345,11.637675118580193
2001-02-08T09:30:00-05:00,29.75,29.85001,29.53,29.73,510300,73900,58.55224332549237,55.74004207660273,NaN,NaN,111.79980088938733,57.39013307559033,-0.027576224139559347,0.31432823361854645,0.3419044577581058,-1242300,-1667420,32.09375444349487,51.275495353501356,NaN,NaN,12.287791947638347,11.730548951302787
2001-02-09T09:30:00-05:00,29.46001,29.46001,29.08,29.25,10600,72605,52.37665193875196,55.60669579428308,NaN,NaN,-48.45891690368811,41.34881667316473,-0.04823600395540467,0.28160945281384997,0.32984545676925464,-1252900,-1562460,43.73176126357899,47.71280401525819,NaN,NaN,11.272055818590445,11.66504993234388
2001-02-12T09:30:00-05:00,29.2,29.64,29.2,29.49001,14600,71340,54.93604563095402,55.31687204809803,NaN,NaN,15.722721659022335,40.053392906170856,-0.04634680323850271,0.2719119527211262,0.31825875595962894,-1238300,-1451560,52.914079854343605,44.79820053697721,NaN,NaN,11.093584191525922,11.583411969369886
2001-02-13T09:30:00-05:00,29.60001,29.85001,29.52,29.52,17600,69690,55.259601166533116,55.238547386704575,NaN,NaN,80.16333353151117,50.23621913961194,-0.04372072540877214,0.26360784919866376,0.3073285746074359,-1220700,-1341360,59.91432114804132,42.68047919167189,NaN,NaN,11.030255930127847,11.504389678049595
2001-02-14T09:30:00-05:00,29.5,29.5,28.89,29.2,5600,67575,51.04791734696631,54.89142917549663,NaN,NaN,-69.59195950568429,17.926995934109698,-0.06300634640216779,0.22857064160472618,0.29157698800689397,-1226300,-1236100,65.23142660739089,41.221276043090306,NaN,NaN,9.826741878454175,11.26472570667882
2001-02-15T09:30:00-05:00,29.42,29.46001,29.25,29.32001,17100,67925,52.509772702734935,54.85438637439523,NaN,NaN,0.5294399161135604,-4.327076260545058,-0.06679079713256242,0.20808849159119092,0.27487928872375333,-1209200,-1229480,65.54100309576248,40.96086727608604,NaN,NaN,9.18808882995666,10.968063295718512
2001-02-16T09:30:00-05:00,29.42,29.42,29.13,29.19,8500,67390,50.74192765049045,54.41727691301122,NaN,NaN,-42.98878172281389,-3.233049224370224,-0.07646449005952477,0.17929867614934736,0.25576316620887213,-1217700,-1222440,65.888841016952,41.440968012603044,NaN,NaN,8.171312515913039,10.568527470032016
2001-02-20T09:30:00-05:00,29.42,29.47,29.10001,29.16,13700,67525,50.32092786048058,53.99464276857862,NaN,NaN,-56.9895235529924,-17.77549826677317,-0.08276565233503824,0.15230610079007434,0.23507175312511258,-1231400,-1221060,65.96137431475071,42.9984590260122,NaN,NaN,7.203329773241123,10.08778494191903
2001-02-21T09:30:00-05:00,29.3,29.38,29,29.00999,12700,67510,48.168817481710455,53.55570527698088,NaN,NaN,-103.6649479912722,-54.54115457132984,-0.09409277856765397,0.11745577991554512,0.2115485584831991,-1244100,-1225740,65.45307159893454,45.19111907189262,NaN,NaN,5.801336705608418,9.475435193874658
2001-02-22T09:30:00-05:00,28.98,29.00999,28.46001,28.46001,36900,68120,41.210076229124205,52.37847529872747,NaN,NaN,-269.46373537741266,-94.51550974567552,-0.1332869894869626,0.044939821624495835,0.17822681111145844,-1281000,-1236680,64.20748325943947,47.73197355960895,NaN,NaN,2.482528690215315,8.476448550494752
2001-02-23T09:30:00-05:00,28.39999,28.39999,27.78999,28.38,62400,70855,40.29800181513592,51.41088929275075,NaN,NaN,-314.41927459248313,-157.50525264739485,-0.15759694843637603,-0.01876937443401161,0.13882757400236442,-1343400,-1263520,61.1336877676146,50.311832628057275,NaN,NaN,-0.5571304195718164,7.18593726905667
2001-02-26T09:30:00-05:00,28.5,28.75,28.34,28.53,8000,60190,42.85165651992978,50.641409231260965,NaN,NaN,-187.3320432055493,-186.37390494394194,-0.15626548220973688,-0.05650427875980668,0.0997612034499302,-1335400,-1287060,58.48901315450382,52.94616279161488,NaN,NaN,-2.488369480356669,5.803893447711907
2001-02-27T09:30:00-05:00,28.7,29.13,28.5,29.03999,9200,58905,50.58992670544885,50.402944959401474,NaN,NaN,-80.17873542390025,-191.01174731812353,-0.11560238365851239,-0.044741776123210286,0.0708606075353021,-1326200,-1306020,56.37365268079829,55.49741556431819,NaN,NaN,-2.0242256655867013,4.685590717240677
2001-02-28T09:30:00-05:00,29,29,28.64,28.66,8000,47815,45.63195021047933,49.60682261315942,NaN,NaN,-94.49325451209718,-189.1774086222885,-0.10895156999334601,-0.06532885495638041,0.0436227150369656,-1334200,-1324040,54.36131355827077,57.9496274117055,NaN,NaN,-3.1127490239604865,3.571542182783368
2001-03-01T09:30:00-05:00,28.53,28.66,28.48,28.56,16900,47650,44.39877740120062,48.5958607614243,NaN,NaN,-117.20237602118797,-158.72513675104358,-0.10585101385062068,-0.08869105227631024,0.017159961574310427,-1351100,-1338060,52.78263407456366,59.427404528210424,NaN,NaN,-4.3702002437191165,2.4370075504258706
2001-03-02T09:30:00-05:00,28.35001,28.77,28.25999,28.61,5600,46810,45.19625742950804,48.08297543933545,NaN,NaN,-103.75983719403823,-116.59324927135461,-0.09532432117479964,-0.10199543989418913,-0.006671118719389489,-1345500,-1338480,52.73322868302478,60.07036648674226,NaN,NaN,-5.182312495671225,1.3485332581262854
2001-03-05T09:30:00-05:00,28.75,28.75,28.45,28.45,4600,40880,43.067529791222185,47.23522430792603,NaN,NaN,-89.80442916899744,-97.08772646404421,-0.09387934260443223,-0.12402029697492978,-0.030140954370497547,-1350100,-1341420,52.36374377965296,60.03105676712149,NaN,NaN,-6.471422621869107,0.23139670384122946
2001-03-06T09:30:00-05:00,28.53999,28.74001,28.49001,28.55,5200,40385,44.816926134005875,46.4893189484598,NaN,NaN,-73.06708297598304,-95.66539597446076,-0.08139579205346836,-0.131885694437333,-0.05048990238386464,-1344900,-1345160,51.86588850453947,59.45616872115708,NaN,NaN,-7.086317674274179,-0.8139910644609716
2001-03-07T09:30:00-05:00,28.8,28.8,28.53999,28.67999,5000,39580,47.092746758684534,46.20680676358253,NaN,NaN,-53.549227152317876,-87.47659050250489,-0.060548477573057105,-0.12617549935018602,-0.06562702177712891,-1339900,-1346300,51.70451996557725,58.489961103884674,NaN,NaN,-6.997065033005175,-1.697287345681572
2001-03-08T09:30:00-05:00,28.55,28.84,28.55,28.84,18200,39535,49.835282980026875,46.01577178338909,NaN,NaN,-36.43030302401214,-71.32217590306973,-0.03349796007242653,-0.10749947186766207,-0.07400151179523554,-1321700,-1340420,52.5249835811321,57.56024542426822,NaN,NaN,-6.170186258400006,-2.336272904641348
2001-03-09T09:30:00-05:00,28.61,28.63,28.28,28.59,27300,15385,45.83736087034438,45.66544558480723,NaN,NaN,-75.01201571302248,-65.5726116068666,-0.030066959635916365,-0.111585211340131,-0.08151825170421463,-1349000,-1341120,52.410832692566345,56.59753054395496,NaN,NaN,-6.539102881646822,-2.9366771870707016
2001-03-12T09:30:00-05:00,27.84,27.86,27.06,27.16,23300,16020,30.677433153042784,44.26233881999025,NaN,NaN,-250.53973067872812,-97.71967190881273,-0.11685638824335964,-0.2275887370084142,-0.11073234876505456,-1372300,-1345560,51.644170075557014,55.57487309829826,NaN,NaN,-12.592820186486234,-4.316126186987206
2001-03-13T09:30:00-05:00,27.17999,27.21001,26.66,27.17,56800,18130,30.84966776968116,43.02525669770244,NaN,NaN,-263.95494309739865,-135.89724393309587,-0.16348081341119788,-0.3150833655290519,-0.15160255211785403,-1315500,-1339680,52.632368007871015,54.659108556079445,NaN,NaN,-17.074358588531354,-6.138730815779227
2001-03-14T09:30:00-05:00,26.39999,27.02,26.3,26.64999,51000,19800,27.08161675362055,42.01608102088075,NaN,NaN,-254.5952769331019,-176.10645388925266,-0.2159378572954751,-0.42152487373719794,-0.20558701644172284,-1366500,-1345000,51.60481481529574,53.75891795292632,NaN,NaN,-22.25056498618337,-8.440421411551247
2001-03-15T09:30:00-05:00,26.89999,27.44,26.75999,27.44,14400,20240,39.22633134691816,41.939533130293775,NaN,NaN,-141.95712388094742,-197.2118180606397,-0.1852062066621153,-0.437094774769367,-0.2518885681072517,-1352100,-1351080,50.393920664898616,52.99179173130375,NaN,NaN,-22.254154913900408,-10.41381191188684
2001-03-16T09:30:00-05:00,27.45,27.45,26.92,27.07001,10200,19895,36.18656809716562,41.46345538581061,NaN,NaN,-123.48774533036804,-206.9069639841088,-0.17755086546591725,-0.47382714993964825,-0.296276284473731,-1362300,-1353740,49.84288228757783,52.374210955094746,NaN,NaN,-23.359366166682292,-12.263176805429048
2001-03-19T09:30:00-05:00,26.89999,27.08,26.83,27.07001,15100,20225,36.18656809716562,40.43464405664753,NaN,NaN,-117.88460937205922,-180.37593972277506,-0.1607440418247446,-0.49720633675466175,-0.33646229492991714,-1362300,-1351740,50.2830731436274,51.93916955958254,NaN,NaN,-24.191031799848396,-13.967156090346098
2001-03-20T09:30:00-05:00,27.17999,27.39999,26.5,26.5,10200,20050,31.785545556679352,39.44561515280467,NaN,NaN,-115.7615343387294,-150.7372579710412,-0.1750926261141777,-0.5553280775726392,-0.38023545145846155,-1372500,-1363140,47.712667412046216,51.464266263423646,NaN,NaN,-26.418452309991313,-15.745912693152556
2001-03-21T09:30:00-05:00,26.39999,26.39999,25.69,25.8,44700,21650,27.38139624155528,38.23008792711572,NaN,NaN,-159.00486658648575,-131.61917590171797,-0.21611322662274335,-0.6503769847368908,-0.4342637581141474,-1417200,-1373280,45.48541314711024,50.94303619717697,NaN,NaN,-29.9275233192827,-17.771857068314006
2001-03-22T09:30:00-05:00,25.63,25.7,24.55,25.23,45600,22085,24.41486947967219,36.74570307355601,NaN,NaN,-183.54057883684544,-139.93586689289756,-0.2629121004576757,-0.7629038836862421,-0.49999178322856636,-1462800,-1395420,40.986559067875305,50.103988367523435,NaN,NaN,-33.907166839828896,-20.07690132138756
2001-03-23T09:30:00-05:00,25.46001,25.8,25.21001,25.8,18600,19895,32.31232128919032,35.97747389483944,NaN,NaN,-131.03054122858836,-141.4444260725416,-0.23752804316118814,-0.7969018371800516,-0.5593737940188634,-1444200,-1411800,37.992575179092626,49.07747632462627,NaN,NaN,-34.301048642729185,-22.108922367293506
2001-03-26T09:30:00-05:00,26,26.42999,26,26.25,8700,19930,37.834639346774026,35.478739124322885,NaN,NaN,-81.95068576379641,-134.25764135088906,-0.17534854247670384,-0.7785594721147433,-0.6032109296380395,-1435500,-1426440,35.496780647335754,47.908254334826005,NaN,NaN,-32.63606470656502,-23.612799844332294
2001-03-27T09:30:00-05:00,26.59,27.03,26.59,27.03,7800,19860,46.05071223472117,35.40430808689693,NaN,NaN,-35.16922020654174,-118.13917852445152,-0.07190643903795912,-0.6930939784354884,-0.6211875393975292,-1427700,-1437480,33.698987856861805,46.62214489848919,NaN,NaN,-28.176542628809266,-24.264763099257575
2001-03-28T09:30:00-05:00,26.3,26.64999,26.3,26.47,2400,19580,41.781230501444526,34.82901862414104,NaN,NaN,-58.27358093954917,-97.9929213950642,-0.03337612177045268,-0.6629076916105952,-0.6295315698401425,-1430100,-1440060,33.27485477107112,45.247135697770545,NaN,NaN,-26.105070274831434,-24.527664124339555
2001-03-29T09:30:00-05:00,26.47,27.02,26.47,26.8,13500,19410,45.01629824720393,34.770371293916725,NaN,NaN,-33.186609487318904,-67.92212752515888,0.019322714306232447,-0.6053781769573519,-0.6247008912635843,-1416600,-1430820,36.36391039389199,44.10092696215094,NaN,NaN,-23.33973016045072,-24.357959272355437
2001-03-30T09:30:00-05:00,26.84,27,26.7,26.82001,14700,19865,45.21509035542728,35.80877537980133,NaN,NaN,-22.552188298159358,-46.22645693907309,0.05831266543352298,-0.5518100594716806,-0.6101227249052036,-1401900,-1422360,39.14194312093576,43.207910751106574,NaN,NaN,-21.155678061272194,-23.900490527914975
2001-04-02T09:30:00-04:00,26.95,27.25,26.49001,26.49001,3000,19785,42.48691727064193,36.64000748701282,NaN,NaN,-25.715578536186154,-34.97943549355104,0.06419650852105618,-0.5298770892538833,-0.5940735977749395,-1404900,-1416240,41.143616388339595,42.38728563542576,NaN,NaN,-20.206943229096577,-23.37284091379806
2001-04-03T09:30:00-04:00,26.25,26.25,25.7,25.89999,29400,20995,38.06462401952861,37.42450800600625,NaN,NaN,-95.04480775877337,-46.95455300399737,0.032281457909515754,-0.5537217753880448,-0.5860032332975605,-1434300,-1417560,40.831670370122296,41.61777531791337,NaN,NaN,-20.815605944028423,-23.007521632402398
2001-04-04T09:30:00-04:00,25.95,26.06,25.74001,26.06,7500,21120,39.89184384371943,37.47204461292063,NaN,NaN,-88.23813253595446,-52.94746332327843,0.026139419124552754,-0.5533289593918695,-0.5794683785164223,-1426800,-1416900,41.07224596088747,40.951941410484004,NaN,NaN,-20.739184404484472,-22.683473456985553
2001-04-05T09:30:00-04:00,26.3,26.83,26.3,26.71001,5000,20460,46.762907122497374,38.227497400444314,NaN,NaN,-3.782147193313621,-47.06657086447737,0.0676844589156319,-0.4948628048718824,-0.5625472637875143,-1421800,-1417940,40.790797720544184,40.30536394141017,NaN,NaN,-18.45979685944852,-22.080091085908833
2001-04-06T09:30:00-04:00,26.55,26.84,26.44,26.59,12900,19740,45.72367221531865,38.90871912316953,NaN,NaN,10.980552738393445,-40.36002265716683,0.08764583200426679,-0.45298997378218075,-0.5406358057864475,-1434700,-1424500,38.97650178818221,39.49775170173552,NaN,NaN,-16.94907757535231,-21.34708915582933
2001-04-09T09:30:00-04:00,26.8,27,26.74001,26.92,4700,18810,49.07505460467818,40.143684055169444,NaN,NaN,55.411029236081134,-24.13470110271337,0.1215513971015243,-0.3886965594095422,-0.5102479565110665,-1430000,-1429520,37.598343195663915,38.775299971993924,NaN,NaN,-14.657086695672032,-20.391374518664
2001-04-10T09:30:00-04:00,27.08,27.53999,27.03,27.45,12700,16605,53.988912960475886,42.04422096366378,NaN,NaN,119.28702752495626,18.731665954032554,0.1749060183994267,-0.2916154335117831,-0.4665214519112098,-1417300,-1426120,39.16723776446383,38.32400173037632,NaN,NaN,-11.126438765987698,-19.06781226828167
2001-04-11T09:30:00-04:00,27.48,27.48,26.91,27.12,8400,14475,50.708024211281426,43.92230344449301,NaN,NaN,86.56494753038704,53.69228196730086,0.18237215684132252,-0.23855625585955664,-0.42092841270087916,-1425700,-1425900,39.27362840383627,38.20164954008782,NaN,NaN,-9.169838144529145,-17.65381596488845
2001-04-12T09:30:00-04:00,27.05,27.27,26.87,27.10001,8100,14160,50.507794342821946,45.22198009118098,NaN,NaN,75.35326741068822,69.51936488810122,0.18005334684696195,-0.1958617291421767,-0.37591507598913865,-1433800,-1428300,38.48293643149623,38.23667534383094,NaN,NaN,-7.658202517225009,-16.225871186650817
2001-04-16T09:30:00-04:00,27.38,27.50999,27.2,27.28999,4300,13865,52.43027758480054,46.264525679611445,NaN,NaN,109.2024630716833,89.1637469547592,0.18471249346354818,-0.1450244591597034,-0.3297369526232516,-1429500,-1427260,39.05553120539461,38.49087181226371,NaN,NaN,-5.840939681793116,-14.742309543099717
2001-04-17T09:30:00-04:00,27.53,27.75999,27.34,27.75999,4400,13330,56.89158794905897,47.03887394492129,NaN,NaN,139.18013781424256,105.91756867039149,0.21095027301999897,-0.06604911134825286,-0.27699938436825183,-1425100,-1426280,39.6258012806023,38.914215628245174,NaN,NaN,-2.9184064575391515,-13.053180530876778
2001-04-18T09:30:00-04:00,27.86,29.10001,27.86,28.87,12900,13465,65.19392851962995,48.71120951764886,NaN,NaN,225.93938223187988,127.24803961177619,0.28970083857221807,0.08512666384702072,-0.20457417472519732,-1412200,-1425260,40.25245144364132,39.41261539057162,NaN,NaN,2.6666196242056817,-10.807494794436426
2001-04-19T09:30:00-04:00,28.82001,29.00999,28.62,28.89999,7300,11595,65.38788349909395,50.16632274992672,NaN,NaN,214.1900429315079,152.77305869200035,0.3276525261815624,0.20499148300175563,-0.12266104317980672,-1404900,-1421100,42.85747150911324,39.876441184516,NaN,NaN,7.0992414957194105,-8.24938961012845
2001-04-20T09:30:00-04:00,28.97,28.98,28.64,28.98,14700,10050,65.93330025623226,51.646194885698506,NaN,NaN,183.79687222336023,174.46177965453475,0.3404881504849552,0.30294914492638725,-0.037539005558567914,-1390200,-1412380,47.977689556787304,40.50756592993396,NaN,NaN,10.84362954757082,-5.52181544474284
2001-04-23T09:30:00-04:00,28.88,28.88,28.31,28.31,13000,9770,57.72952887784559,52.73495285764162,NaN,NaN,127.86386061475484,178.1940591631491,0.2882687208428197,0.3227968954949567,0.03452817465213702,-1403200,-1407120,50.83924079308708,41.20011053027307,NaN,NaN,11.676694274266382,-3.0648854848843796
2001-04-24T09:30:00-04:00,28.32001,28.63,28.27,28.39,7800,9725,58.395188419346155,54.187136029057164,NaN,NaN,104.88468655315384,171.3349689109313,0.24521769764149687,0.3410502967040081,0.09583259906251124,-1395400,-1401180,53.92167594611926,42.13511092855857,NaN,NaN,12.544309699937447,-0.8350004584812618
2001-04-25T09:30:00-04:00,28.14,28.72,28.14,28.72,14700,10070,61.11539215644416,55.70310376568035,NaN,NaN,98.7394724950805,145.89498696357145,0.22556557496943416,0.37778956777430395,0.15222399280486978,-1380700,-1394880,57.001113255119684,43.27288716386088,NaN,NaN,14.085418548082279,1.2964879710278154
2001-04-26T09:30:00-04:00,28.75999,29.17999,28.60001,29.08,33300,11615,63.88915169384054,56.92640694934773,NaN,NaN,115.49043984899286,126.15506634706847,0.22301004692308823,0.4309865514587301,0.20797650453564187,-1347400,-1383380,61.99417392709851,44.78741403575761,NaN,NaN,16.231535650665073,3.430066210975995
2001-04-27T09:30:00-04:00,28.82001,28.87,28.52,28.8,12700,11575,60.28705498740597,57.96664857592539,NaN,NaN,86.5397659385468,106.70364509010578,0.18995270832452482,0.44541738994129787,0.25546468161677305,-1360100,-1377360,64.32927105812988,46.59832612646816,NaN,NaN,16.986509067684093,5.366700904791438
2001-04-30T09:30:00-04:00,28.98,29.25999,28.7,28.8,20000,11840,60.28705498740597,58.76750574612024,NaN,NaN,89.34192700614366,98.99925836838354,0.15694635132729118,0.45164762077588705,0.29470126944859587,-1360100,-1368740,67.41636446962522,48.728184788893955,NaN,NaN,17.598670624052943,7.114125150400224
2001-05-01T09:30:00-04:00,28.89,29.32001,28.75,29.25,18600,12620,64.0635370412462,59.48712175188955,NaN,NaN,91.90040083987171,96.40240122572712,0.1540624326205992,0.4872793102243449,0.3332168776037457,-1341500,-1357960,70.81772810607691,50.98893409900918,NaN,NaN,19.228731397267858,8.84478318566703
2001-05-02T09:30:00-04:00,29.11,29.34,28.97,29.34,19000,12100,64.78481064347594,60.4926064970463,NaN,NaN,91.85905550870112,95.02631782845124,0.14688435602794292,0.5168223226386743,0.3699379666107314,-1322500,-1346320,73.976628873679,53.4677198468551,NaN,NaN,20.781183756704973,10.549983267243878
2001-05-03T09:30:00-04:00,28.96001,28.96001,28.60001,28.77,14000,12425,56.984080050045094,60.95519833327653,NaN,NaN,54.47100674630768,82.8224312079142,0.09493663382152401,0.48860875888763644,0.39367212506611243,-1336500,-1344140,74.53264692315209,56.04269916768765,NaN,NaN,19.886552022467075,11.883778803704335
2001-05-04T09:30:00-04:00,28.53999,28.94,28.44,28.86,11300,12740,57.847140983598806,61.3421171474764,NaN,NaN,47.70004938205868,75.05448789661656,0.05955462884163737,0.46811541111815913,0.40856078227652176,-1325200,-1337160,76.28016100371849,58.70160129613936,NaN,NaN,19.392404939708726,12.95643968027639
2001-05-07T09:30:00-04:00,28.8,29.05,28.74001,28.92999,15900,12890,58.54373632985424,61.46012774610464,NaN,NaN,58.979418420790054,68.98198617954586,0.0349977491563227,0.45230796872192514,0.41731021956560244,-1309300,-1327000,78.5837417419345,61.48431132909166,NaN,NaN,19.170481653858467,13.844159962216686
2001-05-08T09:30:00-04:00,28.86,28.86,28.42,28.45,7800,13045,52.17573705984824,60.5302569275488,NaN,NaN,19.806784799488213,54.56326297146914,-0.016665045196542938,0.3964789130699238,0.4131439582664667,-1317100,-1322120,79.60811868304157,64.29543041762024,NaN,NaN,17.117306394969294,14.311752309752773
2001-05-09T09:30:00-04:00,28.39,28.69,28.33,28.63,8200,12820,54.188186826910204,59.73027859382138,NaN,NaN,10.823529687981763,38.356157807325275,-0.040452049733485596,0.3625788960996097,0.4030309458330953,-1308900,-1319400,80.177251763062,66.96112900718802,NaN,NaN,15.945522690946337,14.54514807849471
2001-05-10T09:30:00-04:00,28.81,28.99001,28.75999,28.82001,8300,12815,56.279644519960826,59.040731755516276,NaN,NaN,51.636588130637904,37.78927408419132,-0.044789081954843823,0.3470445933895405,0.39183367534438435,-1300600,-1312220,81.63439423010043,69.3651793409961,NaN,NaN,15.528495625192956,14.685626299451602
2001-05-11T09:30:00-04:00,29,29.03999,28.78,28.96001,14100,13115,57.808046181516474,59.04634013434992,NaN,NaN,60.470293030462145,40.34332281387202,-0.039797331931573365,0.3420870104299176,0.381884342361491,-1286500,-1304480,83.07843629198611,71.66797901948888,NaN,NaN,15.593438293453495,14.815313727166158
2001-05-14T09:30:00-04:00,29.06,29.06,28.74001,28.83,22600,14030,55.85527474013878,58.86491772869225,NaN,NaN,43.846356341127844,37.31671039793957,-0.04636085894836939,0.32393326867602923,0.3702941276243986,-1309100,-1304440,83.08583794611422,73.75113344805995,NaN,NaN,15.118296935353134,14.85859704262144
2001-05-15T09:30:00-04:00,28.75,29.12,28.7,28.96001,69600,17290,57.40483376832555,58.59987784382663,NaN,NaN,53.17091590164771,43.989536618371474,-0.04312340409778209,0.316389872502171,0.3595132765999531,-1239500,-1288920,85.6995330346872,75.80102057517192,NaN,NaN,15.122226491605517,14.896258392476309
2001-05-16T09:30:00-04:00,28.96001,29.83,28.92,29.75999,17300,17510,65.44293108837658,58.71086208629349,NaN,NaN,238.91398356062203,89.60762739289952,0.008941610766631192,0.37069029005824206,0.36174867929161086,-1222200,-1271580,87.94154602345134,77.65440429633998,NaN,NaN,17.57800328452038,15.279364805625463
2001-05-17T09:30:00-04:00,29.85001,30.21001,29.85001,30.02,19600,18125,67.58408012563578,59.23207816759562,NaN,NaN,311.28429989997755,141.53716974676746,0.05440145651686312,0.42975049993768977,0.37534904342082664,-1202600,-1251980,89.87403112685871,79.47903001553489,NaN,NaN,20.306877609802005,15.997580920507826
2001-05-18T09:30:00-04:00,30.08,30.10001,29.73,30.10001,9400,17860,68.23627933722985,59.79987990686875,NaN,NaN,222.34350424844627,173.91181199036427,0.0817270585857921,0.47750786665306677,0.39578080806727467,-1193200,-1233320,91.30303243542488,81.1852205845206,NaN,NaN,22.72896228781893,16.959206830123698
2001-05-21T09:30:00-04:00,30.16,30.67999,30.07001,30.56,68500,20635,71.75476593194396,60.34925339906145,NaN,NaN,232.77663639142972,211.69786800042465,0.1203171782193273,0.5461772808414338,0.4258601026221065,-1124700,-1196440,93.31194071593524,82.79195005665333,NaN,NaN,25.975294339015342,18.247219331393932
2001-05-22T09:30:00-04:00,30.5,30.81,30.5,30.60001,8900,20690,72.04482840101525,60.867826096028544,NaN,NaN,203.40428663393303,241.7445421468817,0.13686835175707868,0.5969455423184549,0.4600771905613762,-1115800,-1171700,94.26839077401762,84.24136162096322,NaN,NaN,28.69037791105852,19.739099128488874
2001-05-23T09:30:00-04:00,30.5,30.5,30.06,30.09,8800,20395,63.14323032774615,61.30776540157863,NaN,NaN,121.59038638299188,218.2798227113557,0.10332535886869776,0.5892338891472484,0.48590853027855063,-1124600,-1152180,94.88940104996553,85.69541548716418,NaN,NaN,28.425979951686877,20.980082103231446
2001-05-24T09:30:00-04:00,30.2,30.46001,30.14,30.46001,10600,19260,66.3879666399011,61.91782437702877,NaN,NaN,116.39659564297187,179.30228185995455,0.09606801318346037,0.6059935467578761,0.5099255335744157,-1114000,-1134460,95.3788841046419,87.05960999437299,NaN,NaN,29.199880090530506,22.154338958559883
2001-05-25T09:30:00-04:00,30.31,30.31,30.08,30.24001,17000,19475,62.845311127221876,62.225079719697895,NaN,NaN,87.59231649111335,152.35204430848796,0.06779442571688743,0.5946685657205251,0.5268741400036376,-1131000,-1122020,95.69091142917459,88.28155068631872,NaN,NaN,28.75544910282864,23.09735469345542
2001-05-29T09:30:00-04:00,30,30.16,29.89999,30.00999,5300,18740,59.28326706334224,62.73276043423318,NaN,NaN,60.49470831502909,117.89565869320784,0.027036443027862456,0.5606696937884657,0.5336332507606032,-1136300,-1124340,94.41059072186711,89.3388701176634,NaN,NaN,27.297212458962772,23.697334374242182
2001-05-30T09:30:00-04:00,30.05,30.10001,29.64999,29.91,18100,18715,57.75090684825921,62.98724043575811,NaN,NaN,41.84508133230204,85.58381763288165,-0.011173326618098889,0.5196665924879795,0.5308399191060784,-1154400,-1132060,90.09099159845275,90.04699439161989,NaN,NaN,25.64781082970189,23.975973867879283
2001-05-31T09:30:00-04:00,29.72,29.89999,29.58,29.89999,5000,18015,57.590419363013204,63.08086721026185,NaN,NaN,29.21961796592817,67.10966394946891,-0.04001512677045849,0.4808210106430053,0.5208361374134638,-1159400,-1139020,86.25917552526775,90.37733591270327,NaN,NaN,24.25607329217813,24.015988071350545
2001-06-01T09:30:00-04:00,29.8,29.85001,29.5,29.81,15600,18095,56.08156492268687,62.95754712034545,NaN,NaN,17.62256368029739,47.354857556934014,-0.06648626449315242,0.43772830679702324,0.5042145712901757,-1175000,-1151220,79.84820582588566,90.14660516512467,NaN,NaN,22.668667384888952,23.82351368757032
2001-06-04T09:30:00-04:00,29.86,29.94,29.63,29.85001,6800,17870,56.62567753289996,63.012575891256965,NaN,NaN,22.70206347116046,34.37680695294343,-0.08163602420952315,0.40216954102827174,0.4838055652377949,-1168200,-1158660,76.13213307491348,89.6499119600389,NaN,NaN,21.472068493076016,23.487592945499703
2001-06-05T09:30:00-04:00,29.92,30.13,29.85001,30.13,93200,21735,60.32964118020925,63.22149070639151,NaN,NaN,45.20000490309747,31.317866270557126,-0.07339456010954587,0.39206236510086256,0.46545692521040843,-1075000,-1146400,77.95297118044995,89.09658611330767,NaN,NaN,21.38489648856013,23.18720773736548
2001-06-06T09:30:00-04:00,30.17999,30.17999,29.83,29.89,9800,21835,55.921399016979976,62.54138127272033,NaN,NaN,31.99694602536559,29.348239209169833,-0.08394122721114816,0.36053039119647323,0.4444716184076214,-1084800,-1132480,79.83406135777597,88.51748006575941,NaN,NaN,20.085590189311798,22.744119516214955
2001-06-07T09:30:00-04:00,29.91,30.08,29.8,30.06,4300,21640,58.24857064213135,61.87455916675572,NaN,NaN,28.28457440539993,29.161230497064185,-0.07935449604468603,0.34527849835176383,0.42463299439644986,-1080500,-1116700,81.73644185263018,87.93622368902881,NaN,NaN,19.600670686416112,22.295055397672265
2001-06-08T09:30:00-04:00,30.05,30.05,29.66,29.89999,7500,21600,55.28968866377828,60.94980269008061,NaN,NaN,2.184532970513431,26.07362435510739,-0.08640249034162323,0.31662988146942084,0.40303237181104407,-1088000,-1099300,83.57627157630711,87.38431219909182,NaN,NaN,18.363168104497202,21.73335721293297
2001-06-11T09:30:00-04:00,29.85001,29.89999,29.57001,29.75,12500,21520,52.59276746183597,59.581088513644325,NaN,NaN,-35.75714780337065,14.381782100201155,-0.09953705590525908,0.2786110519294702,0.3781481078347293,-1100500,-1085760,84.85482976462201,86.78023284542658,NaN,NaN,16.54991994289052,20.992866174355477
2001-06-12T09:30:00-04:00,29.45,29.85001,29.25999,29.67999,7700,20775,51.33409571151216,58.1017504643941,NaN,NaN,-87.69264642836758,-12.196748166091854,-0.11046702895487231,0.2400643216411389,0.3505313505960112,-1108200,-1092400,81.50393033699902,85.86848567135384,NaN,NaN,14.675372021114066,20.090367009606705
2001-06-13T09:30:00-04:00,29.67999,29.88,29.5,29.53999,9300,17760,48.818044474568545,57.078522903452836,NaN,NaN,-100.91482903103014,-38.779103177371,-0.12365706046499281,0.19596002501477017,0.319617085479763,-1117500,-1098940,78.22722706273713,84.6783303865518,NaN,NaN,12.363742873468318,18.986563561586937
2001-06-14T09:30:00-04:00,29.32001,29.39999,28.99001,28.99001,3400,17065,40.43383622535171,55.22465644527074,NaN,NaN,-230.31121083080168,-90.49826022461131,-0.16345433594421205,0.11529916554949793,0.27875350149371,-1120900,-1107020,74.25527351303253,83.16950105857971,NaN,NaN,7.5641455252741086,17.35478955639939
2001-06-15T09:30:00-04:00,28.7,29,28.45,28.89999,56100,18890,39.245741646996905,53.53897291096896,NaN,NaN,-251.22945973918146,-141.1810587665503,-0.1881161593881837,0.043608302258480336,0.23172446164666405,-1177000,-1124820,66.27218672471092,81.06816357968945,NaN,NaN,3.2459899932698226,15.339246761666594
2001-06-18T09:30:00-04:00,28.89999,28.89999,28.46001,28.46001,10900,18965,33.98893258956585,51.73223473427065,NaN,NaN,-226.21458385122776,-179.27254597612173,-0.2239034360326288,-0.048154833394121965,0.17574860263850683,-1187900,-1142300,59.50646949852952,78.57501206373676,NaN,NaN,-2.364677101817503,12.810114781168867
2001-06-19T09:30:00-04:00,28.60001,28.84,28.50999,28.53999,8100,15945,35.67563443882398,50.15542956216813,NaN,NaN,-182.85056440222448,-198.3041295708931,-0.231094949329554,-0.11312008402343565,0.11797486530611834,-1179800,-1156620,54.58970339080403,76.03920576319044,NaN,NaN,-6.431237244291631,10.061350206103082
2001-06-20T09:30:00-04:00,28.5,29.2,28.5,29.16,4600,15730,46.98465804103641,49.39787518202694,NaN,NaN,-110.30692393641102,-200.1825485519693,-0.18499603601513695,-0.11327017971280284,0.0717258563023341,-1175200,-1168160,50.937142873943884,73.51620343095301,NaN,NaN,-6.505873503361083,7.694603961893916
2001-06-21T09:30:00-04:00,29.16,29.55,29.16,29.49001,7400,15660,51.83826710648944,49.09478248086997,NaN,NaN,-33.146501110209286,-160.7496066078508,-0.12599777603883056,-0.08577136374620409,0.04022641229262647,-1167800,-1177540,48.11886523060366,71.24982195986145,NaN,NaN,-4.92810601411264,5.891359679607266
2001-06-22T09:30:00-04:00,29.3,29.36,29.00999,29.11,6800,15470,46.55303751510435,48.37530819388457,NaN,NaN,-61.857757286689385,-122.87526611735238,-0.10703188500018337,-0.09356344395760274,0.013468441042580624,-1174600,-1177060,48.27657534576357,69.26013926492216,NaN,NaN,-5.371230554261491,4.282418217626015
2001-06-25T09:30:00-04:00,29.03999,29.17999,28.97,29.17999,5100,14875,47.61245486823376,47.46693774302918,NaN,NaN,-61.109305533013185,-89.85421045370947,-0.08518983456950259,-0.09301885216929762,-0.007829017599795027,-1169500,-1173380,49.54295282400396,67.23085223946173,NaN,NaN,-5.378557909283934,2.9022787709245934
2001-06-26T09:30:00-04:00,29,29,28.73,28.73,31600,16190,41.86649939604439,46.46301634153378,NaN,NaN,-94.95684853961309,-72.27546728118719,-0.09567980349500652,-0.12742877196855318,-0.03174896847354666,-1201100,-1177640,48.07555891571047,64.9623877793142,NaN,NaN,-7.2873373428168495,1.4466193261043871
2001-06-27T09:30:00-04:00,28.73,29.22,28.73,29.2,33600,16965,48.81461921637783,45.78916266826567,NaN,NaN,-53.06117377444577,-60.82631724879415,-0.06695526811092549,-0.11544305361220353,-0.04848778550127804,-1167500,-1176100,48.66746572375948,62.60031805582343,NaN,NaN,-6.537943182956983,0.30596753909562
2001-06-28T09:30:00-04:00,29.33,29.67,29.25999,29.42,12400,17335,51.72324848048705,45.53441694088773,NaN,NaN,12.59451171081033,-51.67811468459023,-0.030959440101402377,-0.08718708562803101,-0.056227645526628636,-1155100,-1173560,49.68621237958184,60.179599541771616,NaN,NaN,-4.9561891561247045,-0.44576913165014065
2001-06-29T09:30:00-04:00,29.2,29.77,29.2,29.55,19600,17535,53.408087168626054,45.592654062801294,NaN,NaN,24.076520299317437,-34.491259167388876,0.002033905555708246,-0.053685263581993325,-0.05571916913770157,-1135500,-1165740,52.792503664491235,57.889433391762275,NaN,NaN,-3.1473945453311827,-0.831715619318861
2001-07-02T09:30:00-04:00,29.55,29.86,29.39,29.75999,5600,17475,56.07478685209761,45.9312748585574,NaN,NaN,53.14524014606593,-11.640350031573048,0.036515926990408766,-0.010074260399690615,-0.04659018739009938,-1129900,-1157820,55.77079649724826,56.05135240320866,NaN,NaN,-0.8055621787656623,-0.8279794135255468
2001-07-03T09:30:00-04:00,29.72,29.75999,29.58,29.75999,3500,12990,56.07478685209761,46.44961359980948,NaN,NaN,63.47456920408441,20.045933517166446,0.056639118610520206,0.024208710873050876,-0.03243040773746933,-1129900,-1143580,60.585622439593116,54.7912377872698,NaN,NaN,1.0573607846130837,-0.5586450995057425
2001-07-05T09:30:00-04:00,29.66,29.67999,29.41,29.41,13200,13160,50.48897258750588,47.167837625677635,NaN,NaN,34.39717830733977,37.537603933523556,0.04424294675510867,0.022873275706416507,-0.02136967104869216,-1143100,-1138700,62.10797015604364,53.92357326177059,NaN,NaN,1.0213493275517718,-0.3329316099260976
2001-07-06T09:30:00-04:00,29.3,29.3,28.7,28.86,20100,13950,43.20534009706502,47.45066608639679,NaN,NaN,-60.07725140426892,23.00325131050771,-0.0007509138748872449,-0.022308313392301216,-0.02155739951741397,-1163200,-1140320,61.26204766413614,53.56570618601525,NaN,NaN,-1.3800317284884003,-0.4825173411492837
2001-07-09T09:30:00-04:00,28.74001,28.92999,28.7,28.7,6100,13880,41.33709677147429,47.9755349565331,NaN,NaN,-86.6082507404371,0.8662971025567998,-0.03892712141005915,-0.0702163012799879,-0.031289179869928754,-1169300,-1147080,57.72866161156768,53.43871990837512,NaN,NaN,-3.9235124511690165,-0.9740880711521027
2001-07-10T09:30:00-04:00,28.94,28.94,28.52,28.7,28800,14695,41.33709677147429,48.37992512315098,NaN,NaN,-91.05706161826683,-27.97416325030975,-0.06052934718843027,-0.1069508638554666,-0.046421516667036325,-1169300,-1154960,53.83106609265909,53.38453152993619,NaN,NaN,-5.9432372254410355,-1.6839665217648072
2001-07-11T09:30:00-04:00,28.45,28.7,28.34,28.67999,14500,15035,41.07945448083385,47.958124868850796,NaN,NaN,-111.13475772325742,-62.89602863577811,-0.07174993074865944,-0.13610893010286063,-0.06435899935420118,-1183800,-1165740,48.96102111802474,53.24337997594197,NaN,NaN,-7.662386020091068,-2.53802645009713
2001-07-12T09:30:00-04:00,28.63,28.96001,28.63,28.96001,3300,14735,46.138645709342406,47.55100905476886,NaN,NaN,-47.89594410138036,-79.35465311752213,-0.05656455428011525,-0.13506469220434525,-0.07850013792423,-1180500,-1173220,45.86068988784103,53.08208173717321,NaN,NaN,-7.7322331890520095,-3.2800559842335413
2001-07-13T09:30:00-04:00,28.92,29.16,28.73,29.16,13400,15235,49.47537769373153,47.75974763895652,NaN,NaN,-9.947193795342168,-69.3286415957368,-0.03060288173541345,-0.11675374009349682,-0.08615085835808337,-1167100,-1174000,45.5368737207904,52.88638876396084,NaN,NaN,-6.827424924187479,-3.7868229756555323
2001-07-16T09:30:00-04:00,29.16,29.17,28.84,29.02,18700,13365,47.26781026630602,47.73513016739025,NaN,NaN,-14.374805106674296,-54.88195246898423,-0.020875406719709028,-0.11224511675771964,-0.09136971003801062,-1185800,-1177300,44.11757567719726,52.498861824903216,NaN,NaN,-6.683086874878813,-4.200574961258858
2001-07-17T09:30:00-04:00,28.92,29.28,28.92,29.22,9500,13295,50.65511043582313,48.36288809880301,NaN,NaN,9.850220779663902,-34.700495989398085,-0.00008755754814322725,-0.09147915697318965,-0.09139159942504642,-1176300,-1178700,43.49816300179042,52.17190497390892,NaN,NaN,-5.587025593266671,-4.398639337259974
2001-07-18T09:30:00-04:00,29.03,29.16,28.72,28.92999,4900,13135,46.03711365232445,48.16449484422777,NaN,NaN,-45.5442424756728,-21.582392939881167,-0.004728107420537114,-0.09730173370071782,-0.0925736262801807,-1181200,-1178180,43.813706202233845,51.82520786522853,NaN,NaN,-5.967227271621066,-4.622723327882987
2001-07-19T09:30:00-04:00,29.10001,29.19,28.58,28.75999,17100,13760,43.5318244853562,47.57939313028985,NaN,NaN,-66.85167614866499,-25.373539349338092,-0.01739388574330622,-0.11431598345931349,-0.09692209771600727,-1198300,-1181740,42.08104323251593,51.28198149758096,NaN,NaN,-7.02021901908757,-4.965222712340784
2001-07-20T09:30:00-04:00,28.85001,28.97,28.73,28.83,10800,13930,44.86256138709062,46.968998431608746,NaN,NaN,-61.430546456258284,-35.67020988152131,-0.0190692390784674,-0.12075864656409152,-0.10168940748562412,-1187500,-1185820,40.12269875487059,50.37699543260806,NaN,NaN,-7.5193481102059145,-5.33009776917866
2001-07-23T09:30:00-04:00,28.7,28.83,28.27,28.27,11400,14160,37.292164213944936,45.62738252888356,NaN,NaN,-142.63850786678543,-61.32295043354354,-0.05393048588968424,-0.16910251484772942,-0.11517202895804518,-1198900,-1188440,38.871685883763455,49.16991610307343,NaN,NaN,-10.368744811584094,-6.049904489522293
2001-07-24T09:30:00-04:00,28.39999,28.39999,27.89,28.14,21300,14970,35.782616976605325,44.17794182349125,NaN,NaN,-186.1215090412043,-100.51729639771717,-0.08020000972282229,-0.21542204111157304,-0.13522203138875075,-1220200,-1197220,34.94005178373645,47.3380896276551,NaN,NaN,-13.174034884641278,-7.067637403110719
2001-07-25T09:30:00-04:00,27.98,28.50999,27.98,28.3,10900,13935,39.0526008500897,43.36105812796153,NaN,NaN,-142.28490614864972,-119.86542913231256,-0.0810174016428982,-0.23649378344237348,-0.1554763817994753,-1209300,-1202840,32.66275803861812,45.23486019069613,NaN,NaN,-14.547686377323336,-8.136215827998235
2001-07-26T09:30:00-04:00,28.89999,29.13,28.7,29.13,13300,12920,52.550530538745676,44.028571730938715,NaN,NaN,4.001258401517827,-105.694842222276,-0.02289655153015996,-0.18409707121217522,-0.16120051968201526,-1196000,-1202380,33.04741100317345,43.21952900062737,NaN,NaN,-11.190534177802924,-8.572547020827477
2001-07-27T09:30:00-04:00,29,29.17999,28.95,29.17,8600,12730,53.089726378415726,44.86804527429167,NaN,NaN,32.48747930607331,-86.91123706980966,0.018755087318669122,-0.13775666053367885,-0.15651174785234798,-1187400,-1202360,33.06531383938341,41.45786130261421,NaN,NaN,-8.417402538642516,-8.550383523372483
2001-07-30T09:30:00-04:00,29.12,29.19,28.95,29.17,12500,12375,53.08972637841574,45.70751881764463,NaN,NaN,40.083324219644034,-50.366870652523765,0.04530524268393127,-0.0998801944974339,-0.14518543718136517,-1187400,-1200060,35.210866404230615,40.127847039155036,NaN,NaN,-6.236915068416802,-8.219888029807386
2001-07-31T09:30:00-04:00,29.14999,29.3,28.96001,28.96001,11900,12690,49.65430459808596,46.32000811173407,NaN,NaN,44.14167048499043,-4.314234747284817,0.04749394671228849,-0.08581800379100457,-0.13331195050329306,-1199300,-1195880,39.035568261037106,39.41888612079878,NaN,NaN,-5.412979347669484,-7.8189010752162575
2001-08-01T09:30:00-04:00,28.85001,29.17999,28.85001,28.92999,20700,13550,49.1645054668274,46.53614095155443,NaN,NaN,35.5335792528916,31.249462333023452,0.045675646166257994,-0.07621739279547057,-0.12189303896172857,-1220000,-1198020,37.80510668260241,38.84348732042459,NaN,NaN,-4.883542897096364,-7.399564192627701
2001-08-02T09:30:00-04:00,29.10001,29.3,29.02,29.23,13300,13555,54.04337251477668,46.862426295914794,NaN,NaN,103.30629814939763,51.11047028259942,0.06239879065369858,-0.043894550644605346,-0.10629334129830392,-1206700,-1200160,36.56389822541296,38.202560499326204,NaN,NaN,-2.965921057453929,-6.766186601888591
2001-08-03T09:30:00-04:00,29.06,29.06,28.85001,28.99001,3100,12705,49.91634989550507,47.05160769800044,NaN,NaN,36.26497800721547,51.865970022827845,0.055262940885500905,-0.0372146651914278,-0.0924776060769287,-1209800,-1204640,34.04399587635284,37.48301908498018,NaN,NaN,-2.5384850052500907,-6.162229230940234
2001-08-06T09:30:00-04:00,29.03,29.03,28.8,28.8,4200,12610,46.86487458088543,46.7808765655049,NaN,NaN,7.178560935766471,45.28501736605233,0.03661046019646996,-0.04671453083134125,-0.08332499102781121,-1214000,-1209960,31.28654882992197,36.61076092984672,NaN,NaN,-3.0835750958487296,-5.722421497355733
2001-08-07T09:30:00-04:00,28.89999,29.00999,28.83,28.88,18500,12095,48.29796274569013,46.94236578645958,NaN,NaN,14.078212206448796,39.27232571034399,0.02886533698304214,-0.04724331979900853,-0.07610865678205067,-1195500,-1209200,32.132249644405746,35.77637117571614,NaN,NaN,-3.1229188975689723,-5.351063983100482
2001-08-08T09:30:00-04:00,28.74001,29.09,28.5,28.67999,5500,11645,45.02815823093046,47.04924676828631,NaN,NaN,-39.51851616786411,24.261906626192854,0.010427372294324819,-0.06307444141414464,-0.07350181370846946,-1201000,-1205400,36.350430036493144,35.36704166171452,NaN,NaN,-4.104758143525899,-5.173020291732684
2001-08-09T09:30:00-04:00,28.39999,28.60001,28.3,28.55,21400,12550,42.99105070302907,46.915567433710486,NaN,NaN,-112.94720385074214,-18.9887937738351,-0.009301362970249957,-0.08512851742128191,-0.07582715445103196,-1222400,-1208540,34.4453092401897,34.96151383923732,NaN,NaN,-5.520262460662325,-5.22262631586549
2001-08-10T09:30:00-04:00,28.55,28.85001,28.28999,28.60001,23800,13070,44.03996342753825,47.3975530918243,NaN,NaN,-72.768174356613,-40.795424246600795,-0.017296536147774946,-0.09744782463575064,-0.08015128848797569,-1198600,-1206300,36.9826351655149,34.8265816450767,NaN,NaN,-6.410274947702217,-5.39229040612788
2001-08-13T09:30:00-04:00,28.63,28.84,28.63,28.82001,8000,12535,48.52668353316908,48.30784356015028,NaN,NaN,-16.391637427232034,-45.5094639192005,-0.0066304327596667795,-0.08843932943755917,-0.08180889667789239,-1190600,-1201620,42.03100083077774,35.33307800557965,NaN,NaN,-5.934861207310901,-5.469800520582597
2001-08-14T09:30:00-04:00,28.75999,28.78999,28.45,28.45,4500,12285,42.37324116836909,48.5450321543131,NaN,NaN,-65.46847036877999,-61.41880043424626,-0.02246488524533498,-0.1098900032345611,-0.08742511798922613,-1195100,-1201540,42.1163649139083,36.008335639528944,NaN,NaN,-7.349829501410807,-5.738376089272341
2001-08-15T09:30:00-04:00,28.55,28.55,28.05,28.06,19600,13020,37.041576608340364,47.437249730712715,NaN,NaN,-138.51116716427327,-81.21733063352808,-0.0553038176691735,-0.156554890075693,-0.10125107240651951,-1214700,-1204280,39.94663897265402,36.50113763734898,NaN,NaN,-10.324327817389893,-6.393512050431991
2001-08-16T09:30:00-04:00,27.95,28.2,27.88,28.2,5300,12430,39.96199771338064,46.49955482606735,NaN,NaN,-141.69488267700996,-86.96686639878165,-0.06312994717467284,-0.18016350637486056,-0.11703355920018772,-1209400,-1201680,42.95006292377458,37.207191143376924,NaN,NaN,-11.86955542664843,-7.175803961320054
2001-08-17T09:30:00-04:00,27.85001,28.07001,27.81,27.89,11800,12480,35.98189724506727,45.27756703082817,NaN,NaN,-150.3769984727876,-102.48863122201655,-0.08344234054719657,-0.22133648488418345,-0.13789414433698688,-1221200,-1206200,39.27282884616879,37.49733131780108,NaN,NaN,-14.479597532216559,-8.219203042876698
2001-08-20T09:30:00-04:00,27.95,28.2,27.94,28.10001,18800,12850,40.318499044376395,44.610723776991776,NaN,NaN,-108.33592902660148,-120.87748954189047,-0.07714006765263201,-0.2343192289027769,-0.1571791612501449,-1202400,-1208560,37.46902972788837,37.38543570829046,NaN,NaN,-15.302394487560033,-9.231087534974318
2001-08-21T09:30:00-04:00,28.25,28.5,28.19,28.25999,16400,12605,43.460519177742434,44.20329618491428,NaN,NaN,-67.01737640326697,-121.18727074878787,-0.05750359301555655,-0.22905865251959057,-0.17155505950403402,-1186000,-1206740,39.76664397340391,37.52554551477628,NaN,NaN,-15.012785342172052,-10.057044364573994
2001-08-22T09:30:00-04:00,28.2,28.38,28.03,28.14999,81300,16125,41.8298451299452,43.330901371712024,NaN,NaN,-90.43688743691192,-111.57241480331558,-0.04763730605813471,-0.2311016920767024,-0.18346438601856768,-1267300,-1217260,32.3641898709603,37.22556634660109,NaN,NaN,-15.260246830969692,-10.800359002630522
2001-08-23T09:30:00-04:00,28.25,28.37,28.2,28.3,41400,17530,44.86785611281546,42.97029467294848,NaN,NaN,-63.54670487105692,-95.94277924212498,-0.027710184698130608,-0.21810211689123093,-0.19039193219310033,-1225900,-1220560,30.449411268171303,36.96881030315955,NaN,NaN,-14.568428659478801,-11.338654667894561
2001-08-24T09:30:00-04:00,28.47,28.89,28.36,28.81,10800,17640,53.717752881316144,43.4597859801221,NaN,NaN,17.191091104357035,-62.429161326696054,0.020515138038805142,-0.1647480096445939,-0.18526314768339905,-1215100,-1219340,32.04997877566733,37.023341013569926,NaN,NaN,-11.042105504622315,-11.29629050171281
2001-08-27T09:30:00-04:00,28.75,28.8,28.45,28.45,11500,17590,47.875700179502466,43.42962436825155,NaN,NaN,-1.8713232724398328,-41.13624017586373,0.02838104839435565,-0.1497868371904545,-0.17816788558481014,-1226600,-1224180,29.180902348459014,36.81253049243088,NaN,NaN,-9.927661066957675,-11.100772011033506
2001-08-28T09:30:00-04:00,28.39999,28.48,28.05,28.05,18600,17925,42.36286361999823,43.2392461817564,NaN,NaN,-75.22879404980605,-42.77852370517154,0.00792072423947518,-0.16826698028546616,-0.17618770452494134,-1245200,-1236020,23.612326132273793,35.902665927843785,NaN,NaN,-10.850554436095909,-11.065026643185277
2001-08-29T09:30:00-04:00,28.2,28.25,27.8,27.8,28700,18325,39.31573309836724,42.976723495709116,NaN,NaN,-115.29800649653934,-47.750747517097025,-0.01966677429499611,-0.20077117239368647,-0.18110439809869036,-1273900,-1237340,23.08345105602959,35.0911046289752,NaN,NaN,-12.632807909895167,-11.288995395572405
2001-08-30T09:30:00-04:00,27.92999,27.92999,27.16,27.23,22500,18785,33.41429818179721,42.21774740672761,NaN,NaN,-196.62750479305294,-74.36690750149623,-0.07065209325978333,-0.2694195146734195,-0.19876742141363618,-1296400,-1251440,18.35431010924256,33.76050998209861,NaN,NaN,-16.31902039434752,-12.00757039539742
2001-08-31T09:30:00-04:00,27.2,27.57001,27.2,27.49001,181100,27685,37.98700963063911,41.464913556546904,NaN,NaN,-177.9867067595444,-113.4024670742765,-0.0804996485525169,-0.2993919821042823,-0.2188923335517654,-1115300,-1231480,37.78549478093952,33.457259549967304,NaN,NaN,-17.695610525450746,-12.82014755683361
2001-09-04T09:30:00-04:00,27.45,28.00999,27.37,27.37,132700,34110,36.73311053563637,41.06204708278028,NaN,NaN,-130.30528933914664,-139.08926028761786,-0.0881151390472999,-0.32903625736089026,-0.24092111831359037,-1248000,-1235760,35.81704781576997,33.00730832867171,NaN,NaN,-19.192226453936286,-13.730444542133993
2001-09-05T09:30:00-04:00,27.38,27.45,27.10001,27.39,22800,34325,37.10570464213854,41.066627656623005,NaN,NaN,-160.48781726879207,-156.1410649314151,-0.08479645463641516,-0.34691668660910935,-0.2621202319726942,-1225200,-1231760,39.01465419236903,32.94073798722278,NaN,NaN,-20.252563339060895,-14.662175798837836
2001-09-06T09:30:00-04:00,27.10001,27.10001,26.59,26.59,20200,35060,29.597181428252597,40.326283636256726,NaN,NaN,-212.87407877092542,-175.65627938629228,-0.12693562820331622,-0.4207897672268395,-0.29385413902352325,-1245400,-1226060,43.346116550655104,32.96902753199996,NaN,NaN,-23.886672025656207,-15.979960974097603
2001-09-07T09:30:00-04:00,26.35001,26.44,25.8,26.07001,25800,35280,25.925013570023467,39.60793480232502,NaN,NaN,-240.66843159997438,-184.46446474767657,-0.17719900535688543,-0.51535289571963,-0.3381538903627446,-1271200,-1221020,46.93498631458615,33.516324494029774,NaN,NaN,-28.298268107442897,-17.739719136004073
2001-09-10T09:30:00-04:00,25.7,26.21001,25.64,25.73,24000,35290,23.841981753720262,38.43104071013529,NaN,NaN,-209.28532513341386,-190.72418842245048,-0.21802981112912712,-0.6106911542741535,-0.39266134314502643,-1295200,-1257000,31.56319980212433,33.094479499332344,NaN,NaN,-32.605257187432905,-19.863367429065335
2001-09-17T09:30:00-04:00,24,24.5,23.28,23.58,35000,36640,15.410234101470195,36.42744891897299,NaN,NaN,-304.19644513218753,-225.50241958105866,-0.3658204448814154,-0.8499368992467957,-0.4841164543653803,-1330200,-1273440,27.18250964424901,32.19561276153557,NaN,NaN,-41.10409957948205,-22.89775773626772
2001-09-18T09:30:00-04:00,23.45,23.58,23,23.14999,20000,37415,14.31947901887466,34.46242276818224,NaN,NaN,-251.60873767229623,-243.7266036617595,-0.46230447504015104,-1.0619970481655692,-0.5996925731254181,-1350200,-1298440,22.148361472309432,31.465910733060504,NaN,NaN,-47.669535453262846,-26.436583124409882
2001-09-19T09:30:00-04:00,23.05,23.36,22.16,22.77,39600,38415,13.415802571616013,32.21584751523942,NaN,NaN,-208.26626518196414,-242.80504094396724,-0.5173268227899557,-1.2463511016128628,-0.7290242788229071,-1389800,-1327320,18.000976327790042,30.57673680874755,NaN,NaN,-52.882951039639195,-30.214635683728353
2001-09-20T09:30:00-04:00,22.75,22.75,21.75,21.89999,17800,39040,11.609336153221292,29.208103463232643,NaN,NaN,-185.83665962495684,-231.83868654896372,-0.5735702680132858,-1.4459871138395144,-0.8724168458262286,-1407600,-1354600,15.120686812263259,29.367501668504406,NaN,NaN,-57.83125765414101,-34.1598673937873
2001-09-21T09:30:00-04:00,21,22.10001,21,21.96001,43600,40630,12.484829813810421,26.68018415139749,NaN,NaN,-163.01024461493517,-222.58367044526798,-0.5669710745974594,-1.5811306890730528,-1.0141596144755933,-1364000,-1368360,13.911552788056866,28.276833842761395,NaN,NaN,-61.10070220968906,-38.008558081773266
2001-09-24T09:30:00-04:00,22.60001,22.75,22.50999,22.64,1752100,127295,21.920540701380844,25.220018228639105,NaN,NaN,-111.73863003708776,-184.09210742624805,-0.48047199456783707,-1.6147496076853898,-1.1342776131175527,388100,-1024700,72.67719307395689,31.78146719573876,NaN,NaN,-60.32413027076176,-41.19649696591448
2001-09-25T09:30:00-04:00,22.72,22.8,22.32001,22.48,39400,128445,21.3375809051182,23.93586450054989,NaN,NaN,-99.72483050096349,-153.7153259919815,-0.4009387447999142,-1.6354510441174455,-1.2345122993175313,348700,-684920,84.1774659681979,36.14532540375078,NaN,NaN,-59.92530866100937,-43.872041493785176
2001-09-26T09:30:00-04:00,22.8,22.99001,22.5,22.69,32500,126005,24.18737114100712,23.276798283350598,NaN,NaN,-82.2299415395541,-128.50806126349948,-0.30541445075125884,-1.616280362756605,-1.310865912005346,381200,-330720,89.25477640668993,41.209644424997016,NaN,NaN,-58.67855939771983,-45.98725833720441
2001-09-27T09:30:00-04:00,22.75,23.05,22.50999,23.03999,7400,124305,28.8159664767998,22.621723772362078,NaN,NaN,-69.56560408444916,-105.25385015539796,-0.19524488521580663,-1.5549220185251045,-1.3596771333092978,388600,28520,92.04347665400157,45.085214558787165,NaN,NaN,-56.16790630273163,-47.441636617994014
2001-09-28T09:30:00-04:00,23.42999,23.5,23.27,23.5,17900,124660,34.47822424687145,22.46066046602172,NaN,NaN,-47.76031437791312,-82.20386410799354,-0.07420499594982144,-1.4524333782465746,-1.3782283822967532,406500,382620,93.76200693276567,49.224140210001146,NaN,NaN,-52.23360898352182,-48.1262040987837
2001-10-01T09:30:00-04:00,23.5,23.5,23.06,23.06,13100,124740,31.867143699226972,22.086477541528037,NaN,NaN,-48.620326749847735,-69.58020345054554,-0.009964316783601657,-1.3906837782762551,-1.3807194614926535,393400,383680,93.76634744576404,53.134975442386505,NaN,NaN,-49.74580267901727,-48.35757532453135
2001-10-02T09:30:00-04:00,23.16,23.50999,23.16,23.36,22500,124935,35.45622270864446,22.50498049012746,NaN,NaN,-39.61373911815574,-57.557985173983965,0.0625558972396536,-1.3025245899430864,-1.36508048718274,415900,397120,93.82501663038717,56.740611162367365,NaN,NaN,-46.57390081705227,-48.10276468060577
2001-10-03T09:30:00-04:00,23.25,24.31,23.25,24.23,149100,130955,44.57460689037466,23.837094298723972,NaN,NaN,-15.008912201363268,-44.11377930634581,0.17269742468948746,-1.1492087063208807,-1.3219061310103681,565000,433880,93.99158341930688,60.10179666984742,NaN,NaN,-40.685230668724635,-47.043116964622754
2001-10-04T09:30:00-04:00,24.3,24.45,24.10001,24.16,31300,131395,44.035555147221956,25.27949239825981,NaN,NaN,2.4533819929270964,-29.709982090870557,0.24026324532740584,-1.0215770743511108,-1.2618403196785166,533700,462900,94.12628481444371,64.57058845644166,NaN,NaN,-36.22086396168324,-45.49708082134568
2001-10-05T09:30:00-04:00,24.10001,24.16,23.72,23.89999,10200,122850,42.0036355933553,27.179021076251598,NaN,NaN,-3.677462438590424,-20.893411703006016,0.26492792296070933,-0.9306804159776298,-1.1956083389383392,523500,486300,94.23844909979476,69.36029841755206,NaN,NaN,-33.13741207928437,-43.73141385819407
2001-10-08T09:30:00-04:00,23.71001,23.83,23.53,23.72,34600,117945,40.60680150335683,29.056686968000328,NaN,NaN,-6.693511736311731,-12.508048700298815,0.26591289726684164,-0.8632172173547872,-1.1291301146216288,488900,505400,94.33356514898307,74.51638439445732,NaN,NaN,-31.000183900346677,-41.912666721358725
2001-10-09T09:30:00-04:00,23.39999,23.52,23.3,23.5,48700,119240,38.90382282924405,30.877259843545183,NaN,NaN,-12.428615797823223,-7.071024036232314,0.24884484428800513,-0.8180740592616225,-1.0669189035496276,440200,510260,94.3590834443863,79.97053490278563,NaN,NaN,-29.692228651341335,-40.16688985421338
2001-10-10T09:30:00-04:00,23.25,24.00999,23.25,24.00999,900,118275,44.6941748379057,33.240462606736926,NaN,NaN,25.69461139460014,1.0696806829603687,0.2673753277669648,-0.7326997438409215,-1.0000750716078863,441100,485480,92.08206511062103,85.46777620981119,NaN,NaN,-26.820650766448423,-38.260284270246956
2001-10-11T09:30:00-04:00,24.39999,24.78,24.39999,24.58,33600,118665,50.35724921412487,35.945635421045104,NaN,NaN,118.27505965605353,24.234016215585658,0.31046781940116674,-0.611990297356428,-0.9224581167575947,474700,473680,90.95647102010541,90.9709846549575,NaN,NaN,-22.547126532216343,-36.015547450528295
2001-10-12T09:30:00-04:00,24.5,24.52,23.89999,24.36,19400,118435,48.30151469445725,37.829990706264844,NaN,NaN,105.92925174507707,46.155359052319156,0.31557211072927926,-0.5279929783459956,-0.8435650890752748,455300,460040,89.59314852975426,92.17926718751447,NaN,NaN,-19.619956108873676,-33.67332011600621
2001-10-15T09:30:00-04:00,24.2,24.45,24.10001,24.45,7800,117075,49.21488312825324,39.821226579345925,NaN,NaN,106.66932313712371,68.82792602700624,0.31566278178286056,-0.4489866118466992,-0.7646493936295597,463100,454880,89.04937770708918,92.52726088314955,NaN,NaN,-16.961843612399868,-31.285966329776734
2001-10-16T09:30:00-04:00,24.5,24.85001,24.45,24.69,29000,117525,51.6671299456379,41.78406649396241,NaN,NaN,123.67841252735724,96.04933169204233,0.3214594498928237,-0.3628250812635301,-0.6842845311563538,492100,465260,89.1914924608058,92.5227406013007,NaN,NaN,-14.004566806439858,-28.817194969300036
2001-10-17T09:30:00-04:00,24.7,24.85001,23.95,23.95,45100,117800,44.527705508360164,42.90633356764529,NaN,NaN,75.1041941526197,105.93124824364625,0.2672546738411564,-0.35021618885490824,-0.6174708626960647,447000,466440,89.20863779575647,92.32025211142604,NaN,NaN,-13.436766399404245,-26.619990887886352
2001-10-18T09:30:00-04:00,23.75,23.75,23.5,23.57001,13700,117595,41.36670257473473,43.39836773392124,NaN,NaN,5.595299528324321,83.39529621810041,0.20064952862914387,-0.3666589519096348,-0.5673084805387787,433300,458160,88.1519536326649,91.91953401856169,NaN,NaN,-13.922652955982834,-24.806085469042994
2001-10-19T09:30:00-04:00,23.39999,23.64999,23.36,23.49001,24100,116620,40.711442695177084,44.0301033764891,NaN,NaN,-18.774766655936304,58.454492537897735,0.1484509641399836,-0.38174477536379925,-0.5301957395037828,409200,448940,86.91734303557733,91.43031941783408,NaN,NaN,-14.509332807151768,-23.335120803058533
2001-10-22T09:30:00-04:00,23.55,24.14999,23.55,24.14999,13200,29675,48.02579685152894,44.92793010098085,NaN,NaN,33.262723815367806,43.77317267354655,0.15490394544659497,-0.3365658076955391,-0.4914697531421341,422400,440800,85.77515466042476,90.85532927712248,NaN,NaN,-12.805934588054535,-21.83095134377225
2001-10-23T09:30:00-04:00,24.33,24.64999,24.16,24.3,32000,29305,49.549310426840634,45.28326606787128,NaN,NaN,84.45729241249089,35.928948650573275,0.16488215200298284,-0.28536706313840554,-0.4502492151413884,454400,433260,84.66529430006219,90.18916576860501,NaN,NaN,-10.960070966039147,-20.27796843266752
2001-10-24T09:30:00-04:00,24.35001,24.35001,23.89999,23.91,15200,28440,45.791199553877625,45.40866923977526,NaN,NaN,30.646035789868243,27.037316978022982,0.14170885096025765,-0.2731131514410663,-0.41482200240132394,439200,431700,84.421905875857,89.49599584442024,NaN,NaN,-10.492323862096322,-18.880019208300208
2001-10-25T09:30:00-04:00,23.55,24.2,23.55,24.05,6800,28410,47.33538342679508,45.78950837073524,NaN,NaN,1.9846436392859674,26.31518580021531,0.13247198862583032,-0.24923201661903605,-0.38170400524486636,446000,434240,84.5000360847236,88.8003949147723,NaN,NaN,-9.661722837296026,-17.563119726728182
2001-10-26T09:30:00-04:00,24,24.45,24,24.25999,8300,27930,49.652063955068414,46.4355985458575,NaN,NaN,54.85954178123189,41.04204748764896,0.13661909549903406,-0.2109301358710738,-0.34754923137010785,454300,443260,84.79173962854458,88.11883594902669,NaN,NaN,-8.302268502574384,-16.240140980420495
2001-10-29T09:30:00-05:00,24.02,24.13,23.64,23.64,17600,28155,43.55949057782533,46.768146242184734,NaN,NaN,-41.643590747093526,26.060784575156696,0.09565884961671856,-0.22797566934920965,-0.3236345189659282,436700,446120,84.88884713359714,87.44239049825605,NaN,NaN,-8.907647242159403,-15.192641874954624
2001-10-30T09:30:00-05:00,23.5,23.56,23.25999,23.31,5200,27290,40.69702628720514,46.48263563142041,NaN,NaN,-136.0307027971084,-18.03681446676317,0.04686185113704083,-0.26505720504462715,-0.311919056181668,431500,441540,83.96425156782536,86.86254667377064,NaN,NaN,-10.29194214833861,-14.492541914009479
2001-10-31T09:30:00-05:00,23.5,23.75,23.45,23.62,11200,20395,44.393720767101584,46.05666931377589,NaN,NaN,-78.15332545328853,-39.79668671539452,0.036447444451374045,-0.26635975061745043,-0.3028071950688245,442700,442240,83.99294812318618,86.36515218113355,NaN,NaN,-10.365871044598366,-13.903017504093606
2001-11-01T09:30:00-05:00,23.47,23.95,23.47,23.95,5300,19095,48.10241609174852,46.04244798501098,NaN,NaN,-35.893305094703116,-47.37227646219234,0.05182972529316443,-0.23802003845236896,-0.2898497637455334,448000,442640,84.01055654836347,85.9663956110342,NaN,NaN,-9.321808134831642,-13.248559022770468
2001-11-02T09:30:00-05:00,24,24.3,24,24.08,569000,47035,49.5304574476844,46.06498900782749,NaN,NaN,33.523980313943504,-51.63938875565002,0.06969284234098483,-0.20273371081930236,-0.2724265531602872,1017000,555180,88.00765524319999,85.89198686361355,NaN,NaN,-8.047533904034273,-12.505555434379584
2001-11-05T09:30:00-05:00,24.39999,24.7,24.3,24.45,27200,46665,53.456005957045825,46.1927658657852,NaN,NaN,96.36365870826438,-24.03793886457843,0.10333188057904613,-0.1432617024364795,-0.24659358301552564,1044200,676680,90.70826768743228,86.00032795122972,NaN,NaN,-5.785337234269402,-11.545524262935272
2001-11-06T09:30:00-05:00,24.60001,24.75,24.35001,24.75,35100,45985,56.41607303206009,47.04193497462091,NaN,NaN,112.26521676292059,25.62124504742737,0.14039279589348524,-0.0711025881486691,-0.21149538404215434,1079300,806240,92.6174377714911,86.2438136637822,NaN,NaN,-2.9770458693170827,-10.321455920989816
2001-11-07T09:30:00-05:00,24.67,24.73,24.5,24.61,5600,46220,54.66876828263498,47.992082525185204,NaN,NaN,100.50380149080586,61.35267043624624,0.1492559273854273,-0.02492547481037022,-0.17418140219579753,1073700,932440,93.92649943880642,86.65628122136374,NaN,NaN,-1.1347808967302813,-9.009073774667026
2001-11-08T09:30:00-05:00,24.8,25,24.63,24.82001,18400,45460,56.82878304056443,49.1433211212843,NaN,NaN,134.5041537565182,95.43216220649052,0.1619772503237798,0.028290160708927203,-0.1336870896148526,1092100,1061260,94.9172424297279,87.2277026066602,NaN,NaN,1.0455232965477799,-7.572702764493483
2001-11-09T09:30:00-05:00,24.5,24.83,24.5,24.67,19200,45450,54.81941935371895,49.62857987144073,NaN,NaN,96.18109801970871,107.96358574764356,0.15310512589998387,0.057694317760127234,-0.09541080813985663,1072900,1072440,94.99357204883636,87.88616099154675,NaN,NaN,2.3348257009227544,-6.157341555148307
2001-11-12T09:30:00-05:00,24.3,24.78999,24.14999,24.73,32300,46675,55.497206285949886,50.05342957566283,NaN,NaN,71.86182002201016,103.06321801039272,0.14421712845341123,0.0848606024269074,-0.05935652602650381,1105200,1084640,95.08039344813396,88.63009664498045,NaN,NaN,3.595066203685516,-4.764140446743475
2001-11-13T09:30:00-05:00,25,25.56,25,25.45,17100,46080,62.723873968132985,51.26290631953821,NaN,NaN,187.31707832639358,118.0735903230873,0.17757606372832868,0.16261355363390706,-0.014962510094421635,1122300,1093240,95.1443186769011,89.39598327362647,NaN,NaN,6.957488076170501,-3.0896220863271933
2001-11-14T09:30:00-05:00,26.10001,26.10001,25.7,25.75,11400,44395,65.25555848646871,52.54291882380066,NaN,NaN,214.46641220487092,140.86611246590033,0.2084576768912407,0.24560958601962923,0.03715190912838854,1133700,1105240,95.23731405039942,90.16293169974617,NaN,NaN,10.594356165663605,-1.134768050328508
2001-11-15T09:30:00-05:00,26,26.35001,25.85001,26.05,115100,49465,67.62361393787899,53.82660096542999,NaN,NaN,204.43730247048697,154.85274220869405,0.2356925701443215,0.3317676218087904,0.0960750516644689,1248800,1136580,95.48074747324128,90.92643226008165,NaN,NaN,14.416996338990254,1.0869125767170293
2001-11-16T09:30:00-05:00,26.39999,26.39999,25.89999,26.05,25200,49520,67.623613937879,55.54546691971954,NaN,NaN,177.99474497514208,171.21547159978073,0.2395315817104078,0.3954895288024787,0.15595794709207086,1248800,1171760,95.74373687963174,91.70178152765554,NaN,NaN,17.505462720273833,3.4324197400822865
2001-11-19T09:30:00-05:00,26.45,26.67,26.3,26.5,77800,52750,71.05550246743968,57.713929504022005,NaN,NaN,179.80831643709502,192.8047708827977,0.25667726834964705,0.4768045325291297,0.22012726417948264,1326600,1216040,96.0549252393319,92.5654010756203,NaN,NaN,21.299087182116747,5.984800803230067
2001-11-20T09:30:00-05:00,26.55,26.73,26.37,26.5,10100,51655,71.05550246743968,59.618342482617585,NaN,NaN,149.25902508497626,185.19316023451424,0.2519615477730773,0.5350791988958292,0.28311765112275195,1326600,1256900,96.3221429013001,93.44605784548558,NaN,NaN,24.3769949630079,8.612257111769758
2001-11-21T09:30:00-05:00,26.3,26.3,26,26.24001,12700,51530,66.34338684083659,60.921268964695294,NaN,NaN,102.68903167147644,162.83768412783533,0.2166245007945513,0.5538982771159411,0.3372737763213898,1313900,1292940,96.54447158370655,94.34133749086722,NaN,NaN,25.73036870885097,11.057701625638503
2001-11-23T09:30:00-05:00,26.14999,26.5,26.14999,26.35001,59300,54155,67.33053197907826,62.19270285979486,NaN,NaN,99.33889141469729,141.8180019166774,0.1870651924352268,0.5711052668654233,0.3840400744301965,1373200,1317820,96.69309021834671,94.96172570337771,NaN,NaN,27.139750682465507,13.355137205185217
2001-11-26T09:30:00-05:00,26.60001,26.75,26.5,26.69,34600,55470,70.23626781573167,63.391292992558135,NaN,NaN,106.67027955905374,127.55310883345973,0.1769278715861186,0.6051999139128448,0.42827204232672617,1407800,1349620,96.87791690717016,95.40241493335897,NaN,NaN,29.216132739916205,15.620993710146786
2001-11-27T09:30:00-05:00,26.64999,26.8,26.39999,26.60001,87100,58945,68.49960726084217,64.25440258032828,NaN,NaN,92.83227808195358,110.15790116243144,0.15165171785553944,0.6178366896461505,0.466184971790611,1320700,1348440,96.66202428907415,95.6913139703292,NaN,NaN,30.473849122623786,17.7428301976435
2001-11-28T09:30:00-05:00,26.28,26.45,26.10001,26.19,38600,60615,61.088275414976074,64.71293880406692,NaN,NaN,62.23843801769396,92.753783748975,0.09744328099229149,0.5879890730309754,0.49054579203868387,1282100,1339540,94.94344074011596,95.76395263470845,NaN,NaN,29.446220772024194,19.41474313684074
2001-11-29T09:30:00-05:00,26.14999,26.25,25.89999,26.25,21800,61145,61.74063555005496,65.06378541188768,NaN,NaN,48.28563831177459,81.87310507703464,0.0577151926313324,0.5626897828278494,0.504974590196517,1303900,1337540,94.53667929657546,95.736769553769,NaN,NaN,28.77506327112077,20.751931727452174
2001-11-30T09:30:00-05:00,26.25,26.60001,26.2,26.36,25200,62140,62.96646000320791,65.64571688685119,NaN,NaN,62.86015925037699,74.57735864417057,0.03220505681237085,0.5452309112119806,0.5130258543996098,1329100,1328720,92.6515090210251,95.56947933749676,NaN,NaN,28.535733949544888,21.86390347346542
2001-12-03T09:30:00-05:00,26.2,26.55,26.14,26.38,7200,34050,63.19734286596228,66.19572664256636,NaN,NaN,56.14125492050318,64.47155371646048,0.011126750089867521,0.5269342920119442,0.5158075419220767,1336300,1314420,89.53412038971727,95.17331697618127,NaN,NaN,28.395615833131636,22.797005239132023
2001-12-04T09:30:00-05:00,26.3,26.72,26.3,26.72,17700,33575,66.96759403260808,66.49884950431458,NaN,NaN,73.64385165149933,60.63386843036962,0.014327479962360501,0.5337168918750272,0.5193894119126667,1354000,1321080,89.70780814343715,94.78499479521956,NaN,NaN,29.296582427942504,23.72551626610495
2001-12-05T09:30:00-05:00,26.96001,27.8,26.96001,27.64999,33900,33515,74.62499364627884,67.16809487287244,NaN,NaN,159.13469242076718,80.01311931098425,0.07019718031142141,0.6071358873019435,0.536938706990522,1387900,1342240,90.26082907478519,94.42953158267571,NaN,NaN,32.72694495722884,25.01143465055122
2001-12-06T09:30:00-05:00,27.64999,28.03,27.55,27.75,31000,34785,75.28841811273922,67.71558088536246,NaN,NaN,189.18473944257727,108.1929395371448,0.10302261078633435,0.66571697047344,0.5626943596871057,1418900,1365240,90.83714593076147,94.09784575821287,NaN,NaN,35.676059646954876,26.534952507180314
2001-12-07T09:30:00-05:00,27.7,27.89999,27.46001,27.59,11100,34420,72.04323098469051,68.03126781727757,NaN,NaN,162.87712444281453,128.1963325756323,0.10285553590033047,0.6912637795625187,0.5884082436621882,1407800,1380980,91.22005250942273,93.77472544605507,NaN,NaN,37.11247052627753,28.046026509908486
2001-12-10T09:30:00-05:00,27.5,27.53999,26.85001,26.96001,30200,34970,60.91049179094917,67.30662419752824,NaN,NaN,91.43309801974377,135.25470119548044,0.05179006377723727,0.6531458233837348,0.6013557596064976,1377600,1389240,91.42262317308644,93.44384672703755,NaN,NaN,34.72274281475231,28.999843124886176
2001-12-11T09:30:00-05:00,26.99001,27.39999,26.95,27.14999,29000,34805,62.77842977875479,66.71540471976503,NaN,NaN,89.26923574049684,138.37977801327992,0.02370992853130427,0.630993170270628,0.6072832417393237,1406600,1399760,91.68572824710876,93.11267425173817,NaN,NaN,33.371002358473,29.624294443970008
2001-12-12T09:30:00-05:00,27.05,27.2,26.85001,27.03,34000,35650,60.802173752406205,66.31960378487715,NaN,NaN,59.10742344509678,118.37432421814583,-0.008327036746890726,0.5968744458057103,0.605201482552601,1372600,1396700,90.81313117079296,92.7032927936729,NaN,NaN,31.661906521527484,29.915381883621077
2001-12-13T09:30:00-05:00,26.64999,26.87,26.45,26.45,22800,36220,52.241363257154354,65.24180601902545,NaN,NaN,-13.48290595894308,77.84079513784177,-0.07050242030594756,0.5170734571701665,0.5875758774761141,1349800,1382880,86.7954075235427,91.99631545832975,NaN,NaN,27.27609585244647,29.538341022024703
2001-12-14T09:30:00-05:00,26.45,26.67999,26.25,26.39999,62200,33575,51.56717273511722,63.90829922755297,NaN,NaN,-40.924191085285926,37.080532032221676,-0.11432523129536909,0.4446693383569027,0.5589945696522718,1287600,1358840,80.1524804944882,90.80164142885246,NaN,NaN,23.594694190854515,28.68924861757182
2001-12-17T09:30:00-05:00,26.55,26.7,26.39999,26.64999,10000,32815,54.713505705713246,62.92357768790091,NaN,NaN,-22.514765770494645,14.29095927417398,-0.12494123353105058,0.40281802773845854,0.5277592612695091,1297600,1342840,75.98420639445821,89.3246544363799,NaN,NaN,21.444030786268005,27.654217498814134
2001-12-18T09:30:00-05:00,26.75,27.05,26.75,27.03999,66400,32245,59.16963148668598,62.78653169302305,NaN,NaN,34.85244521738312,3.407601169551249,-0.10496810370467269,0.39654913163866823,0.5015172353433409,1364000,1334320,73.78379154611687,87.81325092252283,NaN,NaN,20.96672681995454,26.69886168754848
2001-12-19T09:30:00-05:00,26.7,27.09,26.7,26.89999,16000,32540,57.00131955321668,62.44800912182031,NaN,NaN,23.372360637775337,-3.739411391913039,-0.10045344126344691,0.37595043376403225,0.47640387502747916,1348000,1329400,72.4785203777347,86.23766814260561,NaN,NaN,19.914636030652776,25.729686593706237
2001-12-20T09:30:00-05:00,26.64999,26.85001,26.57001,26.57001,21300,32970,52.150392510789885,61.67543287236189,NaN,NaN,-20.557757726744683,-5.154381745473354,-0.11775963882404872,0.32920432649741826,0.446963965321467,1326700,1324780,71.20469480890651,84.70575284174002,NaN,NaN,17.503878045643656,24.554571086840156
2001-12-21T09:30:00-05:00,26.55,26.64999,26.35001,26.48,80900,34050,50.87846700118344,60.795513167734825,NaN,NaN,-52.6347025143823,-7.496484031292629,-0.1322527863966922,0.28164798232560173,0.4139007687222939,1245800,1316420,68.84675295807733,83.22808373948,NaN,NaN,15.159138259420118,23.212366397208722
2001-12-24T09:30:00-05:00,26.50999,26.8,26.50999,26.60001,4200,32530,52.540496190657,59.765006179024034,NaN,NaN,-26.971662541681518,-8.387863385530002,-0.1305185973830001,0.2507525219935438,0.3812711193765439,1250000,1306900,66.15995495651742,81.5460942261286,NaN,NaN,13.681883678758739,21.850868866001584
2001-12-26T09:30:00-05:00,26.75,27,26.72,26.8,30400,29695,55.257336408794814,58.38160209063232,NaN,NaN,7.199621574190622,-13.918428114168503,-0.11330272218968229,0.23964271663944103,0.3529454388291233,1280400,1290180,61.6121490657607,79.4997599397697,NaN,NaN,13.194174566493913,20.614198251786203
2001-12-27T09:30:00-05:00,26.75,27.12,26.75,27.10001,375200,46525,59.044908747088755,57.22135142165728,NaN,NaN,29.02477820025681,-12.787944601672207,-0.08064442809689965,0.25213990370799877,0.3327843318048984,1655600,1351700,69.82982908332424,77.9992373078099,NaN,NaN,13.880220001592974,19.652201358901454
2001-12-28T09:30:00-05:00,27.11,27.49001,27.11,27.37,28600,46865,62.15018005548854,56.51470492671428,NaN,NaN,83.7470746842031,8.073021880517349,-0.04175112805239961,0.2805954217393989,0.3223465497917985,1684200,1423200,76.20527441226731,76.92675315801308,NaN,NaN,15.40208195250487,19.04504144370194
2001-12-31T09:30:00-05:00,27.3,27.5,26.95,26.95,27100,46960,55.14550396375054,56.10292008191438,NaN,NaN,40.75018469707732,26.749999322809277,-0.044927088717298,0.26618768889517597,0.31111477761247397,1657100,1505460,81.14251123885722,76.1924594484253,NaN,NaN,14.591660605354878,18.40884418108093
2002-01-02T09:30:00-05:00,27.2,27.2,26.8,27.17999,182900,55745,57.94094009283042,55.75738510434835,NaN,NaN,20.014010270767276,36.14713388529903,-0.03272151664390616,0.2702128818075913,0.30293439845149744,1840000,1623460,85.71985765301166,75.76632583456121,NaN,NaN,14.770383702427397,17.889064112701853
2002-01-03T09:30:00-05:00,27.2,27.3,27.05,27.3,9300,55325,59.364077649855176,55.65466395416613,NaN,NaN,49.06091930079656,44.51939343062021,-0.018459021808154785,0.27986062119130395,0.29831964299945873,1849300,1737240,88.59465352208147,75.60786314536753,NaN,NaN,15.342085139582482,17.5252099736848
2002-01-04T09:30:00-05:00,27.64,27.8,27.42999,27.62,51000,56180,62.962757330795945,56.4204778165691,NaN,NaN,135.07240325426721,65.7289184414223,0.009150015250358856,0.30975716206240733,0.3006071468120485,1900300,1786180,89.56750261647639,75.80586993771995,NaN,NaN,16.938515250201032,17.441396441758545
2002-01-07T09:30:00-05:00,28.05,28.10001,27.64999,27.64999,25600,55910,63.29086650520212,57.257884514432305,NaN,NaN,174.85191740413262,83.9498869854082,0.025148479644852006,0.3320427463681135,0.3068942667232615,1925900,1834520,90.43533183413646,76.54035931912338,NaN,NaN,18.326011022137724,17.567769953241285
2002-01-08T09:30:00-05:00,27.64999,27.95,27.64999,27.8,32200,56965,64.96286816029564,57.98998183261676,NaN,NaN,168.98677944960554,109.59720593591385,0.040633073627211413,0.35768560875727573,0.3170525351300643,1958100,1894720,91.3952988342995,77.64115163625492,NaN,NaN,19.98181463731439,17.912633479537444
2002-01-09T09:30:00-05:00,27.7,28.09,27.62,27.64999,20100,56460,61.925371068825285,58.18682037419815,NaN,NaN,142.33221070728123,134.06084602321664,0.0357446690943411,0.3617333714979907,0.3259887024036496,1938000,1914320,91.68781239000441,78.92001026796117,NaN,NaN,20.542002787102202,18.28825766633241
2002-01-10T09:30:00-05:00,27.64999,27.78999,27.45,27.73,10000,55510,62.92120078913271,58.60966903390643,NaN,NaN,103.87611605495003,145.02388537404732,0.032940991726084,0.3671649420612546,0.3342239503351706,1948000,1934060,91.98339340544197,80.31321548422598,NaN,NaN,21.286286743751305,18.71654753453511
2002-01-11T09:30:00-05:00,27.60001,27.75,27.55,27.55,5300,54075,59.17167629612127,59.111189304287244,NaN,NaN,85.1632615785991,135.0420570389137,0.014922644404576357,0.352877255840891,0.33795461143631467,1942700,1942540,92.11314080859631,81.80667591277525,NaN,NaN,20.90222338343241,19.028786941520437
2002-01-14T09:30:00-05:00,27.39999,27.60001,27.31,27.35001,77400,56805,55.233440225323946,59.42225882029727,NaN,NaN,46.557703937810416,109.38321434564928,-0.012997138570845723,0.3217081882227575,0.3347053267936032,1865300,1930420,89.87424034512223,83.30863929756416,NaN,NaN,19.46344290967261,19.090880651256462
2002-01-15T09:30:00-05:00,27.60001,27.73,27.41,27.69,14900,54440,60.09581934026284,59.96192475955484,NaN,NaN,71.10928150341374,89.80771475641092,-0.011169463216509634,0.3207434977729662,0.3319129609894758,1880200,1914840,86.94857152248625,84.79354048084765,NaN,NaN,19.578321264634727,19.160515024596215
2002-01-16T09:30:00-05:00,27.45,27.57001,27,27.00999,86000,58240,48.701863865341956,59.49367672073678,NaN,NaN,-7.9026194870153885,59.7607487175516,-0.055861026675281034,0.2620866776453745,0.31794770432065556,1794200,1886080,81.66380672604569,86.22580174229657,NaN,NaN,15.90675612613102,18.69569232481547
2002-01-17T09:30:00-05:00,27.2,27.2,26.8,27.17999,58800,57860,51.19318127848814,58.93283904440816,NaN,NaN,-34.770997461229804,32.03132601431561,-0.07299417118790374,0.22670499033577585,0.2996991615236796,1853000,1867080,78.27882063517202,86.82930113885712,NaN,NaN,13.718516464464667,17.984667201908213
2002-01-18T09:30:00-05:00,26.95,27.2,26.89999,26.97,20600,58090,48.08657847407366,57.92829607430709,NaN,NaN,-43.76678847978347,6.245316002639098,-0.09603979044658173,0.17964942346545243,0.27568921391203416,1832400,1845020,74.42169811939337,86.70190283222327,NaN,NaN,10.916119840914948,16.97487472176632
2002-01-22T09:30:00-05:00,27,27.09,26.67999,26.89999,1036000,108825,47.06120332786198,57.35084602888649,NaN,NaN,-74.29929197225717,-17.926083179374412,-0.11243105419931929,0.13515039616288504,0.24758145036220433,796400,1631240,49.147905312767065,84.41657383750255,NaN,NaN,8.34300060731974,15.741749848273951
2002-01-23T09:30:00-05:00,26.95,26.95,26.50999,26.8,908500,150205,45.566730736585434,56.46697393201184,NaN,NaN,-108.32320029448958,-53.812579538955085,-0.12544924015228928,0.09076990017184272,0.216219140324132,-112100,1232780,29.225680980575376,80.3812755037571,NaN,NaN,5.776135181640771,14.318090610183496
2002-01-24T09:30:00-05:00,26.8,27.14999,26.8,27.02,60900,153040,49.37592256838843,55.75353428333564,NaN,NaN,-65.80862188423255,-65.39378001839852,-0.11496387302946437,0.07251429903730156,0.18747817206676592,-51200,863700,20.810881738244547,75.53957751919731,NaN,NaN,4.676796288359136,12.940762849922873
2002-01-25T09:30:00-05:00,26.95,27.2,26.85001,27.05,28900,152965,49.890876629973995,54.81982851899121,NaN,NaN,-60.124289059293005,-70.46443833801115,-0.10215992465296977,0.05977826625055371,0.1619381909035235,-22300,488640,15.824600279277547,70.27222735225453,NaN,NaN,3.9207614281497967,11.652191218241004
2002-01-28T09:30:00-05:00,26.95,27.10001,26.88,27.10001,47700,136590,50.78952381216776,53.92687546948876,NaN,NaN,-62.39969196552824,-74.19101903516011,-0.08706410401036929,0.05310806089056186,0.14017216490093115,25400,127240,12.673542213783051,64.71781380794359,NaN,NaN,3.532550935827372,10.492242606467627
2002-01-29T09:30:00-05:00,26.95,27.05,26.39999,26.59,32700,136795,42.432083409540844,52.3175337015777,NaN,NaN,-124.12135215442456,-84.15543107159358,-0.10686386148194012,0.006592338048506008,0.11345619953044613,-7300,-33500,11.570026527023785,59.016008643138164,NaN,NaN,0.6409528709490326,9.084915501393542
2002-01-30T09:30:00-05:00,26.35001,26.55,25.85001,26.48,34800,137180,40.87000609036427,50.81357906025905,NaN,NaN,-177.916795941417,-98.07415020097906,-0.12172628721121118,-0.03870165948356785,0.08302462772764332,-42100,-19500,12.286394585544471,53.34447879996245,NaN,NaN,-2.220785151533635,7.469815408118231
2002-01-31T09:30:00-05:00,26.75,26.85001,26.60001,26.75,56900,130880,46.113754630249645,49.61304719176741,NaN,NaN,-87.46052442136974,-102.4045307084065,-0.10818682505873849,-0.05220890359577979,0.0559779214629587,14800,-6300,13.00200481832762,47.702951043739986,NaN,NaN,-3.150713581461215,5.9525969810354535
2002-02-01T09:30:00-05:00,27.05,27.05,26.7,26.7,24200,131625,45.312368702449795,48.6230966493623,NaN,NaN,-65.66984356828705,-103.51364161020531,-0.09773044356032651,-0.06618513298744944,0.03154531057287707,-9400,-3720,13.15114824543683,42.06280871780003,NaN,NaN,-4.141447813002977,4.510590581887106
2002-02-04T09:30:00-05:00,26.58,26.58,26.05,26.19,35100,130830,38.048982591124144,47.39563538977661,NaN,NaN,-145.18887040770352,-120.07147729864036,-0.11888799598958992,-0.11706468441411033,0.0018233115754795887,-44500,-17700,13.020889266942007,36.57328364078717,NaN,NaN,-7.36693868199689,2.8138006870465353
2002-02-05T09:30:00-05:00,26.10001,26.44,26.10001,26.33,70600,133080,40.8518716932726,46.02106770070587,NaN,NaN,-134.1120783123696,-122.0696225302294,-0.11699898460859795,-0.14442541918526786,-0.027426434576669906,26100,-11020,13.461956748745877,31.324239728377144,NaN,NaN,-9.158425747766255,1.1034826249304224
2002-02-06T09:30:00-05:00,26.45,26.49001,26.19,26.19,13800,132160,38.953885959335004,45.32478356456251,NaN,NaN,-121.97871141072575,-110.88200562409114,-0.1183661401320663,-0.17538410974175278,-0.057017969609686484,12300,-140,14.224893366727358,26.50717448842584,NaN,NaN,-11.21871049671745,-0.6568306781621305
2002-02-07T09:30:00-05:00,26.39999,26.95,26.39999,26.7,50600,133685,48.36520077245791,45.12278495698892,NaN,NaN,-44.9156344647223,-102.37302763276163,-0.07995126757931134,-0.15695705408382565,-0.07700578650451431,62900,9480,14.93896684378089,21.98289921761219,NaN,NaN,-10.03033192325981,-1.9959022846046561
2002-02-08T09:30:00-05:00,26.8,27.25,26.77,27.25,20800,134225,56.20636375356037,45.70276961980941,NaN,NaN,42.25595929620148,-80.78786705986394,-0.015880629967117227,-0.09685657396341085,-0.08097594399629363,83700,28100,16.389841749023702,17.837766619728633,NaN,NaN,-6.201025286218748,-2.5966341419780976
2002-02-11T09:30:00-05:00,27.25,27.53999,27.25,27.5,121200,140020,59.23656039994386,46.572437982100965,NaN,NaN,118.5833248726531,-28.033428003792615,0.04180275147694526,-0.028722504650112057,-0.07052525612705732,204900,77980,20.311127139600288,15.777996750216726,NaN,NaN,-2.0476784452924326,-2.5182118995944314
2002-02-12T09:30:00-05:00,27.39999,27.53999,27.16,27.25,34700,137885,55.1286422096814,47.25543165875068,NaN,NaN,96.75681134147877,18.14034992697706,0.06045475748869793,0.005043190733815095,-0.05541156675488283,170200,106800,22.57070305432714,15.302641184056133,NaN,NaN,-0.019676910101633933,-2.1612783296668887
2002-02-13T09:30:00-05:00,27.55,27.95,27.39999,27.7,209800,147630,60.44582372236941,48.04613888403503,NaN,NaN,174.18717484683933,77.37352717849008,0.09819946061806663,0.06733775901770045,-0.030861701600366175,380000,180340,28.16779908740517,15.828135280424748,NaN,NaN,3.5714590352676816,-1.3423158489619502
2002-02-14T09:30:00-05:00,27.85001,28,27.7,27.78,33500,145005,61.323277199265746,48.86273892469874,NaN,NaN,180.5217617143582,122.46100641430618,0.12209610465855089,0.12175842922282243,-0.0003376754357284559,413500,250460,33.13124873927974,17.064324456139193,NaN,NaN,6.668115870787034,-0.19796846042638117
2002-02-15T09:30:00-05:00,27.8,27.8,27.35001,27.35001,19900,143060,54.3450543586345,49.1167053923035,NaN,NaN,105.0974595842978,135.02930647192545,0.10323569988528455,0.12870694942087724,0.025471249535592686,393600,312440,37.25807900525989,18.82036279838754,NaN,NaN,7.021490697446348,0.8333828478411514
2002-02-19T09:30:00-05:00,27.25,27.39999,26.89999,26.89999,58900,144975,48.16730897694753,49.526364361403985,NaN,NaN,24.48554436995375,116.20975037138558,0.05705113599205942,0.09678516952566696,0.03973403353360754,334700,338400,38.9573573401391,20.776600713610062,NaN,NaN,5.202242215582006,1.4575056146612733
2002-02-20T09:30:00-05:00,27.05,27.55,27,27.55,22200,94285,55.955469103285836,50.60389743375553,NaN,NaN,71.82018120784306,111.22242434465844,0.06623270332519096,0.12252491269009624,0.05629220936490528,356900,375740,41.41515595882581,22.857226525987304,NaN,NaN,6.423913775996339,2.1669924948519967
2002-02-21T09:30:00-05:00,27.48,27.75,27.35001,27.35001,15300,49625,53.30180495695146,51.117329599948505,NaN,NaN,83.85531395892099,93.15605216707476,0.05523940418598247,0.12534146459738338,0.07010206041140091,341600,368060,41.049065981983254,24.86058803767699,NaN,NaN,6.465178775585155,2.781019106385305
2002-02-22T09:30:00-05:00,27.35001,27.64,27.25999,27.60001,16800,47420,56.10428151980081,51.88818051547357,NaN,NaN,78.31159850942521,72.71401952608815,0.060768585265856045,0.14606279199372096,0.08529420672786492,358400,357040,40.4959135879709,26.81378556214371,NaN,NaN,7.438248263139334,3.4463375573501667
2002-02-25T09:30:00-05:00,27.8,28.09,27.60001,28.08,27200,47335,60.94981753819275,53.523954440264184,NaN,NaN,127.74669400110774,77.24386640945015,0.0909028086480542,0.19892271753793267,0.10801990888987847,385600,355440,40.41076808931887,28.770205478027773,NaN,NaN,9.929743380588558,4.372538389241365
2002-02-26T09:30:00-05:00,28.00999,28.2,27.8,28,23300,46115,59.76564828669607,54.87493848265159,NaN,NaN,120.60675683418,96.46810890229538,0.0989348706324173,0.23168849718040008,0.13275362654798278,362300,360960,40.872662380593525,30.728113023159747,NaN,NaN,11.497993199750761,5.390460505028422
2002-02-27T09:30:00-05:00,28,28.13,27.71001,27.89999,24000,45680,58.24223572818214,56.252677751854954,NaN,NaN,98.00273884259767,101.7046204292463,0.09119018804543777,0.24674136160478,0.15555117355934223,338300,357240,40.644018285042186,32.61519337446795,NaN,NaN,12.292081650995133,6.376406383023666
2002-02-28T09:30:00-05:00,27.89999,28.19,27.8,27.98,21100,44995,59.13957020393285,57.02227556838887,NaN,NaN,100.97582232151035,105.12872210176417,0.08524355162218439,0.2621056130870727,0.1768620614648883,359400,360800,40.984259301063574,34.47557140713099,NaN,NaN,13.20151333530494,7.351421661920991
2002-03-01T09:30:00-05:00,28.05,28.50999,27.91,28.50999,130200,48660,64.57067390584646,57.61972629355218,NaN,NaN,132.9766872615503,116.0617398521892,0.10925801327559825,0.3134345780593861,0.20417656478378787,489600,387040,43.552667874715326,36.41577327325182,NaN,NaN,15.728269785866111,8.548114251056008
2002-03-04T09:30:00-05:00,28.60001,28.8,28.39999,28.8,140400,54470,67.14419239617871,58.1845571504261,NaN,NaN,162.75560369277403,123.06352179052246,0.13522864892281222,0.37321237593730316,0.23798372701449094,630000,435920,48.08518649415587,38.39963465572008,NaN,NaN,18.669169017285945,9.993979217660284
2002-03-05T09:30:00-05:00,28.85001,29.14,28.75999,28.75999,108100,58120,66.42730442690522,58.99160445165638,NaN,NaN,171.54518631684766,133.25120768705602,0.13969463403894067,0.4126020195631668,0.2729073855242261,521900,467840,50.86008404955309,40.42030472680765,NaN,NaN,20.817641574725336,11.540216697241005
2002-03-06T09:30:00-05:00,28.95,29.3,28.89,29.16,107200,59950,69.88875783152872,59.666099745167756,NaN,NaN,177.461613210866,149.14298256070967,0.15821046260177363,0.47067046377644317,0.31246000117466954,629100,526000,55.52474712679636,42.37437244390702,NaN,NaN,23.778128157735214,13.288489763025892
2002-03-07T09:30:00-05:00,29.17999,29.24001,28.75999,28.94,44800,61500,65.86646967925824,59.99061349373864,NaN,NaN,145.0012829746957,157.94807469134673,0.14463364712653498,0.4932520600828383,0.3486184129563033,584300,570980,58.78339771657834,44.20666879942835,NaN,NaN,25.053203751182668,14.96916318990543
2002-03-08T09:30:00-05:00,29.3,29.37,29.00999,29.24001,46700,61305,68.5266245091454,61.003582790203716,NaN,NaN,152.0396418345808,161.76066560595285,0.14450967723154712,0.5292555094957372,0.38474583226419007,631000,599260,60.73148531440124,45.88334067865272,NaN,NaN,26.955933290956434,16.681558918627
2002-03-11T09:30:00-05:00,29.2,29.25,29,29.10001,37600,62145,65.94390435526739,62.273339602940844,NaN,NaN,120.26916379886123,153.26337762717026,0.12441441198595593,0.540263847246635,0.4158494352606791,593400,591940,59.94174908006818,47.38222580293338,NaN,NaN,27.765730179316506,18.26501195586836
2002-03-12T09:30:00-05:00,28.89999,29.14,28.89,29,39900,58080,64.08575927112051,62.85407461492904,NaN,NaN,93.99643547573767,137.75362745894827,0.09512345549761936,0.5347537546327032,0.4396302991350839,553500,598260,60.42030346766562,48.739736339279084,NaN,NaN,27.903533551597214,19.641943612401054
2002-03-13T09:30:00-05:00,29,29.10001,28.85001,28.89999,31700,57930,62.19833976296028,63.48954138678682,NaN,NaN,77.7267503914074,117.80665489505654,0.06138749263202936,0.5163646649251206,0.4549771722930912,521800,576800,57.89129709963957,49.9427528476831,NaN,NaN,27.49129042027572,20.763278870668863
2002-03-14T09:30:00-05:00,28.95,29.2,28.95,29.10001,14300,48155,64.45321204475474,64.08589356714067,NaN,NaN,82.41485837281793,105.28936997468097,0.04564127996479794,0.5120287722490886,0.46638749228429066,536100,567160,56.74233364969703,51.10321142352068,NaN,NaN,27.758599281405733,21.762610357916987
2002-03-15T09:30:00-05:00,29.34,29.73,29.2,29.62,70700,50015,69.54003603772942,64.69948060282185,NaN,NaN,112.49587866798727,97.38061734136227,0.06231184887234359,0.5442773033747201,0.48196545450237654,606800,562320,56.13988853062881,52.2267200264714,NaN,NaN,29.543699959671677,22.874194586739087
2002-03-18T09:30:00-05:00,29.85001,30,29.64999,29.88,41200,51080,71.71925203604104,65.55330944206078,NaN,NaN,129.84310602394913,99.29540578637987,0.08169275396066333,0.5840813969532057,0.5023886429925424,648000,573240,57.24290116434248,53.39602279673917,NaN,NaN,31.729362949146434,24.139218638511565
2002-03-19T09:30:00-05:00,30.10001,30.10001,29.8,29.85001,82700,52270,71.08749237903307,66.47082777426442,NaN,NaN,128.56441221215795,106.20900113366395,0.08306378754749644,0.606218377426913,0.5231545898794165,565300,575600,57.49170580775016,54.59942904836117,NaN,NaN,33.31479336710396,25.450015028310478
2002-03-20T09:30:00-05:00,29.75,30.09,29.75,29.86,24200,52370,71.17856868097061,67.33075623690998,NaN,NaN,119.3029578027118,114.52424261592482,0.0754368217657726,0.6174506170866323,0.5420137953208597,589500,589140,58.96698765035688,55.88390964473926,NaN,NaN,34.637803914369755,26.76255629774752
2002-03-21T09:30:00-05:00,29.89999,29.89999,29.45,29.67,85800,55895,66.86449094340193,67.49460031102107,NaN,NaN,91.38308911349354,116.31788876405994,0.04963507208629703,0.604057635428731,0.554422563342434,503700,582660,57.93076845274193,56.91091682888402,NaN,NaN,34.59979824048129,27.88216228956663
2002-03-22T09:30:00-05:00,29.55,29.7,29.35001,29.50999,63800,58245,63.38053370759495,67.2257675475508,NaN,NaN,70.13574777344553,107.8458625851516,0.015595053685817595,0.573916380449706,0.5583213267638885,439900,549280,52.78501093211353,57.24661857445243,NaN,NaN,33.6021933402078,28.69930958251537
2002-03-25T09:30:00-05:00,29.55,29.64999,29.07001,29.07001,45400,59155,54.90850555558474,66.40299619959934,NaN,NaN,31.350910994698065,88.14742357930137,-0.039726693555121706,0.5086629598199863,0.548389653375108,394500,498580,46.088630187999385,56.9058004414843,NaN,NaN,30.137386540393564,28.90474914792654
2002-03-26T09:30:00-05:00,29.2,29.5,28.86,28.89999,76900,61835,52.01507863703521,65.12630482856409,NaN,NaN,-1.7627176726382618,62.08199760234214,-0.08816859703772262,0.4381789070779547,0.5263475041156773,317600,449040,40.66066860716552,55.84408054722496,NaN,NaN,26.346281653119703,28.539253791525564
2002-03-27T09:30:00-05:00,28.85001,29.39,28.85001,29.33,13900,61330,58.037819388911934,64.56711552211077,NaN,NaN,5.34192309076423,39.28979065995263,-0.09126547622247527,0.41226565883758326,0.5035311350600585,331500,397440,35.915966940684726,54.210692634661136,NaN,NaN,24.76654167506419,28.000294917745368
2002-03-28T09:30:00-05:00,29.2,29.64,29.2,29.59,20400,61295,61.20818236391067,64.044369654594,NaN,NaN,49.82423359459721,30.978019556173372,-0.07642025767644373,0.4080058129645039,0.4844260706409476,351900,367080,33.44322235283279,52.261530994549105,NaN,NaN,24.409149007181508,27.4872740733791
2002-04-01T09:30:00-05:00,29.10001,29.46001,28.89999,29.32001,24700,56020,56.43955350812955,63.36548745122702,NaN,NaN,-12.709133178484702,14.409043365787323,-0.0847560371769513,0.3784810241697585,0.4632370613467098,327200,344540,31.69834421276431,50.24414493259883,NaN,NaN,22.608543599997837,26.790312577181776
2002-04-02T09:30:00-05:00,29.3,29.3,29.06,29.14999,41000,51050,53.607220300981155,62.617020381931354,NaN,NaN,-33.74579047989628,1.3897030708684555,-0.10061121382186644,0.3374730440693767,0.43808425789124317,286200,322880,30.074499065836193,48.0765874753253,NaN,NaN,20.24315959603368,25.855005008446334
2002-04-03T09:30:00-05:00,29.25,29.25,28.7,28.77,22800,46785,47.83001108354006,61.59071119054419,NaN,NaN,-99.27004865874281,-18.11176312635245,-0.1335187299267423,0.2711858454828153,0.4047045754095576,263400,312040,29.266457493421797,46.031956074881165,NaN,NaN,16.32292882272074,24.493279839056964
2002-04-04T09:30:00-05:00,28.85001,29.19,28.85001,29.17999,27400,42795,53.63582513398437,60.81804069691774,NaN,NaN,-57.152497606202104,-30.61064726574572,-0.12467026141885401,0.24886674863599012,0.37353701005484413,290800,303900,28.644085459353775,44.02493834699951,NaN,NaN,14.800817851450226,23.108642412256
2002-04-05T09:30:00-05:00,29.39999,29.60001,29.23,29.53,14800,41295,57.93922336513394,59.98941122030377,NaN,NaN,31.042330469587817,-34.36702789074759,-0.09365743677592869,0.2564652140849333,0.350122650860862,305600,294640,27.91678056443908,42.009002063700244,NaN,NaN,14.935723078534258,21.941082507438608
2002-04-08T09:30:00-04:00,29.25,29.66,29.25,29.64999,52900,41605,59.332774253631676,59.10466280727453,NaN,NaN,42.98743568405817,-23.22771411823902,-0.06484404140451622,0.2690675991052167,0.33391164050973293,358500,300900,29.2250853616475,40.00772950636489,NaN,NaN,15.486244945385344,21.018962855716712
2002-04-09T09:30:00-04:00,29.75,29.89999,29.63,29.69,90100,44230,59.81092162593065,58.299193467767225,NaN,NaN,86.66599999841826,0.8546439774238876,-0.043875995552883795,0.2790666460686282,0.322942641621512,448600,333380,35.741813368896246,38.45416576073246,NaN,NaN,16.070379809880855,20.312022420597305
2002-04-10T09:30:00-04:00,29.78,30.03999,29.64999,29.96001,313200,57895,62.97473852832215,57.7132055997209,NaN,NaN,109.34195514128386,42.57704473742922,-0.014146377455039716,0.30525966980271235,0.31940604725775207,761800,433060,50.73424496197708,37.86611271156248,NaN,NaN,17.534806567452428,19.915277298719467
2002-04-11T09:30:00-04:00,29.85001,29.98,29.46001,29.46001,174000,65010,54.429699163316464,56.82500618685766,NaN,NaN,45.482184302601844,63.10398111919001,-0.029591648180185226,0.28241648703252054,0.31200813521270576,587800,492460,57.15012543282402,37.810352495854055,NaN,NaN,16.12048526223114,19.373164150649707
2002-04-12T09:30:00-04:00,29.7,29.73,29.5,29.56,27100,65650,55.723571778978005,56.27808033481359,NaN,NaN,31.638896969277862,63.223294419128024,-0.034184591957098776,0.2692773952663323,0.3034619872234311,614900,554320,62.61101013649451,38.51220958188127,NaN,NaN,15.377142070670754,18.802303853509855
2002-04-15T09:30:00-04:00,29.69,29.69,29.45,29.53999,76300,65930,55.384669571009326,56.31209205020105,NaN,NaN,20.985990585380943,58.82300539939257,-0.039314943803326674,0.25431830746927275,0.2936332512725994,538600,590340,65.3778614329301,39.890011813662035,NaN,NaN,14.6810746536207,18.21355682495426
2002-04-16T09:30:00-04:00,29.7,29.78,29.57001,29.74001,55000,66620,58.12617496030984,56.74859893043496,NaN,NaN,61.13273151799528,53.71635170330798,-0.03038178381546608,0.25565602150326683,0.2860378053187329,593600,619340,67.46536397058537,41.804632911049175,NaN,NaN,14.879875098016962,17.737316578248933
2002-04-17T09:30:00-04:00,29.8,29.88,29.74001,29.81,164400,70705,59.073836550441946,56.82260015625853,NaN,NaN,95.43900717438002,50.93576210992721,-0.021331142668704228,0.25937387698285264,0.28070501965155686,758000,618580,67.35075572278517,44.049974966913496,NaN,NaN,15.311380942210807,17.3907543445292
2002-04-18T09:30:00-04:00,30.10001,30.19,29.66,30.12,192400,79115,63.061349058358516,56.954969205861936,NaN,NaN,142.40433446172793,70.32019214175243,0.0026841793099486866,0.28406024378899275,0.28137606447904406,950400,691100,72.20318227874805,46.818543533050295,NaN,NaN,16.86344156177017,17.315423946992194
2002-04-19T09:30:00-04:00,30.10001,30.42999,30.10001,30.36,44600,77055,65.83656502649117,57.62618431431633,NaN,NaN,195.894171816987,103.17124711129426,0.030346796203588267,0.31930955973352937,0.2889627635299411,995000,767120,76.19687438043813,49.99700997359842,NaN,NaN,19.03403684813325,17.56094007572663
2002-04-22T09:30:00-04:00,30.45,30.45,30.17999,30.22,39900,75860,62.86930313305716,58.28776165946463,NaN,NaN,161.24035565233726,131.22212012468555,0.03452546806444168,0.3321195986104932,0.29759413054605155,955100,850420,79.647508428572,53.53793921379384,NaN,NaN,20.006805744318758,17.910349456954076
2002-04-23T09:30:00-04:00,30.2,30.27,30,30,22800,74730,58.41392629935236,59.043755603451224,NaN,NaN,106.10013023926965,140.2155998689404,0.01858170162356948,0.3208212575755134,0.3022395559519439,932300,918160,81.94028006312814,57.300355111630005,NaN,NaN,19.54927384351372,18.14448151217688
2002-04-24T09:30:00-04:00,30.28999,30.50999,30.17999,30.2,34200,72595,61.11199763810613,59.5777679251742,NaN,NaN,132.3309633941553,147.59399111289545,0.017622446620971954,0.32426761422815886,0.3066451676071869,966500,959860,83.1952970460337,61.196870224964286,NaN,NaN,19.94495532811711,18.401692057311198
2002-04-25T09:30:00-04:00,30.10001,30.41,30.10001,30.28999,20400,72920,62.29729405096331,59.889058688447726,NaN,NaN,112.39183587131198,141.59149139481227,0.019044732504903128,0.33045108323831585,0.3114063507334127,986900,967160,83.41261124498698,65.1608581307177,NaN,NaN,20.612477506922954,18.717518550112878
2002-04-26T09:30:00-04:00,30.25999,30.28999,29.75,29.8,42100,74005,52.851355532099,59.42610020833825,NaN,NaN,44.26887725009694,111.26643248143425,-0.015171211956557962,0.2924423357877153,0.30761354774427324,944800,957120,81.84497668767102,68.91942179686224,NaN,NaN,18.303808057426814,18.658417051157727
2002-04-29T09:30:00-04:00,29.62,29.7,29,29.12,702900,107915,43.087275245069584,58.23155403827674,NaN,NaN,-89.48433848728065,61.12149365351066,-0.08202226846454319,0.20508571216359428,0.28710798062813747,241900,814480,63.566705519276006,70.90691409331794,NaN,NaN,12.736333158119509,17.812405066437982
2002-04-30T09:30:00-04:00,29.05,29.46001,28.95,29.41,80800,109905,47.5385959913496,57.128972428492986,NaN,NaN,-91.92246547548788,21.51697451055916,-0.10373385886345393,0.15744065704882004,0.261174515912274,322700,692560,52.727476743770424,71.04928779201747,NaN,NaN,9.682222646953228,16.65095043508302
2002-05-01T09:30:00-04:00,29.5,30.03999,29.34,29.94,253600,121445,54.537016005213246,57.13663791719989,NaN,NaN,0.11392602373679174,-4.926432963524554,-0.08046207919277654,0.1605969169213033,0.24105899611407983,576300,614520,47.18162147985845,70.33725179537707,NaN,NaN,9.525366053998653,15.633009809213824
2002-05-02T09:30:00-04:00,29.95,30.10001,29.75,29.84,136400,126895,53.09773722751951,56.94907830638142,NaN,NaN,21.00369397415244,-23.20406134295647,-0.07023727863115065,0.1532623978251415,0.22349967645629215,439900,505120,40.71637106789245,68.77334900476264,NaN,NaN,8.923767374868001,14.674546604307277
2002-05-03T09:30:00-04:00,29.83,29.83,29.39999,29.64999,43600,128335,50.37723540076087,56.59140443707797,NaN,NaN,-51.32405461235195,-42.32264771544626,-0.07431021570889979,0.13061190682016743,0.20492212252906722,396300,395420,35.46801426916274,66.63693135020783,NaN,NaN,7.55612897385935,13.657629799957574
2002-05-06T09:30:00-04:00,29.60001,29.71001,29.09,29.09,140000,132690,43.33095717259303,55.53460316652677,NaN,NaN,-129.68868992791315,-50.36351800357276,-0.11057307890022056,0.06670577390379151,0.17727885280401207,256300,398300,35.70234001048756,64.36814392448655,NaN,NaN,3.9313798446693715,12.268165520630689
2002-05-07T09:30:00-04:00,29.3,29.42,29.07001,29.14999,66200,131495,44.23087440041947,54.4743915843823,NaN,NaN,-131.07961149840182,-58.19494720815553,-0.12529331131987678,0.020662213654166095,0.14595552497404288,322500,398260,35.700401044225984,62.10740430458946,NaN,NaN,1.389494658826079,10.71406968323003
2002-05-08T09:30:00-04:00,29.36,29.82001,29.3,29.8,206000,126135,52.94947904648347,53.75211515496266,NaN,NaN,-30.36469514051834,-64.29067144100655,-0.08780011440806927,0.036205381963956285,0.12400549637202556,528500,388700,35.20824755984553,59.464908967525,NaN,NaN,2.0971408998042738,9.48307985702635
2002-05-09T09:30:00-04:00,29.7,29.7,29.45,29.46001,24400,118655,48.66406923622434,52.52550831280074,NaN,NaN,-51.99268872700015,-78.88994798123707,-0.08252537982882367,0.020848771585995962,0.10337415141481963,504100,401540,36.47492052453676,56.62762654924632,NaN,NaN,1.2230563394847218,8.303076497377546
2002-05-10T09:30:00-04:00,29.60001,29.60001,29,29.07001,27500,118675,44.24086100310417,51.19490530351839,NaN,NaN,-111.18067764328848,-90.86127258742438,-0.100724492900739,-0.02253146471110412,0.07819302818963488,476600,417600,38.10484188737552,53.66029322487515,NaN,NaN,-1.0115578747179648,6.9724144442210445
2002-05-13T09:30:00-04:00,29.2,29.44,29.07001,29.41,43600,117040,48.6248391293754,50.49568479137718,NaN,NaN,-87.38774701750043,-82.40108400534184,-0.08586670343252122,-0.02914035110101665,0.05672635233150457,520200,470380,43.25757724995698,50.897243023934344,NaN,NaN,-1.3698775843975395,5.780658440132676
2002-05-14T09:30:00-04:00,29.72,29.94,29.50999,29.94,35300,116055,54.61525080106828,50.031631445874474,NaN,NaN,11.122285382696859,-53.960704629122105,-0.03874665585786009,0.008293032509179454,0.04703968836703955,555500,516980,47.41961608794463,48.341837241213696,NaN,NaN,0.40729988286206587,5.013035789094017
2002-05-15T09:30:00-04:00,29.91,30.5,29.91,30.2,125800,114125,57.248757213185506,49.67102167174749,NaN,NaN,85.04604388325001,-30.878556824368438,0.008982181553636871,0.058267415309085635,0.049285233755448764,681300,547540,50.00925934730405,45.95588353423635,NaN,NaN,2.726490956051035,4.686386527230734
2002-05-16T09:30:00-04:00,30.38,30.39999,30.19,30.28,20000,105505,58.05525525731647,50.0427287949773,NaN,NaN,95.04839831972596,-1.4703394150232156,0.04308292041951865,0.10313888427984708,0.060055963860328423,701300,586980,53.21198023995209,43.91066950225643,NaN,NaN,4.809136266547481,4.703922204275984
2002-05-17T09:30:00-04:00,30.35001,30.42,30.14999,30.27,38800,105215,57.90819703423693,51.101366065632114,NaN,NaN,93.56821382907374,39.47943887944923,0.06101242962300278,0.1363215008890819,0.07530907126607912,662500,624160,56.06927506206189,43.37513875531256,NaN,NaN,6.418226758163073,4.948822854831283
2002-05-20T09:30:00-04:00,30.00999,30.12,29.81,30,34800,104960,53.935623659421715,51.55829661335155,NaN,NaN,41.76747527053368,65.31048333705606,0.051134578602066216,0.1392272945186619,0.08809271591659568,627700,645660,57.67878004506101,43.72880327683332,NaN,NaN,6.6232557943457975,5.188027560476214
2002-05-21T09:30:00-04:00,30.14999,30.16,29.64,29.74001,47000,106170,50.35351127108027,51.25947484662777,NaN,NaN,19.640860247218743,67.01419830996043,0.024867694950165165,0.11917733460430213,0.09430963965413697,580700,650700,58.066627112071494,44.50630367913425,NaN,NaN,5.736239639842382,5.266343571814238
2002-05-22T09:30:00-04:00,29.60001,29.71001,29.33,29.56,51100,107015,47.97761837130298,50.89375207118373,NaN,NaN,-37.075481118914915,42.58989330952744,-0.005247105156372986,0.08775075820867073,0.09299786336504372,529600,620360,54.81025604343693,45.513009748815996,NaN,NaN,4.2961151880775725,5.127739516994714
2002-05-23T09:30:00-04:00,29.78,29.83,29.47,29.83,15500,106770,51.661787046414325,50.98550576015897,NaN,NaN,6.402064952229477,24.860626636028147,-0.007464491057593961,0.08366724954305127,0.09113174060064523,545100,589120,51.60140925057328,46.66539510463104,NaN,NaN,4.133822167271738,4.985751324177146
2002-05-24T09:30:00-04:00,29.75,29.89999,29.71001,29.71001,44700,106900,49.968194608689224,51.45959414845156,NaN,NaN,23.671902214971865,10.881364313207772,-0.016951316791872728,0.06994259461080432,0.08689391140267705,500400,556700,48.432493803636575,47.574691804141686,NaN,NaN,3.5151110055954273,4.775659850094043
2002-05-28T09:30:00-04:00,29.89999,29.89999,29.47,29.67999,13100,72410,49.53070842858039,51.83815372189162,NaN,NaN,-2.729889375172422,1.9818913840665537,-0.024716860806283103,0.05599783539482317,0.08071469620110627,487300,528620,45.808493535725766,48.29669841067738,NaN,NaN,2.885671924895587,4.505661575065693
2002-05-29T09:30:00-04:00,29.67999,29.8,29.53999,29.66,15800,69160,49.22166906134113,51.57188158009574,NaN,NaN,-12.982625086038658,-4.542805682584927,-0.030300030242691095,0.0428396583977424,0.07313968864043349,471500,506780,43.819932341662295,48.91181875223572,NaN,NaN,2.279857853229248,4.187689614803343
2002-05-30T09:30:00-04:00,29.52,29.78,29.38,29.60001,41300,58545,48.248751379726485,51.54221601891732,NaN,NaN,-32.223483730473355,-3.5724062048966183,-0.03670629726033396,0.027256817065016037,0.06396311432535,430200,486900,42.03132716615703,49.30870494092288,NaN,NaN,1.513956187524366,3.8057276966206324
2002-05-31T09:30:00-04:00,29.56,29.94,29.56,29.82001,15400,52495,51.99610549722868,52.09616205421192,NaN,NaN,21.17603857688115,-0.6176114799662834,-0.02534067002424626,0.032287276795042175,0.057627946819288435,445600,467000,40.25984705472819,49.46263388144807,NaN,NaN,1.810190119586302,3.520650899901442
2002-06-03T09:30:00-04:00,29.95,29.97,29.31,29.31,23500,51490,44.03547785967119,51.768350534947345,NaN,NaN,-45.18248270250977,-14.388488463462611,-0.049961544979905556,-0.004823984405593507,0.04513756057431205,422100,451340,38.87143888913259,49.14933828424632,NaN,NaN,-0.2162636838200211,2.9868059593698044
2002-06-04T09:30:00-04:00,29.31,29.42,29.07001,29.24001,31400,46060,43.061152232728844,50.94305778006595,NaN,NaN,-122.52241049553315,-38.34699268753476,-0.06765247448546832,-0.03942803253252336,0.028224441952944965,390700,432020,37.168421045267195,48.41711006691222,NaN,NaN,-2.1723791686091993,2.249779512515661
2002-06-05T09:30:00-04:00,29.2,29.55,29.2,29.49001,48300,45165,47.52720934404156,50.248661503698536,NaN,NaN,-81.72140323627542,-52.094748317582116,-0.05949725276165181,-0.0461471239991198,0.013350128762532013,439000,425520,36.587638074691476,47.45842283315418,NaN,NaN,-2.6162622042815444,1.5546306958303462
2002-06-06T09:30:00-04:00,29.42999,29.48,29.02,29.09,236400,46685,41.868486960285374,49.09246376819631,NaN,NaN,-126.05297178746933,-70.86064592898131,-0.07691618775306483,-0.08279510592879902,-0.005878918175734195,202600,380000,32.73049367778688,45.995459507285226,NaN,NaN,-4.7313002951524155,0.6566405542613803
2002-06-07T09:30:00-04:00,28.85001,29.36,28.8,29.3,29000,46915,45.53479021027743,48.20864899505635,NaN,NaN,-122.78679045220264,-99.65321173479806,-0.07034665870831522,-0.09381224156112822,-0.023465582852813003,231600,337200,29.57358711868133,44.10291036847234,NaN,NaN,-5.420213179614871,-0.21148140772094115
2002-06-10T09:30:00-04:00,29.2,29.56,29.2,29.36,35700,47325,46.57161516496091,47.68264838830915,NaN,NaN,-73.42133455242697,-105.3009821047815,-0.05849832601541746,-0.09658849037208483,-0.03809016435666737,267300,306240,27.50682053134814,41.94777040320712,NaN,NaN,-5.683885024931405,-0.9932533530367216
2002-06-11T09:30:00-04:00,29.55,29.74001,29.14,29.14,52000,47745,43.31559797767911,47.17994029592335,NaN,NaN,-82.69316898605346,-97.33513380288557,-0.06169806699244871,-0.11521274809722826,-0.05351468110477955,215300,271160,25.34544301571424,39.610542967753034,NaN,NaN,-6.85800614484216,-1.8310751804374985
2002-06-12T09:30:00-04:00,28.89999,28.89999,28,28.53999,85400,50250,35.936240902731896,46.31984190531113,NaN,NaN,-235.60906627547408,-128.1126664107253,-0.09827264135925587,-0.17635548280384938,-0.07808284144459351,129900,209340,22.056337978768127,37.270977391705266,NaN,NaN,-10.35405502307647,-3.048643729385923
2002-06-13T09:30:00-04:00,28.37,28.39999,28.02,28.02,83100,48115,31.00626445237586,44.844447434308385,NaN,NaN,-247.01915073458798,-152.305902200149,-0.14851794240502497,-0.26373026945087474,-0.11521232704584977,46800,178180,20.604890583244156,35.05694034403889,NaN,NaN,-15.141831268850858,-4.776241949309485
2002-06-14T09:30:00-04:00,27.74001,27.99001,27.17999,27.81,104000,52315,29.26043444001442,43.365321707974466,NaN,NaN,-261.3128492652587,-180.01111396276025,-0.1845765083402681,-0.3459329624711849,-0.1613564541309168,-57200,120420,18.21240363046512,32.89836247452665,NaN,NaN,-19.59757077186655,-6.893574638246209
2002-06-17T09:30:00-04:00,28.25,28.59,28.25,28.59,101600,55455,42.26392034127351,42.846265416023975,NaN,NaN,-116.39971054756775,-188.6067891617884,-0.146252679562699,-0.3441723035842905,-0.19791962402159152,44400,75840,16.60941256708088,30.81271383390916,NaN,NaN,-18.954400779214993,-8.61654980124175
2002-06-18T09:30:00-04:00,28.55,28.84,28.55,28.72,19700,54700,44.108003324791724,42.48100357769902,NaN,NaN,-72.74050214115854,-186.61625579280943,-0.10446454727812049,-0.32850030811924213,-0.22403576084112165,64100,45600,15.605994991599488,28.79743259461896,NaN,NaN,-17.82219818734272,-9.931642427827603
2002-06-19T09:30:00-04:00,28.60001,28.89,28.60001,28.62,31300,53915,42.971030030456454,42.104023481322585,NaN,NaN,-63.345360771574676,-152.16351469202954,-0.07713562645983868,-0.32045529391592,-0.2433196674560813,32800,26180,14.9801099752451,26.86520279526811,NaN,NaN,-17.295283919274585,-10.983591212320029
2002-06-20T09:30:00-04:00,28.7,28.7,27.86,27.86,16100,52165,35.48465288238154,40.9246340088335,NaN,NaN,-119.12078334100701,-126.58384121331335,-0.10224593687937317,-0.37112708855529775,-0.2688811516759246,16700,20160,14.782197108525608,25.045370656253645,NaN,NaN,-19.440719733500327,-12.1917524296315
2002-06-21T09:30:00-04:00,27.55,27.61,27.27,27.27,164200,59600,30.973302533554104,39.991621485539426,NaN,NaN,-174.19897921759323,-109.16106720378025,-0.1478257755356559,-0.4536633710954945,-0.3058375955598386,-147500,2100,14.177063531295786,23.28148670212244,NaN,NaN,-22.89865454857996,-13.721309875195566
2002-06-24T09:30:00-04:00,27.39999,27.78999,26.75999,27.48,544900,84610,34.18082984589759,39.357312743622906,NaN,NaN,-151.89975586996033,-116.26107626825876,-0.1524550915719357,-0.4964064600247582,-0.3439513684528225,397400,72700,26.79342168534778,22.540415319271055,NaN,NaN,-24.494624152241546,-15.26035477191642
2002-06-25T09:30:00-04:00,27.7,27.87,27.05,27.05,309000,99405,31.003927770275496,38.17707834549676,NaN,NaN,-134.94583285129576,-128.7021424102862,-0.1716705658283716,-0.5585395757382869,-0.38686900990991535,88400,77560,27.582626381625374,21.89720019833776,NaN,NaN,-26.91326959307425,-16.92505688922468
2002-06-26T09:30:00-04:00,26.64999,27.5,26.55,27.5,52700,101250,37.54593034749578,37.868324301726076,NaN,NaN,-129.5021908762105,-141.9335084312134,-0.14247023845931617,-0.5649568079840606,-0.4224865695247444,141100,99220,31.14533097733802,21.783974291162842,NaN,NaN,-26.653977388875187,-18.31490267488904
2002-06-27T09:30:00-04:00,27.7,28.2,27.42999,28.2,103100,104340,46.10633459920389,37.90914890093511,NaN,NaN,-54.092299858859676,-128.92781173478392,-0.06817541956666168,-0.5077058439830715,-0.4395304244164098,244200,144720,38.04103805254959,22.388792215010568,NaN,NaN,-23.328329398632768,-19.031106492566717
2002-06-28T09:30:00-04:00,28.10001,28.33,27.55,27.67999,20200,104580,41.55012018347459,37.5504706879718,NaN,NaN,-55.75869388753904,-105.23975466877309,-0.04721370664773389,-0.4985475577260772,-0.4513338510783433,224000,219020,47.319162269654385,23.80395948203244,NaN,NaN,-22.226252278334545,-19.48755589053355
2002-07-01T09:30:00-04:00,27.5,27.5,26.46001,26.52,200500,113430,33.57871533927863,36.8549790709432,NaN,NaN,-137.03648632382172,-102.26710075954536,-0.10151341785020418,-0.5782256233910985,-0.47671220554089433,23500,144240,40.71141299126543,24.901528766000382,NaN,NaN,-24.35305087085028,-20.182626602007367
2002-07-02T09:30:00-04:00,26.56,26.56,25.69,25.92,114300,117575,30.33671657820713,36.455013047762854,NaN,NaN,-181.31571101231677,-111.54107639174956,-0.16417042787404712,-0.6819252403834533,-0.5177548125094061,-90800,108400,37.97441296783985,26.03853412236265,NaN,NaN,-27.27975234769449,-21.1965017085341
2002-07-03T09:30:00-04:00,25.7,25.96001,25.52,25.96001,23100,116315,30.816399122362213,36.44145123847616,NaN,NaN,-174.90074860487047,-120.62078793748155,-0.1875629262567624,-0.7522084703303591,-0.5646455440735967,-67700,66640,35.02012083574809,27.06819342611293,NaN,NaN,-29.275694029644022,-22.350672040121232
2002-07-05T09:30:00-04:00,26.25,26.85001,26.25,26.83,9700,104980,40.42279523309114,37.23876272369593,NaN,NaN,-96.11150883723948,-129.0246297331575,-0.13172403753892092,-0.7293005909972479,-0.5975765534583269,-58000,6200,31.23287901123959,27.998227381882536,NaN,NaN,-27.489712071694232,-23.08482061606023
2002-07-08T09:30:00-04:00,26.60001,26.81,26.44,26.5,154000,111230,38.25305465367938,36.95227231743921,NaN,NaN,-91.00558604145469,-136.07400816394062,-0.10543194984744375,-0.7293664907676316,-0.6239345409201879,-212000,-81000,26.73983358722255,28.721828883321226,NaN,NaN,-26.838627040100445,-23.621078676637403
2002-07-09T09:30:00-04:00,26.55,26.55,25.23,25.28999,32200,111055,31.563129868305154,36.05620992769017,NaN,NaN,-146.55993030248473,-137.97869695967324,-0.1549573809008259,-0.8176312670462202,-0.6626738861453944,-244200,-134540,24.417246323736165,29.351203978473844,NaN,NaN,-28.76111569946217,-24.355369679898082
2002-07-10T09:30:00-04:00,25,25.08,23.96001,24.12,92700,113090,26.70067836280336,34.89404195142923,NaN,NaN,-214.486172785373,-144.6127893142845,-0.24650039681964198,-0.9707993821699468,-0.7242989853503048,-336900,-183760,22.48380467480689,29.88718217129969,NaN,NaN,-32.29203483838215,-25.48917898825295
2002-07-11T09:30:00-04:00,23.53,24.58,23.37,24.58,174100,117525,31.189092014001403,34.58721617511637,NaN,NaN,-187.22214046424688,-147.07706768615975,-0.2549964066416839,-1.0430444936524097,-0.7880480870107258,-162800,-202780,21.7665433118013,30.386064042962236,NaN,NaN,-33.332369409779375,-26.609634762756723
2002-07-12T09:30:00-04:00,24.39999,24.94,24.09,24.89999,66200,116680,34.207198486364405,34.818208743174246,NaN,NaN,-134.49796351316408,-154.7543586213447,-0.2193487097761816,-1.0622339742309528,-0.8428852644547712,-96600,-210500,21.467196636581974,30.906787836196965,NaN,NaN,-33.07440351356421,-27.53317315572922
2002-07-15T09:30:00-04:00,24.39999,24.45,23.60001,24.45,38200,113390,32.0765304325199,34.667901642218695,NaN,NaN,-139.02132692814374,-164.35750679868252,-0.20653968864641614,-1.1010598752627914,-0.8945201866163752,-134800,-195060,23.72649383215804,30.687721560969127,NaN,NaN,-33.58956020592504,-28.398371305757195
2002-07-16T09:30:00-04:00,24.35001,24.72,24.25999,24.28,39300,110275,31.28375905633385,34.68788959122286,NaN,NaN,-109.6608938979137,-156.97769951776831,-0.19037792364124506,-1.1324925911679316,-0.9421146675266865,-174100,-181040,25.813541193990375,30.561358333280914,NaN,NaN,-34.24810059773066,-29.23404691889626
2002-07-17T09:30:00-04:00,24.8,24.83,24.47,24.81,40100,111295,36.54891522747004,34.61667422550674,NaN,NaN,-84.19620150705329,-130.91970526210437,-0.12785567568619594,-1.1019342621344315,-0.9740785864482355,-134000,-140460,31.643767649952565,30.59696095275338,NaN,NaN,-33.11431189966847,-29.788370487578007
2002-07-18T09:30:00-04:00,24.5,24.5,23.64,23.64,32700,111365,30.91713409235716,33.531731332160554,NaN,NaN,-112.71354175126991,-116.01798551950897,-0.1477517142634872,-1.1587682292775945,-1.0110165150141073,-166700,-141240,31.592373902411694,30.136342084886387,NaN,NaN,-34.01393777136087,-30.392022956689846
2002-07-19T09:30:00-04:00,22.89999,23.07001,22.53999,22.67,47600,112940,27.1780886461234,32.505157650921184,NaN,NaN,-152.53523610902903,-119.62544003868193,-0.2051626661053989,-1.267469847645856,-1.062307181540457,-214300,-164780,30.008353378177986,28.899855735495212,NaN,NaN,-36.09619571571634,-31.206904779407918
2002-07-22T09:30:00-04:00,22.75,23.10001,22.28999,22.48,32600,106360,26.501995337723727,31.999677650810117,NaN,NaN,-137.81750439429393,-119.384675531912,-0.23283227684030194,-1.3533475275908344,-1.1205152507505325,-246900,-187200,28.540592326904644,28.030511402326585,NaN,NaN,-37.93604297491418,-32.16821023590881
2002-07-23T09:30:00-04:00,22.14999,22.56,21.95,22.06,41000,81165,25.020294531133132,31.61993321887626,NaN,NaN,-138.3986848189216,-125.13223371611357,-0.25455749526029203,-1.4387121198258974,-1.1841546245656054,-287900,-209960,27.091906869637754,27.253189538169295,NaN,NaN,-39.91382167313685,-33.274726155512816
2002-07-24T09:30:00-04:00,21.75,23.52,21.64999,23.49001,36400,67535,37.776240200785,32.117064724477885,NaN,NaN,-97.67079654532611,-127.82715272376814,-0.15277450762780687,-1.375122759100364,-1.2223482514725572,-251500,-233460,25.644515733856764,26.583503459462772,NaN,NaN,-37.25073551262627,-33.84272749224331
2002-07-25T09:30:00-04:00,23.60001,24.44,23.5,24.28999,106000,70200,43.56085078040984,32.34121154928636,NaN,NaN,-39.91070341407719,-113.26658505632959,-0.018773440322365387,-1.245815051875514,-1.2270416115531486,-145500,-229220,26.40845169182893,26.2389015080763,NaN,NaN,-33.024824665632536,-33.72588423129891
2002-07-26T09:30:00-04:00,24.28,24.83,24.14999,24.83,35700,66830,47.133618793926786,32.97553755930404,NaN,NaN,-8.092626354094945,-84.37806310534276,0.11184884818504015,-1.0872305513218485,-1.1990793995068887,-109800,-208320,30.21449964364504,26.487091940677903,NaN,NaN,-28.406001974433963,-32.965901051746776
2002-07-29T09:30:00-04:00,25.37,25.94,25.24001,25.94,117100,71675,53.631257211257925,34.55183236951495,NaN,NaN,65.16418015168048,-43.78172619614788,0.2696264514427209,-0.8620463352034875,-1.1316727866462084,7300,-157480,38.54122354339403,27.49594745636775,NaN,NaN,-22.16016842207179,-31.42222496179321
2002-07-30T09:30:00-04:00,25.7,26.45,25.55,26.13,81400,65720,54.658532484262835,36.548821949619196,NaN,NaN,91.86220371927952,2.2704515114923454,0.37682673328719907,-0.6606393700372095,-1.0374661033244086,88700,-82160,48.370020683628795,29.344962885569316,NaN,NaN,-16.969934516199242,-29.35761204099407
2002-07-31T09:30:00-04:00,25.85001,26.88,25.77,26.88,53100,62660,58.561195700033416,38.50397221290719,NaN,NaN,117.4146060383308,45.28753202822372,0.48158554138959153,-0.4354841765874191,-0.9170697179770106,141800,-3500,56.2407449151076,31.807405857234052,NaN,NaN,-11.321156062620389,-26.780975472654973
2002-08-01T09:30:00-04:00,26.7,26.75999,26,26.13,37400,63375,53.593423358440475,39.88870256091263,NaN,NaN,100.03222849872007,73.27611841078318,0.4824983246331327,-0.31394681218559484,-0.7964451368187275,104400,46480,60.374239288854646,34.58648033239639,NaN,NaN,-8.21002208711821,-24.12798213186401
2002-08-02T09:30:00-04:00,26.05,26.49001,25.62,25.92,100700,67925,52.256715282234104,41.330144335892214,NaN,NaN,87.3685495236165,92.36835358632547,0.45163640890136647,-0.23189962569201938,-0.6835360345933859,3700,69180,62.124181649785925,37.32917231936981,NaN,NaN,-6.148617031154447,-21.559501403191213
2002-08-05T09:30:00-04:00,25.85001,25.92,24.81,24.81,71900,63820,45.75992635694169,42.36415628593563,NaN,NaN,42.48149330686694,87.83181621736276,0.3440112918812088,-0.25352191974187477,-0.5975332116230836,-68200,54080,60.21908906441341,39.78671145297145,NaN,NaN,-6.448383544402347,-19.40077028050709
2002-08-06T09:30:00-04:00,25.39999,25.86,25.24001,25.42,64600,65440,49.47728824395533,43.287611501398864,NaN,NaN,65.73671374284132,82.60671822207512,0.3028966843659531,-0.2189123561656423,-0.5218090405315954,-3600,35620,57.882190835758145,41.660884537671855,NaN,NaN,-5.505074331783402,-17.41567085926085
2002-08-07T09:30:00-04:00,26,26.34,25.67999,26.27,72800,64445,54.18879738770713,44.94987316535243,NaN,NaN,93.9507900050744,77.91395501542384,0.32025074785316454,-0.12149560571513973,-0.4417463535683043,69200,21100,56.04004628352327,43.40714685060839,NaN,NaN,-3.1715646697892166,-15.380798546479188
2002-08-08T09:30:00-04:00,26.5,27.3,26.5,27.25,156000,63540,58.94275223286791,47.21877770726275,NaN,NaN,130.88822140757372,84.08515359719458,0.3809084929759782,0.03438926265166842,-0.34651923032430976,225200,45260,58.41177042880306,45.43596235422448,NaN,NaN,0.4027214683760267,-13.126009972928443
2002-08-09T09:30:00-04:00,26.95,27.42,26.8,27.21001,52700,62865,58.67517585454165,49.51686202989261,NaN,NaN,119.26860008732375,90.46516370993602,0.39956682116201286,0.15293929612820634,-0.24662752503380653,172500,79020,61.53472709361782,47.792686266132556,NaN,NaN,3.1092036062576853,-10.806693747330424
2002-08-12T09:30:00-04:00,26.92,27.33,26.8,27.25,24900,62200,58.87622167703459,51.93514254031414,NaN,NaN,105.46361985226662,103.06158901901594,0.3951160712237067,0.24726756399582683,-0.14784850722787984,197400,132140,65.87669780174573,50.56302847556884,NaN,NaN,5.332756344147639,-8.501058019976416
2002-08-13T09:30:00-04:00,27,27.17,26.60001,26.60001,44200,62445,54.25591223082772,53.11226197103148,NaN,NaN,80.45066740811723,106.00437975207115,0.33148085334959415,0.26650255945911283,-0.0649782938904813,153200,163500,68.16162140992549,53.599964595288036,NaN,NaN,5.898306867613883,-6.444005893177802
2002-08-14T09:30:00-04:00,26.25,27.36,25.98,27.27,41600,62520,57.921454096901854,54.1380193507809,NaN,NaN,76.83384134335405,102.58099001972705,0.3175683488097416,0.33198214212169574,0.01441379331195411,194800,188620,69.90026880483136,56.70652296050249,NaN,NaN,7.478491876615445,-4.455077640350195
2002-08-15T09:30:00-04:00,27.45,27.74001,27.23,27.46001,191900,70480,58.92666231227695,54.980379602091624,NaN,NaN,98.11852131622294,96.0270500014569,0.30419538939246,0.3946580300525291,0.09046264066006911,386700,220920,72.01635079133578,59.69236947105183,NaN,NaN,9.065515968693786,-2.5235642676296264
2002-08-16T09:30:00-04:00,27.3,27.45,27.09,27.24001,34200,69810,57.22218719442177,55.236874600889045,NaN,NaN,83.90532571191662,88.95439512637547,0.2650024358690007,0.42171568549632,0.1567132496273193,352500,256920,74.19394130341063,62.23899216819588,NaN,NaN,9.914171489282769,-0.7467448737849984
2002-08-19T09:30:00-04:00,27.25,27.62,27.17999,27.62,54600,70910,59.40628361117465,55.57599968138275,NaN,NaN,92.51846583768993,86.36536432346014,0.2493665356013141,0.46842141912896196,0.21905488352764785,407100,298860,76.48928783515544,64.24751125044777,NaN,NaN,11.24744222467715,0.9667104259953081
2002-08-20T09:30:00-04:00,27.45,27.5,27.24001,27.27,45900,71155,56.542697079295785,55.43182120847291,NaN,NaN,82.49196163418935,86.77362316867456,0.20216078648096203,0.4717558666288504,0.26959508014788836,361200,340460,78.52925544996762,65.8395477172235,NaN,NaN,11.598842235634615,2.4855863988009235
2002-08-21T09:30:00-04:00,27.55,27.77,27.23,27.73,64300,72550,59.31826502818706,55.84073847059767,NaN,NaN,96.13655557861185,90.63416601572612,0.18887381344905146,0.5056873469592027,0.31681353351015124,425500,386600,80.54551387451691,67.28035304477079,NaN,NaN,12.67330544217034,3.940974833567983
2002-08-22T09:30:00-04:00,27.64999,28.62,27.64999,28.60001,41900,69345,64.00129625267977,56.67963711134379,NaN,NaN,147.10981393936393,100.43242454035433,0.22327839595128451,0.5959115284492569,0.37263313249797236,467400,402740,81.21022255429739,68.64364168080733,NaN,NaN,15.025056701260969,5.524415100381266
2002-08-23T09:30:00-04:00,28.45,28.45,27.86,27.86,57000,70410,57.896414153747585,57.54652909682992,NaN,NaN,121.54586226678754,107.96053185132851,0.18251496472904716,0.6007768384092813,0.41826187368023415,410400,414320,81.69351094053195,70.17752895767295,NaN,NaN,15.241369603997473,6.912551458040724
2002-08-26T09:30:00-04:00,28.14999,28.19,27.73,28.17,25500,65830,59.633488929932795,58.27197200297117,NaN,NaN,109.7431797673399,111.4054746372585,0.16336776183536228,0.622471575974437,0.45910381413907475,435900,420080,81.94230818546848,71.89610876836653,NaN,NaN,15.931158172154186,8.200923845771218
2002-08-27T09:30:00-04:00,28.28,28.28,27.25999,27.37,36000,63560,53.49925745905421,58.22271915092453,NaN,NaN,65.77578965054052,108.06224024052874,0.08756296508428985,0.5685575204944371,0.48099455541014724,399900,427820,82.29060333999507,73.77114855811452,NaN,NaN,14.654846004787464,9.122912725630682
2002-08-28T09:30:00-04:00,27.33,27.44,27.02,27.14999,67400,64275,51.91756737016607,57.72092023216012,NaN,NaN,19.266503606206477,92.68822984604766,0.017034131978594658,0.5022872203833906,0.4852530884047959,332500,409220,78.37825553851907,75.19732606595137,NaN,NaN,13.136447901833618,9.696274893659673
2002-08-29T09:30:00-04:00,26.8,27.39999,26.8,27.22,23100,63560,52.399830959341834,57.27268131107441,NaN,NaN,8.840699538428407,65.03440696586057,-0.02802101672384033,0.4502268174999955,0.4782478342238358,355600,386860,73.83375948832946,76.07582837985935,NaN,NaN,12.029864416356585,10.029644825473518
2002-08-30T09:30:00-04:00,26.87,27.50999,26.87,27.14,41600,60605,51.76095736948724,56.7644481462496,NaN,NaN,6.871303279309391,42.099495168364946,-0.06425731038860605,0.39792619623807823,0.4621835066266843,314000,367580,70.0615995437789,76.37474993286172,NaN,NaN,10.936285777061709,10.159164961414689
2002-09-03T09:30:00-04:00,26.8,26.92,26.00999,26.00999,55000,59760,43.662998138588776,56.00781142537539,NaN,NaN,-125.50106062733008,-4.949352910569056,-0.15992927995072614,0.2622719066882766,0.42220118663900275,259000,332200,63.636539991501785,76.05152983154574,NaN,NaN,7.451598599276423,9.772369766823507
2002-09-04T09:30:00-04:00,26.2,26.86,26.10001,26.81,87400,60900,49.66679121550706,55.41819264813291,NaN,NaN,-104.91731434319632,-39.08797370931643,-0.16430521826929584,0.21681966380238293,0.38112488207167877,346400,321500,61.790960780049794,75.47229354406134,NaN,NaN,6.21438003202576,9.264085518995257
2002-09-05T09:30:00-04:00,26.3,26.78999,26.17,26.5,31900,58855,47.552073491685476,54.60572201809066,NaN,NaN,-130.69522589015747,-69.08031960858924,-0.18169293917117757,0.15400870810770684,0.3357016472788844,314500,317900,61.14839938281956,74.69601130059588,NaN,NaN,4.5501578067030275,8.590667274382081
2002-09-06T09:30:00-04:00,26.60001,26.7,26.47,26.5,17700,51940,47.552073491685476,53.91499961075236,NaN,NaN,-108.96453596127425,-92.64136670852974,-0.1861271095100842,0.10304276039127913,0.28916986990136334,314500,309680,59.62377400195919,73.65528506477793,NaN,NaN,3.2103108476542306,7.822044927706674
2002-09-09T09:30:00-04:00,26.25,26.87,26.25,26.8,29300,50770,49.944123740378885,53.23913104855266,NaN,NaN,-86.49191340173829,-111.31401004473928,-0.16264027829429514,0.0858695220334944,0.24850980032778955,343800,315640,60.39483546721091,72.50568132421046,NaN,NaN,2.7388986967608986,7.095881180428706
2002-09-10T09:30:00-04:00,26.67,27,26.67,26.89999,22300,50640,50.7503649429927,52.82539303881673,NaN,NaN,-49.48362672101084,-96.11052326347544,-0.1352778035733858,0.07941254586105728,0.2146903494344431,366100,337060,63.1206974696208,71.40507003989997,NaN,NaN,2.5640726037131705,6.44847995518363
2002-09-11T09:30:00-04:00,27.55,27.55,26.89999,26.95,13900,49125,51.17395565728302,52.243656655180715,NaN,NaN,-11.133037683818873,-77.35366793159996,-0.10980181808574646,0.07743807682726,0.18723989491300647,380000,343780,63.95877854663948,70.22030323076588,NaN,NaN,2.528176142121412,5.888436553317598
2002-09-12T09:30:00-04:00,26.75,26.75,26.34,26.44,35200,48805,46.7573250576395,51.01194442696356,NaN,NaN,-100.96903798784018,-71.4084303511365,-0.12233201011897613,0.034324882264286316,0.15665689238326244,344800,349840,64.73701302413832,69.04364540718308,NaN,NaN,1.2979610453783355,5.232654337897704
2002-09-13T09:30:00-04:00,26.23,26.64,26.16,26.64,23400,40380,48.62972443032835,50.350038018147906,NaN,NaN,-93.85726441340974,-68.3869760415636,-0.11243752384190356,0.016109987580883,0.12854751142278656,368200,360580,66.13276128563653,67.93216328897627,NaN,NaN,0.7428508685897831,4.591253842282287
2002-09-16T09:30:00-04:00,25.12,26.75,25.12,26.64,86200,42980,48.62972443032835,49.56405483960473,NaN,NaN,-118.35892729997116,-74.76037882121015,-0.10151363386157934,0.0016554690958123786,0.10316910295739172,368200,365460,66.77624409642408,66.84887299690166,NaN,NaN,0.27874027680784813,3.975180475785938
2002-09-17T09:30:00-04:00,27.07001,27.07001,26.16,26.24001,19400,41220,44.96218701588753,48.95426409366424,NaN,NaN,-69.12470822706256,-78.6885951224205,-0.11581223919131987,-0.041596196031758126,0.07421604315956175,348800,362000,65.8213289802796,65.67249625692199,NaN,NaN,-1.1092199006100112,3.248837564872231
2002-09-18T09:30:00-04:00,26.10001,26.39,25.91,26.39,45300,41190,46.588867970356745,48.57364270796358,NaN,NaN,-91.74612609179817,-94.81121280401636,-0.10980786115580282,-0.06304378328519178,0.04676407787061104,394100,364820,66.2450094682068,64.80583582332825,NaN,NaN,-1.881053656423316,2.5159959618300105
2002-09-19T09:30:00-04:00,25.85001,26.06,25.46001,25.5,105200,43235,39.187655382583195,47.62991588105225,NaN,NaN,-144.0248434781084,-103.42237390207,-0.15751218376579046,-0.15012615183662703,0.007386031929163428,288900,353640,62.91522280708036,64.02594034609618,NaN,NaN,-4.781404281487649,1.4735102127846307
2002-09-20T09:30:00-04:00,25.55,25.64999,25.35001,25.62,23300,42305,40.55880292816401,46.8297619923863,NaN,NaN,-152.61453588522156,-115.17382819643237,-0.17156449742698907,-0.2070695898545729,-0.035505092427583845,312200,342440,59.67894862423039,63.28432242327127,NaN,NaN,-6.810893879038744,0.2900239139527201
2002-09-23T09:30:00-04:00,25.17,25.42999,25.05,25.32001,48700,41890,38.237699898915125,46.44224068955248,NaN,NaN,-179.82493239777602,-127.46702921599335,-0.19019948875758289,-0.27325445337456244,-0.08305496461697956,263500,321500,54.07809418844323,62.60157629448138,NaN,NaN,-9.222151479589586,-1.0688582851247521
2002-09-24T09:30:00-04:00,25,25.45,25,25.3,57100,43470,38.081153034421746,45.614695105189234,NaN,NaN,-168.12872793387322,-147.26783315735548,-0.19242876400777312,-0.32359091962669595,-0.13116215561892283,206400,293020,47.54279038851492,61.58384983794317,NaN,NaN,-11.25987465411162,-2.5247177664085902
2002-09-25T09:30:00-04:00,25.60001,26.05,25.39999,26.02,87400,46040,46.559197253442676,45.54377537388617,NaN,NaN,-77.71254918493003,-144.46111777598185,-0.1365940984787649,-0.301904778717379,-0.16531068023861406,293800,272960,43.550575343217915,60.32686240654306,NaN,NaN,-10.703948439593528,-3.6931792911492956
2002-09-26T09:30:00-04:00,26.25,26.52,26.10001,26.48,359300,60635,51.16024085744442,45.80150161429753,NaN,NaN,4.863997663144356,-114.6833495477313,-0.06357429219627422,-0.24477854548395683,-0.1812042532876826,653100,345800,57.50448840927646,60.17548486420858,NaN,NaN,-8.832250972907092,-4.427332388543267
2002-09-27T09:30:00-04:00,26.10001,26.34,25.45,25.5,171300,68045,42.72141650652903,45.285593954736825,NaN,NaN,-75.96148553544631,-99.35273947777624,-0.07536352875160254,-0.2754086642271858,-0.20004513547558325,481800,379720,62.19150483061081,60.30381839016571,NaN,NaN,-9.828969029371276,-5.198994765804411
2002-09-30T09:30:00-04:00,25.00999,25.60001,25.00999,25.38,545800,93255,41.81194398782889,44.64713531508227,NaN,NaN,-123.01299101054013,-87.99035120032906,-0.08463645946277204,-0.3058407098040483,-0.22120425034127628,-64000,314220,50.58839389752482,59.40865384930171,NaN,NaN,-10.90711068511002,-6.014439897133784
2002-10-01T09:30:00-04:00,25.66,26.17999,25.48,26.17,42100,92610,49.44255909541329,44.523464132091576,NaN,NaN,-30.3469316509392,-60.433991943742264,-0.03357913838371229,-0.26317817332091664,-0.22959903493720435,-21900,268560,44.3733413842514,58.00969405198828,NaN,NaN,-9.356391784473821,-6.491861595325218
2002-10-02T09:30:00-04:00,26.45,26.58,25,26.19,145600,95520,49.62267348214847,44.72813187669936,NaN,NaN,-28.85894322365084,-50.66327075148642,0.003552439096207227,-0.22515848606694533,-0.22871092516315256,123700,234540,40.39164169098297,56.2707389567629,NaN,NaN,-8.082133183193573,-6.719043250734983
2002-10-03T09:30:00-04:00,26.10001,26.55,25.86,26.09,427000,115275,48.68867543466195,44.73234266272319,NaN,NaN,9.16396817850132,-49.803276648415036,0.022342915240750327,-0.20078228111221463,-0.22312519635296496,-303300,43260,26.171691010335238,53.41637679424137,NaN,NaN,-7.316845320150795,-6.804443546365813
2002-10-04T09:30:00-04:00,26.10001,26.10001,25.27,25.27,92400,119010,41.74939372638403,44.240890469584315,NaN,NaN,-75.47260031937594,-49.705499605200956,-0.017347125386887235,-0.244809103086574,-0.22746197769968676,-395700,-132240,19.41728305666875,50.03359386283028,NaN,NaN,-8.797526599384797,-7.0891696967970965
2002-10-07T09:30:00-04:00,25.48,25.82001,25.2,25.21001,159000,125495,41.28580062720838,43.97829144182152,NaN,NaN,-87.23722482103219,-42.550346367299376,-0.04306940317128155,-0.2812987316637887,-0.23822932849250716,-554700,-230380,16.805377901911115,46.53245450008967,NaN,NaN,-10.12252958037147,-7.522506823022007
2002-10-08T09:30:00-04:00,25.60001,26.13,25.48,25.95,81700,128465,48.833342165931455,44.13861102721972,NaN,NaN,-15.03289484286534,-39.48753900568461,-0.007537534917831101,-0.24765124713979603,-0.24011371222196493,-473000,-320600,14.830395916519038,42.85998210354055,NaN,NaN,-8.929033041762773,-7.723439139984974
2002-10-09T09:30:00-04:00,25.5,25.88,25.48,25.67999,125400,134040,46.485244434255314,44.659867388053435,NaN,NaN,-36.95711379834165,-41.10717312062277,0.00008594524558058758,-0.2400062806649892,-0.24009222591056978,-598400,-465020,12.332017643634273,39.24689602043725,NaN,NaN,-8.666092833782272,-7.858103953384588
2002-10-10T09:30:00-04:00,25.85001,26.03999,25.41,26,544700,159515,49.57962803026396,45.30421203820344,NaN,NaN,-4.197303425418534,-43.779427441406746,0.027470855121209142,-0.20575365700905834,-0.2332245121302675,-53700,-415100,17.505268988663474,36.234490332182475,NaN,NaN,-7.4985008174490275,-7.806732076822365
2002-10-11T09:30:00-04:00,26.3,26.67,26.10001,26.31,142700,165480,52.44810433232596,46.31924092630421,NaN,NaN,116.50493122323094,-5.383921132885355,0.06510485762042365,-0.15184344010473794,-0.21694829772516158,89000,-318160,26.567293361892695,34.26943313028601,NaN,NaN,-5.6460433056510375,-7.498062252369318
2002-10-14T09:30:00-04:00,26.60001,27.07001,26.60001,27,102600,166300,58.15454834917883,47.75305487735829,NaN,NaN,198.3794654266603,51.739416916653134,0.13129228133077311,-0.052832946061695196,-0.1841252273924683,191600,-168900,37.88196223735506,33.579373976631736,NaN,NaN,-2.1724242935642843,-6.7372568296828845
2002-10-15T09:30:00-04:00,27.5,27.56,27.27,27.48,202100,175435,61.60626340696235,48.8278453168954,NaN,NaN,253.3118621016145,105.4083683055491,0.1982058310955786,0.06363206147700495,-0.13457376961857365,393700,4440,47.91834328669939,33.891357401166125,NaN,NaN,1.8895638344294252,-5.50485387766684
2002-10-16T09:30:00-04:00,27.55,27.89999,27.32001,27.56,267100,186525,62.16640487129506,49.61399988931331,NaN,NaN,218.23465737506476,156.44672254023038,0.2360879670467972,0.16053618918992285,-0.07555177785687434,660800,256280,58.42766010305159,33.957298236435776,NaN,NaN,5.312787630245554,-3.9594765193936414
2002-10-17T09:30:00-04:00,28.10001,28.14,27.64999,27.89999,830600,222795,64.5345261902462,51.17207915243596,NaN,NaN,198.4351214664394,196.97320751860198,0.26984179327115315,0.2617504637320671,-0.008091329539086048,1491400,565300,67.17921496216209,34.31356324583228,NaN,NaN,8.935138422836332,-2.1173886705036455
2002-10-18T09:30:00-04:00,27.8,28.08,27.73,27.91,218500,232555,64.6047725236627,52.800138333566956,NaN,NaN,162.12842110147096,206.09790549424997,0.27756506685432925,0.33886500402882547,0.06129993717449625,1709900,889480,73.48520566350841,35.94904980054539,NaN,NaN,11.883171080810968,-0.11730870603012944
2002-10-21T09:30:00-04:00,27.7,28.08,27.45,28,77200,233980,65.27082052943393,53.930728435997004,NaN,NaN,132.33557288574997,192.8891269860679,0.2730401755700569,0.4026001566370674,0.1295599810670105,1787100,1208580,77.97172994916157,38.348934698038974,NaN,NaN,14.525787302903122,1.9745621523889065
2002-10-22T09:30:00-04:00,27.8,27.8,27.24001,27.48,655500,263900,58.42952011495149,54.55978890976865,NaN,NaN,88.8919423880099,160.005143043347,0.22152448539215525,0.40646558780720454,0.1849411024150493,1131600,1356160,79.68390214888639,41.15552473074636,NaN,NaN,14.960420725176027,3.8296848056442094
2002-10-23T09:30:00-04:00,27.25,27.33,26.8,27.3,182600,268660,56.232369552449065,55.0986242038963,NaN,NaN,51.61579895989941,126.68137136031393,0.1644495170215491,0.3905029986919857,0.22605348167043657,949000,1413800,80.32705984316794,45.02376536166298,NaN,NaN,14.704893536270452,5.38328605287653
2002-10-24T09:30:00-04:00,27.39999,27.39999,26.73,26.85001,104100,255900,51.062878012300644,55.763873081461774,NaN,NaN,35.77456079159491,94.14925922534505,0.08927712016663397,0.337649881878729,0.24837276171209505,844900,1284500,74.62025356599156,48.96683468375746,NaN,NaN,12.961702097854605,6.465916916444826
2002-10-25T09:30:00-04:00,26.74001,27.53,26.74001,27.34,180100,256340,55.82506457538621,56.80239193490304,NaN,NaN,47.29760990893227,71.18309698683731,0.06648611402240118,0.3314804042400965,0.2649942902176953,1025000,1147520,69.02546211702615,52.69684069912283,NaN,NaN,12.836296847384157,7.375971192293301
2002-10-28T09:30:00-05:00,27.64999,27.64999,27.08,27.22,159600,237030,54.42814869101946,57.20202097240933,NaN,NaN,50.91106053810281,54.898194517307886,0.038641818927130756,0.31329656387660876,0.274654744949478,865400,963180,62.26019760782269,56.084683677073095,NaN,NaN,12.326193391088335,8.083145792121163
2002-10-29T09:30:00-05:00,27.10001,27.2,26.58,26.88,234700,246660,50.567214434471474,57.493590258139044,NaN,NaN,10.641134688841435,39.2480329774742,-0.005038094386422609,0.26835712696644975,0.27339522135287236,630700,863000,58.882595174875995,59.40972492930464,NaN,NaN,10.74846553451874,8.463905755320818
2002-10-30T09:30:00-05:00,26.91,27.24001,26.88,27.06,86100,243685,52.48872935386822,57.70138320982507,NaN,NaN,22.509921451028383,33.42685747569998,-0.02315702515736684,0.2444489399061638,0.2676059650635306,716800,816560,57.329938700729855,62.254344194452244,NaN,NaN,9.968084088466528,8.678788374341634
2002-10-31T09:30:00-05:00,27.35001,27.35001,26.62,26.86,155300,230100,50.155849147092056,57.53765069659408,NaN,NaN,8.078793352797673,27.887703987940533,-0.04850293568418895,0.20697729545829446,0.2554802311424834,561500,759880,55.409523370901844,64.31450348081003,NaN,NaN,8.641784102161688,8.6735020497445
2002-11-01T09:30:00-05:00,26.60001,27.25,26.60001,27.13,41200,227540,53.18113038969619,57.18240655663102,NaN,NaN,6.674818419824302,19.76314569011894,-0.046945052604324744,0.1967989153870775,0.24374396799140224,602700,675420,52.582923505676845,65.36457214283303,NaN,NaN,8.346451418269673,8.626780530962382
2002-11-04T09:30:00-05:00,27.3,27.74001,27.17,27.17,110600,225120,53.63015291414744,56.612684378572816,NaN,NaN,44.41455327822054,18.463844238142464,-0.043177125117380866,0.18977256159467615,0.232949686712057,713300,645000,51.562669913526655,65.6248811876064,NaN,NaN,8.223491016850641,8.569167743232134
2002-11-05T09:30:00-05:00,27.2,27.61,27.16,27.50999,49000,223485,57.37237197259987,56.27025345723745,NaN,NaN,47.634824294987105,25.862582159371602,-0.01897843522618775,0.20922664267932234,0.2282050779055101,762300,671320,52.42281848716847,65.19596392932904,NaN,NaN,9.157230648685651,8.653176729725493
2002-11-06T09:30:00-05:00,27.89999,28.22,27.7,28.07001,216300,228030,62.71064186962324,56.13997600576438,NaN,NaN,128.10754660251735,46.9821071896694,0.030842381682436193,0.2667580550085553,0.23591567332611912,978600,723680,54.166529291657874,64.26648638143588,NaN,NaN,11.612284017551962,9.07590634227213
2002-11-07T09:30:00-05:00,28.07001,28.17,27.75,27.95,172300,209410,60.949169898527614,55.87886153254045,NaN,NaN,116.07490488291502,68.58132949569287,0.050642739922596686,0.299219098229365,0.2485763583067683,806300,772640,55.797872631152785,63.003105450553335,NaN,NaN,13.138659434105604,9.656299641105484
2002-11-08T09:30:00-05:00,27.7,27.92,27.57001,27.77,46600,204605,58.30388916340832,55.381223577824336,NaN,NaN,71.09364652462844,81.4650951166537,0.04664504206412717,0.3068826608869273,0.2602376188228001,759700,804040,56.85842363932702,61.495012142708006,NaN,NaN,13.680890473863666,10.231241188642366
2002-11-11T09:30:00-05:00,27.74001,27.75,27.25999,27.39,42000,201575,53.06753882669457,54.99822491437742,NaN,NaN,7.185455070780766,74.01927547516574,0.015070903365906274,0.27907624803018294,0.26400534466427666,717700,804920,56.88964182993964,59.866850691354664,NaN,NaN,12.624635602352555,10.57315467631525
2002-11-12T09:30:00-05:00,27.39,27.58,27.24001,27.41,68900,194915,53.30523949596886,54.7891441960574,NaN,NaN,-5.03239366466873,63.485831883234574,-0.006639729792118465,0.2557056824241286,0.2623454122162471,786600,809780,57.074384209281874,58.20594528893423,NaN,NaN,11.826872030721919,10.752257155516203
2002-11-13T09:30:00-05:00,27.49001,27.67,26.8,27.09,58000,184460,49.02671035314137,54.643703648974586,NaN,NaN,-49.51157975600825,27.96200661152945,-0.04271287391087408,0.20895431982765444,0.2516671937385285,728600,759780,54.48736799923986,56.76788203416625,NaN,NaN,9.894671578105168,10.62974493017177
2002-11-14T09:30:00-05:00,27.39,27.59,27.31,27.52,30600,144460,54.33124103915215,54.537001967815016,NaN,NaN,19.33940959836703,8.614907554619851,-0.03793654868617144,0.20424650788081422,0.24218305656698566,759200,750360,53.99084018319639,55.69398046746413,NaN,NaN,9.728697617508402,10.501023885505575
2002-11-15T09:30:00-05:00,27.55,27.81,27.5,27.78,43300,135700,57.22950637162114,54.73709894500085,NaN,NaN,77.36257688824149,9.868693627342461,-0.01856948810427575,0.21897119643664098,0.23754068454091673,802500,758920,54.397511777543066,55.132360051015574,NaN,NaN,10.447200707830714,10.493334860123452
2002-11-18T09:30:00-05:00,27.95,27.97,27.63,27.63,57100,134695,55.058573080996446,55.05791027689549,NaN,NaN,91.7029216505624,26.772186943298788,-0.017195409133889894,0.21604642312355438,0.23324183225744427,745400,764460,54.67672852853282,54.831941004848204,NaN,NaN,10.418299250658363,10.482615487342725
2002-11-19T09:30:00-05:00,27.50999,27.91,27.50999,27.60001,36600,103750,54.61251791983759,55.20960946017902,NaN,NaN,69.97371037778306,41.77340775178915,-0.01947306429535689,0.20890050188824816,0.22837356618360505,708800,748900,53.68253606814064,54.571412245377545,NaN,NaN,10.270836685737347,10.45236137282767
2002-11-20T09:30:00-05:00,27.39999,27.89999,27.39999,27.85001,35300,96385,57.689731395830556,55.74774390651748,NaN,NaN,72.99229506733725,66.27418271645824,-0.006007466472782663,0.2208642330926267,0.22687169956540937,744100,752000,53.862530264273346,54.46091273776123,NaN,NaN,11.00353441568987,10.531100378950843
2002-11-21T09:30:00-05:00,28.2,28.2,27.89999,28,92700,95815,59.46537058644022,56.19661820628492,NaN,NaN,132.43979549542973,88.89425989587079,0.010251096106865865,0.23968556969899169,0.22943447359212582,836800,767520,54.809370761041535,54.61994468457299,NaN,NaN,12.122336432859342,10.758419815223485
2002-11-22T09:30:00-05:00,28.10001,28.10001,27.78,27.8,228500,98235,56.085413109469776,56.37199393452222,NaN,NaN,88.4604822943898,91.11384097710045,0.00504902568994442,0.23574575570455636,0.23069673001461194,608300,728680,51.93680193586674,54.64666840045442,NaN,NaN,12.15539506912936,10.95798770863861
2002-11-25T09:30:00-05:00,27.7,27.83,27.46001,27.72,57000,93105,54.74500730599754,56.18432502976491,NaN,NaN,34.421279202074835,79.65751248740294,-0.005684840693141929,0.22359067914818453,0.22927551984132646,551300,689860,49.163365450267264,54.413850326390055,NaN,NaN,11.819854623804083,11.081111553662248
2002-11-26T09:30:00-05:00,27.5,27.57001,27.17,27.28,903700,126555,47.95640498396648,55.13045096650371,NaN,NaN,-48.63936090867416,55.93489823011149,-0.04228464467894616,0.17641971399264378,0.21870435867158994,-352400,477620,37.40330841153285,53.216477406381124,NaN,NaN,9.532229980335314,10.859842757472686
2002-11-27T09:30:00-05:00,27.64999,27.85001,27.61,27.8,52900,124895,55.050486808953245,54.709116460105534,NaN,NaN,46.45190165076225,50.62681954679649,-0.031816762520923414,0.17893340552043568,0.2107501680413591,-299500,268900,29.843106911351015,51.36256556925243,NaN,NaN,9.625461877948595,10.683502631826387
2002-11-29T09:30:00-05:00,27.78,27.85001,27.60001,27.69,27200,118490,53.392492168785814,54.35830238906107,NaN,NaN,29.832407441496077,30.10534193600976,-0.032529121588110554,0.17008876605622092,0.20261788764433147,-326700,36200,24.015049306246695,49.0166102597467,NaN,NaN,9.203929290669292,10.472135011661088
2002-12-02T09:30:00-05:00,27.85001,27.85001,27.21001,27.44,58900,119375,49.72689050952819,54.11968465212061,NaN,NaN,-47.4292090298962,2.9274036711525553,-0.04907202870497973,0.1412778517631068,0.19034988046808654,-385600,-162580,20.357678180024323,46.407184284752745,NaN,NaN,7.7386785243054295,10.081641227753137
2002-12-03T09:30:00-05:00,27.14999,27.37,26.89999,27.25999,135600,120625,47.213430720902444,53.68455545390158,NaN,NaN,-146.95885761686574,-33.34862369263557,-0.07009156675352077,0.10273542202618557,0.17282698877970634,-521200,-377080,17.296533146852255,43.56590920886492,NaN,NaN,5.756596802871518,9.463777738484334
2002-12-04T09:30:00-05:00,27.10001,27.56,27.08,27.50999,74500,121900,50.923502079114776,53.8200405771854,NaN,NaN,-78.12107329351683,-39.2449661696041,-0.06521310494870433,0.09131060759382592,0.15652371254253025,-446700,-395940,17.053719080658,40.89207714325193,NaN,NaN,5.153176414859055,8.847977549395008
2002-12-05T09:30:00-05:00,27.64,27.64,27.22,27.35001,47900,113480,48.570916186712985,53.40858880201118,NaN,NaN,-63.51451998608939,-61.23825049697442,-0.07037334754705032,0.06855702810871733,0.13893037565576766,-494600,-434960,16.53648372193497,38.216765967447536,NaN,NaN,3.9557065411650787,8.149081691076447
2002-12-06T09:30:00-05:00,27,27.47,27,27.47,34200,106575,50.42099026310672,52.922266222831574,NaN,NaN,-84.02900493570326,-84.0105329724143,-0.06352772070622134,0.059520724772990974,0.12304844547921232,-460400,-461700,16.174443135298702,35.4865467787158,NaN,NaN,3.480398259576064,7.482126915147821
2002-12-09T09:30:00-05:00,27.39999,27.78,27.35001,27.35001,53200,106905,48.540507628300325,52.45669011906757,NaN,NaN,-20.311970059561872,-78.58708517834744,-0.06468607700125435,0.04219084922764438,0.10687692622889873,-513600,-487300,15.81740663438083,32.710880929133516,NaN,NaN,2.550683354064341,6.77763497785018
2002-12-10T09:30:00-05:00,27.5,27.5,27.21001,27.45,45100,107060,50.2070709854599,52.14201533804059,NaN,NaN,-54.83735480807788,-60.16278461658985,-0.056614409571104626,0.036108914265017944,0.09272332383612257,-468500,-476760,16.63335175595779,30.064510621120455,NaN,NaN,2.2212171699953847,6.126718148156638
2002-12-11T09:30:00-05:00,27.3,27.52,27.2,27.41,137400,110485,49.5162081711809,51.55819225056562,NaN,NaN,-57.23321850504756,-55.985213658896,-0.05198547129627176,0.02774148471578286,0.07972695601205462,-605900,-508600,16.124896527527312,27.368965354210022,NaN,NaN,1.7613556446484318,5.503094933369752
2002-12-12T09:30:00-05:00,27.35001,27.38,27.05,27.13,83400,111755,44.862558439904134,50.51513424009875,NaN,NaN,-121.3249871233063,-67.54730708633937,-0.06495477946414943,-0.0014665183181321595,0.06348826114601727,-689300,-547540,15.500823671905792,24.561211990700325,NaN,NaN,0.05348440135447352,4.724579143081855
2002-12-13T09:30:00-05:00,26.8,27.17999,25.8,26.98,57600,113105,42.55519096397097,49.54868980113456,NaN,NaN,-242.18418705430093,-99.17834351005892,-0.07983011362500252,-0.03629938088523588,0.04353073273976664,-746900,-604840,14.60507629546997,21.894660159243415,NaN,NaN,-2.06356264025253,3.7548446026055142
2002-12-16T09:30:00-05:00,26.89999,27.25,26.81,27.25,39900,112935,47.76314278756865,49.04998519267535,NaN,NaN,-102.00884744009514,-115.51771898616558,-0.06813495057501656,-0.04163795547900406,0.0264969950960125,-707000,-643520,14.01626049435869,19.3841526623928,NaN,NaN,-2.468027239578559,2.8658629108649323
2002-12-17T09:30:00-05:00,27.14999,27.14999,26.84,26.89,48000,112480,42.26158847486669,48.64321258488251,NaN,NaN,-126.1502867422923,-129.78030537300847,-0.08044882927225241,-0.07406404149430301,0.006384787777949395,-755000,-700820,13.169248686384194,17.653148396310748,NaN,NaN,-4.492582227698239,1.814656462498765
2002-12-18T09:30:00-05:00,26.86,26.87,26.66,26.81,31700,112235,41.12788099193761,47.64874074080996,NaN,NaN,-153.90975203100794,-149.11561207820054,-0.08911329131120393,-0.10500682636105552,-0.01589353504985159,-786700,-736980,12.649734745114372,16.4250503844367,NaN,NaN,-6.493043909939948,0.6278421235789491
2002-12-19T09:30:00-05:00,26.73,26.95,26.5,26.55,49000,112920,37.5977925363427,46.52054790992116,NaN,NaN,-155.99783736915904,-156.0501821273711,-0.10632023654278279,-0.14879383072833008,-0.04247359418554729,-835700,-766260,12.229050469859033,15.583193324694728,NaN,NaN,-9.30141018912958,-0.7906224925222693
2002-12-20T09:30:00-05:00,26.75,26.75,26.5,26.67999,424800,129525,40.354242366490006,45.85107304256129,NaN,NaN,-139.74998050055797,-135.5633408166225,-0.10284885220422445,-0.17103465944082785,-0.0681858072366034,-410900,-699060,18.89561489013721,15.478760232559932,NaN,NaN,-10.854840295859837,-2.2283678929990645
2002-12-23T09:30:00-05:00,26.78,26.98,26.74001,26.85001,60000,121100,43.84797990055299,45.61068369825062,NaN,NaN,-82.06343626677942,-131.57425858195936,-0.08380963277915833,-0.1729478482105513,-0.08913821543139298,-350900,-627840,25.365660700843137,16.055126486416423,NaN,NaN,-11.16211150066698,-3.504616979808766
2002-12-24T09:30:00-05:00,26.95,27.14,26.95,27,67500,121625,46.808060385558626,45.316723577282325,NaN,NaN,-37.0898580454133,-113.76217284258355,-0.057098111964254544,-0.16051085538671117,-0.10341274342245663,-283400,-533520,32.98979396738804,17.19341754975428,NaN,NaN,-10.562380353210925,-4.512868890294788
2002-12-26T09:30:00-05:00,27,27,26.45,26.53999,76000,80240,39.866788741683166,44.69500018835162,NaN,NaN,-108.16734594317987,-104.61369162501792,-0.0657766401170391,-0.1856335435687555,-0.1198569034517164,-359400,-448060,39.06374550585234,18.802507677176948,NaN,NaN,-12.171029613149996,-5.606891850702675
2002-12-27T09:30:00-05:00,26.5,26.53,26.11,26.19,42800,79735,35.54760404508521,43.632615458492936,NaN,NaN,-168.32847184560993,-107.0798185203081,-0.0890108849159355,-0.23112050959663577,-0.14210962468070026,-402200,-361360,44.55456373314567,20.82965914845173,NaN,NaN,-14.974491654155273,-6.9451203940530455
2002-12-30T09:30:00-05:00,26.2,26.53999,26.13,26.42999,88600,82805,40.32208693926639,43.04558540927622,NaN,NaN,-132.89418881333108,-105.70866018286272,-0.08229637430148054,-0.24498009255755093,-0.1626837182560704,-313600,-341900,45.73645598826267,22.966734102300432,NaN,NaN,-15.778697499177092,-8.207059980499338
2002-12-31T09:30:00-05:00,26.39,26.64,26.19,26.55,93700,84545,42.61148461979855,42.5030435260147,NaN,NaN,-101.90925339500112,-109.67782360850705,-0.0646318229603215,-0.24347349695647225,-0.17884167399615075,-219900,-315700,47.36329259200379,25.16172987630372,NaN,NaN,-15.71690356262409,-9.279894777945731
2003-01-02T09:30:00-05:00,26.75,27.32001,26.7,27.27,102000,82865,54.010472727749125,42.82406242291243,NaN,NaN,29.255459198378396,-96.40876015974872,-0.0025927340876357174,-0.1820825916056954,-0.17948985751805968,-117900,-282600,49.42616813531428,27.54039213400279,NaN,NaN,-11.624674112094919,-9.614863254252759
2003-01-03T09:30:00-05:00,27.3,27.61,27.3,27.55,71100,82695,57.54236409664136,43.729762826965086,NaN,NaN,107.17504771395318,-53.34028142832212,0.055933400964391394,-0.10957310631257045,-0.16550650727696184,-46800,-220080,53.160175978064274,30.230345870156963,NaN,NaN,-7.05503025953089,-9.249172826435348
2003-01-06T09:30:00-05:00,27.64,27.89999,27.55,27.85001,55500,83075,60.9985093108255,45.047142708883264,NaN,NaN,152.04055786349335,10.733524513498526,0.11033915582760259,-0.027582562492458607,-0.1379217183200612,8700,-137900,57.59242964146736,33.30087110915678,NaN,NaN,-2.097841838313432,-8.227554113846503
2003-01-07T09:30:00-05:00,27.8,27.84,27.39,27.45,136200,88175,54.61488924190535,45.536553169907314,NaN,NaN,106.02071004081404,58.51650428432756,0.11438517036122813,0.005059744631473961,-0.10932542572975416,-127500,-100680,59.46333691548624,36.54709085352304,NaN,NaN,-0.12351425144045611,-7.069834133502782
2003-01-08T09:30:00-05:00,27.32001,27.55,27.11,27.24001,63100,88670,51.56412988705294,46.20102041363491,NaN,NaN,61.0530969513576,91.1089743535993,0.09852050205663007,0.013825201841033419,-0.08469530021559665,-190600,-94820,59.764309034976925,39.87530944985109,NaN,NaN,0.440134254790521,-5.996981506603739
2003-01-09T09:30:00-05:00,27.3,27.64999,27.23,27.52,623400,117585,55.1606676309717,47.20336231642305,NaN,NaN,91.13769046589162,103.48542060710194,0.10205268637525389,0.042870557753470706,-0.05918212862178318,432800,15320,65.02105633991476,43.61611813519397,NaN,NaN,2.0997004559031858,-4.840312654817036
2003-01-10T09:30:00-05:00,27.39999,27.58,27.33,27.50999,544300,137930,55.00342023851369,48.44662143800669,NaN,NaN,90.24665065177068,100.09974119466544,0.09881755797748175,0.06433981885006901,-0.03447773912741274,-111500,2380,63.963719810628916,47.311451659534676,NaN,NaN,3.347712095027001,-3.670594833410745
2003-01-13T09:30:00-05:00,27.67,27.67,27.37,27.53,61400,136830,55.27787706929603,49.51259534534997,NaN,NaN,92.09739970755432,88.11110956347764,0.09320098091455285,0.08202348701577833,-0.011177493898774524,-50100,-9380,62.96166120359955,50.45902639621056,NaN,NaN,4.429549660001576,-2.513431334351842
2003-01-14T09:30:00-05:00,27.31,27.55,27.31,27.50999,26400,135270,54.917143001452665,50.3032498525571,NaN,NaN,72.5684468923375,81.42065693378234,0.08361978142111769,0.09334723287762259,0.009727451456504901,-76500,820,63.495831099676245,53.18260999612721,NaN,NaN,5.214683067528791,-1.4094149912260372
2003-01-15T09:30:00-05:00,27.5,27.5,27.10001,27.2,154300,140990,49.5251772966821,50.49732963192306,NaN,NaN,36.68461436142663,76.54696041579614,0.05335946315511889,0.07642678040040352,0.023067317245284623,-230800,-7220,62.72788783840791,55.30675955834291,NaN,NaN,4.3631371235113905,-0.5847646891206905
2003-01-16T09:30:00-05:00,27,27.42999,26.95,27.12,85000,142840,48.209649155018965,51.093248232875624,NaN,NaN,17.570737453639826,61.833569813345775,0.026279977241276804,0.055917288796880626,0.029637311555603823,-315800,-156940,50.483392125052106,56.12244860257147,NaN,NaN,3.282516250905581,-0.03229598340265172
2003-01-17T09:30:00-05:00,26.97,27.24001,26.97,27.10001,56400,144075,47.867494627073896,51.97324041730338,NaN,NaN,3.9472501515822533,44.57368971330809,0.006383527442807117,0.03761672085911272,0.0312331934163056,-372200,-209080,47.03972691747694,56.299960258595135,NaN,NaN,2.294569383479573,0.30011335472338035
2003-01-21T09:30:00-05:00,27.10001,27.2,26.8,26.89999,103000,146775,44.46678636268131,52.26929037611874,NaN,NaN,-24.669591861634956,21.220291399470238,-0.019471373068711367,0.006893977080416391,0.026365350149127758,-475200,-294100,42.00777140105997,56.033625645223516,NaN,NaN,0.484396812384078,0.3264395629606229
2003-01-22T09:30:00-05:00,26.85001,27.08,26.83,26.83,173100,134190,43.307374371335946,52.31899678694283,NaN,NaN,-38.94391922363587,-1.0821818237244343,-0.03936296842069574,-0.022838360376741917,0.016524608043953823,-648300,-408460,36.37173545394106,55.24851442107617,NaN,NaN,-1.3630495415003796,0.08508397660905109
2003-01-23T09:30:00-05:00,26.89999,26.96001,26.72,26.91,138200,138100,45.070354892399166,51.68041694156069,NaN,NaN,-48.95868743840102,-18.210842183689962,-0.04481240176610192,-0.03949089416367357,0.005321507602428343,-510100,-464320,33.97399485330533,54.14478775807554,NaN,NaN,-2.486873514942977,-0.2823385221840957
2003-01-24T09:30:00-05:00,26.83,26.83,26.14,26.32001,165500,143000,36.14363153572988,50.15193604435274,NaN,NaN,-117.09198714392922,-45.14338710320377,-0.08357915950917941,-0.09915244178404592,-0.015573282274866512,-675600,-536280,31.127218231028095,52.57100506185866,NaN,NaN,-6.3484933764400004,-1.148932072792082
2003-01-27T09:30:00-05:00,25.95,25.95,25.52,25.74001,69500,142675,29.87852716904284,47.92908017708255,NaN,NaN,-203.0885661379889,-86.55055036111801,-0.14036832094857482,-0.19103368346058502,-0.05066536251201022,-745100,-610860,28.465054841380848,50.490478290423916,NaN,NaN,-12.09544594467176,-2.712719768774893
2003-01-28T09:30:00-05:00,25.75,26.19,25.64999,26.17999,39200,142495,38.57654669752562,46.78348428105543,NaN,NaN,-152.89377321415964,-112.19538663162294,-0.14006392565277673,-0.22574526957798113,-0.0856813439252044,-705900,-657000,26.930512389846868,48.1667051100211,NaN,NaN,-14.036043815343483,-4.330337489713263
2003-01-29T09:30:00-05:00,26.10001,26.53,25.87,26.42999,35300,139830,42.90987969391476,46.16532355297413,NaN,NaN,-110.15138794840206,-126.43688037657617,-0.11579519773925251,-0.23042534109927004,-0.11463014336001753,-670600,-661460,26.78022482312832,45.81069909488905,NaN,NaN,-14.131470410727925,-5.7304993355725005
2003-01-30T09:30:00-05:00,26.45,26.45,25.92,25.94,72300,138760,37.34838471306321,44.893017630266385,NaN,NaN,-127.23342772161776,-142.09182843321952,-0.12473880959643369,-0.27055365535555964,-0.14581484575912596,-742900,-708020,25.1992366615291,42.966283403575794,NaN,NaN,-16.175700554695062,-7.2226709383042955
2003-01-31T09:30:00-05:00,26,26.46001,25.87,26.46001,19900,134655,45.4316079241189,44.20931675066675,NaN,NaN,-91.34961748333609,-136.9433545011009,-0.0892902882448002,-0.2574277060651262,-0.168137417820326,-723000,-717500,24.877206858935352,40.17438962131197,NaN,NaN,-14.95959566359798,-8.327945899060536
2003-02-03T09:30:00-05:00,26.55,26.63,26.32001,26.35001,189200,140560,44.134441765154044,43.413357086085185,NaN,NaN,-61.294253706727204,-108.58449201484855,-0.06787816363486143,-0.2529851223639028,-0.18510695872904137,-912200,-750920,23.726094471659692,37.371849140459126,NaN,NaN,-14.4639592537957,-9.204519235451274
2003-02-04T09:30:00-05:00,26,26.03999,25.72,26.03999,50600,140315,40.61476219571438,42.39175845710388,NaN,NaN,-110.2547355953855,-100.05668449109372,-0.06899634057787613,-0.27135238445138654,-0.20235604387351042,-962800,-802300,22.03776935549611,34.41055901587483,NaN,NaN,-15.241509278271566,-10.066946384425602
2003-02-05T09:30:00-05:00,26.10001,26.45,25.85001,25.85001,147400,140875,38.58410428659253,41.610253242097485,NaN,NaN,-84.82534895726735,-94.99147669286678,-0.07635952838538507,-0.29780545435524175,-0.22144592596985668,-1110200,-890220,19.48293644165372,31.321633916106673,NaN,NaN,-16.53098223730601,-10.990380077694232
2003-02-06T09:30:00-05:00,25.85001,25.92,25.61,25.8,104200,142930,38.04486374051523,40.884197141061506,NaN,NaN,-105.31244799417358,-90.60728074737796,-0.07814438032913795,-0.3191264013812791,-0.24098202105214117,-1214400,-984520,17.182127749385074,28.9429721749876,NaN,NaN,-17.718164067434387,-11.95149207622854
2003-02-07T09:30:00-05:00,26.05,26.05,25.52,25.75,398900,131705,37.48086062280438,40.142294712185105,NaN,NaN,-96.38206282286572,-91.61376981528387,-0.07616052950920321,-0.33618268293864517,-0.26002215342944196,-1613300,-1162580,13.854984500615757,26.572633430926086,NaN,NaN,-18.843404308334293,-12.936050966529361
2003-02-10T09:30:00-05:00,25.60001,25.97,25.53999,25.94,20500,105515,41.056779147954444,39.898722768276045,NaN,NaN,-84.81781433213523,-96.31848194036549,-0.05642870097834762,-0.33055802965237646,-0.27412932867402884,-1592800,-1298700,11.949957363975983,24.42564671399151,NaN,NaN,-18.761211954956657,-13.768216822018974
2003-02-11T09:30:00-05:00,25.89999,26.17999,25.64,25.64,28400,103865,37.41760417044448,39.47802489678379,NaN,NaN,-79.49903881595313,-90.167342584479,-0.05774920175742004,-0.34631583087080386,-0.2885666291133838,-1621200,-1430380,10.452670714429303,22.574284946883527,NaN,NaN,-19.768114644071414,-14.62534508231218
2003-02-12T09:30:00-05:00,25.64999,25.67,25.2,25.35001,43600,104725,34.25670861777357,38.705621591453394,NaN,NaN,-127.45168533843696,-98.69260986071292,-0.0714252349366114,-0.37784817278414806,-0.30642293784753666,-1664800,-1541300,9.385859942647514,20.817989596122253,NaN,NaN,-21.59803783682227,-15.621444047242193
2003-02-13T09:30:00-05:00,25.08,25.25999,24.66,25.05,100500,102035,31.309891871756278,38.36035447259814,NaN,NaN,-170.67369833528403,-111.76485992893501,-0.09260521663312271,-0.42217945863894,-0.3295742420058173,-1765300,-1651480,8.461991182767804,19.199044806960803,NaN,NaN,-24.087101580617265,-16.830823694867203
2003-02-14T09:30:00-05:00,25.14999,25.39999,24.94,25.32001,136600,104615,36.59619000571624,38.84018753236052,NaN,NaN,-129.33814086256402,-118.35607553687468,-0.08078982749569963,-0.43056152637544187,-0.34977169887974224,-1628700,-1654560,8.4369902396991,17.768468763983538,NaN,NaN,-24.577071222113826,-17.937430484473865
2003-02-18T09:30:00-05:00,25.75,26,25.75,25.94,99300,106760,46.733076548632674,39.4227968074396,NaN,NaN,-22.886780665769646,-105.96986880360154,-0.026393919026844403,-0.3827640976632978,-0.35637017863645337,-1529400,-1641880,9.620863552057713,16.532065275570027,NaN,NaN,-21.61112904730567,-18.462244564878407
2003-02-19T09:30:00-05:00,25.99001,25.99001,25.64999,25.82001,110400,107130,45.22604315860297,39.58823705491733,NaN,NaN,-29.376625940814456,-95.94538622857382,0.004675472838906181,-0.35052583758782063,-0.3552013104267268,-1639800,-1645600,9.58172208400562,15.30360079420412,NaN,NaN,-19.726052070741176,-18.642788494287373
2003-02-20T09:30:00-05:00,25.85001,25.95,25.5,25.53,20200,99485,41.723884329578404,39.90077274181126,NaN,NaN,-53.96978431564873,-81.24900602401618,0.00863461159558887,-0.3444080459322407,-0.3530426575278296,-1660000,-1644640,9.68383989494221,14.195358168019341,NaN,NaN,-19.250471543843634,-18.729600358509696
2003-02-21T09:30:00-05:00,25.5,25.99001,25.31,25.78999,60800,95615,45.77760913739418,39.92548711418807,NaN,NaN,-39.307913252020015,-54.97584900736338,0.030474059393881536,-0.3149500832854777,-0.3454241426793592,-1599200,-1611420,13.33154239841798,13.370667849410959,NaN,NaN,-17.563636048592276,-18.563034028521493
2003-02-24T09:30:00-05:00,25.8,25.8,25.35001,25.45,31400,88910,41.69325277376197,39.751116471945785,NaN,NaN,-73.87606277347608,-43.88343338954579,0.02401690007579005,-0.31540301758462164,-0.3394199176604117,-1630600,-1611800,13.324912803787527,12.627726301705803,NaN,NaN,-17.42726836245562,-18.40078179051208
2003-02-25T09:30:00-05:00,25.10001,25.62,24.91,25.62,27400,86805,44.36611968149542,40.019070578073006,NaN,NaN,-101.26488983110391,-59.55905522261264,0.032654101571913396,-0.2986022906955199,-0.3312563922674333,-1603200,-1626560,13.053383247935116,11.985984436880017,NaN,NaN,-16.482425245605327,-18.126730855525402
2003-02-26T09:30:00-05:00,25.58,25.96001,25.44,25.48,27400,86215,42.632847915397264,40.308266551559065,NaN,NaN,-36.704211103845275,-61.0245722552188,0.030441478539091016,-0.29320454409356955,-0.32364602263266057,-1630600,-1624720,13.290594393855017,11.543674290608683,NaN,NaN,-16.22684343426512,-17.855318366773933
2003-02-27T09:30:00-05:00,25.55,26,25.55,25.8,9900,84945,47.66563757564782,40.995464682639955,NaN,NaN,9.146937494403758,-48.401227893208315,0.05083112811198187,-0.26010711249268326,-0.31093824060466513,-1620700,-1616860,14.365378395995336,11.342477908223701,NaN,NaN,-14.457722905376858,-17.36994758657435
2003-02-28T09:30:00-05:00,25.8,26.07001,25.8,25.87,35200,83090,48.72533305736099,41.79864128510828,NaN,NaN,48.15493672592067,-30.908657897620174,0.0682483147749749,-0.22562784713594652,-0.2938761619109214,-1585500,-1614120,14.76202233438164,11.407266324921263,NaN,NaN,-12.706555805828243,-16.703748760753477
2003-03-03T09:30:00-05:00,26,26.32001,25.67999,25.74001,416900,102940,46.82903776812962,42.21094547226365,NaN,NaN,56.29310344828548,-4.874824653267865,0.06997093526532744,-0.2064124928292621,-0.27638342809458954,-2002400,-1688480,13.001939593669888,11.482407912756543,NaN,NaN,-11.78054874322656,-16.000434472535346
2003-03-04T09:30:00-05:00,25.82001,25.82001,25.46001,25.46001,23300,94645,42.951449068012785,42.60622010780424,NaN,NaN,-32.61063174242128,8.856026964468661,0.05203343745592082,-0.21134163127468852,-0.26337506873060934,-2025700,-1772980,11.346374199812928,11.546243875998229,NaN,NaN,-12.103064083173761,-15.44366727405512
2003-03-05T09:30:00-05:00,25.45,25.88,25.39999,25.7,143200,99275,47.0021012738708,43.51660529752547,NaN,NaN,-2.0698065483080805,15.782907875576097,0.055779623930791,-0.19365053881712058,-0.24943016274791158,-1882500,-1823360,10.488839371031986,11.625028120882833,NaN,NaN,-11.187969809481904,-14.835710493401804
2003-03-06T09:30:00-05:00,25.55,25.81,25.55,25.75,83300,96070,47.83316884600611,44.69683936711475,NaN,NaN,20.239230737083773,18.0013665241121,0.06066849135226718,-0.1735945485575776,-0.2342630399098448,-1799200,-1859060,9.916880896456647,11.728948814717752,NaN,NaN,-10.201450799660954,-14.173673394295967
2003-03-07T09:30:00-05:00,25.39999,26.07001,25.39999,26,49300,93325,51.89500626273164,45.78961195690157,NaN,NaN,63.230059617867205,21.016391102501405,0.07864254354473144,-0.1359598604789305,-0.21460240402366193,-1749900,-1891940,9.408037235686862,11.798309314431163,NaN,NaN,-8.165022696251095,-13.3152947231467
2003-03-10T09:30:00-05:00,25.85001,25.87,25.48,25.56,161000,81430,45.22128144101067,45.681626592071424,NaN,NaN,-2.8145874491960297,9.194852923005104,0.05966247623417481,-0.1400243087309434,-0.1996867849651182,-1910900,-1873640,12.111046466464614,11.976179522603086,NaN,NaN,-8.346049328303325,-12.60540252388336
2003-03-11T09:30:00-05:00,25.39999,25.45,25.14999,25.22,34600,82135,40.84966409685451,45.369028087660816,NaN,NaN,-118.56876811733157,-7.99677435197694,0.024761032760833995,-0.16873549401407573,-0.19349652677490972,-1945500,-1857600,14.51855412131178,12.32881038241067,NaN,NaN,-9.881260538109133,-12.21623938305847
2003-03-12T09:30:00-05:00,25.14999,25.3,24.88,25.3,59700,83700,42.26396552661285,45.407605316020415,NaN,NaN,-132.9991841271954,-34.1826498677544,0.008456953896860964,-0.18292533440383352,-0.19138228830069448,-1885800,-1858260,14.500952439485374,12.672889849878038,NaN,NaN,-10.70223461812481,-11.999952988067948
2003-03-13T09:30:00-05:00,25.60001,25.66,25.19,25.66,27400,82890,48.259310458274605,45.58486969608331,NaN,NaN,-27.57201977855284,-43.74489997088172,0.022513700394824893,-0.16324016280716336,-0.18575386320198825,-1858400,-1870100,14.169084694080269,12.732714299568203,NaN,NaN,-9.567856782300781,-11.652510672958353
2003-03-14T09:30:00-05:00,25.77,25.77,25.35001,25.45,408900,98310,45.3039863408299,45.84277923658816,NaN,NaN,-35.16394924977155,-63.42370174440947,0.018435764510306346,-0.1627091575641053,-0.18114492207441166,-2267300,-1973580,11.657901960876629,12.61364209650314,NaN,NaN,-9.522741576222336,-11.348257944853207
2003-03-17T09:30:00-05:00,25.2,26.28,25.2,26.17,315000,107230,55.39065466816985,46.630246021350615,NaN,NaN,96.6899029178552,-43.522803670999224,0.06251354168710072,-0.10300299496553578,-0.1655165366526365,-1952300,-1981860,11.482540917005892,12.501439072865338,NaN,NaN,-6.026157624481039,-10.587957899085755
2003-03-18T09:30:00-05:00,26.2,26.47,26.2,26.45,68800,105705,58.588949737756046,47.76996758009053,NaN,NaN,251.53247386848727,30.49744472616453,0.10624150387838341,-0.03271465680465724,-0.13895616068304065,-1883500,-1969460,13.57910204611484,12.522046762312467,NaN,NaN,-2.082950561112902,-9.372956850803918
2003-03-19T09:30:00-05:00,26.55,26.89,26.35001,26.75,39400,102155,61.75296358083133,48.77620515188935,NaN,NaN,269.04937420523,110.90715639264961,0.14849212417725835,0.046658994538532284,-0.10183312963872607,-1844100,-1961120,15.036704163286458,12.569998602833262,NaN,NaN,2.2364159233744694,-7.714475025921292
2003-03-20T09:30:00-05:00,26.75,26.82001,26.38,26.72,106100,106450,61.24899233172553,49.67075224291539,NaN,NaN,202.57386108135435,156.93633256463104,0.16620365521923655,0.10592143938531962,-0.06028221583391693,-1950200,-1979480,14.458559460405297,12.548322683263523,NaN,NaN,5.463010204307579,-5.831977135888597
2003-03-21T09:30:00-05:00,26.89999,27.42,26.84,27.34,50900,105955,67.20564373700734,51.12622409783523,NaN,NaN,244.27544845990616,212.82421210656656,0.2087087625237118,0.20060373732072279,-0.008105025202988989,-1899300,-1905880,26.63601685480809,13.522185344773394,NaN,NaN,10.407700924195566,-3.5120231273051448
2003-03-24T09:30:00-05:00,26.89999,26.94,26.5,26.57001,56400,107205,55.74512758765229,52.04005827780948,NaN,NaN,125.7954592776109,218.64532337851773,0.17534421111971482,0.21107523869665457,0.03573102757693973,-1955700,-1906560,26.59834210226714,14.611611623520124,NaN,NaN,10.702729357365543,-1.4813442009236182
2003-03-25T09:30:00-05:00,26.58,27.24001,26.57001,27.10001,68300,109250,60.71150066463733,53.01930109143565,NaN,NaN,142.14374967515815,196.7675785398519,0.17873773225439346,0.25915319289493155,0.08041546064053809,-1887400,-1907340,26.55194958740232,15.758976638975147,NaN,NaN,12.758367273554008,0.5529002954303284
2003-03-26T09:30:00-05:00,27.05,27.08,26.87,26.89,193000,117530,57.93701093152198,53.74100409754393,NaN,NaN,116.641579236307,166.28601954606728,0.15735951830025915,0.27711485851586204,0.11975534021560288,-2080400,-1954600,23.83886844362229,16.753404320915553,NaN,NaN,13.391598131439544,2.386999986288788
2003-03-27T09:30:00-05:00,26.60001,27.11,26.55,26.99001,93400,121705,58.90026166159581,54.241379483177084,NaN,NaN,94.08862454364848,144.58897223852614,0.1410016399660023,0.29600739017310573,0.15500575020710344,-1987000,-1961960,23.437224403631973,17.755489118625917,NaN,NaN,14.19853632410237,4.074362320262157
2003-03-28T09:30:00-05:00,26.83,27.16,26.83,27.03,235800,131735,59.30159868547506,55.24711642921026,NaN,NaN,95.15308402843696,114.76449935223229,0.12449621030909497,0.31062601309347215,0.18612980278437719,-1751200,-1932340,28.647456524223898,18.936661265608723,NaN,NaN,14.957615687204914,5.62911280125398
2003-03-31T09:30:00-05:00,26.7,27.02,26.56,26.72,203500,121065,54.83170786680152,56.245833841349324,NaN,NaN,61.781364339041914,101.96168036451851,0.08614424403240956,0.29381010782488914,0.2076658637924796,-1954700,-1932140,28.682747497119905,19.94838936388073,NaN,NaN,14.225126671362181,6.857114782698009
2003-04-01T09:30:00-05:00,26.88,27.09,26.7,27.09,197100,129755,58.82129464357568,57.428500206846664,NaN,NaN,75.08629151055317,88.5501887315975,0.07930943652470873,0.3068026594483655,0.22749322292365676,-1757600,-1906180,33.294591375454985,21.290792145021417,NaN,NaN,14.830701767896187,7.9961986377263194
2003-04-02T09:30:00-05:00,27.5,27.60001,27.41,27.49001,27000,123945,62.66110291321559,58.457199667913876,NaN,NaN,120.69844719356342,89.36156232304879,0.094321671290793,0.345395312037148,0.251073640746355,-1730600,-1836220,43.83536998258461,23.409812522771727,NaN,NaN,16.566489471113716,9.220525899638805
2003-04-03T09:30:00-05:00,27.55,27.57001,27.3,27.42,466700,143115,61.578816757119775,59.619687554791724,NaN,NaN,103.88878738047624,91.32159489041433,0.09202968623779983,0.3661107485436048,0.274081062305805,-2197300,-1878280,39.76684548298628,25.417594202922412,NaN,NaN,17.63215710524894,10.422187500440252
2003-04-04T09:30:00-05:00,27.60001,27.62,27.39999,27.53,114600,146380,62.66980877718626,60.139627134007185,NaN,NaN,104.50420135556091,93.19181835583913,0.0902899644776502,0.38694351790286774,0.29665355342521754,-2082700,-1944580,34.35407661717821,27.051275324363296,NaN,NaN,18.82588961315328,11.62271637368497
2003-04-07T09:30:00-04:00,28,28.03999,27.22,27.28999,70100,141835,58.74987169702011,60.1511215596689,NaN,NaN,99.71379631127385,100.77830475028551,0.06644498013411221,0.3797097785928578,0.3132647984587456,-2152800,-1984200,31.587168930849074,28.337565816130027,NaN,NaN,18.70882327113007,12.635017359034268
2003-04-08T09:30:00-04:00,27.23,27.39999,27.13,27.32001,64000,143305,59.094513790769575,59.96123228895021,NaN,NaN,70.32309346799738,99.82566514177435,0.04707608114518175,0.3721098998902228,0.32503381874504106,-2088800,-2050440,27.586733980851832,29.233996517384696,NaN,NaN,18.707680829627453,13.502540711976152
2003-04-09T09:30:00-04:00,27.2,27.56,26.89999,26.96001,185200,149580,53.339235847475315,59.39624968293233,NaN,NaN,47.29281733244436,85.14453916955054,0.006530594277319279,0.33319706159169016,0.3266664673143709,-2274000,-2159120,22.54233529062347,29.811409076685997,NaN,NaN,17.041356818832682,14.008085870098514
2003-04-10T09:30:00-04:00,26.89,26.94,26.64999,26.91,33300,149875,52.57324607949112,58.351078421681166,NaN,NaN,-9.291502499347578,62.50848119358578,-0.02539455313304534,0.2949232758980642,0.32031782903110956,-2307300,-2181120,21.678184063204156,29.457278163,NaN,NaN,15.451308764069308,14.214260569237199
2003-04-11T09:30:00-04:00,26.98,27.23,26.7,26.78,47600,131810,50.541382808014056,57.97938236599272,NaN,NaN,-11.409619686792809,39.32571698511505,-0.055289965399519636,0.25120537228171,0.30649533768122966,-2354900,-2235560,19.668859290890396,28.962315105044517,NaN,NaN,13.535639387744745,14.117314686166848
2003-04-14T09:30:00-04:00,26.85001,27.22,26.85001,27.22,26900,117405,56.648396091206365,57.689160610747656,NaN,NaN,21.240318464560584,23.631021415772388,-0.04584392669824744,0.2491904293084204,0.29503435600666783,-2328000,-2270600,18.481466692585187,28.385852041129006,NaN,NaN,13.529536566511716,14.033346383358973
2003-04-15T09:30:00-04:00,27.2,27.25,26.94,27.05,400200,133975,53.880198962482865,57.399388327244864,NaN,NaN,8.560263172084245,11.278455356589763,-0.0510588930050665,0.23121073975033468,0.2822696327554012,-2728200,-2398480,14.937324133745676,27.750027447566392,NaN,NaN,12.725893855170087,13.84656745076056
2003-04-16T09:30:00-04:00,27.2,27.2,26.35001,26.41,166100,140310,44.97067435170645,56.404417805109915,NaN,NaN,-114.19081600823078,-21.018271311545266,-0.09506764451795668,0.16343507710795535,0.25850272162591204,-2894300,-2522540,12.4441442318696,26.96480743529765,NaN,NaN,9.119033914844218,13.171205517058226
2003-04-17T09:30:00-04:00,26.60001,26.74001,26.44,26.67,24000,136205,48.68314820540056,55.64595705653316,NaN,NaN,-123.8529715460877,-43.93056512089329,-0.10343200173421901,0.12921271945813828,0.2326447211923573,-2870300,-2635140,10.698709876671785,25.682754103329643,NaN,NaN,7.262967281897302,12.327171483463808
2003-04-21T09:30:00-04:00,26.7,27.03999,26.64,26.74001,59000,136610,49.66780858986202,55.27710710818034,NaN,NaN,-63.578802461879256,-54.364401675910585,-0.10090564521992698,0.10651266466744858,0.20741830988737556,-2811300,-2726420,9.531565349689927,24.31481252137036,NaN,NaN,6.061425640643031,11.43206493448941
2003-04-22T09:30:00-04:00,26.55,27.31,26.55,27.19,183900,142985,55.56900377755436,55.04480061775024,NaN,NaN,-9.02028878341602,-60.4165231255059,-0.067206215836588,0.12341054009164054,0.19061675592822855,-2627400,-2786300,8.849533802481503,22.568736980443685,NaN,NaN,6.842122270987512,10.776358839703425
2003-04-23T09:30:00-04:00,27.60001,27.60001,27.3,27.42,66300,142885,58.26258073837666,54.7306204624046,NaN,NaN,103.91444435930246,-41.345686888062254,-0.029620759378590628,0.15359080670499026,0.18321156608358088,-2561100,-2752880,12.608087957302502,20.338216835780678,NaN,NaN,8.333074717388286,10.427318250801262
2003-04-24T09:30:00-04:00,27.39999,27.75,27.31,27.59,35300,135000,60.183934979626905,54.63098604972654,NaN,NaN,116.42941335617624,4.77835898481915,0.004668543703625294,0.1890472457131125,0.1843787020094872,-2525800,-2679180,20.402887596805186,18.955076986767743,NaN,NaN,10.153666583051029,10.38822515540837
2003-04-25T09:30:00-04:00,27.62,27.7,27.14999,27.21001,233100,141985,54.180089588637905,54.0245775362588,NaN,NaN,58.51516408501256,41.2519861110392,-0.000015337699478534805,0.18435952988513904,0.18437486758461757,-2758900,-2656900,22.64900273240559,18.11900028071256,NaN,NaN,9.881546859467873,10.315842541702585
2003-04-28T09:30:00-04:00,27.10001,27.57001,27.10001,27.42999,156500,138020,56.86293254401582,53.88979616818707,NaN,NaN,55.94615252803662,65.15697710902238,0.009407399419372048,0.19613411685883264,0.1867267174394606,-2602400,-2615120,26.819319803980378,17.778439628793365,NaN,NaN,10.478276746227984,10.339047428063356
2003-04-29T09:30:00-04:00,27.42999,27.73,27.41,27.60001,52500,130470,58.86753056261967,53.873583080462076,NaN,NaN,97.68829689689895,86.49869424508536,0.023968164436535017,0.21668692298512937,0.19271875854859435,-2549900,-2599620,28.362412641837224,17.83384524743518,NaN,NaN,11.578113688451355,10.51605689383307
2003-04-30T09:30:00-04:00,27.50999,27.8,27.39999,27.60001,34100,122320,58.86753056261967,54.26846127440096,NaN,NaN,92.4980244237329,84.21541025797144,0.030081138940203866,0.2303201822238492,0.20023904328364533,-2549900,-2597380,28.596735515609353,18.26630240636274,NaN,NaN,12.464578896436567,10.794417179919284
2003-05-01T09:30:00-04:00,27.67999,27.88,27.3,27.67999,50800,123510,59.884572493927806,54.790698875432156,NaN,NaN,94.02791082843257,79.7351097524227,0.03561432553792626,0.24475695020605315,0.2091426246681269,-2499100,-2592040,29.191353375773133,18.802957357260528,NaN,NaN,13.487628879616725,11.17916170844749
2003-05-02T09:30:00-04:00,27.7,28.19,27.64999,28.10001,38500,102100,64.80604838337987,55.80960355938686,NaN,NaN,158.39394273164206,99.7108654817486,0.062113439676566934,0.28678442426383555,0.2246709845872686,-2460600,-2532380,35.63991920946489,19.943747351444415,NaN,NaN,15.878148341195997,11.850445513125848
2003-05-05T09:30:00-04:00,28.2,28.37,28,28.14,152200,103980,65.24325741160928,56.42352222512993,NaN,NaN,175.66735107192932,123.65510519052714,0.07597026779557842,0.3196338193317416,0.2436635515361632,-2308400,-2473580,41.312744456569746,21.57455290601474,NaN,NaN,17.96367341914325,12.723763785414048
2003-05-06T09:30:00-04:00,28.2,28.28,27.98,28.19,107100,105830,65.81507693495949,57.27601350887825,NaN,NaN,151.40006022282995,134.39745785571336,0.08164242133925009,0.34571657821022583,0.26407415687097574,-2201300,-2403860,47.249806868751904,23.88258738708662,NaN,NaN,19.860787552801174,13.743338609326495
2003-05-07T09:30:00-04:00,28,28.22,27.92,27.95,57900,105525,60.65657370063896,58.39643489094486,NaN,NaN,113.52003227485949,138.60185942593867,0.0631940336611222,0.3430666989473785,0.2798726652862563,-2259200,-2345720,51.6430853168396,26.68251175029876,NaN,NaN,20.118164635465618,14.654028041632083
2003-05-08T09:30:00-04:00,27.7,28.07001,27.7,27.85001,37100,98120,58.59596268259998,59.10449306788768,NaN,NaN,78.60306451613337,135.51689016347882,0.03938553212987522,0.32910458044860036,0.28971904831872514,-2296300,-2305160,54.49064575956958,29.810507170505748,NaN,NaN,19.77347344983454,15.385377385661005
2003-05-09T09:30:00-04:00,28,28.19,27.87,28.16,21700,97540,62.813677168961824,60.043483680680524,NaN,NaN,100.53583933850375,123.94526948485115,0.039539694287468063,0.33914366617806024,0.2996039718905922,-2274600,-2267960,56.99209847031098,33.2005452505501,NaN,NaN,20.65909760773271,16.138765988814107
2003-05-12T09:30:00-04:00,28.17999,28.53999,28.05,28.44,226900,106505,66.1662600529715,60.800430557496036,NaN,NaN,129.14988003508134,114.64177527748157,0.052701097677017195,0.3654803439868637,0.3127792463098465,-2047700,-2215820,60.286962521566885,36.87464730191335,NaN,NaN,22.428030298118586,17.037232318714747
2003-05-13T09:30:00-04:00,28.38,28.67999,28.2,28.5,112900,110805,66.85583468610315,61.41423441090507,NaN,NaN,131.5475377663427,110.67127078618412,0.05916524286292152,0.3867357998884984,0.32757055702557686,-1934800,-2162520,63.37582100002036,40.500913947821765,NaN,NaN,24.08529193315507,18.044097977920508
2003-05-14T09:30:00-04:00,28.64999,28.66,28.33,28.45,44800,93035,65.6549476219865,61.805021028216466,NaN,NaN,118.16869480354634,111.60100329192149,0.0539380226057663,0.39499308528278476,0.34105506267701846,-1979600,-2106600,66.3343544810524,43.78173301098229,NaN,NaN,25.139969995353873,19.057793980410988
2003-05-15T09:30:00-04:00,28.60001,28.74001,28.5,28.72,104500,89955,68.90324896176259,62.85667526915394,NaN,NaN,128.84778374556112,121.64994713780705,0.06195561726933907,0.41849958426369227,0.3565439669943532,-1875100,-2022360,70.23511015560128,47.1807406840677,NaN,NaN,27.0117774770488,20.194077337073534
2003-05-16T09:30:00-04:00,28.72,28.82001,28.5,28.64999,138200,95665,67.13031797964476,63.590059943127436,NaN,NaN,120.45822397659701,125.63442406542569,0.0560146565110714,0.4265622876331925,0.3705476311221211,-2013300,-1970100,72.3736668951959,50.434622619154524,NaN,NaN,28.091956427778857,21.322345778602866
2003-05-19T09:30:00-04:00,28.39999,28.39999,27.50999,27.67999,134800,99455,48.50712933026863,62.850031283673786,NaN,NaN,-8.56494991230761,98.09145807594791,-0.015926749375577143,0.3506391944026497,0.3665659437782268,-2148100,-1990180,70.28411732097136,53.42903009623553,NaN,NaN,22.772792189783555,21.529552408771536
2003-05-20T09:30:00-04:00,27.8,27.8,27.03999,27.34,298900,105205,43.90912655537421,61.781573854584835,NaN,NaN,-97.59916822193921,52.26211687829152,-0.08522260158823097,0.2600376917929381,0.3452602933811691,-2447000,-2092620,60.6618331836114,55.719394215378536,NaN,NaN,16.727971464838426,20.84361227392395
2003-05-21T09:30:00-04:00,27.2,27.56,27.17999,27.53999,44100,104095,47.086422033949326,60.867420250300654,NaN,NaN,-91.27192105660157,10.373993706261945,-0.11457316727592637,0.20204383428626116,0.31661700156218753,-2402900,-2177280,54.0731850976706,57.49666790979978,NaN,NaN,12.928035414504752,19.712815579721205
2003-05-22T09:30:00-04:00,27.50999,27.96001,27.50999,27.85001,374700,121065,51.65790383044116,59.928267067947885,NaN,NaN,-31.529120866387206,-21.701387216127724,-0.11006520311186552,0.1790354976723556,0.2891007007842211,-2028200,-2207900,51.87846323698483,58.656563911765495,NaN,NaN,11.287442601659778,18.509190868569572
2003-05-23T09:30:00-04:00,27.85001,27.87,27.5,27.74001,44500,111635,50.00704949940093,58.83996650279015,NaN,NaN,-50.31806441065134,-55.8566448935774,-0.11112551761088973,0.15019380377060898,0.2613193213814987,-2072700,-2219780,51.01334145497634,59.34946369736597,NaN,NaN,9.45037003416477,17.215073606511744
2003-05-27T09:30:00-04:00,27.60001,28.14,27.52,28.14,138300,110725,55.56754411363358,58.10799987269544,NaN,NaN,-11.704533401006975,-56.48456159131727,-0.08282068995894115,0.15779345893282226,0.2406141488917634,-1934400,-2177040,53.98624346629596,59.83063774004768,NaN,NaN,9.690995663827408,16.14020532898541
2003-05-28T09:30:00-04:00,28.14999,28.23,27.89999,28.09,92800,112740,54.74780265054879,57.685944797689,NaN,NaN,13.61788766579923,-34.241150413769574,-0.06612269137711854,0.15796078467036523,0.22408347604748377,-2027200,-2093080,59.2216992734233,60.37196730837509,NaN,NaN,9.62694647818318,15.209739778870805
2003-05-29T09:30:00-04:00,28.22,28.34,27.75,27.86,81400,115105,51.01931396758303,57.14475560375922,NaN,NaN,-11.704141102241396,-18.32759442289754,-0.06891143757088497,0.13794417908387757,0.20685561665476254,-2108600,-2034220,62.4475043668201,60.94031435175013,NaN,NaN,8.421008893898497,14.239921081017618
2003-05-30T09:30:00-04:00,27.95,28.17999,27.89999,28.17,268300,125980,55.42557689445282,56.61703415558001,NaN,NaN,7.243996455309336,-10.572970958558233,-0.049149305618234024,0.14541898463197,0.19456829025020403,-1840300,-1996640,64.38467176560859,61.46835530141424,NaN,NaN,8.76732314674425,13.458121376121422
2003-06-02T09:30:00-04:00,28.39999,28.41,27.94,27.95,241600,136135,51.860046699296355,55.59516177317464,NaN,NaN,10.07180667436652,1.5050032584453348,-0.05000002435282719,0.13206825980917003,0.18206828416199722,-2081900,-1998480,64.21001843479357,61.74857358093043,NaN,NaN,7.949902496884544,12.671232964801868
2003-06-03T09:30:00-04:00,27.92999,28.28999,27.92999,28.17,130500,135050,54.979032540528046,54.746818762776414,NaN,NaN,18.499026573227834,7.545715253292298,-0.03553215022985304,0.13765309637468093,0.17318524660453397,-1951400,-2001880,63.86526793661187,61.78353407640126,NaN,NaN,8.226608066360965,12.036286550738883
2003-06-04T09:30:00-04:00,28.39999,28.71001,28.14999,28.66,87100,134050,61.03448069070746,54.416785410542204,NaN,NaN,105.29806079805596,25.881749879743648,0.0050904454457838255,0.17954830341176375,0.17445785796597993,-1864300,-1969300,65.76225391541567,61.74266975028435,NaN,NaN,10.465048398032973,11.81182395749518
2003-06-05T09:30:00-04:00,28.46001,28.92999,28.36,28.92999,149000,138605,63.914531176211774,54.06044842586,NaN,NaN,136.26399160043803,55.47537642027953,0.04592468392711416,0.23186371287487262,0.18593902894775846,-1715300,-1890640,69.87434999790203,61.71690116759155,NaN,NaN,13.272951721143958,12.020556495159292
2003-06-06T09:30:00-04:00,29.10001,29.75999,29.03999,29.19,269000,150200,66.4837555704448,54.0142653966315,NaN,NaN,206.95384423646257,95.41734597651018,0.0840094058330996,0.29095078623913295,0.20694138040603335,-1446300,-1811840,73.33005855172728,61.78521485734378,NaN,NaN,16.44726068788668,12.652942808406062
2003-06-09T09:30:00-04:00,29.14999,29.19,28.75999,28.89,520300,175130,61.08012684227389,54.912336647489006,NaN,NaN,117.96916100090932,116.99681684181874,0.08244431561853605,0.3099967749292034,0.22755245931066737,-1966600,-1788780,74.26056101566203,62.06924654982169,NaN,NaN,17.387178304738608,13.329262165024996
2003-06-10T09:30:00-04:00,29.02,29.11,28.82001,29.11,112600,169415,63.42764517183046,56.306516548664455,NaN,NaN,113.14187783326629,135.92538709382643,0.08910681383967872,0.33893597661026575,0.24982916277058703,-1854000,-1769300,75.05240298814117,63.09714439300239,NaN,NaN,18.909860258397483,14.12649046407821
2003-06-11T09:30:00-04:00,29.2,29.52,29.14999,29.44,73800,167460,66.67468612841584,57.705678269697785,NaN,NaN,143.7657375795735,143.61892245012996,0.1073937964981847,0.3840714083933179,0.2766776118951332,-1780200,-1752480,75.74621324922065,64.64521783239881,NaN,NaN,21.252292597602985,15.14446219743889
2003-06-12T09:30:00-04:00,29.8,29.8,29.38,29.5,65600,168500,67.24412362219005,58.81897968339414,NaN,NaN,144.72104711247152,145.31033355253666,0.11453260553305561,0.4198433688114527,0.30531076327839707,-1714600,-1752340,75.75225788351112,66.35048887857927,NaN,NaN,23.29935065775672,16.30944626319858
2003-06-13T09:30:00-04:00,29.63,29.63,29.17,29.32001,44400,165495,63.72631332937346,59.798927099820745,NaN,NaN,109.9343796709164,125.90644063942743,0.09873308303554207,0.4287271170728246,0.32999403403728256,-1759000,-1814880,67.64222049914326,67.53826595316261,NaN,NaN,23.9667083146035,17.403340841970714
2003-06-16T09:30:00-04:00,29.25,30.25999,29.25,30.21001,81400,162655,71.6296300941516,60.94621895557203,NaN,NaN,146.0295844858739,131.51852533642034,0.13744372524002546,0.5017986905873144,0.36435496534728895,-1677600,-1757080,70.75814443048264,68.73625887917595,NaN,NaN,27.356108336437536,18.825164769751687
2003-06-17T09:30:00-04:00,30.8,31.11,30.3,30.81,227800,167305,75.50438878306689,62.428832250751896,NaN,NaN,188.80500917834664,146.6511516054364,0.18946998407608923,0.6011924454424005,0.41172246136631124,-1449800,-1676240,74.4621796899831,69.82486462321593,NaN,NaN,31.6829336193511,20.66198889112303
2003-06-18T09:30:00-04:00,30.81,31,30.57001,30.73,130900,158905,74.05211732776728,64.07403249076505,NaN,NaN,165.11401605459307,150.92080730044034,0.20328769735404417,0.6658320830588664,0.46254438570482226,-1580700,-1636340,76.07314808547417,70.79812488883408,NaN,NaN,34.515468336871244,22.641057383372775
2003-06-19T09:30:00-04:00,30.73,30.8,29.96001,30.07001,411500,177275,63.24449019739649,64.63252629811817,NaN,NaN,111.64013331130191,144.30462454020642,0.15495574651524313,0.6562390688488762,0.501283322333633,-1992200,-1691860,69.50309908643558,71.16372684032173,NaN,NaN,33.172890697965784,24.145604999743206
2003-06-20T09:30:00-04:00,30.2,30.33,30,30.2,83600,162720,64.34814257991005,65.52453314673343,NaN,NaN,93.00234927213675,140.9182184604505,0.12026473354691058,0.6516142392672712,0.5313495057203607,-1908600,-1721780,66.18569650407666,71.30484670241337,NaN,NaN,32.49283590839837,25.338066558122517
2003-06-23T09:30:00-04:00,30.10001,30.10001,29.48,29.7,46300,162810,57.229830010704354,65.68530439460316,NaN,NaN,52.61400913028613,122.23510338933292,0.05546355870758901,0.600678954104847,0.5452153953972579,-1954900,-1777240,60.42816437879472,71.05933930542643,NaN,NaN,29.47112847914786,25.92850397541185
2003-06-24T09:30:00-04:00,29.7,29.92,29.58,29.72,120200,161905,57.4326739720088,65.42803248612469,NaN,NaN,45.54125383836455,93.58235232133651,0.008245674918011647,0.5555224890447725,0.5472768141267609,-1834700,-1854220,53.474670616278964,70.18165478405953,NaN,NaN,27.197352713079425,26.109768080792932
2003-06-25T09:30:00-04:00,29.8,29.95,29.39999,29.56,38600,159195,55.17810982455327,64.80400238957766,NaN,NaN,31.61027274534988,66.88160365948788,-0.03698207624268557,0.5010492188234039,0.5380312950660895,-1873300,-1912740,48.87078934431231,68.68140045166027,NaN,NaN,24.64477978867577,25.900484039061908
2003-06-26T09:30:00-04:00,29.39999,29.99001,29.39999,29.98,49000,157575,59.655286072999864,64.31625456833159,NaN,NaN,41.030968824284734,52.75977076208444,-0.0414930027290058,0.4861650416548322,0.527658044383838,-1824300,-1879160,51.45360855628904,67.11879688055753,NaN,NaN,23.817594748674484,25.60292842614942
2003-06-27T09:30:00-04:00,30,30,29.41,29.52,57200,147020,53.36767679465127,63.76536527921569,NaN,NaN,19.41748133883474,38.04279717542404,-0.07631191531819492,0.43226815023609433,0.5085800655542893,-1881500,-1873740,51.876168567263996,65.51991170567196,NaN,NaN,21.0641598213195,24.954532911173715
2003-06-30T09:30:00-04:00,29.64999,29.64999,29.17,29.33,114500,140665,50.97768097559182,62.87608212234151,NaN,NaN,-20.566792690439613,23.40663681127888,-0.11089732197785473,0.36995841308197086,0.4808557350598256,-1996000,-1881960,51.14901534370283,63.81252687392636,NaN,NaN,18.066907079850427,23.970586363841818
2003-07-01T09:30:00-04:00,29.10001,29.5,28.81,29.49001,89200,138600,52.89105735382156,61.891537209870485,NaN,NaN,-49.13000102706493,4.47238583819298,-0.12093376953604257,0.32968852313977237,0.45062229267581494,-1906800,-1896380,49.82947557493488,61.96133132576309,NaN,NaN,16.183992641344407,22.858215832056473
2003-07-02T09:30:00-04:00,29.5,29.77,29.47,29.77,29000,135695,56.11856622074904,61.09685453833898,NaN,NaN,2.6252459253904568,-1.3246195257989104,-0.10712480212835207,0.3167162900153748,0.4238410921437269,-1877800,-1897280,49.743221217558464,60.10354299248076,NaN,NaN,15.556902906979332,21.815171128474024
2003-07-03T09:30:00-04:00,29.7,29.71001,29.50999,29.59,53800,130935,53.57724740039007,60.37192125769731,NaN,NaN,-17.589629570506226,-13.048739204757112,-0.10820520755857083,0.28858458269551335,0.3967897902540842,-1931600,-1918740,47.62625908719419,58.673831463055826,NaN,NaN,14.281325705324882,20.738907496595576
2003-07-07T09:30:00-04:00,29.7,29.89999,29.69,29.8,69200,120945,56.07634126185517,59.260972055390425,NaN,NaN,14.560347756449682,-14.020165921234124,-0.09342583634598733,0.28000749482160003,0.37343333116758737,-1862400,-1914920,48.05008001255343,57.05182686177517,NaN,NaN,13.93391658738403,19.766765938136786
2003-07-08T09:30:00-04:00,29.60001,29.89,29.60001,29.81,127200,101290,56.197266869425164,57.88189191870173,NaN,NaN,0.9964418178167843,-9.707519019582843,-0.08203121983374145,0.27089430637541057,0.352925526209152,-1735200,-1862760,53.57447277394474,55.55984779634385,NaN,NaN,13.684905884183445,18.897928787572024
2003-07-09T09:30:00-04:00,29.55,29.88,29.55,29.63,213300,106325,53.3501045165918,56.40317671790348,NaN,NaN,-25.150060377164756,-4.911530889602808,-0.08529381700250005,0.24630825495602693,0.331602071958527,-1948500,-1871100,52.61110908474207,53.88398786772013,NaN,NaN,12.68448087851597,18.01029337199259
2003-07-10T09:30:00-04:00,29.62,29.62,29.2,29.31,62600,105765,48.63285389374357,55.3594884104997,NaN,NaN,-96.82142985783037,-24.800866046246973,-0.10631231208668523,0.1987116818501704,0.30502399393685564,-2011100,-1897760,49.544179629485384,52.45835076365226,NaN,NaN,10.446436715104007,16.929742421008505
2003-07-11T09:30:00-04:00,29.55,29.66,29.35001,29.64999,88500,106910,53.35223811323214,54.574066662879844,NaN,NaN,-55.914576913167224,-32.46585551477917,-0.09499670854458692,0.186278108256122,0.2812748168007089,-1922600,-1895960,49.757139478535954,51.28488240468506,NaN,NaN,9.848181554306072,15.918090868622443
2003-07-14T09:30:00-04:00,30.10001,30.10001,29.59,29.62,88100,109095,52.89062977784308,54.26412378910404,NaN,NaN,-10.874747436107928,-37.55287455329069,-0.08740264357957012,0.1720215123262463,0.2594241559058164,-2010700,-1925620,46.29010656919393,50.275021132570714,NaN,NaN,9.230185919312687,14.962675875863907
2003-07-15T09:30:00-04:00,30.05,30.05,29.50999,29.50999,226500,116350,51.142618064797944,53.81483408144612,NaN,NaN,-27.887476685174835,-43.32965825388902,-0.08744674148478926,0.15011572904982984,0.2375624705346191,-2237200,-2026020,36.91368353295389,49.09209348376178,NaN,NaN,8.22833219012642,14.000626777901408
2003-07-16T09:30:00-04:00,29.52,29.53,29.2,29.34,63000,108110,48.47653857082836,53.33615042046578,NaN,NaN,-113.56706544009307,-61.01305926647469,-0.09590445487948446,0.11768190193526351,0.21358635681474797,-2300200,-2096360,32.02011930447627,47.88847419520206,NaN,NaN,6.6305074592170605,12.947752589517929
2003-07-17T09:30:00-04:00,29.39999,29.48,29.10001,29.14999,25800,102855,45.614156804530644,52.333212615575114,NaN,NaN,-148.25341832834508,-71.29945696057763,-0.11025133612979246,0.0757721866525074,0.18602352278229986,-2326000,-2159340,28.3909827505489,46.241143780506334,NaN,NaN,4.448148404252739,11.73352342019433
2003-07-18T09:30:00-04:00,29.2,29.42,29.10001,29.42,18000,83180,50.121279049433916,52.101327062345305,NaN,NaN,-110.75885228494144,-82.26831203493248,-0.09792865967162367,0.06361269819277027,0.16154135786439394,-2308000,-2236420,24.701042159242945,44.30006332279055,NaN,NaN,3.7834644427815602,10.597800709135363
2003-07-21T09:30:00-04:00,29.35001,29.35001,28.8,28.96001,57400,81870,43.50642727619653,51.567666083817066,NaN,NaN,-181.25942575141403,-116.34524769799368,-0.11589969154174193,0.016666743437216525,0.13256643497895845,-2365400,-2307360,21.882238325874923,42.20957925008856,NaN,NaN,1.167142542865731,9.250563828239702
2003-07-22T09:30:00-04:00,29.05,29.05,28.63,28.91,120700,85590,42.844386037033836,50.85004670404651,NaN,NaN,-192.7215608731832,-149.31206453559537,-0.12548803706593226,-0.024293611353456868,0.10119442571247539,-2486100,-2357140,20.144978501741235,40.089258030574726,NaN,NaN,-1.154833836100717,7.764078447619642
2003-07-23T09:30:00-04:00,29.10001,29.17,28.67,29.12,36700,81415,46.52428064853782,50.16474059174571,NaN,NaN,-133.70141181519764,-153.33893381061628,-0.11244039688242316,-0.039356070390553555,0.0730843264918696,-2449400,-2386980,19.16286413765431,37.90494681058157,NaN,NaN,-2.0859559574111373,6.356930675472388
2003-07-24T09:30:00-04:00,29.13,29.34,28.89,28.89,28400,80905,43.240596420170476,49.426408378872885,NaN,NaN,-104.98620941312204,-144.68549202757168,-0.11371243591879072,-0.0690562184066188,0.04465621751217193,-2477800,-2417340,18.19114039941269,35.80243833288289,NaN,NaN,-3.8499490971449655,4.898804993669909
2003-07-25T09:30:00-04:00,28.89999,29.12,28.62,29.12,81100,82510,47.2500780234937,48.79596100470421,NaN,NaN,-115.41811278347411,-145.61734412727822,-0.09427779108441593,-0.07319102134334798,0.021086769741067945,-2396700,-2435080,17.628621301401495,33.62947699637204,NaN,NaN,-4.187340532594322,3.60078420420359
2003-07-28T09:30:00-04:00,29.25,29.25,28.95,29.05,114100,85355,46.18085751056125,48.08050319335678,NaN,NaN,-74.68774134957033,-124.30300724690946,-0.0818138151404158,-0.0811804991844518,0.0006333159559639943,-2510800,-2464160,16.716110429395698,30.99673682890425,NaN,NaN,-4.7686486497404905,2.405150939354436
2003-07-29T09:30:00-04:00,29,29.19,28.72,28.92,295000,94380,44.18130291343903,47.42558879313159,NaN,NaN,-97.87446211730861,-105.33358749573456,-0.07801489122245314,-0.09688529807210244,-0.018870406849649295,-2805800,-2528100,14.890935125221901,28.30243868893852,NaN,NaN,-5.8216251158187475,1.2298972171868385
2003-07-30T09:30:00-04:00,28.95,29.14999,28.95,29.03999,34800,91660,46.484531235921594,47.27213717471574,NaN,NaN,-67.6713746196399,-92.12758005662302,-0.06371461041799864,-0.0985136698721476,-0.034799059454148955,-2771000,-2592420,13.31587496014808,25.714702641128707,NaN,NaN,-6.079940409436379,0.1856346990978075
2003-07-31T09:30:00-04:00,29.22,29.37,28.89,28.89,59400,93180,44.03834124460495,46.606858826956646,NaN,NaN,-60.70588235293432,-83.27151464458547,-0.06066620130425431,-0.11063181108446685,-0.049965609780212535,-2830400,-2662940,11.83749539577245,23.006156635217028,NaN,NaN,-6.975936617670657,-0.8374469175834016
2003-08-01T09:30:00-04:00,28.75,28.75,28.39,28.45,69900,93985,37.76069594111855,45.526149267190604,NaN,NaN,-159.8440545808921,-92.15670300406904,-0.0831995401637441,-0.15396503498489267,-0.07076549482114856,-2900300,-2763660,10.110887857447366,20.42192672723513,NaN,NaN,-9.698205963802748,-2.10326963847188
2003-08-04T09:30:00-04:00,28.38,28.64999,28.10001,28.5,616300,121340,38.82783661286534,44.64652202062399,NaN,NaN,-165.91115412856433,-110.40138555986786,-0.08912550434222669,-0.18217237524893193,-0.09304687090670524,-2284000,-2718300,16.049680669439667,18.931640808412684,NaN,NaN,-11.618728818856642,-3.4626209499554177
2003-08-05T09:30:00-04:00,28.60001,28.66,28.03,28.03,46800,117320,33.0852911479824,43.54714720470641,NaN,NaN,-185.80286508445366,-127.98706615329687,-0.11731368910709172,-0.2396889822905699,-0.12237529318347817,-2330800,-2623300,26.937062520539712,18.568565323845785,NaN,NaN,-15.200338480971084,-5.1394377401005125
2003-08-06T09:30:00-04:00,28.00999,28.2,27.86,28.00999,129400,113125,32.862450145686935,42.63631101478901,NaN,NaN,-205.64154866501937,-155.58110096237277,-0.12899303905157292,-0.2836165919979443,-0.1546235529463714,-2460200,-2561140,33.05482314286428,18.901696780439742,NaN,NaN,-18.135206231946267,-6.995976096078477
2003-08-07T09:30:00-04:00,28.03999,28.55,28.02,28.46001,51600,112575,42.27847039379069,42.07611039652878,NaN,NaN,-120.84865900382391,-167.60965629255068,-0.09942250258378985,-0.2789016811761087,-0.17947917859231885,-2408600,-2476780,40.354195225051136,20.01977914228318,NaN,NaN,-17.836996130690125,-8.544693243880142
2003-08-08T09:30:00-04:00,28.67999,28.7,28.44,28.57001,79900,112145,44.33360624895715,42.13519460886882,NaN,NaN,-67.84463522759032,-149.20977242189034,-0.06702015089732466,-0.26325436721397466,-0.19623421631665,-2328700,-2362460,48.54235719763433,21.924073347408857,NaN,NaN,-16.959870599894504,-9.746861437596479
2003-08-11T09:30:00-04:00,28.35001,28.7,28.35001,28.50999,100700,112775,43.42509261790854,42.176673650359874,NaN,NaN,-67.27234694067246,-129.48201098431196,-0.04523898383252206,-0.25278294610730256,-0.2075439622747805,-2429400,-2391540,46.78301000317942,23.82678988322587,NaN,NaN,-16.50724103500928,-10.712629951512593
2003-08-12T09:30:00-04:00,28.55,28.59,28.37,28.59,42200,103560,45.041917276526334,42.07079055235905,NaN,NaN,-58.53384805010569,-104.02820757744234,-0.022217278031797294,-0.23531555981452712,-0.21309828178272983,-2387200,-2402820,46.08527223895782,25.74981903331898,NaN,NaN,-15.667541523948426,-11.42047446186057
2003-08-13T09:30:00-04:00,28.7,28.7,28.05,28.17999,491700,124995,38.90586549936235,41.761166915158476,NaN,NaN,-89.36861473014196,-80.77362079046686,-0.03084615639746832,-0.25165597727956523,-0.2208098208820969,-2878900,-2486560,41.17559954765132,27.391566115336026,NaN,NaN,-16.749356758802207,-12.181743361423662
2003-08-14T09:30:00-04:00,28.3,28.3,27.92999,28.16,60200,126715,38.6295565837916,41.14541538375118,NaN,NaN,-112.32478512014197,-79.06884601373046,-0.033900197810318805,-0.2631850681449954,-0.22928487033467662,-2939100,-2592660,35.94978712615786,28.700220817104338,NaN,NaN,-17.70232059199236,-12.970397251504904
2003-08-15T09:30:00-04:00,28.28999,28.3,28.10001,28.10001,16100,126620,37.76280466720649,40.54412589494012,NaN,NaN,-96.5819662540773,-84.81631221902786,-0.03577538267084923,-0.27400409867323816,-0.23822871600238893,-2955200,-2717960,30.953533377593942,29.7171795991185,NaN,NaN,-18.73644838038082,-13.794118841344321
2003-08-18T09:30:00-04:00,28.2,28.36,28.14999,28.28999,80400,127770,42.18681079474239,40.40166217217608,NaN,NaN,-70.17679593834873,-85.3972020185631,-0.020779342035422393,-0.26420289354666693,-0.24342355151124453,-2874800,-2807040,27.97667556561936,30.65187534486117,NaN,NaN,-18.383922335636996,-14.449805054814703
2003-08-19T09:30:00-04:00,28.3,28.32001,27.97,28.14,62900,124880,39.782467230932745,39.922943314676886,NaN,NaN,-88.71005666597158,-91.4324437417363,-0.01764359218333958,-0.265478041740419,-0.24783444955707942,-2937700,-2917140,24.801824973511202,31.472300345815682,NaN,NaN,-18.756174261204585,-15.065000655727543
2003-08-20T09:30:00-04:00,28,28.13,27.96001,28.06,33200,124705,38.52141119786759,39.528876882767065,NaN,NaN,-101.04654616225538,-93.76803002815898,-0.017599212404950937,-0.2698334650632681,-0.25223425265831717,-2970900,-2935540,24.305409493878372,32.362865638537535,NaN,NaN,-19.41771032781865,-15.686816323169129
2003-08-21T09:30:00-04:00,28.13,28.14999,27.8,27.89999,79100,127240,36.05933120174815,39.40735082995489,NaN,NaN,-112.08409208267366,-93.7198914206653,-0.02456070907730762,-0.2829351390049517,-0.2583744299276441,-3050000,-2957720,23.689874373920404,33.33279324685704,NaN,NaN,-20.680813256823285,-16.400244456548293
2003-08-22T09:30:00-04:00,27.98,27.98,27.45,27.48,75200,126945,30.541516881369702,38.815470849133774,NaN,NaN,-163.20452601765322,-107.0444033733805,-0.052083757638923645,-0.32347912697629866,-0.271395369337375,-3125200,-2991720,22.739209775864623,33.81061675445882,NaN,NaN,-23.56297722508451,-17.42349199491061
2003-08-25T09:30:00-04:00,27.5,27.7,27.5,27.67999,675600,155020,35.59534736328358,38.99476057879815,NaN,NaN,-153.9030268975361,-123.789649565218,-0.051367200263199186,-0.33560436966637397,-0.2842371694031748,-2449600,-2906680,30.275834750105318,34.04910048514207,NaN,NaN,-24.464799212810593,-18.42939302603918
2003-08-26T09:30:00-04:00,27.64999,27.78999,27.41,27.7,63600,143450,36.09635517432842,39.22575379512968,NaN,NaN,-139.62468246305997,-133.97257472463565,-0.044356994993701715,-0.3396834131453019,-0.2953264181516002,-2386000,-2796340,38.63957488473557,34.44801132384717,NaN,NaN,-25.045654647763747,-19.37457325771412
2003-08-27T09:30:00-04:00,27.7,27.72,27.57001,27.72,131100,148265,36.626994156976856,38.82207692107155,NaN,NaN,-120.8518604651117,-137.93363758520692,-0.03366907930920571,-0.3374127672881073,-0.3037436879789016,-2254900,-2653140,47.449787779387,34.95483936344259,NaN,NaN,-25.374628282514887,-20.2317239755428
2003-08-28T09:30:00-04:00,27.55,27.75,27.50999,27.74001,91500,149870,37.18896174870907,38.31174517105383,NaN,NaN,-111.75369877106132,-137.86755892288448,-0.021158947367862613,-0.3301923721887299,-0.30903342482086726,-2163400,-2475820,55.894586933897045,35.4799986303185,NaN,NaN,-25.498170333476818,-20.98407345524766
2003-08-29T09:30:00-04:00,27.60001,27.88,27.60001,27.82001,78300,150290,39.49888691633066,38.031301906655415,NaN,NaN,-77.43397837117178,-120.71344939358816,-0.0042858401938136725,-0.31439072506313437,-0.3101048848693207,-2085100,-2267800,63.33787087239459,36.6624886924053,NaN,NaN,-24.991654167378776,-21.556584985552107
2003-09-02T09:30:00-04:00,27.82001,28.3,27.82001,28.24001,139400,126445,49.91317183947174,38.379248661151514,NaN,NaN,13.545618742335993,-87.22372026561375,0.036145153166409316,-0.264923443411309,-0.30106859657771834,-1945700,-2167020,66.3047215424686,38.10673507122749,NaN,NaN,-21.36890398029636,-21.529773413372713
2003-09-03T09:30:00-04:00,28.33,28.33,28.10001,28.13,182300,133220,47.60186493855353,39.0003914782366,NaN,NaN,31.726005829337396,-52.953582607134265,0.0553159315995605,-0.23192368207826775,-0.28723961367782824,-2128000,-2115420,67.74401180552518,40.00447880393277,NaN,NaN,-18.988565254554565,-21.166743676398692
2003-09-04T09:30:00-04:00,28.2,28.22,27.91,28.2,214500,137475,49.21340858232536,39.75638090670329,NaN,NaN,10.661248401226299,-26.65096083386667,0.0715179967779947,-0.19784211770533489,-0.2693601144833296,-1913500,-2047140,69.59479588515127,42.40769371528944,NaN,NaN,-16.537486011855513,-20.505421152892524
2003-09-05T09:30:00-04:00,28.2,28.33,28.05,28.13,131300,141460,47.63564131656366,40.46158352451452,NaN,NaN,29.3879022202374,1.577359364393088,0.0759125140568751,-0.17446947191223572,-0.2503819859691108,-2044800,-2023420,70.23375822842824,45.21342406177761,NaN,NaN,-14.906013397415405,-19.705505759252937
2003-09-08T09:30:00-04:00,28.33,28.73,28.24001,28.63,260800,150505,57.99469886545052,41.590718386707955,NaN,NaN,128.1503053720794,42.694216113043325,0.10887896960618737,-0.11428327396137661,-0.22316224356756398,-1784000,-1963200,71.8510919549566,48.34731094673027,NaN,NaN,-9.958245235842657,-18.313039970194325
2003-09-09T09:30:00-04:00,28.75,28.8,28.53,28.72,250300,157985,59.54602409879188,43.00240102012646,NaN,NaN,162.15111180782236,72.4153147261406,0.13161220709767124,-0.05864698469547491,-0.19025919179314615,-1533700,-1880800,73.93778293876382,51.857022229962595,NaN,NaN,-5.4390240101195095,-16.47389483304078
2003-09-10T09:30:00-04:00,28.67999,28.99001,28.67999,28.75999,264200,169085,60.24852292496274,44.55433757206184,NaN,NaN,183.13112136974758,102.69633783422265,0.14324825567678104,-0.011198872197169862,-0.1544471278739509,-1269500,-1709100,77.65490306971313,55.66770034252222,NaN,NaN,-1.5608375520206192,-14.343458078609329
2003-09-11T09:30:00-04:00,28.95,29.03,28.81,28.92,164700,152735,63.015968248172676,46.479811646806446,NaN,NaN,185.87491266260844,137.73907068649905,0.1546517246002794,0.038867527876398356,-0.11578419672388104,-1104800,-1547360,80.47928138082844,59.72408655730136,NaN,NaN,2.6062973854967555,-11.922064440879888
2003-09-12T09:30:00-04:00,28.86,28.98,28.67,28.98,146700,157060,64.02728636553658,48.87165232424694,NaN,NaN,148.31428628136956,161.5243474987255,0.15857674129555172,0.08243672989555861,-0.0761400113999931,-958100,-1330020,83.4977736739157,64.06398397859073,NaN,NaN,6.355553481620923,-9.310976166236916
2003-09-15T09:30:00-04:00,29,29.05,28.71001,28.89999,204400,166475,61.60799426387837,50.729698531432284,NaN,NaN,127.03027409391393,161.30034124309242,0.14831211357362162,0.10925013056703392,-0.0390619830065877,-1162500,-1205720,84.93274902640455,67.96804928404067,NaN,NaN,8.846953315090051,-6.716986240333064
2003-09-16T09:30:00-04:00,28.89999,29.08,28.86,29.08,145500,169730,64.82800459067408,52.7819592040284,NaN,NaN,125.6844077329623,154.0070004281204,0.14594761601533524,0.14337253701258135,-0.0025750790027538883,-1017000,-1102380,86.0210719663922,71.35244193273043,NaN,NaN,11.979203002475025,-4.046102062789052
2003-09-17T09:30:00-04:00,29.14999,29.14999,28.95,29.00999,70800,170125,62.627953275246774,54.63917056961911,NaN,NaN,111.12635963755073,139.60604808168102,0.13237038141505836,0.16288789776606905,0.0305175163510107,-1087800,-1066040,86.39327383986515,74.13411950847888,NaN,NaN,13.993439935134866,-1.4690246345142062
2003-09-18T09:30:00-04:00,29.14999,29.25999,29.00999,29.11,89900,172960,64.48226787201409,56.58869243556946,NaN,NaN,107.6052302294902,123.95211159505739,0.12302554186400186,0.18429944368101303,0.06127390181701117,-997900,-1044660,86.61900962171113,76.32872112903702,NaN,NaN,16.23937560370233,1.0607468280881562
2003-09-19T09:30:00-04:00,29,29.02,28.67999,28.78999,108800,174445,55.06699858654633,57.70070041201344,NaN,NaN,61.26596838756246,106.54244801629595,0.08973826221344938,0.1734467295838229,0.08370846737037352,-1106700,-1074380,84.51991696092344,77.84172442107479,NaN,NaN,15.459079967017415,3.117651562220907
2003-09-22T09:30:00-04:00,28.60001,28.62,28.27,28.39999,166500,179010,46.21123937938812,57.436276664864614,NaN,NaN,3.623958157633959,81.86118482903996,0.03851816921221145,0.13185617888563783,0.09333800967342638,-1273200,-1096520,82.90805219038059,79.02767661021137,NaN,NaN,11.754252459904254,4.351451690461385
2003-09-23T09:30:00-04:00,28.46001,28.67,28.42,28.64,84500,149455,51.391978793391345,57.706999083067316,NaN,NaN,19.262588370432326,60.576820956533936,0.018861153814112658,0.1169144519410672,0.09805329812695454,-1188700,-1130860,80.3485532130459,79.92800099646284,NaN,NaN,10.343028283346138,5.207391203730635
2003-09-24T09:30:00-04:00,28.64999,28.64999,28.07001,28.13,124700,152510,42.110518307175,57.199649777699435,NaN,NaN,-33.89081809792694,31.57338540943839,-0.02788915721656207,0.06319185160625196,0.09108100882281403,-1313400,-1175980,76.98559699232081,80.45591536126067,NaN,NaN,5.612572441961322,5.265274237763591
2003-09-25T09:30:00-04:00,28.03999,28.19,27.85001,27.94,102300,151070,39.2654074272491,56.60177592846268,NaN,NaN,-89.49237466934396,-7.846135570328437,-0.06868507505757757,0.005224665000842066,0.07390974005841963,-1415700,-1259540,71.05432683654638,80.51452740469767,NaN,NaN,0.8319449252361749,4.631941478831103
2003-09-26T09:30:00-04:00,27.89999,27.89999,27.67,27.81,64000,149695,37.403348061478574,55.1309651567504,NaN,NaN,-128.25461567161722,-45.75025238216437,-0.09962469816912092,-0.050621132652981515,0.0490035655161394,-1479700,-1334140,66.15405919595153,80.10759649334018,NaN,NaN,-3.586965057578606,3.457811973629716
2003-09-29T09:30:00-04:00,27.86,27.99001,27.66,27.94,120000,151780,40.444845491744346,53.766595256247,NaN,NaN,-118.23669963350234,-70.12238394039164,-0.10594502309185272,-0.08342771334867649,0.02251730974317622,-1359700,-1351440,65.0339474632564,79.47160824508966,NaN,NaN,-6.147067713231526,2.08568630407811
2003-09-30T09:30:00-04:00,27.87,28.02,27.7,27.81,199900,154805,38.433745156824365,52.20839684423712,NaN,NaN,-114.59263004787982,-96.89342762405406,-0.11285424944310635,-0.11855050206070672,-0.005696252617600369,-1559600,-1425620,60.317917084879745,78.23325210331583,NaN,NaN,-8.878749316716194,0.5193383582503523
2003-10-01T09:30:00-04:00,28,28.36,27.92,28.31,124000,151890,48.9483243111859,51.20356513445235,NaN,NaN,-52.90907535050974,-100.69707907457062,-0.07930804887087084,-0.10483131370618892,-0.02552326483531808,-1435600,-1450060,58.80488227796134,76.68508073882533,NaN,NaN,-7.733978004316114,-0.6597068364019998
2003-10-02T09:30:00-04:00,28.38,28.56,28.28,28.5,79400,145135,52.28326531678798,50.36470648811316,NaN,NaN,-12.65263266577785,-85.3291306738574,-0.041766434419051104,-0.07773130785913196,-0.035964873440080855,-1356200,-1438160,59.33969734414729,74.95950385812759,NaN,NaN,-5.671899914692711,-1.3757344190149583
2003-10-03T09:30:00-04:00,28.85001,28.85001,28.3,28.37,230400,150090,49.88223052130996,49.52715193507256,NaN,NaN,-4.951383947816618,-60.66848432909728,-0.024015023684809622,-0.06598365304609288,-0.04196862936128326,-1586600,-1459540,57.88566412662103,73.02756922242875,NaN,NaN,-4.797564115201652,-1.8645672327559146
2003-10-06T09:30:00-04:00,28.39999,28.39999,28.19,28.25999,85400,141320,47.87845364027619,48.316469724329856,NaN,NaN,-44.29978091159402,-45.88110058471561,-0.018267837327859526,-0.06480342602110767,-0.04653558869324814,-1672000,-1522000,53.74255587919215,70.72196093048589,NaN,NaN,-4.718503409997901,-2.2722724009333413
2003-10-07T09:30:00-04:00,28.08,28.25,28.02,28.24001,268000,142205,47.50520972299063,47.23627375631156,NaN,NaN,-59.394361581942725,-34.84144689152819,-0.014558802885751197,-0.06473409230043714,-0.05017528941468594,-1940000,-1598080,49.129868039834285,68.06028908762656,NaN,NaN,-4.765896527138012,-2.6285044189625797
2003-10-08T09:30:00-04:00,28.2,28.24001,28.03999,28.09,50900,131540,44.688404096490686,45.822426343774175,NaN,NaN,-61.774826658795575,-36.61459715318536,-0.020586704662133144,-0.07590867024235237,-0.05532196558021923,-1990900,-1709140,43.28890809109192,64.96528183543947,NaN,NaN,-5.635952284602996,-3.058139828339782
2003-10-09T09:30:00-04:00,28.37,28.39999,28.05,28.13,170000,131805,45.61443136865714,45.147242971067804,NaN,NaN,-43.935571320205995,-42.871184884070985,-0.020228621286534805,-0.08060774218838773,-0.06037912090185293,-1820900,-1802080,39.09961457653189,61.72097452226864,NaN,NaN,-6.089926002196532,-3.4912521388907463
2003-10-10T09:30:00-04:00,28.17999,28.19,28.03,28.06,66200,127780,44.219215667596124,45.00495556308267,NaN,NaN,-57.20835640732155,-53.32257937597198,-0.02286053535721938,-0.08895479009837715,-0.06609425474115777,-1887100,-1862180,36.63091409636648,58.41546465841049,NaN,NaN,-6.857091243908616,-3.972086296750442
2003-10-13T09:30:00-04:00,28.14999,28.3,28.05,28.14,84200,121770,46.24293944056645,44.637167037880886,NaN,NaN,-38.7628295980779,-52.21518911326875,-0.0176037992597982,-0.08809900381590552,-0.07049520455610732,-1802900,-1888360,35.57714166642292,55.217506690794565,NaN,NaN,-6.963021006017057,-4.39936268378853
2003-10-14T09:30:00-04:00,28.21001,28.25,28,28.17999,177600,123375,47.272727900258815,45.005896294529734,NaN,NaN,-38.187057041530025,-47.97372820518622,-0.01019139896808316,-0.08323445326621126,-0.0730430542981281,-1625300,-1825420,40.04276847879033,52.5787332255424,NaN,NaN,-6.780877073715814,-4.739579025206713
2003-10-15T09:30:00-04:00,28.35001,28.36,28,28.12,58700,122770,45.85367433067784,45.47648678763179,NaN,NaN,-28.11007681084373,-41.24077823559585,-0.008173702161975063,-0.08326018200059693,-0.07508647983862186,-1684000,-1764040,44.111418662808404,50.654239784561106,NaN,NaN,-6.991883380554903,-5.061336790256455
2003-10-16T09:30:00-04:00,28,28.3,28,28.27,93600,122955,49.90312266894849,46.369327831022495,NaN,NaN,-8.673346883260036,-34.188333348206655,0.003776628757135053,-0.07036569389220304,-0.0741423226493381,-1590400,-1717940,47.01935405795511,49.28747513184708,NaN,NaN,-6.100018703888147,-5.209719920775268
2003-10-17T09:30:00-04:00,28.2,28.3,27.91,27.95,54600,120245,42.58604617896301,46.522270737252406,NaN,NaN,-53.20550602898306,-33.38776327253895,-0.008676823477763995,-0.08498835199654309,-0.07631152851877909,-1645000,-1669520,49.964126222744135,48.21105932895335,NaN,NaN,-7.3881223925085795,-5.520920273880027
2003-10-20T09:30:00-04:00,28.03999,28.11,27.84,28.09,67600,115300,46.29608584899557,47.083866500978914,NaN,NaN,-63.999385242473906,-38.435074401418156,-0.00639736207726882,-0.08430823111536512,-0.0779108690380963,-1577400,-1624420,52.60647361826869,47.66024193848112,NaN,NaN,-7.40728122381772,-5.790400409585412
2003-10-21T09:30:00-04:00,28.13,28.46001,28.10001,28.35001,189800,120565,52.44256257964102,47.33345494872571,NaN,NaN,80.25172687329095,-14.747317618453957,0.012670249749661272,-0.062073056851019714,-0.07474330660068099,-1387600,-1576880,55.286938678604876,47.4089602528128,NaN,NaN,-5.529459443106981,-5.753123128659921
2003-10-22T09:30:00-04:00,28.14999,28.14999,27.44,27.59,275300,128095,38.55290947890394,46.35271524601971,NaN,NaN,-169.00109157091188,-42.92552057046758,-0.023863378205743108,-0.10457252935785988,-0.08070915115211677,-1662900,-1572660,55.5273869895861,47.136652370344144,NaN,NaN,-8.779608241590086,-6.1854781447928024
2003-10-23T09:30:00-04:00,27.45,27.92,27.45,27.87,273600,136660,44.395930876216546,45.9608366999416,NaN,NaN,-141.14804396321162,-69.4204599864579,-0.026906234922313726,-0.11434194480500892,-0.0874357098826952,-1389300,-1532440,57.853664104104794,47.134366654450126,NaN,NaN,-9.249124145920314,-6.62314185923959
2003-10-24T09:30:00-04:00,27.8,27.97,27.59,27.95,378100,152365,45.9765778457119,45.8249884289013,NaN,NaN,-107.80340936673485,-80.34004065400828,-0.02150042148485254,-0.11431123673876087,-0.09281081525390833,-1011200,-1405680,64.20811738284752,47.881906761854104,NaN,NaN,-9.062494525665052,-6.971620811586084
2003-10-27T09:30:00-05:00,28.03,28.08,27.84,27.88,63400,149535,44.77714094728435,45.6301263734937,NaN,NaN,-71.90342497208583,-81.92084859993065,-0.020606172708855744,-0.118568531139978,-0.09796235843112226,-1074600,-1305120,68.29234725648546,49.25065527732919,NaN,NaN,-9.30626866520227,-7.305141933531254
2003-10-28T09:30:00-05:00,27.89999,28.16,27.82001,28.10001,73100,143195,49.257773657627794,45.95650991357492,NaN,NaN,-39.63723321606243,-105.89864061780133,-0.004031836938076835,-0.10300215460371831,-0.09897031766564147,-1001500,-1227900,71.0264599583576,51.23190898213388,NaN,NaN,-8.050419768650096,-7.411610195691089
2003-10-29T09:30:00-05:00,28.05,28.09,27.84,28.02,80900,141040,47.74073688427283,46.108388878976044,NaN,NaN,-52.935566845043695,-82.6855356726277,0.002364233391727061,-0.09601502592598266,-0.09837925931770972,-1082400,-1111800,74.57608050619802,53.76594226282432,NaN,NaN,-7.510777486821682,-7.425776951566887
2003-10-30T09:30:00-05:00,28.14999,28.14999,27.64,27.75999,134600,143800,43.09573315309342,46.02814012794014,NaN,NaN,-99.67050645142895,-74.39002817027117,-0.009447096500108138,-0.11018812994284488,-0.10074103344273674,-1217000,-1077340,75.53417420563191,56.544746556343284,NaN,NaN,-8.51936306749355,-7.5820035395564105
2003-10-31T09:30:00-05:00,27.8,28.12,27.8,28,302600,147410,48.11418288822871,46.16180037420173,NaN,NaN,-37.17458790740534,-60.264263878405245,-0.0001196625786981792,-0.10089061166610946,-0.10077094908741129,-914400,-1057980,76.07956685732454,59.437776927121966,NaN,NaN,-7.767813939962926,-7.608547882471627
2003-11-03T09:30:00-05:00,28.14999,28.14999,27.92,27.92,127303,149505.15,46.637769906430485,46.11644623178542,NaN,NaN,-19.859823440639435,-49.85554357211597,0.001546161612861266,-0.0988382470713347,-0.10038440868419597,-1041703,-1051400.6,76.27314450553371,62.02566092903221,NaN,NaN,-7.613834294821478,-7.609303084235892
2003-11-04T09:30:00-05:00,27.84,27.87,27.64999,27.74001,86019,140406.1,43.4102418979087,45.94191534373048,NaN,NaN,-131.37698633554137,-68.20349419601176,-0.008062140221167524,-0.11046208396065538,-0.10239994373948785,-1127722,-1076645,73.80519347140431,64.14664484393192,NaN,NaN,-8.473607004495697,-7.7327750728444355
2003-11-05T09:30:00-05:00,27.60001,27.97,27.60001,27.71001,68200,141271.1,42.877618232986606,45.44009359830462,NaN,NaN,-112.57134556057721,-80.13064993911846,-0.01464277612843197,-0.12070341390002781,-0.10606063777159584,-1195922,-1099349.4,71.56244926562343,65.89972307305109,NaN,NaN,-9.323933138860463,-7.960083367989582
2003-11-06T09:30:00-05:00,27.85001,27.92999,27.56,27.85001,42900,134916.1,46.1953374547794,45.6979001180058,NaN,NaN,-91.94832891294067,-78.58621443142081,-0.00809838518246618,-0.11618361924967857,-0.10808523406721239,-1153022,-1086553.8,72.07742130917649,67.4792441506534,NaN,NaN,-9.088715825470791,-8.121316576201183
2003-11-07T09:30:00-05:00,27.94,27.96001,27.57001,27.60001,98400,136526.1,41.5540031936414,45.359179928337646,NaN,NaN,-108.97093623126571,-92.94548409619289,-0.018540980497322126,-0.13126145968886505,-0.11272047919154292,-1251422,-1153958.2,65.36261964638135,68.39039743837574,NaN,NaN,-10.273443675646208,-8.42876330469333
2003-11-10T09:30:00-05:00,27.59,27.60001,27.35001,27.39,113500,137991.1,38.09173938021127,44.33412112837838,NaN,NaN,-189.36777703512368,-126.84707481508974,-0.03648894458480206,-0.1583316599225455,-0.12184271533774343,-1364922,-1218602,59.625555558007406,68.70029864404735,NaN,NaN,-12.35638169486273,-8.989851646146102
2003-11-11T09:30:00-05:00,27.45,27.55,27.31,27.45,64500,132336.1,39.63912575334334,44.41170800512405,NaN,NaN,-166.29541511770586,-133.83076057152263,-0.04088569338766371,-0.17294983207232306,-0.13206413868465935,-1300422,-1253142,56.75890724600546,68.78826437664873,NaN,NaN,-13.609537549643576,-9.64980677521717
2003-11-12T09:30:00-05:00,27.67999,28,27.52,27.96001,235300,141166.1,50.878326839862055,44.87473628824158,NaN,NaN,-16.259431186786966,-114.56837769676459,-0.0077465444831223695,-0.14174731928856232,-0.13400077480543995,-1065122,-1226982,58.390582413243635,68.82661568444436,NaN,NaN,-11.106118576616367,-9.857851318274198
2003-11-13T09:30:00-05:00,28.25,28.83,28.2,28.61,163200,144646.1,60.876676629104885,45.93902905848393,NaN,NaN,236.6509468429643,-48.848522545583585,0.056133021490853904,-0.06383449794187257,-0.11996751943272647,-901922,-1176762,61.40170744386622,68.62615783165998,NaN,NaN,-5.035448935843922,-9.16893669221273
2003-11-14T09:30:00-05:00,28.95,29.25,28.91,29.03,1251500,204491.1,65.73056141558419,47.43570194907678,NaN,NaN,310.48032646093003,35.041729992855565,0.12112604992683161,0.03144004297581304,-0.08968600695101857,349578,-856562,74.21446485829311,69.04916623178909,NaN,NaN,1.8533679343219454,-7.59432174556492
2003-11-17T09:30:00-05:00,28.85001,28.96001,28.67,28.94,189200,210571.1,63.901031581502224,48.48164894363924,NaN,NaN,199.8370760552566,112.88270061093162,0.1505868538000632,0.09854756029906042,-0.05203929350100277,160378,-551502,80.7654336588723,69.74480721039728,NaN,NaN,6.448858931973252,-5.588153077345181
2003-11-18T09:30:00-05:00,29,29.12,28.75,28.77,128200,207491.1,60.476882645634184,49.391373640879344,NaN,NaN,174.31758027582703,181.0052996896382,0.15078373266442993,0.13644037232953465,-0.014343360334895278,32178,-284982,84.47615196566845,70.45195517178804,NaN,NaN,8.963690544341114,-3.509318274247139
2003-11-19T09:30:00-05:00,28.89999,29.12,28.77,29.07001,87400,198096.1,64.12987803045321,50.893812560690755,NaN,NaN,153.40895442820926,214.93897681263743,0.16227950309806885,0.18850601853769078,0.026226515439621935,119578,-48042,86.89639812680736,71.26354259472915,NaN,NaN,12.305036797784895,-1.2501246925282774
2003-11-20T09:30:00-05:00,28.95,29.02,28.60001,28.69,125500,190691.1,56.949727346931,51.52492287916949,NaN,NaN,98.84557797234851,187.3779030385143,0.1364874170268159,0.19683578672314184,0.06034836969632592,-5922,131158,88.3728452999172,72.14163391205719,NaN,NaN,12.66277920603813,0.7374330072669235
2003-11-21T09:30:00-05:00,28.7,28.7,28.25,28.34,571000,200336.1,51.25742886549489,51.85489851910266,NaN,NaN,41.59357674278428,133.60055309488513,0.09028017431457046,0.173198587589539,0.08291841327496853,-576922,-54142,78.52064608245558,72.30216973898018,NaN,NaN,10.972451956646728,2.199578571464038
2003-11-24T09:30:00-05:00,28.5,28.82001,28.5,28.8,88300,201581.1,57.298495948829434,52.84691666559699,NaN,NaN,72.99035909460643,108.23120970275511,0.0851859078571314,0.18940079809638277,0.10421489023925137,-488622,-183942,72.42930884190042,72.2038922654442,NaN,NaN,11.681336719470929,3.5541154497507366
2003-11-25T09:30:00-05:00,28.8,28.8,28.5,28.66,535800,224716.1,55.06178235588262,53.717214102946706,NaN,NaN,58.782717961369435,85.12423723986358,0.06764275408512546,0.1887683328456582,0.12112557876053273,-1024422,-395262,63.75748318509194,71.64639468826337,NaN,NaN,11.47574219227834,4.685776412968965
2003-11-26T09:30:00-05:00,28.75,28.75,28.31,28.66,138300,227586.1,55.06178235588262,54.35053159588265,NaN,NaN,43.400260648862435,63.12249848399421,0.051996821443982294,0.1861216055655106,0.1341247841215283,-1024422,-624062,55.94707574263269,70.49422714779595,NaN,NaN,11.31694434799901,5.633086117973257
2003-11-28T09:30:00-05:00,28.67999,28.67999,28.55,28.60001,39700,222841.1,54.01394649443015,55.24052754593898,NaN,NaN,43.731986271840654,52.09978014389263,0.03441328296873977,0.17714138783245303,0.14272810486371326,-1064122,-835702,49.8623415583792,69.38706442722437,NaN,NaN,10.875638077880712,6.3820221122457506
2003-12-01T09:30:00-05:00,28.85001,29.09,28.72,29.06,183000,216861.1,60.25899790718578,56.8239031550086,NaN,NaN,82.80968362419166,60.343001520174106,0.04964252283557255,0.20478125840817896,0.1551387355726064,-881122,-896542,48.2381726142751,68.5736799312435,NaN,NaN,12.451427840810524,7.2490800734692895
2003-12-02T09:30:00-05:00,28.97,29.17999,28.97,29.08,517100,236350.95,60.5101068186477,58.31468751681605,NaN,NaN,90.94785505341423,63.93450071193568,0.05644755530479412,0.22569817970359907,0.16925062439880495,-364022,-871622,48.97136176095294,68.01742668231118,NaN,NaN,13.77769120422832,8.181738806434865
2003-12-03T09:30:00-05:00,29.3,29.39,29.10001,29.14999,273400,245720,61.42860714454463,59.068278967150526,NaN,NaN,102.78401181294457,72.73475948225071,0.06067731635192897,0.24509726983871616,0.1844199534867872,-90622,-684862,54.20652836207302,67.71856567865613,NaN,NaN,15.131623870255215,9.174579529837771
2003-12-04T09:30:00-05:00,29.2,29.23,28.97,29.2,109600,247790,62.10681069596185,59.15614568621174,NaN,NaN,87.65782736357501,81.58627282519322,0.06165784329875609,0.2614922576102323,0.19983441431147622,18978,-476182,59.23860465231811,67.56405833640268,NaN,NaN,16.44057818698935,10.212579338002282
2003-12-05T09:30:00-05:00,29.14,29.14999,28.89999,28.98,88900,250090,57.33112525823933,58.5561859606871,NaN,NaN,66.129982839957,86.06587213881647,0.04317847431245425,0.25380750720204404,0.21062903288958978,-69922,-277342,63.369071874920685,66.78938740901894,NaN,NaN,16.24852766154053,11.074857669936318
2003-12-08T09:30:00-05:00,29,29.22,28.91,29.2,184400,254390,60.59429919901323,58.319990790509316,NaN,NaN,78.36584289799971,85.17710399357809,0.04145209821677645,0.26244415566056034,0.2209920574437839,114478,-78222,66.97778344024084,65.80455525054528,NaN,NaN,17.010925785340884,11.922867400708398
2003-12-09T09:30:00-05:00,29.27,29.3,29.00999,29.08,302800,263855,57.98922792828841,58.14230116784176,NaN,NaN,79.36283230761047,82.86009944441733,0.02852418957843661,0.25664729441682965,0.22812310483839304,-188322,-43082,67.58469569761701,64.59802265997017,NaN,NaN,16.920131112755374,12.636762216715109
2003-12-10T09:30:00-05:00,28.89999,29.09,28.78999,28.88,96800,265470,53.83503843632234,57.4069554825467,NaN,NaN,26.32685823719301,67.56866872926703,0.00408265418196771,0.2332264225658527,0.22914376838388498,-285122,-81982,66.13563119471661,63.1151107362494,NaN,NaN,15.648664617703758,13.067033988284916
2003-12-11T09:30:00-05:00,28.89999,29.36,28.89999,29.24001,159900,261700,59.46423713939787,57.586563324865764,NaN,NaN,93.25089218804412,68.68728169416084,0.0094350909825352,0.240937632112054,0.2315025411295188,-125222,-110822,65.02253275153764,61.447231268508006,NaN,NaN,16.18664126216272,13.512692170267458
2003-12-12T09:30:00-05:00,29.39,29.39,29.14999,29.33,99300,258505,60.7525171834766,58.26478391900731,NaN,NaN,124.702712629762,80.40182765212185,0.015927678704562742,0.25141213951022223,0.2354844608056595,-25922,-102022,65.21491422672798,60.496821850241744,NaN,NaN,17.00755445474802,14.011958210907538
2003-12-15T09:30:00-05:00,29.47,29.55,29.2,29.28,108100,201335,59.61877216372273,58.43051793435682,NaN,NaN,129.78709076861725,90.68607722624537,0.013824401599449088,0.25276496280497085,0.23894056120552176,-134022,-151722,63.10390784296839,59.83072177888946,NaN,NaN,17.365015235165167,14.490966357230057
2003-12-16T09:30:00-05:00,28.8,29.39999,28.8,29.39,109500,197350,61.32858488590918,58.87814668650158,NaN,NaN,75.08660469359623,89.83083170344253,0.016622977814798462,0.25971928347401985,0.24309630565922138,-24522,-118962,63.93266792624924,59.84323497468641,NaN,NaN,18.143578796114138,15.012768134213497
2003-12-17T09:30:00-05:00,29.45,29.45,29.25,29.45,87900,195335,62.267081416141174,59.39281090509147,NaN,NaN,118.93509986818785,108.3524800296415,0.019118464417289677,0.2669943861808335,0.2478759217635438,63378,-49262,65.69805819831919,60.53973372152115,NaN,NaN,19.052991836009255,15.589942948755748
2003-12-18T09:30:00-05:00,29.52,29.67,29.37,29.67,616600,221795,65.56679447338604,60.21801433215975,NaN,NaN,149.9859122346292,119.6994840389585,0.03146041415411993,0.2872014394561937,0.25574102530207377,679978,111778,69.42214194027859,61.93686232022826,NaN,NaN,20.791231069234996,16.332984108824213
2003-12-19T09:30:00-05:00,29.7,29.7,29.36,29.52,392000,235120,61.610712605547675,60.314565382042744,NaN,NaN,125.10968947140815,119.78087940728774,0.025642710566368965,0.287794413510035,0.262151702943666,287978,174558,70.7551194358933,63.54521566462956,NaN,NaN,21.188390189720387,17.026613548952238
2003-12-22T09:30:00-05:00,29.60001,29.64999,29.38,29.50999,230000,218070,61.34470997103308,60.374179892927415,NaN,NaN,117.23823798612982,117.27110885079023,0.017623251554555852,0.2841807673868608,0.26655751583230497,57978,212958,71.57144818241935,65.15950755187716,NaN,NaN,21.445132322303923,17.657830516573906
2003-12-23T09:30:00-05:00,29.5,29.58,29.47,29.53,128400,220075,61.7006840847034,60.39361396008161,NaN,NaN,111.6316666922788,124.58012125052676,0.010519807503654444,0.279707275211873,0.26918746770821855,186378,255138,72.48014987486677,66.46476623136242,NaN,NaN,21.752870652266022,18.24283625024421
2003-12-24T09:30:00-05:00,29.55,29.7,29.5,29.62,59400,196255,63.33610009117307,60.48142034545384,NaN,NaN,123.07346487723453,125.40779425233609,0.008805499680487716,0.2801943423088282,0.2713888426283405,245778,291618,73.27576818279417,67.46742076925358,NaN,NaN,22.44301217900068,18.842861382923704
2003-12-26T09:30:00-05:00,29.67999,29.73,29.63,29.7,35200,191100,64.77592277908934,61.01319159694315,NaN,NaN,132.1672491633035,121.84406163807095,0.009900618735679156,0.28376461604793946,0.2738639973122603,280978,211818,68.60339968893828,67.84130132739769,NaN,NaN,23.414812015089232,19.49599718751878
2003-12-29T09:30:00-05:00,29.85001,30,29.75999,29.94,121800,195205,68.74180804613954,61.59515651459503,NaN,NaN,174.72749601939222,131.76762294766777,0.022887484878146958,0.30247335340994397,0.279585868531797,402778,234778,69.21169732658603,68.00086660499377,NaN,NaN,25.409189741325015,20.34073898091967
2003-12-30T09:30:00-05:00,30.07001,30.08,29.96001,30.02,157500,193930,69.95609231542758,62.44993254224783,NaN,NaN,178.80257987017265,144.08049132447633,0.03238408331200138,0.3200659726717987,0.2876818893597973,560278,335238,71.7873285994757,68.30105466941225,NaN,NaN,27.44924348044292,21.356239623708706
2003-12-31T09:30:00-05:00,30.10001,30.17999,30,30.14999,221400,179145,71.86839100602748,63.73802915436961,NaN,NaN,170.9356644631834,155.94129087865724,0.04231165731928155,0.34057146100889923,0.2982598036896177,781678,454298,74.50903688014021,68.89915507551395,NaN,NaN,29.768621880063918,22.558008517473738
2004-01-02T09:30:00-05:00,30.2,30.44,30.12,30.22,628700,196910,72.86996820409112,64.69558137327627,NaN,NaN,174.45259585578177,166.21711707436668,0.04806471833101977,0.3583407016033924,0.3102759832723726,1410378,687218,78.81484437439028,69.884320191432,NaN,NaN,32.02356555047118,23.910230950759086
2004-01-05T09:30:00-05:00,30.39999,30.5,30.14,30.36,191500,201005,74.80197644826117,65.69911417790375,NaN,NaN,164.98904754373427,172.78147675045284,0.0552567395812219,0.3793469077489,0.3240901681676781,1601878,951398,82.43822951872127,71.11455699800294,NaN,NaN,34.554149548540124,25.430790750442092
2004-01-06T09:30:00-05:00,30.47,30.48,30.31,30.45,289300,211025,75.98590125852525,66.8681948275325,NaN,NaN,153.65723140993808,168.56742382856203,0.05965683111573472,0.39866120706234653,0.3390043759466118,1891178,1249078,85.45666129357352,72.71118224447473,NaN,NaN,37.06175730199635,27.09235740066413
2004-01-07T09:30:00-05:00,30.45,30.64,30.31,30.64,262300,214920,78.30352340058585,68.0806904357237,NaN,NaN,147.43597448217673,162.29410275096285,0.06832213152038652,0.424407040347095,0.35608490882670846,2153478,1567718,87.8616268967476,74.42039359951033,NaN,NaN,39.985870783518656,28.934287883929063
2004-01-08T09:30:00-05:00,30.7,30.7,30.32001,30.50999,225100,211035,73.1044271414043,68.85478655895677,NaN,NaN,123.52228201640904,152.81142626160798,0.058628522291906404,0.4293705616915915,0.3707420393996851,1928378,1797058,89.24071598026882,76.10201201250673,NaN,NaN,41.0213794325056,30.661015248011424
2004-01-09T09:30:00-05:00,30.48,30.49001,30.2,30.32001,153400,213865,66.18857941391994,68.8991997689949,NaN,NaN,85.18159690383602,134.95722647121883,0.03397528762946689,0.41321114893651867,0.3792358613070518,1774978,1869978,89.64361084745367,77.54640264873352,NaN,NaN,39.86894862085756,31.97643430127516
2004-01-12T09:30:00-05:00,30.39999,30.39999,30.14,30.27,109900,211365,64.45985904070649,69.10271022864912,NaN,NaN,66.94256460986007,115.34792988444399,0.010093134711229468,0.3918522796960886,0.38175914498485913,1665078,1882618,89.71550218275834,78.90071570208103,NaN,NaN,38.41250123446733,32.89587243458833
2004-01-13T09:30:00-05:00,30.38,30.39,30.05,30.14,342500,223525,60.06792790223654,69.01151150944936,NaN,NaN,48.65490089788678,94.34746378203371,-0.017181556413129795,0.36028219946844686,0.37746375588157666,1322578,1768898,84.06169745110621,79.79287636413008,NaN,NaN,35.86234884640406,33.31965477913343
2004-01-14T09:30:00-05:00,30.10001,30.35001,30.05,30.31,395500,237895,63.564049479400026,69.14460903764197,NaN,NaN,50.602654191708176,74.98079972394,-0.025968380994835727,0.345003279638032,0.37097166063286774,1718078,1681818,79.90895482663001,80.32350528925603,NaN,NaN,34.6413890655781,33.50847396291124
2004-01-15T09:30:00-05:00,30.5,30.5,30.10001,30.39,139800,239410,65.11203217767925,69.27146132953526,NaN,NaN,62.385789860624875,62.75350129278318,-0.02839115168342754,0.33548272102858334,0.3638738727120109,1857878,1667718,79.22647071443404,80.74855547008747,NaN,NaN,34.062704744237166,33.58764978881494
2004-01-16T09:30:00-05:00,30.3,30.48,30.3,30.46001,186600,244345,66.45515747840324,69.39140666520053,NaN,NaN,73.5206652889601,60.42131496980801,-0.027270880325003966,0.32978527230575594,0.3570561526307599,2044478,1721618,79.93206352794174,81.557745744302,NaN,NaN,33.95600040535723,33.64027130546384
2004-01-20T09:30:00-05:00,30.60001,30.64999,30.36,30.36,380200,232525,62.73938472962335,68.96266214259224,NaN,NaN,77.83408436639544,62.59961892111509,-0.03477674867709929,0.3135852167843858,0.34836196546148507,1664278,1721458,79.92338524843187,82.32286631014813,NaN,NaN,32.80084904113813,33.520353839131594
2004-01-21T09:30:00-05:00,30.60001,30.89,30.36,30.87,222100,224030,71.49293749551941,69.07243679831309,NaN,NaN,127.8609496392711,78.44082866939195,-0.008287167911509685,0.33800300557209795,0.34629017348360763,1886378,1834218,81.45177700079682,83.01318405309964,NaN,NaN,34.57421579458115,33.67090554705296
2004-01-22T09:30:00-05:00,31,31.06,30.85001,30.92999,216100,223335,72.31678020374,69.10446459814969,NaN,NaN,178.98074741939467,104.11644731492925,0.009421775401462218,0.3580673927354354,0.3486456173339732,2102478,1911098,82.43367870276843,83.57922989757309,NaN,NaN,36.246918510427726,34.038907398963644
2004-01-23T09:30:00-05:00,31.10001,31.10001,30.66,30.78,178900,225860,67.0957637534186,68.69202142310166,NaN,NaN,146.42526647741045,120.92434263828636,0.007276946016843366,0.3577417998550274,0.35046485383818404,1923578,1924238,82.60319129532252,83.8498261062111,NaN,NaN,35.97372010873491,34.315309214645254
2004-01-26T09:30:00-05:00,30.85001,31.25999,30.8,31.17,667100,256245,72.62915279350179,68.536819733476,NaN,NaN,186.79789965298406,143.57978951109118,0.027244906690321202,0.3845209872010855,0.3572760805107643,2590678,2033478,83.9866738962271,83.96042927603295,NaN,NaN,37.64595528963091,34.79111579678606
2004-01-27T09:30:00-05:00,31.3,31.3,30.92999,30.97,161400,262555,66.45708417859625,67.8561899420525,NaN,NaN,161.32210980738444,160.27739459928893,0.022311463976445123,0.3851654104813207,0.36285394650487557,2429278,2186478,85.70174304213437,83.97793511521586,NaN,NaN,36.88039324705854,35.08958400396784
2004-01-28T09:30:00-05:00,31.10001,31.10001,30.63,30.7,144800,263705,59.1492683148642,66.48802886450095,NaN,NaN,82.89790530322358,151.28478573207946,-0.002489165547872485,0.35974248957003496,0.36223165511790745,2284478,2266098,86.51136717475615,83.88148799221646,NaN,NaN,33.65154409885262,34.88414973180853
2004-01-29T09:30:00-05:00,30.85001,31.16,30.55,31.14999,130600,262360,65.88280736097065,65.97219888018425,NaN,NaN,104.90622450029136,136.46988114825876,0.007511680191028713,0.3716212553566933,0.3641095751656646,2415078,2328618,87.12773071795394,83.73056047347971,NaN,NaN,33.31953221197861,34.6606329432614
2004-01-30T09:30:00-05:00,31.2,31.2,30.78,30.98,122700,257425,61.742496735079534,65.65462154598137,NaN,NaN,98.63709298086818,126.91224644895033,-0.0007816403032344654,0.3631325247866215,0.36391416508985597,2292378,2402378,87.8340509178841,83.60130619279616,NaN,NaN,31.563468046729692,34.21818081518544
2004-02-02T09:30:00-05:00,31.05,31.5,30.94,31.38,239100,237945,66.99808433548185,65.83592335275104,NaN,NaN,144.06818935509264,118.36630438937205,0.016270571504611475,0.3842523794706203,0.3679818079660088,2531478,2390538,87.00872630056054,83.40796505835347,NaN,NaN,32.025209972456466,33.904899266224156
2004-02-03T09:30:00-05:00,31.22,31.60001,31.22,31.58,251000,240920,69.27111914493824,66.49329415580117,NaN,NaN,160.47677949491967,118.1972383268791,0.035514350127259564,0.41237474562508325,0.3768603954978237,2782478,2461178,87.74839709314601,83.67130074707059,NaN,NaN,33.20912352129618,33.80550273123445
2004-02-04T09:30:00-05:00,31.46001,31.83,31.45,31.67999,437900,248350,70.36990055135449,66.97942637522648,NaN,NaN,169.12441357335047,135.44253998090446,0.04865962075132718,0.4376849214369827,0.3890253006856555,3220378,2648358,89.46073848271769,84.3535710082197,NaN,NaN,34.50451056065904,33.90536099258082
2004-02-05T09:30:00-05:00,31.75,31.75,31.32001,31.52,237200,247095,66.28571506949635,67.06326086749914,NaN,NaN,128.35410809025106,140.1321166988964,0.040591146544136814,0.4397642338658265,0.3991730873216897,2983178,2761978,90.34304162673371,85.14761178766969,NaN,NaN,34.204075559671,33.94803450216513
2004-02-06T09:30:00-05:00,31.53,31.75999,31.38,31.75999,388000,255240,69.17570702870592,67.2575858353779,NaN,NaN,129.21470350542813,146.24763880380843,0.0450825445457802,0.45552626800391494,0.41044372345813473,3371178,2977738,91.75465928921214,85.99208291347472,NaN,NaN,34.90650158334429,34.08495837090501
2004-02-09T09:30:00-05:00,31.73,31.73,31.42,31.45,2212500,358195,61.805964865013024,67.19091298790573,NaN,NaN,102.12739056842044,137.85947904647395,0.022009589633113336,0.4379557104995264,0.4159461208664131,1158678,2703178,76.44173086222713,85.74339331446008,NaN,NaN,33.01778850111663,33.93250553236381
2004-02-10T09:30:00-05:00,31.55,31.64999,31.41,31.59,186500,362025,63.687531054975096,66.63338395643828,NaN,NaN,95.95122231283585,124.95436761005722,0.011536500981235542,0.4303667470929575,0.418830246111722,1345178,2415718,64.335577580663,84.52080764159338,NaN,NaN,32.10574398535832,33.67153959707731
2004-02-11T09:30:00-05:00,31.63,31.95,31.45,31.88,203300,355065,67.28297415349277,66.27382638142062,NaN,NaN,118.540897943555,114.8376644840981,0.019056136568055826,0.44265041682179174,0.4235942802537359,1548478,2081338,53.68493842260297,82.46732619301015,NaN,NaN,32.515537203070224,33.50639639793344
2004-02-12T09:30:00-05:00,31.98,31.98,31.60001,31.67999,603900,365485,62.67382030065259,65.95797327765163,NaN,NaN,104.8333747305844,110.13351781216477,0.006144345170442267,0.4312747117167888,0.4251303665463465,944578,1673618,44.098547094783264,79.7169944644002,NaN,NaN,31.35108820403208,33.19849522737611
2004-02-13T09:30:00-05:00,31.85001,31.85001,31.5,31.53999,297600,373375,59.596330962992724,65.02705743261527,NaN,NaN,75.82754543183466,99.45608619744608,-0.015080917597536936,0.40627921954942536,0.4213601371469623,646978,1128778,35.0830167906058,76.22387609971295,NaN,NaN,29.42533177207017,32.65947187661811
2004-02-17T09:30:00-05:00,31.64999,31.82001,31.62,31.74001,250900,376590,62.43444759698614,64.73972624821455,NaN,NaN,85.84562876955398,96.1997338376728,-0.018670585301325204,0.3980219055203058,0.416692490821631,897878,1076618,34.35881686006964,72.55652422956547,NaN,NaN,28.69805225031387,32.093554787146076
2004-02-18T09:30:00-05:00,31.85001,31.85001,31.5,31.60001,173000,366230,59.2949068681248,64.75012900201888,NaN,NaN,65.4695559417216,90.10340056344995,-0.03267515537517007,0.3758485466026684,0.4085237019778385,724878,952558,32.633367126423224,68.70809565468454,NaN,NaN,27.131147209609203,31.384639418926522
2004-02-19T09:30:00-05:00,31.78,31.78,31.48,31.49001,115500,360900,56.87492550382906,64.1067088693659,NaN,NaN,46.88709857225745,75.77264068919045,-0.05048443857651269,0.34541815375719764,0.39590259233371033,609378,764738,30.163673477575045,64.6392344232289,NaN,NaN,25.1112176262168,30.488436305682274
2004-02-20T09:30:00-05:00,31.60001,31.60001,31.21001,31.32001,492200,374705,53.25736951118627,63.50062835337353,NaN,NaN,-3.9516259178534914,54.01564055950287,-0.07345884578436268,0.30407903510325696,0.37753788088761964,117178,599258,28.142809821941896,60.37557434494732,NaN,NaN,22.312342464226333,29.320422899759997
2004-02-23T09:30:00-05:00,31.45,31.45,31.12,31.25999,331700,382345,51.99981173963802,62.42932316795611,NaN,NaN,-36.81542355077725,31.487046762980487,-0.09128020202976234,0.26343762835041673,0.35471783038017907,-214522,426958,26.176344767106343,56.03040423541488,NaN,NaN,19.646226064181807,27.938394780391683
2004-02-24T09:30:00-05:00,31.3,31.47,31.14999,31.39999,228900,360435,54.68752390031518,61.387637793340176,NaN,NaN,-24.99955565173868,9.318009878721956,-0.09196464565898543,0.23976202330644725,0.3317266689654327,14378,250258,24.301008991026634,51.49844794240635,NaN,NaN,18.127291902499763,26.53680865497855
2004-02-25T09:30:00-05:00,31.45,31.46001,31.25,31.44,87800,356755,55.45517221171265,60.322300054794326,NaN,NaN,-18.672856605031537,-7.510472630628669,-0.08804364696665817,0.22167211025710998,0.30971575722376815,102178,125718,23.047709664234347,46.754660169657534,NaN,NaN,17.07779371737569,25.18552080674957
2004-02-26T09:30:00-05:00,31.44,31.45,31.2,31.39999,144900,356760,54.46155473292829,59.477717173610905,NaN,NaN,-43.95129712257333,-25.678151769594827,-0.08634761165787758,0.20178124265142117,0.28812885430929874,-42722,-4702,21.78085872914137,41.85736139125809,NaN,NaN,15.931854830838965,23.863568524476626
2004-02-27T09:30:00-05:00,31.39999,31.48,31.28,31.31,84700,354465,52.19624890864889,58.26489873646398,NaN,NaN,-55.62490770294367,-36.01280812661286,-0.08912785243095944,0.17671903877059947,0.2658468912015589,-127422,-53622,21.307748604678423,36.82543919950568,NaN,NaN,14.341808480484126,22.503317089620555
2004-03-01T09:30:00-05:00,31.37,31.49001,31.14999,31.39999,183800,357520,54.24577157581616,57.72488493009276,NaN,NaN,-76.70611812931621,-43.990947042320656,-0.0828789479785203,0.16224820622840852,0.24512715420692882,56378,558,23.2949792293724,33.02924265430176,NaN,NaN,13.501283983811312,21.217312360219236
2004-03-02T09:30:00-05:00,31.39999,31.44,31.17,31.2,161100,353620,49.19760768107664,56.68989040338574,NaN,NaN,-112.77920597086704,-61.546877106146326,-0.0896152763862735,0.13310805872408693,0.22272333511036044,-104722,-23262,23.01974386949381,30.078111674932536,NaN,NaN,11.353397856150952,19.808181716780908
2004-03-03T09:30:00-05:00,31.2,31.41,31.03,31.33,148600,348500,52.30475869347875,55.62001787052759,NaN,NaN,-105.47759409415454,-78.90782460397092,-0.08287392549325528,0.11913092824379135,0.20200485373704663,43878,-34922,22.877252929841575,27.877562711163876,NaN,NaN,10.339222254177514,18.45547322212328
2004-03-04T09:30:00-05:00,31.38,31.5,31.33,31.47,158000,334505,55.46383679949917,55.105019049016626,NaN,NaN,-24.174215431454385,-74.95240826574714,-0.06721135599587078,0.11799065874220815,0.18520201473807893,201878,13998,24.975527396176773,26.51163273269199,NaN,NaN,10.339728014582404,17.29608104961744
2004-03-05T09:30:00-05:00,31.47,31.73,31.37,31.63,310300,338160,58.82075188895124,55.04962054372795,NaN,NaN,38.72854820513388,-56.081717084131625,-0.04534865573209099,0.1285161950729652,0.17386485080505618,512178,141918,30.314513921279257,26.17102538488295,NaN,NaN,11.303721053552586,16.440029621608176
2004-03-08T09:30:00-05:00,31.8,31.8,31.5,31.60001,225700,330045,57.939213322149214,54.728532381239596,NaN,NaN,63.858850901961425,-27.968723277876098,-0.032767271683868754,0.13290576120022024,0.165673032884089,286478,187938,32.18424573223096,26.015698875751617,NaN,NaN,11.864020325224208,15.786314007839037
2004-03-09T09:30:00-05:00,31.7,31.7,31.12,31.24001,242200,231530,48.53583390847162,53.960027169835804,NaN,NaN,-54.96504835774233,-16.405891755251158,-0.0476485577683084,0.10611233567370348,0.15376089344201188,44278,217738,33.42982399801181,26.07258865229366,NaN,NaN,9.550647498735396,14.895504506538517
2004-03-10T09:30:00-05:00,31.35001,31.35001,30.64999,30.75999,215600,232985,39.362356923673495,52.70912941411041,NaN,NaN,-204.65689120052915,-36.24175117652608,-0.08651360715478504,0.045618884498530576,0.13213249165331561,-171322,174698,32.501323474081275,26.239563652044104,NaN,NaN,4.209971271305421,13.368999758648075
2004-03-11T09:30:00-05:00,30.60001,30.63,30.10001,30.17,185400,232090,31.48551278360827,51.15399679071198,NaN,NaN,-360.7102682784869,-103.54896174593259,-0.145194691105405,-0.049360872228440655,0.09583381887696435,-356722,62978,30.159693170886243,26.38362674839728,NaN,NaN,-3.722209830368207,10.927398388788607
2004-03-12T09:30:00-05:00,30.3,30.33,30.05,30.25,293500,216570,33.43075988265147,49.827635943784365,NaN,NaN,-283.65390711618545,-168.02545281019644,-0.17013179758176808,-0.11683092810024576,0.05330086948152232,-63222,-52102,27.927637169151623,26.50871906282908,NaN,NaN,-9.049011706169463,8.073625518080311
2004-03-15T09:30:00-05:00,30.3,30.3,29.91,29.98,143900,208885,30.303632870293413,48.085929441639955,NaN,NaN,-227.66620110246544,-226.33046321108182,-0.19456000593400863,-0.18989913793598845,0.004660867998020166,-207122,-150822,26.14040698876215,26.640104634095902,NaN,NaN,-14.540962406842198,4.842970100234238
2004-03-16T09:30:00-05:00,30.25,30.27,29.92,30.19,145100,203595,35.36758801547984,46.65110199905189,NaN,NaN,-165.5641495324709,-248.45028344602753,-0.18631275951207488,-0.22823008139207346,-0.04191732187999857,-62022,-172082,25.75810808371905,26.833704521201952,NaN,NaN,-17.239627301437444,1.6883133285668546
2004-03-17T09:30:00-05:00,30.27,30.27,30.00999,30.16,323600,211125,34.97661736387876,45.2593207584055,NaN,NaN,-132.41586380694184,-234.00207796731007,-0.1729091002019184,-0.25805369713239656,-0.08514459693047817,-385622,-214942,24.965418503087605,27.06117307648383,NaN,NaN,-19.45653232720939,-1.3323789079726085
2004-03-18T09:30:00-05:00,30.10001,30.2,29.82001,30.13,75800,209140,34.56512523417068,43.999954781657046,NaN,NaN,-122.6111792486179,-186.38226016133626,-0.15658204834400768,-0.28087215736048776,-0.12429010901648009,-461422,-235882,24.567621510687758,27.29402114119878,NaN,NaN,-21.343688982334434,-4.191137490024298
2004-03-19T09:30:00-05:00,30.10001,30.10001,29.55,29.58,175100,193285,28.049757212700044,42.12881089857733,NaN,NaN,-135.89489260547822,-156.83045725919482,-0.17210686473397166,-0.3394236899339447,-0.167316825199973,-636522,-350542,22.45751540419667,27.23420229654337,NaN,NaN,-25.330706021502973,-7.211075851664108
2004-03-22T09:30:00-05:00,29.5,29.59,29.10001,29.21001,150000,184200,24.67959485689748,40.37752426827881,NaN,NaN,-154.09729534266967,-142.11667610723566,-0.1949018945175814,-0.41094419334694976,-0.21604229882936837,-786522,-466422,20.53764037950178,27.05690919011537,NaN,NaN,-29.91484056249855,-10.454470810354742
2004-03-23T09:30:00-05:00,29.45,29.58,29.22,29.31,427000,194105,27.224424023312352,38.58607179183836,NaN,NaN,-126.21035545007894,-134.2459172907573,-0.19062155359740118,-0.45431924082611985,-0.26369768722871867,-359522,-525922,19.61060683741799,26.82357732637083,NaN,NaN,-32.67306731594449,-13.628556025438993
2004-03-24T09:30:00-05:00,29.39999,29.39999,29.03999,29.14999,93200,194375,25.726460410228484,36.461973478319024,NaN,NaN,-124.83972641304075,-132.73068981197707,-0.1857534049143128,-0.4958894433716097,-0.31013603845729687,-452722,-539342,19.397929839722906,26.425177500909836,NaN,NaN,-35.401263332652505,-16.73894278361235
2004-03-25T09:30:00-05:00,29.55,29.55,29.08,29.31,325900,203425,29.881361791954504,34.39487418567639,NaN,NaN,-103.1107590746885,-128.8306057771912,-0.1599257277525858,-0.5100431981480291,-0.35011747039544333,-126822,-472422,23.833810143766954,25.962270088230387,NaN,NaN,-36.33413746660679,-19.538256309754413
2004-03-26T09:30:00-05:00,29.39999,29.59,29.28,29.42999,93100,203845,32.912133277778835,32.607225611078505,NaN,NaN,-85.2924259764637,-118.7101124513883,-0.12450443353180785,-0.5057480123102032,-0.3812435787783953,-33722,-351862,31.18180571650072,25.89066722996394,NaN,NaN,-36.16632501899007,-21.913694696788077
2004-03-29T09:30:00-05:00,29.55,29.92999,29.5,29.83,440500,216680,41.92421797833705,32.134967330354606,NaN,NaN,-52.80479981222164,-98.45161334529868,-0.06677289576073242,-0.4647096984793109,-0.39793680271857845,406778,-113202,42.92113005576999,26.56861766266095,NaN,NaN,-33.06290190428613,-23.506438583573512
2004-03-30T09:30:00-05:00,29.92999,29.92999,29.58,29.75999,459100,231580,40.88893053514089,32.24400830260229,NaN,NaN,-48.44437980884612,-82.89841821705211,-0.027927501571750835,-0.432846179683267,-0.40491867811151616,-52322,-51762,45.4986574136783,27.496998658346456,NaN,NaN,-30.892389089266015,-24.561574370101013
2004-03-31T09:30:00-05:00,29.88,30.02,29.71001,29.92999,266300,237465,44.47452978507789,33.171795231278686,NaN,NaN,-31.471908115733164,-64.22485455759059,0.012424613871137413,-0.3893879107725944,-0.4018125246437318,213978,81578,50.701661066044075,28.964282079429154,NaN,NaN,-27.96279023030098,-25.047462350129578
2004-04-01T09:30:00-05:00,30,30.25,30,30.14,144000,236765,48.620785903039724,34.25679708987785,NaN,NaN,2.0866648292010748,-43.185369776812664,0.05413081495679617,-0.33414900594773655,-0.3882798209045327,357978,178538,54.1307989262109,30.835936490647676,NaN,NaN,-24.17761012360398,-24.923197746340207
2004-04-02T09:30:00-05:00,30.41,30.59,30.34,30.5,542900,248395,54.845408275964914,36.00978104742581,NaN,NaN,58.38852451316553,-14.449179678886864,0.1039480590323934,-0.258344747114041,-0.3622928061464344,900878,365458,59.91894697279114,33.24868934664975,NaN,NaN,-18.7908890620939,-24.047153648590736
2004-04-05T09:30:00-04:00,30.7,30.85001,30.50999,30.85001,108200,242520,59.92845679916999,37.764128817689404,NaN,NaN,110.43286844130651,18.198353971818772,0.15536318834892832,-0.16808882071027398,-0.3234520090592023,1009078,485918,63.14646978247853,35.91928661084685,NaN,NaN,-12.410637900452045,-22.384794255999495
2004-04-06T09:30:00-04:00,30.85001,30.85001,30.56,30.75,175500,239185,57.92207265179297,39.40308990968327,NaN,NaN,120.59373308242643,52.005976550073285,0.17601124593584205,-0.10343795163939973,-0.2794491975752418,833578,663098,67.31544484734304,38.94428849257939,NaN,NaN,-7.928211479696376,-20.319568145099048
2004-04-07T09:30:00-04:00,30.7,30.71001,30.53,30.61,65600,231685,55.13909377993879,40.87265909152385,NaN,NaN,109.86739937510531,80.27383804824098,0.17333946011288698,-0.06277487243413304,-0.23611433254702002,767978,773898,69.6291939676241,42.162972239503404,NaN,NaN,-5.087761757057177,-18.14359580395021
2004-04-08T09:30:00-04:00,30.8,30.8,30.25999,30.39999,105300,227680,51.16756946610017,42.52393139533814,NaN,NaN,84.52137278320545,96.76077963904186,0.1513283573123816,-0.046953885906543036,-0.19828224321892463,662678,834838,70.85138470896214,45.61967718984379,NaN,NaN,-3.8986580751830244,-16.108604699840612
2004-04-12T09:30:00-04:00,30.45,30.64999,30.34,30.64999,382200,232115,55.295510269987446,44.71078249627313,NaN,NaN,88.3421134863963,102.75149743368802,0.14736145927147515,-0.01408041912958069,-0.16144187840105584,1044878,863638,71.43640411507535,49.255303170956196,NaN,NaN,-1.5918504747859552,-14.034782667689946
2004-04-13T09:30:00-04:00,30.64999,30.82001,30.35001,30.38,189800,234410,50.345790232797896,46.362308654093525,NaN,NaN,76.22616542547132,95.91015683052096,0.121391856967454,-0.009702057191738334,-0.13109391415919233,855078,832838,69.822453063614,52.841863615684474,NaN,NaN,-1.1752831488732043,-12.197711307858983
2004-04-14T09:30:00-04:00,30.38,30.72,30.2,30.69,215200,237915,55.29407360502791,48.47428102515063,NaN,NaN,73.07428270641591,86.40626675531887,0.1197296856005704,0.01856819284152067,-0.10116149275904973,1070278,880178,70.9103107294166,56.52131939351974,NaN,NaN,0.7782460710338646,-10.34400311087429
2004-04-15T09:30:00-04:00,30.8,31.3,30.75,31.25,142300,228850,62.55375804414365,50.808023614592706,NaN,NaN,134.68022345559672,91.36883157141713,0.14907160258365967,0.08517801047052487,-0.0638935921131348,1212578,969098,72.8873529614659,60.02514388049824,NaN,NaN,5.084362705604606,-8.139950851377305
2004-04-16T09:30:00-04:00,31.25,31.52,31.21001,31.48,1974700,323795,65.06310892609821,53.10452187518696,NaN,NaN,148.31721748002138,104.12800051078031,0.17490853632583245,0.15474207829415576,-0.020166458031676687,3187278,1474018,80.84735819969302,63.5726833435834,NaN,NaN,9.42287868069201,-5.630975203938831
2004-04-19T09:30:00-04:00,31.52,31.52,31.25999,31.35001,886400,359360,62.51338612019603,54.5751767424626,NaN,NaN,128.0420335898171,112.06798453146448,0.17382182698276444,0.19711082569677885,0.023288998714014422,2300878,1725218,83.45055298129742,66.46764212397821,NaN,NaN,12.051226906220727,-3.1049463310588945
2004-04-20T09:30:00-04:00,31.60001,31.60001,30.83,30.83,122100,357965,53.4838177222216,55.4748115415398,NaN,NaN,88.83355815639574,114.58946307764936,0.13063052650457874,0.18657715684473786,0.05594663034015911,2178778,1989958,85.6623292521149,69.33647582672369,NaN,NaN,11.266912703986769,-1.051823611766657
2004-04-21T09:30:00-04:00,30.85001,31.36,30.84,31.19,149800,344105,58.0060811956805,56.44135092801141,NaN,NaN,88.84889218144585,117.74438497265533,0.1191754922881331,0.20491599570032548,0.08574050341219239,2328578,2241618,87.38787083113507,71.95691938137304,NaN,NaN,12.170093618134304,0.8370217067906232
2004-04-22T09:30:00-04:00,31.19,31.5,31.03999,31.44,788700,378880,60.85237305116145,57.31503572430582,NaN,NaN,110.27830262275653,112.8640008060873,0.1209210586794746,0.23689182676153564,0.11597076808206104,3117278,2622558,89.45640464376412,74.48017693262685,NaN,NaN,13.862415300841704,2.697792220226492
2004-04-23T09:30:00-04:00,31.5,31.5,31.21001,31.35001,127500,368960,59.294450020237235,57.63282442032528,NaN,NaN,104.98295352379493,104.19714801484201,0.1088760292450899,0.25206580463842343,0.14318977539333352,2989778,2583058,87.84750539372833,76.4750739626938,NaN,NaN,14.698422965956615,4.412168041045081
2004-04-26T09:30:00-04:00,31.60001,31.60001,31.14,31.17999,233400,375975,56.35869475518612,57.37784141718357,NaN,NaN,89.71036198996866,96.53081369487231,0.08346326373245855,0.2475188550589067,0.16405559132644815,2756378,2674158,88.3671535264208,78.27655137297538,NaN,NaN,14.467273128257208,5.848611624932528
2004-04-27T09:30:00-04:00,31.45,31.56,31.25,31.3,177000,362800,57.94162016067223,57.379237667817804,NaN,NaN,89.12388492398001,96.58887904838917,0.06932284675895378,0.25070914977514036,0.18138630301618658,2933378,2825078,89.19169874575645,79.83914093714777,NaN,NaN,14.75168436678077,7.120479159482277
2004-04-28T09:30:00-04:00,31.35001,31.35001,30.91,31.02,81100,343900,53.10212665447038,57.233740015998634,NaN,NaN,39.41478677744245,86.7020579675885,0.03730327899773411,0.22801540176335422,0.1907121227656201,2852278,2929818,89.73547209383985,81.2753036604489,NaN,NaN,13.514069723360853,8.033849240036359
2004-04-29T09:30:00-04:00,31.05,31.08,30.64999,30.83,264400,343805,50.047408646261026,57.15372852886726,NaN,NaN,-10.587852573908233,62.52882692825555,0.0014144925764336125,0.19248023848616214,0.19106574590972852,2587878,2823938,85.07582839295209,82.29133535216246,NaN,NaN,11.546385688339493,8.53564016122252
2004-04-30T09:30:00-04:00,30.95,31.09,30.8,30.86,163100,344760,50.53129358212628,56.813427336877176,NaN,NaN,-6.731943397873732,40.18584754392181,-0.020981433528990456,0.16483895399849047,0.18582038752748092,2750978,2776178,82.98262798355847,83.11606562848269,NaN,NaN,10.0890800566031,8.757560146276889
2004-05-03T09:30:00-04:00,31,31.25999,30.82001,31.25999,276200,331425,56.57174042450907,57.25813806485655,NaN,NaN,30.91995409006828,28.427765963941738,-0.0100865463675881,0.1732122045679958,0.1832987509355839,3027178,2830338,83.47903627072327,84.09153585756192,NaN,NaN,10.585560277063642,9.018703022103567
2004-05-04T09:30:00-04:00,31.35001,31.36,31,31.21001,253900,338710,55.657223283581075,57.28407732761035,NaN,NaN,44.34270040061006,19.471529059267745,-0.007589795297280405,0.17381150681398339,0.1814013021112638,2773278,2798318,81.95687978960679,84.88057650471838,NaN,NaN,10.724598968040063,9.262402442951638
2004-05-05T09:30:00-04:00,31.25,31.46001,31.14,31.39,443300,352100,58.27325852160429,56.97832736171468,NaN,NaN,71.9417056752184,25.976912838822955,0.004205729780160122,0.18665846433646394,0.1824527345563038,3216578,2871178,82.72860351344266,85.58352297271672,NaN,NaN,11.597073049937753,9.595926815378226
2004-05-06T09:30:00-04:00,31.37,31.44,31.10001,31.27,182200,357930,55.905210295472806,56.324191745241436,NaN,NaN,53.817630964033505,38.85800954641131,0.002056958664780617,0.18502393288727959,0.18296697422249897,3034378,2960478,83.65154446117229,85.7838219913938,NaN,NaN,11.662317558839128,9.891125493015497
2004-05-07T09:30:00-04:00,31.25,31.42999,31.06,31.06,372800,371305,51.92828059610476,55.56811277923492,NaN,NaN,25.770867478802817,45.358571721746614,-0.01446746299427018,0.16488264547966125,0.17935010847393143,2661578,2942598,82.69864822795839,85.73011450901244,NaN,NaN,10.57665014021849,9.989057585473068
2004-05-10T09:30:00-04:00,30.75,31.03999,30.46001,30.66,375500,370970,45.3157169663905,54.98467701096127,NaN,NaN,-126.6150156881581,13.851577766101338,-0.05122840827350922,0.11531459813204492,0.16654300640555414,2286078,2794378,75.06498452098403,84.97316131393166,NaN,NaN,7.5556132086181655,9.641422674493796
2004-05-11T09:30:00-04:00,30.75,30.75,30.53999,30.69,178700,370415,45.87242874300237,54.117987550055695,NaN,NaN,-154.78683455125378,-25.97432922427143,-0.07118778966866154,0.0775582693197272,0.14874605898838875,2464778,2732678,72.08217491267527,83.87989731975595,NaN,NaN,5.273204861351752,9.017391558330647
2004-05-12T09:30:00-04:00,30.7,30.84,30.27,30.8,465300,382920,47.96425577101193,53.19740774433073,NaN,NaN,-169.13981000193033,-74.19063235970118,-0.07430230808972335,0.05586817387623455,0.1301704819659579,2930078,2675378,69.32702741226757,82.44208466036335,NaN,NaN,3.941512523556657,8.292265981934364
2004-05-13T09:30:00-04:00,30.75,30.88,30.62,30.75999,219500,386780,47.24900157364536,52.33701856957417,NaN,NaN,-110.72566481320165,-107.09929151514821,-0.07609946229506155,0.035046154097130966,0.11114561639219252,2710578,2610618,66.24520016538258,80.89906285833865,NaN,NaN,2.6393390267996506,7.48470498834369
2004-05-14T09:30:00-04:00,30.8,31.00999,30.50999,30.7,107600,293425,46.13804548953839,51.606972193456464,NaN,NaN,-99.54195787950907,-132.1618565868106,-0.07807833919363785,0.013547692400145195,0.09162603159378305,2602978,2598898,65.67619117955945,79.27827983356283,NaN,NaN,1.2406658702870281,6.592699400049882
2004-05-17T09:30:00-04:00,30.64999,30.77,30.41,30.61,2092100,353710,44.44947489671028,50.643247531744905,NaN,NaN,-122.04051634430162,-131.24695671803929,-0.08180459212134086,-0.010629708557893025,0.07117488356344784,510878,2243858,51.30070870461391,76.5717805449098,NaN,NaN,-0.41137733711692137,5.592117009026053
2004-05-18T09:30:00-04:00,30.61,30.74001,30.50999,30.60001,302400,362725,44.25586013023671,50.0113713514425,NaN,NaN,-101.17064052596248,-120.52371791298101,-0.08113822966112745,-0.03024790351296147,0.05089032614816598,208478,1792598,39.474084961266065,72.98168146401169,NaN,NaN,-1.8520533916049533,4.528664094650194
2004-05-19T09:30:00-04:00,30.75,30.75999,30.3,30.3,1147700,412620,38.7912350054335,49.207358948526235,NaN,NaN,-124.22989832685239,-111.54173557796544,-0.09607706121857038,-0.06920600037504698,0.026871060843523385,-939222,1018738,27.686483239264717,68.88244252446259,NaN,NaN,-4.714028411886185,3.2082794508592833
2004-05-20T09:30:00-04:00,30.39999,30.39999,30.03,30.10001,79700,377170,35.63263413861905,48.143168988275725,NaN,NaN,-166.6657845389961,-122.72975952312432,-0.1134117860359918,-0.11489367170146636,-0.0014818856654745666,-1018922,272838,21.13524307708454,64.46477217400016,NaN,NaN,-8.154976394717778,1.5849571872054176
2004-05-21T09:30:00-04:00,30.3,30.3,30.05,30.16,73100,374450,37.28233902863018,46.7653546028558,NaN,NaN,-149.98570771516057,-132.8185094902546,-0.11448969077286134,-0.14459399913155124,-0.0301043083586899,-945822,-436922,17.010564980843284,59.717024224723026,NaN,NaN,-10.599846862212889,-0.1557291055686263
2004-05-24T09:30:00-04:00,30.25,30.3,29.92,30.00999,183600,371960,34.87529285788294,45.28093100102022,NaN,NaN,-151.9505434500148,-138.80051491139724,-0.11846239432027901,-0.17818230125903867,-0.059719906938759657,-1129422,-764982,15.504426313074319,54.9704204049707,NaN,NaN,-13.411911848255636,-2.049469497381056
2004-05-25T09:30:00-04:00,30,30.42999,29.87,30.3,346900,380455,42.5919861136527,44.16084011473796,NaN,NaN,-116.78483607558407,-141.9233540213216,-0.09569019780385044,-0.1793326541935727,-0.08364245638972226,-782522,-963182,14.65990166309166,50.10837027280278,NaN,NaN,-13.720768903762629,-3.716797984006995
2004-05-26T09:30:00-04:00,30.3,30.53,30.3,30.46001,518600,402330,46.36795694060988,43.47960773224775,NaN,NaN,-60.42495985221198,-129.16236632639348,-0.06542677121225002,-0.1654259204050348,-0.09999914919278477,-263922,-828122,17.940065770434373,45.41469322346435,NaN,NaN,-12.865505004651661,-5.023756129813376
2004-05-27T09:30:00-04:00,30.60001,30.83,30.49001,30.77,443000,411260,52.83965601096487,43.54470597616633,NaN,NaN,0.038552832932899156,-95.82149885200768,-0.02233395150320658,-0.127916588571793,-0.10558263706858642,179078,-588522,23.553694504054647,41.190053671756935,NaN,NaN,-10.063794529318711,-5.743761615456995
2004-05-28T09:30:00-04:00,30.85001,30.85001,30.64,30.75999,228200,414515,52.6188522730731,44.066358498072226,NaN,NaN,14.388318176280213,-62.946693673719516,0.006170337620065441,-0.09786971504350461,-0.10404005266357005,-49122,-409182,27.54884261654348,37.796043535725474,NaN,NaN,-7.883440443968151,-6.049430019530017
2004-06-01T09:30:00-04:00,30.75999,30.94,30.67999,30.92,472600,424335,55.79851482787677,44.77536464699183,NaN,NaN,41.93542285819973,-24.169500412076598,0.03487279221674215,-0.06044906239264236,-0.09532185460938451,423478,-98602,33.98329013163416,35.07469462279397,NaN,NaN,-5.060983797591132,-5.908223416395891
2004-06-02T09:30:00-04:00,31.10001,31.17999,30.92999,31.11,139800,418630,59.291907224210476,45.58448260793459,NaN,NaN,100.82996778467016,19.353460359974235,0.0640292325849232,-0.015285313878230511,-0.07931454646315371,563278,170558,39.03639480344813,32.9110780078783,NaN,NaN,-1.5540884684508347,-5.286204138118025
2004-06-03T09:30:00-04:00,31.10001,31.25,30.99001,31.03,119600,402445,57.240576990439344,46.29816656627701,NaN,NaN,112.9235345373313,54.023159237882886,0.07456508885307025,0.013891814603184116,-0.06067327424988614,443678,312078,41.56884477463507,31.14848119425348,NaN,NaN,0.7746077969282138,-4.420373861682848
2004-06-04T09:30:00-04:00,31.3,31.3,31.03999,31.09,352800,410975,58.40295813016079,47.174231754892894,NaN,NaN,131.41274340686954,80.29799735267021,0.08164214076672904,0.041379401708525165,-0.04026273905820388,796478,435558,43.76391683275338,29.583318740910183,NaN,NaN,3.047922656608084,-3.3534743590698577
2004-06-07T09:30:00-04:00,31.39999,31.39999,31.14,31.39999,245300,404600,63.86796003261014,48.561266407457175,NaN,NaN,171.02081398773282,111.62449651496074,0.10194798918805122,0.08717224742686014,-0.014775741761191074,1041778,653738,47.51569183641612,29.312960393181772,NaN,NaN,6.809405567288531,-1.901634369590088
2004-06-08T09:30:00-04:00,31.3,31.44,31.25999,31.44,238100,397730,64.51594754040505,50.00841550818348,NaN,NaN,159.40706129927537,135.11882420317585,0.11201907188111854,0.1252480980902071,0.01322902620908856,1279878,825018,50.31788578078257,30.08751759457581,NaN,NaN,10.074837339988129,-0.19070983965034283
2004-06-09T09:30:00-04:00,31.44,31.44,31.07001,31.07001,108300,394210,54.739499587044406,51.14757726401283,NaN,NaN,101.981726701676,135.34917598657702,0.0887267026104443,0.12413740447214394,0.03541070186169964,1171578,946678,52.267327712827786,31.843292199830312,NaN,NaN,10.048332333118061,1.2720104707451434
2004-06-10T09:30:00-04:00,31.2,31.2,31.03,31.08,124700,377180,54.93805609237693,52.52653597499553,NaN,NaN,74.6108665464534,127.68664238840145,0.0697910022869738,0.12264945472041688,0.05285845243344309,1296278,1117198,54.936330241638586,34.25765556872703,NaN,NaN,10.085772671093112,2.531119356509139
2004-06-14T09:30:00-04:00,30.99001,31.02,30.8,30.86,131300,372770,49.76086099420053,53.41785897253628,NaN,NaN,29.395236529487697,107.28314101292509,0.03974212604472112,0.10253610998934448,0.06279398394462336,1164978,1190898,56.07941439921994,37.04828767003965,NaN,NaN,8.535119737682273,3.3888336966767296
2004-06-15T09:30:00-04:00,31.05,31.05,30.81,30.89999,175400,376160,50.67085439521697,54.54611336806013,NaN,NaN,32.17108207597173,79.51319463057287,0.020804312252294704,0.08879937425999174,0.06799506200769703,1340378,1250618,57.03056286033832,40.01444028055851,NaN,NaN,7.533239513563361,3.9808916705176767
2004-06-16T09:30:00-04:00,31,31.02,30.83,30.91,821900,312650,50.91054533562952,55.1402961696299,NaN,NaN,29.11718970095863,53.45522031090951,0.007862777841466675,0.07782353430953037,0.0699607564680637,2162278,1427098,59.80104485487677,43.2388076514003,NaN,NaN,6.779116448948337,4.380638067436342
2004-06-17T09:30:00-04:00,30.91,30.96001,30.74001,30.96001,267900,310925,52.16119538734136,55.55409891582501,NaN,NaN,20.1687707004273,37.092629110659786,0.001892797490006315,0.07232675333057159,0.07043395584056528,2430178,1678818,63.42351295892902,46.48762530772135,NaN,NaN,6.477561170779602,4.680198510771094
2004-06-18T09:30:00-04:00,30.85001,30.96001,30.81,30.86,117000,259390,49.44807986553891,55.311843476866,NaN,NaN,14.749696724603359,25.120395146289773,-0.008972831597820585,0.059217916343289545,0.06819074794111013,2313178,1882198,66.08291233421613,49.52542658130431,NaN,NaN,5.47865781981188,4.794264126348349
2004-06-21T09:30:00-04:00,30.81,30.85001,30.62,30.64999,105200,260665,44.243866919481775,54.71363023732378,NaN,NaN,-30.149930333157243,13.211361773760785,-0.029336856359456043,0.03151967749179008,0.06085653385124612,2207978,2090798,68.60431537929904,52.45796035007256,NaN,NaN,3.0771357437664006,4.548960071693784
2004-06-22T09:30:00-04:00,30.64999,30.64999,30.34,30.52,129800,263500,41.343409039274796,53.68112268099505,NaN,NaN,-89.22968817987312,-11.06879227740819,-0.04941322159840169,-0.0009099931467559941,0.048503228451645695,2078178,2238358,70.28702391707034,55.05108419188944,NaN,NaN,0.15399342301852048,3.921107693311604
2004-06-23T09:30:00-04:00,30.60001,30.75,30.44,30.7,174000,263020,46.56701235023893,52.77220161856852,NaN,NaN,-73.09100674523317,-31.51043156664655,-0.048361390846840206,-0.011948510106904564,0.03641288073993564,2252178,2256338,70.49453776680156,57.298094403557535,NaN,NaN,-0.8989048468652757,3.2325344732863353
2004-06-24T09:30:00-04:00,30.7,30.78999,30.64,30.71001,519000,271625,46.85047705839599,52.03005162342257,NaN,NaN,-63.225976622449735,-48.189381031221956,-0.044860094155792125,-0.019662236954804513,0.025197857200987613,2771178,2324538,71.31293915830273,59.422672573819504,NaN,NaN,-1.6788768969239187,2.5309042775420134
2004-06-25T09:30:00-04:00,30.5,30.64999,30.38,30.44,304200,260905,40.594599325245376,50.75802599450004,NaN,NaN,-140.36740271117094,-79.21280091837684,-0.057775040419458676,-0.04702094332333573,0.010754097096122945,2466978,2355298,71.69428993058244,61.41769922366444,NaN,NaN,-4.290080189041599,1.556477925172926
2004-06-28T09:30:00-04:00,30.55,30.57001,30.17,30.28999,391700,258340,37.591376801153395,48.88112719225313,NaN,NaN,-169.8059525523354,-107.14400536221247,-0.072512546245657,-0.07988658571094831,-0.007374039465291306,2075278,2328758,70.81952601028613,63.082258807512304,NaN,NaN,-7.4481829643231166,0.2700977981020627
2004-06-29T09:30:00-04:00,30.31,30.59,30.28999,30.45,681300,280995,42.47961784834974,47.30710364282061,NaN,NaN,-124.0749479186391,-114.11305730996567,-0.06766980979139608,-0.09196130170453642,-0.024291491913140333,2756578,2464438,72.65632954113102,64.67786193325148,NaN,NaN,-8.671004943446293,-1.0072025935477025
2004-06-30T09:30:00-04:00,30.5,30.63,30.38,30.56,176800,266205,45.63229332967795,46.65658891015158,NaN,NaN,-88.87671636762131,-117.2701992344433,-0.05384570923806034,-0.09159862846071576,-0.03775291922265542,2933378,2600678,74.39894555296762,66.25869177897576,NaN,NaN,-8.744063801039866,-2.1124684803322973
2004-07-01T09:30:00-04:00,30.60001,30.62,29.91,30.13,1131500,315790,37.07719778864751,45.38081331702805,NaN,NaN,-143.70823289511677,-133.36665048897672,-0.06945575905792734,-0.12457261804506459,-0.05511685898713725,1801878,2406818,67.77964035415044,67.1760710727266,NaN,NaN,-11.704080747516604,-3.4826988042157696
2004-07-02T09:30:00-04:00,30.25,30.25,30.02,30.11,138300,316725,36.73225554101721,44.45019864180066,NaN,NaN,-143.86319536099364,-134.06580901894125,-0.07637271360193276,-0.1505827509895532,-0.07421003738762044,1663578,2246138,62.7929243826762,67.65560750011633,NaN,NaN,-14.124211337756165,-5.002914880435826
2004-07-06T09:30:00-04:00,30.12,30.12,29.78999,29.89,666500,332410,33.08589399644977,43.19413004188872,NaN,NaN,-164.01339937570324,-132.9072983836148,-0.09006787015397215,-0.18679487508008563,-0.09672700492611348,997078,2030498,56.75771352766481,67.63611826206822,NaN,NaN,-17.39310285601362,-6.772941734089796
2004-07-07T09:30:00-04:00,29.89999,29.92999,29.72,29.82001,277900,334040,31.997645321789207,41.843208612328695,NaN,NaN,-164.3443578605954,-140.96118037200605,-0.09751497902819238,-0.21862072871135396,-0.12110574968316158,719178,1623018,47.47261437795879,66.75551608514552,NaN,NaN,-20.376064915034764,-8.716245045653363
2004-07-08T09:30:00-04:00,29.7,30.13,29.7,29.75,276000,335935,30.90270478732259,40.324744998041645,NaN,NaN,-141.00293848971586,-151.386424796425,-0.1004345629006268,-0.2466489533089451,-0.1462143904083183,443178,1124978,39.06150570212979,65.01537270965986,NaN,NaN,-23.15453536250561,-10.778857948060827
2004-07-09T09:30:00-04:00,30,30,29.64,29.67999,135300,337285,29.804364136683205,38.92162244598052,NaN,NaN,-141.4134243624903,-150.9274630898997,-0.10013442171902182,-0.2713824175570956,-0.17124799583807376,307878,826178,35.04923944660605,62.79868178911628,NaN,NaN,-25.784552753541455,-12.92252863455806
2004-07-12T09:30:00-04:00,29.64999,29.67999,29.42999,29.55,175300,339815,27.826766826109903,37.748972439311096,NaN,NaN,-157.0980459127864,-153.57443320025823,-0.10143151002026135,-0.29803738336340047,-0.19660587334313911,132578,519978,31.480671063862772,60.146992909442254,NaN,NaN,-28.62690342108235,-15.166010746918673
2004-07-13T09:30:00-04:00,29.60001,29.82001,29.60001,29.78999,518900,359195,36.23848159877408,37.38433476498962,NaN,NaN,-108.23861695569653,-142.4194767162569,-0.07981927311770315,-0.29637996474026806,-0.21656069162256492,651478,450858,30.720302524156295,57.320798524234114,NaN,NaN,-28.589916567489617,-17.083711578428808
2004-07-14T09:30:00-04:00,29.7,30.13,29.7,29.89999,122600,356555,39.707116988395256,36.89434223914363,NaN,NaN,-69.07207833569107,-123.36502081127603,-0.05309459802619182,-0.2829289391553047,-0.22983434112911288,774078,461838,31.005390312113832,54.50014513461356,NaN,NaN,-27.499653682184157,-18.571703307536715
2004-07-15T09:30:00-04:00,29.95,30.00999,29.57001,29.57001,226700,326795,33.7719173192924,35.96015940063624,NaN,NaN,-93.2253210207123,-113.80949731747532,-0.052523979748619304,-0.295489315814887,-0.24296533606626772,547378,482678,31.580870312295147,51.662140217041596,NaN,NaN,-28.41828019837574,-19.97835714908515
2004-07-16T09:30:00-04:00,29.62,29.67,29.25999,29.31,97800,318290,29.970480314510795,35.201293757012344,NaN,NaN,-131.78459875674116,-111.8837321963255,-0.06379109563507823,-0.3227042056101155,-0.25891310997503725,449578,511018,32.40654042173546,48.855872394981084,NaN,NaN,-30.482048187739935,-21.478884440321547
2004-07-19T09:30:00-04:00,29.5,29.5,29.02,29.17,128500,318865,28.13415895724404,34.5257781967331,NaN,NaN,-146.66640286749322,-109.79740358726686,-0.0740830824824169,-0.35151696307805835,-0.27743388059564145,321078,548718,33.555264649409764,46.19413944063278,NaN,NaN,-32.76845658580964,-23.09168046110556
2004-07-20T09:30:00-04:00,29.17,29.3,29.09,29.28999,329000,330055,31.980854841274024,33.77586655337055,NaN,NaN,-133.07262399309735,-114.76420499474702,-0.06646354963578432,-0.36051331764037187,-0.29404976800458754,650078,548438,33.55070413209015,43.40088048284415,NaN,NaN,-33.40310109832345,-24.564740552136687
2004-07-21T09:30:00-04:00,29.60001,29.60001,28.96001,28.96001,137900,330460,27.604848379274728,32.48819191405603,NaN,NaN,-129.59977393349106,-126.86974411430701,-0.07658140206549413,-0.3897765205864552,-0.31319511852096105,512178,496058,32.65654298394574,40.41928029934258,NaN,NaN,-35.434924990353956,-26.11762404331058
2004-07-22T09:30:00-04:00,28.84,29.2,28.75999,29.10001,454300,344475,31.86461403493891,32.11586450307685,NaN,NaN,-142.03146051384087,-136.63097201293272,-0.06711873926567574,-0.39709354260305574,-0.32997480333738,966478,579878,35.61370056062718,38.12171317123377,NaN,NaN,-35.67935832160146,-27.48358608306642
2004-07-23T09:30:00-04:00,29.05,29.05,28.73,28.92,66600,321855,29.464005773926957,31.59670380542755,NaN,NaN,-146.328034490085,-139.5396591596015,-0.06614875069266096,-0.4126607417032062,-0.34651199101054525,899878,669938,38.72697462861822,36.40271676022963,NaN,NaN,-36.66079593215562,-28.794616061507735
2004-07-26T09:30:00-04:00,28.94,28.94,28.41,28.63,419800,327635,26.05803895847569,31.094714159857972,NaN,NaN,-159.5949574022633,-142.12537006655552,-0.07742119265835395,-0.4432884818334877,-0.3658672891751337,480078,701738,39.833242643712246,35.19382598280445,NaN,NaN,-38.650034839929134,-30.20253302985365
2004-07-27T09:30:00-04:00,28.7,28.86,28.46001,28.75,163500,316225,29.680409599242907,30.929197322533238,NaN,NaN,-134.22111088008475,-142.355067443953,-0.06943433215173911,-0.4526602043648076,-0.3832258722130685,643578,700438,39.80160584421912,34.64589680182304,NaN,NaN,-39.07231849840718,-31.46964523964701
2004-07-28T09:30:00-04:00,28.67999,28.78,28.25999,28.67999,126800,288500,28.7941326842531,30.77858502945685,NaN,NaN,-133.54499320364397,-143.14411129798359,-0.06176253780949059,-0.4604290444749317,-0.3986665066654411,516778,701358,39.838022339140885,34.701362275895264,NaN,NaN,-39.685028446927404,-32.64327141211564
2004-07-29T09:30:00-04:00,28.75,28.94,28.53999,28.81,216100,290465,32.80673967576759,30.993040425105733,NaN,NaN,-96.53261498157036,-134.0443421915295,-0.04178481053792604,-0.45089751983784865,-0.4091127092999226,732878,654638,38.56224399795193,34.95229117241997,NaN,NaN,-38.963220242176874,-33.54612124498153
2004-07-30T09:30:00-04:00,28.85001,28.97,28.75999,28.92,314600,249620,36.08838216663327,31.583155806571686,NaN,NaN,-71.04706384307998,-118.98814806212847,-0.01632298380459052,-0.4295164390556607,-0.4131934552510702,1047478,684158,39.872478285576484,35.551705973970954,NaN,NaN,-37.37051010995888,-34.092462511406865
2004-08-02T09:30:00-04:00,28.92,29.02,28.84,28.89,254700,255440,35.578040728706625,31.535981458709728,NaN,NaN,-59.921113555806926,-99.05337929283718,0.002344149643108917,-0.41026326819718406,-0.412607417840293,792778,746698,42.66232230018687,36.40470738654456,NaN,NaN,-36.216328750319306,-34.395871974108644
2004-08-03T09:30:00-04:00,28.85001,29.05,28.75,28.86,169700,230600,35.04434218782471,31.20292611581183,NaN,NaN,-59.58884246473345,-84.12692560976691,0.015768596201938212,-0.3928966725878702,-0.4086652687898084,623078,742598,42.52302540483284,37.22739560745306,NaN,NaN,-35.40576097179363,-34.54014183092079
2004-08-04T09:30:00-04:00,28.88,28.91,28.62,28.8,344600,233935,33.94751879608667,31.215469078439998,NaN,NaN,-71.85472159357545,-71.78887128775321,0.02325282678015783,-0.37959923531461115,-0.402852062094769,278478,694938,40.853174787588536,37.88970306997401,NaN,NaN,-35.010028585980635,-34.60726851021505
2004-08-05T09:30:00-04:00,28.89999,28.89999,28.23,28.27,441200,242195,26.159077942888075,30.943226051895515,NaN,NaN,-116.17531448746873,-75.71741118893289,-0.0034257905612780637,-0.40713430029636655,-0.4037085097350885,-162722,515818,35.25052160837693,38.09284458330554,NaN,NaN,-37.09443942363452,-34.96257864070355
2004-08-06T09:30:00-04:00,28.00999,28.00999,27.78999,27.88,582500,264555,22.134772216757426,30.51469842757504,NaN,NaN,-197.33993415590527,-100.97598525149796,-0.04117620092491542,-0.45517876089123277,-0.41400255996631735,-745222,157278,27.207277775902753,37.639416949483625,NaN,NaN,-40.365656995471696,-35.734446977099
2004-08-09T09:30:00-04:00,27.85001,27.94,27.75,27.75,512300,281405,20.97636262320701,29.728663269141684,NaN,NaN,-188.0945570248686,-126.61067394531028,-0.06720081628414182,-0.4980035803214946,-0.4308027640373528,-1257522,-252782,21.238515080278944,36.759974874354256,NaN,NaN,-43.3776224224168,-36.826329183572966
2004-08-10T09:30:00-04:00,27.89999,28.16,27.8,28.16,77800,259350,32.90293853416266,30.107098280205104,NaN,NaN,-136.23411657488523,-141.93972876734065,-0.04989697444506158,-0.4931739820936798,-0.4432770076486182,-1179722,-613342,17.585379517474294,35.68346319817772,NaN,NaN,-41.822706084940485,-37.54009731233975
2004-08-11T09:30:00-04:00,28.10001,28.7,28,28.63,1819900,344215,43.44096809761781,30.9339807132536,NaN,NaN,-60.86206850054519,-139.7411981487346,-0.002400005901293134,-0.44627701502523465,-0.4438770091239415,640178,-541002,20.538518850958297,34.60666450462994,NaN,NaN,-36.49904658452005,-37.39137577979408
2004-08-12T09:30:00-04:00,28.63,28.73,28.47,28.47,511600,358460,41.07586828989392,31.763399464394098,NaN,NaN,-32.154979755762774,-122.93713120239343,0.02133190184061412,-0.41721213182317385,-0.43854403366378797,128578,-482742,22.9336062793311,33.47856676539514,NaN,NaN,-33.193652934858825,-36.79170108766047
2004-08-13T09:30:00-04:00,28.55,28.60001,28.19,28.25,1089000,408020,38.01142551257601,32.61721278968698,NaN,NaN,-66.44861244740251,-96.75886686069286,0.025046584510345915,-0.4072358030258556,-0.4322823875362015,-960422,-525782,22.396534896512932,32.233087640595194,NaN,NaN,-31.591209449648478,-36.04877371080161
2004-08-16T09:30:00-04:00,28.35001,28.7,28.31,28.63,643400,433765,45.565550984151784,33.7518657457519,NaN,NaN,-18.38472295554422,-62.81690004682798,0.054253640557260785,-0.36446533683962556,-0.41871897739688635,-317022,-337682,30.10082976651576,31.54017506361638,NaN,NaN,-27.52166007021336,-34.83061461928901
2004-08-17T09:30:00-04:00,28.61,28.8,28.56,28.67,142000,424415,46.30728633344168,35.00280529212252,NaN,NaN,18.382962843037003,-31.893484163243546,0.07608607950807961,-0.32361137801178685,-0.39969745751986646,-175022,-136742,37.265859853140476,31.35644917175921,NaN,NaN,-24.15947266077464,-33.30616576807267
2004-08-18T09:30:00-04:00,28.55,29.08,28.55,29.05,709100,452975,52.87660070599457,36.43636679428158,NaN,NaN,78.28092821059762,-4.064884821014975,0.11367634893911949,-0.2576020213459671,-0.3712783702850866,534078,-157962,36.83643492163204,31.23317709487922,NaN,NaN,-18.988628824619504,-31.26080334757936
2004-08-19T09:30:00-04:00,29.10001,29.10001,28.82001,28.95,842600,472390,51.10459258280139,37.50895325257931,NaN,NaN,96.34811252614178,21.63573363536594,0.1282812071706333,-0.21092686132179495,-0.33920806849242824,-308522,-245382,35.04479889493466,30.888342852690517,NaN,NaN,-15.477916922665113,-29.00610528687732
2004-08-20T09:30:00-04:00,28.94,29.23,28.89999,29.19,129100,475515,55.00212809420465,38.8963880644006,NaN,NaN,127.85685416579261,60.496826958004974,0.1491192710400635,-0.15280897969234886,-0.30192825073241236,-179422,-89182,40.60367132233708,30.741296354272674,NaN,NaN,-11.267227717839312,-26.47197991987189
2004-08-23T09:30:00-04:00,29.10001,29.31,29.08,29.13,133100,461180,53.84653623027569,40.23940192457567,NaN,NaN,127.09884203483021,89.59353995607987,0.15328664957704596,-0.11031993876110491,-0.26360658833815087,-312522,-88282,40.63519580575233,30.60645138290978,NaN,NaN,-8.265020185479827,-23.870985672101597
2004-08-24T09:30:00-04:00,29.13,29.28,29.08,29.14999,443000,475155,54.191850051774175,41.6854255856962,NaN,NaN,112.44699686598,108.40634676066846,0.15154210829100662,-0.07417895297439259,-0.2257210612653992,130478,-27182,42.85271488069197,30.749275675274312,NaN,NaN,-5.7534810321458725,-21.282770723536494
2004-08-25T09:30:00-04:00,29.25,29.42999,29.11,29.42999,149800,476305,58.83745043693763,44.019595049556884,NaN,NaN,127.63032256711072,118.27622563197107,0.16243137758036652,-0.022681839289941053,-0.18511321687030757,280278,-77942,41.4669007406186,31.193302756148714,NaN,NaN,-2.1260732246367082,-18.546099652265095
2004-08-26T09:30:00-04:00,29.42999,29.44,29.28,29.39,664600,498730,57.93378216380592,46.57666718863178,NaN,NaN,121.0228038646046,123.21116389966365,0.15987721287998352,0.014733299229671815,-0.1451439136503117,-384322,-93102,41.04002980522559,32.18135647252892,NaN,NaN,0.5683639005626945,-15.815462001861125
2004-08-27T09:30:00-04:00,29.3,29.61,29.3,29.60001,372700,501635,61.29570402860057,49.45662014615989,NaN,NaN,129.8500118955066,123.60979544560644,0.1646208811780069,0.060632187822196926,-0.10398869335580999,-11622,-59542,42.45234005650253,33.69662968511632,NaN,NaN,3.904467109803558,-12.998329271623312
2004-08-30T09:30:00-04:00,29.55,29.55,29.2,29.23,110100,494405,53.224732638877676,50.90817686792525,NaN,NaN,91.8369062247522,116.55740828359083,0.13629929323107934,0.0663854231830392,-0.06991387004804014,-121722,-21382,44.09223521148284,35.58997652040265,NaN,NaN,4.42428318223433,-10.509384635357936
2004-08-31T09:30:00-04:00,29.25,29.39,29.17999,29.39,598000,515820,55.92718334746459,51.800049385771445,NaN,NaN,83.0804919093881,110.68410729227246,0.12225105402987405,0.0828999474893024,-0.03935110654057163,476278,47778,47.03791021414005,37.482790189201346,NaN,NaN,5.682681992151186,-8.19623225999949
2004-09-01T09:30:00-04:00,29.45,29.52,29.3,29.50999,462400,521710,57.891973377486394,53.00119974917091,NaN,NaN,90.8878063846837,103.33560405578706,0.11505352560399143,0.10446580046441767,-0.010587725139573768,938678,179458,52.201765599172134,39.57337299776142,NaN,NaN,7.312692759212851,-5.980671542969157
2004-09-02T09:30:00-04:00,29.55,29.87,29.45,29.81,278400,513570,62.40484129205214,54.74358659056207,NaN,NaN,116.92293116717916,102.51562951630197,0.12375342188786463,0.14410405222025702,0.02035063033239239,1217078,499738,61.925584972960685,42.39687657465054,NaN,NaN,10.149955470683441,-3.6762962553045
2004-09-03T09:30:00-04:00,29.64999,29.99001,29.64999,29.78999,1716900,570290,61.92811224274902,55.91234096617615,NaN,NaN,123.0666779914994,101.15896273550052,0.12125646520026033,0.1719212118327178,0.05066474663245747,-499822,402098,58.04855569147765,44.39314271214782,NaN,NaN,12.283765099070651,-1.3962874903937643
2004-09-07T09:30:00-04:00,30,30.38,29.78999,29.95,188400,554095,64.27813555921179,57.19597305373116,NaN,NaN,149.61776260348037,112.71513401124616,0.12308452041341907,0.20452039714923131,0.08143587673581225,-311422,364158,56.566573201212236,45.77176509415295,NaN,NaN,14.79281687650102,0.9164417048769193
2004-09-08T09:30:00-04:00,30.05,30.05,29.83,29.88,401100,570260,62.461711530713124,57.88062382692534,NaN,NaN,124.6381093972119,121.02665750881093,0.11256834424741667,0.2221463070450831,0.10957796279766642,-712522,126398,48.25276489868169,46.58721723537077,NaN,NaN,16.362280278916053,3.1229900725967954
2004-09-09T09:30:00-04:00,29.95,29.95,29.73,29.75999,506500,504590,59.36440515408423,58.47061043915983,NaN,NaN,98.0920104530324,122.46749832248068,0.09141823093794332,0.2238507514700956,0.13243252053215226,-1219022,-305142,37.48424812320833,46.76146360881889,NaN,NaN,16.828476384196875,5.080916688539664
2004-09-10T09:30:00-04:00,29.75,29.75,29.46001,29.72,160700,487045,58.32650660745803,58.70806604724935,NaN,NaN,63.291252000179156,111.74116248908066,0.06961002454750362,0.2194450512165318,0.14983502666902818,-1379722,-824502,29.074573959670374,45.937956654342706,NaN,NaN,16.933469194362353,6.774138475085762
2004-09-13T09:30:00-04:00,29.75999,29.84,29.64999,29.75,3257800,595485,58.90693922244973,59.069523403833216,NaN,NaN,76.11986512103275,102.35179991498732,0.05284050334262466,0.215885655847309,0.16304515250468435,1878078,-348922,41.923590587868915,46.02998485306531,NaN,NaN,17.172528612381715,8.259622780413755
2004-09-14T09:30:00-04:00,29.8,30.06,29.8,29.98,178100,572220,63.14510852298271,59.7090418660624,NaN,NaN,106.87686308942048,93.80362001217534,0.05275131697626595,0.2289842987250168,0.17623298174875085,2056178,124598,51.3700887184857,46.638368698622,NaN,NaN,18.553371007317274,9.730158241399971
2004-09-15T09:30:00-04:00,29.98,29.98,29.83,29.86,169000,573570,59.686329801190396,59.76967610636616,NaN,NaN,86.28707853237037,86.13341383920704,0.04066530337353497,0.22706461096566954,0.18639930759213458,1887178,644538,59.2147439935933,47.906071788120194,NaN,NaN,18.786778468304213,11.02396113095772
2004-09-16T09:30:00-04:00,29.89999,29.92999,29.78999,29.85001,58700,541050,59.3946547035027,59.87402414491594,NaN,NaN,71.12367807840808,80.73974736428218,0.028621376424906975,0.2221760281232683,0.19355465169836134,1828478,1254038,66.11523544642245,49.69715790534849,NaN,NaN,18.902697906420375,12.149494956023812
2004-09-17T09:30:00-04:00,29.89999,29.89999,29.75,29.85001,948100,546325,59.39465470350272,59.73823490740896,NaN,NaN,59.61132024406226,80.00376101305879,0.017807495683165392,0.21581402130231808,0.1980065256191527,1828478,1895678,71.56873641751811,51.77690050256388,NaN,NaN,18.999795285894592,13.128109288862495
2004-09-20T09:30:00-04:00,29.8,29.8,29.42999,29.52,160200,547880,50.02828907667786,59.50991751010896,NaN,NaN,-10.610703573106324,62.65764727423099,-0.012769588549695954,0.18204453993203273,0.1948141284817287,1668278,1853718,70.76663697870542,53.68221491450836,NaN,NaN,16.412272781466942,13.597275502091701
2004-09-21T09:30:00-04:00,29.55,29.78,29.47,29.67,203600,551405,53.60928367549455,59.344353247825396,NaN,NaN,-1.4135125007887985,40.99957215618913,-0.02346874328775167,0.16547819937203911,0.18894694265979078,1871878,1816858,70.02420345292887,55.32409300299327,NaN,NaN,15.171548229152295,13.8221716059575
2004-09-22T09:30:00-04:00,29.64999,29.64999,29.22,29.3,2548800,656695,45.0362120745627,58.42608458333085,NaN,NaN,-87.987424457955,6.14467155812406,-0.054279624719058756,0.12109741176096733,0.1753770364800261,-676922,1304038,60.51230849306489,55.917703209699894,NaN,NaN,11.264099992945493,13.456732804098642
2004-09-23T09:30:00-04:00,29.39999,29.39999,29.09,29.09,187800,658595,41.02607960623437,56.899030177201006,NaN,NaN,-146.28231077951992,-37.33652621346154,-0.08574644904040613,0.06819397517951842,0.15394042421992454,-864722,765398,52.452843142800866,55.24107879325991,NaN,NaN,6.618974524640171,12.479910192747433
2004-09-24T09:30:00-04:00,28.85001,29.3,28.85001,29.17,531000,651915,43.104485051922644,55.55448537785627,NaN,NaN,-158.90750983757445,-81.04029222978889,-0.09727230672090675,0.032350040818791115,0.12962234753969787,-333722,332958,47.03646332116601,54.454500766809076,NaN,NaN,3.4769894383567133,11.193778656405902
2004-09-27T09:30:00-04:00,29.17,29.2,28.99001,29,402100,653385,39.88748859078266,53.812296308682754,NaN,NaN,-147.7443242768777,-108.46701637054316,-0.11142806101769627,-0.009662728732422465,0.1017653322852738,-735822,-147862,41.86055676567967,53.40407102141389,NaN,NaN,-0.2035092018897432,9.565594676649381
2004-09-28T09:30:00-04:00,29.2,29.38,28.75,29.22,673400,681550,45.5508900667186,52.604380489826,NaN,NaN,-124.30788651138806,-133.045891172663,-0.10134725955297089,-0.02491874215593981,0.07642851739703108,-62422,-534722,38.21670275645558,52.68720943982631,NaN,NaN,-1.6094950748057661,7.96915328358436
2004-09-29T09:30:00-04:00,29.3,29.36,29.19,29.35001,668100,685055,48.63090721059702,51.8377020652912,NaN,NaN,-76.86995957702575,-130.82239819647717,-0.08211586740953944,-0.02621631686489323,0.05589955054464621,605678,-278202,41.83237760176648,52.99779011686618,NaN,NaN,-1.822817935196638,6.570300252329932
2004-09-30T09:30:00-04:00,29,29,28.64999,28.78999,1650500,744460,38.52239773981153,50.42312286045931,NaN,NaN,-167.63631284455775,-135.09319860948474,-0.10200614755157014,-0.07160813389481646,0.030398013656753674,-1044822,-314222,41.46542366311501,53.882850809969376,NaN,NaN,-5.602234142154584,4.831366767403573
2004-10-01T09:30:00-04:00,28.78999,29.11,28.78999,29.06,644200,762750,44.51121375415587,49.39485675558118,NaN,NaN,-110.46212628807488,-125.40412189958481,-0.09217138447464476,-0.08481621693655228,0.0073551675380924796,-400622,-327602,41.32042603985262,53.839767627968214,NaN,NaN,-6.608146327462302,3.197150610994162
2004-10-04T09:30:00-04:00,29.06,29.33,29.06,29.19,227300,688270,47.179162721458205,48.254432055472286,NaN,NaN,-61.40291984183514,-108.13584101257632,-0.07294612859106892,-0.08382749320074367,-0.010881364609674753,-173322,-215102,43.12138928200572,53.25057481107678,NaN,NaN,-6.497962954625391,1.812134387334226
2004-10-05T09:30:00-04:00,29.28999,29.28999,29.03999,29.10001,210100,689355,45.546621907317295,47.24445292019563,NaN,NaN,-64.09522842639228,-96.09330939557717,-0.06271590230271228,-0.0892762424880651,-0.02656034018535282,-383422,-279302,42.323095926221804,52.04402852055024,NaN,NaN,-6.9363456569043445,0.5623515238715731
2004-10-06T09:30:00-04:00,29.16,30,28.86,29.07001,403800,689490,44.98774046940399,46.21538761776001,NaN,NaN,-25.509053117112366,-85.82112810359448,-0.05468850778874729,-0.09492097492128693,-0.04023246713253964,-787222,-557882,38.953228483394945,50.10388516604828,NaN,NaN,-7.454430730788307,-0.5829030839369811
2004-10-07T09:30:00-04:00,29.09,29.10001,28.3,28.41,549100,691620,34.85471753282165,44.46253496271136,NaN,NaN,-158.41395074547538,-83.976655683778,-0.08854373505025755,-0.15091213594536157,-0.06236840089510402,-1336322,-616182,38.26654291224931,47.725157058529085,NaN,NaN,-11.551400717817176,-2.149831317348437
2004-10-08T09:30:00-04:00,28.28999,28.45,28,28.02,315700,699370,30.485207201866316,43.06660054308196,NaN,NaN,-212.9212234706582,-104.46847512029467,-0.1294422147931179,-0.2241711693865014,-0.09472895459338349,-1652022,-866462,35.38284668508477,45.19774346612761,NaN,NaN,-16.61483663426303,-4.216260648336236
2004-10-11T09:30:00-04:00,28.02,28.25,28.00999,28.21001,220500,547505,34.775421802223946,41.72132469499121,NaN,NaN,-184.43412727102972,-129.0747166061336,-0.13530139466929142,-0.26385569792999775,-0.12855430326070633,-1431522,-1118102,32.713553851739576,42.53269706604266,NaN,NaN,-19.123256244250165,-6.345831447752511
2004-10-12T09:30:00-04:00,28.00999,28.23,27.95,28.16,221900,549695,34.17755037857839,40.9457060024209,NaN,NaN,-168.79235726783304,-150.01414237442174,-0.13390060874452864,-0.29593006419136714,-0.1620294554468385,-1653422,-1372102,30.234188700890698,40.3699742237445,NaN,NaN,-21.260294558946473,-8.476469035065934
2004-10-13T09:30:00-04:00,28.16,28.28,27.77,27.86,1535600,618025,30.761020576526562,40.21248750029891,NaN,NaN,-160.6048321555154,-177.03329818210233,-0.14367143962265874,-0.3416187549751619,-0.19794731535250318,-3189022,-1852462,26.191333558754636,38.49415211059834,NaN,NaN,-24.213907849452703,-10.724674579978329
2004-10-14T09:30:00-04:00,27.85001,28.06,27.66,27.67,170800,623630,28.79758193682838,39.190565849220754,NaN,NaN,-154.74752193891442,-176.30001242079015,-0.15258482108990645,-0.38867834171488624,-0.2360935206249798,-3359822,-2257162,23.35754113278422,36.80280052571392,NaN,NaN,-27.277127764304716,-13.089310749167813
2004-10-15T09:30:00-04:00,27.64999,27.74001,27.42999,27.71001,229300,587690,29.813525666374886,38.47099706890591,NaN,NaN,-150.12789219659066,-163.74134616597664,-0.14546704316609016,-0.4179273245825925,-0.27246028141650236,-3130522,-2552862,21.5249896728227,35.35026001908128,NaN,NaN,-29.393029934596182,-15.418413489943294
2004-10-18T09:30:00-04:00,27.64999,28,27.62,27.97,518500,605605,36.185407160845,37.80203400420066,NaN,NaN,-104.12661217447331,-147.67984314666538,-0.11430421228851406,-0.41534054677714494,-0.3010363344886309,-2612022,-2788962,20.16464493273287,34.0608273173868,NaN,NaN,-29.224901391836344,-17.390768904499446
2004-10-19T09:30:00-04:00,28.05,28.05,27.46001,27.50999,474800,619165,30.84898211453185,36.531896497338856,NaN,NaN,-111.76432057118342,-136.27423580733543,-0.11539221066589783,-0.44527659782100315,-0.3298843871551053,-3086822,-3075642,18.625432743380117,32.40318839893063,NaN,NaN,-30.8416692463653,-19.312326096194568
2004-10-20T09:30:00-04:00,27.55,27.55,27.21001,27.5,268600,505155,30.742948061939416,35.97622152034799,NaN,NaN,-123.44555142407569,-128.84237966104752,-0.10765514208434496,-0.46445331476053653,-0.35679817267619157,-3355422,-3108922,18.449372973182577,30.75918477822118,NaN,NaN,-32.13321475758003,-21.143881619249633
2004-10-21T09:30:00-04:00,27.5,27.5,27.07001,27.24001,316000,511565,28.04158521908856,34.799819482128896,NaN,NaN,-123.28956928833345,-122.55078913093129,-0.11050133053204364,-0.49492483584124614,-0.3844235053092025,-3671422,-3171242,18.10425839212894,29.10088708909806,NaN,NaN,-34.0868125895587,-22.992871757865213
2004-10-22T09:30:00-04:00,27.32001,27.35001,26.98,27.03999,402300,505130,26.13865807749083,33.296926293274076,NaN,NaN,-123.98756195665146,-117.32272308294345,-0.11575269736884047,-0.5291143770202531,-0.41336167965141263,-4073722,-3359882,17.06374634920435,27.239626879612253,NaN,NaN,-36.318677450112645,-24.89655828532913
2004-10-25T09:30:00-04:00,27.14999,27.14999,26.7,26.89,203700,495210,24.780639607586494,31.813641843293304,NaN,NaN,-131.81258973386448,-122.85991859482169,-0.11877967656434973,-0.5618362753568498,-0.44305659879250003,-4277422,-3692962,15.382634726435583,25.315308222484667,NaN,NaN,-38.58529610040168,-26.852092258910925
2004-10-26T09:30:00-04:00,26.95,27.39999,26.95,27.39999,463500,484715,36.8033057887657,31.22903936610485,NaN,NaN,-91.30489633228854,-118.76803374704272,-0.07786466875264636,-0.540387434733308,-0.4625227659806616,-3813922,-3838382,14.701633305782138,23.583051424083756,NaN,NaN,-36.65913731599401,-28.25309869563708
2004-10-27T09:30:00-04:00,27.5,28.22,27.45,28.12,480600,475340,49.15853393090056,32.250740537396204,NaN,NaN,-15.366893480591584,-97.15230215834589,0.002027947984566736,-0.4599878309999532,-0.46201577898451995,-3333322,-3833962,14.825060806494449,21.908659845101262,NaN,NaN,-30.26900826262996,-28.541085776636063
2004-10-28T09:30:00-04:00,28.2,28.21001,28,28.07001,263800,406005,48.450291255112965,33.53396082691382,NaN,NaN,7.73244376743061,-70.94789954719309,0.05301864864559419,-0.39574246817752723,-0.4487611168231214,-3597122,-3819102,15.268970802716268,20.471954424932086,NaN,NaN,-25.675873302076713,-28.13176970884187
2004-10-29T09:30:00-04:00,28.2,28.21001,27.92,28.14999,303700,388980,49.69894832734194,34.5999270072794,NaN,NaN,14.449160383023887,-43.26055507925801,0.09139471298799173,-0.33451772558813175,-0.4259124385761235,-3293422,-3663042,19.98536398739897,19.56279800605061,NaN,NaN,-21.660370767927482,-27.2072841458541
2004-11-01T09:30:00-05:00,28.10001,28.10001,27.77,27.89,1321300,443680,45.81408363368007,35.431107954072374,NaN,NaN,-0.20364695091087684,-16.93876652266729,0.09794803275947872,-0.30347739762677506,-0.4014254303862538,-4614722,-3730502,19.480576315285106,18.794682835650214,NaN,NaN,-19.525479999840176,-26.109883553566398
2004-11-02T09:30:00-05:00,27.85001,28.22,27.52,27.67999,1214700,493910,42.897158778081604,36.297974968469155,NaN,NaN,-8.36940136363974,-0.35166752893753744,0.08717830034975932,-0.29245255494905464,-0.37963085529881396,-5829422,-4133602,16.756975491543216,18.120800116563686,NaN,NaN,-18.673607495867792,-25.047558402466596
2004-11-03T09:30:00-05:00,29.39999,30.28,28.38,28.5,1325800,540010,54.956470192556694,38.16646698673547,NaN,NaN,218.61326702401556,46.4443645719839,0.13165015470982577,-0.21506816191153177,-0.34671831662135755,-4503622,-4367662,15.40976128783798,17.553101556210386,NaN,NaN,-13.50250243503169,-23.39826469283304
2004-11-04T09:30:00-05:00,28.60001,28.60001,28.00999,28.56,1230700,574090,55.69377376565452,40.01505613668401,NaN,NaN,103.5470595642047,65.60728773133872,0.1596129573472651,-0.14720211993727617,-0.30681507728454127,-3272922,-4302822,17.391142867727098,17.25782678441784,NaN,NaN,-9.299274967418564,-21.384123303488114
2004-11-05T09:30:00-05:00,28.7,28.83,28.58,28.73,707400,593675,57.80140334483111,41.55905586411159,NaN,NaN,147.9843271603767,92.31432108680929,0.18241850268161774,-0.07879194893251906,-0.2612104516141368,-2565522,-4157242,21.818989235584326,17.37599423462152,NaN,NaN,-5.223105528795095,-19.075406478531967
2004-11-08T09:30:00-05:00,28.67999,28.72,28.53,28.72,379100,601605,57.627744499825326,43.471824605918265,NaN,NaN,125.817157461077,117.51848196920687,0.18889312652600862,-0.025094043456626025,-0.21398716998263465,-2944622,-3823222,30.96237814696805,18.257204620592088,NaN,NaN,-2.0656301464706943,-16.645438431094643
2004-11-09T09:30:00-05:00,28.75,28.88,28.64999,28.73,410000,611010,57.76439835682613,45.401928198410175,NaN,NaN,126.46216700981805,144.4847956438984,0.18563826231413222,0.018060657910030642,-0.16757760440410158,-2534622,-3164262,44.70229954121147,20.132413661165575,NaN,NaN,0.5175284344707581,-14.193586021728157
2004-11-10T09:30:00-05:00,28.8,28.84,28.5,28.64999,301000,549280,56.20259751276325,47.413429076529795,NaN,NaN,98.74359756483605,120.51086175206251,0.17028843376968728,0.04528293780800752,-0.12500549596167976,-2835622,-2830662,50.11506836593903,22.418900087866295,NaN,NaN,2.2480659874178532,-11.844778591850154
2004-11-11T09:30:00-05:00,28.8,28.92999,28.67999,28.8,242400,552860,58.469798693800456,49.72279626340905,NaN,NaN,102.63716008799507,120.32888185682059,0.16245359652164898,0.07806149969038145,-0.08439209683126751,-2593222,-2694722,52.16964306743168,24.926464139168246,NaN,NaN,4.3646061152877484,-9.52915220511617
2004-11-12T09:30:00-05:00,28.82001,28.89999,28.57001,28.84,354400,559115,59.07810442913202,52.17261517923373,NaN,NaN,87.73885052712288,108.27978653016983,0.15234887953957765,0.10604400259320457,-0.04630487694637309,-2238822,-2629382,53.16805845515097,27.62542297693363,NaN,NaN,6.297369587084152,-7.268220520516124
2004-11-15T09:30:00-05:00,28.77,29.11,28.75999,28.99001,445200,555450,61.36369464278501,53.926928668806546,NaN,NaN,97.58713817116796,102.63378267218802,0.14802449915964688,0.13872574700318552,-0.009298752156461372,-1793622,-2399182,56.604897803960874,30.618513298232113,NaN,NaN,8.60080142493462,-5.0012173854517314
2004-11-16T09:30:00-05:00,29.05,29.05,28.8,28.85001,747600,569090,58.102121492981794,54.56575635181235,NaN,NaN,81.79906383046857,93.70116203631812,0.12870467448380263,0.1515820909482919,0.022877416464489278,-2541222,-2400502,56.57925723805767,33.600955900486625,NaN,NaN,9.733076675520229,-2.8963182338843088
2004-11-17T09:30:00-05:00,28.92,29.03999,28.75,28.84,562600,583790,57.86529813038068,55.2382568429029,NaN,NaN,72.16472103117489,88.38538672958589,0.10900108709954537,0.159128775338921,0.05012768823937563,-3103822,-2454142,55.479478083664986,36.47313499198297,NaN,NaN,10.618849069719706,-0.9655800476551639
2004-11-18T09:30:00-05:00,28.78999,28.87,28.69,28.75999,238300,579905,55.90388351193421,55.681466498945206,NaN,NaN,55.28321949910852,78.91459861180859,0.08537418730030231,0.15684542236475352,0.0714712350644512,-3342122,-2603922,52.41568622218831,38.789586580182196,NaN,NaN,10.883584732348849,0.727157778059695
2004-11-19T09:30:00-05:00,28.63,28.69,28.38,28.41,839300,601755,48.20635118021067,55.85234275226882,NaN,NaN,14.529708239240671,64.27277015423213,0.04310271449584427,0.12534962818425655,0.08224691368841228,-4181422,-2992442,45.410392012858786,40.64171627286603,NaN,NaN,8.96668796844035,1.9042335195426456
2004-11-22T09:30:00-05:00,28.5,28.53999,28.25,28.46001,292900,606215,49.28099893786732,56.30833133511066,NaN,NaN,-8.513351662047002,43.05267218758915,0.01678995071377136,0.10323435208062648,0.08644440136685512,-3888522,-3411422,39.309087975543,42.25258145029459,NaN,NaN,7.646527131386678,2.7245611783775074
2004-11-23T09:30:00-05:00,28.5,28.5,28.25999,28.37,162900,591185,47.375696903661165,55.76684752876098,NaN,NaN,-30.467445275733404,20.599370366348733,-0.007114861849087065,0.07755082405549629,0.08466568590458336,-4051422,-3713462,35.59608340140254,43.694461601263484,NaN,NaN,5.995118948176942,3.1917837169202836
2004-11-24T09:30:00-05:00,28.5,28.58,28.33,28.44,302400,582275,49.026225612488986,55.290594089249154,NaN,NaN,-22.5642582174417,1.653574516625421,-0.018029606865330033,0.06212867732292082,0.08015828418825086,-3749022,-3842502,34.11355156316415,44.88891936522327,NaN,NaN,5.0108512892911135,3.4516505129732593
2004-11-26T09:30:00-05:00,28.55,28.73,28.46001,28.61,3009300,719550,52.89060549244323,54.93982281407859,NaN,NaN,6.780579561117723,-8.046953470972742,-0.013807400730436986,0.06289903327520463,0.07670643400564162,-739722,-3322022,44.20712464865787,46.48807189472853,NaN,NaN,5.170014320499292,3.6971310569055498
2004-11-29T09:30:00-05:00,28.7,28.75999,28.50999,28.60001,809000,744815,52.63806316943094,54.58341700476471,NaN,NaN,6.7295237724234696,-9.606990364336175,-0.011774053339276086,0.061988867331546516,0.0737629206708226,-1548722,-2795482,52.18716891634652,48.004128378255565,NaN,NaN,5.237124640369224,3.917130140257503
2004-11-30T09:30:00-05:00,28.55,28.77,28.53999,28.7,340200,695760,54.95633884527887,54.382841325368474,NaN,NaN,11.278392649844317,-5.648641501957913,-0.00417372951776189,0.06854575877362024,0.07271948829138213,-1208522,-2259482,58.66800489146643,49.00167876041663,NaN,NaN,5.899764383135715,4.200363603525819
2004-12-01T09:30:00-05:00,28.7,29.19,28.7,29.17999,669100,668480,64.05260823160282,54.94355637671416,NaN,NaN,132.24877828342952,26.894603209874663,0.030777670770920612,0.11119157675503288,0.08041390598411227,-539422,-1557082,65.3048250367478,50.086661379760116,NaN,NaN,9.339450538133217,4.934518879898304
2004-12-02T09:30:00-05:00,29.25,29.5,29.10001,29.46001,487500,626565,68.0998893040161,55.631419991729565,NaN,NaN,238.48826815642818,79.10510848464864,0.06820821898224982,0.16567417971192455,0.09746596072967473,-51922,-817662,70.6480349342857,51.40654651310683,NaN,NaN,13.677368505590062,6.1834973978542696
2004-12-03T09:30:00-05:00,29.46001,29.59,29.2,29.25999,771200,603590,62.67191248830774,55.88812056738498,NaN,NaN,200.92023968724857,117.93304050987481,0.07443998622693497,0.19051594351334344,0.11607595728640847,-823122,-834342,70.38470454492231,52.6363069480905,NaN,NaN,15.630049807575608,7.533004884957318
2004-12-06T09:30:00-05:00,29.25999,29.32001,28.97,29.2,370900,586765,61.09896030519804,55.86921097184305,NaN,NaN,117.48742476174257,140.08462070773862,0.06955700612419682,0.2030222149416545,0.1334652088174577,-1194022,-763402,70.88180613145701,53.65608611434022,NaN,NaN,16.728961885414776,8.846713027879812
2004-12-07T09:30:00-05:00,29.45,29.45,28.87,28.89999,300200,582820,53.82356515521059,55.563599804859386,NaN,NaN,79.3969072540304,153.70832362857584,0.04248744144184757,0.18657451061976715,0.14408706917791958,-1494222,-820542,69.8645745535308,54.60503735115974,NaN,NaN,15.37783155030477,9.779729959654805
2004-12-08T09:30:00-05:00,28.95,29.37,28.94,29.32001,372600,580950,60.85189909595679,55.77692844525768,NaN,NaN,103.79876995052024,148.018321961994,0.048784581686815626,0.20506779628643912,0.1562832145996235,-1121622,-936982,67.73142209237571,55.48017620892478,NaN,NaN,16.5425770688392,10.745850975252576
2004-12-09T09:30:00-05:00,29.39999,29.60001,29.06,29.50999,1360000,633900,63.55401675826822,56.32336653428154,NaN,NaN,132.03728805200365,126.72812594110908,0.06087341434817553,0.2323749825348429,0.17150156818666737,238378,-878922,68.25194697265768,56.61133769110116,NaN,NaN,18.39946946992744,11.839225045920413
2004-12-10T09:30:00-05:00,29.64999,29.64999,29.39999,29.49001,1367700,690165,63.06103940834462,57.38441569343396,NaN,NaN,139.3035734025743,114.40479268417423,0.06242075150856244,0.2495275075723704,0.18710675606380797,-1129322,-940162,67.02384663754339,58.15515587857863,NaN,NaN,19.696351791156065,12.96167172381122
2004-12-13T09:30:00-05:00,29.60001,29.64999,29.41,29.63,661900,705540,65.10349271298351,58.51459382022797,NaN,NaN,129.8676404702328,116.88083582587228,0.06734641170264483,0.271289770692114,0.2039433589894692,-467422,-794842,68.47351687376472,60.23832937130876,NaN,NaN,21.403807136776344,14.167691068520522
2004-12-14T09:30:00-05:00,29.75,29.91,29.59,29.89,479500,707255,68.5784976741202,60.02907958954648,NaN,NaN,149.90045943917772,130.98154626290176,0.08163658981832272,0.3059890962623726,0.22435250644404986,12078,-493582,71.29115795015935,62.787977553362815,NaN,NaN,23.98658664953862,15.570390437237393
2004-12-15T09:30:00-05:00,29.89999,29.99001,29.69,29.98,604900,700120,69.70316623807689,61.50600391994561,NaN,NaN,142.80981373119047,138.7837550190358,0.09001208244559042,0.3368676095010379,0.24685552705544747,616978,-145862,74.16159916481526,65.64855238205219,NaN,NaN,26.439147852205046,17.123070067947058
2004-12-16T09:30:00-05:00,30.07001,30.44,30.00999,30.39999,623500,703165,74.32206848050672,63.036822704807285,NaN,NaN,175.03889189994467,147.384075788624,0.11509534277158256,0.39072470551992566,0.2756293627483431,1240478,54558,75.67148677170209,67.89600681941248,NaN,NaN,30.20889961169115,18.99247428848193
2004-12-17T09:30:00-05:00,29.5,29.8,29.17999,29.7,1019000,742200,58.354076775817056,63.44510939097773,NaN,NaN,61.80922008547142,131.8852051252034,0.0775989695633944,0.3726280747025861,0.29502910513919167,221478,324718,77.5738699567573,69.70934260801324,NaN,NaN,27.79165231213012,20.249499720431672
2004-12-20T09:30:00-05:00,29.77,29.8,29.31,29.34,2002900,800380,52.14865927844736,63.244560850489755,NaN,NaN,45.503894550959714,115.0124559413488,0.024365020041418994,0.3254853801909654,0.3011203601495464,-1781422,61918,71.70042183652595,70.64022953266036,NaN,NaN,23.48422293995684,20.711603037506695
2004-12-21T09:30:00-05:00,29.34,29.63,29.34,29.62,3683300,969900,56.06227006673454,62.673822410142016,NaN,NaN,47.32268866529109,94.49690178657147,0.00484544620644578,0.30717716790760363,0.30233172170115785,1901878,439878,74.67075452667589,71.30922449622665,NaN,NaN,21.466690314644108,20.819472648526325
2004-12-22T09:30:00-05:00,29.64999,29.86,29.60001,29.84,912000,1007355,58.906140380735835,62.01712605847915,NaN,NaN,81.41350043455532,82.21763912724444,0.0036405346299888675,0.3068823899886439,0.30324185535865505,2813878,879258,77.61252853119524,71.80668832457732,NaN,NaN,20.86437083929815,20.825886675779444
2004-12-23T09:30:00-05:00,29.64999,30.08,29.64999,29.96001,642900,1024380,60.411434537870406,61.855663347733625,NaN,NaN,99.53331156878437,67.11652306101239,0.007588636279105165,0.3127276507075365,0.30513901442843133,3456778,1322518,80.12087363966216,72.5021289742016,NaN,NaN,20.893371437716958,20.835527356056232
2004-12-27T09:30:00-05:00,30.10001,30.12,29.89999,29.92,563100,902070,59.627237974873765,61.75054032413903,NaN,NaN,107.6590171061449,76.28648246514709,0.00433018217397535,0.31055174214590053,0.3062215599719252,2893678,1856958,82.6456133386124,73.34240091756985,NaN,NaN,20.669884833370013,20.81186413852963
2004-12-28T09:30:00-05:00,30.05,30.24001,30,30.23,413000,882270,63.572804319164945,62.44691455013577,NaN,NaN,134.3386465645709,94.05343286786933,0.0190525632365382,0.3300372640175979,0.3109847007810597,3306678,2874578,86.2313738787233,74.51145801222644,NaN,NaN,21.735763691431412,20.94384978894417
2004-12-29T09:30:00-05:00,30.3,30.3,30.17,30.28999,300100,880265,64.29990099731494,62.69320040023278,NaN,NaN,136.81528710406909,111.95195255562494,0.02827473311606038,0.3463281171761352,0.31805338406007483,3606778,3215558,87.18671906248645,75.90112208152007,NaN,NaN,22.811019479943994,21.21058831622986
2004-12-30T09:30:00-05:00,30.39999,30.39999,30.24001,30.31,268000,860210,64.55404857216618,62.76463124408263,NaN,NaN,131.36398242869865,121.9420489544536,0.030950161763260875,0.3567410862641509,0.32579092450089003,3874778,3427738,87.75603333551477,77.29427110743845,NaN,NaN,23.751864877099436,21.573627824925513
2004-12-31T09:30:00-05:00,30.35001,30.35001,30.17999,30.19,236300,847650,61.716541384839786,62.668595670975144,NaN,NaN,102.73659472147413,122.58270558499154,0.020376316656529225,0.35126132032155155,0.3308850036650223,3638478,3464078,87.8555588473303,78.78225055099465,NaN,NaN,23.745738680657517,21.88392937574437
2005-01-03T09:30:00-05:00,30.45,30.45,29.82001,29.84,606200,839400,54.22934346086653,61.89187072439536,NaN,NaN,56.75970199596897,112.40284256295635,-0.012672122550561882,0.31504485047681996,0.32771697302738184,3032278,3491798,87.93611384651527,80.17243604904824,NaN,NaN,21.487094465009704,21.827238674210847
2005-01-04T09:30:00-05:00,29.98,30.05,29.47,29.60001,454300,843570,49.770713922065184,60.54845759924857,NaN,NaN,-16.63831037648599,82.20745117474497,-0.05102528461414402,0.2639353672597018,0.3149606518738458,2577978,3346058,84.75308410738774,81.13400220313599,NaN,NaN,18.170161843625017,21.3047991269843
2005-01-05T09:30:00-05:00,29.58,29.74001,29.53999,29.55,448300,850975,48.869040544512806,59.060305763993995,NaN,NaN,-47.91139161902954,45.26211543012524,-0.07845243134657603,0.21689511269062578,0.2953475440372018,2129678,3050638,78.54658698909509,81.44721561915598,NaN,NaN,15.204529471254688,20.43333203330864
2005-01-06T09:30:00-05:00,29.7,29.88,29.55,29.77,1247500,894720,52.91060060867827,57.53091520172053,NaN,NaN,-26.796398499618338,13.630039244461846,-0.08018337062087205,0.19511833076111174,0.2753017013819838,3377178,2951118,76.51382688637892,81.50738277020433,NaN,NaN,13.806952540537065,19.48670639148413
2005-01-07T09:30:00-05:00,29.85001,29.89999,29.71001,29.75,173600,835400,52.50429582857337,57.113073705488844,NaN,NaN,-19.344093325415024,-10.786098364915985,-0.08085117137683501,0.17423773716094004,0.25508890853777505,3203578,2864138,74.69437561009866,81.30170460258584,NaN,NaN,12.552908477860377,18.496163832395023
2005-01-10T09:30:00-05:00,29.85001,30.05,29.74001,30.00999,456100,789820,57.11460438728279,57.46778407040566,NaN,NaN,17.191467160027397,-18.699745332104293,-0.06276502642042173,0.1766326255122479,0.23939765193266963,3659678,2989618,75.59595127221392,81.579956705135,NaN,NaN,12.771471884471685,17.678350696977404
2005-01-11T09:30:00-05:00,29.8,29.94,29.74001,29.8,570800,785265,52.66780503197715,57.22532228220871,NaN,NaN,-19.89560749844867,-19.35120475649683,-0.06372234867010296,0.15974471609504093,0.22346706476514389,3088878,3091798,76.3353212415626,81.6988543276269,NaN,NaN,11.650305985945279,16.817201452544243
2005-01-12T09:30:00-05:00,29.95,30.03999,29.75999,30,318000,777190,56.16811552094571,57.029749077937986,NaN,NaN,12.021592177526378,-7.3646079971856455,-0.05025572270613887,0.1606474113824703,0.21090313408860917,3406878,3347238,78.11998053607172,81.7351008994038,NaN,NaN,11.72502654582996,16.0897478944422
2005-01-13T09:30:00-05:00,30,30.03999,29.50999,29.55,247500,759320,47.63273904256393,56.116985113987525,NaN,NaN,-57.52642278301286,-13.510612853864558,-0.06982132674949532,0.12362647565174001,0.19344780240123532,3159378,3303678,77.05282694403991,81.51595470685935,NaN,NaN,9.039504276815899,15.0825702347813
2005-01-14T09:30:00-05:00,29.64999,29.73,29.5,29.67,275800,741935,49.822493021434,55.41664618874182,NaN,NaN,-71.49603989581634,-23.941002167944823,-0.07253002602308894,0.10278526987237413,0.17531529589546307,3435178,3349998,77.40626891674225,81.14171581958291,NaN,NaN,7.534084596378901,14.004215143580957
2005-01-18T09:30:00-05:00,29.7,29.91,29.58,29.91,255500,703760,53.968283187133466,54.73060896502529,NaN,NaN,-22.60755965100369,-31.900807530151035,-0.05670771920893353,0.10443064688429615,0.16113836609322968,3690678,3356198,77.4563209295484,80.51492632321329,NaN,NaN,7.554231744406954,13.082788943698956
2005-01-19T09:30:00-05:00,30,30,29.71001,29.72,549300,631080,50.41687033028578,53.73896391738036,NaN,NaN,-26.788705608760683,-33.279427152213444,-0.05741231533126831,0.08937297192914428,0.1467852872604126,3141378,3366698,77.54703810588259,79.82637768345585,NaN,NaN,6.465320006366411,12.137436238365735
2005-01-20T09:30:00-05:00,29.64999,29.81,29.53999,29.57001,509700,472400,47.7457662255784,52.53837232119552,NaN,NaN,-94.22528201094445,-54.528801989907606,-0.06575451893255485,0.06459213859471902,0.13034665752727387,2631678,3211658,72.88332272343044,78.76404121116411,NaN,NaN,4.741449055083242,11.08086664075395
2005-01-21T09:30:00-05:00,29.7,29.7,29.37,29.37,351000,444350,44.36995604681619,51.29933051133668,NaN,NaN,-139.32669608277348,-70.88885664985973,-0.08148880653372789,0.028485649360113996,0.10997445589384189,2280678,3035918,67.89861942274386,77.33854553797937,NaN,NaN,2.241095278269968,9.818042160399095
2005-01-24T09:30:00-05:00,29.5,29.5,29.12,29.12,341200,429265,40.51408770010953,50.319669385568325,NaN,NaN,-186.89133243130482,-93.96791515695743,-0.1040360073624959,-0.020070553309277983,0.08396545405321791,1939478,2736778,60.33439102188002,75.3669939076483,NaN,NaN,-1.1162211565183344,8.256004543696605
2005-01-25T09:30:00-05:00,29.39999,29.50999,29.284,29.32001,174900,409855,44.657768116742744,49.954458970902444,NaN,NaN,-132.50105542488134,-115.94661431173297,-0.10071574268964743,-0.041929224308841384,0.05878651838080605,2114378,2421518,53.562034400353156,73.13906178571725,NaN,NaN,-2.6724295778529963,6.6947996691895195
2005-01-26T09:30:00-05:00,29.41,29.64,29.39999,29.5,498200,414115,48.15753502038486,49.90363714775044,NaN,NaN,-82.20546174058819,-127.02996553809847,-0.08240438361643479,-0.044218961139737445,0.038185422476697345,2612578,2315758,51.474635640199025,71.20535097508181,NaN,NaN,-2.9047887770018344,5.323429891162183
2005-01-27T09:30:00-05:00,29.60001,29.60001,29.35001,29.44,741800,436200,47.0885170149333,49.48777403391151,NaN,NaN,-90.47335100787608,-126.2795793374848,-0.07078459358018548,-0.050295319498534496,0.020489274081650976,1870778,2163578,48.54309040783825,69.20744122661463,NaN,NaN,-3.4071188300104907,4.0762086452803725
2005-01-28T09:30:00-05:00,29.5,29.53999,29.09,29.2,506200,448110,42.97873252054263,48.807376654766465,NaN,NaN,-140.38562404505635,-126.49136492994134,-0.07529392505371946,-0.07362813223549836,0.0016657928182211082,1364578,1980358,45.20505955475165,67.10106150837557,NaN,NaN,-5.076180392068188,2.768724497087721
2005-01-31T09:30:00-05:00,29.34,29.39999,29.11,29.25,690500,470820,44.07385419050605,47.87589449785384,NaN,NaN,-135.47712486943902,-116.20852341756817,-0.07099755821670489,-0.08708115495266,-0.01608359673595511,2055078,2003478,45.71235800742573,64.96651913231925,NaN,NaN,-6.127537073003008,1.4978299870747598
2005-02-01T09:30:00-05:00,29.35001,29.53,29.25,29.53,806900,480855,49.87905763634468,47.676698255308665,NaN,NaN,-62.64328061008719,-102.23696845460935,-0.046567292447796976,-0.07429271229570134,-0.02772541984790436,2861978,2152998,49.00074592968676,63.014049467185274,NaN,NaN,-5.322447096975247,0.5235046893533303
2005-02-02T09:30:00-05:00,29.39999,29.67999,29.39999,29.64999,327600,474520,52.17030445780524,47.39114032222721,NaN,NaN,-9.137102327617654,-87.62329657201526,-0.02090349189591041,-0.05385478471779237,-0.03295129282188196,3189578,2268398,51.445326245096695,61.10871701782991,NaN,NaN,-3.9692724807773963,-0.11832062066534488
2005-02-03T09:30:00-05:00,29.7,29.7,29.47,29.56,407700,472490,50.31265500020788,47.58256289063035,NaN,NaN,-8.476386310583912,-71.22390363255683,-0.00916466423400314,-0.04440712311438588,-0.03524245888038274,2781878,2450618,55.10477410967235,59.54099895823223,NaN,NaN,-3.3663424204029826,-0.5823237349135788
2005-02-04T09:30:00-05:00,29.60001,29.85001,29.49001,29.83,369100,428570,55.43944132009847,47.9837734833921,NaN,NaN,46.129747105623615,-33.920829402420836,0.016225500369822,-0.014960583418105244,-0.031186083787927244,3150978,2807898,61.26853514770006,58.388303689014926,NaN,NaN,-1.2886483157827062,-0.6832272464663113
2005-02-07T09:30:00-05:00,29.60001,29.94,29.60001,29.85001,671100,453445,55.80340350192383,48.11485350587712,NaN,NaN,72.96165299842026,7.7669261711510185,0.0328503051395057,0.009876797636454882,-0.02297350750305082,3822078,3161298,66.2102048481398,57.58500968320002,NaN,NaN,0.5059400995596969,-0.5133461970340244
2005-02-08T09:30:00-05:00,29.83,29.98,29.83,29.92,435100,452395,57.12259461850517,48.5938338121785,NaN,NaN,116.09485540630574,43.51455337442961,0.04622438678843056,0.03480697598248739,-0.011417410805943178,4257178,3440338,69.51730779053129,57.01145751781777,NaN,NaN,2.384138866176024,-0.09941975943258896
2005-02-09T09:30:00-05:00,29.95,30.06,29.59,29.60001,485000,448105,49.80340462708069,48.74080798371438,NaN,NaN,59.17993995847119,57.17796183164738,0.031866919439243725,0.02841623849311148,-0.0034506809461322466,3772178,3556858,70.80238218552121,56.86281890796711,NaN,NaN,1.963641673961351,0.195303302480831
2005-02-10T09:30:00-05:00,29.7,29.75,29.50999,29.64999,313900,447900,50.86244655166721,49.20455730548945,NaN,NaN,23.679968719005274,63.609232837565216,0.024418486517659172,0.027072427200941718,0.0026539406832825465,4086078,3817698,73.49604952070561,57.262635343535806,NaN,NaN,1.9189039944546877,0.44153197276281053
2005-02-11T09:30:00-05:00,29.67,30.13,29.67,29.95,281600,449605,56.75972341085298,50.364959856256846,NaN,NaN,127.05920857816228,79.79512513207297,0.037591637500965426,0.04964348755948933,0.012051850058523904,4367678,4061038,75.74425098337036,58.363339626499396,NaN,NaN,3.66084760726924,0.901434206263729
2005-02-14T09:30:00-05:00,30,30.02,29.86,29.97,415000,456565,57.129108576096534,51.25576988906783,NaN,NaN,122.53835564654324,89.71046566169755,0.04504417643578809,0.06835707060325902,0.023312894167470927,4782678,4253158,77.37594534739976,60.064333265574156,NaN,NaN,5.180316511320497,1.5127031069861245
2005-02-15T09:30:00-05:00,30.05,30.10001,29.89,29.96001,214100,454495,56.867785669239694,51.877930649700325,NaN,NaN,125.0280041815117,91.49709541673874,0.046503915632101586,0.08144278870759791,0.03493887307549633,4568578,4315438,77.89507271311422,61.95150734221095,NaN,NaN,6.358178578021406,2.2049138885625936
2005-02-16T09:30:00-05:00,30,30,29.75999,29.92,215700,437815,55.76754099587756,52.497860934053485,NaN,NaN,91.07684591537038,97.87647660811858,0.042109164013061515,0.08757532809182322,0.04546616407876171,4352878,4431578,78.86881758229976,64.11763071181534,NaN,NaN,7.061523770803518,2.898715300311297
2005-02-17T09:30:00-05:00,29.88,29.99001,29.78999,29.88,198500,422255,54.62958111652428,53.33006440519504,NaN,NaN,79.8364387805702,109.10777062043158,0.03417997398718934,0.08819113156274838,0.05401115757555904,4154378,4445238,78.98606869179949,66.5305599358902,NaN,NaN,7.366631380756135,3.536989026089131
2005-02-18T09:30:00-05:00,29.99001,30.38,29.81,30.33,947900,452100,63.62274629370388,54.72641384113774,NaN,NaN,145.8248777356606,112.86090445193122,0.05564387988092662,0.1235660074267173,0.06792212754579069,5102278,4592158,80.25507437671564,68.9978968194109,NaN,NaN,10.38168562970203,4.514802826605259
2005-02-22T09:30:00-05:00,30.39999,30.41,29.91,29.97,3282500,599165,54.34259922852391,55.04523824057911,NaN,NaN,113.36150058909713,111.02553344044202,0.04258650409365247,0.12115525766285629,0.07856875356920381,1819778,3999578,63.57818224696234,70.03914227064487,NaN,NaN,10.144787894866186,5.319086407785392
2005-02-23T09:30:00-05:00,30.10001,30.22,29.97,30.11,482400,614540,56.971127380812476,55.38815416365106,NaN,NaN,104.78522479043386,106.97697756222644,0.04038811560378146,0.12905389807393064,0.08866578247014918,2302178,3546298,54.285689563779634,70.24202536483651,NaN,NaN,10.782634015190425,6.099593208843253
2005-02-24T09:30:00-05:00,30.22,30.38,29.92,30.34,410100,610135,60.94872752243151,56.14787362952417,NaN,NaN,123.65389689619269,113.49238775839089,0.05076271019413431,0.15211917021281707,0.10135646001868276,2712278,3218178,48.73306079259847,69.78690298504553,NaN,NaN,12.611375441281094,7.029847813477231
2005-02-25T09:30:00-05:00,30.3,30.63,30.3,30.59,448200,595455,64.76177359276129,56.81375450614295,NaN,NaN,181.95695398193965,133.9164907986648,0.06963460839996212,0.1883997205186354,0.11876511211867329,3160478,3019398,45.68442127577732,68.67375199419389,NaN,NaN,15.430406017481591,8.229927556906425
2005-02-28T09:30:00-05:00,30.7,30.7,30.02,30.13,779800,609135,54.26290683472268,56.70371902991429,NaN,NaN,115.22202434683483,127.79592012089965,0.04737390313484294,0.17798249103722696,0.13060858790238403,2380678,2475078,38.569187623878044,66.69939362103234,NaN,NaN,14.263389669959995,9.091850715914077
2005-03-01T09:30:00-05:00,30.3,30.44,30.28999,30.37,390800,594150,58.08121091924832,56.77219162282453,NaN,NaN,128.25582214521955,130.77478443212414,0.04506341180351908,0.18693785265678287,0.14187444085326378,2771478,2665418,41.972600243392954,64.73191451052246,NaN,NaN,14.639004794372257,9.88430129855096
2005-03-02T09:30:00-05:00,30.39999,30.62,30.25999,30.39999,758500,591730,58.54691359336528,57.39672797755913,NaN,NaN,129.30041955889033,135.67782338581543,0.04187339163028195,0.1942161803911162,0.15234278876083426,3529978,2910978,46.119931533198994,62.96888232107087,NaN,NaN,15.080070356339384,10.626554021092163
2005-03-03T09:30:00-05:00,30.60001,30.62,30.28,30.37,312900,590995,57.85472644604653,57.89617654144337,NaN,NaN,113.1283351955645,133.5727110456898,0.03437610454155274,0.19531291943777518,0.16093681489622244,3217078,3011938,47.772691055062324,61.13149957352492,NaN,NaN,15.217784255824427,11.282444054625344
2005-03-04T09:30:00-05:00,30.52,30.67,30.5,30.64999,333800,587300,62.33226901845847,58.29421551341518,NaN,NaN,147.2279610458688,126.62691245847562,0.04427597550806761,0.21628178428130695,0.17200580877323934,3550878,3090018,49.073754089411366,59.22646408109927,NaN,NaN,16.750267525108473,12.063561693265791
2005-03-07T09:30:00-05:00,30.60001,30.88,30.60001,30.72,438600,590775,63.37991003691757,58.740701332045255,NaN,NaN,157.69813003881458,135.12213359687158,0.051059733557098946,0.23583047571961302,0.18477074216251407,3989478,3411778,54.14341939258147,57.5669979414694,NaN,NaN,18.310746081185595,12.956016605825763
2005-03-08T09:30:00-05:00,30.8,30.8,30.48199,30.52,731200,593780,58.384245074646095,58.84901986100285,NaN,NaN,109.46735619419606,131.3644404066669,0.03818697372352836,0.23250445931692454,0.19431748559339618,3258278,3509138,55.584233596589144,55.97336657600332,NaN,NaN,18.125273251666883,13.694481840945922
2005-03-09T09:30:00-05:00,30.63,30.63,30.28,30.33,386000,591325,54.02747495582688,58.724729429570665,NaN,NaN,55.34024420232138,116.57240533535307,0.014219841433508629,0.21209228738528196,0.19787244595177333,2872278,3377598,53.154234364587,54.13661063188098,NaN,NaN,16.62584630263721,14.113248192616107
2005-03-10T09:30:00-05:00,30.5,30.55,30.34,30.44,577600,595955,56.07128821201541,58.827708507820034,NaN,NaN,56.69077966559934,105.28489422936002,0.0036682573502391236,0.20245776763957224,0.19878951028933312,3449878,3424158,53.92210309199362,52.346327374751986,NaN,NaN,15.988503194262762,14.381141764279915
2005-03-11T09:30:00-05:00,30.55,30.55,30.10001,30.2,428700,601695,50.76810040824271,57.909519516001374,NaN,NaN,5.61817094777688,76.96293620974164,-0.020266132582778346,0.1734568445608602,0.19372297714363854,3021178,3318218,51.83994891486483,50.31667555604837,NaN,NaN,13.795854616391928,14.297529314581631
2005-03-14T09:30:00-05:00,30.25,30.27,30,30.25,1195700,647400,51.79108081166489,57.727268200511446,NaN,NaN,-34.31597597063655,38.56011500785142,-0.03278061256169623,0.15274721144151826,0.1855278240032145,4216878,3363698,52.684631345857866,49.538564777398044,NaN,NaN,12.309514467487181,14.013527193568137
2005-03-15T09:30:00-05:00,30.32001,30.34,29.88,29.89999,688100,661055,44.77699887485781,56.85625902151468,NaN,NaN,-81.55253301017207,0.3561371669777998,-0.06293427455895109,0.10685998080452563,0.16979425536347673,3528778,3417798,53.724361019837325,49.49846988140216,NaN,NaN,8.737534660161817,13.259813974510092
2005-03-16T09:30:00-05:00,29.83,29.91,29.56,29.61,2245900,762645,39.9495765582337,55.35631966692913,NaN,NaN,-178.91527268437616,-46.49496621036171,-0.0985893532047464,0.04655756385754373,0.14514691706229013,1282878,3099918,47.165966056266825,49.38653454309275,NaN,NaN,4.049884325862694,11.944109738989034
2005-03-17T09:30:00-05:00,29.72,29.75,29.52,29.71001,196200,761670,42.26148694216793,53.74915633474389,NaN,NaN,-175.16154449777235,-92.86543104303604,-0.11070992111844372,0.006759515664235494,0.11746943678267921,1479078,2705758,40.55500241673973,49.02014748173293,NaN,NaN,0.9628282871233752,10.37535524586537
2005-03-18T09:30:00-05:00,29.58,29.74001,29.39999,29.58,1285200,816005,40.100166733332514,52.737532041787446,NaN,NaN,-182.1857707809308,-130.42621938877758,-0.12187114217296798,-0.034869490933530756,0.08700165123943722,193878,2140298,33.336186400737205,48.64636168008001,NaN,NaN,-2.2653755788317684,8.569536556622921
2005-03-21T09:30:00-05:00,29.66,29.67999,29.33,29.46001,667400,801980,38.16043939812351,51.31461979027853,NaN,NaN,-169.0980977375191,-157.3826437421541,-0.13092875157461836,-0.07665928822883572,0.054269463345782636,-473522,1202218,25.292769221534755,47.454945178518706,NaN,NaN,-5.542881785331321,6.553476793486601
2005-03-22T09:30:00-05:00,29.64999,29.71001,29.41,29.47,233000,649505,38.42748566698031,49.87751779553675,NaN,NaN,-136.53103308737897,-168.37834375759547,-0.12959961004213189,-0.10773004920688223,0.021869560835249657,-240522,448358,20.923618904142927,45.655208562157554,NaN,NaN,-8.120722202365528,4.457162651222012
2005-03-23T09:30:00-05:00,29.47,29.85001,29.47,29.78999,274800,639125,46.41031629123138,49.060059927335665,NaN,NaN,-88.7355080051364,-150.34239082174753,-0.10175107053429762,-0.10531927733262236,-0.0035682067983247474,34278,198638,19.709072528609255,43.65066438169662,NaN,NaN,-8.068913794563267,2.667723158966972
2005-03-24T09:30:00-05:00,29.95,30.02,29.77,29.8,612300,649235,46.64336185423651,47.93942370131981,NaN,NaN,-51.76298880266727,-125.6626796827265,-0.07829084075848908,-0.10143175774643609,-0.023140916987947017,646578,32138,18.920475837714292,41.49685879228969,NaN,NaN,-7.959975536472749,1.1494804881898693
2005-03-28T09:30:00-05:00,29.95,29.95,29.78,29.78,243500,639000,46.21096227897551,46.71307029003824,NaN,NaN,-50.45195615485394,-99.31591675751113,-0.06054766994653672,-0.09882550442111793,-0.038277834474581204,403078,73978,19.789005756918044,39.04297210402802,NaN,NaN,-7.987792597193821,-0.15584423829351501
2005-03-29T09:30:00-05:00,29.8,29.89999,29.66,29.67999,525700,626295,44.0137023731616,45.68660295421792,NaN,NaN,-60.66835802959162,-77.62996881592562,-0.05228601816315833,-0.10363535717852912,-0.05134933901537079,-122622,144158,21.31162233922258,36.59492844278754,NaN,NaN,-8.607172913860813,-1.3631769062317005
2005-03-30T09:30:00-05:00,29.72,30.14999,29.72,30.14999,304700,621990,54.87320677972348,45.747012370210534,NaN,NaN,-10.482742960620405,-52.42031079057391,-0.013904411293088767,-0.06872985313173174,-0.05482544183864298,182078,228678,23.202377263729858,34.455510078440604,NaN,NaN,-5.806890434325924,-1.997993124530875
2005-03-31T09:30:00-05:00,30.14999,30.14999,29.82001,29.86,898600,628995,48.60837764046446,45.21394732938547,NaN,NaN,-18.74713630795809,-38.42263645113827,-0.00712532270878382,-0.06373209522462275,-0.056606772515838934,-716522,78518,22.18257479738186,32.18840091453976,NaN,NaN,-5.36742225116806,-2.4793401426219015
2005-04-01T09:30:00-05:00,30.03999,30.10001,29.53999,29.60001,344700,630585,43.78218525972278,44.71495339020547,NaN,NaN,-52.67666651778247,-38.60537199416132,-0.018578681402689298,-0.07983012426920055,-0.061251442866511255,-1061222,-263042,20.026400342924404,29.916004587972587,NaN,NaN,-6.581247405674619,-3.0653268944865752
2005-04-04T09:30:00-04:00,29.75,29.89999,29.60001,29.75,215800,624685,47.04852893362097,44.37619968463091,NaN,NaN,-46.980309711973426,-37.91104270558522,-0.01465307045590028,-0.07956778093638661,-0.06491471048048633,-845422,-512742,18.60280488517887,27.481588412209806,NaN,NaN,-6.520017742047711,-3.5588541584238804
2005-04-05T09:30:00-04:00,30.03,30.36,30.02,30.35001,456800,625595,57.649142299110956,45.295638500648984,NaN,NaN,75.23957777643184,-10.729455544380523,0.02745861609173479,-0.030591440365817846,-0.05805005645755264,-388622,-565942,18.304257284843786,24.951581002567412,NaN,NaN,-2.6040911421544912,-3.4224594418139676
2005-04-06T09:30:00-04:00,30.41,30.58,30.35001,30.37,1220800,650075,57.95116937393103,46.58146655891308,NaN,NaN,128.31683754036047,17.030460555815655,0.05421892573577024,0.009723600712160163,-0.044495325023610074,832178,-435922,21.615189425117364,23.126525528913874,NaN,NaN,0.46858832045241705,-2.8665954757759127
2005-04-07T09:30:00-04:00,30.35001,30.69,30.16,30.67999,1007500,681150,62.42612953621724,48.02179817277375,NaN,NaN,143.66640956918064,49.513169731243394,0.08833801669937234,0.06592719585060536,-0.022410820848766985,1839678,75318,33.09667093262473,22.593787565762803,NaN,NaN,4.617555018394739,-1.7974311194658195
2005-04-08T09:30:00-04:00,30.64999,30.71001,30.39999,30.46001,552900,679915,57.730830540477164,49.28113130185551,NaN,NaN,143.6314613964576,88.77479531409142,0.09125808260091438,0.09166178240237599,0.00040369980146161277,1286778,544918,41.56379573955362,23.181473947106834,NaN,NaN,6.459621238843422,-0.6178522111359279
2005-04-11T09:30:00-04:00,30.60001,30.60001,30.39999,30.42999,417200,679340,57.09966600894625,50.63393320262857,NaN,NaN,124.76386226301737,123.12362970908957,0.08638493712831376,0.1083848712118538,0.021999934083540052,869578,887918,46.85441091528358,24.721591210946038,NaN,NaN,7.703502955006951,0.570912812598769
2005-04-12T09:30:00-04:00,30.34,30.64999,30.14999,30.63,373100,638210,60.22016111119416,52.19055287721527,NaN,NaN,113.86512304148796,130.84873876210082,0.09136570454654587,0.1362070647667224,0.04484136022017653,1242678,1214178,51.364945117854,26.89597165478254,NaN,NaN,9.73175257639855,1.8796042074273092
2005-04-13T09:30:00-04:00,30.67999,30.89999,30.5,30.77,420600,624835,62.287940001268,53.3246688565036,NaN,NaN,141.62752977112822,133.51087720825436,0.09822367467660251,0.16762095356592965,0.06939727888932715,1663278,1380398,53.52889826491454,29.311673493090062,NaN,NaN,12.050715480135253,3.332620103528444
2005-04-14T09:30:00-04:00,30.85001,30.85001,30.59,30.64999,1148000,569940,59.435847413411004,54.23841782501607,NaN,NaN,116.80161135785282,128.13791756598877,0.08908163058007046,0.18074931711441522,0.09166768653434476,515278,1115518,49.731545270411154,31.512464166854123,NaN,NaN,13.123826196542362,4.731363831101861
2005-04-15T09:30:00-04:00,30.75,31.10001,30.75,30.8,4044300,762345,61.7909679854539,55.35127537547881,NaN,NaN,129.3745851320544,125.28654231310813,0.08741933912474335,0.20094186044027396,0.1135225213155306,4559578,1770078,57.71458422283877,34.22143405727703,NaN,NaN,14.731411870879032,6.1599421224986
2005-04-18T09:30:00-04:00,31.39999,31.39999,30.37,30.59,1153800,755775,56.817739035043665,56.2658494227561,NaN,NaN,101.29684555510107,120.59313897152488,0.06735810827495092,0.19772015665921927,0.13036204838426835,3405778,2277318,62.66294632891052,37.17510005654045,NaN,NaN,14.623661490241584,7.369044889319026
2005-04-19T09:30:00-04:00,30.64,30.73,30.37,30.57001,926900,768750,56.35278818524193,56.371533808864555,NaN,NaN,57.68327304294462,109.3567689718162,0.04878889307824652,0.1913481647320765,0.14255927165382998,2478878,2524558,64.82372666500666,40.14805358520308,NaN,NaN,14.403004345544614,8.373896240208396
2005-04-20T09:30:00-04:00,30.64999,30.64999,30.12,30.19,433100,778755,48.266713613618975,56.34712923551846,NaN,NaN,11.135949238156146,83.2584528652218,0.009041438248596378,0.15386106946457545,0.14481963121597907,2045778,2601058,65.48923356551883,43.241386354355726,NaN,NaN,11.686560768794536,8.847134030006416
2005-04-21T09:30:00-04:00,30.55,30.63,30.33299,30.60001,429500,786490,55.659483503935476,57.19550768153364,NaN,NaN,44.453870015172306,68.7889045966857,0.008500123871989729,0.15544478605596623,0.1469446621839765,2475278,2993058,68.75164826570017,46.72176120598257,NaN,NaN,11.655598949776483,9.248343304259283
2005-04-22T09:30:00-04:00,30.73,30.73,30.35001,30.49001,795200,795635,53.45255380497765,57.65293802948769,NaN,NaN,40.608614569746486,51.03571048422412,-0.0006443614872296277,0.14613921032493948,0.1467835718121691,1680078,2417158,59.80665946630939,49.66489367606332,NaN,NaN,10.928209220980294,9.488324149505141
2005-04-25T09:30:00-04:00,30.60001,30.7,30.42999,30.56,344500,800685,54.68376109017304,57.441125085992134,NaN,NaN,44.952635975312894,39.76686856826648,-0.003213768773446757,0.14276636084536065,0.1459801296188074,2024578,2140918,56.04030372979641,52.36032556498851,NaN,NaN,10.712786216227496,9.66324730189405
2005-04-26T09:30:00-04:00,30.60001,30.67999,30.37,30.37,345200,791660,50.75868591512164,56.92737626750575,NaN,NaN,17.901546168819447,31.81052319344145,-0.018111981515088915,0.12334015272494625,0.14145213424003517,1679378,1981018,53.92342564010009,54.66805672320156,NaN,NaN,9.332310557556184,9.615970624131498
2005-04-27T09:30:00-04:00,30.33,30.67,30.19,30.60001,339100,793380,54.97223265325171,56.394955061579644,NaN,NaN,16.940208361677453,32.971375018145714,-0.013111323887885329,0.12506297938017852,0.13817430326806385,2018478,1975558,53.84862611216687,56.150339236026,NaN,NaN,9.437006182571013,9.590404275337143
2005-04-28T09:30:00-04:00,30.42999,30.64999,30.39999,30.45,347100,765805,51.85569202956254,55.975302310800025,NaN,NaN,14.874093496252643,27.055419714361783,-0.020122687799384364,0.1130209435188334,0.13314363131821777,1671378,1814778,51.57968045141583,56.86575957258758,NaN,NaN,8.575259028481009,9.445383525786266
2005-04-29T09:30:00-04:00,30.58,30.89999,30.41,30.89999,429800,770060,59.30821745494169,56.133055985513984,NaN,NaN,106.55948757681891,40.245594315776266,0.004041055148651607,0.13819495025403228,0.13415389510538067,2101178,1898998,52.703878664062124,57.28357869750033,NaN,NaN,10.237069910418148,9.558481580733677
2005-05-02T09:30:00-04:00,31.05,31.05,30.87,31.03,502700,784405,61.17801602299538,56.20147419349979,NaN,NaN,198.57602015044654,70.970271150803,0.02604846132955227,0.16671447176732102,0.14066601043776875,2603878,2014858,54.27661732347668,57.49155528361624,NaN,NaN,12.183327249288055,9.933459533384303
2005-05-03T09:30:00-04:00,31.05,31.14999,30.88,31.00999,2936300,908380,60.71558886381352,56.08916339796732,NaN,NaN,172.8871776610583,101.96739744925077,0.03591735716411831,0.18556270689291665,0.14964534972879834,-332422,1612498,48.27314406978331,57.11614426967829,NaN,NaN,13.592186146026966,10.456134763761826
2005-05-04T09:30:00-04:00,31.14999,31.33,31,31.32001,532500,873965,65.11517477211237,56.49482963787457,NaN,NaN,204.5517935985131,139.4897144966179,0.058640606715836485,0.22294610812359394,0.16430550140775746,200078,1248818,43.580951601943575,56.676816150502034,NaN,NaN,16.22068904024074,11.279642517544527
2005-05-05T09:30:00-04:00,31.39999,31.39999,31.17999,31.31,637000,855440,64.86258552405023,56.71423089063145,NaN,NaN,189.14582100414836,174.34405999819703,0.06767230510131075,0.2488958827843959,0.18122357768308514,-436922,827158,38.8641551713691,55.33035693253992,NaN,NaN,18.24449462473989,12.274621390001007
2005-05-06T09:30:00-04:00,31.55,31.55,31.17,31.17,1699700,912780,61.282076569591204,57.033112143099125,NaN,NaN,158.30486057023293,184.69313459687982,0.05919905091998273,0.25522239133306357,0.19602334041308084,-2136622,-20402,31.4871992586573,53.10351785609326,NaN,NaN,18.922923161102215,13.224378785872608
2005-05-09T09:30:00-04:00,31.25999,31.42,31.09,31.39999,1036100,943725,64.726847768771,57.631259256208345,NaN,NaN,135.3714752827375,172.05222562333802,0.06367518440676201,0.27561732092153335,0.21194213651477134,-1100522,-761282,26.713818951546756,50.38138159084612,NaN,NaN,20.544623295001475,14.270128001462446
2005-05-10T09:30:00-04:00,31.45,31.45,31.14,31.2,550000,952570,59.74877393987423,58.45140642236943,NaN,NaN,108.64088494643545,159.20296708041346,0.04844764918499339,0.2725016979960131,0.2240540488110197,-1650522,-1024902,25.24719010520964,47.50694991510976,NaN,NaN,20.441824712312794,15.151798960155352
2005-05-11T09:30:00-04:00,31.14999,31.37,31.02,31.33,573500,960215,61.80514506168996,58.89038224792332,NaN,NaN,90.45719689558236,136.3840477398273,0.042617257589583485,0.27732562079799905,0.23470836320841557,-1077022,-1280322,23.87925276292458,44.30177880776864,NaN,NaN,20.96301531235342,15.981972724755076
2005-05-12T09:30:00-04:00,31.39999,31.5,31.22,31.28999,716500,938640,60.77602846549001,59.41348758081707,NaN,NaN,98.78298511109963,118.31148056121756,0.03203567795167725,0.27475296064801213,0.24271728269633489,-1793522,-1551642,22.485555741012263,41.63598568453314,NaN,NaN,21.097531649958682,16.71276685692702
2005-05-13T09:30:00-04:00,31.28,31.35001,30.85001,31.08,1828500,827850,55.5481630463902,59.47523057768973,NaN,NaN,44.16100902603518,95.482710252378,0.008110107298462121,0.2528549168194125,0.2447448095209504,-3622022,-1848722,21.037709685321786,39.13580039564209,NaN,NaN,19.687901879488226,17.137786145864332
2005-05-16T09:30:00-04:00,31.2,31.45,31.14999,31.45,653500,802835,61.78560928911808,60.26286796154661,NaN,NaN,86.17672113025228,85.64375942188094,0.014070121804256652,0.26233246177627123,0.24826233997201458,-2968522,-2222322,19.35028548254958,36.66629038438848,NaN,NaN,20.334124806301997,17.594405954498285
2005-05-17T09:30:00-04:00,31.45,31.46001,31.14,31.42999,1428900,827935,61.28476848892132,60.713763378380165,NaN,NaN,78.0266183037757,79.52090609334898,0.013527812579659515,0.265172105696589,0.2516442931169295,-4397422,-2771702,17.169405640219665,34.04634606496368,NaN,NaN,20.702964652007175,18.038485768428128
2005-05-18T09:30:00-04:00,31.56,31.63,31.42,31.5,628700,837715,62.43219751350415,61.46922805580456,NaN,NaN,105.86725889282015,82.60291849279653,0.014652435033073008,0.26995983690827074,0.25530740187519774,-3768722,-3310042,15.344405444057301,31.45811213586664,NaN,NaN,21.337487140509875,18.50977167872552
2005-05-19T09:30:00-04:00,31.55,31.60001,31.32001,31.49001,490300,840755,62.14914356797813,61.67215134959288,NaN,NaN,89.59773914854247,80.76586930028512,0.011624094432336918,0.2698375199156189,0.25821342548328197,-4259022,-3803142,13.888218203998818,28.685564960147833,NaN,NaN,21.781302353017345,18.97713320362435
2005-05-20T09:30:00-04:00,30.57001,31.55,30.57001,31.47,311400,816565,61.54722827907408,61.6985236535985,NaN,NaN,26.52934705391543,77.23953690586116,0.005485561009935247,0.265070376745701,0.25958481573576575,-4570422,-3992822,13.362880627204149,25.76315519612836,NaN,NaN,21.99435889902409,19.408165445824313
2005-05-23T09:30:00-04:00,31.46001,31.63,31.36,31.53,508600,824770,62.71334623198327,61.84122060846777,NaN,NaN,95.12937614409434,79.03006790862956,0.002812959625701439,0.26310101526789254,0.2602880556421911,-4061822,-4211482,12.76351120180452,23.22675284841559,NaN,NaN,22.47897593016799,19.84685265787341
2005-05-24T09:30:00-04:00,31.60001,31.64999,31.5,31.57001,540200,834520,63.50806542878472,61.72642708394437,NaN,NaN,112.04340622512044,85.8334254928985,0.0011707130738538019,0.26175144698450836,0.26058073391065456,-3521622,-4036322,16.01330109894367,21.25763495534417,NaN,NaN,23.096170509854264,20.311040922442103
2005-05-25T09:30:00-04:00,31.60001,31.60001,31.25,31.37,748700,855000,56.97101152686862,61.16274322700283,NaN,NaN,61.71109193021013,77.0021921003765,-0.015059821713837018,0.24175595676835826,0.2568157784821953,-4270322,-4136642,15.653626842838833,19.59974007473486,NaN,NaN,21.908294428793347,20.539219994777994
2005-05-26T09:30:00-04:00,31.39999,31.55,31.39999,31.49001,821000,878695,59.6544939725326,61.04648732721294,NaN,NaN,88.01844888751769,76.68633404817155,-0.0191259283374845,0.23290836806033965,0.25203429639782415,-3449322,-3974702,18.82327674644533,18.695174181005438,NaN,NaN,21.587865778429375,20.68902653529962
2005-05-27T09:30:00-04:00,31.64999,31.64999,31.34,31.39,791100,896760,56.492651315644814,60.45833043770392,NaN,NaN,74.88869233064597,86.35820310351764,-0.02935202555761726,0.21534426445080257,0.24469629000841983,-4240422,-3908702,20.140459912474043,18.225648535357386,NaN,NaN,20.444282703626158,20.65406313077484
2005-05-31T09:30:00-04:00,31.5,31.5,31.22,31.28999,1182500,930750,53.442186701415515,60.00785992067115,NaN,NaN,1.0127836924534945,67.53488461318948,-0.04283611742711996,0.19115114322451987,0.23398726065163983,-5422922,-4180922,18.786454915939288,17.764167450409506,NaN,NaN,18.610737145710097,20.362159418622735
2005-06-01T09:30:00-04:00,31.34,31.47,31.2,31.37,591900,813530,55.5118691642219,59.558340213709144,NaN,NaN,-3.5027112124236153,44.42566112568073,-0.04606931083087179,0.17640062211305008,0.22246993294392187,-4831022,-4442802,17.56318802786646,17.313019969333926,NaN,NaN,17.587110139361943,19.965723807299764
2005-06-02T09:30:00-04:00,31.35001,31.45,31.25,31.37,408900,807350,55.5118691642219,59.18232883504714,NaN,NaN,-1.4770885108276532,31.788025037473183,-0.04770900033217518,0.1628336825287029,0.21054268286087807,-4831022,-4554942,17.051183482797526,16.924850522318586,NaN,NaN,16.73438758006705,19.50410434626652
2005-06-03T09:30:00-04:00,31.39999,31.39999,31.19,31.25999,1874900,869245,51.837265608278656,58.91726473232489,NaN,NaN,-54.865915021750745,3.2111522556194885,-0.05517579995989674,0.14157293291100714,0.1967487328709039,-6705922,-5206262,14.421520654042382,16.452265591512916,NaN,NaN,14.996505903010378,18.86016171151564
2005-06-06T09:30:00-04:00,31.24001,31.36,31.17999,31.27,537100,811115,52.147660390799516,58.22883981101642,NaN,NaN,-63.03182675801357,-24.37295156211242,-0.05811834452976469,0.12410080220869801,0.1822191467384627,-6168822,-5591942,13.130199536174075,16.007973738200377,NaN,NaN,13.609462448899546,18.1100618168562
2005-06-07T09:30:00-04:00,31.36,31.55,31.25,31.28,453800,782000,52.47716102886367,57.599724992440876,NaN,NaN,0.37146688559154734,-24.501214923484806,-0.057939095343401165,0.10979527755921126,0.16773437290261242,-5715022,-5650362,12.941175925014818,15.70595732997146,NaN,NaN,12.508508123636819,17.309839860682
2005-06-08T09:30:00-04:00,31.37,31.37,31.00999,31.06,494900,779245,45.1168055440248,56.36291128033521,NaN,NaN,-145.72379650205676,-52.94543198141143,-0.07035857060827289,0.07978615964227131,0.1501447302505442,-6209922,-5926142,12.058646505008781,15.471260262896566,NaN,NaN,9.424830300367235,16.183409923494178
2005-06-09T09:30:00-04:00,31.07001,31.28999,31.02,31.19,373200,769230,49.614019285433166,55.46754526015343,NaN,NaN,-124.71693969591891,-77.59340221842969,-0.0675270891150565,0.06573586885672356,0.13326295797178006,-5836722,-6127282,11.4455719219457,15.296785528464202,NaN,NaN,7.933905035354191,15.004909225188467
2005-06-10T09:30:00-04:00,31.14999,31.28,31.00999,31.12,966000,781705,47.36347740437273,54.45442019767476,NaN,NaN,-124.36351285450026,-91.49292178497959,-0.06789465919279372,0.048394633980787916,0.11628929317358164,-6802722,-6146642,11.385570556070945,15.155549094811832,NaN,NaN,6.0277808660420975,13.722462316738985
2005-06-13T09:30:00-04:00,31.2,31.37,31.03999,31.25,363300,708445,51.741578596224606,53.67072250940628,NaN,NaN,-82.81472729174064,-95.449501891725,-0.057329785762904456,0.04462706096995106,0.10195684673285552,-6439422,-6200762,11.208675757711887,15.044489420233788,NaN,NaN,5.590294393486626,12.560724041988648
2005-06-14T09:30:00-04:00,31.35001,31.60001,31.25,31.52,1039800,727760,59.311265005937514,53.37095105063148,NaN,NaN,65.42182818259836,-82.43942963232364,-0.031401357549036196,0.06270514979656028,0.09410650734559647,-5399622,-6137682,12.907159134139022,14.822622137033457,NaN,NaN,7.573390332604876,11.848247797790966
2005-06-15T09:30:00-04:00,31.64999,31.64999,31.25999,31.39999,885800,700605,55.16899677205483,53.242235711001925,NaN,NaN,48.51905175096784,-43.590859981718715,-0.0220205189095877,0.06658085870861186,0.08860137761819956,-6285422,-6152782,12.843822495884154,14.621921826536692,NaN,NaN,7.956103231141968,11.292227145412538
2005-06-16T09:30:00-04:00,31.55,31.61,31.45,31.60001,979500,718145,60.16279062279348,53.27854261459199,NaN,NaN,115.99894404582605,4.552316766630272,-0.0030293917294237638,0.08481463795641986,0.08784402968584362,-5305922,-6046622,15.96593370680354,14.417825895133706,NaN,NaN,9.922961034435424,11.096617700987236
2005-06-17T09:30:00-04:00,31.39999,31.77,31.39999,31.66,536300,720445,61.546294777765155,53.639517147600586,NaN,NaN,136.3766061215925,56.700340561848826,0.012060248989843078,0.10291934092314747,0.0908590919333044,-4769622,-5640002,26.784413739473024,14.892394025633633,NaN,NaN,11.952159898859398,11.218838014968973
2005-06-20T09:30:00-04:00,31.75,31.75,31.5,31.62,484500,729100,60.04881214888398,54.11141896527691,NaN,NaN,127.1587074466552,98.69502750952799,0.017504873726707032,0.11274018409168818,0.09523531036498115,-5254122,-5402942,32.259762778002965,15.854773158638181,NaN,NaN,13.15810549569225,11.49587622650087
2005-06-21T09:30:00-04:00,31.7,31.7,31.50999,31.57001,400800,723710,58.144762322862135,54.29948276232263,NaN,NaN,105.05841286147063,106.62234444530245,0.01594133746565614,0.11516198219705132,0.09922064473139518,-5654922,-5454002,31.7097057835703,16.865238712617025,NaN,NaN,13.60863858180346,11.797699420115526
2005-06-22T09:30:00-04:00,31.5,31.66,31.42999,31.46001,507300,722065,54.08113460199969,54.19728743644963,NaN,NaN,68.25851960506469,110.5702380161218,0.006201153277792373,0.10697208632863564,0.10077093305084327,-6162222,-5429362,32.30952265199984,17.955120081845763,NaN,NaN,12.810695160825574,11.942413097359818
2005-06-23T09:30:00-04:00,31.5,31.53,31.24001,31.25,561800,712720,47.286413114232516,53.87222654401776,NaN,NaN,-23.481330471441197,82.67418311266836,-0.014549937113674166,0.08258351165875055,0.09713344877242472,-6724022,-5712982,29.137127627016667,19.00623486562964,NaN,NaN,9.971202040422963,11.660811517797411
2005-06-24T09:30:00-04:00,31.35001,31.35001,31.10001,31.10001,358200,689580,43.119568676526875,53.22736285014115,NaN,NaN,-96.27719649484821,36.14342258938022,-0.037251145316815684,0.05056951712640512,0.0878206624432208,-7082222,-6175502,24.85172522041961,19.84348670021861,NaN,NaN,6.205280509659565,10.88144994520629
2005-06-27T09:30:00-04:00,31.10001,31.11,30.89999,30.97,869400,693495,39.84228322598078,52.32487157850665,NaN,NaN,-169.5882647881562,-23.205971857582064,-0.05862463491989148,0.014539868793356447,0.07316450371324792,-7951622,-6715002,20.976299904415242,20.417424127318636,NaN,NaN,1.972253120782818,9.608707541717223
2005-06-28T09:30:00-04:00,31.2,31.28999,31.09,31.28,529200,660830,49.66590712548403,52.64980740575374,NaN,NaN,-55.60756510441835,-55.33916745075985,-0.04983147492568254,0.01087516005614475,0.06070663498182729,-7422422,-7068502,18.896908512305245,20.9058714135541,NaN,NaN,1.4508446926254561,8.443298563275542
2005-06-29T09:30:00-04:00,31.39999,31.39999,31.2,31.24001,403100,651390,48.564187952960886,52.5748194534343,NaN,NaN,-25.942010131914664,-74.17927339815573,-0.04481336351424014,0.004689930589027114,0.04950329410326725,-7825522,-7401162,17.171790578649592,21.31488703189009,NaN,NaN,0.6862491615382067,7.3351486487416375
2005-06-30T09:30:00-04:00,31.27,31.3,30.97,31.03,625900,662240,43.1507392069806,52.273909582192005,NaN,NaN,-95.35852531769197,-88.55471236740588,-0.053172577593872186,-0.016962427889072984,0.0362101497047992,-8451422,-7746642,15.580942308334784,21.61455644276608,NaN,NaN,-1.7738248863053079,6.033866715163502
2005-07-01T09:30:00-04:00,31.10001,31.10001,30.87,30.99001,483900,592690,42.18640726658161,51.59139734436037,NaN,NaN,-126.44063889693115,-94.58740084782247,-0.058506766052126756,-0.036923307860359245,0.02158345819176751,-8935322,-8117262,14.074549280444671,21.819261694389848,NaN,NaN,-4.030708885232097,4.5960702008212735
2005-07-05T09:30:00-04:00,30.88,31.19,30.85001,31.10001,443900,588030,45.776082562938335,50.62459859843185,NaN,NaN,-93.08830315430104,-79.28740852105143,-0.05195993993152734,-0.04336646672264166,0.008593473208885675,-8491422,-8225222,13.660242821121386,21.873053386317164,NaN,NaN,-4.80061554747329,3.253686522493479
2005-07-06T09:30:00-04:00,30.99001,31.14999,30.85001,30.89999,1084000,619540,40.81363526257013,49.59921563346866,NaN,NaN,-109.50456352569536,-90.06680820530683,-0.05797584441300143,-0.06387633230736611,-0.005900487894364684,-9575422,-8655822,12.126920143162977,21.821846075408505,NaN,NaN,-7.064095255667373,1.7797176970419286
2005-07-07T09:30:00-04:00,30.60001,30.92999,30.60001,30.89,387400,614165,40.57703547667461,48.200233123031595,NaN,NaN,-147.76963087892725,-114.43233235470935,-0.05929105206959148,-0.08001430298135404,-0.020723250911762553,-9962822,-9083282,10.82760718279033,21.454822752264704,NaN,NaN,-8.928921731956613,0.2499120643278514
2005-07-08T09:30:00-04:00,30.96001,31.34,30.85001,31.25999,667900,628900,51.73636866292579,47.49952411482878,NaN,NaN,-35.9050386473202,-102.541635020635,-0.033206436466888235,-0.062231296495372845,-0.02902486002848461,-9294922,-9251982,10.356021635921778,20.281366173439615,NaN,NaN,-6.919453201234011,-0.7742829736095573
2005-07-11T09:30:00-04:00,31.35001,31.45,31.19,31.36,545800,607890,54.23802044274507,47.08446756439029,NaN,NaN,20.47497835101006,-73.15851157104674,-0.008469349812541067,-0.03961154729416094,-0.031142197481619876,-8749122,-9214742,11.274681693385887,18.782431810252685,NaN,NaN,-4.468173718564948,-1.3019816514603275
2005-07-12T09:30:00-04:00,31.39999,31.42,31.23,31.34,583600,618905,53.63924937681927,46.762645211101514,NaN,NaN,17.592656865884287,-51.02231956700968,0.006486918371071522,-0.02303354951778047,-0.029520467888851994,-9332722,-9383002,10.73918014007306,17.284537121431452,NaN,NaN,-2.7136751840575197,-1.5036521561170693
2005-07-13T09:30:00-04:00,31.31,31.35001,31.09,31.17,728300,603330,48.716202082064534,46.37943574539185,NaN,NaN,-20.313419355159528,-33.18409073290251,0.004941292159137682,-0.02334385268992989,-0.02828514484906757,-10061022,-9480122,10.431213446824913,15.721800749633243,NaN,NaN,-2.7302744974699027,-1.678883919167474
2005-07-14T09:30:00-04:00,31.35001,31.45,31.25,31.36,1118500,614965,53.81789594798535,46.84597023351706,NaN,NaN,32.27262461206945,2.824360365296826,0.016096719284962053,-0.008164245742865006,-0.02426096502782706,-8942522,-9276062,15.889032617196293,14.775508248931787,NaN,NaN,-1.1037291485806895,-1.5967189519407905
2005-07-15T09:30:00-04:00,31.39999,31.55,31.36,31.50999,454500,588715,57.41905954333049,47.867362438288744,NaN,NaN,76.49885191084117,25.3051384769291,0.03203810225056333,0.015786662785377104,-0.01625143946518623,-8488022,-9114682,20.038750169455383,14.431724316720059,NaN,NaN,1.4274515201510958,-1.1646945987848067
2005-07-18T09:30:00-04:00,31.55,31.55,31.3,31.32001,626500,593225,51.89883198125994,48.72854449223725,NaN,NaN,54.24151938435689,32.05844668359847,0.02837444349646583,0.019216614905396057,-0.009157828591069773,-9114522,-9187762,19.56794138276952,14.33112727945965,NaN,NaN,1.8045080240519287,-0.7405227955224161
2005-07-19T09:30:00-04:00,31.45,31.47,31.22,31.33,322600,585130,52.15929183606245,48.906643400135714,NaN,NaN,44.399235084625964,37.41976232734681,0.025311726588357557,0.02248182964437717,-0.0028298969439803845,-8791922,-9079602,22.471226355926987,14.586435696861201,NaN,NaN,2.181109168723656,-0.3231468006301201
2005-07-20T09:30:00-04:00,31.5,31.81,31.5,31.78,1248400,627510,62.11158786572683,49.874314822476144,NaN,NaN,181.0274688680544,77.68793997198956,0.0508089407798435,0.06068127903082399,0.009872338250980488,-7543522,-8576102,34.35095161105346,15.813518627747195,NaN,NaN,6.01934499190698,0.5829234554466085
2005-07-21T09:30:00-04:00,31.75,31.78,31.37,31.44,709000,637595,53.12002751054362,50.586406844159214,NaN,NaN,114.8909021475513,94.21159547908594,0.04233860211709142,0.06279559089734477,0.020456988780253343,-8252522,-8438102,37.19165023030845,17.357140622173883,NaN,NaN,6.075773087767007,1.3676162600638082
2005-07-22T09:30:00-04:00,31.5,31.5,31.28999,31.39999,838700,651440,52.163054339268875,51.2990244922083,NaN,NaN,60.638677375716156,91.03956057206094,0.03207025126564826,0.060544802862313674,0.028474551596665412,-9091222,-8558742,35.7358629373968,18.90437731195618,NaN,NaN,5.7941048864566875,1.9999717781199338
2005-07-25T09:30:00-04:00,31.5,31.5,31.2,31.21001,506400,658850,47.76300887136411,51.440947799953,NaN,NaN,22.4587773072301,84.68301215663557,0.01156939549438002,0.042936295964640436,0.03136690047026042,-9597622,-8655362,34.568792487329034,20.397845145256724,NaN,NaN,4.0731729880187055,2.296143379534044
2005-07-26T09:30:00-04:00,31.39999,31.47,31.22,31.36,431400,636950,51.25867981427434,52.187022410789005,NaN,NaN,35.81213116959094,82.96559137362857,0.007399414787027991,0.040616168954045406,0.033216754167017415,-9166222,-8730222,33.65179425763121,21.935336153433024,NaN,NaN,3.8183500173961353,2.5136014706572
2005-07-27T09:30:00-04:00,31.5,31.69,31.39,31.64999,424600,631720,57.21947140517287,53.375767834253175,NaN,NaN,115.71469302909667,69.90303620583703,0.02260151563878647,0.06146864871550051,0.038867133076714036,-8741622,-8969842,30.832437276890815,23.364252588725915,NaN,NaN,5.639988261122253,2.96022815500935
2005-07-28T09:30:00-04:00,31.7,32,31.69,31.95,1833600,703245,62.3494480636428,54.133844934304385,NaN,NaN,197.48080024169568,86.4210158246659,0.0497366822307724,0.10103798586517954,0.05130130363440714,-6908022,-8700942,37.191760321985946,25.28109106630193,NaN,NaN,9.003836433811188,3.8236007662667553
2005-07-29T09:30:00-04:00,32,32,31.73,31.73,958000,719850,56.95584280479158,54.327975103022005,NaN,NaN,157.77871852479484,105.84902405448165,0.049629609654024756,0.11333831570193809,0.06370870604791333,-7866022,-8455902,42.38978981365885,27.503598789178568,NaN,NaN,9.884324813984447,4.689418487369283
2005-08-01T09:30:00-04:00,31.95,32.03999,31.82001,31.89,1020700,746690,59.68715874247155,54.75996862914002,NaN,NaN,162.73026254437642,133.9033211019109,0.0565908385888621,0.13444725428399096,0.07785641569512886,-6845322,-7905442,52.00007253164877,30.450805388576835,NaN,NaN,11.519786461367291,5.665185340797569
2005-08-02T09:30:00-04:00,31.97,32.07001,31.85001,32.00999,725300,760760,61.65235609362916,55.68397962996607,NaN,NaN,152.16887404551792,157.17466967709632,0.06493509615411726,0.15902528588777542,0.09409018973365817,-6120022,-7296202,59.96105483832819,33.98865120225564,NaN,NaN,13.478052744454208,6.7813092556056604
2005-08-03T09:30:00-04:00,31.95,32.09,31.89999,32.09,723600,742740,62.949363151666155,56.33622728737184,NaN,NaN,143.4319805611838,162.71812718351373,0.07100935908281475,0.1828518885871766,0.11184252950436185,-5396422,-6627162,66.52664385064699,37.6056234332164,NaN,NaN,15.460038425020803,8.021127708379252
2005-08-04T09:30:00-04:00,32.00999,32.06,31.77,31.77,694700,758105,54.945073380773046,56.15951399004631,NaN,NaN,89.3653771611372,141.09504256740203,0.04965286205368753,0.17390860707147127,0.12425574501778373,-6091122,-6463782,67.9104833821118,41.02503294840614,NaN,NaN,14.58969129005126,8.959493934332396
2005-08-05T09:30:00-04:00,31.74001,31.74001,31.52,31.55,598300,754625,50.21744371551916,56.03941482820768,NaN,NaN,10.37904620707088,111.61510810385725,0.018491436434732444,0.1473700405611993,0.12887860412646684,-6689422,-6228462,69.84423820490028,44.61619700712977,NaN,NaN,12.29643316720371,9.436199539028298
2005-08-08T09:30:00-04:00,31.64999,31.67,31.36,31.42999,416500,748160,47.801241352857915,55.72812550797879,NaN,NaN,-27.328369076523124,73.60338177967733,-0.010843012567474691,0.11532483841712349,0.12616785098459818,-7105922,-6280582,68.85454385492467,47.929291114201035,NaN,NaN,9.658942879248187,9.468020016202567
2005-08-09T09:30:00-04:00,31.5,31.78999,31.5,31.78999,394400,738700,54.82327905586902,55.207532021560375,NaN,NaN,30.99974857380258,49.369556685334246,-0.006836757503070001,0.11762190410576068,0.12445866160883068,-6711522,-6398882,66.54949419597425,50.229187013123955,NaN,NaN,9.665765565213283,9.496269380346956
2005-08-10T09:30:00-04:00,31.81,32.03999,31.69,31.74001,1930400,798805,53.74234785718893,55.251983474892185,NaN,NaN,63.71429854437553,33.426020281972605,-0.008291593015670257,0.11409417033924285,0.12238576335491311,-8641922,-7047982,55.5590754771963,51.54114595933022,NaN,NaN,9.329046943007116,9.472380460726978
2005-08-11T09:30:00-04:00,31.75,31.99001,31.72,31.92999,432600,764510,57.19699443942549,55.61155062490337,NaN,NaN,73.7693839117597,30.306821632097105,0.002239515405926734,0.12518515761232152,0.12294564220639478,-8209322,-7471622,49.780762541921405,52.54435307393913,NaN,NaN,10.134480223685054,9.56696614114956
2005-08-12T09:30:00-04:00,31.89999,31.91,31.64999,31.75,204700,752020,53.14726390008178,55.99614026981178,NaN,NaN,34.206941701955216,35.07240073107398,-0.0038846022173732314,0.11808988943467824,0.12197449165205147,-8414022,-7816542,45.62057504418332,53.33376611371443,NaN,NaN,9.541003200640558,9.563257149648274
2005-08-15T09:30:00-04:00,31.71001,31.85001,31.63,31.77,521500,746770,53.54089558988363,56.1591556823553,NaN,NaN,23.188778350678774,45.17583021651435,-0.0073551081137062935,0.11278060650991861,0.1201357146236249,-7892522,-7973862,43.82174047176486,54.06019084329541,NaN,NaN,9.183142871049508,9.50895510984845
2005-08-16T09:30:00-04:00,31.83,31.85001,31.53999,31.55,431800,752230,48.69456581373489,55.550233854395444,NaN,NaN,-20.622228447875713,34.851434812178695,-0.024279927471814733,0.08978580528385649,0.11406573275567122,-8324322,-8296422,40.31199205782256,54.73730189907625,NaN,NaN,7.4017719412672145,9.207928942908275
2005-08-17T09:30:00-04:00,31.55,31.75,31.50999,31.61,403500,709985,50.023210748146404,54.66978833185999,NaN,NaN,-27.68336023796327,16.571903055710933,-0.03082613812173199,0.07553306010350624,0.10635919822523823,-7920822,-8152202,42.528348985837575,55.118486803637076,NaN,NaN,6.325568842008268,8.796163214208274
2005-08-18T09:30:00-04:00,31.62,31.77,31.53,31.62,376000,693335,50.254434992952454,54.19111634530005,NaN,NaN,-24.188343878997475,-3.0196425024405023,-0.033644698907667636,0.06430332459065369,0.09794802349832132,-7544822,-8019302,44.57090773308206,55.274280940738734,NaN,NaN,5.510926001116222,8.326843612337981
2005-08-19T09:30:00-04:00,31.85001,31.85001,31.39,31.39999,1864600,744630,45.28974641458007,53.16272975045066,NaN,NaN,-66.80342893316964,-23.221716629465476,-0.0485811051418545,0.0372216420710032,0.0858027472128577,-9409422,-8218382,42.15406875266057,54.57099495652529,NaN,NaN,3.3462131874679972,7.615324980213698
2005-08-22T09:30:00-04:00,31.41,31.56,31.25999,31.39999,1283000,783460,45.28974641458007,51.993971916232866,NaN,NaN,-130.71358383119852,-54.00218906584094,-0.056178500663197684,0.015579621383860598,0.07175812204705828,-9409422,-8521762,38.70933291509176,53.053014819151265,NaN,NaN,1.5793363176680237,6.753040885564316
2005-08-23T09:30:00-04:00,31.39,31.39,31.16,31.2,2521400,887960,41.01780525824761,50.42743206670298,NaN,NaN,-189.15049615209293,-87.70784260668438,-0.07141253084280988,-0.01750754150645406,0.05390498933635581,-11930822,-9243062,32.01147694343685,50.58764575435054,NaN,NaN,-1.2260259434019627,5.6131741957119905
2005-08-24T09:30:00-04:00,31.3,31.44,31.09,31.10001,1617800,947620,39.03529340633855,49.29101921138623,NaN,NaN,-177.67359100590002,-117.70588876027173,-0.08408993266013998,-0.05120742648881915,0.03288250617132082,-13548622,-10368622,24.800193209976,47.508339313483695,NaN,NaN,-4.182913097112693,4.213733153879893
2005-08-25T09:30:00-04:00,31.14999,31.25,31.11,31.14,966900,904285,40.27852886950707,48.58109672238536,NaN,NaN,-165.173062834596,-145.90283255139144,-0.08537546445106309,-0.07383682439250805,0.011538640058555042,-12581722,-11376002,20.37599099850202,43.97489308445524,NaN,NaN,-6.3198963802405626,2.708928934719828
2005-08-26T09:30:00-04:00,31.2,31.2,30.9879,31.03,718300,892300,37.98395995534324,47.879862336848596,NaN,NaN,-165.21998799661574,-165.58614436408067,-0.08883082654875926,-0.09949989312739405,-0.010669066578634777,-13300022,-12154122,17.74302365343955,40.324070212920596,NaN,NaN,-8.811097581825141,1.0632108609276896
2005-08-29T09:30:00-04:00,30.99001,31.37,30.75,31.34,1147400,898635,47.12564546008222,47.33003136572097,NaN,NaN,-121.22328030531577,-163.6880836589041,-0.06645917822951145,-0.09374303936552408,-0.027283861136012638,-12152622,-12702762,16.157653771022538,36.72465303970976,NaN,NaN,-8.432355388290626,-0.29329860324635537
2005-08-30T09:30:00-04:00,31.25,31.33,31.11,31.3,394700,882105,46.1797208402416,46.789843721653305,NaN,NaN,-84.0167902745937,-142.66134248340427,-0.05125712733124053,-0.0913552703000633,-0.04009814296882277,-12547322,-12826062,15.815635034127027,33.885835865204804,NaN,NaN,-8.391284763715436,-1.4501537690276525
2005-08-31T09:30:00-04:00,31.28,31.64999,31.19,31.62,691500,880500,54.11472605897086,46.56968169447798,NaN,NaN,-9.07018485493131,-108.94066125321054,-0.018254573490745135,-0.06291635983225419,-0.04466178634150905,-11855822,-12487502,20.774624224152745,31.81396884250704,NaN,NaN,-5.8648928424817175,-2.08083077952109
2005-09-01T09:30:00-04:00,31.7,32,31.56,31.63,485300,870030,54.341273816033585,46.65496811704596,NaN,NaN,69.91820660406493,-61.92240736547832,0.004433072416468217,-0.03912044582092378,-0.043553518237391994,-11370522,-12245262,24.21449983039291,30.284963470093437,NaN,NaN,-3.776566226148793,-2.3230787004679048
2005-09-02T09:30:00-04:00,31.73,31.78,31.58,31.61,817000,880965,53.76948325774253,46.671295807607315,NaN,NaN,45.32469413182485,-19.813470939790204,0.017541576192775334,-0.02162654799642283,-0.03916812418919816,-12187522,-12022762,27.335333036606485,29.1073629390107,NaN,NaN,-2.224279340135425,-2.3089645061346933
2005-09-06T09:30:00-04:00,31.61,32.13,31.61,32.11,641900,892235,63.97501551510692,47.76275650056247,NaN,NaN,120.86043840049295,28.603272801371553,0.05710409421626717,0.0322119935811358,-0.02489210063513137,-11545622,-11901362,29.052045926708246,28.30308107250253,NaN,NaN,2.7287886544009465,-1.5892854832010306
2005-09-07T09:30:00-04:00,32.2,32.39999,32.17999,32.32001,1813800,963205,67.24564000165725,48.99293001867029,NaN,NaN,192.04320751462498,83.8152723592153,0.09253690718954576,0.09077903335180082,-0.0017578738377449325,-9731822,-11338262,36.540968558839765,27.87541104200269,NaN,NaN,8.010042356254052,-0.2179529347074476
2005-09-08T09:30:00-04:00,32.34,32.45,32.14999,32.3,1928900,963130,66.62497715119885,50.162254458545036,NaN,NaN,171.3942114694464,119.90815162409083,0.10863360507591303,0.13403413250714635,0.025400527431233322,-11660722,-11299242,37.03693438613974,27.337270088649664,NaN,NaN,11.968658285209196,1.5229915252806443
2005-09-09T09:30:00-04:00,32.35001,32.49001,32.28,32.41,665000,974750,68.35415097312777,51.809711927012735,NaN,NaN,173.23808905928414,140.5721281151347,0.11981632163951367,0.1751709294806254,0.055354607841111736,-10995722,-11224282,38.038790147795275,27.043321616873566,NaN,NaN,15.796883482879972,3.5621189477948336
2005-09-12T09:30:00-04:00,32.5,32.52,32.27,32.3,566500,992840,64.74182683141473,53.19914624250093,NaN,NaN,145.70809733597991,160.6488087559657,0.11301986175556515,0.19662943503556818,0.08360957328000303,-11562222,-11099222,39.76094043289995,27.118436439574158,NaN,NaN,17.92687350910496,5.614226742267709
2005-09-13T09:30:00-04:00,32.3,32.3,31.91,31.96001,776400,1005585,55.05698775570528,54.20194499231933,NaN,NaN,76.13764293543764,151.70424966295462,0.08037566441862015,0.18407915380327822,0.10370348938465807,-12338622,-11257822,38.306831855905784,27.568104647607658,NaN,NaN,16.74021610683528,7.20365379434879
2005-09-14T09:30:00-04:00,32,32.10001,31.84,31.87,1536900,1060840,52.804871771540626,55.18548630411948,NaN,NaN,48.098458832236915,122.91529992647699,0.049011815970012,0.16496825934717307,0.11595644337716107,-13875522,-12086562,31.76887780669003,28.06586783308723,NaN,NaN,15.065495871747455,8.326774091120027
2005-09-15T09:30:00-04:00,31.85001,32.03999,31.82001,31.85001,650600,1073195,52.29327142067938,56.043682200631785,NaN,NaN,38.3307028415455,96.30259820089682,0.024451415139958743,0.1465207123021095,0.12206929716215076,-14526122,-12659642,28.186375370593524,28.623752431093767,NaN,NaN,13.570375295324272,9.07585997743492
2005-09-16T09:30:00-04:00,31.89999,32.02,31.75999,32,509400,1079865,55.75693898210374,57.31318070254325,NaN,NaN,38.94639890548424,69.44426017013684,0.01623477704278989,0.1423627684656381,0.12612799142284822,-14016722,-13263842,24.987106501046952,29.14118692020858,NaN,NaN,13.306816036451153,9.680282271580095
2005-09-19T09:30:00-04:00,31.95,31.99001,31.67999,31.77,688400,1021055,49.787578768880316,57.50331879602883,NaN,NaN,17.071416552377574,43.716924013416374,-0.005594253873212621,0.11913517408133245,0.12472942795454507,-14705122,-13892422,22.168051486496324,29.570501042742418,NaN,NaN,11.219763010893134,9.900208091481957
2005-09-20T09:30:00-04:00,31.77,31.87,31.47,31.53,614800,987645,44.440947190554475,57.37912067819404,NaN,NaN,-18.790631873147834,24.731269051699275,-0.03543638122280873,0.08043395142603416,0.11587033264884289,-15319922,-14488682,19.87717324728432,29.8606109151108,NaN,NaN,7.671957761810498,9.581886615814605
2005-09-21T09:30:00-04:00,31.34,31.59,31.34,31.38,1017400,912445,41.44524482258533,56.47415773273793,NaN,NaN,-55.79188139960338,3.953201005331219,-0.06291223212562333,0.03723004249181372,0.10014227461743705,-16337322,-14981042,18.204239307277078,29.67701199247682,NaN,NaN,3.7497927232418147,8.748730345447063
2005-09-22T09:30:00-04:00,31.46001,31.55,31.25999,31.45,1725700,917840,43.363913803607275,55.6900605889932,NaN,NaN,-62.68932718143886,-16.250804999265654,-0.07328134154523472,0.008540597685893658,0.08182193923112838,-14611622,-14998142,18.147113840271004,29.24362727889669,NaN,NaN,1.1374420182093754,7.661403441555965
2005-09-23T09:30:00-04:00,31.25,31.62,31.24001,31.47,1253300,932160,43.9292295049402,54.98718532093589,NaN,NaN,-63.38889188556999,-36.71786315747649,-0.0754085711561219,-0.012438774714023992,0.06296979644209791,-13358322,-14866462,20.22318535683955,28.73561673034191,NaN,NaN,-0.813878478096224,6.450648881605653
2005-09-26T09:30:00-04:00,31.66,31.66,31.226,31.42,463300,919410,42.77959658672829,53.47322682605171,NaN,NaN,-72.55370667894358,-54.64288780374072,-0.07655380236335037,-0.03272245651209005,0.04383134585126032,-13821622,-14689762,23.043860058174133,28.306460596875183,NaN,NaN,-2.7641536308742807,5.134248522679948
2005-09-27T09:30:00-04:00,31.42,31.44,31.2,31.24001,472200,885650,38.83920821804997,51.44419598436547,NaN,NaN,-106.39081790852475,-72.16292501081611,-0.08514467760217942,-0.06259950115146395,0.022545176450715465,-14293822,-14484542,26.30293481374953,27.575172472225884,NaN,NaN,-5.646410130455921,3.5941544293748233
2005-09-28T09:30:00-04:00,31.35001,31.42,31.16,31.25999,470500,889440,39.505326375230744,49.50707807179632,NaN,NaN,-110.2283296459204,-83.05021466007952,-0.08499631022127904,-0.08370021132588334,0.001296098895395701,-13823322,-13981742,33.71020201550745,27.337548731466434,NaN,NaN,-7.835277523272234,1.9613784361395294
2005-09-29T09:30:00-04:00,31.12,31.37,31.00999,31.33,700100,889870,41.89342747607943,47.61702639343572,NaN,NaN,-112.35012278216784,-92.98237378022532,-0.075991611032095,-0.09369341489472305,-0.01770180386262805,-13123222,-13684062,37.70245299039259,27.313524648794818,NaN,NaN,-9.05435830476788,0.3877017588670424
2005-09-30T09:30:00-04:00,31.35001,31.38,31.23,31.35001,957000,913455,42.590996637228876,46.03482423670817,NaN,NaN,-85.20740485400398,-97.34607637391211,-0.06492565879001168,-0.09885887735014265,-0.03393321856013097,-12166222,-13445642,40.77873758791064,27.386224445581295,NaN,NaN,-9.892569756994316,-1.08090845768458
2005-10-03T09:30:00-04:00,31.45,31.49001,31.25,31.38,1464100,945810,43.682239585175445,45.22234222452746,NaN,NaN,-69.08874662649566,-96.65308436342252,-0.052362969575232045,-0.09938693052917102,-0.04702396095393898,-10702122,-12821742,48.01319080283951,28.079535798933705,NaN,NaN,-10.325645532067531,-2.4015851825964303
2005-10-04T09:30:00-04:00,30.42999,31.78999,30.42999,31.50999,618700,944650,48.27195413772904,44.89856239354092,NaN,NaN,-84.33683302723706,-92.24228738716498,-0.03301959936871193,-0.0882984601648289,-0.05527886079611696,-10083422,-11979662,55.85218458461995,29.799771997357276,NaN,NaN,-9.489629182095257,-3.4141628968105486
2005-10-05T09:30:00-04:00,31.50999,31.52,30.99001,30.99001,1116100,909765,35.72851460140441,43.71536547787842,NaN,NaN,-91.543703886183,-88.5053622352175,-0.0518445497152481,-0.12008454794017709,-0.06823999822492899,-11199522,-11454902,59.909176893730375,32.06568639186705,NaN,NaN,-12.702853161243588,-4.741118648872411
2005-10-06T09:30:00-04:00,31,31.11,30.53999,30.78,2054400,916040,32.10048086149925,42.02561846926381,NaN,NaN,-148.5989141105234,-95.75512050088861,-0.0737061034678331,-0.16037262755972037,-0.08666652409188727,-13253922,-11481042,59.615288685615944,34.53912797647912,NaN,NaN,-16.662490594405376,-6.444171783948549
2005-10-07T09:30:00-04:00,30.95,30.95,30.73,30.75,450900,905335,31.60673669456274,40.726986892526845,NaN,NaN,-144.37838234072254,-107.58931599823231,-0.08466911385149992,-0.19250291640626216,-0.10783380255476224,-13704822,-11788762,56.12485898943128,36.96461422668876,NaN,NaN,-19.93559126012123,-8.371517423401789
2005-10-10T09:30:00-04:00,30.8,30.88,30.57001,30.71001,1276300,940825,30.923926641033958,39.76148542470395,NaN,NaN,-160.78643090690198,-125.92885285431358,-0.0886709896958417,-0.21867253967456435,-0.13000154997872265,-14981122,-12644562,47.751339359385035,38.9556260918388,NaN,NaN,-22.787038370210265,-10.430877558660143
2005-10-11T09:30:00-04:00,30.75,30.89999,30.41,30.45,712400,937625,26.860782419414292,38.71973811019173,NaN,NaN,-171.59417876603817,-143.3803220020738,-0.10193903959732284,-0.2574253494753762,-0.15548630987805337,-15693522,-13766582,39.44266038036587,40.47265616848801,NaN,NaN,-26.659584625448794,-12.749264282487093
2005-10-12T09:30:00-04:00,30.39999,30.8,30.39999,30.52,1276500,924605,29.544728390988567,37.73265343786182,NaN,NaN,-153.9862444093428,-155.86883010670576,-0.09902660785408865,-0.2792695696956642,-0.18024296184157554,-14417022,-14410082,35.61517022101708,41.72037448139844,NaN,NaN,-28.988727184993802,-15.069187554273766
2005-10-13T09:30:00-04:00,30.48,30.78,30.44,30.67,1285300,956340,35.04534810642831,37.098090480825256,NaN,NaN,-122.02021415112593,-150.55309011482626,-0.08079412339277742,-0.2812356160825473,-0.2004414926897699,-13131722,-14385642,35.86970577199392,42.837983082480896,NaN,NaN,-29.269516668690553,-17.09780599919045
2005-10-14T09:30:00-04:00,30.75,30.92999,29.85001,30.81,1362300,998985,39.77164086073692,36.8832365003973,NaN,NaN,-122.64780994780924,-146.2069756362436,-0.05436913413772654,-0.2684029103619281,-0.21403377622420156,-11769422,-13998562,39.9208079285195,44.043479358934135,NaN,NaN,-28.032843870270746,-18.659954266487635
2005-10-17T09:30:00-04:00,30.75,30.85001,30.64999,30.8,895500,1009340,39.5502720244668,36.93402677228422,NaN,NaN,-65.22919829324235,-127.09552911351167,-0.03364321451333044,-0.2560877943658646,-0.22244457985253416,-12664922,-13535322,44.44386426127891,45.33926003375767,NaN,NaN,-27.10469590505084,-19.86634592913952
2005-10-18T09:30:00-04:00,30.85001,30.92999,30.73,30.75999,1029900,1030095,38.623968946963394,36.87107267026512,NaN,NaN,-50.036159019180786,-102.78392516414019,-0.019414336678745175,-0.24671250070096562,-0.22729816402222044,-13694822,-13135582,48.0765489334946,46.365427670756745,NaN,NaN,-26.592859871953824,-20.827276492398706
2005-10-19T09:30:00-04:00,30.62,31.11,30.60001,31.06,1051800,1031815,48.38567540016507,37.33480466484267,NaN,NaN,-20.93938756718595,-76.17455379570883,0.011739951194099846,-0.21262322502959563,-0.22436317622369548,-12643022,-12780782,51.13091155118715,47.32460328224207,NaN,NaN,-23.050012197957027,-21.144810164621322
2005-10-20T09:30:00-04:00,31.14999,31.14999,30.35001,30.42,1750100,1033035,35.43727352542514,36.823824442570974,NaN,NaN,-76.00967733621903,-66.97244643272748,-0.00814640095982927,-0.23454617742348205,-0.22639977646365278,-14393122,-13033062,48.92702249911553,47.90662363304242,NaN,NaN,-24.26081831494127,-21.5899541860956
2005-10-21T09:30:00-04:00,30.7,30.7,30.14999,30.23,1361700,1038455,32.64431058049455,36.03540094223662,NaN,NaN,-127.8946406244962,-68.02181256806487,-0.030245046006892873,-0.26420608397226886,-0.23396103796537598,-15754822,-13830142,42.66918460108298,47.52490890434552,NaN,NaN,-26.24439845606455,-22.254874796091165
2005-10-24T09:30:00-04:00,30.2,30.48,30.17999,30.48,937700,1062175,39.41090897435028,35.40246914485242,NaN,NaN,-114.93609626543838,-77.96319216250409,-0.02442315923292679,-0.2644899870065345,-0.2400668277736077,-14817122,-14260582,39.71507690712127,46.37225835595275,NaN,NaN,-25.38214046869011,-22.701627035033873
2005-10-25T09:30:00-04:00,30.5,30.5,30.0601,30.28999,1216500,1099390,36.41647237608082,35.45160898590073,NaN,NaN,-128.73762774778237,-93.7034859082244,-0.02943116188525524,-0.27685578013017675,-0.2474246182449215,-16033622,-14728342,36.73842750629221,44.717204828278604,NaN,NaN,-25.756005052835885,-23.13796675186273
2005-10-26T09:30:00-04:00,30.21001,30.31,29.91,29.91,1346900,1143210,31.295413612167195,35.394104182377006,NaN,NaN,-167.3877251349582,-122.99315342177886,-0.053021601846619915,-0.3137016205531964,-0.2606800187065765,-17380522,-15675842,31.575834022355806,42.71438663804573,NaN,NaN,-27.97065460857686,-23.82835073139332
2005-10-27T09:30:00-04:00,29.98,30.02,29.78,29.8,2871100,1251760,29.98105464527002,35.277984035998955,NaN,NaN,-181.91903400007178,-144.17502475454938,-0.0696715256576198,-0.34776942577860126,-0.27809790012098146,-20251622,-16847542,26.59821404606329,40.60534057066231,NaN,NaN,-30.142559924143068,-24.730380616071855
2005-10-28T09:30:00-04:00,29.85001,30.25999,29.85001,30.25,1076600,1257740,40.91368605625787,35.99153827994352,NaN,NaN,-115.89330660618624,-141.77475795088742,-0.04520176464888098,-0.33460010593208267,-0.2893983412832017,-19175022,-17531582,24.199778516039586,38.92308622470906,NaN,NaN,-27.982604844024454,-25.19498407720794
2005-10-31T09:30:00-05:00,30.45,30.52,30.31,30.39,1238900,1246480,43.85100646328234,37.205125711648385,NaN,NaN,-43.83827641119693,-127.55519398003912,-0.015922178940710796,-0.30930106495909016,-0.29337888601837936,-17936122,-18155382,22.231057197958663,37.69368599739426,NaN,NaN,-25.262393805376583,-25.20461403837489
2005-11-01T09:30:00-05:00,30.45,30.45,30.2,30.3,1293600,1280225,42.39203159103643,38.122790225937514,NaN,NaN,-58.143717975076186,-113.43641202549789,0.00019545463070053115,-0.2931345677300037,-0.2933300223607042,-19229722,-18794602,20.399648761601114,36.606863036007404,NaN,NaN,-23.61728348392848,-24.97785253059683
2005-11-02T09:30:00-05:00,30.17999,30.39999,30.14,30.3,1188900,1283865,42.39203159103642,38.647553331980944,NaN,NaN,-59.63878830095411,-91.88662465869707,0.012961662870186574,-0.277127943772971,-0.2900896066431576,-19229722,-19164442,19.40365449970089,35.4307165165579,NaN,NaN,-22.33888416145092,-24.600857049290273
2005-11-03T09:30:00-05:00,29.5,30.7,29.5,30.49001,1788800,1270585,46.73155079989483,39.14468975620651,NaN,NaN,-66.2881302399763,-68.76044390667795,0.035054488958889296,-0.24627149544454596,-0.28132598440343526,-17440922,-18602302,25.368149118746757,34.391240887288426,NaN,NaN,-19.90501562962458,-23.930022560766602
2005-11-04T09:30:00-05:00,30.48,30.67999,30.48,30.64999,507900,1273435,50.13727138052233,39.900903995924764,NaN,NaN,44.50853987542553,-36.680074610355604,0.05983857526305292,-0.20652776532461914,-0.26636634058767206,-16933022,-18153902,29.829039200681905,33.3473248115315,NaN,NaN,-16.807824378111164,-22.91256567753011
2005-11-07T09:30:00-05:00,30.8,30.8,30.53,30.71001,508900,1235065,51.39287871386957,40.812968979275205,NaN,NaN,68.46448586029267,-14.219522156057675,0.07849467068173127,-0.16824800223550795,-0.24674267291723923,-16424122,-17851502,32.74848391526629,32.25246302451519,NaN,NaN,-13.908396939485106,-21.626255857809397
2005-11-08T09:30:00-05:00,30.64999,30.71001,30.61,30.64,576000,1228245,49.81706558225473,40.915211135138755,NaN,NaN,58.60486291330441,9.130194021618438,0.08385476072418477,-0.14192422201200827,-0.22577898273619304,-17000122,-17405582,36.91640164885549,31.237140888634354,NaN,NaN,-11.94662883853095,-20.243451997912477
2005-11-09T09:30:00-05:00,30.67,30.75999,30.53999,30.67,328100,1180825,50.51723253974922,41.992351064733334,NaN,NaN,57.299763213352875,32.51790432447983,0.08679147000273285,-0.11728964523277696,-0.2040811152355098,-16672022,-16894042,41.402832836589624,30.699698769882502,NaN,NaN,-10.131072813998689,-18.79882640021051
2005-11-10T09:30:00-05:00,30.69,31.09,30.67999,31.07001,1473800,1190250,58.776233323103455,43.85891697491968,NaN,NaN,127.91396509010517,71.35832339049611,0.11147066248701615,-0.06474278712673964,-0.1762134496137558,-15198222,-16445502,45.090393292022284,30.87264224780674,NaN,NaN,-5.856738179601697,-16.94995665440925
2005-11-11T09:30:00-05:00,31.09,31.13,30.86011,31.08,1651500,1204710,58.960461189008825,45.25531356168101,NaN,NaN,129.07237536594724,88.27109048860046,0.12333966874213123,-0.02203886368609176,-0.145378532428223,-13546722,-15768242,50.18767112412521,31.620684691878456,NaN,NaN,-2.366837014727406,-14.866653848740414
2005-11-14T09:30:00-05:00,31.13,31.13,30.81,30.87,296900,1174780,53.54353203013358,46.47867496554192,NaN,NaN,102.40730204539665,95.05965372562126,0.11223694160549488,-0.005082355421354379,-0.11731929702684926,-13843622,-15252142,53.713848551567324,32.83321476654096,NaN,NaN,-0.8877912983079155,-12.869673484392914
2005-11-15T09:30:00-05:00,30.87,31.2,30.87,31.03,451600,1145865,56.800101742391604,48.30043840341509,NaN,NaN,117.99493938526666,106.93766902001371,0.1106747252376463,0.02102410952020861,-0.08965061571743768,-13392022,-14530522,58.17236162567585,34.73296673820668,NaN,NaN,1.349294981790611,-10.838392274938125
2005-11-16T09:30:00-05:00,31.12,31.14999,30.89,30.97,328200,1109685,55.2363944378685,50.10439124574356,NaN,NaN,108.69509034422728,117.2167344461886,0.10088207402680707,0.03645197681607115,-0.06443009721073592,-13720222,-13940162,61.44440761235203,37.221980564370156,NaN,NaN,2.7485319549019707,-8.897403099246683
2005-11-17T09:30:00-05:00,31.05,31.17,30.92999,31.13,397200,1042040,58.51613141790921,51.3617087715758,NaN,NaN,112.04657534246935,114.04325649666143,0.10025404805130107,0.06088746285339042,-0.039366585197910656,-13323022,-13565122,63.40301210284711,40.02221153485641,NaN,NaN,4.9161713402732286,-6.92403532217241
2005-11-18T09:30:00-05:00,31.3,31.32001,31.13,31.25999,1958300,1071870,61.01523102264561,52.587724811530315,NaN,NaN,128.04894670934715,113.83857076534142,0.10325948643841786,0.08970777285011167,-0.013551713588306192,-11364722,-13128722,65.59326689659909,43.11951222761649,NaN,NaN,7.497300089473502,-4.863844549080136
2005-11-21T09:30:00-05:00,31.35001,31.35001,31.14,31.32001,514500,1050710,62.149070554997756,53.99894188038469,NaN,NaN,119.56238042070535,117.26958644040315,0.1036840886554585,0.11605339723101693,0.012369308575558437,-10850222,-12530042,68.38832888185009,46.54727509334856,NaN,NaN,9.970833097146674,-2.7446048853334495
2005-11-22T09:30:00-05:00,31.3,31.35001,30.36,31.14,684600,1024115,56.812234909722434,55.02895640314798,NaN,NaN,54.12279562334235,104.49515768801828,0.08691434355302696,0.12101223801684213,0.03409789446381518,-11534822,-12158602,70.01582056235904,50.16242981210985,NaN,NaN,10.611868782165713,-0.8365372185478548
2005-11-23T09:30:00-05:00,31.2,31.25999,31.09,31.22,718500,992695,58.51712383154757,55.870783048266034,NaN,NaN,90.65996502292221,100.88813262375729,0.07664174780888464,0.12990007922492097,0.053258331416036336,-10816322,-11577822,72.40783991199126,53.52240772591303,NaN,NaN,11.632759260839684,0.9447908499360793
2005-11-25T09:30:00-05:00,31.23,31.3,31.2,31.25999,115200,854900,59.380336450845,56.53100198186051,NaN,NaN,96.03186731546317,97.68519101835605,0.06825191907975003,0.13857323026572388,0.07032131118597384,-10701122,-11053442,74.39408132330564,56.70562502038615,NaN,NaN,12.720668003289113,2.627059014700798
2005-11-28T09:30:00-05:00,31.28999,31.28999,30.89,30.92999,861200,844130,50.113151058916024,56.439592863649544,NaN,NaN,45.61000690836015,81.19740305815864,0.03771452356045649,0.11746446563654445,0.07974994207608796,-11562322,-11092962,73.96195550364065,59.649444419555756,NaN,NaN,10.935645077007438,3.8139998807446034
2005-11-29T09:30:00-05:00,31.07001,31.16,30.94,30.96001,490700,806720,50.86439832936783,56.5144023455862,NaN,NaN,37.51152156422863,64.78723128686329,0.017785959280112645,0.10198239117622876,0.08419643189611611,-11071622,-11137242,73.4471747685999,62.25878535668035,NaN,NaN,9.696526694325657,4.6543608541133255
2005-11-30T09:30:00-05:00,30.98,31.06,30.75999,30.75999,546400,769360,45.90422438911829,56.18490176339827,NaN,NaN,-10.654151056034593,51.83184195098791,-0.009169660020451761,0.07273435687055141,0.08190401689100317,-11618022,-11153882,73.24087543722287,64.53293125672558,NaN,NaN,7.100274911279603,5.003777147994223
2005-12-01T09:30:00-05:00,31,31.12,30.92999,31.07001,488200,734325,53.47694887480567,55.80638144566272,NaN,NaN,36.33153219489697,40.966155385382855,-0.006546182401641815,0.07372128888895091,0.08026747129059272,-11129822,-11216582,72.41549695367792,66.48472437541527,NaN,NaN,7.133475877599434,5.30801982365211
2005-12-02T09:30:00-05:00,31,31.2,30.92,31.17999,585900,674180,55.83872689326917,55.58340042453846,NaN,NaN,52.549650241379304,32.26971197056609,0.001728207695788811,0.08242773091032873,0.08069952321453992,-10543922,-11185142,72.58234823744303,68.08434416922368,NaN,NaN,7.896600339864348,5.677817040253858
2005-12-05T09:30:00-05:00,31.17999,31.25,31.10001,31.24001,2846000,791085,57.118141902656824,55.838729701147265,NaN,NaN,91.1523033720817,41.3781712633104,0.009918453637514327,0.09309759026143283,0.0831791366239185,-7697922,-10412262,76.36678617656297,69.70241114243767,NaN,NaN,8.902380793327064,6.138469004978602
2005-12-06T09:30:00-05:00,31.28,31.39999,31.14999,31.17999,719200,801600,55.38997490190112,55.73800635539794,NaN,NaN,107.80890971104218,55.43764889267311,0.009943334899773698,0.09560830524863562,0.08566497034886192,-8417122,-9881362,78.55633889478625,71.1584095188027,NaN,NaN,9.23130635428366,6.580302912022182
2005-12-07T09:30:00-05:00,31.14999,31.16,30.96001,31.05,887300,817165,51.73884721699414,55.48818155390692,NaN,NaN,0.10126192694915548,57.588731489269854,0.00036103464457271084,0.08611626365457781,0.0857552290100051,-9304422,-9418642,80.27190697926422,72.50323090215356,NaN,NaN,8.446496756620085,6.846902032679025
2005-12-08T09:30:00-05:00,31.02,31.3,31.02,31.16,338800,817700,54.47365057729007,55.19943292243412,NaN,NaN,52.39698064678498,60.80182117964746,0.0005742374182569898,0.08647302578282634,0.08589878836456935,-8965622,-8985802,81.74328874773468,73.81325066250268,NaN,NaN,8.565706374059555,7.0924455100191
2005-12-09T09:30:00-05:00,31.16,31.28,31.12,31.2,492600,768640,55.46200133801165,54.80277365924598,NaN,NaN,70.37450580591725,64.36679229255506,0.0024473500078536076,0.08895797587438636,0.08651062586653276,-8473022,-8571622,83.04630838660636,75.05989648321747,NaN,NaN,8.94065018457995,7.356474749242079
2005-12-12T09:30:00-05:00,31.3,31.34,30.95,31.21001,753200,723725,55.72106364163247,54.34363030829132,NaN,NaN,43.309703857360276,54.79827238961077,0.003343200511538441,0.0906896265059558,0.08734642599441736,-7719822,-8576002,82.97886093370414,76.1020773440642,NaN,NaN,9.320481203084524,7.637047099790999
2005-12-13T09:30:00-05:00,31.16,31.60001,31.16,31.55,1674000,792580,63.48912305807217,54.820550890316305,NaN,NaN,189.99578869995028,71.2356481873924,0.02463049298509172,0.11813454222578201,0.09350404924069029,-6045822,-8101742,84.4513899565547,77.1331894436496,NaN,NaN,12.037778229947836,8.26572297552769
2005-12-14T09:30:00-05:00,31.63,31.81,31.562,31.64,3037800,921890,65.22814197331802,55.29990932901419,NaN,NaN,266.4120076137771,124.497797324758,0.04157291553690262,0.14547019366181857,0.10389727812491595,-3008022,-6842462,87.53499184269029,78.21370029584239,NaN,NaN,14.832743971596146,9.203868832108899
2005-12-15T09:30:00-05:00,31.86,31.86,31.64999,31.73,569300,933945,66.92470668393817,55.83879291709227,NaN,NaN,245.8969527486733,163.19779174513565,0.05480915492584795,0.17240872178222588,0.11759956685637793,-2438722,-5537082,89.79444222479479,79.31372607452019,NaN,NaN,17.688672186819762,10.415983597067594
2005-12-16T09:30:00-05:00,31.82001,31.85001,31.7,31.7,501300,939150,65.77270878146065,56.95733275441688,NaN,NaN,195.74685681447892,188.272261946848,0.057245524159440564,0.18915647205567865,0.13191094789623808,-2940022,-4430482,91.2434813539083,80.54812077811073,NaN,NaN,19.721834184378977,11.745390823826362
2005-12-19T09:30:00-05:00,31.96001,32.3,31.95,31.98,985000,890485,70.82112561573557,58.382813274871715,NaN,NaN,230.9909347978369,225.8085081349433,0.07243802716111766,0.22245848184763517,0.1500204546865175,-1955022,-3277522,92.44680469263064,81.90523720125579,NaN,NaN,23.174814960779635,13.378165700533973
2005-12-20T09:30:00-05:00,32.06,32.08,31.89999,31.94,408200,885170,69.2497233947475,60.05034891813095,NaN,NaN,157.90966511401143,219.39128341775555,0.07424265823122614,0.24282377747555017,0.16858111924432403,-2363222,-2541002,93.09919240068514,83.32368841293167,NaN,NaN,25.533041018914492,15.114576460302619
2005-12-21T09:30:00-05:00,32.38,32.38,31.98,32.03999,469200,874400,70.9829639686573,61.300778567691786,NaN,NaN,158.54070798339887,197.8170234916799,0.07632604952008129,0.26398868114442564,0.18766263162434435,-1894022,-2318202,93.28805195756627,84.8145851989237,NaN,NaN,28.04707089367663,16.962075665070333
2005-12-22T09:30:00-05:00,32.21001,32.31,32.05,32.25,625600,869755,74.26405332665766,62.61687331293382,NaN,NaN,143.3340829623925,177.30444953442372,0.08532220436674792,0.29431538708277927,0.20899318271603134,-1268422,-2084142,93.4896291863751,86.3079624095617,NaN,NaN,31.30497278017203,19.011060967227717
2005-12-23T09:30:00-05:00,32.36,32.37,32.23,32.28999,741800,901085,74.84729141914475,63.8832411355401,NaN,NaN,134.56010345060503,165.06709886164896,0.08713480642152605,0.3179116907429389,0.23077688432141286,-526622,-1601462,93.89670388714204,87.56009938888879,NaN,NaN,34.13852693475336,21.172127534017093
2005-12-27T09:30:00-05:00,32.5,32.5,32.00999,32.03,432600,879655,64.59757456932627,64.54092682607047,NaN,NaN,101.44701314729905,139.15831453154138,0.06500725651857966,0.31203595496963743,0.24702869845105777,-959222,-1402302,94.06169419850485,88.66762476772581,NaN,NaN,33.50169783024037,22.933494719191845
2005-12-28T09:30:00-05:00,32.16,32.21001,32.02,32.03,323300,871285,64.59757456932627,65.45940735123705,NaN,NaN,78.2079764423066,123.2179767972004,0.04547823562504005,0.30387649298235786,0.2583982573573178,-959222,-1121502,94.29582912177366,89.66933349219077,NaN,NaN,32.99542769673538,24.37091371598378
2005-12-29T09:30:00-05:00,32.19,32.19,31.89999,31.92,462300,867080,60.53020765901373,65.89201857136017,NaN,NaN,59.371346132273,103.3841044269752,0.02147806879990205,0.2852458433571954,0.26376777455729333,-1421522,-1027002,94.37619164055755,90.57168369882098,NaN,NaN,31.35499783814134,25.368640019149144
2005-12-30T09:30:00-05:00,31.85001,31.85001,31.67,31.72,417500,863545,53.88665531215999,65.77949385522791,NaN,NaN,13.170870193870945,77.35146187327089,-0.009858939878249928,0.2514440997094809,0.2613030395877308,-1839022,-1141122,92.67813206559988,91.25967110446337,NaN,NaN,27.828905817171883,25.72010656172382
2006-01-03T09:30:00-05:00,31.78,32.19,31.67,32.11,1230000,895750,62.52433088275018,66.26544151530774,NaN,NaN,50.818276327178,60.60309644858548,-0.0064769089441061856,0.2532069034075981,0.2596838123517043,-609022,-1157602,92.4195285935703,91.93400450873953,NaN,NaN,27.419921664971792,25.962937290759246
2006-01-04T09:30:00-05:00,32.13,32.46001,32.13,32.42999,2160600,861480,67.84614599774733,66.57665743957025,NaN,NaN,106.38305590672454,61.590305000470586,0.014035939291104194,0.27722873646558455,0.26319279717448035,1551578,-655442,93.05540618471638,92.54857709646537,NaN,NaN,28.971920346474555,26.39279201300429
2006-01-05T09:30:00-05:00,32.77,32.77,32.28999,32.35001,1261100,888575,65.34825180974009,66.5852367136004,NaN,NaN,118.52351854925371,69.65341342186001,0.01865359278919737,0.28650978816097705,0.2678561953717797,290478,-405502,93.35422061063524,92.96423629417572,NaN,NaN,29.329096065055797,26.812264020440217
2006-01-06T09:30:00-05:00,32.48,32.63,32.39101,32.56,774900,882955,68.61538989155665,66.70599979985887,NaN,NaN,121.90797239782597,82.16073867497062,0.03152907380649139,0.3072675376298939,0.2757384638234025,1065378,91878,93.91530804563372,93.25858385280706,NaN,NaN,30.741352821147487,27.373562420541255
2006-01-09T09:30:00-05:00,32.66,32.74001,32.56,32.71001,622700,897150,70.73791979365801,67.06065772930154,NaN,NaN,144.10944563167627,108.34845376253168,0.04500580252879932,0.33199571698440167,0.28698991445560235,1688078,797298,94.61031923841469,93.49907227312895,NaN,NaN,32.60333413117556,28.120672664917585
2006-01-10T09:30:00-05:00,32.95,32.95,32.48,32.59,823300,913685,66.84319997768566,66.77652018372653,NaN,NaN,135.6204520755133,125.30888891219874,0.04081828636389606,0.33801277241047245,0.2971944860465764,864778,1092058,94.87380305894689,93.67242929929441,NaN,NaN,32.846351767987144,28.795769679641808
2006-01-11T09:30:00-05:00,32.49001,32.64,32.44,32.50999,1015600,926805,64.30131829885887,66.42306267687734,NaN,NaN,97.36736709047044,123.50575114894791,0.02823835365528432,0.3324924281156818,0.3042540744603975,-150822,751578,89.43496659031804,93.41069888426817,NaN,NaN,32.24394111273408,29.288365598654988
2006-01-12T09:30:00-05:00,32.41,32.56,32.41,32.48,547900,870500,63.329200307366214,65.87636527249941,NaN,NaN,78.46130062140203,115.49330756337758,0.014185476329286684,0.32198591987200587,0.3078004435427192,-698722,553738,86.33777739237712,92.91425070104037,NaN,NaN,31.469072132934446,29.599895103552054
2006-01-13T09:30:00-05:00,33.11,33.11,32.28999,32.46001,878500,762535,62.64931378174954,65.04674101929169,NaN,NaN,101.85809169661626,111.48333142313564,0.0005519059716946328,0.3084903260073375,0.30793842003564287,-1577222,25218,78.51526116446641,91.84465298518974,NaN,NaN,30.64377870429039,29.74902133222896
2006-01-17T09:30:00-05:00,32.23,32.39999,32.23,32.37,1063700,787255,59.54924492510924,63.95402341257487,NaN,NaN,21.937396520572335,87.04892160091485,-0.01657392734074048,0.2872210108597173,0.3037949382004578,-2640922,-840582,67.6948862307936,89.97309458116486,NaN,NaN,29.06309195135689,29.651031420675807
2006-01-18T09:30:00-05:00,32.39999,32.49001,32.32001,32.42,1213900,822885,60.71223568349924,63.67649920644436,NaN,NaN,37.29033245319283,67.38289767645077,-0.026017992491469577,0.2712724475861208,0.29729044007759037,-1427022,-1298942,62.76349812144538,87.73750914708917,NaN,NaN,28.046705665378408,29.421842027061892
2006-01-19T09:30:00-05:00,32.61,32.71001,32.31,32.59,2798500,913560,64.45421467532395,63.66625921401561,NaN,NaN,69.21641402570722,61.75270706349811,-0.022434780752338457,0.2692469641371673,0.29168174488950577,1371478,-994482,64.60778824416028,85.61693479868822,NaN,NaN,28.191702149143254,29.2461077587878
2006-01-20T09:30:00-05:00,32.60001,32.60001,31.96001,31.97,3070600,1046680,46.90697208888975,62.69317095900676,NaN,NaN,-46.37161249057978,36.78612444110175,-0.06123898313181014,0.2151330159747431,0.27637199910655325,-1699122,-1194562,62.41982008865107,83.33433683069488,NaN,NaN,22.13208501543002,28.229818795450974
2006-01-23T09:30:00-05:00,32.02,32.03999,31.81,31.95,1085000,1077470,46.46750144546571,62.16323139710003,NaN,NaN,-115.45429464402613,-6.67635282702673,-0.08614644076998423,0.16868894814407298,0.2548353889140572,-2784122,-1435942,59.78918247357441,80.98512614555023,NaN,NaN,17.334643072447477,26.67336512073619
2006-01-24T09:30:00-05:00,31.88,31.96001,31.73,31.8,1173700,1104875,43.19855618292178,60.782818918540855,NaN,NaN,-128.92845178939803,-36.8495224890208,-0.10913794907413382,0.11841295257138995,0.22755090164552377,-3957822,-1699322,56.96797213157082,78.45287211255027,NaN,NaN,12.282562733676803,24.617536208299136
2006-01-25T09:30:00-05:00,31.89999,31.97,31.64,31.75999,1425200,1139045,42.34289689256547,58.96115826817072,NaN,NaN,-119.33961205886536,-68.17551139143244,-0.12245527229126929,0.07448181128143716,0.19693708357270645,-5383022,-2490522,49.42341470521701,75.33630129258601,NaN,NaN,7.9818819019479275,22.24101416453468
2006-01-26T09:30:00-05:00,31.84,32.03999,31.83,31.92,1221300,1178480,46.874942856053536,57.64163620005026,NaN,NaN,-77.16194085127368,-97.45118236682862,-0.11596697817458351,0.051978360854477046,0.16794533902906056,-4161722,-3597162,41.203901188280156,71.61127847670352,NaN,NaN,5.699911839122302,19.877999546618625
2006-01-27T09:30:00-05:00,31.96001,32.34,31.96001,32.28999,1228700,1223750,55.571220801956436,56.709909836507386,NaN,NaN,-15.297775692119586,-91.23641500713657,-0.08374028866122116,0.0632699782025341,0.14701026686375526,-2933022,-3843942,39.621444086541544,67.73314533676835,NaN,NaN,6.530987580876923,17.971283551512666
2006-01-30T09:30:00-05:00,32.39,32.49001,32.11,32.14,977700,1249520,51.86472841716433,55.36182473818641,NaN,NaN,-6.401246487140569,-69.42580537575947,-0.07006369564030263,0.059430647313376994,0.12949434295367962,-3910722,-4069262,38.17966030853341,63.702383984633975,NaN,NaN,5.992445734602892,16.260021006239842
2006-01-31T09:30:00-05:00,31.61,32.21001,31.61,32.13,2370400,1347165,51.617537315383366,54.27427740516482,NaN,NaN,-80.85730328135175,-59.811575674150205,-0.059637369238790455,0.054947631405191544,0.114585000643982,-6281122,-4533922,35.32489176105193,59.44889032049862,NaN,NaN,5.49467253322855,14.722114081523944
2006-02-01T09:30:00-05:00,32.28999,32.42999,32.21001,32.33,1472700,1359300,56.12180467743601,53.69002643220604,NaN,NaN,6.666950828324646,-34.61026309671221,-0.0382571772152384,0.066763529124934,0.1050207063401724,-4808422,-4419002,36.58775689098014,55.67408962768877,NaN,NaN,6.486358732948331,13.545577603156
2006-02-02T09:30:00-05:00,32.44,32.44,31.99001,32.07001,900500,1296295,49.65077285340774,52.71299589978043,NaN,NaN,-35.11337778873684,-26.200550484204836,-0.04040039076038701,0.05452021788968864,0.09492060865007565,-5708922,-4728442,34.627100653597424,51.980469860633086,NaN,NaN,5.255157406700552,12.361231860805221
2006-02-03T09:30:00-05:00,32.02,32.17,31.86,32.00999,823400,1274410,48.26715041025044,51.68569851610193,NaN,NaN,-70.34069944170254,-37.209135234121426,-0.04432156950004848,0.03951864677501504,0.08384021627506352,-6532322,-5448302,30.528568187358104,48.55284893369678,NaN,NaN,3.8380999255029185,11.143641584333464
2006-02-06T09:30:00-05:00,31.89,31.89999,31.62,31.72,924800,1281905,42.15477432596635,50.44323633044887,NaN,NaN,-127.27357367980554,-61.383600672654424,-0.06372671803567831,0.004181818730465636,0.06790853676614395,-7457122,-6157582,27.122200476962362,45.65479995128027,NaN,NaN,0.5835448962835403,9.635056343183475
2006-02-07T09:30:00-05:00,31.75,31.87,31.60001,31.67,1328600,1317200,41.186311459812075,49.048527457328355,NaN,NaN,-123.20771422309774,-69.85368286100362,-0.07635882169275048,-0.027539990349794152,0.04881883134295632,-8785722,-6658502,25.00056730825156,42.95744775033785,NaN,NaN,-2.315283304736846,7.927864964909143
2006-02-08T09:30:00-05:00,31.63,32.08,31.50999,32.08,1537800,1352925,51.10585326030344,48.095073070541176,NaN,NaN,-68.64140370808867,-84.91535376828628,-0.0545533537318024,-0.019372860821796678,0.035180492910005724,-7247922,-7146402,23.10476091705364,39.992945798401664,NaN,NaN,-1.6298373779110622,6.562478915934828
2006-02-09T09:30:00-05:00,32.08,32.35001,32.08,32.11,1491900,1376740,51.74714885378403,48.440799982319334,NaN,NaN,15.918547201239994,-74.70896877029092,-0.03643253583219706,-0.010360176880240601,0.02607235895195646,-5756022,-7155822,23.068389003207656,37.182129292298555,NaN,NaN,-0.8896176903270341,5.4978936864688475
2006-02-10T09:30:00-05:00,31.92,32.05,31.77,32.03999,812200,1389955,50.09584646287626,48.69996748356294,NaN,NaN,-43.97458822864969,-69.43574652768035,-0.027870475864733086,-0.008765735878959902,0.019104739985773184,-6568222,-7163002,23.03861896844829,34.5570890419324,NaN,NaN,-0.7892581899497382,4.599729132694764
2006-02-13T09:30:00-05:00,32.02,32.03,31.84,32,644600,1378260,49.131406080268064,49.12374247623053,NaN,NaN,-36.6348108460362,-51.30799396092648,-0.02376916879693069,-0.010606721010390174,0.013162447786540512,-7212822,-7114142,23.759661023326558,32.18506681991495,NaN,NaN,-0.987332386700702,3.80157748706684
2006-02-14T09:30:00-05:00,32.66,32.66,32.05,32.31,900300,1370090,56.17494767773598,50.11174610374271,NaN,NaN,92.11683305845004,-8.243084504616927,-0.00028905361783619285,0.012801130764245272,0.013090184382081465,-6312522,-6619502,30.825359620615203,30.85663431387197,NaN,NaN,1.0434624917198905,3.407561059160133
2006-02-15T09:30:00-05:00,32.31,32.53999,32.25999,32.5,974500,1358120,59.844886299840304,51.038170635441766,NaN,NaN,122.29134297177069,29.943464831354948,0.02644899577232828,0.046151429097491814,0.019702433325163533,-5338022,-6237522,35.77538973364561,30.46888349568379,NaN,NaN,3.944387462731965,3.4842505453846804
2006-02-16T09:30:00-05:00,32.50999,32.73,32.42,32.71001,1161200,1276255,63.484723875634536,51.6034208549902,NaN,NaN,179.10824028311146,62.58140344772926,0.055044111319291295,0.08850757247427765,0.03346346115498636,-4176822,-5921682,39.62260503982612,30.468966420918406,NaN,NaN,7.603470348761955,4.07271051729572
2006-02-17T09:30:00-05:00,32.53,32.72,32.52,32.69,756200,1160535,62.89968942316034,52.39163235541849,NaN,NaN,159.11596876118853,103.1995148456969,0.06849940105250958,0.11908771247062333,0.05058831141811375,-4933022,-5594642,43.40316055923419,30.842073581682747,NaN,NaN,10.338151461578885,4.967773509336172
2006-02-21T09:30:00-05:00,32.74001,32.81,32.45,32.52,692800,1140925,58.008750553464004,52.848147586709956,NaN,NaN,125.81538044635104,135.68955310417434,0.06203185736420386,0.12812813312336857,0.06609627575916471,-5625822,-5277242,46.879589850764695,31.667409159519373,NaN,NaN,11.212056036610656,5.859813870375383
2006-02-22T09:30:00-05:00,32.47,32.84,32.47,32.8,641800,1114330,63.09834699158047,53.34647203772028,NaN,NaN,138.1351842490432,144.89322334229297,0.071992672551221,0.15608711644819095,0.08409444389696996,-4984022,-5011542,49.66677180758035,32.60162451070511,NaN,NaN,13.614759568384002,6.967663255805186
2006-02-23T09:30:00-05:00,32.72,32.8,32.58,32.67999,790800,1082610,59.75528113261489,54.068222629092226,NaN,NaN,118.58499020123816,144.15195278818646,0.06603651285244841,0.16664008496253047,0.10060357211008206,-5774822,-5098902,48.76087004887578,33.6111794675107,NaN,NaN,14.56023251141004,8.05231600660588
2006-02-24T09:30:00-05:00,32.66,32.75999,32.56,32.67999,665900,1054840,59.7552811326149,54.8888033949754,NaN,NaN,100.89073293261194,128.50845131808654,0.057924380655958466,0.17300904793003014,0.11508466727407167,-5774822,-5418502,45.491779684181544,34.67998028871238,NaN,NaN,15.313071066345774,9.089566729425865
2006-02-27T09:30:00-05:00,32.7,33.03,32.7,32.92999,1548200,1070815,64.32214089910607,56.47218672162824,NaN,NaN,132.15718031987691,123.11669362982425,0.06470857261443563,0.19597038304211623,0.1312618104276806,-4226622,-5277222,47.17767871412909,36.112514448510005,NaN,NaN,17.385054089758697,10.274636352330555
2006-02-28T09:30:00-05:00,32.8,32.8,32.41,32.5,912700,1067565,53.15045333319974,57.32676828401308,NaN,NaN,56.79609181351046,109.31283590325613,0.03693099626511884,0.17742555575907915,0.1404945594939603,-5139322,-5179922,48.36223001558986,37.781204641891314,NaN,NaN,15.553394738851608,11.028744693262134
2006-03-01T09:30:00-05:00,32.46001,32.57001,32.31,32.53,1319700,1015030,53.75395773856355,57.51591860388879,NaN,NaN,31.51825091856337,87.98944923716017,0.018218233534326056,0.16326735141186788,0.14504911787754182,-3819622,-4947042,51.183883348210685,39.78685624411681,NaN,NaN,14.309509714650744,11.497425410603364
2006-03-02T09:30:00-05:00,32.5,32.53,32.36,32.47,757400,979265,52.30279984432785,57.55560796035621,NaN,NaN,25.971382461307613,69.46672768917406,0.000382961525740827,0.14552781978471785,0.14514485825897702,-4577022,-4707482,53.97027011234785,41.994133466198264,NaN,NaN,12.861072348536624,11.692232116022401
2006-03-03T09:30:00-05:00,32.37,32.66,32.33,32.36,795500,974015,49.65611008772629,57.52419821927407,NaN,NaN,22.595958413155742,53.80777278528283,-0.019159117905567846,0.12119596087701723,0.14035507878258507,-5372522,-4627022,54.90136086775105,44.270043601862746,NaN,NaN,10.855671188527273,11.572723412094525
2006-03-06T09:30:00-05:00,32.36,32.38,32.10001,32.19,954100,980550,45.79889367961659,57.28616161922754,NaN,NaN,-31.52752007595904,21.07083270611563,-0.04253195539140625,0.08719013454332725,0.1297220899347335,-6326622,-5047022,49.29581877362628,46.0940548697413,NaN,NaN,7.958900863015756,11.056463047940415
2006-03-07T09:30:00-05:00,32.10001,32.36,32.10001,32.2,1244300,996525,46.0643012958842,56.563972591952414,NaN,NaN,-41.95604523720679,1.3204052959721821,-0.055496476632080016,0.06035149414463348,0.1158479707767135,-5082322,-5035622,49.44669620993563,47.424150340407046,NaN,NaN,5.690815216103993,10.289941929106641
2006-03-08T09:30:00-05:00,32.13,32.53,32.13,32.42,490900,954640,51.671152525681855,55.980134465226804,NaN,NaN,-16.691861490285913,-8.321617185797674,-0.047729448168838035,0.056186160565665944,0.10391560873450398,-4591422,-5189982,47.390400802509475,48.253793988183034,NaN,NaN,5.314279425340416,9.57913299999718
2006-03-09T09:30:00-05:00,32.5,32.50999,32.28,32.31,381500,896825,48.93215431765784,54.940665211085616,NaN,NaN,-25.109000240329156,-18.537693726125024,-0.04832649044727233,0.043507495675413566,0.0918339861226859,-4972922,-5269162,46.32615991797663,48.732619336622356,NaN,NaN,4.1931340394363,8.809704577059911
2006-03-10T09:30:00-05:00,32.39,32.49001,32.314,32.42999,626700,853565,51.925750161484515,54.156812406680196,NaN,NaN,-14.555141579736322,-25.967913724703436,-0.03934710193621446,0.04265010870241781,0.08199721063863227,-4346222,-5063902,49.49264669607829,49.16758263211123,NaN,NaN,4.110304494154081,8.138361708073363
2006-03-13T09:30:00-05:00,32.63,32.63,32.35001,32.41,761900,851050,51.38532302887372,53.68371044063803,NaN,NaN,-5.359209517671584,-20.73425161304595,-0.0336796230928649,0.03989768177255115,0.07357730486541605,-5108122,-4820202,53.035252962490944,49.60727285437738,NaN,NaN,3.8920114641322447,7.531740244653204
2006-03-14T09:30:00-05:00,32.41,32.64999,32.36,32.64,868500,862245,56.93851960332518,53.243722770048365,NaN,NaN,21.622398956985137,-8.018562774207563,-0.014354543221423405,0.055634125838636805,0.06998866906006021,-4239622,-4651662,55.36687276964059,50.01442292309597,NaN,NaN,5.331659070623371,7.217442934077513
2006-03-15T09:30:00-05:00,32.71001,32.78,32.561,32.75,729000,853680,59.33120958361132,53.213431945119545,NaN,NaN,83.68561137927375,12.056931799704369,0.004892401012192932,0.07610417032530137,0.07121176931310844,-3510622,-4435502,58.23102805385015,50.690862780594145,NaN,NaN,7.259277302993173,7.223419272494036
2006-03-16T09:30:00-05:00,32.75,32.82001,32.67999,32.75,815000,845705,59.331209583611326,53.18314112019072,NaN,NaN,97.89321503784645,36.65737485533949,0.016050320929486467,0.09127467047496651,0.07522434954548005,-3510622,-4143042,61.802520810148955,51.855915718163246,NaN,NaN,8.827489694157036,7.452572189874465
2006-03-17T09:30:00-05:00,32.75,32.78999,32.66,32.72,395200,807405,58.30647313579515,52.75345056566851,NaN,NaN,80.49742271064639,55.66788771341603,0.01960216867352005,0.0997270603873801,0.08012489171386006,-3905822,-4054962,62.8332534923143,52.974171059462186,NaN,NaN,9.870532942984326,7.797995154604445
2006-03-20T09:30:00-05:00,32.77,32.85001,32.64999,32.78,745800,806885,59.801846910665866,53.22855010691609,NaN,NaN,91.1272269909628,74.9651750151429,0.023899396441644877,0.10999913726591615,0.08609974082427127,-3160022,-3665342,67.06670982045085,54.31020533123797,NaN,NaN,11.165137589059762,8.279015502383777
2006-03-21T09:30:00-05:00,32.73,32.82001,32.46001,32.58,1330400,838765,52.98063260161698,53.17331259713419,NaN,NaN,29.470816575942383,76.53485853893436,0.011791482036576123,0.10083909336999142,0.0890476113334153,-4490422,-3715502,66.02404756440333,55.37021706096601,NaN,NaN,10.447765121824641,8.588836876589614
2006-03-22T09:30:00-05:00,32.62,32.92,32.61011,32.91,559500,834650,60.904580369032224,53.78772549175593,NaN,NaN,106.5959867152677,81.11693360613314,0.023832345868900637,0.1188380436695411,0.09500569780064046,-3930922,-3799562,64.22211797579973,56.10249190835543,NaN,NaN,12.239150522143134,9.110310254525832
2006-03-23T09:30:00-05:00,32.8,32.8,32.56,32.73,1707700,880495,55.418492275790655,54.19932421947481,NaN,NaN,57.667872214042795,73.07186504137242,0.017776666798139065,0.11722653129831428,0.09944986450017522,-5638622,-4225162,55.903159734363214,56.1740489702563,NaN,NaN,12.035887855322628,9.528249911782517
2006-03-24T09:30:00-05:00,32.60001,32.78999,32.60001,32.67999,465500,870475,53.96408293318219,54.78255202330092,NaN,NaN,54.026381039017,67.77765670704653,0.008951015427616324,0.11063863378469563,0.1016876183570793,-6104122,-4664822,48.861838698746865,56.1430503934792,NaN,NaN,11.428216653624911,9.799673732045717
2006-03-27T09:30:00-05:00,32.59,32.60519,32.38879,32.42999,778800,832005,47.28356680457714,54.869642416779,NaN,NaN,-28.43133962455017,43.86594338394395,-0.013931441450242152,0.08427331654427661,0.09820475799451876,-6882922,-5409402,39.73415014814354,55.44929710335119,NaN,NaN,8.74068493654632,9.648389618402947
2006-03-28T09:30:00-05:00,32.24001,32.38,32.10001,32.13,1013700,837055,40.762515132467364,54.09045403154939,NaN,NaN,-130.07883305123002,11.956013458509462,-0.04758338793464753,0.038725523076209356,0.08630891101085689,-7896622,-6090642,33.557487267305135,54.4612318508366,NaN,NaN,4.1264739477009185,8.85954452258837
2006-03-29T09:30:00-05:00,32.33,32.33,32.13,32.22,503300,796235,43.289436841744745,53.68740278326988,NaN,NaN,-108.18547676824585,-31.00027923819325,-0.06122464834435,0.009778100580419391,0.07100274892476939,-7393322,-6783122,28.677458254983875,53.20061030347997,NaN,NaN,1.2423353478321375,7.7713717833374805
2006-03-30T09:30:00-05:00,32.14,32.39999,32.07001,32.16,690200,792875,42.00305621271407,52.97863892978627,NaN,NaN,-103.38031560718078,-63.20991680243797,-0.07104160719665066,-0.017799260071043932,0.05324234712560673,-8083522,-7272102,25.821907784470028,51.5098432383651,NaN,NaN,-1.4804732968346543,6.449679629027176
2006-03-31T09:30:00-05:00,32.12,32.23,31.95,31.98,895800,797890,38.32378433317417,52.04567188009345,NaN,NaN,-139.41338113391103,-101.89786923702357,-0.08544314818209618,-0.0535615881020135,0.03188156008008268,-8979322,-7847142,22.930233906648425,49.359484734376345,NaN,NaN,-4.981612776477915,4.816637856812163
2006-04-03T09:30:00-04:00,32.10001,32.19,31.95,31.96001,2382100,869290,37.92645718693439,50.68766742177983,NaN,NaN,-136.52350280419478,-123.5163018729525,-0.09155705724905559,-0.08256476148123681,0.008992295767818778,-11361422,-8742842,19.303988172559727,46.78356440601343,NaN,NaN,-7.904010206898122,2.9994024191392645
2006-04-04T09:30:00-04:00,32.05,32.07899,31.84,32,2518900,933020,39.282633242626744,49.25562625456664,NaN,NaN,-142.67971346425904,-126.0364779555583,-0.08811947744223438,-0.10115705103497419,-0.013037573592739816,-8842522,-8932022,18.633724403733027,43.9551855738622,NaN,NaN,-9.923792638369267,1.1532316966380456
2006-04-05T09:30:00-04:00,31.87,32.03999,31.85001,31.89999,1908800,1003915,37.09962314898013,47.66765579495012,NaN,NaN,-134.86238649112198,-131.37185990013353,-0.08760904388686326,-0.1225488784513189,-0.03493983456445564,-10751322,-9603622,16.450058034589375,40.715723947036516,NaN,NaN,-12.278132950821535,-0.7655346815704658
2006-04-06T09:30:00-04:00,31.87,31.87,31.50999,31.66,2216300,1095655,32.44075418581842,45.82010444138036,NaN,NaN,-166.53939885832332,-144.00367655036203,-0.09769356451277439,-0.15705679020542362,-0.059363225692649235,-12967622,-10580442,13.898809545970764,37.220406522297694,NaN,NaN,-15.843412308428615,-2.9195171996930585
2006-04-07T09:30:00-04:00,31.74001,31.7899,31.25,31.28,1833100,1155975,26.719248100108373,43.457061669197685,NaN,NaN,-178.58459991878306,-151.83792030733645,-0.12260259764225948,-0.21261647274547357,-0.0900138751032141,-14800722,-11744722,11.591293161148428,33.257876760918954,NaN,NaN,-21.122091487811666,-5.519884955138574
2006-04-10T09:30:00-04:00,31.3,31.3,31.02,31.22,1887700,1212265,25.94127761556807,41.52567917019419,NaN,NaN,-187.83552244530594,-162.10032423555867,-0.1347964867919413,-0.25850948359314074,-0.12371299680119943,-16688422,-12810122,9.961502011169287,29.25340922140223,NaN,NaN,-25.567750291981,-8.383865717544634
2006-04-11T09:30:00-04:00,31.23,31.23,30.73,30.88,2293300,1283505,22.027344635720453,38.748733760671925,NaN,NaN,-190.40843601703597,-171.64606874611405,-0.1559432636187038,-0.3186420763245792,-0.16269881270587538,-18981722,-14837962,7.732837786747993,25.218460636469963,NaN,NaN,-30.9124417314945,-11.602233719537471
2006-04-12T09:30:00-04:00,30.89999,31.09,30.86,31.09,4217500,1457930,29.138756822710008,36.871609799737584,NaN,NaN,-152.60803571819508,-175.19519859152868,-0.14613784666897328,-0.345371121042092,-0.19923327437311872,-14764222,-15640542,7.059641384981873,21.72963789722844,NaN,NaN,-32.92405875434707,-14.64820872451027
2006-04-13T09:30:00-04:00,30.92,31.07001,30.89,31.02,1764800,1505420,28.21500133569539,35.03238968563139,NaN,NaN,-135.69457473849764,-169.02623376756353,-0.13498207861871,-0.36796087264650623,-0.23297879402779623,-16529022,-16352822,6.517363457506747,18.705032522854147,NaN,NaN,-34.81218826776139,-17.528777230689002
2006-04-17T09:30:00-04:00,31.03,31.03,30.73,30.84,1521400,1561730,25.937911500732,33.50770002107102,NaN,NaN,-130.79863797036344,-159.4690413778796,-0.13027703201320645,-0.3958250840443043,-0.2655480520310978,-18050422,-17002762,6.059943546585629,16.299732051314297,NaN,NaN,-37.12995141372904,-20.328944971123292
2006-04-18T09:30:00-04:00,30.98,31.14999,30.88,31.13,7651602,1907020.1,35.03476644620014,33.098575114909075,NaN,NaN,-94.31532133747228,-140.76500115631288,-0.0995705892532262,-0.39001128859763057,-0.29044069934440436,-10398820,-15744841.6,18.04844499034394,15.191943317245642,NaN,NaN,-36.066903583554684,-22.577224772899203
2006-04-19T09:30:00-04:00,31.11,31.11,30.83,30.95,1405900,1910795.1,32.376579786125845,32.31908532522201,NaN,NaN,-92.76690547908447,-121.2366950487226,-0.08394401806417345,-0.3953707219246212,-0.31142670386044774,-11804720,-14309441.2,29.1582834688557,15.22628797537934,NaN,NaN,-36.06432437547725,-24.50395328755321
2006-04-20T09:30:00-04:00,31.00999,31.27,30.95,31.23,3495900,2057615.1,40.00245878338257,32.176185508841186,NaN,NaN,-64.12753531091947,-103.54059496726748,-0.049040938160110015,-0.37272787656058526,-0.32368693840047524,-8308820,-13018360.8,37.381104834541965,16.05194490752734,NaN,NaN,-33.43615643968124,-25.779982309285785
2006-04-21T09:30:00-04:00,31.41,31.41,31.03,31.16,1167900,2030625.1,38.82372779052853,32.21189575579506,NaN,NaN,-51.75100498234017,-86.75188101603598,-0.026109801282841794,-0.3563241900040275,-0.3302143887211857,-9476720,-11607900.4,44.90490129219845,17.621564006495202,NaN,NaN,-31.738882150651072,-26.63125371519511
2006-04-24T09:30:00-04:00,30.67999,31.10001,30.67999,31.03999,1619700,2088335.1,36.82053744347374,32.132901488405025,NaN,NaN,-77.50316529167944,-76.09278648029917,-0.015016546295628763,-0.3489850715907217,-0.3339685252950929,-11096420,-10217100,51.13911338706765,19.895501521817202,NaN,NaN,-30.97271709001017,-27.25146276874012
2006-04-25T09:30:00-04:00,31.00999,31.03999,30.75,30.85001,2743900,2186590.1,33.84355614048849,31.74439598110943,NaN,NaN,-79.80249066120817,-73.19022034504636,-0.016355669287166807,-0.35441311190405145,-0.33805744261688464,-13840320,-10905400,48.23048724412874,22.009556010416894,NaN,NaN,-31.257975668176698,-27.823821754373917
2006-04-26T09:30:00-04:00,30.82001,31,30.74001,30.85001,2192300,2245520.1,33.84355614048849,31.511819766217172,NaN,NaN,-76.38282323685372,-69.9134038966002,-0.01325560924978919,-0.35462695417912116,-0.34137134492933197,-13840320,-11312520,46.544207209595754,24.159138094345924,NaN,NaN,-31.4837127177474,-28.34666332057013
2006-04-27T09:30:00-04:00,30.75,30.85001,30.58,30.67999,4469801,2443845.15,31.223397221416832,31.424865697331345,NaN,NaN,-95.422353025346,-76.1723674394855,-0.01835573254838596,-0.36431601061481445,-0.3459602780664285,-18310121,-13312780.2,39.27802294025919,25.971939051080806,NaN,NaN,-32.458436185396415,-28.93405944411674
2006-04-28T09:30:00-04:00,30.67999,31,30.67999,30.99001,2495700,2534120.15,40.299583250737115,32.39488963666197,NaN,NaN,-62.915838590148844,-78.40533416104725,0.0023486527593406525,-0.3430244621172527,-0.34537311487659333,-15814421,-14580320.4,35.49634658886886,27.679442867346555,NaN,NaN,-30.446745466295962,-29.150157447285203
2006-05-01T09:30:00-04:00,30.92999,31.03,30.71001,30.72,1018600,2540260.15,35.86085889639172,33.1034311567208,NaN,NaN,-74.05981907985395,-77.71666491868214,0.001119933456015576,-0.3439731980565739,-0.34509313151258947,-16833021,-15727640.6,32.450784100330495,29.285820159429502,NaN,NaN,-30.141343031648,-29.29175538790846
2006-05-02T09:30:00-04:00,30.75999,30.83,30.64,30.72,791300,2460720.15,35.86085889639172,34.09153931819732,NaN,NaN,-91.41283519759759,-80.03873382596004,0.0034372354460955323,-0.3407965872049701,-0.3442338226510656,-16833021,-16326180.8,30.9584815616076,30.944794714776613,NaN,NaN,-29.902410179654282,-29.37899178672929
2006-05-03T09:30:00-04:00,30.56,30.64999,30.36,30.38,2203100,2444930.15,30.89184803740946,34.21676011924728,NaN,NaN,-159.823641221456,-96.72689742288047,-0.013850201767315329,-0.3615465748602098,-0.3476963730928945,-19036121,-17365341,28.507371971644858,32.47677547096683,NaN,NaN,-31.294140222866734,-29.65258442046321
2006-05-04T09:30:00-04:00,31.3,31.3,30.38,30.48,1475800,2423280.15,33.79740912880064,34.61550353304052,NaN,NaN,-88.88551714676628,-95.41953024716452,-0.014407934190489802,-0.3657062908310067,-0.3512983566405169,-17560321,-17215381,29.37635405493745,34.10956051364045,NaN,NaN,-31.512752191689135,-29.918322673495485
2006-05-05T09:30:00-04:00,30.63,30.83,30.53999,30.78,1190000,2371965.15,41.71452514044624,35.742404507305814,NaN,NaN,-86.77862397743806,-100.19208732462236,0.00834579685582415,-0.3408661105707367,-0.34921190742656083,-16370321,-17326561,29.094003292097412,35.75485049546272,NaN,NaN,-29.110798697345118,-29.802962105474005
2006-05-08T09:30:00-04:00,30.71001,30.81799,30.7,30.77,3090900,2434855.15,41.53621241294078,36.20679350493015,NaN,NaN,-61.758100718863325,-97.73174365242424,0.024715415863820922,-0.31831763759678466,-0.3430330534606056,-19461221,-17852201,27.736654178550538,36.44686543747748,NaN,NaN,-27.277505044373612,-29.442182525316806
2006-05-09T09:30:00-04:00,30.69,30.75999,30.50999,30.55,3177400,2499340.15,37.71647506944118,36.588214596595535,NaN,NaN,-123.38146077419721,-104.12546876774418,0.02276743381521318,-0.3145737611915891,-0.33734119500680226,-22638621,-19013321,24.965838598320815,36.14740508958213,NaN,NaN,-26.870725016447444,-29.074831452621183
2006-05-10T09:30:00-04:00,30.50999,30.66,30.5,30.52,2280700,2498710.15,37.21390672399455,36.389032306639244,NaN,NaN,-124.86752258213765,-97.13424503988051,0.021513915271420214,-0.310448800917527,-0.33196271618894724,-24919321,-20189961,22.51162896128207,35.08529967006357,NaN,NaN,-26.691259215387582,-28.734321133016383
2006-05-11T09:30:00-04:00,30.55,30.64999,30.39999,30.46001,1620600,2368865.15,36.17584074681232,36.19989751780237,NaN,NaN,-131.0221981162255,-105.56158123377236,0.018798458209241253,-0.30846464342739566,-0.3272631016366369,-26539921,-21985881,19.38014257214573,33.26210261863123,NaN,NaN,-26.838346169229588,-28.46346756676113
2006-05-12T09:30:00-04:00,30.38,30.56,30.36,30.39,1406100,2350930.15,34.95054876755685,36.066326898094026,NaN,NaN,-138.16072774686026,-115.8380019876568,0.014626736672228247,-0.30897968079635163,-0.3236064174685799,-27946021,-24301021,16.243299374252743,30.76954447485874,NaN,NaN,-27.303831141526846,-28.29780522029909
2006-05-15T09:30:00-04:00,30.46001,30.82001,30.39999,30.82001,2248900,2387305.15,46.856727835785456,36.99583916204381,NaN,NaN,-39.56639524399913,-111.39966089268395,0.04163771628187857,-0.27155927211623165,-0.3131969883981102,-25697121,-25548201,14.848960144052512,28.385149681996154,NaN,NaN,-23.999984103050984,-27.68383077497793
2006-05-16T09:30:00-04:00,30.8,31,30.78,30.89999,1808200,2095135.05,48.7361632574069,38.05959681325226,NaN,NaN,48.667586145318616,-76.9898515087808,0.06434445103233677,-0.23276642460768926,-0.29711087564002603,-23888921,-25798261,14.57874229701116,26.10190218824011,NaN,NaN,-20.7263922922403,-26.689910991729697
2006-05-17T09:30:00-04:00,30.78999,31.00999,30.56,30.58,3359700,2192825.05,42.29186485785493,38.85020164442642,NaN,NaN,-19.499552409980698,-55.916257474349415,0.05749123891881408,-0.22524682699150844,-0.2827380659103225,-27248621,-26264121,14.06521875544216,24.30098760361032,NaN,NaN,-19.84631921412781,-25.712255023500855
2006-05-18T09:30:00-04:00,30.63,30.64,30.42999,30.45,1288500,2082455.05,39.97901206111836,38.82730370231079,NaN,NaN,-105.22550294047582,-50.756918439199474,0.044463365271613375,-0.22715885932080582,-0.2716222245924192,-28537121,-26663561,13.622154302373232,22.738545297432065,NaN,NaN,-19.851029646759024,-24.874937112537737
2006-05-19T09:30:00-04:00,30.49001,30.49001,30.13,30.28,1091100,2078615.05,37.120162648888524,38.91725397034628,NaN,NaN,-180.52579744564832,-59.229932378957095,0.025594228506124528,-0.23962943895976352,-0.26522366746588805,-29628221,-27000001,13.243736378242573,21.366613317282923,NaN,NaN,-20.75521693340237,-24.286405658375543
2006-05-22T09:30:00-04:00,30.16,30.42,30.14,30.14999,873300,2041295.05,35.05559514709428,38.85973513111075,NaN,NaN,-173.91299768497734,-86.09925286715273,0.006546786463305254,-0.25704018438675647,-0.2635869708500617,-30501521,-27960881,12.201236612793025,20.02681010665331,NaN,NaN,-22.147475034569784,-23.980844140689005
2006-05-23T09:30:00-04:00,30.25,30.28,30.00999,30.00999,2276200,2017910.05,32.93153343297483,39.005426945079705,NaN,NaN,-191.09365781221993,-134.05150165866044,-0.012266375398873264,-0.2789199400986533,-0.26665356469978,-32777721,-29738641,10.547048020221453,18.743929824408784,NaN,NaN,-23.96989623625207,-23.97928015434087
2006-05-24T09:30:00-04:00,30.06,30.19,29.78999,30.10001,1705700,1993580.05,35.6322187416808,39.136484774571144,NaN,NaN,-182.07801037984845,-166.56719325263398,-0.01523918136839203,-0.28570254141027007,-0.27046336004187804,-31072021,-30503321,9.923814107054895,17.354462685274314,NaN,NaN,-24.67983805294133,-24.079359854140936
2006-05-25T09:30:00-04:00,30.31,30.42,30.17999,30.38,531000,1796640,43.282243553775366,39.248464661237506,NaN,NaN,-72.62782127115312,-160.04765691876943,0.004030455030520519,-0.2654252912537274,-0.2694557462842479,-30541021,-30904101,9.603510976075839,15.962284662701345,NaN,NaN,-22.928509802706024,-23.91495270393595
2006-05-26T09:30:00-04:00,30.49001,30.61,30.39,30.55,1935800,1768645,47.372042021098146,39.66530963324875,NaN,NaN,-5.089716590935851,-124.96044074782694,0.02920258615105842,-0.2329525135954249,-0.2621550997464833,-28605221,-30699501,11.179595775892835,14.77963763394008,NaN,NaN,-20.16836535287865,-23.379725939499192
2006-05-30T09:30:00-04:00,30.34,30.42,30.09,30.14999,1443900,1789910,40.05342339680798,39.83223451377495,NaN,NaN,-98.6921884344951,-109.91627889773049,0.020311456750852386,-0.23676577880791783,-0.2570772355587702,-30049121,-30609021,11.91103988541306,13.847152011589527,NaN,NaN,-20.10324884916583,-22.911657783737283
2006-05-31T09:30:00-04:00,30.19,30.36,30.14,30.34,1171000,1808895,44.444062904559516,40.348674240958154,NaN,NaN,-69.05197943276156,-85.50794322183881,0.028143627353494127,-0.22189770136690257,-0.2500413287203967,-28878121,-29829101,18.16679996864454,13.536807083543989,NaN,NaN,-18.59195388027917,-22.29455722610041
2006-06-01T09:30:00-04:00,30.47,30.78,30.39999,30.77,876200,1742550,52.858802581604245,41.54031437201473,NaN,NaN,54.637246610793426,-38.164891823710434,0.06129851920871415,-0.17341817970950402,-0.23471669891821817,-28001921,-29215081,22.814231268427562,13.782099133278408,NaN,NaN,-14.270218473101922,-21.148223118529195
2006-06-02T09:30:00-04:00,30.91,30.92999,30.71001,30.89,969700,1717245,54.91126734407771,42.96607998462336,NaN,NaN,114.88434647235623,-0.6624582750085579,0.088663980437336,-0.12388672337154816,-0.21255070380888416,-27032221,-28513321,27.856993131964643,14.611648687400685,NaN,NaN,-10.165383413401758,-19.579246017796706
2006-06-05T09:30:00-04:00,30.75,30.78999,30.39,30.41,878200,1701655,46.23907482218031,42.92196191222298,NaN,NaN,15.43883331806848,3.4432517067923087,0.0724735145753363,-0.1219588105897138,-0.1944323251650501,-27910421,-28374361,28.84828710201967,15.611600612969768,NaN,NaN,-9.630617924336448,-18.15801343301667
2006-06-06T09:30:00-04:00,30.47,30.5999,30.3,30.46001,3027300,1698475,47.17514001919489,42.8104602523507,NaN,NaN,-5.794125373889782,22.02286431891337,0.06349058660582663,-0.11506909190776682,-0.17855967851359345,-24883121,-27341161,35.90074470975759,17.1346007853088,NaN,NaN,-8.908236672174061,-16.836616752896298
2006-06-07T09:30:00-04:00,30.55,30.87,30.48,30.60001,1461000,1612655,49.80973994316897,43.34745132987313,NaN,NaN,63.859926093775734,48.60524542422082,0.06509434735911537,-0.09719174431469924,-0.1622860916738146,-23422121,-26249961,42.39487357025107,19.15814755779515,NaN,NaN,-7.472721452721889,-15.498917424299954
2006-06-08T09:30:00-04:00,30.63,30.74001,30.3,30.64999,2199300,1608585,50.754018265026524,44.11709463015228,NaN,NaN,32.7680512795734,44.23140635797681,0.0673563384351023,-0.07809066862993674,-0.14544700706503905,-21222821,-24894141,49.27187466229712,21.70455615493257,NaN,NaN,-6.038736209995499,-14.147462965113604
2006-06-09T09:30:00-04:00,30.50999,30.67,30.42999,30.42999,791500,1567130,46.5981624015134,44.79409461248263,NaN,NaN,13.560314455963882,23.966599954698342,0.05252930661777805,-0.07978537379281647,-0.13231468041059452,-22014321,-23890561,53.67988156133483,24.59285223943916,NaN,NaN,-6.096030112486226,-12.997258271881122
2006-06-12T09:30:00-04:00,30.44,30.53999,30.12,30.12,763800,1535015,41.44818578019208,45.25070822913248,NaN,NaN,-68.9220440022577,7.094424490633105,0.021905787346369665,-0.10493244622763243,-0.1268382335740021,-22778121,-22864101,57.72602482512261,27.84462282603413,NaN,NaN,-7.803101766458559,-12.255235913963613
2006-06-13T09:30:00-04:00,30.14999,30.37,30.02,30.03999,1069400,1476040,40.21285670605256,45.77080274863802,NaN,NaN,-96.05031640757647,-10.95681371610423,-0.0023864701449298753,-0.12982132125516443,-0.12743485111023456,-23847521,-22656981,58.513511052559856,31.270798756915443,NaN,NaN,-9.564024178636991,-11.870777094631238
2006-06-14T09:30:00-04:00,29.94,30.16,29.94,30.09,1023000,1436780,41.38871675366973,46.181981178065804,NaN,NaN,-110.96197017777247,-45.92119297041387,-0.013133963232868417,-0.14385230515132008,-0.13071834191845166,-22824521,-22537461,58.98827868929702,34.77540336993274,NaN,NaN,-10.653272459283649,-11.696847861010154
2006-06-15T09:30:00-04:00,30.13,30.59,30.08,30.46001,975500,1317570,49.32919920139051,46.61390658146688,NaN,NaN,-0.4243736785265391,-52.55967796203386,0.0056231283291758305,-0.12368943150698186,-0.1293125598361577,-21849021,-22662701,58.236214823617765,38.24916793047145,NaN,NaN,-9.170749632255056,-11.335976685473712
2006-06-16T09:30:00-04:00,30.32001,30.48,30.25999,30.31,803100,1293300,46.57431367885361,46.55692598559227,NaN,NaN,-7.561604149949674,-56.78406168321658,0.008690566431365593,-0.11844935179695071,-0.1271399182283163,-22652121,-22790261,57.433045740950824,41.552985785118445,NaN,NaN,-8.783895998109555,-10.971393730135976
2006-06-19T09:30:00-04:00,30.35001,30.41,29.99001,30.08,957800,1286635,42.64215575317532,46.741835439618505,NaN,NaN,-74.0991936868048,-57.819491620125994,-0.003361348957594046,-0.13134160442530884,-0.1279802554677148,-23609921,-22956621,56.34169872720893,44.726604273818154,NaN,NaN,-9.678052388456395,-10.786630681324606
2006-06-20T09:30:00-04:00,30.12,30.12,29.92999,29.97,474100,1266675,40.86515672835731,46.48619928417549,NaN,NaN,-119.12441280617503,-62.434310899845705,-0.016592220032393856,-0.1487205305082071,-0.13212831047581325,-24084021,-23003921,56.01578074542829,47.43010290073128,NaN,NaN,-10.95483367255898,-10.810659680072375
2006-06-21T09:30:00-04:00,29.95,30.25,29.95,30.12,465900,1176160,44.27534741640172,45.87309534380388,NaN,NaN,-84.82505377598567,-57.206927619488354,-0.013238043947885497,-0.14867586541067013,-0.13543782146278463,-23618121,-23162641,54.86879245256502,49.71971441388395,NaN,NaN,-11.01410178859753,-10.839722838433111
2006-06-22T09:30:00-04:00,30.16,30.16,29.86,29.95,372300,1109490,41.363962075110415,44.90543068173479,NaN,NaN,-123.4990325265768,-81.8218593890984,-0.020055993304256142,-0.1605078130931048,-0.14045181978884866,-23990421,-23590921,51.78735642161786,51.429026077430606,NaN,NaN,-11.936381770998421,-10.996388400228156
2006-06-23T09:30:00-04:00,29.87,30.12,29.8,29.98,1943300,1180105,42.08767401595771,44.608902052718896,NaN,NaN,-114.70436865985813,-103.2504122910801,-0.020082981219577994,-0.16555554631332114,-0.14547256509374315,-22047121,-23469921,52.5973336048034,53.12538654191517,NaN,NaN,-12.482447080962194,-11.208682497475875
2006-06-26T09:30:00-04:00,29.97,30,29.78,29.87,754100,1121020,40.13177854043235,44.10580480423586,NaN,NaN,-125.01897219248724,-113.43436799221658,-0.024740811073227342,-0.17639857893527733,-0.15165776786204999,-22801221,-23308181,53.71665128927812,54.397951297595206,NaN,NaN,-13.49957503966604,-11.5359528606459
2006-06-27T09:30:00-04:00,29.77,29.87,29.49001,29.56,673500,1082500,35.171207356715726,43.060195333774914,NaN,NaN,-168.8054747283184,-123.37058037664524,-0.04476413525242268,-0.20761293692757832,-0.16284880167515564,-23474721,-23186321,54.58673637810948,55.26879864101365,NaN,NaN,-15.92294116326904,-12.162665475306348
2006-06-28T09:30:00-04:00,29.64,29.73,29.42999,29.56,481600,1048030,35.171207356715726,41.94713741175271,NaN,NaN,-156.29064985523323,-137.66369959249477,-0.053483095552756266,-0.229702671116101,-0.17621957556334472,-23474721,-23157641,54.802092853362836,55.66381422608978,NaN,NaN,-17.8777346639067,-12.979103930820683
2006-06-29T09:30:00-04:00,29.81,30.10989,29.73,30.07001,632400,1035840,47.54301062542108,42.01462657060326,NaN,NaN,-56.89798170877267,-124.34348942893394,-0.021990091752470742,-0.20370719025393313,-0.1817170985014624,-22842321,-22928021,56.57752878841024,55.870789028023744,NaN,NaN,-15.817881164344735,-13.384643535609833
2006-06-30T09:30:00-04:00,30.10001,30.39999,30.09,30.24001,1312400,1052975,50.90616602267173,42.69019658792324,NaN,NaN,19.909944438650744,-97.42062680923217,0.01140755280454503,-0.16745765749578112,-0.17886521030032615,-21529921,-22824581,57.38954799923127,55.8467549690315,NaN,NaN,-13.032689539787201,-13.334364393349457
2006-07-03T09:30:00-04:00,30.23,30.36,30.21001,30.3,313800,1024755,52.07386422228944,43.53741141051159,NaN,NaN,38.406660349588044,-64.73550030081711,0.037201648257254444,-0.1323631499787581,-0.16956479823601253,-21216121,-22507561,59.86662917558227,55.943406263533106,NaN,NaN,-10.42817658849071,-12.919194706941065
2006-07-05T09:30:00-04:00,30.25,30.28999,30.16,30.27,1093000,928040,51.415262601069095,44.2535932567544,NaN,NaN,28.11309360927165,-25.35178663329911,0.05105007568180528,-0.10575220363375593,-0.1568022793155612,-22309121,-22274441,61.63291295842103,56.132308711327674,NaN,NaN,-8.50040405440684,-12.287938899436176
2006-07-06T09:30:00-04:00,30.19,30.50999,30.19,30.38,937700,901875,53.72623084952921,44.56766694590716,NaN,NaN,74.55152689789259,20.816648717326068,0.06550335184894712,-0.07492308950437732,-0.14042644135332444,-21371421,-21853781,64.65571951163676,56.590844760471896,NaN,NaN,-6.20185242227798,-11.418497974127861
2006-07-07T09:30:00-04:00,30.3,30.53,30.3,30.41,699600,826890,54.363784872471136,45.124057745451275,NaN,NaN,97.9789030312728,51.79202566533515,0.07432336237624297,-0.04752223838302072,-0.12184560075926369,-20671821,-21419681,67.50123911509053,57.310001430053305,NaN,NaN,-4.120617666091101,-10.375943644408324
2006-07-10T09:30:00-04:00,30.53,30.64,30.46001,30.52,1642100,869420,56.71851109883914,46.129511698712975,NaN,NaN,139.8887754067424,75.7877918589535,0.08408620673724453,-0.01673784233770803,-0.10082404907495256,-19029721,-20919641,70.45222334431674,58.317896045561,NaN,NaN,-1.671713905993437,-9.132482253206197
2006-07-11T09:30:00-04:00,30.57001,30.64999,30.44881,30.59,1552700,908865,58.19670483296951,47.36747942047099,NaN,NaN,133.2244210490538,94.75134399884664,0.09118386061899829,0.013155776698795307,-0.07802808392020298,-17477021,-20171821,74.22208101022059,59.618346064474736,NaN,NaN,0.8188183711537808,-7.710867878297629
2006-07-12T09:30:00-04:00,30.64,30.7,30.42,30.48,677400,889265,55.01687131603771,48.13473112758785,NaN,NaN,108.3911524005531,110.80695575710293,0.0845439480467469,0.027651851138230654,-0.05689209690851625,-18154421,-19340881,77.63636617800023,61.244601330577254,NaN,NaN,2.1375141918860465,-6.303956153985675
2006-07-13T09:30:00-04:00,30.31,30.39999,30.10001,30.16,788700,877550,46.9756698082828,48.53556739424302,NaN,NaN,14.457196913171547,98.78808976015873,0.05604726799020056,0.013166988079234443,-0.042880279910966115,-18943121,-18855221,79.35730592968028,63.213883438296,NaN,NaN,1.003947085894398,-5.259969976859951
2006-07-14T09:30:00-04:00,30.16,30.27,29.85001,29.97,1319700,894760,42.960679477930164,48.59792492724106,NaN,NaN,-37.2436261878557,71.74358391633304,0.023513585802892853,-0.013488297657350046,-0.0370018834602429,-20262821,-18773421,79.64147399880248,65.14560775215307,NaN,NaN,-1.2058880454525598,-4.680815415230324
2006-07-17T09:30:00-04:00,29.92999,30.22,29.92999,30.09,432600,876235,46.094382771326785,49.0238252294478,NaN,NaN,-18.683154013365115,40.02919803231153,0.009884941834494829,-0.02464570616712436,-0.03453064800161919,-19830221,-18933521,77.39578846875186,66.83697469354405,NaN,NaN,-2.143229857018749,-4.318303192628671
2006-07-18T09:30:00-04:00,30.07001,30.21001,29.86,30.09,689000,862795,46.094382771326785,49.80405204477716,NaN,NaN,-24.942002286124126,8.395913365275945,0.00113939616726845,-0.03310640279253363,-0.03424579895980208,-19830221,-19404161,71.05308004978895,68.01314209866402,NaN,NaN,-2.9015033077590173,-4.115903209075863
2006-07-19T09:30:00-04:00,30.19,30.91,30.19,30.8,1708900,924535,60.85257593775101,51.6384355148511,NaN,NaN,131.24139221915877,12.965961328997077,0.04122088226528461,0.01728030387180368,-0.023940578393480925,-18121321,-19397541,71.08897016209062,69.17649047785885,NaN,NaN,1.447304682526085,-3.3211592245612986
2006-07-20T09:30:00-04:00,30.91,31.03999,30.83,30.83,1092700,955875,61.33427183794704,52.62352560146011,NaN,NaN,173.33280872711117,44.741083691785,0.06631510607936002,0.05895330420571909,-0.007361801873640921,-17028621,-19014641,73.16168591666951,70.36107312987738,NaN,NaN,4.964908271858602,-2.1374352965013133
2006-07-21T09:30:00-04:00,30.87,31.03,30.8,30.97,644200,969470,63.5860666631924,53.529232790068725,NaN,NaN,157.0600375584733,83.6018164410508,0.08756892104583341,0.10209934943365084,0.014530428387817432,-16384421,-18238961,76.79165025144151,71.74693757646382,NaN,NaN,8.58472258705979,-0.6056984559925844
2006-07-24T09:30:00-04:00,31.14999,31.63,31.14999,31.57001,1857600,965185,71.30033283856217,54.90255197694535,NaN,NaN,221.47292270381882,131.6330317844876,0.13445865829523662,0.18260375125686323,0.0481450929616266,-14526821,-17178281,80.64639384554852,73.23120648146141,NaN,NaN,14.861776536483731,1.603940828646889
2006-07-25T09:30:00-04:00,31.42,31.92999,31.42,31.84,2366200,1045790,73.97233111602222,56.51377115658486,NaN,NaN,222.56862709456715,181.13515766062585,0.1735908935794492,0.2651337099359381,0.09154281635648889,-12160621,-15644361,84.6238242011459,74.87341442737034,NaN,NaN,20.94371993354088,4.366766415060317
2006-07-26T09:30:00-04:00,31.89999,32.03999,31.73,31.99001,1877800,1106005,75.3457659072875,58.05802366071045,NaN,NaN,210.07126852086586,196.90113292096726,0.19775700841797866,0.3387390768789622,0.14098206846098355,-10282821,-14076661,87.46026634150662,76.5023106295039,NaN,NaN,26.219592025141765,7.488598645071952
2006-07-27T09:30:00-04:00,31.83,31.85001,31.62,31.83,1919500,1177900,71.03965498716066,59.24915724033112,NaN,NaN,154.7375169164984,193.1820745588447,0.19104034086957866,0.3797824945479569,0.1887421536783782,-12202321,-13111401,88.82693701372432,78.0255747651206,NaN,NaN,29.02298186437568,10.564939104972485
2006-07-28T09:30:00-04:00,31.89999,32.10001,31.82001,32,1817000,1237130,72.81714784038768,60.399059864727455,NaN,NaN,149.9312673946118,191.75632052607241,0.18594409008775709,0.4211722662880746,0.2352281762003175,-10385321,-11911581,90.24946402716384,79.43966338532395,NaN,NaN,31.89150256731524,13.611591028164307
2006-07-31T09:30:00-04:00,32.02,32.02,31.83,31.89,463100,1194665,69.83054146043952,61.23004819526102,NaN,NaN,121.30412095601545,171.72256017651173,0.16383788896679774,0.44002553740881467,0.27618764844201693,-10848421,-11175901,91.00562908442443,80.6384882477671,NaN,NaN,33.26895759263531,16.419786251660163
2006-08-01T09:30:00-04:00,31.88,31.96001,31.72,31.89,3115000,1334725,69.83054146043952,62.28816749128972,NaN,NaN,100.66296965406428,147.34142868841116,0.13887554743228475,0.44978208273237286,0.3109065353000881,-10848421,-10913461,91.26584553387305,81.61202248747229,NaN,NaN,34.360952683891945,18.982810027693276
2006-08-02T09:30:00-04:00,32.10001,32.27,32.03,32.09,633700,1311760,72.23210438183533,64.09219853225775,NaN,NaN,111.76970023191066,127.68111503062009,0.12587860691004082,0.46825479393763914,0.3423761870275983,-10214721,-10899841,91.2799453977434,82.46363959233395,NaN,NaN,36.01650762810998,21.416195399181376
2006-08-03T09:30:00-04:00,31.85001,32.03999,31.74001,31.81,2033400,1366545,64.49202863125194,65.63015204320932,NaN,NaN,75.8562174811916,111.90485514355873,0.09014328759229945,0.4550552965179726,0.36491200892567316,-12248121,-10909001,91.1733434886621,83.28734455589536,NaN,NaN,35.067690262412725,23.36640895107157
2006-08-04T09:30:00-04:00,31.95,31.99001,31.75999,31.82001,899700,1376550,64.63791460600837,66.95469003140086,NaN,NaN,67.68463934224343,95.45552953308507,0.06033160334682025,0.44032651310919846,0.3799949097623782,-11348421,-11101621,88.82418967778383,84.10365892796906,NaN,NaN,34.350670730410414,24.935589205262833
2006-08-07T09:30:00-04:00,31.75999,31.84,31.67999,31.72,630800,1325985,61.90149404558668,68.0837694081337,NaN,NaN,51.90915262286302,81.57653586645456,0.0286367892533001,0.41579089632900335,0.38715410707570325,-11979221,-11327781,86.02165830765037,85.17284308924488,NaN,NaN,32.95611379736276,26.08137843270568
2006-08-08T09:30:00-04:00,31.75999,31.87,31.64259,31.71001,1020700,1299385,61.620866657051856,68.1386473166552,NaN,NaN,46.853520535563796,70.81464604275446,0.0031027574428196814,0.39103255387922786,0.3879297964364082,-12999921,-11758081,80.79816593350122,85.86635707291705,NaN,NaN,31.734149361543423,26.88891713682536
2006-08-09T09:30:00-04:00,31.92999,32.05,31.72,31.74001,739700,1302500,62.17542020159432,68.19872934263,NaN,NaN,52.0149680574886,58.863699607870046,-0.01468628268210781,0.3695719430837734,0.3842582257658812,-12260221,-12167181,76.06880391899325,86.07400835879733,NaN,NaN,30.851983089980322,27.455069415847497
2006-08-10T09:30:00-04:00,31.53999,31.8,31.53999,31.71001,680000,1297065,61.22274296381317,68.02992050696005,NaN,NaN,32.01049880352457,50.09455587233664,-0.030483968005706852,0.3461532657587476,0.37663723376445446,-12940221,-12305601,74.48027051993981,85.90890980654721,NaN,NaN,29.85703123468258,27.798206818538223
2006-08-11T09:30:00-04:00,31.64,31.67999,31.45,31.56,456200,1253890,56.55624315435448,66.97677124380236,NaN,NaN,11.267045401837878,38.81103708425553,-0.05179464865509181,0.3118939229455897,0.3636885716006815,-13396421,-12715201,69.83301710604235,85.13652575372534,NaN,NaN,27.716394686841046,27.786519371152913
2006-08-14T09:30:00-04:00,31.67999,31.88,31.60001,31.63,408700,1252695,58.158912553200054,65.84724134645792,NaN,NaN,24.39166535133058,33.30753962994905,-0.061285052178546295,0.2870822563774986,0.3483673085560449,-12987721,-12916901,67.5963119201268,83.9202748765097,NaN,NaN,26.27991848959216,27.57129067378709
2006-08-15T09:30:00-04:00,31.87,31.94,31.77,31.89999,651400,1250815,63.7184285236845,65.01671724762915,NaN,NaN,51.76335542422279,34.28950660768085,-0.049966656743943794,0.28590898762611516,0.33587564437005896,-12336321,-12784181,68.31544733519465,82.55278780463027,NaN,NaN,26.488602124118827,27.416620880977337
2006-08-16T09:30:00-04:00,32,32.17999,31.99001,32.17999,1290600,1229900,68.40680617046384,64.8286566178651,NaN,NaN,121.57079207489805,48.20067141116273,-0.02544633931455259,0.30406772022686823,0.3295140595414208,-11045721,-12541281,69.64329041606985,81.18252733336922,NaN,NaN,28.101557376286436,27.51446895173578
2006-08-17T09:30:00-04:00,32.14999,32.36,32.14999,32.25999,998300,1225180,69.61493515478642,64.59992714032214,NaN,NaN,166.85724348721547,75.17002034790092,-0.006642243909076195,0.3212112546550756,0.3278534985641518,-10047421,-11962721,72.58985571286316,79.92112673949062,NaN,NaN,29.79794570578371,27.84067991659977
2006-08-18T09:30:00-04:00,32.2,32.32001,32.12,32.31,484900,1217215,70.37752781841245,64.63899759446306,NaN,NaN,168.13411653568386,106.54343457467012,0.005694539799547094,0.3349716733135857,0.3292771335140386,-9562521,-11195941,75.92513556255098,78.84394863078536,NaN,NaN,31.42063161220751,28.352101587400874
2006-08-21T09:30:00-04:00,32.28,32.3,32.14999,32.2,468900,1147780,66.42835218369812,64.39598407469582,NaN,NaN,133.8216925799605,128.42944002039607,0.0031065798460997995,0.33316035832166335,0.33005377847556355,-10031421,-10604681,78.1345250307465,77.90599716627632,NaN,NaN,31.689207691077094,28.828831030783192
2006-08-22T09:30:00-04:00,32.12,32.34,32.08,32.3,376200,1048280,68.17663061557514,64.10630737710581,NaN,NaN,122.95093465875154,142.66695586730185,0.004694373720607048,0.3359217456263224,0.33122737190571533,-9655221,-10068461,79.93313558705131,77.0955107512269,NaN,NaN,32.412218065803536,29.340743464357526
2006-08-23T09:30:00-04:00,32.33,32.33,32.21001,32.28,422000,975490,67.42041775395836,64.3154780287277,NaN,NaN,115.12364732074113,141.37752691647046,0.0011473953326684994,0.332661616071551,0.3315142207388825,-10077221,-9874761,80.55536330204077,76.33708359503964,NaN,NaN,32.80588042214866,29.83576302975626
2006-08-24T09:30:00-04:00,32.46001,32.56,32.41,32.5,701200,914575,71.20411458178299,64.78449231271159,NaN,NaN,159.10371829954107,139.8268218789356,0.009881603806081163,0.34386622549648393,0.33398462169040277,-9376021,-9740481,80.99530698792762,75.77787768862133,NaN,NaN,34.256397145994306,30.46728218921884
2006-08-25T09:30:00-04:00,32.45,32.58,32.38,32.52,394300,843440,71.52784474116162,65.47208879096695,NaN,NaN,134.4445584800279,133.08891026780438,0.013069505699842332,0.35032150381520566,0.3372519981153633,-8981721,-9624321,81.38761682206783,75.44687472536545,NaN,NaN,35.54234538790297,31.192291217602286
2006-08-28T09:30:00-04:00,32.55,32.86,32.50999,32.73,335000,837035,74.73910457805214,66.40910578532412,NaN,NaN,160.52050841343333,138.42867343449896,0.024709543072438334,0.3681389269559112,0.3434293838834729,-8646721,-9347381,82.32443520440776,75.55589395900162,NaN,NaN,37.65334800877386,32.1152993306268
2006-08-29T09:30:00-04:00,32.77,32.89999,32.73,32.88,845800,723575,76.75574036524048,67.45055722558456,NaN,NaN,166.49672496353742,147.13783149545614,0.03715164734882287,0.3898689430695015,0.3527172957206786,-7800921,-8976521,83.52063283687174,76.08816745313581,NaN,NaN,40.09239227427231,33.25488403686187
2006-08-30T09:30:00-04:00,32.94,32.97,32.86,32.89999,685700,726175,77.0190417128476,68.57886427908701,NaN,NaN,155.07932163256126,155.12896635782016,0.04106262536386229,0.4040455774255065,0.3629829520616442,-7115221,-8384121,85.23906802350754,76.85665298910492,NaN,NaN,42.161894111778246,34.527314047564204
2006-08-31T09:30:00-04:00,32.89999,32.91,32.75,32.8,375900,643300,72.58968426509645,69.72411007271145,NaN,NaN,121.71356112783147,147.65093492347825,0.03167100544937834,0.40257170887336713,0.3709007034239888,-7491121,-8007141,86.22357141287178,78.02740686816416,NaN,NaN,42.69014110699519,35.69343219891149
2006-09-01T09:30:00-04:00,32.8,33.00999,32.8,32.97,2468600,721745,75.20096974147754,70.94139987187413,NaN,NaN,127.40981589773456,146.24398640701958,0.03159184552797806,0.41039051033396134,0.3787986648059833,-5022521,-7215301,88.02956852445071,79.48692519704444,NaN,NaN,43.92058655075808,36.868739963461
2006-09-05T09:30:00-04:00,32.95,33,32.82001,32.82001,805700,730490,68.95889880314758,71.31571917755005,NaN,NaN,105.28220388807412,135.19632550194774,0.016860686360457344,0.399874522756555,0.38301383639609765,-5828221,-6651601,89.12275579689442,80.97316151573729,NaN,NaN,43.12105032252778,37.7619271576134
2006-09-06T09:30:00-04:00,32.84,32.84,32.62,32.7,1378000,748355,64.35597340180726,71.02637397978887,NaN,NaN,68.1710962579582,115.5311997608319,-0.0044070057260302,0.3775050792385599,0.3819120849645901,-7206221,-6532661,89.34388606869531,82.38034691949625,NaN,NaN,41.049874068385364,38.231633859152254
2006-09-07T09:30:00-04:00,32.56,32.63,32.42999,32.46001,1418700,782305,56.26758027746167,70.07299148855138,NaN,NaN,25.097816019151693,89.53489863815,-0.03630358129740918,0.3365326083428286,0.3728361896402378,-8624921,-6834601,84.6397375088515,83.24105276206684,NaN,NaN,36.60071009706021,37.99864475028196
2006-09-08T09:30:00-04:00,32.53999,32.75,32.48,32.72,468700,771740,61.86002807064733,69.46459864942531,NaN,NaN,46.22208621599596,74.43660365578289,-0.04119976516259288,0.3213364831869967,0.3625362483495896,-8156221,-6967621,82.57694299600016,83.71618186445608,NaN,NaN,34.49272156203686,37.49779858053266
2006-09-11T09:30:00-04:00,32.72,32.94,32.60001,32.92999,1016900,799775,65.67772264178146,69.41098225357412,NaN,NaN,76.73465607783199,64.30157169180237,-0.03201294113429565,0.32252007193172005,0.3545330130660157,-7139321,-7390981,76.21080875194866,83.57877355882765,NaN,NaN,33.981993108599724,36.995540655970814
2006-09-12T09:30:00-04:00,33.03,33.33,33.00999,33.31,1090100,833845,71.28023462394599,69.63266825417203,NaN,NaN,151.78070479491763,73.60127187317107,-0.0035575059169601353,0.35008613066981553,0.35364363658677567,-6049221,-7435181,75.55589744297478,83.26611369139361,NaN,NaN,35.55083283802312,36.78915382483543
2006-09-13T09:30:00-04:00,33.33,33.34,33.16,33.24001,905700,846560,69.04479326021907,69.7486950760478,NaN,NaN,146.37703780742999,89.24246018306543,0.006773600121811163,0.36211063673903965,0.3553370366172285,-6954921,-7384921,75.81045066297597,82.92719136003186,NaN,NaN,36.004911749624405,36.67711924266243
2006-09-14T09:30:00-04:00,33.14999,33.23,33.07001,33.2,557400,809900,67.7370051203355,69.50104440023011,NaN,NaN,117.53400905396593,107.72969879002828,0.0071009692645819245,0.36421324819795586,0.35711227893337394,-7512321,-7162401,76.95469358643227,82.6385761170679,NaN,NaN,35.94217124376675,36.572126671391615
2006-09-15T09:30:00-04:00,33.25,33.28999,33.14,33.14,1963500,858160,65.72645882579161,69.0866596919894,NaN,NaN,112.5170496147604,120.98869146978116,-0.00015087095093441194,0.35692369024470594,0.35707456119564035,-9475821,-7426321,72.5700355463748,82.00874888308981,NaN,NaN,35.27408945160708,36.386692782850965
2006-09-18T09:30:00-04:00,33.14,33.22,33.07001,33.13,1559700,911900,65.37815824278995,68.41802066804209,NaN,NaN,92.11321892905553,124.06440404002588,-0.008581832255045385,0.3463472708768336,0.354929103131879,-11035521,-8205561,61.439156181164684,80.51694323857245,NaN,NaN,34.63563305805467,36.13654139359435
2006-09-19T09:30:00-04:00,33.14,33.19,33.00999,33.17999,693900,923150,66.33847729480473,67.67393044872526,NaN,NaN,83.37670991005409,110.38360506305317,-0.013461897506987452,0.3381017312481447,0.35156362875513214,-10341621,-9064041,51.980006511058555,78.26404135815723,NaN,NaN,34.37139345342422,35.884377402141475
2006-09-20T09:30:00-04:00,33.2,33.42999,33.17999,33.31,716900,940185,68.76500432264315,67.08435634942494,NaN,NaN,121.05478951326019,105.31915540421922,-0.010723136975123393,0.3381597075362279,0.3488828445113513,-9624721,-9598001,47.12062372120939,75.5412953365645,NaN,NaN,34.83000023373236,35.733752092368746
2006-09-21T09:30:00-04:00,33.33,33.33,33.05,33.10001,572800,947725,61.10334402025342,66.2639034747933,NaN,NaN,72.75293803991019,96.36294120140806,-0.02502617989559336,0.31760011964185964,0.342626299537453,-10197521,-10135041,42.78801459564886,72.43875556390573,NaN,NaN,32.951612363781514,35.33630355971343
2006-09-22T09:30:00-04:00,33,33.07001,32.83,32.89,1020700,963700,54.556554244426856,64.7893023678611,NaN,NaN,-2.4338235071264256,73.37276657703069,-0.04920514254785313,0.2811198713526366,0.33032501390048974,-11218221,-10483521,40.20473400950377,69.02269595569523,NaN,NaN,29.24605889931298,34.46626860822765
2006-09-25T09:30:00-04:00,33,33.09,32.81,33.02,795700,983770,57.585983913141675,63.97695130428925,NaN,NaN,4.211708166702645,55.7924644245601,-0.05649584683588238,0.2597052053556368,0.31620105219151917,-10422521,-10360921,41.54191840378865,65.62406471333053,NaN,NaN,27.04896130098235,33.40665327862118
2006-09-26T09:30:00-04:00,33.02,33.07001,32.9252,33.05,774200,1005730,58.277218497993616,63.542754525445424,NaN,NaN,14.218579842098443,41.960838410969004,-0.05907212811394169,0.24236089204909206,0.30143302016303375,-9648321,-10222261,43.09196063115458,62.3203557535062,NaN,NaN,25.471953089691475,32.27312468020265
2006-09-27T09:30:00-04:00,33.09,33.14,32.89,33.14,1074300,1017155,60.36415904795952,63.8353672947667,NaN,NaN,26.173947587064905,22.984670025729947,-0.05459475030310906,0.23318958228414743,0.2877843325872565,-8574021,-10012121,45.452524950338024,59.52126914218381,NaN,NaN,24.742266546704695,31.197287803988655
2006-09-28T09:30:00-04:00,33.14,33.14,32.98,33.08,463800,1006060,58.27155595393347,63.57904785785856,NaN,NaN,27.123532874759714,13.858788992699857,-0.05537920426413534,0.2185603272570873,0.27393953152122263,-9037821,-9780181,48.0156311371302,57.05260400940738,NaN,NaN,23.537239202567925,30.102995146642836
2006-09-29T09:30:00-04:00,33.27,33.27,33.06,33.19,575800,1016055,60.94465070344052,63.24097129083422,NaN,NaN,62.57954148549706,26.86146199122455,-0.0484453268106681,0.2133828730078875,0.2618281998185556,-8462021,-9228941,53.59639242787445,55.43728855768779,NaN,NaN,23.25504394616218,29.124716403717027
2006-10-02T09:30:00-04:00,33.08,33.2,32.97,33,423200,913785,54.45574497728899,62.039222030358715,NaN,NaN,14.591909030290259,28.937502163942078,-0.056072116515340775,0.1917380541743796,0.2478101706897204,-8885221,-8921481,56.4074243836498,54.069540482021715,NaN,NaN,21.07065787211323,27.974136613487914
2006-10-03T09:30:00-04:00,32.98,33.21001,32.94,33.10001,1416100,944305,57.04809033987383,61.182314678905485,NaN,NaN,22.125424043686802,30.51887100425975,-0.053789881009222246,0.1805728194281926,0.23436270043741483,-7469121,-8485641,60.09751574373577,52.94718798779028,NaN,NaN,19.98318479307834,26.83257206771512
2006-10-04T09:30:00-04:00,33.06,33.39,33.02,33.39,1627800,956795,63.5302068779784,60.881829090165695,NaN,NaN,96.03279161767328,44.490639810381424,-0.033169821235673524,0.19290042389282291,0.22607024512849644,-5841321,-7939101,64.1910271330079,52.035497526831385,NaN,NaN,21.061583397718444,26.00814511485845
2006-10-05T09:30:00-04:00,33.28,33.39,33.21001,33.39,1045300,938125,63.530206877978394,60.72495395103618,NaN,NaN,124.72041853978146,64.01001694338578,-0.02056778967867623,0.20036050803015115,0.22092829770882738,-5841321,-7299801,68.28903645390753,51.72971187736943,NaN,NaN,21.91286459464978,25.423105040542925
2006-10-06T09:30:00-04:00,33.48,33.48,33.16,33.25999,1331700,981275,58.9077793421746,60.262784029563655,NaN,NaN,106.92637905606371,72.8793844574991,-0.021901978510700998,0.19355082457045114,0.21545280308115214,-7173021,-7042001,69.79041013671934,52.326230017051905,NaN,NaN,21.255950979308043,24.827797317509372
2006-10-09T09:30:00-04:00,33.25,33.25999,33.09,33.19,806800,970770,56.5234701279033,59.561712089070696,NaN,NaN,22.903226267061658,74.54164790485338,-0.0280209246882204,0.18042664722087665,0.20844757190909705,-7979821,-6860921,70.83492520907092,53.6730099240528,NaN,NaN,20.00782003640262,24.139229134494123
2006-10-10T09:30:00-04:00,33.24001,33.24001,32.89,33.05,1355100,984020,51.990425227407904,58.363527867982455,NaN,NaN,-59.92339420702779,58.131884254710464,-0.04122210809248908,0.1569199367934857,0.19814204488597478,-9334921,-7234081,65.7869316179193,55.00631763096065,NaN,NaN,17.568927437573997,23.200614606362677
2006-10-11T09:30:00-04:00,32.95,33.11,32.88,33.03999,736700,975570,51.67134368349146,57.68981355821374,NaN,NaN,-86.89930127265059,21.545465676645694,-0.04978066109440962,0.13591621851796276,0.18569687961237238,-10071621,-8080141,56.036322569218335,55.95262534335847,NaN,NaN,15.496874599476687,22.100080319664677
2006-10-12T09:30:00-04:00,33.03999,33.27,33.03,33.24001,890600,992230,57.30945955387032,57.88644965174542,NaN,NaN,35.889555983990014,3.779293165487407,-0.04146356568427906,0.13386742250702355,0.1753309881913026,-9181021,-8748081,49.76528271134029,56.63552167920393,NaN,NaN,15.299374365862231,21.1285508976929
2006-10-13T09:30:00-04:00,33.14,33.16,33.00999,33.13,3143600,1051235,53.60537381864389,57.602120359281294,NaN,NaN,-18.957143076191386,-21.397411260963615,-0.0426960231298415,0.12196095927900075,0.16465698240884225,-12324621,-9778401,41.96399761350122,56.6656701941834,NaN,NaN,14.027688184006967,20.11414193859491
2006-10-16T09:30:00-04:00,33.03999,33.2,33,33.17999,969700,1021735,55.027815140471425,57.37002011945828,NaN,NaN,1.1691657104903315,-25.744223372277883,-0.03954120875987929,0.11523047145899312,0.15477168021887242,-11354921,-10453421,37.78485988755782,56.28659156964078,NaN,NaN,13.385919468330536,19.15296729998571
2006-10-17T09:30:00-04:00,33.2,33.31,33.06,33.27,1388400,1056460,57.551424389055484,57.16911050096514,NaN,NaN,59.1845254751885,-1.9226394358346255,-0.031157812674769636,0.11582441437541036,0.14698222705018,-9966521,-10579741,37.04143383011329,55.685799346767574,NaN,NaN,13.566795697078362,18.35494278528466
2006-10-18T09:30:00-04:00,33.39,33.64999,33.36,33.63,755700,1058400,65.814113186806,57.70786458902746,NaN,NaN,250.7962648194373,65.61647378258296,-0.0026355683289630283,0.1436877666389762,0.14632333496793923,-9210821,-10407581,38.80851214187238,55.02814798996344,NaN,NaN,16.47339843868492,18.08615073577041
2006-10-19T09:30:00-04:00,33.61,33.78,33.60001,33.60001,1428000,1101160,64.6845322241956,57.97499898336711,NaN,NaN,243.3462959788029,107.10782178154554,0.012131889054034534,0.1614881962854824,0.14935630723144785,-10638821,-10699141,36.918662313789916,53.83688155324313,NaN,NaN,18.434252992183694,18.135879629543737
2006-10-20T09:30:00-04:00,33.62,33.86,33.55,33.86,1987400,1149495,69.56185380132263,59.05400675651237,NaN,NaN,226.02113200182106,156.10347679714803,0.035982173049832894,0.19433402354373897,0.15835185049390607,-8651421,-9964501,44.28128744236608,52.97072891458,NaN,NaN,21.822540199816423,18.66254542529698
2006-10-23T09:30:00-04:00,33.75,33.95,33.66,33.95,772700,1148345,71.05225018175913,60.05430388807561,NaN,NaN,205.55641833398056,196.98092732184608,0.05334475018196516,0.22503278822136252,0.17168803803939736,-7878721,-9269261,50.20461502829446,52.26409314919134,NaN,NaN,25.063549571481563,19.576974589037633
2006-10-24T09:30:00-04:00,33.84,33.84,33.64999,33.84,689200,1144095,66.75024144058365,60.28430635683312,NaN,NaN,147.89397736766364,214.7228177003411,0.052845667116424716,0.23774512193492825,0.18489945481850353,-8567921,-8989541,52.39726851708607,51.421681819482636,NaN,NaN,26.40794151551792,20.552827007106245
2006-10-25T09:30:00-04:00,33.85001,33.85001,33.52,33.64,1141500,1147455,59.67548630817689,60.00896917327587,NaN,NaN,99.15663483209825,184.39489170287328,0.03531336852730854,0.2290411654776392,0.19372779695033066,-9709421,-9089261,51.52619972149395,50.224336338595954,NaN,NaN,25.287095389282367,21.229151061702833
2006-10-26T09:30:00-04:00,33.72,33.78,33.50999,33.77,2016300,1225080,62.46060603330623,60.26274250835671,NaN,NaN,89.75385508022602,153.67640352315792,0.029003395248818675,0.229982041011354,0.20097864576253532,-7693121,-8500121,56.162876104242216,49.25094105056187,NaN,NaN,25.242751358566935,21.80252253268342
2006-10-27T09:30:00-04:00,33.66,33.70731,33.55,33.63,829900,1237785,57.82842561787725,60.35595361478341,NaN,NaN,65.72147255329517,121.61647163345273,0.012761263453135108,0.2169302250789542,0.2041689616258191,-8523021,-8474441,56.35883152352561,48.2169343587372,NaN,NaN,23.724579197522093,22.0771020562318
2006-10-30T09:30:00-05:00,33.5,33.61,33.42999,33.44,1657400,1299495,52.17335202430046,60.369019814561454,NaN,NaN,25.846354556146927,85.67445887788601,-0.012074682187301983,0.18907560889169162,0.2011502910789936,-10180421,-8934781,51.881719467901114,47.223704919450185,NaN,NaN,20.575738148791302,21.862621498026016
2006-10-31T09:30:00-05:00,33.45,33.50999,33.22,33.3,1331500,1295265,48.416296797341275,60.136516465550734,NaN,NaN,-18.349157771905062,52.42583184997228,-0.037776718711806434,0.15392939268923556,0.191706111401042,-11511921,-9523581,46.76458488974766,46.56143794234514,NaN,NaN,16.731353341302828,21.129583189922702
2006-11-01T09:30:00-05:00,33.25,33.57001,33.0173,33.06,1867200,1307235,42.73496583643012,59.09548120001928,NaN,NaN,-52.71083207097256,22.052338469358133,-0.0689699265966417,0.10549370315523987,0.17446362975188157,-13379121,-10257521,41.296856731377964,45.95655037234783,NaN,NaN,11.475680557349223,19.750454242412204
2006-11-02T09:30:00-05:00,32.96001,33.27921,32.96001,33.24001,1797800,1344860,47.6927798906178,58.673153062303136,NaN,NaN,-63.810731244955285,-8.660578795678127,-0.07500844141285762,0.08070307798580956,0.15571151939866718,-11581321,-11035161,36.43589709353951,45.561686049493424,NaN,NaN,8.728676009462887,18.175914494848016
2006-11-03T09:30:00-05:00,33.3,33.37,33.03999,33.07001,735000,1315025,43.83319326105282,57.87353721377324,NaN,NaN,-60.34103817212868,-33.8730809407629,-0.08712979411840452,0.046799276750661534,0.13392907086906605,-12316321,-11793821,32.425848415441266,45.17889951577081,NaN,NaN,5.15838291071945,16.316267125686792
2006-11-06T09:30:00-05:00,33.2,33.53,33.06,33.47,896900,1319530,53.390718620395546,57.57634394458324,NaN,NaN,-12.498213703911139,-41.541994592774515,-0.06585431380564774,0.05161117861200637,0.11746549241765411,-11419421,-12041621,31.217326090682278,44.76289182009716,NaN,NaN,5.372632353754133,14.752890729696412
2006-11-07T09:30:00-05:00,33.42999,33.83,33.42999,33.73,957800,1299665,58.35174394312792,57.04331757003481,NaN,NaN,63.86344185011513,-25.099474668370508,-0.03354538085096388,0.07553376635394926,0.10907914720491314,-10461621,-11831561,33.48060644142542,44.38232712720809,NaN,NaN,7.356130657496385,13.696210719382123
2006-11-08T09:30:00-05:00,33.32001,33.32001,33.07001,33.22,2985100,1412085,47.6401587090504,55.825862318953014,NaN,NaN,-67.29664251078746,-28.01663675633349,-0.04507772561839017,0.052731990181925426,0.0978097158003156,-13446721,-11845081,33.40441937712184,44.13130977458895,NaN,NaN,4.940809344488683,12.445439094397345
2006-11-09T09:30:00-05:00,33.07001,33.19,32.28,32.44,4776398,1606374.9,36.58016895386763,53.47002768699195,NaN,NaN,-198.00707389644006,-54.855905286630446,-0.1006124173221443,-0.02795580585236479,0.07265661146977952,-18223119,-13173440.6,26.92221930164895,42.89137633596629,NaN,NaN,-2.055733548191202,10.373843002598981
2006-11-10T09:30:00-05:00,32.37,32.53999,32.25999,32.49001,1914500,1544919.9,37.580738060216035,51.07920539259601,NaN,NaN,-214.67410526093585,-85.72251870439189,-0.12761709211645034,-0.08686475367578339,0.04075233844066693,-16308619,-13971900.2,23.917792857008237,41.01374618087441,NaN,NaN,-6.590643143051321,7.950344981791796
2006-11-13T09:30:00-05:00,32.32001,32.7,32.32001,32.55,1603300,1576599.9,38.82750391948445,49.08472414108893,NaN,NaN,-169.15236098777962,-117.05334816116559,-0.13439630990225027,-0.1272430489371459,0.007153260965104366,-14705319,-14629079.8,21.764896445920712,38.8257196043626,NaN,NaN,-9.506852817285743,5.456459581923576
2006-11-14T09:30:00-05:00,32.41,32.85001,32.38,32.82001,2427800,1628569.9,44.227257520185425,47.981279227660956,NaN,NaN,-119.45277183320601,-153.7165908978298,-0.11443392313803996,-0.13588914295744559,-0.021455219819405628,-12277519,-14992259.4,20.658228899244236,36.62086454563048,NaN,NaN,-9.960227502900484,3.254075712662996
2006-11-15T09:30:00-05:00,32.77,33.12,32.72,32.98,1415900,1661579.9,47.201244740421,46.89132484959773,NaN,NaN,-63.83830167181679,-153.02492273003568,-0.0855172793281008,-0.12835181897953163,-0.04283453965143083,-10861619,-14475239,26.395873562570358,34.4946500783682,NaN,NaN,-9.30208013248307,1.4603391633564153
2006-11-16T09:30:00-05:00,32.97,33.19,32.97,33.12,801400,1630249.9,49.72744589039606,46.31268344049193,NaN,NaN,-31.61102700671667,-119.74571335209097,-0.053584942847447324,-0.10981571821073999,-0.056230775363292664,-10060219,-12842659,40.923589334740875,33.3921327791693,NaN,NaN,-7.941918745147005,0.11715946214164097
2006-11-17T09:30:00-05:00,33.03,33.23,33.03,33.22,1078200,1584789.9,51.51202156937252,46.26544555085422,NaN,NaN,-14.605171987590609,-79.73192669742194,-0.023866950097309055,-0.08606446298492898,-0.062197512887619925,-8982019,-11377339,50.38856770855221,33.28547908207295,NaN,NaN,-6.2842214375232155,-0.797323523524767
2006-11-20T09:30:00-05:00,33.22,33.28999,33.07001,33.14,1454500,1618879.9,49.98338462631572,46.37738039578097,NaN,NaN,-7.175709610025093,-47.33659642187104,-0.008527513265228368,-0.07285690446915538,-0.06432939120392701,-10436519,-10523579,54.92039771503193,33.86803714102183,NaN,NaN,-5.3951728389517,-1.4541591400143288
2006-11-21T09:30:00-05:00,33.22,33.22,33.02,33.09,1509900,1659914.9,49.00457753428428,46.82520980277055,NaN,NaN,-13.52140281147169,-26.15032261752419,-0.00107042950742188,-0.06566742808820436,-0.06459699858078248,-11946419,-10457359,55.26175474210061,34.865529856073444,NaN,NaN,-4.949806902142982,-1.9535373917469936
2006-11-22T09:30:00-05:00,33.06,33.19,33.02,33.16,1215000,1663589.9,50.4670194529985,47.02336977151202,NaN,NaN,-3.9944121034751117,-14.181544703855858,0.008715794780647532,-0.05370225510497306,-0.062418049885620594,-10731419,-10431319,55.404760577206254,36.22044867633536,NaN,NaN,-4.167436123573129,-2.2698086391507273
2006-11-24T09:30:00-05:00,33.00999,33.08,32.98,33.02,118700,1568709.9,47.53112648214897,47.28750785873318,NaN,NaN,-21.90047335318226,-12.239433973148952,0.0060272947209501285,-0.054883931484432935,-0.060911226205383064,-10850119,-10589299,54.271339802639744,37.7808409182781,NaN,NaN,-4.3098135613867115,-2.5612379137558676
2006-11-27T09:30:00-05:00,32.94,32.98,32.69,32.8,1512900,1602859.9,43.271122074464074,46.56467953402379,NaN,NaN,-67.399772674732,-22.79835411057723,-0.00945833579796812,-0.07273414595284322,-0.0632758101548751,-12363019,-11265499,49.59466878236103,39.093508253398014,NaN,NaN,-5.662887595389994,-3.0043307254178857
2006-11-28T09:30:00-05:00,32.74001,32.95,32.74001,32.87,1389200,1589449.9,44.96140469159021,45.608226730342516,NaN,NaN,-51.07512626315942,-31.578237441204102,-0.013624497458893756,-0.0803064319784923,-0.06668193451959854,-10973819,-11372959,48.873894017135505,40.19302879452017,NaN,NaN,-6.319770094516997,-3.477964921003473
2006-11-29T09:30:00-05:00,32.92999,33.12,32.91,33.10001,1137700,1579759.9,50.210957046511545,45.79185518301831,NaN,NaN,7.411783629867715,-27.391600152936217,-0.0002349208825322413,-0.06697558562276384,-0.0667406647402316,-9836119,-10950899,51.83470604297248,41.50947784208092,NaN,NaN,-5.379017460948534,-3.7495438552813387
2006-11-30T09:30:00-05:00,33.14999,33.36,33.13,33.25999,1195400,1546169.9,53.53084454857233,47.002617725497224,NaN,NaN,68.06896676143475,-12.978924379954245,0.01898773301549679,-0.04300599847086062,-0.06199373148635741,-8640719,-10532759,54.63753727433819,43.48914341155872,NaN,NaN,-3.596009003178127,-3.72761030498088
2006-12-01T09:30:00-05:00,33.3,33.36,33.03,33.23,833400,1497949.9,52.819824252874795,48.09112388211571,NaN,NaN,54.14669112048162,2.230508514778532,0.028692045012181533,-0.026128675221130493,-0.054820720233312026,-9474119,-10257559,56.4344116461004,45.811759039351024,NaN,NaN,-2.327812851133625,-3.527639240145558
2006-12-04T09:30:00-05:00,32.89,33.14,32.89,33.07001,1611400,1541769.9,49.074937302980445,48.823083409508286,NaN,NaN,5.148571510680154,16.740177351860964,0.02356003736486767,-0.02537067352722744,-0.04893071089209511,-11085519,-10002059,58.09408850970107,48.40670132962105,NaN,NaN,-2.272727134130995,-3.3483660821434773
2006-12-05T09:30:00-05:00,33.13,33.25,33.03,33.2,1009100,1547379.9,52.049587460887494,49.38182126241558,NaN,NaN,47.475284431206006,36.45025949073405,0.02785008837606799,-0.014118100422010116,-0.04196818879807811,-10076419,-9822579,59.26797419376737,51.16454027922985,NaN,NaN,-1.382503933522026,-3.0675286323404127
2006-12-06T09:30:00-05:00,33.17,33.28,33.02,33.25,1639600,1581469.9,53.182400426453,49.80904666856072,NaN,NaN,67.36524493985351,48.44095175273121,0.032652560742159976,-0.0011524878703781383,-0.033805048612538115,-8436819,-9542719,61.09789811404478,53.64325631862088,NaN,NaN,-0.32534390840191113,-2.6757879574920556
2006-12-07T09:30:00-05:00,33.25999,33.42999,33.16,33.17999,605000,1462464.9,51.35300950308912,49.925158355181644,NaN,NaN,90.21983468575158,52.87112533759457,0.02979127572348477,0.003434046041817851,-0.02635722968166692,-9041819,-9622939,60.262163756944105,55.02458306306396,NaN,NaN,0.0840350661299524,-2.2815275255460543
2006-12-08T09:30:00-05:00,33.14999,33.32001,33.02,33.24001,827600,1265025,52.850407088720466,50.02075732084936,NaN,NaN,65.88963329924321,55.219713773346896,0.030506799819098113,0.01177627009220572,-0.018730529726892393,-8214219,-9370959,62.01956147689602,55.85536833223137,NaN,NaN,0.8312530548981983,-1.8368445854825897
2006-12-11T09:30:00-05:00,33.3,33.36,33.19,33.31,348900,1186745,54.605145817726246,50.35088312023583,NaN,NaN,101.24321265975908,74.43864200316268,0.03399342055838385,0.02376124597108742,-0.01023217458729643,-7865319,-8726919,66.14119118033183,56.65685357975279,NaN,NaN,1.938411583996871,-1.2975222755569527
2006-12-12T09:30:00-05:00,33.32001,33.32001,33.14999,33.32001,1073900,1160275,54.86387271183427,50.76940420434654,NaN,NaN,91.1907912022216,83.1817433573658,0.03512887521094578,0.03367891942638579,-0.0014499557845599857,-6791419,-8069919,69.74783064810255,57.69157328732435,NaN,NaN,2.9382961828106064,-0.6924053529330156
2006-12-13T09:30:00-05:00,33.3,33.44,33.22,33.25,720200,1074895,52.60559389301744,50.922159521490755,NaN,NaN,112.06519403018504,92.12173317543211,0.029544386829731203,0.03548052775260402,0.005936140922872816,-7511619,-7884879,70.6946410794998,58.78370760891676,NaN,NaN,3.245506785730204,-0.1298464759811272
2006-12-14T09:30:00-05:00,33.42,33.59,33.31,33.42,1075700,1057885,57.211276046456334,51.613598776084146,NaN,NaN,179.06997435205108,109.89176110869201,0.03529025630981892,0.05004896131014647,0.014758705000327547,-6435919,-7363699,73.23545671466725,60.138287388347294,NaN,NaN,4.7582173616297965,0.5684483579632904
2006-12-15T09:30:00-05:00,33.3,33.48,33.27,33.41,709400,1053285,56.86123503662809,52.58432113052443,NaN,NaN,130.7173788754043,122.85731022392422,0.036268953499328974,0.06009489687448877,0.023825943375159794,-7145319,-7149919,74.22270735700837,61.8974330008221,NaN,NaN,5.940418481426702,1.3358726613152063
2006-12-18T09:30:00-05:00,33.48,33.57001,33.39999,33.48,1903800,1094565,58.76321030270721,53.57016438846136,NaN,NaN,158.53170167224945,134.31500802642228,0.03923112335261717,0.07286484756593126,0.033633724213314085,-5241519,-6625159,76.51291587408782,63.87164884774727,NaN,NaN,7.468454711352604,2.2119558113205486
2006-12-19T09:30:00-05:00,33.39999,33.7,33.39999,33.64999,1605100,1102095,63.02643745597605,54.485555846280256,NaN,NaN,175.4091393840262,151.1586776627832,0.049572926146211074,0.09559988189607793,0.04602695574986686,-3636419,-5994159,78.93631723780658,65.80747821880684,NaN,NaN,10.046226469519949,3.331137333920463
2006-12-20T09:30:00-05:00,33.78999,33.78999,33.60001,33.67,1349000,1094050,63.50473542853058,55.19797662342013,NaN,NaN,185.15681485627235,165.77700182800066,0.054313645562455784,0.11391901270293658,0.0596053671404808,-2287419,-4949319,82.20962259032859,67.77691288423473,NaN,NaN,12.341563438223794,4.618341063106653
2006-12-21T09:30:00-05:00,33.62,33.74001,33.52,33.58,498800,1058240,59.76018828458257,55.69371691139926,NaN,NaN,135.79038219290788,157.12108339617203,0.048150825101984845,0.11979389851796185,0.071643073415977,-2786219,-4219379,84.07187646583773,69.75101751421596,NaN,NaN,13.37229918079993,5.868906508491407
2006-12-22T09:30:00-05:00,33.64,33.64,33.35001,33.44,275000,1066055,54.387828147945854,56.07320911461107,NaN,NaN,75.32869905447572,146.04334743198632,0.03217631365437812,0.11186346548394965,0.07968715182957153,-3061219,-3402559,85.85609096049737,71.73401768927285,NaN,NaN,12.81124036841344,6.860668488480269
2006-12-26T09:30:00-05:00,33.39999,33.47,33.34,33.46001,432700,1012045,55.01037108200656,56.28469365897672,NaN,NaN,47.484906299259855,123.83398835738842,0.02102756272683122,0.10597160523811056,0.08494404251127934,-2628519,-2879959,86.86951443576454,73.70555627798693,NaN,NaN,12.506572076456882,7.667226143905499
2006-12-27T09:30:00-05:00,33.57001,33.64999,33.56,33.62,817800,983475,59.741614996433256,56.75320898540388,NaN,NaN,110.36021309294442,110.82420309917204,0.022373211461100134,0.1129105568376545,0.09053734537655436,-1810719,-2514819,87.54120938367643,75.59436422581777,NaN,NaN,13.555067534964385,8.508346342628197
2006-12-28T09:30:00-05:00,33.62,33.69,33.50999,33.58,281600,940670,58.096616137847974,57.23489517360094,NaN,NaN,93.52902994872713,92.498646117663,0.018665679054975445,0.11386944419527367,0.09520376514029823,-2092319,-2475799,87.61412666482111,77.54807586209469,NaN,NaN,13.985494866558195,9.290796131761054
2006-12-29T09:30:00-05:00,33.44,33.63741,33.33,33.49001,315900,896695,54.46323450798786,57.35009713212004,NaN,NaN,43.614935130724795,74.06355670522638,0.008752477709082856,0.1061443622766518,0.09739188456756895,-2408219,-2400199,87.7635536736818,79.3869324475794,NaN,NaN,13.348766963811014,9.870506250625334
2007-01-03T09:30:00-05:00,33.7,33.85001,33.34,33.5,1806100,945330,54.80117732583052,57.36409938269892,NaN,NaN,69.92535645335862,72.98288818500296,0.0018298910522180217,0.09967924838284148,0.09784935733062346,-602119,-1908379,88.71720221066066,80.99950466403145,NaN,NaN,12.907713432478953,10.304392990890138
2007-01-04T09:30:00-05:00,33.7,33.99001,33.53999,33.88,1701900,949855,65.33851688669807,58.11228825233205,NaN,NaN,161.4195043199451,95.76980778914,0.02075366027350499,0.1237914326725047,0.10303777239899971,1099781,-1162719,89.99085060707247,82.44543466110073,NaN,NaN,15.812709312004824,11.09129532247795
2007-01-05T09:30:00-05:00,33.91,33.91,33.61,33.69,1529200,975860,58.05116888816417,58.50125789484253,NaN,NaN,120.66328240738771,97.83042165202866,0.018462039213601664,0.1261153214160018,0.10765328220240013,-429419,-886459,90.4222296211941,83.85454812836461,NaN,NaN,15.927643066584778,11.78220214306464
2007-01-08T09:30:00-05:00,33.75,33.8,33.52,33.73,1609900,974375,59.0857531598011,58.635149117224294,NaN,NaN,88.39863317487684,96.80434229725861,0.017629137054750985,0.12968970352083886,0.11206056646608788,1180481,-231899,91.37115221677766,85.14995494994392,NaN,NaN,16.34356462366187,12.43382535457853
2007-01-09T09:30:00-05:00,33.92,33.92,33.64999,33.69,934800,990865,57.55702923899034,58.68484870310731,NaN,NaN,108.58025618800022,109.79740650871368,0.012608600275703444,0.12782131681071718,0.11521271653501373,245681,298881,92.0582700989149,86.42392371722295,NaN,NaN,16.21951397959597,12.974638015295307
2007-01-10T09:30:00-05:00,33.69,33.81,33.52,33.75,526300,975800,59.2597593567066,58.7203164926787,NaN,NaN,74.45626709198616,110.70358863643919,0.011579548909962795,0.12968715267246722,0.11810760376250443,771981,573701,92.39590285079761,87.55842278698795,NaN,NaN,16.61473477323157,13.49465183785763
2007-01-11T09:30:00-05:00,33.73,34.12,33.7,34.12,3075100,1112110,67.83051804753885,59.06346510636176,NaN,NaN,194.52473479176788,117.32463473080375,0.03286331149558258,0.15918674313198267,0.12632343163640009,3847081,1123161,93.03359437392031,88.5653711538532,NaN,NaN,19.90714090566641,14.410721704687456
2007-01-12T09:30:00-05:00,34.14999,34.33,34.08,34.28,1293200,1123075,70.70097951383383,59.57748254102627,NaN,NaN,258.75232706813324,144.94244366295283,0.05353997205421632,0.1932483967041705,0.13970842464995417,5140281,2237101,94.11170420490998,89.41551984060902,NaN,NaN,23.63508915642561,15.728488483507192
2007-01-16T09:30:00-05:00,34.36,34.38,34.22,34.36,651000,1119615,72.04416151731367,60.454909200507075,NaN,NaN,239.22993977499644,175.10870498297677,0.06752476657906559,0.22411438287378616,0.15658961629472057,5791281,3159261,94.82561240391799,90.18364383618618,NaN,NaN,27.072617309968994,17.34907831585888
2007-01-17T09:30:00-05:00,34.39999,34.67999,34.28999,34.56,2826700,1207165,75.11554842544416,61.93546064889981,NaN,NaN,234.22774292208342,200.2382023297934,0.08408634013538566,0.26169754146395263,0.17761120132856698,8617981,4833721,95.817277420656,90.89515715476894,NaN,NaN,31.06615819694515,19.30866115601406
2007-01-18T09:30:00-05:00,34.62,34.75,34.52,34.66,2561300,1299760,76.50544932961176,63.47082338087161,NaN,NaN,207.8861898911794,226.92418688963207,0.09482138765575307,0.2961379358982583,0.20131654824250525,11179281,6915181,96.67128327679663,91.59528350055693,NaN,NaN,34.770516156526874,21.51749758465875
2007-01-19T09:30:00-05:00,34.64999,34.78999,34.62,34.67,1521400,1280640,76.64592564440814,64.67827414144125,NaN,NaN,172.04345824147464,222.4279315795734,0.09538202573905658,0.320544080416326,0.2251620546772694,12700681,8685901,97.19581825325562,92.2848984198126,NaN,NaN,37.73328710515409,23.83403894472951
2007-01-22T09:30:00-05:00,34.73,34.92,34.39999,34.46001,5078500,1454310,67.51676435464887,65.35114187121273,NaN,NaN,126.21965970486454,195.92139810691967,0.07527950872982997,0.31926144058955686,0.24398193185972689,7622181,9182281,97.32315952159279,92.97840076672485,NaN,NaN,37.437312679867425,25.777363764034927
2007-01-23T09:30:00-05:00,34.39999,34.48,34.19,34.28,2029300,1488325,60.82824768296861,65.80578566942565,NaN,NaN,66.80294905970177,161.43599996386075,0.0450212099132799,0.30025844425132675,0.25523723433804685,5592881,9142601,96.9441703656232,93.63415910186355,NaN,NaN,34.984448570491985,27.092661593528792
2007-01-24T09:30:00-05:00,34.35001,34.58,34.25999,34.53999,3488200,1637795,66.05820030276297,66.60985873920654,NaN,NaN,81.46711140498088,130.88387366044023,0.03796081346903868,0.30268825117434517,0.2647274377053065,9081081,9235221,96.97379322520136,94.22391560290215,NaN,NaN,34.59164194897885,28.163944501450228
2007-01-25T09:30:00-05:00,34.55,34.55,34.37,34.42,3214300,1784760,61.94744836946258,66.36763955940401,NaN,NaN,70.46773075776437,103.40018183375723,0.021474574192061557,0.2915706554453834,0.27009608125332185,5866781,8172721,86.60241035992821,93.98188415667758,NaN,NaN,32.89275280905525,28.839488545393802
2007-01-26T09:30:00-05:00,34.25,34.35001,34.06,34.23,2592700,1892760,56.00439199511674,66.22144120990063,NaN,NaN,26.02818052833494,74.1971262911293,-0.0045721844007579615,0.2643808507523744,0.26895303515313235,3274081,6287401,71.90664727167238,92.65934256028315,NaN,NaN,29.443138644050055,28.925724273773266
2007-01-29T09:30:00-05:00,34.25,34.3,34.1299,34.17999,1967500,1950245,54.52172389548339,65.89543911959223,NaN,NaN,19.999458225029507,52.95308599516229,-0.026301621466104097,0.23607600832050224,0.26237762978660634,1306581,5024281,64.06307079984464,90.70876531621651,NaN,NaN,26.233079324449516,28.54106070958416
2007-01-30T09:30:00-05:00,34.34,34.38,34.23,34.35001,1187600,1995545,58.54033083414965,65.96567494781787,NaN,NaN,37.206529880035816,47.033802159229104,-0.030084204755900568,0.22477237384173065,0.2548565785976312,2494181,4404541,60.57193956107997,88.45974170637116,NaN,NaN,24.784211152259562,28.004367915680646
2007-01-31T09:30:00-05:00,34.38,34.57001,34.28999,34.50999,1685900,2064045,61.947582069921125,66.15766228447606,NaN,NaN,60.182821336622816,42.776944145557486,-0.022991919877715983,0.22611667875048624,0.24910859862820223,4180081,3424341,55.42711520912851,85.8191140176805,NaN,NaN,24.657329480848716,27.526219567847512
2007-02-01T09:30:00-05:00,34.64999,34.83,34.61,34.8,2628200,2105150,67.20860487162207,66.11323991476772,NaN,NaN,117.8661765569405,52.256633305392725,-0.0011046535434200422,0.24772778169892717,0.24883243524234722,6808281,3612641,56.19682144157589,83.18791595108448,NaN,NaN,26.336980055352388,27.35632820891964
2007-02-02T09:30:00-05:00,34.87,34.89999,34.66,34.73,1197600,2079935,64.87703378204576,65.69724379106857,NaN,NaN,112.65144641685406,69.58128648309655,0.005935974450797243,0.25625240330584376,0.2503164288550465,5610681,4079961,58.129293744273184,80.61774377532471,NaN,NaN,26.91390945736321,27.293125530125863
2007-02-05T09:30:00-05:00,34.73,34.78,34.58,34.72,3132600,2160105,64.53261274229683,65.16070459285308,NaN,NaN,90.00893994952797,83.58318282799624,0.007117466349646995,0.25921326179210524,0.25209579544245825,2478081,4314261,59.10346819558484,78.06616204615807,NaN,NaN,27.26412970562922,27.288983269483484
2007-02-06T09:30:00-05:00,34.73,34.74001,34.53,34.62,2216100,2190415,61.042680710385966,64.15549975606321,NaN,NaN,67.953640582839,89.73260496855687,-0.0011951823925250848,0.2506018174518019,0.25179699984432696,261981,3867821,56.41031849189929,75.25137926553258,NaN,NaN,26.51223910187997,27.178019816968696
2007-02-07T09:30:00-05:00,34.63,34.72,34.57001,34.67,1572700,2222310,62.145020350436795,63.12975482897928,NaN,NaN,69.76883119272644,91.64980693977759,-0.005447438138273197,0.24498770217148547,0.25043514030975866,1834681,3398741,53.64439367830401,72.17803000849739,NaN,NaN,26.20911528557724,27.039604883912773
2007-02-08T09:30:00-05:00,34.63,34.72,33.7,34.64,1345800,2263285,61.02918563553165,62.014273399773806,NaN,NaN,-40.56979504735635,59.96261261891823,-0.01202480523602728,0.23540413376472458,0.24742893900075186,488881,2134861,46.96280878531317,68.58995790364435,NaN,NaN,25.64734562422445,26.8407107039573
2007-02-09T09:30:00-05:00,34.73,34.73,34.45,34.53999,2625700,2240815,57.33338949459922,61.28688948119884,NaN,NaN,34.52063869419302,44.33645107438602,-0.024155178312852715,0.21723496610968596,0.24139014442253867,-2136819,585361,40.330572909534176,64.51905885992588,NaN,NaN,24.124252720347954,26.45264527772739
2007-02-12T09:30:00-05:00,34.5,34.52,34.35001,34.39,1421023,2247206.15,52.225338142865205,60.67239594262002,NaN,NaN,-35.89458882566039,19.15574531934835,-0.04226472605672019,0.18855923685163845,0.23082396290835863,-3557842,-621823.6,36.05813333166326,60.170056214643026,NaN,NaN,21.291368448360643,25.715320016389285
2007-02-13T09:30:00-05:00,34.39999,34.53999,34.39999,34.52,1295034,2279407.85,55.8932463736116,59.9463278048235,NaN,NaN,-10.470084965539238,3.471000209672708,-0.045207934676419564,0.17431404456283417,0.21952197923925373,-2262808,-1126781.4,34.41578490483478,55.70162704890255,NaN,NaN,19.887531859342218,24.882778851096848
2007-02-14T09:30:00-05:00,34.50999,34.74001,34.50999,34.71001,2023308,2239238.25,60.64875628790043,59.85356408471191,NaN,NaN,61.724416759464106,1.8621173230202288,-0.03455815186118813,0.17632428941276856,0.2108824412739567,-239500,-1541617.6,33.08266624370174,51.8787881834578,NaN,NaN,20.0820064216403,24.19695421831734
2007-02-15T09:30:00-05:00,34.75,34.89,34.67999,34.87,1134100,2167878.25,64.15337910689355,60.43563459269597,NaN,NaN,122.77519663228678,34.53111565894886,-0.017783865816964062,0.1886526090027516,0.20643647481971567,894600,-1460473.8,33.624272659305674,49.14433285400304,NaN,NaN,21.340674391390476,23.788914243042075
2007-02-16T09:30:00-05:00,34.64999,34.77,34.64999,34.73,1294300,2156523.25,59.186059244464744,60.76880140333749,NaN,NaN,80.58927524124974,43.7448429683602,-0.017154323533950994,0.18499357040227693,0.20214789393622792,-399700,-1113050,36.01225379949769,47.14070306826398,NaN,NaN,20.86835365717656,23.371691302204145
2007-02-20T09:30:00-05:00,34.66,34.8,34.66,34.75,739000,1939548.25,59.66651672923019,60.849243252986106,NaN,NaN,82.27374306938131,67.37850934736854,-0.016427071127418202,0.18161405502695516,0.19804112615437336,339300,-333621.6,41.129330400808236,45.75194527110172,NaN,NaN,20.6301541469272,22.980043137164582
2007-02-21T09:30:00-05:00,34.66,34.67999,34.55,34.59,975800,1886873.25,54.17238508816783,60.29387204000373,NaN,NaN,25.258284665228324,74.52418327352206,-0.027126438550534232,0.16413307796620558,0.1912595165167398,-636500,-8360,43.17168494284009,44.87655739493827,NaN,NaN,18.758192570645832,22.376921627661904
2007-02-22T09:30:00-05:00,34.64,34.64999,34.44,34.53999,1374700,1781198.25,52.54379652471024,59.24638572951003,NaN,NaN,-3.5832568168144694,61.46264855826634,-0.03734577990839133,0.14457729163125066,0.181923071539642,-2011200,-362700,41.48327737317917,43.825589961481356,NaN,NaN,16.736851369415458,21.571197305055268
2007-02-23T09:30:00-05:00,34.50999,34.50999,34.3,34.39,898000,1665383.25,47.893309801411284,58.03326258803613,NaN,NaN,-64.32998215155675,24.04161280149763,-0.053023906909367424,0.11564318790293271,0.16866709481230013,-2909200,-1123460,38.04320513157111,42.39086934628834,NaN,NaN,13.567662349398649,20.427835168532894
2007-02-26T09:30:00-05:00,34.47,34.56,34.39999,34.53,1881409,1629818.7,52.15033548739219,57.1488142126858,NaN,NaN,-31.97397459375745,1.5289628344961947,-0.0526742851329578,0.10282423839610288,0.15549852352906068,-1027791,-1249078.2,37.49035974483513,40.84707588552051,NaN,NaN,12.112903391614605,19.239987771830283
2007-02-27T09:30:00-05:00,34.27,34.34,33.16,33.48,3057900,1684338.7,31.41831529092198,55.032788111295524,NaN,NaN,-344.4045422937995,-83.80669423813997,-0.11812007327551372,0.007848431934668554,0.12596850521018227,-4085691,-2134076.4,33.76731987166811,39.229718841218286,NaN,NaN,1.3875287684402087,16.689636485631702
2007-02-28T09:30:00-05:00,33.55,33.98,33.55,33.67999,2330100,1741463.7,36.58905203289721,53.20736180289983,NaN,NaN,-251.00469522116933,-139.0592902154195,-0.1413337121922274,-0.05069863503010197,0.09063507716212542,-1755591,-2357894.6,32.8780734311146,37.74641025213332,NaN,NaN,-4.477077593513294,13.665820188610988
2007-03-01T09:30:00-05:00,33.42999,33.72,33.11,33.56,2406631,1777500.25,34.889402922583045,51.340234466260654,NaN,NaN,-244.46639890098618,-187.23591863225383,-0.15695840878555534,-0.10556293381981874,0.051395474965736584,-4162222,-2788099,31.178481591546472,36.618958309721414,NaN,NaN,-9.49187548645684,10.357577949315584
2007-03-02T09:30:00-05:00,33.5,33.67,33.25999,33.25999,2559100,1774045.25,31.010632312692522,49.460037524695885,NaN,NaN,-198.28723153452012,-214.02736850884654,-0.17813814681623458,-0.17127720855455664,0.006860938261677933,-6721322,-3550523.4,28.37862230041523,35.7652475519272,NaN,NaN,-15.033502463989077,6.730280747414918
2007-03-05T09:30:00-05:00,33.10001,33.45,32.98,33.09,1744600,1801395.25,29.04057824725726,47.80398324643818,NaN,NaN,-183.90583264910276,-244.41374011991556,-0.19298581481557175,-0.23437133025778678,-0.04138551544221501,-8465922,-5038149.6,23.87374024797485,34.89493376023518,NaN,NaN,-20.064733452702953,2.9024215759695084
2007-03-06T09:30:00-05:00,33.28999,33.53999,33,33.44,2897500,1789640.25,37.80197719655637,46.511749733791376,NaN,NaN,-129.96370157340158,-201.52557197583602,-0.16946192398319238,-0.25321292042120547,-0.0837509964380131,-5568422,-5334695.8,23.086979889474506,34.085733401995164,NaN,NaN,-21.010379186794864,-0.513692818711116
2007-03-07T09:30:00-05:00,33.35001,33.60001,33.28999,33.45,1175800,1737625.25,38.037379011809506,44.896651356927734,NaN,NaN,-96.67615625282448,-170.65986418216704,-0.14443241237915466,-0.26429151191195643,-0.11985909953280177,-4392622,-5862102,21.71627224827286,33.27384811660739,NaN,NaN,-21.63792194617725,-3.5314398369205633
2007-03-08T09:30:00-05:00,33.58,33.96001,33.5,33.56,1161000,1717040.25,40.696223560464595,43.221140246468515,NaN,NaN,-59.106051479358065,-133.58779469784142,-0.11306033813650748,-0.26118452220343613,-0.14812418406692865,-3231622,-5675982,23.443665959822965,32.5466619237872,NaN,NaN,-21.270619864663736,-6.065608412312445
2007-03-09T09:30:00-05:00,33.75,33.8,33.53999,33.63,1147300,1707115.25,42.390359933651936,42.02144743855332,NaN,NaN,-55.040758035457046,-104.9384999980288,-0.08165246365186457,-0.2501897636317594,-0.1685372999798948,-2084322,-4748582,31.54879052128838,32.22784311820082,NaN,NaN,-20.44725103363061,-8.120128786786468
2007-03-12T09:30:00-04:00,33.67,33.73,33.48,33.63,2392700,1695465.25,42.390359933651936,40.787436238869155,NaN,NaN,-54.402143113658354,-79.03776209093994,-0.056149736934623495,-0.2387244711481742,-0.1825747342135507,-2084322,-3472262,40.8328216854765,32.20666392424855,NaN,NaN,-19.79161862838326,-9.787484478443153
2007-03-13T09:30:00-04:00,33.55,33.64999,33.08,33.08,3381500,1793489.1,33.63472069663682,39.32046021090265,NaN,NaN,-87.50894830973864,-70.54681143820736,-0.07065687600336507,-0.270895829217757,-0.20023895321439195,-5465822,-3451742,40.971439841858626,32.049503559892734,NaN,NaN,-22.045028448325038,-11.53856218842628
2007-03-14T09:30:00-04:00,33.19,33.27,32.89,33.21001,3423800,1899927.4,36.949887411046774,38.20660955992669,NaN,NaN,-96.0934532631825,-70.43027084027895,-0.06592324473947114,-0.28264300913873086,-0.21671976439925972,-2042022,-2981622,44.19705417656079,32.24334476013428,NaN,NaN,-22.79479367858164,-13.146595258448475
2007-03-15T09:30:00-04:00,33.17,33.3,33.11,33.28999,1382000,1867862,38.96964688709711,37.56920506604711,NaN,NaN,-77.63015440408525,-74.13509142522437,-0.05242056147069296,-0.2822454662376259,-0.22982490476693296,-660022,-2467302,47.572409646395776,32.924002225478894,NaN,NaN,-22.772043935975905,-14.521659355238107
2007-03-16T09:30:00-04:00,33.25999,33.27,33.03999,33.2,859200,1854117,37.51352026023149,36.52371826410707,NaN,NaN,-82.48325317430715,-79.6235904529944,-0.04485705051501104,-0.28589621791069675,-0.2410391673956857,-1519222,-2354282,48.312281199368705,33.69699661508844,NaN,NaN,-23.186337886899675,-15.759470574046903
2007-03-19T09:30:00-04:00,33.23,33.46001,33.14999,33.46001,782467,1828525.35,44.02187885418556,37.423972804340174,NaN,NaN,-53.93803788444714,-79.53076940715216,-0.018974168818730985,-0.26475687841909945,-0.24578270960036847,-736755,-2084768.6,50.120007011487104,34.865045696504076,NaN,NaN,-21.526549429081008,-16.583338981908916
2007-03-20T09:30:00-04:00,33.32001,33.64999,33.32001,33.63,2088929,1896021.8,47.84648734684189,38.228075326764795,NaN,NaN,-20.37282837412893,-66.1035454200302,0.011332495996554254,-0.23161708960467564,-0.2429495856012299,1352174,-721169.4,58.10382499420086,36.666885093867386,NaN,NaN,-18.937302833071996,-16.91961953207507
2007-03-21T09:30:00-04:00,33.60001,34.03,33.48,33.97,1889100,1941686.8,54.537101900845215,39.63148239664066,NaN,NaN,46.74083050830332,-37.536688665733045,0.053646988893847586,-0.17589084948392042,-0.229537838377768,3241274,335489.8,63.0405870173752,38.94274976714086,NaN,NaN,-14.434609103891733,-16.564618042334594
2007-03-22T09:30:00-04:00,34.00999,34.10001,33.89999,34.09,1667000,1956301.8,56.65083521891533,41.462925461370865,NaN,NaN,104.34539362683829,-1.1415790595483344,0.08710740178435278,-0.12065358614732702,-0.2077609879316798,4908274,1449149,67.40052646688909,41.730028636174715,NaN,NaN,-10.09132090400571,-15.63986130828761
2007-03-23T09:30:00-04:00,34,34.33,33.39999,33.92,1487458,1985774.7,52.89860356924622,43.16707012722723,NaN,NaN,84.72958785421785,32.30098914615667,0.0945585408284002,-0.08956281189617954,-0.18412135272457975,3420816,2437156.6,70.7025343538993,45.074942500883594,NaN,NaN,-7.6128858237855646,-14.493150524787318
2007-03-26T09:30:00-04:00,34.02,34.02,33.73,33.97,961500,1939779.25,53.86644893873254,44.31453239452552,NaN,NaN,111.89096702101111,65.46679012724832,0.0991413378858555,-0.06019468036726039,-0.15933601825311589,4382316,3460970.8,73.67785849584365,48.68857668705282,NaN,NaN,-5.319261141750679,-13.182594898639227
2007-03-27T09:30:00-04:00,33.89999,33.89999,33.67,33.73,2922100,1932989.25,48.69424381370929,45.07573702323264,NaN,NaN,67.80885632701494,83.10312706747709,0.08295299029026765,-0.05564478039028131,-0.13859777068054896,1460216,3482579.2,73.7384777061942,52.40444850547578,NaN,NaN,-4.883437329709615,-11.997000960220712
2007-03-28T09:30:00-04:00,33.7,33.75,33.5,33.5,2763592,1954663.85,44.303880702899846,45.333426819120874,NaN,NaN,18.217895296078037,77.39854002503202,0.05504342155467827,-0.06979349373720112,-0.12483691529187939,-1303376,2573649.2,66.77254179415627,55.49936820792816,NaN,NaN,-5.873565156495306,-11.122224416831369
2007-03-29T09:30:00-04:00,33.59,33.7,33.46001,33.66,2708128,1969738.7,47.82789760448544,45.721822367037554,NaN,NaN,22.932105573869062,61.11588241443818,0.046013717994850045,-0.06731976779831683,-0.11333348579316688,1404752,1872944.8,61.916516798366814,57.668491513433764,NaN,NaN,-5.621981517965277,-10.33647543127907
2007-03-30T09:30:00-04:00,33.64999,33.87,33.36,33.64999,3073850,1995476.2,47.624874404794916,46.09571625783348,NaN,NaN,25.81271964538093,49.332508772670806,0.038336384548322,-0.06541300510776438,-0.10374938965608638,-1669098,854962,55.59123856208955,58.722664147477545,NaN,NaN,-5.479281884465659,-9.642590638877154
2007-04-02T09:30:00-04:00,33.8,33.89,33.72,33.83,1188800,1967686.2,51.6034364927765,47.37919595755774,NaN,NaN,75.83401982336294,42.121119333141166,0.04394840509810845,-0.04881388328345082,-0.09276228838155927,-480298,-117560.8,50.304101722964596,59.389282853270835,NaN,NaN,-4.187046548144231,-8.86322719734388
2007-04-03T09:30:00-04:00,34,34.27,33.92999,34.17999,982487,1871935.55,58.244774489060944,48.900259320273044,NaN,NaN,156.73602415977098,59.90655289969239,0.06834330307522848,-0.00733315953752367,-0.07567646261275215,502189,-309166.2,49.309077362997115,59.75442736658771,NaN,NaN,-0.9107735219727205,-7.7271623865765715
2007-04-04T09:30:00-04:00,34.2,34.39999,34.10001,34.38,922590,1859275.05,61.49655624780405,50.509324274609256,NaN,NaN,175.2177816552513,91.30653017152704,0.09350498244486756,0.04120476544333229,-0.05230021700153527,1424779,236464.8,52.20815651897434,60.085552143200466,NaN,NaN,2.8963394965931397,-6.20951926040947
2007-04-05T09:30:00-04:00,34.36,34.64999,34.36,34.62,1102376,1856343.85,65.01710614877672,52.473866123791026,NaN,NaN,193.85659571616404,125.49142819998603,0.12016720033301281,0.09790878341473075,-0.022258416918282065,2527155,460945.4,53.389239807450764,60.44819204377776,NaN,NaN,7.291197099675317,-4.2808454946830725
2007-04-09T09:30:00-04:00,34.62,34.64,34.52,34.63,1307677,1864362.7,65.16004882513073,53.98373540742997,NaN,NaN,170.21543271451438,154.37197081381274,0.13142030114042744,0.14201695950725224,0.010596658366824795,3834832,1561731.4,58.77005705260058,61.06605276100015,NaN,NaN,10.813803997946465,-2.124466995735996
2007-04-10T09:30:00-04:00,34.55,34.6899,34.5,34.67999,1422350,1815845.2,65.90994594727788,55.27398245031826,NaN,NaN,149.6632364174601,169.13781413263217,0.13467789467283414,0.17894402670786747,0.04426613203503333,5257182,2709227.4,63.500308388999244,61.451515860628604,NaN,NaN,13.921422260828638,0.1678028980589521
2007-04-11T09:30:00-04:00,34.64999,34.67,34.42999,34.53,2447510,1769145.7,61.62408123181311,55.78019525967311,NaN,NaN,119.60211459841499,161.71103222036098,0.11968407613333673,0.19387122720170424,0.07418715106836751,2809672,3170724,65.22813999700685,61.607769644888016,NaN,NaN,15.366108721173111,2.3389894442181176
2007-04-12T09:30:00-04:00,34.48,34.97,34.37,34.92,1072437,1651577.55,67.53540190000513,56.55766430832237,NaN,NaN,135.98465328896023,153.86440654710276,0.12822474290552274,0.23446807970027095,0.1062433367947482,3882109,3662190,67.01870299619134,61.58049653983817,NaN,NaN,18.57252012441095,4.658065255674236
2007-04-13T09:30:00-04:00,35.17999,35.45,35.16,35.42999,2666677,1715811.4,73.32240970455726,58.016507603701726,NaN,NaN,194.57870320208437,154.00882804428682,0.15843388462254743,0.3042856925729325,0.14585180795038505,6548786,4466516.2,69.76295766629283,61.51338391929486,NaN,NaN,23.56210670997264,7.358642606288294
2007-04-16T09:30:00-04:00,35.53,35.77,35.49001,35.77,3204802,1833091.5,76.34933749790912,59.62242821507149,NaN,NaN,200.5659005741854,160.07892161622104,0.189431964153176,0.38264176314185505,0.19320979898867904,9753588,5650267.4,73.28593292804474,61.485389235880646,NaN,NaN,28.844440120294696,10.428042251146351
2007-04-17T09:30:00-04:00,35.94,36,35.87,35.88,2848940,1936415.15,77.24872506463902,61.66203401870933,NaN,NaN,192.43538826038395,168.6333519848058,0.20418910945105903,0.44844618580250284,0.2442570763514438,12602528,7119336.6,76.88529219931408,61.71016169967492,NaN,NaN,33.29218379898174,13.694348186551407
2007-04-18T09:30:00-04:00,35.84,35.88,35.59,35.87,2173891,1940663.25,76.9621931498034,63.99477062205958,NaN,NaN,150.2171907834674,174.7563672218163,0.1998696499277242,0.4940941387610991,0.2942244888333749,10428637,8643129.6,79.90909273159733,62.648486766634996,NaN,NaN,36.66228086510989,16.975481426345475
2007-04-19T09:30:00-04:00,35.78,36.09,35.7,36.02,3099383,2001177.4,78.26453942264187,66.16881646621361,NaN,NaN,144.64893862736844,176.48922428949794,0.19357506013265363,0.5361933139991919,0.34261825386653827,13528020,10572311.8,82.95010632678603,64.15088601866493,NaN,NaN,39.86952047697768,20.246058433578646
2007-04-20T09:30:00-04:00,36.14999,36.23,36.03999,36.16,2496655,2042660.15,79.43316213605084,68.44083701844617,NaN,NaN,140.9361086564524,165.76070538037155,0.1852930963898317,0.5742346243538279,0.38894152796399617,16024675,12467489.6,85.30349788709736,66.2731902561655,NaN,NaN,42.902015965528214,23.482623795285726
2007-04-23T09:30:00-04:00,36.27,36.28,36.10001,36.2,1399882,2038281.35,79.76786833610807,70.45258215011272,NaN,NaN,123.74528161911078,150.3965815893566,0.16939555255370697,0.6006859686561299,0.4312904161024229,17424557,14001683.4,86.88203218960776,68.88589957521144,NaN,NaN,45.468119479199935,26.623408892987754
2007-04-24T09:30:00-04:00,36.23,36.28999,36.06,36.2,1031130,2041762.85,79.76786833610807,71.98994599633036,NaN,NaN,106.17275095004584,133.14405412728897,0.14661929288857145,0.6145645322131372,0.4679452393245658,17424557,14966089.2,87.77120844800476,71.63319465271198,NaN,NaN,47.56170275517198,29.614593730442643
2007-04-25T09:30:00-04:00,36.23,36.38,35.75,36.31,1995175,1995416.6,80.76617496416947,73.36634733321362,NaN,NaN,91.31531656435837,121.36367928346718,0.12741132456573467,0.6272093950317341,0.49979807046599944,19419732,16764308.2,89.23625715298685,74.27805898371288,NaN,NaN,49.638655300688356,32.475173954763456
2007-04-26T09:30:00-04:00,36.33,36.50999,36.28999,36.35001,1129338,1913703.9,81.13087402546415,74.517330752977,NaN,NaN,98.69328359603979,112.17254827720144,0.10668981109415088,0.633160334333688,0.5264705232395371,20549070,18168518.2,90.22144153856293,76.90893053593517,NaN,NaN,51.48498184630602,35.190860796412395
2007-04-27T09:30:00-04:00,36.32001,36.34,36.16,36.23,842717,1820433.35,76.44844494942045,75.32364476185485,NaN,NaN,80.58458967475143,100.10224448086126,0.07565062259771593,0.6210338014866821,0.5453831788889661,19706353,18904853.8,90.70202729302633,79.18978555310845,NaN,NaN,51.852747299938606,37.57113029691614
2007-04-30T09:30:00-04:00,36.33,36.33,36.10001,36.11,1364416,1734961.65,71.97526063711153,75.7568815254144,NaN,NaN,70.02456569940989,89.35810129692108,0.039599855938288075,0.5948829988118263,0.5552831428735382,18341937,19088329.8,90.82305432042432,81.14141026249594,NaN,NaN,50.96134094848451,39.48401753285448
2007-05-01T09:30:00-04:00,36.06,36.24001,36.02499,36.19,2680857,1809564.5,73.10508700316367,76.57695336622514,NaN,NaN,62.501930856864554,80.62393727828481,0.014971046617685557,0.5739969511456451,0.5590259045279595,21022794,19807977.2,91.30132356772666,83.00378051754737,NaN,NaN,50.48601976811001,41.055732137890985
2007-05-02T09:30:00-04:00,36.32001,36.46001,36.2,36.42,1347803,1827830.3,76.08963679528152,77.18797014445917,NaN,NaN,77.99554389879975,77.95998274517308,0.008330909287801669,0.5694395411377116,0.5611086318499099,22370597,20398150.2,91.68408535880266,84.76559354344818,NaN,NaN,50.87244289260281,42.4581193885641
2007-05-03T09:30:00-04:00,36.42,36.55,36.36,36.5,1303256,1846863.6,77.04386930410698,77.45378868728415,NaN,NaN,86.375993981662,75.49652482229752,0.0037221726342708816,0.5657613476427485,0.5620391750084777,23673853,21023106.8,92.08143871810846,86.359770761435,NaN,NaN,51.46146433420869,43.74431152365619
2007-05-04T09:30:00-04:00,37.03999,37.05,36.45,36.7,942300,1838859.8,79.27111750382942,77.6624872591356,NaN,NaN,112.85594397178718,81.95079568170468,0.008277912234627927,0.5723865653017626,0.5641086530671346,24616153,22005066.8,92.67378434465637,87.74461729119298,NaN,NaN,52.623423662102475,45.012756114862796
2007-05-07T09:30:00-04:00,36.74001,36.78,36.7,36.78,2262972,1886624.55,80.1027062698788,77.86634305950987,NaN,NaN,113.93555235969319,90.73299301376133,0.01066196191311164,0.5774361054585242,0.5667741435454126,26879125,23712504.4,93.57392507992762,88.93666249695109,NaN,NaN,53.836918194482244,46.27335069766558
2007-05-08T09:30:00-04:00,36.72,36.72,36.53999,36.64,1927305,1911872.3,74.47217356243048,77.68848451755467,NaN,NaN,95.61645928308828,97.35589869900608,-0.0025043242101986385,0.5636437382826642,0.5661480624928629,24951820,24498309.6,93.94278258192425,89.9390689148316,NaN,NaN,53.268279643740726,47.2726262613906
2007-05-09T09:30:00-04:00,36.7,36.81,36.61,36.75999,1841061,1881549.85,76.02748577669523,77.52869497141562,NaN,NaN,115.7789884276592,104.91258760477797,-0.008129398801752341,0.5559863139906724,0.5641157127924248,26792881,25382766.4,94.3368048561667,90.75240452407307,NaN,NaN,53.21690401284038,48.121808797312
2007-05-10T09:30:00-04:00,36.66,36.66,36.03,36.11,1367349,1896295.45,56.09118204222451,75.86141067899946,NaN,NaN,13.843453836444361,90.40607957573442,-0.05785270863971981,0.491799826992775,0.5496525356324948,25425532,25733102.2,94.48970744727806,91.40856234980026,NaN,NaN,46.08528061728607,47.830876200165434
2007-05-11T09:30:00-04:00,36.00999,36.3,35.96001,36.25,1189280,1822425.6,58.608790418971445,74.35004797063255,NaN,NaN,-23.812069186362407,63.07247694410451,-0.08206218567506629,0.447074803538662,0.5291369892137283,26614812,26132834,94.66664604804778,91.9646061968317,NaN,NaN,41.2214963410924,46.88667907744072
2007-05-14T09:30:00-04:00,36.27,36.48,36.21001,36.21001,1162567,1720313.85,57.59297685473516,72.76612715053449,NaN,NaN,5.2353130817077576,41.332429088507425,-0.10031049079426224,0.40374887572090046,0.5040593665151627,25452245,25847458,92.38584810825193,92.29422331542078,NaN,NaN,37.08120036568845,45.48589640433325
2007-05-15T09:30:00-04:00,36.14999,36.42999,36.14999,36.17,2288210,1692277.35,56.537163631667696,71.03548348392722,NaN,NaN,-17.109371854900324,18.78726286090971,-0.11363849098929518,0.36201125277854374,0.4756497437678389,23164035,25489901,89.4770472674516,92.31142260931111,NaN,NaN,33.4374959648745,43.76469634155343
2007-05-16T09:30:00-04:00,36.44,36.62,36.3401,36.58,3063738,1736769.7,63.85056029203695,69.80117536011099,NaN,NaN,62.6365360299016,8.158772381358192,-0.09420627158406192,0.3578919042877615,0.45209817587182344,26227773,25376879.4,88.52821143587595,92.19047760197633,NaN,NaN,32.459788407813676,42.14970949387632
2007-05-17T09:30:00-04:00,36.49001,36.49001,36.35001,36.44,1415400,1652570.55,60.12989686286368,68.6355647824998,NaN,NaN,24.877720604571465,10.36562573498361,-0.09014425020654232,0.3394178631136455,0.42956211332018784,24812373,25254247.6,87.4446858033466,91.9578103527135,NaN,NaN,30.448783011201748,40.478148567779954
2007-05-18T09:30:00-04:00,36.52,36.64,36.409,36.59,693667,1562421.15,62.64172756547201,67.96888384881125,NaN,NaN,62.68706157840196,27.665451887936484,-0.07721632956771046,0.3330417013605498,0.41025803092826024,25506040,25032493.2,85.40898070320698,91.57109080862654,NaN,NaN,29.58789873942144,38.92239859230017
2007-05-21T09:30:00-04:00,36.62,36.71001,36.58,36.67,1768642,1580859.15,63.94632336547673,67.31468644611932,NaN,NaN,91.36215430879754,44.89082013335444,-0.0637003828280559,0.33063255239319034,0.39433293522124624,27274682,25396980.6,85.98644446972762,91.19145658734088,NaN,NaN,29.290889675857475,37.54646874709407
2007-05-22T09:30:00-04:00,36.8,36.81,36.52,36.64999,1101374,1584371.35,63.35041369742634,66.40474193912968,NaN,NaN,84.18217160353089,65.14912882504068,-0.056761619483179704,0.3233809108672716,0.3801425303504513,26173308,25998835.2,86.90783615137391,90.8502959296674,NaN,NaN,28.878010620989187,36.30811758622194
2007-05-23T09:30:00-04:00,36.8,36.94,36.69,36.78,1724445,1570834.85,65.59385746920039,65.58688395092206,NaN,NaN,121.26791468304863,76.87540455567009,-0.04460575157080804,0.32438534088694126,0.3689910924577493,27897753,26332831.2,87.40283383995725,90.51610986694232,NaN,NaN,29.179102372089403,35.28968684134586
2007-05-24T09:30:00-04:00,36.67999,36.87,36.60001,36.64,1955819,1612158.9,61.2461448451828,64.29938590387587,NaN,NaN,77.14098553059434,87.32805754087467,-0.04694687614699122,0.3103074972740103,0.3572543734210015,25941934,26558743.4,87.74046978063905,90.1637302552268,NaN,NaN,28.170189339838153,34.2726157697019
2007-05-25T09:30:00-04:00,36.58,36.74001,36.55,36.62,997900,1619918.05,60.62790518092841,62.90832868323657,NaN,NaN,49.11604386858768,84.61385399891182,-0.050486588057539195,0.29414613834907755,0.34463272640661674,24944034,26446342.2,86.49824819753967,89.65832476362765,NaN,NaN,27.170236114491725,33.257990104671876
2007-05-29T09:30:00-04:00,36.64999,36.7,36.53,36.64,1565593,1629976.9,61.05130985463396,61.9496955612511,NaN,NaN,39.421471911994566,74.22571751955121,-0.05192421804205288,0.2797274538540506,0.3316516718961035,26509627,26293331.2,84.73942963360815,89.0009424101765,NaN,NaN,26.45133387472881,32.28561064325144
2007-05-30T09:30:00-04:00,36.61,36.64999,36.36,36.64999,3189990,1655433.55,61.27532382117872,60.895969707285644,NaN,NaN,6.071160673328719,58.60351533351078,-0.05248940987876227,0.26603990954765067,0.31852931942641294,29699617,26998593,86.13849061100242,88.41534853552191,NaN,NaN,25.90614645980287,31.3742586170445
2007-05-31T09:30:00-04:00,36.71001,36.7998,36.62,36.73,1386600,1657373.4,63.10555795896971,61.396996558481725,NaN,NaN,70.17109254383693,48.38415090566845,-0.04788999929321758,0.25866682030989097,0.30655681960310854,31086217,27636285.8,87.27451116129014,87.89997737223705,NaN,NaN,25.901810149300413,30.592480264509632
2007-06-01T09:30:00-04:00,36.74001,36.82001,36.64,36.77,3572230,1770822.1,64.02107707980184,61.783588462826756,NaN,NaN,74.81406740840205,47.91876728123,-0.042738818401232226,0.25313329660156825,0.2958721150028005,34658447,29379588.4,89.74809293660631,87.54865214999123,NaN,NaN,26.13200768329011,29.955269895763987
2007-06-04T09:30:00-04:00,36.60001,36.77,36.60001,36.7,1749120,1811163.1,61.16083614131415,62.038435554725254,NaN,NaN,53.2466549909677,48.74488950570599,-0.04443436459266026,0.24032915926197518,0.28476352385463544,32909327,30972647,91.39429107963272,87.47782664794701,NaN,NaN,25.607133789775993,29.33410759490856
2007-06-05T09:30:00-04:00,36.59,36.64999,36.42999,36.61,1685280,1782278.5,57.59784278234318,62.114198351202084,NaN,NaN,2.003864601521288,41.26136804361134,-0.05150750171500207,0.22037914671088288,0.27188664842588495,31224047,31915531,92.19330752288435,87.67184523762079,NaN,NaN,24.21772969663813,28.603196466584212
2007-06-06T09:30:00-04:00,36.53999,36.53999,36.2,36.27,3136326,1842729.55,46.562229836497,60.879317604377796,NaN,NaN,-89.49115108258745,22.148905692428105,-0.07741744305495296,0.17511484460719373,0.2525322876621467,28087721,31593151.8,89.1456738249102,87.71594969398038,NaN,NaN,19.515049576176175,27.304889767954492
2007-06-07T09:30:00-04:00,35.94,36.2,35.64999,35.73,3281173,1914735.15,35.06957684720781,59.089294746116664,NaN,NaN,-225.358281805225,-36.95696917738428,-0.12636276916064565,0.09457882621133962,0.22094159537198527,24806548,30337218,78.28786393790429,87.06189098930591,NaN,NaN,10.590882013579545,24.917174374472356
2007-06-08T09:30:00-04:00,35.39,35.91,35.39,35.85001,1995520,1946143.7,38.691313706846266,57.37855089907197,NaN,NaN,-223.87274674848777,-96.69433200876225,-0.144772130687388,0.03997643201275025,0.18474856270013826,26802068,28765942.2,67.2517558458132,85.76494635663492,NaN,NaN,4.739656525403619,22.034671824605393
2007-06-11T09:30:00-04:00,35.77,36.03999,35.77,35.86,1267350,1950047.2,38.996353984866936,55.596410229028415,NaN,NaN,-155.8577432107497,-138.51521164910574,-0.1497683464477137,-0.0024618703595038482,0.14730647608820985,28069418,27797960.4,61.50005294451326,84.0159183905482,NaN,NaN,0.313780054644131,18.931687286039498
2007-06-12T09:30:00-04:00,35.75,35.89999,35.57001,35.60001,2087300,1996283.85,34.223911905387325,53.51594581531134,NaN,NaN,-173.93783008281923,-173.70355058597383,-0.1629836929323735,-0.05642314007725702,0.10656055285511648,25982118,26749574.6,55.921632078560314,81.80261809963294,NaN,NaN,-5.1615598440843335,15.48979483887895
2007-06-13T09:30:00-04:00,35.92999,35.92999,35.53,35.89,2145000,1989123.35,42.65397869317834,51.87738304559548,NaN,NaN,-131.41240586957963,-182.08780154337228,-0.14518794947313307,-0.07492438398629986,0.07026356548683321,28127118,26757454,55.95396904442751,79.55627061423796,NaN,NaN,-6.993005181753624,12.277966264502869
2007-06-14T09:30:00-04:00,36.02,36.05949,35.50999,35.99001,1747400,1923306.45,45.25962710411257,50.73548892123332,NaN,NaN,-99.55649680836676,-156.92744454400062,-0.12068110496663857,-0.080587815721465,0.040093289245173566,29874518,27771048,60.01746349813667,77.5760558797735,NaN,NaN,-7.579394338040325,9.441200464139555
2007-06-15T09:30:00-04:00,36.10001,36.14999,35.95,36.07001,1221500,1913611.45,47.32156979539821,49.78503639369546,NaN,NaN,-54.372513565025784,-123.02739790730823,-0.09425449642751807,-0.07772483128922403,0.016529665138294045,31096018,28629838,63.12180953653362,75.9063102611302,NaN,NaN,-7.387241228771585,7.037137365152249
2007-06-18T09:30:00-04:00,36.00999,36.03,35.8,35.86,984400,1928148.1,42.76733232992055,48.479037999073064,NaN,NaN,-74.03498199349686,-106.66284566385764,-0.08630287909296117,-0.09134893372790742,-0.0050460546349462496,30111618,29038278,64.5322644781262,74.46294132145292,NaN,NaN,-8.68402743478881,4.791256679446384
2007-06-19T09:30:00-04:00,35.91,35.99001,35.83,35.86,1631963,1921314.15,42.76733232992055,47.15703860684034,NaN,NaN,-66.49539941354806,-85.1743595300034,-0.0767488159483884,-0.10098207457043173,-0.024233258622043348,30111618,29864178,67.25912994412397,73.11441555953303,NaN,NaN,-9.703196315448775,2.7206205373185046
2007-06-20T09:30:00-04:00,36.06,36.06,35.36,35.41,1913600,1961925.45,34.51301233824982,45.114713919646064,NaN,NaN,-101.96721715249384,-79.28532178658625,-0.09523423323372254,-0.14327605016419653,-0.04804181693047399,28198018,29878358,67.30560682557974,71.68806524983943,NaN,NaN,-13.467994465500938,0.40796125120144167
2007-06-21T09:30:00-04:00,35.36,35.5101,35.16,35.50999,1597900,1955598.2,37.403988682074264,43.21349331980838,NaN,NaN,-124.06446566086221,-84.18691555708536,-0.09500908251319866,-0.16680317007197232,-0.07179408755877366,29795918,29862638,67.19173308133156,70.07689668874836,NaN,NaN,-15.533891373479749,-1.869446266610157
2007-06-22T09:30:00-04:00,35.28999,35.38,34.88,34.97,3168610,2016237.75,29.762572933523018,40.97076023353758,NaN,NaN,-157.99629462569112,-104.91167176921844,-0.12369379659597082,-0.2264113333037372,-0.10271753670776637,26627308,28968896,60.884703590054976,67.8976404394928,NaN,NaN,-20.269132750956413,-4.49797290723105
2007-06-25T09:30:00-04:00,34.97,35.25999,34.78999,34.91,2120600,2072372.75,29.052361646008734,38.93179729522798,NaN,NaN,-156.22467621517936,-121.34961061355493,-0.13808119010987385,-0.2753190243451087,-0.13723783423523483,24506708,27847914,54.03383039685364,65.1719635019192,NaN,NaN,-24.130568359387574,-7.302629400396267
2007-06-26T09:30:00-04:00,35.08,35.33,35.00999,35.09,1172800,2052733.1,34.1305311949822,38.043818820834076,NaN,NaN,-123.66309722007767,-132.78315017486085,-0.127122134854842,-0.29614050280378734,-0.16901836794894534,25679508,26961492,49.30895755902021,62.326483768641324,NaN,NaN,-25.57117178244192,-9.91242116925993
2007-06-27T09:30:00-04:00,35,35.38,34.92999,35.38,5263602,2156413.7,41.40706695436469,38.49649668563099,NaN,NaN,-102.32524017400158,-132.85475477916242,-0.09354122825976538,-0.2859449032736521,-0.1924036750138867,30943110,27510510.4,52.10257900551575,60.456106273470716,NaN,NaN,-24.280330474791644,-11.964979641478747
2007-06-28T09:30:00-04:00,35.32001,35.53999,35.31,35.41,1713750,2172771.2,42.119397374199785,38.74135980472767,NaN,NaN,-64.08125720383764,-120.85811308775749,-0.06392114332830834,-0.2723051041742721,-0.20838396084596378,32656860,28082698.8,54.89268161663475,59.57331525710084,NaN,NaN,-23.047498489056075,-13.548196619704079
2007-06-29T09:30:00-04:00,35.36,35.46001,34.96001,35.31,1731500,2080734.7,40.358108915163136,38.83862801403455,NaN,NaN,-86.2955295221666,-106.51796006705258,-0.04648696555945006,-0.26649266779527636,-0.2200057022358263,30925360,28942309.2,58.77765489553571,59.378858253602445,NaN,NaN,-22.581115472105104,-14.838613598618512
2007-07-02T09:30:00-04:00,35.42,35.7,34.8,35.50999,1264103,2056483.85,45.28577797068081,39.62876130441265,NaN,NaN,-61.224498797104815,-87.51792458343769,-0.018353992560597804,-0.24294819293657355,-0.22459420037597574,32189463,30478860.2,64.64013783750656,60.00160866495575,NaN,NaN,-20.63041234618919,-15.666013419700038
2007-07-03T09:30:00-04:00,35.64999,35.64999,35.53999,35.57001,671718,2005805.75,46.70882041837081,39.918392856212115,NaN,NaN,-3.014287601118698,-63.388162659645886,0.006119275143294606,-0.2169451064468575,-0.2230643815901521,32861181,31915194.8,69.06850065437696,60.938360922809274,NaN,NaN,-18.616222444914634,-16.087471851873552
2007-07-05T09:30:00-04:00,35.48,35.62,35.38,35.56,3255574,2011768.15,46.49164268936585,40.006393969444495,NaN,NaN,-9.76820099161638,-44.876754823168845,0.02253268327237648,-0.1948985274996815,-0.217431210772058,29605607,31647694.2,67.37614129166039,61.46398076520382,NaN,NaN,-17.047076710824967,-16.224558260295183
2007-07-06T09:30:00-04:00,35.49001,35.64,35.42999,35.64,977730,1896596,48.550554199917094,40.09417856976727,NaN,NaN,6.571901558076711,-30.746123070785984,0.03872678096655238,-0.16902273456386752,-0.2077495155304199,30583337,31232989.6,64.72822042106253,61.57872439981303,NaN,NaN,-15.140377125087163,-16.069675240979752
2007-07-09T09:30:00-04:00,35.64999,35.67,35.44,35.53,1264800,1860060,45.93338445651933,40.32032515023861,NaN,NaN,2.7833948391544387,-12.930338198521778,0.04172087547547393,-0.15559842118607747,-0.1973192966615514,29318537,30911625,62.6727030109564,61.44589858072947,NaN,NaN,-14.21479437300588,-15.804692259840627
2007-07-10T09:30:00-04:00,35.39,35.50999,35.14999,35.23,1916690,1892527,39.65498751786963,40.09801480652069,NaN,NaN,-57.535809961688834,-12.192600431438553,0.024064061892941024,-0.1672392192953751,-0.19130328118831613,27401847,29954101.8,56.877072611676965,60.704323056983256,NaN,NaN,-15.225867870912657,-15.722003061422345
2007-07-11T09:30:00-04:00,35.19,35.45,35.17999,35.45,1681400,1872232,45.53433640151156,40.88525223961081,NaN,NaN,-35.93276487374503,-18.77629588596382,0.02751959685822772,-0.1569037851155315,-0.1844233819737592,29083247,29198515,52.733025488008145,59.66342439001386,NaN,NaN,-14.296880775119053,-15.518414163379019
2007-07-12T09:30:00-04:00,35.39,36.03,35.39,36.00999,863550,1808159.5,57.01458408987555,42.286009054453764,NaN,NaN,87.44466446343432,0.6662772050463218,0.06566144281973235,-0.10234657844909378,-0.16800802126882614,29946797,29266753,53.065612446379205,58.65441577323154,NaN,NaN,-9.327248731443822,-14.633961958816847
2007-07-13T09:30:00-04:00,35.94,36.03999,35.82001,35.92,1806650,1811122,55.00801955645736,44.089255241806214,NaN,NaN,116.70078891356954,22.692054676144885,0.08191467709809852,-0.06561467489620298,-0.1475293519943015,28140147,28778115,50.334385352298135,57.90082161339176,NaN,NaN,-6.096685615269761,-13.414351052595835
2007-07-16T09:30:00-04:00,35.88,36,35.88,35.96001,1388274,1819460.7,55.75361618637704,45.99648770897539,NaN,NaN,126.41884227054263,47.419144162422526,0.09170612840584394,-0.03289669148699659,-0.12460281989284053,29528421,28820091.8,50.56975160755417,57.65338741415609,NaN,NaN,-3.316254464726831,-11.971765825757405
2007-07-17T09:30:00-04:00,35.8,35.92999,35.77,35.85001,1450300,1842755.7,53.145973910926784,47.35473361725714,NaN,NaN,101.30370384855031,79.18704692447037,0.08715187070981004,-0.01566298150557799,-0.10281485221538803,28078121,28955346.6,51.3694488827287,57.80056536584955,NaN,NaN,-1.8179258829712224,-10.521217262502237
2007-07-18T09:30:00-04:00,35.75999,35.75999,35.49001,35.75,2247200,1873517.55,50.81876944162389,48.026998080632794,NaN,NaN,55.91414246572378,97.55642839236411,0.074283643965941,-0.00996029725796177,-0.08424394122390277,25830921,28304881.4,47.39800062013804,57.46452405260828,NaN,NaN,-1.2690568292054203,-9.199480057745548
2007-07-19T09:30:00-04:00,35.67,35.7,35.42,35.56,1332531,1844464.1,46.64027232455654,48.349917719943996,NaN,NaN,25.648704666293803,85.19723643293601,0.05096669718329823,-0.02053556974477999,-0.07150226692807822,24498390,27215200,41.596258444053056,56.514779540281026,NaN,NaN,-2.0625547108808138,-8.17991929390773
2007-07-20T09:30:00-04:00,35.44,35.5,35.11,35.23,2122319,1870685.05,40.423376733361174,48.35457970695814,NaN,NaN,-54.325713452461926,50.99193595972972,0.013272371638612196,-0.05491180237981297,-0.06818417401842516,22376071,26062384.8,36.50530398881001,54.92389733265776,NaN,NaN,-4.788540712880305,-7.695436639475241
2007-07-23T09:30:00-04:00,35.53999,35.72,35.42,35.5,1916087,1808058.9,46.68512235418265,48.45453287720827,NaN,NaN,17.357144703723183,29.17959644636583,0.006802930324873668,-0.05968051111233308,-0.06648344143720675,24292158,25015132.2,32.601733119655805,52.635439852811274,NaN,NaN,-5.0823187088167945,-7.322134077952605
2007-07-24T09:30:00-04:00,35.39,35.53999,35.05,35.14,2853223,1844690.05,40.56335495437184,48.015571058351206,NaN,NaN,-87.63856586997646,-8.608857497339528,-0.019976853134954717,-0.09145450785590015,-0.07147765472094543,21438935,23687295,28.448022394958755,49.733977119995686,NaN,NaN,-7.451073916065214,-7.3405540548258355
2007-07-25T09:30:00-04:00,35.36,35.99001,34.94,35.12,2130400,1892570.05,40.247599772246375,47.56956799284267,NaN,NaN,-58.627919659686384,-31.517269922421566,-0.036339388087582095,-0.11690188983042304,-0.08056250174284095,19308535,22382817.8,25.068877648050005,46.71202971688065,NaN,NaN,-9.38489549064578,-7.632602831371542
2007-07-26T09:30:00-04:00,34.89,34.94,34.25999,34.39999,3457170,1802248.45,30.917039282787243,46.31003121304768,NaN,NaN,-279.93972604372664,-92.63495606442564,-0.08990502040436371,-0.1929437772482956,-0.10303875684393188,15851365,20653412.8,21.433906651626103,43.619578733349485,NaN,NaN,-14.751709836086116,-8.649618117759339
2007-07-27T09:30:00-04:00,34.27,34.61,33.58,33.58,3411503,1887136.1,24.072506954478598,44.748539962901916,NaN,NaN,-321.0003604349948,-145.9698854609322,-0.17015641274724466,-0.3157342727779877,-0.14557786003074305,12439862,18666171,18.17304452540526,40.44103169866726,NaN,NaN,-22.490520639043034,-10.626889906514151
2007-07-30T09:30:00-04:00,33.67999,34.00999,33.60001,34,2987829,1949952.55,32.3354116407081,44.225713114533235,NaN,NaN,-252.54707608668943,-199.95072961901474,-0.18340592604862838,-0.3748352675915285,-0.19142934154290014,15427691,16893277.6,15.85550209537962,37.51091951893174,NaN,NaN,-25.16834324601009,-12.704240383584999
2007-07-31T09:30:00-04:00,34.47,34.5,33.62,33.63,2694110,2021452.9,29.30935494989474,43.066785867989175,NaN,NaN,-185.7754671584778,-219.57810987671502,-0.20396333343915093,-0.4463835083418388,-0.24242017490268788,12733581,15152206.8,13.971193599929634,34.74221724121185,NaN,NaN,-28.43847395251847,-14.95198803628978
2007-08-01T09:30:00-04:00,33.57001,34,33.48,33.86,4001543,2187944.15,33.47691478617992,41.385523774868055,NaN,NaN,-158.93256641525102,-239.63903922782794,-0.1892680620173416,-0.47900525242436487,-0.2897371904070233,16735124,14637524.6,13.461880170871552,31.91337922153273,NaN,NaN,-29.37506267065897,-17.01242726977109
2007-08-02T09:30:00-04:00,33.88,34.3,33.88,34.14999,2386101,2144470.5,38.40738575991688,40.19976421797231,NaN,NaN,-102.09826887336907,-204.07074779375642,-0.14898764303380918,-0.4759717441992848,-0.3269841011654756,19121225,15291496.6,17.57359209634643,29.57332256039332,NaN,NaN,-28.325302356409505,-18.628552282148007
2007-08-03T09:30:00-04:00,34.17,34.31,33.67,33.67999,4094655,2300316.75,34.00795882748966,38.646502978051785,NaN,NaN,-106.11569679780767,-161.093815066319,-0.14294372869782979,-0.5056637620377629,-0.3627200333399331,15026570,15808838.2,20.780242849045166,27.44550050621411,NaN,NaN,-29.0549118529574,-20.11803222083506
2007-08-06T09:30:00-04:00,33.84,34.49001,33.84,34.34,3421526,2408153.05,43.75174522646707,37.97548664344752,NaN,NaN,-65.9263859563424,-123.76967704024958,-0.08623502821736218,-0.47051381861163577,-0.3842787903942736,18448096,16412919.2,24.474939829635574,25.52446414527889,NaN,NaN,-25.95629745047441,-20.95207011078354
2007-08-07T09:30:00-04:00,34.28999,34.78999,34.27,34.5,1754300,2400033.55,45.83947002097226,37.61982239911525,NaN,NaN,-35.252245430048944,-93.66503269456382,-0.03245630812003464,-0.4248491755443169,-0.39239286742428225,20202396,17906682.2,32.818753235601136,24.483089332097684,NaN,NaN,-22.8532576776968,-21.223668334628293
2007-08-08T09:30:00-04:00,34.60001,34.89999,34.45,34.89999,2438073,2437867.2,50.75983718773758,37.914077032199614,NaN,NaN,-12.242922699041664,-64.32710395132196,0.03205636329472378,-0.35232241330587755,-0.3843787766006013,22640469,19087751.2,38.59511861257091,24.26872220127753,NaN,NaN,-18.569100149941676,-20.84444430824449
2007-08-09T09:30:00-04:00,34.5,34.75999,34.05,34.08,2228400,2506109.7,42.27989954309501,38.04668580432347,NaN,NaN,-48.181198600128326,-53.54368989667381,0.021985670165789506,-0.35689668889336446,-0.37888235905915396,20412069,19345920,39.81332292417483,24.5050092680893,NaN,NaN,-17.982868440526193,-20.435647755713305
2007-08-10T09:30:00-04:00,33.88,34.12,33.62,33.89999,2373232,2534438.8,40.67348871594506,37.61728340159221,NaN,NaN,-80.650533301471,-48.45065719740647,0.00648741013608789,-0.3707730963890441,-0.377260506525132,18038837,19948373.4,42.671519241293204,25.224279705349108,NaN,NaN,-18.102492749804167,-20.102339897726285
2007-08-13T09:30:00-04:00,34.12,34.36,34,34,2071000,2568575.1,41.9921727659091,37.71934181670201,NaN,NaN,-52.21712910575703,-45.70880582728938,0.006255136825091712,-0.3694415854937674,-0.3756967223188591,20109837,20280721.6,44.244537156459934,26.35260218831348,NaN,NaN,-17.759119730972557,-19.76759415961861
2007-08-14T09:30:00-04:00,34.19,34.2,33.69,33.72,1358700,2563995.1,39.354700838479374,37.65556332143294,NaN,NaN,-74.2526876637136,-53.508894274022325,-0.008662142760605729,-0.38652440076961625,-0.3778622580090105,18751137,19990469.8,43.131463998825524,27.64278692765459,NaN,NaN,-18.330939609196246,-19.562357795272558
2007-08-15T09:30:00-04:00,33.7,34.14,33.56,33.64,2001100,2551690.1,38.60856180129763,38.204957787040826,NaN,NaN,-79.15169264355596,-66.89064826292518,-0.019218435798864786,-0.4018853027575915,-0.3826668669587267,16750037,18812383.4,38.85843125062368,28.88739582758299,NaN,NaN,-19.014924975527162,-19.4841531067375
2007-08-16T09:30:00-04:00,33.28,33.72,32.94,33.64999,3455600,2657843.55,38.764691399647546,39.25439953312433,NaN,NaN,-116.93028516776394,-80.64046557645231,-0.02070121436140282,-0.40854338491048026,-0.38784217054907744,20205637,18771097,38.713680428426045,30.35458410637019,NaN,NaN,-19.517476039355174,-19.488913525682882
2007-08-17T09:30:00-04:00,34.39999,34.39999,33.39149,33.73,1859150,2644685.1,40.07906693773651,39.80751776862636,NaN,NaN,-59.32267753789275,-76.37489442373666,-0.011903465055849438,-0.4027215018688892,-0.3908180368130398,22064787,19576287,43.16061923641857,32.3049496164444,NaN,NaN,-19.569454835405057,-19.500419427071765
2007-08-20T09:30:00-04:00,33.92,34.03,33.67999,33.89,1554852,2626623.35,42.72653896962387,40.76588805574987,NaN,NaN,-51.46912125699636,-76.22529285398453,0.008008632727770304,-0.38080724590332693,-0.38881587863109723,23619639,20278247.4,46.78575628567147,34.64884695114024,NaN,NaN,-18.886486945804613,-19.412714786890742
2007-08-21T09:30:00-04:00,33.78999,34.05,33.73,33.98,1559109,2561917.65,44.219479760012554,41.533214125309335,NaN,NaN,-36.71548470200518,-68.71785226164283,0.029357673986531108,-0.35211878614793335,-0.38147646013446446,25178748,21563769.6,52.731407321452984,37.453813176181775,NaN,NaN,-17.909003016311985,-19.197898819665205
2007-08-22T09:30:00-04:00,34.09,34.2,33.97,34.14999,2742800,2592537.65,47.028144421010744,42.14898260110176,NaN,NaN,20.804797531135865,-48.72655422670448,0.055526074408197346,-0.3120688671242178,-0.3675949415324151,27921548,23798071.8,60.90697338528642,40.54905469682035,NaN,NaN,-16.305433605987243,-18.784689503425497
2007-08-23T09:30:00-04:00,34.23,34.44,34.14,34.37,6065199,2722939.1,50.50197721917913,43.32712677193672,NaN,NaN,86.62659677851217,-8.015177837449263,0.08640896938414783,-0.2595837298022303,-0.34599269918637815,33986747,26554293.8,68.21122762987764,43.936982181165526,NaN,NaN,-13.945437685311093,-18.09336781512344
2007-08-24T09:30:00-04:00,34.3,34.58,34.22,34.58,4721602,2788444.05,53.6279256254769,44.03256822900885,NaN,NaN,111.07757651560502,26.06487297325029,0.11779212749081236,-0.19875253982286267,-0.31654466731367503,38708349,29883006.2,74.42596296807642,47.50491240533987,NaN,NaN,-11.016046980236199,-17.08232198156812
2007-08-27T09:30:00-04:00,34.46001,34.55,34.34,34.34,741500,2676127.6,49.76022442483342,44.31262211499893,NaN,NaN,87.0887148292361,53.776440190496785,0.11885726302653277,-0.16797308853050907,-0.28683035155704184,37966849,32752448.2,78.35443502329662,50.75746110446097,NaN,NaN,-9.510312632486166,-16.000606360270698
2007-08-28T09:30:00-04:00,34.34,34.36,33.88,33.99001,1447900,2613817.1,44.69760535175293,43.87960555528574,NaN,NaN,-1.5683647609104834,60.805864178715716,0.09357360861956077,-0.1698633407825909,-0.2634369494021517,36518949,35020488.4,80.85744337887313,53.77619858776827,NaN,NaN,-9.62840161359698,-15.090291396460167
2007-08-29T09:30:00-04:00,34,34.34,33.86,34.24001,1300100,2478744.95,48.71163719021911,44.33901538722318,NaN,NaN,12.993538399708475,59.24361235243024,0.09117714101259056,-0.14946552313641348,-0.24064266414900404,37819049,36999988.6,82.73405036419268,56.841964833483836,NaN,NaN,-8.55408119347264,-14.156547081747663
2007-08-30T09:30:00-04:00,34.14,34.44,34.14,34.24001,1152300,2417054.9,48.71163719021911,44.91316884967132,NaN,NaN,45.14538421294837,50.94736983931748,0.0870893183832809,-0.1317810161699029,-0.2188703345531838,37819049,37766449,83.41213324671622,59.752008691014055,NaN,NaN,-7.682215000535125,-13.2316424987173
2007-08-31T09:30:00-04:00,34.49001,34.66,34.34,34.39999,1085200,2266582.15,51.33322548806574,45.58038690125394,NaN,NaN,88.23407409993389,46.37866935618325,0.092166733294587,-0.10366191793495005,-0.19582865122953705,38904249,37805629,83.44791851855163,62.552250216877745,NaN,NaN,-6.205748054970134,-12.227943292467705
2007-09-04T09:30:00-04:00,34.50999,34.82001,34.49001,34.7,896400,2140325.85,55.8869567324422,46.761262322251284,NaN,NaN,124.9089702069374,53.94272043172352,0.11144889589231502,-0.05651753136414328,-0.1679664272564583,39800649,38172389,83.80022845197155,65.45716196353104,NaN,NaN,-3.575342432450443,-10.991857455322382
2007-09-05T09:30:00-04:00,34.63,34.69,34.44,34.63,868200,2096020.85,54.60315036663013,47.90373293406075,NaN,NaN,102.28744191717824,74.71388176734126,0.11475632795585311,-0.024521017311641913,-0.13927734526749502,38932449,38655089,84.27463749264314,68.70117669510385,NaN,NaN,-1.7381581463760145,-9.669900411187186
2007-09-06T09:30:00-04:00,34.61,34.86,34.53999,34.74001,2101200,2079177.2,56.302054565455435,49.15640173161846,NaN,NaN,134.34486641258218,98.98414736991602,0.11910399212806669,0.00960264489258833,-0.10950134723547836,41033649,39298009,84.90856405808631,72.00081124007959,NaN,NaN,0.29243225177714877,-8.24671003076371
2007-09-07T09:30:00-04:00,34.42999,34.7,34.22,34.37,2286100,2082062.2,49.581176962551055,49.83512387624806,NaN,NaN,62.03555443151449,102.36218141362923,0.09297052481719484,0.006711808786015183,-0.08625871603117966,38747549,39483709,85.09545857297336,74.99615690697635,NaN,NaN,0.2056716752033758,-7.039226929911269
2007-09-10T09:30:00-04:00,34.39999,34.53,34.19,34.39999,1057700,2016285.6,50.10110158914154,50.36187834907075,NaN,NaN,43.384588089426906,93.39228421152784,0.07441720124532306,0.006762785525474158,-0.0676544157198489,39805249,39663909,85.28588520969171,77.74616611583495,NaN,NaN,0.278189931810036,-5.993881663951083
2007-09-11T09:30:00-04:00,34.49001,34.72,34.37,34.66,864300,1955950.6,54.483527210283064,51.095024595518645,NaN,NaN,84.26339277172502,85.26316872448535,0.07609728797345812,0.027467194246973747,-0.04863009372648437,40669549,39837689,85.47857031488758,80.08524918679457,NaN,NaN,1.5931964843171265,-4.910013357055624
2007-09-12T09:30:00-04:00,34.67,34.94,34.64,34.81,1213100,1948670.6,56.83860347370463,51.79577167071107,NaN,NaN,121.59123676828106,89.12392769470594,0.08317718906007829,0.05534139259861348,-0.0278357964614648,41882649,40427729,86.14212539244183,81.88776004444853,NaN,NaN,3.3870521035731045,-3.72471829125152
2007-09-13T09:30:00-04:00,35.07001,35.14,34.89,34.89,889500,1893090.6,58.08425614703037,52.337363022700444,NaN,NaN,148.75719810647297,92.0063940334841,0.08861363495474098,0.08293124723196144,-0.005682387722779549,42772149,40775429,86.53265809446287,83.19643364906175,NaN,NaN,5.239909469906072,-2.4440571825147215
2007-09-14T09:30:00-04:00,35,35,34.71001,34.78999,1140200,1777320.6,55.91183825518709,52.500499639108305,NaN,NaN,112.71315168461236,102.14191348410365,0.08104522143443174,0.09562413907026013,0.014578917635828387,41631949,41352309,87.17827191201086,84.10731285934278,NaN,NaN,6.226989144850852,-1.2053362786053539
2007-09-17T09:30:00-04:00,34.71001,34.8,34.46899,34.67999,2763000,1822513.1,53.539936314158446,52.77047905977439,NaN,NaN,60.1178244923471,105.48856076468769,0.06490010580680698,0.09570404989433712,0.030803944087530132,38868949,41165049,85.74137505566173,84.63495143308316,NaN,NaN,6.432020252791524,-0.11428534554865699
2007-09-18T09:30:00-04:00,34.67,35.312,34.64999,35.3,2328624,1861201.7,63.0537390989637,54.081631470289445,NaN,NaN,161.50261576553436,120.93640536344958,0.0906652453908467,0.1441355008260885,0.05347025543524181,41197573,41270653.8,85.88269145652063,84.99389772434368,NaN,NaN,9.617506447255947,1.2759706248520006
2007-09-19T09:30:00-04:00,35.44,35.67,35.35001,35.44,1623600,1864426.25,64.8062238049053,55.23124479990988,NaN,NaN,229.22206210973104,142.46257043173958,0.11050850857005937,0.191605891147816,0.08109738257775664,42821173,41458358.6,86.14552536175948,85.23757450988418,NaN,NaN,12.790678509119878,2.9209288940331257
2007-09-20T09:30:00-04:00,35.48,35.63,35.33,35.39999,1046300,1779601.25,63.873761180733865,56.31425365637522,NaN,NaN,186.51000052701514,150.01313091584802,0.11386014879082833,0.22342256856629206,0.10956241977546373,41774873,41258903.4,84.34847039654521,85.30445573487195,NaN,NaN,15.090619802866948,4.659456166723672
2007-09-21T09:30:00-04:00,35.44,35.52,35.39999,35.45,1371400,1544911.3,64.56016453982943,57.25903501721549,NaN,NaN,156.93418829952748,158.85733823883103,0.11218481650460668,0.2497934404062221,0.1376086239016154,43146273,41561768.2,84.86477458870904,85.40565973988319,NaN,NaN,17.185085362683157,6.448831766146455
2007-09-24T09:30:00-04:00,35.32001,35.46001,35.26801,35.38,1385100,1378086.2,62.762604206805136,57.75015269395569,NaN,NaN,118.7771434397677,170.58920202831516,0.09953204920221703,0.2620236854043867,0.16249163620216966,41761173,42140213,85.82644335646002,85.55038937591807,NaN,NaN,18.456258175450213,8.164178396046992
2007-09-25T09:30:00-04:00,35.32001,35.4305,35.2106,35.25999,1824300,1432226.2,59.693914439267665,58.1137786991441,NaN,NaN,93.1206953111807,156.91281793744443,0.07724374222873368,0.25904631398808675,0.18180257175935308,39936873,41888073,83.3406889654926,85.4836787668359,NaN,NaN,18.712203561260743,9.67103913393467
2007-09-26T09:30:00-04:00,35.37,35.592,35.33,35.46001,751700,1397416.2,62.94576481062499,58.58832943094192,NaN,NaN,107.76865361977998,132.6221362394542,0.07033196838028383,0.26971753223470785,0.19938556385442402,40688573,41461553,79.16386269473074,85.07334295516765,NaN,NaN,19.84383046867986,11.124295038898268
2007-09-27T09:30:00-04:00,35.66,35.66,35.47,35.60001,822600,1373541.2,65.0699779343465,59.69467235749874,NaN,NaN,113.34304269371167,117.98874467279352,0.06942959724298983,0.2861725604081613,0.21674296316517147,41511173,41408813,78.63903960387485,84.61217017166061,NaN,NaN,21.415951901261188,12.594531733521542
2007-09-28T09:30:00-04:00,35.53,35.61,35.28,35.35001,1069200,1369386.2,58.608692550696475,60.302357426181224,NaN,NaN,76.35983372131524,101.87387375715107,0.04729397410452177,0.2758604307958237,0.2285664566913019,40441973,40867953,73.27408808541765,83.7541846627839,NaN,NaN,20.927059055503644,13.784892779518986
2007-10-01T09:30:00-04:00,35.5,35.89,35.48,35.89,8321930,1731222.7,66.37523781067287,61.15176532620903,NaN,NaN,121.3149011528258,102.38142529976268,0.06331766961619859,0.30771354371155013,0.24439587409535155,48763903,42268499,77.5459688197634,83.18757027027502,NaN,NaN,22.9945194745461,15.10055373595143
2007-10-02T09:30:00-04:00,35.89999,35.98,35.56,35.69,2193700,1796087.7,61.753460723222624,61.50282655831745,NaN,NaN,107.06075958559902,105.16943815464636,0.0550501513669886,0.3132085633040873,0.2581584119370987,46570203,43595165,80.69392999944019,82.7984134564892,NaN,NaN,23.194537588262445,16.25683714342443
2007-10-03T09:30:00-04:00,35.72,35.83,35.53999,35.83,1216700,1813512.7,63.66093786813606,61.90116096696786,NaN,NaN,95.80423128873252,102.77655368843686,0.053563303167047716,0.32511254089590835,0.27154923772886064,47786903,45014831,83.37924405368281,82.57316959643347,NaN,NaN,23.95874267565061,17.357109362313885
2007-10-04T09:30:00-04:00,35.82001,36.03999,35.78999,35.78999,1037800,1760342.7,62.69855053393122,62.3859261297353,NaN,NaN,109.00024316224234,101.907993782143,0.04479449136365632,0.32754235193343106,0.28274786056977474,46749103,46062417,85.0335238099067,82.41997330342603,NaN,NaN,24.28125011599195,18.346272327125035
2007-10-05T09:30:00-04:00,36.00999,36.25,35.96001,36.25,1831191,1737597.25,68.57979560598801,63.46020179343741,NaN,NaN,147.88463313267067,116.21295366441409,0.06372917400849143,0.36240932808038906,0.29868015407189763,48580294,47690081.2,87.17019648880884,82.52203197722226,NaN,NaN,26.492428904997062,19.510008981106754
2007-10-08T09:30:00-04:00,36.16,36.21001,35.98,36,783600,1723892.25,62.7859922593567,63.44107701917977,NaN,NaN,128.2289756751148,117.59576856887188,0.053578851749453704,0.3656537187587148,0.31207486700926107,47796694,47496639.4,85.60599457935709,82.50226791456771,NaN,NaN,26.44539572220024,20.50077851554868
2007-10-09T09:30:00-04:00,36.17999,36.3,36.05,36.3,473500,1704352.25,66.44900856141821,63.558418787502134,NaN,NaN,147.64985343705183,125.71358733916244,0.060708306610971374,0.3879602502729753,0.32725194366200394,48270194,47836637.6,86.07883157698116,82.49750407279784,NaN,NaN,27.616550953182117,21.5173174352106
2007-10-10T09:30:00-04:00,36.3,36.36,36.19,36.36,1435032,1715448.85,67.14554109444987,63.792117352767555,NaN,NaN,143.9709093320946,135.34692294783486,0.06284004737499493,0.40580200288074764,0.3429619555057527,49705226,48220302.2,86.61323025804356,82.65927263433343,NaN,NaN,28.76247057605148,22.552339312473585
2007-10-11T09:30:00-04:00,36.38,36.39,35.97,36.05,4141898,1878068.75,60.19251780014733,63.4801425856474,NaN,NaN,100.24204970324864,133.5952842560361,0.037971807599408325,0.39042671500501314,0.3524549074056048,45563328,47983147.2,84.45508470858763,82.63000907146761,NaN,NaN,27.501626061398376,23.259380276605697
2007-10-12T09:30:00-04:00,36.12,36.25,36,36.25,1450300,1893573.75,62.86430031094159,63.48740659308572,NaN,NaN,96.14893577216135,123.24814478393425,0.029944600436564772,0.3898856579513108,0.35994105751474603,47013628,47669814,81.5634019947962,82.32550611706306,NaN,NaN,27.297499973691806,23.83625451904657
2007-10-15T09:30:00-04:00,36.2,36.39,35.7,35.86,2198300,1865338.75,55.09835511182778,63.15915235541144,NaN,NaN,54.336609625140234,108.46967157393935,-0.0048268457398024656,0.35390750033999296,0.35873434607979543,44815328,47073540.8,76.21540495928828,81.81655725947704,NaN,NaN,24.517063868581037,23.933512997551492
2007-10-16T09:30:00-04:00,35.8,35.83,35.53,35.59,3103000,1904057.55,50.451607500838634,62.26671254756956,NaN,NaN,-27.510532875416395,73.4375943114457,-0.046869165126249834,0.30014788967198314,0.34701705479823297,41712328,45761967.6,65.96907886699059,80.87407270035274,NaN,NaN,20.63378675299921,23.462123534044025
2007-10-17T09:30:00-04:00,35.95,35.95,35.37,35.62,2439900,1944872.55,50.94662609013981,61.25790170155481,NaN,NaN,-30.94163889075999,38.45508466687477,-0.07201267567340058,0.25700121020648226,0.32901388587988284,44152228,44651368,58.76477309171628,79.45448223519854,NaN,NaN,17.738456398803475,22.64445680043823
2007-10-18T09:30:00-04:00,35.23,35.85741,35.23,35.63,1320500,1958582.55,51.121921076894786,60.72313231056897,NaN,NaN,-51.526369864122294,8.101400753400585,-0.08635849767567394,0.22106576378529041,0.30742426146096435,45472728,44633248,58.65222928388045,78.41006374937446,NaN,NaN,15.476663089805873,21.620486270347893
2007-10-19T09:30:00-04:00,35.61,35.64999,35.17999,35.2,1611200,1970572.55,43.86328669321664,59.11513580217923,NaN,NaN,-105.58308285984546,-32.245002973000766,-0.12106744958434651,0.15608994948053123,0.27715739906487774,43861528,44002828,54.725333032361256,76.7800183359886,NaN,NaN,11.092999025519308,20.116559521086668
2007-10-22T09:30:00-04:00,34.95,35.2,34.82001,35.2,1972000,1999917.55,43.86328669321664,57.83726622860737,NaN,NaN,-161.25624328675934,-75.36357355538068,-0.13900258355746034,0.10340416961805232,0.24240675317551266,43861528,43812068,53.55685122835509,74.84165556662538,NaN,NaN,7.615572020566995,18.330704163869573
2007-10-23T09:30:00-04:00,35.23,35.61,35.19,35.61,2164500,2016927.55,51.48129928730316,56.96729204426217,NaN,NaN,-71.56785190978539,-84.17503736225447,-0.1190019668816466,0.09365429457345442,0.21265626145510103,46026028,44674808,57.93172519850674,73.02397564839853,NaN,NaN,6.835734428913169,16.68856563030437
2007-10-24T09:30:00-04:00,35.48,35.49001,34.97,35.35001,3290700,2143877.55,47.11501960361113,55.85418269209645,NaN,NaN,-114.35984083618764,-100.85867775134001,-0.11875838903935043,0.06420827515591299,0.18296666419526342,42735328,44391428,56.06362981263083,70.95469750573598,NaN,NaN,4.783611801452246,14.987857940468354
2007-10-25T09:30:00-04:00,35.09,35.62,35.09,35.56,2067400,2206117.55,50.74838581938933,54.58051056448226,NaN,NaN,-74.84484039558016,-105.52237185763158,-0.10064720910144781,0.05715765281845364,0.15780486191990145,44802728,44257428,55.157875517870316,68.66810315066893,NaN,NaN,4.210858175550558,13.448286545480098
2007-10-26T09:30:00-04:00,34.75999,35.74001,34.75999,35.67999,920401,2198677.6,52.746154084175465,53.86337926625502,NaN,NaN,-81.24917171094499,-100.65558962785148,-0.07780057469785376,0.06055414354758426,0.13835471824543802,45723129,44629748.2,57.22567689099841,66.64093760150045,NaN,NaN,4.353771446297029,12.14907010273966
2007-10-29T09:30:00-04:00,35.75999,35.86,35.67999,35.83,839400,1824551.1,55.19312676578727,53.05938770942424,NaN,NaN,9.022104690453194,-66.59992003240897,-0.05109037798889074,0.0744917457593246,0.12558212374821534,46562529,45169948.4,60.100511054747464,64.78534327848377,NaN,NaN,5.212263454768324,11.158097724458042
2007-10-30T09:30:00-04:00,35.71001,35.88,35.69,35.78999,1220650,1775898.6,54.384221064668964,52.14786485015418,NaN,NaN,7.733679542696789,-50.73961374191255,-0.0353689550972309,0.08137092987667671,0.11673988497390761,45341879,45033118.6,59.01850793681832,62.814291684110536,NaN,NaN,5.681357728369897,10.37570629644545
2007-10-31T09:30:00-04:00,34.89999,36.10001,34.89999,36.00999,1654539,1797790.55,58.026914375607085,51.993178891258445,NaN,NaN,-17.736339538068588,-31.41491348228875,-0.010685381940428743,0.10338315754837168,0.11406853948880043,46996418,45885336.6,63.434030732875456,61.312787828702525,NaN,NaN,7.16090206323107,9.916448548843396
2007-11-01T09:30:00-04:00,36.00999,36.08,35.44,35.50999,2415498,1866675.45,48.53973849167554,50.96999590416801,NaN,NaN,-14.215162463914654,-19.28897789595565,-0.027602824117532926,0.07956500934188426,0.10716783345941719,44580920,45840975,63.0531906814261,59.990629877747516,NaN,NaN,5.514439567027713,9.287590122869727
2007-11-02T09:30:00-04:00,35.39999,35.62,35.22,35.41,2411015,1895666.65,46.88873776635986,50.38359466520602,NaN,NaN,-67.46609684498819,-16.53236292276429,-0.044117520363314816,0.05202093300527366,0.09613845336858848,42169905,45130330.2,57.13544884871355,58.62777586984932,NaN,NaN,3.668886884603676,8.484918231688862
2007-11-05T09:30:00-05:00,35.41,35.73,35.16,35.39,2652979,1989135.6,46.5476971203953,50.10474392374578,NaN,NaN,-60.41880181326714,-30.42054422350835,-0.05430872791364985,0.02825254347652617,0.08256127139017602,39516926,43721209.6,47.59643212455485,57.31544395967535,NaN,NaN,2.086006302776437,7.570787956129944
2007-11-06T09:30:00-05:00,35.34,35.58,35.03,35.58,1337399,2032330.55,50.249738406215116,50.054966232036875,NaN,NaN,-61.86685951171358,-44.34065203439043,-0.04647676533789406,0.02446531471780844,0.0709420800557025,40854325,42823698.8,42.70584006175377,56.16837731467802,NaN,NaN,1.8064456582186275,6.7473104849997565
2007-11-07T09:30:00-05:00,35.87,35.87,34.77,34.77,2126002,2066879.05,38.12651627198559,49.12672303168621,NaN,NaN,-122.5849470338745,-65.31037353355161,-0.09147052718204338,-0.04339607892185171,0.04807444826019166,38728323,41170079.8,35.473601038737854,54.51276101145355,NaN,NaN,-2.7124784506796082,5.39591206561699
2007-11-08T09:30:00-05:00,34.19,35.11,34.19,35,3631756,2041371.95,42.37763137934522,49.02060479498111,NaN,NaN,-203.1829085497597,-103.10392275072063,-0.10063693213929549,-0.07772171691392771,0.022915215225367783,42360079,40725911.6,33.817002393297614,53.01930882294899,NaN,NaN,-4.920207650931213,3.9221806775386754
2007-11-09T09:30:00-05:00,34.14,35.35001,34.14,34.91,3258713,2131792.6,41.1851854965256,48.82931185236033,NaN,NaN,-181.25390244799792,-125.86148387132258,-0.10705920629300768,-0.11090879264089182,-0.0038495863478841368,39101366,40112203.8,31.619800264976192,51.45237661127907,NaN,NaN,-7.047917192515819,2.355023838959462
2007-11-12T09:30:00-05:00,34.03,35.42,34.03,35,2365966,2140175.9,42.915035389342876,48.21743585964888,NaN,NaN,-153.69902732233513,-144.51752897313617,-0.09969365712409414,-0.1284666577530018,-0.028773000628907672,41467332,40502285,34.53149208359959,49.780931388785696,NaN,NaN,-8.226181511747042,0.8434230745728186
2007-11-13T09:30:00-05:00,34.96001,35.58,34.96001,35.46001,3230866,2146569.2,50.869048603805766,48.4855807882342,NaN,NaN,-7.713547207664766,-133.6868665123264,-0.060231885869804165,-0.10406285796616288,-0.043830972096358715,44698198,41271059.6,39.95775294000766,48.630511612169755,NaN,NaN,-6.661572602664887,-0.22871916503256795
2007-11-14T09:30:00-05:00,35.49001,35.7599,35.33,35.60001,2512455,2150196.95,53.014760756257374,48.647464712296205,NaN,NaN,59.736920523655634,-97.22249300082038,-0.023006485622920583,-0.07258907912500945,-0.049582593502088865,47210653,42967525.6,49.838115588800726,48.25052876009336,NaN,NaN,-4.7071697322354105,-0.8684978174901169
2007-11-15T09:30:00-05:00,35.22,35.75,35.22,35.38,2425915,2205467.7,49.36601638117667,48.406026304939154,NaN,NaN,29.432835292870624,-50.69934423229431,-0.012056777107294504,-0.064653564886207,-0.05259678777891249,44784738,43452457.4,52.2566327929557,47.8955970388046,NaN,NaN,-4.212271860748342,-1.3461798236698632
2007-11-16T09:30:00-05:00,35.5,35.63,35.3,35.53999,2116399,2230727.65,51.95556926878422,48.174772198010366,NaN,NaN,38.30861417731152,-6.78684090723242,0.006128027146555463,-0.04493675384571816,-0.05106478099227362,46901137,45012411.6,59.089810237132085,47.82340412326065,NaN,NaN,-3.000978685583886,-1.5825796610861522
2007-11-19T09:30:00-05:00,35.60001,35.60001,35.21001,35.34,1725003,2218377.8,48.60900229328146,47.762256571482695,NaN,NaN,3.2602313877357134,24.605010834781744,0.004907322119569721,-0.044930628342811474,-0.049837950462381195,45176134,45754172,61.88338595896543,48.02803826769972,NaN,NaN,-2.999599564875957,-1.7850110759132671
2007-11-20T09:30:00-05:00,35.67,35.67,35.06,35.41,3843043,2302304.95,49.827179234556596,47.17656120426481,NaN,NaN,3.6728306652009413,26.882286409354883,0.0088065574715403,-0.03882975362295582,-0.04763631109449612,49019177,46618367.8,64.89137318572108,48.1321341571887,NaN,NaN,-2.640024948680052,-1.9071559148799506
2007-11-21T09:30:00-05:00,34.97,35.23,34.62,34.62,2262584,2250899.15,38.682818328232315,46.47249547830457,NaN,NaN,-145.2120602773162,-14.107509750839487,-0.03919279490606624,-0.09662730472707892,-0.05743450982101268,46756593,46527555.8,64.31698811357995,48.22240540234254,NaN,NaN,-6.101432739214832,-2.506338318356362
2007-11-23T09:30:00-05:00,34.67999,35.28,34.67999,35.17999,1331126,2214085.45,47.62512798338522,46.525094779520664,NaN,NaN,-72.69419278887014,-34.53291536718764,-0.03096243497835903,-0.09613755354396147,-0.06517511856560244,48087719,47188152,66.63085700315267,48.90064884194533,NaN,NaN,-5.897430271968804,-2.9907800260152824
2007-11-26T09:30:00-05:00,35.5,35.5,34.89,34.91,2070704,2271600.6,44.27272754505914,46.362596952710945,NaN,NaN,-52.53596392559623,-52.701830987769185,-0.04081664475868027,-0.11619592451395278,-0.0753792797552725,46017015,47011327.6,65.40821214424972,50.172918843352114,NaN,NaN,-6.910017933999931,-3.550671155727375
2007-11-27T09:30:00-05:00,35.41,35.7,34.7,35.36,2117071,2335484.15,50.523941273017776,46.38218287176828,NaN,NaN,-8.518600553690801,-55.05759737605449,-0.015448229353821286,-0.09468956644754911,-0.07924133709372783,48134086,47602918,67.55336478909783,51.9477420381624,NaN,NaN,-5.526888593493244,-3.8329879325510703
2007-11-28T09:30:00-05:00,35.87,36.37,35.61,36.2,1808885,2364895.9,59.62788419763085,47.91799486645722,NaN,NaN,191.1294256553241,-17.566278378029853,0.05559128941506594,-0.009752225324895392,-0.06534351473996133,49942971,47787676.8,68.21628094583052,54.286504888669015,NaN,NaN,-0.7597252099346214,-3.3939504007487207
2007-11-29T09:30:00-05:00,35.77,36.42999,35.56,36.42,5502180,2557277.95,61.61979461357246,49.29243509747345,NaN,NaN,191.08569713878148,49.69327310518968,0.11183890665463145,0.07445511857832798,-0.037383788076303465,55445151,49525388.4,73.66588465547284,57.132853621681534,NaN,NaN,3.615154183542166,-2.3926497458500227
2007-11-30T09:30:00-05:00,36.5,36.58,36.34,36.47,2469439,2559975,62.077740857027905,50.78476048036647,NaN,NaN,230.64843795655344,110.36179925427442,0.14476274720193377,0.14356964592611376,-0.0011931012758200146,57914590,51490762.6,78.21537312162229,60.46110882572769,NaN,NaN,7.089559781617802,-1.0380483847831905
2007-12-03T09:30:00-05:00,36.83,36.83,36.17,36.24001,1649808,2521914.65,58.61334624369312,51.90606839853435,NaN,NaN,180.0655126221537,156.88209456382438,0.1431435229739375,0.17773630244160188,0.03459277946766436,56264782,53540316,81.75519720189072,63.834230619891336,NaN,NaN,8.778302323693257,0.3642874307134447
2007-12-04T09:30:00-05:00,35.73,36.38,35.66,36.23,1344434,2456487.4,58.460426613554816,52.448309684945,NaN,NaN,104.71553584918571,179.5289218443997,0.13367061400761687,0.20168104697718547,0.06801043296956859,54920348,54897568.4,83.64988801198636,66.95509741074696,NaN,NaN,10.055594825883073,1.7487599157376774
2007-12-05T09:30:00-05:00,36.58,36.60001,36.3,36.52,1904000,2484817.45,61.5871659457548,53.06062434133768,NaN,NaN,137.998971409436,168.90283099522205,0.13861302809356474,0.2412767180865245,0.10266368999295977,56824348,56273843.8,85.31520349557928,69.48917511837399,NaN,NaN,12.102336350844284,3.2278422636100497
2007-12-06T09:30:00-05:00,36.27,36.8,36.27,36.77,2719954,2514515.05,64.09614707655459,54.11277653386467,NaN,NaN,132.374790647976,157.16064969706093,0.14946296420185273,0.2894923952452757,0.14002943104342297,59544302,57093674,86.21585907043072,71.91483413819364,NaN,NaN,14.596848358526222,4.8519859914552175
2007-12-07T09:30:00-05:00,36.7,36.82001,36.63,36.75,3442869,2505070.7,63.73748074634903,54.95434163940501,NaN,NaN,126.1332752247749,136.25761715070524,0.1458754235271218,0.3223737104523252,0.17649828692520342,56101433,56731042.6,83.76849982051938,73.67759767986415,NaN,NaN,16.50279627774153,6.51638746092469
2007-12-10T09:30:00-05:00,36.64999,36.82001,36.57001,36.82001,1115792,2397924.65,64.48662490723787,56.088457540401905,NaN,NaN,111.1884339341019,122.48220141309488,0.13883856523794885,0.3500464934726395,0.21120792823469065,57217225,56921531.2,84.02503024269332,75.25914370013045,NaN,NaN,18.293098499440312,8.198774752141208
2007-12-11T09:30:00-05:00,36.55,36.8,36.00999,36.25,2244614,2391857.05,54.59693316518934,56.429154249732804,NaN,NaN,60.266136337687804,113.5923215107953,0.0888476028608936,0.32226743181080764,0.23341982894991403,54972611,56931983.8,84.0399360281944,76.62689818887853,NaN,NaN,16.97596584428673,9.452659193876283
2007-12-12T09:30:00-05:00,37.89,37.89,35.96001,36.27,2767821,2368704.8,54.85852312752997,57.584561735396925,NaN,NaN,92.25825215342857,104.4441776595938,0.05200500722490245,0.2984260879810421,0.24642108075613964,57740432,57115200.6,84.31617969262132,78.05541187309578,NaN,NaN,15.989208692739881,10.386451979428225
2007-12-13T09:30:00-05:00,35.83,36.25,35.8,36.25,2107401,2348452.1,54.5202415548533,58.07706984764466,NaN,NaN,19.021414429546564,81.77350241590793,0.022663666395058346,0.2747506637499626,0.25208699735490425,55633031,56332946.4,78.1006301838775,78.8746813860047,NaN,NaN,15.086190643059682,11.05784321708986
2007-12-14T09:30:00-05:00,35.67,36.09,35.67,35.7,1130564,2283684.55,46.1011805990973,58.207673637218804,NaN,NaN,-17.222897419964838,53.10226788695998,-0.03431292857864854,0.20919583663159358,0.24350876521024212,54502467,56013153.2,75.6455920618209,79.60592280868835,NaN,NaN,11.674655989339074,11.145959327411177
2007-12-17T09:30:00-05:00,35.59,35.83,35.32001,35.32001,1637737,2259751.45,41.350254931826946,57.55241032713375,NaN,NaN,-58.15998023736698,19.232585052666202,-0.09469611107734152,0.1251386263635652,0.21983473744090673,52864730,55142654.2,69.26311238990885,79.7280476373177,NaN,NaN,7.180769929588241,10.579503699150758
2007-12-18T09:30:00-05:00,35.99001,35.99001,35.41,35.59,2168414,2281922,45.63701958834345,56.55306285504178,NaN,NaN,-39.63342159466282,-0.7473265338039241,-0.11235305371466325,0.07939342029757768,0.19174647401224093,55033144,55154760.8,69.30190561009746,79.80559225619392,NaN,NaN,4.698738308190629,9.739394357585025
2007-12-19T09:30:00-05:00,35.36,35.78,35.36,35.57001,1663013,2172920.5,45.372591917027044,55.39254837671711,NaN,NaN,-53.9841517059511,-29.995807305679858,-0.12055418165967899,0.04105374693764219,0.16160792859732118,53370131,54280700.6,63.1090439528368,79.05153220600563,NaN,NaN,2.6344207666374406,8.724398130306799
2007-12-20T09:30:00-05:00,35.49001,35.78,35.49001,35.78,2094560,2164519.3,48.73304366296239,54.43935571999814,NaN,NaN,-49.82487619101411,-43.76506542979199,-0.1074471177761391,0.027299031377147287,0.1347461491532864,55464691,54247032.6,62.87597116844621,77.95586063792163,NaN,NaN,1.849558633878563,7.742278202245623
2007-12-21T09:30:00-05:00,35.99001,35.99001,35.73,35.87,2064086,2201167.3,50.148491764045396,53.834723257166154,NaN,NaN,-33.04394686010765,-46.929275317820554,-0.08908417377565418,0.02339093193371866,0.11247510570937284,57528777,54852294.6,65.35324120353945,76.78429235232511,NaN,NaN,1.598268072425107,6.86456246941412
2007-12-24T09:30:00-05:00,35.75999,36.00999,35.75999,35.99001,510223,2123143.25,52.04960596327068,53.376807496431574,NaN,NaN,-34.042028201991634,-42.10568491074549,-0.06627135286594323,0.029635914626943816,0.09590726749288704,58039000,55887148.6,69.14440486571891,75.748186413306,NaN,NaN,1.9154089844582185,6.157540542991849
2007-12-26T09:30:00-05:00,36.07001,36.07001,35.77,35.95,1036995,2069139.45,51.34657064141664,52.64533640326457,NaN,NaN,-41.798368782298965,-42.53867434827272,-0.05192637783206076,0.030999295202811084,0.08292567303487185,57002005,56280920.8,70.46857846828146,74.68771319707045,NaN,NaN,1.9920971726594954,5.562477204372941
2007-12-27T09:30:00-05:00,35.98,35.99001,35.53,35.58,989007,2028145.55,45.25852436154119,51.29979192362076,NaN,NaN,-80.04519382288824,-47.750882771660144,-0.06458171200341675,0.002198533030600913,0.06678024503401767,56012998,56809494.2,72.19362311075278,73.6861249142363,NaN,NaN,0.3246709458119679,4.81421916743566
2007-12-28T09:30:00-05:00,35.83,35.83,35.42999,35.44,1060400,1806056.55,43.17265889643027,49.83087607719799,NaN,NaN,-94.01761314758606,-56.58943016297453,-0.07867164590924751,-0.031559312352541724,0.047112333556705785,54952598,56707075.6,71.32423969525148,72.79724919100288,NaN,NaN,-1.6855651990065361,3.8856785436582033
2007-12-31T09:30:00-05:00,35.86,35.86,35.2,35.31,1497268,1757448,41.27058858654151,48.17258776857682,NaN,NaN,-102.46377895943569,-70.47339658284014,-0.09210465628512571,-0.06801848679970135,0.024086169485424358,53455330,55892386.2,64.65449582047837,71.4136395894161,NaN,NaN,-3.932759956722361,2.768758757889551
2008-01-02T09:30:00-05:00,35.63,35.63,34.71001,34.94,6611270,2005521.1,36.36048661135214,46.869984443302734,NaN,NaN,-148.16340452722693,-93.29767184788717,-0.11952805329196603,-0.12532389712953318,-0.0057958438375671495,46844060,53653398.2,50.639175814085725,69.02787100269406,NaN,NaN,-7.448688358085673,1.3091234556073763
2008-01-03T09:30:00-05:00,35.28,35.3,35.03,35.14999,2544382,2065518.5,40.674419814317396,45.85683420664469,NaN,NaN,-122.63347289485428,-109.46469267039825,-0.11699673836504924,-0.1520417667938787,-0.035045028428829464,49388442,52130685.6,43.70098315321155,66.12678553559336,NaN,NaN,-9.18594863142482,-0.19017255682579437
2008-01-04T09:30:00-05:00,34.89,35.16,34.75999,34.78999,3270508,2133843.9,36.150180154212734,44.544686963741796,NaN,NaN,-148.01360352769748,-123.0583746113601,-0.1319318569952172,-0.19995984967285096,-0.06802799267763376,46117934,50151672.8,36.66905004362065,63.167386954146444,NaN,NaN,-12.135515377120457,-1.8966501025821747
2008-01-07T09:30:00-05:00,34.82001,35.58,34.82001,35.48,5457840,2270738.2,48.07246536862285,44.68549301870791,NaN,NaN,-80.7144390318177,-120.39773978820642,-0.08972178962586201,-0.18018022970996128,-0.09045844008409927,51575774,49476308,34.62163629724989,60.23710439953423,NaN,NaN,-10.788196394486018,-3.166871001425581
2008-01-08T09:30:00-05:00,35.66,36.39,35.57001,35.77,6231188,2410154.15,52.11906080995172,45.45469343857396,NaN,NaN,30.152912319728433,-93.87440153237358,-0.0392301578348562,-0.13949613737766953,-0.10026597954281333,57806962,50346634.4,39.32334788502533,58.098549792042554,NaN,NaN,-8.291036734384537,-3.898894677562575
2008-01-09T09:30:00-05:00,36.02,36.42999,35.89,36.41,8323324,2770530.75,59.60122071872009,46.45213637645801,NaN,NaN,103.73538984091928,-43.494642658744354,0.03623093912446078,-0.05497730563723735,-0.09120824476169813,66130286,54203879.6,54.82823933371808,57.06471648658688,NaN,NaN,-3.340290950853885,-3.8190941451756193
2008-01-10T09:30:00-05:00,36.33,36.56,36.14,36.36,5622258,2939412.95,58.827789727288774,47.413221934333855,NaN,NaN,125.59607304973116,6.151266530172734,0.07926985204297464,0.007879070292020174,-0.07139078175095447,60508028,56427796.8,61.01386152846833,56.91506059913199,NaN,NaN,0.17166329093543042,-3.248985940016898
2008-01-11T09:30:00-05:00,36.28,36.61,36.18201,36.47,3495961,2975819.95,60.05586997541178,48.221995242365956,NaN,NaN,148.7966529654496,65.51331782880216,0.1097611513765498,0.0658106574697328,-0.043950493906817004,64003989,60005007.8,68.48858185895861,57.315961362740005,NaN,NaN,3.358952242494367,-2.304994771086717
2008-01-14T09:30:00-05:00,36.41,36.49001,36.14,36.19,4276445,3084272.15,55.516508777289445,48.60542502902624,NaN,NaN,112.90340949728242,104.23688753462218,0.10565038855193377,0.08811249178310021,-0.017537896768833564,59727544,61635361.8,71.19887472739387,57.7335066144439,NaN,NaN,4.599576405296814,-1.318627460174784
2008-01-15T09:30:00-05:00,36.08,36.09,35.677,35.78,5242473,3289867.6,49.60406462103641,48.43074350458094,NaN,NaN,26.566495551196773,103.51960418091585,0.07153012159720139,0.07187475522766817,0.0003446336304667834,54485071,60970983.6,68.60917957687852,57.695276236669585,NaN,NaN,3.7389032425652764,-0.5961230740690612
2008-01-16T09:30:00-05:00,35.53,36.28,35.53,35.87,4217230,3418842.25,50.84167882043314,48.39467980308212,NaN,NaN,31.679933830854377,89.10851297890285,0.05213491990191032,0.06551328350785468,0.013378363605944363,58702301,59485386.6,63.08378168999873,57.16779075250653,NaN,NaN,3.435205278505488,-0.02021902370126849
2008-01-17T09:30:00-05:00,36.02,36.37,35.14999,35.17999,6972059,3659024.5,42.27075989562081,48.18126805551638,NaN,NaN,-33.182917572161756,57.35271485452428,-0.00691140962144879,0.004739101579133376,0.011650511200582166,51730242,57729829.4,57.21938707190587,56.09820246401746,NaN,NaN,0.23138270769851219,0.015724080784414465
2008-01-18T09:30:00-05:00,35.32001,35.32001,34.47,34.67,7714805,3961614.1,37.26977813464097,47.75963371538857,NaN,NaN,-157.1645112641137,-3.839517991388385,-0.07621078339337573,-0.08361296804113749,-0.007402184647761765,44015437,53732119,46.59655522486481,54.331939287561276,NaN,NaN,-4.263857455957675,-0.5956447101787411
2008-01-22T09:30:00-05:00,34.2,34.5,30.36,33.41,9254145,4319593.35,28.34675320764326,46.83650261689583,NaN,NaN,-347.44197291212123,-95.90859447326912,-0.1959939652295966,-0.2523946411847575,-0.05640067595516092,34761292,48738868.6,37.285587951052854,52.37701729688803,NaN,NaN,-12.149289811032752,-2.246165438872171
2008-01-23T09:30:00-05:00,32.77,33.64999,32.46001,33.64999,10737891,4753283.6,31.70086686015881,46.50367263466774,NaN,NaN,-217.12079069569916,-144.6460517226483,-0.24496762016032625,-0.36261020115556875,-0.1176425809952425,45499183,46941691,34.60533157197851,51.231742708166074,NaN,NaN,-16.805359177129148,-4.326050258623168
2008-01-24T09:30:00-05:00,33.78,33.78,33.25,33.52,5734832,5014514.05,30.858279216592223,45.80251973483023,NaN,NaN,-156.5193909101035,-182.28591667083987,-0.27004488401966187,-0.45519868601981983,-0.18515380200015796,39764351,43154101,29.75134477164346,50.23533996662551,NaN,NaN,-20.63310626393217,-6.6556296879530255
2008-01-25T09:30:00-05:00,33.97,33.97,32.53999,32.99001,6073672,5266347.9,27.633351904067283,45.19417485981984,NaN,NaN,-154.35125496380627,-206.51958414916876,-0.3037413399076744,-0.564830476884751,-0.2610891369770766,33690679,39546188.4,26.008900816964115,49.473900736150036,NaN,NaN,-24.964398160248287,-9.271168041138063
2008-01-28T09:30:00-05:00,33.21001,33.41,32.87,33.41,5296754,5481735.25,33.559056218938636,44.15750277769954,NaN,NaN,-125.34000299232198,-200.15468249481043,-0.2797559222516443,-0.610784039791632,-0.3310281175399877,38987433,38540587.6,25.062600215464826,48.79111244459396,NaN,NaN,-26.43583131129988,-11.723262794018323
2008-01-29T09:30:00-05:00,33.61,33.61,33.39,33.5,2396965,5548563.5,34.79129629554862,42.91980531238503,NaN,NaN,-92.59504684128122,-149.18529728064243,-0.24129554951693327,-0.6326475544361543,-0.391352004919221,41384398,39865208.8,28.74050621401311,48.03519518237881,NaN,NaN,-27.176943070510845,-13.930931404945825
2008-01-30T09:30:00-05:00,33.53999,33.62,33.11,33.11,3951853,5671292.75,32.019972492460866,40.949716153366516,NaN,NaN,-92.99419561342106,-124.3599782641868,-0.22586122892294536,-0.6736785410729027,-0.44781731214995735,37432545,38251881.2,27.002236032892824,46.04762351803414,NaN,NaN,-28.69112240700222,-16.03953011952531
2008-01-31T09:30:00-05:00,32.81,33.7,32.81,33.7,3974315,5539445,39.82866619617044,39.59263590114377,NaN,NaN,-75.43075999404921,-108.14225208097594,-0.16261219034248653,-0.6510825500780655,-0.48847035973557895,41406860,38580383,27.95769130750901,43.68646850225134,NaN,NaN,-27.382962383372462,-17.660020442932044
2008-02-01T09:30:00-05:00,33.37,33.89,33.37,33.86,3571156,5590783.7,41.781697675518764,38.28733787972284,NaN,NaN,-52.521434706383424,-87.77628802949135,-0.09978040133634114,-0.6131958614060053,-0.5134154600696642,44978016,40837850.4,34.319834782918846,41.24584371110564,NaN,NaN,-25.714590472542454,-18.81067330430496
2008-02-04T09:30:00-05:00,33.75,34.10001,33.75,33.98,2793094,5566913,43.268955729728226,37.412512662039894,NaN,NaN,-36.2281970996408,-69.95392685095513,-0.04282916931878311,-0.5669519217181431,-0.52412275239936,47771110,42594585.8,38.84580449260697,38.93491012290657,NaN,NaN,-23.915121116318552,-19.539880134592615
2008-02-05T09:30:00-05:00,33.73,33.86501,33.28999,33.36,4460031,5517022.55,37.88404765880664,36.5753685933092,NaN,NaN,-54.36708173760966,-62.30833383022082,-0.03967668907090238,-0.5737186137379879,-0.5340419246670856,43311079,42979922,39.82531560742542,36.878919839374205,NaN,NaN,-24.015240098661632,-20.17921727231676
2008-02-06T09:30:00-05:00,33.63,33.7,33.34,33.45,3089392,5359932.75,39.06946794071207,35.73449638761483,NaN,NaN,-50.06027280992051,-53.72154926952071,-0.02500850989035308,-0.5653025620300269,-0.5402940521396739,46400471,44773507.2,44.29754748526369,35.537045967607426,NaN,NaN,-23.735171678554373,-20.68721075892213
2008-02-07T09:30:00-05:00,33.34,33.52,33.12,33.32001,2785758,5083054.45,37.94316585759261,35.42538252775568,NaN,NaN,-55.43580720575471,-49.72255871186181,-0.01787369231613911,-0.5626361675348477,-0.5447624752187086,43614713,45215077.8,45.37394613005541,34.690943043189534,NaN,NaN,-23.832665952464875,-21.136561500856807
2008-02-08T09:30:00-05:00,33.19,33.28999,32.92,33.11,2769013,4940392.2,36.13094380381365,35.34403721841087,NaN,NaN,-64.81919564188361,-52.182110898961845,-0.020900610476697556,-0.5708882383145806,-0.549987627837883,40845700,44388614.6,43.67288937278349,34.48210976804087,NaN,NaN,-24.43523718894877,-21.607800884869945
2008-02-11T09:30:00-05:00,32.89,33.06,32.75999,33.00999,2631293,4897158.8,35.26709901077045,35.838347632919955,NaN,NaN,-74.60000884187579,-59.85647324740885,-0.023070451939574133,-0.5788256927623507,-0.5557552408227766,38214407,42477274,39.94334378924444,34.67194947076884,NaN,NaN,-25.17672078451533,-22.117646584819287
2008-02-12T09:30:00-05:00,33.39999,33.55,33.14999,33.49001,2420103,4804341.7,42.387051625813164,36.601646544752406,NaN,NaN,-35.94931190123369,-56.17291928013365,0.01247939411309762,-0.5401559981814046,-0.5526353922945022,40634510,41941960.2,38.94034856215251,34.98159354149555,NaN,NaN,-23.760936783816863,-22.352402327533227
2008-02-13T09:30:00-05:00,33.53,33.71001,33.35001,33.44,2114069,4647921.5,41.87034882293721,37.388222945205634,NaN,NaN,-19.65863836340359,-50.09259239083026,0.035953908458535744,-0.5076930067213326,-0.5436469151798683,38520441,40365954.2,36.06877496864192,35.43283855556687,NaN,NaN,-22.74361309541716,-22.408289580088073
2008-02-14T09:30:00-05:00,33.5,33.67,33.16,33.3,2708703,4572495.15,40.386137327960235,38.299136189769406,NaN,NaN,-27.971093127481982,-44.59964957517572,0.044804368199093614,-0.4876414549310013,-0.5324458231300949,35811738,38805359.2,33.43915808927841,35.963571217875035,NaN,NaN,-22.286058606705613,-22.39082801246201
2008-02-15T09:30:00-05:00,33.00999,33.36,33,33.33,2759953,4361889.85,40.86983743908131,38.82133484835102,NaN,NaN,-49.23497731571653,-41.482805909942314,0.054771682734922056,-0.46398121971144235,-0.5187529024463644,38571691,38350557.4,32.69114724292284,36.50846743412203,NaN,NaN,-21.77673609548474,-22.30310059575097
2008-02-19T09:30:00-05:00,33.33,33.77,33.33,33.75,2804350,4116367.1,47.31493060816487,39.715880156395045,NaN,NaN,85.8187292414828,-9.399058293270599,0.08968057026594245,-0.40665218961393634,-0.4963327598798788,41376041,38982884.2,34.87247649109908,36.94646531105674,NaN,NaN,-19.5022058896793,-21.902972780597874
2008-02-20T09:30:00-05:00,33.25999,33.64999,33.14,33.64999,3062015,3806760.6,46.028386447967605,40.716481153216954,NaN,NaN,32.2575575067821,4.242315588332557,0.10500214746122793,-0.3650800755533439,-0.4700822230145718,38314026,38518787.4,34.001514965877135,37.44641380626991,NaN,NaN,-17.9320439619623,-21.335697235078506
2008-02-21T09:30:00-05:00,34.14,34.14999,33.02,33.3,2438832,3391807.65,41.750001321913274,40.85371937648431,NaN,NaN,32.13737411265212,14.601518083543699,0.09105113487810285,-0.35626830441694324,-0.4473194392950461,35875194,37989738,32.99000334745723,37.8058646662662,NaN,NaN,-17.72375199496419,-20.819705057919318
2008-02-22T09:30:00-05:00,33.3,33.37,32.69,33.37,2672879,3238710,42.893322133289914,40.933121123467956,NaN,NaN,-95.77938466306136,1.0398597764278208,0.08607922193138162,-0.33972041188081903,-0.42579963381220065,38548073,38537005,35.1395184208548,37.864413497547346,NaN,NaN,-17.23712612934733,-20.30790806812332
2008-02-25T09:30:00-05:00,33.27,33.8,33.25999,33.8,2575229,3063787.85,49.45621144592872,41.37506796033942,NaN,NaN,79.9534468123932,26.877544602049767,0.10977403759059434,-0.2885820868239577,-0.39835612441455204,41123302,39047327.2,37.163663509286295,37.7442605701673,NaN,NaN,-14.886177433459865,-19.533375120314258
2008-02-26T09:30:00-05:00,33.73,33.92,33.49001,33.5,3024510,2950175.65,45.52525649051338,41.92086859117561,NaN,NaN,78.59481382254513,25.432761518262232,0.10335739015892847,-0.26915938671589146,-0.37251677687481993,38098792,38391877.4,35.62584086685504,37.444298088697984,NaN,NaN,-13.988284737975237,-18.741219351408684
2008-02-27T09:30:00-05:00,33.56,33.75,33.47,33.64999,3035846,2982119.7,47.76088069596249,42.54168378797921,NaN,NaN,68.77368766439068,32.73598754978395,0.106885570421345,-0.2389098138481387,-0.3457953842694837,41134638,38955999.8,38.00362603701399,36.99473227096586,NaN,NaN,-12.588146660175662,-17.862208966946824
2008-02-28T09:30:00-05:00,33.39999,33.39999,33.17,33.25999,4668805,3017967.3,42.83799522263196,42.8913144569106,NaN,NaN,-61.80071594008666,13.948369539236193,0.08175750885907085,-0.24359849819564516,-0.325356007054716,36465833,39074127.6,38.51576553232807,36.50486222827105,NaN,NaN,-12.815845932822741,-17.141299962071955
2008-02-29T09:30:00-05:00,33.05,33.07001,32.63,32.8,4110887,3024795.9,37.878791116372234,43.01616069352192,NaN,NaN,-185.22947015633886,-3.941647559419303,0.03533258440285242,-0.2811902765511505,-0.3165228609540029,32354946,37835502.2,35.229511373018354,35.9017637997164,NaN,NaN,-14.583233128953449,-16.775861843055026
2008-03-03T09:30:00-05:00,32.64999,32.82001,32.60001,32.78999,2418890,2967182.6,37.77630319835176,43.195389564063454,NaN,NaN,-180.1950514999504,-55.971347221888024,0.006629012384820998,-0.30823659547297666,-0.31486560785779766,29936056,35598053,30.214460489337668,35.20684356400877,NaN,NaN,-16.02186770990171,-16.668148395461696
2008-03-04T09:30:00-05:00,32.50999,32.85001,32.5,32.83,3206787,2987867.25,38.49264903442174,42.91721795039263,NaN,NaN,-158.30921248072872,-103.3521524825428,-0.00628541988498299,-0.3227223827140264,-0.31643696282904343,33142843,34606863.2,28.292980987539124,34.44631730867925,NaN,NaN,-16.9992750401372,-16.71545220184391
2008-03-05T09:30:00-05:00,32.75999,33,32.45,32.77,3494298,2939580.6,37.79004327925982,42.625767554415674,NaN,NaN,-131.6274351307832,-143.43237704157758,-0.014994608182480218,-0.3351802230571437,-0.32018561487466346,29648545,32309644.6,24.417294518525324,33.614068705099484,NaN,NaN,-18.008010010552788,-16.90010331737375
2008-03-06T09:30:00-05:00,32.81,32.81,32.03999,32.11,2623476,2916284.8,31.071520708006418,41.96043779584755,NaN,NaN,-190.70755051080366,-169.213743955721,-0.05886790353088439,-0.39377049428826894,-0.33490259075738454,27025069,30421491.8,21.77680966501066,32.78104381765179,NaN,NaN,-21.065690906887085,-17.495187258732795
2008-03-07T09:30:00-05:00,32.10001,32.10001,31.62,31.74001,3992523,2976623.05,28.059818778773206,41.04543646296839,NaN,NaN,-228.76591327953392,-177.92103258035996,-0.10383953675384083,-0.4647020116996856,-0.3608624749458448,23032546,28557011.8,19.530800804816877,31.841019072072793,NaN,NaN,-24.683062914603394,-18.52202663814288
2008-03-10T09:30:00-04:00,31.66,31.8,30.78999,31,2871402,2981742.5,23.2134038779473,39.32389883938142,NaN,NaN,-246.8347718059495,-191.24897664155978,-0.17051924020954817,-0.57401152520778,-0.4034922849982318,20161144,26602029.4,17.493463996515487,30.5996610367454,NaN,NaN,-29.721362538007106,-20.12193176669491
2008-03-11T09:30:00-04:00,30.89999,31.62,30.66,31.3,3730083,3036682,28.59755409161444,38.078839385356204,NaN,NaN,-194.42632298103405,-198.47239874162088,-0.18055002490586197,-0.6291798161305593,-0.4486297912246973,23891227,24751706.2,15.812239916445463,29.300427104643138,NaN,NaN,-32.00686660906133,-21.819779601318686
2008-03-12T09:30:00-04:00,31.19,31.45,31.12,31.3,3182700,3074811.85,28.59755409161444,37.13937886890629,NaN,NaN,-153.88452363686028,-202.92381644283628,-0.1732823236038708,-0.6652326957295358,-0.491950372125665,23891227,23600242.6,14.855436936855241,28.005100932457278,NaN,NaN,-33.77625048476506,-23.527846870382454
2008-03-13T09:30:00-04:00,30.92999,31.52,30.62,31.25999,4518527,3195034.75,28.29072782503927,36.09633641831696,NaN,NaN,-143.48014822820002,-193.47833598631556,-0.15771165057951153,-0.6890899353500544,-0.5313782847705428,19372700,22069768.8,13.671306578792397,26.471657229452823,NaN,NaN,-35.28624503690773,-25.207618037028922
2008-03-14T09:30:00-04:00,31.32001,31.78,30.46001,30.67999,5051852,3312192.2,24.231943145137464,34.29460296826044,NaN,NaN,-130.95617265598858,-173.91638786160647,-0.17185451967555743,-0.7461964343649896,-0.5743419146894322,14320848,20327429.2,12.454218119474561,24.706696844466272,NaN,NaN,-37.96345888193395,-27.029881014872498
2008-03-17T09:30:00-04:00,30.08,30.86,30,30.64,4885566,3418472.85,23.9765282129607,32.75540809129239,NaN,NaN,-140.83749147071092,-152.71693179455877,-0.16902600090659092,-0.7856244158226708,-0.6165984149160799,9435282,18182256.8,11.1393395668413,22.95766103732243,NaN,NaN,-40.17467657753511,-28.907708952395726
2008-03-18T09:30:00-04:00,31.09,31.78,30.77,31.60001,6180645,3587287.6,40.25662054734919,32.219389509248586,NaN,NaN,-69.02646669117779,-127.63696053658751,-0.09150551237786142,-0.7309803053884067,-0.6394747930105453,15615927,16527196.8,10.240986237157188,20.97461533733266,NaN,NaN,-36.67775657257681,-30.01771575527874
2008-03-19T09:30:00-04:00,31.41,31.91,30.50999,31.19,7359676,3802170.65,36.64708006060105,31.77718128338923,NaN,NaN,-73.00695826231774,-111.46144746167901,-0.05845621254393385,-0.7125450586904627,-0.6540888461465288,8256251,13400201.6,8.797407138181015,18.851875452036438,NaN,NaN,-35.01963678657006,-30.732275902606073
2008-03-20T09:30:00-04:00,31.50999,31.50999,30.95,31.09,2021974,3781327.75,35.80387184063386,31.628972763693632,NaN,NaN,-66.9745355579232,-96.16032492762363,-0.03509574364951773,-0.697958525708426,-0.6628627820589083,6234277,10772517,7.802132720333489,16.892776976844665,NaN,NaN,-33.99463814564506,-31.198327651611642
2008-03-24T09:30:00-04:00,31.42999,31.7,31.23,31.5,2458688,3770618.2,41.72427992811863,31.910971101534123,NaN,NaN,-41.40784465014755,-78.25065932645543,0.013594358180997856,-0.645869834332661,-0.6594641925136588,8692965,9646940.4,7.415147441710943,15.264254616299898,NaN,NaN,-31.171035320570788,-31.194428747177234
2008-03-25T09:30:00-04:00,31.49001,31.7,31.38,31.56,3434689,3813591.2,42.559144031061166,32.20143502986551,NaN,NaN,-31.279828937734454,-56.33912681986014,0.05324100099646123,-0.5929129412680822,-0.6461539422645435,12127654,10185414.8,9.722092664597483,13.93776259323264,NaN,NaN,-28.677348638567356,-30.83484587451868
2008-03-26T09:30:00-04:00,31.41,31.42999,31.25,31.25,2507131,3787722.25,39.41712902310345,32.31765544014005,NaN,NaN,-45.67047644564619,-51.66792877075382,0.0614071537494878,-0.5693950000776837,-0.6308021538271715,9620523,8986334,9.173916440916969,12.848949873403471,NaN,NaN,-27.524989496658108,-30.362009249110027
2008-03-27T09:30:00-04:00,31.44,31.56,31.12,31.41,5658180,3918838.95,41.805175133321846,33.08434504194829,NaN,NaN,-35.693996276061675,-44.205336373502604,0.07926820465809992,-0.5317168980045466,-0.6109851026626465,15278703,10390824.4,15.2048748501348,12.379525958055195,NaN,NaN,-25.85550396966384,-29.718222780617715
2008-03-28T09:30:00-04:00,31.67,31.67,31.14,31.33,2423890,3806593.2,40.93630242124227,34.004093873553224,NaN,NaN,-28.630408776589615,-36.53651101723588,0.0867726165176611,-0.5025193320155701,-0.5892919485332312,12854813,11714931.6,20.560397536683723,12.45306858175997,NaN,NaN,-24.736476233438527,-29.00654470244926
2008-03-31T09:30:00-04:00,30.78999,31.17,30.62,31.17,3496815,3775889.6,39.182297963692896,35.1447291653922,NaN,NaN,-75.28219900049943,-43.31138188730626,0.08208910854183482,-0.48668056285593764,-0.5687696713977725,9357998,11847938.2,21.099468124371896,12.710640305178284,NaN,NaN,-24.285698847521747,-28.33213815174533
2008-04-01T09:30:00-04:00,31.3,31.72,31.07001,31.67,3015115,3805700.85,46.846834813630885,36.448249216964804,NaN,NaN,4.454166733931881,-36.16458275297299,0.11194452619602502,-0.42883901365274113,-0.5407835398487661,12373113,11897030,21.311713926010512,13.103459877290073,NaN,NaN,-21.55570396836025,-27.36407612554746
2008-04-02T09:30:00-04:00,31.75999,31.77,31.41,31.45,1405736,3715648.3,44.20695662738729,37.56320654094857,NaN,NaN,30.27875495617325,-20.974736472609106,0.11567934080978992,-0.3961843638365288,-0.5118637046463187,10967377,12166400.8,22.54296407045122,13.652568958261213,NaN,NaN,-20.03840810574618,-26.317552122718705
2008-04-03T09:30:00-04:00,31.47,31.53,31.31,31.35001,1899950,3635930.9,43.0203782514003,38.61532442854578,NaN,NaN,17.510235773318538,-10.333890062733062,0.11024158354197383,-0.3740617252188514,-0.4843033087608252,9067427,10924145.6,20.917452759023817,14.170150828277745,NaN,NaN,-19.127605968362527,-25.29041695781068
2008-04-04T09:30:00-04:00,31.28,31.89,31.28,31.60001,2810641,3645289.15,46.86088269390637,40.23167725345785,NaN,NaN,96.40111800987918,14.672415294560684,0.12142397343355049,-0.3325233419688871,-0.4539473154024376,11878068,10728796.6,20.665103740841346,14.756642658375373,NaN,NaN,-17.22590899096659,-24.138344391118668
2008-04-07T09:30:00-04:00,31.99001,32.05,31.78999,31.96001,3393552,3615340.6,51.889575165775724,42.22546632151607,NaN,NaN,202.69688699983618,70.26823249462781,0.14918054344567777,-0.2674716360953404,-0.4166521795410182,15271620,11911521,26.450456581398925,15.850293873700918,NaN,NaN,-14.03799723569739,-22.695437654629913
2008-04-08T09:30:00-04:00,31.89999,31.92,31.75,31.85001,1641608,3553850.9,50.32254202900369,42.94446071306282,NaN,NaN,149.5871783138859,99.29483481061861,0.15553612856761323,-0.22223201883150168,-0.3777681473991149,13630012,12162900.8,27.657958574070634,17.094363326337593,NaN,NaN,-11.851035256199848,-21.146237311997048
2008-04-09T09:30:00-04:00,31.84,31.88,31.55,31.7,1668448,3450769.15,48.18543600952985,43.76862899512916,NaN,NaN,100.48951054327776,113.33698592803951,0.14523697766407373,-0.19622192531902272,-0.34145890298309645,11961564,12361738.2,28.65570347684948,18.512813064813916,NaN,NaN,-10.610698997116405,-19.64116040987124
2008-04-10T09:30:00-04:00,31.67999,32.07001,31.62,31.95,1917434,3387505.85,51.855036923355485,44.91514078675214,NaN,NaN,130.7487660493746,135.98469198325074,0.15023553863771671,-0.15366447968595054,-0.30390001832366725,13878998,13324052.4,33.44028247882096,20.344109476134445,NaN,NaN,-8.475934468697076,-18.046128132560646
2008-04-11T09:30:00-04:00,31.88,31.92999,31.45,31.53,3177571,3320458.05,45.96535824622642,45.218074952331264,NaN,NaN,59.233241370290166,128.55111665533292,0.1214601242841643,-0.15207486296846184,-0.27353498725262615,10701427,13088724.2,32.859928657860934,22.161593848716592,NaN,NaN,-8.334106036190624,-16.658696404507786
2008-04-14T09:30:00-04:00,31.49001,31.56,31.31,31.39,1089664,3122348.65,44.164667839124576,45.3327552243358,NaN,NaN,-5.461336891507258,86.91947187706424,0.09061640495253737,-0.16026448106195446,-0.2508808860144918,9611763,11956752.8,30.149435813972644,23.620689787957673,NaN,NaN,-8.750010675325472,-15.528884157481741
2008-04-15T09:30:00-04:00,31.47,31.53,31.25,31.36,2110446,2983592.65,43.76897997575853,45.64360172095401,NaN,NaN,-37.460005483157985,49.510035117655455,0.06690660076781349,-0.16724763505472495,-0.23415423582253844,7501317,10731013.8,27.50384710990268,24.929970550028084,NaN,NaN,-9.201885681144745,-14.625027232290742
2008-04-16T09:30:00-04:00,31.45,31.56,31.28999,31.53,2732390,2811179.9,46.68403900033403,45.99209199716917,NaN,NaN,-9.810586518115793,27.45001570537675,0.061522142590790335,-0.15725155758405052,-0.21877370017484085,10233707,10385442.4,26.790103871886828,25.757486908724655,NaN,NaN,-8.779856887991508,-13.790002897390853
2008-04-17T09:30:00-04:00,31.42999,31.48,31.21001,31.33,1481910,2517291.6,43.80678296337742,46.1971263216074,NaN,NaN,-58.86368696562676,-10.472474897623526,0.04415316144532927,-0.16358224836817925,-0.20773540981350852,8751797,9360002.2,24.73856262128001,26.055927271910104,NaN,NaN,-9.22529023853592,-13.137901088983005
2008-04-18T09:30:00-04:00,31.75,31.8,31.53,31.63,2282936,2530339.7,48.8948273253019,46.89087841886518,NaN,NaN,54.12514485541567,-11.49409420059843,0.05199122209720569,-0.14274638219200142,-0.1947376042892071,11034733,9426663.4,25.1398945963289,26.34452916276418,NaN,NaN,-8.151933251168792,-12.42561996929526
2008-04-21T09:30:00-04:00,31.52,31.64999,31.46001,31.53,3293737,2572092.15,47.35560342987804,46.927219034311406,NaN,NaN,10.526106726797135,-8.296605476937557,0.04957212007598036,-0.13277245419423167,-0.18234457427021203,7740996,9052510,24.354878654826877,26.561898071965345,NaN,NaN,-7.688671941814815,-11.748913108226626
2008-04-22T09:30:00-04:00,31.37,31.37,31.02,31.2,2659808,2533348.1,42.59071797736406,46.8117734164526,NaN,NaN,-112.74875960447524,-23.354356301201,0.02605979296371974,-0.14976983306556235,-0.1758296260292821,5081188,8568484.2,23.33954023709464,26.618796369582732,NaN,NaN,-8.68009564831204,-11.310510613953113
2008-04-23T09:30:00-04:00,31.25999,31.5,31.17999,31.3,901659,2453074.5,44.415884654996475,46.91145244528091,NaN,NaN,-65.42852798962869,-34.47794459550357,0.017941395949655797,-0.15340288109221234,-0.17134427704186814,5982847,7718312.2,21.63355339095763,26.66994641472086,NaN,NaN,-8.987761186193113,-10.978689267130257
2008-04-24T09:30:00-04:00,31.48,31.66,31.2,31.39999,1694097,2254870.35,46.25578127432369,46.86823091531072,NaN,NaN,-32.402635310762435,-29.18573426453071,0.019855665630473196,-0.14652469500377663,-0.16638036063424982,7676944,7503341.6,21.21136245886464,26.70896489457967,NaN,NaN,-8.73454869955985,-10.658097757477341
2008-04-25T09:30:00-04:00,31.66,31.87,31.59,31.81,3163610,2291856.35,53.10982872381404,46.955391883742024,NaN,NaN,83.95258273934122,-23.2202466877456,0.04769736430912991,-0.10675865524783745,-0.15445601955696736,10840554,7464505.8,21.13113155850769,26.329013107230292,NaN,NaN,-6.454626273042111,-10.057601831129451
2008-04-28T09:30:00-04:00,31.92,32.05,31.82001,32,3836066,2308818.9,55.915550542179815,47.35489249182603,NaN,NaN,142.35333912590946,3.1451997920768635,0.07618112917693343,-0.05922960808580058,-0.135410737262734,14676620,8851630.6,31.148516578770995,26.578338678994605,NaN,NaN,-3.680022789783508,-9.146519110937174
2008-04-29T09:30:00-04:00,31.8,31.8,31.53,31.64999,1089823,2212554.3,49.98232595563295,47.48324177369053,NaN,NaN,28.87098518002395,31.469148748976703,0.0689383538302133,-0.049237794974967386,-0.11817614880518068,13586797,10552752.4,41.03901238135753,27.462860743602324,NaN,NaN,-3.049494122319498,-8.275515541134649
2008-04-30T09:30:00-04:00,31.8,31.86,31.45,31.48,1832984,2233916.7,47.35421080289456,47.161754193657615,NaN,NaN,4.373558872232808,45.429566121349,0.05101388485420913,-0.054408792737419276,-0.1054226775916284,11753813,11706945.6,46.63981038717122,28.405684165627342,NaN,NaN,-3.323689907328695,-7.56811187916237
2008-05-01T09:30:00-04:00,31.36,32.06,31.36,32.03999,1808908,2229364.6,55.63079530030916,47.85214255466353,NaN,NaN,79.86179907083189,67.88245299766785,0.07380331480365102,-0.013168534087064643,-0.08697184889071566,13562721,12884101,51.6811054978016,29.750053939908817,NaN,NaN,-0.8538625567423664,-6.608933404530941
2008-05-02T09:30:00-04:00,32.14,32.19,32,32.05,2250225,2201343.8,55.76466900543347,48.680714066542734,NaN,NaN,150.5807099439499,81.2080784385896,0.0856501168348242,0.020090797152814588,-0.0655593196820096,15812946,13878579.4,55.50561873002527,31.561209862484002,NaN,NaN,1.1229923019833912,-5.504372589314608
2008-05-05T09:30:00-04:00,32.05,32.061,31.87,31.96001,886184,2075975.4,54.1819170323235,49.4244952848688,NaN,NaN,110.33074938883185,74.80356049117407,0.08344028241909628,0.03874103334186074,-0.044699249077235534,14926762,13928607.8,55.69560051990724,33.57490653462718,NaN,NaN,2.2735600387137085,-4.393239356739134
2008-05-06T09:30:00-04:00,31.78999,32,31.67,31.89999,1703350,2079062.5,53.099412133298486,49.882736222937694,NaN,NaN,74.16025189492912,83.86141383415512,0.07425830187514942,0.048123628266701246,-0.026134673608448178,13223412,13855930.8,55.32602657489824,35.61318672769943,NaN,NaN,2.91232457306664,-3.3495873667668805
2008-05-07T09:30:00-04:00,31.88,32.02,31.47,31.62,2287303,2110005.25,48.255932997755245,50.20053265396468,NaN,NaN,23.462352945176324,87.6791726487438,0.046980428602715694,0.03259086214494644,-0.014389566457769253,10936109,13692390,54.45044681838742,37.735464170349964,NaN,NaN,2.0511208949755626,-2.5780576150893886
2008-05-08T09:30:00-04:00,31.60001,31.75,31.5,31.5,2157486,2122007.85,46.30639329044714,50.01564450861791,NaN,NaN,-12.05693825867358,69.2954251828427,0.01989346166949712,0.010477260629102148,-0.009416201040394971,8778623,12735570.4,49.5132928686507,39.47642118980151,NaN,NaN,0.7620045637114686,-2.1009058752606946
2008-05-09T09:30:00-04:00,31.5,31.5,31.261,31.47,1469193,2036588.95,45.808141653753594,49.905111524609026,NaN,NaN,-65.67783117323688,26.043716959405366,0.00004434321736832003,-0.009360772018684571,-0.009405115236052891,7309430,11034867.2,42.190553258683856,40.75039794721987,NaN,NaN,-0.44038907304074454,-1.863689189229273
2008-05-12T09:30:00-04:00,31.59,31.71001,31.45,31.71001,1082149,2036213.2,50.405749011513876,50.4633280270483,NaN,NaN,2.3217305082764126,4.441913183294274,0.0030035979013775423,-0.005650617859330964,-0.008654215760708506,8391579,9727830.6,37.58945305607633,41.76824886286142,NaN,NaN,-0.2166767364556287,-1.6284016959758953
2008-05-13T09:30:00-04:00,31.72,31.74001,31.41,31.41,1293094,1995345.6,45.23916503032908,50.52213376814348,NaN,NaN,-37.631998993551015,-17.91653699440175,-0.014366090646966487,-0.026611829069416615,-0.012245738422450128,7098485,8502845.2,33.862195292590286,42.64172328440661,NaN,NaN,-1.5480887048918348,-1.6169284115353153
2008-05-14T09:30:00-04:00,31.48,31.75999,31.48,31.67,1528729,1935162.55,50.02038402049947,50.7910339642989,NaN,NaN,1.5629198218279765,-22.296423619071415,-0.0077957460594463585,-0.021990420996758075,-0.014194674937311717,8627214,8041066.2,32.551846247102745,43.45175784070933,NaN,NaN,-1.2747408061101628,-1.5680444679031507
2008-05-15T09:30:00-04:00,31.55,31.633,31.39999,31.58,1213124,1921723.25,48.443647051362994,50.45773527340954,NaN,NaN,-41.853077331691615,-28.255651433675023,-0.00888309507212981,-0.02529854377747398,-0.01641544870534417,7414090,7768159.6,31.769415946637906,44.21163529700435,NaN,NaN,-1.5106241805941514,-1.5598415697161507
2008-05-16T09:30:00-04:00,31.61,31.7,31.4722,31.7,1381566,1876654.75,50.67615283282757,50.08349257988438,NaN,NaN,-6.7435844496273525,-16.46880208895312,-0.001291181674995645,-0.018029425799088727,-0.016738244124093082,8795656,8065404.8,33.64035476337288,44.38962373876162,NaN,NaN,-1.0695206506544288,-1.4897957241359048
2008-05-19T09:30:00-04:00,31.58,31.89999,31.53999,31.89999,2174887,1820712.25,54.23307115237374,50.38711723679444,NaN,NaN,49.84923252989073,-6.963301684630255,0.016450462403026833,0.003824833879690459,-0.012625628523336374,10970543,8581197.6,36.87500241238055,44.09219445526327,NaN,NaN,0.34770941773870806,-1.2272949895823886
2008-05-20T09:30:00-04:00,31.67,31.97,31.64999,31.81,1653316,1770387.65,52.40187677913723,50.74766480652605,NaN,NaN,53.55214975041716,11.27352806416338,0.021080374654378887,0.013724839794637234,-0.007355534859741652,9317227,9024946,39.60264253292046,43.58953960853107,NaN,NaN,1.0175235002907252,-0.9066066338862295
2008-05-21T09:30:00-04:00,31.91,32.02,31.5,31.53,2029170,1826763.2,47.07570089126114,50.1365866344512,NaN,NaN,-8.368341923014732,9.287275715194838,0.005075359022493444,-0.0010113360816248473,-0.006086695104118292,7288057,8757114.6,38.52073623469628,42.64951323259498,NaN,NaN,0.042100906964453774,-0.7710769851932748
2008-05-22T09:30:00-04:00,31.5,31.89,31.46001,31.87,995284,1791822.55,53.284848612917635,49.95945660641435,NaN,NaN,11.649441269615588,19.98777943545628,0.016531163521936947,0.014577259298302891,-0.001953904223634054,8283341,8930964.8,39.6728013563928,41.51859770590694,NaN,NaN,1.086773221018855,-0.5056698128772563
2008-05-23T09:30:00-04:00,31.59,31.66499,31.35001,31.35001,1328860,1700085.05,44.65592332849414,49.27902848471225,NaN,NaN,-118.3111353981108,-2.3257307542404106,-0.010321884698608848,-0.014856260096895113,-0.004534375398286266,6954481,8562729.8,38.046512169824844,40.25794853804392,NaN,NaN,-0.8709127099788558,-0.5578473696060563
2008-05-27T09:30:00-04:00,31.33,31.67,31.33,31.48,1597606,1588162.05,46.96794073304752,48.84106624183719,NaN,NaN,-93.19951554071453,-30.93548036836146,-0.018274767686614273,-0.027377835006554108,-0.009103067319939834,8552087,8079038.6,35.96121902144873,38.87474799851181,NaN,NaN,-1.6944369641272665,-0.720217311680515
2008-05-28T09:30:00-04:00,31.50999,31.71001,31.39999,31.45,1394002,1603371,46.48529162610801,48.71459185814809,NaN,NaN,-72.8308027287412,-56.21207086419313,-0.0241330261381944,-0.039269349992682834,-0.015136323854488435,7158085,7647210.2,34.16105830068433,37.42550596153301,NaN,NaN,-2.4953288455146256,-0.9738046736568164
2008-05-29T09:30:00-04:00,31.42,32.25,31.42,32.13,2288490,1626146.3,57.21709286999222,49.493927542401316,NaN,NaN,109.55283638069962,-32.62783520345026,0.016994230437103623,0.006106464191891092,-0.01088776624521253,9446575,8078913.8,37.527895852928914,36.56940617469574,NaN,NaN,0.44631223966829553,-0.7709308288960862
2008-05-30T09:30:00-04:00,32.12,32.1996,31.99001,32.08,1456783,1608540.05,56.322699249583515,50.24496737067488,NaN,NaN,157.87091051125884,-3.3835413551216162,0.0387895109456743,0.03759912243688035,-0.001190388508793952,7989792,8020204,37.2489225463148,36.216432552383665,NaN,NaN,2.4459605394903976,-0.31137491912658855
2008-06-02T09:30:00-04:00,32.03999,32.12,31.592,31.7,1672091,1579633.35,49.93419440957405,50.211284899107746,NaN,NaN,51.88810864469281,30.656307453439105,0.026177100557391697,0.03153098718794567,0.005353886630553972,6317701,7892848,36.61309639385563,36.14669279079648,NaN,NaN,2.0483659863725285,0.02573092451614245
2008-06-03T09:30:00-04:00,31.82001,32.03999,31.71001,31.91,2668533,1668750.8,53.10016901621599,50.77278518381395,NaN,NaN,93.38361191806526,67.97293294519507,0.0302525382414482,0.043169559432364224,0.012917021190916023,8986234,7979677.4,37.397694174084975,36.39922842518895,NaN,NaN,2.755971626147503,0.41576531046347964
2008-06-04T09:30:00-04:00,31.88,32.09,31.77,31.92,2460816,1706624.1,53.25176817667648,51.003598337826595,NaN,NaN,107.38200669617697,104.01549483017871,0.03174147020452228,0.05259385894656887,0.020852388742046594,11447050,8837470.4,44.68238858654749,37.26569573514929,NaN,NaN,3.358166435616562,0.8361083283424914
2008-06-05T09:30:00-04:00,31.95,32.259,31.87,32.2,1914355,1687976.7,57.40361199088251,51.64359583350657,NaN,NaN,156.9194053039774,113.48880861483426,0.04868960221631337,0.08171439151243831,0.03302478929612494,13361405,9620436.4,50.36037781813416,38.59362158311331,NaN,NaN,5.167693689122201,1.454906237025307
2008-06-06T09:30:00-04:00,31.92999,31.97,31.3,31.42,2634666,1711835.7,45.32680378427309,51.26149947289554,NaN,NaN,-56.02350941408124,70.70992462976625,0.006681115139579419,0.041376183220599216,0.0346950680810198,10726739,10167825.8,53.92135360962175,40.042264357845376,NaN,NaN,2.628462337120647,1.6225571084674983
2008-06-09T09:30:00-04:00,31.41,31.55,31.09,31.25,3173076,1797029.85,43.1938854692083,50.47298620981229,NaN,NaN,-152.97318462060107,29.73766597670747,-0.0311645369781123,-0.004260603141620578,0.02690393383649172,7553663,10415018.2,55.47470867472912,41.37081480515599,NaN,NaN,-0.10708446680554799,1.3754654548570633
2008-06-10T09:30:00-04:00,31.05,31.24001,30.92999,30.95,1942927,1840068.75,39.64820440523966,49.56200961167675,NaN,NaN,-206.8661807728025,-30.312292561466087,-0.07264233918258622,-0.06389899014174105,0.008743349040845165,5610736,9739918.6,50.47059811267186,42.147097346566795,NaN,NaN,-3.575730553508484,0.6681517393762708
2008-06-11T09:30:00-04:00,31.02,31.02,30.57001,30.64,2322154,1891521.75,36.32954644372589,48.79442715113852,NaN,NaN,-244.29298321984038,-100.64729054466956,-0.1146949778177885,-0.13462537323139045,-0.019930395413601962,3288582,8108225,40.873693233610524,42.3151657036321,NaN,NaN,-7.581244872546438,-0.5103334908984019
2008-06-12T09:30:00-04:00,30.75,30.92999,30.00999,30.38,3137069,1971938.75,33.776001297643234,47.40093805719035,NaN,NaN,-245.79893115253864,-181.19095783597277,-0.15145114773965027,-0.2092443300881648,-0.05779318234851453,151513,5466246.6,30.695991125419,41.67396497284825,NaN,NaN,-11.726922847397732,-2.1127033989697344
2008-06-13T09:30:00-04:00,30.85001,31.3,30.75,30.86,1882696,2005417.35,41.895773762561426,47.20378451676659,NaN,NaN,-112.65792700785326,-192.51784135472718,-0.1353905154914576,-0.22703132671283655,-0.09164081122137893,2034209,3727740.6,26.091906637037624,40.82006457764917,NaN,NaN,-12.544728885595319,-3.6029927542019604
2008-06-16T09:30:00-04:00,31.02,31.12,30.72,30.96001,1597364,2016207.25,43.45151131429427,46.95261098685564,NaN,NaN,-103.62933941293527,-182.649072313194,-0.11100875145854372,-0.23040175054455858,-0.11939299908601486,3631573,2943322.6,24.319465998701972,39.988510790310116,NaN,NaN,-12.683974669621358,-4.9002758849761605
2008-06-17T09:30:00-04:00,31.25,31.25,30.8,30.88,1496256,1982275.7,42.47176321392639,46.665930385985526,NaN,NaN,-84.22119566085414,-158.12007529080432,-0.093925040030756,-0.23679929912445985,-0.14287425909370385,2135317,2248238.8,22.838939719151426,39.17978803448634,NaN,NaN,-13.095592873862078,-6.071035454817006
2008-06-18T09:30:00-04:00,30.82001,30.92,30.49001,30.53,2383644,2018792.1,38.393496149144845,45.321387763067854,NaN,NaN,-120.0296562219559,-133.26740989122743,-0.09932721986044293,-0.2670332839192575,-0.16770606405881458,-248327,1540857,21.4104125023036,38.028539223727385,NaN,NaN,-14.73121979626505,-7.30820464645244
2008-06-19T09:30:00-04:00,30.25,30.88,30.25,30.57001,1779713,2006319.25,39.113248947240486,44.092141312900495,NaN,NaN,-114.56799629412961,-107.02122291954561,-0.09342401562144115,-0.284486083585616,-0.19106206796417485,1531386,1816831.6,23.422801657321543,37.04095916022787,NaN,NaN,-15.827858083413805,-8.525297994589778
2008-06-20T09:30:00-04:00,30.46001,30.49001,29.92,30,2037844,2058447.25,33.16794607359445,42.89455214604481,NaN,NaN,-150.9032596665759,-114.67028945129016,-0.11946139044337972,-0.3403888060183995,-0.22092741557501977,-506458,1308698.2,22.291001243887777,36.01795236380159,NaN,NaN,-18.7543508858532,-9.986591264770267
2008-06-23T09:30:00-04:00,30.22,30.37,30.209,30.22,1360143,2060011.4,37.139434186210245,41.754499658187264,NaN,NaN,-116.26798012610168,-117.19801759392342,-0.11346470995001395,-0.3627583030125372,-0.24929359306252324,853685,753120.6,21.091004833333557,34.853188839462206,NaN,NaN,-19.919437493739895,-11.405569297480213
2008-06-24T09:30:00-04:00,30.24001,30.48,30.06,30.33,1782741,2069268.15,39.08848232996946,40.742836383422464,NaN,NaN,-101.09672633241671,-120.57312372823594,-0.09446539408271948,-0.3673753356659226,-0.27290994158320314,2636426,853342.4,21.907701403222646,33.226425469224715,NaN,NaN,-20.273053240706105,-12.672352717941054
2008-06-25T09:30:00-04:00,30.37,30.87,30.34,30.67,2678819,2133509,44.78693627550031,39.84164526089516,NaN,NaN,-56.68720620870034,-107.90463372558483,-0.05341888537903233,-0.33968354830699354,-0.2862646629279612,5315245,1966056.8,30.507324973913086,31.808350266066075,NaN,NaN,-18.805879050209395,-13.54857076540796
2008-06-26T09:30:00-04:00,30.37,30.50999,29.89999,30.05,2324673,2135318.15,37.83577030294277,39.30657144080014,NaN,NaN,-104.87768233108761,-105.96657093297642,-0.06184855396263722,-0.36357535538125774,-0.3017268014186205,2990572,2257894,32.60360607991258,30.28565401394399,NaN,NaN,-19.781208103749268,-14.438947528028148
2008-06-27T09:30:00-04:00,30.11,30.44,30.07001,30.25,2161800,2170569,41.01603491553723,39.151010686966494,NaN,NaN,-87.07802602294264,-93.20152420424978,-0.04837558510491835,-0.36219628279976845,-0.3138206976948501,5152372,3389660,40.1443827778305,29.190630735594084,NaN,NaN,-19.536405664230838,-15.167155833199962
2008-06-30T09:30:00-04:00,30.08,30.97,30.08,30.58,2441642,2209046.55,45.93119948011555,39.59979604945762,NaN,NaN,-44.35535790142203,-78.81899975931385,-0.013474188674002352,-0.33066343353735306,-0.3171892448633507,7594014,4737725.8,47.656786715928106,28.989644207255246,NaN,NaN,-17.7259271288389,-15.53269458971981
2008-07-01T09:30:00-04:00,30.19,30.69,30.19,30.58,10508273,2601033.55,45.93119948011555,40.28562840919975,NaN,NaN,-46.93737470020193,-67.98712943287089,0.011999423491142247,-0.3021899654994229,-0.31418938899056514,7594014,5729243.4,52.389902306501675,29.812230569604612,NaN,NaN,-16.306036729504378,-15.643172038260463
2008-07-02T09:30:00-04:00,30.81,30.89,30.37,30.37,2258884,2590936.95,43.27006761913052,40.9637760035917,NaN,NaN,-32.637779563230936,-63.177244103777014,0.016799455767112392,-0.2931900692816747,-0.3099895250487871,5335130,5733220.4,52.40849130747617,31.36312343975155,NaN,NaN,-15.9022507345157,-15.68018328058264
2008-07-03T09:30:00-04:00,30.53,30.69,30.42,30.5,2497662,2620102.3,45.37976850412451,41.212632770846206,NaN,NaN,-25.59600740878831,-47.32090911931715,0.03004977939889003,-0.2724273008001745,-0.30247708019906455,7832792,6701664.4,56.8288194257219,33.55861721037185,NaN,NaN,-14.949836949050882,-15.575848090363817
2008-07-07T09:30:00-04:00,30.49001,30.67999,30.14,30.3,3816947,2679216.35,42.74601241072241,41.16223999201964,NaN,NaN,-57.989301103711504,-41.503164135470925,0.02677365949771776,-0.26901000582691736,-0.2957836653246351,4015845,6474359,55.52524614070031,35.78760150622888,NaN,NaN,-14.898808566125782,-15.47912815832981
2008-07-08T09:30:00-04:00,30.28999,31.28,30.28999,31.10001,4317293,2736427.2,54.19730292515522,41.999778542821694,NaN,NaN,94.14841093071489,-13.802410369043539,0.07706810398781311,-0.19944853533986873,-0.27651663932768183,8333138,6622183.8,56.22844956661852,38.172566495333676,NaN,NaN,-11.042232903133318,-14.845285979016026
2008-07-09T09:30:00-04:00,31.28999,31.73,31.10001,31.25,6234141,2950987.9,55.97516475308148,43.25561201453146,NaN,NaN,210.20688652687215,37.62644187637128,0.11664461088323352,-0.13071087572363993,-0.24735548660687345,14567279,8016836.8,62.286919794775606,41.092317016224534,NaN,NaN,-7.369540808261488,-13.77732238319395
2008-07-10T09:30:00-04:00,31.37,31.44,30.97,31.42,5928496,3131305,57.96662882561748,44.60228200584411,NaN,NaN,159.48754108234874,76.05150600548723,0.14843979103674682,-0.06180574781093995,-0.21024553884768676,20495775,11048965.8,71.51728082616421,44.527636956856156,NaN,NaN,-3.7360635414403314,-12.342856834372004
2008-07-11T09:30:00-04:00,31.09,31.19,30.74001,30.82001,4324066,3190654.85,49.46248758095076,45.766177827798124,NaN,NaN,64.85764776853009,94.1422370409509,0.12421374318207357,-0.054978359870094806,-0.17919210305216837,16171709,12716749.2,75.12379371788478,48.30140784785594,NaN,NaN,-3.2507553700275893,-11.043985196608515
2008-07-14T09:30:00-04:00,30.92999,31.5,30.74001,31.03,3421931,3267616.6,52.11056928207702,46.83554462036004,NaN,NaN,101.16956097448634,125.97400945659047,0.11755256747605802,-0.03225139370709584,-0.14980396118315387,19593640,15832308.2,80.17412086743425,52.521630421720275,NaN,NaN,-2.004033984789116,-9.75256359492003
2008-07-15T09:30:00-04:00,30.8,31.44,30.74001,31.17999,5179129,3446704.85,53.965999446141176,47.8982244143723,NaN,NaN,101.77051653047688,127.49843057654286,0.11815291727350612,-0.002112814591271217,-0.12026573186477733,24772769,19120234.4,83.89097405721618,56.94900703986267,NaN,NaN,-0.4148177502048097,-8.418599902817856
2008-07-16T09:30:00-04:00,31.5,31.64999,31.25999,31.39999,8097715,3776777.8,56.620797904793484,48.7435002450361,NaN,NaN,150.97305556770385,115.65166438470922,0.12747175949451217,0.039073967503362894,-0.08839779199114928,32870484,22780875.4,86.84744070304968,60.97330102051529,NaN,NaN,1.727104067706632,-6.969213621314358
2008-07-17T09:30:00-04:00,31.64999,31.81,31.25999,31.71001,3847497,3849970.45,60.11179173605744,50.33464463311572,NaN,NaN,148.7980214284453,113.51376045392854,0.1472210069255458,0.09562846666578295,-0.05159254025976283,36717981,26025316.6,88.80799567365096,64.98790027721088,NaN,NaN,4.642207918034604,-5.310439115693078
2008-07-18T09:30:00-04:00,31.78999,31.99001,31.42999,31.7,2858738,3903921.7,59.944049414851435,51.68664566878102,NaN,NaN,141.36549493050964,128.81532988632443,0.1517134286811862,0.13804924559171994,-0.013664183089466271,33859243,29562823.4,90.47512763947702,68.58295348161421,NaN,NaN,6.926308707846007,-3.562332283758923
2008-07-21T09:30:00-04:00,31.7,31.71001,31.08501,31.14,4387789,4021418.95,51.316649980857136,52.07132070454828,NaN,NaN,73.08026266399462,123.1974702242261,0.11096280498999721,0.12503932314803023,0.01407651815803303,29471454,31538386.2,91.25826507152034,71.69734479272793,NaN,NaN,6.329263666763785,-2.149247147969965
2008-07-22T09:30:00-04:00,31.06,31.60001,30.99001,31.57001,3187349,4112779.25,56.49453982000221,52.82584501454018,NaN,NaN,77.14949335583276,118.27326558929727,0.10691815062537423,0.14772420643975082,0.04080605581437659,32658803,33115593,91.8354234043616,74.51488201400365,NaN,NaN,7.472348496556494,-0.7747334844661855
2008-07-23T09:30:00-04:00,31.63,31.99001,31.63,31.71001,3801520,4213718.2,58.05858603789936,53.88216775873796,NaN,NaN,123.2722229981527,112.73309907538703,0.10734066541075896,0.1749818875778253,0.06764122216706633,36460323,33833560.8,92.09139868571755,77.34937539816374,NaN,NaN,8.883002882557312,0.6049431393943141
2008-07-24T09:30:00-04:00,31.64999,32.06,31.64999,31.67999,5173559,4338455.2,57.58056274827318,54.75365306189143,NaN,NaN,112.64578058008688,105.50265090571534,0.09944603606116316,0.19194876724352028,0.09250273118235712,31286764,32747317.4,87.61577527847302,79.54844367336025,NaN,NaN,9.874702466858286,1.9291944718891674
2008-07-25T09:30:00-04:00,31.72,32.03999,31.72,31.87,5850137,4514728.4,59.834718251712495,55.97427490767644,NaN,NaN,115.84518317083625,100.39858855378067,0.10056737435113507,0.21821194912127595,0.11764457477014088,37136901,33402849,87.99495865705218,81.86770885309967,NaN,NaN,11.369068138149043,3.2777478527834356
2008-07-28T09:30:00-04:00,32.34,32.34,31.61,31.61,2640933,4538685.05,55.48950222934257,56.06657485797553,NaN,NaN,103.61634093792927,106.50580420856758,0.07833316379976216,0.21556102951984357,0.13722786572008142,34495968,34407751.8,88.57258067538476,84.17800393229727,NaN,NaN,11.387687288317204,4.4363106292882595
2008-07-29T09:30:00-04:00,31.84,32.00999,31.77,31.92999,3637896,4598497.75,59.397535554341076,56.31102991520835,NaN,NaN,103.38010854237616,111.75192724587627,0.07946077147633746,0.23655383006550323,0.15709305858916578,38133864,35502764,89.18331702080872,86.0991751627282,NaN,NaN,12.56890611050657,5.598109983748018
2008-07-30T09:30:00-04:00,31.94,32.09,31.55,31.92,5642879,4355228.05,59.222712835584716,56.40075020163459,NaN,NaN,89.16075718901857,104.92963408404944,0.07393234328886492,0.24950848770024692,0.175576144411382,32490985,34708896.4,85.61100803675569,87.10586996348472,NaN,NaN,13.474353460753916,6.723287623320289
2008-07-31T09:30:00-04:00,31.92999,32.32001,31.83,31.95,4034969,4444032.3,59.607192990231965,57.12537201658325,NaN,NaN,110.76968656210643,104.55441528045336,0.0669054117222671,0.25920790906421587,0.19230249734194876,36525954,35756734.4,86.38614300422076,87.9103234839373,NaN,NaN,14.327388319305145,7.809587722746697
2008-08-01T09:30:00-04:00,32.07001,32.11,31.57001,31.71001,4288195,4533558.95,55.12910030767463,57.34098137555451,NaN,NaN,62.43110212102292,93.87159907049069,0.041924988611626135,0.24470873310648145,0.2027837444948553,32237759,34776906,81.94097044744146,88.03652702536638,NaN,NaN,13.838665561914375,8.670884556913508
2008-08-04T09:30:00-04:00,31.88,32.25,31.62,31.98,3126968,4499060,58.87249790253419,57.69144555101115,NaN,NaN,85.97635383445835,90.34360164979651,0.03945135653989379,0.25209794016972253,0.21264658362982874,35364727,34950657.8,82.11670455675858,87.90979348961942,NaN,NaN,14.463039248862158,9.498335227191887
2008-08-05T09:30:00-04:00,32.39999,33.07001,32.07001,33.02,3274033,4446897,69.44637516384732,58.60755821237211,NaN,NaN,221.9959134489308,114.06676263110744,0.10026453863752463,0.3379772569267345,0.2377127182892099,38638760,35051637,82.22496242725015,87.57961646991944,NaN,NaN,18.775155076587033,10.823595205676908
2008-08-06T09:30:00-04:00,32.77,33.14999,32.44,33.14999,9166953,4593537.6,70.4683744049857,59.34731411729556,NaN,NaN,221.68670350363024,140.57195189402975,0.1392535068769033,0.411779601885339,0.2725260950084357,47805713,38114582.6,85.15957237269151,87.3190148055652,NaN,NaN,22.51264208817677,12.49345904603403
2008-08-07T09:30:00-04:00,32.75999,33.05499,32.5,32.75,3833534,4488789.5,63.43679423098508,59.59679588987653,NaN,NaN,172.82868681700145,152.98375194500878,0.12838014215354726,0.4330012727003698,0.30462113054682255,43972179,39603827.6,86.3404072187115,87.02367763265337,NaN,NaN,23.339584012915896,14.042905469874295
2008-08-08T09:30:00-04:00,32.66,33.35001,32.64,33.32001,6504621,4597817.25,68.29236758015878,60.80934714696951,NaN,NaN,195.97748649639732,179.69302882008364,0.14843456245977626,0.4901643336215429,0.3417297711617666,50476800,43251635.8,88.71006086754902,86.84166304665543,NaN,NaN,25.746678633859048,15.71487306472926
2008-08-11T09:30:00-04:00,33.47,33.5,33.14,33.35001,2849519,4569196.65,68.52924673983682,61.66896906981484,NaN,NaN,183.15057901256583,199.12787385570513,0.1520221443697265,0.5317574516239247,0.37973530725419824,53326319,46843954.2,90.46443106909501,86.74373502270781,NaN,NaN,27.675822388729802,17.423580111015053
2008-08-12T09:30:00-04:00,33.28,33.48,33.22,33.28,3521053,4486292.85,67.26630271492056,62.32666311817349,NaN,NaN,147.90474773480068,184.30964071287912,0.13837167024031133,0.5526998950545874,0.41432822481427606,49805266,49077255.4,91.36299685687064,86.69170632064731,NaN,NaN,28.8274933326559,19.05271057124946
2008-08-13T09:30:00-04:00,33.17999,33.3699,33.00999,33.3,5973715,4380092.85,67.45084777616569,63.03168347730867,NaN,NaN,114.54861918890609,162.88202384993428,0.12006114784629235,0.5644046596221415,0.44434351177584913,55778981,50671909,91.94656073119579,87.00104813869893,NaN,NaN,29.806902384935835,20.58902368749037
2008-08-14T09:30:00-04:00,33.08,33.57001,32.89,33.28,3494072,4362421.6,67.04379507717766,63.54661753627047,NaN,NaN,101.08482538957705,148.53325156444942,0.09696331512624218,0.5655476556836518,0.46858434055740966,52284909,52334455,92.51442249709525,87.3238669844163,NaN,NaN,30.497096767111515,22.00446269886482
2008-08-15T09:30:00-04:00,33.21001,33.7,33.21001,33.61,3045426,4371756,70.23555118600655,64.59990674746075,NaN,NaN,111.94832205785157,131.72741867674026,0.09419089892533355,0.5863229642140766,0.49213206528874304,55330335,53305162,92.83221621752833,87.62812666599798,NaN,NaN,32.02514450879084,23.435988671711396
2008-08-18T09:30:00-04:00,33.74001,33.74001,33.14999,33.33,2169616,4260847.35,64.5253471313241,64.96617900295954,NaN,NaN,91.87235132161838,113.47177313855077,0.06515993962804034,0.5735819898237935,0.5084220501957532,53160719,53272042,92.68762942453932,87.87843469483587,NaN,NaN,31.691351767046033,24.6153262567592
2008-08-19T09:30:00-04:00,33.16,33.31,32.88,33.17999,7032215,4453090.65,61.63424409259222,65.13843123560294,NaN,NaN,57.59489365120637,95.40980232183192,0.02933963052494848,0.5450965883519387,0.5157569578269903,46128504,52536689.6,89.35979330396007,88.14620507106476,NaN,NaN,30.573101141333854,25.46643695455558
2008-08-20T09:30:00-04:00,33.08,33.11,32.7,32.97,4168496,4471439.45,57.73453695437102,65.0046700901843,NaN,NaN,32.613344382742824,79.02274736059928,-0.012753006139970657,0.4998157001520269,0.5125687062919976,41960008,49772895,78.02146129692407,87.54872780625786,NaN,NaN,28.475949762475715,25.896367355687026
2008-08-21T09:30:00-04:00,32.73,33.09,32.53999,32.75999,2710257,4348274.35,54.05120115778152,64.92767729376337,NaN,NaN,13.729862778940161,61.5517548384719,-0.056542660309318926,0.44189038090534893,0.49843304121466786,39249751,47165863.4,69.11319485197087,86.6324581208671,NaN,NaN,25.593249134100265,25.853064752603203
2008-08-22T09:30:00-04:00,33.03999,33.37,32.89,33.31,3494438,4230489.4,61.05826696206979,65.08380365515876,NaN,NaN,57.32888514666251,50.627867456234085,-0.0504688731282672,0.43534694980433386,0.48581582293260106,42744189,44648634.2,61.77856678685315,85.17973399444529,NaN,NaN,25.087234283454595,25.743660399867686
2008-08-25T09:30:00-04:00,33.06,33.17999,32.63499,32.77,2074946,4202190.05,52.58027931438741,63.87908252305448,NaN,NaN,9.113433053181478,34.076083802546705,-0.0829069078518957,0.3821821881177314,0.4650890959696271,40669243,42150339,55.48497985618386,83.26973523936911,NaN,NaN,21.786697000341295,25.178379914221058
2008-08-26T09:30:00-04:00,32.75999,32.96001,32.59,32.73,1344406,4087515.55,52.00425856232654,62.56021710572168,NaN,NaN,-13.471740894980632,19.862756893309303,-0.10568515754370889,0.332982649039991,0.43866780658369986,39324837,40789605.6,52.35642098030885,80.92665299705607,NaN,NaN,19.01578631697423,24.298009400328652
2008-08-27T09:30:00-04:00,32.75999,32.81,32.52,32.78,2616232,3936183.2,52.70177552812985,61.79343005551773,NaN,NaN,-33.82646899913277,6.574794216934178,-0.11523030003505558,0.2946299315398804,0.40986023157493595,41941069,40785817.8,52.34757259297117,78.49859338093177,NaN,NaN,16.991534084345503,23.25422721233106
2008-08-28T09:30:00-04:00,32.83,33.00999,32.8,32.97,1667043,3817786.9,55.356841194424014,60.86946388510811,NaN,NaN,-0.5384284954583795,3.7211359620544733,-0.10678370906209456,0.27638059524731773,0.3831643043094123,43608112,41657490,54.263198930382764,76.03810324256274,NaN,NaN,16.053613860406628,22.225568162056142
2008-08-29T09:30:00-04:00,32.97,33.06,32.61,32.61,2408298,3723792.05,49.66780168087642,59.52221780946809,NaN,NaN,-54.38732943743008,-18.622106954764075,-0.12235936579427442,0.23021509706656929,0.3525744628608437,41199814,41348615,53.44335026722979,73.3937403281438,NaN,NaN,13.48325599330917,20.976666423663715
2008-09-02T09:30:00-04:00,32.89999,33.31,32.55,32.55,5185164,3826701.85,48.76822531924633,58.200926566919925,NaN,NaN,-63.3523899081229,-33.11527154702495,-0.13275101944561818,0.18663568855382096,0.31938670799943913,36014650,40417696.4,50.94505388709616,70.50674440173135,NaN,NaN,11.127027313947266,19.56957512227565
2008-09-03T09:30:00-04:00,32.64999,32.78999,32.46001,32.74001,3011277,3813564.05,51.74867782584441,57.07934299903984,NaN,NaN,-102.31429816830584,-50.88378300168999,-0.12309107218377796,0.1655228677697167,0.28861393995349466,39025927,40357914.4,50.780883828001926,67.56633890864606,NaN,NaN,9.976147147312785,18.19908541156667
2008-09-04T09:30:00-04:00,32.50999,32.58,31.87,32.02,11658098,3938121.3,41.82032942661482,55.27766688114249,NaN,NaN,-207.27310604249524,-85.57311041036249,-0.1591643613064678,0.0896584883204099,0.2488228496268777,27367829,37443266.4,43.43227886635081,64.06047150645003,NaN,NaN,5.590758094527006,16.39789579484672
2008-09-05T09:30:00-04:00,31.66,32.06,31.5,31.85001,5803102,4036599.7,39.8751929539158,53.109069864564574,NaN,NaN,-244.08165286822887,-134.28175528491658,-0.1865475763428164,0.0156383791983572,0.2021859555411736,21564727,33034589.4,35.147113790271035,59.94010704736023,NaN,NaN,1.4038631864951232,14.255891136510776
2008-09-08T09:30:00-04:00,32.39,32.47,32,32.38,7643871,4093562.2,47.99647179476347,51.9284359119531,NaN,NaN,-122.23639727738157,-147.8515688529069,-0.16195227993546715,-0.0002543943781603275,0.16169788555730683,29208598,30636346.2,31.61414637439701,55.577715400921484,NaN,NaN,0.4093681848347629,12.277816429128489
2008-09-09T09:30:00-04:00,32.50999,32.64,31.84,32.10001,3408564,4121514.45,44.571276583756266,50.709652518464814,NaN,NaN,-125.13638574714236,-160.2083680207108,-0.1573890949592716,-0.035038483141782706,0.12235061181748891,25800034,28593423,28.945030219105135,51.262375180574715,NaN,NaN,-1.5417718311079074,10.303589534809003
2008-09-10T09:30:00-04:00,32.02,32.09801,31.84,31.97,5238973,4207410.45,43.035521349795744,49.659722832423725,NaN,NaN,-147.5899105008617,-169.26349048722193,-0.15569076423506148,-0.07226284347633793,0.08342792075872354,20561061,24900449.8,24.859186705859372,47.46506985264152,NaN,NaN,-3.5929744251209996,8.31836611196186
2008-09-11T09:30:00-04:00,31.5,32.37,31.5,32.10001,3970702,4107259.8,45.07365344096267,49.01846942407953,NaN,NaN,-123.0554934234729,-152.41996796341746,-0.13892837826690585,-0.09023255207490877,0.04869582619199708,24531763,24333236.6,24.292000245219114,44.263555952159244,NaN,NaN,-4.641505581018294,6.466955870107552
2008-09-12T09:30:00-04:00,32.21001,32.39999,31.995,32.39999,3869145,4126013.45,49.558204406068015,48.19703638436511,NaN,NaN,-66.23255984273679,-116.85014935831904,-0.10243911208658725,-0.07935306391623698,0.02308604817035027,28400908,25700472.8,28.5252462736471,41.88831877264454,NaN,NaN,-4.151485321947422,4.950035699813984
2008-09-15T09:30:00-04:00,31.8,32.16,31.5,31.5,6297609,4288622.6,39.213766893138434,47.24228549713304,NaN,NaN,-136.09038586582926,-119.62094707600859,-0.13184404978482128,-0.14171901406067633,-0.00987496427585505,22103299,24279413,26.84508849746358,39.84261224702167,NaN,NaN,-7.304122171684135,3.199441718171396
2008-09-16T09:30:00-04:00,31.23,32.03,31.02,31.45,7326078,4546445.7,38.73008836356561,46.294130482935834,NaN,NaN,-148.7243625275894,-124.33854243209798,-0.1464638671406281,-0.1929547982016402,-0.046490931061012084,14777221,22074850.4,24.44007275770889,37.84858737397881,NaN,NaN,-9.889697831966963,1.3295646395802019
2008-09-17T09:30:00-04:00,31.00999,31.5401,30.12,30.95,6844090,4537039.45,34.18872884951392,44.971770005891834,NaN,NaN,-205.67169804144376,-135.9548999402144,-0.1794343904554322,-0.2707839191303023,-0.09134952867487013,7933131,19549264.4,22.007588948506324,35.681445685088455,NaN,NaN,-13.661039152877352,-0.8119501879137341
2008-09-18T09:30:00-04:00,30.67,31.39,30.35001,31.35001,14902738,5073751.55,40.227194043889384,43.891080923710796,NaN,NaN,-160.20488920207035,-143.38477909593388,-0.16433290855548116,-0.2967656643692216,-0.13243275581374042,22835869,19210085.6,21.69529452075571,33.35516679868652,NaN,NaN,-14.764496711376909,-2.805171119837045
2008-09-19T09:30:00-04:00,32.74001,33.08,31.06,31.55,4820914,5179284.4,43.041102581332915,43.4177452737434,NaN,NaN,-42.38153633242568,-138.6145743938717,-0.1322827309087143,-0.2977861694496333,-0.165503438540919,27656783,19061260.6,21.550788213335593,31.077126651979793,NaN,NaN,-14.728063972108524,-4.508441527304399
2008-09-22T09:30:00-04:00,31.25999,31.92,30.46001,30.8,4334230,5221274,36.16513140830491,42.51752428010473,NaN,NaN,-135.8191483854679,-138.5603268977994,-0.1516142057396574,-0.35502119571549073,-0.20340698997583334,23322553,19305111.4,22.462102649600595,29.042630135015827,NaN,NaN,-17.09497598380321,-6.3065178782328
2008-09-23T09:30:00-04:00,30.73,30.91,30.07001,30.07001,3318587,5283456.05,30.97782489785949,41.03389192810581,NaN,NaN,-192.34676062317007,-147.28480651691555,-0.20051476616494218,-0.4540504476820111,-0.2535356815170689,20003966,20350460.4,26.40874422244515,27.301763020333194,NaN,NaN,-21.037284778025235,-8.41091314963172
2008-09-24T09:30:00-04:00,30.34,30.67,30.23,30.35001,4029529,5417712.2,34.838546034391825,40.535193114375595,NaN,NaN,-156.204599210615,-137.3913867507498,-0.20047299241928368,-0.5041269220411735,-0.3036539296218898,24033495,23570533.2,37.03964155718737,26.845146069678666,NaN,NaN,-22.773198982678828,-10.46266826863845
2008-09-25T09:30:00-04:00,30.38,31.2795,30.38,30.89999,9256121,5749706.65,41.732661060832974,40.66786940772682,NaN,NaN,-96.01427155404237,-124.55326322114419,-0.15207089025589193,-0.49374254244175475,-0.3416716521858628,33289616,25661282.6,42.81581976395188,27.392910782084442,NaN,NaN,-21.7674814120079,-12.077641574834084
2008-09-26T09:30:00-04:00,30.75,31.22,30.53,30.84,5521082,5942408.6,41.22037056443769,40.18386217698926,NaN,NaN,-83.80659693113412,-132.8382753408859,-0.11447504939079611,-0.48476546392435793,-0.3702904145335618,27768534,25683632.8,42.876152769005046,28.19733981027073,NaN,NaN,-21.163042326926664,-13.375555967990167
2008-09-29T09:30:00-04:00,30.46001,31.06,29,30.14999,8689305,6256458.95,35.779855581633115,39.55590353398047,NaN,NaN,-143.32634471332915,-134.33971460645816,-0.12556869262264891,-0.527251280311873,-0.40168258768922405,19079229,24834968,41.102820406300836,29.06575339507042,NaN,NaN,-22.491742256481572,-14.67786829491751
2008-09-30T09:30:00-04:00,30.27,30.45,29.78,30.05,3309721,6162686.8,35.057754360173675,38.98606303472176,NaN,NaN,-124.40691624769647,-120.75174573136341,-0.12865851964870567,-0.5625057372501061,-0.43384721760140044,15769508,23988076.4,39.35363632084207,30.101071224712047,NaN,NaN,-23.761614999947312,-15.975546395636051
2008-10-01T09:30:00-04:00,30.10001,30.48,30.10001,30.25,6053559,6314800.9,37.76335551979923,38.4638988974958,NaN,NaN,-96.5732377204626,-108.82547343333295,-0.10713183613836719,-0.5677620127743594,-0.46063017663599226,21823067,23545990.8,38.434151800917626,31.111224907261942,NaN,NaN,-23.949392725493254,-17.114667299901367
2008-10-02T09:30:00-04:00,30.25,30.59,29.925,30.3,6353371,6049564.55,38.45369569150458,37.67071970359841,NaN,NaN,-88.33158922023593,-107.28893696657164,-0.08063293949319561,-0.5614213510024868,-0.4807884115092912,28176438,22523355.2,36.320145140346334,31.66800339774046,NaN,NaN,-23.895908843754164,-18.083416091880338
2008-10-03T09:30:00-04:00,30.60001,30.60001,29.64999,29.64999,6814359,6100127.4,33.28480126248819,37.247222158551956,NaN,NaN,-107.00560211493453,-111.92873800333173,-0.09689589600190796,-0.6019082815116761,-0.5050123855097681,21362079,21242064.2,33.81082340056162,32.165555890818894,NaN,NaN,-25.46228427697469,-19.137540118322388
2008-10-06T09:30:00-04:00,29.39999,29.88,27.41,28.53999,8544953,6145181.5,26.687636693085125,36.38704703923192,NaN,NaN,-207.37253599837925,-124.73797626034175,-0.16824326441173465,-0.7153164660244364,-0.5470732016127018,12817126,19989643.6,31.518571163388643,32.67116291979602,NaN,NaN,-29.27563426678308,-20.5858392823882
2008-10-07T09:30:00-04:00,28.72,28.78,27.39,27.85001,5060117,6227759.15,23.561471223466356,35.62795720879995,NaN,NaN,-217.33136550259073,-143.3228661113206,-0.24318817250240488,-0.8510584172407079,-0.607870244738303,7757009,18387143.8,28.825680664275254,33.158169470922374,NaN,NaN,-33.60659783572872,-22.445947647151133
2008-10-08T09:30:00-04:00,27.03,27.82001,26.55,27.35001,9958035,6463712.25,21.587993164905086,34.29658571744393,NaN,NaN,-229.55278640999538,-169.91877584922716,-0.30378085803727806,-0.9875963172849005,-0.6838154592476224,-2201026,13582325.2,22.59283246205338,33.2222793238722,NaN,NaN,-37.81416730522059,-24.641407598303914
2008-10-09T09:30:00-04:00,27.64,27.64,25,25.25,10773621,6803858.2,15.656533806838326,32.34054509069431,NaN,NaN,-249.8754782614762,-202.2275536574752,-0.4536180020834164,-1.250837961851893,-0.7972199597684766,-12974647,5352108.2,16.15083093666368,32.83656808982421,NaN,NaN,-44.435859385975796,-27.46918642511418
2008-10-10T09:30:00-04:00,24.10001,25.53999,22.89,24.14,15960723,7408437.1,13.539034480887665,30.724395310164514,NaN,NaN,-250.97486960468632,-231.02140715542555,-0.58732312054654,-1.5313738604516516,-0.9440507399051116,-28935370,-4707381.6,11.743342209969072,32.07094234413625,NaN,NaN,-50.563289263360346,-30.768343973435062
2008-10-13T09:30:00-04:00,25.67999,27.83,25.22,27.05,7756160,7481364.65,37.43058950402288,31.18530706774762,NaN,NaN,-114.5751921593008,-212.46193838760988,-0.446022317914444,-1.5015786372981665,-1.0555563193837225,-21179210,-11506648.8,9.797220269982489,30.884404918960342,NaN,NaN,-44.51447098447917,-32.73207640358422
2008-10-14T09:30:00-04:00,28.45,28.56,26.83501,27.60001,12535852,7741853.35,40.762427450639,31.608441454622415,NaN,NaN,-65.41706567136603,-182.07907842136495,-0.28935282660186745,-1.417247352636057,-1.1278945260341895,-8643358,-14786722.2,9.02058160380713,28.883043493718894,NaN,NaN,-38.888867070225764,-33.61161792739016
2008-10-15T09:30:00-04:00,27.37,27.37,24.89999,24.89999,8958617,7847579.7,31.807977052539044,30.89953545402999,NaN,NaN,-120.97645547834037,-160.36381223503395,-0.3380132408994432,-1.5504110771584934,-1.2123978362590502,-17601975,-17866912,8.351100325095913,26.421277819514895,NaN,NaN,-38.34549512782752,-34.28788609888121
2008-10-16T09:30:00-04:00,25.63,26.7,24.39,26.2,11304305,7667658.05,38.781121487351776,30.725303377095283,NaN,NaN,-104.6999527092879,-131.3287071245963,-0.2567766324575278,-1.5333686268309599,-1.276591994373432,-6297670,-16531516.6,11.42050519096604,24.17444584965497,NaN,NaN,-34.83938120283331,-34.366671113731506
2008-10-17T09:30:00-04:00,25.62,27.50999,25.62,26.10001,7742992,7813761.95,38.45539957665749,30.916413662454165,NaN,NaN,-73.96398785138155,-95.92653077393535,-0.18714112739645916,-1.510518403619006,-1.3233772762225469,-14040662,-13552575,18.016638723682206,22.525432872325066,NaN,NaN,-32.54273901378774,-34.10610938516811
2008-10-20T09:30:00-04:00,26.45,27.48,26.42,27.14999,8094160,8001758.45,43.793899120291144,31.540424002462554,NaN,NaN,-46.93869463276622,-82.39923126862843,-0.05461244608181137,-1.391642833824811,-1.3370303877429996,-5946502,-10506033.4,24.23075012184262,21.44522671525368,NaN,NaN,-28.705500862486495,-33.33459388192788
2008-10-21T09:30:00-04:00,27.10001,27.71001,27.00999,27.07001,4888852,8080271.7,43.48447897848861,31.949075678083226,NaN,NaN,-33.68394810743751,-76.05260775584273,0.038402152601680006,-1.2890276969908996,-1.3274298495925796,-10835354,-10944432.6,23.949433186717997,20.410603957096562,NaN,NaN,-25.976132085796422,-32.2833850539091
2008-10-22T09:30:00-04:00,26.75,26.75,25.36501,26.39999,10562391,8406914.8,40.87878168838099,32.12229610643154,NaN,NaN,-68.329071657777,-65.52313099173003,0.06403161021191561,-1.247390336827685,-1.3114219470396007,-21397745,-11703586.6,23.44189748687606,19.49072912470583,NaN,NaN,-24.663455906230336,-31.19482374709785
2008-10-23T09:30:00-04:00,25.81,26.59,24.95,25.78999,7834750,8335846.25,38.61037725497034,32.502694391608834,NaN,NaN,-77.59879359716757,-60.102899169305964,0.049766223536359844,-1.2492141676191508,-1.2989803911555107,-29232495,-16290551.6,20.601090132532306,18.54717674841802,NaN,NaN,-24.342673361203985,-30.215945120541583
2008-10-24T09:30:00-04:00,24.23,26.02,24.23,25.7,10636195,8591601.9,38.2729627670088,33.33021768260338,NaN,NaN,-90.30898061533664,-63.37189772209699,0.044315732567716815,-1.2435857254458647,-1.2879014580135815,-39868690,-21456157.2,17.961311192171536,17.578801036188228,NaN,NaN,-24.19375356718388,-29.355632041490484
2008-10-27T09:30:00-04:00,25.21001,25.75,24.12,24.60001,5929035,8453588.4,34.32437750871614,34.09899670297837,NaN,NaN,-104.43535417710137,-74.87122963096401,-0.019880873776168873,-1.3127525502337924,-1.2928716764576236,-45797725,-29426401.8,14.80834705676061,16.57756292136575,NaN,NaN,-25.306918265336158,-28.777244359182724
2008-10-28T09:30:00-04:00,25.42999,27.5,24.58,26.14999,7073242,8641764.45,43.2145210060452,35.64374869163124,NaN,NaN,-43.18021513498442,-76.7704830364734,0.05162709216825023,-1.228337811247311,-1.2799649034155611,-38724483,-35004227.6,13.078115803706865,15.89794030291243,NaN,NaN,-23.349947426434696,-28.001916225933005
2008-10-29T09:30:00-04:00,26.3,26.85001,25.64,25.97,7502410,8714207,42.49515329677382,37.56079294091234,NaN,NaN,-33.45815493902049,-69.7962996927221,0.09392317679163154,-1.1625609324260218,-1.2564841092176533,-46226893,-39970057.2,11.760647022037915,15.584355737582015,NaN,NaN,-22.03362459705477,-27.14930313609326
2008-10-30T09:30:00-04:00,26.28,26.86,25.989,26.58,4828387,8637957.8,45.78879560888756,39.86434730719805,NaN,NaN,-5.9884930195893915,-55.47423957720646,0.1658938358049462,-1.0491168144614704,-1.2150106502664166,-41398506,-42403259.4,11.167033163651638,15.543190805702197,NaN,NaN,-19.925472921084705,-26.117327391092036
2008-10-31T09:30:00-04:00,26.63,27.21001,26.42,26.60001,6100070,8602243.35,45.89826309085814,40.46918113482915,NaN,NaN,27.93590454121622,-31.825262545895885,0.2146612331980282,-0.9466841087688813,-1.1613453419669095,-35298436,-41489208.6,12.94467784930211,15.768009204225027,NaN,NaN,-18.209205512173707,-24.987595694103703
2008-11-03T09:30:00-05:00,26.67,27.13,26.67,26.8,3951569,8372574.15,47.0491039206864,40.91822945411825,NaN,NaN,50.76098448185205,-0.7859948141052087,0.25732545493571224,-0.8396885232972693,-1.0970139782329815,-31346867,-38599037,18.49828935010835,16.44498832896083,NaN,NaN,-16.466946747504473,-23.770360130303814
2008-11-04T09:30:00-05:00,27.39999,27.57001,27.07001,27.14999,3883961,8313766.35,49.090082674732294,42.15266556998919,NaN,NaN,95.78251836986199,27.00655188686407,0.3029139482172485,-0.718371542961421,-1.0212854911786695,-27462906,-36346721.6,22.64006459162256,17.465628633712733,NaN,NaN,-14.426305285986876,-22.435495152544252
2008-11-05T09:30:00-05:00,27.11,27.42,26.44,26.75,5999426,8115835.9,46.86673172566098,42.73020915843985,NaN,NaN,60.912508289720094,45.88068453261218,0.29939312042953325,-0.647044090641753,-0.9464372110712862,-33462332,-33793809.4,27.15851921422332,18.589772492516826,NaN,NaN,-13.274267658501449,-21.126748367680996
2008-11-06T09:30:00-05:00,26.5,26.63,25.55499,26.10001,8637078,8009008.75,43.4248583285567,43.08517049786122,NaN,NaN,-17.518664741201388,43.57465018828977,0.24863929577491173,-0.6356380913526465,-0.8842773871275582,-42099410,-33933990.2,27.06503897346454,19.236086796072705,NaN,NaN,-13.209517514199876,-19.995715388612265
2008-11-07T09:30:00-05:00,26.06,26.59,25.8,26.42999,5676285,7494786.85,45.60872001109009,43.21480056148972,NaN,NaN,-11.89888245924584,35.60769278819736,0.23291403985620085,-0.5931348373073071,-0.8260488771635079,-36423125,-34158928,26.905007484862296,19.427105179145542,NaN,NaN,-12.560780918752462,-18.933581892918006
2008-11-10T09:30:00-05:00,27.12,27.12,26.05,26.24001,4835785,7348768.1,44.54266258306128,43.290385104673476,NaN,NaN,13.381067303528168,28.13170935253259,0.20625486541589722,-0.5682302953936365,-0.7744851608095337,-41258910,-36141336.6,25.47534888248842,19.536099157414856,NaN,NaN,-12.295857587559443,-17.985335563581067
2008-11-11T09:30:00-05:00,26.22,26.33,25.60001,25.77,10627922,7253371.6,41.93136925562829,43.36556993090543,NaN,NaN,-50.42748343653926,-1.1102910087476459,0.15579908368960438,-0.5797363061975283,-0.7355353898871326,-51886832,-41026121.8,22.327103394732006,19.456471007975995,NaN,NaN,-12.764870807086147,-17.239554884081794
2008-11-12T09:30:00-05:00,25.42,25.73,24.97,25.2,4237660,7017323.75,38.94921161283062,43.389772385038306,NaN,NaN,-123.45303224040165,-37.983399114772,0.08633679915389492,-0.627614390944764,-0.7139511900986589,-56124492,-45558553.8,19.87305263536608,19.404468329606978,NaN,NaN,-13.999502949293962,-16.776690321969248
2008-11-13T09:30:00-05:00,25.02,26.55,24.53,26.55,7599645,6832090.75,48.32331603302373,44.107654761182225,NaN,NaN,-49.91751128767044,-44.463168424065806,0.13093607011123864,-0.5502811024596106,-0.6812171725708492,-48524847,-46843641.2,19.22774678319756,19.494928014680266,NaN,NaN,-12.366967492942127,-16.146729917822515
2008-11-14T09:30:00-05:00,25.88,26.71001,25.53999,25.53999,5996898,6744786.05,43.003257031737704,44.727574727112334,NaN,NaN,-39.28398229105043,-49.94018839042673,0.09378019225595646,-0.5639919322509037,-0.6577721245068602,-54521745,-50463365.2,17.503666352113868,19.687450821491215,NaN,NaN,-12.583788251076802,-15.637738251144556
2008-11-17T09:30:00-05:00,25.08,25.83,25.00999,25.10001,6151430,6647649.55,40.89131153857464,44.56163119372159,NaN,NaN,-109.71757480075492,-74.55991681128334,0.04349378237774937,-0.6034048965346734,-0.6468986789124228,-60673175,-54346218.2,15.860758326417653,19.886211001684842,NaN,NaN,-13.411458854617441,-15.319698337354968
2008-11-18T09:30:00-05:00,24.91,25.45,24.41,25.27,5928129,6699613.4,42.07496021839605,44.531617402408884,NaN,NaN,-131.1008790509736,-90.69459593417021,0.026441235379358385,-0.6138471346882248,-0.6402883700675832,-54745046,-54917861,15.628189571639282,20.16246404094208,NaN,NaN,-13.740779474715481,-15.094138499835042
2008-11-19T09:30:00-05:00,25.41,25.61,24.10001,24.25,6997766,6521382.15,37.25427186980608,43.92200856390307,NaN,NaN,-153.56151935874527,-96.71629335783894,-0.0448896942115542,-0.696400487832026,-0.6515107936204718,-61742812,-56041525,15.157692499775791,20.44751113637952,NaN,NaN,-15.519743136241223,-15.154939162178781
2008-11-20T09:30:00-05:00,23.98,24.39,22.355,23.56,12781578,6768723.55,34.38429090308719,43.099581979062286,NaN,NaN,-228.67952645433581,-132.468696391172,-0.12533983551332906,-0.8081855880121331,-0.6828457524988041,-74524390,-61241433.6,13.18020262903444,20.46433433493183,NaN,NaN,-17.931047046366977,-15.551526002777095
2008-11-21T09:30:00-05:00,23.27,23.67,21.99001,23.59,9508379,6712332.75,34.62012352536813,42.21179766511097,NaN,NaN,-208.3872251028089,-166.28934495352368,-0.1610539999148919,-0.884163252392419,-0.7231092524775271,-65016011,-63340286.8,12.472877836121683,20.033947798218495,NaN,NaN,-19.79573793460666,-16.15784199303846
2008-11-24T09:30:00-05:00,23.7,24.67,23.61,24.06,6283930,6730077.5,38.35807397496627,41.44522561512769,NaN,NaN,-118.13454597462731,-167.97273918829816,-0.13840947843905604,-0.8961211005263472,-0.7577116220872911,-58732081,-62952068,13.398642660972072,19.373846231743464,NaN,NaN,-20.31224295197377,-16.751327844314932
2008-11-25T09:30:00-05:00,24.69,24.84,24.02,24.22,6164617,6684646.25,39.62357826863575,40.92785751105446,NaN,NaN,-86.99896096022853,-159.15235557014915,-0.09984193906970618,-0.8825140459244238,-0.7826721068547177,-52567464,-62516551.6,14.491292490170707,18.46904432288256,NaN,NaN,-20.388125479000905,-17.270870363555787
2008-11-26T09:30:00-05:00,23.75999,24.722,23.75999,24.60001,6608695,6639960.5,42.635807597829945,40.871496744573975,NaN,NaN,-77.14890569488892,-143.8698328373779,-0.03904785051678705,-0.8314819200007015,-0.7924340694839145,-45958769,-59359743,22.15783632152008,18.11852984774367,NaN,NaN,-19.617134805812725,-17.60605099816392
2008-11-28T09:30:00-05:00,24.74001,25.14,24.53999,24.92,1595024,6478292.35,45.11877229518513,40.8365004791522,NaN,NaN,-38.74650334137354,-105.88322821478543,0.028749143652729514,-0.7564976399180026,-0.7852467835707321,-44363745,-53327614,34.28268070835347,18.645506506564466,NaN,NaN,-18.272846405907607,-17.701307484984447
2008-12-01T09:30:00-05:00,24.8,24.8,23.44,23.64,5771699,6461873.8,38.02802953517268,40.37116954716016,NaN,NaN,-90.88879104005822,-82.3835414022353,-0.0047917561150503385,-0.7912364787145449,-0.7864447225994946,-50135444,-50351500.6,39.30578410408528,19.63339473667853,NaN,NaN,-19.13359895722307,-17.905920552447107
2008-12-02T09:30:00-05:00,23.91,24.28999,23.58,24.25,7442438,6636417.25,42.653401543075745,40.42274328197783,NaN,NaN,-77.09675020126562,-74.17598224756297,0.020535290824901353,-0.7607756090683679,-0.7813108998932693,-42693006,-47143685.6,44.25192701104287,21.19945356641502,NaN,NaN,-18.461618767211483,-17.985306011699162
2008-12-03T09:30:00-05:00,23.96001,25.03,23.77,24.83,10260344,6955236.4,46.724936610132715,40.978152210356555,NaN,NaN,-36.32633539747289,-64.04145713501183,0.07947060665188033,-0.6819726415784189,-0.7614432482302992,-32432662,-43116725.2,49.784301745873115,23.335971360022665,NaN,NaN,-16.64344144054278,-17.793611072962538
2008-12-04T09:30:00-05:00,24.53999,24.955,24.11,24.36,8388098,7074670,43.998810157337424,40.66925893352181,NaN,NaN,-35.534362957250096,-55.718548587484065,0.08919177107888376,-0.6499535343816945,-0.7391453054605782,-40820760,-42089123.4,51.117418071699056,25.613805023487057,NaN,NaN,-15.932358992893745,-17.527717918666994
2008-12-05T09:30:00-05:00,23.88,25.34,23.74001,25.19,8018117,7043721.95,49.59202434669637,41.139885170304574,NaN,NaN,-7.266599947944028,-49.422567908798165,0.15031653621723806,-0.5512496351890306,-0.7015661714062686,-32802643,-39776903,54.071994204303884,28.225828441500628,NaN,NaN,-13.566496693210286,-16.96182917217318
2008-12-08T09:30:00-05:00,25.94,25.94,25.13,25.39,9152863,7217550.85,50.86549050367832,41.85232652495484,NaN,NaN,65.5395814716915,-18.136893406448227,0.19990809123872155,-0.4516810573578667,-0.6515891485965882,-23649780,-34479770.2,60.03203700757007,31.380919775868655,NaN,NaN,-11.258984888198063,-16.147137131605305
2008-12-09T09:30:00-05:00,25.25999,25.46001,24.74001,24.99001,8474832,7399503.2,48.24063736393108,42.2927320353502,NaN,NaN,35.7301033281277,4.42847729943044,0.20092559124283538,-0.400432159543044,-0.6013577507858794,-32124612,-32366091.4,62.14309290681552,34.70341287123839,NaN,NaN,-10.081696992274193,-15.280645683129432
2008-12-10T09:30:00-05:00,25.21001,25.28999,24.75999,24.92,7121238,7224169,47.775922586918846,43.044278515143965,NaN,NaN,35.33209855936242,18.760164090797495,0.19204507820736827,-0.361301403026669,-0.5533464812340373,-39245850,-33728729,59.944898940632164,37.90249904558527,NaN,NaN,-9.24873558477349,-14.418944240507155
2008-12-11T09:30:00-05:00,24.72,25.63,24.72,25.07001,9031031,7463837.55,48.911563100045065,44.081940814926675,NaN,NaN,54.23790103316901,36.71461688888132,0.19102966633594776,-0.3145593983141026,-0.5055890646500504,-30214819,-31607540.8,62.187207699739666,41.4029994077785,NaN,NaN,-8.241282975173952,-13.536421202602412
2008-12-12T09:30:00-05:00,24.73,25.19,24.45,25.12,6547762,7411243.4,49.307170351716266,45.131015588237254,NaN,NaN,37.10561768261968,45.58906041499406,0.18817873908405514,-0.2703656407949815,-0.4585443798790366,-23667057,-29780423.6,64.05385305408663,45.08735478049029,NaN,NaN,-7.294736163412918,-12.644751911289628
2008-12-15T09:30:00-05:00,25.53,25.53,24.83,25.07001,4292473,7326022.15,48.89938678054927,45.88396650292176,NaN,NaN,75.40142738073503,47.56142959680277,0.1775174092294976,-0.23664761834216463,-0.41416502757166224,-27959530,-30642373.6,62.48670143532235,48.593644692943876,NaN,NaN,-6.596640382990533,-11.780735978675471
2008-12-16T09:30:00-05:00,25.39,26.17999,25.14,26.06,7632027,7400052,56.56117387890843,47.09379476079838,NaN,NaN,153.55238382253046,71.12588569568331,0.2284840507975981,-0.12855996407466463,-0.3570440148722627,-20327503,-28282951.8,65.01026694314359,52.20214286815622,NaN,NaN,-3.770255934936548,-10.636381686712769
2008-12-17T09:30:00-05:00,25.74001,26.2028,25.64,25.89999,9335199,7570405.5,55.122591953331224,47.98570792904847,NaN,NaN,151.954060434941,94.45027807079903,0.241495080592177,-0.05517516413204149,-0.2966702447242185,-29662702,-26366322.2,66.95496775636286,55.401937970644994,NaN,NaN,-1.783273667353807,-9.371651969661489
2008-12-18T09:30:00-05:00,25.94,26.50999,25.78,26.09,6011848,7521109.6,56.536291064684406,48.801244984012705,NaN,NaN,150.6582915132421,113.73435616681363,0.25182125111932413,0.018106319174936658,-0.23371493194438747,-23650854,-25053529.2,68.25636985206371,57.82863005233859,NaN,NaN,0.291593637355092,-7.991188311516263
2008-12-19T09:30:00-05:00,26.25999,26.48,25.94099,26.09,8949445,7329502.95,56.536291064684406,50.12326366469211,NaN,NaN,142.71983869938862,134.85720037016742,0.24722334307829788,0.07531424690348487,-0.171909096174813,-23650854,-25050288.6,68.25969285179046,59.89676639146039,NaN,NaN,2.0252260640821254,-6.560271972145065
2008-12-22T09:30:00-05:00,26.2,26.21001,25.5,25.91,5075828,7107875.4,54.64505601195986,50.97981041246955,NaN,NaN,102.15749926039719,140.20841474609986,0.2214616901611817,0.1049180165266641,-0.11654367363451759,-28726682,-25203719,67.8972856654604,61.585720581061636,NaN,NaN,3.050181257548843,-5.187350082188793
2008-12-23T09:30:00-05:00,26.03,26.32001,25.75,25.92,3210162,6954187,54.73564735252188,51.552004036925915,NaN,NaN,104.01318467740775,130.30057491707532,0.1954060805170233,0.12771392701176154,-0.06769215350526175,-25516520,-26241522.4,65.36918761253999,62.698926714394986,NaN,NaN,3.9429706440385757,-3.883018549870598
2008-12-24T09:30:00-05:00,25.84,25.95,25.72,25.83,876877,6689800,53.69612885615419,52.24466965826997,NaN,NaN,75.76534288714478,115.06283140751609,0.1637049662377868,0.13693905429197173,-0.026765911945815055,-26393397,-25587661.4,66.22253062907691,63.777863325636254,NaN,NaN,4.466214551407244,-2.690270963973763
2008-12-26T09:30:00-05:00,25.91,25.99001,25.74001,25.85001,1040404,6411385.45,53.905732170646694,52.55279164569499,NaN,NaN,70.07507503598471,98.94618811206462,0.13677464828342567,0.14420239840846705,0.00742775012504137,-25352993,-25928089.2,65.32006261400363,64.58129678347196,NaN,NaN,4.966982131391102,-1.5963776646359251
2008-12-29T09:30:00-05:00,25.92,25.96001,25.42,25.81,1559310,6409599.75,53.385365809356244,52.7327827389577,NaN,NaN,49.82464419983343,80.36714921215358,0.11010423153478088,0.14505803954351748,0.03495380800873659,-26912303,-26580379,63.53345663558937,64.83139818547333,NaN,NaN,5.282668969852872,-0.6136567168518112
2008-12-30T09:30:00-05:00,25.92,26.39,25.89999,26.31,2865698,6264299.7,58.74502013801849,53.48309579424966,NaN,NaN,95.69475478426088,79.07460031692631,0.11920604996620661,0.18396137046649486,0.06475532050028825,-24046605,-25644363.6,65.0123081600776,65.0363421321349,NaN,NaN,6.925111059887006,0.46331010839659115
2008-12-31T09:30:00-05:00,26.48,26.71001,26.3699,26.55,2382995,6011327.55,61.05944234466853,54.431918634088916,NaN,NaN,129.3373252481042,84.13942843106558,0.13338779272955123,0.23149006141222728,0.09810226868267605,-21663610,-24873781.6,66.22660602150361,65.48503549505429,NaN,NaN,8.983574752568753,1.680490771849757
2009-01-02T09:30:00-05:00,26.56,27.23,26.39,27.09,3589070,5677763.85,65.71939862084992,55.63247831414641,NaN,NaN,161.42207601468286,101.2707750565732,0.16885138464387592,0.30916649948752095,0.14031511484364503,-18074540,-23210010.2,68.74857231355372,65.95370439604102,NaN,NaN,12.204536646188398,3.1839258967552775
2009-01-05T09:30:00-05:00,27.12,27.12,26.66,26.96001,3880603,5452389.1,63.74194699900033,56.663533788952414,NaN,NaN,155.4250502291195,118.34077009520016,0.17265292417721978,0.35613127006516976,0.18347834588794998,-21955143,-22530440.2,69.74242921217706,66.36003126447605,NaN,NaN,14.414984962257396,4.788362906112723
2009-01-06T09:30:00-05:00,27.00999,27.08,26.3,26.52,5732078,5338087.15,57.44144793126604,57.273681014003614,NaN,NaN,110.4514658791758,130.4661344310686,0.13623175661492323,0.353768041656604,0.2175362850416808,-27687221,-22685423.8,69.20191349493459,66.83968926873408,NaN,NaN,14.633977788317404,6.194879317856249
2009-01-07T09:30:00-05:00,26.07001,26.5,26.07001,26.28,3947269,5077807.45,54.28936409575504,57.11140888663551,NaN,NaN,54.51258310091623,122.22970009439969,0.08896270448514165,0.32873966564810786,0.2397769611629662,-31634490,-24203000.8,63.973598870560394,66.76564154926385,NaN,NaN,13.922051730811125,7.298761091135517
2009-01-08T09:30:00-05:00,26.14999,26.42999,25.99001,26.42999,5521645,4930148.1,55.91744103585538,57.16818382110152,NaN,NaN,48.29373504862558,106.02098205450397,0.06205781700138069,0.31734923241469204,0.25529141541331135,-26112845,-25092847.8,61.060512609109345,66.34460903874574,NaN,NaN,13.764262684261553,8.222404175867808
2009-01-09T09:30:00-05:00,26.44,26.5,26,26.14999,3906385,4769405.45,52.18106152915405,56.85709599713506,NaN,NaN,31.85186837530118,80.10694052662764,0.02174479247552419,0.2824724060077166,0.2607276135321924,-30019230,-27481785.8,53.956979434778155,65.32322400893963,NaN,NaN,12.563403854948053,8.842546987164987
2009-01-12T09:30:00-05:00,26.24001,26.25,25.681,25.81,4811668,4558437.3,47.988018616453665,56.24650510797573,NaN,NaN,-27.214686810713467,43.578993118661046,-0.02873689966276849,0.2248064889537318,0.2535433886165003,-34830898,-30056936.8,47.53707025751895,63.84303668077738,NaN,NaN,10.27793547767704,9.047602485809566
2009-01-13T09:30:00-05:00,25.81,26.17999,25.74001,26.03,5286113,4495354.85,50.746046869880765,55.96800445497008,NaN,NaN,-28.327957256669812,15.823108491491922,-0.04714303117331503,0.1946145996498565,0.24175763082317153,-29544785,-30428449.6,46.674261636517976,62.32710639299578,NaN,NaN,9.100508181551286,9.055160442344098
2009-01-14T09:30:00-05:00,25.60001,25.87,25.41499,25.66,3907528,4476107.6,46.29938355305189,55.36541418357937,NaN,NaN,-114.12184315908635,-17.903776760508574,-0.0820249160091168,0.13922648581177555,0.22125140182089234,-33452313,-30792014.2,45.79822315440043,60.92918036027152,NaN,NaN,6.735388409049804,8.72376443758777
2009-01-15T09:30:00-05:00,25.72,25.92999,25.14,25.84,7710770,4480044.75,48.65645811351375,55.00543770196219,NaN,NaN,-112.25987210136564,-50.01449819050682,-0.09011825132289081,0.10860358766727884,0.19872183899016965,-25741543,-30717753.8,46.021082206423316,59.48621975865341,NaN,NaN,5.415559403992099,8.251163718502674
2009-01-16T09:30:00-05:00,26.13,26.28,25.72,26.06,4456586,4236114.1,51.4607423981048,54.83079557535205,NaN,NaN,-27.220892889043505,-61.82905044337575,-0.07823867248943867,0.10092349837837133,0.17916217086781,-21284957,-28970899.2,51.1131371468613,58.47143936814325,NaN,NaN,5.0900280310567805,7.799572906010404
2009-01-20T09:30:00-05:00,26.00999,26.31,25.41,25.42999,8966914,4383867.4,44.04225729904091,54.16343068175809,NaN,NaN,-86.70556784031434,-73.72722664929593,-0.10853053582166691,0.04349900109072635,0.15202953691239326,-30251871,-28055093.8,53.585183829404215,57.76084845341574,NaN,NaN,2.4573589960214064,7.03639949029769
2009-01-21T09:30:00-05:00,25.77,26.06,25.28,25.97,6294301,4251110.2,50.6140203620688,53.58264498347597,NaN,NaN,-68.46520343521512,-81.75467588500499,-0.08875138651138376,0.04109030377316358,0.12984169028454734,-23957570,-26937650.8,56.47712177512384,57.1511922830619,NaN,NaN,2.2652046879788,6.354800232823563
2009-01-22T09:30:00-05:00,25.82001,26.22,25.60001,26.08,4778875,4236262.55,51.854397915781085,52.925141809984005,NaN,NaN,-28.71474651743122,-64.67325655667396,-0.06586550345964262,0.04750981095999407,0.11337531441963669,-19178695,-24082927.2,62.84597917005096,56.909718936529565,NaN,NaN,2.4961945344160146,5.80357084733677
2009-01-23T09:30:00-05:00,25.88,26.17999,25.61,26.08,4563258,4303917.35,51.854397915781085,51.93478461676481,NaN,NaN,-30.252666096092078,-48.271815355619246,-0.049101917907226886,0.05199791703560308,0.10109983494282997,-19178695,-22770357.6,65.35620253186303,56.66740680926595,NaN,NaN,2.680962100628142,5.357483883521252
2009-01-26T09:30:00-05:00,26.17,26.31,25.8,25.94,6880949,4604120.95,50.00073265571149,50.95326930652989,NaN,NaN,-20.030797578537364,-46.83379629351803,-0.045877004405210836,0.043753579436316414,0.08963058384152725,-26059644,-23725295,62.07049430296081,56.119411458607644,NaN,NaN,2.3073298271576586,4.921747589755024
2009-01-27T09:30:00-05:00,26.2,26.7,26.14999,26.48,5819156,4843058.55,56.46519909308819,50.88353724666005,NaN,NaN,64.02500462249606,-16.687681800955943,-0.007806349182400779,0.07987264736352628,0.08767899654592706,-20240488,-21723018.4,65.93732205171693,55.88622635552066,NaN,NaN,3.9340361937696766,4.780645961757117
2009-01-28T09:30:00-05:00,26.77,27.07001,26.61,26.89,8140520,5172119.05,60.62752897438203,51.33626330941912,NaN,NaN,132.65299266493426,23.535957419073934,0.04183071117380022,0.13996738551317733,0.09813667433937712,-12099968,-19351498,69.85700964587187,56.30646998232863,NaN,NaN,6.6602693831201165,5.049163593380403
2009-01-29T09:30:00-05:00,26.53999,26.82001,26.392,26.50999,3911086,5224388.45,55.34575178013609,51.29542836258202,NaN,NaN,68.36349734848372,42.95160619225692,0.045603380219044976,0.15514089961318334,0.10953751939413836,-16011054,-18717969.8,70.82292310079973,57.00378501744937,NaN,NaN,7.332460099458547,5.375348808534423
2009-01-30T09:30:00-05:00,26.57001,26.61,26.11,26.23,5236180,5367047.7,51.767278939151986,51.26587246329616,NaN,NaN,22.374897581006305,53.4771189276766,0.02671047119300987,0.1429256083854007,0.11621513719239082,-21247234,-19131677.6,69.26207788068035,58.09700633501381,NaN,NaN,6.771456777832249,5.574792804148398
2009-02-02T09:30:00-05:00,26,26.69,25.97,26.39999,5823066,5478747.5,53.72359311591008,51.67555635611448,NaN,NaN,38.043796565829126,65.0920377565499,0.02325740824516373,0.1452868974988455,0.12202948925368176,-15424168,-17004582.4,72.60506132336553,59.88757712543143,NaN,NaN,6.903542724542322,5.76461422134753
2009-02-03T09:30:00-05:00,26.55,27.28999,26.44099,27.08,6919063,5630670.5,60.6068524213412,52.37989960979022,NaN,NaN,161.78619403388416,84.64427563882751,0.06215803352764532,0.19972703116323842,0.1375689976355931,-8505105,-14657505.8,75.7402971687004,61.963722520587304,NaN,NaN,9.282946082450291,6.267233058647925
2009-02-04T09:30:00-05:00,27.33,27.48,26.83,26.96001,4998156,5593974.4,58.940888412957335,53.282864242640606,NaN,NaN,176.6078868678846,93.43525447941757,0.07437009322223997,0.23053161416339307,0.1561615209411531,-13503261,-14938164.4,74.64025640201925,64.02386775256008,NaN,NaN,10.669827721295762,6.896175153311901
2009-02-05T09:30:00-05:00,26.69,27.25,26.69,27.19,4569844,5625103.15,61.145508200375055,54.174939248844986,NaN,NaN,142.81451961950435,108.32545893362169,0.09137950219804997,0.27038589868871554,0.17900639649066558,-8933417,-13522637,76.4945359730466,66.2005430216046,NaN,NaN,12.503366377152034,7.697202471003349
2009-02-06T09:30:00-05:00,27.19,27.55,27.05,27.41,4571742,5577608,63.18200040722441,55.01217196378211,NaN,NaN,160.7083904252985,135.99215750248013,0.10965832460677932,0.3160793022491397,0.2064209776423604,-4361675,-10145525.2,80.21198071501561,68.27903184790134,NaN,NaN,14.654882298056847,8.691156732010992
2009-02-09T09:30:00-05:00,27.42,27.44,27.04089,27.33,3548968,5559737.15,61.91124190274947,56.288528006904144,NaN,NaN,128.26918095456134,154.03723438022658,0.10837935203897692,0.3418951676910815,0.2335158156521046,-7910643,-8642820.2,81.60598827211649,70.28051787952363,NaN,NaN,16.048751893916986,9.74224175514042
2009-02-10T09:30:00-05:00,27.17,27.22,26.36,26.42,6174094,5627858.45,49.67283951209897,56.22130080333488,NaN,NaN,39.82227722375465,129.64445101820067,0.041693298897891445,0.2856324392744689,0.24393914037657746,-14084737,-9758746.6,77.25359618302522,71.7645517658023,NaN,NaN,13.350628825410467,10.257725622321855
2009-02-11T09:30:00-05:00,26.5,26.78999,26.49001,26.75,4152551,5571180.35,53.27961304934491,56.32310188430372,NaN,NaN,36.77845461368143,101.67856456736004,0.01654602357035745,0.2646216698395243,0.24807564626916684,-9932186,-9044531.6,78.06012202972626,72.85127625577911,NaN,NaN,12.284323016719362,10.547239535807213
2009-02-12T09:30:00-05:00,26.46001,27.06,26.285,27.06,6363500,5693978.95,56.43794140235885,56.650497847630696,NaN,NaN,48.46504199220605,82.8086690419004,0.017438646152084902,0.26987395395927294,0.25243530780718804,-3568686,-7971585.4,79.25040140091227,73.84371903213977,NaN,NaN,12.416154607303863,10.814227403163878
2009-02-13T09:30:00-05:00,27.07001,27.07001,26.64999,26.64999,4067587,5511819.8,51.48098463251995,56.75623013168845,NaN,NaN,41.13485983438153,58.893962923717005,-0.011383322811453045,0.23820615429287173,0.24958947710432478,-7636273,-8626505,76.52146933145642,74.87593153417517,NaN,NaN,10.909895496835013,10.827894273688326
2009-02-17T09:30:00-05:00,26.44,26.56,26.05,26.19,5869371,5582459.05,46.54210323771614,56.04743757059044,NaN,NaN,-45.115545055126155,24.217017721779502,-0.06048258879145471,0.17398624111500638,0.2344688299064611,-13505644,-9745505.2,71.96193049172771,75.30626070846165,NaN,NaN,7.98843979701655,10.422257919878072
2009-02-18T09:30:00-05:00,26.22,26.33141,25.98,26.17999,5876027,5427914.7,46.43769787552228,55.03387820638618,NaN,NaN,-69.81101820193473,2.2903586366416264,-0.09086288263059686,0.12089022661821502,0.21175310924881188,-19381671,-10804892,67.84060954076887,75.16223212952572,NaN,NaN,5.669048052443046,9.743227938815926
2009-02-19T09:30:00-05:00,26.49001,26.5,26.12,26.13,3896719,5308035.6,45.88412727453373,54.358047884557436,NaN,NaN,-63.087982249944346,-17.68292873608352,-0.11026223748474229,0.07392531239288402,0.1841875498776263,-23278390,-13474132.8,58.716114841628325,74.29746011101348,NaN,NaN,3.631866300002818,8.870176276128339
2009-02-20T09:30:00-05:00,25.69,26.13,25.66,25.86,6713184,5404751.05,42.9089327930843,53.72530887412403,NaN,NaN,-129.07947220674518,-53.19183157587378,-0.13555122055539828,0.014748524183378464,0.15029974473877675,-29991574,-18758710.4,45.63079539547776,72.60951136207044,NaN,NaN,1.0069294059498786,7.746855294674273
2009-02-23T09:30:00-05:00,25.78999,26.07001,25.22,25.35001,8094039,5581290.1,37.908861412352195,52.595685181012755,NaN,NaN,-176.7836023721561,-96.77552401718131,-0.17821267069924068,-0.07246609363527412,0.10574657706396656,-38085613,-24848578.4,35.7447684602069,69.97663330041625,NaN,NaN,-2.8996752244973423,6.225922363364042
2009-02-24T09:30:00-05:00,25.50999,25.798,25.32001,25.72,4740883,5474286.8,43.09005332576568,51.34448524561451,NaN,NaN,-152.9504396948555,-118.34250294512717,-0.1729620124011904,-0.11045593843752144,0.06250607396366896,-33344730,-28816395.6,31.02798647061202,66.78289682198137,NaN,NaN,-4.6516987434770645,4.671976490958169
2009-02-25T09:30:00-05:00,25.61,25.63,25.08031,25.2,7642676,5565462.8,38.258112214504195,49.867144088582144,NaN,NaN,-168.37187492246147,-138.05467428923254,-0.1943590881360372,-0.18044278620637755,0.013916301929659654,-40987406,-33137542.6,26.86958560716512,63.37070605092037,NaN,NaN,-7.747886821172568,2.8977103035109213
2009-02-26T09:30:00-05:00,25.5,25.5,23.92999,23.94,7676332,5542253.4,29.597454919190554,47.613711711354675,NaN,NaN,-230.85948329992377,-171.6089744992284,-0.2781188647917003,-0.3337322790599657,-0.05561341426826542,-48663738,-38214612.2,22.973728625803375,59.547791240402994,NaN,NaN,-13.972492149478862,0.4876813816552379
2009-02-27T09:30:00-05:00,23.52,23.83,22.92999,22.98,9912645,5842331.35,24.961102393033173,44.88364756748388,NaN,NaN,-273.85481558971844,-200.56404317582306,-0.37679636002366956,-0.5266088642978524,-0.1498125042741828,-58576383,-43931574,19.53840268057543,55.21396423794298,NaN,NaN,-21.107180900022886,-2.59729894429878
2009-03-02T09:30:00-05:00,23.66,23.66,21.97,21.99001,11638723,6162458.5,21.262187896738197,41.980143709911644,NaN,NaN,-243.81305744373807,-213.96993419013944,-0.48070625151346846,-0.7506953186660184,-0.2699890671525499,-70215106,-50357472.6,16.543882986957016,50.56667100328873,NaN,NaN,-28.52433492740968,-6.301161227600336
2009-03-03T09:30:00-05:00,22.19,22.48,21.77499,21.94,7500922,6246351.3,21.092151403065216,39.9386659878378,NaN,NaN,-210.68207239488657,-225.5162607301457,-0.521365624975065,-0.9216960983713811,-0.4003304733963161,-77716028,-59231732.2,13.472872717617975,46.010905041473926,NaN,NaN,-33.98389010434704,-10.255836781421294
2009-03-04T09:30:00-05:00,22.75999,22.83,22.00999,22.57001,5911156,6195955.95,28.815327737396842,38.19121703698437,NaN,NaN,-154.54791623409292,-222.75146899247193,-0.47566378208942706,-0.9949102010080999,-0.5192464189186728,-71804872,-65395225.4,11.83031844087165,41.28020478512717,NaN,NaN,-35.65134787659512,-13.883766937874697
2009-03-05T09:30:00-05:00,22.45,22.69,21.7,21.97,6274109,6259753.6,26.186572585599336,36.030404978644405,NaN,NaN,-141.7413324926018,-204.92783883100756,-0.4556410368876471,-1.0887977150282317,-0.6331566781405846,-78078981,-71278274,10.512850086669005,36.370379691252644,NaN,NaN,-37.93948052769093,-17.32029745070559
2009-03-06T09:30:00-05:00,22.00999,22.28999,21.63,22.28999,8982488,6480385.8,29.861474935680477,34.48615428601302,NaN,NaN,-120.9787045577346,-174.35261662461076,-0.3930123292147858,-1.1244220896590669,-0.7314097604442811,-69096493,-73382296,10.08047823049489,31.62459461261253,NaN,NaN,-38.480522240292366,-20.343186706360843
2009-03-09T09:30:00-04:00,22.00999,22.32001,21.7,21.88,7060129,6604805.15,27.94197098543586,33.15757341085014,NaN,NaN,-108.05813461107623,-147.2016320580784,-0.3526519936620687,-1.172224752521867,-0.8195727588597983,-76156622,-74570599.2,9.834470032083416,27.186918865495077,NaN,NaN,-39.553012538143165,-23.087447539472603
2009-03-10T09:30:00-04:00,22.06,22.71001,22.05,22.67,7928691,6823791.3,36.42244431920541,32.44219815682751,NaN,NaN,-78.76639941177007,-120.81849746145508,-0.2509804741938899,-1.1332983516021606,-0.8823178774082707,-68227931,-72672979.8,13.466257773529648,23.303036596406564,NaN,NaN,-37.545704294811856,-25.15291279023535
2009-03-11T09:30:00-04:00,22.92,23.02991,22.23,22.25999,10766484,7053410.8,34.17446903976092,31.60579399720088,NaN,NaN,-69.50046330941129,-103.80900687651874,-0.19221988098627363,-1.1225927286411128,-0.9303728476548392,-78994415,-74110888.4,13.037720656740944,20.040294154628896,NaN,NaN,-36.66400793026344,-26.797354953096505
2009-03-12T09:30:00-04:00,22.14999,23.42,22.14999,23.35001,8992020,7295384.25,44.05941206201431,31.687971087838736,NaN,NaN,-46.27259943233841,-84.71526026446607,-0.0672688341819464,-1.0144588903822722,-0.9471900562003258,-70002395,-72495571.2,16.261590124356218,17.942493778120216,NaN,NaN,-32.357102179884635,-27.591604556923382
2009-03-13T09:30:00-04:00,23.55,24.28,23.47501,24.13,11528773,7553647.9,49.861572817573894,32.54173618821171,NaN,NaN,-2.9979372042137378,-61.1191067937619,0.07298689523611768,-0.8559564371551787,-0.9289433323912963,-58473622,-70370997,20.439351389620626,16.84924970164977,NaN,NaN,-26.700415759922947,-27.464291871637606
2009-03-16T09:30:00-04:00,24.35001,24.4599,23.87,23.87,6934746,7697005.85,48.07170383238684,32.89756836725608,NaN,NaN,7.763765611311627,-37.95472674928433,0.14894678202609357,-0.7427598548586793,-0.8917066368847729,-65408368,-68221346.2,24.54146760732364,16.385926925700602,NaN,NaN,-22.88368193365059,-26.809919023353746
2009-03-17T09:30:00-04:00,23.82001,24.28999,23.69,24.24001,4510711,7629072.85,50.77955979549889,33.791957480184266,NaN,NaN,14.16864900387163,-19.367717066155993,0.22049162402764988,-0.6160921068502105,-0.8365837308778604,-60897657,-66755291.4,27.294698878607278,16.416292159375043,NaN,NaN,-18.911361051687674,-25.68155359883002
2009-03-18T09:30:00-04:00,24.02,24.74001,24.02,24.28,6840172,7677280.1,51.07649499005127,35.32617462810288,NaN,NaN,34.56818295859973,1.4460121874462046,0.263955052224351,-0.5066399155974217,-0.7705949678217727,-54057485,-61767905.4,35.86745162025852,17.3372723732647,NaN,NaN,-15.696176125179084,-24.255071102594172
2009-03-19T09:30:00-04:00,24.57001,24.57001,23.47,23.69,9299664,7947427.35,46.608932560456765,36.87244821149029,NaN,NaN,19.372761967370543,14.575084467387995,0.24673307256445354,-0.46217862711620583,-0.7089116996806594,-63357149,-60438856.2,37.966550570444916,18.65356865111252,NaN,NaN,-14.297915310308642,-22.83262027512481
2009-03-20T09:30:00-04:00,23.66,23.89999,23.46001,23.55,4831648,7853350.55,45.58992104830983,38.61014343660254,NaN,NaN,11.01575448697609,17.377822805625957,0.22053305370010645,-0.43324538255552625,-0.6537784362556327,-68188797,-62381891.2,36.10593252444814,20.05085790379045,NaN,NaN,-13.464304669629213,-21.494289474339723
2009-03-23T09:30:00-04:00,23.98,24.5,23.74001,24.41,5069859,7702141.55,52.46501163011455,40.851062024248925,NaN,NaN,56.79542462134648,27.184154607632923,0.2533942464573167,-0.3370356281839868,-0.5904298746413035,-63118938,-61924005.2,36.890824731205846,21.723568761903874,NaN,NaN,-10.560725949341727,-19.93235182791144
2009-03-24T09:30:00-04:00,24.25,24.505,23.98,24.09,6040758,7767135.3,49.936564152600965,42.359721768192074,NaN,NaN,64.81091754276915,37.31260831541242,0.24566884437932246,-0.28334381916715046,-0.5290126635464729,-69159696,-63576413,35.20986098875338,23.39353608675257,NaN,NaN,-8.929844566864158,-18.360565076333256
2009-03-25T09:30:00-04:00,24.09,24.53,23.82001,24.25,4271676,7598585.3,51.202854420972955,44.146599042147336,NaN,NaN,74.20593396230466,45.240158516153414,0.24298207893661344,-0.2252850648757061,-0.46826714381231954,-64888020,-65742520,33.081835008536714,25.00560643831455,NaN,NaN,-7.2251621230516,-16.769793225864447
2009-03-26T09:30:00-04:00,24.46001,24.62,24.14,24.52,6769734,7553255.4,53.34731338955682,45.82415893170993,NaN,NaN,92.67192473672459,59.89999107002423,0.25006041571829496,-0.15569162416445081,-0.4057520398827458,-58118286,-64694747.4,35.12435410069048,26.79445471475709,NaN,NaN,-5.172996935949107,-15.113108041590827
2009-03-27T09:30:00-04:00,24.41,24.61501,24.25999,24.25999,4769723,7296109.3,51.02194736144157,47.472728672853194,NaN,NaN,79.61110979501498,73.61906213163199,0.22849433301281874,-0.12013412361672238,-0.3486284566295411,-62888009,-63634589.8,37.21260484367136,28.75003577272766,NaN,NaN,-4.094453419612081,-13.539014524165292
2009-03-30T09:30:00-04:00,24.00999,24.22,23.81,24.12,5020230,6965184.65,49.76421686868152,48.425712426387214,NaN,NaN,50.007248950686254,72.26142699749995,0.19724362400590972,-0.10207392662215398,-0.2993175506280637,-67908239,-64592450,36.08251207446028,30.36548250850842,NaN,NaN,-3.5378612436999544,-12.110278341241672
2009-03-31T09:30:00-04:00,24.44,24.67999,24.2,24.21001,8359160,7008096.55,50.60730259305185,49.599486251622274,NaN,NaN,69.7477350223743,73.24879049342096,0.17578949722180776,-0.07958067910080402,-0.2553701763226118,-59549079,-62670326.6,40.01893726285148,32.29271226608775,NaN,NaN,-2.8472765572716976,-10.786992372103105
2009-04-01T09:30:00-04:00,23.92,24.33749,23.64,24.2,6837195,7054398.5,50.505788179314465,50.05994168857228,NaN,NaN,40.92290768965065,66.59218523889015,0.15481663660314174,-0.06184938056868461,-0.21666601717182635,-66386274,-62969977.4,39.6093943966339,33.96041257125044,NaN,NaN,-2.295123094518542,-9.573868189591025
2009-04-02T09:30:00-04:00,24.7,24.7,24.21001,24.3,10706488,7276017.45,51.5513431441459,50.18063956904171,NaN,NaN,69.08528785338962,61.874857862223166,0.1419125790685155,-0.03927529333618196,-0.18118787240469747,-55679786,-62482277.4,40.67354768175923,35.405712306403196,NaN,NaN,-1.5591720327085925,-8.428911595750677
2009-04-03T09:30:00-04:00,24.5,24.53999,23.75,23.89999,6395641,7146675.1,47.25140040506864,50.122046467090414,NaN,NaN,30.234845039272688,51.99960491107471,0.10250942544804936,-0.05305109059463575,-0.15556051604268512,-62075427,-62319761,41.046346605828845,36.584632234867854,NaN,NaN,-2.0096901786965553,-7.5118799647429455
2009-04-06T09:30:00-04:00,23.7,24.28,23.7,24.13,4378367,7012587,49.842131356887414,50.05508729290388,NaN,NaN,19.537992874347065,45.90575369580687,0.08853549503947256,-0.04489114724334442,-0.13342664228281698,-57697060,-60277525.2,45.666803300615605,37.896925407868444,NaN,NaN,-1.731359920790169,-6.686091387035406
2009-04-07T09:30:00-04:00,23.86,24.13,23.64999,23.86,8460539,7039179.4,46.928404113949185,49.758795087468016,NaN,NaN,-23.395753069113084,27.277056077509393,0.05912138522947981,-0.05952491074596722,-0.11864629597544703,-66157599,-61599229.2,43.30148302911719,38.42792765135835,NaN,NaN,-2.2590769272517366,-6.053660749923453
2009-04-08T09:30:00-04:00,24.03,24.17,23.86,24.02,3328708,6667290.6,48.8371491764705,49.917953417183284,NaN,NaN,-15.044369264624214,16.083600686654428,0.04887845218304264,-0.057548230746643725,-0.10642668292968636,-62828891,-60887752.6,44.95429659131056,38.92705236713447,NaN,NaN,-2.2177526212481093,-5.505673874398404
2009-04-09T09:30:00-04:00,24.49001,24.49001,24.07001,24.13,3903719,6412875.55,50.16419120090118,50.24468699951124,NaN,NaN,42.809998067461414,10.828542729468774,0.047886305730025475,-0.04656880076715453,-0.09445510649718,-58925172,-61536829.8,43.7026538219195,39.469675316953854,NaN,NaN,-1.8419914144539424,-4.98229066583491
2009-04-13T09:30:00-04:00,24.10001,24.44,24.10001,24.32001,4172676,6045070.7,52.45809387120374,50.244192873874745,NaN,NaN,59.422587249343344,16.666091171482908,0.05774129175764606,-0.022278491800122424,-0.08001978355776848,-54752496,-60072243.6,47.27019212210311,40.211058702017944,NaN,NaN,-0.9213706600940244,-4.402159236443355
2009-04-14T09:30:00-04:00,24.45,24.48,24.17999,24.21001,2811958,5838931.3,50.994705909375185,50.31977442793004,NaN,NaN,55.34301088578267,23.827094773770032,0.05460089422237677,-0.011768665779797516,-0.06636956000217428,-57564454,-60045722.4,47.335274507522065,41.077159667644274,NaN,NaN,-0.4981861454773658,-3.844448794876785
2009-04-15T09:30:00-04:00,24.2,24.45,24,24.35001,3259798,5776385.65,52.79944374348696,50.433816522395325,NaN,NaN,42.07587292279645,36.92141997215193,0.059309836332222664,0.007767735413104049,-0.051542100919118615,-54304656,-57675133.8,52.92793238330041,42.49473805155598,NaN,NaN,0.3283740244048545,-3.248331249265122
2009-04-16T09:30:00-04:00,24.38,24.63,24.16,24.46001,3834030,5626078.55,54.225842066643054,50.49656857075863,NaN,NaN,99.62886010345547,59.85606584576787,0.06664203290941428,0.03176044021764923,-0.034881592691765044,-50470626,-55203480.8,57.94275152829216,44.12462358209895,NaN,NaN,1.4061719700870803,-2.5834022179290934
2009-04-17T09:30:00-04:00,24.5,24.85001,24.46001,24.74001,4678699,5395030.3,57.72770809576256,50.97555148035298,NaN,NaN,186.68087658195117,88.63024154866582,0.08593118088110188,0.07253238340961232,-0.013398797471489567,-45791927,-52576831.8,62.513301103829015,45.93181617211021,NaN,NaN,3.296231024010264,-1.7434546119377567
2009-04-20T09:30:00-04:00,24.34,24.73,24.14999,24.25999,7361203,5521508.05,50.58321274625795,51.03405118589415,NaN,NaN,62.37035279853301,89.21979465850376,0.06300498993371753,0.06535743994565735,0.002352450011939816,-53153130,-52256958.6,63.04006890085694,47.85735594542426,NaN,NaN,3.069724885205704,-1.0558575409172626
2009-04-21T09:30:00-04:00,24.12,24.37,23.86,24.03,6848867,5610458.45,47.546918069541846,50.815452291357715,NaN,NaN,-64.39442463271173,65.27230755480488,0.030633600579748354,0.04064445073662526,0.010010850156876906,-60001997,-52744467.2,61.61890199909399,49.40021056944158,NaN,NaN,2.0120019085526537,-0.6175919052787031
2009-04-22T09:30:00-04:00,23.64,24.00999,23.64,23.77,5203176,5568579.35,44.30891190137381,50.37281827150481,NaN,NaN,-156.30975166208526,25.595182637828533,-0.007945882693879849,0.00007849678952709382,0.008024379483406943,-65205173,-54924570.6,55.58415700676674,50.541265041593924,NaN,NaN,0.1573282837418504,-0.5068890211329098
2009-04-23T09:30:00-04:00,23.8,23.81,23.28999,23.78999,3337294,5521860.25,44.621176788440714,49.87780638895445,NaN,NaN,-180.46999568818887,-30.424588520500333,-0.030507660736550507,-0.03011019643728119,0.0003974642992693161,-61867879,-57204021.2,50.0633490251933,51.2119651375535,NaN,NaN,-1.2898962910789171,-0.6187472025537679
2009-04-24T09:30:00-04:00,23.72,23.97501,23.64999,23.75999,3625482,5364647.65,44.22044508500305,49.66130958037833,NaN,NaN,-112.65320871010904,-90.29140557891238,-0.04496783765276617,-0.0558123327666884,-0.010844495113922228,-65493361,-61144308,42.25116235013086,51.29802340500364,NaN,NaN,-2.6108230512054034,-0.9033294666468588
2009-04-27T09:30:00-04:00,24.00999,24.19,23.87,24.02,4275824,5339952.7,48.534469664069924,49.56790517374851,NaN,NaN,-35.97582103255169,-109.9606403451293,-0.03498181008693256,-0.05457175772258793,-0.019589947635655372,-61217537,-62757189.4,39.5318497624598,50.85981243799252,NaN,NaN,-2.638182073806006,-1.1511655533838798
2009-04-28T09:30:00-04:00,24.05,24.36,23.95,24.11,3778006,5277841.5,49.97664327018958,49.7856365420514,NaN,NaN,-0.997602201612887,-97.28127585890954,-0.0209667696239192,-0.045798409665554374,-0.024831640041635173,-57439531,-62244696.2,40.834886120572186,50.68362694452502,NaN,NaN,-2.2792349318204375,-1.3123183217319594
2009-04-29T09:30:00-04:00,24.12,24.40199,23.95,24.2,6880750,5203921,51.4420104861816,49.971698064173616,NaN,NaN,17.155785039355077,-62.58816851862148,-0.005113326002621495,-0.031223297544912043,-0.02610997154229055,-50558781,-59315417.8,47.76370827522565,50.884299207661805,NaN,NaN,-1.5873384884304107,-1.3516069169745952
2009-04-30T09:30:00-04:00,24.2,24.52,24.005,24.17999,6005941,5162358.3,51.08371169100809,50.03737809918125,NaN,NaN,31.545674176424995,-20.18503454569871,0.004052402498999536,-0.02104446841854113,-0.025096870917540665,-56564722,-58254786.4,50.04490135179789,51.337316888367404,NaN,NaN,-1.090895479784914,-1.314362425947498
2009-05-01T09:30:00-04:00,24.14,24.24001,23.92,24.14,4935207,4873794.25,50.329250549344636,49.885317861905605,NaN,NaN,-10.060378982776092,0.33353139976787993,0.007261604924389355,-0.01601986476205397,-0.023281469686443325,-61499929,-57456100,51.753545419683206,51.657556409623126,NaN,NaN,-0.8497584899924735,-1.24799043509678
2009-05-04T09:30:00-04:00,24.17,24.63,24.17,24.53999,3308921,4719458.25,57.14668901845473,50.32474522683986,NaN,NaN,102.47636887345199,28.023969380968605,0.034631085568189175,0.020007387273793142,-0.014623698294396031,-58191008,-56850794.2,53.0638212814354,52.06673832204551,NaN,NaN,1.2390329570839147,-0.8927013790709666
2009-05-05T09:30:00-04:00,24.53999,24.83,24.48,24.82001,5663215,4783700.65,61.165208622266405,50.92229986103838,NaN,NaN,164.70157984358673,61.16380579000853,0.0679738707582822,0.07034364015345673,0.0023697693951745206,-52527793,-55868446.6,55.19068974326504,52.22836384775727,NaN,NaN,4.272994684502303,-0.1547447985604996
2009-05-06T09:30:00-04:00,25,25,24.45,24.67,6639723,4692659.85,58.025999951414924,51.19373970995066,NaN,NaN,146.16820500667575,86.96628978347266,0.07571428744717998,0.0970126287041495,0.02129834125696952,-59167516,-57590193.6,50.8421297410564,51.72117657724043,NaN,NaN,5.99927459879315,0.7244008296328789
2009-05-07T09:30:00-04:00,24.83,25.38,24.67,25.17,8924762,4972462.55,64.55574281876264,51.681456475879244,NaN,NaN,211.1911059057413,122.89537612933592,0.10831142160816938,0.15668761826718125,0.04837619665901187,-50242754,-56325800,53.72561626631218,51.09348480313208,NaN,NaN,9.66348676498682,2.0014131061120133
2009-05-08T09:30:00-04:00,25.52,25.67,25.28,25.59,5632898,5058921.5,68.92838127099944,52.99182565621792,NaN,NaN,243.2307986494389,173.55361165577892,0.1494271923446903,0.23516018708987474,0.08573299474518445,-44609856,-52947785.4,60.40753679139129,50.905446795313104,NaN,NaN,14.3579202733716,3.7666284157205254
2009-05-11T09:30:00-04:00,25.39,25.40199,25.13,25.14999,4615496,5081062.5,60.50669495166153,53.91752400494075,NaN,NaN,152.01340459099012,183.46101879928656,0.13850251895354238,0.2588611434371124,0.12035862448357004,-49225352,-51154654.2,63.426529495751694,51.03456304507437,NaN,NaN,15.604985241414651,5.457822247962543
2009-05-12T09:30:00-04:00,25.36,25.67,25.09,25.56,5275445,5204236.85,64.82002856727988,55.382603766791185,NaN,NaN,156.20178615771354,181.7610600621119,0.1494632081468624,0.30718763466714805,0.15772442652028565,-43949907,-49439077,66.0906387590745,51.78502602738207,NaN,NaN,18.151379175497098,7.271187523324622
2009-05-13T09:30:00-04:00,25.25999,25.821,25.25999,25.5,6741262,5378310.05,63.723225129825316,56.7470357911758,NaN,NaN,140.87633447474755,180.70268595572628,0.14323104412339382,0.33676323167452793,0.1935321875511341,-50691169,-47743807.6,68.53010229723961,53.10407983252823,NaN,NaN,19.78231327167132,9.058491201659864
2009-05-14T09:30:00-04:00,25.72,25.75,25.45,25.53,4524984,5412857.75,64.05076481538123,58.163487200488525,NaN,NaN,125.48211828157866,163.56088843089373,0.13196657034220954,0.358490400478896,0.22652383013668648,-46166185,-46928493.8,69.66055678521694,55.06189372074867,NaN,NaN,21.175954964234382,10.789557453456224
2009-05-15T09:30:00-04:00,25.60001,25.60001,25.17,25.33,5882648,5473055.2,60.15156397056934,58.99327965095277,NaN,NaN,88.99550258356147,132.71382921771826,0.10315960344022862,0.35547333443697227,0.25231373099674365,-52048833,-48416289.2,65.06727121746272,56.88585239610602,NaN,NaN,21.16963584715812,12.272425795413637
2009-05-18T09:30:00-04:00,25.41,25.58,25.13499,25.58,4691871,5339588.6,63.16977983417131,59.935646548380035,NaN,NaN,85.84910537413454,119.48096937434714,0.09335027762562575,0.36900157802877587,0.2756513004031501,-47356962,-48042611.2,65.67938279832313,58.66045930165966,NaN,NaN,22.075236262474256,13.67282729070801
2009-05-19T09:30:00-04:00,25.5,25.58,25.31,25.39,6561246,5325207.55,59.48233684728054,60.50995557417282,NaN,NaN,77.18927977834531,103.67846809847349,0.06766999002216573,0.3602387879308573,0.29256879790869156,-53918208,-50036271.4,59.671727733370254,59.511032120098555,NaN,NaN,21.720423532877124,14.82248389673217
2009-05-20T09:30:00-04:00,25.42,25.78999,25.42,25.49001,8416098,5485853.65,60.78010434906692,61.202555049748455,NaN,NaN,83.28324573821932,92.15985035116785,0.05174182124018051,0.3572460744589172,0.3055042532187367,-45502110,-48998459.6,61.63879975772123,60.339167720521644,NaN,NaN,21.80260235448269,15.819643676410815
2009-05-21T09:30:00-04:00,25.35001,25.49001,24.99001,25.25999,4996770,5568827.45,56.31260042184158,61.62993718349823,NaN,NaN,42.52179749894962,75.56778619464203,0.02158139886651822,0.33248100180188445,0.3108996029353662,-50498880,-49864998.6,59.048936020797775,60.86026704917269,NaN,NaN,20.54492184804859,16.494683415216212
2009-05-22T09:30:00-04:00,25.28,25.39999,25.065,25.28999,3655612,5570333.95,56.75901606865663,61.60224625851266,NaN,NaN,37.92679051711649,65.35404378135306,0.0006262154171071121,0.3116823722067501,0.311056156789643,-46843268,-48823885.6,61.16043805164401,61.4385968184733,NaN,NaN,19.6398945559144,16.94399929245881
2009-05-26T09:30:00-04:00,25.19,25.66,24.89,25.52,4412867,5577186.1,60.12344237776648,61.52783438390552,NaN,NaN,47.23785840249289,57.63179438702472,-0.0006980535979122515,0.3101835897922527,0.31088164339016494,-42430401,-47838573.4,63.099616888467125,62.00352018598773,NaN,NaN,19.80186439588844,17.3522657358059
2009-05-27T09:30:00-04:00,25.55,25.60001,25.22,25.25999,4591008,5617836.2,54.92127763702361,61.30606850430614,NaN,NaN,43.74230593304689,50.94239961796503,-0.02091896600803167,0.2847329358801254,0.30565190188815705,-47021409,-46459213.6,65.68273683433512,63.06356354979336,NaN,NaN,18.40438925818636,17.502569096145965
2009-05-28T09:30:00-04:00,25.21001,25.59,25.14,25.39,5719961,5559796.75,56.9280856565884,60.761235849865116,NaN,NaN,41.84462586913871,42.65467564414892,-0.02698607097019512,0.2719193131754132,0.2989053841456083,-41301448,-45619081.2,67.18928905809328,64.02525446349202,NaN,NaN,17.802698231756732,17.545444686947505
2009-05-29T09:30:00-04:00,25.36,25.84,25.28999,25.83,6549105,5586954.95,62.941041810217165,60.33356874552353,NaN,NaN,95.15658500196044,53.181633144751075,-0.004019451639970195,0.2938810695956455,0.2979005212356157,-34752343,-42469773.8,72.12875425243413,64.86248428213793,NaN,NaN,19.114129208604922,17.769542475755706
2009-06-01T09:30:00-04:00,26.02,26.10001,25.8,26,7528980,5716643.6,64.97549099380382,60.65276846281942,NaN,NaN,173.78792091856326,80.35385922504044,0.01871938737675627,0.3212997554565611,0.3025803680798048,-27223363,-38545792.8,76.81269227628475,65.81863876646172,NaN,NaN,20.83357847384321,18.207261904053922
2009-06-02T09:30:00-04:00,25.94,26.33,25.82001,26.16,6533383,5877866.7,66.82163013143251,60.79574000311603,NaN,NaN,208.67818712160133,112.64192496886213,0.039442608681864666,0.35188362893213565,0.312441020250271,-20689980,-34197708.6,80.68600533154117,66.86116495020933,NaN,NaN,22.83228016378543,18.86797879830128
2009-06-03T09:30:00-04:00,25.99001,26.14,25.88,26.10001,5920613,5890736.6,65.42909283712021,60.91758769649424,NaN,NaN,170.68193916071678,138.0298516143961,0.04368698880316335,0.3670497562542252,0.32336276745106185,-26610593,-30115545.4,83.47666613935571,67.92877665321762,NaN,NaN,24.06683671587758,19.610672786526465
2009-06-04T09:30:00-04:00,26.12,26.16,25.64,25.74001,20046496,6561075.25,57.66311430842482,60.46132694599735,NaN,NaN,102.52050284482593,150.16502700953353,0.018134744292806038,0.34603119781706937,0.32789645352426333,-46657089,-31186673.6,80.20208049423567,68.68174263243326,NaN,NaN,22.802100977325246,20.066591099497717
2009-06-05T09:30:00-04:00,25.56,25.99001,25.42999,25.78999,9662352,6597954.75,58.401329823130496,60.336310221180284,NaN,NaN,59.49138019030443,143.03198604720234,0.0013686766616253787,0.32960729935129507,0.3282386226896697,-36994737,-31635152.4,78.80812975292196,69.6632325278232,NaN,NaN,21.986267451426254,20.34083057834465
2009-06-08T09:30:00-04:00,25.66,25.7,25.24001,25.50999,6260063,6629313,52.8423760737704,59.59863852400879,NaN,NaN,-20.886105049537083,104.09718085358229,-0.030073152745895226,0.29064718175730064,0.32072033450319587,-43254800,-34841439.8,69.5070028795229,69.9366339621946,NaN,NaN,19.581886757858452,20.232410032560907
2009-06-09T09:30:00-04:00,25.64,25.64,25.31,25.38,5337605,6665418.45,50.441894853406865,58.95289266730352,NaN,NaN,-38.622474291277534,54.6370485710065,-0.059423402117806334,0.24644108185593794,0.30586448397374427,-48592405,-40421924.8,56.916171522093606,69.73980851853199,NaN,NaN,16.85263967944818,19.749585696401947
2009-06-10T09:30:00-04:00,25.62,25.66,25.10001,25.27,6176723,6710482.35,48.43669394558038,58.071220495625916,NaN,NaN,-68.84337710408704,6.731985318045742,-0.08451294801971154,0.20022329894910484,0.2847362469688164,-54769128,-46053631.8,47.55419641621215,68.73376542270992,NaN,NaN,13.978495052037623,18.925144175778474
2009-06-11T09:30:00-04:00,25.24001,25.78999,25.22,25.53999,6493238,6698081.15,53.33961085871498,57.85886409825973,NaN,NaN,-12.281686849440842,-16.228452620807605,-0.08117403589765271,0.1832687020967505,0.2644427379944032,-48275890,-46377392,47.07480699965124,67.87847049262801,NaN,NaN,12.884006926300035,18.062124568710125
2009-06-12T09:30:00-04:00,25.53999,25.88,25.39999,25.63,17595696,7351616.75,54.87993204810245,57.724643811077286,NaN,NaN,25.25145876867265,-23.076436905133956,-0.0714926394139262,0.17507693872699548,0.24656957814092167,-30680194,-45114483.4,49.22502482945965,67.02594097675771,NaN,NaN,12.419599624159583,17.256049576631476
2009-06-15T09:30:00-04:00,25.36,25.56,24.84,24.84,15870453,7851007,41.82854419484717,56.417865369440186,NaN,NaN,-140.05596396421421,-46.91040868806938,-0.11434064755755799,0.10364376869397418,0.21798441625153217,-46550647,-45773652.8,48.12599487404476,65.95639654715612,NaN,NaN,7.435751626990675,15.853149869539934
2009-06-16T09:30:00-04:00,24.88,25.3,24.86,24.94,6354410,7934133.95,43.65519121391372,55.613144910646625,NaN,NaN,-138.16004875342898,-66.81792358049968,-0.13080857920583344,0.05447369224424037,0.1852822714500738,-40196237,-44094419.2,51.12000652334657,64.91620152494265,NaN,NaN,4.096616233608119,14.173645064406816
2009-06-17T09:30:00-04:00,24.98,25.64999,24.98,25.50999,7463246,7979233.95,52.760627146256844,55.3154693027658,NaN,NaN,-39.42988237398582,-60.935224634479425,-0.09958691075533171,0.06079863300590915,0.16038554376124087,-32732991,-39687191.8,57.97558910383781,64.25808009963869,NaN,NaN,4.290922805620273,12.761827598865882
2009-06-18T09:30:00-04:00,25.56,26.16,25.49001,26,10436719,8080265,58.90845495009042,55.027427384185316,NaN,NaN,89.81231993457594,-40.516423277676076,-0.044988174353699645,0.10415032581911632,0.14913850017281596,-22296272,-34491268.2,64.32780240596125,63.700869253462045,NaN,NaN,6.706219225529981,11.896740688389324
2009-06-19T09:30:00-04:00,26.24001,26.39,25.97,26.08,10601793,8360516.15,59.827664193819686,54.65972546990073,NaN,NaN,135.58906616658598,-18.44890179809341,-0.004662643824029644,0.1433101953927789,0.14797283921680854,-11694479,-30694125.2,68.12023156081423,63.079979202357016,NaN,NaN,8.873208047444546,11.46480745396864
2009-06-22T09:30:00-04:00,25.89999,25.89999,25.53999,25.61,6224387,8488954.9,52.40997819244166,53.63032175997281,NaN,NaN,20.02345010199267,13.566981015147968,-0.010486301153386057,0.13486496277507598,0.14535126392846204,-17918866,-24967769,72.81415994044391,62.51770453156435,NaN,NaN,8.143875141876517,10.990388552241194
2009-06-23T09:30:00-04:00,25.78,25.78999,25.46001,25.53,6001527,8568387.9,51.245322795758725,52.617195328446996,NaN,NaN,-5.719133055620996,40.055164154709566,-0.020017300343722205,0.12032963849880929,0.1403469388425315,-23920393,-21712600.2,75.06198743220062,61.91665605248185,NaN,NaN,7.193483367076796,10.447973525789138
2009-06-24T09:30:00-04:00,25.71001,25.812,25.49001,25.66,4161465,8546910.75,53.07034792030949,52.289140586438755,NaN,NaN,6.643435606057825,49.269827750718285,-0.017925025984307064,0.11794065636214768,0.13586568234645474,-19758928,-19117787.6,76.71477780565438,61.66756300329746,NaN,NaN,7.003393909228888,9.955890723423387
2009-06-25T09:30:00-04:00,25.73,26.52,25.57001,26.37,8134480,8667636.7,61.53833717584951,52.5132125402044,NaN,NaN,127.14693682439805,56.736751128682705,0.02839791035094455,0.17136307028513542,0.14296515993419087,-11624448,-16983422.8,78.00601827834592,61.61026932654204,NaN,NaN,9.785127086556166,9.93149591815664
2009-06-26T09:30:00-04:00,26.39999,26.48,26.10001,26.37,4967680,8588565.45,61.53833717584951,53.13435261892433,NaN,NaN,142.52183627298163,58.12330514996184,0.054640177962083425,0.21126538238679515,0.15662520442471173,-11624448,-16969416.6,78.01463410194411,62.21795727100069,NaN,NaN,11.91362349404922,10.214657000427009
2009-06-29T09:30:00-04:00,26.32001,26.56,26.09,26.53,4266172,8425425.05,63.270462930166524,54.050678910121455,NaN,NaN,143.62866213249265,82.84434755606183,0.07700689860535456,0.25288382768140494,0.17587692907605038,-7358276,-14857298.6,79.32962808934164,63.81891845437555,NaN,NaN,14.196867562113166,10.78354422352503
2009-06-30T09:30:00-04:00,26.47,26.55,26.11,26.31,5413977,8369454.75,59.31494910785512,54.827697135998214,NaN,NaN,121.53488494384995,108.29515115595602,0.07134577448609042,0.2650591471836634,0.193713372697573,-12772253,-12627670.6,80.6456626403309,66.18259461324118,NaN,NaN,14.896349204960165,11.371087792301479
2009-07-01T09:30:00-04:00,26.46001,26.46001,26.24001,26.38,5536336,8350240.9,60.16822908070859,55.31545558042633,NaN,NaN,118.82361425399972,130.73118688554442,0.06675861679545111,0.2771616436918869,0.21040302689643578,-7235917,-10123068.4,82.02975191930521,68.67937639321646,NaN,NaN,15.716288667482345,11.991830774470174
2009-07-02T09:30:00-04:00,26.10001,26.25,25.75,25.75,4989840,7597408.1,50.00372411958856,54.96715501410391,NaN,NaN,31.3461414665841,111.57102781398162,0.018260545778225057,0.23322870911921711,0.21496816334099206,-12225757,-10243330.2,81.72752872589282,71.00098381439025,NaN,NaN,13.180507396415605,12.161641720462377
2009-07-06T09:30:00-04:00,25.59,25.98,25.53999,25.95,5551559,7391868.45,52.733616384545535,55.7460887419395,NaN,NaN,12.431028968807212,85.55286635314673,-0.002290644503253919,0.21210485771192467,0.21439550221517858,-6674198,-9253280.2,82.30550327971129,73.44237727193787,NaN,NaN,11.961719877374726,12.133081457164142
2009-07-07T09:30:00-04:00,26.00999,26.19,25.84,25.85001,7325520,7445141.3,51.22762216169866,56.286976666781285,NaN,NaN,34.32715629686391,63.69256518602098,-0.02338738413332292,0.18516127204852495,0.20854865618184787,-13999718,-10581568.6,78.70840362425037,75.41297706485956,NaN,NaN,10.515529624454164,11.90200262391986
2009-07-08T09:30:00-04:00,26.08,26.2601,25.97501,26.09,5311922,7443857.15,54.58036792869909,56.41695815124144,NaN,NaN,57.18310321276282,50.82220883980356,-0.021970103649972067,0.18108602661938278,0.20305613026935485,-8687796,-9764677.2,79.3073612496099,76.93667507527186,NaN,NaN,10.302022565572088,11.673434044155892
2009-07-09T09:30:00-04:00,26.2,26.2,25.64999,25.75999,5232574,7396649.7,49.537480797236924,55.74760285460905,NaN,NaN,5.960105117864689,28.249507012576554,-0.042841761779219445,0.14950392804533053,0.19234568982454997,-13920370,-11101567.8,75.56106454243027,77.7390509421625,NaN,NaN,8.551646398942415,11.227464380553966
2009-07-10T09:30:00-04:00,25.7,25.89999,25.58,25.64,3640055,7253990.55,47.80788371066567,54.88904710581234,NaN,NaN,-31.37508766368312,15.70526118652312,-0.0630889372183511,0.1134845183016111,0.1765734555199622,-17560425,-12168501.4,72.6130504313801,78.05996657577434,NaN,NaN,6.595088035854539,10.565696331311191
2009-07-13T09:30:00-04:00,25.78,26.14,25.58,26.09,4616457,6605028.6,54.25814027762626,55.02105868332553,NaN,NaN,15.809345175869884,16.380924427935653,-0.04536408596323843,0.11986834806591418,0.1652324340291526,-12943968,-13422455.4,69.19607506725794,77.80153194197536,NaN,NaN,6.872892226486958,10.038152887764872
2009-07-14T09:30:00-04:00,25.96001,26.28999,25.96001,26.21001,4204695,6021740.7,55.82607395261464,55.34825519452952,NaN,NaN,58.669378009360464,21.249368770434966,-0.02572406696336524,0.13307735032494605,0.1588014172883113,-8739273,-12370366.4,70.45240820381164,77.47227628280471,NaN,NaN,7.577812066029903,9.686675627517019
2009-07-15T09:30:00-04:00,26.37,26.44,26.03,26.44,5320648,5970052.6,58.74464581279334,55.7535621868498,NaN,NaN,88.57674283742713,27.528096695367804,0.0011640768451127714,0.16025651334470226,0.15909243649958948,-3418625,-11316532.2,71.69757326270194,77.11390452973669,NaN,NaN,9.064040332743323,9.597727728263633
2009-07-16T09:30:00-04:00,26.45,26.7,26.36,26.61,5610250,5877402.8,60.80598201286722,55.701251103779626,NaN,NaN,143.2962547549226,54.99532662277939,0.02735460911609816,0.19328569789471217,0.165931088778614,2191625,-8094133.2,75.14650091687072,76.9096532896313,NaN,NaN,10.926393980997586,9.787537192939912
2009-07-17T09:30:00-04:00,26.69,26.69,26.4003,26.53,5463023,5628718,59.30429168910327,55.54167642615489,NaN,NaN,122.53698985455331,85.77774212642666,0.0357181783690573,0.21057881173993565,0.17486063337087834,-3271398,-5236327.8,77.73752727957961,76.8898599451767,NaN,NaN,12.032134134732107,10.108193898910224
2009-07-20T09:30:00-04:00,26.60001,26.64999,26.3324,26.59,3614911,5279373.9,60.10017790241302,55.31522749560107,NaN,NaN,106.22779732536569,103.86143255632582,0.041322784428528686,0.2265141139065392,0.1851913294780105,343513,-2578831.6,79.84205754141796,76.92646204889643,NaN,NaN,13.171689090305557,10.545836069109559
2009-07-21T09:30:00-04:00,26.82001,27.03,26.7,26.98,5665652,5251437.15,64.9046919617962,55.71449484231115,NaN,NaN,176.48589231308785,127.42473541707132,0.06586996917288437,0.26752879094411597,0.2016588217712316,6009165,370856,81.88860462144007,77.01524361897566,NaN,NaN,15.637096607477485,11.27315900316212
2009-07-22T09:30:00-04:00,26.99001,27.11,26.772,26.88,7369613,5319841.45,62.816025748373086,55.90362317571576,NaN,NaN,159.17283407698827,141.54395366498355,0.06958240501707069,0.28863682804256996,0.21905442302549927,-1360448,782491.4,82.1607947793441,77.02460382326414,NaN,NaN,17.095199654824476,12.104879096256742
2009-07-23T09:30:00-04:00,26.95,27.57001,26.82001,27.42,6627473,5443141.85,68.67773816271671,57.23748132165354,NaN,NaN,208.87416042963284,154.65953479992558,0.10072612433252859,0.34496207844116,0.24423595410863141,5267025,1397571.4,82.58202710245847,77.08563942159026,NaN,NaN,20.313652909637685,13.277561069596876
2009-07-24T09:30:00-04:00,27.52,27.94,27.35001,27.89999,4141402,5243487.95,72.78457078175724,58.669692350025805,NaN,NaN,237.2212451091368,177.5963858508423,0.1433713622485815,0.4234501569193583,0.2800787946707768,9408427,3933536.4,84.23489928352161,77.22345342186243,NaN,NaN,24.546332467635725,14.887385555030997
2009-07-27T09:30:00-04:00,27.89999,28.05,27.67999,27.88,4663750,5228291.45,72.35905851688925,60.17908066111085,NaN,NaN,202.4994639227171,196.85071917031257,0.15875566747140368,0.4785233790100314,0.3197677115386277,4744677,4813769.2,84.77495578409948,77.65677857613737,NaN,NaN,27.73343239552666,16.722535103673234
2009-07-28T09:30:00-04:00,27.89,28.13,27.83,28.07001,5460102,5287987.95,73.91980355489645,61.56046892012495,NaN,NaN,178.71405663445174,197.29635203458534,0.16928675063557536,0.5313761498330969,0.36208939919752153,10204779,5652892,85.29220825915428,78.08426764824767,NaN,NaN,30.87916197665078,18.744910371241456
2009-07-29T09:30:00-04:00,27.86,28.162,27.86,28.05,4113047,5222941.45,73.44945154669536,63.26846683080055,NaN,NaN,146.77099692611444,194.81598460441054,0.16243504695178845,0.5651332078872571,0.4026981609354686,6091732,7143328,86.18967896732103,78.84345439288275,NaN,NaN,33.28119553785018,20.821522537899845
2009-07-30T09:30:00-04:00,28.49001,28.53,28.06,28.09,5080441,5200146.7,73.80822859804354,65.12563432275611,NaN,NaN,139.46569436164847,180.93429139081368,0.14850680253771592,0.5883316641076135,0.4398248615698976,11172173,8324357.6,86.87321784795782,79.86203777978115,NaN,NaN,35.36410593614802,22.8990344519353
2009-07-31T09:30:00-04:00,28,28.32001,27.87,27.87,5961598,5248734.6,68.33852102800009,66.13137580492567,NaN,NaN,105.44368104082179,154.57877857715067,0.1139421914413804,0.5822526008716231,0.4683104094302427,5210575,7484787.2,83.7016466156385,80.8981500332369,NaN,NaN,35.657468404510794,24.7216678737318
2009-08-03T09:30:00-04:00,28.02,28.2,27.77,28.03999,8180176,5380165.45,70.17754780663199,67.15648108021263,NaN,NaN,92.77852264611434,132.6345903218301,0.09288359294026138,0.5844149006055694,0.49153130766530806,13390751,9214002,84.92258034861429,81.93173375786567,NaN,NaN,36.42351862427988,26.393360838095813
2009-08-04T09:30:00-04:00,27.92999,28.11,27.89999,28.11,4449828,5236380.85,70.92653608449055,68.02661609961957,NaN,NaN,85.04667279121762,113.9011135531833,0.07480203748477587,0.5850338545212779,0.510231817036502,17840579,10741162,85.92536091696131,82.94800430459847,NaN,NaN,37.27029423979919,27.94720846691058
2009-08-05T09:30:00-04:00,28.16,28.16,27.66499,27.71001,4502074,5195888.45,61.4333951815852,68.07143132595657,NaN,NaN,61.64021965477556,96.87495809891553,0.029369508982088344,0.5469437032641125,0.5175741942820241,13338505,12190516.6,86.82119912088771,83.78191131917113,NaN,NaN,35.24133753800128,28.989226905637825
2009-08-06T09:30:00-04:00,27.71001,27.86,27.38,27.50999,7179000,5293209.75,57.30303634404827,67.9284845155955,NaN,NaN,34.10188694543067,75.80219661567196,-0.018129752150572,0.4949120040938091,0.5130417562443811,6159505,11187983,82.89105093791812,84.15002015190957,NaN,NaN,32.26405791419134,29.457059906859755
2009-08-07T09:30:00-04:00,27.63,27.8999,27.5807,27.63,5144059,5368409.95,59.0806629874465,67.85566202166932,NaN,NaN,39.53912993977608,62.62128639546281,-0.04396952317506542,0.45807985227554937,0.5020493754506148,11303564,12406580.8,83.84813889816479,84.43616882024865,NaN,NaN,30.27583179568611,29.574027319549234
2009-08-10T09:30:00-04:00,27.67999,27.89999,27.53,27.85001,4903602,5382767.2,62.18862497689517,67.66165723703352,NaN,NaN,39.91414963125306,52.04841179249056,-0.04839700009930875,0.44155312532647883,0.4899501254257876,16207166,12969863.8,84.28573508408824,84.60739242472353,NaN,NaN,29.451808728369894,29.556567520809327
2009-08-11T09:30:00-04:00,27.92,28,27.74001,27.81,4956141,5420339.5,61.27712573870586,67.55173580777158,NaN,NaN,45.40244847078966,44.119566928404964,-0.05565513264309502,0.4203812096219188,0.47603634226501385,11251025,11651953,78.89968622365606,84.37445609931721,NaN,NaN,28.516522346534295,29.407989638770037
2009-08-12T09:30:00-04:00,27.89,28.12,27.66,27.96001,5316773,5420145.75,63.44073651832489,67.17766426174359,NaN,NaN,49.73351251567172,41.7382255005842,-0.05205350020505545,0.4109694670086945,0.46302296721374997,16567798,12297811.6,79.58807884321828,84.16060265222863,NaN,NaN,28.31505736759571,29.251856457173705
2009-08-13T09:30:00-04:00,28.03999,28.06,27.62,27.92999,7561766,5517721.55,62.685893691053174,66.45633018383616,NaN,NaN,39.535587803652255,42.824965672228515,-0.053204434549619206,0.39651742402672596,0.44972185857634517,9006032,12867117,80.20124436569543,83.87248444381248,NaN,NaN,27.94282767481483,29.064852345408152
2009-08-14T09:30:00-04:00,27.99001,28.06,27.59,27.92999,5772371,5533188.95,62.685893691053174,65.76538983913359,NaN,NaN,33.25445493587767,41.568030671448824,-0.05523678186453279,0.3806758812456792,0.435912663110212,9006032,12407610.6,78.16039232377659,83.40001562521799,NaN,NaN,27.632685339050383,28.860257058785614
2009-08-17T09:30:00-04:00,27.58,27.99001,27.58,27.82001,7542910,5729588.9,59.66933414864153,64.74749916725823,NaN,NaN,9.984562078971257,35.58211316099246,-0.06460781361646173,0.35515289608963485,0.4197607097060966,1463122,9458801.8,66.47076139071804,82.05562656318683,NaN,NaN,26.57461201333597,28.533736338007092
2009-08-18T09:30:00-04:00,27.99001,27.99001,27.64,27.8,4171551,5654883.85,59.1119743991121,63.72339365671657,NaN,NaN,1.664341174458056,26.834491701726144,-0.0721984161405117,0.329512689530457,0.4017111056709687,-2708429,6666911,57.67561978234801,80.01890804997447,NaN,NaN,25.53459446841006,28.10528749949323
2009-08-19T09:30:00-04:00,27.77,28.2,27.64,28.19,5693145,5571060.45,65.81437183762571,63.152403888115295,NaN,NaN,72.06234944398855,31.300259087389556,-0.05194473305348246,0.3367801893541156,0.38872492240759804,2984716,3950294.6,50.65253456122267,77.43171638663625,NaN,NaN,26.404085226459138,27.862258603345502
2009-08-20T09:30:00-04:00,28.21001,28.42,28.10001,28.39,4320777,5455725.65,68.65223045209751,63.17481170412225,NaN,NaN,193.87384641846472,62.167910810352055,-0.027307486285312765,0.35459056455095705,0.3818980508362698,7305493,3610186.8,49.834375683154136,75.0126256057445,NaN,NaN,27.99898749977125,27.881791302834895
2009-08-21T09:30:00-04:00,28.50999,28.85001,28.44,28.67999,4980223,5497666.7,72.24937337693936,63.322799244858494,NaN,NaN,278.3477952461563,111.1865788724078,0.004590958939672984,0.387636749510861,0.38304579057118804,12285716,4266123.6,51.46270456865714,72.62263447860471,NaN,NaN,30.541700127221638,28.261778277747286
2009-08-24T09:30:00-04:00,28.85001,28.89,28.63049,28.88,6184305,5573694.45,74.42886139618305,63.572965338550816,NaN,NaN,258.5494839263119,160.8995632418759,0.03361563636183584,0.42506533602348284,0.391449699661647,18470021,7667503.4,58.91074444648048,70.69301901642751,NaN,NaN,33.401359932556566,28.996004228434327
2009-08-25T09:30:00-04:00,28.85001,29.07001,28.81,28.88,4663105,5533844.6,74.42886139618305,64.5012129253078,NaN,NaN,218.27391134945594,204.22147727687548,0.046476782472665346,0.44954567775247867,0.4030688952798133,18470021,11903193.4,65.92331819904952,69.20031323629622,NaN,NaN,35.69241769542944,29.952634723719342
2009-08-26T09:30:00-04:00,28.81,29.075,28.75011,28.89,6038129,5630098.7,74.54478612778358,65.7327664812889,NaN,NaN,166.46048482300088,223.10110435267796,0.0490649844156556,0.46440012579938283,0.41533514138372724,24508150,16207880.2,71.28665460764016,68.37142778413352,NaN,NaN,37.603471933800165,31.045611468016602
2009-08-27T09:30:00-04:00,28.89,28.98,28.59,28.88,4339645,5593058.9,74.182615805642,66.8114773968743,NaN,NaN,126.22612507139506,209.57156008326402,0.043690443850932625,0.46994819619739303,0.4262577523464604,20168505,18780482.6,73.92768351039598,67.6628238278643,NaN,NaN,39.09913394621474,32.196114679187765
2009-08-28T09:30:00-04:00,28.97,29.03,28.47,28.67,5794535,5584705.75,66.83870198765565,67.14362575478576,NaN,NaN,93.77063066187564,172.65612716640788,0.020743640721003875,0.4521873032477153,0.4314436625267114,14373970,19198133.4,74.34031840597794,66.95243692228499,NaN,NaN,38.4267535381763,33.08620594475756
2009-08-31T09:30:00-04:00,28.5,28.77,28.38,28.62,5478082,5449601.05,65.18406673315462,67.42269296867495,NaN,NaN,63.645183726344825,133.67526712641447,-0.0018506595580169427,0.4291303380791902,0.43098099763720715,8895888,17283306.8,68.95222132057017,66.24190371492172,NaN,NaN,37.40841369658897,33.703664195019186
2009-09-01T09:30:00-04:00,28.62,28.73,28.10001,28.16,7560535,5605136.4,52.34527242060714,66.63015981883798,NaN,NaN,20.14654146478805,94.0497931494809,-0.04920061146102389,0.3694802333109273,0.41868084477195117,1335353,13856373.2,60.50074397121952,64.87852265263611,NaN,NaN,32.35807671394147,33.511437412008085
2009-09-02T09:30:00-04:00,28.16,28.35069,28.06,28.22,5343621,5647213.75,53.62823651859222,65.98318430651933,NaN,NaN,-1.7055030293778994,60.416595579005126,-0.07628744015347233,0.32332154458011075,0.3996089847335831,6678974,10290538,53.19454152542927,62.949472449759945,NaN,NaN,28.61623764646952,32.81212315978829
2009-09-03T09:30:00-04:00,28.33,28.33,27.96001,28.09,4183184,5497422.95,50.45852424107599,65.1098007743781,NaN,NaN,-21.163372125294707,30.938696139667183,-0.10120528107843596,0.27310238338553816,0.3743076644639741,2495790,6755995,47.12025462888803,60.73231975726791,NaN,NaN,24.48407946911278,31.622402632548933
2009-09-04T09:30:00-04:00,28.23,28.53999,28.17,28.49001,6434898,5561964.9,58.572398850852416,65.03144825310746,NaN,NaN,21.6245987777992,16.509489762851892,-0.08940274078764832,0.2625542384794137,0.35195697926706204,8930688,5667338.6,45.40063497120807,59.227310727302914,NaN,NaN,23.25106534870079,30.42649730628491
2009-09-08T09:30:00-04:00,28.60001,28.61,28.23,28.36,6484496,5641009.6,55.39673784189088,64.76607421330594,NaN,NaN,16.764564993757872,7.133366016334493,-0.08882415685371292,0.2409267831999209,0.3297509400536338,2446192,4377399.4,43.38049096446548,58.20623009745417,NaN,NaN,21.22349285090308,29.11178238408751
2009-09-09T09:30:00-04:00,28.39999,28.75999,28.36,28.69,4642535,5625329.3,61.15392254083148,64.43318497782063,NaN,NaN,50.83461318717011,13.270980360810904,-0.06575164989245225,0.24756137768806852,0.31331302758052076,7088727,5528074.2,45.70149717275987,57.85258456970682,NaN,NaN,21.359147335377227,28.00426309141461
2009-09-10T09:30:00-04:00,28.73,28.91,28.58,28.91,4851324,5602056.85,64.44846647008299,64.13291612196245,NaN,NaN,82.68298253308372,30.148677473303223,-0.03665996840743502,0.26748806707122696,0.304148035478662,11940051,6580289.6,47.808414189908945,57.70787303447502,NaN,NaN,22.580853978857526,27.22949036104931
2009-09-11T09:30:00-04:00,28.89999,28.985,28.7901,28.92,5387184,5493327.75,64.59545018173996,63.586207322305356,NaN,NaN,92.85434952786879,52.95222180393593,-0.018638772875045118,0.2808495693848556,0.29948834225990073,17327235,9546578.6,53.3087427769814,57.839732906498185,NaN,NaN,23.58070581054798,26.708235425263407
2009-09-14T09:30:00-04:00,28.69,29.06,28.69,29.03,3940118,5401715.1,66.24848322223386,63.0018945955947,NaN,NaN,90.723888535887,66.77207975555348,-0.002076796399846703,0.29689234676009235,0.29896914315993905,21267353,12013911.6,57.33633329193663,57.72727496688791,NaN,NaN,24.915586514079248,26.45214272366567
2009-09-15T09:30:00-04:00,29.03,29.09,28.7695,28.77,5797625,5314450.85,59.21139353417927,61.91493260545157,NaN,NaN,75.05599478610276,78.43036571402246,-0.010905438507571197,0.28533734502547503,0.29624278353304623,15469728,14618618.8,61.146593775822296,57.38608036522883,NaN,NaN,23.879066115309552,26.08456035104337
2009-09-16T09:30:00-04:00,28.83,29.03,28.71001,29.03,5152633,5363504.95,63.39838502540374,61.11876109813873,NaN,NaN,82.4424396600919,84.75193100860682,-0.001975575551634523,0.29377331409350305,0.29574888964513757,20622361,17325345.6,64.67699693923757,56.913961960342924,NaN,NaN,24.332443933279006,25.834258005648458
2009-09-17T09:30:00-04:00,28.86,29.07001,28.86,29.00999,5022211,5329958.25,62.86354914972766,60.31025633700198,NaN,NaN,92.27609565707962,86.670553633406,-0.00024822514254047023,0.295438608216962,0.29568683335950247,15600150,18057365.4,65.58769018898572,56.318248151670765,NaN,NaN,24.52978899421202,25.647905289728968
2009-09-18T09:30:00-04:00,29,29.00999,28.75999,28.75999,6988098,5463324.3,56.45549518371993,59.56859870814943,NaN,NaN,48.05907635952729,77.7114989997377,-0.01780267937082436,0.273433484145972,0.2912361635167964,8612052,16314328.8,61.520427657153235,55.40254166961186,NaN,NaN,22.698948705004433,25.22662577762546
2009-09-21T09:30:00-04:00,28.67,29.08501,28.67,29.03999,4603031,5444464.7,61.2231274376073,59.28567447275319,NaN,NaN,68.81980642526007,73.33068257761231,-0.0126584239664142,0.2754131335587786,0.2880715575251928,13215083,14703874.8,57.94504386796285,54.61631470871133,NaN,NaN,22.636393963412758,24.85659266130936
2009-09-22T09:30:00-04:00,29.10001,29.16,28.78999,28.95,3830631,5326781,58.987743728063535,59.760136709000086,NaN,NaN,74.8073118974332,73.2809459998784,-0.017139773807235914,0.26664684026614793,0.28378661407338385,9384452,13486819.6,55.3280924896133,54.24683960288231,NaN,NaN,21.890692973579412,24.432892705919368
2009-09-23T09:30:00-04:00,28.91,29,28.53999,28.53999,4193934,5303322.45,50.02556756531391,59.50280321233735,NaN,NaN,-1.1775993197310366,56.55693820391381,-0.047803210536473684,0.22403260090279176,0.27183581143926544,5190518,10400451,49.253232221155244,53.96531750971989,NaN,NaN,18.20678391326683,23.54344859268329
2009-09-24T09:30:00-04:00,28.69,28.71001,28.39999,28.50999,5083949,5255613.45,49.43375149966373,59.42960515937933,NaN,NaN,-41.523197647259714,29.79707954304596,-0.06890934046002573,0.18569913586423326,0.254608476324259,106569,7301734.8,44.02657315032533,53.74434026125112,NaN,NaN,15.12968253535141,22.34148201306445
2009-09-25T09:30:00-04:00,28.44,28.6833,28.39999,28.53,3526110,5214936.7,49.85983138601225,58.80727891189075,NaN,NaN,-37.758532176380044,12.63355783586449,-0.07957013773340238,0.155145804157506,0.23471594189090839,3632679,6305860.2,42.466851722645465,53.53478431492522,NaN,NaN,12.792726288584108,20.977374052424402
2009-09-28T09:30:00-04:00,28.64,29.0721,28.58,28.84,4043696,5127394.75,56.039837145745565,58.853214576451805,NaN,NaN,46.539844179312965,8.177565386675068,-0.06443730548240331,0.15416931003790424,0.21860661552030755,7676375,5198118.6,40.73802823774631,53.346036977302425,NaN,NaN,12.61628625875217,19.782932939042656
2009-09-29T09:30:00-04:00,28.87,29.0515,28.75,28.88,6430199,5175000.6,56.78007297111407,58.54079675004341,NaN,NaN,59.397604178198364,5.095623842828097,-0.05101471760083001,0.15483821851927004,0.20585293612010006,14106574,6142543,42.87329992857379,53.14402288843199,NaN,NaN,12.694812021041926,18.77034423647112
2009-09-30T09:30:00-04:00,28.97,28.97,28.45,28.67,7155977,5154772.7,51.84429342423602,57.64049867534006,NaN,NaN,-2.282818148192753,4.874580077135751,-0.055205855087391786,0.1368456172608603,0.1920514723482521,6950597,6494558.8,43.687740943729594,52.849689085133456,NaN,NaN,11.273119379717334,17.699312114077724
2009-10-01T09:30:00-04:00,28.69,28.69,28.24001,28.25999,7926926,5283937.95,43.832716109530494,56.15744624161082,NaN,NaN,-104.23052157344847,-7.666884708101986,-0.08285557367699553,0.08848200525200767,0.1713375789290032,-976329,6277979.2,43.278916408981104,52.13327291599058,NaN,NaN,7.33255338452872,16.218346581285008
2009-10-02T09:30:00-04:00,28.07001,28.28999,28.06,28.14999,5992961,5374426.8,41.95932489349601,54.42250636098669,NaN,NaN,-182.59265730871522,-36.633709734569024,-0.10442445056197686,0.040807015726532114,0.14523146628850897,-6969290,4157585.4,39.392294432519904,50.85155585460367,NaN,NaN,3.54279795966106,14.407553921053015
2009-10-05T09:30:00-04:00,28.12,28.39,27.99001,28.33,4785578,5291960.8,46.02481463453254,53.48060786815478,NaN,NaN,-149.85299242004598,-75.9122770544408,-0.10230553237530696,0.01734955081937528,0.11965508319468224,-2183712,2185568,36.14155844400607,49.06548190233109,NaN,NaN,1.6391500638986338,12.583496227173818
2009-10-06T09:30:00-04:00,28.39999,28.63,28.19,28.56,7127793,5324125.65,50.76973048734363,52.578561115436194,NaN,NaN,-80.94537908558911,-103.98087370719831,-0.08202722032245842,0.017121057791609218,0.09914827811406764,4944081,353069.4,33.3845767123817,46.83030902898424,NaN,NaN,1.5279591757219178,11.004133791252118
2009-10-07T09:30:00-04:00,28.53,28.63,28.42,28.58,4128488,5298423.3,51.171699728634394,51.743429013929536,NaN,NaN,-52.16852463301814,-113.9580150041634,-0.06464472740053348,0.018342368863400793,0.08298709626393427,9072569,777463.8,34.62831040391953,44.61892475862236,NaN,NaN,1.5607076748594955,9.655072917481743
2009-10-08T09:30:00-04:00,28.74001,28.82001,28.56,28.61,4539305,5282822.35,51.80734873203231,51.41141855309471,NaN,NaN,-11.905700095057746,-95.49305070848524,-0.049202981762504885,0.02148336906080317,0.07068635082330806,13611874,3695104.4,42.56719465426977,43.26512240127355,NaN,NaN,1.7701635422352022,8.528657292446523
2009-10-09T09:30:00-04:00,28.60001,28.905,28.58,28.88,5196469,5273286.6,57.206778960752004,51.12453651903362,NaN,NaN,30.951880587527207,-52.784143129236746,-0.02035875788170044,0.045237903471182506,0.06559666135288295,18808343,8850631,53.348297300851186,42.936783360765574,NaN,NaN,3.5904908383693113,7.823204941864065
2009-10-12T09:30:00-04:00,28.84,29.08,28.84,29.02,3940060,5273283.7,59.72640707334143,51.17729818655347,NaN,NaN,92.34168395315658,-4.345207854596237,0.007123923264940352,0.07450156543405839,0.06737764216911804,22748403,13837054,60.97808564757949,43.34035430062031,NaN,NaN,5.891218172084881,7.547206831895609
2009-10-13T09:30:00-04:00,28.92999,28.92999,28.67999,28.74001,4488793,5207842.1,53.004762701741754,51.39009783915545,NaN,NaN,30.216218332640782,17.887111629049738,0.005493510755666148,0.07424453061370073,0.06875101985803458,18259610,16500159.8,64.33309971632241,44.41748769313225,NaN,NaN,5.86506213952727,7.306900447271561
2009-10-14T09:30:00-04:00,28.97,29.21001,28.75999,29.17999,10170129,5458716.9,60.52317962053669,52.18219984778924,NaN,NaN,113.73593900084339,51.06800435582204,0.031635326671647215,0.1082951781975936,0.07665985152594638,28429739,20371593.8,68.56441549045843,46.170190717427474,NaN,NaN,8.388446581334527,7.461407037851985
2009-10-15T09:30:00-04:00,29.13,29.32001,29.06,29.25999,6474180,5531315.35,61.722292887774145,53.02951852648651,NaN,NaN,154.15415415415453,84.2799752056645,0.05076865420974995,0.14012066928813383,0.08935201507838388,34903919,24630002.8,72.4377494244485,48.31096912469911,NaN,NaN,10.780742345112893,7.9355977960321145
2009-10-16T09:30:00-04:00,29.17,29.3,29.05,29.24001,5617203,5462770.6,61.222124066452096,53.39968187796554,NaN,NaN,132.826110802212,104.65482124860145,0.058009994302835016,0.16186450795692764,0.10385451365409262,29286716,26725677.4,74.12728217502726,50.695915834504895,NaN,NaN,12.52997700007803,8.591937682324389
2009-10-19T09:30:00-04:00,29.25999,29.55,29.17,29.49001,5105477,5487892.9,65.03963057509296,53.989650278249755,NaN,NaN,167.91285350252284,119.7690551584747,0.07451534040429741,0.1969986891594644,0.12248334875516698,34392193,29054435.4,75.89549808304312,53.054644274109855,NaN,NaN,15.252032323171038,9.54337977387391
2009-10-20T09:30:00-04:00,29.55,29.55,29.14,29.21001,4748840,5533803.35,58.13648196391576,54.439092316798316,NaN,NaN,128.6816204319008,139.4621355783267,0.06196875112471281,0.19994428766105798,0.13797553653634517,29643353,31331184,77.5135398804329,55.47077276958866,NaN,NaN,15.43087673344298,10.384450768098063
2009-10-21T09:30:00-04:00,29.2,29.25999,28.81,28.825,9425012,5795357.25,50.24025451151737,54.89677363122595,NaN,NaN,43.51237398862597,125.41742257588324,0.025027952323802005,0.1692604769410977,0.1442325246172957,20218341,29688904.4,73.67195467277365,57.64170407414527,NaN,NaN,12.922747825050527,10.747064633376986
2009-10-22T09:30:00-04:00,28.77,29.14,28.59,29.00999,5381797,5810249.65,53.50773169516577,55.721659831345214,NaN,NaN,27.376323969326705,100.06185653891767,0.011052857914303826,0.15804859701017548,0.14699573909587166,25600138,27828148.2,69.47085848368735,59.79017293494295,NaN,NaN,11.9463562880408,10.918392012614675
2009-10-23T09:30:00-04:00,29.11,29.11,28.61,28.71001,6078336,5937860.95,48.003052659359405,55.86296254740428,NaN,NaN,-1.168106505337082,73.26301307740783,-0.01877002448119111,0.12353320849438276,0.14230323297557387,19521802,25875165.4,65.26427440589615,61.870366932220804,NaN,NaN,9.260077613735973,10.681489955632003
2009-10-26T09:30:00-04:00,28.8,28.97,28.34,28.39999,7267988,6099075.55,43.07146049818095,55.31308611960694,NaN,NaN,-56.95113969390663,28.290214438121943,-0.057560577250639844,0.07035251141227405,0.1279130886629139,12253814,21447489.6,56.85838778666933,63.54706772324135,NaN,NaN,5.298531774828211,9.91249592980289
2009-10-27T09:30:00-04:00,28.48,28.7,28.37,28.52,8489633,6202047.25,45.409478999763586,54.9014989246876,NaN,NaN,-60.60591199098667,-9.567292046455554,-0.07236372503294537,0.03745843237173219,0.10982215740467756,20743447,19667508.4,53.855347677659076,64.92042752850845,NaN,NaN,2.8980849526249854,8.910437218777476
2009-10-28T09:30:00-04:00,28.48,28.59,28.2,28.23,9471551,6317825.95,41.024874656151866,54.131322204981856,NaN,NaN,-95.09964168504536,-37.28969518118982,-0.09735697538962886,-0.011874061832358507,0.08548291355727035,11271896,17878219.4,50.942634298603785,65.51867321738946,NaN,NaN,-0.5962170097593789,7.552343757557925
2009-10-29T09:30:00-04:00,28.28,28.50999,28.17999,28.48,5806684,6211813.85,45.87659434291653,53.322023303707894,NaN,NaN,-83.7484552505336,-59.51465102516188,-0.09274356244001095,-0.03044653949274334,0.062297022947267605,17078580,16173907.8,48.26498156364548,65.15557923616048,NaN,NaN,-1.9178020831631042,6.199465780312064
2009-10-30T09:30:00-04:00,28.39,28.59,28.03,28.07001,6954938,6259912.7,40.05664342930477,51.91704018627671,NaN,NaN,-121.58780350084744,-83.59859042426395,-0.11172274784063448,-0.07735641185352549,0.03436633598710899,10123642,14294275.8,45.42893152241968,64.04492537007764,NaN,NaN,-5.063594632156508,4.590457149959411
2009-11-02T09:30:00-05:00,28.08,28.405,28.03999,28.19,6993379,6370302.75,42.36126215393127,51.15679014714739,NaN,NaN,-124.86586593326558,-97.18153567213574,-0.11041767235068699,-0.10365575445124975,0.006761917899437243,17117021,15266917.2,47.15920863257846,62.818218864095925,NaN,NaN,-6.806576380170496,2.9623095027979955
2009-11-03T09:30:00-05:00,28.10001,28.27,28.0325,28.2,4974027,6262614.45,42.55946784172677,49.87366787723239,NaN,NaN,-124.73933471416555,-110.00822021677152,-0.10323486995250296,-0.12228166954119146,-0.0190467995886885,22091048,15536437.4,47.65449440968126,61.324653072611845,NaN,NaN,-8.113262337994321,1.3800849541133788
2009-11-04T09:30:00-05:00,28.25,28.91,28.25,28.56,8205230,6466451.55,49.316492408325765,48.987539271557516,NaN,NaN,-38.72166221156822,-98.73262432207608,-0.07017308108238857,-0.10676315094167421,-0.036590069859285645,30296278,19341313.8,54.183438540736134,60.02077372377524,NaN,NaN,-7.111276099553673,0.16703337501808568
2009-11-05T09:30:00-05:00,28.78,29.10001,28.74001,29.03,6651652,6572068.9,56.50951372406042,48.650924247100974,NaN,NaN,39.9698135697805,-73.98897055801328,-0.015444116789249437,-0.055895215845847446,-0.04045109905659801,36947930,23315183.8,59.820193776565226,58.99883883817081,NaN,NaN,-3.764782576826034,-0.3946546181025028
2009-11-06T09:30:00-05:00,28.97,29.19,28.85001,29.16,5297598,6577125.35,58.27346733564359,48.16762687285458,NaN,NaN,58.32143654986127,-38.00712254787153,0.028333625120704267,-0.005034067655717678,-0.033367692776421945,42245528,29739561,66.90826781680266,58.35689381915365,NaN,NaN,-0.5121000098957785,-0.4114325312158279
2009-11-09T09:30:00-05:00,29.33,29.67999,29.19,29.64999,4541727,6607208.7,64.17200024359218,48.5987353214029,NaN,NaN,133.5198849564305,13.670027630067699,0.08586159416587034,0.07395929993091599,-0.011902294234954355,46787255,35673607.8,71.84829877489793,57.95223374018686,NaN,NaN,4.417096753763968,0.2783573666384286
2009-11-10T09:30:00-05:00,29.60001,29.88,29.56,29.85001,3583310,6561934.55,66.26824293900185,49.74359163765179,NaN,NaN,154.8440257331838,69.58669971953756,0.13029132407708388,0.1509618608614005,0.020670536784316622,50370565,41329511.2,75.58883881234526,58.08915403587056,NaN,NaN,9.103718906920848,1.5391233009644885
2009-11-11T09:30:00-05:00,29.96001,30.02,29.67999,29.89,5100098,6308433,66.68788963765823,50.68503149068697,NaN,NaN,150.82895305780266,107.49682277341176,0.15367255057206455,0.2127612249993973,0.05908867442733276,55470663,46364388.2,78.34699809275608,58.7231640079469,NaN,NaN,12.91706489036559,3.164543528021788
2009-11-12T09:30:00-05:00,29.78,30.00101,29.64999,29.72,3450331,6157240.55,63.09438852679189,51.76298405264642,NaN,NaN,126.7700776929314,124.85687559804194,0.14888397832193043,0.2451936473297458,0.09630966900781537,52020332,49378868.6,79.81733764948223,59.76266852534591,NaN,NaN,14.99179659623644,4.85415110919531
2009-11-13T09:30:00-05:00,29.69,29.96001,29.67,29.78,3706901,6061725.45,63.8350933456218,53.24610068460648,NaN,NaN,116.41582518409666,136.475753324889,0.14102887280347481,0.2725957600121589,0.1315668872086841,55727233,52075209.6,81.056442620746,61.491101013494244,NaN,NaN,16.89636536977698,6.574467432135548
2009-11-16T09:30:00-05:00,29.96001,30.27811,29.77,30.08,3769310,5994917.1,67.36227136641514,54.81415728222445,NaN,NaN,134.51427140710965,136.67463061502485,0.14665830724019355,0.31488977125892603,0.16823146401873249,59496543,54617067.2,82.16790097982563,63.513426249363285,NaN,NaN,19.643401539208575,8.441458018860267
2009-11-17T09:30:00-05:00,30.12,30.21001,29.99001,30.16,8409082,6177929.2,68.2515064120162,56.75891669335761,NaN,NaN,127.16346788979271,131.13851904634663,0.14607033583847825,0.3508193838168303,0.20474904797835206,67905625,58124079.2,83.59779730987134,65.84593789302525,NaN,NaN,22.161667578438916,10.401487955942931
2009-11-18T09:30:00-05:00,30.25999,30.36,30.00999,30.33,4640938,5938725.5,70.11486113739133,58.49022146439153,NaN,NaN,119.22470475950962,124.81766938668802,0.14702690324208267,0.3885326770309554,0.24150577378887272,72546563,61539259.2,84.87012358221756,68.46059089435182,NaN,NaN,24.855059406179187,12.466283877405253
2009-11-19T09:30:00-05:00,30.25,30.25,29.86,30.17999,8943145,6116792.9,66.41088923160632,60.37266759312735,NaN,NaN,91.94519923381469,117.85269369486468,0.12814401815095122,0.40168579647756175,0.27354177832661053,63603418,63855876.4,85.68149438615633,71.3357739560473,NaN,NaN,26.084380038645204,14.411726186153818
2009-11-20T09:30:00-05:00,30.13,30.42,30.03999,30.39,4254777,6025614.95,68.88876381419387,62.267489140288966,NaN,NaN,97.35927493286137,114.04138364461762,0.12049958981855546,0.42416626559980486,0.3036666757812494,67858195,66282068.8,86.49813930315364,74.1456975753741,NaN,NaN,27.870986482994205,16.334477657131014
2009-11-23T09:30:00-05:00,30.57001,30.87,30.53,30.67,4317246,5878077.85,71.8684914931069,64.36099082967327,NaN,NaN,120.13624906087554,111.16577917537082,0.1244918973732908,0.4592815474978629,0.33478965012457207,72175441,68817848.4,87.31261589358687,76.9784205385102,NaN,NaN,30.34076743282968,18.33537619651654
2009-11-24T09:30:00-05:00,30.75,31,30.60001,30.91,6797063,5793449.35,74.15355376148744,66.13506664061339,NaN,NaN,120.98689037906925,109.93046367322613,0.1327321534131028,0.5007048418909505,0.36797268847784775,78972504,71031224.2,87.99343553638485,79.39342032391369,NaN,NaN,33.167131783719334,20.454198423259793
2009-11-25T09:30:00-05:00,30.98,31.10001,30.85001,31.10001,6534277,5646585.65,75.8276261020799,67.51493181047192,NaN,NaN,126.59890502500835,111.40530372632585,0.13971020498811504,0.5426104447129916,0.40290023972487654,85506781,73623267.8,88.7544821813767,81.46015520997165,NaN,NaN,36.06939288809222,22.684940489664424
2009-11-27T09:30:00-05:00,30.64,30.94,30.35001,30.78999,3394233,5525963.1,68.07964420167689,68.21537301518859,NaN,NaN,92.6334153920943,111.54294695798178,0.11330215600692284,0.5445279347335301,0.4312257787266073,82112548,77325093.8,89.75340193626735,83.09195050421913,NaN,NaN,36.1962427600748,24.61512652829448
2009-11-30T09:30:00-05:00,30.83,30.83,30.5699,30.67999,5203066,5438369.5,65.52145689486464,68.31176277599376,NaN,NaN,88.91514570162654,109.85412111173483,0.07985927014277855,0.5310498664050805,0.4511905962623019,76909482,79135351.2,90.21131648757203,84.40359462655299,NaN,NaN,35.52361859277361,26.173482537505784
2009-12-01T09:30:00-05:00,30.75999,31.22,30.75999,31.22,5944852,5385943.15,71.23574346300927,68.66658424199429,NaN,NaN,119.08384721405295,109.64364074237031,0.0850603203741786,0.5575159967300252,0.47245567635584657,82854334,81271129.8,90.7372665293536,85.48562517776786,NaN,NaN,36.76843497959233,27.687047172089574
2009-12-02T09:30:00-05:00,31.17,31.28999,31,31.14999,4983246,5386404.1,69.62465595310577,68.87635326452626,NaN,NaN,121.88346384579935,109.82295543571634,0.07508607248723781,0.5663132669648938,0.491227194477656,77871088,81050846.6,90.1989576357648,86.3321937165542,NaN,NaN,37.25051320723906,29.053256605682357
2009-12-03T09:30:00-05:00,31.24001,31.315,30.92999,31,7722773,5362281.25,66.17178059515942,69.09616698369537,NaN,NaN,104.78787675834509,105.46074978238369,0.05084783519031333,0.5547869884655476,0.5039391532752343,70148315,77979153.4,82.82051145059552,86.54670613091945,NaN,NaN,36.58696685230488,30.12950092662843
2009-12-04T09:30:00-05:00,31.2,31.39999,30.86,30.98,6784293,5368913.3,65.70387183523454,69.22965116152486,NaN,NaN,94.18696115477829,105.77145893492047,0.027119579739299793,0.537838627949359,0.5107190482100592,63364022,74229448.2,74.7788439165799,86.098306223479,NaN,NaN,35.9163373600682,30.956191845691254
2009-12-07T09:30:00-05:00,30.98,31.28999,30.91,30.94,4296695,5318868.15,64.71820644618414,69.04078938150835,NaN,NaN,81.76202038554003,104.34083387170317,0.003616681104830932,0.5152398995910978,0.5116232184862669,59067327,70661017.2,68.01097315301426,85.08709709299248,NaN,NaN,35.08746396011377,31.54637357632304
2009-12-08T09:30:00-05:00,30.81,30.95,30.64999,30.7,5625348,5373049.2,58.999199822748395,68.3799103394178,NaN,NaN,38.187717966249785,88.16160802214253,-0.03128468337114565,0.4725173642723348,0.5038020476434805,53441979,64778546.2,58.59619855436185,83.30126861045609,NaN,NaN,32.70096397521456,31.711315061878974
2009-12-09T09:30:00-05:00,30.74001,30.96001,30.64999,30.96001,6328285,5510297.95,62.831285100487484,67.85965490821037,NaN,NaN,46.472025227584666,73.0793202984996,-0.03952002400688592,0.4544020176348731,0.493922041641759,59770264,61158381.4,53.67203748954612,81.07283388955099,NaN,NaN,31.705538305162584,31.71048981091949
2009-12-10T09:30:00-05:00,31.07001,31.35001,31.03999,31.28,6752410,5592913.55,66.92798815683022,67.89659054572635,NaN,NaN,98.43960245932395,71.80966543869538,-0.026692049737339907,0.4605569794700841,0.487249029207424,66522674,60433253.2,52.7164291528607,78.718186372887,NaN,NaN,32.07369734074455,31.7623766008945
2009-12-11T09:30:00-05:00,31.28,31.42,31.23,31.28,5955051,5718149.55,66.92798815683022,67.75653514162896,NaN,NaN,109.61055409964482,74.89438402766868,-0.021694639022233064,0.4601307304296327,0.48182536945186577,66522674,61064983.6,53.49330037324733,76.3606978778937,NaN,NaN,32.36804529862798,31.84890070057071
2009-12-14T09:30:00-05:00,31.50999,31.64999,31.39999,31.57001,4646441,5765126.55,70.36164556287459,67.64890328946949,NaN,NaN,142.55901304781327,87.0537825601233,-0.003310039212869209,0.4776878204357793,0.4809978596486485,71169115,63485341.2,56.4458725762117,74.15593049808119,NaN,NaN,33.662053331712094,32.10792250501948
2009-12-15T09:30:00-05:00,31.57001,31.58,31.39,31.58,4171617,5785241.9,70.47536066500037,67.386175211149,NaN,NaN,128.58204681907594,105.13264833068851,0.004638962293402327,0.4867965625154014,0.48215760022199905,75340732,67865091.8,61.24111736849112,72.24505062894592,NaN,NaN,34.740404147935195,32.4839913111503
2009-12-16T09:30:00-05:00,31.67999,31.75999,31.42,31.42,6069656,5668270.6,66.10103138111492,66.69141844536578,NaN,NaN,121.85545064508598,120.20933341418879,-0.005228504645427179,0.47562196941521506,0.48085047406064224,69271076,69765254.2,63.137360068237086,70.41525619229309,NaN,NaN,34.4226448861382,32.76094182186286
2009-12-17T09:30:00-05:00,31.14999,31.41,30.96001,31.13,16427941,6257620.75,58.95804330214991,66.039875523971,NaN,NaN,41.799976488517665,108.88140822002754,-0.034030099397737046,0.43831284981347096,0.472342949211208,52843135,67029346.4,58.68542950819136,68.19611530457338,NaN,NaN,31.99504798787201,32.65152841700702
2009-12-18T09:30:00-05:00,31.02,31.14999,30.88,31.13,10356074,6328267.2,58.95804330214991,65.57106026734853,NaN,NaN,6.447388173666348,88.24877503483182,-0.05460472747199774,0.40408703987121086,0.4586917673432086,52843135,64293438.6,54.54361571404215,65.64842239217839,NaN,NaN,30.03362433966963,32.27754212024454
2009-12-21T09:30:00-05:00,30.94,31.62,30.92999,31.42,9174879,6574272.3,63.52882810281705,65.02056631304907,NaN,NaN,76.46542495982432,75.03005741723405,-0.05031271848724339,0.39580086923415436,0.44611358772139775,62018014,62463218.4,51.90453798079809,62.87465606728157,NaN,NaN,29.602389911893116,31.89537751905148
2009-12-22T09:30:00-05:00,31.39,31.64,31.39,31.56,3957630,6556291.5,65.52492950953578,64.72772870993693,NaN,NaN,124.51929629958337,74.21750731333552,-0.04011775405389989,0.3959663951540229,0.43608414920792277,65975644,60590200.8,49.27684655882584,59.951648133214505,NaN,NaN,29.82211554175719,31.599197236580867
2009-12-23T09:30:00-05:00,31.64999,31.64999,31.44,31.46001,3457381,6389307.4,62.877985717402964,64.49245764724003,NaN,NaN,106.85235537308095,71.21688825893452,-0.04198153304973373,0.3836072328957556,0.42558876594548933,62518263,59239638.2,47.41294277787914,57.42253608516334,NaN,NaN,29.244690965655234,31.262839197877206
2009-12-24T09:30:00-05:00,31.5,31.52,31.36,31.46001,2198422,6172514.65,62.87798571740296,64.29060863882349,NaN,NaN,76.62537532072545,78.18196802537608,-0.04482898382464506,0.369552536164683,0.41438151998932804,62518263,61174663.8,50.31283261417516,55.67496384927727,NaN,NaN,28.77251246427816,30.907078235934485
2009-12-28T09:30:00-05:00,31.59,31.64,31.44,31.62,6543809,6329993.45,65.46668755226662,64.34407157497223,NaN,NaN,100.67161836501504,97.02681406364582,-0.03783135058269049,0.3670923317609649,0.4049236823436554,69062072,64418451.2,54.81147195997155,54.732142335488504,NaN,NaN,29.073190753796734,30.645094309914807
2009-12-29T09:30:00-05:00,31.64,31.75999,31.53999,31.58,10151051,6577392.7,64.26014120315418,64.71985310214407,NaN,NaN,107.5746587641804,103.24866082451703,-0.03770650619393756,0.35779054960123347,0.395497055795171,58911021,63797052.6,53.80645386638497,54.39001771491872,NaN,NaN,29.001580752165406,30.410306658807748
2009-12-30T09:30:00-05:00,31.48,31.60001,31.39999,31.49001,3636937,6461996.95,61.51343283592063,64.62572079753217,NaN,NaN,62.16763911504209,90.77832938760878,-0.045000241518865725,0.33924675389658887,0.3842469954154546,55274084,61656740.6,50.379946892635644,54.15486838656796,NaN,NaN,28.205532660582435,30.09533894477556
2009-12-31T09:30:00-05:00,31.50999,31.53,31.07001,31.07001,3510935,6388381.4,50.63510151584817,63.46194318031916,NaN,NaN,-22.20540306633383,64.96677769972582,-0.07751935181193409,0.28734780565053697,0.36486715746247106,51763149,59505717.8,47.13146255752077,53.75594220118654,NaN,NaN,24.127209518584593,29.242749026748278
2010-01-04T09:30:00-05:00,31.47,31.62,31.27,31.61,5580848,6281285.15,60.344940603901655,62.991725497967124,NaN,NaN,57.841335251272625,61.20996968583525,-0.06270353156981312,0.28648774300020463,0.34919127457001775,57343997,58470864.6,45.60782778318099,53.19269415903894,NaN,NaN,23.510065326491635,28.4237942124259
2010-01-05T09:30:00-05:00,31.56,31.67,31.3,31.3,5428535,6213497.25,53.80227015881062,61.80891296910541,NaN,NaN,29.556803395388396,46.987006691909926,-0.07309722571361033,0.25781974242800487,0.3309169681416152,51915462,55041542.6,40.89039746928458,52.081588794258444,NaN,NaN,20.708207678071098,27.321567564660928
2010-01-06T09:30:00-05:00,31.3,31.62,31.3,31.62,4883535,6242839.25,58.771455058530556,60.972919711500424,NaN,NaN,54.11648088038576,36.295371115151,-0.05837516889468769,0.2579480070232556,0.3163231759179433,56798997,54619137.8,40.33695249072152,50.588434160132046,NaN,NaN,20.106853902689288,26.290894184379265
2010-01-07T09:30:00-05:00,31.5,31.73,31.42999,31.73,6114695,6267306.6,60.35027321190882,60.56215127084284,NaN,NaN,93.4393983204873,42.549722956240046,-0.0419514610744921,0.26388384957482813,0.30583531064932024,62913692,56147059.4,43.32509188595566,49.173272147111945,NaN,NaN,20.164366117549772,25.41567588911791
2010-01-08T09:30:00-05:00,31.78999,31.81,31.56,31.78,4284801,6165132.4,61.079849345845275,60.7137088453925,NaN,NaN,132.62370454929766,73.51554447936634,-0.029055593239350697,0.2695158191001319,0.2985714123394826,67198493,59234128.2,48.89431429089907,48.47390677444821,NaN,NaN,20.440957521499517,24.705001836600996
2010-01-11T09:30:00-05:00,31.95,32,31.8199,31.96001,4177637,6036393.75,63.671570948792336,61.05038939158125,NaN,NaN,213.7421400464963,104.69570543841107,-0.01068377181527902,0.2852166975703838,0.29590046938566283,71376130,62040554.8,53.379427430684686,48.390750468494105,NaN,NaN,21.48789839161801,24.245415630174854
2010-01-12T09:30:00-05:00,31.82001,31.91,31.61,31.73,5791359,6028209.15,58.326939143286204,60.67882589447191,NaN,NaN,121.95415134781612,123.17517502889662,-0.015984978047008602,0.27591924682690205,0.29190422487391066,65584771,64774416.6,57.3098514163188,48.77684428531701,NaN,NaN,20.698327442816435,23.738688746266508
2010-01-13T09:30:00-05:00,31.81,32.25,31.8,32.14999,8056066,6198690.4,64.23105968757699,60.58640662147485,NaN,NaN,223.7904161729814,157.10996208741577,0.005671833079736399,0.2989940162235811,0.29332218314384473,73640837,68142784.6,61.60487491950849,49.6574177396515,NaN,NaN,21.975358463228893,23.486784420118276
2010-01-14T09:30:00-05:00,32.21001,32.45,32.09,32.44,7801316,6380175.35,67.64033830757094,60.92657466362971,NaN,NaN,244.06852414732379,187.23578725278304,0.03478217419984031,0.3367999008936451,0.3020177266938048,81442153,71848476.8,65.6941014620476,50.963214788520666,NaN,NaN,24.20989004553842,23.590085223749725
2010-01-15T09:30:00-05:00,32.32001,32.5,32.03,32.22,9692305,6561307.8,62.75390925759905,60.917712059358,NaN,NaN,174.58005828010508,195.6270579989445,0.03441130900247924,0.3450318629469038,0.31062055394442456,71749848,72758747.8,66.63415641253673,52.12902363126078,NaN,NaN,24.421237348527278,23.70882124157509
2010-01-19T09:30:00-05:00,32.33,33.005,32.33,33,17753696,6627595.55,70.80639782610284,61.2991199360606,NaN,NaN,240.76567350122403,201.03176468989008,0.07932086968143048,0.40977164104621266,0.3304507713647822,89503544,76384230.6,70.14333566600234,53.22415675312012,NaN,NaN,27.67250628817846,24.27506196251843
2010-01-20T09:30:00-05:00,33.11,33.16,32.47,32.72,16706113,6945097.5,65.34492942542094,61.37660480907965,NaN,NaN,192.34152131566867,215.10923868346057,0.08242957873802259,0.43348774478731045,0.35105816604928786,72797431,77826762.6,71.43083008690999,54.4830407688719,NaN,NaN,28.239420452080843,24.841398889598775
2010-01-21T09:30:00-05:00,32.71001,32.87,31.98,32.00999,15058406,7239273.85,53.97580174382188,60.83820258821545,NaN,NaN,84.62173199111456,187.2755018470872,0.031545252847175465,0.3904897321082572,0.35894447926108175,57739025,74646400.2,64.79657787530095,55.51280012477657,NaN,NaN,24.275685685995228,24.76058271765541
2010-01-22T09:30:00-05:00,31.91,32.22501,31.60001,31.66,13220941,7702439.4,49.41203110097133,60.750840415724255,NaN,NaN,-0.8345240286998725,138.29489221188248,-0.02760968356880522,0.32443237480007525,0.3520420583688805,44518084,67261586.4,52.58399596968116,55.90226679707374,NaN,NaN,19.43038246499983,23.999125538704615
2010-01-25T09:30:00-05:00,31.98,31.98,31.63,31.66,7485566,7903848.65,49.41203110097134,59.96991830837209,NaN,NaN,-16.771963852922553,100.02448778527696,-0.06644900670450521,0.268980799988249,0.3354298066927542,44518084,61815233.6,45.73735753978567,55.911518922545504,NaN,NaN,15.849441384549543,22.83488494525389
2010-01-26T09:30:00-05:00,31.53999,31.64,31.31,31.48,9292527,8258553.9,47.03969903600311,59.48687751388583,NaN,NaN,-70.53385520329667,37.76458204437283,-0.1018546042768913,0.20811155134664006,0.30996615562353136,35225557,50959636.2,35.746729990955586,55.54411410266487,NaN,NaN,12.202001482059483,21.315901593368974
2010-01-27T09:30:00-05:00,31.37,31.75,31.33,31.7,13239723,8593349.6,50.18755935582511,58.87374210654973,NaN,NaN,-48.657689525089545,-10.43526012377881,-0.10749277648551203,0.17560018501664132,0.28309296150215335,48465280,46093206,32.33669537207386,54.9726671656186,NaN,NaN,10.234610247098262,19.732859972473157
2010-01-28T09:30:00-05:00,31.8,31.84,31.41,31.5,12893016,8730447.85,47.42768726682561,57.9507002533295,NaN,NaN,-49.93907041197371,-37.34742060439647,-0.1207361618854243,0.13217275914537296,0.25290892103079726,35572264,41659853.8,29.569307455658688,53.990111134883115,NaN,NaN,7.745758040197508,18.02041683929092
2010-01-29T09:30:00-05:00,31.60001,31.69,31.28,31.28,11901914,9143696.7,44.527045312508704,56.76835710809117,NaN,NaN,-80.28257033786142,-53.23702986622878,-0.13905327857086092,0.07909232281722112,0.21814560138808203,23670350,37490307,27.210701230172717,52.44128163054551,NaN,NaN,4.768558529747455,16.127294223641854
2010-02-01T09:30:00-05:00,31.33,31.545,31.2,31.46001,6471172,9291708.55,47.36369809944686,55.60350904742364,NaN,NaN,-86.32892727224947,-67.14842255009417,-0.1337456639541484,0.05096352144539651,0.18470918539954492,30141522,34614994.6,25.688957121222856,50.46339089415538,NaN,NaN,3.162652118871544,14.275202494388953
2010-02-02T09:30:00-05:00,31.55,32.12,31.38,32.11,9894023,9507367.3,56.09423843246809,55.44403042522235,NaN,NaN,0.21672986761477306,-52.99830553591189,-0.08361090030983048,0.0801955600122568,0.1638064603220873,40035545,35576992.2,27.156750224705917,48.30959795189732,NaN,NaN,4.594979519604684,12.8923134979912
2010-02-03T09:30:00-05:00,32,32.03,31.58,31.67999,5967340,9534307.55,50.16604725995213,54.43938668039201,NaN,NaN,-25.40444062202791,-48.347655755299556,-0.07674000602373643,0.06788145279241675,0.14462145881615318,34068205,32697577.2,25.53120957365465,45.73290757005061,NaN,NaN,3.8087012784509273,11.594654609485447
2010-02-04T09:30:00-05:00,31.42,31.53,30.86,30.88,10027637,9791512.65,41.40014718649775,52.565087314601065,NaN,NaN,-153.24966809844966,-69.00977529259474,-0.12078260378565578,-0.0063567959159165355,0.11442580786973924,24040568,30391238,24.27769032971416,42.77459248916965,NaN,NaN,-0.11939330924255549,9.921219192524305
2010-02-05T09:30:00-05:00,30.78999,30.98,30.27,30.83,14325820,10202068.9,40.91888629968622,51.00544281760729,NaN,NaN,-199.6381714196064,-92.88089550894374,-0.14629010858095298,-0.068436827856452,0.07785328072450098,9714748,27600117.6,22.81763182911581,39.64484073321102,NaN,NaN,-3.250644825603518,8.039524332791759
2010-02-08T09:30:00-05:00,30.85001,30.94501,30.59,30.67999,6971445,10336401.1,39.43764916541345,48.76481791327234,NaN,NaN,-163.76725508957205,-108.36856107240824,-0.16489201044817342,-0.1282617323357158,0.03663027811245762,2743303,22120473.8,20.243625424269922,36.08057571594442,NaN,NaN,-6.220107498807527,6.002434071134719
2010-02-09T09:30:00-05:00,31.07001,31.2,30.67999,30.92,8632859,10559162.2,42.99331071397742,47.1682737195978,NaN,NaN,-115.23287288383106,-131.45848162269743,-0.15292448426156927,-0.15452532721450396,-0.0016008429529346946,11376162,16388597.2,17.96116738585529,32.26131409444051,NaN,NaN,-7.541409145189741,4.06759932594551
2010-02-10T09:30:00-05:00,30.95,30.95,30.49001,30.73,7047223,10621955.4,40.943959124761015,46.23742781823631,NaN,NaN,-125.20397075588757,-151.41838764946934,-0.1495176780823223,-0.18849794055583757,-0.03898026247351527,4328939,10440744,15.951335832017492,28.772368234205974,NaN,NaN,-9.258158909662916,2.1639195780014493
2010-02-11T09:30:00-05:00,30.53,31.03999,30.49001,30.94,4335547,10435929.45,44.11471931700777,45.859048405096054,NaN,NaN,-100.49772262469442,-140.8679985547183,-0.12578730920464531,-0.1962143989793219,-0.0704270897746766,8664486,7365527.6,15.015773083578793,26.088923742341517,NaN,NaN,-9.727051005246093,0.465209494680372
2010-02-12T09:30:00-05:00,30.71001,30.92999,30.5,30.87,6966723,10394199.8,43.280548007929035,45.42108532702161,NaN,NaN,-97.30520933205287,-120.4014061372076,-0.1081447612566894,-0.20560804134553834,-0.09746328008884894,1697763,5762130.6,14.537030955763115,23.860328986339905,NaN,NaN,-10.349529864884007,-1.079753270971682
2010-02-16T09:30:00-05:00,31.17999,31.17999,30.82001,31.14,5786055,10198887.3,47.41117168729501,45.44761908782817,NaN,NaN,-55.65102445472382,-98.77816001023794,-0.07329830355880376,-0.18908615953735364,-0.11578785597854988,7483818,6710233.6,16.23763043284835,22.46682187504653,NaN,NaN,-9.675282062167852,-2.3076859554282776
2010-02-17T09:30:00-05:00,31.25,31.53999,31.2,31.38,10161539,9819279.45,50.83839068320786,45.494107039784076,NaN,NaN,-3.659098253656179,-76.46340508420296,-0.0312429456723404,-0.15484153806897538,-0.12359859239663498,17645357,7964072.6,18.54601073947019,21.4817729727177,NaN,NaN,-8.086341066658026,-3.1332081141753845
2010-02-18T09:30:00-05:00,31.39,31.55,31.31,31.53,5326504,9250299,52.904222825216,45.885288151097676,NaN,NaN,22.92410540638381,-46.837789851748674,0.007453819088521232,-0.11428131853598344,-0.12173513762450468,22971861,11692657,25.151827104680237,21.16623866193353,NaN,NaN,-6.152347822041231,-3.564513786727648
2010-02-19T09:30:00-05:00,31.42999,31.60001,31.345,31.53,4369234,8715840.4,52.904222825216,46.483657973433914,NaN,NaN,37.8972811720915,-19.158789092391505,0.032427296058773314,-0.08120101755103803,-0.11362831360981135,22971861,14554132,29.853483706689772,21.355008838827597,NaN,NaN,-4.572878113114692,-3.7085658333543687
2010-02-22T09:30:00-05:00,31.64,31.64,31.24001,31.44,6989660,8404276.35,51.40120928608221,46.77205162962216,NaN,NaN,33.25466687679892,6.953186149378854,0.04167263306597069,-0.06153752227734799,-0.10321015534331868,15982201,17411019.6,34.291406623380155,21.96946951755312,NaN,NaN,-3.6279453918281157,-3.697048627422047
2010-02-23T09:30:00-05:00,31.35001,31.47,31.08,31.14,4313801,8245688.1,46.64420365651055,46.09704914562519,NaN,NaN,-3.349199067972555,17.413551226729105,0.02707853104394023,-0.0693619915383934,-0.09644052258233363,11668400,18247936,35.57724547781427,22.570933464203716,NaN,NaN,-4.085710661971791,-3.7525717752148675
2010-02-24T09:30:00-05:00,31.23,31.42999,31.12,31.37,4352047,7998664.1,50.431727513158066,46.11602630656847,NaN,NaN,14.931520394957303,21.131674956451796,0.03206902180237095,-0.056354245329369945,-0.0884232671317409,16020447,17922954,35.2884707884144,23.26788069382942,NaN,NaN,-3.4199647481884594,-3.705056485639666
2010-02-25T09:30:00-05:00,31.14999,31.39,31,31.39,5437891,7608572.5,50.75905838184865,46.784519963379246,NaN,NaN,8.867082359749741,18.320270347124982,0.035598344937733034,-0.043925335959574596,-0.07952368089730763,21458338,17620249.4,35.00347244750803,24.03400798795755,NaN,NaN,-2.78098707358904,-3.573046569632434
2010-02-26T09:30:00-05:00,31.44,31.565,31.32001,31.39999,8794422,7403642.8,50.9333553032761,47.49983917792138,NaN,NaN,49.69040058354842,20.678894229416365,0.03730687292006196,-0.03289008974723018,-0.07019696266729214,30252760,19076429.2,37.61370587083831,25.090870419509162,NaN,NaN,-2.201690000054304,-3.3771384882641295
2010-03-01T09:30:00-05:00,31.39999,31.81,31.39999,31.7,6249891,7121041.65,55.97339014095931,48.68096353331752,NaN,NaN,92.41150470387919,32.51026179483241,0.05620796686569873,0.00006299591483127642,-0.05614497095086746,36502651,23180519.2,44.39189724534415,26.815746978157318,NaN,NaN,-0.28792560578154586,-2.935822362195189
2010-03-02T09:30:00-05:00,31.75,31.94,31.71001,31.81,5321039,7063535,57.68946918909052,49.73068913868274,NaN,NaN,121.35516115585004,57.451133839596935,0.07264009787639303,0.03465515139462383,-0.0379849464817692,41823690,29211577.2,52.55052890453855,29.286415658063266,NaN,NaN,1.8206356942569173,-2.256328354130602
2010-03-03T09:30:00-05:00,31.96001,31.96001,31.63,31.67999,5066762,6822171.95,54.962637302387144,50.73202329422747,NaN,NaN,110.97711885282625,76.66025353117072,0.07118089232131837,0.05099116891987876,-0.020189723401439607,36756928,33358873.4,57.2007310419662,32.23280103020246,NaN,NaN,2.92006187661199,-1.5168440354530888
2010-03-04T09:30:00-05:00,31.72,31.74001,31.46001,31.58,10135582,7030584.05,52.89194370163616,51.35896789312949,NaN,NaN,79.7315643395179,90.83314992712435,0.060337808201819026,0.05523253685083418,-0.005105271350984849,26621346,34391475,58.29661405738921,35.324289671188914,NaN,NaN,3.316949221771114,-0.826302141563917
2010-03-05T09:30:00-05:00,31.64999,32.02,31.61,32.02,5832148,6820809.6,60.028371994060635,52.55524103499604,NaN,NaN,126.9469161703288,106.28445304448044,0.07850488139589243,0.09302583039388068,0.014520948997988259,32453494,34831621.8,58.78109173126987,38.484579726582254,NaN,NaN,5.7939999083385905,0.11945529413644118
2010-03-08T09:30:00-05:00,32.03,32.03,31.8201,31.83,4370672,6323052.2,56.07778032327425,53.17428450899456,NaN,NaN,119.31519840265462,111.66519178423553,0.0735185544677382,0.10641914208266101,0.03290058761492281,28082822,33147656,56.09602584279431,41.331607970149825,NaN,NaN,6.762920824532236,1.0685217984786974
2010-03-09T09:30:00-05:00,31.73,31.89,31.69,31.81,4838883,6216424.1,55.662511379195195,53.51886455870794,NaN,NaN,92.2606769281468,105.84629493869485,0.06496295558805998,0.11410428209999779,0.049141326511937804,23243939,29431705.8,50.60296322352095,43.62139029043917,NaN,NaN,7.438512772312228,1.9785205090263447
2010-03-10T09:30:00-05:00,31.83,31.94,31.78,31.83,4063399,5987951.1,56.013299363997,53.74094145433515,NaN,NaN,96.60321584260605,102.97151433665083,0.057023347664444834,0.12042051109249385,0.06339716342804902,27307338,27541787.8,48.0270787210299,45.25533683446414,NaN,NaN,8.093601117919658,2.852103453153961
2010-03-11T09:30:00-05:00,31.82001,32.08,31.64999,32.08,6034457,5937312.8,60.24715927856247,54.265436915288475,NaN,NaN,107.92863667416921,108.6109288035811,0.06443413323939992,0.14393982997729893,0.079505696737899,33341795,28885877.6,49.977315918162596,46.69275342099792,NaN,NaN,9.875159680942886,3.85539719998095
2010-03-12T09:30:00-05:00,32.13,32.13,31.75999,31.84,4899613,5965516.1,54.79450432802464,54.50781513257008,NaN,NaN,92.55558626726997,101.73266282296932,0.04966024875314587,0.14158100767933135,0.09192075892618548,28442182,28083615.2,48.80023834042887,47.72909854364425,NaN,NaN,9.883598705595732,4.7165688436402045
2010-03-15T09:30:00-04:00,31.84,32.05,31.78,32.05,5500039,5892181.9,58.34682594919139,55.34371672490442,NaN,NaN,98.72862621499979,97.61534838543835,0.05036067726426016,0.1548716055065107,0.10451092824225053,33942221,29255495,50.62939913668277,48.80425237642057,NaN,NaN,10.934108184970812,5.604788749544577
2010-03-16T09:30:00-04:00,32.05,32.16,31.92999,32.14,5493980,5877578.15,59.80464885153389,56.01321110621698,NaN,NaN,120.55118465072208,103.2734499299534,0.05295048592638947,0.17069903565023736,0.11774854972384789,39436201,32493947.4,55.37411214219359,50.238941044547666,NaN,NaN,12.231443841051247,6.551453762616958
2010-03-17T09:30:00-04:00,32.12,32.23,32,32.14999,11159637,5927483.05,59.97211497735461,56.67128657732455,NaN,NaN,121.11732771420927,108.17627230427406,0.051362023264017564,0.18195107880386985,0.13058905553985228,50595838,37151647.4,61.15616797107811,52.106990724802664,NaN,NaN,13.343512894313431,7.521747924287883
2010-03-18T09:30:00-04:00,32.14999,32.46001,32.07001,32.37,7126250,6017470.35,63.571694199008526,57.57402506987687,NaN,NaN,151.19574254978463,116.82969347939714,0.060523892234083165,0.20624392083245624,0.14572002859837307,57722088,42027706,66.10709268376877,54.14223264001198,NaN,NaN,15.36076501840322,8.641607509161503
2010-03-19T09:30:00-04:00,32.34,32.45,32.13,32.25,8386637,6218340.5,60.38220197634461,57.88894020097582,NaN,NaN,131.85876657095002,124.69032954013315,0.0541069904243722,0.21335376662883832,0.15924677620446612,49335451,46206359.8,69.67429189816178,55.9481179723561,NaN,NaN,16.192949164084038,9.720370602721864
2010-03-22T09:30:00-04:00,32.3,32.6882,32.299,32.46001,7909168,6264315.9,63.80477306920261,58.32574762098382,NaN,NaN,167.77148895870158,138.4989020888735,0.05919914795771278,0.23324571115160708,0.1740465631938943,57244619,50866839.4,73.07766920706646,57.41434227967953,NaN,NaN,17.919270933890207,10.891642078603056
2010-03-23T09:30:00-04:00,32.42,32.62,32.35001,32.62,5713414,6334296.55,66.20035912820748,59.12844203711385,NaN,NaN,165.03971096437903,147.39660735160487,0.06791093523033817,0.258935232231817,0.19102429700147885,62958033,55571205.8,76.00501990437552,58.75750576985162,NaN,NaN,20.10779140061994,12.208234838891181
2010-03-24T09:30:00-04:00,32.56,32.60001,32.27,32.27,6314973,6432442.85,57.270380294071686,59.441187508002095,NaN,NaN,112.72393025934582,145.7179278606322,0.04573359688656156,0.2481912931096808,0.20245769622311924,56643060,56780650.2,76.70626632212631,60.07248093161855,NaN,NaN,19.326393067368468,13.225114585816508
2010-03-25T09:30:00-04:00,32.50999,32.50999,32.11,32.14,5120512,6416573.9,54.33842642410678,59.03476282443397,NaN,NaN,69.86531668388302,129.45184268745186,0.01929377567215182,0.22657491581330902,0.2072811401411572,51522548,55540742.2,74.30865971173009,61.181592930222855,NaN,NaN,17.77247323777956,13.874737250382658
2010-03-26T09:30:00-04:00,32.22,32.22,31.84,31.89999,6810906,6317398.1,49.31839255599673,58.55194941248557,NaN,NaN,-10.623407856622473,100.95540780193737,-0.015496223723825003,0.18791086048637595,0.20340708421020096,44711642,54615980.4,72.48877880084655,62.35250385579802,NaN,NaN,14.841682414900733,14.01287227388524
2010-03-29T09:30:00-04:00,31.99001,32.24001,31.98,32.24001,4818676,6245837.35,55.579394936204096,58.5460125237005,NaN,NaN,32.6578157212064,73.93267315443836,-0.01664472520550292,0.1826011777033223,0.1992459029088252,49530318,53073120.2,69.43347890664359,63.697540690306774,NaN,NaN,14.275905564269694,14.050448458225876
2010-03-30T09:30:00-04:00,32.24001,32.28,32.11,32.24001,3440007,6151785.75,55.579394936204096,58.515019350286714,NaN,NaN,44.90804042368474,49.9063390462995,-0.018308526548799497,0.17636024472282585,0.19466877127162535,49530318,50387577.2,64.34934033836615,64.8634165201165,NaN,NaN,13.83203256688638,14.01924618803452
2010-03-31T09:30:00-04:00,32.19,32.28,31.99001,32.13,4834344,6140164.85,53.11718213876826,58.00573526887285,NaN,NaN,15.73239686042254,30.50803236651485,-0.027186941007763504,0.16068509501192096,0.18787203601968447,44695974,47998160,60.13054777682239,65.58864736716365,NaN,NaN,12.725696590614419,13.834453388403077
2010-04-01T09:30:00-04:00,32.3,32.37,32.13,32.31,5602828,5913527.15,56.51192568031557,58.12840822260791,NaN,NaN,55.67306812606733,27.66958265495172,-0.02155218881885676,0.1609317999961135,0.18248398881497027,50298802,47753410.8,59.69880637334531,66.36711651237196,NaN,NaN,12.788511155987015,13.685033069486497
2010-04-05T09:30:00-04:00,32.34,32.42,32.17,32.22,4655598,5854699.65,54.39123714395376,57.84586616509093,NaN,NaN,50.23961766633622,39.84218775954345,-0.024297895395441638,0.1521116195706682,0.17640951496610985,45643204,47939723.2,59.934638391919215,67.03177645917457,NaN,NaN,12.22013481828549,13.475761890743497
2010-04-06T09:30:00-04:00,32.13,32.2605,32.12,32.2,3978807,5835106.4,53.9071148962436,57.42461373971305,NaN,NaN,15.947843840547172,36.5001933834116,-0.02762976040816026,0.14187231445590953,0.1695020748640698,41664397,46366539,56.90654293683658,67.14123580164906,NaN,NaN,11.618648953724412,13.210460042597914
2010-04-07T09:30:00-04:00,32.2,32.2,31.91,32.06,4733117,5829818.1,50.51749767518147,56.749283932414976,NaN,NaN,-49.79018650047921,17.560547998578812,-0.03874950214848216,0.12106519717846709,0.15981469932694925,36931280,43846731.4,52.344733359183365,66.51184761508514,NaN,NaN,10.14034464769225,12.771872129039963
2010-04-08T09:30:00-04:00,31.96001,32.02,31.83,31.94,4562156,5854755.95,47.7462114736144,55.618892309172544,NaN,NaN,-111.32684221613242,-7.851299816732177,-0.05280294767891727,0.09381101472830267,0.14661396240721994,32369124,41381361.4,48.26781514541937,65.23761350520304,NaN,NaN,8.083162013709153,12.10205639827842
2010-04-09T09:30:00-04:00,31.99001,32.12,31.94,32.08,4154965,5760781.35,51.11552900748713,54.95698709711129,NaN,NaN,-62.51866528831314,-31.489646499608273,-0.05124553588150668,0.08255704255533658,0.13380257843684326,36524089,38626418.8,44.131419821661,63.413122642595845,NaN,NaN,7.240557077485771,11.407556495308041
2010-04-12T09:30:00-04:00,32.03999,32.17999,31.98,31.99001,4513461,5741473.75,48.93147503759984,53.89460866628252,NaN,NaN,-67.67450893935768,-55.07247182074705,-0.054545808802726525,0.0656203174334351,0.12016612623616163,32010628,35899903.6,40.43795759294925,61.08171467015891,NaN,NaN,5.911428548796968,10.622395360092174
2010-04-13T09:30:00-04:00,31.92999,32.08501,31.8391,32.02,7279141,5830428.85,49.70277170829337,52.71620956486009,NaN,NaN,-103.63406675100596,-78.98885393905769,-0.05293661440003161,0.053995358236122115,0.10693197263615373,39289769,35424978,39.81291150573165,58.49656407025577,NaN,NaN,5.007342977872794,9.82024501977512
2010-04-14T09:30:00-04:00,32.03999,32.03999,31.78999,31.91,6331129,5872286.3,46.90453846149946,51.97579229110493,NaN,NaN,-126.19888844384697,-94.27059432773123,-0.05714779912619257,0.03549722372841302,0.09264502285460559,32958640,34630450,38.73424731916661,55.784276998615795,NaN,NaN,3.456567975741234,8.911148299198851
2010-04-15T09:30:00-04:00,31.92999,31.95,31.72501,31.82001,5119531,5570281,44.68797470984663,51.286474311514915,NaN,NaN,-143.05903655536915,-100.61703319557857,-0.06337908462182412,0.013421167077325435,0.07680025169914956,27839109,33724447,37.48701239481367,53.15415933312176,NaN,NaN,1.5111505986684628,7.8540057705516535
2010-04-16T09:30:00-04:00,31.78,31.87,31.47501,31.63,8929887,5660462.85,40.35190467353415,50.64601089133902,NaN,NaN,-183.10799673464248,-124.73489948484443,-0.07678846484243604,-0.019185329353895497,0.05760313548854054,18909222,30201473.6,33.03287212367235,50.335880284752186,NaN,NaN,-1.4816134727157781,6.520345878656306
2010-04-19T09:30:00-04:00,31.63,31.92,31.52,31.89,11269977,5804629.85,47.8137054611032,50.09131878597467,NaN,NaN,-120.25182197467298,-135.2503620919075,-0.065100390566075,-0.023772352719053202,0.04132803784702179,30179199,29835187.8,32.599176449413235,47.7048586806643,NaN,NaN,-1.98562111865484,5.305207736183285
2010-04-20T09:30:00-04:00,32,32.05,31.85001,31.96001,5741227,5696232.8,49.64054135360234,49.667114958645975,NaN,NaN,-49.731772603159875,-124.46990326233829,-0.05027076718685796,-0.02151042113655066,0.0287603460503073,35920426,29161319.2,31.772695892053264,45.377955505927666,NaN,NaN,-1.8672358178859878,4.280572942744818
2010-04-21T09:30:00-04:00,31.98,31.98,31.28,31.39999,13931348,6107129.5,38.13931590600571,48.5972673705915,NaN,NaN,-188.51318092853205,-136.9327617592753,-0.07434194054211689,-0.06416707962733881,0.010174860914778077,21989078,26967406.8,29.17896649639657,43.16712827161153,NaN,NaN,-5.714163569736773,2.8527534409617332
2010-04-22T09:30:00-04:00,31.24001,31.25,30.84,31.03999,11010043,6341883,32.867524165239175,46.90838154808604,NaN,NaN,-299.7514111628165,-168.2712366807648,-0.10859927953672845,-0.12557423850613247,-0.01697495896940403,10979035,23595392,25.70558164425512,40.73904079096223,NaN,NaN,-10.957497982819262,0.8798603804215912
2010-04-23T09:30:00-04:00,31.03999,31.38,30.84,31.35001,10974809,6634597.85,40.49546485728568,45.91582638475261,NaN,NaN,-199.4285116589534,-171.53533966562696,-0.10443865266104996,-0.14752327479571647,-0.04308462213466652,21953844,24204316.4,27.386546679282603,38.41417709720247,NaN,NaN,-12.532876625144832,-1.0362449060878978
2010-04-26T09:30:00-04:00,31.39999,31.48,30.99001,31.02,7321484,6660126.75,35.82858736698081,44.624502989805265,NaN,NaN,-164.14232941279298,-180.31344115325095,-0.11702367855152525,-0.18936422032407307,-0.07234054177254783,14632360,21094948.6,24.35611863109476,36.08914678964948,NaN,NaN,-15.559422192765245,-3.110984518470376
2010-04-27T09:30:00-04:00,30.95,31.17999,30.61,30.66,10691977,6953791.8,31.556250483920124,43.27012819042945,NaN,NaN,-192.4895044119298,-208.86498751500494,-0.14109199842868594,-0.24870553980840526,-0.10761354137971932,3940383,14698940,19.561177111593324,33.7474642005359,NaN,NaN,-19.662850722536344,-5.4755368333369425
2010-04-28T09:30:00-04:00,30.88,30.99001,30.60001,30.86,10333270,7298454.95,36.11403160981558,42.439258200158115,NaN,NaN,-157.13250324958165,-202.58885197921487,-0.13503665446707,-0.2764093594635568,-0.14137270499648683,14273653,13155855,18.60932109893325,31.629000340072615,NaN,NaN,-21.243080815359217,-7.728043116482981
2010-04-29T09:30:00-04:00,31.02,31.465,31.02,31.28,10236383,7568556.9,44.475930964811475,41.96500119710985,NaN,NaN,-72.0458584569312,-157.0477414380378,-0.09607015084958287,-0.2614603935584654,-0.16539024270888253,24510036,15862055.2,25.459809367955657,30.29531387909366,NaN,NaN,-19.461952578200005,-9.40431589672827
2010-04-30T09:30:00-04:00,31.37,31.42999,30.88,30.88,12506785,7913754.75,39.211961027109865,41.27075019636057,NaN,NaN,-91.31634329373459,-135.42530776499407,-0.09062977948733972,-0.2786774670680572,-0.18804768758071747,12003251,13871936.6,23.868771064566047,29.111800555637718,NaN,NaN,-19.949253600231366,-10.910735568657284
2010-05-03T09:30:00-04:00,30.88,31.16,30.86,31.03,5629629,7962456.3,41.98493069706169,40.719475838415455,NaN,NaN,-87.71877389284037,-120.14059666100351,-0.0711818528704749,-0.2770250036688111,-0.2058431507983362,17632880,14472040.6,25.383013591048922,28.081093561731812,NaN,NaN,-19.33831031700776,-12.114674818421637
2010-05-04T09:30:00-04:00,30.89,31.14,30.72,30.85001,14483320,8487681.95,39.64777519173213,40.201135604860646,NaN,NaN,-93.95819458470909,-100.4343346955594,-0.06487070748277762,-0.28693153515180825,-0.22206082766903062,3149560,14313876,25.24051901661062,27.117255825834953,NaN,NaN,-19.64518670880562,-13.190462231333635
2010-05-05T09:30:00-04:00,30.49001,31.00999,30.39999,30.95,9627695,8732410.85,41.59292260119036,39.98006045424234,NaN,NaN,-100.43940518065381,-89.09571508177382,-0.04910875975765694,-0.2834467773661018,-0.23433801760844486,12777255,14014596.4,24.955045371183317,26.22211532414707,NaN,NaN,-19.25533710514042,-14.056872927591748
2010-05-06T09:30:00-04:00,30.85001,30.94,28.53,30.12,21647696,9586687.85,32.28976586284651,39.404193396336076,NaN,NaN,-206.1121941742222,-115.90898222523201,-0.08748735994166079,-0.34369721753552085,-0.25620985759386006,-8870441,7338501,19.623295314332367,25.264288409194215,NaN,NaN,-22.32650119455231,-15.238248394300399
2010-05-07T09:30:00-04:00,30.14,30.14,29.34,29.72,18182032,10288041.2,28.93126887016176,38.05544792555455,NaN,NaN,-197.75633033104089,-137.19697963269329,-0.13014734020734336,-0.4188940328530393,-0.2887466926456959,-27052473,-472643.8,15.461053261803244,24.040136752936352,NaN,NaN,-26.070742141526544,-16.78574750104699
2010-05-10T09:30:00-04:00,30.24001,30.83,30.24001,30.52,13168461,10720791.2,41.93845451144367,37.505298865400356,NaN,NaN,-84.16351874576101,-136.4859286032774,-0.09637667121067406,-0.4092175316590385,-0.31284086044836446,-13884012,-6776022.2,13.054670622610573,22.703134947976157,NaN,NaN,-24.162066505390516,-17.83950735881035
2010-05-11T09:30:00-04:00,30.31,30.75999,30.24001,30.46001,8829207,10798294.5,41.327626701668954,37.733035350804876,NaN,NaN,-82.68214178014054,-134.2307180423637,-0.07113395701415481,-0.40175830671605794,-0.33062434970190313,-22713219,-11948578,11.476188169217707,21.438650781749093,NaN,NaN,-22.98387887117381,-18.574417574862274
2010-05-12T09:30:00-04:00,30.72,30.73,30.42,30.71001,6115777,10787526.9,44.92749833088051,38.59446207692211,NaN,NaN,-57.11980673241932,-125.5667983527168,-0.032614698178423496,-0.3713927224249325,-0.338778024246509,-16597442,-17823517.4,9.997584399440711,20.31665097854807,NaN,NaN,-20.787824576352154,-18.890618575075113
2010-05-13T09:30:00-04:00,30.60001,30.7,30.38,30.38,6874547,10875277.7,41.323212612835185,38.653586916604226,NaN,NaN,-69.3963188089298,-98.2236232796583,-0.024733749266934058,-0.36969521083017653,-0.3449614615632425,-23471989,-20743827,9.35253402216101,19.028507217325096,NaN,NaN,-20.230801330190037,-19.082073254377246
2010-05-14T09:30:00-04:00,30.21001,30.35001,29.73,29.97,13544078,11105987.25,37.31765685837768,38.75994902313256,NaN,NaN,-127.38537596298538,-84.1494324060472,-0.04151783352892402,-0.3968587534743975,-0.35534091994547345,-37016067,-22736545.8,8.929172324209134,17.926582481118977,NaN,NaN,-21.148210483911186,-19.377235715739236
2010-05-17T09:30:00-04:00,30.03999,30.09,29.52,29.97,11950984,11140037.6,37.31765685837768,39.17147804987953,NaN,NaN,-134.0177373399062,-94.12027612487626,-0.046621763605508515,-0.4136181244523591,-0.3669963608468506,-37016067,-27362956.8,8.02132792968628,17.10230753955419,NaN,NaN,-21.850920347249524,-19.73061923452642
2010-05-18T09:30:00-04:00,30.17,30.22,29.7,29.73,11648254,11435388.95,35.01355505578661,39.0928725817346,NaN,NaN,-116.5728031329024,-100.89840839542862,-0.059347221758773716,-0.4411803880453178,-0.38183316628654407,-48664321,-32553177.2,7.143809315890849,16.28334241219402,NaN,NaN,-23.156695247509333,-20.22005866495255
2010-05-19T09:30:00-04:00,29.53999,29.905,29.48,29.66,12608719,11369257.5,34.34743412886078,38.36940852202384,NaN,NaN,-130.0785076832815,-115.49014858560106,-0.06519834934065605,-0.4633311029623641,-0.3981327536217081,-61273040,-41488296.8,5.9392206347987155,14.88901464553995,NaN,NaN,-24.406930804047075,-20.818183256251768
2010-05-20T09:30:00-04:00,29.25,29.39999,28.72,28.73,15949340,11616222.35,26.99847682355329,37.49701679319838,NaN,NaN,-192.91931425680866,-140.19474767517684,-0.12116864457870624,-0.5495935593450909,-0.42842491476638467,-77222380,-52238375,4.874300253602684,13.53226673047114,NaN,NaN,-28.161801903826884,-21.867271634476783
2010-05-21T09:30:00-04:00,28.42,28.88,28.25,28.8,16465016,11890732.7,28.242978830941297,36.515448802761206,NaN,NaN,-187.30892661515227,-152.1794578056102,-0.14152477610255432,-0.6053308848945775,-0.4638061087920232,-60757364,-56986634.4,4.4912445935786565,12.03999751636612,NaN,NaN,-30.684567838063387,-23.126885377846296
2010-05-24T09:30:00-04:00,28.67999,29.03999,28.52,28.73,10310836,12040200.3,27.733814502821616,35.66445161069617,NaN,NaN,-148.61103889479796,-155.09811811658855,-0.14710344706217104,-0.6476854176197371,-0.500581970557566,-71068200,-63797061,4.005077965727679,10.523180298445912,NaN,NaN,-32.85248385928652,-24.516256589480616
2010-05-25T09:30:00-04:00,28.14,28.61,27.97,28.61,16411637,12326183.3,26.840496863634456,34.61070691515647,NaN,NaN,-159.09364149234193,-163.60228578847645,-0.14598305355615315,-0.6830607875027574,-0.5370777339466043,-87479837,-71560164.2,3.5353021070801844,8.993198636724259,NaN,NaN,-34.898472090229234,-25.999430232444706
2010-05-26T09:30:00-04:00,28.78,28.89999,28.39999,28.42999,12620332,12440536.4,25.512929110918066,34.12664714716158,NaN,NaN,-125.9382504723032,-162.77423434628082,-0.14421952220177348,-0.7173521366988211,-0.5731326144970477,-100100169,-79325590,3.138708830324532,7.815728173580843,NaN,NaN,-37.01051894088375,-27.572442905078855
2010-05-27T09:30:00-04:00,28.67,29.00999,28.67,29.00999,9438449,12400639.7,36.42417178868672,34.66185449848479,NaN,NaN,-88.73792890700304,-141.93795727631968,-0.09331456358961854,-0.6897758189840708,-0.5964612553944523,-90661720,-82013458,3.0127275492637295,6.92656205125659,NaN,NaN,-35.53599848181552,-28.710093701755522
2010-05-28T09:30:00-04:00,29,29.16,28.77,28.87,13301496,12440375.25,35.08816792335192,34.17254831362109,NaN,NaN,-75.87730920493213,-119.65163379427565,-0.06001262945291019,-0.67147704221059,-0.6114644127576798,-103963216,-90654628.4,2.645145813456679,6.183024564888454,NaN,NaN,-34.73163067725329,-29.570313269683776
2010-06-01T09:30:00-04:00,28.75999,29.00999,28.5,28.55,11633609,12740574.25,32.182319115125864,33.51931205743945,NaN,NaN,-87.40435780894678,-107.41029757710541,-0.050840709188424094,-0.6750152992432099,-0.6241745900547858,-115596825,-99560353.4,2.329667569968393,5.529701664942075,NaN,NaN,-34.92416594887348,-30.335149366710876
2010-06-02T09:30:00-04:00,28.8,29.2,28.56,29.17,10510172,12541916.85,42.174457336718106,33.322666272142136,NaN,NaN,-53.33342065381535,-86.2582534094001,0.002830658889721116,-0.6206362664426344,-0.6234669253323555,-105086653,-103081716.6,2.217070886158055,4.973950699707601,NaN,NaN,-31.79672838114671,-30.54394636877314
2010-06-03T09:30:00-04:00,29.17,29.42999,29.13,29.34,8442426,12482653.4,44.58537198739629,33.55567765603936,NaN,NaN,-16.79682516714156,-64.42996834836775,0.052855476595374484,-0.5573975795881374,-0.6102530561835119,-96644227,-102390528.2,3.205966693333039,4.53491017621989,NaN,NaN,-28.50014159343301,-30.251974258010264
2010-06-04T09:30:00-04:00,28.89,28.97,28.3775,28.48,11034633,11952000.25,36.33270896222362,33.48532423488549,NaN,NaN,-79.0262683559034,-62.48763623814784,0.0321196615118301,-0.5701034792937243,-0.6022231408055544,-107678860,-105793956.2,3.0427878050699633,4.114454139138521,NaN,NaN,-28.307712430756254,-29.97422256840255
2010-06-07T09:30:00-04:00,28.52,28.8,28.44,28.44,9478668,11516832.05,35.99894631565779,33.39113062469122,NaN,NaN,-76.50462929031464,-62.613100255224346,0.020376735473028984,-0.5767522214642682,-0.5971289569372972,-117157528,-108432818.6,2.9187410546868904,3.749983648067136,NaN,NaN,-28.26864141774619,-29.730568118308785
2010-06-08T09:30:00-04:00,28.45,28.55,28.16,28.50999,10570945,11386956.25,37.087962629850175,33.539302594267184,NaN,NaN,-85.90786292119924,-62.31380127767484,0.021858823794849602,-0.5698054271937352,-0.5916642509885848,-106586583,-106630770.2,5.744624480102942,3.6500418740822864,NaN,NaN,-27.902327923698078,-29.469390947650112
2010-06-09T09:30:00-04:00,28.55,28.71249,28.27499,28.38,8428602,11366926,35.86727572193588,33.64786270805826,NaN,NaN,-76.73301972048563,-66.9937210910089,0.018740324296668498,-0.5682388456177492,-0.5869791699144177,-115015185,-108616476.6,5.552817029244196,3.622441616542677,NaN,NaN,-27.96362434124125,-29.254281432448845
2010-06-10T09:30:00-04:00,28.64999,28.99001,28.64999,28.92,6967867,11409530.5,44.098480765565334,34.86929156105912,NaN,NaN,-26.074347990826777,-68.84922565574594,0.05561622596922833,-0.5174588874528823,-0.5730751134221106,-108047318,-110897094.8,5.33259309907541,3.6551768197907295,NaN,NaN,-25.42634754426022,-28.707433734136185
2010-06-11T09:30:00-04:00,28.84,29.21001,28.83,29.16,7042168,11417911.55,47.33380520303782,36.23292201620887,NaN,NaN,15.315150894404871,-49.98094180568429,0.09635468800079572,-0.45263175342111595,-0.5489864414219117,-101005150,-109562352.8,7.64124595870085,3.8801769172994574,NaN,NaN,-22.30834078480001,-27.79327759851673
2010-06-14T09:30:00-04:00,29.25,29.48,29.2,29.21001,6416383,11061526.8,48.00903623251734,37.68115213975857,NaN,NaN,68.04022738655574,-21.07197047031022,0.12503422076512583,-0.39269366546550444,-0.5177278862306303,-94588767,-105048600.6,15.174930771909246,4.678023546312427,NaN,NaN,-19.597013239488657,-26.622382690084148
2010-06-15T09:30:00-04:00,29.35001,29.73,29.34,29.71001,4921172,10710036.2,54.31551601061678,39.64365350740017,NaN,NaN,132.97468648603268,22.704539411136167,0.17308435404721312,-0.30137244367161387,-0.474456797718827,-89667595,-101664803,20.4158482469427,5.883776842016892,NaN,NaN,-15.19260011044622,-24.98955660727873
2010-06-16T09:30:00-04:00,29.62,29.86,29.55,29.82001,5576836,10406465.3,55.59174958860548,41.792140684377834,NaN,NaN,168.1549812033513,71.68213959590355,0.20547335393408234,-0.21761510530122408,-0.4230884592353064,-84090759,-95479917.8,29.045176168243344,7.734238794725379,NaN,NaN,-11.21617794128531,-23.021931083565384
2010-06-17T09:30:00-04:00,29.87,29.87,29.56,29.86,5710785,10061568.6,56.072195326329584,43.19557093706661,NaN,NaN,169.07791491238282,110.71259217654547,0.22141218394056977,-0.14632322930959418,-0.36773541325016396,-78379974,-89546449,36.19309724601272,10.104265201636021,NaN,NaN,-7.838019617916024,-20.852800874186904
2010-06-18T09:30:00-04:00,29.75999,29.75999,29.49001,29.55,6962820,9612242.6,51.42736427908533,44.362656391047565,NaN,NaN,116.29302164271277,130.90816632620704,0.20336463903835056,-0.11352961445222576,-0.3168942534905763,-85342794,-86413977.8,39.649631431147554,12.747442745756798,NaN,NaN,-6.205439444454469,-18.760320669939414
2010-06-21T09:30:00-04:00,29.86,29.92999,29.35001,29.5,7458574,9161920.5,50.697897854061424,45.68519772954296,NaN,NaN,100.09305226886376,137.31873130266865,0.18109025833856746,-0.09053143056736701,-0.27162168890593447,-92801368,-86056498,40.04876698468156,15.441664132522025,NaN,NaN,-5.062224558614503,-16.803449796893
2010-06-22T09:30:00-04:00,29.53,29.74001,29.17,29.21001,7226367,9007697.05,46.57186770626737,45.99929847022505,NaN,NaN,56.21581590266376,121.96695718599486,0.14160589622209147,-0.09461431862832015,-0.23622021485041161,-100027735,-88128526,38.46098915168619,18.030515437202606,NaN,NaN,-5.228187641124413,-15.149840917497487
2010-06-23T09:30:00-04:00,29.23,29.28,28.94,29.09,6431090,8508669.7,44.94177695975676,46.0247559682508,NaN,NaN,6.042742461536441,89.54450943763189,0.10392946468764638,-0.10630838399085363,-0.2102378486785,-106458825,-92602139.2,35.21480353400153,20.316860925821782,NaN,NaN,-5.825373644980619,-13.817774164280792
2010-06-24T09:30:00-04:00,28.96001,29.1282,28.84,28.88,10191902,8387248.2,42.160883369334876,46.44105414018732,NaN,NaN,-25.861844790914,50.556557496972545,0.06338144197522755,-0.13101104620946558,-0.19439248818469312,-116650727,-100256289.8,30.475382229704692,22.276331956152838,NaN,NaN,-7.130030280367102,-12.86238218086455
2010-06-25T09:30:00-04:00,28.88,29.16,28.78,29.00999,8439191,8337285.3,44.4521555091886,47.044854796868094,NaN,NaN,-20.56586457469089,23.18478025349182,0.04471206429179225,-0.13850240781995282,-0.18321447211174507,-108211536,-104830038.2,28.046334199108315,24.071160037897222,NaN,NaN,-7.613502378564796,-12.112542209107442
2010-06-28T09:30:00-04:00,29.03,29.2,28.78,28.96001,6556176,8000019.3,43.73476957508863,47.519626721527985,NaN,NaN,-21.762540985915553,-1.1863383974640336,0.029147304284480174,-0.14678034175614485,-0.17592764604062502,-114767712,-109223307,25.91006657390247,25.511548758882903,NaN,NaN,-8.211713914778487,-11.555281024203305
2010-06-29T09:30:00-04:00,28.66,28.72,28.2701,28.42999,15076555,8172166.6,36.928589418731136,47.59543484272764,NaN,NaN,-112.77207623626083,-34.983916825248954,-0.01435707501213851,-0.19387398980579817,-0.17951691479365967,-129844267,-115186613.4,23.31419065677045,26.78021830370621,NaN,NaN,-10.811802489511855,-11.449069804961669
2010-06-30T09:30:00-04:00,28.28999,28.56,28.14,28.2,9503316,8121823.8,34.425060089342196,46.90447622299742,NaN,NaN,-127.22745796835169,-61.63795691122657,-0.05391295859531006,-0.24690811303779725,-0.1929951544424872,-139347583,-121764365,20.834622428911146,27.88750611298019,NaN,NaN,-13.795733944746615,-11.78430753921666
2010-07-01T09:30:00-04:00,28.14999,28.14999,27.49001,27.96001,23346144,8867009.7,31.98810589807661,45.80835484407162,NaN,NaN,-171.08920224022356,-90.68342840108849,-0.0894357148800039,-0.30478979804249207,-0.21535408316248816,-162693727,-130972965,17.955534778070003,28.624241028649415,NaN,NaN,-17.097557971404747,-12.543343315243531
2010-07-02T09:30:00-04:00,28.00999,28.22,27.87,28.03,10103379,8820447,33.467333890511355,44.76966181964262,NaN,NaN,-130.60296094332514,-112.69084767481533,-0.10058238201026476,-0.3410820606753191,-0.24049967866505434,-152590348,-139848727.4,15.703103778818729,28.66196767200009,NaN,NaN,-19.394810251239118,-13.522124306100043
2010-07-06T09:30:00-04:00,28.22,28.38499,27.94,28.17,11668285,8929927.85,36.44500456719988,43.49319671654142,NaN,NaN,-104.51487874631633,-129.2413152268955,-0.0911691397536844,-0.35446110335715986,-0.26329196360347545,-140922063,-145079597.6,14.54506827509364,28.242626245439446,NaN,NaN,-20.507987547313178,-14.52010476913049
2010-07-07T09:30:00-04:00,28.2,28.75,28.06,28.72,8794480,8841104.6,46.563169713313506,42.84829815402056,NaN,NaN,-58.854887560851196,-118.45787749181356,-0.04298976724243986,-0.3170291726565253,-0.27403940541408545,-132127583,-145536260.8,14.444916611389004,27.199750562806994,NaN,NaN,-18.408893186922896,-15.075645971672262
2010-07-08T09:30:00-04:00,28.82001,29.03,28.75999,28.96001,7165160,8777932.5,50.28288199061042,42.434775772897765,NaN,NaN,-6.134138689962493,-94.23921363613573,0.007276967136646495,-0.26494319649327736,-0.27222016362992385,-124962423,-142659228.8,18.263411985535726,25.919058758487207,NaN,NaN,-15.472287534204524,-15.132309052034014
2010-07-09T09:30:00-04:00,29.02,29.03999,28.88,29.03,4261566,8642617.45,51.346472209283654,42.42899776791193,NaN,NaN,2.7077005565596934,-59.47983307677909,0.04535008933522355,-0.21553255196089438,-0.26088264129611793,-120700857,-134260654.8,28.32079874206015,25.109856423552394,NaN,NaN,-12.769193684910556,-14.79472114244495
2010-07-12T09:30:00-04:00,28.97,29.08,28.87,28.98,5026113,8541814.7,50.51507589838362,42.415939056792084,NaN,NaN,2.4064400495031975,-32.87795287821341,0.06602379216162496,-0.17835290109408675,-0.2443766932557117,-125726970,-128887979.2,33.922167732468495,24.67224219125146,NaN,NaN,-10.785763443617734,-14.222012899755347
2010-07-13T09:30:00-04:00,29.14999,29.3799,29.14999,29.2,5439207,8492955.9,54.04124471539944,42.9494659860158,NaN,NaN,42.8350535552294,-3.407966417904272,0.09178841399767229,-0.12964117575862133,-0.22142958975629362,-120287763,-124761119.2,37.93422400577095,24.634616109400366,NaN,NaN,-8.038409341059397,-13.338640962798783
2010-07-14T09:30:00-04:00,29.11,29.25999,28.955,29.2,5958258,8544810.2,54.04124471539944,43.59942796856171,NaN,NaN,31.692590134436994,14.701529121153374,0.10514421078853461,-0.08999932627062535,-0.19514353705915996,-120287763,-122393155.2,40.17866091445805,24.98917735086155,NaN,NaN,-5.791159896993052,-12.260429381969393
2010-07-15T09:30:00-04:00,29.19,29.36,29.00999,29.28999,4599086,8495922.7,55.544044348266915,44.555368038485426,NaN,NaN,50.58798710967885,26.045954281081627,0.11552557014486264,-0.050736574378081656,-0.1662621445229443,-115688677,-120538406,41.94940843453238,25.808750651206385,NaN,NaN,-3.467763897987682,-11.00433431282915
2010-07-16T09:30:00-04:00,29.14999,29.33,28.64,28.67999,9790086,8699887.75,44.8405811256566,44.583112725376,NaN,NaN,3.191979616994181,26.142810093168528,0.07856336909130013,-0.06805793315881914,-0.14662130225011927,-125478763,-121493987.2,41.27158167112497,26.753411184921855,NaN,NaN,-4.4554165332738895,-10.068774630035541
2010-07-19T09:30:00-04:00,28.8,28.92,28.67999,28.81,5391840,8621338.75,47.1769525280099,44.82898293629894,NaN,NaN,-4.0184521879474575,24.857831645678395,0.06091140881818652,-0.0704820412273861,-0.13139345004557262,-120086923,-120365977.8,42.45364434139392,27.935095311171246,NaN,NaN,-4.575614407254924,-9.284037455352596
2010-07-20T09:30:00-04:00,28.48,28.74001,28.32091,28.73,8178387,8657329.4,45.88891677601993,45.46900631896243,NaN,NaN,-34.212570950338765,9.448306744564762,0.04274690129056835,-0.07795982343236219,-0.12070672472293054,-128265310,-121961487.2,41.19076068748896,29.211993170508286,NaN,NaN,-5.050367235880677,-8.679227423999464
2010-07-21T09:30:00-04:00,28.72,28.81,28.2,28.25999,14343379,9013180,39.12956765590658,45.80504257371702,NaN,NaN,-58.88582295809979,-8.667375873942595,0.00022639667316308454,-0.12042372888147668,-0.12065012555463976,-142608689,-126425672.4,37.80235973688934,30.42397440679244,NaN,NaN,-7.631524841405532,-8.529555626486045
2010-07-22T09:30:00-04:00,28.53999,28.73,28.325,28.44,10500777,9216664.35,42.615855190600826,46.56416752318304,NaN,NaN,-39.014533987102645,-26.587880093298896,-0.01384873812125434,-0.1379610482062077,-0.12411231008495335,-132107912,-129709519.4,35.489645177966665,31.676410863927913,NaN,NaN,-8.709536171503574,-8.555267132917121
2010-07-23T09:30:00-04:00,28.42999,28.5,28.17,28.42999,8860508,9150094.65,42.470187537130194,47.20722849794153,NaN,NaN,-58.41450572594617,-38.909177161886966,-0.02145209276817478,-0.15092742604517184,-0.12947533327699706,-140968420,-132807450.8,33.412865561450985,32.941393848401646,NaN,NaN,-9.615985011663303,-8.70679825845229
2010-07-26T09:30:00-04:00,28.55,28.89,28.46001,28.84,10261500,9241210.1,50.00788167631807,48.176005434307115,NaN,NaN,14.919585112298916,-35.121569701837686,0.0022531082321056994,-0.12665894798686494,-0.12891205621897064,-130706920,-134931450.2,32.028983171232554,34.190244912411565,NaN,NaN,-8.10352291174029,-8.620616066064862
2010-07-27T09:30:00-04:00,28.89999,28.97,28.74001,28.87,6226141,9224708.35,50.51873687698873,48.4585459459982,NaN,NaN,43.029234415990125,-19.67320862857191,0.020082753840343165,-0.10380861391854168,-0.12389136775888485,-124480779,-134174544,33.09247168238028,35.52221313176808,NaN,NaN,-6.735898753801599,-8.351370735741538
2010-07-28T09:30:00-04:00,28.82001,28.91,28.42999,28.48,9662867,8954023.95,44.19597234710012,48.02376668574747,NaN,NaN,-10.398196959600071,-9.975683428871967,0.006445864210651367,-0.11583403749557064,-0.12227990170622201,-134143646,-132481535.4,35.52254139127747,36.755008089321066,NaN,NaN,-7.467947952396084,-8.225167480977902
2010-07-29T09:30:00-04:00,28.64,28.8299,28.32001,28.46001,10543875,9006051.9,43.892736837676125,47.491357016346925,NaN,NaN,-28.560424085010066,-7.884861448453452,-0.002600289449028584,-0.12553026351750773,-0.12292997406847915,-144687521,-134997457.2,33.571199951910344,37.130036747167516,NaN,NaN,-8.144369979009435,-8.213624980696693
2010-07-30T09:30:00-04:00,28.2,28.69,28.089,28.57001,7539379,8215713.65,46.084897465308494,47.17491569969871,NaN,NaN,-59.392365855883334,-8.080433474440882,0.000006740288156142915,-0.12292154870828398,-0.12292828899644012,-137148142,-134233401.6,34.743570910558034,37.18870840274534,NaN,NaN,-8.08269622010227,-8.194920872040347
2010-08-02T09:30:00-04:00,28.88,29.13,28.87,29.11,11736207,8297355.05,55.31475763651397,47.26588090834974,NaN,NaN,74.52126442922373,3.83990238894408,0.03722203671455808,-0.07640074310324252,-0.1136227798178006,-125411935,-133174404.6,36.418490374676416,37.080441714810014,NaN,NaN,-5.070516581280758,-7.7485774019318345
2010-08-03T09:30:00-04:00,29.14999,29.46001,29.14999,29.35001,10271129,8227497.25,58.69908714058805,47.59858393872036,NaN,NaN,135.796258063039,22.393307118353857,0.07494937755124743,-0.01993605787874131,-0.09488543542998874,-115140806,-131306410,39.37440709062218,37.02299501310745,NaN,NaN,-1.4470040546727891,-6.848352638037685
2010-08-04T09:30:00-04:00,29.37,29.67999,29.32001,29.64,9461309,8260838.7,62.40408180297922,48.08858661405695,NaN,NaN,170.34029274434022,58.54100505914191,0.1140387104016882,0.0476629525721215,-0.0663757578295667,-105679497,-125613580.2,47.400116119655486,37.41233127633053,NaN,NaN,2.8471901890333213,-5.463275091313256
2010-08-05T09:30:00-04:00,29.53999,29.64999,29.42,29.64999,4285070,8116834.2,62.528789371039075,49.3520300601557,NaN,NaN,150.3554415902148,94.32417819418689,0.13380372288248574,0.10087889577354048,-0.032924827108945266,-101394427,-116954961.4,56.77325495075588,38.51959365344702,NaN,NaN,6.275920063293674,-3.786247212083695
2010-08-06T09:30:00-04:00,29.36,29.74001,29.28,29.71001,8894113,8348461.55,63.31609411956729,50.504825888124095,NaN,NaN,130.5161415099742,132.3058796673584,0.14330834308614937,0.14621060174874145,0.0029022586625920763,-92500314,-108025395.8,63.91484936769675,40.05253686961151,NaN,NaN,9.3136364392651,-1.9148352618910103
2010-08-09T09:30:00-04:00,29.89999,29.89999,29.63499,29.78999,4061668,8300239.3,64.38981036658791,51.82631828745037,NaN,NaN,143.23586716572436,146.0488002146585,0.14683087215823204,0.18644084886038215,0.03960997670215009,-88438646,-100630738,68.5488083473382,42.00668313102931,NaN,NaN,12.155609594476692,0.09522828901866154
2010-08-10T09:30:00-04:00,29.58,29.98,29.46001,29.86,8698113,8463184.6,65.3459714087273,53.69891855550899,NaN,NaN,127.51251468012859,144.39205153807643,0.14544836623999707,0.22142043450214643,0.07597206826214936,-79740533,-93550683.4,72.22636667238731,44.465540769279166,NaN,NaN,14.80954544923841,2.1972735976214826
2010-08-11T09:30:00-04:00,29.45,29.49001,29.05,29.09,13216566,8826100,49.57840578931499,54.196243598274286,NaN,NaN,35.72670808792068,117.46933460679251,0.0871249706295519,0.18487828154908925,0.09775331091953735,-92957099,-91006203.8,73.4288521230599,47.17548412250011,NaN,NaN,12.337319353948585,3.6458515628110684
2010-08-12T09:30:00-04:00,28.86,29.28999,28.78999,29.21001,9555625,9073926.95,51.54100502491135,54.844159133115795,NaN,NaN,18.709366049733955,91.14011949869635,0.0527693208038406,0.1637149619243381,0.1109456411204975,-83401474,-87407613.2,75.07262507483621,50.15118123059905,NaN,NaN,10.960841048663564,4.690850060789996
2010-08-13T09:30:00-04:00,29.02,29.21001,28.97,29.10001,4342820,8801563.65,49.6339897491168,54.817452566887134,NaN,NaN,16.41503400193605,68.31989799708872,0.020438196826538524,0.13649338715367065,0.11605519032713213,-87744294,-86456409.2,75.50399775497206,53.25653941515187,NaN,NaN,9.246922416270305,5.341717540144326
2010-08-16T09:30:00-04:00,28.92999,29.03,28.73,28.95,4643297,8764136.5,47.07592037671808,54.57153710258209,NaN,NaN,-15.78676012674696,36.515372538594455,-0.011529070141154604,0.10164385265068887,0.11317292279184347,-92387591,-87246198.2,74.35346392523662,56.20375314678447,NaN,NaN,7.035070083092844,5.5836250462798285
2010-08-17T09:30:00-04:00,29.12,29.459,29.03999,29.35001,7185945,8714514.4,53.898977539101985,55.264608902010785,NaN,NaN,42.58989045402103,19.530847693372948,-0.006465233090528988,0.10509138142868224,0.11155661451921123,-85201646,-88338420.8,72.70351828867227,58.85953721088409,NaN,NaN,7.2044115878565655,5.815165980790791
2010-08-18T09:30:00-04:00,29.3,29.53,29.12,29.31,4410012,8217846.05,53.160735013254026,55.92660877169492,NaN,NaN,43.591321780062856,21.103770431801383,-0.0065227850177581315,0.10340313324701356,0.10992591826477169,-89611658,-87669332.6,73.09735867265326,61.68283426236574,NaN,NaN,7.116348307059493,6.001049170257748
2010-08-19T09:30:00-04:00,29.14999,29.2,28.67999,28.77,8736176,8129616,44.33458895322663,55.80158673511765,NaN,NaN,-40.63447987068908,9.235001247716777,-0.04168063435710419,0.05782512531839146,0.09950575967549564,-98347834,-90658604.6,68.35238310939735,64.08346370513996,NaN,NaN,4.099420009697536,5.729387861606289
2010-08-20T09:30:00-04:00,28.73,28.75999,28.49001,28.67,5606176,7966899.4,42.91367821280332,54.915795347709754,NaN,NaN,-92.83546995495102,-12.615099543660643,-0.06882086687404657,0.01347967608293743,0.082300542956984,-103954010,-93900547.8,63.53542483010745,66.02038759481361,NaN,NaN,1.229154641192517,5.086497401547179
2010-08-23T09:30:00-04:00,28.85001,29.07001,28.77,28.8,6570766,7782362.7,45.36512299916924,53.963369337608405,NaN,NaN,-47.90550002280818,-19.038847522872885,-0.0746781573034139,-0.011047153672283372,0.06363100363113053,-97383244,-94899678.4,62.083327418756056,67.64245333253747,NaN,NaN,-0.3800811199917777,4.3055576127559
2010-08-24T09:30:00-04:00,28.49001,28.5,28.09,28.17999,12139289,8078020.1,37.16741511966978,52.16075028880059,NaN,NaN,-154.0496583499902,-58.366757283675135,-0.1145823425219252,-0.07959692452127598,0.03498541800064922,-109522533,-99763855.8,55.44014744277148,68.2167412841886,NaN,NaN,-4.700576289052064,3.018967055354762
2010-08-25T09:30:00-04:00,28.06,28.58,28.02,28.46001,10713406,8130547.05,42.24368671008381,50.71181438444665,NaN,NaN,-128.79218803754856,-92.84345924719742,-0.11603565016657258,-0.1100591447075665,0.005976505459006076,-98809127,-101603349.6,53.12502591087617,67.95615349562577,NaN,NaN,-6.559057473784257,1.6506778369063306
2010-08-26T09:30:00-04:00,28.61,28.61,28.17,28.28,6570094,7931858,40.00610717593182,49.046815317044114,NaN,NaN,-123.8157569805382,-109.47971466916724,-0.1224060790447079,-0.1470310933468788,-0.0246250143021709,-105379221,-103009627,51.35928987572367,67.05932781762769,NaN,NaN,-8.796752842345697,0.15818773987032686
2010-08-27T09:30:00-04:00,28.36,28.58,28,28.57001,7200617,7914919.9,45.05552938778967,47.66579524712996,NaN,NaN,-116.91416725455623,-114.29545412908828,-0.1012499492811795,-0.15118745090364527,-0.049937501622465776,-98178604,-101854545.8,52.74850151253634,65.9307344722847,NaN,NaN,-9.021019637703251,-1.1531275997830412
2010-08-30T09:30:00-04:00,28.57001,28.60001,28.21001,28.21001,5837461,7619982.6,40.49882101875489,45.89099879070336,NaN,NaN,-107.71961487583997,-126.25827709969465,-0.10520109566311106,-0.1814388712013546,-0.07623777553824354,-104016065,-103181110,50.948790295877195,64.41090758824826,NaN,NaN,-10.72940819220559,-2.521167684414834
2010-08-31T09:30:00-04:00,28.17,28.32001,28.03999,28.10001,8756195,7544235.9,39.19444581708984,45.14928736411586,NaN,NaN,-119.64017917738225,-119.37638126517304,-0.1084876801705226,-0.21184737575139678,-0.10335969558087418,-112772260,-103831055.4,50.04781862682847,62.74083376708888,NaN,NaN,-12.508618675548435,-3.9479463974339195
2010-09-01T09:30:00-04:00,28.37,28.8,28.37,28.75,10353820,7588861.45,49.53708078011258,45.006149918058796,NaN,NaN,-43.2562297867553,-102.2691896150144,-0.06243739028628836,-0.18140643343873464,-0.11896904315244627,-102418440,-104552918,49.01116274918288,60.87930074382793,NaN,NaN,-10.54823948800781,-4.890845410373046
2010-09-02T09:30:00-04:00,28.8,28.95,28.72,28.89999,6006223,7674919.1,51.58362227068741,45.14540938388527,NaN,NaN,-5.221932114885933,-78.55042464188395,-0.019644260104275182,-0.14352436828279025,-0.12388010817851507,-96412217,-102759517.2,51.68852572248595,59.178195598650355,NaN,NaN,-8.313160929184168,-5.379747627346064
2010-09-03T09:30:00-04:00,29,29.19,28.99001,29.17,6608035,7560615.2,55.112795450313996,45.71947188914212,NaN,NaN,43.99083538234873,-46.36942411450296,0.026568228135420424,-0.09066982300923954,-0.11723805114465996,-89804182,-101084632.8,54.11192060995316,57.73237107613011,NaN,NaN,-5.297830142778491,-5.368045129550697
2010-09-07T09:30:00-04:00,29.14,29.14,28.94,29,3957088,7555386.2,52.51720574959871,45.620773904177604,NaN,NaN,37.84860620962097,-17.255779897410783,0.04436040414312532,-0.06178754596575331,-0.10614795010887863,-93761270,-99033673.8,56.95908299085025,56.6077685548571,NaN,NaN,-3.664670340801247,-5.124705874015061
2010-09-08T09:30:00-04:00,28.96001,29.25,28.95,29.16,6854801,7463220.6,54.68054212557056,45.72933155505736,NaN,NaN,66.6932947565098,20.010914889367626,0.06436530649585986,-0.025691316989053803,-0.09005662348491367,-86906469,-93860515.6,63.166841111271246,55.898445871901245,NaN,NaN,-1.653444626950958,-4.62881141014876
2010-09-09T09:30:00-04:00,29.37,29.56,29.34,29.47,6310172,7117900.9,58.61477034142623,46.74934451135733,NaN,NaN,129.41295671315706,54.54475218935009,0.09413436083554357,0.027611327559515786,-0.06652303327602778,-80596297,-89496087,67.4343057299598,55.832868916227135,NaN,NaN,1.3101794081890905,-3.78038415038621
2010-09-10T09:30:00-04:00,29.47,29.8,29.47,29.77,5455445,6912891.9,62.048369008147624,48.1161081395962,NaN,NaN,157.16790873018803,87.02272035836488,0.12761012557013235,0.09298962368663766,-0.03462050188349469,-75140852,-85241814,70.96554602441495,56.36359185867767,NaN,NaN,4.925367780879402,-2.5367053030625515
2010-09-13T09:30:00-04:00,29.92999,29.98,29.69,29.84,5951254,6993313.6,62.82342837278074,49.36312995199703,NaN,NaN,164.92685971073516,111.20992522404217,0.1466854176987536,0.1487362702399473,0.0020508525411937067,-69189598,-81118897.2,73.91731964990905,57.20887701804575,NaN,NaN,8.074681170235571,-1.0207929497342485
2010-09-14T09:30:00-04:00,29.74001,30.06,29.71001,29.94,8386633,7180480.4,63.95589500057543,51.276592800633146,NaN,NaN,147.50167514715537,133.14053901154904,0.15731501842384576,0.19869462557100093,0.041379607147155155,-60802965,-74527236.2,77.80278355121264,58.806208168648695,NaN,NaN,11.007759363763475,0.6975716664797118
2010-09-15T09:30:00-04:00,29.87,30.23,29.83,30.22,4894129,7065889.6,66.98816875311834,53.044055803707046,NaN,NaN,154.46369334741757,150.69461872973062,0.17322242890148348,0.2579076432740095,0.08468521437252602,-55908836,-68327709.6,80.71287421278365,60.776768761642074,NaN,NaN,14.474979796657273,2.6657728279336492
2010-09-16T09:30:00-04:00,30.05,30.14999,29.95,30.10001,4915031,7091140.55,64.48458693925376,54.79251864394432,NaN,NaN,134.37664230530078,151.68735584815937,0.1656827392356727,0.2917886384171169,0.1261058991814442,-60823867,-64373223.6,82.30633708732996,62.98727213389967,NaN,NaN,16.64898085019061,4.663373973970358
2010-09-17T09:30:00-04:00,30.05,30.14,29.8788,29.94,6039969,6956330.2,61.19984855768774,55.945684298937046,NaN,NaN,107.81249457585612,141.81627301729299,0.14091049705392228,0.302244020498847,0.16133352344492474,-66863836,-62717820.4,82.9416813193923,65.14392783438937,NaN,NaN,17.56016809878979,6.505773134658848
2010-09-20T09:30:00-04:00,30.07001,30.39999,29.97,30.34,5468758,6949459.3,65.87897215948371,57.75855223756053,NaN,NaN,118.9407937820253,132.619059831551,0.1420531930630339,0.3389000147737171,0.1968468217106832,-61395078,-61158916.4,83.5410495833849,67.47194635492565,NaN,NaN,19.797551973928922,8.404598683126002
2010-09-21T09:30:00-04:00,30.34,30.52,30.23,30.3625,7579723,6999907.15,66.12642890174553,59.682265315035934,NaN,NaN,114.89591423206893,126.09790764853372,0.13496403220882142,0.36555186197170997,0.23058782976288855,-53815355,-59761394.4,84.08105217579399,69.90289160842318,NaN,NaN,21.677929389409073,10.300788784023583
2010-09-22T09:30:00-04:00,30.33,30.535,30.28999,30.41,5875527,6686719.05,66.67588324211866,60.906465490893524,NaN,NaN,106.3251625108505,116.4702014812203,0.12437475974212542,0.3860562794405453,0.2616815196984199,-47939828,-58167592.8,84.69766383832992,72.45192740050511,NaN,NaN,23.38760472560501,12.170333918535215
2010-09-23T09:30:00-04:00,30.22,30.46201,30.19,30.25,8156824,6558889.95,62.97061531195461,61.71982213669832,NaN,NaN,87.18593498619953,107.03206001740004,0.09862115180775444,0.38495795945811295,0.2863368076503585,-56096652,-57222149.8,85.0671729783069,74.83611649020659,NaN,NaN,23.844742644295174,13.838106593643781
2010-09-24T09:30:00-04:00,30.49001,30.67999,30.45,30.66,5575195,6509145,67.89421455902487,62.632780644463374,NaN,NaN,106.79803242068948,106.82916758636671,0.10086416969007744,0.4124170197629553,0.31155285007287786,-50521457,-53953674,86.29890785994932,77.13518700806347,NaN,NaN,25.722415554579435,15.535865016634588
2010-09-27T09:30:00-04:00,30.66,30.66,30.41,30.42999,4840523,6391140.3,62.84574626196272,63.37053353820367,NaN,NaN,90.60729307887402,101.16246744573645,0.07946351468033358,0.4108822434232948,0.33141872874296124,-55361980,-52747054.4,86.73394543607073,79.26196289700779,NaN,NaN,25.82209499513685,17.005326442134912
2010-09-28T09:30:00-04:00,30.5,30.74001,30.3,30.67999,5635410,6381037.75,65.82062303521539,64.1662536031783,NaN,NaN,93.12699190025666,96.80868297937398,0.07481732463976631,0.42494038454266914,0.3501230599029028,-49726570,-51929297.4,87.03441621149874,80.9667896898812,NaN,NaN,26.803259242154333,18.405031127851974
2010-09-29T09:30:00-04:00,30.57001,30.6893,30.46001,30.57001,7966258,6341540.9,63.4150893813663,64.50913353460258,NaN,NaN,90.40173234693268,93.62399694659042,0.05777246317541884,0.4223386388721764,0.36456617569675753,-57692828,-53879897.4,82.24899998628153,82.02498213676131,NaN,NaN,26.904324793936684,19.619215937292648
2010-09-30T09:30:00-04:00,30.67999,30.88,30.38,30.49001,8680352,6257867.5,61.6500917355236,64.48068515798658,NaN,NaN,87.43024845458328,93.67285964026718,0.03563145289959735,0.4091054918212542,0.37347403892165687,-66373180,-55935203,77.41876975294008,82.48592668879883,NaN,NaN,26.481806514095375,20.59958601969304
2010-10-01T09:30:00-04:00,30.71001,30.75,30.33,30.49001,8792777,6397195.2,61.6500917355236,64.3968753981825,NaN,NaN,74.4884387021348,87.21094089655624,0.016481145439246336,0.3940754707207148,0.37759432528146847,-66373180,-59105547.6,70.5374504245217,82.244507458414,NaN,NaN,26.135530123571275,21.39043517738993
2010-10-04T09:30:00-04:00,30.47,30.5428,30.11,30.19,6194566,6376521.75,54.9931435305855,63.7566788646118,NaN,NaN,30.814849629051967,75.25245220659183,-0.018974257860640498,0.35387650295566786,0.37285076081630836,-72567746,-62546700.8,63.89851516877694,81.25134543109718,NaN,NaN,23.905119333127168,21.749675771066677
2010-10-05T09:30:00-04:00,30.60001,30.8,30.44,30.75,6791375,6518236.1,63.019997565191396,63.47323806547416,NaN,NaN,94.34985839375744,75.49702550529203,-0.007863673290699369,0.36302116920293415,0.3708848424936335,-65776371,-65756661,58.37882909276888,79.65605649395327,NaN,NaN,24.30588846446175,22.114849012980258
2010-10-06T09:30:00-04:00,30.67999,30.78999,30.532,30.63,5801340,6465563.05,60.528808370124565,63.19068245339351,NaN,NaN,90.18968895139507,75.4546168261845,-0.011526953353503622,0.356476150801754,0.3680031041552576,-71577711,-68533637.6,54.03052363524652,77.63635553309017,NaN,NaN,23.859225597556673,22.364045667919747
2010-10-07T09:30:00-04:00,30.75,30.84,30.60201,30.69,6051969,6452652.9,61.351460273119976,63.201511861638664,NaN,NaN,99.92898183958661,77.95436350318518,-0.012744718611077843,0.3520722058914103,0.36481692450248815,-65525742,-68364150,54.25448011130362,75.5872697325124,NaN,NaN,23.738360474445866,22.560376354566337
2010-10-08T09:30:00-04:00,30.71001,30.8475,30.6347,30.77,3683604,6364060.85,62.47447654208701,62.95833360325319,NaN,NaN,104.99393719675811,84.05546320210983,-0.01106044423110858,0.3509913692136024,0.362051813444711,-61842138,-67457941.6,55.50273205864819,73.58453276645979,NaN,NaN,23.958456740604063,22.760102124000298
2010-10-11T09:30:00-04:00,30.75,30.84,30.67999,30.78999,2452325,6189114.4,62.765618363514704,62.71827570766527,NaN,NaN,104.08425545311894,98.70934436692322,-0.011450009090301583,0.347739302081834,0.3591893111721356,-59389813,-64822355,59.006256523145076,71.79347593412771,NaN,NaN,24.219232557842776,22.96854932883494
2010-10-12T09:30:00-04:00,30.73,30.94,30.5975,30.86,3194548,5929510.15,63.82420850318495,62.51458465488429,NaN,NaN,107.44716390415384,101.3288054690025,-0.009900738143043764,0.3468133884933309,0.35671412663637464,-56195265,-62906133.8,61.3867200647953,70.12840852173238,NaN,NaN,24.72357479749011,23.219267252928535
2010-10-13T09:30:00-04:00,30.99001,31.17999,30.91,31.08,3325585,5851082.95,66.99928594364863,62.80234684286244,NaN,NaN,178.0808487225793,118.90703742323936,0.002377119364056879,0.35968552584144575,0.3573084064773889,-52869680,-59164527.6,65.58859808326511,68.73708174351512,NaN,NaN,26.05752622673595,23.624732820615307
2010-10-14T09:30:00-04:00,31.03999,31.17999,30.88,31.02,5113906,5861026.7,65.31557971278612,62.618158639559674,NaN,NaN,157.90091560007806,130.50142417533763,0.00286145769606877,0.36088522859747485,0.3580237709014061,-57983586,-57656096.4,67.1410308311416,67.36866195574314,NaN,NaN,26.72812934041206,24.068075180586273
2010-10-15T09:30:00-04:00,31.09,31.24001,30.95,31.14999,5880539,5853055.2,67.23658551965148,62.93179001510886,NaN,NaN,169.70953013291023,143.44454276256806,0.00804665297968793,0.368082087126016,0.36003543414632805,-52103047,-55708278.2,69.08078412072304,66.10772186178973,NaN,NaN,27.834521283641056,24.6061389095941
2010-10-18T09:30:00-04:00,31.19,31.45,31.13499,31.44,7162316,5937733.1,71.08440026705313,63.30777410309728,NaN,NaN,207.12623886010815,164.0529394439659,0.026100200439234944,0.39266068469537174,0.3665604842561368,-44940731,-52818461.8,71.74570070060646,65.01567075386886,NaN,NaN,29.966501605242524,25.371905008972448
2010-10-19T09:30:00-04:00,31.19,31.19,30.7,30.85001,8832941,6000394,56.5373002204442,62.8165034487457,NaN,NaN,64.91096380913832,155.5456994249628,-0.00494604684452582,0.36037792570047955,0.36532397254500537,-53773672,-52334143.2,72.17849481852888,64.29634895617224,NaN,NaN,27.218004495325754,25.63563350702292
2010-10-20T09:30:00-04:00,30.92,31.2838,30.84,31.14,5494633,5981349.3,60.785208111942794,62.754726047061354,NaN,NaN,105.55898855812403,141.04132739207176,-0.008970057820686494,0.3541114002691472,0.3630814580898337,-48279039,-51416015,73.02214251753117,63.982304153643035,NaN,NaN,26.309004426205796,25.731829352620473
2010-10-21T09:30:00-04:00,31.27,31.3653,30.99001,31.22,5984027,5872709.45,61.89175293795626,62.771987561520824,NaN,NaN,120.53990474571268,133.56912522119868,-0.009226735931062435,0.35154803817600566,0.3607747741070681,-42295012,-48278300.2,75.73066925552858,64.3532483558578,NaN,NaN,25.9392467646715,25.761460411484904
2010-10-22T09:30:00-04:00,31.32001,31.32001,31.14999,31.23,4671840,5827541.7,62.035959896459154,63.275045873368946,NaN,NaN,114.29851797023706,122.48692278866403,-0.011554874165520812,0.34633118140016705,0.35788605556568787,-37623172,-45382325.2,77.93278076328488,65.35569589832265,NaN,NaN,25.689156656456362,25.751131303623684
2010-10-25T09:30:00-04:00,31.39999,31.63499,31.37,31.39999,6532508,5912140.95,64.49552539627447,63.380440718446316,NaN,NaN,152.0476982478282,111.47121466620804,-0.004822794691860199,0.3518575622008626,0.3566803568927228,-31090664,-42612311.8,79.819014949466,66.8871377452296,NaN,NaN,26.209890966459078,25.816668398314455
2010-10-26T09:30:00-04:00,31.33,31.33,31.155,31.31,4007635,5830752.2,62.19821615452351,63.49968413161766,NaN,NaN,90.20386424159621,116.52979475269963,-0.0093451771292411,0.3449988854811714,0.3543440626104125,-35098299,-38877237.2,82.04734163933074,68.88833903123562,NaN,NaN,25.973742815453306,25.839107600762862
2010-10-27T09:30:00-04:00,31.19,31.25,30.92999,31.12,5492398,5707059.2,57.5381726386185,63.227306443438984,NaN,NaN,44.151268794815465,104.24825080003791,-0.027045672506446572,0.3205369719773543,0.3475826444838009,-40590697,-37339568.8,82.8851739106471,70.93338858833157,NaN,NaN,24.39237826419672,25.63243198125341
2010-10-28T09:30:00-04:00,31.3,31.41,31.13,31.3,5006965,5523389.85,60.55343316013065,63.09008905901353,NaN,NaN,82.02518807721471,96.5453074663383,-0.0284038863845526,0.31207778650311013,0.34048167288766273,-35583732,-35997312.8,83.60447543732106,72.94065597252249,NaN,NaN,23.9184692850732,25.38758016751338
2010-10-29T09:30:00-04:00,31.22,31.27,31.05,31.17,6751203,5421311.15,57.38406284912828,62.705692236557354,NaN,NaN,47.064631188942535,83.0985301100794,-0.03916661258668075,0.2915234071543118,0.33069001974099255,-42334935,-36939665.4,81.02966478953581,74.51375656297897,NaN,NaN,22.58596372839156,24.987349247638836
2010-11-01T09:30:00-04:00,31.34,31.5,31.00999,31.17,6945508,5458858.25,57.38406284912828,62.245681832696164,NaN,NaN,60.781564776226865,64.84530341575913,-0.0468741400967822,0.2720973446200148,0.318971484716797,-42334935,-39188519.6,75.08659626286286,75.49231914855523,NaN,NaN,21.50240495908382,24.489500063559547
2010-11-02T09:30:00-04:00,31.42,31.5,31.39,31.47,5305789,5384578.95,62.620278714613576,61.932895602050806,NaN,NaN,126.73722480745538,72.15197552893098,-0.03301055213534254,0.2777082945476188,0.31071884668296135,-37029146,-39574689,74.08179668646515,76.09897619164094,NaN,NaN,22.049980346179645,24.140997246790988
2010-11-03T09:30:00-04:00,31.57001,31.57001,31.17,31.49001,8271379,5508080.9,62.947299891888996,61.763732757701014,NaN,NaN,105.05277338423637,84.33227644681514,-0.024146429054370144,0.28053581036499864,0.3046822394193688,-28757767,-37208103,76.18506884426019,76.7449789068637,NaN,NaN,22.589626684912925,23.919372880808407
2010-11-04T09:30:00-04:00,31.72,31.73,31.55,31.64101,7898383,5600401.6,65.40679076108118,61.63303313208878,NaN,NaN,170.0980111740294,101.9468410661781,-0.010466035304305454,0.291599695288987,0.30206573059329245,-20859384,-34263233.4,78.52086931714308,77.41927070660799,NaN,NaN,23.76025959890035,23.8966424119644
2010-11-05T09:30:00-04:00,31.71001,31.71001,31.33,31.45,10245648,5928503.8,59.98283450349994,60.84006414897784,NaN,NaN,109.39125105253723,114.41216503889703,-0.016286470242440843,0.2817076427902414,0.29799411303268225,-31105032,-32017252.8,80.12219426156778,78.01759167524808,NaN,NaN,23.21700591177005,23.799551483365207
2010-11-08T09:30:00-05:00,31.41,31.55,31.3,31.37,7745074,6193141.25,57.820159844157274,60.93169697924306,NaN,NaN,69.51858456723046,116.15956899709776,-0.026903010970738217,0.2643653493192595,0.2912683602899977,-38850106,-31320287,80.60540180520077,78.6195136028675,NaN,NaN,22.144480932677777,23.563112833267002
2010-11-09T09:30:00-05:00,31.46001,31.46001,31.17,31.24001,7484086,6407618.15,54.38871037214014,60.474804283542866,NaN,NaN,14.406266717319061,93.69337737907048,-0.04309804889464902,0.2373957991716864,0.2804938480663354,-46334192,-33181296.2,75.33908092805984,78.78500920361955,NaN,NaN,20.238786454633757,23.088209064890826
2010-11-10T09:30:00-05:00,31.28,31.28,30.925,31.23,6534441,6568060.95,54.12234135175802,59.91984631310014,NaN,NaN,-55.03718064751536,61.67538657272014,-0.05418553766220113,0.212761925988584,0.26694746365078514,-52868633,-38003469.4,63.72167144691367,77.92722364586133,NaN,NaN,18.59516665986077,22.446345864172248
2010-11-11T09:30:00-05:00,31.08,31.34,31,31.32001,5827797,6603755.5,56.19961744761162,59.50296470961103,NaN,NaN,-26.11415380084034,22.43295357774619,-0.05498394654983779,0.1982175304634879,0.2532014770133257,-47040836,-43239759.8,53.98657311358209,76.21678024231115,NaN,NaN,17.733248750252596,21.77304627646944
2010-11-12T09:30:00-05:00,31.13,31.18201,30.89,30.92999,6763852,6647921.15,46.396597057164136,58.21018411396029,NaN,NaN,-127.89970289742139,-25.025237212245536,-0.07980057921424061,0.1534507529955249,0.23325133220976552,-53804688,-47779691,47.2469285227933,73.89020264040595,NaN,NaN,13.90257026666789,20.648692560783505
2010-11-15T09:30:00-05:00,31.03999,31.11,30.89,30.94,4181891,6498899.9,46.65379173985437,57.099868084341075,NaN,NaN,-121.59328191488194,-63.24761050866802,-0.09265957862078616,0.1174268589337828,0.21008643755456896,-49622797,-49934229.2,44.41323270010362,71.20205200188973,NaN,NaN,10.884273682646002,19.253775578192432
2010-11-16T09:30:00-05:00,30.74001,30.83501,30.39999,30.49001,12298395,6672172.6,37.85954768127504,55.6942520159594,NaN,NaN,-269.1409330463189,-119.95705046139558,-0.12649461059512243,0.051968174310665916,0.17846278490578835,-61921192,-53051629.2,40.6173382737406,68.18292088496783,NaN,NaN,5.078942966913789,17.228799490866912
2010-11-17T09:30:00-05:00,30.53999,30.66,30.47501,30.53999,5812574,6688069.65,39.229737550316976,54.1711309009727,NaN,NaN,-223.7198031712398,-153.6935749661405,-0.13950810094014113,0.004077658730611944,0.14358575967075307,-56108618,-53699626.2,39.85482433562948,65.05794580627557,NaN,NaN,0.857083262945926,14.889982886878201
2010-11-18T09:30:00-05:00,30.72,31.03999,30.6299,30.97,5721512,6674943.9,49.53903125726255,53.610771501553714,NaN,NaN,-97.62139619056877,-167.99502344408614,-0.11421826974228699,0.0008129224928943302,0.11503119223518132,-50387106,-54368880.2,39.03966028209834,62.05865977003004,NaN,NaN,0.4390871397375093,12.825569208715246
2010-11-19T09:30:00-05:00,30.94,31.02,30.82001,30.9975,5078031,6695253.45,50.12178825488841,53.09203760196516,NaN,NaN,-68.61129569961531,-156.13734200452492,-0.09167331472338747,0.0004395488309469897,0.09211286355433446,-45309075,-52669757.6,42.26814022971989,59.71448433909126,NaN,NaN,0.2988546380762097,11.036038555766812
2010-11-22T09:30:00-05:00,30.96001,31.03999,30.71001,31.00999,7405160,6738886.05,50.401951353128645,52.219299933287665,NaN,NaN,-68.24427242747332,-145.46754010704322,-0.072779599818276,0.0011383637814894598,0.07391796359976546,-37903915,-50325981.2,46.47882291839783,57.742843355657875,NaN,NaN,0.2714292578737165,9.49823722749637
2010-11-23T09:30:00-05:00,30.69,30.75,30.55,30.56,9032711,6990139.85,41.383151901689295,50.679003648273394,NaN,NaN,-134.2780294370878,-118.49495938519699,-0.08651336496852509,-0.034223742610890895,0.052289622357634194,-46936626,-47329068,51.36356228459374,55.96987860139598,NaN,NaN,-2.7360308068702666,7.7504846511582794
2010-11-24T09:30:00-05:00,30.67999,30.87,30.67999,30.845,5593758,6995207.85,47.759020667602236,49.41844864159633,NaN,NaN,-76.70148886721044,-89.09129652439114,-0.07287492966704032,-0.038804039726166195,0.034070889940874115,-41342868,-44375918,55.6581869315042,54.336829859564645,NaN,NaN,-3.136303273738904,6.195229233315825
2010-11-26T09:30:00-05:00,30.69,30.73,30.53999,30.61,2863585,6888038.85,43.5523705517279,48.24484407361261,NaN,NaN,-106.04153747298422,-90.77532478087421,-0.07581416720439296,-0.0606968190646171,0.015117348139775867,-44206453,-43139787.4,57.35560546786393,52.710644945728646,NaN,NaN,-4.89147893168252,4.611413781173204
2010-11-29T09:30:00-05:00,30.39999,30.61,30.14,30.55,7439129,6922435.15,42.522534265613224,47.15215653228803,NaN,NaN,-132.5978897090323,-103.5726435827576,-0.07764900223489034,-0.08194390465383705,-0.004294902418946717,-51645582,-44407088.8,55.029798553129524,50.88381614200927,NaN,NaN,-6.604481985410744,3.0091429573754973
2010-11-30T09:30:00-05:00,30.22,30.46001,30.1801,30.27,8216836,6986001.55,38.006049167488975,45.98196644624153,NaN,NaN,-142.21597573213782,-118.36698424369051,-0.09255834234271683,-0.11999283034734276,-0.027434488004625928,-59862418,-48798789.4,47.79657251835276,48.91649411274447,NaN,NaN,-9.565077969328229,1.212825682132108
2010-12-01T09:30:00-05:00,30.61,30.89999,30.61,30.85001,8573871,7149405.65,49.881312845511815,45.67903583865252,NaN,NaN,-36.42924740839831,-98.79722783795262,-0.059786168448130596,-0.10216719856478917,-0.04238103011665858,-51288547,-49669173.6,46.49227149131614,47.68582268734465,NaN,NaN,-7.96699004550989,-0.09857656467389164
2010-12-02T09:30:00-05:00,30.89999,31.09,30.84,31.09,5519234,7011798.4,53.82283156369658,45.50926541837287,NaN,NaN,17.759248054237702,-79.90508045366298,-0.02040913411015855,-0.06789244775435677,-0.047483313644198215,-45769313,-50554462.6,45.14290676126571,47.05413223360777,NaN,NaN,-5.2650300724387,-0.8366413514974357
2010-12-03T09:30:00-05:00,30.96001,31.11,30.94,31.09,7771973,7005477.9,53.822831563696575,46.03971074026805,NaN,NaN,38.02821168151252,-51.091130622763636,0.00577440499423422,-0.04026530740140544,-0.046039712395639656,-45769313,-50867034.6,44.65016278628712,46.86864896671447,NaN,NaN,-3.2155317169268955,-1.1764828322730727
2010-12-06T09:30:00-05:00,30.98,31.02,30.86,30.89,5092160,6747803.5,50.020759001303965,46.28020840180016,NaN,NaN,14.590847633476084,-21.65338315426196,0.009539238700042953,-0.03411566402058597,-0.04365490272062892,-50861473,-50710212.8,44.97467828196637,46.9087522225618,NaN,NaN,-2.737717013460075,-1.3995162867283586
2010-12-07T09:30:00-05:00,31.11,31.1299,30.87,30.91,6939969,6707548.25,50.39810246667137,47.17581945789989,NaN,NaN,37.42933078573098,14.275678149311796,0.01307324756586177,-0.027313343263301704,-0.040386590829163474,-43921504,-47522030,51.234388505827546,47.66711295342515,NaN,NaN,-2.244987193918449,-1.5202978448983715
2010-12-08T09:30:00-05:00,30.95,30.99001,30.78999,30.94,5221949,6594441.4,50.99576595437,48.01625005818939,NaN,NaN,25.327078499971684,26.626943330985796,0.016885701371906467,-0.019279464114280387,-0.036165165486186854,-38699555,-45004231.6,55.53628364347959,48.78721718970015,NaN,NaN,-1.6724024485329052,-1.5420270739890192
2010-12-09T09:30:00-05:00,31.03999,31.03999,30.89,30.99001,3670291,6451233.9,52.03333788709667,48.19441481746326,NaN,NaN,52.81635026050159,33.63836377223857,0.021911329467754016,-0.008776003651494335,-0.03068733311924835,-35029264,-42856221.8,58.8698309925102,50.20365795472958,NaN,NaN,-0.9069996690189499,-1.4513088732790094
2010-12-10T09:30:00-05:00,31.03999,31.32001,31.03999,31.28999,5730086,6446348.35,57.80458887746596,48.74318629050452,NaN,NaN,138.88517906888754,53.80975724971357,0.043336461048555666,0.023483243191446235,-0.01985321785710943,-29299178,-39562194.8,63.40132872663399,51.713171418794865,NaN,NaN,1.5092380939758094,-1.0283735922426067
2010-12-13T09:30:00-05:00,31.36,31.49001,31.3,31.34,9561426,6586227.05,58.696791490797374,49.33567487176657,NaN,NaN,174.83947047617974,85.85948181825431,0.05786606891643788,0.05247936828843791,-0.005386700627999962,-19737752,-33337450.6,70.10432117649329,53.40070700865882,NaN,NaN,3.7562598425066227,-0.3448545301355739
2010-12-14T09:30:00-05:00,31.45,31.74001,31.44,31.655,5587590,6656512,63.877763882380826,50.94243287038739,NaN,NaN,214.7680835805485,121.3272323772178,0.0840911843149586,0.09972727976569828,0.015636095450739688,-14150162,-27383182.2,74.8493991939136,55.07826678789596,NaN,NaN,7.391668993994273,0.7603631161686899
2010-12-15T09:30:00-05:00,31.53999,31.77,31.53,31.56,5817074,6332445.95,61.37723130564326,51.915162201676026,NaN,NaN,190.21474686677246,154.30476605057797,0.08991515038571962,0.1280300334328892,0.03811488304716959,-19967236,-23636718.4,77.2916909878937,56.62351707763806,NaN,NaN,9.677771711664906,2.0342786298110065
2010-12-16T09:30:00-05:00,31.57001,31.78999,31.435,31.78,5071785,6295406.5,64.81245871853599,53.43373992787661,NaN,NaN,171.13892735947482,177.9692814703726,0.10254439865557448,0.16629538136663768,0.0637509827110632,-14895451,-19609955.8,79.58621160275266,58.2114175158444,NaN,NaN,12.718427730200169,3.560585644152315
2010-12-17T09:30:00-05:00,31.62,31.67,31.44,31.67,6012508,6309956.3,61.85029829114078,54.81429450112857,NaN,NaN,127.49315076149396,175.69087580889388,0.09748347141748483,0.18560532198291924,0.08812185056543441,-20907959,-17931712,80.47184130348609,60.02870628372701,NaN,NaN,14.388597017571175,5.107444411783581
2010-12-20T09:30:00-05:00,31.74001,31.758,31.53,31.66,3241704,6218139.95,61.57478346764168,56.497775522568055,NaN,NaN,118.12285740176863,164.34755319401168,0.08775956888679684,0.19782131167393047,0.11006174278713363,-24149663,-18814094.2,78.54245406636991,62.22484068001395,NaN,NaN,15.669814018510674,6.616354355601737
2010-12-21T09:30:00-05:00,31.69,31.71001,31.58,31.58,2948581,5995311,59.29902889894761,57.170469526384885,NaN,NaN,97.62677017099087,140.91929051210013,0.0709554885415325,0.19875610346404926,0.12780061492251676,-27098244,-21403710.6,73.00996002532732,64.11896128958618,NaN,NaN,16.13116192532394,7.975612579847766
2010-12-22T09:30:00-05:00,31.57001,31.67,31.54359,31.6675,2645951,5675973,60.996973766338684,57.68290825514504,NaN,NaN,87.07159394426209,120.29065992759806,0.061122324345308454,0.20420352035415235,0.1430811960088439,-24452293,-22300722,71.14064919911166,65.97594289228947,NaN,NaN,16.98780445852105,9.263068562515379
2010-12-23T09:30:00-05:00,31.61,31.7,31.61,31.64999,2875664,5540068.3,60.45346967031331,58.15652526276052,NaN,NaN,82.21496950654719,102.50586835701253,0.049333063039466246,0.2047475248081767,0.15541446176871046,-27327957,-24787223.2,66.08931551287742,67.50731094418877,NaN,NaN,17.562052027929205,10.448637629003068
2010-12-27T09:30:00-05:00,31.60001,31.62,31.4904,31.59,835149,5438646.5,58.529291862974894,58.764277610022724,NaN,NaN,60.88596510922711,89.18443122655917,0.03411235613100155,0.19805490693246242,0.16394255080146086,-28163106,-26238252.6,63.266177858407076,68.81384662822025,NaN,NaN,17.558019716793805,11.464263641544601
2010-12-28T09:30:00-05:00,31.58,31.66,31.5215,31.61,1652538,5149316.95,58.99785312807208,59.37854551440849,NaN,NaN,60.286075495640034,77.61707484533346,0.022565806173060615,0.19214980851778662,0.169584002344726,-26510568,-26710433.6,62.33306058026065,69.60660891925119,NaN,NaN,17.671745424242793,12.351046753358629
2010-12-29T09:30:00-05:00,31.64999,31.69,31.59,31.62,1991857,4838068,59.24579623137386,59.967833391337344,NaN,NaN,62.609567886437,70.6136343884227,0.013237827164983895,0.18613128630095588,0.17289345913597198,-24518711,-26194527,62.975600211396646,70.1379886741024,NaN,NaN,17.829115036046588,13.133627936599765
2010-12-30T09:30:00-05:00,31.58,31.6039,31.49001,31.50999,3877200,4603234.45,55.28510980331587,60.200102813924424,NaN,NaN,35.742129100917964,60.347741419753866,-0.0018995359998242312,0.1705190391361917,0.17241857513601594,-28395911,-26983250.6,61.25523276533986,70.3083745150188,NaN,NaN,16.973537152010604,13.682186395944171
2010-12-31T09:30:00-05:00,31.53999,31.5699,31.42999,31.5,3908415,4522693.5,54.9260150841883,59.99449040011888,NaN,NaN,22.872384548500897,48.479224428144605,-0.013497210855367092,0.1555470615668071,0.16904427242217418,-32304326,-27978524.4,59.06260982728064,69.99846602220785,NaN,NaN,16.15316484014297,14.035183316544
2011-01-03T09:30:00-05:00,31.67,31.99001,31.66,31.78751,6877746,4477982.15,62.47941664563112,60.264677911178424,NaN,NaN,101.99912267764651,56.70185594182848,-0.003251790514148256,0.16497953427948886,0.16823132479363712,-25426580,-27431219.2,59.91238236569042,69.27047039286478,NaN,NaN,17.41464174071178,14.517963091425111
2011-01-04T09:30:00-05:00,31.85001,31.92,31.72,31.89,4160906,4431419.45,64.74730741975478,60.32678816384799,NaN,NaN,111.96324917589551,67.03729067787957,0.008347244190094305,0.17866538003125498,0.17031813584116068,-21265674,-26382240.4,61.559386430627896,68.32118376691581,NaN,NaN,19.147847090123776,15.179375091239207
2011-01-05T09:30:00-05:00,31.77,32.02,31.77,31.96001,7962762,4482559.1,66.24807807053469,60.67470578991167,NaN,NaN,139.58990333219353,82.43335776703088,0.018094834808738247,0.19293667935208347,0.17484184454334523,-13302912,-24139080.6,64.88208771257236,67.43478353296427,NaN,NaN,21.04817111977493,16.017774523887166
2011-01-06T09:30:00-05:00,32.00999,32.11,31.97,32.09,4966766,4469799.95,68.89581824313694,60.96637432738316,NaN,NaN,205.27418215303797,116.33976837745487,0.029957533022646782,0.2122887608216537,0.18233122779900693,-8336146,-20127127.6,69.89430561432171,66.74250453379064,NaN,NaN,23.48333713984907,17.08428346902458
2011-01-07T09:30:00-05:00,32.12,32.12,31.89,32.07001,6201109,4596340.85,68.01222703368543,61.40651209470777,NaN,NaN,178.1206272304114,147.38941691383698,0.032884424961353076,0.22343675900069826,0.19055233403934518,-14537255,-16573713.4,73.50170234976498,66.24463746566771,NaN,NaN,25.27042680276857,18.253732516702293
2011-01-10T09:30:00-05:00,31.92,32.05,31.88,31.98,4483172,4533995.15,64.03018420858155,61.58189786191776,NaN,NaN,125.87054657928992,152.16370169416567,0.025513631053377617,0.22244437285606722,0.1969307418026896,-19020427,-15292482.8,74.67979288128872,65.96873309530476,NaN,NaN,25.74192382095334,19.3234741315953
2011-01-11T09:30:00-05:00,32.06,32.19,32.00999,32.14,3356196,4223733.65,67.65540567732067,62.17878191751584,NaN,NaN,157.09212105739843,161.18947607046624,0.02797173975735273,0.2318954164993805,0.20392367674202777,-15664231,-14172194.2,75.69722142818695,66.16068033836616,NaN,NaN,27.20285680076813,20.44910022719142
2011-01-12T09:30:00-05:00,32.28,32.36,32.17999,32.31,2886045,4088656.4,70.99975489400043,62.89326628377739,NaN,NaN,181.40572801985292,169.55264100799815,0.037035979466083946,0.2502186510746327,0.21318267160854876,-12778186,-14067249,75.79534040045422,66.4931582813192,NaN,NaN,29.50946603655911,21.74343819995823
2011-01-13T09:30:00-05:00,32.22,32.22,32.05,32.14,7414520,4168528.7,63.88597944203691,63.13844555318622,NaN,NaN,112.83166004029339,151.0641365854492,0.027983233496275683,0.24816171347889338,0.2201784799826177,-20192706,-16438561,69.01500201722256,66.70213588877242,NaN,NaN,29.342078822157568,22.82895828884385
2011-01-14T09:30:00-05:00,32.08,32.17999,32.06,32.17999,3907414,4110310.15,64.77994442189075,63.58492073596592,NaN,NaN,100.5702916094958,135.5540694612661,0.021386963565694972,0.2469121844397364,0.22552522087404142,-16285292,-16788168.4,68.04849724972769,67.04373013100961,NaN,NaN,29.46800425424679,23.777393426758557
2011-01-18T09:30:00-05:00,32.19,32.31,32.16499,32.3,8160055,4217687.5,67.38886742576247,64.18427890008667,NaN,NaN,120.36498707891673,134.45295756119145,0.02173409683881755,0.25269284192256336,0.2309587450837458,-8125237,-14609130.4,70.79388191248754,67.64807451188294,NaN,NaN,30.351527682737135,24.716555463326927
2011-01-19T09:30:00-05:00,32.33,32.33,31.96001,32.08,9936344,4552419.5,58.79132371903318,64.15181657777661,NaN,NaN,72.66272825022119,117.56707899975599,0.004666843146467592,0.2367922990168303,0.2321254558703627,-18061581,-15088600.4,69.38122979036137,68.105619481809,NaN,NaN,28.412496665441655,25.24454706362903
2011-01-20T09:30:00-05:00,32.07001,32.22,31.95,32.16,8815094,4845745.15,60.75221440113524,64.54232404904943,NaN,NaN,62.59263178832253,93.80445975344992,-0.003286054816486944,0.22801788734975403,0.23130394216624098,-9246487,-14382260.6,70.32079868637254,68.7531599047399,NaN,NaN,27.411777335101466,25.554151388125092
2011-01-21T09:30:00-05:00,32.25999,32.33,32.14999,32.1875,8079684,5117431.8,61.43161136771891,65.00700949787306,NaN,NaN,87.52228513953398,88.74258477329803,-0.008452284896710016,0.22073858604535346,0.22919087094206347,-1166803,-10577080,74.80602061392435,69.87768924664303,NaN,NaN,26.798284110842918,25.73188463422764
2011-01-24T09:30:00-05:00,32.17999,32.2654,32.12,32.14999,3711418,5159219.5,59.908280120712426,64.82335688895029,NaN,NaN,68.71403993141853,82.37133443768258,-0.01573058507495456,0.20952763959837029,0.22525822467332485,-4878221,-8295665.8,77.04581031357162,71.10150552863453,NaN,NaN,25.85334355096787,25.749235908047673
2011-01-25T09:30:00-05:00,32.03999,32.24001,32.03,32.14999,8002410,5517582.55,59.908280120712426,64.47771208187584,NaN,NaN,52.56646155017128,68.8116293319335,-0.021521495595723167,0.1983563551786709,0.21987785077439406,-4878221,-7646262.6,77.65477235730987,72.25117595196896,NaN,NaN,25.077267912755236,25.653240480148753
2011-01-26T09:30:00-05:00,32.17999,32.22501,32.08,32.11,7671703,5818540.8,58.12611696194113,63.89757200269059,NaN,NaN,47.67579862049669,63.8142434059886,-0.02857958653043699,0.18415336761134782,0.2127329541417848,-12549924,-6543931.2,78.68831519090111,73.23733505756387,NaN,NaN,23.93796573581707,25.40820123095851
2011-01-27T09:30:00-05:00,32.14999,32.25,32.05,32.19,6874020,6062648.95,60.64814049708412,63.308452163686816,NaN,NaN,53.139795311629825,61.92367611065007,-0.028339304669273507,0.17730882330519293,0.20564812797446644,-5675904,-5829814.6,79.35452379117001,73.91306492733875,NaN,NaN,23.60708022808694,25.150898230548286
2011-01-28T09:30:00-05:00,32.21001,32.25,31.58,31.61,11096035,6423590.7,41.250229617725026,61.396880919689636,NaN,NaN,-107.67082586785224,22.885053909172818,-0.06559220721670142,0.12365786895358966,0.18925007617029108,-16771939,-8950841.8,69.17648606682901,73.60412090712904,NaN,NaN,16.285046114986507,23.884347928325173
2011-01-31T09:30:00-05:00,31.77,31.77,31.56,31.67999,9021602,6679250.05,43.59472755291508,59.937205444284885,NaN,NaN,-192.1958166453123,-29.296917406173343,-0.08276191146568282,0.08579768683818756,0.16855959830387038,-7750337,-9525265,67.46147356003087,73.08852666989634,NaN,NaN,11.318646690004265,22.089247751422185
2011-02-01T09:30:00-05:00,31.81,32.28999,31.81,32.25,13057332,6988229.35,58.2184863477068,59.26313977788389,NaN,NaN,25.32814638214582,-34.74458043977843,-0.05434505242972548,0.10062828276671354,0.15497333519643902,5306995,-7488221.8,70.27578489634037,72.70128120333587,NaN,NaN,12.293029772015906,20.68978804007843
2011-02-02T09:30:00-05:00,32.14999,32.17999,32.03999,32.14,4627637,7011565.9,55.242001910409805,58.13758599334171,NaN,NaN,22.168319370601555,-39.84607628975746,-0.04211786359785025,0.1023260056991262,0.14444386929697645,679358,-4842365.4,73.48379904037537,72.53617110618738,NaN,NaN,11.908344729218328,19.435296138526986
2011-02-03T09:30:00-05:00,32.03,32.2475,31.78999,32.1825,6316297,6929242.65,56.174295169367866,57.586751402436775,NaN,NaN,-13.655867352074242,-53.20520882249828,-0.030850826983994717,0.10588033556698306,0.13673116255097778,6995655,-2308053.6,76.1400762144323,73.04510497741664,NaN,NaN,11.943933341157905,18.365101453188547
2011-02-04T09:30:00-05:00,32.25,32.34,32.065,32.33,4380090,6899908.85,59.33977426360577,57.198167819702135,NaN,NaN,99.49282647898647,-11.772478353130538,-0.014005061880321218,0.11922483520057625,0.13322989708089747,11375745,3321483.2,80.75253867246175,73.95253650761194,NaN,NaN,13.059687282187038,17.607185143045474
2011-02-07T09:30:00-05:00,32.32001,32.38,32.25,32.28,9145277,7047117.25,57.815314041912536,56.51434257799857,NaN,NaN,132.0730112745247,53.08128723083687,-0.007117808915230367,0.1243326359368595,0.13145044485208987,2230468,5317644.2,82.07570222576274,74.75838081570302,NaN,NaN,13.446833465353079,17.012849189089415
2011-02-08T09:30:00-05:00,32.25,32.39,32.25,32.3725,5162266,7081071.95,59.869326471171824,56.5913427745799,NaN,NaN,144.89967916828283,76.99559378806427,0.002276840409088654,0.13429649536345067,0.13201965495436202,7392734,5734792,82.34878465772115,75.68463473480016,NaN,NaN,14.411273990436019,16.641195589281786
2011-02-09T09:30:00-05:00,32.28,32.36501,32.2,32.3,4933379,7159931.1,57.50590254333345,56.359463356165485,NaN,NaN,97.5809008873345,92.07811009141085,0.0022154902437538093,0.13478901775905427,0.13257352751530047,2459355,6090791.4,82.59252719568443,76.56118677117958,NaN,NaN,14.485288331549583,16.333208838177185
2011-02-10T09:30:00-05:00,32.19,32.36,32.17999,32.31,4383270,7234792.35,57.75362953893289,56.09675036839506,NaN,NaN,94.21730866041257,113.65274529390823,0.0014904265830503194,0.13443656074411336,0.13294613416106305,6842625,6060185.4,82.48706797113435,77.1098330109803,NaN,NaN,14.616328083978262,16.08794015900591
2011-02-11T09:30:00-05:00,32.17,32.46001,32.14,32.38,4342047,7081168.7,59.53206650548818,56.069877967307605,NaN,NaN,107.3675402658906,115.22768805128904,0.004213032042312742,0.13821242421395397,0.13399939217164122,11184672,6021970.8,82.34568662859492,77.48839560491054,NaN,NaN,15.231109607878224,15.965535794559099
2011-02-14T09:30:00-05:00,32.44,32.49001,32.31,32.49001,9054840,7338540,62.223534404856615,56.2352532733179,NaN,NaN,145.75273638114686,117.96363307261348,0.01149758861356881,0.14837137793860222,0.1368737893250334,20239512,9623779.6,84.96191058166272,78.01033404950716,NaN,NaN,16.534978706719325,16.046884782010558
2011-02-15T09:30:00-05:00,32.37,32.45,32.28999,32.42,5502352,7205654.85,59.51092374112119,56.33416804325933,NaN,NaN,112.18163533729272,111.42002430641544,0.00974495809888079,0.1490549869486344,0.1393100288497536,14737160,11092664.8,85.8808453133068,78.52408620110758,NaN,NaN,16.882591494263753,16.166271455189587
2011-02-16T09:30:00-05:00,32.5,32.7074,32.47,32.59,4258652,6921770.25,63.65434264945564,56.54889676842873,NaN,NaN,181.07055141343122,128.1179544116348,0.017714536347968962,0.1614531992847148,0.14373866293674584,18995812,14399956.2,87.7029094652574,79.12039946354238,NaN,NaN,18.412148077680673,16.487110972688313
2011-02-17T09:30:00-05:00,32.50999,32.75999,32.45,32.73,8771984,6919614.75,66.67853148419385,58.36520404460507,NaN,NaN,176.22623732868166,144.5197401452886,0.02940512331263856,0.18049506707754404,0.15108994376490548,27767796,18584990.4,89.54204224020714,80.5750820473551,NaN,NaN,20.65375230506599,17.082345448742267
2011-02-18T09:30:00-05:00,32.71001,32.85001,32.64999,32.81,4583117,6744786.4,68.30161244477227,60.129981536880585,NaN,NaN,186.86452628786782,160.41913734968404,0.03891904651271405,0.19973875190579804,0.160819705393084,32350913,22818238.6,91.00714390461806,82.25691564339705,NaN,NaN,23.020217240645852,17.930612847585635
2011-02-22T09:30:00-05:00,32.48,32.63,32.23,32.31,12072430,7162837,51.43758438784839,59.6456313968907,NaN,NaN,45.678451241475024,140.4042803217497,0.009466994065209983,0.17265344797459647,0.1631864539093865,20278483,22826032.8,91.00964126027783,83.73790538367828,NaN,NaN,19.496966060378394,18.154377592270315
2011-02-23T09:30:00-05:00,32.22,32.32001,31.99001,32,9818613,7253647.15,44.157862682966886,58.853907166359065,NaN,NaN,-55.04208983856271,106.9595352865786,-0.03076047283439351,0.1247358628663946,0.1554963357007881,10459870,21970574.8,88.1172598207227,84.78315258227452,NaN,NaN,13.766363251710764,17.527518400761807
2011-02-24T09:30:00-05:00,31.94,32.17999,31.87,32.11,9071523,7323638.15,47.02294872146631,58.20023956293752,NaN,NaN,-69.43194833995477,56.859035335901396,-0.048759442327280106,0.09454703279168797,0.14330647511896807,19531393,22077691,88.16796691072776,85.64228763200992,NaN,NaN,10.283455018982519,16.492652203364766
2011-02-25T09:30:00-05:00,32.21001,32.37,32.14,32.31,6129152,7286394.75,51.85922100289111,57.66591433002933,NaN,NaN,4.344259927998411,22.482639855764752,-0.04602776218480853,0.08577177238795741,0.13179953457276594,25660545,21656240.8,86.60209485346554,86.06011307351018,NaN,NaN,9.098635571033645,15.436364113031749
2011-02-28T09:30:00-05:00,32.42999,32.71001,32.31,32.66901,15415500,7502368,59.08050550233047,57.75628514863062,NaN,NaN,100.30369473670493,5.170473545532175,-0.020193158353153523,0.10655808663132404,0.12675124498447757,41076045,23401267.2,87.58525375509242,86.45365246846232,NaN,NaN,10.728558943744709,14.763820517419314
2011-03-01T09:30:00-05:00,32.77,32.81,32.39999,32.41251,10264594,7564517.6,52.967228207226725,57.26327812977739,NaN,NaN,83.87970533883214,12.81072436500359,-0.02046676811750807,0.10116778483759248,0.12163455295510055,30811451,25507860.8,88.666476580641,86.9049161772423,NaN,NaN,9.820364694335264,14.05761254269302
2011-03-02T09:30:00-05:00,32.36,32.569,32.31,32.50999,11750613,7499181.65,54.87809390688373,57.075577512888124,NaN,NaN,44.72075235903093,32.763292804522315,-0.014453332745006209,0.10356788702384279,0.118021219768849,42562064,31928299.6,91.18600288096873,87.51873586904833,NaN,NaN,9.780606220054905,13.446611639459004
2011-03-03T09:30:00-05:00,32.71001,33.2,32.71001,33.17999,11736387,7854619.15,65.31026200162776,57.61533697450922,NaN,NaN,232.32570607737728,93.11482368798872,0.03175529745783484,0.15771534159114253,0.1259600441333077,54298451,38881711.2,93.00077405961335,88.26971487536825,NaN,NaN,13.891689680714919,13.510194216781278
2011-03-04T09:30:00-05:00,33.16,33.23,32.8999,33.13499,8822723,7979940.45,64.23605398819808,57.95133608041707,NaN,NaN,206.1387318604577,133.4737180744806,0.05503315794265978,0.1947514915616324,0.13971833361897262,45475728,42844747.8,93.78606486654955,89.08688474950786,NaN,NaN,16.528181826893615,13.941335303940184
2011-03-07T09:30:00-05:00,33.21001,33.21001,32.68111,32.88,8393375,8180604.7,58.37679704580019,57.67656912619875,NaN,NaN,129.48416206107646,139.30981153935488,0.04919168937553314,0.20120794533838904,0.1520162559628559,37082353,42046009.4,91.55644620107181,89.55792300803708,NaN,NaN,16.57582537012961,14.31769102768153
2011-03-08T09:30:00-05:00,32.89999,33.16,32.78,33.06,5819426,8014312.15,61.07588173591461,57.788351840112576,NaN,NaN,130.36177537760875,148.60622554711023,0.05305293670214159,0.2183324268405329,0.1652794901383913,42901779,44464075,92.16380549682545,90.00670587828843,NaN,NaN,17.550819108249765,14.779566467762706
2011-03-09T09:30:00-05:00,33.05,33.2,32.94,33.11,8018082,8157102.95,61.81657447131599,57.657082684531176,NaN,NaN,131.77345785966452,166.01676664723692,0.05437603074228495,0.23324952856624748,0.17887349782396253,50919861,46135634.4,92.56210422113053,90.35379121799365,NaN,NaN,18.54946409829806,15.318123272124899
2011-03-10T09:30:00-05:00,32.85001,32.92,32.56,32.5925,12788813,8549874.65,50.9994910909984,56.537151227874354,NaN,NaN,28.115341228443942,125.17469367745025,0.017698442509062523,0.20099655096029068,0.18329810845122815,38131048,42902153.8,83.69953053198374,89.93646895312054,NaN,NaN,15.624988805769771,15.361961205502737
2011-03-11T09:30:00-05:00,32.59,32.78999,32.47,32.7,8036203,8732521.3,52.845407505423154,55.43313658934942,NaN,NaN,14.241170186606508,86.79518134268002,-0.0010288358399996589,0.18201206365122857,0.18304089949122823,46167251,43040458.4,83.77110639645772,89.41960913110908,NaN,NaN,13.954338753407319,15.16087228377482
2011-03-14T09:30:00-04:00,32.55,32.75,32.39999,32.53999,7612977,8896067.8,49.83601984690894,55.31873912213945,NaN,NaN,-13.679940434209831,58.16236084362278,-0.024593011155408795,0.15229963554696724,0.17689264670237603,38554274,43334842.6,83.9328281654773,88.91412248148049,NaN,NaN,11.612290477265882,14.653932025702115
2011-03-15T09:30:00-04:00,31.99001,32.32001,31.84,32.16,12933520,9090001.8,43.50059418574259,55.27179137233772,NaN,NaN,-129.2976826218307,6.230469243734888,-0.06393614401460351,0.09697246668412163,0.16090861069872514,25620754,39878637.6,74.54110894713509,87.94439741908137,NaN,NaN,7.404416785010313,13.618286991317571
2011-03-16T09:30:00-04:00,32.11,32.12,31.44,31.60001,20909392,9860353.8,36.19754321313222,54.498548121742424,NaN,NaN,-197.07616988054528,-59.539456304307066,-0.12244824581913938,0.007848303424800918,0.1302965492439403,4711362,30636937.8,56.37579308631609,85.67352786019482,NaN,NaN,0.9581097337102434,11.809690240230811
2011-03-17T09:30:00-04:00,31.92,32.06,31.81,31.97,10336148,10164228.6,43.00577584411407,53.86615918182978,NaN,NaN,-122.10440887804882,-89.58340632560561,-0.1302795496126036,-0.0325528877718142,0.0977266618407894,15047510,26020230.2,49.84143623327773,83.04776653018143,NaN,NaN,-1.8402509471746875,9.859698642030025
2011-03-18T09:30:00-04:00,32.16,32.215,31.89,31.97,16715156,10561387.2,43.00577584411407,52.71796420624288,NaN,NaN,-92.65822437031522,-110.96328523698995,-0.12924954516696047,-0.0638352696179112,0.06541427554904927,15047510,19796282,42.66229238665477,79.83898357529303,NaN,NaN,-3.936296712706186,7.888842162781995
2011-03-21T09:30:00-04:00,32.21001,32.5,32.17,32.2375,8786430,10771552.85,47.68650871257255,52.34076995662473,NaN,NaN,-34.26226120288145,-115.07974939072429,-0.10535362799500683,-0.06627775944470926,0.039075868550297564,23833940,16852215.2,39.745932155702334,76.34465897351167,NaN,NaN,-4.116983240234998,6.173724248065282
2011-03-22T09:30:00-04:00,32.35001,32.41,32.2,32.22,6418512,10488856.95,47.41217961362913,51.807490364249404,NaN,NaN,-37.61287240612036,-96.74278734758221,-0.08632637513581376,-0.06883210036946963,0.017494274766344124,17415428,15211150,38.17922804760692,72.5584607711287,NaN,NaN,-4.342720717417348,4.671374967282049
2011-03-23T09:30:00-04:00,32.16,32.27,31.95,32.2,7350105,10365431.55,47.07884624519261,50.50524638164689,NaN,NaN,-64.85426784131064,-70.29840693973529,-0.07131093567065969,-0.07164439482198048,-0.00033345915132080087,10065323,16281942.2,39.84542749616323,68.76165030231083,NaN,NaN,-4.620460883862035,3.3439698456900375
2011-03-24T09:30:00-04:00,32.32001,32.63,32.2,32.58,10606172,10442164,53.73441550962349,49.75512934746299,NaN,NaN,-4.7873126563806645,-46.83498769540166,-0.033907559693568665,-0.04271790876828163,-0.008810349074712969,20671495,17406739.2,41.625228271624806,65.03587625981622,NaN,NaN,-2.8037786698975014,2.4657200577489604
2011-03-25T09:30:00-04:00,32.58,32.81,32.57001,32.67,5297848,10400598.8,55.17237044010788,49.52624173277069,NaN,NaN,35.69837127766383,-21.163668565805843,-0.0028624459318576136,-0.012388406489534987,-0.009525960557677373,25969343,19591105.8,45.02687518459083,61.71233547292473,NaN,NaN,-0.887202247237918,1.9867311570365493
2011-03-28T09:30:00-04:00,32.67999,32.74001,32.64999,32.66,3930114,9826329.5,54.96794314542274,49.08996040487841,NaN,NaN,33.85484084607399,-7.540248156014748,0.016194753801780922,0.01071748169454878,-0.0054772721072321425,22039229,19232163.6,44.56729217858082,58.31258452162153,NaN,NaN,0.605858782498519,1.789463674959688
2011-03-29T09:30:00-04:00,32.63,32.86,32.59,32.85001,4032862,9514742.9,58.141607032343586,48.82746273066609,NaN,NaN,47.25711450897697,9.433749227004723,0.039466411186939165,0.04385574187644181,0.004389330689502649,26072091,20963496.2,47.35831022208524,55.083742093118296,NaN,NaN,2.817246192868383,1.9362897489466444
2011-03-30T09:30:00-04:00,33.00999,33.25999,33.00999,33.09,5209727,9187698.6,61.8031802474816,49.599154813272044,NaN,NaN,105.29244483980547,43.46309176322794,0.06725932514901523,0.08846348712577168,0.021204161976756456,31281818,25206795.2,53.533424874330855,52.92902026042881,NaN,NaN,5.846343423523001,2.494868845314695
2011-03-31T09:30:00-04:00,33.07001,33.23,33.02,33.11,3284618,8765110.15,62.10071501524178,50.26024820683051,NaN,NaN,103.25475942099281,65.07150617870265,0.08223657919627811,0.1239998859721041,0.04176330677582599,34566436,27985783.4,57.08402631809764,51.02280025483166,NaN,NaN,8.405119467144022,3.3391903627188846
2011-04-01T09:30:00-04:00,33.23,33.35001,33.17,33.28,3934582,8520703.1,64.62322213094338,51.3164769414044,NaN,NaN,126.18756961819896,83.16934584680966,0.09778130925754566,0.16398994334775807,0.06620863409021241,38501018,30492118.4,60.04903287765819,49.31681487713029,NaN,NaN,11.351420992801978,4.483794738445041
2011-04-04T09:30:00-04:00,33.39,33.545,33.39,33.48,4287637,8315416.2,67.37444077345768,53.021751697669764,NaN,NaN,148.62741737366576,106.12386115232803,0.11455850838588935,0.2094067695725741,0.09484826118668474,42788655,34642003.6,64.43091803995429,48.59465838376024,NaN,NaN,14.734115624895638,5.948126293652269
2011-04-05T09:30:00-04:00,33.35001,33.42999,33.28999,33.33,4332906,8241090.2,63.39253570712779,54.96425116152659,NaN,NaN,119.91833073329435,120.65610439719151,0.10863142239768335,0.23063753918378893,0.12200611678610558,38455749,37118735.2,66.7732533253266,49.33733411511814,NaN,NaN,16.50656797942438,7.456475105905428
2011-04-06T09:30:00-04:00,33.42999,33.50999,33.36,33.39999,3956633,8038017.75,64.44834379278535,56.495863157860256,NaN,NaN,124.49163981716451,124.49594339266332,0.10257609287278727,0.25022623287708967,0.1476501400043024,42412382,39344848,68.76429617102121,50.6889669678141,NaN,NaN,18.285832917727753,9.003526221880046
2011-04-07T09:30:00-04:00,33.32001,33.47501,33.23,33.34,7039391,7750546.65,62.777083768470966,57.90809943817146,NaN,NaN,99.89292720243155,123.82357694895106,0.0882290015555551,0.2579363919487463,0.1697073903931912,35372991,39506159,68.9096811245158,52.56378044908989,NaN,NaN,19.33299024586279,10.479163939591865
2011-04-08T09:30:00-04:00,33.39999,33.5,33.23,33.32001,6910414,7694257.2,62.19828276694463,58.94465472776947,NaN,NaN,88.31098503855397,116.24826003302205,0.0717885076305615,0.25944302493139304,0.18765451730083155,28462577,37498470.8,64.86314752149721,54.35786726093237,NaN,NaN,20.059184692642777,11.847738332884852
2011-04-11T09:30:00-04:00,33.42,33.59,33.42,33.50999,8928734,7760045.05,65.45783170006058,60.233629876800286,NaN,NaN,96.79849365082178,105.88247528845326,0.0681339217067291,0.27282191943424294,0.20468799772751384,37391311,36419002,62.730209860043324,56.11150881896354,NaN,NaN,21.59683136884707,13.240465909450883
2011-04-12T09:30:00-04:00,33.37,33.60001,33.37,33.47,6205348,7423636.45,64.20287524147554,61.45677480510621,NaN,NaN,84.10815425460571,98.72043999271553,0.05785343550908589,0.2770047921138712,0.2191513566047853,31185963,34965044.8,59.87428551336609,57.542141534478034,NaN,NaN,22.56597669424586,14.572681735850166
2011-04-13T09:30:00-04:00,33.46001,33.57001,33.37,33.44,4451090,6600721.35,63.2236088297245,62.13457432797056,NaN,NaN,75.01979258978504,88.82607054723962,0.04446456223847517,0.27473205940287926,0.2302674971644041,26734873,31829543,54.1489598798706,58.43669379220987,NaN,NaN,23.13813597474894,15.796318055692847
2011-04-14T09:30:00-04:00,33.42,33.67999,33.28999,33.62,8318617,6499844.8,66.52296569309624,62.94533113175545,NaN,NaN,79.0978614990516,84.66705740656364,0.04312964470100927,0.28417955304066567,0.2410499083396564,35053490,31765642.8,54.03555823928116,59.08017115325919,NaN,NaN,24.53902218241924,17.045275788082332
2011-04-15T09:30:00-04:00,33.78999,34.00999,33.75,33.92,9762949,6152234.45,71.16596884298508,64.10233296729562,NaN,NaN,127.17715620904094,92.44029164066103,0.05697971014993597,0.3122745460270764,0.2552948358771404,44816439,35036415.2,58.79260253690426,60.09626475028228,NaN,NaN,27.211837863736893,18.497641798890125
2011-04-18T09:30:00-04:00,33.7,33.7,33.35001,33.53999,7612281,6093527,59.8438002051625,64.22391819392554,NaN,NaN,66.27244472473711,86.3350818554441,0.03609486757785352,0.3004134203494573,0.26431855277160377,37204158,34998984.6,58.71770880801006,60.90765036356263,NaN,NaN,26.09795639175249,19.58340102644189
2011-04-19T09:30:00-04:00,33.60001,33.84,33.54021,33.82001,5456938,6045448.3,64.3452587179865,64.40549522753304,NaN,NaN,97.6242652052956,89.03830404558208,0.03657298068850573,0.31003477863223594,0.2734617979437302,42661096,37294011.2,61.92071087796487,61.50674222096506,NaN,NaN,26.60150261200761,20.585986967236995
2011-04-20T09:30:00-04:00,34.17999,34.28,34.07001,34.14999,7125840,6034235.05,68.78580172438566,64.88300142104332,NaN,NaN,181.77747524240579,110.38984057610621,0.053520890335955806,0.340362910863675,0.2868420205277192,49786936,41904423.8,67.39377677547031,62.24315296792025,NaN,NaN,28.555508799306235,21.72449008610403
2011-04-21T09:30:00-04:00,34.36,34.45,34.13,34.25,4834453,5745649.1,70.00509121115832,65.26742064105866,NaN,NaN,194.0914251030494,133.38855329690577,0.06510517886749406,0.36822349411208677,0.3031183152445927,54621389,45818003.6,71.18037520963763,63.03824884877593,NaN,NaN,30.51004517086006,22.97956938392632
2011-04-25T09:30:00-04:00,34.14,34.32001,34.11,34.28999,6355184,5798515.9,70.50128396513706,65.49076658332147,NaN,NaN,168.1504094859632,141.5832039522902,0.06874166199283133,0.3890453927356319,0.32030373074280055,60976573,49050030.4,73.87833263044305,63.71306417666798,NaN,NaN,32.21549649594695,24.29898754278641
2011-04-26T09:30:00-04:00,34.34,34.7399,34.34,34.69,5849270,5894473.7,74.96288981267614,66.3172204480035,NaN,NaN,197.04857770833328,167.73843054900945,0.09002494338465106,0.4328349099736144,0.34280996658896334,66825843,54974367.4,77.95263254191919,64.51159126356745,NaN,NaN,35.25279636405735,25.863817374396543
2011-04-27T09:30:00-04:00,34.64999,35.14,34.63,35.08,8748285,6130244.85,78.39404251402033,67.31334178523457,NaN,NaN,209.01959087570953,190.01749568309225,0.12040919140413503,0.4933214558441321,0.3729122644399971,75574128,61556973.8,81.42027422978394,65.41558969633621,NaN,NaN,39.11362225871836,27.756646643585373
2011-04-28T09:30:00-04:00,35.08,35.28,35.05,35.25999,5221047,6130810.85,79.77182601439472,68.5272519456577,NaN,NaN,196.6709745115398,192.99619553691906,0.14122817202020832,0.5494474794652575,0.4082193074450492,80795175,67758621.6,83.97715765844572,66.49183802018834,NaN,NaN,42.69589682195266,29.890825240494983
2011-04-29T09:30:00-04:00,35.33,35.35001,35.19,35.24001,11660051,6549582.5,79.16830747867479,69.73939656792413,NaN,NaN,168.63874819336257,187.9056601549817,0.14187695716704712,0.5855655039038581,0.44368854673681096,69135124,70661368.6,85.01652920666139,67.93136528341437,NaN,NaN,45.28951969099969,32.09063873342423
2011-05-02T09:30:00-04:00,35.48,35.67,35.42999,35.60001,14847246,7095215.7,81.83497450925424,70.90919248286653,NaN,NaN,168.97440555661873,188.0704593691128,0.1537755137792184,0.635907938960834,0.4821324251816156,83982370,75262528,86.51027637285901,69.6299414629012,NaN,NaN,48.46397367480708,34.429686582193206
2011-05-03T09:30:00-04:00,35.52,35.60001,35.325,35.50999,11296957,7445681.7,79.10797115235385,71.97384219078641,NaN,NaN,135.98349497055466,175.85744282155707,0.1430317566298147,0.660922120968884,0.5178903643390693,72685413,76434442,86.86933433286565,71.5581592357226,NaN,NaN,50.139307158172976,36.67391809304746
2011-05-04T09:30:00-04:00,35.46001,35.535,35.28999,35.479,9466824,7702377.6,78.14258350474299,73.03948323900202,NaN,NaN,115.50741299580956,157.15500724557708,0.12210059976160126,0.6705161140410709,0.5484155142794697,63218589,73963334.2,81.91800830486888,73.54166269465104,NaN,NaN,51.18849742240309,38.74742942581255
2011-05-05T09:30:00-04:00,35.42,35.55,35.145,35.25,11723402,8090716.05,71.22560788305384,73.37538625257044,NaN,NaN,91.68758880098405,136.15833010346591,0.0829665963646955,0.6521237597353391,0.5691571633706436,51495187,68103336.6,71.50906673661336,74.78977044446049,NaN,NaN,49.97877895884021,40.351907930530786
2011-05-06T09:30:00-04:00,35.50999,35.67,35.355,35.5,7422965,8109894.75,73.93784702270028,73.57337755112152,NaN,NaN,96.57753549856389,121.74608756450618,0.06485443384840739,0.6502252056811528,0.5853707718327454,58918152,66059942.2,68.25231955862294,75.46546451744041,NaN,NaN,49.75972544088102,41.69588186058082
2011-05-09T09:30:00-04:00,35.32001,35.74001,35.32001,35.7,9030531,8215900.6,75.89532869886972,74.71991530067203,NaN,NaN,93.03703651271942,106.55861375572631,0.05752912385906728,0.6572821766565795,0.5997530527975122,67948683,62853204.8,63.374420405317444,75.79808677439094,NaN,NaN,50.17722767397791,42.90750269106612
2011-05-10T09:30:00-04:00,35.85001,35.92999,35.64,35.92,7772367,8158082.25,77.86479407780332,75.6855963978018,NaN,NaN,103.21421925659197,100.00475861293376,0.05849404167783345,0.6728706048948041,0.6143765632169707,75721050,63460332.2,63.90045970752632,75.9394974050739,NaN,NaN,51.1456628106405,44.084382708148176
2011-05-11T09:30:00-04:00,35.96001,36.05,35.67,35.86,13494828,8522556.25,76.04004663140553,76.20375674830322,NaN,NaN,96.69512382578853,96.24230077892956,0.046602265469744886,0.6726293950541518,0.6260271295844069,62226222,63261858.8,63.57897938260054,75.66701187701176,NaN,NaN,51.37952785919268,45.126546301154534
2011-05-12T09:30:00-04:00,35.73,36.2,35.63,36.19,7883406,8694172.05,78.9604653767401,76.84342633155906,NaN,NaN,102.38534312243293,98.38185164321933,0.052058221979456976,0.691099907058728,0.6390416850792711,70109628,66984747,66.93890749139902,75.36404989713758,NaN,NaN,52.5009741478307,46.18003599353684
2011-05-13T09:30:00-04:00,36.25,36.34,35.89,36.08,10093785,8782930.45,75.650420119821,77.21122177117934,NaN,NaN,105.11799228214649,100.08994299993587,0.03990296772151347,0.6889203947311628,0.6490174270096494,60015843,67204285.2,67.1314705323316,74.88213117584391,NaN,NaN,52.40441295802108,47.06923270274888
2011-05-16T09:30:00-04:00,36,36.28,35.92999,36.14,7558371,8672701.55,76.23560650836083,77.3021301065854,NaN,NaN,100.8055151079892,101.64363871898982,0.02810460216807953,0.6841481797197488,0.6560435775516693,67574214,67129391.4,66.98812834428988,74.09895230458467,NaN,NaN,52.49547979781877,47.844410859187434
2011-05-17T09:30:00-04:00,35.97,36.16,35.89,36.14,7883059,8686240.45,76.23560650836083,77.14795610618114,NaN,NaN,93.47413574269476,99.69562201621038,0.013255301456361002,0.6726127043721206,0.6593574029157596,67574214,65500024.2,63.79656862363894,72.84011618986003,NaN,NaN,52.56938160112471,48.51940667946419
2011-05-18T09:30:00-04:00,36.14,36.44501,36.08,36.42,5667672,8696777.15,78.9708757295781,77.09074537155139,NaN,NaN,119.30267771477848,104.21713279400838,0.015110892930130015,0.6782460190784221,0.6631351261482921,73241886,67703157,66.14528554624579,71.56641103898862,NaN,NaN,53.43143135163647,49.22112448977452
2011-05-19T09:30:00-04:00,36.57001,36.57001,36.17,36.34,17064688,9193719.55,76.26976498215727,76.88370662180013,NaN,NaN,119.42077916745872,107.62422000301353,0.004330714270985192,0.6685485189870235,0.6642178047160383,56177198,64916671,60.774893161187336,69.83486560716905,NaN,NaN,53.3770888503307,49.814833684139685
2011-05-20T09:30:00-04:00,36.36,36.36,35.92999,36.03999,11715352,9537764.5,67.01289349253094,75.82498654917704,NaN,NaN,77.84912212469432,102.1704459715231,-0.027854600323570233,0.6293995543115756,0.6572541546351458,44461846,61805871.6,55.370063981314594,67.61056472205874,NaN,NaN,50.511051584930385,49.914293384252645
2011-05-23T09:30:00-04:00,35.66,35.74001,35.50999,35.67,27913184,10615664.5,57.71029901192122,74.29658139628899,NaN,NaN,-4.327976585059397,81.14374763291337,-0.07617150590670452,0.5620397722517652,0.6382112781584697,16548662,51600761.2,42.13256239110813,64.4150810119332,NaN,NaN,44.875060364366135,49.194402952840285
2011-05-24T09:30:00-04:00,35.66,35.72,35.53,35.57001,10177465,10832074.25,55.46926029726335,72.67705831004045,NaN,NaN,-21.791412861048716,58.090637912164674,-0.11466214866942226,0.4948835923216919,0.6095457409911141,6371197,39360157.8,32.19133880083356,60.86317604735924,NaN,NaN,39.59109805683026,47.822502253410285
2011-05-25T09:30:00-04:00,35.41,35.705,35.41,35.62,7246441,10756982.05,56.381230597907,71.61674564681569,NaN,NaN,-36.90392611351844,26.849317146505296,-0.13514342571629467,0.44061645884574574,0.5757598845620404,13617638,27435308.2,25.803719220665243,57.59850836764866,NaN,NaN,35.580106290547235,46.073588544429846
2011-05-26T09:30:00-04:00,35.53999,35.71001,35.33,35.67,6588230,10825341.2,57.32266407640004,70.4299468649371,NaN,NaN,-45.31874163845557,-6.098587014677561,-0.1429544614648146,0.3970668077310222,0.5400212691958368,20205868,20241042.2,22.85700756431399,54.355986082340884,NaN,NaN,32.54546046314636,44.1409988185322
2011-05-27T09:30:00-04:00,35.67,35.72,35.52,35.69,7043594,10594518.35,57.71579667458865,69.13140886320272,NaN,NaN,-34.85248944782771,-28.638909329181963,-0.14400327580997063,0.36001717443337355,0.5040204502433442,27249462,16798565.4,21.586694697729413,51.37114853179888,NaN,NaN,30.149169181855722,42.14216601329271
2011-05-31T09:30:00-04:00,35.95,36.12,35.81,36.11,10185875,10361449.8,65.00599555174321,68.21292325419844,NaN,NaN,50.79083581780012,-17.61514684861006,-0.11490340208292665,0.36039119763968586,0.4752945997226125,37435337,20975900.4,26.89608812839758,48.72797913328968,NaN,NaN,30.063033437251974,40.41657564528689
2011-06-01T09:30:00-04:00,35.99001,36.08,35.58,35.61,12042414,10398722.65,53.238313845788895,66.58422805522582,NaN,NaN,-16.666763968490926,-16.590217070098507,-0.12688274083175466,0.3166911736829192,0.4435739145146739,25392923,24780245.6,31.44845928787484,46.43294198366642,NaN,NaN,25.976974092140132,38.353775423408784
2011-06-02T09:30:00-04:00,35.62,35.6236,35.39,35.53,7604109,10305586.9,51.62793908886963,64.63190474894937,NaN,NaN,-81.80110180276647,-25.56965220794811,-0.1368891471562061,0.27246248056941624,0.40935162772562234,17788814,25614480.8,32.441958154745606,43.96887417390546,NaN,NaN,22.22046331725622,36.049016551101275
2011-06-03T09:30:00-04:00,35.13,35.38989,35.13,35.19,12026672,10320750.4,45.34953690936787,62.4675559482027,NaN,NaN,-151.6652013059604,-46.838944141449076,-0.16141499984118657,0.2075828779241391,0.36899787776532567,5762142,22725735.6,30.77853221135372,41.37223572240704,NaN,NaN,16.825440144272687,33.30279135012576
2011-06-06T09:30:00-04:00,35.09,35.17999,34.92999,34.98,6513633,10275283.8,41.95577658366931,60.01899666786759,NaN,NaN,-182.1306976080684,-76.29458577349722,-0.1850914807598955,0.13763352681545626,0.3227250075753518,-751491,17125545,27.802370704160865,38.5732530338264,NaN,NaN,11.2372213537702,30.15056706493211
2011-06-07T09:30:00-04:00,35.23,35.35001,35.03,35.05099,8213680,10234441.25,43.495193548072635,57.68039574213272,NaN,NaN,-138.92140826281596,-114.23703458962044,-0.18864044537635444,0.08692445085490874,0.2755648962312632,7462189,11130915.4,25.014084027225067,35.80307556265397,NaN,NaN,7.274819484145126,26.88260312481968
2011-06-08T09:30:00-04:00,35.00999,35.145,34.939,35.09,6631078,10177376.8,44.36833138192709,55.208785431586215,NaN,NaN,-135.3131685908813,-137.9663155140985,-0.1809987692755986,0.04931643463676494,0.23031520391236354,14093267,8870984.2,24.035438985908414,32.795229379772735,NaN,NaN,4.354744602480918,23.66433762162843
2011-06-09T09:30:00-04:00,35.17,35.63,35.11,35.46001,6970953,9851183.05,51.95223493540388,53.47181899967526,NaN,NaN,-60.97993582478282,-133.80208231850176,-0.1452074261293959,0.04880592125061867,0.19401334738001458,21064220,9526065.4,24.952006128295906,30.236451734566206,NaN,NaN,4.132635252189129,20.874094425994244
2011-06-10T09:30:00-04:00,35.32001,35.32001,34.78,34.80499,17102512,10312138.35,41.235396718146205,51.63056923007635,NaN,NaN,-130.2545777759742,-129.51995761250456,-0.1587327212253229,-0.004402554151639038,0.15433016707368385,3961708,9165978.6,24.775050431773423,28.051093623884693,NaN,NaN,0.0782602232737845,17.90326096846275
2011-06-13T09:30:00-04:00,34.78999,35.13499,34.78999,34.98,10150664,10314982.3,44.52792732041837,50.68897125211186,NaN,NaN,-118.54106344541194,-116.80203077997325,-0.14912735195236682,-0.032079022866774665,0.11704832908559215,14112372,12138751.2,29.236805070656047,27.12996810099526,NaN,NaN,-1.9802052343938032,15.062765796626099
2011-06-14T09:30:00-04:00,35.25,35.41901,35.14999,35.28,8585711,10366349.3,49.72771608134965,50.27886095097517,NaN,NaN,-53.87741779911521,-99.7932326872331,-0.1172111984968133,-0.02946566903542447,0.08774552946138883,22698083,15185930,33.58520563090724,27.22953001742909,NaN,NaN,-1.8714882631348535,12.643586645231677
2011-06-15T09:30:00-04:00,35.13,35.2384,34.72,34.8,15194078,10731900.25,42.812763100321135,49.30968470114761,NaN,NaN,-110.2749397040632,-94.78558690986947,-0.12249480499742334,-0.06537297678539034,0.057121828212033,7504005,13868077.6,32.650728865470484,27.718602134915184,NaN,NaN,-4.26272615666114,10.228399102104131
2011-06-16T09:30:00-04:00,34.81,34.96001,34.63,34.86,10648922,10980962.75,43.86358731247062,48.348322075152645,NaN,NaN,-117.5103820180882,-106.09167614853057,-0.11607679607565183,-0.08797416688253179,0.028102629193120045,18152927,13285819,32.22411465905461,28.38768121311094,NaN,NaN,-5.737278896504192,7.9475879594458
2011-06-17T09:30:00-04:00,34.98,35.07001,34.66,34.77,17370256,10996241.15,42.599120224421064,47.26855947156925,NaN,NaN,-105.68164190620375,-101.17708897457648,-0.11196897101250916,-0.1118585845725164,0.00011038643999275455,782671,12650011.6,31.736478924091045,29.112665800708196,NaN,NaN,-7.308263274050443,5.768180640374908
2011-06-20T09:30:00-04:00,34.7,35.16,34.64999,35.12,8445184,10832732.75,48.782576939184345,46.109743856386466,NaN,NaN,-70.3833357465759,-91.54554343480928,-0.08118949140022133,-0.10137647781028392,-0.02018698641006258,9227855,11673108.2,30.961226012692734,29.40303279244356,NaN,NaN,-6.62917939190826,3.9971292071915983
2011-06-21T09:30:00-04:00,35.25999,35.42,35.16,35.34,12641551,10069151.1,52.26356159843652,46.0401186958613,NaN,NaN,5.939085831090381,-79.58224270876816,-0.04341749563674655,-0.07445885595599577,-0.03104136031924922,21869406,11507372.8,30.82365808783203,29.358404135297643,NaN,NaN,-4.9316557563002625,2.7215884981213323
2011-06-22T09:30:00-04:00,35.28999,35.37,35.11,35.13,7642316,9942393.65,48.85056927094302,45.84173513743797,NaN,NaN,-14.154539392622507,-60.35816264648001,-0.030585434837025346,-0.0692731538655309,-0.038687719028505554,14227090,12851989.8,33.408797072892625,29.42746405802243,NaN,NaN,-4.602626530832166,1.67527206541369
2011-06-23T09:30:00-04:00,35,35.13,34.63,35.09,19459328,10553038,48.20483726810354,46.04568516306195,NaN,NaN,-70.13300784963828,-50.88268781279004,-0.023139206695051928,-0.06761172739732046,-0.044472520702268536,-5232238,8174956.8,29.30633699388541,29.322307256774696,NaN,NaN,-4.5333389443164975,0.7883276354522346
2011-06-24T09:30:00-04:00,35.08,35.08,34.62,34.67999,11041953,10775724.15,42.06665472377772,46.05360503021255,NaN,NaN,-100.33860301127353,-49.81408003380399,-0.04301949256208899,-0.09824688640487977,-0.05522739384279078,-16274191,4763584.4,26.728250744290037,29.245584402498206,NaN,NaN,-6.41296438263573,-0.2404283671317602
2011-06-27T09:30:00-04:00,34.75,34.95,34.53999,34.86,6268105,10736949.7,45.35649342966067,46.18655502175455,NaN,NaN,-95.95220918639774,-54.927854721768355,-0.04123360244046306,-0.10676939689336962,-0.06553579445290655,-10006086,916796.2,24.14848849682815,29.183756150327003,NaN,NaN,-6.941460488319991,-1.1977186701586502
2011-06-28T09:30:00-04:00,34.92999,35.44,34.89,35.35001,9300152,10692663.55,53.15485829039105,46.81416408664484,NaN,NaN,37.62055008110659,-48.591561871765116,-0.006083936759801498,-0.07314071540265843,-0.06705677864285693,-705934,-3598271.8,21.52271691761827,29.00427600259199,NaN,NaN,-4.811167285699089,-1.7139256152358557
2011-06-29T09:30:00-04:00,35.53999,35.53999,35.32001,35.42,6541609,10417623.3,54.16112855653982,46.97194220244025,NaN,NaN,116.60474477678065,-22.439705037884462,0.02134406488630068,-0.040376697534981076,-0.06172076242128176,5835675,-5276554.8,20.62498589283669,28.695203128630617,NaN,NaN,-2.8057387526611057,-1.86989892058232
2011-06-30T09:30:00-04:00,35.57001,35.62981,35.45,35.53,11835754,10629205.55,55.76923899022177,48.010073793302794,NaN,NaN,153.54277275235233,22.295451082513658,0.04499915322813369,-0.005471820886114642,-0.050470974114248335,17671429,-695821.4,29.293825823437857,29.017972799463788,NaN,NaN,-0.6766366350979051,-1.699432879798832
2011-07-01T09:30:00-04:00,35.53,35.98,35.505,35.96001,10374813,10546612.6,61.46107184761008,49.21958411667363,NaN,NaN,205.89406081461044,83.54198384769045,0.08536914221095393,0.05624045364944408,-0.029128688561509852,28046242,8168265.2,42.402639907262746,29.958389573507123,NaN,NaN,3.073392153364155,-1.0176007322041196
2011-07-05T09:30:00-04:00,35.99001,35.99001,35.73711,35.86,6410500,10541455.95,59.54195947718932,49.920601502090754,NaN,NaN,179.9987460039574,138.73217488576148,0.10008023384325196,0.09597160374255509,-0.004108630100696863,21635742,14496630.8,49.58848815805922,31.101481182589403,NaN,NaN,5.521181500197971,-0.08348898471810673
2011-07-06T09:30:00-04:00,35.8,36.00999,35.8,35.96001,6900059,10475774.9,60.85817212933653,51.20955928987757,NaN,NaN,162.44171133218578,163.69640713597732,0.11047435199912556,0.13398430989821009,0.02350995789908453,28535801,20344977.8,55.156512196581716,32.70903713481163,NaN,NaN,7.924682567253373,1.0605355227063904
2011-07-07T09:30:00-04:00,36.12,36.12219,35.8,35.94,7400035,10514222.75,60.4345342936278,52.39319835996023,NaN,NaN,143.5741429829455,169.09028677721028,0.1097066085581863,0.1606432185968174,0.050936610038631105,21135766,23404996,57.783904954889,34.534736441656946,NaN,NaN,9.760767929544043,2.3034258665403406
2011-07-08T09:30:00-04:00,35.7,35.82001,35.57001,35.78,6741168,10502733.5,57.01681516798427,53.42303371307189,NaN,NaN,88.61364536763635,156.1044613002671,0.09279919457927276,0.16693560326272205,0.0741364086834493,14394598,22749629.8,57.01344930423756,36.340234325953126,NaN,NaN,10.38500566235337,3.457937265942202
2011-07-11T09:30:00-04:00,35.47,35.53999,35.2,35.28999,11117121,10203463.95,48.053896745796166,53.370985127829876,NaN,NaN,12.143661656657216,117.35438146867644,0.04539008699121733,0.13087401742247096,0.08548393043125363,3277477,17795876.8,51.431279090853586,37.80238097439319,NaN,NaN,8.201138147699528,4.135537391907534
2011-07-12T09:30:00-04:00,35.27,35.6389,35.17,35.28999,5988703,9995365.9,48.05389674579617,53.0702947812127,NaN,NaN,13.210600537090844,83.99675237530315,0.012516212782127084,0.10112919640891249,0.08861298362678541,3277477,14124223.8,47.70319904820696,39.00806247156282,NaN,NaN,6.458102447517362,4.467332399851795
2011-07-13T09:30:00-04:00,35.47,35.77,35.33,35.42999,8597039,9995932.3,50.625712146641824,53.19709070090547,NaN,NaN,39.38401535618072,59.38521318010212,-0.0006180099779816289,0.08784047115430837,0.08845848113229,11874516,10791966.8,44.54717968775063,39.803661229766966,NaN,NaN,5.712752721820968,4.645249588704534
2011-07-14T09:30:00-04:00,35.5,35.62,35.28,35.37,9443574,9708407.1,49.4949195650822,53.289239436403946,NaN,NaN,17.86033440753882,34.2424514650208,-0.013452769987245955,0.07164251864823257,0.08509528863547852,2430942,7051002,41.24786707983423,40.6566276644776,NaN,NaN,4.777767086547147,4.664180659824907
2011-07-15T09:30:00-04:00,35.42,35.42999,35.00999,35.19,9994797,9675700.85,46.16307407567856,53.58184081868258,NaN,NaN,-33.452966828011306,9.829129025891259,-0.033055109468460464,0.04377640179990294,0.0768315112683634,-7563855,2659311.4,37.716317309128954,41.44148956196609,NaN,NaN,3.023138534903784,4.42974607055046
2011-07-18T09:30:00-04:00,35.07001,35.10001,34.67,34.92999,8569316,9235653.85,41.78715516324515,53.326888085367194,NaN,NaN,-105.27590445393194,-13.654784196226576,-0.060902361627168757,0.0007035592344024622,0.06160592086157122,-16133171,-1222818.2,34.87390308109761,42.20759060369962,NaN,NaN,0.1784925815389206,3.8224241435488118
2011-07-19T09:30:00-04:00,35,35.315,34.91499,35.24001,9930598,9309924.55,48.10390357879307,52.966105605967336,NaN,NaN,-50.2770920762029,-26.35232271888532,-0.05594077464065002,-0.008320047439241307,0.04762072720140871,-6202573,-3118828.2,33.54427029987784,43.066272988146736,NaN,NaN,-0.45641002240091766,3.2111621198417075
2011-07-20T09:30:00-04:00,35.28999,35.31,34.99001,35.12,6808332,9018263.6,46.02203650640502,52.384741888100564,NaN,NaN,-50.82076077701766,-44.39327794552501,-0.05799134710966035,-0.02486845668566673,0.03312289042399362,-13010905,-8095912.4,30.280543000369903,43.755955638684824,NaN,NaN,-1.602505101195749,2.523495373979214
2011-07-21T09:30:00-04:00,35.47,35.78999,35.3613,35.64999,14622883,9367291.95,55.23582403474498,52.34664081985222,NaN,NaN,49.26209381010464,-38.11292606501184,-0.022715855388069073,0.004728071188907279,0.027443926576976353,1611978,-8259705.2,30.176486625396407,43.81900283882472,NaN,NaN,0.3418541674094446,2.2118323444692467
2011-07-22T09:30:00-04:00,35.63,35.66,35.44,35.59,7642684,8776459.75,54.10993756337877,51.82155979954998,NaN,NaN,35.86090978146274,-24.25015074311703,-0.0034936805936393173,0.023076825834927206,0.026570506428566523,-6030706,-7953075.4,30.65689717977699,42.980021215432885,NaN,NaN,1.5417996485712604,2.1161133879123915
2011-07-25T09:30:00-04:00,35.28,35.46001,35.17999,35.22,6821027,8565413.45,47.65764715251286,50.97268034778738,NaN,NaN,-39.44707489423794,-11.084384831178232,-0.015117223165927663,0.007673977471156945,0.02279120063708461,-12851733,-7296787.8,31.739440312729045,41.70508922648072,NaN,NaN,0.5169946553219572,1.8876678546851866
2011-07-26T09:30:00-04:00,35.19,35.21001,34.89999,34.935,8696680,8686842.2,43.36788749684671,49.72337430260954,NaN,NaN,-118.32670038456571,-24.694306492850792,-0.04000598186019965,-0.027216276688164953,0.012789705172034696,-21548413,-10365955.8,29.425871511131433,39.86718632037714,NaN,NaN,-1.7567527974762713,1.3670363329478357
2011-07-27T09:30:00-04:00,34.78,34.8,34.28999,34.33,13037633,8873716.25,35.96677424395919,47.97567715620464,NaN,NaN,-222.40921788799784,-59.01199791504682,-0.092234881868929,-0.10250389716412656,-0.010269015295197555,-34586046,-14680984,26.501083185775897,37.632699051154766,NaN,NaN,-6.467630057554747,0.2477982771617524
2011-07-28T09:30:00-04:00,34.31,34.67999,34.25,34.3,13788359,9236053.75,35.641955658108344,46.44890147692779,NaN,NaN,-191.419460892056,-107.14830885547894,-0.12195674889623802,-0.16271495141549508,-0.04075820251925706,-48374405,-24678260.6,21.234879426042696,35.07708691699799,NaN,NaN,-10.181022971333183,-1.2420333297660955
2011-07-29T09:30:00-04:00,34.00999,34.36,33.78999,34.12,18230528,9555792.45,33.6767607609719,45.42196319229748,NaN,NaN,-204.14803629049186,-155.15009806986987,-0.14530825977446374,-0.22239352723733674,-0.077085267462873,-66604933,-36793106,16.86202824457972,32.60785471369272,NaN,NaN,-13.852333073780478,-3.04350472176815
2011-08-01T09:30:00-04:00,34.45,34.45,33.19,33.53999,27608496,10417476.6,28.268114237188072,44.00869301311119,NaN,NaN,-213.0660408417023,-189.87389125936275,-0.18863934683280698,-0.31288445100388174,-0.12424510417107476,-94213429,-53065445.2,12.99204414037004,30.12848650599008,NaN,NaN,-19.064641402375297,-5.332238533283457
2011-08-02T09:30:00-04:00,33.31,33.44,32.78999,32.82001,23052080,11249555.6,23.27172277933954,42.05483662973245,NaN,NaN,-238.5233135217184,-213.91321388679324,-0.2507243691626221,-0.43765056562435234,-0.18692619646173028,-117265509,-72208864.4,10.065323289220842,27.665496763237947,NaN,NaN,-25.613964738817526,-8.229627991216894
2011-08-03T09:30:00-04:00,32.82001,32.88,32.19501,32.88,23351136,12072109.45,24.469633154266646,40.26731617181705,NaN,NaN,-215.11094617063597,-212.4535595433209,-0.2709620805338175,-0.5256287971290021,-0.25466671659518464,-93914373,-84074529.8,8.74964023322002,25.34419484562265,NaN,NaN,-30.132683032186836,-11.3586358542126
2011-08-04T09:30:00-04:00,32.42,32.56,31.57001,31.57001,26524160,13028315.7,17.898289169731044,38.24840296424937,NaN,NaN,-218.72739469140495,-217.9151463031907,-0.35072115952736216,-0.6930681660043874,-0.3423470064770252,-120438533,-98487355.4,7.472016193349177,23.183887623066948,NaN,NaN,-37.27036810351642,-15.060311889827432
2011-08-05T09:30:00-04:00,31.81,32.27499,31.03999,31.81,34270800,14404797.3,22.02940561302961,36.83713513923397,NaN,NaN,-187.7971324123366,-214.64496552755963,-0.36389050887936075,-0.7972101425762261,-0.4333196336968654,-86167733,-102399915.4,7.166106864280195,21.204759321865705,NaN,NaN,-40.99664243287185,-18.765501967405207
2011-08-08T09:30:00-04:00,31.17999,31.53999,30.17,30.17999,35749888,15636435.65,16.10287574215596,34.55134743661704,NaN,NaN,-201.34980820739432,-212.30171900069803,-0.45314199795693877,-0.9997471311430388,-0.5466051331861,-121917621,-107940753.8,6.744960108661388,19.29052287963596,NaN,NaN,-47.122506661098654,-22.816502637932842
2011-08-09T09:30:00-04:00,30.56,31.37,29.64,31.28,33607104,17017355.7,29.823673864274795,33.394321533607744,NaN,NaN,-158.33641578207187,-196.26433945276875,-0.410145286869941,-1.0592867417735263,-0.6491414549035853,-88310517,-102149755.4,12.530819573065457,18.022685491971355,NaN,NaN,-45.727487300285844,-26.089500446840415
2011-08-10T09:30:00-04:00,30.89999,31.12,29.91,29.96001,31686368,18171822.15,24.620306921563767,31.207498882666226,NaN,NaN,-149.28754072964472,-183.09965836457047,-0.44001586700316,-1.1991612886575354,-0.7591454216543754,-119996885,-107366257.8,11.819437329756141,16.711467685139905,NaN,NaN,-47.0017231190733,-29.076960828587968
2011-08-11T09:30:00-04:00,30.07001,31.73,30.02,31.33,23576672,18878477.05,36.92123628003687,29.979734505284657,NaN,NaN,-102.93372171160303,-159.94092376861008,-0.34132126394663254,-1.185797001587666,-0.8444757376410335,-96420213,-102562593.8,16.519324096998517,15.701641036370015,NaN,NaN,-42.26053486525838,-30.96032854811231
2011-08-12T09:30:00-04:00,31.56,31.92999,31.32001,31.64,14175844,19087529.4,39.333696031841406,29.38516656809384,NaN,NaN,-69.5253665957575,-136.28657060529426,-0.23408637423293632,-1.1370837054322038,-0.9029973311992675,-82244369,-101777921,17.294764085522587,14.669878448712412,NaN,NaN,-37.95605576753143,-31.95971815088647
2011-08-15T09:30:00-04:00,31.92999,32.24001,31.71001,32.17,22841264,19801126.8,43.3245920932754,29.38207403926732,NaN,NaN,-47.5269973900998,-105.52200844183537,-0.1125466121738602,-1.0436805964165927,-0.9311339842427325,-59403105,-89275017.8,28.665053749485892,14.615534322880592,NaN,NaN,-33.163615264129945,-32.131703452778396
2011-08-16T09:30:00-04:00,31.99001,32.355,31.78999,32.14,16553742,20132284,43.151550956828906,29.89527237590087,NaN,NaN,-40.47028412082476,-81.94878210958595,-0.02389352366510744,-0.9610008888241168,-0.9371073651590094,-75956847,-86804283.8,30.692813957758233,14.914943663736475,NaN,NaN,-29.731181596181173,-31.788771758978793
2011-08-17T09:30:00-04:00,32.23,32.53999,31.89,32.17,12656551,20424694.95,43.395025834381435,30.44906310277752,NaN,NaN,-31.43644680093547,-58.378563323844105,0.043383011593790544,-0.8828786006667713,-0.9262616122605618,-63300296,-75464966,39.23059238547381,16.200351732267272,NaN,NaN,-27.044748391827284,-31.111054135100005
2011-08-18T09:30:00-04:00,31.53,31.60001,30.84,31.11,14270383,20407069.95,37.31400255102124,30.708866087781047,NaN,NaN,-71.16756180889317,-52.02533134330214,0.024074258040702512,-0.8961687897096837,-0.9202430477503862,-77570679,-71695059.2,41.79764936377727,17.981467526495667,NaN,NaN,-26.760448307887398,-30.489539016926777
2011-08-19T09:30:00-04:00,30.82001,31.49001,30.77,31.03,18010240,20925447.75,36.89379978513309,31.324986484062833,NaN,NaN,-70.31516417880411,-52.18329085991145,0.013994160101023723,-0.9027503476241066,-0.9167445077251303,-95580919,-74362369.2,40.49426766793731,19.945912064179044,NaN,NaN,-26.67521634369363,-29.94463577789347
2011-08-22T09:30:00-04:00,31.52,31.59,30.965,31.00999,11777102,21173251.5,36.7822247970482,32.290022342470586,NaN,NaN,-61.66680452245487,-55.01125228638246,0.014023346232456935,-0.8992153249345591,-0.9132386711670161,-107358021,-83953352.4,36.13133878774125,21.80777031407336,NaN,NaN,-26.641435184268104,-29.47274997880413
2011-08-23T09:30:00-04:00,31.13,32.05,31.06,32.02,12479410,21362388,45.70741095591867,33.80700647116002,NaN,NaN,-25.784978814939375,-52.07419122520538,0.08608881382781786,-0.8056276538822438,-0.8917164677100616,-94878611,-87737705.2,34.549579056213204,23.650623087144304,NaN,NaN,-23.750307184141118,-28.65525815099513
2011-08-24T09:30:00-04:00,31.89999,32.405,31.85001,32.39,11762508,21298631.75,48.57185078912267,35.99797515825942,NaN,NaN,18.130472966189405,-42.1608072717804,0.15848727933556872,-0.6936073685406008,-0.8520946478761695,-83116103,-91700866.6,32.92401503629543,25.468623004497605,NaN,NaN,-20.475217814687205,-27.486680960094
2011-08-25T09:30:00-04:00,32.31,32.42999,31.73,31.84,15550723,21386749.95,44.78902445134583,37.62366221813915,NaN,NaN,12.717955197394023,-25.383703870522968,0.1682257390083164,-0.641812474115774,-0.8100382131240904,-98666826,-95920096,31.238886895929,27.18810729247252,NaN,NaN,-18.87943391332359,-26.257074239126798
2011-08-26T09:30:00-04:00,31.66,32.35001,31.05,32.24001,12478867,21099166.9,47.96322916851815,39.8994017485936,NaN,NaN,13.958291973309436,-8.529012640100259,0.19842361311728707,-0.5620086967274815,-0.7604323098447686,-86187959,-94041504,32.885977249712695,29.05532280254761,NaN,NaN,-16.573187378537806,-24.873661830471228
2011-08-29T09:30:00-04:00,32.60001,33.09,32.56,33.06,11473836,20292433.9,53.823921829614406,41.61370517468928,NaN,NaN,136.89600293959435,31.18354885230959,0.26621192426861906,-0.42766740450899476,-0.6938793287776138,-74714123,-87512724.4,38.40782337280772,30.903680216814912,NaN,NaN,-12.670148773356182,-23.130302822311936
2011-08-30T09:30:00-04:00,33.00999,33.37,32.71001,33.17,11804637,19730061.75,54.563212188138294,43.752484122301745,NaN,NaN,156.2834780607244,67.59724022744234,0.3080909638664493,-0.3087656239445522,-0.6168565878110015,-62909486,-81118899.4,43.32562690982861,33.154122329677236,NaN,NaN,-9.33063187055027,-21.158921257774555
2011-08-31T09:30:00-04:00,33.34,33.63,33.125,33.39999,10386090,19081809.45,56.144191092672145,45.12555232320427,NaN,NaN,175.48071673565644,99.06728898133575,0.33849048539743865,-0.19374348106420314,-0.5322339664616418,-52523396,-75000358,47.6344909755898,35.37663424957661,NaN,NaN,-6.10725129945411,-19.008682692300205
2011-09-01T09:30:00-04:00,33.39,33.75,33.11,33.17999,9624992,18236851.05,54.20139453396725,46.187530787641826,NaN,NaN,146.5638036519606,125.83645867224907,0.33061247542074934,-0.1189683721857051,-0.44958084760645445,-62148388,-67696670.4,52.296814622073484,37.8767807164731,NaN,NaN,-3.969822803606507,-16.860274136772535
2011-09-02T09:30:00-04:00,32.66,32.95,32.38,32.45,11320832,17089352.65,48.23681255326984,46.53840367764143,NaN,NaN,67.18939257292828,136.48267879217283,0.2658559254769493,-0.11726094076026783,-0.38311686623721714,-73469220,-65152922.6,53.83835501988537,39.67487366435878,NaN,NaN,-3.828700959248036,-14.998620825697607
2011-09-06T09:30:00-04:00,31.7,32.57001,31.64,32.53,44453184,17524517.45,48.900470369453274,46.94904077854317,NaN,NaN,29.915359012449894,115.08655000674393,0.21992938403976214,-0.10820513618751448,-0.3281345202272766,-29016036,-56013305.2,58.968856309796855,41.69459097521868,NaN,NaN,-3.525822205499711,-13.359649594240764
2011-09-07T09:30:00-04:00,32.92,33.32001,32.78,33.31,10855652,16386944.85,54.96334549616923,47.775349325813735,NaN,NaN,108.96041958047876,105.6219383106948,0.23238377344777905,-0.037654803417552785,-0.27003857686533184,-18160384,-47063484.8,63.27342765455061,43.41193635158131,NaN,NaN,-1.4357947470914123,-11.656241758933714
2011-09-08T09:30:00-04:00,33.09,33.42999,32.89,32.95,9131336,15259193.25,51.902492203486744,48.817384300989836,NaN,NaN,95.77729224626201,89.68125341281592,0.2074955332320882,-0.010669160325221583,-0.21816469355730977,-27291720,-42017149.6,65.4729206758891,45.1030271595893,NaN,NaN,-0.5835975404748356,-10.074435442011017
2011-09-09T09:30:00-04:00,32.59,32.63,31.82001,31.97,16098445,14885281.9,44.61816683390619,49.36912480447363,NaN,NaN,-13.74521359148087,57.61944996412764,0.12046646303397543,-0.06758161476484048,-0.1880480777988159,-43390165,-38265505,67.0526856775852,47.00005701742129,NaN,NaN,-2.1343028116057012,-8.940130780524544
2011-09-12T09:30:00-04:00,31.58,32.11,31.49001,32.08,13393121,14846145.75,45.54204299668116,49.994826104447405,NaN,NaN,-44.688551689730765,35.243861111595834,0.0683376182634485,-0.10262605496950528,-0.17096367323295378,-29997044,-29571069.8,70.42941975271827,49.44991994349108,NaN,NaN,-3.0985846913471384,-8.105624196356343
2011-09-13T09:30:00-04:00,32.16,32.48,31.99001,32.41,11253457,14266755.4,48.326985121324924,50.18193854483358,NaN,NaN,1.1194926501515376,29.48468783913615,0.054700369627499495,-0.10258821119857942,-0.1572885808260789,-18743587,-27516580,71.18104670047313,52.0664533466525,NaN,NaN,-3.0848926681314337,-7.388376835181356
2011-09-14T09:30:00-04:00,32.52,33.08,32.065,32.72,14000297,14139083.15,50.868804012435476,50.34600663221306,NaN,NaN,36.558601265737224,15.004324176187836,0.06450276836707386,-0.07666012036723657,-0.14116288873431043,-4743290,-24833161.2,72.17584189841709,54.87015526537548,NaN,NaN,-2.332220546513612,-6.666068793943107
2011-09-15T09:30:00-04:00,32.96001,33.03999,32.5,33.02,12105172,14111514.2,53.264711128593085,50.95141282344501,NaN,NaN,57.40822167628946,7.330510062193326,0.08769763454571078,-0.03154084555217196,-0.11923848009788274,7361882,-17902440.8,74.61329576384294,57.96832732736933,NaN,NaN,-1.0050214800677495,-5.85734774910377
2011-09-16T09:30:00-04:00,32.95,33.11,32.7,33.02,11865723,13991281.2,53.2647111285931,51.33009010630751,NaN,NaN,60.48806097141497,22.177164974772495,0.09872554685332365,0.0041684534687718156,-0.09455709338455183,7361882,-7752031.4,77.69509668557822,61.168978715645444,NaN,NaN,0.07752573174921236,-5.009508680410487
2011-09-19T09:30:00-04:00,32.53,32.825,32.44,32.71001,11645969,13673067.65,50.32380022829299,51.080081420498836,NaN,NaN,19.84054556958299,35.08298442663524,0.08154149370347469,0.00736977374479153,-0.07417171995868316,-4284087,-2609440,79.08066898651259,64.07418197376721,NaN,NaN,0.21140729983749493,-4.263663540375061
2011-09-20T09:30:00-04:00,32.83,33.3501,32.64999,33.00999,10829656,13625695.35,53.02665716359013,50.970327490173965,NaN,NaN,60.76948090465085,47.01298207753509,0.08631655446347293,0.033723973120658,-0.05259258134281493,6545569,2448391.2,80.3720957255335,66.72035831774613,NaN,NaN,1.0662378751313806,-3.5022490524455696
2011-09-21T09:30:00-04:00,33.03,33.08,32.10001,32.12,14044859,13703967.8,45.17362855218043,50.186715880138834,NaN,NaN,-33.415608683705756,33.0181400876465,0.028467007527195033,-0.01700882193382114,-0.04547582946101617,-7499290,1897191.2,79.79397089678261,69.01746402640278,NaN,NaN,-0.4886190789366998,-3.0717304848014453
2011-09-22T09:30:00-04:00,31.32001,31.64,31.09,31.47,26669920,14449338.4,40.46071575289724,49.205238824348115,NaN,NaN,-177.97417315648343,-14.05833887890808,-0.05035114235942816,-0.10841475741030138,-0.058063615050873214,-34169210,-6409027.2,71.45301701019278,70.38576419698272,NaN,NaN,-3.3354474577955693,-3.1094043380863203
2011-09-23T09:30:00-04:00,31.28,31.67999,31.17,31.48,17981488,14570876.65,40.56345333086164,48.65714173703325,NaN,NaN,-155.8205512358675,-57.32006132036457,-0.09594581013003269,-0.17799587771341407,-0.08205006758338139,-16187722,-11118948,67.1656765036238,71.33771573153547,NaN,NaN,-5.579103729720598,-3.462218536891217
2011-09-26T09:30:00-04:00,31.74001,32.04041,31.37,32,13336816,14613774.1,45.800748263034365,48.435733015146184,NaN,NaN,-104.3710873131366,-82.16238789690848,-0.08556080667383405,-0.18900107592567394,-0.1034402692518399,-2850906,-10832311.8,67.29429193501281,71.93238970476519,NaN,NaN,-5.990943829055694,-3.823465007200428
2011-09-27T09:30:00-04:00,32.50999,32.88,32.34,32.49001,14318914,14756028,50.249490832019774,48.099029110564075,NaN,NaN,3.2582551271625126,-93.66463305240616,-0.04235211019300886,-0.15638040699310096,-0.1140282968000921,11468008,-9847824,67.76138706406869,72.25295823401648,NaN,NaN,-5.001012968221829,-3.9916861444891993
2011-09-28T09:30:00-04:00,32.61,32.655,31.88,31.92999,15071984,14919395.35,45.638843608847424,47.65162563951841,NaN,NaN,-49.04950786727391,-96.79141288911978,-0.04774916260585174,-0.17371475005740677,-0.12596558745155503,-3603976,-9068761.2,68.14904709373576,72.44411012100552,NaN,NaN,-5.565567591532372,-4.2165263512096525
2011-09-29T09:30:00-04:00,32.34,32.57001,31.67,32.14,12782813,15039231.5,47.58124099348224,47.86327379377384,NaN,NaN,-46.67689762127252,-70.5319577820776,-0.03407808869995804,-0.16856319832650257,-0.13448510962654453,9178837,-399151.8,72.16087265719287,72.80898061954893,NaN,NaN,-5.448981528116771,-4.392591376482098
2011-09-30T09:30:00-04:00,31.8,32.34,31.72,31.73,10358211,15075892.45,44.25651986661325,47.77145071305471,NaN,NaN,-68.7412698025481,-53.11610149541373,-0.04866206179916149,-0.1953126868754964,-0.14665062507633492,-1179374,2602517.8,73.40966838406236,73.02185552178778,NaN,NaN,-6.348278688646255,-4.671975278219835
2011-10-03T09:30:00-04:00,31.49001,31.92999,30.7,30.72,48032048,16911453.25,37.33558692120205,46.986350841617366,NaN,NaN,-167.76967998814482,-65.79582003041537,-0.11837092260962973,-0.29461427833837206,-0.17624335572874233,-49211422,-6669585.4,63.877651931294075,72.50018446684643,NaN,NaN,-9.449264346275568,-5.35444514508494
2011-10-04T09:30:00-04:00,30.45,31.08,30.11099,31.05,20949744,15736281.25,40.60389221726488,46.25314285624803,NaN,NaN,-180.79624808194026,-102.60672067223592,-0.13319128062659727,-0.3427324565119889,-0.20954117588539165,-28261678,-14615522.6,57.04202980007194,71.4191978883932,NaN,NaN,-10.951643043427561,-6.154044844848171
2011-10-05T09:30:00-04:00,31.08,31.57001,30.9792,31.55,16962400,16041618.65,45.26221530003444,45.681536011351,NaN,NaN,-95.29500392038217,-111.85581988285757,-0.10167910808348754,-0.3366400609897511,-0.23496095290626354,-11299278,-16154583,55.79656407964888,70.07514562523649,NaN,NaN,-10.738803954358426,-6.809010431921064
2011-10-06T09:30:00-04:00,31.53,31.92999,31.39,31.92999,9795422,16074822.95,48.56383499866769,45.34575914492775,NaN,NaN,-40.74800203586881,-110.67004076577685,-0.05020553373158215,-0.29771787007074124,-0.2475123363391591,-1503856,-18291121.6,54.03282536570223,68.38498338810248,NaN,NaN,-9.524156413435716,-7.1968884292803
2011-10-07T09:30:00-04:00,31.98,32.14,31.8,31.89999,10780832,15808942.3,48.31605566916325,45.20234881927563,NaN,NaN,-13.785880834991866,-99.6789629722656,-0.014969044687802968,-0.2662236421989128,-0.25125459751110985,-12284688,-20512184.4,52.18604210214018,66.46393861064732,NaN,NaN,-8.627543327719168,-7.401267700485852
2011-10-10T09:30:00-04:00,32.23,32.67999,32.23,32.63,6614941,15470033.3,54.411429063931614,45.30126109787144,NaN,NaN,54.54502628946294,-55.21602171674404,0.056779379027079496,-0.18028037372726047,-0.23705975275433996,-5669747,-11803849.4,58.21615723217593,64.88137157540748,NaN,NaN,-5.927173449927974,-7.190682807549012
2011-10-11T09:30:00-04:00,32.50999,32.64,32.41499,32.58,5107410,15162730.95,53.94218468912865,45.927586536224894,NaN,NaN,55.76536582641488,-7.903698935073001,0.09774377746579635,-0.11488003092209453,-0.21262380838789088,-10777157,-8306945.2,60.37713394123748,63.494454650011406,NaN,NaN,-3.8940229077137616,-6.719731393286834
2011-10-12T09:30:00-04:00,32.7,32.92,32.58,32.60001,8411012,14883266.7,54.11273905671742,46.90273105792634,NaN,NaN,74.0583642158103,25.966974692165497,0.12151102059396685,-0.06073503264543234,-0.18224605323939919,-2366145,-6520318.6,61.47345195489094,62.781628574632705,NaN,NaN,-2.189302827409663,-6.072527312447238
2011-10-13T09:30:00-04:00,32.52,32.67999,32.31,32.57001,5969969,14576506.55,53.79112944179012,47.84756506584979,NaN,NaN,55.42895588923074,45.20236627718541,0.1297850322168553,-0.020014762968330047,-0.14979979518518535,-8336114,-7886770.2,60.10371515895411,62.277202764299155,NaN,NaN,-0.8600079742445224,-5.3278816927039925
2011-10-14T09:30:00-04:00,32.95,32.95,32.69,32.88,6229328,14294686.8,56.657637701196705,48.62305716857568,NaN,NaN,97.5937678852863,67.47829602124105,0.14931601030471336,0.03684521769570637,-0.112470792609007,-2106786,-5851189.8,61.480630938048826,61.86194126451602,NaN,NaN,1.0854320032260734,-4.411694021856841
2011-10-17T09:30:00-04:00,32.75999,32.8,32.25999,32.31,6760754,14050426.05,50.459227722711624,48.63803837505367,NaN,NaN,50.645741265619904,66.69843901647243,0.1183795633704428,0.0355036616040465,-0.0828759017663963,-8867540,-6490748.4,60.77097491912945,61.36262611130608,NaN,NaN,1.106954358196599,-3.6233156818492063
2011-10-18T09:30:00-04:00,32.2,32.8,31.99001,32.55,9932527,14005569.6,52.800645769406955,49.149595672236494,NaN,NaN,55.702534077490995,66.68587266668767,0.10885534853881328,0.0531932839071203,-0.05566206463169297,1064987,-4122319.6,62.49735397742374,60.95893374585522,NaN,NaN,1.783487088393262,-2.850915286100282
2011-10-19T09:30:00-04:00,32.75,32.88,32.345,32.49001,6233465,13614999.9,52.1373345889704,49.47503092905708,NaN,NaN,70.98791228977524,66.07178228148065,0.09385841671757705,0.061660956265278344,-0.03219746045229871,-5168478,-4682786.2,61.8042142045524,60.21917242780946,NaN,NaN,2.1659720427400107,-2.134217096265955
2011-10-20T09:30:00-04:00,32.42,32.64,32.08501,32.46001,6920418,12627524.8,51.78696562849988,50.01291991204898,NaN,NaN,42.48139333224794,63.48226977008409,0.07791742527932413,0.06519932114685645,-0.012718104132467677,-12088896,-5433342.6,60.83123380081686,59.3207128147205,NaN,NaN,2.3946814143519553,-1.4872315947491104
2011-10-21T09:30:00-04:00,32.8,33.16,32.8,33.11,6784645,12067682.65,58.32207671558105,51.51195489736176,NaN,NaN,121.62005665939424,68.28752752490566,0.10543815232111353,0.11907958626892423,0.013641433947810706,-5304251,-6072835.6,59.96502779702959,59.041239662273036,NaN,NaN,4.463058892307523,-0.6371900965981627
2011-10-24T09:30:00-04:00,33.21001,33.62,33.11,33.61,36228336,13212258.65,62.52958539046096,53.078075838304336,NaN,NaN,160.74899129175589,90.30817753013284,0.14894483425231905,0.19982247676320952,0.05087764251089047,30924085,1885489.4,66.38084419901959,59.708297833626446,NaN,NaN,7.563424351595735,0.5343262531438226
2011-10-25T09:30:00-04:00,33.48,33.52,32.84,32.92999,8333305,12912978.2,54.47495190922647,53.73612845324663,NaN,NaN,105.33809157236257,100.23528902910716,0.12454555396338954,0.20655958496512739,0.08201403100173785,22590780,6190648,69.25154459187002,60.66936787021366,NaN,NaN,7.850948621055899,1.579558019988405
2011-10-26T09:30:00-04:00,33.23,33.485,32.95,33.37,8655617,12592159.85,58.22477645246513,54.42619569994645,NaN,NaN,114.5895080000847,108.95560817116908,0.1300563780212338,0.2445845035282801,0.1145281255070463,31246397,13473623,73.39092376265778,62.05208918428192,NaN,NaN,9.278441439231065,2.679398508451642
2011-10-27T09:30:00-04:00,34,34.265,33.71001,34.17999,16386570,12772347.7,64.0887598391412,55.552817426373444,NaN,NaN,185.5014631344702,137.5596221316135,0.17734022399135668,0.33620340549624217,0.1588631815048855,47632967,25417995.6,78.50235001998256,63.931825464127805,NaN,NaN,12.526919384754127,4.086187205066283
2011-10-28T09:30:00-04:00,33.9801,34.315,33.9801,34.21001,10215289,12765201.6,64.28883523197908,56.258346438376826,NaN,NaN,173.33574311447705,147.90275942263008,0.19814783598899238,0.40654797649112595,0.20840014050213357,57848256,38048497,82.36094757592994,65.65645334582452,NaN,NaN,15.124630801575833,5.663107718853361
2011-10-31T09:30:00-04:00,33.96001,34.06,33.55,33.56,12897859,11008492.15,56.897084372297925,56.46941070146035,NaN,NaN,112.1516459046044,138.1832903451998,0.15742034313336864,0.40517556941884436,0.24775522628547572,44950397,40853759.4,83.08704608601893,67.27858992759461,NaN,NaN,14.999851008951278,6.996928188867349
2011-11-01T09:30:00-04:00,32.92999,33.315,32.82001,32.92,13507215,10636365.7,50.71426551977782,56.22666259167896,NaN,NaN,27.360480474604717,122.58776812564822,0.08053886317324105,0.348428805252027,0.26788994207878597,31443182,42624239.8,83.54736423047201,68.85529794727898,NaN,NaN,12.817132910297268,7.82838600621448
2011-11-02T09:30:00-04:00,33.27,33.31,32.92999,33.14,6063715,10091431.45,52.62023863202998,56.143027533838946,NaN,NaN,32.83529491679763,106.23692550899082,0.039726645257947946,0.3175482486512209,0.27782160339327294,37506897,43876339.8,83.88147954223962,70.55370968894223,NaN,NaN,11.66825162943928,8.376938238103737
2011-11-03T09:30:00-04:00,33.42,33.56,33.16,33.5,7748336,9989077.15,55.643119525291695,56.07056194984573,NaN,NaN,62.92899307163359,81.7224314964235,0.032505313790799684,0.3184532456317726,0.2859479318409729,45255233,43400793,83.1904867893668,72.10441367832208,NaN,NaN,11.660805992423654,8.846062203006582
2011-11-04T09:30:00-04:00,33.25999,33.36,32.95,33.19,5672406,9733655.85,52.53484412729328,56.218820264458714,NaN,NaN,22.4093567472332,51.53715422297472,0.0038847323708179893,0.2908038473044954,0.2869191149336774,39582827,39747707.2,77.88285752294614,73.32669100716613,NaN,NaN,10.686771692469144,9.109020701501233
2011-11-07T09:30:00-05:00,33.21001,33.63499,33.07001,33.58,5520145,9678916.05,55.87438232574716,56.43837287562587,NaN,NaN,57.10445463920382,40.5277159698946,0.008015364405551728,0.2969383204406171,0.28892295603506535,45102972,39778222.2,77.89554411364266,74.42656173118176,NaN,NaN,10.891279108083603,9.363629045298715
2011-11-08T09:30:00-05:00,33.74001,34.015,33.48,33.99001,4987543,9672922.7,59.12998104252914,56.93784762230864,NaN,NaN,108.10428845823662,56.67647756662099,0.03371601079662723,0.3310679695308494,0.29735195873422215,50090515,43507688.8,79.4472316489962,75.68677726292775,NaN,NaN,12.072139958782216,9.750559175796358
2011-11-09T09:30:00-05:00,33.41,33.50999,32.88,33.00999,13046965,9904720.35,49.6925000360763,56.78824293713552,NaN,NaN,-3.67261602615817,49.37489537802983,-0.01719625889160492,0.27585663511971603,0.29305289401132095,37043550,43415019.4,79.29827410944303,77.00585157068677,NaN,NaN,9.977025481353131,9.78291150516161
2011-11-10T09:30:00-05:00,33.33,33.64,33.14999,33.48,6093238,9910883.8,53.52371564788796,56.445502860871734,NaN,NaN,37.657016860083566,44.32050013571981,-0.020882394015941663,0.26694990149139386,0.2878322955073355,43136788,42991330.4,78.5729165914465,78.33498648457369,NaN,NaN,9.515254995325835,9.744674860899357
2011-11-11T09:30:00-05:00,33.77,34.17,33.77,34.07001,7083969,9953615.85,57.8619702968379,56.1121017827558,NaN,NaN,119.35275371570351,63.70917952941387,0.012930845234530142,0.30399585205049817,0.29106500681596803,50220757,45118916.4,79.58288408146352,79.2779893333197,NaN,NaN,10.579299837765618,9.86390700045168
2011-11-14T09:30:00-05:00,33.85001,33.99001,33.69,33.84,4100148,9820585.55,55.67997069224614,56.19817455297149,NaN,NaN,84.50291190410111,69.18887098239333,0.01611418728860048,0.31120774092671866,0.2950935536381182,46120609,45322443.8,79.68154732984303,80.02298952888918,NaN,NaN,10.730390594024323,9.987690370962058
2011-11-15T09:30:00-05:00,33.82001,34.019,33.62,33.92,5627422,9605330.3,56.29727305418188,56.0604957388084,NaN,NaN,79.96541474186645,63.561096239119294,0.019679813596695683,0.3196933206339878,0.3000135070372921,51748031,45653947,79.85232671238661,80.48451831101268,NaN,NaN,11.037769360889408,10.137701655237393
2011-11-16T09:30:00-05:00,33.55,33.81,33.25,33.27,10464672,9816890.65,50.18152221055552,55.06712162248085,NaN,NaN,0.21670084606629042,64.33895961356419,-0.023333616616741992,0.27084648626636465,0.29418010288310664,41283359,46501908.8,80.3082608676706,80.61351194299039,NaN,NaN,9.38321474109212,10.029917810359496
2011-11-17T09:30:00-05:00,33.22,33.25,32.64,32.92,10134160,9977577.75,47.207702337600175,53.84704070145379,NaN,NaN,-111.56813676488107,34.49392888857126,-0.07408858080601372,0.2015693768755895,0.2756579576816032,31149199,44104391,75.13137265817596,80.0971137345794,NaN,NaN,7.077043274863569,9.608078591002934
2011-11-18T09:30:00-05:00,33.00999,33.05,32.8116,32.85001,6194672,9948079.1,46.61282302424036,53.112450605163964,NaN,NaN,-115.66703361654635,-12.510028577878714,-0.10899668251368061,0.13941210453950248,0.2484087870531831,24954527,39051145,65.54139624718887,78.84385303180582,NaN,NaN,5.042574454934279,8.955863714421698
2011-11-21T09:30:00-05:00,32.39,32.47,32.101,32.22,7436574,8508491,41.538657890581995,52.4570500602214,NaN,NaN,-204.20019731100302,-70.25065042089955,-0.1676330800521527,0.03886743698799222,0.2065005170401449,17517953,33330613.8,56.715680009085325,76.92730415884964,NaN,NaN,1.6673743960558434,7.914650954655147
2011-11-22T09:30:00-05:00,32.21001,32.45,32.12,32.3,5162051,8349928.3,42.396165168350656,51.72675909853002,NaN,NaN,-171.79477580779843,-120.60268853083252,-0.19237484768757784,-0.033968042569327395,0.15840680511825045,22680004,27517008.4,49.43075054542006,74.46653780193394,NaN,NaN,-0.819781232141519,6.666874927969909
2011-11-23T09:30:00-05:00,32.08,32.08,31.78999,31.83,6472359,8240765.4,38.795801912135616,50.52337926901886,NaN,NaN,-189.0923432424344,-158.46449734853266,-0.22923636751299048,-0.12813865427298765,0.10109771324000283,16207645,22501865.6,44.16107061917321,71.67872236120584,NaN,NaN,-4.070953591344222,5.132899425210748
2011-11-25T09:30:00-05:00,31.74001,31.955,31.67999,31.71001,2497579,7546315.85,37.91065987245355,49.47879467938746,NaN,NaN,-176.18247616111537,-171.38736522777953,-0.24890267486832265,-0.21003063034540048,0.038872044522922165,13710066,19014039,40.89578032498417,69.03678827563712,NaN,NaN,-7.004524246093472,3.3989817578815735
2011-11-28T09:30:00-05:00,32.25,32.62,32.25,32.56,7381191,7404610.95,47.115388684818036,48.853152276463945,NaN,NaN,-79.4536791510641,-164.14469433468307,-0.19429125875170455,-0.20399202891670853,-0.00970077016500398,21091257,18241385,40.18688613772551,66.34331270592875,NaN,NaN,-6.879619323383306,1.9306101748437337
2011-11-29T09:30:00-05:00,32.63,32.89999,32.59,32.7,4789863,6999211.15,48.4704203862848,48.0917550867322,NaN,NaN,-41.299202466171494,-131.56449536571677,-0.14085389928955033,-0.18576814427694188,-0.04491424498739156,25881120,19914018.4,42.51012915132459,63.704948241809355,NaN,NaN,-6.37183944703001,0.7445459431474848
2011-11-30T09:30:00-05:00,33.39999,33.92,33.37,33.88,13397086,6993704.7,58.19347752352507,48.69896776440712,NaN,NaN,79.33948673779712,-81.33764285659765,-0.024262285578553422,-0.07524210196058334,-0.05097981638202992,39278206,23233658.8,46.91698429404806,61.39199896928115,NaN,NaN,-2.603703093490816,0.2662246521991562
2011-12-01T09:30:00-05:00,33.8,34.12,33.8,33.92999,5973051,6989171.5,58.550301009960094,49.058009575983704,NaN,NaN,96.41993756130142,-24.235186695850494,0.053741966511152525,0.01619764175691074,-0.037544324754241784,45251257,29042381.2,53.61692882829826,59.609428414770555,NaN,NaN,0.45529012537482333,0.2932340055099658
2011-12-02T09:30:00-05:00,34.12,34.16,33.42999,33.50999,15173383,7360423.85,54.352877716980416,48.80736010599388,NaN,NaN,64.14138891686096,23.82958631974477,0.07335514347737873,0.05414960459248164,-0.019205538884897098,30077874,32315942.8,56.91716113517636,57.990448204321474,NaN,NaN,1.7342232250220437,0.4990896082974055
2011-12-05T09:30:00-05:00,33.86,33.99001,33.39999,33.57001,43739088,9263757.95,54.85099680751083,48.748147685655645,NaN,NaN,54.00052115730082,50.52042638141775,0.0858083344090517,0.08805487912641752,0.002246544717365826,73816962,42861083.8,65.44615729541279,56.9736346304336,NaN,NaN,2.9087188994127664,0.8433223641710285
2011-12-06T09:30:00-05:00,33.63,33.92,33.57001,33.71001,5064387,9240970.05,56.05558930962761,48.73088456104462,NaN,NaN,59.77766241294192,70.73579935724042,0.09802953016045991,0.12478345741794072,0.026753927257480808,78881349,53461129.6,71.5443616406751,56.380208553882774,NaN,NaN,4.226713010153781,1.3266638850257073
2011-12-07T09:30:00-05:00,33.66,34.12,33.53,33.96001,6479719,9315578.85,58.200267559910586,49.30365208599856,NaN,NaN,74.049132672971,69.6777285442752,0.11626117444289435,0.17208039531109875,0.0558192208682044,85361068,62677702,75.57988373255762,56.042467329946135,NaN,NaN,5.959866695203602,1.9885500007654064
2011-12-08T09:30:00-05:00,33.8,33.87,33.25999,33.33,7784508,9052456,51.39325232742412,49.602619942414556,NaN,NaN,30.523358570835597,56.498412746182034,0.08087915343323063,0.15691816265974268,0.07603900922651205,77576560,69142762.6,77.94290462719194,56.243291042018704,NaN,NaN,5.505157653233103,2.490922522546506
2011-12-09T09:30:00-05:00,33.49001,33.89,33.42999,33.82001,5606008,9028094.5,55.73017546579119,50.25385940252533,NaN,NaN,52.009531281157734,54.07204121904139,0.0850406295733426,0.1823397961931903,0.0972991666198477,83182568,79763701.4,81.16704088577384,57.359408516203345,NaN,NaN,6.4304676474394125,3.0537146832454924
2011-12-12T09:30:00-05:00,33.59,33.67,33.27,33.42,5421449,8944968.5,51.67667425267858,50.978003428389364,NaN,NaN,28.84889616681472,49.04171622094417,0.05677623023855782,0.16826945441804497,0.11149322417948715,77761119,80552532.8,81.38468227355872,59.121480106522874,NaN,NaN,5.979423055383315,3.4716730221223244
2011-12-13T09:30:00-05:00,33.62,33.81,33.25999,33.36,5022816,8991101.9,51.07656999646342,51.59803234468314,NaN,NaN,34.111968388349666,43.908577416025715,0.0312388262288235,0.15054175696551653,0.11930293073669303,72738303,79323923.6,79.83714129596727,61.29336516013338,NaN,NaN,5.439682397055459,3.7528172185413435
2011-12-14T09:30:00-05:00,33.32001,33.4989,33.25,33.34,5186730,8969067.3,50.86453348751204,52.46008460006716,NaN,NaN,25.101053808240888,34.11896164307969,0.011230869923668715,0.13334151814127893,0.12211064821761021,67551573,75762024.6,75.36299524300003,63.522074061835305,NaN,NaN,4.939669399721516,3.922367530138511
2011-12-15T09:30:00-05:00,33.55,33.8,33.53,33.71001,6535289,8772598.15,54.618065101954265,53.65347068788865,NaN,NaN,58.88863885008193,39.79201769892899,0.020601444088836907,0.14786245332865633,0.12726100923981942,74086862,75064085,74.48219270859465,65.92110351780748,NaN,NaN,5.553826840992972,4.155433145974863
2011-12-16T09:30:00-05:00,33.75,33.75,33.39999,33.41,5777223,8554751.3,51.20264342981918,53.94541745538873,NaN,NaN,37.784049010973256,36.94692124489209,0.005088625044775336,0.1336217905457886,0.12853316550101326,68309639,72089499.2,70.69015471106229,68.09990841590296,NaN,NaN,5.119483088112344,4.293154566280217
2011-12-19T09:30:00-05:00,33.56,33.8,33.31,33.41,4601637,8475099.55,51.20264342981918,54.14057624421262,NaN,NaN,33.46014988400262,37.86917198832967,-0.006073075867245176,0.1209418206669568,0.12701489653420198,68309639,70199203.2,68.31006713454858,69.94276112899038,NaN,NaN,4.76263785484464,4.3602236075037055
2011-12-20T09:30:00-05:00,33.78999,34.16,33.74001,34.11,5208816,8363711.65,58.26486748292854,54.14567552702715,NaN,NaN,87.99229222918832,48.6452367564974,0.030763741017094393,0.16546957280556995,0.13470583178847556,73518455,70355233.6,68.40463019906613,71.47759297934881,NaN,NaN,6.502452346214784,4.666256284462431
2011-12-21T09:30:00-05:00,34.2,34.375,34.06,34.33,5196891,8365453.65,60.21375798771316,54.26449388258094,NaN,NaN,120.34929349921909,67.69488469469304,0.06505145673822113,0.21602015271125197,0.15096869597303084,78715346,72587988.2,69.7936698344394,72.63307447978747,NaN,NaN,8.53918050040959,5.219531172454882
2011-12-22T09:30:00-05:00,34.47,34.5889,34.31,34.575,3699830,8226827.2,62.32375270785279,54.833842096214674,NaN,NaN,162.07509111554012,88.33217514778468,0.09739120268566534,0.2727076993301125,0.17531649664444718,82415176,74253651,70.82416341421289,73.62643178543294,NaN,NaN,10.886942146975763,6.0291613116721505
2011-12-23T09:30:00-05:00,34.66,34.84,34.58,34.8,2240243,8213960.4,64.20140654444337,55.50172850599557,NaN,NaN,207.3266647731185,122.24069830021372,0.12531636846845354,0.3319619572300141,0.20664558876156056,84655419,77522807,72.78646403926516,74.15073940999382,NaN,NaN,13.42717512448425,7.086020427788164
2011-12-27T09:30:00-05:00,34.73,34.961,34.73,34.88,2224070,7956104.35,64.87174876337804,56.13145418126346,NaN,NaN,196.6390153320207,154.87647138981734,0.13947149498798678,0.38098495749654404,0.24151346250855726,86879489,81236777,74.85552033318027,74.38725074517276,NaN,NaN,15.728548352433947,8.320667274166134
2011-12-28T09:30:00-05:00,34.88,34.88,34.425,34.5,5908160,8012019.2,59.20102933396751,56.20293716512467,NaN,NaN,129.26468547987875,163.13095003995542,0.11457978343952946,0.3847381918079691,0.27015840836843963,80971329,82727351.8,75.65551660229151,74.3926530930109,NaN,NaN,16.17423341700828,9.442605294572154
2011-12-29T09:30:00-05:00,34.47,34.81,34.47,34.75,4775363,7580933.05,61.58047422122945,56.93059587182505,NaN,NaN,120.8590463157633,163.23290060326426,0.10646311260554614,0.4032372991253723,0.2967741865198262,85746692,84133621,76.41782132093219,74.2837185711352,NaN,NaN,17.232708890311518,10.555477236820634
2011-12-30T09:30:00-05:00,34.64999,34.87,34.63,34.69,2711530,7417857,60.66600775320999,57.28315532092639,NaN,NaN,110.5289235832955,152.92366709681534,0.08926007484975584,0.408349280082021,0.31908920523226514,83035162,84257618.2,76.48773314668966,73.94948230405775,NaN,NaN,17.861905065995938,11.599252640988535
2012-01-03T09:30:00-05:00,35.10001,35.25999,35.03,35.14,18864224,7602399.05,64.87854022373597,58.2261457474305,NaN,NaN,142.84814018558464,140.02796217930856,0.09960725678636334,0.4435982762152193,0.34399101942885596,101899386,87706411.6,78.40531363838883,73.73667025868848,NaN,NaN,19.644535145208017,12.748578713019889
2012-01-04T09:30:00-05:00,35.11,35.13,34.85001,34.97,6173984,5724143.85,62.16974956844695,59.01851571685789,NaN,NaN,106.30827343929802,121.96181380076402,0.08688598966103867,0.4525985065051543,0.36571251684411565,95725402,89475594.2,79.33632878751084,73.70089793665588,NaN,NaN,20.385979281592327,13.839635937101665
2012-01-05T09:30:00-05:00,34.78,35.11,34.71201,35.07001,5939684,5767908.7,63.144636527275814,59.89566593398388,NaN,NaN,92.44078078997593,114.59703286278348,0.07740611207916903,0.4624701569430769,0.3850640448639079,101665086,93614345.6,81.36082890550553,74.12931462683484,NaN,NaN,21.27633663236835,14.90202175071119
2012-01-06T09:30:00-05:00,35.12,35.21001,34.96001,35.13,6762441,5782044.8,63.74812043123605,60.547812743218294,NaN,NaN,96.95246548665646,109.81571669696211,0.06772441842152982,0.46971956789082014,0.4019951494692903,108427527,98150512.6,83.29287077059786,74.75864877412077,NaN,NaN,22.185059283709172,15.942455683996617
2012-01-09T09:30:00-05:00,35.2,35.2189,34.91,35.19,10695297,5927584.25,64.37640985603265,61.488796059376405,NaN,NaN,89.15280674620274,105.54049332954355,0.05827004126500934,0.474832701050552,0.41656265978554263,119122824,105368045,85.81271464113264,75.83883162626866,NaN,NaN,23.119207695148596,16.967705971304042
2012-01-10T09:30:00-05:00,35.42999,35.53,35.39999,35.45,7122238,6003395.75,67.04201974823076,62.620180082120086,NaN,NaN,117.41851926586111,100.45456914559885,0.06208447931336841,0.49416825892725313,0.4320837796138847,126245062,110237180.2,87.2137897489648,77.1890975272984,NaN,NaN,24.66819949066362,18.067776474069696
2012-01-11T09:30:00-05:00,35.41,35.53999,35.28999,35.48,3500955,5907371.05,67.34564134122982,63.26880678628446,NaN,NaN,108.19810623625769,100.83253570499078,0.05919602876211222,0.506078815566525,0.4468827868044128,129746017,117041303.2,88.8681645179556,78.65077855007623,NaN,NaN,26.053120343379288,19.208539883971067
2012-01-12T09:30:00-05:00,35.56,35.62,35.33,35.59,3409115,5826686,68.49181790964829,63.860096780708396,NaN,NaN,111.29184735006272,104.60274901700814,0.057228248225723255,0.5184180970865668,0.4611898488608436,133155132,123339312.4,90.13988030257529,80.10407929780023,NaN,NaN,27.55151922858574,20.400394076058877
2012-01-13T09:30:00-05:00,35.36,35.46201,35.155,35.42999,4826746,5808686.8,64.92203648686132,64.045688479209,NaN,NaN,87.27829997041378,102.66791591375961,0.03857883796443129,0.5094133963163827,0.4708345583519514,128328386,127319484.2,90.85120880251294,81.53458253982164,NaN,NaN,27.95200742630735,21.47919598323723
2012-01-17T09:30:00-05:00,35.71001,35.87,35.61099,35.64999,5792816,5771563.15,67.43515079179004,64.27667021116234,NaN,NaN,126.94257160576176,110.22586888567142,0.03461475972296302,0.5141030080056552,0.4794882482826922,134121202,130319159.8,91.35726238778808,82.86106813614471,NaN,NaN,28.973423380547665,22.54979989713872
2012-01-18T09:30:00-05:00,35.64,35.86,35.57001,35.85001,6940371,5829720.55,69.56976135381026,64.61224253905036,NaN,NaN,126.99173568660085,112.14051216981936,0.03870899565877145,0.5278744928561565,0.48916549719738506,141061573,133282462,91.83758997808887,84.07407311078103,NaN,NaN,30.4527594184813,23.678794114473373
2012-01-19T09:30:00-05:00,35.75999,35.89,35.66,35.85001,4447516,5822014.5,69.56976135381026,65.35286625475341,NaN,NaN,126.44508139720058,115.78990720200795,0.034786365444311906,0.5326484540027749,0.49786208855846303,141061573,135545573.2,92.19437649887357,85.25542024625119,NaN,NaN,31.688345681775264,24.823015766945073
2012-01-20T09:30:00-05:00,35.89999,35.95641,35.715,35.85001,7768840,5950015.7,69.56976135381026,65.92352962136633,NaN,NaN,122.78030880738247,118.08759949347188,0.02596526443364855,0.5303186691005237,0.5043534046668752,141061573,137126861.4,92.44293743120714,86.40007139698513,NaN,NaN,32.733188661218165,25.953040466126943
2012-01-23T09:30:00-05:00,35.86,35.92,35.59,35.69,5658176,5973079.95,65.2934718717552,66.25406277269099,NaN,NaN,93.4826918170635,119.32847786280183,0.004265669040891096,0.5096854909679891,0.505419821927098,135403397,138541863.6,92.66793727152368,87.55580026304469,NaN,NaN,32.57908850779819,26.899618757794265
2012-01-24T09:30:00-05:00,35.59,35.82001,35.59,35.7,4382133,6007195.1,65.43646077936029,66.29391424094986,NaN,NaN,79.75655116248174,109.89127377414584,-0.013528469782260744,0.4885092346992721,0.5020377044815328,139785530,139674729.2,92.85144460993443,88.58766676101223,NaN,NaN,32.48250305359722,27.697173657194686
2012-01-25T09:30:00-05:00,35.5601,36.02,35.48,35.96001,6827191,6236542.5,69.01139413589108,66.78260313862444,NaN,NaN,91.89631626944634,102.87218989071494,-0.011956057678107368,0.48709263238389866,0.49904869006200603,146612721,140784958.8,93.03541238934497,89.5661727325718,NaN,NaN,33.31941556218163,28.50035107219282
2012-01-26T09:30:00-05:00,36.10001,36.10001,35.67999,35.8,5074496,6379063.8,64.58430285459217,66.88543644771848,NaN,NaN,91.06000211501133,95.79517403427708,-0.025104939968726203,0.4676675151010983,0.4927724550698245,141538225,140880289.2,93.0519468452623,90.40125258541158,NaN,NaN,32.87317599145816,29.125040346373584
2012-01-27T09:30:00-05:00,35.66,35.94,35.66,35.82001,3500667,6258689.15,64.88765159763128,66.96683153103241,NaN,NaN,76.07543099326408,86.45419847145341,-0.03524588317310312,0.4487151011034456,0.4839609842765487,145038892,141675753,93.19707899207653,91.1086960298029,NaN,NaN,32.57377415817108,29.617716605201796
2012-01-30T09:30:00-05:00,35.60001,35.78999,35.45,35.77,5297789,6284810.45,63.4254593562832,66.89890649533602,NaN,NaN,43.472549980629054,76.45217010416653,-0.04735808375503925,0.4247633795827497,0.4721214633377889,139741103,142543294.2,93.35998017385887,91.64778642499765,NaN,NaN,31.941030091037582,29.949618531749767
2012-01-31T09:30:00-05:00,35.9001,36.13,35.71001,35.8,7538660,6526166.95,63.950259142309996,66.67806645205596,NaN,NaN,84.91612400531633,77.48408467273343,-0.05485689876819311,0.4035503398775475,0.4584072386457406,147279763,144042140.8,93.64319716825524,92.1070298120898,NaN,NaN,31.524986846417775,30.174671148130912
2012-02-01T09:30:00-05:00,35.91,36.3167,35.91,36.14999,13009191,6233415.3,69.45647239692389,66.82884009889125,NaN,NaN,132.64748490299,85.63431839944217,-0.03852498859504283,0.41025100290193706,0.4487759914969799,160288954,146777387.4,94.13484425029706,92.48322122154278,NaN,NaN,32.63103186736412,30.525579822307083
2012-02-02T09:30:00-05:00,36.19,36.19,35.8,36.00999,5953320,6222382.1,65.16855829249566,66.59146441195178,NaN,NaN,98.3677683442494,87.09587164528979,-0.03929479812367154,0.39965749384239047,0.438952291966062,154335634,149336869.2,94.558916956136,92.7988666967971,NaN,NaN,32.39256004107575,30.792291282131178
2012-02-03T09:30:00-05:00,36.22,36.27,36.09,36.22,8292410,6340018.4,68.32730628123227,66.83469796869255,NaN,NaN,150.2178912817554,101.92436370298805,-0.028316898252201017,0.4035561691508107,0.43187306740301173,162628044,152854699.6,95.08493164213937,93.10127547105616,NaN,NaN,33.087708779354955,31.12020806744886
2012-02-06T09:30:00-05:00,36.06,36.14999,35.91,36.02,4095364,6206664.55,62.513114309147014,66.48312393421806,NaN,NaN,96.8255039596927,112.59495449880077,-0.03665258177392816,0.38605734018560156,0.4227099219595297,158532680,156613015,95.57690521107702,93.40267852986251,NaN,NaN,31.9664905083747,31.241105559009696
2012-02-07T09:30:00-05:00,35.98,36.19,35.86,36.14999,3442136,5844006.5,64.62035053972731,66.12959459035498,NaN,NaN,106.00810760054333,116.81335121784616,-0.035513945364840094,0.3783174902534796,0.4138314356183197,161974816,159552025.6,95.92076657293003,93.6943340009226,NaN,NaN,31.627342907721744,31.296282323111416
2012-02-08T09:30:00-05:00,36.16,36.19,35.95,36.14999,4758289,5725809.05,64.62035053972731,65.77606524649192,NaN,NaN,107.80521701010568,111.8448976392693,-0.036711392627705286,0.36794219483368806,0.40465358746139335,161974816,159889198,95.95957444144015,93.96327671110592,NaN,NaN,31.3510861722668,31.304111444419327
2012-02-09T09:30:00-05:00,36.13,36.145,35.86,35.96001,6164477,5858985.15,58.99893911965584,65.02100651548089,NaN,NaN,58.3551379253369,103.8423715554868,-0.05135068679681776,0.3404652289653711,0.3918159157621889,155810339,160184139,95.99546343752671,94.21702856870017,NaN,NaN,29.477324776383018,31.04314192041414
2012-02-10T09:30:00-05:00,35.75,35.85001,35.621,35.81,3648007,5870929.75,54.935217744076354,64.28113122064669,NaN,NaN,-44.047147134767464,64.98936387218224,-0.07097982357910404,0.30309113628830886,0.3740709598674129,152162332,158090996.6,89.89295790855927,94.01881575705987,NaN,NaN,26.656869236612668,30.41653153701393
2012-02-13T09:30:00-05:00,35.98,36.1683,35.97,36.08,5493762,5904280.55,60.24309127030684,63.9101762557143,NaN,NaN,84.05418869985228,62.435100820214146,-0.06574167090053828,0.29189387124174004,0.35763554214227833,157656094,157915679.4,89.3804384169427,93.77088674327474,NaN,NaN,25.718970400933593,29.74545137471674
2012-02-14T09:30:00-05:00,36.09,36.25,36,36.23,4253102,5827294.85,62.86027465864568,63.470810578768194,NaN,NaN,109.94672443066327,63.22282418623813,-0.05270005665837124,0.29176047131931426,0.3444605279776855,161909196,157902555.4,89.33937510207083,93.50688407989801,NaN,NaN,25.72178311864471,29.170641623849306
2012-02-15T09:30:00-05:00,36.25999,36.32001,36.05,36.16,5725266,5766539.6,60.84722814580766,63.20387667099787,NaN,NaN,104.48115782725334,62.55801234966765,-0.049370818805776095,0.2827470044704654,0.3321178232762415,156183930,156744378.2,85.6018167695648,92.9747319316339,NaN,NaN,25.127045863457198,28.592985086650433
2012-02-16T09:30:00-05:00,36.10001,36.39999,36.03999,36.36,5059891,5797158.35,64.3591307419438,63.16612518130591,NaN,NaN,127.80785213114827,76.44855519082992,-0.03496033915017688,0.2884173993385204,0.3233777384886973,161243821,157831074.6,86.18578494803667,92.47392521420248,NaN,NaN,25.670536871113903,28.17549248443093
2012-02-17T09:30:00-05:00,36.34,36.36,36.17,36.24001,4532293,5635331,60.83360996565719,62.980993081975484,NaN,NaN,111.73301520896662,107.60458765957674,-0.03470110552786615,0.2800013565788646,0.31470246210673075,156711528,158740913.8,86.6731453572654,91.99629415587437,NaN,NaN,25.071243458472008,27.73202833786537
2012-02-21T09:30:00-05:00,36.3,36.34,35.92,35.98,7076977,5706271.05,53.9384935540021,62.26586696852492,NaN,NaN,34.95378463222121,97.78450684605052,-0.05218184666781023,0.24947515377196794,0.30165700043977817,149634551,157136605.2,81.23119205322719,91.1097223619438,NaN,NaN,22.36915891405338,26.965904134463656
2012-02-22T09:30:00-05:00,35.95,36.09,35.85001,35.98,4212266,5697777.7,53.9384935540021,61.15743990831622,NaN,NaN,-19.83224494869091,71.82871297017968,-0.06315312721911515,0.22271559141588426,0.2858687186349994,149634551,154681676.2,73.61445341518524,89.64398015943581,NaN,NaN,20.214533715914914,26.00142264609955
2012-02-23T09:30:00-05:00,36,36.07001,35.92999,36.00999,3551574,5533996.85,54.62644315040998,60.404431683881526,NaN,NaN,-10.44916460104083,48.84264848452085,-0.06741144083759859,0.20160441758800118,0.2690158584255998,153186125,154082115.2,71.84268122172686,88.02139189269232,NaN,NaN,18.632497157566114,24.948719004880488
2012-02-24T09:30:00-05:00,36.11,36.24001,36.03999,36.19,7647137,5662628.9,58.62129121641697,59.71114489353757,NaN,NaN,64.12784528794627,36.10664711588047,-0.05751139876242867,0.19712660997256393,0.2546380087349926,160833262,154000003.4,71.58855745641404,86.3430794508548,NaN,NaN,18.386035328014103,24.011192765328147
2012-02-27T09:30:00-05:00,36.00999,36.34,35.92,36.25999,9274066,5951298.85,60.09250555332028,59.53824426812139,NaN,NaN,67.88603165909082,27.33725040590531,-0.04614628945811847,0.1969551469123445,0.24310143637046297,170107328,156679163.4,74.72946367884782,84.85397648426701,NaN,NaN,18.598095246475694,23.237893119777798
2012-02-28T09:30:00-05:00,36.22,36.46001,36.17999,36.39999,4370211,5904919.95,62.93159842176264,59.417619116838196,NaN,NaN,162.7838883635318,52.90327115216743,-0.029885630835346677,0.20574439782627962,0.2356300286616263,174477539,161647761,79.29986831330024,83.66676946572203,NaN,NaN,19.604636448472352,22.71885645244845
2012-02-29T09:30:00-05:00,36.38,36.48,36.17999,36.17999,6353828,5845678.35,56.16917291011318,58.81396357186576,NaN,NaN,109.51372889182531,78.77246592027068,-0.0343151909132316,0.19273604002008682,0.22705123093331842,168123711,165345593,81.92059831663627,82.66398545680747,NaN,NaN,18.48019859416095,22.11333390126452
2012-03-01T09:30:00-05:00,36.21001,36.42,36.17999,36.37,6014043,5495920.95,60.151893853013775,58.89631748139133,NaN,NaN,119.640594672802,104.79041777503923,-0.02523668277453789,0.19550537746514607,0.22074206023968396,174137754,169535918.8,84.34008806238286,81.83145864429719,NaN,NaN,18.72558227094269,21.629369382647116
2012-03-02T09:30:00-05:00,36.44,36.44,36.22,36.31,3602672,5378388.55,58.34890759224613,59.14015247054631,NaN,NaN,107.70848888841827,113.50654649513362,-0.02406502419676504,0.19066077999372766,0.2147258041904927,170535082,171476282.8,85.31978605409176,81.50480351183522,NaN,NaN,18.392629147559354,21.16697792049172
2012-03-05T09:30:00-05:00,36.27,36.42,36.17999,36.23,3395746,5133555.35,55.94122887279661,58.83287658500986,NaN,NaN,75.98226014596769,115.12579219250901,-0.02913215023972332,0.17831061639083856,0.20744276663056188,167139336,170882684.4,83.59678060278515,81.09168509653826,NaN,NaN,17.413054795753197,20.630703188386217
2012-03-06T09:30:00-05:00,36.03,36.12,35.67999,35.75999,4315934,5144583.85,44.3599050068753,57.51142160988341,NaN,NaN,-143.78400422726847,53.81221367434896,-0.06266712749972342,0.1291088572559076,0.191775984755631,162823402,168551857,77.01959355778698,80.21170070051797,NaN,NaN,12.56056624120567,19.47782648164614
2012-03-07T09:30:00-05:00,35.84,35.955,35.72,35.92,4343105,5189632.3,48.28514509162365,56.614129963155975,NaN,NaN,-122.06023728188562,7.497420439606773,-0.07193800784850271,0.10185347494500263,0.17379148279350534,167166507,168360416.2,76.48730264169669,79.56066397709881,NaN,NaN,9.848697466914942,18.102236622398827
2012-03-08T09:30:00-05:00,36.11,36.41,36.11,36.32001,4186387,5161037.2,56.53947363738528,56.055583027116086,NaN,NaN,68.58334865760615,-2.714028763432401,-0.05003442687203202,0.11124844920346533,0.16128287607549735,171352894,167803444.2,74.86617568608625,78.75212045838808,NaN,NaN,10.348819120999057,16.994605550770288
2012-03-09T09:30:00-05:00,36.37,36.60001,36.35001,36.47,4698180,5087722.35,59.17102048385378,55.9368266355587,NaN,NaN,143.61668164418208,4.467609787720358,-0.025581173123231993,0.12930640967145735,0.15488758279468934,176051074,168906642.6,75.95332131876441,77.9864187413523,NaN,NaN,11.660359971548269,16.232570468024285
2012-03-12T09:30:00-04:00,36.39999,36.53999,36.39,36.47,2426577,5026650.85,59.17102048385378,56.31057855911954,NaN,NaN,132.5592442075418,15.783006600035185,-0.010325420572630112,0.1419808070789017,0.15230622765153182,176051074,170688990.2,77.63636364499142,77.72964528362117,NaN,NaN,12.670702035016578,15.723732120451755
2012-03-13T09:30:00-04:00,36.66,37.005,36.58,36.99001,7159387,5109932.1,67.16513130751201,57.255338398655944,NaN,NaN,257.86347648182993,96.11250274185487,0.031575141738429735,0.19177515482456897,0.16020001308613924,183210461,174766402,80.92542297260974,78.25185739486577,NaN,NaN,16.49283909402329,15.833604545247688
2012-03-14T09:30:00-04:00,36.89999,37.06,36.89999,36.98,6216973,5208125.65,66.8936165863079,58.13156507264864,NaN,NaN,248.66993865031762,170.25853792829554,0.05408305358620899,0.22780383006890048,0.1737207764826915,176993488,176731798.2,82.27837688163213,78.99726422771616,NaN,NaN,19.317834418174634,16.331351669951538
2012-03-15T09:30:00-04:00,36.99001,37.1019,36.89,37.03999,3819861,5112855.4,67.73540926037009,58.78257350435958,NaN,NaN,203.86885818982813,197.3156398347399,0.06760009613828782,0.25822089665555126,0.19062080051726343,180813349,178623889.2,83.4923001614314,79.84753156378882,NaN,NaN,21.840637810357652,17.11839254715241
2012-03-16T09:30:00-04:00,36.95,36.99001,36.8,36.85001,4000270,5059874.35,62.3302788577307,58.94241445467462,NaN,NaN,136.92666955578466,195.9776374170604,0.05866667457377922,0.26395414373448745,0.20528746916070822,176813079,178776290.2,83.58980629406742,80.48041317916166,NaN,NaN,22.298123437442584,17.858354102908148
2012-03-19T09:30:00-04:00,36.78999,36.89999,36.72,36.84,4130750,5039797.2,62.04932283862748,58.87939477016497,NaN,NaN,103.50817430575805,190.16742343670367,0.04748159349781572,0.26463946103297786,0.21715786753516214,172682329,178102541.2,81.30342217796502,80.62352416949486,NaN,NaN,22.58017848834179,18.532900443684383
2012-03-20T09:30:00-04:00,36.62,36.77,36.61,36.64999,2980582,4834977.45,56.814240243171504,58.925471008240564,NaN,NaN,62.13426827205394,151.02158179474847,0.02387615665113718,0.24700306334908362,0.22312690669794644,169701747,175400798.4,72.71434465835043,79.96593462247445,NaN,NaN,21.251838493550384,18.92132016509381
2012-03-21T09:30:00-04:00,36.69,36.72,36.57001,36.63499,3717857,4810257,56.40962782238145,58.658166291766825,NaN,NaN,47.6814762428531,110.82388931325556,0.0048376281893604545,0.22917394193464702,0.22433631374528656,165983890,173198878.8,66.54426895549848,78.69480468626843,NaN,NaN,20.0588824931941,19.083829069108138
2012-03-22T09:30:00-04:00,36.48,36.59,36.39999,36.50999,4888195,4877088.05,53.020930424861476,58.27759649409649,NaN,NaN,9.998966452701195,72.04991096583018,-0.017371388403969817,0.2026220782403243,0.21999346664429412,161095695,169255348,57.18538780652886,76.6852048114425,NaN,NaN,18.06053151065138,18.937643703614317
2012-03-23T09:30:00-04:00,36.59,36.66,36.46001,36.62,2760532,4632757.8,55.55163902457753,58.24976864779513,NaN,NaN,25.30081938012532,49.7247409306983,-0.02536599010528892,0.18828597901268296,0.21365196911797188,163856227,166663977.6,52.009065998001766,74.4289394825294,NaN,NaN,17.061893950669578,18.66967945319364
2012-03-26T09:30:00-04:00,36.86,37.25999,36.81,37.25999,9504578,4644283.4,66.76738091083006,59.85030264093478,NaN,NaN,138.16037270134268,56.65518060981522,0.009847717992912147,0.22596161660911207,0.21611389861619992,173360805,166799672.8,52.25279311094978,72.65988230775532,NaN,NaN,19.88834768638324,18.84377491507787
2012-03-27T09:30:00-04:00,37.28,37.48,37.28,37.33,5334957,4692520.7,67.72675173495318,61.23898882974403,NaN,NaN,166.74038706216436,77.57640436783731,0.03390035985890466,0.25848934843983074,0.22458898858092607,178695762,168598475.8,55.48053209762836,71.15939869746472,NaN,NaN,22.429840731138366,19.35607003165794
2012-03-28T09:30:00-04:00,37.36,37.49001,37.07001,37.25,8930586,4821358.6,65.40328689698057,61.87211834828655,NaN,NaN,128.43402849281387,93.72691481782945,0.040046028877867595,0.27464652467826056,0.23460049580039297,169765176,169354733,56.8026735087143,69.86914854193816,NaN,NaN,23.75600016180047,19.984631478821157
2012-03-29T09:30:00-04:00,37.09,37.36501,37.03999,37.33,8620652,4951689.05,66.6359360620909,62.40532660387492,NaN,NaN,109.53976249858054,113.63507402700534,0.04476534131734991,0.29055717244708035,0.24579183112973044,178385828,172812759.6,62.313948386932864,68.8949076182359,NaN,NaN,25.21617609895756,20.731994995983502
2012-03-30T09:30:00-04:00,37.47,37.66,37.41,37.61,7242820,5133696.45,70.58605882542251,63.220686485415534,NaN,NaN,146.88605092450513,137.9521203358813,0.06100475042513165,0.32204776916114497,0.2610430187360133,185628648,177167243.8,67.87253890779527,68.19749156557903,NaN,NaN,27.771282544489516,21.737607502912933
2012-04-02T09:30:00-04:00,37.61,37.84,37.48,37.74001,10149188,5471368.55,72.23008814965397,63.58246911699711,NaN,NaN,149.85930458436013,140.2919067124848,0.07390238272124439,0.3534209971375688,0.2795186144163244,195777836,181650650,72.38832042003357,67.5876985261093,NaN,NaN,30.40625000179696,22.975985002753507
2012-04-03T09:30:00-04:00,37.78,38,37.55,37.72,8863070,5698725.35,71.56707124928074,63.91628730720945,NaN,NaN,147.30998668722697,136.4058266374973,0.07428697445041693,0.37237733247934557,0.29809035802892864,186914766,183294450.8,73.84015603836177,66.98496846587571,NaN,NaN,32.32857778251353,24.31206968557637
2012-04-04T09:30:00-04:00,37.57001,37.63,37.42999,37.515,7096895,5836414.85,64.98570933837837,63.71988016992433,NaN,NaN,98.25073605768038,130.3691681504706,0.05483352916505224,0.36663226948524397,0.3117987403201917,179817871,185304989.8,75.5345917166243,66.41656071981807,NaN,NaN,32.0330172240061,25.41506219106633
2012-04-05T09:30:00-04:00,37.39999,37.55,37.32001,37.50999,3536294,5803910.2,64.8288035074959,63.89834621633612,NaN,NaN,77.4461920807381,123.95045406690213,0.03660368623502608,0.3575533481139743,0.32094966187894824,176281577,184884139.6,74.44756515526385,65.76354349561781,NaN,NaN,31.749702365189542,26.320010787369647
2012-04-09T09:30:00-04:00,37.19,37.22,37.02,37.03999,3188564,5728429.4,52.11609940808057,63.18883025701134,NaN,NaN,3.8325757924852133,95.33975904049814,-0.009661590657691121,0.30887267355683434,0.31853426421452546,173093013,182377012.6,68.15502983762323,64.82437261416482,NaN,NaN,27.322228141117304,26.463184695047882
2012-04-10T09:30:00-04:00,37.02,37.11,36.60001,36.62,6500191,5932110.1,43.84255562905163,62.26228135600278,NaN,NaN,-65.76874793177346,52.21414853727144,-0.06786009007018234,0.2337091516267975,0.30156924169697985,166592822,176540009.8,56.23720173371049,63.6474338338334,NaN,NaN,20.40298265248513,25.597441546110346
2012-04-11T09:30:00-04:00,36.92999,36.95799,36.71539,36.75,3793531,5763817.3,46.66497321069481,61.56623459802517,NaN,NaN,-58.23479538273169,11.105192123279702,-0.09523349687042809,0.18252737060894475,0.27776086747937284,170386353,173234327.2,50.8175783963129,62.52409879389156,NaN,NaN,15.82926244528906,24.201987388850164
2012-04-12T09:30:00-04:00,36.78999,36.99001,36.77,36.95,4721875,5689062.4,50.76476041416615,61.405079597261214,NaN,NaN,-37.07597418635853,-15.960149925528071,-0.09716708071536029,0.1563020165851725,0.2534690973005328,175108228,172292398.6,49.357944363660415,61.96499569082953,NaN,NaN,13.404869967584442,22.65954204295506
2012-04-13T09:30:00-04:00,36.89,36.89,36.58,36.58,4560676,5726103.15,44.02284478514873,60.58159429444487,NaN,NaN,-75.21756463544936,-46.49290126876557,-0.11920871966717206,0.10445819771656772,0.22366691738373978,170547552,171145593.6,47.56656295027696,61.64767404456347,NaN,NaN,8.939262196319696,20.699502064864294
2012-04-16T09:30:00-04:00,36.75999,36.75999,36.4801,36.59,7243203,5888249.8,44.2383904204782,58.97238068799116,NaN,NaN,-83.62323069889582,-63.98406256704177,-0.12817582582998846,0.06344713509625421,0.19162296092624267,177790755,172085142,49.193477462772115,61.42915149826507,NaN,NaN,5.578006609887129,18.539288428438987
2012-04-17T09:30:00-04:00,36.78,37.16,36.7,37.13,4194637,5891444.15,54.440419732102704,58.02335697350185,NaN,NaN,-12.695585237441716,-53.36943002817543,-0.09436249715623463,0.0736698394809494,0.16803233663718403,181985392,175163656,54.20719967089588,61.33819918206989,NaN,NaN,6.08575434304086,16.76021213052497
2012-04-18T09:30:00-04:00,37.06,37.14,36.99001,37.00999,4080229,5946426.5,52.15656434655027,57.07716250561397,NaN,NaN,-6.977727659569663,-43.11801648354302,-0.07741299636232521,0.07126609118427751,0.14867908754660272,177905163,176667418,56.4670592748921,61.314226736796876,NaN,NaN,5.716697823117299,15.18256722946673
2012-04-19T09:30:00-04:00,37.21001,37.39,36.95,37.09,9542746,6237670.95,53.55548501218948,56.14284457347815,NaN,NaN,8.154434542986717,-34.07193473767397,-0.05898068802164741,0.07495322751954347,0.13393391554119088,187447909,179135354.2,59.95945717792399,61.146048793296245,NaN,NaN,5.874424546341207,13.8528325604488
2012-04-20T09:30:00-04:00,37.21001,37.48,37.14999,37.28999,5714547,6278988.55,56.944316026100154,55.16843437352655,NaN,NaN,37.4327230649237,-11.541877197599359,-0.032793964475165666,0.0929414599472338,0.12573542442239946,193162456,183658335,65.43272127161744,60.97177610499783,NaN,NaN,7.092213681733746,12.887029863489506
2012-04-23T09:30:00-04:00,36.89999,37.05,36.89,37,4906723,6386298.1,51.119749343406724,53.66055303022318,NaN,NaN,-46.37093000617731,-4.091417059055654,-0.03431430986429215,0.08284253709203426,0.11715684695632642,188255733,185751330.6,67.63727070966708,60.632415411400224,NaN,NaN,6.252147798852327,11.939189568541337
2012-04-24T09:30:00-04:00,37.03,37.21001,36.95,37.13,2971108,6059624.6,53.41991205456115,52.3643273734575,NaN,NaN,-17.115222354837517,-4.975344482534817,-0.02624022038954725,0.08435657146939235,0.1105967918589396,191226841,187599620.4,69.48787490383724,60.32153818750561,NaN,NaN,6.295609772779493,11.132963883432502
2012-04-25T09:30:00-04:00,37.32001,37.58,37.28999,37.52,6216387,6103696.1,59.56697065671998,51.9772746104819,NaN,NaN,71.27807877469002,10.675816804317119,0.00407661723342502,0.11569256340072087,0.11161594616729585,197443228,191507233.4,73.00278004446996,60.14069449663744,NaN,NaN,8.386713104824727,10.740642343631391
2012-04-26T09:30:00-04:00,37.35001,37.55701,37.22,37.50999,5472672,5930800.4,59.350476880398546,51.58596556568923,NaN,NaN,59.097454764200535,20.86442084855988,0.021208524618676186,0.13812660194064108,0.1169180773219649,191970556,192411762.8,73.7564134904137,60.09132652057672,NaN,NaN,9.951790008208851,10.627949152856743
2012-04-27T09:30:00-04:00,37.58,37.7,37.42,37.53,3911638,5695349.7,59.6660560195114,52.125248180791424,NaN,NaN,79.33674464551711,29.245225164678565,0.031045758021353023,0.15572527484865617,0.12467951682730315,195882194,192955710.4,74.22243089822207,60.524712310619485,NaN,NaN,11.300543040837294,10.724033993996821
2012-04-30T09:30:00-04:00,37.50999,37.63,37.41,37.50999,4775086,5571963,59.171347968336505,53.22016191931177,NaN,NaN,72.9761424041985,53.11463964675372,0.033170404594429215,0.16614252257033968,0.13297211797591046,191107108,193525985.4,74.72908535341674,61.84556114059851,NaN,NaN,12.266591838816773,10.944399400399671
2012-05-01T09:30:00-04:00,37.44,37.745,37.25999,37.64999,5532508,5341129,61.57203040753609,54.28495171908615,NaN,NaN,84.45993305198513,73.42967072811825,0.040485436001887365,0.18357891297826967,0.1430934769763823,196639616,194608540.4,75.7052707145743,63.623253449045755,NaN,NaN,13.77631343401755,11.348958548059368
2012-05-02T09:30:00-04:00,37.5,37.61,37.47,37.58,2863251,5041138.05,59.68268792800544,54.921946541503246,NaN,NaN,90.68887818858312,77.31183061089688,0.03717688831208649,0.1895645873664904,0.1523876990544039,193776365,193875167.8,73.63022880323132,65.35698805187225,NaN,NaN,14.539277343872115,11.804718376032618
2012-05-03T09:30:00-04:00,37.62,37.62,37.37801,37.44,3297100,4851148.3,55.98224068654473,55.77618910588867,NaN,NaN,74.18274060886371,80.3288877798295,0.022830518301626634,0.1809258469314372,0.15809532862981057,190479265,193576909.6,72.7568015260903,67.15629080728749,NaN,NaN,14.190063612098006,12.145481981184815
2012-05-04T09:30:00-04:00,37.28999,37.32001,36.92999,36.95,4886359,4918651.55,45.37751816357033,55.8575553732524,NaN,NaN,-21.82929181292385,60.09568048814132,-0.020070302184607952,0.13300745089905064,0.1530777530836586,185592906,191519052,66.86339206687825,68.41842756472363,NaN,NaN,10.513346049448236,11.912319705222448
2012-05-07T09:30:00-04:00,36.73,37.155,36.73,37.03,5690191,5043732.9,47.13815561071248,55.33596507886738,NaN,NaN,-43.57702296764512,36.785047413772595,-0.042197754482726724,0.1003305599802502,0.14252831446297692,191283097,191554249.8,66.91275926190664,69.32596753551012,NaN,NaN,8.041817518520183,11.359390821407839
2012-05-08T09:30:00-04:00,36.82001,37.12,36.66,37.03999,3984408,4917943.75,47.366306694352105,54.99380381799608,NaN,NaN,-54.8365208693996,8.92575662949565,-0.05451660185989762,0.0743825621381049,0.12889916399800253,195267505,191279827.6,66.08609549617964,70.01304155131638,NaN,NaN,6.111105551209782,10.609635782808116
2012-05-09T09:30:00-04:00,36.83,37.02,36.575,36.78999,8694813,5163007.85,42.430912973480055,54.19919152951684,NaN,NaN,-91.50921948302704,-27.513862904826386,-0.07650953141416832,0.033262249730292126,0.10977178114446044,186572692,189839093,61.771337932152115,70.14246160518981,NaN,NaN,2.9081921995856295,9.509429556633474
2012-05-10T09:30:00-04:00,36.97,37.2028,36.97,37.05,3401534,5096990.8,48.44733296382909,53.59226416792605,NaN,NaN,-23.139116370495323,-46.97823430069819,-0.07069105512807207,0.02140796223437036,0.09209901736244243,189974226,189738085.2,61.468330464458816,69.8592908332499,NaN,NaN,1.9259144641434978,8.426070257706336
2012-05-11T09:30:00-04:00,36.98,37.3,36.97,37.00999,3514116,5044662.8,47.622578092103424,53.342466221404386,NaN,NaN,-25.13236500688149,-47.63884893948973,-0.06673139888380827,0.008684768757682093,0.07541616764149037,186460110,189911526,61.81470306903579,69.44339314463339,NaN,NaN,0.8876524194915639,7.349153423675654
2012-05-14T09:30:00-04:00,36.8,37.0372,36.63,36.89,8433738,5104189.55,45.14067808970502,52.75109236677181,NaN,NaN,-99.95140371089343,-58.913725088139394,-0.0690964291494806,-0.01095436879536038,0.058142060354120215,178026372,187260181,53.84614114457613,68.3261264475433,NaN,NaN,-0.7136256923403884,6.197327835673362
2012-05-15T09:30:00-04:00,36.8,36.94,36.575,36.67,5206145,5154764.95,40.92891512895248,51.41980268621699,NaN,NaN,-126.27604557437216,-73.2016300291339,-0.08152659141509713,-0.04376617891475121,0.037760412500345925,172820227,182770725.4,43.59758434724804,66.22575532631316,NaN,NaN,-3.386710401187724,4.828179516121779
2012-05-16T09:30:00-04:00,36.75999,36.89999,36.67999,36.73,6770621,5289284.55,42.504504055065794,50.216518912978934,NaN,NaN,-105.93114462958592,-76.08601505844567,-0.08155901231651692,-0.06418835289530023,0.017370659421216694,179590848,181374356.6,40.984695252465535,63.884918309316866,NaN,NaN,-5.138283178711489,3.4043991311455972
2012-05-17T09:30:00-04:00,36.8,36.80991,36.35001,36.39,5766801,5100487.3,36.55445394185404,48.56569019314627,NaN,NaN,-150.00140702805444,-101.4584731899575,-0.09916024559810155,-0.10657964757641025,-0.007419401978308697,173824047,178144320.8,35.660671874705415,61.13050695049425,NaN,NaN,-8.604383597316005,1.6888587413653684
2012-05-18T09:30:00-04:00,36.49001,36.5,35.96001,36.07001,6830625,5156291.2,32.01245687431316,46.62576940071603,NaN,NaN,-200.05460918756555,-136.44292202609432,-0.12534758667107598,-0.1641038853171537,-0.0387562986460777,166993422,174250983.2,30.515112128466114,57.97236600585493,NaN,NaN,-13.16592788313905,-0.43325363356383395
2012-05-21T09:30:00-04:00,36.11,36.4469,36.09,36.42,7835828,5302746.45,40.69246854958596,45.13437212514817,NaN,NaN,-144.70105277076456,-145.39285183806854,-0.1125014991657737,-0.17938317260329484,-0.06688167343752113,174829250,173611558.8,29.75572119327562,54.690255325762166,NaN,NaN,-14.20440760914273,-2.400561344360819
2012-05-22T09:30:00-04:00,36.45,36.66,36.22,36.32001,5614344,5434908.25,39.15446317881057,43.66807035734853,NaN,NaN,-111.72532071382928,-142.48270686595995,-0.1043236866563235,-0.1972862817579255,-0.09296259510160201,169214906,172890494.6,28.882831007880355,51.49401262609423,NaN,NaN,-15.529357281246112,-4.276103621058718
2012-05-23T09:30:00-04:00,36.23,36.34,35.81,36.16,6769770,5462577.4,36.760070420012845,42.2950581954534,NaN,NaN,-145.9249452872975,-150.48146699750228,-0.10309311431763157,-0.22182898799864148,-0.1187358736810099,162445136,169461352.2,25.110266147498677,48.09068867048054,NaN,NaN,-17.38483184479423,-6.148779081592362
2012-05-24T09:30:00-04:00,36.25999,36.50999,36.16,36.50999,6592328,5518560.2,44.72266184760098,42.24828274431273,NaN,NaN,-85.97887379326622,-137.67696035054465,-0.07349946755485445,-0.21061020812457798,-0.13711074056972353,169037464,168504035.6,24.16146548088699,45.04055105719546,NaN,NaN,-16.34984775669681,-7.606074606607283
2012-05-25T09:30:00-04:00,36.42,36.62,36.31,36.42,3065789,5476267.75,43.215949279521745,41.968125149227674,NaN,NaN,-69.39287545199718,-111.54461360343096,-0.05559071866413284,-0.20659913889988957,-0.15100842023575672,165971675,168299686.2,23.953403202102876,41.97202562435233,NaN,NaN,-15.998786695368878,-8.805033476430367
2012-05-29T09:30:00-04:00,36.62,36.745,36.422,36.53999,9650043,5720015.6,45.836226059056315,41.85883367527797,NaN,NaN,-42.42785771918532,-91.0899745931151,-0.03241750805406532,-0.19153030530333837,-0.15911279724927305,175621718,168458179.8,24.496478852030307,39.001338721198806,NaN,NaN,-14.893681702451273,-9.674840365861925
2012-05-30T09:30:00-04:00,36.41,36.42999,36.22,36.33,3818102,5634295.3,42.1688860957638,41.840117469726806,NaN,NaN,-81.10888487325084,-84.96668742499942,-0.02814407946828948,-0.1942928965846349,-0.1661488171163454,171803616,168975921.8,26.346847402189255,36.47101796905861,NaN,NaN,-15.08545672969815,-10.44778556069567
2012-05-31T09:30:00-04:00,36.33,36.41,35.95,36.14999,4766289,5729447.2,39.26841593117341,41.18448053882283,NaN,NaN,-102.90005791571089,-76.3617099506821,-0.03396328868235979,-0.20860292796929514,-0.17463963928693535,167037327,169894360,29.64091451887731,34.197631115802785,NaN,NaN,-16.143381611396144,-11.261442139367167
2012-06-01T09:30:00-04:00,35.8,35.89999,35.47,35.50999,10556684,6092426.4,31.08260501859381,40.00305389071501,NaN,NaN,-196.59851111696725,-98.4856374154223,-0.07508139315422258,-0.26849138072971357,-0.193409987575491,156480643,167382995.8,26.19149627420758,31.653116344743633,NaN,NaN,-20.051679816093376,-12.517190378899482
2012-06-04T09:30:00-04:00,35.52,35.67,35.38,35.59,5566742,6126445.55,32.96398068801285,39.133289790594134,NaN,NaN,-185.23742023571205,-121.65454637216526,-0.09004820053180085,-0.30597023824024205,-0.2159220377084412,162047385,166598137.8,25.20431867264547,29.60727188246287,NaN,NaN,-22.46667757679103,-13.938545692883988
2012-06-05T09:30:00-04:00,35.48,35.88,35.45,35.78999,7621863,6223029.15,37.55287260582331,38.89214389608492,NaN,NaN,-136.98613485279225,-140.56620179888665,-0.07997721538255612,-0.31589355693663634,-0.23591634155408023,169669248,165407643.8,23.742535734273375,28.189054124393255,NaN,NaN,-22.95089485636636,-15.22602414481004
2012-06-06T09:30:00-04:00,35.92999,36.35001,35.87,36.35001,8536379,6450627.7,48.23822220394986,39.30169519243378,NaN,NaN,-39.90306787181149,-132.3250383985988,-0.031582406867324,-0.2753943501382352,-0.2438119432709112,178205627,166688046,28.542723961867964,27.300341889350573,NaN,NaN,-19.56830108962139,-15.846349422640232
2012-06-07T09:30:00-04:00,36.59,36.60001,36.28999,36.37,7312652,6381519.65,48.576467772280374,40.160410466035664,NaN,NaN,10.139708805789649,-109.71708505429868,0.003904625549130042,-0.23893116133449865,-0.2428357868836287,185518279,170384236.4,40.23762074714187,27.627266808810315,NaN,NaN,-16.875959437964156,-15.993436567686507
2012-06-08T09:30:00-04:00,36.25999,36.63,36.25999,36.59,5226234,6472754.65,52.27289841766235,41.60758486198917,NaN,NaN,34.43982237150904,-63.509418356603405,0.042196296601961225,-0.19009041613117716,-0.2322867127331384,190744513,177237010.4,54.956604242354196,29.373087674088033,NaN,NaN,-13.430300344985946,-15.627274250157855
2012-06-11T09:30:00-04:00,36.7,36.77,36.25,36.27,7851484,6689623.05,46.98271479850737,42.05688816548356,NaN,NaN,30.3769279731591,-20.386548714829182,0.04568083578969029,-0.17518566799602553,-0.22086650378571582,182893029,181406139.2,61.21517742054214,31.620191690321356,NaN,NaN,-12.224523822416215,-15.141167046194763
2012-06-12T09:30:00-04:00,36.34,36.61,36.14,36.61,8853922,6710632.25,52.48494803142982,43.00906565495636,NaN,NaN,43.583604665801516,15.727399188889581,0.06918181600303902,-0.13438923378191703,-0.20357104978495605,191746951,185821679.8,66.52086520367615,34.30862270430673,NaN,NaN,-9.338836127294782,-14.312262629209052
2012-06-13T09:30:00-04:00,36.60001,36.89999,36.47,36.57001,15158934,7208271.7,51.80395665568586,44.08362895750444,NaN,NaN,97.20309661709334,43.14863208667054,0.07958900002523789,-0.10408479975340867,-0.18367379977864656,176588017,185498157.8,65.81050321845036,37.21578249508899,NaN,NaN,-7.294150817305852,-13.309675227508595
2012-06-14T09:30:00-04:00,36.64999,37.22,36.58,37.12,14048391,7572160.2,59.572983236963886,45.144366199601784,NaN,NaN,177.2684769435196,76.57438571421653,0.11871343034919798,-0.035282011842149075,-0.15399544219134706,190636408,186521783.6,67.01087214725024,40.27645439982922,NaN,NaN,-2.7625977170793967,-11.802949868875853
2012-06-15T09:30:00-04:00,37,37.14999,36.9744,37.06,7422605,7654950.4,58.465753070350395,46.23363789894669,NaN,NaN,179.49532627009395,105.58548649393352,0.13458759834879455,0.014239055744646123,-0.12034854260414843,183213803,185015641.6,63.4793349577386,43.099735239517486,NaN,NaN,0.42837431994304165,-10.055617841901725
2012-06-18T09:30:00-04:00,37.05,37.31,37.02,37.31,7202242,7673531.25,61.663026830364664,47.36412366832586,NaN,NaN,185.87255043407575,136.68461098611687,0.15453352566112832,0.07281836447226198,-0.08171516118886635,190416045,186520244.8,65.43884505591858,46.02418996836665,NaN,NaN,4.1379023082651845,-8.027972106163595
2012-06-19T09:30:00-04:00,37.38,37.75,37.38,37.64999,6074480,7585463.85,65.54728230593489,49.034009111909505,NaN,NaN,219.45664888744898,171.85921983044634,0.1813766927618464,0.14500570476344166,-0.03637098799840474,196490525,187468959.6,66.65378214304252,48.90325673557045,NaN,NaN,8.600749434387588,-5.652440457513427
2012-06-20T09:30:00-04:00,37.59,37.73,37.3,37.55,5874289,7598461.1,63.50929094805181,50.765500184543676,NaN,NaN,166.94743251486508,185.8080870100007,0.18264386306650102,0.19193384083472154,0.00928997776822052,190616236,190274603.4,70.01120538770346,51.78684894048661,NaN,NaN,11.550910234752958,-3.1948189300468006
2012-06-21T09:30:00-04:00,37.47,37.64,36.98,37.03,5341055,7527025.35,54.090408659017825,52.40891473028825,NaN,NaN,101.01103279763362,170.5565981808235,0.14059372761847616,0.18503213729131573,0.04443840967283957,185275181,189202358,67.2254709973918,54.717847134999765,NaN,NaN,11.071343973490084,-1.1567956581129604
2012-06-22T09:30:00-04:00,37.21001,37.49001,37.1301,37.41499,4764059,7435611.9,58.945062712042244,54.26470630343321,NaN,NaN,103.91510027512535,155.44055298182977,0.1310313877389913,0.2082276443465787,0.07719625660758739,190039240,190567445.4,68.92094415003649,57.8404632405277,NaN,NaN,12.306165793364265,0.7664845492409289
2012-06-25T09:30:00-04:00,36.88,37.12,36.88,36.96001,8618133,7713229.1,51.95317429717091,55.29329928138661,NaN,NaN,48.836915556415185,128.03342600629767,0.08842947227167178,0.1877330969471771,0.09930362467550533,181421107,188768457.8,64.20695147422546,60.73077865052427,NaN,NaN,10.911430287586919,2.2157625118617847
2012-06-26T09:30:00-04:00,37.03,37.185,36.94,37.07001,6401508,7550802.35,53.392592733461186,55.66146860492313,NaN,NaN,53.93083068388302,94.92826236558447,0.0632064087629215,0.1783116356291572,0.1151052268662357,187822615,187034875.8,59.951564053626946,62.97426722850706,NaN,NaN,10.291297954638287,3.3694104322584275
2012-06-27T09:30:00-04:00,37.17999,37.595,37.12,37.47,8066836,7763239.05,58.286342547046715,56.35503108883501,NaN,NaN,86.28665486475445,78.79610683556233,0.06856073178533259,0.20080614159790144,0.13224540981256885,195889451,188089518.8,61.6181537239704,64.50144815542338,NaN,NaN,11.399174613453344,4.516519601000558
2012-06-28T09:30:00-04:00,37.35001,37.41,36.92,37.3,12607266,8155287.9,55.613628353793146,56.59365465570149,NaN,NaN,57.43323597639137,70.08054747131389,0.05626799186704268,0.2025803996463722,0.14631240777932952,183282185,187690919.6,60.591856819263434,64.90396619663117,NaN,NaN,11.424413747149698,5.503361621879007
2012-06-29T09:30:00-04:00,37.62,38.03,37.62,38.005,9551121,8105009.75,63.15844293953852,57.74906380863229,NaN,NaN,134.09427502889864,76.11638242206854,0.08927103022239527,0.2579011955573236,0.16863016533492833,192833306,188249732.8,61.5585290698657,64.92849131444001,NaN,NaN,14.095466222384747,6.730805136236969
2012-07-02T09:30:00-04:00,38.14,38.14999,37.85001,38.125,6582543,8155799.8,64.27168168616997,58.59097335539945,NaN,NaN,150.9172876010164,96.53245683098878,0.11139771100021384,0.30787730408519565,0.1964795930849818,199415849,191848681.2,67.14775845724078,64.97326940398034,NaN,NaN,16.55039455911995,8.133603625220253
2012-07-03T09:30:00-04:00,38.12,38.22,37.97,38.12,3697140,7959563.65,64.18465449109209,59.475308915071324,NaN,NaN,149.9532928979923,115.73694927381064,0.11731627849549561,0.34312494120435133,0.22580866270885572,195718709,193427900,69.25983430167531,65.21965019563926,NaN,NaN,18.435648131750916,9.605324269010348
2012-07-05T09:30:00-04:00,38.03,38.06,37.84,37.88,3692437,7717366.55,59.98599088472426,59.50480946133992,NaN,NaN,113.71494178242807,121.22260665734537,0.097501114974058,0.3476850564264282,0.2501839414523702,192026272,192655264.2,66.99061902615173,65.21820354413224,NaN,NaN,18.738359004199783,10.910043516894552
2012-07-06T09:30:00-04:00,37.73,37.78,37.47501,37.63,5904270,7646947.45,55.885001982939656,59.32047009795344,NaN,NaN,59.826774305471574,121.70131432316138,0.06173488960971546,0.32735255346451453,0.26561766385479907,186122002,193223227.6,67.82514724159081,65.52861870726453,NaN,NaN,17.73830735167111,11.885509779005488
2012-07-09T09:30:00-04:00,37.46001,37.89,37.46001,37.83,6279535,7699612.5,58.33883410195757,59.08302776021008,NaN,NaN,68.26690025282537,108.53583936794675,0.0464230147569753,0.3236464323010182,0.2772234175440429,192401537,193136873.8,67.5455414784143,65.67909702315708,NaN,NaN,17.63346080925009,12.706645640469002
2012-07-10T09:30:00-04:00,38.05,38.05,37.53,37.64999,5669762,7590526.4,55.354399633544084,58.35496471218216,NaN,NaN,64.20310312290904,91.19300247232528,0.020377046451364067,0.30269472560824795,0.2823176791568839,186731775,190600059,59.75255620998117,65.1861523136527,NaN,NaN,16.657696525954215,13.271081481252605
2012-07-11T09:30:00-04:00,37.62,37.69,37.42101,37.62,6571961,7476428.35,54.85095351082359,57.73651203809443,NaN,NaN,26.86107833539187,66.5745595598052,-0.0015039884638564094,0.2804376935770634,0.2819416820409198,180159814,187488280,51.85011051064635,63.88893125100577,NaN,NaN,15.720322011520585,13.620972985576602
2012-07-12T09:30:00-04:00,37.58,37.83,37.39,37.71001,3999508,6918457.05,56.14028803046302,57.88293199319766,NaN,NaN,33.7098636708716,50.5735439374939,-0.011965936259142274,0.26698426171699197,0.27895019797613424,184159322,185914890,48.36700559937171,62.54189800829005,NaN,NaN,15.28396618923506,13.858543443242096
2012-07-13T09:30:00-04:00,37.72,38.19,37.7,38.13,5160965,6474085.75,61.644304904452596,58.07573500694126,NaN,NaN,106.81211274449855,59.9706116252993,0.00636363661459638,0.2869047437443797,0.2805411071297833,189320287,186554547,49.84220510818409,61.179130933872024,NaN,NaN,16.49114201196825,14.234628953060119
2012-07-16T09:30:00-04:00,38.09,38.24001,38,38.2,3850592,6295485.1,62.489221484743226,58.82830980605356,NaN,NaN,127.59128758514764,71.83548909176375,0.01942826218638799,0.3048264348627683,0.2853981726763803,193170879,186708415.4,50.21071260013428,60.179399585722656,NaN,NaN,17.727724150728793,14.733642552727073
2012-07-17T09:30:00-04:00,38.28999,38.77,38.12,38.69,6453863,6258066.15,67.83119390297702,59.85963846101898,NaN,NaN,183.9188185904874,95.77863218527942,0.05526718939151487,0.3544821594157739,0.299214970024259,199624742,189287008.8,56.03962332655138,59.8999752480744,NaN,NaN,20.51621949844238,15.559724973543545
2012-07-18T09:30:00-04:00,38.55,38.84,38.44,38.75,5748676,6241775.95,68.42417402769495,60.583769281065294,NaN,NaN,177.62904483594352,125.93222548538975,0.0759343113181446,0.39413285917193974,0.31819854785379514,205373418,194329729.6,64.73457793547583,60.122576977467645,NaN,NaN,22.957206310840995,16.616508021728894
2012-07-19T09:30:00-04:00,38.83,38.84,38.52,38.75,4801770,6188150,68.42417402769495,61.49880825777256,NaN,NaN,153.60269735732652,149.91079222268073,0.08200650545624188,0.4207066796740975,0.3387001742178556,205373418,198572548.8,70.09421525811126,60.80131686595677,NaN,NaN,24.94104635895857,17.805727784190275
2012-07-20T09:30:00-04:00,38.61,38.7,38.19,38.25,4197445,6130969.5,58.07749066777997,61.13588309550409,NaN,NaN,89.83457469041304,146.51528461186362,0.04651682583370864,0.39684620650999136,0.3503293806762827,201175973,200943686,72.60042273391498,61.59002355624601,NaN,NaN,23.677879215440033,18.644606560083098
2012-07-23T09:30:00-04:00,37.87,37.89999,37.59,37.8,4673969,6126465,50.65363672204539,60.163165598066634,NaN,NaN,-16.268411597985583,117.74334477523698,-0.010077741489548153,0.33773220381434754,0.3478099453038957,196502004,201609911,73.2780317661194,62.02790022116591,NaN,NaN,20.149863072373144,18.85964320469596
2012-07-24T09:30:00-04:00,37.77,37.80499,37.17999,37.38,4431102,5917113.45,44.8865172875893,58.78472722638786,NaN,NaN,-78.85211800886132,65.18915745536724,-0.07499616369091933,0.25406474069024654,0.32906090438116586,192070902,200099143,69.10450485072337,62.01680526038363,NaN,NaN,15.152887554022149,18.33010668317113
2012-07-25T09:30:00-04:00,37.44,37.61929,37.21201,37.56,5069047,5850490.4,47.63803400961398,57.90273030673712,NaN,NaN,-85.2945829915169,12.604431889875155,-0.10326715618780913,0.19997695914640445,0.3032441153342136,197139949,198452449.2,64.77408068940784,61.85848109347335,NaN,NaN,11.965685896764311,17.420903713684442
2012-07-26T09:30:00-04:00,37.95,38.10001,37.77,37.92,8521141,5873205.65,52.72184610295938,57.67679060102425,NaN,NaN,0.6578793482705306,-17.984531711936032,-0.09536369135740658,0.18403950113745537,0.27940319249486195,205661090,198509983.6,64.85694414147927,61.646466586322525,NaN,NaN,10.887731838813307,16.487593445845707
2012-07-27T09:30:00-04:00,38.14999,38.89999,38.13,38.83,6373160,5561500.35,62.605271797625626,57.981536150714824,NaN,NaN,128.5623317033728,-10.238980309344097,-0.029884021933816618,0.2420481650775912,0.2719321870114078,212034250,200681639,67.9240464898096,61.67350265856504,NaN,NaN,13.514861490344085,16.06291745220262
2012-07-30T09:30:00-04:00,38.74001,38.82001,38.57001,38.63,5215340,5344711.3,59.65367207586702,58.28862703945218,NaN,NaN,119.8583801442582,16.986378039104665,-0.0025187504855630483,0.268783748904454,0.27130249939001705,206818910,202745020.2,70.55366770472001,62.44501062247496,NaN,NaN,14.527639284956923,15.843591999738948
2012-07-31T09:30:00-04:00,38.60001,38.75999,38.38,38.39,5167020,5273935.15,56.227856254748,58.38697723544677,NaN,NaN,78.9490851670261,48.54661867428215,-0.0030243438488065655,0.2675220695790088,0.2705464134278154,201651890,204661217.8,72.78501525639533,63.94036096145703,NaN,NaN,14.179236455226313,15.605826921951428
2012-08-01T09:30:00-04:00,38.61,38.7,38.34,38.41,6243840,5401270.15,56.45229382041656,58.4092633633006,NaN,NaN,67.23439553878801,79.05241438034314,-0.004372865603977094,0.26508033142284404,0.26945319702682113,207895730,206812374,75.06899446029051,65.84764588009408,NaN,NaN,13.979346548898672,15.373472582943892
2012-08-02T09:30:00-04:00,38.12,38.3,37.78,38.03999,5332078,5483252.2,51.21985426038926,57.6646597458675,NaN,NaN,-7.562080837058416,77.40842234327735,-0.031058587226517276,0.23062996299367455,0.26168855022019183,202563652,206192886.4,73.16471326195115,67.51353931964887,NaN,NaN,12.134757981879899,14.91079906850618
2012-08-03T09:30:00-04:00,38.46001,38.722,38.39999,38.49001,4462566,5411167,56.50074826574493,57.236911658796195,NaN,NaN,68.62237643550033,65.42043128970285,-0.019823077576074377,0.23690970325009886,0.25673278082617323,207026218,205191280,70.06978612265912,68.93204457125779,NaN,NaN,12.26777448401909,14.533224127865166
2012-08-06T09:30:00-04:00,38.62,38.625,38.46001,38.5,3532248,5273802.65,56.61303849021564,56.435614843598955,NaN,NaN,60.64140814320668,53.57703688949253,-0.013444764607831616,0.23992682506638374,0.25337158967421536,210558466,205939191.2,71.05440655037101,70.0045290872449,NaN,NaN,12.406342467125022,14.229383890616575
2012-08-07T09:30:00-04:00,38.42999,38.53,38.37,38.41,4235680,5202098.55,55.229805364334226,55.49315993907319,NaN,NaN,40.419217957662966,45.87106344761991,-0.016795694992901122,0.23237697093308896,0.24917266592599008,206322786,206873370.4,72.28100210594522,70.54355938513558,NaN,NaN,12.113838578032887,13.927163131676048
2012-08-08T09:30:00-04:00,38.49001,38.61,38.38,38.55,3203491,5033675.05,56.99022536025602,54.67644931997041,NaN,NaN,48.87265481076912,42.19871530201614,-0.011352721852756875,0.23498176361004397,0.24633448546280085,209526277,207199479.8,72.71566257865523,70.73080562231729,NaN,NaN,12.373793918133593,13.705253244027126
2012-08-09T09:30:00-04:00,38.52,38.66,38.45,38.53,3110252,4989212.25,56.64754042582611,54.574310016973705,NaN,NaN,50.8277538213282,53.87668223369345,-0.010868181056626153,0.23274925914201816,0.2436174401986443,206416025,207969954.4,73.76248963215964,70.81381040076333,NaN,NaN,12.493624676264032,13.5321634486324
2012-08-10T09:30:00-04:00,38.50999,38.72,38.44,38.69,3949057,4928616.85,58.78278651702002,55.1549635737576,NaN,NaN,60.867526405467636,52.325712227686914,-0.0020049397519103507,0.2411112655087564,0.24311620526066674,210365082,208637727.2,74.66959702710216,70.91320791940497,NaN,NaN,13.179605233286345,13.481797989297249
2012-08-13T09:30:00-04:00,38.56,38.63499,38.4101,38.59,2250993,4848636.9,56.8965975911123,56.012826452580676,NaN,NaN,42.68819257644437,48.73506911433445,-0.0049427399751642564,0.23693778029171142,0.24188052026687568,208114089,208148851.8,72.68827712537511,71.16919165330866,NaN,NaN,13.260597928984334,13.450197980681118
2012-08-14T09:30:00-04:00,38.75999,38.77,38.61,38.69,2448620,4648374.75,58.336315409120715,56.77698940968829,NaN,NaN,71.30496951880508,54.912219426562885,-0.0023484017940466617,0.23894501802431733,0.241293419818364,210562709,208996836.4,73.97808355258725,71.82662042925004,NaN,NaN,13.710002350301318,13.48731289062686
2012-08-15T09:30:00-04:00,38.7,38.88499,38.63,38.78,2294566,4475669.25,59.6428284246982,57.271345289812494,NaN,NaN,85.75100119257516,62.2878887029241,0.00294454991375645,0.24497410721055957,0.24202955729680312,212857275,209663036,74.97785573551047,72.54954268596656,NaN,NaN,14.436996239453581,13.62298194045925
2012-08-16T09:30:00-04:00,38.78,38.78,38.53999,38.67999,4592766,4465219.05,57.48557797019602,56.905652873567526,NaN,NaN,65.50611398916377,65.22356073649121,-0.0024812305023318715,0.23892801916888828,0.24140924967122016,208264509,210032732.8,75.53948960857805,73.09350290873573,NaN,NaN,14.512219577213134,13.750015888566947
2012-08-17T09:30:00-04:00,38.72,38.72,38.36,38.48,6007793,4555736.45,53.33149086005593,56.454068501009594,NaN,NaN,32.50926488460227,59.55190843231814,-0.020715710984506003,0.21551461094058766,0.23623032192509366,202256716,208411059.6,68.29783152491949,72.9323717530357,NaN,NaN,13.479084679989475,13.711311430198737
2012-08-20T09:30:00-04:00,38.48,38.61,38.42999,38.56,4566484,4550362.2,54.74043401698506,56.3478240554551,NaN,NaN,31.69516209470505,57.35330233597027,-0.028107031936424692,0.2010965320045628,0.22920356394098748,206823200,208152881.8,67.19341993649456,72.5329720873285,NaN,NaN,12.957357416978372,13.6036037140244
2012-08-21T09:30:00-04:00,38.57001,38.75,38.42,38.42999,5663434,4611978.8,51.99324871666992,56.02932083375891,NaN,NaN,25.743561487921752,48.24102072979361,-0.04165289127090774,0.1771374498523528,0.21879034112326054,201159766,206272293.2,59.62953290081889,71.43015340450908,NaN,NaN,11.778120328380249,13.342820373218093
2012-08-22T09:30:00-04:00,38.39,38.53999,38.35001,38.46001,2509774,4484015.15,52.58496619132946,56.12682882882607,NaN,NaN,-31.77657095637552,24.735506300003472,-0.04803852359511393,0.15874218662936812,0.20678071022448205,203669540,204434746.2,53.314274407739916,70.01226491492257,NaN,NaN,10.926294301405415,12.997602362959139
2012-08-23T09:30:00-04:00,38.42999,38.50999,38.33,38.41,2565280,4186222.1,51.44732392906596,55.76586994763471,NaN,NaN,-86.51667611431984,-5.669051720693257,-0.054599357070591714,0.1385315138862424,0.19313087095683412,201104260,203002696.4,48.962212110264815,68.50458105689441,NaN,NaN,9.905867494862566,12.555925953231057
2012-08-24T09:30:00-04:00,38.45,38.84,38.41,38.74001,5991148,4167121.5,57.91729959788321,55.85903145532525,NaN,NaN,95.89504474060821,7.0081042505079285,-0.03654964191836596,0.14744381855887667,0.18399346047724263,207095408,203970434.8,51.82418308424272,67.13099366645669,NaN,NaN,10.694382820350059,12.289991219962342
2012-08-27T09:30:00-04:00,38.77,38.94,38.64999,38.78,3610940,4086901.5,58.636607146220776,56.102374439745724,NaN,NaN,172.47433540818366,35.16393891320365,-0.022445802399110093,0.15593620747835502,0.1783820098774651,210706348,204747064.4,54.05102730197041,65.82885260902991,NaN,NaN,11.551086994592437,12.184433473480928
2012-08-28T09:30:00-04:00,38.64999,38.85001,38.60001,38.72,3558889,4006494.95,57.060692876469105,56.10740783376094,NaN,NaN,108.50310964988935,51.71584854559717,-0.017884477536505017,0.15602641295683384,0.17391089049333885,207147459,205944603,57.32653708445937,64.72962935944449,NaN,NaN,11.876656112700907,12.140465279083783
2012-08-29T09:30:00-04:00,38.7,38.99001,38.69,38.85001,2849145,3836760.2,59.59472443524103,56.317920977290576,NaN,NaN,151.13897656301552,88.29895804947537,-0.007376571534041421,0.16469017607578706,0.17206674760982849,209996604,207210015.8,60.528485089037645,63.784343320650066,NaN,NaN,12.836132655962077,12.23984633292354
2012-08-30T09:30:00-04:00,38.66,38.8062,38.55,38.72,3807997,3760556.15,56.033576511658154,56.121548834050444,NaN,NaN,58.3578678367653,117.27386683969242,-0.010269361720886522,0.15923004545872033,0.16949940717960685,206188607,208226885.2,62.93525744770664,62.9461762078361,NaN,NaN,12.733799991814937,12.310411141336596
2012-08-31T09:30:00-04:00,38.86,39.05,38.67,38.84,4666234,3770739.55,58.49866994313906,56.23598257348093,NaN,NaN,138.5610271987483,125.80706333132044,-0.005431343739166539,0.16271022750564867,0.1681415712448152,210854841,208978771.8,64.65155801700637,62.37212484295262,NaN,NaN,13.308427270198791,12.452984874031195
2012-09-04T09:30:00-04:00,38.8,39.02,38.62,38.92,6334391,3910846.7,60.10460663766193,56.362289089805294,NaN,NaN,121.1772854579846,115.54765334128062,0.00145825071324035,0.16996438463636565,0.1685061339231253,217189232,210275348.6,67.45057933729703,61.90587454186046,NaN,NaN,14.23439850231317,12.707472535214334
2012-09-05T09:30:00-04:00,38.99001,39.08,38.82001,38.92999,2779798,3838052.6,60.311142365512126,56.41002579986344,NaN,NaN,152.64819169020154,124.37666974934305,0.00480137133390493,0.17450784809050646,0.16970647675660153,219969030,212839662.8,72.1479124173101,61.70373573341759,NaN,NaN,15.067020777415186,13.044550855528742
2012-09-06T09:30:00-04:00,39.10001,39.56,39.10001,39.55,5035574,3929656.75,70.51372705871889,57.34060787761507,NaN,NaN,300.3948986331481,154.22785416336956,0.044665486941829896,0.2255383354338889,0.180872848492059,225004604,215841262.8,76.43482832154285,61.767688498629354,NaN,NaN,19.236394003056766,13.929099876604175
2012-09-07T09:30:00-04:00,39.63,39.655,39.42,39.53,3980884,3973188.35,69.88960407666512,58.52333025023001,NaN,NaN,264.7776049360327,195.51180158322305,0.06438476716643798,0.2613538074501065,0.19696904028366852,221023720,218808285.4,79.75235517560148,62.58586875939235,NaN,NaN,22.37749866094329,15.13601398865262
2012-09-10T09:30:00-04:00,39.53999,39.57001,39.39,39.39,2781239,3914797.45,65.51800908323726,59.2931570406766,NaN,NaN,188.07439435753636,205.4144750149807,0.06263907202297259,0.27526788031238425,0.21262880828941166,218242481,220285813.4,81.17372711425533,63.584462129232406,NaN,NaN,23.74211797059821,16.365457414644847
2012-09-11T09:30:00-04:00,39.39999,39.52,39.37,39.41,2391976,3921846.6,65.84666923182778,60.2826870774736,NaN,NaN,151.99240390905456,211.57749870519464,0.05759911748362842,0.2846277051439472,0.22702858766031878,220634457,220974858.4,81.81485767203,65.16912818431892,NaN,NaN,24.948263367365307,17.59157255074777
2012-09-12T09:30:00-04:00,39.42,39.53999,39.36,39.42999,2864129,3942622.05,66.19350378539093,61.25472547704942,NaN,NaN,128.0943910765137,206.66673858245707,0.05062666950394329,0.2903119245402479,0.2396852550363046,223498586,221680769.6,82.47337556245512,67.25192112394143,NaN,NaN,26.042033591805204,18.798781270898832
2012-09-13T09:30:00-04:00,39.44,39.90601,39.295,39.83,6849316,4170359.55,72.26344574657624,62.741591321157294,NaN,NaN,146.60443186253596,175.90864522833468,0.06694507950246736,0.3233666044143888,0.25642152491192144,230347902,222749429.2,83.45041476609507,69.71536417078644,NaN,NaN,28.98572929009497,20.254059559355422
2012-09-14T09:30:00-04:00,39.83,39.89,39.549,39.67,11318609,4506651.7,67.07564761204554,63.395759036454606,NaN,NaN,126.935522203723,148.3402286818727,0.06111519875349819,0.33281552335379416,0.271700324600296,219029293,222350543.8,81.62142483863089,71.84373858181418,NaN,NaN,29.879224830631397,21.629083169537704
2012-09-17T09:30:00-04:00,39.57001,39.89999,39.57001,39.89999,2602484,4336386.25,70.36863259219761,64.23376085402438,NaN,NaN,121.24964490252708,134.97527879087087,0.06645776724193414,0.35477253365271366,0.2883147664107795,221631777,223028403,82.33017175101125,73.86367747103138,NaN,NaN,31.699954887288577,23.0677791292164
2012-09-18T09:30:00-04:00,39.84,40.08,39.81,40.03,3210575,4268590.8,72.06925359617425,65.3058009054319,NaN,NaN,130.09647437594273,130.59609288424852,0.07199098347467048,0.3783034957541176,0.3063125122794471,224842352,223869982,83.1965696111053,75.71153693722037,NaN,NaN,33.74472151530234,24.593056612942963
2012-09-19T09:30:00-04:00,40.03,40.21001,39.99001,40.07001,4891082,4229973.2,72.59060644185786,66.2340781916188,NaN,NaN,129.9812757045594,130.97346980985768,0.07144596192474095,0.3956199646853733,0.32417400276063235,229733434,225116951.6,84.41587664531461,77.41777919124016,NaN,NaN,35.55496451632764,26.15904345628363
2012-09-20T09:30:00-04:00,40.03999,40.24001,39.92999,40.24001,4836469,4346307.95,74.74745390796542,67.57078371992647,NaN,NaN,123.95662769432052,126.44390897621459,0.07525260793831556,0.4182397626835268,0.34298715474521124,234569903,225961351.8,85.19909103930303,79.00805301921135,NaN,NaN,37.76956470815695,27.81768934940839
2012-09-21T09:30:00-04:00,40.144,40.32001,40.08,40.19,8167402,4626414.05,72.9293652561472,68.60154767085562,NaN,NaN,123.57371624989267,125.77154778544852,0.06737520406861536,0.4272061598309804,0.35983095576236507,226402501,227435993.4,86.47725341619359,80.56703126201043,NaN,NaN,39.062266252381086,29.42405747840449
2012-09-24T09:30:00-04:00,40.14,40.375,40.09,40.3,6989906,4676351.95,74.40408606122043,69.62293905825265,NaN,NaN,123.09089690027744,126.13979818499861,0.06264531328618317,0.43813759737009406,0.3754922840839109,233392407,229788119.4,88.22408518808983,82.05085310849563,NaN,NaN,40.58893114988052,31.019039431472493
2012-09-25T09:30:00-04:00,40.42,40.67999,40.25999,40.2699,4965211,4744065.5,73.22851179636757,70.54560830331376,NaN,NaN,129.1283692611213,125.94617716203429,0.05105253537829568,0.4393079533067805,0.38825541792848484,228427196,230505088.2,88.70312208587434,83.23336808482165,NaN,NaN,41.52606990115345,32.520043784284056
2012-09-26T09:30:00-04:00,40.36,40.448,40.03999,40.065,6669027,4899572.4,65.62706262009803,70.19656084341227,NaN,NaN,88.00847326247278,117.55161667361699,0.024494258660154533,0.418873241253678,0.39437898259352344,221758169,228910035.2,80.82571299592841,83.5470027044206,NaN,NaN,40.151786365886835,33.61029272451302
2012-09-27T09:30:00-04:00,40.12,40.39999,40.09,40.295,3146042,4914417.25,69.45940453706815,70.16583230486962,NaN,NaN,91.23239932512281,111.00677099977743,0.017646600592808537,0.4164372333345341,0.39879063274172555,224904211,226976896.8,72.43038270907088,83.024004671097,NaN,NaN,40.06706677911272,34.53268901802726
2012-09-28T09:30:00-04:00,40.22,40.23,39.95,40.12,4719527,4959993.75,63.644981048634875,70.03204458811231,NaN,NaN,60.227792533653556,98.33758625652962,-0.002374232029691725,0.3958228427046109,0.3981970747343026,220184684,225733333.4,67.56831504450128,82.05218952325743,NaN,NaN,38.18697135043478,35.05472935122834
2012-10-01T09:30:00-04:00,40.24001,40.61,40.22,40.36,5344461,4993905.1,67.64510521618278,70.16050430128054,NaN,NaN,100.47278919011245,93.81396471449662,-0.0031124882882499483,0.3943064643739902,0.39741895266224014,225529145,224160681,61.908526810279525,80.63030874741811,NaN,NaN,37.79874483426748,35.44673156309107
2012-10-02T09:30:00-04:00,40.5,40.64999,40.34,40.53999,6266512,4990511.15,70.28567017273139,70.45280190037627,NaN,NaN,111.8322301158658,90.35473688544553,0.004451297350216987,0.40298307435001135,0.39853177699979436,231795657,224834373.2,63.325729718066725,79.26261975853322,NaN,NaN,38.31241179345589,35.856114453143185
2012-10-03T09:30:00-04:00,40.59,40.91,40.55,40.88,5785918,5140817.15,74.5166535470023,70.61374531469242,NaN,NaN,152.658938582153,103.28482994938159,0.027024093027769536,0.43231189328450625,0.4052878002567367,237581575,227999054.4,69.13502358588475,78.24009181708962,NaN,NaN,40.208535100762546,36.47788883137452
2012-10-04T09:30:00-04:00,40.94,41.27,40.91,41.13,6372156,5207646.25,77.09872385927022,71.32967933235133,NaN,NaN,193.07638623507995,123.65362733137299,0.052015120881128585,0.47030670135814745,0.41829158047701887,243953731,231808958.4,74.39370999769241,77.7238264713083,NaN,NaN,42.69427440670454,37.36594391356452
2012-10-05T09:30:00-04:00,41.27,41.34,41.07001,41.17,4033473,5210275.7,77.49169358212465,71.8384694030604,NaN,NaN,185.06813255499029,148.62169533564034,0.06369151645378002,0.4979059760442439,0.4342144595904639,247987204,237369462.4,79.80243741408971,77.54327401867106,NaN,NaN,44.76045520331845,38.422302669243656
2012-10-08T09:30:00-04:00,41.14999,41.19,40.94,41.14,3126011,5227514.3,76.43238433927996,72.15012159899653,NaN,NaN,147.14983693710906,157.95710488503966,0.06179806019321771,0.511462034831986,0.44966397463876834,244861193,241235872,82.560811112357,77.4978626973319,NaN,NaN,46.08203175114878,39.51654968094439
2012-10-09T09:30:00-04:00,40.92,40.99001,40.61,40.64,6128340,5414332.5,61.373802499315055,71.34892131738633,NaN,NaN,77.86611465404827,151.16388179267616,0.021363389527345122,0.4763682115479497,0.4550048220206046,238732853,242623311.2,83.43505943184267,77.42780432494104,NaN,NaN,42.140821111891206,39.89144559965108
2012-10-10T09:30:00-04:00,40.66,40.66,40.21001,40.34,6180363,5580144.2,54.442984080128724,69.89860204396942,NaN,NaN,10.274671692619565,122.68702841476947,-0.02839367413152405,0.41951272935619954,0.4479064034877236,232552490,241617494.2,80.29257172650493,77.07733865974117,NaN,NaN,36.34545828691682,39.38487598354619
2012-10-11T09:30:00-04:00,40.52,40.64,40.36011,40.37,3791824,5427269.6,54.990367501519266,68.61724506149599,NaN,NaN,14.183558435256918,86.90846285480487,-0.06026094163035706,0.3725802264497773,0.43284116808013434,236344314,240095610.8,75.64977429093372,76.30394729365118,NaN,NaN,32.05495032550349,38.337743746682946
2012-10-12T09:30:00-04:00,40.53999,40.625,40.28999,40.31,3508304,5036754.35,53.60315995670154,67.13146462545895,NaN,NaN,-3.579530651912682,49.17893021342426,-0.08485093952665734,0.32677749367181264,0.41162843319847,232836010,237065372,67.30470493786025,74.80970584720622,NaN,NaN,28.187715115215,36.88773965647324
2012-10-15T09:30:00-04:00,40.41,40.92,40.39999,40.89,12298051,5521532.7,63.25331715111863,66.41895072222687,NaN,NaN,61.83685415207264,32.11633365641697,-0.06255394019939658,0.33343600794922423,0.3959899481486208,245134061,237119945.6,67.37450725271074,73.28623335912309,NaN,NaN,27.864745763378725,35.59874052888831
2012-10-16T09:30:00-04:00,41.02,41.33,41.00999,41.33,5658160,5643911.95,68.59054508852998,66.63062804140058,NaN,NaN,146.54948885253918,45.85300849611512,-0.020829824764663607,0.3699526671927913,0.3907824919574549,250792221,239531819.2,70.3838382681479,72.54038516428162,NaN,NaN,29.56677537560574,34.73703122127651
2012-10-17T09:30:00-04:00,41.39999,41.39999,41.17,41.33,5397902,5669252.95,68.59054508852998,66.56856665221929,NaN,NaN,137.60567048521645,71.31920825463449,0.002851286907836259,0.39434660059225024,0.391495313684414,250792221,243179765.4,74.25223480479376,72.67051745683325,NaN,NaN,30.83939273778628,34.18022572363505
2012-10-18T09:30:00-04:00,41.08,41.36,41.0117,41.34,4289215,5641890.25,68.71033361769825,66.93037755000952,NaN,NaN,109.89050700645761,90.46059796887462,0.014613668346739273,0.40976239911783807,0.3951487307710988,255081436,246927189.8,77.50306774750212,73.38014264990474,NaN,NaN,31.865267808286735,33.84951745001386
2012-10-19T09:30:00-04:00,41.24001,41.33,40.53011,40.60001,6218469,5544443.6,52.69503433462349,65.86251534418386,NaN,NaN,27.15674817285779,96.60785373382872,-0.029606900084849896,0.3581401056650364,0.3877470057498863,248862967,250132581.2,79.84691603368067,74.66145616586196,NaN,NaN,27.01524208006591,32.87319239716415
2012-10-22T09:30:00-04:00,40.60001,40.67999,40.39,40.63,4485754,5419236,53.17142065556448,64.64006895010051,NaN,NaN,-26.385991310058202,78.96328464140257,-0.05739257675660908,0.31600628480412496,0.37339886156073404,253348721,251775513.2,80.94285707819478,75.9198224058711,NaN,NaN,23.504369564225016,31.534789135315705
2012-10-23T09:30:00-04:00,40.32001,40.32001,39.85001,40.09,5915582,5466754.55,44.48454372481631,62.494918248515795,NaN,NaN,-115.43247119939697,26.56689263101533,-0.10966523149296303,0.23631732219453028,0.3459825536874933,247433139,251103696.8,79.04980663779114,76.62802119529299,NaN,NaN,17.213520275127063,29.488893583860186
2012-10-24T09:30:00-04:00,40.33,40.38,40.11,40.16,5884352,5427520.8,45.72246906161777,60.25375719154062,NaN,NaN,-90.89579836638733,-19.133401139305427,-0.1353669065765145,0.17677392046685014,0.31214082704336465,253317491,251608750.8,79.43911818898061,76.98840749467071,NaN,NaN,12.800730248442003,27.104870250229016
2012-10-25T09:30:00-04:00,40.41,40.58,40.285,40.48,4746262,5507531.8,51.09156234708941,58.36803353189525,NaN,NaN,-48.78840976824565,-50.869184494246085,-0.12680413758481557,0.15363565506234522,0.2804397926471608,258063753,252205214.2,79.91383749509747,76.99636464331412,NaN,NaN,10.913649197640146,24.79183867128775
2012-10-26T09:30:00-04:00,40.42999,40.52,40.14,40.32001,3641148,5453612.85,48.507984004784454,56.37343350800271,NaN,NaN,-78.17551230519373,-71.93563658985639,-0.1275567815356305,0.12099381572762269,0.24855059726325318,254422605,253317141.8,80.80363571831428,76.87085211516822,NaN,NaN,8.54876850877861,22.471400076643587
2012-10-31T09:30:00-04:00,40.52,40.58,39.85001,40.0289,8629875,5617883.55,44.13475571993833,55.14207302376151,NaN,NaN,-107.67576409241866,-88.19359114632847,-0.14218573538225834,0.07081842803543026,0.2130041634176886,245792730,251805943.6,75.88355921692659,76.33145924267421,NaN,NaN,5.111705512920196,19.991443710397387
2012-11-01T09:30:00-04:00,39.99001,40.48,39.99001,40.36,4900539,5549584.9,49.690308947096725,54.802596228544935,NaN,NaN,-77.82329175772308,-80.67175525799368,-0.12471315885280393,0.05711271485168368,0.1818258737044876,250693269,252457969.6,76.54709710853267,76.06392534139049,NaN,NaN,4.058874757306714,17.715362431384435
2012-11-02T09:30:00-04:00,40.42,40.55,40.09,40.14,7032988,5611938.4,46.38926514510612,54.18823177451543,NaN,NaN,-73.19703957984798,-77.13200350068583,-0.12292157434135711,0.02817390577779122,0.15109548011914833,243660281,250526527.6,70.37056120067979,75.68683869208664,NaN,NaN,2.1147352987340953,15.486701412434385
2012-11-05T09:30:00-05:00,40.09,40.25,39.9045,40.16,4693805,5528020.85,46.735689088633364,53.69769814108198,NaN,NaN,-94.16384115508897,-86.20708977805448,-0.11545604720739863,0.006775421109900037,0.12223146831729867,248354086,248584594.2,64.71640295547944,75.50195997905942,NaN,NaN,0.6954099999523287,13.373659782079805
2012-11-06T09:30:00-05:00,40.13,40.45,39.95,40.2,7549180,5703806.2,47.466835549727264,52.57009231241117,NaN,NaN,-71.42023972665513,-84.85603526234677,-0.10328605706646081,-0.006876103015777346,0.09640995405068346,255903266,248880726.4,65.17591055598648,75.34491735786483,NaN,NaN,-0.23765782497991217,11.429185838214131
2012-11-07T09:30:00-05:00,39.96001,39.97,39.16,39.53,11974922,6146251.75,38.04622350912112,50.38835505673911,NaN,NaN,-186.62963418884868,-100.64680928163277,-0.13388050314033972,-0.0709406748747412,0.06293982826559852,243928344,248507849.2,64.04489329965635,74.89213557440117,NaN,NaN,-4.263000858316037,9.187444881566964
2012-11-08T09:30:00-05:00,39.50999,39.55209,39.05,39.06,8888980,6284283.75,33.08560669823491,47.85228802886089,NaN,NaN,-218.31739280349666,-128.7456294907875,-0.17660638441931847,-0.15781815225854956,0.0187882321607689,235039364,245377068.2,55.358526060296995,73.54258494979425,NaN,NaN,-9.487073377899177,6.519656558786087
2012-11-09T09:30:00-05:00,38.98,39.42999,38.89999,39.17,7340637,6342297.45,35.21463078353912,45.459737826420955,NaN,NaN,-187.99737346422697,-151.70569626766328,-0.18727948627394203,-0.21531112568165867,-0.02803163940771662,242380001,245121012.2,54.70502268788309,71.91415315982145,NaN,NaN,-12.897733598883018,3.7457436791190726
2012-11-12T09:30:00-05:00,39.46001,39.53999,39.28999,39.37,3573718,6331392.15,39.01401378250624,44.4825220726983,NaN,NaN,-131.16437403531705,-159.1058028437089,-0.17113258773967874,-0.24194737408231504,-0.0708147863426363,245953719,244640938.8,53.431467450115335,70.0273354038525,NaN,NaN,-14.475763347999711,1.1426712466735323
2012-11-13T09:30:00-05:00,39.21001,39.64999,39.19,39.22,5221676,6417060.75,37.24958737165076,43.34524826670446,NaN,NaN,-120.35151491506937,-168.89205788139174,-0.1609680162062215,-0.27202480660041317,-0.11105679039419167,240732043,241606694.2,46.12286283591344,67.54019295797526,NaN,NaN,-16.31146273338553,-1.3507764647634763
2012-11-14T09:30:00-05:00,39.25,39.38,38.64999,38.75,6859172,6145116.8,32.31768527946818,42.47618694917959,NaN,NaN,-152.1847306452736,-162.00307717267674,-0.17514066872810957,-0.3299826263043286,-0.15484195757621905,233872871,239595599.6,42.02023228057234,64.89522336103106,NaN,NaN,-19.56090851303848,-3.952223900231334
2012-11-15T09:30:00-05:00,38.72,38.8,38.48,38.64,8624520,6293434.8,31.274031709706875,41.44415570975739,NaN,NaN,-157.00483699509337,-149.74056601099608,-0.1804509279474114,-0.3804056175104833,-0.19995468956307189,225248351,237637397,38.435260137406544,61.9663763573472,NaN,NaN,-22.494060648162044,-6.601057721364292
2012-11-16T09:30:00-05:00,38.66,39.035,38.58,38.92999,9847020,6515890.7,37.04588469852478,40.44089302057421,NaN,NaN,-115.51709954803974,-135.24451122775864,-0.15399032665798668,-0.39244259788555524,-0.23845227122756857,235095371,236180471,35.975998436117905,58.82795928170581,NaN,NaN,-23.163678626730327,-8.967146422130869
2012-11-19T09:30:00-05:00,39.3,39.36,39.17,39.34,7423703,6672615.1,44.18349952648368,40.13200127212415,NaN,NaN,-58.43906533919065,-120.69944948853336,-0.10099310283431212,-0.3646936497704587,-0.2637005469361466,242519074,235493542,34.843959251591926,55.54512524836849,NaN,NaN,-21.399569051860247,-10.743206797806494
2012-11-20T09:30:00-05:00,39.33,39.57001,39.2352,39.56,4895680,6606475.65,47.615480434735204,40.38062446603821,NaN,NaN,-33.32996458278421,-103.29513942207629,-0.046037250744413116,-0.321247110366663,-0.27520985962224986,247414754,236830084.2,38.87417978766381,52.90159814627829,NaN,NaN,-18.835213832077304,-11.899207802702323
2012-11-21T09:30:00-05:00,39.4617,39.67,39.46001,39.53,5205641,6642470,47.189382128909465,40.20198683616769,NaN,NaN,-16.068403803212433,-76.07187405366408,-0.008584132726555005,-0.2859400255304436,-0.2773558928038886,242209113,238497332.6,43.563765437923415,50.54564588409192,NaN,NaN,-16.927638854144877,-12.617555095765544
2012-11-23T09:30:00-05:00,39.75999,40.03,39.64999,40.02,2853329,6489357.35,54.371568713133605,40.772151376741085,NaN,NaN,31.98980867683824,-38.27294491927776,0.049140006484469034,-0.21593088469830235,-0.2650708911827714,245062442,242460150.8,52.82751936360959,49.29257146715833,NaN,NaN,-12.873297991758728,-12.654089795193142
2012-11-26T09:30:00-05:00,39.83,39.86,39.64,39.842,4703867,6430333.1,51.62491811557125,41.121382021522365,NaN,NaN,19.694379714377085,-11.230649066794387,0.07380143485739099,-0.17281909761103265,-0.24662053246842364,240358575,243512791.6,54.943199753829695,48.594485524183355,NaN,NaN,-10.394410353500334,-12.331278446379883
2012-11-27T09:30:00-05:00,39.67,39.89,39.58,39.60001,5396605,6462850.25,48.06970903264604,41.164444413159416,NaN,NaN,13.348869468595984,3.126937894762929,0.07219510307552673,-0.1563766536240152,-0.22857175669954194,234961970,242001370.8,51.37996044852391,47.609060516507455,NaN,NaN,-9.40628390965537,-11.913422083990667
2012-11-28T09:30:00-05:00,39.48,39.935,39.28999,39.91,7531137,6657349.7,52.57523887872247,42.202231225273806,NaN,NaN,23.4426215179232,14.481455114904412,0.08927038151666494,-0.11698377980371077,-0.20625416132037572,242493107,241017041.4,49.14460477553109,46.544754193355644,NaN,NaN,-7.136077486245373,-11.230944284312768
2012-11-29T09:30:00-05:00,40.16,40.27,40.00999,40.19,8403340,6646022.95,56.26618345962238,43.85798670823005,NaN,NaN,99.2546131561713,37.546058506781165,0.11504246001628826,-0.06245108630001539,-0.17749354631630365,250896447,242754508.2,53.02916526472555,46.378371279386265,NaN,NaN,-4.043105935086643,-10.204110234423322
2012-11-30T09:30:00-05:00,40.23,40.32001,40.07001,40.24001,4229008,6612446.4,56.91121379433971,45.40774263757295,NaN,NaN,109.94704599507823,53.13750597042916,0.12997487982776565,-0.015024946531596584,-0.14499982635936223,255125455,244767110.8,57.11547821762864,46.550546674368086,NaN,NaN,-1.3681196067041053,-8.941825859034862
2012-12-03T09:30:00-05:00,40.34,40.5,40.092,40.1499,9936953,6757644.65,55.32775549244147,46.57300990256833,NaN,NaN,116.68337015571994,72.53530405869773,0.12809205935495996,0.015115247834337708,-0.11297681152062225,245188502,245733096.2,58.960911174528825,46.945506940397614,NaN,NaN,0.38569421319093533,-7.609322991574034
2012-12-04T09:30:00-05:00,40.14999,40.37,40.14,40.235,4080358,6726972.3,56.55708689730792,47.95211701154384,NaN,NaN,113.31211890778654,92.52795394653585,0.12665801776155752,0.04534571068132465,-0.08131230708023288,249268860,248594474.2,63.914498271184854,48.21633804291701,NaN,NaN,2.1943094675681745,-6.208804068839433
2012-12-05T09:30:00-05:00,40.32001,40.545,40.08,40.37,6294332,6664229.9,58.50777063958874,49.822837394409596,NaN,NaN,124.00257108022484,112.63994385899619,0.12847625908719423,0.07928301677875993,-0.04919324230843431,255563192,251208491.2,67.74485284741961,50.05381094054895,NaN,NaN,4.282160318974274,-4.710094870580332
2012-12-06T09:30:00-05:00,40.35001,40.43761,40.25999,40.35001,2943845,6212676.05,58.091815415968995,51.738393373428316,NaN,NaN,110.24037138770981,114.83709550530389,0.12205373002685237,0.10337392022513114,-0.01867980980172122,252619347,251553071.2,68.2236771797243,52.18155501500022,NaN,NaN,5.907011565523625,-3.1933653797083386
2012-12-07T09:30:00-05:00,40.5,40.50999,40.16,40.48,4618969,5999175.5,60.07934030052656,53.38364020214273,NaN,NaN,103.75481796901934,113.5986499000921,0.12009591340461999,0.13144008195405377,0.011344168549433778,257238316,251975643.4,68.83468151645464,54.52860380645285,NaN,NaN,7.8491933648459185,-1.6158569876291593
2012-12-10T09:30:00-05:00,40.38,40.72,40.3201,40.64999,5240832,5894185.25,62.57871050947781,54.697583843785175,NaN,NaN,116.30540583897158,113.52305703674241,0.12331810769837366,0.16549180317240086,0.042173695474027204,262479148,255433772.6,73.35066198668471,57.27908257324519,NaN,NaN,10.236142712131278,0.07728582662233174
2012-12-11T09:30:00-05:00,40.84,41.17999,40.71001,41.08,3891178,5910058.25,68.0312454952191,56.15585277667689,NaN,NaN,152.47931967225207,121.35649718963552,0.14593092176520456,0.2245873476805329,0.07865642591532834,266370326,258854065.8,76.91385046516734,59.996201907352585,NaN,NaN,14.109763741733413,2.0819255287810576
2012-12-12T09:30:00-05:00,41.14999,41.3,40.95,41.02,6757566,5986852.75,66.57364198075504,57.54044276609442,NaN,NaN,145.0039941316337,125.55678179991727,0.1479081000310018,0.2635415509540806,0.1156334509230788,259612760,259663979.4,77.67505743879933,62.432722764558015,NaN,NaN,16.898011955443522,4.198509304018552
2012-12-13T09:30:00-05:00,40.98,41.05,40.59,40.67,5929160,5940352.15,58.67607180671658,57.84790727277891,NaN,NaN,96.91352249542015,122.89141202145936,0.11800337961775428,0.26313767544527167,0.14513429582751738,253683600,259876830,77.88146635632965,64.22229040689516,NaN,NaN,17.06616765327278,6.03674621105487
2012-12-14T09:30:00-05:00,40.55,40.675,40.46001,40.50999,5246262,5771439.25,55.4381689194104,58.120282330196,NaN,NaN,63.878307545916535,114.91610993683881,0.08153912200371588,0.24705819833216225,0.16551907632844637,248437338,258116634.4,71.95658843475579,65.43753245553273,NaN,NaN,16.24157988529618,7.494579593089343
2012-12-17T09:30:00-05:00,40.64,40.84,40.53999,40.83,5549074,5556541.95,60.17180162802911,58.9847175155805,NaN,NaN,87.97115273490029,109.24925931602456,0.07332290102306521,0.25717270260727787,0.18384980158421266,253986412,256418087.2,66.68462519704993,66.53072279471316,NaN,NaN,16.957221086132975,8.846385520667004
2012-12-18T09:30:00-05:00,40.98,41.205,40.745,41.14999,8472469,5608980.25,64.26009846421937,59.819350343116,NaN,NaN,126.8048647869141,104.11436833895695,0.08307431595287373,0.2876926965253048,0.2046183805724311,262458881,255635798.2,64.34632719435845,67.61656011034368,NaN,NaN,18.87357162097135,10.278840677853339
2012-12-19T09:30:00-05:00,41.17,41.17,40.67999,40.71001,6996891,5714040.8,55.78151538730427,59.78473119509327,NaN,NaN,88.12336900315138,92.7382433132605,0.05488745855455707,0.27322770376562744,0.21834024521107037,255461990,254805644.2,61.867134573414845,68.24784363239291,NaN,NaN,17.735955342390273,11.344142772787187
2012-12-20T09:30:00-05:00,40.64,40.78011,40.5555,40.77,4718617,5689689.6,56.6219093715724,59.764066593467035,NaN,NaN,53.854522246034264,84.12644326338332,0.036181046447129134,0.2635665532699818,0.22738550682285266,260180607,256105045.6,64.19269431343582,68.75335906780771,NaN,NaN,17.099915991873598,12.166396089799532
2012-12-21T09:30:00-05:00,40.19,40.37,40.06,40.21001,5572852,5825665.75,47.539171480055664,59.2077391640109,NaN,NaN,-42.412111368634115,62.86835948047319,-0.015250724322371428,0.20832210141988838,0.2235728257422598,254607755,257339129,66.29505645406749,69.27722658777476,NaN,NaN,13.400108862734191,12.342640771647341
2012-12-24T09:30:00-05:00,40.05,40.17999,39.97,40.05,3332679,5757106.35,45.3029721969572,58.403873828271564,NaN,NaN,-76.75130984110628,29.923866965271884,-0.058937428835571765,0.1499010396977951,0.20883846853336688,251275076,256796861.8,64.5029292600477,69.31925737269353,NaN,NaN,9.68994818502538,11.963684687844204
2012-12-26T09:30:00-05:00,40.10001,40.12,39.75999,39.91,4404164,5707484.3,43.380250001308,57.323336639822934,NaN,NaN,-110.56612920733748,-17.550331833578433,-0.09406822485162963,0.09125318746882982,0.18532141232045946,246870912,253679268,55.25489701588548,68.42711767044109,NaN,NaN,6.06922341034143,11.121618791058093
2012-12-27T09:30:00-05:00,39.95,40.05,39.49001,39.85001,5483695,5605112.2,42.54696429458797,56.212990131152864,NaN,NaN,-141.14285500814483,-63.40357663583768,-0.11667427700458916,0.039478566064723,0.15615284306931215,241387217,250864313.4,48.494134791574076,67.01786464271608,NaN,NaN,2.903046599697982,9.94753704943522
2012-12-28T09:30:00-05:00,39.72,39.83549,39.42999,39.46001,5800918,5474991.1,37.5033448157575,54.600419025097935,NaN,NaN,-168.01605800449798,-107.77769268594412,-0.1510395586985719,-0.03264660530390273,0.11839295339466918,235586299,245945451.8,39.41806067744383,64.91667743992959,NaN,NaN,-1.5252549425486228,8.3085667648661
2012-12-31T09:30:00-05:00,39.39,39.95,39.24001,39.88049,11874039,5857242.65,45.06456250831651,53.34940845358641,NaN,NaN,-131.3290764249327,-125.56108569720384,-0.13890662292502692,-0.05524032526161449,0.08366629766341244,247460338,244515968.4,37.236929064187535,62.337125088322644,NaN,NaN,-2.944481568727049,6.7009884314956505
2013-01-02T09:30:00-05:00,40.67999,40.7,40.38,40.66499,9534414,5837115.7,55.80735626673694,52.476273508694824,NaN,NaN,29.106411124141644,-104.38954150415425,-0.07471803153050538,-0.009731241749719288,0.06498678978078609,256994752,245659903.6,40.093641533485645,59.707110164631096,NaN,NaN,-0.3220797132587233,5.697692982245026
2013-01-03T09:30:00-05:00,40.7,40.73,40.50999,40.72,5279563,5897075.95,56.450460835340536,51.75318914116523,NaN,NaN,38.43455405085076,-74.58940485251661,-0.02765088577649255,0.030423182560170403,0.058074068336662954,262274315,248740584.2,47.07944934010199,57.52170958615272,NaN,NaN,1.8896019647912092,5.153679979751623
2013-01-04T09:30:00-05:00,40.85001,40.98,40.8,40.89999,4645816,5814650.15,58.5746315030081,51.74594340518605,NaN,NaN,74.81643209538007,-31.397547431811642,0.01425648557818917,0.07589467530939942,0.06163818973121025,266920131,253847167,56.19765635754411,55.9728660148109,NaN,NaN,4.368497207994164,5.0415110123577005
2013-01-07T09:30:00-05:00,40.82001,41.08,40.78,41.03,4133023,5874109.05,60.08893264826967,52.07814081439028,NaN,NaN,79.80223547075799,18.166111263239547,0.04751085639371866,0.12102676022335856,0.0735159038296399,271053154,260940538,65.17393754049735,55.488390950935305,NaN,NaN,6.847025427336455,5.299441643068951
2013-01-08T09:30:00-05:00,41.02,41.2,41.00999,41.03999,5787234,5932522.3,60.209297833014375,52.080819114746376,NaN,NaN,92.30163214864797,62.89225297795567,0.0658307621758163,0.15580435654941027,0.08997359437359398,276840388,266816548,70.55664660224696,55.76496390844938,NaN,NaN,8.85546785262802,5.807445387291675
2013-01-09T09:30:00-05:00,41.16,41.49001,41.14,41.49001,5665184,5953739.9,65.28785153804844,52.15423004859125,NaN,NaN,125.77321335694158,82.22561342451567,0.10176131985682169,0.2171752441946211,0.1154139243377994,282505572,271918712,74.27468450628623,56.47413228787279,NaN,NaN,12.268365298214905,6.730433945994993
2013-01-10T09:30:00-05:00,41.64999,41.83,41.45,41.78,5518773,6035119.65,68.11220367962692,53.034993498042866,NaN,NaN,159.4110863896012,106.42091989226576,0.1364016783940727,0.28591602233039026,0.14951434393631757,288024345,277068718,77.37969455796846,57.58217228676948,NaN,NaN,16.070404055214055,8.064715390169145
2013-01-11T09:30:00-05:00,41.82001,41.88,41.64999,41.77,3854058,5889944.25,67.90701488020434,53.84107246294515,NaN,NaN,156.81471526953646,122.82057652709705,0.14896191228338013,0.3357167342905427,0.1867548220071626,284170287,280518749.2,79.19162084007233,58.65352418152923,NaN,NaN,19.035122800906404,9.631916448845896
2013-01-14T09:30:00-05:00,41.75,41.88,41.64,41.81,4643578,5825665.15,68.31814939303976,55.325285171015445,NaN,NaN,138.24568261131313,134.50926595520806,0.14987569245207397,0.37409943757225506,0.2242237451201811,288813865,284070891.4,80.88899501193468,59.69594836423402,NaN,NaN,21.57917186205158,11.338667222160993
2013-01-15T09:30:00-05:00,41.64999,41.8,41.62,41.75999,5747512,5850727.65,67.1597339614228,56.88648243990584,NaN,NaN,115.54644027253563,139.1582275799856,0.13735597425152535,0.3959187129345878,0.25856273868306245,283066353,285316084.4,81.4599236981094,60.90716225266699,NaN,NaN,23.385485538375058,13.059641267334431
2013-01-16T09:30:00-05:00,41.72,41.8,41.60899,41.67,3811904,5763869.15,65.0231578018218,58.43240442565683,NaN,NaN,98.6096975566125,133.7255244199198,0.11420821159017452,0.4013230031707806,0.2871147915806061,279254449,284665859.8,80.1140069374901,62.682812961353044,NaN,NaN,24.356354598810547,14.673457457545304
2013-01-17T09:30:00-05:00,41.89999,42.16,41.78999,42.03999,4360840,5558287.7,69.34170636949312,60.34631457386433,NaN,NaN,118.38721040503293,125.52074922300615,0.11470698591548978,0.43049852397496835,0.31579153805947857,283615289,283784048.6,78.22634533804394,64.80654228610089,NaN,NaN,26.48974094551237,16.361497955826312
2013-01-18T09:30:00-05:00,42.06,42.19,41.91,42.17999,6024375,5509661.9,70.81032554615749,62.72538462603576,NaN,NaN,111.94422128617447,116.54665042633374,0.11506194001502201,0.4596189630782561,0.3445570230632341,289639664,284877924,78.89079857255466,67.62602356432309,NaN,NaN,28.722936440963597,18.127417739417353
2013-01-22T09:30:00-05:00,42.11,42.31,41.97,42.3,7608809,5654171.5,72.04647744958532,64.65266426469782,NaN,NaN,106.9851341279759,110.2945407296663,0.11377017856720845,0.4867697462722447,0.37299956770503623,297248473,286564845.6,79.90902826844814,70.67403065034169,NaN,NaN,30.967767262440095,19.96175338556346
2013-01-23T09:30:00-05:00,42.35001,42.42999,42.14,42.25,5544750,5652766.4,70.70303854466604,65.71664157026419,NaN,NaN,102.75554192431075,107.73636106002132,0.1004050577101912,0.4985058898427752,0.398100832132584,291703723,288292319.6,80.92379726004313,73.59047034509581,NaN,NaN,32.484775478698644,21.75075654172563
2013-01-24T09:30:00-05:00,42.44,42.659,42.35001,42.52,8999773,5936121.1,73.56915992754686,66.93940579113607,NaN,NaN,111.58111540504945,110.33064462970871,0.10036601978074527,0.5235583568585156,0.4231923370777703,300703496,292582129,83.1938946405566,76.17007358084257,NaN,NaN,34.663688768828784,23.595461145597508
2013-01-25T09:30:00-05:00,42.56,42.87,42.5125,42.85001,4046115,5918218.65,76.584420994136,68.22581932621664,NaN,NaN,122.12785276808056,111.07877310231825,0.1122825024386046,0.5635454651260261,0.4512629626874215,304749611,296808993.4,85.07815181591339,78.23296611358323,NaN,NaN,37.535568041565114,25.586904987878594
2013-01-28T09:30:00-05:00,42.92,42.96001,42.67999,42.7,5686551,5928361.45,72.53370663955927,69.11473175416589,NaN,NaN,118.14032788737312,112.31799442255797,0.10017812255044989,0.5764856158754839,0.47630749332503397,299063060,298693672.6,85.84045244401594,79.70914574954885,NaN,NaN,38.77007812700721,27.47021543632554
2013-01-29T09:30:00-05:00,42.75,43.23,42.73,43.16,7231172,5999874.15,76.61782561292239,70.28676945273075,NaN,NaN,140.05450559271358,118.93186871550552,0.11235354987534585,0.6167494306692163,0.5043958807938704,306294232,300502824.4,86.55072461828621,80.85157989355164,NaN,NaN,41.20209580911921,29.43191263243892
2013-01-30T09:30:00-05:00,43.2,43.28999,42.98,43.03,5346617,5673503.05,73.30059229683495,70.85910807835836,NaN,NaN,136.71837058737532,125.72443444811843,0.10120033584466481,0.6308963005997015,0.5296959647550367,300947615,302351602.8,87.25433533552034,81.7786978099255,NaN,NaN,42.16653216484168,31.251143994210743
2013-01-31T09:30:00-05:00,42.95,43.06,42.89,42.91,6007227,5497143.7,70.27594013779863,71.01366068251347,NaN,NaN,109.19972790108432,125.2481569473254,0.07641737187455422,0.6252176795982294,0.5488003077236752,294940388,301198981.2,84.29350019534631,82.27254106973821,NaN,NaN,42.048935091847625,32.79368557958744
2013-02-01T09:30:00-05:00,43.09,43.33,42.95,43.25,5623555,5514343.3,73.59990073821123,71.42029538665683,NaN,NaN,121.58110617509901,125.1388076287291,0.07357266332574475,0.6407661368808562,0.5671934735551114,300563943,300361847.6,82.1140967415307,82.48128934841382,NaN,NaN,42.97283696673222,34.247850063465265
2013-02-04T09:30:00-05:00,43.05,43.075,42.74001,42.77,7593371,5661721.05,62.90493365101129,71.03363711936909,NaN,NaN,78.10884576298821,117.13251120385209,0.03212938127074083,0.6073552001435374,0.5752258188727966,292970572,299143350,78.91577634100682,82.34034515763325,NaN,NaN,40.20431498019509,35.098773622998095
2013-02-05T09:30:00-05:00,42.98,43.32001,42.98,43.24001,8056207,5857880.25,67.83385396786025,71.08178854840034,NaN,NaN,103.93832639142141,109.90927536359365,0.029219975892174177,0.6117507887380143,0.5825308128458401,301026779,298089859.4,76.1540053195731,81.9613509877378,NaN,NaN,39.49458212766409,35.72674626652181
2013-02-06T09:30:00-05:00,43.28999,43.32001,43.09599,43.23,3968855,5766961.3,67.62775667412188,71.2678313249932,NaN,NaN,98.14455558729706,102.194512363578,0.019915020505259395,0.6074245884774143,0.5875095679721549,297057924,297311921.2,74.09197926829177,81.53120615422363,NaN,NaN,38.88355197853,36.177718511094405
2013-02-07T09:30:00-05:00,43.27,43.28,42.84,43.07001,6529250,5810164.6,64.26685145682782,70.90534168837425,NaN,NaN,73.06457684385018,94.96748215213117,-0.002527524166901829,0.5843501627635277,0.5868776869304295,290528674,296429578.4,71.71995917645894,81.066464285539,NaN,NaN,37.320683920487454,36.34099928386484
2013-02-08T09:30:00-05:00,43.17999,43.392,43.09,43.39,4192520,5743851.95,67.72199589565588,70.68474671333841,NaN,NaN,93.6816103278615,89.38758298268367,-0.0013910169913524673,0.585138915691239,0.5865299326825915,294721194,295261028.6,68.58818085345504,80.33056301988901,NaN,NaN,37.07126240118267,36.44532258633882
2013-02-11T09:30:00-05:00,43.39,43.39,43.2075,43.3,2447854,5673541.75,65.79500943800542,70.23821328393986,NaN,NaN,88.11226432418232,91.38826669492249,-0.011696628083442073,0.5719091475782889,0.583605775661731,292273340,295121582.2,68.20543128972193,79.49459180712286,NaN,NaN,36.277002043218545,36.4212767944645
2013-02-12T09:30:00-05:00,43.25999,43.38,43.22,43.25,5133590,5698042.35,64.69366578752381,69.80897237271542,NaN,NaN,81.46648459656744,86.8938983359517,-0.026054334538258894,0.5510378574889074,0.5770921920271663,287139750,292344176.4,60.91420293039127,78.06533506929057,NaN,NaN,35.30918003292638,36.26240582853048
2013-02-13T09:30:00-05:00,43.31,43.33,43.0937,43.22,4843270,5652830.25,64.0014276941761,69.12556292747465,NaN,NaN,67.70291054810993,80.80556932811427,-0.04086342479194527,0.5260129110372347,0.56687633582918,282296480,289391887.6,54.27268658838528,75.99953449413547,NaN,NaN,34.321459214587186,35.985127740824296
2013-02-14T09:30:00-05:00,43.17,43.39,43.09,43.308,5172500,5720860.05,65.17845849465624,68.31085132036894,NaN,NaN,72.29754708847548,80.65216337703933,-0.047555496342631676,0.5074319654008903,0.554987461743522,287468980,288779948.8,52.98318878275778,73.70703713462437,NaN,NaN,33.804053086207944,35.67354564730768
2013-02-15T09:30:00-05:00,43.33,43.45,43.24001,43.41,8229914,5914313.75,66.54392098559953,67.88300948794326,NaN,NaN,88.94865105614319,79.70557152269566,-0.047807332485154896,0.4952282961370784,0.5430356286222333,295698894,288975488.8,53.36449011280253,71.38732553953768,NaN,NaN,33.727536972052555,35.39554440798552
2013-02-19T09:30:00-05:00,43.3,43.69,43.3,43.67999,7245102,5975350.1,69.90764355831452,67.40371076975698,NaN,NaN,127.64719969487618,87.61255859683443,-0.03317966024931018,0.5015610533105956,0.5347407135599058,302943996,291109620,57.422946983392606,69.30676999418814,NaN,NaN,34.60765521496248,35.282988808982225
2013-02-20T09:30:00-05:00,43.64999,43.74001,43.38499,43.395,6739598,5931889.55,62.73733535851941,66.64919241702016,NaN,NaN,115.24409408467409,94.36808049445577,-0.0453345110838429,0.4780725747051022,0.5234070857889451,296204398,292922549.6,60.562702688773726,67.40022480513483,NaN,NaN,33.282450366324234,34.99719760288823
2013-02-21T09:30:00-05:00,43.32001,43.332,43.045,43.2,7447117,6027007.9,58.328879778037425,65.7958309627515,NaN,NaN,20.969768967604384,85.02145217835466,-0.06779267306155723,0.43866624446199864,0.5064589175235559,288757281,294214709.8,62.675391925599655,65.85607421443864,NaN,NaN,30.82847559175454,34.40166588701199
2013-02-22T09:30:00-05:00,43.34,43.42999,43.1701,43.39,6168074,5885422.95,61.1904393989567,64.90944086709045,NaN,NaN,64.17187796030655,83.39631835272087,-0.07080714310953606,0.4179499886366358,0.48875713174617186,294925355,295705984.8,65.00539066173494,64.6340237801675,NaN,NaN,29.568422547653856,33.711202552817966
2013-02-25T09:30:00-05:00,43.61,43.73,42.88,42.91,6078648,5987049.6,51.55800523316355,64.09894598010133,NaN,NaN,-9.025752373115534,63.80143766686913,-0.10407311119764912,0.35866574274911045,0.46273885394675957,288846707,294335547.4,61.22304263888532,63.37025708715881,NaN,NaN,25.260471101364267,32.50395520261029
2013-02-26T09:30:00-05:00,43.09,43.13,42.71001,43.02,6549051,6030174.6,53.3695867181414,63.06578403369284,NaN,NaN,-125.46894229650897,13.178209268592104,-0.1166666498471608,0.3169055416378086,0.4335721914849694,295395758,292825899.8,57.26992455628227,62.02139417549518,NaN,NaN,22.330906023568627,31.050662462747198
2013-02-27T09:30:00-05:00,43.07001,43.63,42.88,43.49001,6849828,6011107.4,60.21573485210371,62.53635390354868,NaN,NaN,60.8973537975495,2.3088612111671862,-0.09240203206498404,0.31806965140373933,0.41047168346872337,302245586,294034137.4,59.52260152760121,60.98072433687444,NaN,NaN,21.96531300350564,29.75275539714126
2013-02-28T09:30:00-05:00,43.5,43.785,43.42999,43.45,4358703,5961711.7,59.416035336078586,62.18986703778088,NaN,NaN,150.74254479315482,28.263416376277274,-0.07864510923029877,0.31216529693084993,0.3908104061611487,297886883,295860057.8,62.72107543642987,60.337946926872355,NaN,NaN,21.427249998364722,28.563397483030325
2013-03-01T09:30:00-05:00,43.36,43.78999,43.22501,43.78,7491484,6035924.55,63.69830328593475,61.9024604228008,NaN,NaN,154.56785348153213,46.34261148052239,-0.04840294474667345,0.3303067252278069,0.37870966997448036,305378367,297950660.2,66.03078592621168,60.155275860640685,NaN,NaN,22.346418350130783,27.67525760690182
2013-03-04T09:30:00-05:00,43.7,44.03,43.61,44.02,4903477,5999920.65,66.46934692221487,61.95062738595861,NaN,NaN,229.79822870687653,94.1074076965208,-0.015046764046334926,0.3599012149165617,0.3749479789628966,310281844,302237687.6,71.59914833341392,60.397684220904395,NaN,NaN,24.015793117133455,27.152476965506338
2013-03-05T09:30:00-05:00,44.17999,44.48,44.14,44.39999,6582695,5949386.85,70.33093472506488,62.35328945292583,NaN,NaN,295.87699017295415,178.3765941904134,0.027480764956076043,0.40929893515799165,0.3818181702019156,316864539,306531443.8,75.86624681671184,61.46568735564158,NaN,NaN,26.762968295579963,27.09683286980257
2013-03-06T09:30:00-05:00,44.53,44.60001,44.395,44.49001,5068391,5799996.05,71.17777770079145,62.86588588196978,NaN,NaN,248.2475874455555,215.84664092001464,0.054959511852634146,0.45051756001770826,0.3955580481650741,321932930,310468912.6,78.98446300492586,63.23081424253733,NaN,NaN,29.223630978350347,27.40066117102368
2013-03-07T09:30:00-05:00,44.59,44.66,44.41,44.46001,4437563,5823431.45,70.45603211522909,63.24285542629641,NaN,NaN,197.84514376583243,225.26716071455016,0.06378083249373168,0.4752840887822387,0.41150325628850704,317495367,314390609.4,81.54244300621099,65.27076097278398,NaN,NaN,30.974785008276108,27.91125029063117
2013-03-08T09:30:00-05:00,44.61,44.67,44.34,44.53999,4029272,5698432.55,71.2918090218496,63.58199028602856,NaN,NaN,161.74668604284085,226.70292722681188,0.06731890885565511,0.49565189235807594,0.4283329835024208,321524639,317619863.8,83.34060497791455,67.4119120345777,NaN,NaN,32.66504921921441,28.59036442328592
2013-03-11T09:30:00-04:00,44.57001,44.77,44.42999,44.77,6748676,5826240.35,73.60442084398474,63.84604580643357,NaN,NaN,149.04666826320283,210.55261513807713,0.07678120893961676,0.5243094946769418,0.447528285737325,328273315,321218158,85.08432442623356,69.38772470906633,NaN,NaN,34.82542135699763,29.481086842387594
2013-03-12T09:30:00-04:00,44.83,45,44.82001,44.97,4612305,5934462.9,75.45587288708072,64.75451277275938,NaN,NaN,153.34887419304036,182.0469919420944,0.0873705002775712,0.556741411084289,0.4693709108067178,332885620,324422374.2,86.44492069158761,71.23645456641019,NaN,NaN,37.236821352801805,30.58904891530391
2013-03-13T09:30:00-04:00,44.96001,45.017,44.77499,44.98,4098227,5882694.75,75.54822489710362,65.98446599554983,NaN,NaN,128.83190393315908,158.16385523961512,0.08578656858145373,0.5766041215335349,0.4908175529520812,336983847,327432557.6,87.59018923677267,73.01608294577969,NaN,NaN,39.22335316651074,31.8225209511906
2013-03-14T09:30:00-04:00,45.06,45.10001,44.8839,45.02,3777683,5829415.4,75.93823063375916,67.03787965517857,NaN,NaN,119.13106258005226,142.42103900245908,0.0783747338108236,0.5887859702156106,0.510411236404787,340761530,332085790.2,89.12044150093459,74.73858657715108,NaN,NaN,40.98777791666051,33.13184337482916
2013-03-15T09:30:00-04:00,44.71001,44.84,44.56,44.73,5778848,5859732.8,67.52870129703604,68.17864365974089,NaN,NaN,77.68056021908082,125.60781383770707,0.04646016199272207,0.5684864388956896,0.5220262769029675,334982682,334777398.8,89.89652835532881,76.7866926997542,NaN,NaN,40.20277084380899,34.14197587039771
2013-03-18T09:30:00-04:00,44.41,44.67999,44.26199,44.44,4042019,5650338.05,60.33333020363952,68.67605390870503,NaN,NaN,45.92921979819703,104.98432414470592,0.0007548717740938349,0.5229698666205849,0.522214994846491,330940663,335310868.4,90.04805516095678,79.12798774294524,NaN,NaN,37.338302739056836,34.59859399449187
2013-03-19T09:30:00-04:00,44.50999,44.61,44.22,44.47,7023219,5639243.9,60.79867354325486,68.7176923866444,NaN,NaN,38.81413722614769,82.07737675132739,-0.03077829481351102,0.48374212632960223,0.5145204211431132,337963882,336326520.8,90.34494391576197,81.32958362781385,NaN,NaN,35.13158051226321,34.67473492560206
2013-03-20T09:30:00-04:00,44.63,44.94,44.63,44.84,4386910,5521609.5,66.08342854117691,69.19393475843715,NaN,NaN,72.48954503904505,70.80890497250459,-0.03000747251254754,0.4770110805024288,0.5070185530149763,342350792,337399909.8,90.6620002052254,83.32536396844209,NaN,NaN,34.696212209425134,34.67780310900535
2013-03-21T09:30:00-04:00,44.75999,44.83501,44.5,44.59,4419926,5370249.95,60.18006268128371,68.94263185810492,NaN,NaN,50.54864351132109,57.09242115875834,-0.048528102054447575,0.44635842544691684,0.4948865275013644,337930866,336833777,89.00192849292937,84.9661598660648,NaN,NaN,32.47811718463814,34.36356226266718
2013-03-22T09:30:00-04:00,44.74001,44.92999,44.69,44.92999,6881355,5405914,64.78708136747508,68.82247003276636,NaN,NaN,71.53221597104874,55.862752309151915,-0.04040696903285257,0.4443778162102987,0.4847847852431513,344812221,338799684.8,89.70675674086726,86.25956046659716,NaN,NaN,32.007948437325666,34.027046001904104
2013-03-25T09:30:00-04:00,45.03999,45.10001,44.60001,44.8,6813367,5442649.95,61.84113175528562,68.21605553492499,NaN,NaN,67.45497645022722,60.16790363955796,-0.04591394857080894,0.4273923495296401,0.47330629810044905,337998854,340211323,90.19278060388777,87.28288430853831,NaN,NaN,30.697926096067334,33.551457443927426
2013-03-26T09:30:00-04:00,44.88,45.35001,44.88,45.32001,4855715,5357983.15,68.09179025195232,67.99562786000791,NaN,NaN,123.67012422153046,77.13910103863451,-0.01808795141573316,0.45069635883078263,0.4687843102465158,342854569,341189460.4,90.52657090361811,88.10732058701633,NaN,NaN,31.626014170523998,33.276394119155505
2013-03-27T09:30:00-04:00,45.21001,45.58,45.07001,45.55,5264633,5278723.4,70.40112767356136,67.9917061141745,NaN,NaN,155.7370584433754,93.78860371950057,0.010704652252010838,0.48216512556152935,0.4714604733095185,348119202,342343142.4,90.91914834211754,88.77708525386679,NaN,NaN,33.166010548349924,33.26062503761185
2013-03-28T09:30:00-04:00,45.67999,46.03999,45.56,46.009,7415613,5431568.9,74.38549474680728,68.21268366595719,NaN,NaN,223.46023898369052,128.37092281397446,0.05318423541689987,0.5379407675806434,0.4847565321637435,355534815,345863932.2,92.00765483403008,89.39616024358934,NaN,NaN,35.91459519001195,33.63976363081186
2013-04-01T09:30:00-04:00,45.98,46.11,45.82491,46.07001,6364648,5375227.1,74.86972775844824,68.30306273127601,NaN,NaN,218.87037721341915,157.83855506244853,0.0764956925726834,0.5803761478795977,0.5038804553069143,361899463,349281380.6,92.89758702271473,89.95425042905228,NaN,NaN,38.205367281886645,34.291992723822545
2013-04-02T09:30:00-04:00,46.39999,46.78999,46.39,46.74001,8852219,5572664.2,79.46163192095435,68.5891883765527,NaN,NaN,258.3118082377156,196.0099214199462,0.12526088452126927,0.6604565609585009,0.5351956764372316,370751682,355831946.2,94.22497547331047,90.50996862774677,NaN,NaN,41.978490665720244,35.39006385837936
2013-04-03T09:30:00-04:00,46.82001,46.87,46.37,46.46001,8472813,5667170.1,73.42355113555944,68.43742596501383,NaN,NaN,190.4921753233163,209.37433164030335,0.1265113568543098,0.6933348725051189,0.5668235156508091,362278869,359716806.2,94.84079841824514,91.02786928356623,NaN,NaN,42.883513732669776,36.4605566975637
2013-04-04T09:30:00-04:00,46.53,46.92999,46.48,46.67,9794535,5903477.3,74.96027641385913,68.36757209216383,NaN,NaN,165.64007234576047,211.3549344207804,0.12889664374054166,0.7279443203264861,0.5990476765859445,372073404,364507646.6,95.48080459746296,91.48218093331828,NaN,NaN,44.129163406169845,37.556071941650295
2013-04-05T09:30:00-04:00,46.27,46.42,46.14,46.41,9969227,6180060.5,69.59448795915159,68.51512828231493,NaN,NaN,106.34547905052048,187.9319824341464,0.10158072438176957,0.7260235820631564,0.6244428576813869,362104177,365821519,95.64052558015493,91.89246644937727,NaN,NaN,43.34822937619034,38.38352300372745
2013-04-08T09:30:00-04:00,46.42,46.45,46.02,46.45,7700539,6363623.85,69.95086171683549,69.20209481897179,NaN,NaN,91.19696343147176,162.3972996777569,0.07599438611357567,0.7194358403233565,0.6434414542097808,369804716,367402569.6,95.83145069449012,92.30556613034393,NaN,NaN,42.84761683437611,39.021250693820114
2013-04-09T09:30:00-04:00,46.59,46.82001,46.48331,46.60001,5937566,6323068.35,71.30899997662499,69.95283242135537,NaN,NaN,106.45070147390022,132.02507832499384,0.05968076851538995,0.7180424148540183,0.6583616463386284,375742282,368400689.6,95.95198015982008,92.70606871920522,NaN,NaN,42.84735040711185,39.56783636714751
2013-04-10T09:30:00-04:00,46.82001,47.425,46.78,47.38499,9062039,6545555.05,77.1332442196021,70.7421049698143,NaN,NaN,134.08652281367534,120.74394782306565,0.09042057683285931,0.7713873673797025,0.6809667905468432,384804321,372905780,96.45080048014684,93.11955445312819,NaN,NaN,44.861541837534766,40.324080005774256
2013-04-11T09:30:00-04:00,47.50999,48.0094,47.5,47.84,7660438,6723665.6,79.70500135247372,72.13674344632788,NaN,NaN,155.6817093160735,118.75227521712824,0.12777712807607933,0.8406882006419423,0.712911072565863,392464759,376984051,96.83144533443702,93.67880565609302,NaN,NaN,47.46937829954722,41.34483690488468
2013-04-12T09:30:00-04:00,47.72,47.99001,47.66,47.92999,5624164,6815989.65,80.17978073139254,73.23622197232199,NaN,NaN,141.56827398958984,125.79683420494212,0.1437366798843327,0.8925819224212788,0.7488452425369461,398088923,384181000.2,97.36791636342416,94.22603134341851,NaN,NaN,49.64984749832937,42.53126698966249
2013-04-15T09:30:00-04:00,47.91,47.99989,47.02,47.06,10745250,7064309.75,64.47595994667999,73.42442398599302,NaN,NaN,96.4685787751787,126.85115727368353,0.08385709501773575,0.8536666113091158,0.7698095162913801,387343673,387688791.6,97.58273835376502,94.75388546840975,NaN,NaN,45.89125909078137,43.011265861250905
2013-04-16T09:30:00-04:00,47.42999,47.75,47.22,47.74001,8771789,7300798.25,69.50370520657421,73.52527505418028,NaN,NaN,101.8446413038918,125.92994523968181,0.07830824695190142,0.8676948249812568,0.7893865780293554,396115462,391763427.6,97.806673414969,95.27389279064911,NaN,NaN,44.610445915597744,43.23972015472903
2013-04-17T09:30:00-04:00,47.45,47.66,47.14011,47.52,16487660,7774020.3,66.23733382240039,73.22786120766878,NaN,NaN,86.52934552366531,116.41850978167982,0.049488077812034015,0.8512466752943979,0.8017585974823639,379627802,390728123.8,95.38865918567443,95.59314356518887,NaN,NaN,42.45162698039307,43.12713541553818
2013-04-18T09:30:00-04:00,47.47,47.50999,46.765,46.94,10353594,8072354.5,58.44012766828227,72.08890641634558,NaN,NaN,53.09514444333316,95.90119680713175,-0.015493817784706043,0.7823913252514814,0.7978851430361874,369274208,386090013.6,85.223636247072,95.10857080897759,NaN,NaN,37.79623108596825,42.36557765417105
2013-04-19T09:30:00-04:00,47,47.64,47,47.60001,12796637,8491190.05,63.67966801522628,71.28961643468686,NaN,NaN,75.43666268170581,82.67487454555496,-0.020564869755529847,0.7721790558417752,0.792743925597305,382070845,382886398,78.96432475247448,94.11333778967473,NaN,NaN,35.842243241889555,41.43367273813084
2013-04-22T09:30:00-04:00,47.8,47.96001,47.545,47.89,4716652,8382954.9,65.72433268457927,70.30838077494579,NaN,NaN,101.70079643700085,83.72131807791938,-0.01138607315152007,0.7785113341579049,0.7898974073094249,386787497,382775162.8,78.74805644974366,93.00784357370569,NaN,NaN,35.04340862742244,40.5207778651725
2013-04-23T09:30:00-04:00,48.045,48.38,47.67999,48.19,10824797,8583526.4,67.74717907377601,69.90292562767554,NaN,NaN,116.88463583454694,86.7293169840504,0.006907850767231771,0.7985322207684646,0.7916243700012329,397612294,383074529.2,78.9154244040272,91.87031685840441,NaN,NaN,35.10125214637817,39.74655990534474
2013-04-24T09:30:00-04:00,48.12,48.13,47.32001,47.36,12635824,8972531.85,57.61596788020125,68.66404644669998,NaN,NaN,64.93868934434596,82.41118574818654,-0.04217374232677218,0.7389071920927677,0.7810809344195399,384976470,384144262.8,79.53562115512523,90.73137518395171,NaN,NaN,31.488244503479535,38.56680056222114
2013-04-25T09:30:00-04:00,47.62,47.67999,47.3,47.55,10833973,9250998.85,59.12295599398133,67.91607987775924,NaN,NaN,49.828059682915544,81.75776879610302,-0.06572192640657426,0.6989285264113221,0.7646504528178963,395810443,389451509.8,82.31500158325011,89.77955204131567,NaN,NaN,29.19959866105668,37.22862886205479
2013-04-26T09:30:00-04:00,47.39,47.64999,47.27,47.535,6174844,9188960.4,58.94476934073866,67.12993042232377,NaN,NaN,41.57380902943759,74.98519806564937,-0.08496465717777801,0.6584446313456738,0.7434092885234518,389635599,390964460.6,83.02287212007533,88.86465357171461,NaN,NaN,27.3769771588465,35.82125004731075
2013-04-29T09:30:00-04:00,47.58,47.86,47.5799,47.69,3949921,9068224.05,60.277020093840946,66.34193185926776,NaN,NaN,66.49444722127106,67.9439282225034,-0.08945742299222259,0.6315875097831736,0.7210449327753962,393585520,392324065.2,83.6559834812457,87.9863680946736,NaN,NaN,26.29973337375086,34.461033379659334
2013-04-30T09:30:00-04:00,47.56,47.56,47.09,47.33,8217852,9036505.7,55.7518756478713,64.81469124700128,NaN,NaN,6.306845021862106,45.828370059966446,-0.11713188362186078,0.5746300782480702,0.691761961869931,385367668,389875140,78.01273747443481,86.66936359426559,NaN,NaN,24.001965777576608,32.966880865076085
2013-05-01T09:30:00-04:00,46.92999,47.28,46.8,46.83,9250641,9075397.1,50.123602841407724,62.70173421049657,NaN,NaN,-56.833200460878764,21.473992098921507,-0.1665529461798727,0.48357077914509006,0.6501237253249628,376117027,388103251.4,74.11695142189285,85.04689974336956,NaN,NaN,20.231059395784268,31.147477798034398
2013-05-02T09:30:00-04:00,47.19,47.45,47.08,47.35001,9803266,9075833.65,55.19018597314236,60.91676315633583,NaN,NaN,-8.139737672943317,9.88043262774973,-0.1615393606359783,0.4481995245299899,0.6097388851659682,385920293,386125221.4,69.91928701053844,83.0862833610206,NaN,NaN,18.587355137472926,29.35317456081133
2013-05-03T09:30:00-04:00,47.78,47.91,47.58501,47.67,6232754,8889010,58.01642512580994,60.455367811987976,NaN,NaN,67.79323500501505,15.124317822865226,-0.1350666409128174,0.4409055840249465,0.5759722249377639,392153047,386628711,70.3791516056165,81.14317002186714,NaN,NaN,18.117664858968872,27.748101746262407
2013-05-06T09:30:00-04:00,47.67999,47.71001,47.35001,47.36,10918926,9049929.35,54.434473127666514,59.378994092066,NaN,NaN,2.1845200592873835,2.262332390468496,-0.1364281411632755,0.40543704848366957,0.5418651896469451,381234121,384158431.2,65.11909373033461,78.80834290153611,NaN,NaN,16.613151977217314,26.157394636398823
2013-05-07T09:30:00-04:00,47.38,47.55499,47.32001,47.50999,9847371,9245419.6,55.854639291582316,58.637373054150416,NaN,NaN,-14.389477351559938,-1.8769320842159174,-0.12549778465206907,0.3849929588318588,0.5104907434839279,391081492,385301196,66.3712335400194,76.73566964113219,NaN,NaN,15.812192697292065,24.679508645097858
2013-05-08T09:30:00-04:00,47.47,47.78999,47.47,47.64999,20766144,9830624.85,57.19567646534438,58.54848368251199,NaN,NaN,35.862803179570854,16.662268643874008,-0.1077876214300888,0.37575621669631687,0.48354383812640567,411847636,392447317.8,72.91820870013926,75.85671053063699,NaN,NaN,15.540727728652056,23.37396851417703
2013-05-09T09:30:00-04:00,47.59,47.91,47.55,47.71001,7140270,9804616.45,57.78771133308361,58.12762963378752,NaN,NaN,66.70527779493862,31.63127173745039,-0.0916148696889344,0.36902525101523764,0.46064012070417204,418987906,399060840.4,77.3190703742437,75.73919236076337,NaN,NaN,15.482320316750888,22.24659020025901
2013-05-10T09:30:00-04:00,47.77,48.23,47.71001,48.17999,6045051,9825660.8,62.19686771423807,57.875667850191725,NaN,NaN,162.35183994877514,50.542992726202414,-0.0508820417713326,0.39703756849000627,0.44791961026133886,425032957,405636822.4,80.68079436581456,75.87724506905415,NaN,NaN,16.717168313271948,21.456672787832286
2013-05-13T09:30:00-04:00,48.13,48.59,48.07001,48.58,9156363,9746216.45,65.49990203464074,57.71514806168206,NaN,NaN,225.27103337919613,95.16029539018416,-0.0012400675330765942,0.4463695258449931,0.4476095933780697,434189320,416227862.2,84.63164965364997,76.28554687259863,NaN,NaN,18.790411459925718,21.07577831241706
2013-05-14T09:30:00-04:00,48.60001,49.11,48.60001,49.07001,6580730,9636663.5,69.06560899502408,58.53297956988369,NaN,NaN,266.9182428222626,151.42183942494867,0.0571300888094175,0.5190222043898416,0.4618921155804241,440770050,426165573.8,87.2636167152919,76.83754655546768,NaN,NaN,21.73031250241771,21.169283196702867
2013-05-15T09:30:00-04:00,49.05,49.605,49.02,49.33,11797391,9402150.05,70.7905906468024,59.366382045085196,NaN,NaN,256.0496309581177,195.45920498065803,0.10310149049430634,0.590768978698307,0.4876674882040007,452567441,434309534.8,88.93587799219533,77.31046629896376,NaN,NaN,24.72199050529095,21.676812812215452
2013-05-16T09:30:00-04:00,49.23,49.31,48.78,48.82001,7954012,9282170.95,63.330478157362165,59.67964696055831,NaN,NaN,160.1313904616899,214.1444275140083,0.08951838218470354,0.5995654659348801,0.5100470837501766,444613429,439434639.4,89.8399549077674,77.7974007837989,NaN,NaN,25.024687414284806,22.155080612511075
2013-05-17T09:30:00-04:00,48.8801,49.14,48.7,49.10001,9246613,9104669.75,65.48130413851516,60.051381535177896,NaN,NaN,133.65770766432115,208.40560105711748,0.08953099549435428,0.6219608281181195,0.5324298326237652,453860042,445200056.4,90.75512561881963,78.3044823650542,NaN,NaN,25.94221107135995,22.696099249489485
2013-05-20T09:30:00-04:00,49.13,49.17,48.715,48.75999,8967777,9317226,60.8163089460042,60.413126770758815,NaN,NaN,104.01526579967245,184.15444754121276,0.05829219534231023,0.605295076801653,0.5470028814593427,444892265,447340645.4,91.07651264287576,79.23760916279996,NaN,NaN,25.282423063460385,23.065574080056756
2013-05-21T09:30:00-04:00,48.89,49.36,48.785,49.28999,8319063,9191939.3,65.00170755755366,61.47584853619781,NaN,NaN,115.49355990480977,153.86951095772218,0.06449298836675377,0.6276191169177849,0.5631261285510312,453211328,449828901,91.44865420522397,80.4755879330379,NaN,NaN,26.03578467102402,23.489889878766366
2013-05-22T09:30:00-04:00,49.56,50.39999,49.06,49.28999,20132448,9566770.5,65.00170755755366,62.1766715065129,NaN,NaN,134.88712292085683,129.63700935027003,0.05986478286267416,0.6379571071293739,0.5780923242666998,453211328,449957678.4,91.46848449652622,82.01481632489417,NaN,NaN,26.631119410549463,23.93863695473538
2013-05-23T09:30:00-04:00,48.88,49.42999,48.73,49.27,6668422,9358492.95,64.69940760582402,62.65402739794248,NaN,NaN,83.27910104027866,114.26655146598777,0.04727963000448676,0.6371918617723082,0.5899122317678215,446542906,450343573.8,91.5318565042707,83.52572381765518,NaN,NaN,27.028964590767107,24.38011233131134
2013-05-24T09:30:00-04:00,49.08,49.2,48.74001,49.12,5906746,9345088.05,62.355964252263234,63.219848192556526,NaN,NaN,65.05480817306233,100.54597156773602,0.021962256891832066,0.6173650528826116,0.5954027959907795,440636160,447698797.4,86.77448185474378,85.07253725511298,NaN,NaN,26.718477521006772,24.71416450126783
2013-05-28T09:30:00-04:00,49.52,50.06,49.41499,49.62,9923719,9643777.95,66.68734914596334,63.993613182155194,NaN,NaN,111.70209422288443,102.0833372523784,0.03142317837683173,0.6346817689618192,0.6032585905849874,450559879,448832320.2,87.08432240897758,86.5520436028957,NaN,NaN,27.69961721068058,25.140657745469653
2013-05-29T09:30:00-04:00,49.35001,49.35001,48.58,48.84,15882063,10026988.5,55.884647160314614,63.89996823179593,NaN,NaN,40.84335085499661,87.15329544241577,-0.019571725455951094,0.5787939337650485,0.5983656592209996,434677816,445125617.8,80.4472167562349,87.08982989261683,NaN,NaN,25.15063975669733,25.142083747073606
2013-05-30T09:30:00-04:00,48.89999,49.36,48.845,49.19,9719566,10050434.75,59.087268148932594,63.99279371864229,NaN,NaN,54.403343382470105,71.05653953473842,-0.033627364214718236,0.5563314539526019,0.5899588181673201,444397382,443362828.6,77.42505556099054,87.09740026309875,NaN,NaN,24.03312963345172,24.98366173084191
2013-05-31T09:30:00-04:00,48.97,49.2,48.10001,48.11,13329914,10226767.15,47.603273073935405,62.950394101477805,NaN,NaN,-17.751241946351588,50.85047093741237,-0.11497598314210955,0.4462388392396832,0.5612148223817928,431067468,440267741,72.29003392563547,86.49806023165739,NaN,NaN,18.871752317172916,24.110531814603483
2013-06-03T09:30:00-04:00,48.38,48.44,47.94,48.37,12698195,10550039.2,50.11682273373056,61.85160272284137,NaN,NaN,-47.0069006915789,28.43812916448413,-0.14846038629262936,0.37563933951600603,0.5240997258086354,443765663,440893641.6,72.68456926614782,85.6446973468358,NaN,NaN,15.654123427762054,22.902473473626138
2013-06-04T09:30:00-04:00,48.37,48.5825,47.8,48.07001,13141367,10661161.25,47.29753175242337,60.2967400626556,NaN,NaN,-66.96561864989808,-7.295413410072362,-0.18558800084510052,0.29211472475225975,0.47770272559736027,430624296,436906525,66.21677503676946,84.14135151265563,NaN,NaN,12.118104772019976,21.361849373396687
2013-06-05T09:30:00-04:00,48,48.31,47.28,47.37,12852070,10811396.2,41.439484556472664,58.20023248477491,NaN,NaN,-132.37394805018766,-41.93887319110922,-0.24815816810409463,0.16750501546724195,0.4156631835713366,417772226,433525407,61.24013544082368,82.16308418755766,NaN,NaN,7.034881475942174,19.315139673760328
2013-06-06T09:30:00-04:00,47.36,48.06,47.16,48.06,16861952,10616186.6,48.24410273326558,57.12263424019658,NaN,NaN,-121.39892219533452,-77.09932630667015,-0.23412240938982648,0.1230101718340535,0.35713258122388,434634178,431572766.2,58.505426984215944,79.92490362158969,NaN,NaN,5.101899138125745,17.284676740098245
2013-06-07T09:30:00-04:00,48.3,48.7551,48.28999,48.5,7663410,10642343.6,52.06886831400552,56.16460310987446,NaN,NaN,-32.886256515992294,-80.1263292205983,-0.18822812166903896,0.12184742913758129,0.31007555080662025,442297588,433818790.2,60.680432390792475,77.77671124815917,NaN,NaN,4.854080391896549,15.508877261783717
2013-06-10T09:30:00-04:00,48.72,48.77,48.41,48.57001,5663613,10623271.7,52.66823113520748,55.58259755196042,NaN,NaN,-29.09912492776937,-76.54477406783637,-0.1479542670402545,0.12513271700630213,0.2730869840465566,447961201,434657897.8,61.49251853615268,75.66356881196468,NaN,NaN,4.855078444136947,13.986906002119893
2013-06-11T09:30:00-04:00,48.19,48.67,47.99001,48.37,9941617,10662534.4,50.71702911024913,54.562263377152945,NaN,NaN,-64.23039859058873,-75.99773005597451,-0.13020924087808172,0.11032543294895447,0.2405346738270362,438019584,436136955.4,62.94526296817948,73.62761229503293,NaN,NaN,4.255416136805372,12.596693164217818
2013-06-12T09:30:00-04:00,48.59,48.81,47.88,47.88,8583250,10762660.4,46.201215953787184,53.21937111974106,NaN,NaN,-77.3160118648925,-64.98614281891548,-0.14572478266842454,0.05837869549150554,0.20410347815993007,429436334,438469777,65.17675078137061,71.74963131537895,NaN,NaN,2.3274355991169404,11.129656369203406
2013-06-13T09:30:00-04:00,47.75999,48.67751,47.52,48.62,6904891,10518035.4,53.00641810459201,52.384157583938766,NaN,NaN,-58.963003794978974,-52.49895913884437,-0.10244619099574437,0.07604573941524961,0.17849193041099398,436341225,438811186.4,65.50416390961588,69.89051041576076,NaN,NaN,2.8618057364088267,9.948534850232752
2013-06-14T09:30:00-04:00,48.49001,48.84,48.44,48.53999,7313969,10486033.25,52.237032070747404,51.6613767138305,NaN,NaN,-8.615065489163245,-47.64472093347856,-0.0766829377051538,0.08263825827955174,0.15932119598470554,429027256,436157120,60.72435329237963,68.02978694702047,NaN,NaN,3.0471447177004367,8.962621974156708
2013-06-17T09:30:00-04:00,48.75,49.02499,48.4101,48.64999,8437355,10445570.35,53.24189277088762,50.700986972753654,NaN,NaN,6.7505248343903075,-40.474790981046624,-0.05094774126482904,0.09563651940366924,0.14658426066849828,437464611,434057802,57.170766509927724,65.89310438280262,NaN,NaN,3.495866311054589,8.181656879427834
2013-06-18T09:30:00-04:00,48.63,49.0997,48.63,49.06,7399676,10367165.3,56.883124242236654,50.77230676431952,NaN,NaN,42.00590128161616,-19.227531006605652,-0.0073171543075553624,0.13743781778405406,0.14475497209160942,444864287,435426742.6,58.86138177400181,64.35125902692883,NaN,NaN,4.97816065752107,7.724014562012582
2013-06-19T09:30:00-04:00,49.06,49.1333,48.265,48.28,22305664,11066495.35,49.0565267636875,50.055825236802015,NaN,NaN,-10.409546074650747,-5.846237848557299,-0.03068425157488669,0.10639965762300108,0.13708390919788777,422558623,434051200.4,56.45012537802789,62.853049728145784,NaN,NaN,3.840279028360405,7.169195200062271
2013-06-20T09:30:00-04:00,48.00999,48.00999,46.89999,47.03999,28952064,11507476.15,39.70382347637077,49.49157883697597,NaN,NaN,-190.0156632971103,-32.05676974898356,-0.12410608541895596,-0.018048697575807182,0.10605738784314878,393606559,425504267.2,44.3053346566592,60.85414263750463,NaN,NaN,-0.5503729724189937,6.066399746850662
2013-06-21T09:30:00-04:00,47.24001,47.59,46.89,47.285,15980563,11973083.2,42.054554674030605,48.915702546997395,NaN,NaN,-169.9810166465716,-64.32995998046523,-0.16148617406591742,-0.09580032973924801,0.06568584432666941,409587122,421616240.4,40.08092097688411,58.52531061684293,NaN,NaN,-3.2000689172533017,4.742618509121524
2013-06-24T09:30:00-04:00,46.88,47.28841,46.45,46.89,19003312,12627911.5,39.38843355136742,48.35076696120769,NaN,NaN,-188.90705777783705,-103.4614765029107,-0.20225673988177006,-0.18713508052554317,0.01512165935622689,390583810,412240080.2,32.12582885897419,56.090243032714696,NaN,NaN,-6.242180969358346,3.173361440767257
2013-06-25T09:30:00-04:00,47.28999,47.32001,46.81,47.13,5688250,12416138.05,41.80261088533136,48.376704556126164,NaN,NaN,-141.31697401016663,-140.12605156126727,-0.20202993012565695,-0.2374157533008443,-0.03538582317518735,396272060,402521634.8,26.299318983268307,53.5944704286036,NaN,NaN,-7.929540745911007,1.5872325569560763
2013-06-26T09:30:00-04:00,47.44,47.99001,47.39999,47.81,7599910,12002030.4,48.10909439577998,48.36706110344863,NaN,NaN,-49.90287568216026,-148.02471748276918,-0.14757841019739643,-0.2198588359219329,-0.07228042572453647,403871970,398784304.2,24.461956926221745,51.16279399588973,NaN,NaN,-7.3317656476129285,0.31308995630336134
2013-06-27T09:30:00-04:00,48.12,48.25999,47.91,47.98,5338160,11782960.1,49.580087190230586,48.18929102317899,NaN,NaN,-2.069609657672945,-110.43550675488169,-0.09420497859008434,-0.1900366489621419,-0.09583167037205756,409210130,401905018.4,28.927061903677355,48.89469610395293,NaN,NaN,-6.392417728339753,-0.6448397129313692
2013-06-28T09:30:00-04:00,47.94,48.16,47.56,47.61,8770652,11554997,46.49102999660305,47.74806237042152,NaN,NaN,-35.33162263353615,-83.50562795227461,-0.07855202159618624,-0.19402169736729036,-0.11546967577110412,400439478,400075489.6,27.886356854516066,46.49425598383603,NaN,NaN,-6.549404076837573,-1.4883489077751126
2013-07-01T09:30:00-04:00,47.75,48.25999,47.17999,47.74001,25891984,12214686.45,47.72352363830402,47.53424055099687,NaN,NaN,-38.1115234114853,-53.34652107900426,-0.055273575161730454,-0.1845616447232672,-0.12928806956153674,426331462,407225020,37.36911805404043,44.66738848996896,NaN,NaN,-6.312861670980115,-2.1775650168043987
2013-07-02T09:30:00-04:00,47.71001,47.92,47.5,47.64,5129289,11814082.55,46.82994435760357,47.57914972269805,NaN,NaN,-39.72021078713558,-33.027168434398064,-0.042989273676962425,-0.18302466165773978,-0.14003538798077736,421202173,412211042.6,42.99855137500242,43.08323138951409,NaN,NaN,-6.369715266235501,-2.776443623865985
2013-07-03T09:30:00-04:00,47.46001,47.73,47.23,47.57001,3926691,11367813.6,46.17829239562213,47.091426457771625,NaN,NaN,-61.712146839162614,-35.38902266579854,-0.0362260651190042,-0.1853179693795326,-0.1490919042605284,417275482,414891745,45.81828413715785,41.67709712005279,NaN,NaN,-6.593332637233754,-3.3217134829185233
2013-07-05T09:30:00-04:00,47.89,48.23,47.75,48.22,4384371,10743934.55,52.75360103912327,47.12832424122705,NaN,NaN,10.49816358774975,-32.875468016714,0.0127520989111235,-0.13315178062162403,-0.14590387953274753,421659853,417381689.6,48.37289970844574,40.79485043548609,NaN,NaN,-4.885208679297529,-3.5450699395440957
2013-07-08T09:30:00-04:00,48.47,48.63,48.36,48.49001,6630277,10692277.9,55.20196240423583,47.26832921503763,NaN,NaN,68.44144444030161,-12.120854601946428,0.06134376239023273,-0.0692241765449566,-0.13056793893518934,428290130,422951820,53.63896549509081,40.54257893442632,NaN,NaN,-2.7226693615252633,-3.4275841426842626
2013-07-09T09:30:00-04:00,48.67999,48.75,48.42,48.625,5581285,10688161.5,56.41792751856603,47.23510087763259,NaN,NaN,82.44454930402232,11.990359941155095,0.0983894437065225,-0.007581134302036219,-0.10597057800855872,433871415,424459810.6,54.97787879465217,40.26518586447276,NaN,NaN,-0.5736056129213505,-3.0198729241467035
2013-07-10T09:30:00-04:00,48.57001,49.11,48.57001,48.95,5038141,10442987.7,59.28342364525001,47.96559351202991,NaN,NaN,111.06966871782542,42.1483358421473,0.13815807611395547,0.06672701713388562,-0.07143105898006985,438909556,428001287.2,58.0425168593521,40.37892811313878,NaN,NaN,2.113182757563591,-2.286579255330947
2013-07-11T09:30:00-04:00,49.45,49.64,49.35001,49.58,7472105,10387430.45,64.19755245506909,49.715145581936945,NaN,NaN,165.1785666962282,87.52647854922546,0.19669816135006685,0.17444164270751372,-0.02225651864255313,446381661,433822523,62.55450837062818,41.682440521279425,NaN,NaN,6.049314572419197,-1.0957372799380696
2013-07-12T09:30:00-04:00,49.59,49.89,49.46001,49.88,5578145,10321093.15,66.28431330789547,51.445842627213,NaN,NaN,159.7481428356275,117.376474398801,0.24242691759725096,0.2807771283540106,0.038350210756759616,451959806,439882513.6,66.58320927779862,43.57546111420186,NaN,NaN,10.012987148231433,0.49122335265757355
2013-07-15T09:30:00-04:00,50,50,49.71001,49.92999,4266160,10168702.7,66.63330868382197,53.39190513667404,NaN,NaN,151.12033568176753,133.9122526470942,0.2612210099510046,0.3648764731955154,0.10365546324451078,456225966,445469680.8,69.80840414406904,46.26707363456578,NaN,NaN,13.348483774605013,2.3279748415072077
2013-07-16T09:30:00-04:00,49.98,50.05161,49.52,49.64,7064051,10100037.5,62.58614793693059,54.87644349750256,NaN,NaN,123.70729978903975,142.16480274409767,0.2398556545445816,0.4034750314252378,0.16361937688065617,449161915,448527780.8,71.43354946001449,49.49094724004765,NaN,NaN,15.090100656891709,4.151135672276422
2013-07-17T09:30:00-04:00,49.77,50.02,49.69501,49.77,4668543,9963480.85,63.65197062206634,55.9866489422373,NaN,NaN,120.0950611847529,143.96988123748318,0.22069524360711415,0.43948843138954885,0.2187931877824347,453830458,451511961.2,72.96295756689956,52.95530442866749,NaN,NaN,16.848613073166195,5.965061015260675
2013-07-18T09:30:00-04:00,49.88,50.09,49.85001,49.91,6544691,9175432.2,64.81445256090801,57.07481789728568,NaN,NaN,113.86154243838304,133.70647638591413,0.20405643708427024,0.4738637341377725,0.26980729705350226,460375149,454310658.8,74.34994035266993,56.19979574645267,NaN,NaN,18.657971479889202,7.778333938779036
2013-07-19T09:30:00-04:00,49.82001,50.595,49.72,50.57001,6559527,8055805.35,69.72954272128777,58.734711663334586,NaN,NaN,121.98868820007736,126.1545854588041,0.2225910945545036,0.5480461652466317,0.32545507069212815,466934676,457305632.8,75.78172237876895,59.62089328389931,NaN,NaN,21.807561853457962,9.78250935516174
2013-07-22T09:30:00-04:00,50.5457,50.91499,50.48,50.82001,6172734,7565413.9,71.3614389743388,60.423134187337084,NaN,NaN,132.74183432312742,122.47888518707609,0.2355269699887922,0.6198637831781184,0.3843368131893262,473107410,460681921.6,77.31876675571644,62.47443961973331,NaN,NaN,24.960350853687636,11.950772426379725
2013-07-23T09:30:00-04:00,50.89999,50.92,50.535,50.64,5310828,6880789.7,68.49796943497414,61.97085026429212,NaN,NaN,116.46405458890153,121.03023614704846,0.21629647011854064,0.654707400837502,0.43841093071896137,467796582,464408855,78.90994077751637,65.03953886277002,NaN,NaN,26.795096892660062,14.071390207276917
2013-07-24T09:30:00-04:00,50.78999,50.86,50.41,50.56,3790092,6785881.8,67.20727541856061,63.472920480216295,NaN,NaN,99.83549922316813,116.97832375473152,0.1838022251044814,0.6681637120995632,0.48436148699508175,464006490,466444061.4,79.74556802770226,67.4629162835232,NaN,NaN,27.964524415677538,16.05612366561986
2013-07-25T09:30:00-04:00,50.53999,50.82001,50.2,50.81,3869044,6599338.5,69.16276596676113,64.64500368933328,NaN,NaN,90.90253558106753,112.3865223832684,0.16533883022300033,0.6910350247738322,0.5256961945508318,467875534,467944138.4,80.36315245866285,69.74793433711014,NaN,NaN,29.52155085543211,17.979756121307325
2013-07-26T09:30:00-04:00,50.72,51.155,50.46001,51.14,4832664,6574063.7,71.57253269079374,65.81433013837314,NaN,NaN,101.91324716555629,108.37143417636419,0.16136615451760616,0.7274038876978395,0.5660377331802333,472708198,469098842.8,80.84726792358757,71.69138451057418,NaN,NaN,31.57672697061792,19.922180528351696
2013-07-29T09:30:00-04:00,51.08,51.21001,50.84,50.99001,6497367,6460399.45,68.93573362226407,66.70845914578014,NaN,NaN,102.06873253909248,102.23681381955718,0.13568460852191977,0.735643493832633,0.5999588853107133,466210831,467719527,78.36207177854564,73.36168400942371,NaN,NaN,32.58140761044222,21.730641540078913
2013-07-30T09:30:00-04:00,51.38,51.48,50.795,51,5698836,5450742.05,69.01760526421296,67.40375783284892,NaN,NaN,102.44385874989784,99.43277465175645,0.10764292946536735,0.7345125471424225,0.6268696176770552,471909667,468542144,78.7809993098085,74.8430041844563,NaN,NaN,33.434986736516684,23.402690853855738
2013-07-31T09:30:00-04:00,51.10001,51.44,50.98,51.02,6477234,5518139.3,69.19266077226284,67.76055128407704,NaN,NaN,101.35404947774086,99.73648470267099,0.0799854306871085,0.7268514060359408,0.6468659753488323,478386901,471418226.2,80.22271057871629,76.10501862789117,NaN,NaN,34.19760130092583,24.944820917722893
2013-08-01T09:30:00-04:00,51.34,51.5,51.205,51.34,8762391,5759924.3,71.92586364398596,68.16351916522636,NaN,NaN,109.04611132785111,103.3651998520277,0.07298157662164517,0.7380929461258887,0.6651113695042435,487149292,475272977.8,81.98903374566041,77.2054346613099,NaN,NaN,35.61675012646601,26.469382233257623
2013-08-02T09:30:00-04:00,51.14,51.36,51.13,51.36,3818538,5731632.65,72.09251279771766,68.55346231621891,NaN,NaN,96.62297465374647,102.30714534966575,0.05997854161693261,0.7400845465254093,0.6801060049084767,490967830,478924904.2,83.4931388863497,78.18291571432994,NaN,NaN,36.852354171947596,27.952663938784763
2013-08-05T09:30:00-04:00,51.32001,51.46001,51.19,51.28999,3479786,5574108.1,70.5145732714968,69.11977841154507,NaN,NaN,93.31409788191479,100.5562184182302,0.038016045655408615,0.7276260619777375,0.6896100163223289,487488044,483180346.8,85.05891845904436,79.15615635711778,NaN,NaN,37.51541464794119,29.318771182949966
2013-08-06T09:30:00-04:00,51.21001,51.37,50.87,51.05,4280242,5509055.95,65.24286951299939,69.23341404661173,NaN,NaN,67.42234291130309,93.55191525051126,0.000654870715730338,0.6904286047169919,0.6897737340012615,483207802,485439973.8,85.82766678391152,80.07506415833292,NaN,NaN,36.73056457631187,30.377598810573094
2013-08-07T09:30:00-04:00,50.95,51.17999,50.75,51.09,3955205,5454909.15,65.70310326999353,69.29688909726069,NaN,NaN,53.37538445437757,83.95618224583859,-0.026532548249228127,0.6566080486897263,0.6831405969389545,487163007,487195195,86.41248638797364,80.93667458942603,NaN,NaN,36.176553096832386,31.20602085146728
2013-08-08T09:30:00-04:00,51.27,51.33,50.91,51.09,3629491,5262778.45,65.70310326999353,69.0092862793111,NaN,NaN,62.09673442514133,74.56630686529664,-0.04841027814869059,0.6226277492530912,0.6710380274017818,487163007,487197938,86.41342994691661,81.69608227286516,NaN,NaN,35.70590303625843,31.8488611635803
2013-08-09T09:30:00-04:00,50.96001,51.23,50.73,50.91,3902427,5178992.55,61.45611063608013,68.30176282657833,NaN,NaN,35.35268329027714,62.31224859260277,-0.07718997372598735,0.5745505602442975,0.6517405339702849,483260580,485656488,82.9282911622699,82.09676258761897,NaN,NaN,34.200625089661436,32.18482743873475
2013-08-12T09:30:00-04:00,50.87,50.87,50.55,50.7,3841760,5157772.55,56.83995125651673,67.46904724240281,NaN,NaN,-11.681124542961403,41.31320410762753,-0.11052560682898172,0.5135835254340577,0.6241091322630394,479418820,484042643.2,79.3212953358973,82.12614505607475,NaN,NaN,31.617530471018423,32.103785014775276
2013-08-13T09:30:00-04:00,50.89999,51.005,50.442,50.89,4430148,5026077.4,59.783296348724505,66.9387630231288,NaN,NaN,-9.561714315118818,25.91639266234315,-0.11919032859606982,0.4751212215179521,0.5943115501140219,483848968,484170876.4,79.3979743012532,82.10131693275696,NaN,NaN,30.077444968826196,31.814307865353978
2013-08-14T09:30:00-04:00,50.74001,51.02,50.4601,50.49001,5880715,5086686,51.77788296115558,65.69698566558554,NaN,NaN,-50.77396552909362,5.086522665648924,-0.1493177066671768,0.40766441678005094,0.5569821234472278,477968253,482331925.6,75.09734686657646,81.72518796189365,NaN,NaN,26.28828165045348,31.024875548939622
2013-08-15T09:30:00-04:00,50.03,50.17999,49.634,49.64,6461320,5082517.45,39.63241983197938,63.4155490328131,NaN,NaN,-245.72377662467824,-56.477579544314985,-0.219697034781132,0.2823608299708127,0.5020578647519447,471506933,479200710.8,68.31235842319805,80.82983728329441,NaN,NaN,18.208258261654482,29.1939302221846
2013-08-16T09:30:00-04:00,49.52,49.62,49.34,49.41,10277848,5268433.5,37.096742160964446,61.14133535700597,NaN,NaN,-276.0312963620553,-118.75437547478145,-0.27154778097002835,0.16262313853940924,0.4341709195094376,461229085,474794411.8,60.08540068773877,79.5243607768082,NaN,NaN,10.76133623131184,26.560702509202777
2013-08-19T09:30:00-04:00,49.38,49.75,49.27,49.5,8096297,5364611.65,38.74817844337409,58.97923344123178,NaN,NaN,-208.9191297882968,-158.20197652384854,-0.28802650442911226,0.07413778897304724,0.3621642934021595,469325382,472775724.2,56.715467152740786,77.94825133701764,NaN,NaN,5.36186066229572,23.532296531073197
2013-08-20T09:30:00-04:00,49.53,49.84,49.48,49.64,5029930,5350566.75,41.32856973870589,56.98894122454914,NaN,NaN,-151.7132746784001,-186.6322885965048,-0.27762353354133334,0.015134876475492831,0.2927584100168262,474355312,470876993,53.66661986909617,76.05138771490192,NaN,NaN,1.7271414242608838,20.417274372957152
2013-08-21T09:30:00-04:00,49.545,49.8,49.23,49.34,6178359,5469980.1,37.66670658047893,54.54185857715578,NaN,NaN,-147.50566669221044,-205.97862882912813,-0.2783639902352969,-0.05519657777729492,0.22316741245800195,468176953,468918733,50.64288212658423,73.8123768849679,NaN,NaN,-2.5602236728352605,17.134774652129664
2013-08-22T09:30:00-04:00,49.52,49.745,49.4135,49.66,2768516,5414953.7,43.424950824488235,52.494175579067964,NaN,NaN,-108.56169355350417,-178.54621221489336,-0.24584871608204667,-0.0841434826445564,0.16170523343749027,470945469,468806440.2,50.46728554144518,71.45338736033186,NaN,NaN,-4.40747708655626,14.057310118031676
2013-08-23T09:30:00-04:00,49.67,49.85001,49.48,49.78999,2366644,5291652.7,45.622477102958534,50.71616870988665,NaN,NaN,-84.43448073544816,-140.2268490895719,-0.20575955385234795,-0.09549420887794469,0.11026534497440327,473312113,471223045.8,54.15162902264052,69.24572382916016,NaN,NaN,-5.233733797768486,11.301446701488796
2013-08-26T09:30:00-04:00,49.88,50.17,49.78999,49.86,3941797,5163874.2,46.82056228108596,49.400289621892846,NaN,NaN,-53.83529757346746,-109.21008264660607,-0.16638358126687822,-0.09771413160919451,0.0686694496576837,477253910,472808751.4,56.44115614583519,67.14668735501185,NaN,NaN,-5.549802875481799,8.89412533335014
2013-08-27T09:30:00-04:00,49.45,49.50999,48.951,49.05,6653336,5211599.2,36.735768360155205,47.33119427119011,NaN,NaN,-113.20225369361563,-101.50787844964916,-0.18529973618080955,-0.16295522056832823,0.022344515612481318,470600574,472057803.8,55.03941617052877,64.90575376805151,NaN,NaN,-9.288718584976637,6.2965762021606
2013-08-28T09:30:00-04:00,49.06,49.435,48.82001,49.25999,6008602,5188167.6,40.32437344831365,45.518427855355824,NaN,NaN,-100.69222494297536,-92.14519009980215,-0.17424493670873195,-0.19546165527343362,-0.021216718564701677,476609176,473744248.4,57.58694021153876,62.8467187869531,NaN,NaN,-11.11417758216561,3.8093256615425704
2013-08-29T09:30:00-04:00,49.17,49.735,49.00999,49.41,4042557,4952175.9,42.81966010493285,44.187252817416734,NaN,NaN,-74.36351445557783,-85.3055542802169,-0.1484150785357771,-0.20673556673442306,-0.05832048819864596,480651733,475685501.2,60.370494534695816,61.23544759926924,NaN,NaN,-11.783345305511206,1.581801237677745
2013-08-30T09:30:00-04:00,49.48,49.48,49.06821,49.22,4127281,4967613.05,40.50921649453597,43.02077176298955,NaN,NaN,-80.06089333675341,-84.43083680047795,-0.13603891954619496,-0.22836913763138966,-0.0923302180851947,476524452,476327969,61.27629176849803,59.94651877302643,NaN,NaN,-13.054259577789196,-0.5090645931032465
2013-09-03T09:30:00-04:00,49.72,49.86501,49.31,49.53999,6063012,5096774.35,45.81220989379795,42.022837016209074,NaN,NaN,-45.32521107590578,-82.72881950096561,-0.0998876266822891,-0.21718975143805608,-0.11730212475576698,482587464,477394679.8,62.79674573912667,58.76071673287454,NaN,NaN,-12.44859131063181,-2.2147112670358986
2013-09-04T09:30:00-04:00,49.5,50.16,49.5,50.11,4051195,5085322,53.725294560980174,42.16193784476798,NaN,NaN,-2.224030169022431,-60.53317479604698,-0.034546294601858624,-0.16048499300809027,-0.12593869840623165,486638659,480602296.8,66.99352374703858,58.18187222433611,NaN,NaN,-9.193379722927828,-3.2116639035918886
2013-09-05T09:30:00-04:00,50.21001,50.23599,49.996,50.17999,4288035,5101963.5,54.601931864119685,43.231188704206566,NaN,NaN,31.71180527717569,-34.05236875201676,0.013834117686662872,-0.10864605129790306,-0.12248016898456593,490926694,483465800.4,70.22289147641672,58.31833887099458,NaN,NaN,-6.351395263597319,-3.660196955021236
2013-09-06T09:30:00-04:00,50.32001,50.5,49.60001,50.2,5639418,5202459.85,54.86519113266196,44.5003636307564,NaN,NaN,38.052378450094274,-11.56919017088234,0.04582643529004686,-0.06519712487200735,-0.11102356016205421,496566112,486648676.2,73.34471476195563,59.26543273343864,NaN,NaN,-4.013931515189507,-3.710730463616703
2013-09-09T09:30:00-04:00,50.28999,50.52,50.14,50.50999,4286730,5221675,58.84660433722798,45.935965480317385,NaN,NaN,93.2882680436289,23.10064210519412,0.08427132091947079,-0.005684409012715719,-0.0899557299321865,500852842,491514354.2,77.26816880820581,60.73348285168614,NaN,NaN,-0.7505010325721152,-3.2878405448960475
2013-09-10T09:30:00-04:00,50.74001,50.88029,50.56,50.83,6500121,5354593.05,62.521988456550226,47.44978110302055,NaN,NaN,151.7438580398652,62.51445592834832,0.1251925883534803,0.06653500550966385,-0.05865758284381643,507352963,496467454,80.42659051024631,62.64490932605401,NaN,NaN,3.230319303154146,-2.3566748523174486
2013-09-11T09:30:00-04:00,50.95,51.21001,50.815,51.17,6753926,5470781.95,65.99669578597904,49.47335176055627,NaN,NaN,191.4641876210565,101.2520994863641,0.16651121933603746,0.14948144132623042,-0.017029778009807053,514106889,501961100,83.2126264956411,64.9713196381295,NaN,NaN,7.77915217704267,-0.9086995624088603
2013-09-12T09:30:00-04:00,51.10001,51.30499,51.05,51.08501,3098376,5331665,64.38963881040499,50.970829473836034,NaN,NaN,187.48856236909677,132.40745090474832,0.1784115374842147,0.20598464384546133,0.027573106361246623,511008513,505977463.8,84.90434905723275,67.43110988925719,NaN,NaN,10.974597840667041,0.7889143523162683
2013-09-13T09:30:00-04:00,51.19,51.28,51.03,51.21001,3668804,5192039.2,65.71208211585949,52.405801260471826,NaN,NaN,157.16239084424842,156.22945338357914,0.18424362797576824,0.2578776413309569,0.07363401335518868,514677317,509599704.8,86.25012883548749,69.72385987588912,NaN,NaN,14.018096172815591,2.678797469530457
2013-09-16T09:30:00-04:00,51.66,51.84,51.52499,51.67,6880852,5022189.4,70.11090530202438,54.06939719053885,NaN,NaN,178.21995759332594,173.21579129351855,0.20692489381807527,0.3322901306277828,0.12536523680970751,521558169,513740770.2,87.61004267773471,71.95020891388194,NaN,NaN,18.16284962577183,4.890804920422082
2013-09-17T09:30:00-04:00,51.71001,51.71001,51.495,51.7,3654014,4800075.25,70.37781845705652,56.47240076888895,NaN,NaN,145.4950603267594,171.9660317508974,0.21106532595843447,0.3891968942577506,0.17813156829931615,525212183,517312614.2,88.65254341805796,74.35114657441974,NaN,NaN,21.566679494820647,7.273072716764734
2013-09-18T09:30:00-04:00,51.7,52.12,51.3699,52.02,6868742,4892015.85,73.13380324338871,58.815931468537165,NaN,NaN,138.0010279301161,161.27339981270933,0.22139373637064455,0.4548737387626218,0.23348000239197728,532080925,520907421.4,89.60089691177637,76.63785776729385,NaN,NaN,25.394052964853763,9.861784180777452
2013-09-19T09:30:00-04:00,52.19,52.19,51.75,51.85001,6104129,4888304.35,69.43794976888924,60.717237873105475,NaN,NaN,126.08639053165214,148.9929654452204,0.20328460113934255,0.48758575381615543,0.2843011526768129,525976796,523901078,90.32598308406436,78.77753552082017,NaN,NaN,27.505276553691534,12.382283091193749
2013-09-20T09:30:00-04:00,51.78999,51.88,51.515,51.53999,8986309,5199194,63.16825383422702,62.33574054022627,NaN,NaN,90.88926634798692,135.7383405459681,0.1589009598276091,0.48292735246132423,0.32402639263371513,516990487,524363712,90.43695426842228,80.86043998510047,NaN,NaN,27.434380649796232,14.532582742422674
2013-09-23T09:30:00-04:00,51.48,51.48,51,51.17999,4773766,5319550.1,56.75934044941236,63.117678437055865,NaN,NaN,51.90440087807827,110.47522920291856,0.09682385667707977,0.44505621348006486,0.3482323568029851,512216721,522495422.4,86.13963388843887,82.52778913862278,NaN,NaN,25.349097215652804,16.077799095741263
2013-09-24T09:30:00-04:00,51.22,51.24001,50.89999,50.92,5956762,5420298.35,52.608108109706265,63.037879404822014,NaN,NaN,32.53004666319491,87.88222647020567,0.03307274215358952,0.38957328449497197,0.35650054234138245,506259959,518704977.6,78.03772983426265,83.31666100199593,NaN,NaN,22.273225382247894,16.962859993813638
2013-09-25T09:30:00-04:00,51,51.02,50.52,50.52499,5207465,5348004.8,46.98547839437264,62.49384701412579,NaN,NaN,0.16089593822406975,60.31420007182727,-0.03707771193839127,0.3101534024183934,0.34723111435678466,501052494,512499291.4,66.93737044661309,83.08198092843853,NaN,NaN,17.7583105257232,17.076495784086433
2013-09-26T09:30:00-04:00,50.5,50.88,50.5,50.7,4319262,5263537.8,49.55777188772527,62.11474563948746,NaN,NaN,-6.866487625099568,33.72362444047692,-0.0710998930395621,0.25835624805733204,0.32945614109689414,505371756,508378283.4,60.75683779863109,82.18284685962962,NaN,NaN,14.857510011012131,16.75949781650439
2013-09-27T09:30:00-04:00,50.42,50.78999,50.37,50.7,3937072,5258263.55,49.55777188772527,61.45125760738012,NaN,NaN,-22.308504448978095,11.084070281083928,-0.09170075190520172,0.21483020121539198,0.3065309531205937,505371756,506054537.2,57.531094442171984,80.77305583348435,NaN,NaN,12.55219276678081,16.15845423797245
2013-09-30T09:30:00-04:00,50.34,50.74001,50.27,50.59,8585273,5481163.15,47.86483252397816,60.40431789791069,NaN,NaN,-43.266270722420145,-7.950064039015766,-0.10962039340198626,0.16950546136811084,0.2791258547700971,496786483,502968489.6,53.47086591874516,78.84764693409143,NaN,NaN,10.139510958658336,15.298605198070433
2013-10-01T09:30:00-04:00,50.63,51.25999,50.56,51.23,11691027,5762563.9,57.05658256483785,59.76573838211488,NaN,NaN,7.804347788869974,-12.895203813880752,-0.07680702766398617,0.18311707019011436,0.25992409785410053,508477510,503411999.8,53.97360251552574,76.75914522122604,NaN,NaN,10.758205864246253,14.649976721809836
2013-10-02T09:30:00-04:00,50.89,51.13,50.78,51.11,6404828,5880245.55,55.09517888551188,59.10184838747966,NaN,NaN,-1.2605810370756092,-13.179499208940689,-0.06224169245530567,0.18212198228496845,0.24436367474027412,502072682,503616037.4,54.21867534375594,74.56731138454911,NaN,NaN,10.657641217442286,14.079643078328758
2013-10-03T09:30:00-04:00,51.05,51.07001,50.45,50.655,7228344,6027261,48.313399458874066,57.859085340552134,NaN,NaN,-54.0594097689323,-22.618083637707237,-0.08111446417064194,0.1429705945269717,0.22408505869761364,494844338,501510553.8,51.18969101114644,72.06299439709618,NaN,NaN,8.377315439030061,13.26502484414323
2013-10-04T09:30:00-04:00,50.74001,51.25999,50.63,51.22,4503387,5970459.45,55.61889830203953,56.82394198341036,NaN,NaN,-10.20700720148376,-20.197784188208367,-0.054677358257443937,0.15573836087580872,0.21041571913325266,499347725,500305747.6,49.48603922332187,69.33985129320955,NaN,NaN,8.843209349651577,12.633336916358708
2013-10-07T09:30:00-04:00,50.87,50.98,50.64999,50.64999,3971791,5954712.5,48.21481757425219,55.24087049178148,NaN,NaN,-68.69497584399528,-25.283525212523394,-0.07353584147221631,0.11849591729298226,0.19203175876519857,495375934,500023637.8,49.074191056453714,66.51282612452353,NaN,NaN,6.613123867032035,11.773306480740612
2013-10-08T09:30:00-04:00,50.75999,50.95,49.89,49.92,7359965,5997704.7,40.73580613175205,52.92672784095028,NaN,NaN,-154.21528869300502,-57.6874525088984,-0.12983807637879913,0.029734163291699645,0.15957223967049877,488015969,495931329.6,43.4279592048572,63.21475914545788,NaN,NaN,1.8622248660975425,10.357437678648745
2013-10-09T09:30:00-04:00,50.02,50.13,49.58,49.83,11392574,6229637.1,39.91375925204709,50.81785708974727,NaN,NaN,-191.6692262887481,-95.76918155923289,-0.16551927934467262,-0.04732685951034199,0.11819241983433063,476623395,490841472.2,37.62899830722488,59.45068880425505,NaN,NaN,-2.0153064584913865,8.589902801914441
2013-10-10T09:30:00-04:00,50.25999,51.02,50.25999,50.99001,7330066,6441221.6,53.06155326118242,50.09594990595837,NaN,NaN,-39.62423204104305,-92.88214601365505,-0.10625518149858035,-0.014626557038894816,0.09162862445968553,483953461,488663296.8,35.44757851409507,55.52287625037455,NaN,NaN,-0.4810486749163231,7.294052590938618
2013-10-11T09:30:00-04:00,50.95,51.295,50.94,51.23,4694648,6492513.8,55.243528385871286,49.98767761570544,NaN,NaN,24.451813344682453,-85.95038190442179,-0.0490592804517332,0.03030452389501903,0.07936380434675223,488648109,486523373.6,33.39905571472261,51.7556920951091,NaN,NaN,1.4889788298386226,6.464756339352904
2013-10-14T09:30:00-04:00,50.98,51.60001,50.85001,51.60001,8858211,6591381.75,58.45047783294696,50.404989738794065,NaN,NaN,60.58293549913874,-60.09479963579499,0.012251399937749902,0.0946780542689396,0.0824266543311897,497506320,486949450.8,34.214249487995545,48.62544349894716,NaN,NaN,4.205582893326663,6.14201727563487
2013-10-15T09:30:00-04:00,51.53999,51.6951,51.24001,51.27,8043094,6810835.75,54.68676217905926,50.955081437700244,NaN,NaN,73.05677647381509,-14.64038660243097,0.028225572681262426,0.11770862018276773,0.0894830475015053,489463226,487238902.2,34.79811478445538,46.329782380221616,NaN,NaN,5.080306851475291,5.990344357897787
2013-10-16T09:30:00-04:00,51.52,52.34,51.52,52.32001,7239836,6829390.45,62.87740650930934,51.90648391067054,NaN,NaN,179.1662340077879,59.52670545687622,0.10295162884716338,0.21817258356045954,0.11522095471329616,496703062,491254835.6,42.43218431104194,45.02087855967953,NaN,NaN,8.952457508817934,6.413503379457809
2013-10-17T09:30:00-04:00,52.03999,52.81,52.03999,52.75999,6823574,6865362.7,65.67704423031181,53.057860506569575,NaN,NaN,236.86891052593626,114.8253339702721,0.1714196269401197,0.3294954883884458,0.15807586144832608,503526636,495169470.6,48.73334294887234,44.39246773872954,NaN,NaN,13.038250945902394,7.359895888949892
2013-10-18T09:30:00-04:00,52.82001,52.85001,52.28,52.55,7646234,6798358.95,63.22622575306214,54.155102880075574,NaN,NaN,205.93781837996698,151.122534977329,0.1905057229176678,0.3962080150954108,0.20570229217774302,495880402,496615929.2,50.87307626568961,44.206911334939875,NaN,NaN,15.363770960281798,8.50330661342588
2013-10-21T09:30:00-04:00,52.60001,52.61,52.14,52.28,4103258,6764833.55,60.11977327196039,54.37390221629862,NaN,NaN,146.38794570994287,168.2835370194898,0.1733757755627017,0.42242201163112014,0.24904623606841844,491777144,495470094,49.12395931833067,43.86050824942594,NaN,NaN,16.198902092181715,9.602677396105284
2013-10-22T09:30:00-04:00,52.42999,52.89,52.37,52.77,5053934,6719692.15,63.61376282613637,54.98237249777179,NaN,NaN,150.8543324624451,183.8430482172158,0.18255056005311127,0.47723443613480754,0.29468387608169627,496831078,496943664.4,51.436423038870075,43.66177594193409,NaN,NaN,18.055827027128483,10.810270200537168
2013-10-23T09:30:00-04:00,52.64,52.8,52.42,52.67101,5140750,6716356.4,62.42390561121683,55.9902657943677,NaN,NaN,123.80383918211783,172.7705692520818,0.16972764802875617,0.5068434361176415,0.3371157880888853,491690328,495941117.6,49.7786569690076,43.56098779606703,NaN,NaN,19.152153466367132,12.001967809941448
2013-10-24T09:30:00-04:00,52.87,52.965,52.63,52.67,3725641,6686675.35,62.411078756219915,56.475421541094875,NaN,NaN,116.3937372857892,148.6755346040524,0.1496552152909446,0.5241848072025661,0.3745295919116215,487964687,492828727.8,44.936632071368734,43.23603014235609,NaN,NaN,20.019307897774013,13.147302108203242
2013-10-25T09:30:00-04:00,52.74001,52.75999,52.47,52.74001,3855907,6682617.1,62.97893904106431,57.530001645867166,NaN,NaN,93.85523717383738,126.25901836282648,0.13028238948527598,0.5373825787682165,0.4071001892829405,491820594,492016766.2,43.741264774125476,42.85510683647551,NaN,NaN,20.8904056378799,14.253459755299907
2013-10-28T09:30:00-04:00,52.75,53.03,52.66,52.92,8983397,6702523.3,64.46524408992471,59.22496150002235,NaN,NaN,97.93558215380503,116.5685456515989,0.11908534603945975,0.5559568718322652,0.4368715257928054,500803991,493822135.6,47.11016633900517,43.118121631771785,NaN,NaN,22.040304657263267,15.365866169866102
2013-10-29T09:30:00-04:00,53.08,53.28,52.92,53.27,7263002,6481122.05,67.22110767805904,61.17548638759464,NaN,NaN,106.18573142776128,107.63482544466214,0.12417791353877117,0.5920939177162694,0.46791600417749823,508066993,496069318.6,51.040189689109106,44.076063873334945,NaN,NaN,23.83081369578749,16.575144387854873
2013-10-30T09:30:00-04:00,53.46,53.5,52.82,52.98,8240294,6572895.35,62.87035000152741,61.8761147261907,NaN,NaN,91.93262008336568,101.26058162491174,0.09808720136602878,0.5905250058850342,0.49243780451900543,499826699,497696592.8,53.721862467281014,45.38136986999109,NaN,NaN,24.1531175459114,17.65771198186295
2013-10-31T09:30:00-04:00,52.97,53.1801,52.7,52.77,5904015,6506678.9,59.8495226711412,62.2051143179957,NaN,NaN,70.26847211534906,92.0355285908237,0.05870098439281257,0.5658140350100211,0.5071130506172086,493922684,498888192.2,55.63801995020884,46.969867315382956,NaN,NaN,23.57884917339979,18.50358872351107
2013-11-01T09:30:00-04:00,52.89,53.175,52.74,53.115,10779209,6820470,62.99525605244931,62.529741333674444,NaN,NaN,74.10552230077427,88.08558561621109,0.048331105165145494,0.5675269320736405,0.519195826908495,504701893,501464452,59.53869094485146,48.778755990872675,NaN,NaN,23.968388730121756,19.284274438741168
2013-11-04T09:30:00-05:00,53.17,53.32,52.99,53.16,3156136,6779687.25,63.39807806110103,63.15197818239171,NaN,NaN,80.39181851126749,84.57683288770359,0.037436254990693696,0.565991145646862,0.5285548906561683,507858029,502875259.6,61.533380167429875,50.68841780394228,NaN,NaN,24.39987214794782,20.015074111484974
2013-11-05T09:30:00-05:00,53,53.1,52.74,52.98,4248074,6624092.7,60.558364099239185,62.98633229595813,NaN,NaN,60.11205346146791,75.36209729444491,0.012339190089527663,0.5439788782680779,0.5316396881785502,503609955,501983852,59.53623379817998,51.91013562445214,NaN,NaN,23.997877738022584,20.584046058133204
2013-11-06T09:30:00-05:00,53.175,53.3,52.8,52.86,4736148,6291271.4,58.67159050211195,62.48594274394385,NaN,NaN,63.64713505233987,69.70500028823976,-0.016542981927772926,0.5109609607688341,0.527503942696607,498873807,501793273.6,59.094633665958554,52.65022781852973,NaN,NaN,23.14985599331248,20.950590334587385
2013-11-07T09:30:00-05:00,53.07,53.22,52.36,52.39,6050918,6227314,51.85679785144098,61.67384075097091,NaN,NaN,16.956776845806754,59.0426612343313,-0.0685820121071592,0.4417764275626581,0.5103584396698173,492822889,501573314.6,58.554796161203015,53.198922096780684,NaN,NaN,20.420039715327857,20.87479738897888
2013-11-08T09:30:00-05:00,52.39,53.2,52.39,53.16,6664692,6325816.2,60.04476395668733,61.66848294273712,NaN,NaN,53.475935828883905,54.916743939953236,-0.053117124995010756,0.4439620334260539,0.49707915842106465,499487581,500530452.2,55.94534644448656,53.686164034363244,NaN,NaN,20.38252342244559,20.80447253661698
2013-11-11T09:30:00-05:00,53.1,53.38,53.1,53.29,5095661,6137688.7,61.24323057754696,61.499159210695026,NaN,NaN,116.49701091462889,62.13778242062551,-0.03687502540061488,0.45098537667029603,0.4878604020709109,504583242,499875494.8,54.30843760046621,53.89130793162011,NaN,NaN,20.715574112807865,20.791772761787108
2013-11-12T09:30:00-05:00,53.2,53.2999,53.02,53.26,3066453,5888856.65,60.7900748163701,61.38245701106312,NaN,NaN,101.08154206633043,70.33168014159801,-0.031124002347880042,0.44895539913606086,0.4800794014839409,501516789,499456861.6,53.23624394883923,54.13827843017952,NaN,NaN,20.854516976616,20.80073622104838
2013-11-13T09:30:00-05:00,53.04,53.56,52.91,53.56,5214822,5787605.95,63.683906226994736,61.4733732589756,NaN,NaN,137.00743025792252,85.0037391827145,-0.011119294000144275,0.46618028398376055,0.4772995779839048,506731611,501028422.4,56.69283411226376,54.9780071473863,NaN,NaN,21.817308841916788,20.945960881172436
2013-11-14T09:30:00-05:00,53.7,54.07,53.68,54.005,6201782,5756516.35,67.5139012723435,61.7972991326384,NaN,NaN,251.3501488541213,131.88241358437742,0.026049572656707043,0.5098615438047887,0.4838119711480816,512933393,505050523.2,64.02238437469632,56.426658547427074,NaN,NaN,23.83880354035419,21.3592241181984
2013-11-15T09:30:00-05:00,54.03,54.32,53.92,54.32,4004361,5574422.7,69.93130346413686,62.187731945082135,NaN,NaN,251.8547524583381,171.5581769102683,0.06367247926625386,0.5634025702308989,0.49973009096464505,516937754,508540557.8,68.93536727566625,57.9856014714743,NaN,NaN,26.309820557123746,22.066452180902022
2013-11-18T09:30:00-05:00,54.37,54.52,53.96,54.08,3796643,5559091.95,65.90719610441298,62.09388111839313,NaN,NaN,207.98556525997944,189.8558877793384,0.0640437885098849,0.5797848266020011,0.5157410380921162,513141111,510252131.6,71.0250760241072,59.413093352545594,NaN,NaN,27.181128256658553,22.797120191724385
2013-11-19T09:30:00-05:00,53.92,54.2232,53.78,54.14,4515078,5532149.15,66.42732216055066,62.34795055832336,NaN,NaN,150.63477875937846,199.76653511794797,0.060046383960371985,0.5907990180425813,0.5307526340822093,517656189,513480011.6,74.50790042301008,60.897810349383384,NaN,NaN,28.041442771614157,23.54630913170864
2013-11-20T09:30:00-05:00,54.19,54.55,54.08,54.3,4743998,5512311.55,67.83649006242086,62.91844822912905,NaN,NaN,158.9888596928642,204.16282100493632,0.05976521331984608,0.6054591507320168,0.5456939374121708,522400187,516613726.8,77.35386908292517,62.448942430291694,NaN,NaN,29.16807636195109,24.34941873602899
2013-11-21T09:30:00-05:00,54.48,54.69,54.38,54.521,4590280,5555543.5,69.72663222789217,63.39926081308925,NaN,NaN,155.71463959269428,185.03571915265093,0.06558470601010258,0.627674819924799,0.5620901139146964,526990467,519425141.6,79.55873581240283,63.878945635116786,NaN,NaN,30.675933279894352,25.253206528009756
2013-11-22T09:30:00-05:00,54.79,55.25,54.73,55.25,5924653,5658980.8,74.95505855500947,64.224759419797,NaN,NaN,181.16919412852286,170.89860748668784,0.10719280127147734,0.6960811155040432,0.5888883142325658,532915120,522620614.8,81.73540895773765,65.32194769156733,NaN,NaN,33.77582410733643,26.470723325056422
2013-11-25T09:30:00-05:00,55.54,55.705,55.38,55.47,5270091,5473315.5,76.28610434574189,65.34816943740432,NaN,NaN,185.55713801024518,166.412922036741,0.13632382921610164,0.7592931007526929,0.6229692715365912,538185211,527629434.8,84.51826111852824,67.10637821444935,NaN,NaN,36.760186447190044,27.940646628218367
2013-11-26T09:30:00-05:00,55.48,55.62,55.27,55.31,5035288,5361929.8,73.2375848611529,66.38859760590725,NaN,NaN,146.47745344667084,165.58145697419945,0.13154595463297958,0.7874017148278156,0.655855760194836,533149923,530728181.6,85.94500562326452,69.0242619256855,NaN,NaN,38.305945360448106,29.421403589965472
2013-11-27T09:30:00-05:00,55.39,55.57,55.18,55.29,4449529,5172391.55,72.84571465781809,67.8878059492199,NaN,NaN,123.90685331168956,158.5650556979645,0.11439975404563518,0.7988554527518801,0.6844556987062449,528700394,531988223,86.49020896415443,71.01964855446774,NaN,NaN,39.44555188427998,30.853424774867545
2013-11-29T09:30:00-05:00,55.4,55.47,55.14,55.26,2837650,5019073.3,72.2214761849304,68.75757110838012,NaN,NaN,107.0905566667994,148.84023911278555,0.08950124168234752,0.7963322508091792,0.7068310091268317,525862744,531762678.4,85.84827301445884,73.15557188089431,NaN,NaN,40.21608035239141,32.1909470002281
2013-12-02T09:30:00-05:00,55.24,55.41,55.1,55.28,4724392,4716332.45,72.39133393662156,69.55386420545689,NaN,NaN,94.8201368933899,131.57042766575896,0.06403584340289847,0.7868758133804548,0.7228399699775563,530587136,531297081.6,84.45475971318444,75.30888060323134,NaN,NaN,40.90374190074538,33.43563198601628
2013-12-03T09:30:00-05:00,55.18,55.18,54.68,54.8,4402284,4778639.85,62.511845567703226,69.67684783055212,NaN,NaN,58.81858677579762,106.22271741886944,0.007495287721934751,0.7322090796299747,0.72471379190804,526184852,528897009.8,77.47353143989282,77.04011542402088,NaN,NaN,38.7263371151862,34.191447004469126
2013-12-04T09:30:00-05:00,54.57,54.975,54.17,54.61,3474855,4739978.9,59.075084997617175,69.347646314168,NaN,NaN,29.22164282844925,82.77155529522513,-0.04706858600456698,0.6658780594023312,0.7129466454068982,522709997,526809024.6,71.9048335343517,78.12668681131288,NaN,NaN,35.86932499652291,34.43114386047681
2013-12-05T09:30:00-05:00,54.54,54.81,54.38,54.51,3617222,4684032.6,57.28984867842172,68.6173568431736,NaN,NaN,22.39644017052041,62.46947266699128,-0.09168231678134187,0.5983437494302208,0.6900260662115627,519092775,524887500.8,67.12320302773536,78.34817385795853,NaN,NaN,32.96354681652844,34.22148713991275
2013-12-06T09:30:00-05:00,54.97,55.24,54.815,55.22,4846485,4623810.95,65.30634272679654,68.28700250479214,NaN,NaN,64.73316832647016,53.99799499892547,-0.07581949499783947,0.5952516974642634,0.6710711924621029,523939260,524502804,66.17442289932605,78.15096354536279,NaN,NaN,32.61874098934087,33.99252340411677
2013-12-09T09:30:00-05:00,55.43,55.4872,55.26,55.33,3902008,4485676.75,66.35983299318443,68.31933371113296,NaN,NaN,85.92398322886027,52.21876426601955,-0.06100048734983421,0.5948205832748101,0.6558210706246443,527841268,523953630.4,64.76700686000129,77.70395860506952,NaN,NaN,32.65670008102128,33.80169150081741
2013-12-10T09:30:00-05:00,55.31,55.31,54.87,55.11,3545513,4408169.35,62.28615546019304,68.02353608967884,NaN,NaN,50.81701960169044,50.6184508311981,-0.06853335565809648,0.5701543760520238,0.6386877317101203,524295755,523575811,63.76226304388847,76.93641307798941,NaN,NaN,31.4587866032567,33.466990801165885
2013-12-11T09:30:00-05:00,55.12,55.12,54.09,54.16,9989176,4754305.5,48.453832882080555,66.63906057679739,NaN,NaN,-34.82583161724616,37.808955942059015,-0.13611175459023406,0.46854803847232773,0.6046597930625618,514306579,521895127.4,59.35144442367793,75.6505256023289,NaN,NaN,25.4058673992408,32.31540174374801
2013-12-12T09:30:00-05:00,54.14,54.19,53.745,53.77,5645363,4775832.55,44.1218840599783,64.81014999337496,NaN,NaN,-117.4733153514442,9.835004837666094,-0.20173483954296967,0.35249124363384965,0.5542260831768193,508661216,519808815.6,54.32741204639693,73.84828819047132,NaN,NaN,18.890141386802792,30.39750740704155
2013-12-13T09:30:00-05:00,53.93,54.04,53.58,53.81,4319973,4681742.1,44.668282435197106,62.646808841959796,NaN,NaN,-127.96543902243687,-28.70471663211531,-0.23479091107624106,0.260737444331518,0.4955283554077591,512981189,517617201.4,49.57959788455497,71.55144454238686,NaN,NaN,14.036215329766558,28.060179967430837
2013-12-16T09:30:00-05:00,54.01,54.38,53.8149,53.91,6211597,4792103.9,46.08760453765677,60.48977314138229,NaN,NaN,-94.68237586466661,-64.82598845082069,-0.2413375598250146,0.19385640562649087,0.43519396545150546,519192786,515887505,46.15151645761453,68.81096278089302,NaN,NaN,10.5755780524797,25.56237969386639
2013-12-17T09:30:00-05:00,53.93,54.0199,53.4,53.65,5133582,4858950.85,42.99925945030132,58.329892754892896,NaN,NaN,-131.22099597496702,-101.23359156615217,-0.2533497316580523,0.11850680087894006,0.37185653253699236,514059204,513840194.8,42.41342497951347,65.70156416348223,NaN,NaN,6.698632715354531,22.867558696936126
2013-12-18T09:30:00-05:00,53.8,55,53.5,54.98,10210097,5143701.8,58.367836091459445,57.295758571581565,NaN,NaN,-32.433989695617946,-100.75522318182655,-0.16611036882294805,0.16421857150830732,0.33032894033125537,524269301,515832739.2,46.91959159699214,62.87509149439921,NaN,NaN,8.47634240162836,20.811670654749303
2013-12-19T09:30:00-05:00,54.85,54.9,54.551,54.86,6691022,5241053,56.8777550664816,56.19977849169236,NaN,NaN,1.6723892275787655,-76.92608226602195,-0.11339231184002696,0.1885885505312217,0.30198086237124866,517578279,517616151.8,50.64238287395993,60.36038505579214,NaN,NaN,9.310291088114276,19.1686164309443
2013-12-20T09:30:00-05:00,54.79,55.07,54.69,54.91,6813324,5352205.2,57.36614236855614,55.12655052254483,NaN,NaN,16.18868834104117,-48.095256793326335,-0.07396766137133293,0.2095212856570825,0.28348894702841543,524391603,519898234.6,54.9923412781747,58.25592659614858,NaN,NaN,10.114037256739282,17.875105120343584
2013-12-23T09:30:00-05:00,55.2,55.21,54.97,55.12,3850877,5248516.4,59.443710114288585,54.907397990158074,NaN,NaN,45.84146345798545,-19.990488928795923,-0.03456235242018019,0.2402860065031902,0.2748483589233704,528242480,521708173.4,58.1431000578159,56.8751814974288,NaN,NaN,11.430952606879579,16.95451190413444
2013-12-24T09:30:00-05:00,55.13,55.15,54.9401,55.02,3291896,5149606.65,57.99443031471694,54.83020836995091,NaN,NaN,42.05857050508038,14.665424367213552,-0.016939558957988377,0.2536739102258849,0.2706134691838733,524950584,523886449.4,61.62495982791743,56.14090480411206,NaN,NaN,12.062613527945317,16.255669278964564
2013-12-26T09:30:00-05:00,55.04,55.43,55.04,55.43,2593912,5027537.85,62.07686379729289,55.172138021298856,NaN,NaN,82.63612327233935,37.67944696080501,0.018692177068002802,0.2939786905188768,0.275286513450874,527544496,524541488.4,62.63163023697589,55.82007817620068,NaN,NaN,13.885457041373606,15.917067530737285
2013-12-27T09:30:00-05:00,55.59,55.59,55.28,55.38,2670397,4938581.25,61.29450741739894,54.88557835634189,NaN,NaN,98.96911258615312,57.13879163251988,0.034344966311941616,0.31821772134080106,0.28387275502885945,524874099,526000652.4,64.84400878463343,55.725048596579775,NaN,NaN,15.12732751681876,15.804247528748924
2013-12-30T09:30:00-05:00,55.38,55.47,55.1,55.47,2374166,4915407.05,62.21755088962897,54.589701063230784,NaN,NaN,87.68084595761924,71.4372231558355,0.04551098750121707,0.34076148940538076,0.2952505019041637,527248265,526571984.8,65.70028759307391,55.79171150608496,NaN,NaN,16.418712047046256,15.892028174219972
2013-12-31T09:30:00-05:00,55.52,55.56,55.2349,55.44,6007957,4979585.3,61.68944157915666,54.54707864315675,NaN,NaN,94.95506297033323,81.25994305830504,0.04551759971068359,0.35214750154251817,0.3066299018318346,521240308,525171550.4,61.73129887991438,55.64664263722967,NaN,NaN,17.343872945091654,16.099434570058783
2014-01-02T09:30:00-05:00,55.31,55.42,55,55.13,8771744,5198058.3,56.365319467197565,55.11218482780797,NaN,NaN,57.815203380169294,84.41126963332283,0.020556674256396346,0.33232574465233,0.31176907039593366,512468564,522675146.4,55.316221712376425,55.35841244356528,NaN,NaN,16.687371316032383,16.1834255337693
2014-01-03T09:30:00-05:00,55.22,55.5,55.15,55.26,3642412,5206436.15,58.002247406696995,56.10363935257359,NaN,NaN,68.38953818118038,81.56195261509103,0.009287992115291965,0.3233790605400486,0.31409106842475665,516110976,520388442.4,50.17288121370522,55.061660241230165,NaN,NaN,16.57910473153216,16.239951133449708
2014-01-06T09:30:00-05:00,55.43,55.61,54.95,55.03,9123491,5481749.6,54.13297901643417,56.77968910837624,NaN,NaN,49.38652457407766,71.64543501267595,-0.01580346242865127,0.29433674038894253,0.3101402028175938,506987485,516811119.6,43.37782028427853,54.6186761269247,NaN,NaN,15.40704499395197,16.12096454209289
2014-01-07T09:30:00-05:00,55.28,55.79,55.28,55.61,5713996,5525125.15,61.16790724769227,57.85685358766449,NaN,NaN,93.81611571415272,72.87248896398266,0.003484899565659283,0.3144963272746679,0.31101142770900864,512701481,513901762.8,38.778072007824775,54.09200152336829,NaN,NaN,16.447030805759116,16.16754543690235
2014-01-08T09:30:00-05:00,55.7,56.18,55.55,56.1,7793238,5719686.65,65.9231370982973,59.4942734196642,NaN,NaN,135.96742025309368,81.07496042053477,0.04382701044335968,0.3657951907632082,0.32196818031984853,520494719,513752645,38.552422082804355,53.81621560217478,NaN,NaN,18.908328104534526,16.559085817992663
2014-01-09T09:30:00-05:00,56.18,56.56,56.05,56.52,6204636,5852642.8,69.38387589101552,60.28113340534677,NaN,NaN,167.2704885876507,102.96601746203105,0.09068327603855081,0.435322275368037,0.3446389993294862,526699355,516598803.2,45.11692234057337,53.68745351243058,NaN,NaN,22.169210223028006,17.36053216156914
2014-01-10T09:30:00-05:00,56.66,56.75,56.21,56.74,7734240,5739896,71.04279037136993,61.292921641410224,NaN,NaN,169.33278095795302,123.15466601738558,0.1261959864487468,0.5023839823904197,0.3761879959416729,534433595,520263327,52.19781261591457,53.79855563685591,NaN,NaN,25.375469855388804,18.505523260686235
2014-01-13T09:30:00-05:00,56.86,57.07,56.16,56.28,12815568,6098406.25,63.317459266599755,61.7180157055562,NaN,NaN,151.1936513446597,143.516091371502,0.10905350369253958,0.5125048755573474,0.4034513718648078,521618027,523189435.4,56.97159089658906,53.93993060959979,NaN,NaN,25.619442270496773,19.521797404944884
2014-01-14T09:30:00-05:00,56.37,57.075,56.305,56.99,6943414,6229578.3,68.93289078993448,62.39581432524519,NaN,NaN,165.90376267694612,157.93362076406066,0.13422451490543214,0.571232015496598,0.43700750059116583,528561441,526361427.4,61.46426092956954,54.17715638615362,NaN,NaN,27.806354348415052,20.705305539726336
2014-01-15T09:30:00-05:00,57.11,57.11,56.79,56.94,10054071,6421702,68.14178678439771,63.12062550165096,NaN,NaN,155.29721917746286,161.7995805489345,0.1357899490669286,0.6067449369248266,0.47095498785789797,518507370,525963957.6,60.610272073611625,54.10467868941749,NaN,NaN,29.233547280252875,21.923625788372984
2014-01-16T09:30:00-05:00,56.92,57.18,56.85,57.08,5489813,6439513.55,69.20739186343494,63.629948934946825,NaN,NaN,140.19417344036563,156.3843175194775,0.13429366556707945,0.6388220698167473,0.5045284042496678,523997183,525423523.2,59.40175620635438,53.873973401515954,NaN,NaN,30.716620212196883,23.179767848919255
2014-01-17T09:30:00-05:00,57.08,57.24,56.86,57.02,6907491,6274383.25,68.15523143922962,64.12000065079188,NaN,NaN,120.88787779470643,146.69533688682816,0.11788717921379632,0.6518873782669132,0.5340001990531169,517089692,521954742.6,52.20645677046661,52.97129111478976,NaN,NaN,31.59894336771339,24.38250720874699
2014-01-21T09:30:00-05:00,57.31,57.45,56.91,57.35,5697308,6224697.55,70.78591794514928,64.73202686904332,NaN,NaN,121.94776510758774,140.84615963941377,0.11761552185703361,0.681019601374409,0.5634040795173754,522787000,522188537.2,52.622999421680824,52.03719910254739,NaN,NaN,33.15543981242873,25.635783294987238
2014-01-22T09:30:00-05:00,57.39,57.5,57.2101,57.4,5391277,6153595.2,71.17446985800639,65.40952888896116,NaN,NaN,117.76616221716043,131.21863954745663,0.10933408802479838,0.7000716895483734,0.590737601523575,528178277,522111904.4,52.46160196092408,51.37507789404809,NaN,NaN,34.53390847954317,26.906944035638087
2014-01-23T09:30:00-05:00,57.17,57.35,56.6301,57,7052834,6313693.05,63.857316747109365,65.94467155181201,NaN,NaN,76.10797944533348,115.38079160103075,0.06749926469823586,0.6751116823963699,0.607612417698134,521125443,522635519,53.51079394867659,51.246118768069515,NaN,NaN,33.578217343085406,27.859983079559132
2014-01-24T09:30:00-05:00,56.66,56.77,55.66,55.66,13101851,6804190.8,46.58085369272061,65.12885771509941,NaN,NaN,-13.888620948441694,84.56423272326927,-0.05331557102519935,0.5409679539166348,0.5942835249418341,508023592,519440800.8,46.73366491134425,51.00046046075802,NaN,NaN,26.214997440410208,27.624985131109288
2014-01-27T09:30:00-05:00,55.64,55.7556,55.03,55.21,13825864,7365788.4,42.42937160397679,64.29288575706674,NaN,NaN,-79.91678004481302,44.40330115536538,-0.16038099732748867,0.3938072782824733,0.554188275609962,494197728,514862408,39.092449819373854,50.69436257040769,NaN,NaN,18.738586859659044,26.355499663759254
2014-01-28T09:30:00-05:00,55.56,56.1799,55.53,55.95,8806215,7672579.3,50.27728885036292,63.51498444297179,NaN,NaN,-30.833646342986775,13.847018865250476,-0.1769074529332746,0.3330539594433688,0.5099614123766434,503003943,510905796.6,33.92942600183194,50.348030712836774,NaN,NaN,15.310245836039831,24.777606259799335
2014-01-29T09:30:00-05:00,55.57,56,55.25,55.44,12281199,8167930.95,45.6578227682932,62.06746199082864,NaN,NaN,-64.45401629417057,-22.597016837015712,-0.2151883635284461,0.24097595796608573,0.45616432149453184,490722744,503414690,26.731050077834396,49.50364699819607,NaN,NaN,10.848590610444607,22.78774688132009
2014-01-30T09:30:00-05:00,55.99,56.577,55.96,56.45,10714026,8403234.4,54.56167813153183,61.00873357943696,NaN,NaN,7.325621903181857,-36.35348834544603,-0.1676044896560755,0.24665870942443746,0.41426319908051296,501436770,499476955.4,23.864877314768194,47.98564378206712,NaN,NaN,10.45444990828424,21.02584731374354
2014-01-31T09:30:00-05:00,55.87,56.285,55.69,55.96,10821218,8505708.1,50.25922416907554,59.524193136415924,NaN,NaN,-36.25628780345785,-40.827021716449266,-0.16404114884543686,0.2092117630237169,0.37325291186915377,490615552,495995347.4,21.654101861974027,45.80395015678565,NaN,NaN,8.532760221870575,19.241120586333118
2014-02-03T09:30:00-05:00,56.1,56.26,54.76,54.86,15808739,9114024.45,42.21200574051747,58.01666074169576,NaN,NaN,-113.5127154803065,-47.54620880354796,-0.2268107135203155,0.0897395199687594,0.3165502334890749,474806813,492117164.4,19.488417714854876,43.12658064380464,NaN,NaN,3.7276351430483587,17.02490838014958
2014-02-04T09:30:00-05:00,55.17,55.47,55,55.4,10079955,9161847.65,46.721882161084466,56.430160125349325,NaN,NaN,-115.41954265363707,-64.46338806567802,-0.22268805781337753,0.03819016122235297,0.2608782190357305,484886768,488493729.4,17.7065861840979,40.00103244769952,NaN,NaN,1.7070615374332139,14.836644545475814
2014-02-05T09:30:00-05:00,55.37,55.47,54.65,55.09,16384164,9695356.05,44.57139967290563,54.74656104595703,NaN,NaN,-131.62708155647368,-77.89800111813864,-0.23059223382939437,-0.027362073251012475,0.2032301605783819,468502604,484049701.4,15.798700218149136,36.80020588659506,NaN,NaN,-0.6118417076433619,12.62971793788736
2014-02-06T09:30:00-05:00,55.22,55.47,55.14,55.4,7842110,9697799.65,47.189122428681394,53.17382751490321,NaN,NaN,-94.15496155635921,-98.19411781004685,-0.2055277270912567,-0.053679498285688965,0.15184822880556773,476344714,479031290.2,13.968340201795769,33.554961886269446,NaN,NaN,-1.540533096410041,10.60539636155916
2014-02-07T09:30:00-05:00,55.48,56.365,55.33,56.35,11497049,9962420.3,54.310340037296115,52.18490670047938,NaN,NaN,-22.060840714570443,-95.35502839226938,-0.11980126746535558,0.002096644473873255,0.12189791193922883,487841763,478476532.4,13.778305536761025,30.810093941004762,NaN,NaN,0.1952640459450121,9.11823460218571
2014-02-10T09:30:00-05:00,56.46,56.84,56.24,56.82,7902756,9970846.1,57.3728407615184,51.22682975879146,NaN,NaN,40.7240111044067,-64.50768307532674,-0.030906420967187473,0.08326488573024449,0.11417130669743196,495744519,482664073.6,22.364286721505593,28.64875731956368,NaN,NaN,2.651270267810782,8.194382554417864
2014-02-11T09:30:00-05:00,56.86,57.635,56.73,57.59,10380222,9849078.8,61.88079649074349,50.56299594684411,NaN,NaN,100.13949944880065,-21.395874654839197,0.07453003542586081,0.20733385097975798,0.13280381555389717,506124741,486911668.2,29.98084698030577,27.04298910666237,NaN,NaN,6.296450430409189,7.923249393845196
2014-02-12T09:30:00-05:00,57.77,57.91,57.42,57.59,6535785,9828697.35,61.88079649074349,50.42181592853227,NaN,NaN,119.60560523911334,28.85066270427821,0.13549782900096413,0.30217610180510235,0.16667827280413822,506124741,494436095.6,41.01960238779703,26.150761138028116,NaN,NaN,9.078342896826069,8.088262751413891
2014-02-13T09:30:00-05:00,57.28,58.03,57.1844,58,8256303,9738808.95,64.21761525057772,51.68158461123635,NaN,NaN,118.11988022422592,71.30563106039524,0.19125390894378946,0.40574565898387505,0.21449175004008558,514381044,502043361.6,49.66038325925194,26.35981244859295,NaN,NaN,12.124533526044507,8.664872862075407
2014-02-14T09:30:00-05:00,57.95,58.3,57.8299,58.21,8379768,9883306.7,65.38799837124326,53.32148652318396,NaN,NaN,135.31667832094067,102.78113486749746,0.22762112279771446,0.49901815353722867,0.2713970307395142,522760812,509027171.4,56.0291922444702,27.56957976467126,NaN,NaN,14.95813808152743,9.563910750568553
2014-02-18T09:30:00-05:00,58.47,58.87,58.35,58.75,10874177,10081641,68.2626703755971,54.60615663212925,NaN,NaN,155.5813404892535,125.75260074446683,0.2704703760456313,0.6094850007965533,0.33901462475092203,533634989,516605265.4,61.69266171866614,29.55266803015942,NaN,NaN,18.284498681322788,10.809709026390586
2014-02-19T09:30:00-05:00,58.73,58.94,58.31,58.39,10732639,10333407.55,64.4213141066289,55.946406013438946,NaN,NaN,132.67063574078136,132.25882800286297,0.2570838632140079,0.6603694537684319,0.40328559055442403,522902350,519960787.2,63.90931614048762,32.20825846320608,NaN,NaN,19.9114849996479,12.109962736855916
2014-02-20T09:30:00-05:00,58.47,59.01,58.27,58.92,9852260,10556456.7,67.33561169164989,56.85882983916167,NaN,NaN,130.76565313236006,134.49083758151232,0.2653633794650953,0.7349898148857932,0.4696264354206979,532754610,525286761,67.15774001575687,35.30060579899099,NaN,NaN,22.20448934469081,13.552037966546616
2014-02-21T09:30:00-05:00,58.98,59.22,58.74,58.81,5196273,10463628.65,66.12498271786,57.99209830693199,NaN,NaN,123.37148264624,135.5411580659151,0.24534059541875497,0.7763021796941416,0.5309615842753866,527558337,527922219.6,68.66090248650609,38.65823441502899,NaN,NaN,23.713071380308183,15.003614168512554
2014-02-24T09:30:00-05:00,59.01,59.585,58.92,59.25,6464204,10131746.3,68.55995534171048,59.87409470701721,NaN,NaN,121.69117042783894,132.8160564872948,0.24316863953390722,0.8349223836927706,0.5917537441588634,534022541,530174565.4,69.92768848375657,42.261039469950546,NaN,NaN,25.731224808836483,16.536129974273116
2014-02-25T09:30:00-05:00,59.16,59.43,58.93,59.1,6858502,9783378.2,66.79718401540444,61.30804483946863,NaN,NaN,103.94207374719197,122.48820313888245,0.21409244225926738,0.8593692969829476,0.6452768547236802,527164039,528880375.4,68.22127507236371,45.86923153339809,NaN,NaN,26.9018074172373,18.016941037553714
2014-02-26T09:30:00-05:00,59.27,59.47,58.955,59.1,7448999,9715517.4,66.79718401540444,62.895600863932835,NaN,NaN,94.72801426629394,114.89967884398497,0.1787620996008421,0.8687294792247329,0.6899673796238908,527164039,529732713.2,68.7619269458688,49.65231915680665,NaN,NaN,27.860780069967113,19.423203756469913
2014-02-27T09:30:00-05:00,59.1,59.44,58.94,59.44,5980067,9400460.8,68.89928170897598,64.44632652681102,NaN,NaN,91.03626930893681,106.95380207930035,0.1626544254347294,0.8932854114173026,0.7306309859825731,533144106,529810612.4,68.81414789862622,53.56987684943739,NaN,NaN,29.274053946445562,20.830468069323576
2014-02-28T09:30:00-05:00,59.49,60.01,58.9301,59.44,10341197,9381819.35,68.89928170897598,65.48839378907387,NaN,NaN,91.45345045591206,100.57019564123475,0.13737081033590814,0.9023444989024583,0.7649736885665501,533144106,530927766.2,69.59904448743288,57.5570724887711,NaN,NaN,30.446615401016576,22.204203402422575
2014-03-03T09:30:00-05:00,58.66,59.24,58.61,59,8919817,9286749.3,62.92049281753375,65.88465465021783,NaN,NaN,61.539402025137896,88.53984196069453,0.07926843416686236,0.8640592312751281,0.7847907971082657,524224289,528968115.8,66.44014564104796,60.705348125881265,NaN,NaN,29.89178648402569,23.302429556937305
2014-03-04T09:30:00-05:00,59.54,60.2,59.54,60.12,9658830,8979253.85,70.04583561599632,66.46787173059302,NaN,NaN,104.9582961824745,88.74308644775104,0.10301660369219623,0.913561551723511,0.8105449480313147,533883119,530311931.8,67.52852512691335,63.38732513635323,NaN,NaN,31.532893118555638,24.478210065739923
2014-03-05T09:30:00-05:00,60.21,60.24,59.88,59.97,10740157,9012263.95,68.15680518456382,66.9161580658659,NaN,NaN,104.14277181935013,90.62603795836228,0.0955389625353229,0.9299686512004683,0.8344296886651454,523142962,529507716.4,66.14597476018493,65.18206602009522,NaN,NaN,32.30905690408583,25.59690247121791
2014-03-06T09:30:00-05:00,60.29,60.495,59.47,59.6,14206792,8903395.35,63.60050483408078,66.87207875040183,NaN,NaN,91.99462035960987,90.81770816849689,0.05462393983193081,0.902709613455059,0.8480856736231281,508936170,524666129.2,58.39479369443712,65.80595247975131,NaN,NaN,31.61268566050709,26.456300069687792
2014-03-07T09:30:00-05:00,59.92,60,59.07,59.45,12630296,9142804.65,61.79688935791198,66.61557096373532,NaN,NaN,67.32348689874563,85.99171545706362,0.008811234295612258,0.8590997164926435,0.8502884821970312,496305874,517298482.8,48.987304938563824,65.30296052932943,NaN,NaN,30.514519763150144,27.036045740182413
2014-03-10T09:30:00-04:00,59.45,59.73,59.1499,59.7,7775874,8956745.9,63.64724071904072,66.28589741683844,NaN,NaN,65.29367383136069,86.74256981830817,-0.012162683288603371,0.835085128086277,0.8472478113748804,504081748,513269974.6,44.742836991457374,64.09225876310022,NaN,NaN,30.103018303154798,27.474184677749896
2014-03-11T09:30:00-04:00,59.7,60,59.4449,59.58,6031607,8863188.45,62.092630713038275,66.11956288872481,NaN,NaN,76.03504436950882,80.95791945571503,-0.04005345677127459,0.7971809904107872,0.8372344471820617,498050141,506103379,38.37311979969347,62.268244738757794,NaN,NaN,29.327846385483575,27.738993493140423
2014-03-12T09:30:00-04:00,59.29,59.64,59.11,59.57,8822635,8785309.1,61.95681987360195,65.73536347314996,NaN,NaN,44.942431284022106,69.11785134864942,-0.06370626814614233,0.7576016119993838,0.8213078801455261,489227506,499320287.8,33.51043480528004,59.864865795152305,NaN,NaN,28.64930891619136,27.86903855357627
2014-03-13T09:30:00-04:00,59.76,59.79,58.635,58.76,12551347,9086087.2,52.029851045320726,64.72856835368286,NaN,NaN,-13.298282061676659,48.05927086439213,-0.1343718191006935,0.6533431062696593,0.7877149253703528,476676159,492868285.6,29.660298706830957,57.07910838231836,NaN,NaN,25.061533226651434,27.46796636401558
2014-03-14T09:30:00-04:00,58.67,58.9,58.41,58.44,8006052,9073574.65,48.709450954140834,63.31067518314217,NaN,NaN,-100.73560371516378,14.447452741610244,-0.19922272365834082,0.5386865207974267,0.7379092444557676,468670107,487341132.2,26.81773735773146,53.99982615903086,NaN,NaN,21.00048092067835,26.54403987211026
2014-03-17T09:30:00-04:00,58.8,59.2599,58.7,59.01,6430116,8976092.05,54.303546629915296,62.41827251275009,NaN,NaN,-45.80319518406179,-7.77192106147425,-0.19977773924132103,0.48818707040411624,0.6879648096454373,475100223,481544827.2,24.198596262180445,50.85534910116062,NaN,NaN,19.079799058938093,25.477719755942807
2014-03-18T09:30:00-04:00,59.13,59.76,59.07,59.64,6147184,8739742.4,59.55423210607103,61.90091880494056,NaN,NaN,41.07048121587181,-14.764833692201659,-0.15571984869169553,0.49331499878081786,0.6490348474725134,481247407,478184280.4,22.807799866144578,47.57291145260889,NaN,NaN,19.056180422696382,24.560356994050462
2014-03-19T09:30:00-04:00,59.71,60.04,59.08,59.46,8404755,8623348.2,57.5205947243748,61.088155448897616,NaN,NaN,41.612841315544905,-15.430751685897098,-0.13734643095684151,0.47735180877646144,0.614698239733303,472842652,474907309.6,21.50956768147681,44.19401286566965,NaN,NaN,18.41218132622987,23.682046184361806
2014-03-20T09:30:00-04:00,59.46,59.53,59.14,59.46,4895324,8375501.4,57.5205947243748,60.27539209285468,NaN,NaN,3.840724180283328,-12.002950437505103,-0.12423448832399997,0.459405129328303,0.583639617652303,472842652,474140608.2,21.205440908983547,40.73732689578041,NaN,NaN,17.89660083805286,22.855553992031957
2014-03-21T09:30:00-04:00,59.51,59.72,58.07,58.18,19504442,9090909.85,44.88106598167803,58.98686160457927,NaN,NaN,-152.04588168675332,-22.265006031823013,-0.19651114021033367,0.3380006923893859,0.5345118325997196,453338210,471074228.8,19.988188286218872,37.41932994186404,NaN,NaN,13.114257532165011,21.463940212050964
2014-03-24T09:30:00-04:00,58.38,58.45,57.11,57.53,20495099,9792454.6,40.06630356673843,56.8454664582037,NaN,NaN,-269.78848697924724,-67.06206439086012,-0.27786583052213165,0.18717954444705498,0.46504537496918663,432843111,462622806.4,17.078355319138538,33.81574638416584,NaN,NaN,7.387886719105953,19.453075427344533
2014-03-25T09:30:00-04:00,57.72,58.4325,57.44,58.04,14646433,10181851.15,45.04757348430991,55.19480705104271,NaN,NaN,-179.77243071696023,-111.2306467774265,-0.285983909687059,0.10756548786036291,0.3935493975474219,447489544,455871233.8,15.1774781222788,30.175139481458263,NaN,NaN,4.355492410423363,17.29627785349865
2014-03-26T09:30:00-04:00,58.31,58.76,58.01,58.06,13638275,10491314.95,45.23978467170868,53.883327039444694,NaN,NaN,-115.35073594467116,-142.6233622294697,-0.2783919767816294,0.04555942657038514,0.32395140335201456,461127819,453528267.2,14.571364456813527,27.044894535913716,NaN,NaN,2.0691770815730743,15.12097774322357
2014-03-27T09:30:00-04:00,58.09,58.24,57.43,57.93,12960990,10840361.1,44.158587257836615,52.62344831801074,NaN,NaN,-141.1654682585858,-171.62460071724354,-0.2702894322766401,-0.01391038699378555,0.25637904528285455,448166829,448593102.6,13.36100641370696,24.500158926995365,NaN,NaN,-0.10458707766014194,12.945897054525897
2014-03-28T09:30:00-04:00,58.11,58.65,57.52,57.71,13128851,10979743.8,42.3154916176124,51.099751953623006,NaN,NaN,-113.46583614154302,-163.90859160820148,-0.267419140538515,-0.07789488039028925,0.18952426014822576,435037978,444933056.2,12.52976674896287,22.199225338245753,NaN,NaN,-2.4578836049337225,10.74535696031738
2014-03-31T09:30:00-04:00,58.19,58.54,58,58.49,9508135,11009159.7,50.244681480581335,50.25346986559037,NaN,NaN,-65.64439643271922,-123.07977349889589,-0.2035516227726423,-0.0649152683175771,0.1386363544550652,444546113,447273656.6,16.123554871283844,20.609970700502206,NaN,NaN,-2.099665807084771,8.910353707831359
2014-04-01T09:30:00-04:00,58.66,59.13,58.46,58.855,10115357,11031986.05,53.46800737515363,49.647126115701205,NaN,NaN,-12.575476160751975,-89.64038258765422,-0.13082066142434237,-0.02488947232536276,0.10593118909897961,454661470,448708041.8,18.337853442717474,19.526214888890596,NaN,NaN,-0.784060684194063,7.525437366113441
2014-04-02T09:30:00-04:00,59,59.16,58.81,59.12,8999250,10944940.7,55.71134623032406,49.91009005748715,NaN,NaN,17.05079955580306,-63.16007548755939,-0.06243054216019284,0.027893011398738565,0.0903235535589314,463660720,449214622,19.149646228596183,18.77545399758812,NaN,NaN,0.9972668520168302,6.592841578385354
2014-04-03T09:30:00-04:00,59.23,59.27,58.6,58.99,9609530,10715077.6,54.3276327518351,50.311388757322455,NaN,NaN,14.41641551609939,-32.04369873262236,-0.025411987053433643,0.058558569742139355,0.083970556795573,454051190,450391494.2,21.111664137320048,18.367877338987295,NaN,NaN,2.052350798654287,5.944200038423773
2014-04-04T09:30:00-04:00,59.31,59.49,57.975,58.01,20116645,11089395.05,45.21135675416532,49.66194662334032,NaN,NaN,-37.56547395723741,-16.86362629576123,-0.0641841896074957,0.003740319786203372,0.06792450939369907,433934545,450170807.6,21.008708120299076,18.140028185995767,NaN,NaN,0.11028583835317753,5.110783724127973
2014-04-07T09:30:00-04:00,57.71,58.3646,57.16,57.43,15269233,11464063,40.84315610622855,48.32544119478014,NaN,NaN,-127.82836699638572,-29.300420408494517,-0.12275471354817051,-0.08551888254151407,0.037235831006656436,418665312,444994647.4,18.704641263273757,17.846945428647857,NaN,NaN,-2.9833167068377953,3.954483662561435
2014-04-08T09:30:00-04:00,57.48,57.51,56.613,56.96,15165040,11920734.65,37.66721056753297,46.907342326434296,NaN,NaN,-177.44115442386698,-62.27355606111754,-0.18336435228572595,-0.191969609350501,-0.008605257064775058,403500272,434762407.8,15.1641635517353,17.39370227652346,NaN,NaN,-6.606579156255593,2.445760402730431
2014-04-09T09:30:00-04:00,57.09,58.19,57.05,58.18,14438585,12201532.15,48.79718667720616,46.284241751636536,NaN,NaN,-78.48621357786591,-81.38095868785133,-0.13380503495694493,-0.17586155076095622,-0.04205651580401129,417938857,425618035.2,12.827380678842829,16.79526940294198,NaN,NaN,-5.938359115277887,1.248029043014957
2014-04-10T09:30:00-04:00,58.16,58.25,56.11,56.24,17622692,12455099.4,37.3702412356908,45.74775426978031,NaN,NaN,-160.93640922911078,-116.45152363689337,-0.2191507805235761,-0.3159949914584814,-0.09684421093490533,400316165,414871030.2,10.733872935335185,16.134246877878862,NaN,NaN,-9.96003440830723,-0.35312287860249825
2014-04-11T09:30:00-04:00,55.99,56.69,55.56,55.71,14710731,12790333.35,34.961530599939465,45.38312762929467,NaN,NaN,-205.1700110213352,-149.97243104971295,-0.29409604601655037,-0.4644642684555933,-0.17036822243904293,385605434,405205208,9.268692540825839,15.576413822285096,NaN,NaN,-13.93107113880501,-2.2928297729171425
2014-04-14T09:30:00-04:00,56.09,56.34,55.39,56.02,11085252,13023090.15,37.4990864064408,44.84394998087545,NaN,NaN,-178.395184855405,-160.08579462151678,-0.30431659544659206,-0.550763966747283,-0.24644737130069094,396690686,400810282.8,8.687993002878713,15.112879170899376,NaN,NaN,-16.023292437784857,-4.254324439326815
2014-04-15T09:30:00-04:00,56.24,56.74,55.42,56.62,17424536,13586957.75,42.19965065617111,44.626797551194194,NaN,NaN,-134.68002431090335,-151.53356859892406,-0.25423244709966647,-0.564237930175274,-0.31000548307560755,414115222,402933272.8,11.570120453043486,14.898504599201516,NaN,NaN,-16.04085296564269,-5.9381142288005115
2014-04-16T09:30:00-04:00,57.11,57.21,56.535,56.9,29585654,14646002.7,44.304753053603164,44.63723796517751,NaN,NaN,-75.40232913439104,-150.9167917102291,-0.18881818154753122,-0.5460282100100216,-0.35721002846249034,443700876,408085676.6,18.30926431210652,15.251951591944344,NaN,NaN,-15.347717600394148,-7.282343281885317
2014-04-17T09:30:00-04:00,56.92,57.18,56.59,56.89,8656853,14834079.15,44.2427787279044,44.77490133019837,NaN,NaN,-66.20333618302604,-131.97017710101213,-0.13530118709447198,-0.5263365123305803,-0.39103532523610834,435044023,415031248.2,26.44675181119777,16.24602195353255,NaN,NaN,-14.828258471818428,-8.360331166161476
2014-04-21T09:30:00-04:00,57,57.59,56.89,57.57,5549914,14136352.75,49.42364749352815,44.716256045408855,NaN,NaN,-21.98428254189872,-95.33303140512483,-0.04770405415154244,-0.4506653929255364,-0.402961338773994,440593937,426028948.8,37.126557477811296,17.74623642542737,NaN,NaN,-12.737008038605783,-8.985570719367805
2014-04-22T09:30:00-04:00,57.98,58.505,57.9,58.2,8981137,13560654.65,53.714673269783816,44.73387503788245,NaN,NaN,48.8435093065126,-49.88529257274131,0.05357970689662672,-0.3359867051532106,-0.38956641204983733,449575074,436605826.4,45.3456932290679,19.675367838738115,NaN,NaN,-9.582930252808325,-9.070907795573595
2014-04-23T09:30:00-04:00,58.3,58.3311,57.71,57.91,8669286,13261797.3,51.54668709618129,44.43639938544367,NaN,NaN,30.23756967727113,-16.901773775106427,0.0992981494671647,-0.26544372521588144,-0.36474187468304614,440905788,441963939.6,48.984039821074695,21.80639595248658,NaN,NaN,-7.668015656566118,-8.870494632858241
2014-04-24T09:30:00-04:00,58.21,58.21,57.28,57.82,8012689,12980518,50.86060780518296,44.188754746397095,NaN,NaN,14.610628417068607,1.1008177351855033,0.12032990278428718,-0.21432949620268715,-0.33465939898697433,432893099,439802384.2,47.60717513908504,23.69893245261265,NaN,NaN,-6.320588977624471,-8.506222396396273
2014-04-25T09:30:00-04:00,57.78,57.8049,57.24,57.39,6368627,12650899.85,47.60075477288966,44.35942603344883,NaN,NaN,-9.197654756067367,12.501954020577244,0.10281373638911401,-0.20614222850058184,-0.30895596488969584,426524472,438098474,46.497661145832055,25.519571954436433,NaN,NaN,-6.112719681384226,-8.164293437108839
2014-04-28T09:30:00-04:00,57.87,58.13,56.98,57.73,9735247,12481219.65,50.312558506297606,45.03581191916805,NaN,NaN,4.267413419199345,17.752293212796857,0.11095997493939475,-0.1702559962154524,-0.28121597115484714,436259719,437231630.4,45.911441954369884,27.4629148609433,NaN,NaN,-5.151996001047772,-7.733965231957257
2014-04-29T09:30:00-04:00,57.83,58.12,57.68,58.07,8955765,12453601.15,52.93563016138812,46.12641331872913,NaN,NaN,37.65751311475043,15.51509397444443,0.1345109722324796,-0.11307725586424766,-0.24758822809672726,445215484,436359712.4,45.292886694236074,29.614966513979066,NaN,NaN,-3.5794972727040553,-7.1404698092068
2014-04-30T09:30:00-04:00,57.97,58.21,57.77,58.12,11115209,12503593.75,53.325855670019635,46.44988967535867,NaN,NaN,50.73901897018388,19.61538383302698,0.14766909144989,-0.06300186378436479,-0.21067095523425478,456330693,439444693.4,47.964179601939854,32.12473786562886,NaN,NaN,-2.1782741259802236,-6.431584711603003
2014-05-01T09:30:00-04:00,58.16,58.57,57.79,58.25,6857522,12396507.35,54.38484263876431,47.66521834700677,NaN,NaN,75.02825341652915,31.698908832919084,0.15839223105644326,-0.012680666413700692,-0.17107289747014395,463188215,445503716.6,52.835307414734245,35.13198318558593,NaN,NaN,-0.7118896409189297,-5.614485415790993
2014-05-02T09:30:00-04:00,58.23,58.34,57.63,57.75,6126561,12222358.9,49.712927700523366,48.71888956847705,NaN,NaN,53.59112378782731,44.25666454169802,0.1264609117798307,-0.01299675774535558,-0.1394576695251863,457061654,451611153,57.18595950775928,38.554645111795466,NaN,NaN,-0.6762541297423574,-4.9090238034983305
2014-05-05T09:30:00-04:00,57.55,58.145,57.21,58.13,7218668,11577460.05,53.01633566464335,49.82726451549153,NaN,NaN,50.8828577444746,53.57975340675307,0.12533981071110295,0.017217093863692412,-0.10812271684741054,464280322,457215273.6,60.76256591014888,42.274257462314765,NaN,NaN,0.274049568181319,-4.168584750401238
2014-05-06T09:30:00-04:00,58.07,58.07,57.59,57.62,6117725,11119884.65,48.41912834632494,50.271512921931084,NaN,NaN,42.19109487075568,54.486469757954126,0.0865053319125472,0.000008948043273449002,-0.08649638386927375,458162597,459804696.2,62.328515625113276,45.8998571174626,NaN,NaN,-0.19819846076394573,-3.601386709024482
2014-05-07T09:30:00-04:00,57.7,57.79,57.03,57.78,9058117,10814538.5,49.887266630532814,50.67026389171177,NaN,NaN,14.211875030907677,47.181040970098884,0.0686292777402053,-0.0007097866940171116,-0.06933906443422241,467220714,461982700.4,63.64285479158561,49.13797072313968,NaN,NaN,-0.1854930928556503,-3.113401906714649
2014-05-08T09:30:00-04:00,57.81,58.12,57.31,57.47,7710004,10478109.45,47.09061091148668,50.873680476253355,NaN,NaN,27.142368572945692,37.60386400138219,0.03467592838936591,-0.02599415394751503,-0.06067008233688094,459510710,461247199.4,62.84545189647902,51.73787787208834,NaN,NaN,-0.9556017137091479,-2.8051447362852917
2014-05-09T09:30:00-04:00,57.53,57.88,57.11,57.82,7298599,9961904.8,50.46687244835974,50.948196544455605,NaN,NaN,20.417141351199138,30.969067514056558,0.03446615723246721,-0.017587385796296928,-0.05205354302876414,466809309,463196730.4,64.1284039247966,53.666581189730145,NaN,NaN,-0.6797693251028273,-2.5015196775449398
2014-05-12T09:30:00-04:00,58.05,58.45,57.9501,58.41,5244471,9488591.8,55.60925539353306,51.08352383900914,NaN,NaN,104.57031294182303,41.70655855352624,0.0706548876885805,0.03626506658196149,-0.034389821106619006,472053780,464751422,65.16153687371263,55.08199859291906,NaN,NaN,1.079479985918325,-1.9899482970501876
2014-05-13T09:30:00-04:00,58.56,58.71,58.42,58.5,3230398,9095849.1,56.35363071820208,51.42687695486776,NaN,NaN,145.8626689643895,62.44087337225301,0.09569055206014017,0.0852233689685562,-0.010467183091583964,475284178,468175738.2,67.38935240223583,56.39666377728771,NaN,NaN,2.739329474257175,-1.3143371868634217
2014-05-14T09:30:00-04:00,58.47,58.715,58.3,58.54,3746722,8411958.4,56.701149332705526,51.84405849254795,NaN,NaN,138.52823423675113,87.3041452134217,0.10901429846962221,0.1258006899954438,0.01678639152582159,479030900,470537775.4,68.86819546902413,57.91530808656908,NaN,NaN,4.208356489144943,-0.5253809474336553
2014-05-15T09:30:00-04:00,58.33,58.392,57.68,57.95,6469381,7256144.75,50.33500124711923,52.03936181213577,NaN,NaN,33.136071223337154,88.50288574349999,0.0738451949521431,0.10909288521600047,0.035247690263857365,472561519,473147937.2,70.46225794820117,59.627065001024015,NaN,NaN,3.7396513085636247,0.08390937485167038
2014-05-16T09:30:00-04:00,58.02,58.2,57.71,58.15,8913526,7268978.4,52.290477783856474,52.18064176053283,NaN,NaN,27.69551783637041,89.95856104053425,0.060372981362940926,0.11071391696753352,0.050340935604592595,481475045,476081084.4,72.18578821446363,61.503804019602136,NaN,NaN,3.890320920891447,0.6276824528573527
2014-05-19T09:30:00-04:00,58.15,58.55,58,58.51,4386054,7210785.4,55.67362998546554,52.37621317653837,NaN,NaN,103.59415660835758,89.76332977384115,0.07127941771440381,0.13944020774759736,0.06816079003319354,485861099,478842548.2,73.73937952383707,63.53569636457364,NaN,NaN,4.98418434539913,1.2500398660776066
2014-05-20T09:30:00-04:00,58.51,58.55,57.965,58.14,4611825,6992319.8,51.62195306776829,52.25450584780612,NaN,NaN,67.51560516467498,74.09391701389825,0.05014483134195,0.13084182921063103,0.08069699786868104,481249274,480035567.4,74.40453894245542,65.42429346032475,NaN,NaN,4.769352387101773,1.7527987976524875
2014-05-21T09:30:00-04:00,58.34,58.6849,58.22,58.63,3921546,6754932.8,56.171051740966355,52.38209221224913,NaN,NaN,124.74300703119862,71.33687157278774,0.06480436327411539,0.16170245196132527,0.09689808868720988,485170820,481263551.4,75.10355641836573,67.01488267486985,NaN,NaN,5.930216136565335,2.3495727032114657
2014-05-22T09:30:00-04:00,58.65,59.17,58.46,58.98,3526105,6530603.6,59.12746567501154,53.05455921042685,NaN,NaN,175.3688135190687,99.78342003193407,0.09204830303774122,0.2119584674843864,0.11991016444664518,488696925,484490632.6,76.88976169801131,68.42229711703071,NaN,NaN,7.8077341057839575,3.129310046436107
2014-05-23T09:30:00-04:00,59,59.115,58.805,59.01,2796717,6352008.1,59.3803826118665,53.50913399237136,NaN,NaN,168.22588597944255,127.88949366054848,0.10512028436501628,0.25131051990291553,0.14619023553789925,491493642,486494352,77.94769837248786,69.64980657862635,NaN,NaN,9.406222208771071,4.026011783912531
2014-05-27T09:30:00-04:00,59.33,59.375,59.01,59.33,3246595,6027575.5,62.07609064558421,54.484631299461306,NaN,NaN,186.68643040021766,144.5079484189205,0.12689183395465448,0.30480502798121734,0.17791319402656286,494740237,488270179.6,78.87087610485167,70.83140375575053,NaN,NaN,11.566796134064715,5.1032666910771285
2014-05-28T09:30:00-04:00,59.3,59.45,59.155,59.16,4401693,5799871.9,59.805384487033464,55.193068289211354,NaN,NaN,158.8253210009186,162.76989158616922,0.121414936359414,0.32968186447583037,0.20826692811641637,490338544,490088033.6,79.80297436048225,71.98569801067173,NaN,NaN,12.758662615107303,6.196894680224296
2014-05-29T09:30:00-04:00,59.31,59.63,59.31,59.63,2682165,5378219.7,63.75306082208402,56.383243282825454,NaN,NaN,166.55653192736176,171.13259656540185,0.13971292362454574,0.3829080826470985,0.2431951590225528,493020709,491658011.4,80.59899376628053,73.25380814422897,NaN,NaN,14.97660946016338,7.451139648787022
2014-05-30T09:30:00-04:00,59.51,59.82,59.495,59.79,7778275,5424257.35,65.01282525219963,57.422239911671156,NaN,NaN,158.55606333379853,167.77004652834782,0.151851427598236,0.43300944352034776,0.28115801592211176,500798984,494078423.2,81.7905473154947,74.51538981499313,NaN,NaN,17.19652698179877,8.843337839217272
2014-06-02T09:30:00-04:00,59.74,59.94,59.42,59.87,4880336,5361946.1,65.65555615053322,58.13983282288546,NaN,NaN,141.6229058694796,162.44945050635525,0.15404145311234557,0.4737098323125437,0.31966837920019814,505679320,496915558.8,83.10073255833234,75.79676093532309,NaN,NaN,19.2243922563124,10.326345613088003
2014-06-03T09:30:00-04:00,59.73,60.015,59.61,59.98,3054482,5153736.8,66.5650675281078,58.86922116645015,NaN,NaN,133.06633177143124,151.72543078059795,0.15144459858926518,0.5089741274367796,0.35752952884751443,508733802,499714271.8,84.3007246213942,77.00471609383442,NaN,NaN,21.188836857261723,11.878130076541392
2014-06-04T09:30:00-04:00,59.93,60.15,59.78,60.15,3600011,5027851.1,67.97650391986329,59.67460363696142,NaN,NaN,129.6236096187485,145.88508850416395,0.14946743875611918,0.5443638272926634,0.39489638853654424,512333813,504113325.6,85.98526344512456,78.22736380641301,NaN,NaN,23.265288745948126,13.504867029313782
2014-06-05T09:30:00-04:00,60.22,60.405,59.79,60.22,3929846,4771437.55,68.56495285130381,60.97674303726033,NaN,NaN,125.62701278423062,137.69918467553774,0.14125990462585503,0.571471269318863,0.430211364693008,516263659,508761915.6,87.51036203832679,79.44508552713627,NaN,NaN,25.1830948872541,15.173185294733827
2014-06-06T09:30:00-04:00,60.27,60.4,60.04,60.16,3950918,4583483.25,67.4213496272078,62.057519597499706,NaN,NaN,118.26639085493734,129.64125017976548,0.12095928889710883,0.5814104758143941,0.46045118691728526,512312741,511064667,88.19563874330531,80.5886462791964,NaN,NaN,26.53303359326865,16.796020765953088
2014-06-09T09:30:00-04:00,60.11,60.16,59.73,59.85,5533449,4495225.75,61.6957187741201,62.48766879668931,NaN,NaN,81.9326959974655,117.70320820536264,0.07791304908467173,0.5578424982731249,0.4799294491884532,506779292,511284661.4,88.26190053255523,81.62596920839054,NaN,NaN,26.24674080408577,18.14612362854347
2014-06-10T09:30:00-04:00,59.86,60.05,59.46,60.05,6922426,4579123.5,63.82988748071901,63.35966411190008,NaN,NaN,69.16843732374782,104.92362931582598,0.0552362767219966,0.5489747950909489,0.49373851836895233,513701718,512278244.6,88.5738595347525,82.63806353641176,NaN,NaN,26.55596019447884,19.347528852248523
2014-06-11T09:30:00-04:00,59.8,60.065,59.77,59.98,5901164,4712661.8,62.51698584612146,63.81294511941116,NaN,NaN,71.45517927065978,93.28994324620824,0.029158781934954026,0.5301869957876448,0.5010282138526908,507800554,511371592.8,86.31946739731582,83.43920003490821,NaN,NaN,26.475553219308466,20.3658180475428
2014-06-12T09:30:00-04:00,59.85,59.97,59.54,59.68,4305324,4740591.9,57.09664498796332,63.66788649890771,NaN,NaN,45.12202006206624,77.18894470177536,-0.012427715857301458,0.485493569031064,0.49792128488836546,503495230,508817907,80.1329446930327,83.67085596312401,NaN,NaN,24.922634390749554,21.01679181085805
2014-06-13T09:30:00-04:00,59.73,59.78,59.47,59.63,2950920,4564668.85,56.221729308266845,63.442268405793456,NaN,NaN,28.52986689963417,59.24163991071474,-0.045572182108482406,0.44095605725276243,0.48652823936124484,500544310,506464220.8,74.81101435797027,83.4468071049442,NaN,NaN,23.377430016291907,21.354025840205743
2014-06-16T09:30:00-04:00,59.9,60.2,59.55,59.75,9021662,4570075.65,57.88952066954713,63.14322769321937,NaN,NaN,48.53095514654002,52.56129174052965,-0.06073498777919001,0.4106095046372573,0.4713444924164473,509565972,507021556.8,75.23051086700724,83.18678101652674,NaN,NaN,22.464069563469813,21.512603514957753
2014-06-17T09:30:00-04:00,59.77,59.87,59.54,59.72,3728159,4537180.9,57.30179315550171,62.9643997409671,NaN,NaN,26.29128260221665,43.985860796223406,-0.07326659988219003,0.3797612425637098,0.45302784244589983,505837813,505448775.8,71.60636919341192,82.60130921887885,NaN,NaN,21.53694582220374,21.516080987421464
2014-06-18T09:30:00-04:00,59.66,60.21,59.58,60.2,5374240,4575301.65,63.659140362248266,62.95769113669312,NaN,NaN,70.78184978205714,43.85119489850285,-0.05077810506923697,0.38955521110935365,0.4403333161785906,511212053,506131075.6,72.23133721447019,82.0036194651781,NaN,NaN,22.40890686604506,21.64362754151055
2014-06-19T09:30:00-04:00,60.17,60.4,60.13,60.4,4313803,4594914.5,65.9350130446193,63.023561693294496,NaN,NaN,135.97252768453328,62.02129642299626,-0.02527178204829489,0.408743588618222,0.4340153706665169,515525856,508537200.8,74.37350614804781,81.47383081036047,NaN,NaN,23.81155392054499,21.95333130994404
2014-06-20T09:30:00-04:00,60.36,60.69,60.3,60.68,4426653,4639941.9,68.8739452177705,63.2534466266686,NaN,NaN,181.21021674321156,92.55736639171172,0.005951986237066165,0.4414553534628496,0.4355033672257834,519952509,512418840.6,77.40214606089083,81.06678891768607,NaN,NaN,25.911262612924645,22.5187500675127
2014-06-23T09:30:00-04:00,60.72,60.7699,60.4,60.45,3406711,4670441.6,63.99023873131859,63.069530284040795,NaN,NaN,164.5138347584013,115.753942314084,0.006561962592895543,0.4437058204669029,0.43714385787400734,516545798,513814805.8,78.39122867242203,80.64468206418806,NaN,NaN,26.295583131005053,23.058297648011607
2014-06-24T09:30:00-04:00,60.65,60.965,60.415,60.49,4868458,4751534.75,64.46219529349426,62.81850823930014,NaN,NaN,161.79058823339784,142.85380344032023,0.005167644477158617,0.4436034134704556,0.438435768993297,521414256,516930094.4,80.4479096975818,80.24915679650644,NaN,NaN,26.74421635187059,23.584857462848603
2014-06-25T09:30:00-04:00,60.46,61.19,60.42,61.15,20099195,5536409.85,71.17519705829304,63.004954254085085,NaN,NaN,194.4768173895921,167.59279696182722,0.042145339335789844,0.4911174431630343,0.44897210382724445,541513451,522990374,83.69838305387073,79.976872583331,NaN,NaN,29.32269701061152,24.404548826814736
2014-06-26T09:30:00-04:00,61.3,61.34,60.72,61.23,11236433,5964123.25,71.8688533572811,63.32263309194746,NaN,NaN,189.20016906399096,178.23832523771875,0.06412513390238284,0.529128521205223,0.4650033873028402,552749884,530435179.6,86.63733164768811,79.86556493364408,NaN,NaN,31.617586717354467,25.434982811177555
2014-06-27T09:30:00-04:00,61.05,61.22,60.856,61.07,4840860,5817252.5,68.32735320923861,63.796321265884494,NaN,NaN,150.72654941738364,172.14159177255317,0.0600899245048791,0.5401157929339391,0.48002586842906,547909024,536026482.6,88.33786009814953,79.87099061690081,NaN,NaN,32.47420968975089,26.440586650973746
2014-06-30T09:30:00-04:00,61.11,61.25,60.76,60.83,6540585,5900264.95,63.28940709505294,63.7577155240512,NaN,NaN,114.52577387344428,162.14397959556177,0.034718176763248954,0.5234235893831212,0.4887054126198722,541368439,540991010.8,89.60302555668507,79.94450247561028,NaN,NaN,31.68001236659221,27.18907603891924
2014-07-01T09:30:00-04:00,61.07,61.7199,61,61.6,8150627,6155072.2,70.74282505583206,64.34527546760197,NaN,NaN,162.2265707033058,162.23117608954334,0.06167983979462388,0.5658052123631521,0.5041253725685282,549519066,546611972.8,90.81764569199696,80.26580092523034,NaN,NaN,33.45846275206692,28.08470271222605
2014-07-02T09:30:00-04:00,61.58,62.07,61.49,62.07,4036664,6176904.85,74.18776393688239,65.56606967823903,NaN,NaN,183.37390574196428,160.0105937600178,0.10074381592699733,0.6300551424772749,0.5293113265502776,553555730,549020428.6,91.28732120457725,81.06254210462637,NaN,NaN,36.18792693802261,29.242306173054132
2014-07-03T09:30:00-04:00,62.2,62.34,61.93,62.32,2468587,6103841.9,75.81876570457963,66.96585799226138,NaN,NaN,184.4816597437424,159.0668918959681,0.13107598769652262,0.6931563111709309,0.5620803234744083,556024317,549675315.2,91.4158945728926,82.24860497712083,NaN,NaN,38.941609070574216,30.627920872699857
2014-07-07T09:30:00-04:00,62.07,62.33,61.8,61.85,3900326,6101312.3,67.2194079135925,67.63227850969318,NaN,NaN,138.4225372371025,156.60608945991186,0.10809770445026445,0.6972024540372388,0.5891047495869743,552123991,550518308.6,91.5879793298739,83.41699558161132,NaN,NaN,38.25524345739662,31.717538384799393
2014-07-08T09:30:00-04:00,61.75,61.78,61.06,61.27,7145438,6181911.75,58.41450047026442,67.7117576036048,NaN,NaN,67.9577241572537,147.29247951667372,0.04564370081852065,0.6461593756101252,0.6005156747916045,544978553,551240331.4,91.7407014504624,84.85516217140062,NaN,NaN,34.453876925156806,32.108443890564736
2014-07-09T09:30:00-04:00,61.44,61.59,61.11,61.53,5879917,6129786.3,60.88777686187723,67.513803067864,NaN,NaN,64.69516885437174,127.7861991468869,0.015223828871578582,0.6195454608810778,0.6043216320094992,550858470,551508212.2,91.80018284494327,86.25293685929157,NaN,NaN,32.29642468341157,32.13529828954285
2014-07-10T09:30:00-04:00,61.04,61.62,60.805,61.49,4726647,6071060.45,60.29365752741691,67.11084910234955,NaN,NaN,48.98522178246366,100.90846235498678,-0.012703007316444581,0.5884428728639435,0.6011458801803881,546131823,550023430.8,88.01655880507236,87.22744062050762,NaN,NaN,30.43828897790659,31.89286838788053
2014-07-11T09:30:00-04:00,61.58,61.675,61.24,61.62,3779770,6044782.75,61.604912868961854,66.59163250600608,NaN,NaN,64.84512429546245,76.98115526533081,-0.026725330516784274,0.5677392170344078,0.594464547551192,549911593,548800886,84.91323726387449,87.76394713500645,NaN,NaN,29.34314258326678,31.52862184436428
2014-07-14T09:30:00-04:00,61.98,61.98,61.67,61.82,4078764,6101174.95,63.59668497922975,66.56352152371402,NaN,NaN,91.83594976647903,67.66383777120612,-0.02676935209721143,0.5610028574296777,0.5877722095268891,553990357,549174159.2,85.08613893647838,88.24215501101047,NaN,NaN,29.0365618219387,31.172613269732054
2014-07-15T09:30:00-04:00,61.86,61.9,61.15,61.29,5498884,5925036.05,55.395624585528154,65.91590933028787,NaN,NaN,42.73953692664858,62.6202003250851,-0.06457561916157017,0.5070526855749264,0.5716283047364966,548491473,549876743.2,85.4247302895667,88.59764219615224,NaN,NaN,26.111975321054132,30.449664991349493
2014-07-16T09:30:00-04:00,61.49,61.53,60.815,61.09,5279219,6002589.05,52.63716375550534,64.59176409437445,NaN,NaN,-4.765739296552536,48.728018694900236,-0.10286165316938178,0.44305123827476933,0.5459128914441511,543212254,548347500,81.10840075045378,88.41264346019389,NaN,NaN,22.84079634295775,29.362683755864957
2014-07-17T09:30:00-04:00,60.85,61.36,60.35,60.42,7322415,6099997.8,44.62110065690711,62.645496044347745,NaN,NaN,-79.20300968710214,23.09037240098708,-0.1692012381153214,0.33441134379999937,0.5036125819153208,535889839,546299103.2,75.59823280902182,87.62413640028915,NaN,NaN,17.148182923320306,27.617755065501434
2014-07-18T09:30:00-04:00,60.64,61.519,60.5,61.4099,8938743,6331244.8,55.42261086513677,61.72372873405476,NaN,NaN,-19.57165472457593,6.207016596979402,-0.14333003061934801,0.3244500436411357,0.46778007426048374,544828582,545282501,72.94947171677411,86.52496580161949,NaN,NaN,15.92405961699772,25.947227144286618
2014-07-21T09:30:00-04:00,61.23,61.258,60.95,61.16,3731885,6296506.4,52.631692632221174,60.96246341528106,NaN,NaN,-30.292811356389624,-18.21873562759433,-0.13981355775645338,0.293013127064917,0.4328266848213704,541096697,542703769,66.57717009939901,84.88026184038476,NaN,NaN,13.98268729018873,24.238007165129776
2014-07-22T09:30:00-04:00,61.47,61.86,61.44,61.69,5640694,6408205.55,57.51778407958845,60.01781763126366,NaN,NaN,64.70184555933403,-13.826273901057238,-0.10040287940566278,0.3073230855642919,0.40772596496995467,546737391,542352952.6,65.73590058517469,83.08870861846889,NaN,NaN,14.119601099536238,22.7925205843307
2014-07-23T09:30:00-04:00,62.15,62.28,61.9,62.19,7265003,6528032.8,61.54752261377337,59.114943251041595,NaN,NaN,141.31826636849448,15.390527231952166,-0.04224607276653314,0.3549183740117883,0.3971644467783214,554002394,544510980.6,68.38256189173006,81.45265438183695,NaN,NaN,15.67074814009734,21.77512452086879
2014-07-24T09:30:00-04:00,62.33,62.4,62,62.06,6107422,5828444.15,59.95511595516521,57.98182541179771,NaN,NaN,127.81656327364179,56.79444182410096,-0.015497072852510285,0.37779310571268354,0.3932901785651938,547894972,546912007.2,71.06091832346394,79.99872750687777,NaN,NaN,16.343870895412614,20.999231145803623
2014-07-25T09:30:00-04:00,61.93,61.95,61.52,61.83,4129327,5473088.85,57.138414855364985,57.261754479067164,NaN,NaN,48.64736390073359,70.43824554916286,-0.016182549917572453,0.37306199116822825,0.3892445410858007,543765645,546699419.8,70.49153610322784,78.49183870497447,NaN,NaN,15.982787426994378,20.282596328830873
2014-07-28T09:30:00-04:00,61.85,62.045,61.56,61.89,7004884,5581290.05,57.69675175376854,57.21048671360317,NaN,NaN,54.03958927466061,87.30472567537291,-0.015483486006757308,0.36989018357735404,0.38537366958411134,550770529,548634186.2,72.64016888647444,77.1275149504039,NaN,NaN,15.865380525597036,19.651565499797467
2014-07-29T09:30:00-04:00,62.08,62.1656,61.82,61.94,5321796,5520350.6,58.18558147155794,57.017472757151786,NaN,NaN,73.49974835121236,89.06430623374857,-0.01455615136221633,0.36717848038134093,0.38173463174355726,556092325,550505173,74.56863551533377,75.89669014114608,NaN,NaN,15.91142467693532,19.117259667960017
2014-07-30T09:30:00-04:00,62.25,62.48,61.87,62.19,7752694,5500453.95,60.634924760337825,57.04184898807471,NaN,NaN,101.26222039753999,81.05309703955767,-0.0007376442816354745,0.3808125763915129,0.38155022067314837,563845019,552473698,76.44948490573111,75.07047057690741,NaN,NaN,16.6566469606352,18.765743566913613
2014-07-31T09:30:00-04:00,61.63,61.76,60.91,60.91,8415797,5719410.6,45.83201241504291,55.91521324136621,NaN,NaN,-74.35812542236033,40.61815930035725,-0.07720293343731466,0.285046553876505,0.3622494873138197,555429222,553980548,77.80279236051432,74.56258165523884,NaN,NaN,12.324528399372237,17.84556997155056
2014-08-01T09:30:00-04:00,60.77,61.27,60.5034,60.96,16923843,6442173.4,46.38266071310456,54.685640079500125,NaN,NaN,-114.35884661443603,8.016917197323323,-0.12119446619631297,0.21075640456842848,0.33195087076474145,572353065,559698032,82.02377981687857,74.34384171812455,NaN,NaN,9.146123726611794,16.602791936559306
2014-08-04T09:30:00-04:00,61.09,61.34,60.6665,61.22,9208914,6707602.8,49.270545225701454,54.24813441094108,NaN,NaN,-77.5122708269899,-18.29345482300678,-0.1288480326219928,0.17089082998725047,0.29973886260924326,581561979,565856322,85.27233026470245,74.33295600206283,NaN,NaN,7.430890778654986,15.292520342572974
2014-08-05T09:30:00-04:00,60.96,61.16,60.43,60.63,10309531,6865807.45,43.53964562723574,53.59831168749325,NaN,NaN,-124.14637965178855,-57.82268042360697,-0.16727579664978198,0.09064411679701578,0.25791991344679777,571252448,568888346.6,86.56011712095193,74.72236431424128,NaN,NaN,4.058482344926776,13.68765777148066
2014-08-06T09:30:00-04:00,60.37,60.85,60.15,60.6,9568213,7050222.25,43.2640851785635,53.50138201046871,NaN,NaN,-137.1716921040651,-105.50946292392798,-0.1868586375352203,0.02434661652777237,0.21120525406299268,561684235,568456189.8,85.41373089907916,75.42347132067393,NaN,NaN,1.3174914890032106,11.920491159698168
2014-08-07T09:30:00-04:00,60.73,60.8,59.71,59.82,10947034,7361241.6,36.75135124611397,52.16772060910994,NaN,NaN,-169.94146711241618,-124.62613126193915,-0.24104064003422265,-0.09009554597978564,0.150945094054437,550737201,567517785.6,82.84790073756348,76.13050196501604,NaN,NaN,-3.3331829459896323,9.741394858885625
2014-08-08T09:30:00-04:00,59.9,60.57,59.701,60.53,5472579,7445882.05,44.884488195227256,51.614348863610374,NaN,NaN,-129.34978072312333,-127.6243180836766,-0.21843071716848622,-0.12209330240617078,0.09633741476231544,556209780,564289128.6,74.5500640221563,76.69999438807012,NaN,NaN,-4.608064556535225,7.691472085254075
2014-08-11T09:30:00-04:00,60.77,60.95,60.47,60.5,4700622,7476974.95,44.62338216208604,50.69332015521735,NaN,NaN,-75.78575524055353,-127.27901496638933,-0.19560157614534304,-0.14816455541936335,0.04743702072597968,551509158,558278564.4,62.083719662801,76.4391243221863,NaN,NaN,-5.676613460118101,5.781745578772336
2014-08-12T09:30:00-04:00,60.44,60.6,60.28,60.45,2878463,7345953.9,44.16227118333057,49.4515164816143,NaN,NaN,-91.80770368100528,-120.81127977223268,-0.17466231244208086,-0.17089086982662138,0.003771442615459468,548630695,553754213.8,54.672559493955056,75.45983843663092,NaN,NaN,-6.665688721249157,4.003540678769266
2014-08-13T09:30:00-04:00,60.69,61.24,60.67,61.18,4751902,7319588.05,51.96641894702384,48.88089526674706,NaN,NaN,-18.454858856590437,-97.06791312273775,-0.10582938951535548,-0.12851529427873487,-0.0226859047633794,553382597,552093886.2,52.20947118226408,74.1133064979738,NaN,NaN,-5.053579473410588,2.7096663713150013
2014-08-14T09:30:00-04:00,61.29,61.9,61.1,61.9,4797399,7193337.25,58.175443817367324,48.954968764032934,NaN,NaN,49.16499569053599,-53.246620562147314,-0.010982954454941657,-0.03641459783205647,-0.025431643377114815,558179996,553582445.2,54.2016018213299,72.94973976355251,NaN,NaN,-1.5283983627950468,2.1042285521564232
2014-08-15T09:30:00-04:00,62.2,62.27,61.39,61.96,7777642,7135282.2,58.65507136334138,49.02342016471671,NaN,NaN,69.75180797170485,-13.426302823181683,0.053101613448390886,0.04094537343337379,-0.012156240015017094,565957638,555532016.8,56.744755309685104,71.81435307949613,NaN,NaN,1.3825418451635043,2.001130451157435
2014-08-18T09:30:00-04:00,62.27,62.525,62.19,62.44,7448758,7321125.85,62.372579233645475,49.32249143343724,NaN,NaN,111.64843316712778,24.060534858354576,0.12122820951486256,0.1393790218785611,0.018150812363698546,573406396,559911464.4,61.867288690593206,70.90711402058608,NaN,NaN,5.070902491874873,2.4396693141170687
2014-08-19T09:30:00-04:00,62.53,62.89,62.31,62.85,3874865,7232834.4,65.24699334461698,49.651924903742916,NaN,NaN,127.45162625727865,67.91240084601137,0.18357342170854868,0.2476175894993844,0.06404416779083572,577281261,565641577.6,67.32047472415785,70.25504186475942,NaN,NaN,9.10219643207786,3.391458902397182
2014-08-20T09:30:00-04:00,62.73,62.949,62.56,62.84,4513780,7095273.25,65.11633544731467,51.02937654890519,NaN,NaN,127.7892732702254,97.16122727137451,0.21180491568644916,0.3288003123988972,0.11699539671244802,572767481,569518554.4,70.4043396440621,69.72658095644141,NaN,NaN,12.254870058166203,4.657660496078471
2014-08-21T09:30:00-04:00,62.93,63.12,62.87,62.93,3125885,6946196.4,65.78050048061432,52.41493653229874,NaN,NaN,134.01887854431362,114.13200384213005,0.223073670549774,0.3958374848996655,0.17276381434989152,575893366,573061228.4,72.9191464522381,69.07625000182422,NaN,NaN,15.032868659002766,6.139833090781941
2014-08-22T09:30:00-04:00,63.03,63.1699,62.844,62.99,3249218,6902190.95,66.2419505074611,53.62717976671014,NaN,NaN,121.16556341717049,124.41475493122319,0.22069682247540695,0.4486348424441502,0.22793801996874324,579142584,575698217.6,74.64610950971667,68.31723423361096,NaN,NaN,17.459321409746238,7.756902850633984
2014-08-25T09:30:00-04:00,63.37,63.6,63.21,63.47,4862977,6795095.6,69.75568864801991,55.499754268194735,NaN,NaN,136.05428044650125,129.29592438709787,0.2361921792451851,0.5231782440252246,0.2869860647800395,584005561,577818050.6,75.97260381321645,67.56098328305842,NaN,NaN,20.673154465115097,9.602081652702715
2014-08-26T09:30:00-04:00,63.56,63.735,63.43,63.7,3603438,6709177.7,71.29733766771471,57.50212944599124,NaN,NaN,131.7309884251416,130.15179682067046,0.24558444985470818,0.5939666270984247,0.34838217724371656,587608999,579883598.2,77.22307615730055,66.97593651578852,NaN,NaN,23.85620164099805,11.638384508173477
2014-08-27T09:30:00-04:00,63.85,63.88,63.56,63.65,4151668,6529126.4,70.45654291553112,59.909643136663895,NaN,NaN,121.39463410763749,128.87286898815287,0.2322303834432809,0.6386701565478177,0.4064397731045368,583457331,582021568.2,78.4719624705746,66.66336949671789,NaN,NaN,26.261324772059165,13.727375974442861
2014-08-28T09:30:00-04:00,63.47,63.77,63.401,63.63,3466762,6281674.65,70.10043464125641,61.71078216852312,NaN,NaN,101.7266081226202,122.41441490381419,0.20670462578002058,0.6648205553295625,0.45811592954954194,579990569,582841008.8,78.94840808450999,66.97753692974315,NaN,NaN,28.172592397504186,15.790978320594478
2014-08-29T09:30:00-04:00,63.73,63.92,63.57,63.86,4139087,5642436.85,71.86176229088613,63.6563807491517,NaN,NaN,99.86728112681256,118.1547584457426,0.19037128454119212,0.6960800352260321,0.50570875068484,584129656,583838423.2,79.54190294931075,68.2245500216367,NaN,NaN,30.32587393332428,17.86739197955588
2014-09-02T09:30:00-04:00,63.99,64.05,63.655,63.83,5076754,5435828.85,71.27200629627856,65.59279040007655,NaN,NaN,93.10987169630148,109.56587669570266,0.16362930530959185,0.7102453823218298,0.5466160770122379,579052902,582847891.4,77.21378834177708,69.83463779648113,NaN,NaN,31.990874369280487,19.885032320945108
2014-09-03T09:30:00-04:00,64.23,64.41,63.97,64.12,5421859,5191445.25,73.53319805860879,67.13327462233262,NaN,NaN,101.74489904145823,103.56865881896599,0.1518139603093408,0.7363835273989139,0.5845695670895731,584474761,582221043.8,75.70369536883877,71.51279666695076,NaN,NaN,34.09240564306311,21.91465708124768
2014-09-04T09:30:00-04:00,64.26,64.42,63.6695,63.8,6231386,5024603.9,67.24364204641776,67.7810030672648,NaN,NaN,84.38436745426216,96.16660548829093,0.11069893072406145,0.7229432304946499,0.6122442997705885,578243375,581178252.6,73.14104099557183,72.86561375082518,NaN,NaN,34.262619358688404,23.67865169231064
2014-09-05T09:30:00-04:00,63.82,64.18,63.1529,64.17,6349371,4794720.75,70.39657623522204,68.61968198668485,NaN,NaN,73.08757310732504,90.4387984852319,0.09715662703929895,0.7336900835697122,0.6365334565304133,584592746,582098688,73.97835497928304,74.09658515579646,NaN,NaN,35.305049366542555,25.339565645772343
2014-09-08T09:30:00-04:00,64.05,64.3,63.93,64.18,7204787,4881331.15,70.47928074493143,69.19873209463385,NaN,NaN,88.12457795244669,88.09025785035871,0.07841048513312376,0.734546562946818,0.6561360778136942,591797533,583632263.4,75.35680999207817,75.06012239161682,NaN,NaN,36.184399222618296,26.888827585321764
2014-09-09T09:30:00-04:00,64.27,64.29,63.85,64.01,6667272,4979663.65,67.04987533332599,69.32750937954164,NaN,NaN,77.67405747217597,85.00309500553361,0.04571948913651125,0.7132854392343333,0.667565950097822,585130261,584847735.2,76.42285020878879,75.71029206909044,NaN,NaN,36.01318164580959,28.192306736820026
2014-09-10T09:30:00-04:00,64.1,64.54,63.97,64.46,7039628,5187721.9,71.06362080185568,69.75231547629457,NaN,NaN,95.46659072681584,83.74743334260513,0.045464592385288216,0.7243966905794323,0.6789320981941441,592169889,586386760.8,77.73614627460287,76.2339925427005,NaN,NaN,37.00328525542868,29.45101795376412
2014-09-11T09:30:00-04:00,64.21,64.37,63.96,64.28,6360282,5268140.9,67.52059975544914,69.87660828163992,NaN,NaN,82.96545973173772,83.46365179810024,0.025244625150584343,0.7104878796323746,0.6852432544817902,585809607,587900007.2,78.97617450545654,76.66663740364469,NaN,NaN,36.82538131519401,30.50449843396839
2014-09-12T09:30:00-04:00,64.25,64.28,63.625,63.81,7340348,5395288.35,59.21840121881786,69.37492618959396,NaN,NaN,47.861017026023205,78.41834058183989,-0.024993757495417546,0.6540010576125184,0.6789948151079359,578469259,586675309.8,75.31985180162495,76.71476185306672,NaN,NaN,34.11785452200827,31.02069216083123
2014-09-15T09:30:00-04:00,63.81,63.88,63.42,63.64,6082501,5310531.3,56.51175576446419,68.42893098362569,NaN,NaN,6.920247570284345,62.1774745054074,-0.07221125736023293,0.5887307434076448,0.6609420007678777,572386758,582793154.8,65.0405955269786,75.93390411833543,NaN,NaN,31.04089246327351,31.023577918322985
2014-09-16T09:30:00-04:00,63.55,64.56,63.47,64.51,6907896,5283488.2,65.2622308425812,67.99785192468762,NaN,NaN,85.91001574159623,63.82466615929145,-0.04852515262316148,0.6002855599889259,0.6488107126120873,579294654,581626033.4,62.288351617850694,74.8671380798033,NaN,NaN,30.99938781677734,31.02012218953075
2014-09-17T09:30:00-04:00,64.47,64.81,64.09,64.56,6704292,5424959.55,65.68952011120986,67.65735029580752,NaN,NaN,134.29877826248037,71.59110366642437,-0.033859592594494115,0.6064862218689697,0.6403458144634638,585998946,580391844.8,59.424703725590525,73.50661959801872,NaN,NaN,31.10248207587054,31.03188788757929
2014-09-18T09:30:00-04:00,64.77,65.07,64.65,65.04,5460682,5472304.65,69.5604412991956,67.6187793428032,NaN,NaN,199.21995298479627,94.84200231703609,0.0019020401797560371,0.6427233646881589,0.6408213245084029,591459628,581521849,61.18426270768844,72.23775207110289,NaN,NaN,32.46241763253111,31.236249279715263
2014-09-19T09:30:00-04:00,65.16,65.31,64.79,64.88,6833544,5657687.6,66.85292320706523,67.26100512253026,NaN,NaN,188.18940667160112,122.90768024615167,0.008163958791156944,0.651026272997349,0.6428623142061921,584626084,582753214,63.06394342949388,71.06075496254455,NaN,NaN,32.70407203363085,31.44593824456035
2014-09-22T09:30:00-04:00,64.74,64.8,64.2849,64.53,4005694,5695511.4,61.237775437910955,66.54427434693258,NaN,NaN,93.87248215087713,140.29812716227022,-0.01653619549006846,0.6221920698436065,0.638728265333675,580620390,584399940.4,65.47200161451397,70.22205591059723,NaN,NaN,31.115384261695006,31.398716247008156
2014-09-23T09:30:00-04:00,63.93,64.43,63.83,64.15,7833909,5844058,55.76161266274903,65.27487539008546,NaN,NaN,7.626132363194748,124.64135048658993,-0.06122479490293775,0.5621972717050028,0.6234220666079405,572786481,583098305.8,62.029553339681804,69.24533147994316,NaN,NaN,27.985619871360228,30.911131050487025
2014-09-24T09:30:00-04:00,64.31,65.27,64.29,65.27,8120933,6069932.75,65.54217654225506,65.15334213978811,NaN,NaN,159.2544535896738,129.6324855520286,-0.020233074839589693,0.5981307230584534,0.6183637978980431,580907414,582079999.4,59.39831608059323,68.26370827173041,NaN,NaN,28.56914665504324,30.576561851137914
2014-09-25T09:30:00-04:00,65.19,65.21,64.2,64.2,11661538,6445426.25,53.39636043534671,63.93904101122559,NaN,NaN,66.58763040009387,103.10602103508813,-0.0674020126238829,0.5341112821181895,0.6015132947420724,569245876,577637249,49.52725689338338,66.51720126559472,NaN,NaN,24.23248670705934,29.670265401983833
2014-09-26T09:30:00-04:00,64.5,64.5,63.85,64.4,6513229,6597749.6,55.07227238065073,62.83854041377697,NaN,NaN,1.7194130352458836,65.81202230781709,-0.08615361326046345,0.493821278166493,0.5799748914269565,575759105,575863853.2,46.22504164641408,64.43636066947586,NaN,NaN,21.612514310309315,28.519158103173186
2014-09-29T09:30:00-04:00,63.86,64.48,63.81,64.26,10284128,6905001.65,53.61872051961159,61.87917221279737,NaN,NaN,-18.070003728819508,43.42352513187776,-0.10761243180355051,0.44545935167251827,0.5530717834760688,565474977,572834770.6,41.175104864982316,61.918664573489686,NaN,NaN,19.108143031045422,27.174727378583505
2014-09-30T09:30:00-04:00,64.39,64.51,63.86,63.91,7581741,7030251,50.06138302071544,60.37901237128735,NaN,NaN,-42.84011232215519,33.33027619480778,-0.14279961425772691,0.3745722656539101,0.517371879911637,557893236,569856121.6,36.9054565067245,59.00218673292694,NaN,NaN,15.874426609558888,25.560398697294275
2014-10-01T09:30:00-04:00,64.1,64.1,63.03,63.24,11141664,7316241.25,44.03815650168501,58.70169499601848,NaN,NaN,-169.38154589350694,-32.39692370182838,-0.20484308221583192,0.26131802714184715,0.46616110935767907,546751572,563024953.2,29.380873416807432,55.45966522659487,NaN,NaN,11.001506019426433,23.480556886170298
2014-10-02T09:30:00-04:00,63.24,63.39,62.565,63.11,7225190,7365931.45,42.95815294515258,57.54024869075668,NaN,NaN,-225.0161589223965,-90.71768156632645,-0.24553871124134696,0.15923772030599537,0.40477643154734233,539526382,557081054.4,24.667989764358026,51.8416750810758,NaN,NaN,6.8392031212679,21.103220634041385
2014-10-03T09:30:00-04:00,63.64,64.4866,63.6,64.41,11383129,7617619.35,54.87579423551654,57.42339429583184,NaN,NaN,-8.623946454305248,-92.78635346423667,-0.17890170463088173,0.18114930075874014,0.36005100538962187,550909511,552111135.6,21.55465599504582,48.735536543080606,NaN,NaN,7.298949624784385,19.131181918433242
2014-10-06T09:30:00-04:00,64.69,64.91,63.85,64.11,8287494,7671754.7,52.16712355878824,56.488029489846625,NaN,NaN,14.750272081483487,-86.22229830217607,-0.15018441231673052,0.17232048999370875,0.32250490231043927,542622017,547540543.6,19.1597444364064,45.65492174440601,NaN,NaN,6.710298545359174,17.35677000799409
2014-10-07T09:30:00-04:00,63.98,64.01,63.09,63.09,11281754,7902478.8,44.18195766978718,54.95177502974501,NaN,NaN,-143.72957413741702,-106.40019066522844,-0.19234628750663002,0.08207204292715176,0.2744183304337818,531340263,542229949,16.821128569009204,42.61180923322163,NaN,NaN,3.2501154439773963,15.341533641705992
2014-10-08T09:30:00-04:00,63.22,64.75,63.055,64.7,11412295,8121112.15,55.706789565946025,53.96222847737004,NaN,NaN,-1.3813703720028858,-72.80015556092762,-0.10844480462640668,0.13886232465077342,0.2473071292771801,542752558,541430146.2,16.494589503166026,39.419689718612894,NaN,NaN,4.842433471181808,13.841662188773965
2014-10-09T09:30:00-04:00,64.6,64.665,63.32,63.36,15686362,8587416.15,47.00738215241572,52.54468983060936,NaN,NaN,-65.45676282726019,-40.888276341900365,-0.1379424461503773,0.07487907158920848,0.21282151773958577,527066196,538938109,15.485866748230436,36.02125566995121,NaN,NaN,2.5232893357653157,12.2247517812013
2014-10-10T09:30:00-04:00,63.29,64.06,62.97,62.97,15607184,9000757.95,44.813877525140924,51.3715542654115,NaN,NaN,-127.26882333228284,-64.61725171749588,-0.17602896746910338,-0.007214691596793443,0.16881427587230993,511459012,531048009.2,12.813934382837829,32.259965153402916,NaN,NaN,-0.03284213932822398,10.47366693541137
2014-10-13T09:30:00-04:00,63,63.03,61.41,61.48,17939415,9593603.65,37.595847099261924,50.073999582305284,NaN,NaN,-260.6923082576574,-119.70576778532407,-0.28730049844197847,-0.19031134718016318,0.09698915126181532,493519597,521227525.2,10.407061549505684,28.57264431124748,NaN,NaN,-5.095637097133406,8.24948064504783
2014-10-14T09:30:00-04:00,61.85,62.06,60.6,61.02,19320985,10214258.1,35.68490730237026,47.94133749374208,NaN,NaN,-251.4678375594398,-141.2534204697286,-0.3722229284326879,-0.3682895092790446,0.003933419153643342,474198612,509799195,8.424046627383944,24.931625064589678,NaN,NaN,-9.615022764464626,5.697408729403193
2014-10-15T09:30:00-04:00,60.33,60.79,59.205,60.52,32120124,11485049.7,33.680950630935456,46.53309393628414,NaN,NaN,-254.89962732520252,-191.95707186036856,-0.4378828134927602,-0.5434200977123069,-0.10553728421954671,442078488,489664381,6.187179828517131,21.83590527424209,NaN,NaN,-13.836821183401943,2.9068044561453164
2014-10-16T09:30:00-04:00,59.7,60.915,59.45,60.21,30185004,12721265.8,32.46370503792721,44.918196268946744,NaN,NaN,-200.98697234627713,-219.06311376417193,-0.4749039292632665,-0.6991671957986298,-0.22426326653536335,411893484,466629838.6,4.662033796049613,18.867118999216054,NaN,NaN,-17.529565189405925,-0.012676921790575335
2014-10-17T09:30:00-04:00,60.79,61.56,60.645,61.17,15704741,13164825.65,39.72815264129684,43.926012849067114,NaN,NaN,-120.16204950957378,-217.6417589996301,-0.4099032760386335,-0.7366423615836553,-0.32673908554502173,427598225,449857681.2,3.9068692514122887,16.205102169675335,NaN,NaN,-18.143844988492297,-2.6028437884622497
2014-10-20T09:30:00-04:00,60.97,61.96,60.97,61.91,9854756,13457278.75,44.66876622779675,43.54082593528721,NaN,NaN,-80.10419498271199,-181.52413634464105,-0.2974704297073628,-0.6985771226792252,-0.4011066929718624,437452981,438644358,3.4988155548941933,13.81891353025888,NaN,NaN,-16.956207095279485,-4.653324260864712
2014-10-21T09:30:00-04:00,62.43,63.59,62.37,63.55,14962042,13813685.4,53.72259357389219,44.232571440444865,NaN,NaN,6.379224702233539,-129.9547238923064,-0.10308802652501409,-0.52996672612813,-0.4268786996031159,452415023,434287640.2,3.3523137836518373,11.959730699319193,NaN,NaN,-12.575497653303156,-5.785063316927347
2014-10-22T09:30:00-04:00,63.57,63.73,63.05,63.23,13813756,14098326.55,51.93681351677747,44.87390433841807,NaN,NaN,20.928055514008157,-74.78918732446424,0.0076212618707307,-0.41735212226470253,-0.42497338413543323,438601267,433592196,3.3283564106135373,10.435471174051727,NaN,NaN,-9.807279165266111,-6.359665580975742
2014-10-23T09:30:00-04:00,63.73,64.66,63.73,64.31,11165017,14073500.5,57.117736744026246,45.03404308902591,NaN,NaN,74.17119677786408,-19.757553499635996,0.14940965804701062,-0.23821131157666997,-0.3876209696236806,449766284,441166756,10.805129742812397,9.667647870320772,NaN,NaN,-5.663436907832039,-6.2602043419552125
2014-10-24T09:30:00-04:00,64.49,65.24,64.35,65.21,9703455,14233011.8,60.90018294255019,45.65783304500891,NaN,NaN,110.94285904358976,26.46342821099671,0.291417340535649,-0.023349293954119332,-0.3147666344897683,459469739,447541058.8,16.647558193596936,9.48820599583438,NaN,NaN,-0.9354896594673572,-5.499530815885519
2014-10-27T09:30:00-04:00,65.22,65.35,64.99,65.28,9110783,14174344.55,61.1869393727642,46.87247459522155,NaN,NaN,120.24606930415179,66.53348106836947,0.37248533002856193,0.1508400280459341,-0.22164530198262783,468580522,453766567,22.019905542152202,9.859547208201734,NaN,NaN,2.7995648427627606,-4.313945721792908
2014-10-28T09:30:00-04:00,65.8,65.8,65.18,65.76,8770851,14233800.05,63.18099978714311,47.40634675387849,NaN,NaN,131.18020469041784,91.49367706600631,0.4364240553341474,0.32388476718505643,-0.11253928814909096,477351373,458753837,26.127623192611026,10.54762104316209,NaN,NaN,6.493907527046794,-2.769966686244379
2014-10-29T09:30:00-04:00,65.74,65.975,65.35,65.79,10162376,14184835.65,63.30788117296254,48.57066811248898,NaN,NaN,123.47844432287599,112.00375482777989,0.456562068642288,0.45816329765376906,0.001601229011481048,487513749,468536333.4,33.524523811067766,11.836096547650472,NaN,NaN,9.471956259358747,-1.0211205511582182
2014-10-30T09:30:00-04:00,65.69,67.04,65.63,67,11630631,14405107.7,68.08503373143277,50.23289355579554,NaN,NaN,144.35970379743696,126.04145623169447,0.5224552222945219,0.6546702568796334,0.13221503458511152,499144380,478411952.6,40.05059640133577,13.781572406114615,NaN,NaN,13.67160063241759,1.0778396179240397
2014-10-31T09:30:00-04:00,67.86,67.99,67.05,67.27,11388664,14405384.45,69.05325446948184,52.479851225096965,NaN,NaN,159.28978638642883,135.71084170026228,0.5523931983703083,0.822706532547997,0.27031333417768866,510533044,488624613.6,45.95903593460177,16.32099914790719,NaN,NaN,17.385558292193327,3.407513714248224
2014-11-03T09:30:00-05:00,67.37,67.46,66.87,67.35,8681072,14425063.35,69.34995749711118,54.88449766757846,NaN,NaN,132.5525014955457,138.17212813854107,0.5448413955705727,0.9513650786409045,0.4065236830703318,519214116,498751332.4,51.105001581770594,19.369638787506236,NaN,NaN,20.48404374067776,5.847018003738157
2014-11-04T09:30:00-05:00,67.33,67.54,66.95,67.36,5716005,14146775.9,69.38946436677755,57.43510579156718,NaN,NaN,117.01672163397681,135.33943152725286,0.5084785634330622,1.0421218873616596,0.5336433239285974,524930121,508267082,55.402477629532136,22.88501720186445,NaN,NaN,23.03292495620913,8.302147568376867
2014-11-05T09:30:00-05:00,67.97,67.99,67.13,67.29,6592084,13905765.35,68.7217077422587,60.02496312759086,NaN,NaN,108.44355644355798,132.33245395138925,0.4496993974102935,1.0957675706914642,0.6460681732811707,518338037,514431939.6,57.97925838719043,26.693390386945936,NaN,NaN,24.99474418034878,10.686804227229997
2014-11-06T09:30:00-05:00,67.38,67.85,67.38,67.7,7962369,13519565.7,70.5116757291589,62.22378620529529,NaN,NaN,100.67164179104569,123.594841550111,0.4095589313366259,1.158016837451953,0.7484579061153271,526300406,519863144.8,60.163047468451985,30.7116888310202,NaN,NaN,27.194170332918528,13.044999385185502
2014-11-07T09:30:00-05:00,67.7,67.76,66.82,67.03,13895564,13433984.7,64.06010441691619,63.60888179023239,NaN,NaN,78.92007145738536,107.5208985643023,0.3133485262871373,1.1401435639742488,0.8267950376871115,512404842,520237504.4,60.31613449681398,34.77006875544304,NaN,NaN,27.422080866944913,15.09886816829399
2014-11-10T09:30:00-05:00,67.18,67.7351,66.92,67.71,5455262,12809777.05,67.32752673259279,64.58066273013958,NaN,NaN,79.29750030065556,96.86989832532427,0.27247773963422994,1.167392212229899,0.894914472595669,517860104,519966702,60.136108252433004,38.8260540746417,NaN,NaN,28.54354479103541,17.019536257257048
2014-11-11T09:30:00-05:00,67.86,68.21,67.69,67.96,9777484,12332602,68.46271663519232,65.76108438145492,NaN,NaN,87.93718883510954,91.05399176555082,0.2403726405310438,1.1953802732594738,0.95500763272843,527637588,520508195.4,60.390688646498305,42.90193494863347,NaN,NaN,29.80350857119401,18.8458180163909
2014-11-12T09:30:00-05:00,67.7,67.97,67.59,67.86,3879944,10920593,67.45315359764069,66.49932844242738,NaN,NaN,78.96258511401145,85.15779749964152,0.19256066670425986,1.195708466108755,1.003147799404495,523757644,521592116.8,60.928579020556455,46.48218132561518,NaN,NaN,30.585687774960135,20.522942267615075
2014-11-13T09:30:00-05:00,67.96,68.2,67.49,67.81,5216636,9672174.6,66.92177816303237,66.92944238674754,NaN,NaN,75.37051533330231,80.09757220809286,0.14016230924742645,1.1783506859637782,1.0381883767163518,518541008,520040237.2,59.67900222755822,49.55585589946956,NaN,NaN,31.105144182730367,22.034685398345832
2014-11-14T09:30:00-05:00,67.79,67.79,66.98,67.25,6331845,9203529.8,61.114822927004205,66.92429121205039,NaN,NaN,51.48928496678122,74.61141490997201,0.05476963706467797,1.1066504230471992,1.0518807859825212,512209163,520001101.4,59.64578047782859,52.243418394875015,NaN,NaN,30.011691490277325,23.174257697193188
2014-11-17T09:30:00-05:00,67.11,67.76,67.11,67.58,8587202,9140152.1,63.144353669479464,66.92167363221728,NaN,NaN,53.627666628829004,69.47744817560671,0.009846082314423077,1.0641883888755501,1.054342306561127,520796365,520588353.6,60.00555938263383,54.66327097987665,NaN,NaN,29.597034951821083,24.091797304997172
2014-11-18T09:30:00-05:00,67.63,68.72,67.57,68.67,8240094,8804054.7,68.91539458671899,67.32221030462846,NaN,NaN,95.12882269738132,70.91577494806106,0.041121736614603055,1.105744477329381,1.064622740714778,529036459,520868127.8,60.18766864980518,56.56778132550075,NaN,NaN,30.90196648878069,25.064678616966248
2014-11-19T09:30:00-05:00,68.59,68.63,68.1102,68.29,6253619,8426047.85,65.08891886853822,67.10820210013598,NaN,NaN,97.84831068671653,74.69292006260208,0.024612366876832326,1.0953881993108183,1.070775832433986,522782840,520673167,59.982702206239814,57.99150316870818,NaN,NaN,30.875833560818943,25.894843608945205
2014-11-20T09:30:00-05:00,67.99,68.27,67.775,68,9041595,8319876.75,62.24832297467458,66.62213556479261,NaN,NaN,75.61079117502035,74.74097523094568,-0.015294788555165528,1.0516573467400292,1.0669521352951947,513741245,519713214.4,58.91876486293864,58.91719809216081,NaN,NaN,30.02689712768896,26.48513696876574
2014-11-21T09:30:00-05:00,68.68,68.82,68.13,68.32,8098686,8239638.3,64.1096258432053,66.24782616094218,NaN,NaN,114.8449775654785,87.41211375068515,-0.028811588892959872,1.0309376491789948,1.0597492380719546,521839931,521639368,60.43520327055654,59.58364106993124,NaN,NaN,29.83373760534242,26.963508488276695
2014-11-24T09:30:00-05:00,68.59,68.68,68.45,68.67,5020069,8035102.6,66.07953133648948,66.01140237306446,NaN,NaN,133.26853466346165,103.34028735761167,-0.023098655561099246,1.0308759186205805,1.0539745741816797,526860000,522852095,61.40127865073461,60.01212685715999,NaN,NaN,30.22682228173057,27.42969617305582
2014-11-25T09:30:00-05:00,68.81,68.97,68.485,68.76,5510248,7872072.45,66.58738319239237,65.85895061950258,NaN,NaN,139.01635810980272,112.11779444009596,-0.022172325196561093,1.0262591676859785,1.0484314928825396,532370248,523518852.8,61.951365038073355,60.29584876079448,NaN,NaN,30.69191885473373,27.895727984724093
2014-11-26T09:30:00-05:00,68.99,69.21,68.72,69.18,5325907,7630249,68.92552308081198,65.74565400176353,NaN,NaN,164.1729848293995,125.38272926863256,-0.0031843403344826715,1.0444510674644363,1.047635407798919,537696155,526501515.8,64.39580784898479,60.598188787975396,NaN,NaN,31.75080024559427,28.44645259341983
2014-11-28T09:30:00-05:00,69.25,69.99,69.25,69.61,4395483,7268491.6,71.15134026401114,66.25217084798459,NaN,NaN,204.2745685569922,151.11548474502692,0.02677439250556035,1.0811033984308693,1.054329005925309,542091638,532171594.4,68.53434748289942,61.18520400126721,NaN,NaN,33.30908476922526,29.141114332820607
2014-12-01T09:30:00-05:00,69.36,69.94,69.27,69.44,8537446,7125930.7,69.045684598294,66.3748964098204,NaN,NaN,162.28784406598345,160.60405804512794,0.023687268812536022,1.0839380919409791,1.060250823128443,533554192,534514446.6,70.08181561062143,61.89561166970924,NaN,NaN,34.039685114684666,29.840910158801186
2014-12-02T09:30:00-05:00,69.69,70.31,69.69,70.21,7444845,7064119.35,72.95041741847648,66.69544646576927,NaN,NaN,182.02165141500925,170.35468139543747,0.059984090485953656,1.1352309362358852,1.0752468457499316,540999037,537342254,71.87943845195699,62.71623665581343,NaN,NaN,35.86524000459155,30.70152870819981
2014-12-03T09:30:00-05:00,70.37,70.4272,70.05,70.32,6576989,7107168.55,73.46537297681188,67.12489070713863,NaN,NaN,171.05432293628675,176.76227436073424,0.07680689275607522,1.1712554616950257,1.0944485689389505,547576026,540383409.6,73.70898787845462,63.62912300280617,NaN,NaN,37.51603634609305,31.675029799327415
2014-12-04T09:30:00-05:00,70.2,70.61,69.96,70.23,4235366,6989332.65,72.25337518272885,67.50571906568837,NaN,NaN,144.5102253165135,172.82972245815705,0.06760328663672821,1.1789526772348609,1.1113493905981326,543340660,541512310.6,74.37545423828077,64.67886957500063,NaN,NaN,38.558155326041565,32.65833344600087
2014-12-05T09:30:00-05:00,70.28,70.849,70.21,70.79,8325072,7007467.8,75.01536659558015,68.49861504201523,NaN,NaN,146.12191448476642,161.1991916437119,0.08389670011170236,1.2162202657377605,1.1323235656260582,551665732,543427129.4,75.5094862941019,65.81199141902016,NaN,NaN,40.287491650142265,33.748213189449636
2014-12-08T09:30:00-05:00,70.7,71.4263,70.7,71.04,5942764,6609827.8,76.15645590472334,69.42805091596122,NaN,NaN,151.33626403345534,159.0088756372063,0.09534233051750318,1.251501478772937,1.1561591482554339,557608496,548237990.2,78.12844477022941,67.10648323241983,NaN,NaN,42.08213492479171,34.93877343735565
2014-12-09T09:30:00-05:00,70.22,70.81,69.81,70.74,9776261,6825877.75,71.91207451290728,69.64209948211753,NaN,NaN,97.33974727125425,142.0724948084553,0.06783244599708338,1.2409497057517882,1.1731172597547048,547832235,549604629.8,78.82130526801984,68.43745727657803,NaN,NaN,42.42730801465531,36.0085640912556
2014-12-10T09:30:00-05:00,70.69,70.73,69.6,69.65,9011217,6787564.4,59.03767822615943,69.2098680076619,NaN,NaN,59.74144638807043,119.80991949881204,-0.03322244526232265,1.1315892031768016,1.1648116484391242,538821018,547853628.2,75.52029380666038,69.54728524803666,NaN,NaN,38.64549837131114,36.385268988406395
2014-12-11T09:30:00-05:00,69.91,70.67,69.69,69.85,7383296,6962732,60.437264109843206,69.08050666017394,NaN,NaN,58.20894769497913,102.54966397450517,-0.0926759505593262,1.0489667102399665,1.1416426607992927,546204314,548426359,75.8761695252829,70.7585284382041,NaN,NaN,35.9846118402172,36.3280322529508
2014-12-12T09:30:00-05:00,69.46,69.86,68.72,68.78,10438571,7223828.75,50.49659632483125,68.10814740886151,NaN,NaN,-10.70830253978555,71.18362056959475,-0.20377506790862365,0.886923825913513,1.0906988938221367,535765743,545246361.2,69.80799215177319,71.428013358291,NaN,NaN,30.15699802087636,35.44645593408302
2014-12-15T09:30:00-05:00,69.19,69.21,67.91,68.15,17776209,7796046.95,45.727563811806434,66.65443544281273,NaN,NaN,-68.72972857698475,27.170422047506747,-0.3128764383575122,0.6996033458752464,1.0124797842327586,517989534,537322568.8,57.473729301234734,71.14747411904101,NaN,NaN,23.617295530368164,33.75657587640947
2014-12-16T09:30:00-05:00,67.86,69.02,67.32,67.36,14735628,8103468.25,40.55523289698267,64.79499613599775,NaN,NaN,-112.99654551513677,-14.896836509771456,-0.42450410315101905,0.4818496552939848,0.9063537584450039,503253906,528406903,47.338608762998845,70.10370581367854,NaN,NaN,16.224279898416498,31.251962165267617
2014-12-17T09:30:00-05:00,67.44,68.785,67.31,68.62,17776237,8580275.4,50.22558970314007,63.45928660902117,NaN,NaN,-85.78812878922109,-44.00275154522977,-0.4000697521071942,0.40626656831101116,0.8063363204182054,521030143,524848728,44.00353593149323,68.64711496242914,NaN,NaN,13.23247546562085,28.677749779603793
2014-12-18T09:30:00-05:00,69.43,70.51,69.28,70.5,16048093,9069999.1,60.540254821419246,62.701351934550324,NaN,NaN,53.416213106114256,-44.96129846300274,-0.2511564630955786,0.4923907415487321,0.7435472046443107,537078236,523023512.4,42.35511818446806,66.77717001254119,NaN,NaN,14.751248681876039,26.68824962278554
2014-12-19T09:30:00-05:00,70.5,70.93,70.02,70.41,17821989,9509018.8,59.900302865335426,62.04811038219615,NaN,NaN,76.13883624622825,-27.591870705799987,-0.1571768293387399,0.5470761679708858,0.7042529973096257,519256247,519721613.2,39.47422200691789,64.59091332656236,NaN,NaN,15.617362249012794,25.10669428367515
2014-12-22T09:30:00-05:00,70,70.12,69.39,69.74,9896619,9598915.45,55.220570742163886,60.781692762459535,NaN,NaN,12.232241805955546,-11.399476629211925,-0.13921112137593517,0.5302390955897067,0.6694502169656419,509359628,517995632,38.018515582360045,62.172275978734014,NaN,NaN,14.632123726470258,23.61032706121731
2014-12-23T09:30:00-05:00,69.9,69.95,67.78,68.14,22190387,10457431.35,45.98191307099435,58.81858848347257,NaN,NaN,-90.66970863633962,-6.934109253452495,-0.2288643986099932,0.3833697187031504,0.6122341173131436,487169241,514778699,35.398321131669775,59.43579978253509,NaN,NaN,10.237291578227659,21.699893420790215
2014-12-24T09:30:00-05:00,68.19,69.025,68.13,68.64,4519110,10407874.45,48.86125194553274,57.147722537958565,NaN,NaN,-91.26554487902038,-8.029592471412354,-0.24673267562557766,0.30381827278117157,0.5505509484067492,491688351,508910340.6,31.177140438407093,56.35020593968698,NaN,NaN,7.897403545746422,19.728109152926816
2014-12-26T09:30:00-05:00,68.91,69.32,68.87,69.13,4242831,10353720.65,51.58486547783324,55.47411531526236,NaN,NaN,-45.978706350285336,-27.908576362692276,-0.21874664356523488,0.27711764395020566,0.49586428751544054,495931182,500680929.8,26.41930457374906,52.8437643882332,NaN,NaN,7.004246632686501,17.9104145071782
2014-12-29T09:30:00-05:00,69.06,69.47,68.98,69.37,5225880,10395240.5,52.90781738325661,53.813498278014734,NaN,NaN,-28.57601185965167,-48.85154598386826,-0.17894294107284925,0.272185611174379,0.45112855224722825,501157062,497061092.8,24.638208835526214,49.023033250040115,NaN,NaN,6.739738181566127,16.31460360351933
2014-12-30T09:30:00-05:00,69.26,69.42,68.99,69.07,4965135,10216624.95,51.030709572644504,52.321972210853104,NaN,NaN,-35.85956646533389,-58.46990763812617,-0.16787241885953258,0.24128802867281252,0.4091604475323451,496191927,494427552.6,23.402101017742055,45.06451866073456,NaN,NaN,5.939862294429729,14.832497702220817
2014-12-31T09:30:00-05:00,69.27,69.66,68.37,68.38,7863590,10237562.2,46.90847060969632,51.4556002382486,NaN,NaN,-60.01725747089768,-52.339417405037786,-0.19989790614772696,0.15928806484768643,0.3591859709954134,488328337,494659371.8,23.764675809856485,41.36768880381999,NaN,NaN,3.9643360744872096,13.27990318397316
2015-01-02T09:30:00-05:00,68.71,69.3501,68.35,68.63,7516770,10284551.25,48.53074763528546,50.605134775780186,NaN,NaN,-56.56554785230744,-45.3994179996952,-0.19681209656788595,0.11317085028555596,0.3099829468534419,495845107,495490723,25.13331558725217,37.743199236817794,NaN,NaN,2.8506380624843333,11.790008166617612
2015-01-05T09:30:00-05:00,68.32,68.875,68.15,68.28,10784758,10612020.85,46.39343040493502,50.31205149578759,NaN,NaN,-78.89095746750424,-51.98186822313899,-0.20972299327875443,0.0478292052549989,0.25755219853375333,485060349,493316556.4,23.923681826478045,34.46574849929671,NaN,NaN,1.2923837525559505,10.290347536037375
2015-01-06T09:30:00-05:00,68.51,69.09,67.63,68.05,13344507,10862992.6,44.991185355219926,50.259453034602835,NaN,NaN,-88.70158044915524,-64.0069819410397,-0.2238473842627129,-0.022257031794637783,0.2015903524680751,471715842,487428312.4,20.97883242099317,31.858970150708025,NaN,NaN,-0.4012811940622477,8.762972003166
2015-01-07T09:30:00-05:00,68.51,69.67,68.36,69.65,14146442,11273176.5,55.14740022318602,51.301750700760216,NaN,NaN,9.488651849304151,-54.93733827811209,-0.12069542777819714,0.050721067745328696,0.17141649552352584,485862284,485362383.8,20.0464650492208,29.909531314009598,NaN,NaN,1.2508791961893777,7.689815887883626
2015-01-08T09:30:00-05:00,70.34,70.92,70.22,70.84,22138371,11891282,60.9257277391511,52.066046274761,NaN,NaN,158.7370255460939,-11.186481674713777,0.024665522398542222,0.20224839852170362,0.1775828761231614,508000655,489296847.4,26.72549729254787,28.67538569694207,NaN,NaN,4.671311509338929,7.2586009766629545
2015-01-09T09:30:00-05:00,70.9,70.98,69.97,70.21,9724348,11926938.55,56.756922165160056,51.795808227885345,NaN,NaN,123.60555836151383,24.84773956805048,0.07265782502861906,0.2684051574089352,0.19574733238031616,498276307,489783087.4,27.531203580705238,27.616534653816156,NaN,NaN,6.099125691797674,7.092961650253629
2015-01-12T09:30:00-05:00,70.75,70.996,70.05,70.24,11972057,12156376.6,56.90812908069753,51.58208152898264,NaN,NaN,122.05065807176669,65.03606267590467,0.09905956615247496,0.31957179007090986,0.2205122239184349,510248364,494820690.4,35.45030666580773,27.329112129451143,NaN,NaN,7.261009487548602,7.116968484152911
2015-01-13T09:30:00-05:00,70.9,71.29,69.34,69.93,14219779,12345437,54.776675636584734,51.55037473572698,NaN,NaN,86.26974833937098,100.03032843360991,0.08862095621943689,0.331288419192731,0.2426674629732941,496028585,499683239,42.0347268020661,27.615984359430147,NaN,NaN,7.581987292546325,7.183399742494827
2015-01-14T09:30:00-05:00,69.26,69.995,69.07,69.82,12547964,12084024.75,54.00374399277874,52.123362658711585,NaN,NaN,30.475333602662513,104.22766478428159,0.068200284819949,0.32791781899823036,0.25971753417828136,483480621,499206906.4,41.58720508132427,28.058047498691188,NaN,NaN,7.62367327906447,7.246295962004776
2015-01-15T09:30:00-05:00,70.08,70.21,69.0301,69.07,16382777,12166382.2,48.933752837825395,52.128541293875344,NaN,NaN,6.066717833369231,73.69360324173665,0.0015947889283644545,0.26171102033873694,0.2601162314103725,467097844,491026344.2,34.74553112842638,28.312932547978274,NaN,NaN,6.169372414353448,7.0924497409117295
2015-01-16T09:30:00-05:00,68.96,70.495,68.94,70.37,13759279,11965534.3,56.54849089721892,52.4830859666886,NaN,NaN,49.55468612617873,58.88342879466963,0.040355685928516905,0.3105608388210186,0.2702051528925017,480857123,487542507.4,32.30788582007335,28.733545494144295,NaN,NaN,7.251100846590072,7.115114184580064
2015-01-20T09:30:00-05:00,70.48,70.66,69.55,70.37,10387243,11682491.8,56.54849089721891,52.74313407482877,NaN,NaN,75.43374515811755,49.56004621193981,0.06007134470258918,0.34529433377073815,0.28522298906814897,480857123,481664259.2,28.654920365892934,29.02045346059906,NaN,NaN,8.105363728866061,7.256578405192349
2015-01-21T09:30:00-05:00,70.3,70.78,69.95,70.51,8391032,11210943.95,57.34293985036101,53.19400766609424,NaN,NaN,98.79406782586246,52.06491010923811,0.07561384790130626,0.3797402989447818,0.3041264510434755,489248155,480308173.2,27.871979720773922,29.33973051081562,NaN,NaN,9.033306279611052,7.51039667296645
2015-01-22T09:30:00-05:00,70.82,71.36,69.84,71.35,11497378,11290981.9,61.849983801058315,54.261258608334366,NaN,NaN,126.55875296910362,71.28159398252633,0.13222595975027862,0.4694089007313238,0.3371829409810452,500745533,483761155.6,32.89942864750216,29.992212856361732,NaN,NaN,11.212711313173456,8.039298764424593
2015-01-23T09:30:00-05:00,71.25,71.32,70.905,70.94,6815557,10522240.4,58.595696817766665,54.98018354994018,NaN,NaN,128.40255701263206,95.7487618183789,0.1315385567196069,0.5016061368805538,0.3700675801609469,493929976,489127582,39.90953657825699,31.047657212862077,NaN,NaN,12.098972256780367,8.619252120475418
2015-01-26T09:30:00-05:00,71.01,71.35,70.58,71.31,7871692,10689869.5,60.60991153880513,55.99564648807376,NaN,NaN,116.26325612776002,109.09047581869515,0.14445093744067394,0.5506312519617893,0.40618031452111536,501801668,493316491,44.76071211407494,32.536016519119,NaN,NaN,13.433164867005287,9.306953941408256
2015-01-27T09:30:00-05:00,70.67,71.3,70.5,70.8,10040133,10979734.6,56.527882074339466,56.819696253725155,NaN,NaN,88.06420933078098,111.61656865322784,0.10872173374625083,0.5420824817039289,0.4333607479576781,491761535,495497373.4,47.15281207632707,34.40558649449999,NaN,NaN,13.395757394038988,9.891068720355504
2015-01-28T09:30:00-05:00,70.93,71.19,69.665,69.78,11005442,11268712.7,49.366749749782116,56.40679264848201,NaN,NaN,27.847512535902823,97.42725759523591,0.011583103811301787,0.4478396277218053,0.4362565239105035,480756093,493798961,45.50031300236778,36.22371849115334,NaN,NaN,11.141590510788866,10.069714690417413
2015-01-29T09:30:00-05:00,69.78,70.43,69.22,70.37,12119965,11626454.2,53.07018179229323,55.845682223706454,NaN,NaN,6.1407431549878835,73.34365563241276,-0.016233558787930424,0.4159645754255905,0.43219813421352093,492876058,492225066,43.96274026931597,37.454950132351065,NaN,NaN,10.369415518564427,10.112529094438415
2015-01-30T09:30:00-05:00,70.07,70.53,69.17,69.27,13886498,11927599.6,46.27446411356464,55.09693522002107,NaN,NaN,-33.50009128090286,40.96312597370577,-0.10695721212017528,0.29850161906330186,0.40545883118347714,478989560,489236982.8,41.12159861397364,38.42569263472738,NaN,NaN,7.460007928986181,9.73359749937381
2015-02-02T09:30:00-05:00,69.4,69.69,68.44,69.66,18042262,12453874.2,48.778791919102034,54.5162682799071,NaN,NaN,-79.71797674584047,1.7668793989856681,-0.13702176850157183,0.23418162055651237,0.3712033890580842,497031822,488283013.6,40.227757540325605,38.766939125764374,NaN,NaN,5.877138811491317,9.18267482967631
2015-02-03T09:30:00-05:00,70,70.16,69.07,70.13,17432769,12786274.75,51.70071675355226,54.29655693111907,NaN,NaN,-35.179625800279986,-22.88188762722653,-0.12207263091884452,0.21861260040952857,0.3406852313283731,514464591,492823624.8,46.21983097088258,39.06587513782269,NaN,NaN,5.467919951500448,8.651995561365473
2015-02-04T09:30:00-05:00,69.29,69.63,68.87,69.25,15184796,12878289.2,46.367354997418886,53.75110057430766,NaN,NaN,-118.1156228095296,-52.07451469631301,-0.16556905844916592,0.13372390826691571,0.29929296671608163,499279795,496528365.2,50.57359373405211,39.70776004158897,NaN,NaN,3.4090798689858315,7.903007605311238
2015-02-05T09:30:00-05:00,69.69,70.48,69.69,70.42,10801369,12711035.55,53.26962047932508,54.06080540584334,NaN,NaN,3.3179602927482974,-52.639071268760915,-0.112214303106419,0.1590250878330579,0.2712393909394769,510081164,499969386.4,54.27613400905308,41.102803104490874,NaN,NaN,3.8997959466592294,7.331120225503808
2015-02-06T09:30:00-05:00,70.42,70.7099,69.59,69.78,11886074,12198420.7,49.51570727924232,53.55846371884501,NaN,NaN,-18.04611612822836,-49.54827623822602,-0.11620625951225572,0.12598156654915726,0.24218782606141298,498195090,503810492.4,58.053508357860714,42.94177614290426,NaN,NaN,3.068166559778068,6.722126844685845
2015-02-09T09:30:00-05:00,69.46,69.6599,68.8,68.96,8139027,12119154.65,45.127708786551416,52.742693568083055,NaN,NaN,-134.1072589086357,-60.426132670785066,-0.16715508081611183,0.03324397504127319,0.20039905585738502,490056063,502415340.6,56.23626371470103,44.911872096390546,NaN,NaN,0.9145570923552757,5.892474022924335
2015-02-10T09:30:00-05:00,69.52,70.19,69.36,70.12,8629017,11952002.65,51.65461438959022,52.336384606599424,NaN,NaN,-23.87345384687755,-58.16489828010458,-0.11812477933056839,0.05274308169417452,0.1708678610247429,498685080,499259438.4,52.251773896845805,46.653285966109976,NaN,NaN,1.2859863616390717,5.234404357026441
2015-02-11T09:30:00-05:00,70.18,70.57,69.79,70.19,8088132,11645420.3,52.02545715931882,51.63463270361803,NaN,NaN,18.946346168653434,-30.752504484467977,-0.07829177331568393,0.073003144380138,0.15129491769582193,506773212,500758121.8,53.92142729196278,48.15485729785716,NaN,NaN,1.6922833921022034,4.728387076322979
2015-02-12T09:30:00-05:00,70.52,70.639,69.85,70.44,10124113,11524227.75,53.40027387471772,51.263531064828825,NaN,NaN,33.02123715964302,-24.811849111089025,-0.03464594364145368,0.10798748814400483,0.1426334317854585,516897325,502121354,55.44753587378863,49.264714390395135,NaN,NaN,2.44094219718568,4.401609236446221
2015-02-13T09:30:00-05:00,70.49,70.78,70.17,70.72,8592300,11134703.9,54.95717934231343,50.85976447936513,NaN,NaN,63.498626718140144,-8.502900541815327,0.011095198551194951,0.15650242997445218,0.14540723142325723,525489625,507580261,61.015528040326465,50.425772670841674,NaN,NaN,3.5185798583613552,4.275462182434097
2015-02-17T09:30:00-05:00,70.79,71.26,70.72,71.23,8381717,10865825.8,57.727521551758244,50.94545301346648,NaN,NaN,125.76322640572226,43.471196521056264,0.07040459025628737,0.23341296924361643,0.16300837898732906,533871342,516343316.8,67.94181370842882,51.91070135884894,NaN,NaN,5.255814184147795,4.415512468393197
2015-02-18T09:30:00-05:00,71.22,71.35,70.87,71.31,7780916,10735509.45,58.162212943150344,51.57370038442135,NaN,NaN,120.42918016405875,72.33172332324354,0.10750713983362564,0.2973923037793611,0.18988516394573546,541652258,524936752.4,73.00661121104638,53.875436945183125,NaN,NaN,6.799742741314361,4.75611679309622
2015-02-19T09:30:00-05:00,71.23,71.55,71.11,71.43,5383564,10585136.05,58.84583035237892,51.98624671014176,NaN,NaN,125.70815115031343,93.68408431957553,0.13105357005997295,0.35370212652070165,0.2226485564607287,547035822,532989274.4,76.7184182995573,56.2151282330575,NaN,NaN,8.27390841107458,5.258658452807414
2015-02-20T09:30:00-05:00,71.33,72.21,71.2,72.18,8213664,10420950.35,62.92346448470483,53.17546102236606,NaN,NaN,161.66048404357335,119.4119336963616,0.18477537513125303,0.453617775374795,0.26884240024354195,555249486,540659706.6,79.5965124283001,58.96333636265225,NaN,NaN,10.767736844063371,6.045669651558265
2015-02-23T09:30:00-05:00,72.29,72.74,72.1611,72.51,8577479,10509046.45,64.58613099324978,54.30455667051948,NaN,NaN,192.6792975365854,145.24806786005064,0.2273697755087033,0.553054619629421,0.32568484412071774,563826965,548327174.6,81.9928807611611,61.94655944985478,NaN,NaN,13.362687864690262,7.090957967719979
2015-02-24T09:30:00-05:00,72.61,72.65,72.15,72.42,8052216,10518072.65,63.746524540876585,55.16497151247121,NaN,NaN,162.27525428003338,152.55047343491287,0.23343522483205376,0.6174788751607849,0.38404365032873117,555774749,552707856,83.2064538991585,64.58846108758878,NaN,NaN,15.300496176886744,8.263749140458089
2015-02-25T09:30:00-05:00,72.36,72.605,72.1,72.39,9629676,10497549.8,63.450427220144654,56.385190956951625,NaN,NaN,136.80337709029448,155.82531282016004,0.21958408817443192,0.6585237605467711,0.43893967237233916,546145073,553606419,83.45279557587128,66.93697550486158,NaN,NaN,16.84632611333437,9.4898315651547
2015-02-26T09:30:00-05:00,72.39,72.62,72.0501,72.59,4424872,10168521.3,64.62995192115656,57.19664320279673,NaN,NaN,119.35193457963146,154.5540695060236,0.20815330686765737,0.6991313059569109,0.4909779990892535,550569945,554313243.6,83.65589303303534,69.03552972086031,NaN,NaN,18.487871241983367,10.775265804701652
2015-02-27T09:30:00-05:00,72.56,72.65,72.2,72.24,6745251,9899785.6,60.92451400857772,58.01155796917783,NaN,NaN,100.91563388950564,142.40509947521008,0.16326463925813606,0.6950587981619236,0.5317941589037876,543824694,552028285.2,80.22777378920672,70.61940582309931,NaN,NaN,18.98649521686186,11.948298577867396
2015-03-02T09:30:00-05:00,72.47,72.91,72.34,72.89,6769915,9543956.45,64.94422871132738,59.42702367809039,NaN,NaN,109.3724772755559,125.74373542300418,0.16320390551187958,0.735799040793637,0.5725951352817574,550594609,549381814,76.32648413615132,72.05442156748862,NaN,NaN,20.542088366733815,13.175982833419742
2015-03-03T09:30:00-05:00,72.85,72.86,71.87,72.23,10144017,9149044.2,58.3774657199141,59.9072273445421,NaN,NaN,77.67366399925768,108.82341736684904,0.1072705216985026,0.7066832874048856,0.599412765706383,540450592,546316982.6,71.96220977113148,73.46230984422331,NaN,NaN,20.06846874004264,14.160623677223013
2015-03-04T09:30:00-05:00,72.02,72.68,71.6,72.58,9153510,8735081.25,60.64977177748463,60.52324981726823,NaN,NaN,68.55763130896649,95.17426821058345,0.08346071289948309,0.7037386568307369,0.6202779439312538,549604102,547008788.4,72.34657841878092,74.77839206756747,NaN,NaN,20.306319904498718,15.038580281119541
2015-03-05T09:30:00-05:00,72.67,73.17,72.58,72.84,6252116,8288447.25,62.29645652113591,61.15869143486954,NaN,NaN,96.8350711725932,90.6708955291758,0.07509967451282118,0.7141525370722803,0.6390528625594591,555856218,548066043,72.95673783783874,76.0290493507139,NaN,NaN,20.969378741094737,15.885837203973141
2015-03-06T09:30:00-05:00,72.5,72.66,71.315,71.41,12314891,8364123.35,49.92253837836191,60.79907422315871,NaN,NaN,21.941479353589685,74.8760646219926,-0.031163093624757665,0.6000989955285121,0.6312620891532698,543541327,548009369.6,72.8639285593564,76.87536367350175,NaN,NaN,17.61444863280979,16.132781693806947
2015-03-09T09:30:00-04:00,71.63,71.92,71.22,71.85,10306278,8285133.55,53.015000864361404,60.46246560263037,NaN,NaN,7.753826398850029,54.552334446651436,-0.07380824106881123,0.5390017878172557,0.612810028886067,553847605,548659968.8,73.28408876946472,77.25695474929003,NaN,NaN,15.805249336639204,16.0859913570687
2015-03-10T09:30:00-04:00,71.22,71.54,71,71.05,12323925,8494378.45,47.296136541517576,59.68631728822803,NaN,NaN,-41.17016434312889,30.78356877817412,-0.15330924646613686,0.42117347080339584,0.5744827172695327,541523680,548874586.4,73.43023651775025,77.2872136997689,NaN,NaN,12.350744950009755,15.552384727488851
2015-03-11T09:30:00-04:00,71.43,71.51,70.9627,71.01,7525106,8439182.9,47.02300235410768,58.841829574065805,NaN,NaN,-55.0046150187505,6.071119512630719,-0.20289236825443624,0.32086725695148743,0.5237596252059237,533998574,545753480.8,67.63561109656405,76.63844175669794,NaN,NaN,9.544222237032676,14.694075800280826
2015-03-12T09:30:00-04:00,71.34,71.95,71.27,71.95,7574171,8413484.85,53.77835927365886,58.18860777327681,NaN,NaN,-8.963168784010147,-15.088528478689947,-0.1681205677365008,0.3136089155352977,0.4817294832717985,541572745,542896786.2,62.75432631020392,75.43542846254822,NaN,NaN,9.204211271060649,13.909809438963658
2015-03-13T09:30:00-04:00,71.85,72.28,71.33,71.81,6480353,8231296.85,52.700503656960954,57.33963439211332,NaN,NaN,-9.135173565461352,-21.303859062500155,-0.15083942752617596,0.29318019886407853,0.4440196263902545,535092392,541206999.2,59.99607154921698,73.8642278045522,NaN,NaN,8.60156810585349,13.151489248519347
2015-03-16T09:30:00-04:00,72.43,73.41,72.17,73.4,13635139,8483438.8,62.012581441303176,57.21578131357235,NaN,NaN,127.42422053496553,2.630219764722926,-0.03467864830023204,0.4006713160149644,0.43534996431519646,548727531,540182984.4,58.323093628852625,72.08684492810178,NaN,NaN,11.253499698286479,12.880347884200367
2015-03-17T09:30:00-04:00,73.14,73.34,72.735,73.19,10142499,8571477.9,60.32337562298901,56.99242048520409,NaN,NaN,127.2235355296502,36.30895973927875,0.022575877832602953,0.4635698116059501,0.44099393377334717,538585032,539595254.8,57.3348990642263,70.22128089155571,NaN,NaN,12.78577167902293,12.866836997746447
2015-03-18T09:30:00-04:00,73.03,74.45,72.75,74.14,12886940,8826779.1,64.97183593497175,57.01684077190517,NaN,NaN,195.2649596586144,86.36287467475174,0.11388476389820007,0.5833498886460973,0.4694651247478972,551471972,543089934.4,61.51084415206134,68.63949168577184,NaN,NaN,15.690212691266872,13.270176382535078
2015-03-19T09:30:00-04:00,74.14,74.665,74.01,74.57,9403877,9027794.75,66.86418645066482,57.441103089197114,NaN,NaN,237.96699122988957,135.7489066775317,0.18830694874011566,0.7048488106730417,0.5165418619329261,560875849,546950555.2,65.52521949404145,67.58930923611719,NaN,NaN,18.66745448868265,14.041216111984731
2015-03-20T09:30:00-04:00,75.4,76.01,74.48,74.9,9544290,9094326.05,68.28044161833438,57.67940401112618,NaN,NaN,240.84501228625354,185.74494384787465,0.2414325864900284,0.8183325950454616,0.5769000085554332,570420139,554016104.6,71.40367559942274,67.2376800549223,NaN,NaN,21.53311223636178,15.111486986895738
2015-03-23T09:30:00-04:00,74.67,75.09,74.404,74.69,4667762,8898840.2,66.33735544161718,58.24796756267641,NaN,NaN,163.5891283174694,192.9779254043754,0.24341321522559323,0.8811665275874248,0.6377533123618315,565752377,557421073.8,73.7285414026783,67.36384660003277,NaN,NaN,23.27034827022374,16.277038598799738
2015-03-24T09:30:00-04:00,74.78,74.98,74.03,74.04,8467691,8919613.95,60.58991077181827,58.243691776557384,NaN,NaN,114.3215671404567,190.39753172653673,0.18459875528861214,0.8685017564725968,0.6839030011839846,557284686,561161004.6,76.03332678443009,67.62718576900771,NaN,NaN,23.002479478729157,17.237815867361082
2015-03-25T09:30:00-04:00,74.25,74.62,72.67,72.69,15039073,9190083.8,50.75442808196549,57.419261173759494,NaN,NaN,36.83870970025187,158.7122817348642,0.04566916016827405,0.7409894513943271,0.6953202912260531,542245613,559315732.8,72.64687643429974,67.60505281161207,NaN,NaN,19.440744727229262,17.552519990199393
2015-03-26T09:30:00-04:00,72.28,73.12,71.92,72.52,18253751,9881527.75,49.66119597970664,57.40059385956983,NaN,NaN,-20.709604154935874,106.97696265789912,-0.06099137659950837,0.6190810704766676,0.680072447076176,523991862,551938935.4,60.95820650723939,66.75464409360372,NaN,NaN,16.27750517397948,17.370375016453693
2015-03-27T09:30:00-04:00,72.72,73.32,72.6,73.04,8841565,9986343.45,52.99630147112916,57.39925818862467,NaN,NaN,10.414189653648407,60.89079813137808,-0.09766177144316956,0.557995232772214,0.6556570042153835,532833427,544421593,51.809875731010976,65.22077173371416,NaN,NaN,14.669293858075239,16.984506279542487
2015-03-30T09:30:00-04:00,73.63,73.89,73.54,73.78,8008154,10048255.4,57.32894648252045,58.11588747012488,NaN,NaN,58.55503449585097,39.88397936705439,-0.074278901598551,0.5628083772171948,0.6370872788157458,540841581,539439433.8,46.797222016033714,63.31841355502013,NaN,NaN,14.664936485906537,16.65313916616592
2015-03-31T09:30:00-04:00,73.49,74.17,72.5,72.5,8442900,9963199.55,48.92778118332983,58.2519431007836,NaN,NaN,8.99862550190137,18.81939103934332,-0.14322396181786767,0.45805732654341114,0.6012812883612788,532398681,534462232.8,42.385347391898904,61.51482329040118,NaN,NaN,11.802491586313577,15.960189511901302
2015-04-01T09:30:00-04:00,72.53,72.81,71.31,71.77,21829329,10596990.5,44.88769655372243,57.61689576364528,NaN,NaN,-66.48088696494217,-1.84452829369546,-0.23099801444909696,0.3125337702999076,0.5435317847490045,510569352,528126980.6,37.53470252635494,59.71342159155483,NaN,NaN,8.061608173030857,14.831820749205523
2015-04-02T09:30:00-04:00,71.84,72.32,71.64,71.99,7560107,10662390.05,46.32610607375845,57.16158165055939,NaN,NaN,-59.01087906932328,-9.50478327657294,-0.2648191820394099,0.21250780719974216,0.47732698923915207,518129459,526954500,36.69765807319209,58.049249200410195,NaN,NaN,5.561947844762895,13.507553191428006
2015-04-06T09:30:00-04:00,71.59,72.49,71.5,72.1,5746209,10333955.95,47.069965465836546,56.094251938026055,NaN,NaN,-57.42839987374282,-23.073301182051182,-0.2694671315719173,0.14049307477425543,0.40996020634617275,523875668,525162948.2,35.398653515828485,56.41178919233704,NaN,NaN,3.7913595087653142,12.119525522476193
2015-04-07T09:30:00-04:00,72.28,72.81,72.21,72.27,5599340,10098609.05,48.263313917730976,55.232818959079054,NaN,NaN,-34.52079045987848,-41.68846617319707,-0.2511429900805658,0.09603146874546553,0.3471744588260313,529475008,522889633.6,33.7653803531466,54.72825214154563,NaN,NaN,2.6866353915532084,10.771969789487196
2015-04-08T09:30:00-04:00,72.43,73.2,72.34,72.88,12577094,10111267.5,52.40951907309994,54.33551061180249,NaN,NaN,-15.039846547514253,-46.4961605830802,-0.1907287909998438,0.10876347007622655,0.29949226107607035,542052102,524820317.8,36.44728051871566,52.93799759630665,NaN,NaN,2.9468232544376702,9.65409171305155
2015-04-09T09:30:00-04:00,72.9,73.55,72.795,73.43,8181416,10144083,55.84545555261046,53.548458404798616,NaN,NaN,12.918246017781023,-30.616333986535558,-0.11049472172144481,0.16137385892426437,0.2718685806457092,550233518,532753151,46.10374058127547,51.550749102537644,NaN,NaN,4.195590025694585,8.87430575771484
2015-04-10T09:30:00-04:00,73.5,74.16,73.21,74.06,5084287,10019588.8,59.456316612994506,52.91816376156005,NaN,NaN,52.324487107096516,-8.349260751251595,-0.01668669134294898,0.25101021646702293,0.2676969078099719,555317805,540190820.2,53.27257970124413,50.25567082409633,NaN,NaN,6.373636470365063,8.517067288093443
2015-04-13T09:30:00-04:00,74.11,74.44,73.63,73.66,6814835,10036312.9,56.3077858228505,52.20176593164815,NaN,NaN,53.954770872497036,13.927373397996377,0.015017501531672028,0.28646878472456194,0.2714512831928899,548502970,545116280.6,57.32111500516609,49.08371179570259,NaN,NaN,7.2765010710949625,8.339843542807946
2015-04-14T09:30:00-04:00,73.74,73.86,73.18,73.78,5878683,9648490.1,57.04272700887593,51.94839566286655,NaN,NaN,23.647048425004993,25.560941174973067,0.039285183292394166,0.3205577623083826,0.28127257901598846,554381653,550097609.6,61.001220116811126,48.00998989087267,NaN,NaN,8.226853072065179,8.32370204698755
2015-04-15T09:30:00-04:00,74.19,74.33,73.83,73.97,6254622,9454096.25,58.24046338915909,52.48311247052323,NaN,NaN,57.19273538127741,40.007457560731396,0.061997349565685034,0.3587692659730948,0.29677191640740974,560636275,553814444.2,63.52828306051478,47.358661792745174,NaN,NaN,9.357039563584536,8.47132169221569
2015-04-16T09:30:00-04:00,74.05,74.23,73.82,73.93,4439529,9031725.7,57.87461284115943,53.06978510348414,NaN,NaN,51.13271417411814,47.65035119199882,0.06772457240219748,0.3814276319101566,0.3137030595079591,556196746,555007089.8,64.32706230775382,47.599294349924776,NaN,NaN,10.199552600436315,8.718211821961495
2015-04-17T09:30:00-04:00,73.46,73.65,72.815,73.29,12115355,9167299.6,52.22214311783716,53.014488078248995,NaN,NaN,-8.748760437806792,35.435701683018166,0.02406077497030218,0.34377902822083684,0.31971825325053466,544081391,552759807,61.589836556877806,48.297862980343844,NaN,NaN,9.40050687478928,8.815682543794034
2015-04-20T09:30:00-04:00,73.66,73.94,73.55,73.74,6659541,9023062.15,55.512234509906556,52.88472293734801,NaN,NaN,47.99917703940204,34.24458291639915,0.02123498549772801,0.3462619851226947,0.3250269996249667,550740932,553207399.4,61.937234226045945,49.37929242391614,NaN,NaN,9.624526627035127,8.931231698542762
2015-04-21T09:30:00-04:00,74.11,74.45,74.08,74.23,6577201,9118534.1,58.83626019345444,53.5924714380712,NaN,NaN,106.72499022013773,50.86017127542571,0.04665810852928903,0.38334963528657795,0.3366915267572889,557318133,553794695.4,62.4175478231462,50.810163883290954,NaN,NaN,10.773087333638694,9.194353932127894
2015-04-22T09:30:00-04:00,74.4,74.51,73.97,74.35,6078169,8999058,59.63174808014649,54.64561797567291,NaN,NaN,110.14617061577674,61.45085832232557,0.06473550164718317,0.41761090381626786,0.3528754021690847,563396302,554346700.8,62.89153705063231,52.62136634931077,NaN,NaN,11.94958327377124,9.58795812379123
2015-04-23T09:30:00-04:00,74.24,74.82,73.89,74.63,10532499,8773729.3,61.50125381143348,55.72955709979256,NaN,NaN,112.44663382594568,73.71364225269107,0.08732436765483703,0.46203086173763097,0.37470649408279394,573928801,557893111.8,65.86973424609276,54.70508607594651,NaN,NaN,13.476936165175795,10.143526415417597
2015-04-24T09:30:00-04:00,74.48,74.73,74.07,74.39,10397196,8380901.55,58.97992789170925,56.58026870164061,NaN,NaN,97.42400195336474,94.9481947309254,0.07817257670262168,0.47242221496107106,0.3942496382584494,563531605,561783154.6,68.8252511359978,57.0927001916729,NaN,NaN,14.10571453836301,10.709553290124084
2015-04-27T09:30:00-04:00,74.57,74.64,72.945,73.04,17847730,8831209.8,47.24656575188679,56.507643832651745,NaN,NaN,11.529187179747646,87.6541967589945,-0.02140966906160202,0.3674875519314469,0.3888972209930489,545683875,560771743.2,67.19597321557904,59.480599681846634,NaN,NaN,11.050679877399876,10.758285659734911
2015-04-28T09:30:00-04:00,73.25,73.53,72.2,73.4,15798381,9220721.15,50.09754195049304,56.342502609608395,NaN,NaN,-34.68227244676643,59.372744225613665,-0.06327470400341689,0.3098038409887778,0.37307854499219467,561482256,561604567.8,67.87044298520514,61.72511128659589,NaN,NaN,9.380021641920381,10.561390800047121
2015-04-29T09:30:00-04:00,72.89,73.41,72.25,72.73,13661257,9481639,45.201423139749096,55.582214580118304,NaN,NaN,-56.699797645548074,26.0035505733487,-0.13235705294218697,0.20763222881446097,0.33998928175664794,547820999,558489507.2,62.67936495471831,62.90908445612752,NaN,NaN,6.374691084687374,9.963290840710014
2015-04-30T09:30:00-04:00,72.42,72.78,71.33,71.709,14554425,9117893.8,38.95372365056796,54.11774365423069,NaN,NaN,-139.7264532172784,-24.431066835296114,-0.23697560762599645,0.04376977222415235,0.2807453798501488,533266574,550357061.8,51.5863202545251,62.788637352790445,NaN,NaN,1.5802998297822235,8.765720696291758
2015-05-01T09:30:00-04:00,72.2,72.72,72.19,72.68,11508332,9315305.05,46.523898852185916,53.4188945848975,NaN,NaN,-88.93268586057329,-61.702404398083715,-0.23071838843977988,-0.007652605699576043,0.22306578274020383,544774906,546605722,47.417485971650294,62.081235278967895,NaN,NaN,0.04915841800898601,7.520497513679934
2015-05-04T09:30:00-04:00,72.96,73.43,72.79,73.14,8561748,9456082,49.70580867374259,52.894828989530836,NaN,NaN,-38.00249324977449,-71.60874048398816,-0.18737936831587126,-0.011158427654635261,0.176220940661236,553336654,548136277.8,49.22056752585788,61.239760093899804,NaN,NaN,-0.11287848545857984,6.430015228088718
2015-05-05T09:30:00-04:00,72.99,73,72.15,72.22,11373760,9744803,44.05929535036628,51.88188841533135,NaN,NaN,-112.59244315177895,-87.19077462499064,-0.21071139739235406,-0.08716830607920656,0.12354309131314749,541962894,544232405.4,44.98356230670878,59.91513718291367,NaN,NaN,-2.1942348343314775,5.197979504885833
2015-05-06T09:30:00-04:00,72.41,72.45,71.42,71.94,10152164,9623556.5,42.47772206805883,50.78211050296702,NaN,NaN,-153.63921479129928,-106.57865805414087,-0.2332848862157409,-0.16806301645652866,0.06522186975921225,531810730,541030351.6,41.8048124388794,58.306405049422644,NaN,NaN,-4.361535237693976,3.8323345416601455
2015-05-07T09:30:00-04:00,71.84,72.53,71.73,72.28,9019729,9665472.15,45.056838721166095,50.27030304606194,NaN,NaN,-112.42830675331078,-101.11902876134737,-0.21410094210749464,-0.20240430787515606,0.01169663423233859,540830459,542543128.6,43.82448311197254,57.03745123192941,NaN,NaN,-5.303053757904131,2.5272790702938206
2015-05-08T09:30:00-04:00,73.02,73.65,72.96,73.45,11222370,9972376.3,52.88540139916955,50.082672109580734,NaN,NaN,1.2082641353477168,-83.09083876216316,-0.11629326173983988,-0.13366994294246126,-0.01737668120262138,552052829,543998713.2,45.77452558182442,55.88297204305644,NaN,NaN,-3.4982212230790592,1.666493314097695
2015-05-11T09:30:00-04:00,73.71,73.84,73.42,73.49,7980692,10030669.15,53.13127412132126,49.67517310442837,NaN,NaN,25.866328692861348,-70.31707437363599,-0.04618189115081933,-0.07510404514114555,-0.028922153990326212,560033521,545338086.6,47.577797249915704,54.822989859254264,NaN,NaN,-2.0162561793548512,1.1403862436044743
2015-05-12T09:30:00-04:00,72.96,73.32,72.68,73.02,7019849,10087727.45,49.8400612599183,48.97576690298349,NaN,NaN,-28.718639109800378,-53.54231356524027,-0.029547135539618588,-0.06585607341484945,-0.03630893787523086,553013672,547548242.2,50.502914572309166,53.93808825365975,NaN,NaN,-1.7915092194971227,0.7215440345899604
2015-05-13T09:30:00-04:00,73.26,73.64,72.97,73.1,6005823,10075287.5,50.40322667503193,48.18305067895481,NaN,NaN,-1.867878053488504,-23.188046217678124,-0.012135448560720588,-0.05147824857613159,-0.039342800015411,559019495,552989995.2,56.88236944440159,53.296133624967524,NaN,NaN,-1.4447663554346912,0.4120711217292959
2015-05-14T09:30:00-04:00,73.49,74.14,73.19,74.11,6894435,10198032.8,56.9715005091542,48.03959158020087,NaN,NaN,61.00981892717094,11.499578918418226,0.06422854103735122,0.04094287628127802,-0.023285664756073198,565913930,558006689.4,61.77372676011918,52.79245331240476,NaN,NaN,0.9347460863827438,0.4867389738226456
2015-05-15T09:30:00-04:00,74.24,74.35,74.0295,74.26,3872343,9785882.2,57.86399542046345,48.79797941367063,NaN,NaN,91.6898231797764,29.59589072730396,0.1185099845806799,0.12485181596977668,0.006341831389096778,569786273,561553378.2,64.81285271333596,52.62223041938739,NaN,NaN,3.1275444138653885,0.8639968938287517
2015-05-18T09:30:00-04:00,74.21,74.79,74.17,74.7,6792243,9792517.3,60.45510665046434,49.537805463668576,NaN,NaN,114.62129846122924,47.34688468097754,0.17434200738068478,0.22426934061495274,0.04992733323426797,576578516,564862377.2,67.41572598950958,52.589750633980564,NaN,NaN,5.767359651131598,1.5644772877291584
2015-05-19T09:30:00-04:00,74.8,75.24,74.61,75.05,5869169,9757115.7,62.43402302999244,50.76870545582882,NaN,NaN,142.62172050524674,81.61495660398697,0.22207814588167385,0.32752501558636027,0.10544686970468643,582447685,570749179.8,71.46040688131035,53.21696791445142,NaN,NaN,8.577614591801485,2.5663540454537763
2015-05-20T09:30:00-04:00,75.18,75.47,74.85,75.15,10577011,9982057.8,63.003678430838995,52.48655936870532,NaN,NaN,146.18226011431588,111.22498423754784,0.24577695671626376,0.4126680656000161,0.16689110888375236,593024696,577550220,75.27838629449556,54.909258345877895,NaN,NaN,11.050576815607126,3.7783858697613977
2015-05-21T09:30:00-04:00,75.13,75.2356,74.88,75.16,4537941,9682329.9,63.06399714983568,53.66799496139459,NaN,NaN,132.14370031502648,125.45176051511893,0.24686354028207874,0.4754705342363508,0.22860699395427203,597562637,583879961.4,78.20127456966208,57.10810038859302,NaN,NaN,13.10543544449466,5.110821523294721
2015-05-22T09:30:00-04:00,75.03,75.34,74.92,74.98,4612315,9393085.85,61.131944475643614,54.48414751867323,NaN,NaN,122.88663372695989,131.69112262455565,0.22103224929244392,0.5048973055698269,0.283865056277383,592950322,588512771.2,80.05956352666223,59.3108858172219,NaN,NaN,14.35922512413004,6.432022037699767
2015-05-26T09:30:00-04:00,74.75,74.83,74.07,74.22,9533833,8977391,53.65727712907266,55.16971764572368,NaN,NaN,62.14369916486091,121.19560276528198,0.14216545275458703,0.4615718722206168,0.31940641946602977,583416489,589880365.8,80.5857036114604,61.85389591041845,NaN,NaN,13.419102959181489,7.430176455054299
2015-05-27T09:30:00-04:00,74.48,75.16,74.28,75.08,13043718,8839657.85,59.666991360226874,56.39752259516426,NaN,NaN,85.44614799523622,109.76048826327988,0.1372519481639678,0.4909713546709895,0.3537194065070217,596460207,592682870.2,81.65397668168399,64.70026478490449,NaN,NaN,14.358627852131137,8.419955226065275
2015-05-28T09:30:00-04:00,75.07,75.34,74.77,75.13,5766396,8444914.8,59.99183705908166,57.46430819072965,NaN,NaN,91.090819113338,98.7422000630843,0.126943375636975,0.5123986260532405,0.3854552504162655,602226603,594523251.6,82.34115452320498,67.45145559999251,NaN,NaN,15.213164119235742,9.39041363937534
2015-05-29T09:30:00-04:00,75.01,75.62,74.71,74.94,9839177,8209152.4,58.077609716515646,57.83518021339723,NaN,NaN,83.68989565763262,89.05143913160552,0.09818810250595106,0.5081903785487043,0.41000227604275324,592387426,593488209.4,80.51458309840767,69.93288827974847,NaN,NaN,15.39556727184846,10.248292729728643
2015-06-01T09:30:00-04:00,75.37,75.5299,74.74,75.24,7466723,8007071.95,60.23512232432168,58.34259794218297,NaN,NaN,81.48115484453487,80.77034335512052,0.09042505846528592,0.5230335991243606,0.4326085406590747,599854149,594868974.8,81.11638206047225,72.32850148050251,NaN,NaN,16.15164578004624,11.091628879774014
2015-06-02T09:30:00-04:00,75,75.09,74.46,74.75,5722417,7865105.4,55.23499426368158,58.72795029959463,NaN,NaN,48.429698241553645,78.02754317045907,0.045604437112536034,0.48961408704974474,0.4440096499372087,594131732,597012023.4,82.04334826241868,74.58138960122461,NaN,NaN,15.389915952727245,11.705669890195903
2015-06-03T09:30:00-04:00,75,75.07,74.68,74.89,5357958,7564315.3,56.34988764115909,59.15271179717514,NaN,NaN,52.33451361277805,71.40521629396743,0.02000760172714322,0.46901915209613776,0.44901155036899454,599489690,597617920,82.30777917555524,76.39749029630703,NaN,NaN,15.060017412082827,12.184862393322607
2015-06-04T09:30:00-04:00,74.61,74.91,74.11,74.37,6479514,7380682.8,51.24478628612469,58.74366078124446,NaN,NaN,11.232979585385756,55.43364838837698,-0.03436356812399105,0.4060570902140057,0.44042065833799676,593010176,595774634.6,78.51949030678735,77.59361626392617,NaN,NaN,13.29490717865471,12.343440219798621
2015-06-05T09:30:00-04:00,74.27,74.39,73.74,74.34,7772234,7318308.05,50.957955407462286,58.250372208887235,NaN,NaN,-32.9214567625104,32.11137790434837,-0.0725707300056212,0.34970724583097024,0.42227797583659143,585237942,594344737.8,75.6121840601532,78.36499707441313,NaN,NaN,11.763613063586982,12.260607768911244
2015-06-08T09:30:00-04:00,74.36,74.52,73.97,73.97,6736570,7094018.05,47.431728000223764,57.3201308767272,NaN,NaN,-41.143295925614524,7.586487750318506,-0.12017632460542566,0.27205757007980935,0.392233894685235,578501372,590074182.4,67.56573668592748,78.37571212415726,NaN,NaN,9.428653674476244,11.856042898277673
2015-06-09T09:30:00-04:00,74.21,74.21,73.66,73.95,8297533,7109860.1,47.24142996161394,56.234945657557304,NaN,NaN,-72.58763780502274,-16.616979458996767,-0.14856702233252128,0.2065251167695834,0.3550921391021047,570203839,585288603.8,59.87618075769654,77.54826740104197,NaN,NaN,7.440206591558899,11.225209140174991
2015-06-10T09:30:00-04:00,74.12,74.95,73.98,74.86,7728761,7145305.7,55.90923408336938,55.72819963273805,NaN,NaN,2.401176191127834,-26.60364694332681,-0.10373686601961352,0.22542105657758782,0.32915792259720134,577932600,580977185.8,53.92213480967383,76.02282086641185,NaN,NaN,8.07704553721088,10.77547148260869
2015-06-11T09:30:00-04:00,75.44,75.49,74.97,75.37,4912014,7090615.25,59.88679552475006,55.501256659517644,NaN,NaN,101.86992741964903,-8.47625737647416,-0.040653996015939664,0.27834042757727673,0.3189944235932164,582844614,578944073.4,51.33001299385409,74.10344503956843,NaN,NaN,9.848837852415395,10.643095249723935
2015-06-12T09:30:00-04:00,75,75.1099,74.34,74.44,6330563,7062421.65,50.87394575444223,54.76854246514612,NaN,NaN,-18.231234828247874,-5.5382129896216545,-0.0612423641868694,0.24244146835962965,0.30368383254649906,576514051,577199295.2,49.14655456956335,71.89537297120422,NaN,NaN,8.518589677261135,10.33959445365782
2015-06-15T09:30:00-04:00,73.97,74.68,73.59,74.53,7150167,7226312.85,51.63257274225251,54.62392072323039,NaN,NaN,-90.02191877167948,-15.313937558834647,-0.06796136635415617,0.21873212460380387,0.28669349095796004,583664218,578231864.4,50.48882616258495,69.74559601057027,NaN,NaN,7.697960326473704,9.962218149774376
2015-06-16T09:30:00-04:00,74.49,74.935,74.33,74.9,6041425,7188771.95,54.72779573896917,54.271121035997695,NaN,NaN,-2.6840290213065936,-1.333215802091418,-0.04761125383834175,0.22717942366003285,0.2747906774983746,589705643,582132225.2,55.289476465892996,67.86241742372805,NaN,NaN,7.957981567714347,9.675898638051514
2015-06-17T09:30:00-04:00,74.99,75.16,74.5,74.97,5132122,7151919.6,55.310469879115836,53.93673766600013,NaN,NaN,29.77151947595049,4.140852854873113,-0.030398314647142044,0.23679278418944705,0.2671910988365891,594837765,585513258.2,59.00058627632358,66.19523397752224,NaN,NaN,8.339101850896027,9.484927668457873
2015-06-18T09:30:00-04:00,75.11,76.276,75.08,76.03,9511182,7098628.15,63.063070367470374,54.29284199821119,NaN,NaN,193.4079706793534,22.44846150681399,0.04719474545340885,0.3261845306533502,0.27898978519994133,604348947,589814124.8,63.18651845585316,64.95751507448263,NaN,NaN,11.227762004261585,9.733904002144117
2015-06-19T09:30:00-04:00,75.84,76.005,75.66,75.71,10327390,7388100.6,59.69626822165173,54.25435241944905,NaN,NaN,169.6939181885545,60.033492110174464,0.07038939671590355,0.36697653109482076,0.2965871343789172,594021557,593315626,66.21114019087901,63.89285494094025,NaN,NaN,12.53660101560275,10.134289289781064
2015-06-22T09:30:00-04:00,76.27,76.66,76.21,76.3,6635028,7489236.25,63.55920052113024,54.84893858069538,NaN,NaN,222.09036060034202,122.45594798457878,0.11618591964515324,0.4418195339353588,0.32563361429020554,600656585,596714099.4,68.88335417574052,62.95285536332039,NaN,NaN,14.913009974135221,10.81696367326023
2015-06-23T09:30:00-04:00,76.41,76.65,76.18,76.45,4631642,7244126.7,64.49102455847495,55.430448360503654,NaN,NaN,183.937637930897,159.78028137501948,0.14540354516433823,0.5073880457456283,0.3619845005812901,605288227,599830616.2,71.13759587697888,62.15498512770779,NaN,NaN,17.1125720942372,11.716336304828369
2015-06-24T09:30:00-04:00,76.35,76.42,75.68,75.68,7294405,6956661.05,56.50360786501187,55.80607847328131,NaN,NaN,104.80814558423697,174.78760659667677,0.10365454796016971,0.4915526855315022,0.3878981375713325,597993822,600461827.6,71.58657010256339,61.65977654169179,NaN,NaN,16.49034471779571,12.398337506680846
2015-06-25T09:30:00-04:00,75.91,76.46,75.71,76.1,9232471,7129964.8,59.453484482739455,56.41290197865825,NaN,NaN,107.49690684259352,157.60539382932478,0.09532036816641021,0.5070485977793453,0.4117282296129351,607226293,601037296.8,72.01399687283848,61.40276317116932,NaN,NaN,16.91243322690667,13.043208323855964
2015-06-26T09:30:00-04:00,76.21,76.5,75.72,75.99,6147481,6945380,58.33757979450906,57.191891392535766,NaN,NaN,92.34981145219122,142.13657248205215,0.07432622382551546,0.5046360093948294,0.430309785569314,601078812,602448747.8,73.08350708147877,61.79688962799441,NaN,NaN,16.911650880881755,13.595842974859648
2015-06-29T09:30:00-04:00,75.33,75.719,74.09,74.13,13675872,7255837.45,43.47754707870174,56.923042615184904,NaN,NaN,-42.43594466895016,89.2313114281937,-0.0653527094713639,0.3486188987301091,0.413971608201473,587402940,599798018.8,67.84008692970758,62.36574006885233,NaN,NaN,11.467222649023649,13.291754356883077
2015-06-30T09:30:00-04:00,74.93,74.95,74.15,74.39,8722219,7405827.55,45.56489808271885,56.18416147228129,NaN,NaN,-54.526635445260276,41.53845675296225,-0.13665636934967557,0.24315114651437852,0.3798075158640541,596125159,597965405.2,64.39998504901084,63.114157943090696,NaN,NaN,7.9605656712678465,12.530155973223758
2015-07-01T09:30:00-04:00,75.16,75.26,74.75,75.19,7756536,7525756.45,51.49987050048473,55.58509539911948,NaN,NaN,-2.118315705110303,20.15316449509279,-0.1265928708538318,0.22156642729676435,0.34815929815059615,603881695,599142979.8,65.60685106154153,64.13393209078266,NaN,NaN,7.072779172880519,11.750530716031866
2015-07-02T09:30:00-04:00,75.36,75.41,74.695,74.84,5678771,7485719.3,48.98362326048379,55.45007236383673,NaN,NaN,-12.981978192593482,-3.9426125119446,-0.13915934168370936,0.17421012104595945,0.3133694627296688,598202924,597338306,62.13061321221479,65.06136485097204,NaN,NaN,5.520607581686886,10.860541696839727
2015-07-06T09:30:00-04:00,74.14,75.275,74.14,74.81,9352585,7564736.85,48.763694679709374,55.24515250222651,NaN,NaN,-40.58479308137902,-30.52953341865865,-0.1445122589951902,0.13272913898568106,0.2772413979808713,588850339,594892611.4,57.670916371819196,65.57437129448877,NaN,NaN,4.243308395130375,9.915222653738391
2015-07-07T09:30:00-04:00,74.91,75.17,73.885,75.17,10653269,7760571.8,51.57352168486827,55.01984721264787,NaN,NaN,-45.15731251628361,-31.07380698812534,-0.11984499038136237,0.12743516000416832,0.2472801503855307,599503608,597312745,60.67871784604505,65.95931710735678,NaN,NaN,4.04206378493253,9.076199958194698
2015-07-08T09:30:00-04:00,74.57,74.8,73.86,73.88,13074865,7999438.4,42.56546599547663,54.109489792387926,NaN,NaN,-106.72994061036441,-41.51446802114617,-0.18268074412261162,0.018929220232266175,0.2016099643548778,586428743,595373461.8,57.172917092824555,65.82876930853541,NaN,NaN,0.8060975276427159,7.894756753830129
2015-07-09T09:30:00-04:00,74.68,74.87,74.24,74.28,6654595,7945730.1,45.73075258441905,52.87146709359855,NaN,NaN,-75.31318008275132,-56.153440896674375,-0.18879952479826845,-0.03438944164295776,0.15441008315531068,593083338,593213790.4,53.46802070140411,65.13459089750334,NaN,NaN,-0.7750182461484166,6.656217468118908
2015-07-10T09:30:00-04:00,75.21,75.37,74.78,75.28,8059479,8103103.35,52.742628049936755,52.37477850990462,NaN,NaN,-3.0764141200966253,-54.172328082175,-0.12032753835511452,0.004000660211417539,0.12432819856653206,601142817,593801769,54.33562512703394,64.2863398215144,NaN,NaN,0.2503138803718977,5.7410883841550495
2015-07-13T09:30:00-04:00,75.82,76.08,75.61,75.92,7815118,8177331.1,56.60688404562162,51.878184475939726,NaN,NaN,65.34066574155823,-32.987236317587545,-0.03139302699381809,0.08508691482425945,0.11647994181807754,608957935,597823288.2,59.84969640827995,63.64107855241007,NaN,NaN,2.415715838969566,5.266035163414266
2015-07-14T09:30:00-04:00,75.96,76.78,75.79,76.68,5831836,8111414.55,60.71498877292755,51.60846763411491,NaN,NaN,106.94060973891611,-2.567651866547604,0.0734345752351091,0.2082731608619639,0.1348385856268548,614789771,600880520.8,63.461836556409644,63.09281002951227,NaN,NaN,5.638598053177075,5.319258433380381
2015-07-15T09:30:00-04:00,76.92,77.26,76.56,76.78,6994934,8159090,61.23502224709304,51.94642580426357,NaN,NaN,132.1232456446986,45.202985384465,0.14044139242038015,0.31039032615233,0.16994893373194983,621784705,607951713.2,70.15078097285456,62.9902536631045,NaN,NaN,8.316475462950597,5.747432294747555
2015-07-16T09:30:00-04:00,77.06,77.25,76.84,77.14,5109242,8157946,63.12734831953738,52.20884464974914,NaN,NaN,133.64155062653015,86.99393152632129,0.19650276442119605,0.4155773892584449,0.21907462483724885,626893947,614713835,74.88564874596345,63.19537165404199,NaN,NaN,11.109519205379398,6.513444710552104
2015-07-17T09:30:00-04:00,77.05,77.07,76.66,76.97,3877857,7876279.75,61.59817956500109,52.44174463335571,NaN,NaN,106.24362584383749,108.85793951910811,0.20849368229968285,0.4796917277118524,0.2711980454121696,623016090,619088489.6,77.38494632644506,63.50261731439672,NaN,NaN,12.925771778715978,7.429491434575515
2015-07-20T09:30:00-04:00,77.07,77.4,76.99,77.22,3874760,7553648.25,63.016963320559846,53.837417222059855,NaN,NaN,116.31805466716668,119.05341730422981,0.21856172911915944,0.5444002068111189,0.32583847769195945,626890850,622675072.6,79.21153293907969,64.3148634579233,NaN,NaN,14.851020690260322,8.489709899673343
2015-07-21T09:30:00-04:00,77.19,77.39,76.534,76.88,8140190,7628906.35,59.782077263447874,54.85293002068335,NaN,NaN,91.08564673392495,115.88242470323158,0.18874620591652758,0.561771235087619,0.37302502917109137,618750660,623467250.4,79.60338949353608,65.40082091824654,NaN,NaN,15.562505797352047,9.500109313627444
2015-07-22T09:30:00-04:00,76.67,77.12,76.55,77.05,5765359,7685592.2,60.86384581234618,55.52178540010203,NaN,NaN,85.15570816783321,106.4889172078585,0.16761223045558404,0.5825403172405714,0.4149280867849874,624516019,624013513.2,79.88496129832703,66.42068593515978,NaN,NaN,16.45782306242093,10.494068420597943
2015-07-23T09:30:00-04:00,77.19,77.35,76.625,76.77,5677435,7604743.7,58.09226943217294,56.17240298379411,NaN,NaN,78.36369092325594,95.43334526720363,0.12392758794987524,0.5698375717223314,0.44590998377245616,618838584,622402440.6,76.52945579562439,67.44917469111762,NaN,NaN,16.46032147005058,11.346390284805462
2015-07-24T09:30:00-04:00,76,76.05,74.71,74.85,13229714,7804605.85,43.473269980073184,55.79451550524867,NaN,NaN,-36.78778034253359,66.82706402992943,-0.03654477933673972,0.4002290096015315,0.43677378893827123,605608870,618920996.6,69.71475750487349,68.30944905776435,NaN,NaN,11.533173056333384,11.37307353788088
2015-07-27T09:30:00-04:00,74.67,74.93,74.39,74.78,11036985,8049081.05,43.04793303740122,55.185544887572455,NaN,NaN,-64.62020694896925,30.63941170670224,-0.14365923229361466,0.25719974857125294,0.4008589808648676,594571885,612457203.6,59.178329191100126,68.20227843955401,NaN,NaN,7.545375310604682,10.826259505412851
2015-07-28T09:30:00-04:00,75.2,76.15,74.82,76.13,11445082,7937541.55,52.66630589297312,55.90703345167934,NaN,NaN,-1.7710715680222595,12.068068046312801,-0.12076635057019275,0.24990104265212665,0.3706673932223194,606016967,609910465,55.61202009763664,68.09078579704058,NaN,NaN,7.151821251238889,10.30133975481657
2015-07-29T09:30:00-04:00,76.46,76.61,75.94,76.26,9367016,7969781.4,53.48104089326188,56.46062547373954,NaN,NaN,32.97055597739386,1.6310376082249405,-0.09516977173448116,0.2517051785542179,0.3468749502886991,615383983,608084057.8,53.1387826929521,68.06726879643686,NaN,NaN,7.106823865016917,9.844980341988048
2015-07-30T09:30:00-04:00,76.19,76.33,75.555,76.15,5381101,7851009.65,52.65515343208073,56.454377286749825,NaN,NaN,11.266159745681149,-11.788468627290024,-0.08431971104261471,0.24147531148543067,0.3257950225280454,610002882,606316917.4,50.78539178770561,67.81368070077056,NaN,NaN,6.820062320878232,9.412849196115218
2015-07-31T09:30:00-04:00,76.44,76.93,76.39,76.59,7910277,7962584.95,55.60818824091012,56.38304187212758,NaN,NaN,52.74983053945967,6.119053549108631,-0.04798936356881206,0.2658083180670303,0.3137976816358424,617913159,608777775.2,53.850525177332976,67.38516846998864,NaN,NaN,7.469587474550704,9.13524037874886
2015-08-03T09:30:00-04:00,76.67,76.9,76.01,76.53,8447825,7917346.95,55.103459569104515,55.98221835756879,NaN,NaN,36.216059626578634,26.28630686421821,-0.02939241726491726,0.27705716005469583,0.3064495773196131,609465334,611756465,57.31586090507892,66.9461702091793,NaN,NaN,7.8516758534452915,8.951874017991207
2015-08-04T09:30:00-04:00,76.91,76.95,76.25,76.49,10778684,7923617.7,54.74670410508689,55.51876706171121,NaN,NaN,38.18077463306431,34.27667610443552,-0.021541961375716234,0.2795221255999678,0.30106408697568404,598686650,610290401.6,55.12196799547317,65.87268356793777,NaN,NaN,8.068525102351627,8.825681315756981
2015-08-05T09:30:00-04:00,76.96,77.26,76.83,77.13,5391231,7539436,59.28836757105465,55.2445541511053,NaN,NaN,79.36476700252192,43.555518309461135,0.02260637852916836,0.3293220601371445,0.30671568160797613,604077881,608029181.2,51.82685518242956,64.2256268848282,NaN,NaN,9.563265823737593,8.931050531182782
2015-08-06T09:30:00-04:00,77.2,77.27,75.375,75.45,13360150,7874713.75,46.18507638405187,54.143618209608924,NaN,NaN,-35.83977378393287,34.134331603538335,-0.060917304567709774,0.2305690508983389,0.2914863554660487,590717731,604172151,46.698869879173714,62.03376428145168,NaN,NaN,6.686798009624391,8.610443028103012
2015-08-07T09:30:00-04:00,75.43,75.57,74.53,75.32,10863619,8014920.75,45.34984753854021,52.88168136803609,NaN,NaN,-137.71552873588732,-3.958740251531066,-0.12102866700291781,0.14020052171240138,0.2612291887153192,579854112,596560341.6,38.58497021043843,59.13186694369159,NaN,NaN,4.153560154519595,7.973745474733952
2015-08-10T09:30:00-04:00,75.57,76.26,75.57,75.93,7951120,8021720.85,49.92587240926653,52.17766673559457,NaN,NaN,-49.10892074869921,-21.023736326586636,-0.11581358343249812,0.11646220942469654,0.23227579285719466,587805232,592228321.2,34.871490582907924,55.93673130721815,NaN,NaN,3.4448685682652544,7.326763059524138
2015-08-11T09:30:00-04:00,75.41,75.69,74.91,75.29,7914867,8125872.4,45.61069631552138,51.08815605724994,NaN,NaN,-104.44242053607348,-49.5483753604142,-0.14943464957635805,0.04548248088674711,0.19491713046310516,579890365,588469064.2,31.99391663712082,52.51594240284628,NaN,NaN,1.4594973109461225,6.488582238298708
2015-08-12T09:30:00-04:00,74.72,75.42,73.9,75.34,9665895,8259420.45,46.00335423121413,50.22466211432431,NaN,NaN,-127.22886792467537,-90.86710234585365,-0.16126021030833732,-0.006658132422316498,0.15460207788602082,589556260,585564740,29.938438393445963,49.18801258840496,NaN,NaN,0.001578326799015554,5.561867393798752
2015-08-13T09:30:00-04:00,75.4,75.68,74.985,75.17,6329317,8320424.2,44.81861468006673,50.320758164323856,NaN,NaN,-80.13157041933384,-99.72546167293385,-0.17247719646388399,-0.06099441769383418,0.1114827787700498,583226943,584066582.4,28.906765393422674,46.27315600901562,NaN,NaN,-1.541639273787257,4.5470807270007505
2015-08-14T09:30:00-04:00,74.96,75.42,74.795,75.38,5503959,8401729.3,46.6465098274523,50.57779936361322,NaN,NaN,-79.84112673310284,-88.15058127237695,-0.1580809042455115,-0.08611835153683955,0.07196255270867194,588730902,585841940.4,31.90153466997289,44.32481354322082,NaN,NaN,-2.3188931570581217,3.5662273149923402
2015-08-17T09:30:00-04:00,75.13,76.16,74.83,76.14,5795993,8497790.95,52.747028813154365,50.5835652864833,NaN,NaN,-24.271330153679937,-83.1830631533731,-0.09292536932388426,-0.04419415894618339,0.04873121037770087,594526895,587186273,34.16310404156242,42.792748110644084,NaN,NaN,-1.2045723506097161,2.884684505620618
2015-08-18T09:30:00-04:00,76.06,76.444,75.91,76.03,5465905,8364076.7,51.823408034504496,50.465162939429206,NaN,NaN,25.019808195651,-57.29061740702819,-0.054680057058616935,-0.019618860945570304,0.03506119611304663,589060990,589020398,37.22618177405373,41.6561337592942,NaN,NaN,-0.5526033292883358,2.39364338634791
2015-08-19T09:30:00-04:00,75.62,76.24,75.18,75.72,10070340,8579325.75,49.20831079421913,50.218959893867655,NaN,NaN,-15.410554712521469,-34.92695476459741,-0.047945339335886794,-0.024870478056811862,0.023074861279074932,578990650,586907276,35.19455258319965,40.54250238754378,NaN,NaN,-0.7323618954774574,1.9470712032300004
2015-08-20T09:30:00-04:00,75.16,75.4462,73.96,73.96,12992869,8945097.45,37.605792226364116,48.933074464257224,NaN,NaN,-149.5630478166355,-48.813250244057755,-0.15374023225130382,-0.16910042903505484,-0.015360196783751029,565997781,583461443.6,32.11648455260902,38.990070914349204,NaN,NaN,-4.828120659243104,0.9791866514481284
2015-08-21T09:30:00-04:00,73.22,73.85,71.69,71.7,24008292,9484026.35,28.35909500073673,47.022762709373815,NaN,NaN,-290.2594399138164,-90.89691288020046,-0.35607898877056693,-0.4604589327469597,-0.10437994397639277,541989489,574113161,25.58022257622889,36.723239605145636,NaN,NaN,-12.466480801235111,-0.941622984649477
2015-08-24T09:30:00-04:00,67.39,71.07,56.63,68.65,33675689,10615961.55,20.892806583092906,44.604627172088534,NaN,NaN,-485.84730561590305,-183.21210797264507,-0.6579270150387551,-0.9267887127748367,-0.26886169773608154,508313800,556870542,18.216197510681923,34.08711314194626,NaN,NaN,-22.936595262061118,-4.083761881422569
2015-08-25T09:30:00-04:00,70.8,71.34,67.86,67.96,17883746,10937894.75,19.63346571286624,41.772134182217926,NaN,NaN,-215.0511050117536,-231.226290614126,-0.8542129160915608,-1.3366278428505325,-0.48241492675897174,490430054,537144354.8,13.446873238967228,31.34568586027038,NaN,NaN,-30.971497560250484,-7.924866978397985
2015-08-26T09:30:00-04:00,69.84,70.9,68.17,70.83,26115647,11775326.3,36.71927175933151,41.09600528045219,NaN,NaN,-142.88553804518622,-256.72128728065894,-0.7449070836411398,-1.4135487813103964,-0.6686416976692566,516545701,524655365,11.410041343194038,28.825055250557543,NaN,NaN,-30.107673859094277,-11.093839389926025
2015-08-27T09:30:00-04:00,71.75,72.31,70.69,72.21,18689677,12440755.1,42.99488187996186,40.9277934476966,NaN,NaN,-74.1275033534908,-241.63417838803002,-0.543182790448465,-1.3476201857298378,-0.8044373952813728,535235378,518502884.4,10.561329804797936,26.823366650154647,NaN,NaN,-26.74893541189196,-13.3302816787783
2015-08-28T09:30:00-04:00,71.85,72.2399,71.23,71.8,10045598,12547521.15,41.67259855153718,40.338273886430215,NaN,NaN,-63.461563977549496,-196.27460320077665,-0.4071027120679981,-1.3133157853663704,-0.9062130732983723,525189780,515142942.6,10.118677404120845,25.055308565955567,NaN,NaN,-24.856197035641824,-14.97684101547309
2015-08-31T09:30:00-04:00,71.48,72.1,70.31,70.49,15143084,12882284.1,37.68469298302211,39.7721307912517,NaN,NaN,-74.42373134793039,-113.98988834718212,-0.37580872636911145,-1.3759739812597616,-1.0001652548906501,510046696,515489521.8,10.535212669814499,23.522543996862257,NaN,NaN,-24.880479629573607,-16.391646531773162
2015-09-01T09:30:00-04:00,68.64,69.76,68.32,68.64,21723623,13429531.05,32.89690952309061,38.83595616924288,NaN,NaN,-111.53660344512825,-93.28698803385703,-0.4454381103161351,-1.556962892785819,-1.111524782469684,488323073,515068125.6,10.471669183413525,22.13206048185994,NaN,NaN,-26.74860940106056,-17.871212655957077
2015-09-02T09:30:00-04:00,69.78,70.05,68.91,70.05,12491700,13784554.5,39.2336343581187,38.437029003389455,NaN,NaN,-82.02169738564909,-81.11421990194961,-0.3656133921811624,-1.5685415226961368,-1.2029281305149744,500814773,511921940,9.987323687713769,20.78067178859502,NaN,NaN,-25.817445571885937,-19.006388786804056
2015-09-03T09:30:00-04:00,70.45,70.84,69.39,69.55,14080063,13820550.15,37.868012640115424,37.809993490008246,NaN,NaN,-68.1018698101055,-79.90909319327254,-0.3173567129120005,-1.599624021654975,-1.2822673087429746,486734710,502221806.4,8.657723352021506,19.120399551598492,NaN,NaN,-25.592405026657083,-19.947248249640204
2015-09-04T09:30:00-04:00,68.49,69.27,68.18,68.68,16587918,14106765.1,35.54935047044479,36.58158789410042,NaN,NaN,-88.64706045582416,-84.94619248892748,-0.3143051791662166,-1.6751487827007452,-1.3608436035345286,470146792,491213208.8,7.446166739596308,17.21204688717234,NaN,NaN,-26.204443474892862,-20.841133281819154
2015-09-08T09:30:00-04:00,69.94,70.7,69.52,70.6,11697448,14294081.5,43.73692204499124,36.003981751992335,NaN,NaN,-45.481179302449924,-79.15768207983139,-0.1609796741746361,-1.5620681962528238,-1.4010885220781877,481844240,485572717.6,6.912414862369943,15.046777822052073,NaN,NaN,-23.82660738777577,-21.2676295826701
2015-09-09T09:30:00-04:00,71.42,71.47,69.33,69.51,12423990,14519537.65,40.58481246317283,35.38801758548903,NaN,NaN,-45.17539877993403,-65.88544114679254,-0.11322719447774343,-1.542622515175367,-1.4293953206976235,469420250,481792153,6.572357443445782,13.002335312069652,NaN,NaN,-22.993364343897984,-21.514163119988368
2015-09-10T09:30:00-04:00,69.54,70.71,69.32,70.18,17313714,14901928.6,43.2902874592205,35.794052959264484,NaN,NaN,-41.40577353924749,-57.76225637751222,-0.02157194964030329,-1.4563602577480026,-1.4347883081076993,486733964,478975991.2,6.322829297913501,11.15993136530569,NaN,NaN,-21.433649367515343,-21.502661155349365
2015-09-11T09:30:00-04:00,69.89,70.66,69.69,70.63,7633029,14967114.2,45.098512818170285,36.98972566050974,NaN,NaN,-29.635195085241225,-50.06892143253937,0.07880525925872961,-1.3362817340342872,-1.4150869932930168,494366993,480502447.8,8.353894747576092,9.929479377544775,NaN,NaN,-19.616283379714456,-21.23317861597295
2015-09-14T09:30:00-04:00,70.65,70.7799,70.09,70.41,6232241,15003528.3,44.35391472904954,38.665519099506646,NaN,NaN,-21.729300175509806,-36.6853693764765,0.13644983921874454,-1.244524694269586,-1.3809745334883305,488134752,484100039.8,13.134152822431389,9.56647618552688,NaN,NaN,-18.380955731030152,-20.825718203838264
2015-09-15T09:30:00-04:00,70.76,71.59,70.5,71.42,8414579,15134457.6,48.55343297971393,40.73123104713862,NaN,NaN,11.798316909289147,-25.229470134128697,0.24247334080489757,-1.0778828574822086,-1.3203561982871062,496549331,487041058,16.947954877842776,9.81655344544656,NaN,NaN,-16.054247064358336,-20.144079469626845
2015-09-16T09:30:00-04:00,71.45,71.75,70.91,71.62,12003378,15461331.25,49.36828879054687,41.63473226365401,NaN,NaN,36.48084478439118,-8.898221421263639,0.3210169325788612,-0.9190850325635296,-1.2401019651423908,508552709,494867549.8,26.22998676683703,10.875120975706777,NaN,NaN,-13.925441140251202,-19.255702565430326
2015-09-17T09:30:00-04:00,71.55,73.26,71.55,72.27,19148977,15915263.1,52.02768524689187,42.27993250414901,NaN,NaN,100.46926280214394,19.47678584701465,0.40620555058250485,-0.7323450269142597,-1.1385505774967646,527701686,503061094.2,34.48508536211129,12.58396065837202,NaN,NaN,-11.350716714348073,-18.126418872418576
2015-09-18T09:30:00-04:00,71.02,71.674,70.81,70.91,23715976,16451418.45,46.52179921183918,42.62630397988487,NaN,NaN,51.833457392981494,35.7705163426592,0.3618940852778614,-0.6861829708994378,-1.0480770561772992,503985710,504984837.6,36.287792066057904,14.453183134224664,NaN,NaN,-10.671320783986497,-17.061404859785423
2015-09-21T09:30:00-04:00,71.4,71.57,69.5,69.97,23860059,16444006.8,43.124814573711625,43.01488409350555,NaN,NaN,10.68532868544336,42.25344211484983,0.2647159458010441,-0.7171821239259941,-0.9818980697270382,480125651,503383017.4,35.41399393889995,16.230238939159342,NaN,NaN,-11.10316964620085,-16.21022840070191
2015-09-22T09:30:00-04:00,69.01,69.655,68.76,69.54,29233976,16221921.15,41.62740134364253,43.638490652116396,NaN,NaN,-89.6048050637718,21.972817720237632,0.1714399051614014,-0.7675981882752865,-0.9390380934366879,450891675,494251486.2,30.852972607492333,17.686046326593544,NaN,NaN,-11.897224430932829,-15.594084976449185
2015-09-23T09:30:00-04:00,69.6,70.12,69.11,69.47,9578719,15806669.8,41.37553374459952,43.79148346543646,NaN,NaN,-72.73933510516592,0.1287817423262112,0.1080829214101372,-0.8039344416740164,-0.9120173630841536,441312956,480803535.6,25.619849513674097,18.802655314162138,NaN,NaN,-12.616265768453625,-15.16868223244982
2015-09-24T09:30:00-04:00,68.9,69.17,67.9869,68.76,20064475,15504111.2,38.810532414512046,43.85880630646479,NaN,NaN,-137.6376516973543,-47.49260115757344,0.02571025298463503,-0.8798795468533598,-0.9055897998379948,421248481,459512894.6,19.872847473118753,19.603735608526225,NaN,NaN,-13.95745745051965,-14.995650120745509
2015-09-25T09:30:00-04:00,69.31,69.5199,66.345,66.88,30973747,16118314.7,32.980335324726184,43.675305224627756,NaN,NaN,-192.34018501421863,-96.32732963901347,-0.138988232340298,-1.0793250902633673,-0.9403368579230693,390274734,436770699.4,15.796628465286972,20.200197160361274,NaN,NaN,-17.002915754006104,-15.28240235406845
2015-09-28T09:30:00-04:00,66.46,66.6,63.73,64.29,66470176,18939543.6,26.96951925326327,42.47763359664718,NaN,NaN,-296.5630417656345,-157.77700372922905,-0.39164693704419906,-1.4298955292283182,-1.0382485921841191,323804558,405506480.8,12.117075208242625,20.571958613637893,NaN,NaN,-21.932544350823115,-16.232422639319118
2015-09-29T09:30:00-04:00,64.46,65.98,64.075,64.88,31776031,19771190.95,30.095046257760927,41.72836458197491,NaN,NaN,-224.0632916017842,-184.6687010368315,-0.4823598028511915,-1.6411983457481085,-1.158838542896917,355580589,386444263.6,10.509654217689459,20.853194097512443,NaN,NaN,-24.870157306578065,-17.466384734641824
2015-09-30T09:30:00-04:00,65.84,66.42,65.3796,66.23,26565616,20013290.6,36.76389195731957,41.26219347469627,NaN,NaN,-145.26901926301016,-199.17463786840034,-0.4172120158648789,-1.6803535627280155,-1.2631415468631366,382146205,374610913.4,9.653529661360253,21.091101266330067,NaN,NaN,-25.17809638407969,-18.568057827418663
2015-10-01T09:30:00-04:00,66.39,66.95,65.75,66.9,19853143,20381362.75,39.831753725348065,40.88599639663754,NaN,NaN,-104.1604167428701,-192.47919087750353,-0.3002340466943241,-1.6384341052310418,-1.3382000585367178,401999348,370761086.8,9.385655232113052,21.164798443796993,NaN,NaN,-24.448397220657196,-19.408106312167025
2015-10-02T09:30:00-04:00,66.03,68.3,65.72,68.29,23741758,20864447.5,45.715710740704964,40.98326754032721,NaN,NaN,-61.1218442020863,-166.23552271507705,-0.11026908981678751,-1.4760364208077021,-1.3657673309909146,425741106,377854361.2,14.114501950753692,21.2348233815343,NaN,NaN,-21.90548639456343,-19.76487489536651
2015-10-05T09:30:00-04:00,68.88,69.02,67.8,68.47,18389806,20954541.9,46.44606889404807,40.83274153420822,NaN,NaN,-23.070599122595738,-111.5370341864693,0.03851637236228522,-1.317621865538058,-1.3561382379003433,444130912,401919632,27.86804686840503,22.014829952288746,NaN,NaN,-19.66334402257927,-19.750370484968332
2015-10-06T09:30:00-04:00,68.25,68.45,65.91,66.86,30431551,21891247.05,41.11732733720479,40.24338714468378,NaN,NaN,-65.62711744403686,-79.84979935491984,0.03937034042271881,-1.3069253123719449,-1.3462956527946637,413699361,413543386.4,33.414493927625514,22.52800903520221,NaN,NaN,-19.36868206326585,-19.695843567582262
2015-10-07T09:30:00-04:00,67.35,68.26,66.53,67.93,27466142,22643354.65,45.585528297730356,39.78323307688653,NaN,NaN,-42.87565571740219,-59.371126645798235,0.11840055352374579,-1.1982949608899816,-1.3166955144137273,441165503,425347246,38.57941207021636,22.820460942924,NaN,NaN,-17.698921741951338,-19.41056902106356
2015-10-08T09:30:00-04:00,67.54,68.35,66.87,68.13,23182733,22936805.6,46.404194547700996,39.7748327437338,NaN,NaN,-31.66711511138379,-44.872466319500965,0.186496001795857,-1.0835755121689061,-1.2700715139647631,464348236,437817023.6,43.56009998156434,23.339911508317318,NaN,NaN,-16.11569747384024,-18.93987308574594
2015-10-09T09:30:00-04:00,68.24,68.73,67.94,68.44,13890014,23249654.85,47.717203420498564,40.10286051850431,NaN,NaN,-6.942056218643333,-34.03650872281237,0.2507629563015805,-0.9566178185877874,-1.207380774889368,478238250,448316452.4,47.42589562131785,24.19790448563288,NaN,NaN,-14.434246535842481,-18.296212150045445
2015-10-12T09:30:00-04:00,68.14,68.84,68.05,68.62,11074523,23491768.95,48.50604286874897,40.5941920560119,NaN,NaN,1.9585568926996604,-29.030677519753276,0.30039346933563893,-0.8318889382198194,-1.1322824075554583,489312773,457352824.6,50.564283450920215,25.605855260163445,NaN,NaN,-12.827158787477366,-17.51491881253572
2015-10-13T09:30:00-04:00,68.31,69.19,67.69,67.76,17273345,23934707.25,45.011697461952394,40.85391803582282,NaN,NaN,-4.176839824914687,-16.74062199592884,0.2711934030561398,-0.7932906537352835,-1.0644840567914233,472039428,469020838,54.353341113410224,27.658247517287453,NaN,NaN,-12.398889170388331,-16.78405743508609
2015-10-14T09:30:00-04:00,68.12,68.68,67.445,67.63,21786239,24423850.3,44.48994864350439,41.259590623608,NaN,NaN,-10.506190837932593,-10.266729020034921,0.24008336255473783,-0.7643798535980011,-1.004463216152739,450253189,470838375.2,54.932799212876695,30.162529784413017,NaN,NaN,-12.1848030789514,-16.12702109849542
2015-10-15T09:30:00-04:00,67.26,69.14,67.185,69.14,22133323,24573067.6,51.51941296994648,42.58381045540945,NaN,NaN,31.542207512867478,2.375135504815332,0.3135207970572276,-0.6125622198312044,-0.926083016888432,472386512,472446030.4,55.4712522235651,32.99643148143288,NaN,NaN,-9.946420704743133,-15.244078185102236
2015-10-16T09:30:00-04:00,69.33,69.86,69.155,69.76,17656979,24270117.75,54.09014018023268,44.520997664478685,NaN,NaN,105.72926628409795,24.90940000536359,0.39112455369182,-0.437177324773657,-0.828301878465477,490043491,474807078.6,56.297088998466954,36.15214675216319,NaN,NaN,-7.2967878622418825,-14.108750996122186
2015-10-19T09:30:00-04:00,69.53,70.2,69.15,70.01,15694684,23861849,55.12347333325048,46.30874245558509,NaN,NaN,122.17830374309818,48.953349375443295,0.44276757558004287,-0.27484240899042334,-0.7176099845704662,505738175,478092159,57.47873064759556,39.50708078287077,NaN,NaN,-4.8030194488016775,-12.7793607750764
2015-10-20T09:30:00-04:00,69.79,70.01,68.615,68.91,14802071,23140253.75,49.810997191353565,47.240678543730375,NaN,NaN,85.06652219319045,66.80202177906433,0.38826869630756333,-0.23227411418601207,-0.6205428104935754,490936104,481871494.2,58.85697351092332,43.021612486410994,NaN,NaN,-4.1007774173663885,-11.539563152546398
2015-10-21T09:30:00-04:00,69.3,69.57,67.16,68.29,36068323,24464733.95,47.05816885877373,47.756851053260775,NaN,NaN,38.093774013198036,76.52201474929045,0.29984658673940934,-0.2457345770693138,-0.5455811638087231,454867781,482794412.6,59.20471942153389,46.58011707136962,NaN,NaN,-4.29495103717749,-10.504618564636553
2015-10-22T09:30:00-04:00,68.39,68.5,67.03,67.88,35524535,25237736.95,45.27619761788206,47.725457258773424,NaN,NaN,5.48372246573263,71.31031773986348,0.20751558509606677,-0.28618668243863965,-0.4937022675347064,419343246,472185759.4,53.5969809100948,49.40029413989398,NaN,NaN,-4.963962955427808,-9.71309633474959
2015-10-23T09:30:00-04:00,68.58,69.69,68.3,69.33,26524171,25015258.15,52.173830758842456,48.134583106258745,NaN,NaN,85.9779432755715,67.3600531381582,0.2358025940100491,-0.19894902502214507,-0.43475161903219417,445867417,463350544.6,49.40033021659728,50.93831437905057,NaN,NaN,-3.512651279427122,-8.827318469703522
2015-10-26T09:30:00-04:00,69.16,70.07,68.93,69.6,17831899,22583344.3,53.35287249035037,49.00855061719771,NaN,NaN,108.94797102622881,64.71398659478432,0.26236549831829403,-0.1067947461343266,-0.36916024445262063,463699316,454942772.8,45.730727156055366,51.818045323938414,NaN,NaN,-1.9769486103561058,-7.848694204082463
2015-10-27T09:30:00-04:00,69.79,70.88,69.78,70.88,25160920,22252588.75,58.56763136156443,49.93584369318586,NaN,NaN,174.11127024742342,82.52293620563091,0.3503131523382577,0.0687311959702015,-0.2815819563680562,488860236,454527599.2,45.55079090947456,52.316000955314,NaN,NaN,0.9863174671249081,-6.586549679624268
2015-10-28T09:30:00-04:00,70.77,71.505,70.14,71.47,18157979,21832206.9,60.7459457962818,50.96025449665592,NaN,NaN,187.2046494202526,112.34511128704182,0.42729259433754,0.2525337865538688,-0.1747588077836712,507018215,464957686,50.78935741825798,52.832376486506405,NaN,NaN,4.129181156856403,-5.055730988698458
2015-10-29T09:30:00-04:00,71.88,73,71.49,71.79,22780683,21978583.9,61.915477429340385,51.974416925858904,NaN,NaN,214.1525470198059,154.07887619785646,0.47515732849405723,0.41918785283390037,-0.055969475660156864,529798898,487048816.4,59.645215007153574,53.705185014066096,NaN,NaN,7.070746166578844,-3.323377109373129
2015-10-30T09:30:00-04:00,72.01,72.205,71.34,71.34,12427166,21412854.3,59.242424857254576,52.7413013536093,NaN,NaN,155.8676937018646,168.05682628311507,0.4520417985574633,0.5090827725366722,0.05704097397920896,517371732,501349679.4,64.14369793124321,54.67514319123203,NaN,NaN,8.798024749297431,-1.5917482724201921
2015-11-02T09:30:00-05:00,71.75,72.91,71.34,72.86,18646619,21425694.95,64.77442434025549,54.15292470205952,NaN,NaN,165.42693526043843,179.35261912995702,0.510339471502644,0.694965313357514,0.18462584185486997,536018351,515813486.4,68.02587039477787,55.65175242561543,NaN,NaN,12.08290684095907,0.36177388663398813
2015-11-03T09:30:00-05:00,72.67,72.83,72.09,72.6,10428704,20425552.6,63.1943891607503,55.48895616757709,NaN,NaN,148.6434975720568,174.25906459488368,0.5018506939480949,0.8119392092899886,0.31008851534189374,525589647,523159368.6,69.81346337301066,56.71465700848214,NaN,NaN,14.304840471846832,2.353640541664394
2015-11-04T09:30:00-05:00,72.86,72.88,71.84,72.28,11533043,19628897.65,61.2152155512847,56.18151349481553,NaN,NaN,120.79331615523276,160.9767979418797,0.44697357976080687,0.8688054900429023,0.42183191028209543,514056604,524567046.4,70.157769832102,57.763693980520486,NaN,NaN,15.5898615267514,4.244529253819681
2015-11-05T09:30:00-05:00,72.33,72.35,71.37,72.05,9171965,18928359.25,59.766361206834304,56.58695785385851,NaN,NaN,88.88486056981101,135.92326065188075,0.3706227504112112,0.8851103482961094,0.5144875978848982,504884639,519584194.6,67.23440614872283,58.54493091982448,NaN,NaN,16.260677674375458,5.961121885327649
2015-11-06T09:30:00-05:00,71.61,71.82,70.92,71.75,12661051,18866911.1,57.843285424556015,56.78123014609462,NaN,NaN,61.9266913774422,117.13506018699627,0.27950308836646776,0.8638664583429829,0.5843633699765152,492223588,514554565.8,64.3209905373944,59.033663769095824,NaN,NaN,16.30526460256628,7.438856559218881
2015-11-09T09:30:00-05:00,71.62,71.62,70.79,71.2,15624969,19094433.4,54.38811324029847,57.10816700673354,NaN,NaN,43.45837145471573,92.74134742585171,0.16731179133025742,0.793503109139337,0.6261913178090796,476598619,502670619.4,57.93323769694676,58.96768263952607,NaN,NaN,15.39090978544598,8.57486416296561
2015-11-10T09:30:00-05:00,71.22,71.84,71.075,71.68,9737401,18717636.2,56.81269100298821,57.804918588463146,NaN,NaN,52.87182869036838,73.58701364951403,0.11314531120081694,0.7676229568101007,0.6544776456092838,486336020,494819894,54.11020226361624,58.60378855681766,NaN,NaN,15.253478920594684,9.52895198548405
2015-11-11T09:30:00-05:00,71.95,71.95,70.96,70.97,10580927,18157370.6,52.37757237505724,58.312159642547094,NaN,NaN,36.30966169897339,56.690282758262164,0.02198625758109607,0.6819604675856539,0.6599742100045578,475755093,487159591.8,50.60136252270582,58.38981581486131,NaN,NaN,13.877586401523581,10.150185473489696
2015-11-12T09:30:00-05:00,70.78,70.89,69.74,69.74,10870840,17594246.45,45.71890733704134,57.85109368384701,NaN,NaN,-30.2278034017181,32.86774996395635,-0.12081561252671946,0.5089546943461585,0.6297703068728779,464884253,479159514.6,47.16176679661402,58.22991842771965,NaN,NaN,10.59091317671727,10.213146573950779
2015-11-13T09:30:00-05:00,69.6,70.28,69.48,69.57,18196826,17621238.8,44.86987322670444,57.24516516501516,NaN,NaN,-50.34218552406,10.41397458365591,-0.2205782026555596,0.35404755355342843,0.574625756208988,446687427,470052282.4,43.53391274509556,58.07300311265109,NaN,NaN,7.6474316054066165,9.846615864158755
2015-11-16T09:30:00-05:00,69.42,70.44,69.41,70.44,12959812,17484495.2,49.98850777752552,56.63237062329809,NaN,NaN,-33.83659011691875,-5.0450177306709865,-0.2212617733659613,0.2980485395015364,0.5193103128674977,459647239,466662006.4,42.23155544997546,57.83591486554401,NaN,NaN,6.543303616502567,9.374714114493585
2015-11-17T09:30:00-05:00,70.58,71.21,70.22,70.74,7882337,17138508.5,51.655371317135284,55.98304387478762,NaN,NaN,-2.9533838102657657,-16.210060230797815,-0.19568046831619312,0.2747097274722563,0.47039019578844943,467529576,462900717.6,40.774171770870225,57.120544462159174,NaN,NaN,6.10174367720093,8.907146909166062
2015-11-18T09:30:00-05:00,70.78,72.2,70.78,72.12,12816317,15975908.2,58.5063739952578,55.73953648663886,NaN,NaN,51.500474190493826,-13.171897732493727,-0.08560878996449539,0.3633792083328302,0.4489879982973256,480345893,463818877.6,41.306638138373565,55.81064611438917,NaN,NaN,7.822836783994276,8.752245462712951
2015-11-19T09:30:00-05:00,71.66,71.75,70.85,70.91,11127995,14756081.2,51.601451702410564,55.19375268986429,NaN,NaN,5.190214733789792,-6.08829410539215,-0.09344295128025742,0.3321843091970038,0.42562726047726124,469217898,464685606.6,41.83821783723148,54.217397536245485,NaN,NaN,7.101078267199686,8.516364434782485
2015-11-20T09:30:00-05:00,71.28,71.87,71.28,71.52,9224471,13891096.2,54.51582438954406,54.460995550527755,NaN,NaN,31.51972097032956,10.284087193485734,-0.05840640546669368,0.3526192536438941,0.4110256591105878,478442369,471036595,45.717754668916484,52.62396069868396,NaN,NaN,7.431972451123579,8.361451294259783
2015-11-23T09:30:00-05:00,71.38,71.78,71.13,71.34,10362770,13517639.75,53.492223263681296,53.76798370073711,NaN,NaN,10.239557368917634,19.09931669065301,-0.04861883899826219,0.35025211036276005,0.39887094936102224,468079599,472723067,46.733807584550966,50.97541385665112,NaN,NaN,7.387253029503101,8.222280113580258
2015-11-24T09:30:00-05:00,70.9,71.63,70.86,71.56,7174651,12618326.3,54.61389542065588,53.29646083426362,NaN,NaN,-2.0012771969926266,19.289738013307637,-0.029532046341100182,0.361955891434647,0.3914879377757472,475254250,474268001.8,47.69959005848966,49.37125815853595,NaN,NaN,7.676906878282757,8.1443696513949
2015-11-25T09:30:00-05:00,71.75,72.05,71.6,71.95,4594389,11940146.8,56.61164107397742,53.07112368191671,NaN,NaN,55.32103083665762,20.0538493425404,0.005299072281038708,0.39811177812704557,0.39281270584600686,479848639,474168551,47.63971036241666,47.97163703094265,NaN,NaN,8.494221884474168,8.194348541834795
2015-11-27T09:30:00-05:00,72.14,72.22,71.9,72.09,2657960,10934010.65,57.33759774949043,53.035003133697735,NaN,NaN,80.12162216584908,35.04013082895226,0.03220603099384067,0.4330702445883077,0.400864213594467,482506599,476826291.2,49.465463904089496,46.910527985706594,NaN,NaN,9.373424391490893,8.362787948928524
2015-11-30T09:30:00-05:00,72.2,72.21,71.11,71.11,8846140,10754959.35,50.91558792892007,52.78696561145643,NaN,NaN,9.457203355333638,30.62762730595307,-0.01881341498043987,0.37734744486891714,0.396160859849357,473660459,475869909.2,48.805961270545346,46.25857966953506,NaN,NaN,8.303154616732805,8.354268901471993
2015-12-01T09:30:00-05:00,71.48,72.37,71.3171,72.31,10659529,10355604.85,57.2322510730644,52.816934187890446,NaN,NaN,77.64649694060175,44.10901522028989,0.023164288637169572,0.425116220645819,0.4019519320086494,484319988,479117987,51.18628497733026,46.04972843480034,NaN,NaN,9.281002467750527,8.486659410940355
2015-12-02T09:30:00-05:00,72.39,72.6085,71.59,71.7,9875112,10327925.25,53.465628759588355,52.89465250107123,NaN,NaN,80.17808333944998,60.54488732757842,0.005667495766858266,0.4090363017172223,0.403368805950364,474444876,478956112.2,51.058868580003235,46.08240743889302,NaN,NaN,8.943735114353203,8.551955939999333
2015-12-03T09:30:00-05:00,71.76,71.85,69.82,70.13,13191350,10410840.6,45.217229143260724,52.858818344372615,NaN,NaN,-85.91498408276861,32.29768434369317,-0.10946742312948976,0.2665345270385018,0.37600195016799154,461253526,475237089.6,48.09662626794811,46.14918311541688,NaN,NaN,5.87400155219101,8.169391027455287
2015-12-04T09:30:00-05:00,70.44,71.89,70.272,71.78,14929777,10698731.2,53.36080323918302,53.465313345263944,NaN,NaN,10.405660442851756,18.354491999093703,-0.07402208926097459,0.2834743385917733,0.3574964278527479,476183303,473972430.4,47.09602055091785,46.40361938726132,NaN,NaN,6.025611600235514,7.863136823566748
2015-12-07T09:30:00-05:00,71.63,72,71.01,71.38,8511194,10491238.35,51.36729301363133,53.56379800498578,NaN,NaN,30.76358202698675,22.615767733424327,-0.07671157266739476,0.2616069620185044,0.3383185346858992,467672109,472774760.4,46.11751650716384,46.681188034203366,NaN,NaN,5.474468891104362,7.521898547500693
2015-12-08T09:30:00-05:00,70.84,71.74,70.84,71.54,7483564,10084168.1,52.13755011088801,53.59823934739669,NaN,NaN,17.431236550567398,10.572715655417458,-0.06724950065409058,0.25425665886828597,0.32150615952237654,475155673,470941897.4,44.59065454396959,46.9537939465676,NaN,NaN,5.283964612082651,7.20219369958383
2015-12-09T09:30:00-05:00,71.21,71.9,70.54,70.82,17593633,10476979.7,48.421014119639274,52.877856499138225,NaN,NaN,-18.031790988922452,-9.069259210257032,-0.10667335551309348,0.1881644651310097,0.2948378206441032,457562040,467565330.2,41.8422600181696,46.99205265226732,NaN,NaN,3.9542856152635126,6.738206830395214
2015-12-10T09:30:00-05:00,70.82,71.84,70.75,71.35,9778498,10436858.25,51.179783999654724,52.84773737751281,NaN,NaN,12.21409348009864,10.556556302316421,-0.09465608871423548,0.17651770975130887,0.27117379846554435,467340538,468782732.6,43.20155927757414,47.089434183720364,NaN,NaN,3.6989387500282085,6.30402567605707
2015-12-11T09:30:00-05:00,70.59,70.88,70.21,70.3,15178270,10652229.75,45.93763433478063,52.23500951645828,NaN,NaN,-108.71802345812718,-13.268180477879365,-0.15164265688231698,0.0816204773626481,0.2332631342449651,452162268,463978525.6,39.29808609467379,46.63088642841732,NaN,NaN,1.8128747602982684,5.662432688091527
2015-12-14T09:30:00-05:00,70.57,70.85,69.67,70.76,21091489,10796962.9,48.429723862727464,51.87340241639015,NaN,NaN,-129.95226143017024,-45.41134916931076,-0.15218186525817196,0.043035802672250156,0.1952176679304221,473253757,465094855.2,40.640230954930445,46.19563095487299,NaN,NaN,1.0284136144201552,5.000429963281331
2015-12-15T09:30:00-05:00,71.53,72.02,71.3,71.68,14006263,10849285.45,53.087434042669784,51.76436946081971,NaN,NaN,56.9756160778876,-37.50247326384672,-0.08760971727902,0.0857055213316471,0.1733152386106671,487260020,467515724.6,43.554884749361214,45.899580575649544,NaN,NaN,1.813688181435676,4.54518113730338
2015-12-16T09:30:00-05:00,72.28,72.72,71.27,72.61,15273744,11218855.8,57.28707464681131,51.81261471602214,NaN,NaN,138.86622289028676,-6.122870488004878,0.015225845654858544,0.19234754567924028,0.17712170002438174,502533764,476510069.4,52.82329472165116,46.269836601309144,NaN,NaN,3.8274925933089876,4.442654202447038
2015-12-17T09:30:00-05:00,72.81,72.81,71.77,71.83,11469063,11151493.1,53.00151486140658,51.50289450973043,NaN,NaN,116.78245631829473,14.790802079634341,0.027490457749812985,0.21148477221164796,0.18399431446183498,491064701,481254902,56.84869313261263,46.79721011763223,NaN,NaN,4.1685311622045385,4.403493768126681
2015-12-18T09:30:00-05:00,71.34,71.43,70.48,70.49,15159769,11353081.8,46.55777487843302,51.19162214898137,NaN,NaN,-101.28416271083034,16.27757422909371,-0.05345652677436338,0.11717365599388074,0.17063018276824413,475904932,486003434.8,60.48274608791477,47.63126617601576,NaN,NaN,2.3369815641583704,4.108277738988351
2015-12-21T09:30:00-05:00,70.91,71.13,70.55,71.13,6707204,11227218.45,49.702999523957274,50.65381846690229,NaN,NaN,-71.27762959285937,28.012500596555878,-0.062102546966760014,0.09300199905979412,0.15510454602655413,482612136,487875110.6,61.84665626494312,48.39272126798811,NaN,NaN,1.8511407668092978,3.785829600105629
2015-12-22T09:30:00-05:00,71.38,71.71,70.965,71.61,7495791,11083869.5,51.98537266118233,50.54808588844471,NaN,NaN,4.871602280687571,17.59169783711587,-0.03504776669730403,0.1112948376549241,0.14634260435222812,490107927,488444692,62.27338968425002,49.193758489720025,NaN,NaN,2.169965373329695,3.5549918534233527
2015-12-23T09:30:00-05:00,72.06,72.54,71.99,72.38,8090966,11129685.25,55.475772093300584,51.280838956304706,NaN,NaN,121.73389183022142,14.165231625102802,0.03155233083142503,0.18578301789150942,0.1542306870600844,498198893,487577717.8,61.15222002467804,50.12630090091501,NaN,NaN,3.533195501376566,3.5518780888452404
2015-12-24T09:30:00-05:00,72.14,72.68,72.11,72.45,2568255,11028378.55,55.79040928661237,51.454382245406805,NaN,NaN,125.90586069834706,15.989912501113267,0.07470310111754735,0.24760956345701857,0.1729064623394712,500767148,489518207.2,62.76797418249689,51.24572616031352,NaN,NaN,4.716697007509732,3.7182807915115963
2015-12-28T09:30:00-05:00,72.24,72.2999,71.91,72.11,6534743,11222217.7,53.80168269215557,51.62826722244425,NaN,NaN,84.30358882146858,53.10746280757305,0.0745587470517291,0.2661048961541326,0.19154614910240347,494232405,493183701.8,65.6723890364834,52.642502769550624,NaN,NaN,5.135151870710556,3.920690945682876
2015-12-29T09:30:00-05:00,72.59,73.16,72.44,72.99,7243106,11142066,57.97701346668229,52.04537174785812,NaN,NaN,152.60510353231663,97.88400943260825,0.12497303047805741,0.34776243719997524,0.22278940672191783,501475511,496956376.8,68.40432846385534,54.343479478113885,NaN,NaN,6.738786364493185,4.32327600551292
2015-12-30T09:30:00-05:00,72.91,73.1,72.61,72.68,8496453,11033912.2,56.055058342725964,52.59066062093575,NaN,NaN,130.3735641598205,122.98440180843484,0.1282058295990945,0.3830466937207859,0.25484086412169143,492979058,497530603,68.81118810391155,56.26983148423831,NaN,NaN,7.52433221781071,4.78056975012689
2015-12-31T09:30:00-05:00,72.42,72.75,72.03,72.03,6591727,10869742.95,52.15125013640394,52.66005105927498,NaN,NaN,70.27793561931733,112.69321056625401,0.07970650702592208,0.35447399790409406,0.274767490878172,486387331,495168290.6,65.09737935810197,57.83381863284744,NaN,NaN,7.075716082425208,5.108447797598078
2016-01-04T09:30:00-05:00,70.77,71,70.01,70.73,19666268,11193488.85,45.348952881444184,52.618002384036664,NaN,NaN,-106.23834232609366,66.26436996136587,-0.040338241310788725,0.2243446892396861,0.2646829305504748,466721063,488359073.6,55.756265161427855,59.00940285190131,NaN,NaN,4.558812798577802,5.029928512023753
2016-01-05T09:30:00-05:00,70.93,71.38,70.76,71.07,14540153,11174007.65,47.285556577453725,52.53627614937425,NaN,NaN,-52.87362990409415,38.82892621625333,-0.09418042470600504,0.1469573996679685,0.24113782437397355,481261216,485764835.8,52.65612476874196,59.867680981459266,NaN,NaN,3.0642075710871612,4.749111234747097
2016-01-06T09:30:00-05:00,70.06,70.98,70,70.49,14651688,11481032.35,44.39544604608376,51.91541986390382,NaN,NaN,-100.64340537744484,-11.820775565698957,-0.16220322120273767,0.03838379787055146,0.20058701907328913,466609528,478791639.2,45.35601504733627,59.99633314560034,NaN,NaN,0.9308527621221996,4.203645738657826
2016-01-07T09:30:00-05:00,69.13,70.01,68.87,69.06,17850377,11999373,38.19669172389669,50.551821083695636,NaN,NaN,-179.86572739619137,-73.86863387690133,-0.2894236041662281,-0.161192486134496,0.1282311180317321,448759151,469947657.8,38.13490789246987,58.947162657801684,NaN,NaN,-3.004717544561526,3.1738795553407764
2016-01-08T09:30:00-05:00,69.47,69.65,67.9,68.02,17022809,11970831.8,34.431368445212215,49.22538205396746,NaN,NaN,-202.84592129115933,-128.49340525899666,-0.42153024095542596,-0.39868168316255037,0.02284855779287559,431736342,459017460,31.467005940332058,57.13418500121021,NaN,NaN,-7.621591265059075,1.6316694381407977
2016-01-11T09:30:00-05:00,68.32,68.345,66.26,67.21,28563797,12910096.75,31.80191125822509,48.171391795381176,NaN,NaN,-228.9757890967465,-153.04089461312725,-0.5341354234197574,-0.6448207214818211,-0.11068529806206376,403172545,446307756.4,25.814699896717343,54.65789598755326,NaN,NaN,-12.344998277500345,-0.3649973783793654
2016-01-12T09:30:00-05:00,67.75,68.46,66.96,68.07,13726950,12837530.75,37.278688381028964,47.283940999457734,NaN,NaN,-166.6004834227385,-175.7862653168561,-0.5208216211332473,-0.7617123244786228,-0.24089070334537557,416899495,433435412.2,21.58565429052355,51.78211013223758,NaN,NaN,-14.549665877201692,-2.3913785924968405
2016-01-13T09:30:00-05:00,68.2,68.52,65.98,66.05,16202462,12593079.4,30.98455756777132,45.783882778499795,NaN,NaN,-178.93011696194392,-191.4436076337559,-0.6118899841458041,-1.0057531835276308,-0.3938631993818266,400697033,420252913.2,18.28245621803177,48.63990059893628,NaN,NaN,-18.773083430182243,-4.7316221407376124
2016-01-14T09:30:00-05:00,66.22,68.26,65.81,67.82,23342269,13059879.7,40.469246669744166,44.71198810538863,NaN,NaN,-132.87656315783462,-182.04577478608456,-0.5203455451613647,-1.0442951308335324,-0.5239495856721678,424039302,415308943.4,17.218260703795053,45.501760647444634,NaN,NaN,-18.925401822253388,-6.759304952382723
2016-01-15T09:30:00-05:00,66.1,67.18,65.92,66.87,17882291,13190307.05,37.49113845840071,43.40489733194493,NaN,NaN,-132.3492666083245,-167.9464438495176,-0.49153992327618634,-1.1383744897674006,-0.6468345664912143,406157011,410193077.2,16.169420357897536,42.17329251711611,NaN,NaN,-20.101109203889646,-8.665276988312284
2016-01-19T09:30:00-05:00,67.6,67.85,66.13,66.86,13495221,13291614.95,37.45988896956113,42.237626351759616,NaN,NaN,-105.06933764126526,-143.16515355842137,-0.4424588918921535,-1.199908181356406,-0.7574492894642526,392661790,408090926.2,15.745003827196925,38.60705071645278,NaN,NaN,-21.00424852414528,-10.427987207716997
2016-01-20T09:30:00-05:00,65.68,67.64,64.86,66.99,24665612,13766907.1,38.18126620053548,40.823644404177706,NaN,NaN,-104.5040164250426,-130.74586015888218,-0.3732996091525893,-1.2240738009049892,-0.8507741917523999,417327402,408176507.6,15.841852610115723,34.85258815547139,NaN,NaN,-21.495611282411133,-12.00907636124473
2016-01-21T09:30:00-05:00,67.16,67.5,66.16,66.79,17102840,14286688.9,37.465280906151555,39.4958031587081,NaN,NaN,-84.22083149380367,-111.80400306525414,-0.3153901150650713,-1.245011835583739,-0.9296217205186676,400224562,408082013.4,15.820229322351864,31.06751967107427,NaN,NaN,-22.103094080362947,-13.451078892547333
2016-01-22T09:30:00-05:00,67.73,68.03,67.405,67.85,11343828,14479090.75,43.51138041461858,38.878669607152005,NaN,NaN,-50.64639374410362,-95.35796918250794,-0.18643838765165144,-1.162669705083232,-0.9762313174315805,411568390,405587831,15.229342041735407,27.505517005619513,NaN,NaN,-20.805882113067227,-14.501765066907318
2016-01-25T09:30:00-05:00,67.65,68.1,67.13,67.22,10131859,14581135.4,40.975670747654114,38.566292311881284,NaN,NaN,-53.78518388571799,-79.64515263798663,-0.12714554839374403,-1.1351632529237605,-1.0080177045300165,401436531,404643735,15.000948811616524,24.594422980632988,NaN,NaN,-20.46240721140703,-15.35328537326442
2016-01-26T09:30:00-05:00,67.26,67.86,66.74,67.73,12449656,15075205.45,43.82944546506117,38.31942723242468,NaN,NaN,-50.14206376717962,-68.6596978631695,-0.041579852149643326,-1.0599925197170705,-1.0184126675674272,413886187,408888614.4,20.755421431002958,22.31580131365163,NaN,NaN,-19.33062146949414,-15.92147624415438
2016-01-27T09:30:00-05:00,67.61,68.32,66.49,66.96,15924738,15544705.2,40.635009248638276,38.05082460403571,NaN,NaN,-52.10541349087983,-58.179977276336956,-0.025624174116960052,-1.0504428852136272,-1.0248187110966671,397961449,405015423.8,19.460806864898757,20.466143586334663,NaN,NaN,-19.294295387817044,-16.403307550391904
2016-01-28T09:30:00-05:00,67.28,67.32,65.05,65.4,26127268,16488913.3,35.05985467213314,37.82676481462403,NaN,NaN,-97.80782502841852,-60.89737598325992,-0.10449268167692805,-1.1554345631928271,-1.050941881515899,371834181,399337347.6,17.716203799060125,19.00766472251968,NaN,NaN,-21.021886451570168,-17.063104536274512
2016-01-29T09:30:00-05:00,65.26,66.5,65.07,66.47,17578208,16943001.05,41.03557771117344,38.29849404790697,NaN,NaN,-94.23360642872606,-69.6148185201844,-0.07058211842760143,-1.1391695295504007,-1.0685874111227993,389412389,394906147.4,16.474938991523587,17.936802797604795,NaN,NaN,-20.57808755829262,-17.565244967991383
2016-02-01T09:30:00-05:00,66.02,66.91,65.67,66.57,16705670,17448698.2,41.57666144834271,38.996690490058235,NaN,NaN,-77.33240788940597,-74.324263320922,-0.02950372922670641,-1.1054670726561824,-1.075963343429476,406118059,395842453,17.785695712979916,17.36330249876641,NaN,NaN,-20.061682818613875,-17.921878946651738
2016-02-02T09:30:00-05:00,66.1,66.275,65.41,65.61,12968699,17113819.75,37.974051192279816,39.04635926229044,NaN,NaN,-113.0106419498767,-86.8979789574614,-0.053665561303798404,-1.143045295059224,-1.0893797337554256,393149360,391695087.6,16.547001892200527,17.00339875602905,NaN,NaN,-20.71637574494451,-18.321092774979277
2016-02-03T09:30:00-05:00,65.8,66.11,64.57,66.04,19453147,17359469.45,40.46256301677879,39.723359651505255,NaN,NaN,-126.13640024482994,-101.70417630825143,-0.02862322962559727,-1.1251587707874222,-1.096535541161825,412602507,394623299.2,20.74401220407924,17.17922418360387,NaN,NaN,-20.51334690099446,-18.63427193583859
2016-02-04T09:30:00-05:00,65.84,66.42,65.09,65.68,18958125,17574791.3,39.05000556364497,39.6219852867839,NaN,NaN,-110.23832603535737,-104.19027650963919,-0.02440415804145668,-1.1270407387136459,-1.1026365806721892,393644382,398985339.4,26.661054127036508,17.853709428121114,NaN,NaN,-20.75318076908369,-18.936973197730747
2016-02-05T09:30:00-05:00,65.32,65.5,64.065,64.4,16743961,17519470.5,34.445552599966675,39.40444343975289,NaN,NaN,-187.08424265603668,-122.76040375510134,-0.09211450187443182,-1.2177797080152288,-1.125665206140797,376900421,396482945.8,25.48556796693599,18.519148543052435,NaN,NaN,-22.374509555765506,-19.42804982030714
2016-02-08T09:30:00-05:00,63.68,63.945,62.76,63.52,24652766,17900968.35,31.679897058718055,38.991586874692665,NaN,NaN,-244.41657709302322,-156.17723759582478,-0.17562230856707228,-1.3451930918496373,-1.169570783282565,352247655,385708865,21.15981792281788,18.905920978453928,NaN,NaN,-24.619589243820535,-20.169698309380482
2016-02-09T09:30:00-05:00,62.75,64.63,62.68,63.9908,20741677,17509862.35,34.700630378878756,38.74297003028862,NaN,NaN,-176.33457244589022,-168.84202369502748,-0.17804886266462838,-1.3921318616133505,-1.214082998948722,372989332,381676859.4,19.80503912683531,19.189005729648184,NaN,NaN,-25.57206036034812,-20.941464316661573
2016-02-10T09:30:00-05:00,64.41,65.56,64.355,64.56,14728499,17559939.8,38.25512537943464,38.79938749266598,NaN,NaN,-91.12066597778526,-161.83887684161854,-0.12284258697174288,-1.3676362326634006,-1.2447936456916577,387717831,376699924.2,18.251637215424125,19.362677722010492,NaN,NaN,-25.316597386340412,-21.566483326615693
2016-02-11T09:30:00-05:00,63.4,64.03,63.04,63.52,22801091,17889871.25,34.55410328870879,38.15958198367242,NaN,NaN,-153.02413479463402,-170.39603859347386,-0.1368225758067072,-1.4158218654500416,-1.2789992896433344,364916740,370954395.8,16.630002211535952,19.462724876996244,NaN,NaN,-26.218708393553662,-22.23108690760683
2016-02-12T09:30:00-05:00,63.87,64.4,63.33,64.37,10315981,17238556.85,39.68973153809386,38.067729182989545,NaN,NaN,-107.28196442845189,-154.4355829479569,-0.07250708982945997,-1.3696331519301594,-1.2971260621006995,375232721,370620855.8,16.538139225483093,19.572524192272425,NaN,NaN,-25.406222747250162,-22.684677741841593
2016-02-16T09:30:00-05:00,65.06,65.61,64.84,65.58,17302955,17209590.05,46.16592135072349,38.234620317679706,NaN,NaN,-25.221056231758116,-110.5964787757039,0.06065057617217717,-1.221312841885478,-1.2819634180576551,392535676,378678460,27.02541259683855,20.020380704117827,NaN,NaN,-22.622476866911008,-22.675791902565795
2016-02-17T09:30:00-05:00,66.09,66.49,65.59,66.41,12140012,17141829.6,50.12242054841767,38.91229255337824,NaN,NaN,27.93526403882529,-69.7425114787608,0.20558789485188367,-1.0249785494928005,-1.2305664443446842,404675688,385015731.2,34.044878902898944,21.06210013540355,NaN,NaN,-19.01646003022109,-22.15303020651655
2016-02-18T09:30:00-05:00,66.49,66.76,65.84,66,9722072,16394652.6,48.23651403836415,39.853482508109025,NaN,NaN,31.522581044065628,-45.213862074390626,0.270708138345227,-0.8921812714131505,-1.1628894097583775,394953616,386462888.2,35.56902016842224,22.337301304643706,NaN,NaN,-16.645215803138026,-21.366199577462474
2016-02-19T09:30:00-05:00,65.68,66.12,65.515,65.93,8875405,15983280.85,47.90510163655037,40.34416278849309,NaN,NaN,13.143197017399135,-11.980395711983983,0.3034678817475418,-0.7835545575739502,-1.087022439321492,386078211,390695182.4,39.94026370804896,24.013395927252663,NaN,NaN,-14.830946707456642,-20.4325920246045
2016-02-22T09:30:00-05:00,66.47,66.88,66.36,66.87,7515726,15791875.75,52.613389265069046,41.132500489687835,NaN,NaN,75.74331085610791,24.62465934492797,0.3779915465058975,-0.6145330061891201,-0.9925245526950176,393593937,394367425.6,43.520730173046715,25.851612674400286,NaN,NaN,-11.828026202467056,-19.20336833572772
2016-02-23T09:30:00-05:00,66.69,67.04,66.3,66.37,8211934,15695879.5,50.02357084842715,41.99318046512692,NaN,NaN,72.31606875275709,44.13208434183101,0.38202641932570125,-0.514991528537891,-0.8970179478635922,385382003,392936691,42.45870392507047,27.702448533890998,NaN,NaN,-10.05278019083385,-17.89614145788574
2016-02-24T09:30:00-05:00,65.99,66.68,65.285,66.59,11118606,15629327,51.16267199825673,42.757473963803925,NaN,NaN,51.76236457543265,48.897504449152486,0.3867467707158114,-0.4135844844688279,-0.8003312551846393,396500609,391301675.2,41.2207554164672,29.165073049061565,NaN,NaN,-8.260396846228575,-16.51960651336329
2016-02-25T09:30:00-05:00,66.89,67.46,66.56,67.42,9496414,15307910.8,55.301959983401524,43.918327850929394,NaN,NaN,124.77097543893724,67.5471833281268,0.42969661898146805,-0.26321048145780424,-0.6929071004392723,405997023,393510356.6,43.61249837490987,30.375890495338236,NaN,NaN,-5.4760671898129125,-14.941958038570379
2016-02-26T09:30:00-05:00,67.73,68,67.24,67.3,10365818,14519838.3,54.58166831526443,45.35662183059351,NaN,NaN,137.72956954110802,92.46445783286859,0.4327503271028046,-0.1519691915607666,-0.5847195186635712,395631205,395420955.4,45.67187751994288,31.81776974912444,NaN,NaN,-3.380055782373835,-13.290257716256587
2016-02-29T09:30:00-05:00,67.1,67.27,66.2,66.2292,11091742,14195515,48.50996392617771,46.55876946398349,NaN,NaN,67.18072600499403,90.7519408626458,0.348973666782941,-0.14850243518489492,-0.4974761019678359,384539463,393610060.6,44.03047450089642,33.45138807613005,NaN,NaN,-3.2490028219259206,-11.855792731352206
2016-03-01T09:30:00-05:00,66.6,67.67,66.16,67.65,14549057,14087684.35,55.57199879226219,48.04958149351087,NaN,NaN,102.28143936092448,96.74501498427928,0.37337783426761617,-0.030753809133315713,-0.4041316434009319,399088520,396351364,47.12817368388568,35.40304054449079,NaN,NaN,-0.9219667914125053,-10.293817597075106
2016-03-02T09:30:00-05:00,67.49,67.78,67.35,67.7608,10923739,13985436.35,56.07791789276688,49.32263810160604,NaN,NaN,118.6567998938854,110.12390204796984,0.3798561988117298,0.07068860511373032,-0.30916759369799945,410012259,399053694,50.06232110145007,37.675232250635496,NaN,NaN,1.0960696242491326,-8.666690851171644
2016-03-03T09:30:00-05:00,67.59,67.65,66.9549,67.57,10815045,13553531.25,54.91816984447167,50.77721428416053,NaN,NaN,93.12920312201898,103.79554758458619,0.35464623425731917,0.1341401991236495,-0.22050603513366968,399197214,397693732.2,48.600574701464744,39.9588445713447,NaN,NaN,2.4271375570780838,-7.081858221421683
2016-03-04T09:30:00-05:00,67.57,67.84,67.095,67.41,9855654,13098407.7,53.91128967660749,51.793039865482925,NaN,NaN,87.05133656746324,93.65990098985722,0.3120534604685098,0.1695607904519676,-0.1424926700165422,389341560,396435803.2,47.226959338714636,42.15090315086125,NaN,NaN,3.2572168677072,-5.604847494403272
2016-03-07T09:30:00-05:00,66.97,68.18,66.96,67.9508,11082434,12815331.35,56.79466073102309,52.55223553550433,NaN,NaN,93.96496097983004,99.01674798482443,0.30481044804085233,0.2385203900345232,-0.06629005800632912,400423994,399612709.4,50.994045336643694,43.86294834656161,NaN,NaN,4.7791177738831365,-4.12142388464807
2016-03-08T09:30:00-05:00,67.55,67.77,67.03,67.1208,8204189,11992902.5,51.4722851155728,52.64865443315826,NaN,NaN,67.87138435542212,92.13473698372397,0.23192769364650168,0.22361955905179798,-0.00830813459470369,392219805,398238966.4,49.35346738601057,44.956418952498154,NaN,NaN,4.607044435394161,-2.8744998389277514
2016-03-09T09:30:00-05:00,67.3,67.53,66.78,67.24,13032476,11607442.45,52.16558530963907,52.929302381106474,NaN,NaN,54.85153726350441,79.37368445764776,0.18177097142670737,0.21890557968868052,0.03713460826197316,405252281,397286970.8,48.196276449552464,45.85836582972174,NaN,NaN,4.654923778046071,-1.7988678936457767
2016-03-10T09:30:00-05:00,67.57,68.03,66.76,67.28,11288361,11435435.55,52.41128458833212,53.25117259194803,NaN,NaN,63.07653099585451,73.36315003241486,0.14301913236959585,0.21590852372396796,0.07288939135437211,416540642,400755656.4,52.560823453684414,46.75983438298142,NaN,NaN,4.75936564943485,-0.8619773874914016
2016-03-11T09:30:00-05:00,67.71,68.6,67.66,68.59,10618305,10826296.25,59.710145731156544,53.75808376809713,NaN,NaN,133.69754947015454,82.69239261295313,0.19416955208327585,0.3156013314584669,0.12143177937519108,427158947,408319133.8,60.39614643746989,47.96522125901164,NaN,NaN,6.985773558086908,0.259129890448357
2016-03-14T09:30:00-04:00,68.34,68.57,68.125,68.3,6140946,10617544.5,57.60387494486968,54.299534060700175,NaN,NaN,137.93124310720268,91.48564903842765,0.19643676258093185,0.3669777326013559,0.17054097002042407,421018001,412437935.2,63.89349732588554,49.49627793049844,NaN,NaN,8.248807412139723,1.4005123935471235
2016-03-15T09:30:00-04:00,67.85,67.99,67.04,67.24,15226481,10513720.8,50.58055839160766,54.25795451736809,NaN,NaN,38.51041586136465,85.61345533961615,0.11835875338984025,0.3184894117577244,0.20013065836788413,405791520,415152278.2,66.02294075476078,51.2678625975194,NaN,NaN,7.262618272103939,2.237956090483811
2016-03-16T09:30:00-04:00,67.11,67.465,66.55,67.08,16881339,10750787.15,49.59756699258043,53.85049787516659,NaN,NaN,-15.874891938609043,71.46816949919346,0.051181029198413525,0.264106944865901,0.2129259156674875,388910181,411883858.2,61.332344370857136,52.533565882944195,NaN,NaN,6.168199501414557,2.799419434902489
2016-03-17T09:30:00-04:00,67.02,67.03,65.66,66.3,20920457,11310706.4,45.005665241313565,53.16649765559867,NaN,NaN,-113.32267391322469,36.18832851737763,-0.04532664370613346,0.15626761103482067,0.20159425474095413,367989724,402173674.6,49.97322117676864,52.84080471557461,NaN,NaN,3.8174838284928363,2.9448572054153956
2016-03-18T09:30:00-04:00,66.18,67.08,66.06,66.84,19524758,11843174.05,48.556623146230464,53.169830457031004,NaN,NaN,-80.78071401744464,-6.7073241801422,-0.07081604373456718,0.11307420007274516,0.18389024380731234,387514482,394244781.6,42.97426186293748,52.765360955720396,NaN,NaN,2.8625799241543497,2.933103308092389
2016-03-21T09:30:00-04:00,66.9,67.37,66.79,67.23,12183575,12076566.5,51.0166054341929,52.84444521716891,NaN,NaN,-13.821308807852649,-37.057834563153264,-0.05986761519246811,0.1090557248167272,0.16892334000919532,399698057,389980792.8,39.75006089089329,52.23835289907809,NaN,NaN,2.778278022078438,2.910985410090396
2016-03-22T09:30:00-04:00,67.01,68.11,67.01,67.9,13200185,12325979.05,54.99794935084208,52.76730460703142,NaN,NaN,65.84556465991346,-31.590804803443497,-0.008649200062059437,0.15811183993162103,0.16676103999368047,412898242,391402137.2,41.330203242248864,51.61463019484943,NaN,NaN,3.8915879733679146,3.051071490558613
2016-03-23T09:30:00-04:00,67.85,67.97,67.355,67.42,9105057,12225301.6,51.752581343761534,52.541191142694984,NaN,NaN,44.76106113336779,-19.463614189048137,-0.008245891566758645,0.15645367553523215,0.1646995671019908,403793185,394378738,44.606650507468004,51.329349895278234,NaN,NaN,3.873511673963744,3.1685629453307746
2016-03-24T09:30:00-04:00,67.12,67.64,66.87,67.39,8492750,12175118.4,51.54784606812747,52.37237374208927,NaN,NaN,-9.564231402357448,1.28807431312531,-0.010976906783082496,0.15097843362313768,0.16195534040622017,395300435,399840880.2,50.11230699432729,51.53544615639343,NaN,NaN,3.8010393004037413,3.2589167103411985
2016-03-28T09:30:00-04:00,67.57,67.6399,67.1,67.2,7156295,12014642.25,50.193513605669516,51.90086323313544,NaN,NaN,-5.19637580095062,16.404941956424114,-0.02571509866935226,0.12981146706952984,0.1555265657388821,388144140,399966811.8,50.2351161883741,51.481236931517024,NaN,NaN,3.367907764447966,3.2744868609278797
2016-03-29T09:30:00-04:00,67.08,68.04,66.85,67.98,10455626,11982836.45,55.37675675524192,52.179754064540376,NaN,NaN,48.68290650271121,28.905785018536882,0.014755187912328022,0.17397055062929212,0.1592153627169641,398599766,399747153.6,50.00388914473842,51.52769562856901,NaN,NaN,4.459880852607714,3.4438288597392845
2016-03-30T09:30:00-04:00,68.32,68.5,67.87,67.99,7607715,11635769.35,55.44078083272691,52.41369660190379,NaN,NaN,132.3311278578512,42.20289765812443,0.038534328737648255,0.20738327363902442,0.16884894490137617,406207481,398409001.4,48.538148284003604,51.552115045315524,NaN,NaN,5.3724245744996155,3.7193425332764747
2016-03-31T09:30:00-04:00,67.89,68.29,67.75,67.78,8602692,11519717,53.698382760480726,52.50563218562869,NaN,NaN,89.57702174521546,51.16608978049396,0.03647752733912257,0.21444585407527939,0.1779683267361568,397604789,397171322.2,47.16117568632796,51.16642591907578,NaN,NaN,5.683607321658426,3.9999517887596108
2016-04-01T09:30:00-04:00,67.5,68.8,67.37,68.55,9120164,11434972.95,58.810079819863255,52.44134176339345,NaN,NaN,123.48835837265271,77.776607735496,0.08079324968592189,0.27895988884355916,0.19816663915763727,406724953,399456225.8,49.982226581015645,50.42257450075762,NaN,NaN,7.419682097284536,4.488484689977457
2016-04-04T09:30:00-04:00,68.71,69.62,68.7,69.37,17381180,11811249.25,63.43914315879188,52.85814663581647,NaN,NaN,225.79941048580426,123.97576499284696,0.15485800716959114,0.3917391481196262,0.23688114095003504,424106133,406648624.4,57.647495894049555,49.976431541340766,NaN,NaN,10.379433313372214,5.33004877903385
2016-04-05T09:30:00-04:00,68.56,68.88,68.31,68.47,16555121,12084883.6,56.00029297270309,53.24527053446615,NaN,NaN,115.48144681008606,137.33547305432194,0.13356695207970481,0.40383983104966603,0.2702728789699612,407551012,408438873.6,59.31867344538558,49.49755530495681,NaN,NaN,10.697813927874082,6.096872371725312
2016-04-06T09:30:00-04:00,68.49,70.34,68.49,70.3108,24546616,12902004.95,65.03197083731796,54.3477279519474,NaN,NaN,204.30110325091866,151.72946813293544,0.22823186019722985,0.5555627042164986,0.3273308440192687,432097628,413616903,63.771443215945375,49.671776651034556,NaN,NaN,14.210886662895025,7.256017270463842
2016-04-07T09:30:00-04:00,69.81,70.28,69.18,69.54,19216681,13211215.2,59.52238721712905,55.38463666450564,NaN,NaN,165.82304539605263,166.97867286310287,0.22342683130083563,0.6066143831453132,0.3831875518444776,412880947,416672134.6,66.12730189351788,50.82563955937378,NaN,NaN,15.13799794505753,8.382014509691512
2016-04-08T09:30:00-04:00,69.97,70,68.935,69.35,12883771,13290985.7,58.21317594701108,56.074390435989976,NaN,NaN,124.55961456380474,167.1929241013333,0.19308392469387847,0.6245424577118257,0.43145853301794723,399997176,415326579.2,64.14883360029626,52.338108969185136,NaN,NaN,15.425114971031867,9.38817171845442
2016-04-11T09:30:00-04:00,69.32,69.52,68.67,68.82,8695545,13194847.7,54.605147671655246,56.330714881523,NaN,NaN,80.82369197635578,138.1977803994436,0.12618691337320198,0.5891921747344497,0.46300526136124776,391301631,408765678.8,55.438993651796196,53.45874702353534,NaN,NaN,14.488167925189252,10.116742605130824
2016-04-12T09:30:00-04:00,68.81,69.525,68.8,69.38,13510509,13563325.85,57.595725547146955,56.5162703241162,NaN,NaN,90.55331759969033,133.2121545573644,0.10915899732484491,0.5994540080173039,0.49029501069245895,404812140,408217904.4,54.77035734469547,54.41875803085295,NaN,NaN,14.659840975058144,10.765756657977583
2016-04-13T09:30:00-04:00,69.7,70.07,69.325,70.03,9706171,13287310.35,60.82199639040591,57.1640856845908,NaN,NaN,117.21040007995747,115.7940139231722,0.12977548987291043,0.6525143730335969,0.5227388831606865,414518311,404702041,50.55572312892184,54.84369178952823,NaN,NaN,15.830706211129042,11.489320879856363
2016-04-14T09:30:00-04:00,70.01,70.3,69.81,70.07,6655195,12776003.15,61.018549761540136,57.84056451983456,NaN,NaN,118.57186498165541,106.34377784029274,0.1336814583082384,0.6898407060459846,0.5561592477377462,421173506,406360552.8,52.41587192609769,55.008232141797535,NaN,NaN,16.81880484394185,12.250675731868576
2016-04-15T09:30:00-04:00,70.24,70.24,69.55,70.02,7945340,12127247.3,60.60922162534638,58.58454366409718,NaN,NaN,99.7760123907592,101.38705740568363,0.12086055981861232,0.7072349475110116,0.5863743876923992,413228166,409006750.8,55.30507659412516,55.37037217077976,NaN,NaN,17.504393660839,13.001206864578636
2016-04-18T09:30:00-04:00,69.82,70.746,69.71,70.67,11505376,11726278.2,63.99102612693473,59.199848619218095,NaN,NaN,117.9148762560725,108.80529426162698,0.1426245768869897,0.7646551088011364,0.6220305319141467,424733542,415693133,61.64259150239155,56.20170805346927,NaN,NaN,19.091823955129733,13.87129502037165
2016-04-19T09:30:00-04:00,70.79,71.3,70.53,70.92,6655013,11449850.1,65.22754465620486,59.89890317803796,NaN,NaN,140.60435733611664,118.81550220891226,0.15907270748014235,0.8208714162643247,0.6617987087841823,431388555,421008416,65.79474591249934,57.4343221697904,NaN,NaN,20.773138215945718,14.857272619739373
2016-04-20T09:30:00-04:00,70.94,71.64,70.88,71.3,10763418,11328011.75,67.07810390437172,60.85459754545874,NaN,NaN,148.367851468262,125.04699248657316,0.179260442650383,0.8858742620971611,0.7066138194467781,442151973,426535148.4,69.49264853933698,59.02942737357676,NaN,NaN,22.739114371097664,15.983250012790556
2016-04-21T09:30:00-04:00,71.34,71.88,71.25,71.72,12463114,11495914.6,69.0393329746816,61.58525848508863,NaN,NaN,154.76186162295988,132.28499181483406,0.20287795082831062,0.9602112579821664,0.7573333071538558,454615087,433223464.6,73.26015935963586,60.69213685776391,NaN,NaN,24.99379567522631,17.27047082170995
2016-04-22T09:30:00-04:00,71.76,72.115,71.44,71.87,12052773,11673915.75,69.73282585936472,62.034807249415266,NaN,NaN,150.66461244453583,142.4627118255894,0.20971393635825375,1.019475727601673,0.8097617912434193,466667860,443911403.4,77.94699410926417,62.14210101599354,NaN,NaN,27.071228060338846,18.670578998656936
2016-04-25T09:30:00-04:00,71.6,71.82,71.36,71.59,8937489,11762975.45,66.72818566245063,62.80108529868294,NaN,NaN,125.16806033776541,143.91334864192797,0.177753659023834,1.0319538650232118,0.8542002059993778,457730371,450510769.2,80.24898296565142,63.63712312458396,NaN,NaN,28.038717369471637,20.008884480201893
2016-04-26T09:30:00-04:00,71.73,71.73,71.11,71.32,7433502,11611869.25,63.87030169630486,62.71810893146772,NaN,NaN,100.3637818690497,135.8652335485146,0.12338508637765122,1.0084315639714418,0.8850464775937906,450296869,454292432,81.44428691690806,64.89946910322415,NaN,NaN,28.097791428073688,21.16444261561215
2016-04-27T09:30:00-04:00,71.37,71.54,70.94,71.24,9121173,11687542.15,63.00920840622837,62.96716758783196,NaN,NaN,80.81908101282768,122.35547945742772,0.0696656553240691,0.9721285467488769,0.9024628914248078,441175696,454097176.6,81.17114052049115,65.97402900515081,NaN,NaN,27.921139230809,22.1296849892117
2016-04-28T09:30:00-04:00,70.83,71.59,70.51,70.9,19512040,12233009.55,59.347154350721624,63.04816604523985,NaN,NaN,56.62670689917986,102.72844851267173,0.00241778027475148,0.9054851167682472,0.9030673364934957,421663656,447506890.4,72.35118484005712,66.5599112365623,NaN,NaN,26.789862532400477,22.795424638238668
2016-04-29T09:30:00-04:00,70.26,70.395,69.37,69.7908,13577850,12455893.85,49.28384280565765,62.66807284052574,NaN,NaN,-33.37545334928272,65.92043535390802,-0.1188782742685045,0.7544694936578651,0.8733477679263696,408085806,435790479.6,59.89155020160621,66.87795099012015,NaN,NaN,22.661780458588883,22.776332612574414
2016-05-02T09:30:00-04:00,69.92,70.2211,69.63,70.19,9074808,12040575.25,52.411427309707804,62.297765823565804,NaN,NaN,-24.93946434360286,35.898930417634375,-0.17115862928372472,0.6593994813217137,0.8305581106054384,417160614,427676528.2,53.074895399677416,66.75684656547601,NaN,NaN,20.05702478618042,22.3878600659467
2016-05-03T09:30:00-04:00,69.94,70.4,69.7,69.975,9436765,11684657.45,50.60150972895658,61.56773106203371,NaN,NaN,-32.45217998400974,9.335738047022444,-0.2162473622708041,0.5602489077669333,0.7764962700377374,407723849,419161924.2,47.026191918549166,66.50473719330653,NaN,NaN,17.356410958631958,21.669081622044594
2016-05-04T09:30:00-04:00,69.53,69.65,69.11,69.3008,11802044,11047428.85,45.31673591770448,60.44617293033116,NaN,NaN,-87.72869747055651,-24.373817649654406,-0.28327709975085147,0.422399895349173,0.7056769951000245,395921805,410111146,41.599143590322655,65.73211374075116,NaN,NaN,13.337008404943,20.47878544817294
2016-05-05T09:30:00-04:00,69.31,69.69,69.155,69.59,10145219,10593855.75,47.83353508212733,59.53362389152981,NaN,NaN,-75.47637996018646,-50.79443502152767,-0.2984176410457653,0.3326549437928179,0.6310725848385832,406067024,406991819.6,39.890494501812015,64.6310721627288,NaN,NaN,10.704677754629047,19.08248434909524
2016-05-06T09:30:00-04:00,69.34,69.54,68.61,69.18,14164252,10657879.8,44.69299837251615,58.155193337642764,NaN,NaN,-103.42413271327143,-64.80417089432541,-0.32418250361306966,0.22584445532224606,0.5500269589353157,391902772,403755212.8,38.13999139873443,62.95231501246758,NaN,NaN,7.5121317313248674,17.4295768322709
2016-05-09T09:30:00-04:00,69.18,70.185,69.15,69.97,13606997,10903452.4,51.324471172165374,57.162116660211375,NaN,NaN,-54.083945473050285,-70.63306712021489,-0.27793577417408794,0.2026072412177058,0.4805430153917937,405509769,401425043.8,36.88504285585966,60.88733622270761,NaN,NaN,6.699925334318048,15.896769475420493
2016-05-10T09:30:00-04:00,70.25,70.57,70.06,70.56,11073007,10781577.3,55.6056842944468,56.3426581166453,NaN,NaN,-4.963370030936397,-65.13530512960023,-0.2011079648517965,0.22915805932704814,0.43026602417884463,416582776,403196829.2,38.54096326502077,58.67650156025645,NaN,NaN,7.358778878132314,14.677056532950754
2016-05-11T09:30:00-04:00,70.45,70.63,69.7,69.71,8452541,10718895.8,48.928820547099974,54.906192943246616,NaN,NaN,-41.739436278071125,-55.93745289110315,-0.20057903799480198,0.17954222668534214,0.3801212646801441,408130235,405638515.2,40.8443495623203,56.3610865747339,NaN,NaN,5.746271772604781,13.401230138615615
2016-05-12T09:30:00-04:00,69.86,70.07,68.9,69.3,11322942,10952283.15,46.05612043915814,53.21499969894615,NaN,NaN,-90.58493892910124,-58.959164684886105,-0.21936356745159363,0.10591680536565207,0.3252803728172457,396807293,403786569,39.63112642952555,53.624238883324,NaN,NaN,3.4947038068229337,11.986012091216661
2016-05-13T09:30:00-04:00,69.22,69.67,69.08,69.14,11947338,11152383.05,44.94707886923417,51.65920635657354,NaN,NaN,-95.79898346445796,-57.4341348351234,-0.23281429119061764,0.03426250882897364,0.2670768000195913,384859955,402378005.6,38.689804978568304,50.65572616996093,NaN,NaN,1.34336979840404,10.465634620814859
2016-05-16T09:30:00-04:00,69.15,70.23,69.1199,70.08,8338124,10994020.45,52.2256744848307,50.82744727003968,NaN,NaN,-47.080576165252744,-56.0334609735639,-0.17148671861153555,0.05271840175517184,0.2242051203667074,393198079,399915667.6,37.03382142784848,47.48355006359952,NaN,NaN,1.779463572353426,9.224753042463226
2016-05-17T09:30:00-04:00,69.95,70.13,69.1,69.35,14919984,11407269,47.02590516380014,49.68578275272337,NaN,NaN,-65.03294331190467,-68.04737562975755,-0.17268909694578494,0.008343749184476223,0.18103284613026116,378278095,392254731.4,32.38893586154548,43.99910687367484,NaN,NaN,0.4386235828450241,7.969591691089197
2016-05-18T09:30:00-04:00,69.24,69.99,69.17,69.64,11524253,11445310.75,49.1901565184841,48.96028290756355,NaN,NaN,-54.48877706133948,-70.59724378641121,-0.14753339596958037,-0.003383898831714305,0.14414949713786607,389802348,388589154,30.422768614547223,41.004220000424134,NaN,NaN,0.04642264473622516,6.8377103987530585
2016-05-19T09:30:00-04:00,69.24,69.555,68.61,69.05,8765724,11260441.25,45.14878379148022,48.664921549408014,NaN,NaN,-98.32495212927935,-72.14524642644685,-0.1629989506426046,-0.0595991911653897,0.10339975947721491,381036624,385435020.2,28.80253763430592,38.78357624561697,NaN,NaN,-1.5752497023198226,5.635858955742647
2016-05-20T09:30:00-04:00,69.31,69.93,69.28,69.69,7926080,11054106.6,49.95218102672487,48.48926110062352,NaN,NaN,-39.582077786523264,-60.9018652908599,-0.12424715738496986,-0.0519091872539974,0.07233797013097246,388962704,386255570,29.849232608398395,37.12460033195418,NaN,NaN,-1.4020776604733631,4.63043943914036
2016-05-23T09:30:00-04:00,69.59,69.72,69.35,69.41,5061439,10860304.1,47.9728409372287,48.30149904407153,NaN,NaN,-51.32174076122221,-61.75009821005381,-0.11197348015378908,-0.06762888006126389,0.04434460009252519,383901265,384396207.2,28.815459913419303,35.82383376015918,NaN,NaN,-1.8750869035013922,3.7010785330486806
2016-05-24T09:30:00-04:00,69.76,70.52,69.67,70.41,11936372,11085447.6,54.85331668276005,48.98268338443264,NaN,NaN,60.79982973604984,-36.5835436004629,-0.03499735962561454,0.0005979005605070142,0.03559526018612155,395837637,387908115.6,33.500103766975286,35.24533091563437,NaN,NaN,-0.026539973533903773,3.168561603536883
2016-05-25T09:30:00-04:00,70.6,70.99,70.59,70.85,8953615,11077069.7,57.51560539136467,49.67425983509245,NaN,NaN,170.37040762667863,8.388293337140732,0.04283965775534197,0.08914483238029902,0.04630517462495705,404791252,390905896.4,37.2936369388829,35.05984108971086,NaN,NaN,2.3551893398880264,3.0523655658727606
2016-05-26T09:30:00-04:00,70.88,71,70.63,70.86,5257683,10364351.85,57.57683540674411,50.594533908965865,NaN,NaN,179.3660277497522,63.92648931294705,0.08959668784739663,0.15830103443420285,0.06870434658680621,410048935,396708358.6,43.95765749411282,35.47538866795217,NaN,NaN,4.252457446317949,3.223807263079216
2016-05-27T09:30:00-04:00,70.81,71.34,70.81,71.18,9641321,10167525.4,59.58417585308519,51.18451281474586,NaN,NaN,182.3496910025543,108.31284307076255,0.13400157005475502,0.23620630915524998,0.10220473910049496,419690256,402853869,50.01640091552023,36.41334281507078,NaN,NaN,6.4395711676055,3.683202106582971
2016-05-31T09:30:00-04:00,71.4,71.52,71.04,71.35,7669813,10097275.65,60.649428552476564,51.54478026174799,NaN,NaN,172.10309936687548,152.99781109638212,0.16472632797922843,0.3081126490745305,0.14338632109530208,427360069,411545629.8,57.083274895408906,37.73779364581279,NaN,NaN,8.557630134775266,4.379548967753299
2016-06-01T09:30:00-04:00,71.13,71.765,71.07,71.61,9301692,10090522,62.28664277583079,52.49891042094305,NaN,NaN,159.311856855679,172.70021652030795,0.19063415157199076,0.3816790105602905,0.19104485898829976,436661761,419710454.6,62.45350626157314,39.28130483861656,NaN,NaN,10.817052675888952,5.29919235462982
2016-06-02T09:30:00-04:00,71.55,72.53,71.46,72.53,12473090,10124074.3,67.4476654632853,54.026877922666415,NaN,NaN,187.104644445109,176.04706388399399,0.25384984744869643,0.5083571682991703,0.2545073208504739,449134851,428579174.4,67.24761711617197,41.253911316234166,NaN,NaN,14.487833922518744,6.61185543575681
2016-06-03T09:30:00-04:00,72.31,72.5463,71.71,72.29,13895958,10311611.25,64.95058942196508,55.45570010500434,NaN,NaN,156.25299183131156,171.42445670030588,0.26252845848315876,0.5826678939544223,0.32013943547126356,435238893,433617166,69.62062260483827,43.46325543239631,NaN,NaN,16.799888685230986,8.067288757110264
2016-06-06T09:30:00-04:00,72.3,72.81,72.12,72.6808,9117597,10059278.5,67.0873492194184,56.51724830033203,NaN,NaN,156.4860371969621,166.25172593918745,0.27622716104152556,0.6654233867731705,0.3891962257316449,444356490,438550412.8,71.77697385814169,45.944909177417244,NaN,NaN,19.404445218260186,9.686882537274538
2016-06-07T09:30:00-04:00,72.38,72.45,72.05,72.2292,6439115,9700884.4,62.35648308244024,57.6122895802349,NaN,NaN,116.38256533319088,155.1076191324505,0.2379646735125619,0.6866520676223473,0.4486873941097854,437917375,440661874,72.67109788910405,48.8222064651,NaN,NaN,20.253572937994793,11.196409737377431
2016-06-08T09:30:00-04:00,72.17,72.61,72.01,72.48,4621255,9378296.8,63.87986122438812,58.661554202085185,NaN,NaN,108.82178389904817,145.00960454112436,0.2134228589537066,0.7154659678019186,0.502043108848212,442538630,441837247.8,73.18045592688648,51.876326987409946,NaN,NaN,21.40477908034182,12.654748214943773
2016-06-09T09:30:00-04:00,72.32,72.835,72.15,72.36,9608545,9436097,62.57502219652467,59.90628551673121,NaN,NaN,101.86388351866212,127.96145235583496,0.17461739526137365,0.720314852924929,0.5456974576635554,432930085,438596294.6,69.34265132622436,54.77204939397556,NaN,NaN,21.995884068507966,13.989196194024371
2016-06-10T09:30:00-04:00,71.94,71.98,71.45,71.78,10270936,9383496.7,56.56129467324947,60.37836506291154,NaN,NaN,52.80535073532569,107.2719241366378,0.09915188543332809,0.6696373144552155,0.5704854290218874,422659149,436080345.8,66.43014632493967,57.38497180229992,NaN,NaN,20.778275611829372,14.959064682282229
2016-06-13T09:30:00-04:00,71.52,72.06,71.19,71.21,8724591,9222359.35,51.33943316807994,60.61883593654377,NaN,NaN,32.154891428797036,82.40569498300478,0.005076785071468248,0.5768314103612227,0.5717546252897544,413934558,429995959.4,59.88004489064717,59.603870729244775,NaN,NaN,18.13549981929415,15.41284113042679
2016-06-14T09:30:00-04:00,71.04,71.35,70.74,71.32,8000477,9205477,52.25550974996372,60.43327829848688,NaN,NaN,4.84164561243567,60.097511038853725,-0.05234643352069801,0.5063215833888819,0.5586680169095799,421935035,426799491.4,56.71611019087643,61.262156902380575,NaN,NaN,16.224125248689717,15.528738861607208
2016-06-15T09:30:00-04:00,71.51,71.66,70.77,70.83,7861117,8852533.65,47.92714131280016,59.74838800716085,NaN,NaN,-4.698074813627418,37.39353929631859,-0.12195803285860729,0.4062204758363208,0.5281785086949281,414073918,421106549,51.497196735176544,62.27669688783011,NaN,NaN,13.269614110614746,15.206006754322571
2016-06-16T09:30:00-04:00,70.62,71.2,70.27,71.08,9341198,8743380.9,50.19388997701944,59.22103476218052,NaN,NaN,-30.41828262865692,10.937106066854795,-0.14805687980324905,0.3431074089408668,0.49116428874411583,423415116,419203555.2,49.84603526848164,62.697295300285035,NaN,NaN,11.422284332695618,14.665474979804435
2016-06-17T09:30:00-04:00,70.9,70.93,69.8,70.06,10799114,8845050.4,42.134928869451166,57.97465997763523,NaN,NaN,-92.15003716323987,-18.0539715128583,-0.22622561331726254,0.20838227209753768,0.4346078854148002,412616002,417194925.8,48.093216926992184,62.55992501539017,NaN,NaN,7.118142180474228,13.58728457990012
2016-06-20T09:30:00-04:00,70.66,71,70.41,70.5,7983661,8847929.45,46.15135835006703,56.93908353460598,NaN,NaN,-67.00618115455532,-37.88618602952877,-0.23924360568584674,0.1355533783074918,0.37479698399333855,420599663,418527946.8,49.36575986453341,62.008673941756214,NaN,NaN,4.754558420741846,12.325466557163223
2016-06-21T09:30:00-04:00,70.74,70.81,70.095,70.255,7014947,8945604.85,44.307208796073596,55.654838250337605,NaN,NaN,-101.99425186686477,-59.25336552538887,-0.2539137661566345,0.05740477629754537,0.3113185424541799,413584716,416857883,47.78515933253603,60.96093487539641,NaN,NaN,2.2488866337149203,10.88595513952775
2016-06-22T09:30:00-04:00,70.26,71.25,70.2,70.46,11207552,8909163.85,46.24283058781664,54.14020718780414,NaN,NaN,-80.65141256191056,-74.4440330750455,-0.23955376998042555,0.01187632997864796,0.2514300999590735,424792268,419001553,49.99821021100053,59.728834382169886,NaN,NaN,0.7493026117107713,9.437861921268182
2016-06-23T09:30:00-04:00,71.08,71.39,70.75,71.38,7626917,8842828.95,53.97397273743691,53.35616313890927,NaN,NaN,-25.463296606368754,-73.45303587058785,-0.16157538762560683,0.04946086542706496,0.2110362530526718,432419185,420802366.8,51.84465981989804,58.45912275467415,NaN,NaN,1.8355541513088356,8.351817954131132
2016-06-24T09:30:00-04:00,69.35,70.4,69.05,69.29,22576537,9708771.65,39.926178151772,51.41607949122024,NaN,NaN,-178.22392108211952,-90.6678126543638,-0.23953289406263392,-0.08837986452562063,0.1511530295370133,409842648,420247696,51.21729562357748,56.99057430934813,NaN,NaN,-2.4170747976860567,6.813404703871534
2016-06-27T09:30:00-04:00,68.84,69.08,68.09,68.38,18634739,10158442.55,35.583548375234756,49.50372701213413,NaN,NaN,-228.95639631831054,-123.05785568711485,-0.3352905460851841,-0.26796015306946686,0.06733039301571726,391207909,414369345.2,45.00211813241571,55.01421861244182,NaN,NaN,-7.518080482174502,4.766049677293529
2016-06-28T09:30:00-04:00,68.86,69.77,68.845,69.71,13652372,10457570.5,44.9993596189693,48.15511975460422,NaN,NaN,-128.98262693529205,-128.4555307008003,-0.2934694482351641,-0.2995064172782378,-0.006036969043073742,404860281,412624458.2,43.32161986006031,52.88144460766853,NaN,NaN,-8.08998198219045,2.9294737259386747
2016-06-29T09:30:00-04:00,70.2,71.24,70.2,71.04,8968421,10440906.95,52.479751230958996,47.43402897134953,NaN,NaN,-19.98866952972531,-116.32298209436324,-0.16694011012842186,-0.21471210670360108,-0.047771996575179214,413828702,410431745,41.23761895295539,50.873942295292174,NaN,NaN,-5.557641387286921,1.7170287097635897
2016-06-30T09:30:00-04:00,71.18,71.75,70.83,71.705,9535175,10294011.2,55.72236826660259,47.374105656589045,NaN,NaN,30.55080781087747,-105.12016121091399,-0.03600842124269517,-0.09278252312854818,-0.05677410188585301,423363877,408620683.4,39.54551691742642,48.95361162332694,NaN,NaN,-2.3756968970907053,1.1323536230701192
2016-07-01T09:30:00-04:00,71.87,72.33,71.64,72.16,6793136,9938870.1,57.84205100565813,47.83857835927319,NaN,NaN,81.14445737807849,-53.246485518874394,0.07749928141188572,0.040099999879004145,-0.03739928153288158,430157013,412683556.4,44.99802089967666,47.89060990968619,NaN,NaN,0.8362346988092194,1.0900509196042765
2016-07-05T09:30:00-04:00,71.73,72.38,71.73,72.09,8359777,9900979.1,57.386884335855896,48.20510511540835,NaN,NaN,87.17875621938721,9.980544988665148,0.14045479567666663,0.1381692130629517,-0.0022855826137149204,421797236,418801421.8,52.016045272042724,47.55489098691236,NaN,NaN,3.1282170571254326,1.3812175106787272
2016-07-06T09:30:00-04:00,71.98,73.05,71.9,72.9,18791528,10518599.75,61.19241358387752,49.15262456334244,NaN,NaN,128.64164114253663,61.50539860423088,0.2242643647996422,0.27804487338583783,0.05378050858619563,440588764,425947118.4,58.6522236607492,48.06596433873898,NaN,NaN,6.324801712064046,2.087443825162344
2016-07-07T09:30:00-04:00,73.34,73.35,72.46,72.79,8022362,10688655.1,60.40350574716004,49.881882832638205,NaN,NaN,143.02833430719664,94.10879937161526,0.25752802083173193,0.37569053462586055,0.11816251379412862,432566402,429694658.4,61.647917025177236,48.908955892788654,NaN,NaN,8.591331672676809,3.016570660521553
2016-07-08T09:30:00-04:00,73.15,73.71,72.76,73.69,11013236,10758889.65,64.44267687231951,51.475293404271646,NaN,NaN,171.46440890561962,122.29151959056371,0.3212356239645404,0.5197070437498041,0.19847141978526373,443579638,433737810.6,64.62569056182215,50.08984686670509,NaN,NaN,11.854578742139632,4.27914324360985
2016-07-11T09:30:00-04:00,73.91,74.1,73.42,73.49,7375092,10614097.45,62.90697647001596,52.672123269982286,NaN,NaN,165.57514693535708,139.17765750201943,0.32975365434903114,0.6106634877215527,0.2809098333725215,436204546,434947317.2,65.4889352293585,51.24150224990688,NaN,NaN,14.011771590938144,5.669518721799606
2016-07-12T09:30:00-04:00,73.65,73.955,73.59,73.85,10237174,10689726.6,64.54481062560431,54.117666257805915,NaN,NaN,146.02487034418436,150.94688032697886,0.3382197169637699,0.7036844795772339,0.365464762613464,446441720,439876214,68.82738839634162,52.74451861160728,NaN,NaN,16.293331614016683,7.187206277830617
2016-07-13T09:30:00-04:00,74.08,74.175,73.745,73.82,6401925,10609799,64.2900543337602,55.40675366823045,NaN,NaN,128.9532918188489,151.0092104622413,0.3205496421567824,0.766151815309442,0.4456021731526596,440039795,439766420.2,68.66803756259648,54.07807770814985,NaN,NaN,18.07009483989652,8.741904643840032
2016-07-14T09:30:00-04:00,74.31,74.66,73.87,74.14,4813169,10457401.6,65.83890237664633,56.25424864245969,NaN,NaN,123.80415318711653,147.1643742382253,0.3090298221359644,0.8318894508226151,0.5228596286866507,444852964,442223732.6,70.32405478468803,55.39803449134913,NaN,NaN,20.01426248637045,10.352241478487233
2016-07-15T09:30:00-04:00,74.42,74.63,73.985,74.08,7131321,10346907.75,65.26729060775449,58.064328103601305,NaN,NaN,108.99235167446751,134.66996279199486,0.27701369694028344,0.869126749862005,0.5921130529217216,437721643,441052133.6,68.46601251224828,56.630085697682766,NaN,NaN,21.477333382665662,11.941540321941295
2016-07-18T09:30:00-04:00,74.1,74.25,73.84,74.11,3954259,10004665,65.42890735937146,60.19613945961107,NaN,NaN,92.00332904370957,119.95559921366537,0.23894144242148907,0.890789855948583,0.6518484135270939,441675902,442146404.8,69.28235108805407,58.364388051656924,NaN,NaN,22.74513169358471,13.484910517890354
2016-07-19T09:30:00-04:00,74.2,74.375,73.73,73.95,6634712,9937217.55,63.725783221686456,61.53374114551944,NaN,NaN,81.40103176758447,107.03083149834538,0.1863991818574482,0.8848473908489041,0.6984482089914559,435041190,439866298.8,65.47865400601636,59.94703334779664,NaN,NaN,23.409776797451464,14.902748557827655
2016-07-20T09:30:00-04:00,74.29,74.745,74.19,74.62,6855045,9929222.45,67.53653775848095,62.609225897485295,NaN,NaN,93.5302770375034,99.94622854207628,0.18008557348411658,0.9235551758466016,0.743469602362485,441896235,440237586.8,65.80784679714974,61.70204962238195,NaN,NaN,25.042584640333516,16.351296569614206
2016-07-21T09:30:00-04:00,74.62,74.99,74.55,74.84,9230809,9830385.3,68.69932225866968,63.536151182632935,NaN,NaN,96.75370602924642,94.53613911050226,0.1739497583223023,0.9609068002653629,0.7869570419430606,451127044,441492402.8,66.95474665614438,63.65985174657609,NaN,NaN,26.754177992633956,17.837422487188455
2016-07-22T09:30:00-04:00,74.83,75.08,74.615,74.99,5446479,9721363.4,69.50143797046739,64.36896453726217,NaN,NaN,92.82486363571162,91.3026415027511,0.16338332691788726,0.9911862005904197,0.8278028736725325,456573523,445262778.8,70.19028244312317,65.45929899967942,NaN,NaN,28.426921337192606,19.35020803718905
2016-07-25T09:30:00-04:00,75.01,75.07,74.45,74.91,5868392,8885956.15,68.4933118680717,65.16228078956331,NaN,NaN,84.39405993105501,89.78078768022019,0.13554333455318157,0.9972320418640095,0.8616887073108279,450705131,447068624.6,71.62338852935105,66.85982351805858,NaN,NaN,29.59886008595074,20.81430118701215
2016-07-26T09:30:00-04:00,74.62,74.89,74.48,74.78,6904219,8299430.15,66.79772216226316,65.5626599737337,NaN,NaN,78.26449495620302,89.1534803179439,0.09483621335828452,0.9802339740086836,0.8853977606503991,443800912,448820569,72.98051965328608,67.88327323181122,NaN,NaN,30.191666472278296,22.153924799193028
2016-07-27T09:30:00-04:00,74.63,75.2355,74.49,75.12,7983149,8015969,68.96187687496071,66.17397219714805,NaN,NaN,91.27371601920298,88.70216811428382,0.07797631072936029,0.9828681490620994,0.9048918383327391,451784061,450798134.2,74.46505770066796,68.79878328006056,NaN,NaN,31.27337078271587,23.45670279683915
2016-07-28T09:30:00-04:00,75,75.24,74.68,75.05,5470050,7841050.45,67.97944633459221,66.42659858731038,NaN,NaN,93.0626487618115,87.96395666079684,0.05060424070529046,0.9681471392143521,0.9175428985090617,446314011,449835527.6,72.380384731863,69.35269000649204,NaN,NaN,31.955504988007792,24.670817395577526
2016-07-29T09:30:00-04:00,74.91,75.34,74.731,75.2,4889200,7608751.7,68.99862799199093,66.86171655316573,NaN,NaN,98.36188157809536,89.0713602492736,0.0320027856924584,0.9575463806246347,0.9255435949321763,451203211,448761465.2,70.02477946760969,69.67667888065284,NaN,NaN,32.80327366240128,25.832596862266634
2016-08-01T09:30:00-04:00,75.27,76,75.27,75.68,9255078,7731848.8,72.06297268916178,67.39872812913413,NaN,NaN,140.19926739581874,100.23240174222634,0.04086058950058724,0.9766193318079104,0.9357587423073231,460458289,450712096.8,71.81858302232938,69.89033563965197,NaN,NaN,34.38969539601883,27.05503950994552
2016-08-02T09:30:00-04:00,75.74,75.74,74.93,75.39,12149329,7921326.4,67.70844567180977,67.64289893899482,NaN,NaN,105.38905232327643,105.65731321564104,0.017232253362673977,0.9572990590106656,0.9400668056479916,448308960,451613706.4,72.63376669694392,70.17360200639108,NaN,NaN,34.633987197163414,28.137746322405217
2016-08-03T09:30:00-04:00,75.34,75.39,75.03,75.18,9761216,7469810.8,64.66139372961088,67.55879117849229,NaN,NaN,83.41156939434369,104.08488389066918,-0.020452992193694453,0.9145005654058735,0.934953557599568,438547744,448966443,66.54702843918773,69.9038144102839,NaN,NaN,34.033032410585704,28.979930049288143
2016-08-04T09:30:00-04:00,75.23,75.35,74.97,75.07,8415450,7489465.2,63.06053597216938,67.40116584737906,NaN,NaN,70.34900129384847,99.54215439707656,-0.058544930513788174,0.8617723944573328,0.920317324971121,430132294,445730099.6,59.934534022724996,69.29442308960367,NaN,NaN,33.09828783747597,29.568266876172117
2016-08-05T09:30:00-04:00,75.4,75.4,74.8301,75.25,8244367,7351021.75,64.6047829726777,67.34229981975808,NaN,NaN,69.16246223371253,93.70227052819999,-0.07625437538238056,0.8249993557431452,0.9012537311255258,438376661,443164789.6,55.24828470578234,68.29198977658426,NaN,NaN,32.677261125138315,30.012408911738717
2016-08-08T09:30:00-04:00,75.19,75.19,74.35,74.61,6655527,7315043.5,55.690269449972554,66.76833455034993,NaN,NaN,0.8670585856109235,65.83582876615841,-0.1324167950509183,0.7357327373118778,0.8681495323627961,431721134,437417358.6,46.47968867123979,66.93492082410022,NaN,NaN,29.724758640803245,29.971316015890793
2016-08-09T09:30:00-04:00,75.01,75.0464,74.58,74.79,11261259,7366247.75,57.46784307706896,66.04914207310624,NaN,NaN,7.939951667255741,46.34600863495427,-0.15710437853155368,0.6717690591983541,0.8288734377299077,442982393,436352045.2,45.0523818949206,65.45238761679815,NaN,NaN,27.70347729365949,29.647339055572036
2016-08-10T09:30:00-04:00,74.76,74.76,74.34,74.535,7031564,7397729.7,54.153428680414116,65.0101496746594,NaN,NaN,-50.000671690893725,19.6635604179068,-0.18817259164122546,0.5936576981783759,0.7818302898196013,435950829,435832662.2,44.337522606814964,63.83687161327462,NaN,NaN,25.011036416947235,28.985010107197066
2016-08-11T09:30:00-04:00,74.74,75.05,74.6,74.97,6599846,7487063.55,58.54566429846407,64.22759441237345,NaN,NaN,10.480522048665492,7.689864568870206,-0.17714834128609513,0.5603948632119824,0.7375432044980775,442550675,438316338.4,48.542318778568685,62.290588494377864,NaN,NaN,23.866696325217,28.253822424057056
2016-08-12T09:30:00-04:00,74.83,74.865,74.51,74.78,6211941,7441094.55,56.021138988479365,63.336724920974,NaN,NaN,-31.44383664171855,-12.43139520621601,-0.17980154270092885,0.5127912761219164,0.6925928188228453,436338734,437908753,47.902802410887496,60.596260914487615,NaN,NaN,22.17095442858385,27.384841281846597
2016-08-15T09:30:00-04:00,74.78,75.085,74.78,74.91,4122513,7449507.25,57.375452487852904,62.66370565851612,NaN,NaN,8.87188482666435,-10.830429958005325,-0.17005696419892036,0.4800216135741948,0.6500785777731152,440461247,439656775.6,50.89097427542779,59.0184362446406,NaN,NaN,21.121403482355827,26.490064453347916
2016-08-16T09:30:00-04:00,74.8,74.81,74.24,74.24,6042305,7419886.9,49.000343158317676,61.237881821613044,NaN,NaN,-144.793850454201,-41.37719038229669,-0.20371906117093197,0.39542975130945024,0.5991488124803822,434418942,437944085.4,47.98675725813363,57.12712907017386,NaN,NaN,17.571225645445523,25.215944623647573
2016-08-17T09:30:00-04:00,74.08,74.45,73.925,74.39,7296304,7441949.85,50.73419153150757,60.006077907107,NaN,NaN,-183.4932821496919,-68.07571247405633,-0.21002819737672318,0.3366135657594782,0.5466417631362014,441715246,439096968.8,50.05303483309178,55.53231836311878,NaN,NaN,15.14440561561326,23.777153336785528
2016-08-18T09:30:00-04:00,74.38,74.58,74.19,74.42,4180054,7189412.1,51.09231734514465,58.72705571804655,NaN,NaN,-127.1050626592453,-95.59282941563849,-0.20604171525585063,0.2890896190663881,0.4951313343222387,445895300,439765893.8,51.262829779842974,54.19217909970687,NaN,NaN,13.261724381972279,22.274949200383634
2016-08-19T09:30:00-04:00,74.27,74.41,74.035,74.36,4323457,7133261,50.304703602334,57.172893640415985,NaN,NaN,-136.85847589422107,-116.675757266139,-0.20108509600380609,0.24377496431748114,0.4448600603212872,441571843,440812515.6,53.1739466620015,52.860419359683455,NaN,NaN,11.474531617837846,20.732032402877092
2016-08-22T09:30:00-04:00,74.39,74.785,74.31,74.51,4090216,7044352.2,52.28503111599516,56.07122117214352,NaN,NaN,-67.50111421966399,-131.95035707540467,-0.1819202247534103,0.21745977937952432,0.3993800041329346,445662059,441852678,55.06000873038887,51.60515093350095,NaN,NaN,10.467901041100507,19.265727922623295
2016-08-23T09:30:00-04:00,74.77,75,74.54,74.58,8557869,7127034.7,53.22185128194631,55.25411099731033,NaN,NaN,-28.763932354442726,-108.744373455453,-0.15954533074393418,0.19994834070301692,0.3594936714469511,454219928,445812875.2,61.42974284920303,51.239630534216325,NaN,NaN,9.859307598365843,17.921953590586515
2016-08-24T09:30:00-04:00,74.55,74.705,73.23,73.41,8670361,7161395.3,39.32437551283224,53.558670964500536,NaN,NaN,-194.38270851139416,-110.92225872779345,-0.21510165262671643,0.09061660566355556,0.305718258290272,445549567,446579739.4,62.53707110943329,51.42552604040977,NaN,NaN,4.680197456343394,16.0302741428375
2016-08-25T09:30:00-04:00,73.21,73.51,72.47,72.79,8766486,7326217.1,34.22435695484518,51.38864053465535,NaN,NaN,-274.4471455457643,-140.39067530509723,-0.2810014213800304,-0.04553351843476605,0.23546790294526437,436783081,444757295.6,58.2566204027151,51.64040716161926,NaN,NaN,-1.6268161601166835,13.507832670986902
2016-08-26T09:30:00-04:00,72.87,73.45,72.63,73.07,9974260,7580470.1,38.12702781526275,50.134123275033225,NaN,NaN,-204.63762169565157,-153.94650446538336,-0.2918533309576938,-0.12934876075185286,0.16250457020584091,446757341,445794395.2,59.93714496282342,52.60165403958952,NaN,NaN,-5.452585689421176,10.79920147664289
2016-08-29T09:30:00-04:00,73.1,73.41,72.92,73.23,7372084,7486320.4,40.30659281931696,48.908319685193796,NaN,NaN,-158.88526393575455,-172.22333440860146,-0.2746263607073281,-0.1807783806783192,0.09384798002900889,454129425,447487868.4,62.58586188703246,53.854045467597516,NaN,NaN,-7.829766781908748,8.1379202968498
2016-08-30T09:30:00-04:00,73.32,73.32,72.8,72.98,5497785,7153743.2,38.0511033138825,47.75815358758439,NaN,NaN,-148.61276601423492,-196.1931011405599,-0.26624247194379047,-0.2389551099007292,0.02728736204306126,448631640,446370210.8,59.77692270743206,54.95685976049873,NaN,NaN,-10.504176169879234,5.474763658745651
2016-08-31T09:30:00-04:00,72.88,72.97,72.48,72.76,4756812,6903523,36.134827308338416,46.15737951686113,NaN,NaN,-150.03647660611549,-187.32385475950417,-0.2613194022765296,-0.2993618908026008,-0.03804248852607116,443874828,446035263,58.92341577961455,55.69836668914486,NaN,NaN,-13.310511907791694,2.791152863526031
2016-09-01T09:30:00-04:00,72.76,72.85,72.24,72.57,9501445,6957822.75,34.5180412532618,44.62144396434559,NaN,NaN,-139.51611091499987,-160.33764783335127,-0.25631345272676276,-0.3584343044345246,-0.10212085170776185,434373383,445553323.4,57.647982409698905,56.39445097477426,NaN,NaN,-16.128653619438904,0.08832336595961188
2016-09-02T09:30:00-04:00,72.72,72.87,72.45,72.65,8052275,6948218.15,35.820147302632435,43.08177930825841,NaN,NaN,-112.14708641662658,-141.83954077754626,-0.23370301638322355,-0.39424962218679127,-0.16054660580356772,442425658,444686986.8,55.329492140810295,56.71148796515872,NaN,NaN,-18.067561505615394,-2.505374472836817
2016-09-06T09:30:00-04:00,72.77,73.07,72.66,72.91,8735819,7052232.75,39.99624965674306,42.438629772431646,NaN,NaN,-82.27296763880297,-126.51708151815596,-0.18922386927324028,-0.3970764423951181,-0.2078525731218778,451161477,444093397.2,53.73485615650404,57.122066457899464,NaN,NaN,-18.529160327771248,-4.79448673782745
2016-09-07T09:30:00-04:00,72.85,73.17,72.7,72.91,7561580,6867248.8,39.99624965674306,41.671633924234186,NaN,NaN,-70.42072008999324,-110.87867233330762,-0.14953082143047575,-0.39476609990997247,-0.24523527847949672,451161477,444599364.6,54.9273038807067,57.4702285327291,NaN,NaN,-18.906470798417896,-6.810484460768942
2016-09-08T09:30:00-04:00,72.68,73.025,72.61,72.97,4822216,6756781.4,41.02331958041606,40.95241979818214,NaN,NaN,-67.75876965611798,-94.42313094330811,-0.11074851222572424,-0.38367091876165205,-0.2729224065359278,455983693,447021137.6,60.213215039652674,58.10954176557266,NaN,NaN,-18.948774072944996,-8.54452583393695
2016-09-09T09:30:00-04:00,72.56,72.56,71.49,71.51,14135544,7133566.3,28.32032449149041,39.38210700455046,NaN,NaN,-136.51976460475186,-93.8238616812585,-0.1713204998299589,-0.4870730313233764,-0.31575253149341753,441848149,448516090.8,63.09074865786666,58.81788476527731,NaN,NaN,-23.362581484126864,-10.661390926821223
2016-09-12T09:30:00-04:00,71.105,72.76,71.09,72.57,13023429,7474140.7,42.29201438148731,38.668320094942764,NaN,NaN,-104.71579702348356,-92.3376038026299,-0.12977956528660461,-0.47797698810167333,-0.3481974228150687,454871578,451005274.8,67.32788894395944,59.694161923389494,NaN,NaN,-21.996963711908872,-12.28075846754803
2016-09-13T09:30:00-04:00,72.12,72.12,71.22,71.6,12194203,7877725.2,35.47721626377063,37.40084616507307,NaN,NaN,-138.37160117568942,-103.5573305100072,-0.15566793749794128,-0.5427823446874953,-0.38711440718955403,442677375,449308454.4,62.09481908355614,59.74166736870042,NaN,NaN,-23.549590654842948,-13.890591637161588
2016-09-14T09:30:00-04:00,71.57,72.07,71.31,71.6,13108529,8231036.4,35.47721626377063,37.12604907585439,NaN,NaN,-129.82436409304447,-115.43805931061745,-0.16020464898947717,-0.5873702184264005,-0.4271655694369233,442677375,447611634,57.29868950909824,59.367497254390784,NaN,NaN,-24.673217093533772,-15.430966702357614
2016-09-15T09:30:00-04:00,71.47,72.54,71.3,72.34,9636862,8348064.3,43.528308013919904,37.790617008645434,NaN,NaN,-88.70827193940684,-119.62795976727523,-0.10353052125309403,-0.5565787210032909,-0.45304819975019683,452314237,446877742.8,55.30888269581906,59.156944561041065,NaN,NaN,-22.627494905773123,-16.4590421599884
2016-09-16T09:30:00-04:00,71.99,72.21,71.825,72.11,8690989,8573611.05,41.7831928092048,38.05177165106987,NaN,NaN,-84.41950431491522,-109.20790770930789,-0.07312874366830535,-0.5444591293355785,-0.47133038566727314,443623248,447232762.6,56.103039484496605,58.88307988401771,NaN,NaN,-21.647503919987244,-17.20025098284538
2016-09-19T09:30:00-04:00,72.29,72.435,71.76,71.85,9919663,8853421.35,39.83877970693064,38.018356428756555,NaN,NaN,-79.65748258573034,-104.19624482175725,-0.06253553231136888,-0.5494998010564842,-0.48696426874511534,433703585,442999164,45.67885601649537,57.67543660755077,NaN,NaN,-21.512608448837273,-17.81630204941565
2016-09-20T09:30:00-04:00,72.16,72.34,72.035,72.07,5286599,8913240.5,42.28615699740344,38.320860263293774,NaN,NaN,-58.262893544027854,-88.17450329542494,-0.03413825039387752,-0.5296370817374623,-0.49549883134358474,438990184,442261725.8,44.14037442592137,56.55854030172859,NaN,NaN,-20.61557112416731,-18.21619763152303
2016-09-21T09:30:00-04:00,72.31,72.93,71.87,72.79,8485850,8909639.55,49.52333772332015,39.27718243579246,NaN,NaN,-0.6955373615405261,-62.34873794912416,0.03591628547334491,-0.45060347450190363,-0.48651975997524854,447476034,443221457.6,46.658355288925534,55.682464552393654,NaN,NaN,-17.39042745001911,-18.098230462736755
2016-09-22T09:30:00-04:00,73.09,73.47,73.05,73.34,6502150,8801229,54.24350165493177,40.68614389305461,NaN,NaN,114.79045014414388,-21.648993532414018,0.11747754322263698,-0.33967283094695233,-0.4571503741695893,453978184,443554247,47.541385383185904,54.96056476478559,NaN,NaN,-13.076431432486283,-17.3808306012724
2016-09-23T09:30:00-04:00,73.23,73.41,73.095,73.11,5420444,8633926.9,52.0514580872387,41.8455232348122,NaN,NaN,98.18273599193219,14.871454528955462,0.15192988255850204,-0.26723802097146176,-0.4191679035299638,448557740,444541145.4,50.17552895885392,54.59242453750299,NaN,NaN,-10.32369153438426,-16.372667877431237
2016-09-26T09:30:00-04:00,72.84,72.9,72.09,72.26,5534058,8411916.8,44.8397173744773,42.19148521465036,NaN,NaN,-11.386290206648953,28.525693004771746,0.11513598542491954,-0.2752479217488144,-0.39038390717373395,443023682,446405164.8,54.79287265788422,54.66799714474443,NaN,NaN,-10.329044225012254,-15.50929306994281
2016-09-27T09:30:00-04:00,72.17,72.78,72.01,72.77,7839016,8435263.4,49.37216212380552,42.861193248011965,NaN,NaN,9.771004644258513,42.13247264242902,0.12214472901965123,-0.23770299589916988,-0.3598477249188211,450862698,448779667.6,59.89191245951257,55.02261204323057,NaN,NaN,-8.798878220273833,-14.550662377132957
2016-09-28T09:30:00-04:00,72.84,72.85,72.28,72.66,6522589,8486503.6,48.44749680030125,43.391491620860904,NaN,NaN,26.88841518753861,47.64926315224485,0.11639536519235127,-0.21435351842838202,-0.3307488836207333,444340109,448152482.6,58.03007284275761,54.86667331488092,NaN,NaN,-7.8909669127272375,-13.599277310789283
2016-09-29T09:30:00-04:00,72.57,72.66,71.17,71.38,8857866,8691556.3,39.23842327612525,44.1713558197634,NaN,NaN,-103.82720727546521,3.925731668323036,0.028018902702437398,-0.29572525524268656,-0.32374415794512396,435482243,444453294.4,48.461146384408096,53.821701723919595,NaN,NaN,-10.299843932484983,-13.12792968531724
2016-09-30T09:30:00-04:00,71.53,72.31,71.485,72.11,7453463,8589157.2,45.59051534098723,44.40696303115625,NaN,NaN,-60.36907988125674,-27.784631506314746,0.020695859249220516,-0.2978743338835983,-0.3185701931328188,442935706,443328887.6,45.9793039093822,52.29680279287836,NaN,NaN,-10.041182547488523,-12.686965808484565
2016-10-03T09:30:00-04:00,71.79,72.05,71.49,72.05,9187859,8645936.4,45.172516471182604,45.09948447454282,NaN,NaN,-69.54152502449593,-39.41567846988415,0.014096290155570623,-0.30094983043835555,-0.31504612059392617,433747847,441473720.6,42.14431785829496,50.87176699107398,NaN,NaN,-9.981245308546525,-12.300434308493417
2016-10-04T09:30:00-04:00,71.97,72.27,71.5451,71.91,10594605,8738875.7,44.155227808255646,45.71934244200604,NaN,NaN,-57.51715192644581,-52.87330978402501,0.0031585996895668322,-0.3110978709819676,-0.31425647067153445,423153242,435931829.4,33.22832819737475,49.15245546880802,NaN,NaN,-10.250808490288959,-12.007630620178494
2016-10-05T09:30:00-04:00,72.1,72.35,71.985,72.19,12842056,9002899.5,46.73865784625506,45.94865314431569,NaN,NaN,-10.066750270923272,-60.26434287571739,0.016871450314474457,-0.2931671577784414,-0.31003860809291584,435995298,434262867.2,31.09483173533485,47.42288040020201,NaN,NaN,-9.688218255025244,-11.676285996585174
2016-10-06T09:30:00-04:00,71.95,72.02,71.49,71.92,9308917,9227234.55,44.596246288104325,46.14958553566565,NaN,NaN,-70.80051657151621,-53.65900473492759,0.010177763697918452,-0.2973164034705178,-0.30749416716843625,426686381,432503694.8,28.982483036632217,45.48569779678313,NaN,NaN,-9.85589041268582,-11.416229484599551
2016-10-07T09:30:00-04:00,71.85,72.21,71.45,71.87,9920420,9016478.35,44.19226260265419,46.460548599645904,NaN,NaN,-64.26080021292653,-54.43734880126154,0.005061237849651401,-0.30116761985637197,-0.30622885770602337,416765961,427269745.8,23.801741738104823,43.92304677689808,NaN,NaN,-10.106505318076879,-11.229126032239169
2016-10-10T09:30:00-04:00,72,72.42,72,72.2,11039462,8917280,47.568160003648224,46.83783452866339,NaN,NaN,4.669280048285389,-39.59518778670528,0.025440639221749606,-0.27442805867883635,-0.29986869790058596,427805423,426081261,22.804884379287003,42.39908320213848,NaN,NaN,-9.367246242560077,-10.963143205142156
2016-10-11T09:30:00-04:00,71.85,71.85,70.08,70.39,12499679,8932553.8,35.04592883288821,45.80373389363253,NaN,NaN,-237.16274776078686,-75.52430695357349,-0.07589571299061454,-0.39473833913885414,-0.3188426261482396,415305744,424511761.4,21.522915054958858,40.60369461399801,NaN,NaN,-12.942610445528679,-11.245924239483088
2016-10-12T09:30:00-04:00,70.43,70.71,69.99,70.06,11746381,8864446.4,33.32351985355149,44.30944947924822,NaN,NaN,-270.63683165195886,-127.6383232297806,-0.1535857983581873,-0.5108248740959738,-0.35723907573778646,403559363,418024574.4,17.21524161828819,38.43754148793388,NaN,NaN,-16.37249777620594,-11.978291887586353
2016-10-13T09:30:00-04:00,69.65,70.35,69.42,70.09,13623090,9063757.8,33.642805006518756,42.99454568776823,NaN,NaN,-240.88609248817812,-161.65543841311302,-0.18905780704397523,-0.5935613345427555,-0.40450352749878027,417182453,416123788.8,16.192608406244744,36.010190019890366,NaN,NaN,-18.947618156112085,-12.973909925947172
2016-10-14T09:30:00-04:00,70.25,70.44,69.6,69.62,8382388,9048327.75,31.127923669249114,42.0151318516805,NaN,NaN,-195.0464455090389,-187.81256747233547,-0.2276867727797896,-0.6891119934735173,-0.46142522069372766,408800065,414530609.6,15.368553873560401,33.194167249581525,NaN,NaN,-21.917133916180358,-14.251513353123341
2016-10-17T09:30:00-04:00,69.51,69.65,69.24,69.39,8462992,8975494.2,29.948120566663775,40.62770031188467,NaN,NaN,-183.8907549048152,-225.52457446295557,-0.25043428029122117,-0.7744680710577541,-0.5240337907665329,400337073,409036939.6,12.925802439751038,29.839445105312844,NaN,NaN,-24.71320589605199,-15.746040859256006
2016-10-18T09:30:00-04:00,70.03,70.37,69.86,70.22,5495839,8985956.2,38.941816501737144,39.948723147701514,NaN,NaN,-105.66078855345096,-199.2241826214884,-0.19381762150119752,-0.7663058176430297,-0.5724881961418322,405832912,407142373.2,12.205313751075224,26.56624802733553,NaN,NaN,-24.363349800903293,-16.977084993777048
2016-10-19T09:30:00-04:00,70.31,70.37,69.935,69.96,5296697,8826498.55,37.32522324842181,39.81206600286555,NaN,NaN,-94.41205919846846,-163.97922813079032,-0.15954448361777707,-0.7719188006640536,-0.6123743170462765,400536215,406537743.6,11.97588827272618,23.960158162215397,NaN,NaN,-24.57331510286277,-18.062260723646435
2016-10-20T09:30:00-04:00,70.05,70.51,69.92,70.29,6876029,8845192.5,40.69059759154235,39.4620718779052,NaN,NaN,-73.79917797591074,-130.56184522833684,-0.10305643049108382,-0.7411948551601313,-0.6381384246690475,407412244,404583701.8,11.240514690509357,21.47881607515305,NaN,NaN,-23.724781613206492,-18.871192279297873
2016-10-21T09:30:00-04:00,69.93,69.93,69.53,69.71,5511580,8849749.3,36.93658236530389,38.87379087034243,NaN,NaN,-95.9705667125808,-110.74666946904524,-0.09344488357413971,-0.754944529136722,-0.6614996455625823,401900664,403203821.6,10.739030130872067,19.235581237479984,NaN,NaN,-24.143428098629453,-19.62436882491667
2016-10-24T09:30:00-04:00,70.02,70.09,69.58,69.58,7384722,8942282.5,36.13195741819577,38.30070012819531,NaN,NaN,-84.62248358274019,-90.89301520463023,-0.08478754726276327,-0.7674840796410365,-0.6826965323782732,394515942,402039595.4,10.320661076312504,17.599319300261254,NaN,NaN,-24.720794392271923,-20.352429620253133
2016-10-25T09:30:00-04:00,69.5,69.71,69.29,69.38,7922100,8946436.7,34.87331785321311,37.45317584297802,NaN,NaN,-94.50511836988491,-88.66188116791703,-0.08145611204411107,-0.784516672433412,-0.703060560389301,386593842,398191781.4,9.063853588013401,16.025678004024005,NaN,NaN,-25.563339955734442,-21.09684538246475
2016-10-26T09:30:00-04:00,69.27,69.38,68.675,68.96,8073737,9023994.1,32.326637699728565,36.57677522952262,NaN,NaN,-115.05909214063959,-92.79128775635125,-0.09549171887328145,-0.8224252089809028,-0.7269334901076213,378520105,393788559.4,7.881111834673675,14.518437203884115,NaN,NaN,-27.035353588227235,-21.945203697573675
2016-10-27T09:30:00-04:00,69.49,69.76,69.1,69.28,6974728,8929837.2,36.15234265918296,36.00249523356038,NaN,NaN,-82.51431232272716,-94.53431462571453,-0.07223416533141003,-0.8172261967718839,-0.7449920314404739,385494833,389405077.2,6.913876774192843,13.312161135033262,NaN,NaN,-27.183369453977047,-22.693513091345586
2016-10-28T09:30:00-04:00,68.45,68.64,67.48,67.78,18469311,9480629.6,28.125856802905872,34.613759290650215,NaN,NaN,-164.6002894606976,-108.2602591753379,-0.14280469261938245,-0.9234978972147019,-0.7806932045953194,367025522,382430048.8,5.712493285021054,12.091276056871411,NaN,NaN,-30.0413833397189,-23.7432088411132
2016-10-31T09:30:00-04:00,67.76,67.77,67.335,67.36,12688999,9655686.6,26.361060472008788,33.9934115505874,NaN,NaN,-182.45343882602924,-127.82645022399569,-0.19923686186283773,-1.0297392819238667,-0.8305024200610289,354336523,374394165,4.699351349246342,10.8895929350348,NaN,NaN,-32.95596395308602,-25.059316714252176
2016-11-01T09:30:00-04:00,67.4,67.59,66.48,67,14908656,9871389.15,24.917826063133248,33.39300485127181,NaN,NaN,-190.14445352956693,-146.9543172559321,-0.23956595368930045,-1.1299598621726545,-0.8903939084833541,339427867,364960970,3.838681617749401,9.934124363567744,NaN,NaN,-35.800606823148875,-26.593786729808848
2016-11-02T09:30:00-04:00,66.87,67.385,66.65,66.65,17942887,10126430.7,23.56691440796243,32.67329837994636,NaN,NaN,-172.91153194187797,-158.52480521617977,-0.2665036350191995,-1.2235234522573535,-0.957019817238154,321484980,353553945,3.0994486548470377,8.998898667039336,NaN,NaN,-38.568785711074085,-28.304500869989596
2016-11-03T09:30:00-04:00,66.87,67.15,65.96,66.02,22074152,10764692.45,21.32572859360488,31.97314158882892,NaN,NaN,-173.0433826937412,-176.63061929038258,-0.3008972520934501,-1.3331413823549667,-1.0322441302615166,299410828,336337144,2.3605599660195935,8.069756245072135,NaN,NaN,-41.667996512916545,-30.21357167612202
2016-11-04T09:30:00-04:00,66.2,67.025,66.13,66.48,21382560,11337799.45,26.799552735509153,31.748243886603593,NaN,NaN,-136.673607209342,-171.04528284011147,-0.26791407574296566,-1.3671367249402238,-1.099222649197258,320793388,327090717.2,2.074524838972394,7.294664987873659,NaN,NaN,-42.51708465752866,-31.97121638775154
2016-11-07T09:30:00-05:00,67.2,68.365,67.16,68.18,17367791,11654215.9,42.673625324537156,32.01480165966073,NaN,NaN,-55.320349985881286,-145.61866507208188,-0.11468492967968635,-1.242578811296866,-1.1278938816171797,338161179,323855648.4,1.983945661025544,6.564567267155826,NaN,NaN,-37.531685128638344,-32.76556906502108
2016-11-08T09:30:00-05:00,67.74,68.825,67.65,68.37,15943912,11826427.55,44.131862558396215,32.50099018180176,NaN,NaN,-28.609101232197364,-113.31159461260798,0.009776253400659352,-1.1156735648663556,-1.125449818267015,354105091,326791093.2,5.994798260182861,6.1373465519741615,NaN,NaN,-33.20097966517886,-32.82777057932934
2016-11-09T09:30:00-05:00,71.31,71.57,69.26,70.78,49750120,13726614.5,58.53860372818528,33.775847762990544,NaN,NaN,96.64240497504481,-59.4008072292234,0.25133470534811986,-0.811281436581865,-1.0626161419299849,403855211,343265139.4,24.63395485091408,7.094020849145928,NaN,NaN,-23.130181754110758,-31.442400747155258
2016-11-10T09:30:00-05:00,71.94,72.08,71.06,71.56,28379153,14464417.65,61.9578389905174,35.56308037907722,NaN,NaN,141.9279446134881,3.5934582322224458,0.44902892900683367,-0.5013299806714429,-0.9503589096782765,432234364,369829846.6,43.937473318882894,9.46533821971813,NaN,NaN,-14.004204855303664,-28.951229905462174
2016-11-11T09:30:00-05:00,71.36,71.36,70.18,70.49,15866062,14838601.35,55.22919387947422,36.927168697739965,NaN,NaN,90.47225735402053,49.02263114489496,0.48978034046599905,-0.3381334840957777,-0.8279138245617768,416368302,388944829.4,53.22193206866576,12.529714719171933,NaN,NaN,-9.244846026470091,-26.136032208463305
2016-11-14T09:30:00-05:00,70.8,70.88,70.13,70.27,17406162,15285759.85,53.93230160772627,38.28852468020519,NaN,NaN,72.73281092223426,74.63326332651806,0.4831554871755095,-0.22396946559238984,-0.7071249527678993,398962140,401105021.6,57.9884757155899,16.0243305854274,NaN,NaN,-6.137567507050664,-23.279108679690072
2016-11-15T09:30:00-05:00,70.54,70.54,69.815,70.47,10371554,15529545.6,54.967569123747325,39.9057340676351,NaN,NaN,64.58317744577614,93.27171906211277,0.47288560444309324,-0.1160179472140328,-0.588903551657126,409333694,412150742.2,61.79652419809706,19.87543146852907,NaN,NaN,-3.3924458446596257,-20.438156846114296
2016-11-16T09:30:00-05:00,70.29,70.63,70.08,70.17,7585042,15643962.85,53.0420308366463,41.11214036602535,NaN,NaN,64.59009891172724,86.86125784944925,0.4278828182391526,-0.05405002885818533,-0.4819328470973379,401748652,411729430.4,61.56729057197981,23.779246739799568,NaN,NaN,-1.8061391879307023,-17.776440037802356
2016-11-17T09:30:00-05:00,70.22,70.469,70.015,70.45,12856186,15942970.7,54.63918890169693,43.00594980165328,NaN,NaN,65.16741456110384,71.5091518389724,0.3995082549634939,0.01745247160702945,-0.38205578335646445,414604838,408203525.2,59.57554441722732,27.626607534957156,NaN,NaN,-0.03133411333392096,-15.241424905735437
2016-11-18T09:30:00-05:00,70.51,70.699,69.66,69.7,12185025,16276642.95,49.75734686144758,44.677113115184625,NaN,NaN,49.5537126061212,63.325442889392534,0.31640062731326074,0.01344500078511146,-0.3029556265281493,402419813,405413827.4,57.9774076240657,31.432182983158544,NaN,NaN,-0.01565489421644554,-13.066314904089868
2016-11-21T09:30:00-05:00,69.85,70.02,69.765,69.95,6791829,16246998.3,51.31871370574492,46.5628908039426,NaN,NaN,43.62882378066861,57.504645461079406,0.26644053722572214,0.030095045004003396,-0.23634549222171874,409211642,407463727.8,58.85091464571525,35.36162819944182,NaN,NaN,0.46071291662498415,-11.13388235827346
2016-11-22T09:30:00-05:00,69.92,69.92,68.4735,68.94,14522066,16576996.6,45.20649020303428,48.108574789304875,NaN,NaN,5.5015008202786655,45.68831013597991,0.15885814369552467,-0.03777281260231291,-0.19663095629783758,394689576,404534904.2,57.02698081949426,39.2135947826309,NaN,NaN,-1.0368997691593655,-9.691456274114305
2016-11-23T09:30:00-05:00,67.79,69.22,67.79,69.21,13676020,16857110.75,47.023000625653445,49.94409422016548,NaN,NaN,-12.024320339961516,30.36542628564216,0.1021233933807362,-0.06897671457191734,-0.17110010795265354,408365596,405858293,57.66543521762064,43.16394301488812,NaN,NaN,-1.7144385245232003,-8.551882309887004
2016-11-25T09:30:00-05:00,69.41,69.54,69.205,69.48,4009283,16708838.5,48.84919065469482,51.51906835725017,NaN,NaN,20.50757539278343,21.433458451978076,0.08000033024110248,-0.07109969515127545,-0.15110002539237793,412374879,405412301.2,57.35616491238938,47.11263159156076,NaN,NaN,-1.7434652624941969,-7.579251303116603
2016-11-28T09:30:00-05:00,69.35,69.36,68.85,68.96,6507177,16110731.8,45.58970092412692,51.72735947150659,NaN,NaN,0.7331540141393905,11.669346733581714,0.030132638258485,-0.11343422756927168,-0.14356686582775668,405867702,406101879,57.73361440049398,51.09475078723708,NaN,NaN,-2.7281654257630077,-6.886239034923232
2016-11-29T09:30:00-05:00,69.12,69.61,69.11,69.41,7093901,15830976.9,48.77512325350423,52.059020949728584,NaN,NaN,13.007770920136768,5.5451361614753445,0.02732375276138352,-0.10941217487602728,-0.1367359276374108,412961603,406851871.2,58.16730161939886,54.821358170038216,NaN,NaN,-2.642742771522544,-6.2800252830088485
2016-11-30T09:30:00-05:00,69.46,69.48,68.72,68.75,8640677,15517577.95,44.646637691302445,51.06673766137981,NaN,NaN,-14.933727037526408,1.4580905899143297,-0.016742221289137688,-0.15766370424883291,-0.14092148295969523,404320926,408778141.2,59.32178709926952,57.29906047349218,NaN,NaN,-3.8003455420411147,-5.925785320013458
2016-12-01T09:30:00-05:00,68.83,69,68.05,68.25,11360653,15188466.25,41.76266371029825,49.62422514136416,NaN,NaN,-56.43547735455716,-7.424140813004799,-0.07410834286727289,-0.23355691154378633,-0.15944856867651344,392960273,405697076.6,56.62972321688386,58.205649751920824,NaN,NaN,-5.649605448710146,-5.8863310526844135
2016-12-02T09:30:00-05:00,68.37,68.68,68.14,68.41,7964530,14482985.15,43.03083265389301,48.75291362525122,NaN,NaN,-71.93334187740285,-25.912324267042056,-0.09451494633925378,-0.27759225160058065,-0.18307730526132687,400924803,403407061.4,54.6448065758197,58.30728364528896,NaN,NaN,-6.811221767579963,-6.018458297669492
2016-12-05T09:30:00-05:00,68.69,68.79,68.07,68.29,5832104,13705462.35,42.287078777229155,47.921111994501416,NaN,NaN,-88.29072197469192,-43.717099464808314,-0.10833981920066652,-0.31850207926216,-0.2101622600614935,395092699,401252060.8,52.77032441490076,57.9345585523826,NaN,NaN,-7.981036771089617,-6.298826651015224
2016-12-06T09:30:00-05:00,68.49,68.5,68.09,68.48,5490793,13111612.45,43.939288362065156,47.13337765438126,NaN,NaN,-94.46308910894473,-65.21127147062461,-0.09728426399845003,-0.33176759005955603,-0.234483326061106,400583492,398776438.6,50.62203079419812,57.1363804521041,NaN,NaN,-8.53011582072684,-6.617582246688312
2016-12-07T09:30:00-05:00,67.94,67.94,66.97,67.89,12758870,12952360.35,40.10025159468023,46.20896485138369,NaN,NaN,-147.27409462393814,-91.67934498790696,-0.12076973623362913,-0.3854454963531424,-0.26467576011951327,387824622,395477177.8,47.82756312027787,56.1549713484111,NaN,NaN,-10.094167336521762,-7.114237259521662
2016-12-08T09:30:00-05:00,67.68,68.09,67.29,68.02,7586638,10844186.25,41.31688142876576,45.25737146046003,NaN,NaN,-119.37057374770411,-104.26636426653636,-0.11844973142638315,-0.41273792440249224,-0.2942881929761091,395411260,395967375.2,48.284357227875276,55.3484579777431,NaN,NaN,-11.079934416831998,-7.68076542485171
2016-12-09T09:30:00-05:00,68.26,68.976,68.26,68.85,12100155,10030236.35,48.50794476141794,45.168128453315056,NaN,NaN,-44.40825597153747,-98.76134708536327,-0.05513463645953792,-0.3632064885505315,-0.3080718520909936,407511415,397284697.6,49.562383215959926,54.74738480573554,NaN,NaN,-9.921786082055277,-8.000911233023649
2016-12-12T09:30:00-05:00,68.72,69.28,68.72,69.18,15018142,9987840.35,51.07497798194367,45.150718758757826,NaN,NaN,-6.954752214498893,-82.49415313332466,0.011308748526940582,-0.29393591643231787,-0.30524466495925845,422529557,402772069.2,54.59588212262661,54.44345391122921,NaN,NaN,-8.199479523782111,-8.029278131703428
2016-12-13T09:30:00-05:00,69.43,69.84,69.23,69.74,11041413,9669602.9,55.1601830673878,45.861696820497365,NaN,NaN,52.60216959865478,-53.08110139180477,0.09088210081184589,-0.1916420389444511,-0.282524139756297,433570970,409369564.8,59.79145244944915,54.64091617051171,NaN,NaN,-5.485142469748472,-7.665830179995577
2016-12-14T09:30:00-05:00,69.73,70.1,69.1401,69.38,11682151,9735132.75,52.14578107462328,46.2276097097095,NaN,NaN,53.12449430807311,-13.00138360540252,0.11559430621058997,-0.13803125699305951,-0.2536255632036495,421888819,416182404.2,64.33053708685213,55.11699487545682,NaN,NaN,-4.043625772769506,-7.14837240753471
2016-12-15T09:30:00-05:00,69.66,69.9,69.4087,69.83,8210088,9766385.05,55.424937445427375,46.69730590904754,NaN,NaN,78.59423318505607,26.59157778114952,0.15605399782226143,-0.05855806592582269,-0.21461206374808411,430098907,423119933.6,68.25987917151261,55.895831608251335,NaN,NaN,-1.8384020967028019,-6.389805220273009
2016-12-16T09:30:00-05:00,69.68,69.87,69.38,69.58,8257063,9536428.9,53.24215863914718,47.243910031548985,NaN,NaN,74.89104457054869,50.45143788956675,0.1592349015220799,-0.015568436845484257,-0.17480333836756415,421841844,425986019.4,69.74281000807471,56.7536312945071,NaN,NaN,-0.6065164446833432,-5.563621109474485
2016-12-19T09:30:00-05:00,69.63,69.94,69.2,69.29,9318325,9393093.9,50.74557912533744,47.384656879537076,NaN,NaN,64.6857818459688,64.77954470166028,0.13596779983755322,-0.0048435885706226145,-0.14081138840817584,412523519,423984811.8,67.37577998854557,57.411379749446155,NaN,NaN,-0.263400787802843,-4.806446777807108
2016-12-20T09:30:00-05:00,69.32,69.48,69.08,69.24,4884998,9297752.35,50.307573380654304,47.78900942877649,NaN,NaN,44.449465061377076,63.149003794204745,0.11234964187543264,-0.00037433606388503904,-0.11272397793931768,407638521,418798322,61.54577854775036,57.5702362814805,NaN,NaN,-0.09829333764628477,-4.133853429212705
2016-12-21T09:30:00-05:00,69.28,69.31,68.73,68.85,5432275,8843262.8,46.90666132453702,48.156437829793546,NaN,NaN,5.296801448846708,53.583465222359465,0.0677954782493144,-0.02797963012767468,-0.09577510837698908,402206246,414861807.4,57.48034170016295,57.63099474457186,NaN,NaN,-0.8914645678079169,-3.6706550204405923
2016-12-22T09:30:00-05:00,68.76,68.96,68.48,68.94,4458413,8382382.45,47.78392240661439,48.495944240702215,NaN,NaN,-17.970857242579417,34.27044713683237,0.04293259377431455,-0.042109366159095885,-0.08504195993341043,406664659,410174957.8,52.99212212930482,57.51294585553508,NaN,NaN,-1.3256085878019404,-3.3356483872064993
2016-12-23T09:30:00-05:00,68.96,69.5,68.96,69.46,4188703,8391353.45,52.65178139171167,49.23628014173668,NaN,NaN,52.42283715429407,29.776805653581448,0.05905891845191388,-0.011218311868518072,-0.07027723032043195,410853362,407977261.4,50.98190853223299,57.38520186391596,NaN,NaN,-0.37185381566648734,-2.912249162700783
2016-12-27T09:30:00-05:00,69.55,70,69.53,69.6,5141174,8323053.3,53.89791242188922,49.947610431724115,NaN,NaN,97.6519708149987,36.370043447387424,0.07564579727409464,0.024280016272186344,-0.05136578100190829,415994536,408671464.8,51.60639437673854,57.45551354838313,NaN,NaN,0.7721875555276462,-2.385901060096722
2016-12-28T09:30:00-05:00,69.67,69.75,69.06,69.07,4558824,8196299.45,48.67515421740164,50.56010347620422,NaN,NaN,44.652423104540254,36.410635056020055,0.048721584083889394,0.009536199102953447,-0.03918538498093595,411435712,409430903,52.322001413618665,57.776544855050325,NaN,NaN,0.33050569818478703,-1.997842951770792
2016-12-29T09:30:00-05:00,69.11,69.41,69.0779,69.19,5539273,8041229.25,49.85984153063041,51.170314912051694,NaN,NaN,33.678341036573734,42.086942973565456,0.037307308251851724,0.0074487503338787064,-0.029858557917973018,416974985,412384650.8,55.102812064137446,58.26357734335477,NaN,NaN,0.2840832598189249,-1.671853492972261
2016-12-30T09:30:00-05:00,69.2,69.27,68.72,68.94,6648979,7805645.55,47.40489133476552,51.091525381576524,NaN,NaN,-1.6984014109646068,45.34143413988842,0.012515149364251181,-0.01421462121265904,-0.02672977057691022,410326006,413116920.2,55.791217225088396,58.708494058292516,NaN,NaN,-0.43037988356739704,-1.4945001202001376
2017-01-03T09:30:00-05:00,69.31,69.86,69.22,69.84,11792938,7997065.95,55.83539182474162,51.431554941776376,NaN,NaN,81.2190868403204,51.10068407709368,0.05399942731944799,0.040769513572399774,-0.01322991374704822,422118944,415370036.6,57.92872674994649,58.946554388815365,NaN,NaN,1.4366647953181337,-1.075762275126099
2017-01-04T09:30:00-05:00,69.95,70.58,69.95,70.39,9174456,8164183.55,60.04975810052923,51.78081030128647,NaN,NaN,156.84387850135403,62.939065614364765,0.11239055954581086,0.12725828568521536,0.014867726139404494,431293400,418429809.4,60.70717904676502,59.01196343148079,NaN,NaN,4.3829948826174885,-0.2959398240198722
2017-01-05T09:30:00-05:00,70.33,70.77,70.27,70.75,5979290,8188608.4,62.567608732410854,52.525226562557016,NaN,NaN,179.94110412724606,89.99680181890594,0.16593610390624094,0.2222878560222057,0.056351752115964736,437272690,423597205,64.92061567508921,59.054111902069145,NaN,NaN,7.64338505761769,0.8382494447854937
2017-01-06T09:30:00-05:00,70.77,71.15,70.515,70.95,5769255,7839127.65,63.927786042381065,53.13257289091086,NaN,NaN,199.4783189205909,123.15679739570938,0.20304855359469845,0.3101624441093378,0.10711389051463935,443041945,428810597,68.581168207113,59.077061118897745,NaN,NaN,10.741769115732534,2.2530379692064995
2017-01-09T09:30:00-05:00,70.95,71.37,70.82,71.25,5751911,7747391.3,65.92776105305798,54.038687349047336,NaN,NaN,212.26351158281943,165.9491799944662,0.23383453962225115,0.39940706504245327,0.16557252542020212,448793856,436504167,73.0504559365451,59.313321542359915,NaN,NaN,13.960365809593645,3.9255133749760915
2017-01-10T09:30:00-05:00,71.37,71.91,71.21,71.5,10320463,7658406.7,67.5427406999466,55.23848460437656,NaN,NaN,207.75820916821763,191.2570044600456,0.2553175291255801,0.4847194368271772,0.22940190770159713,459114319,443903242,76.51101826294969,59.965838561960204,NaN,NaN,17.148062025245444,5.814448896443142
2017-01-11T09:30:00-05:00,71.59,71.84,70.05,70.78,23741959,8094597.55,58.885979192120146,55.85122787662413,NaN,NaN,110.90889646791422,182.07000805335764,0.20735835263035624,0.4885998484895424,0.2812414958591862,435372360,444719034,76.86377430532502,61.059981116072684,NaN,NaN,17.360153600330374,7.463835282712746
2017-01-12T09:30:00-05:00,70.43,70.89,70.26,70.85,9358905,8010472.15,59.430391354649416,56.74578002163215,NaN,NaN,76.53130876543314,161.38804898099505,0.16833161387224183,0.4916560131994885,0.32332439932724666,444731265,446210749,77.52833792772506,62.49198084661284,NaN,NaN,17.69063359098086,8.92480646960819
2017-01-13T09:30:00-05:00,70.91,71.16,70.75,70.92,5279017,7690315.45,60.00078414643626,57.618413003048,NaN,NaN,89.93295536114834,139.47897626910657,0.1365657383740097,0.4940315722947588,0.3574658339207491,450010282,447604416.4,78.15953348182236,64.28965308607839,NaN,NaN,18.12185138481464,10.238670028923398
2017-01-17T09:30:00-05:00,70.48,70.68,69.98,70.56,6038233,7581722.7,55.666139887601325,57.833724324182974,NaN,NaN,37.615773640272,104.54942868059706,0.08326319460125525,0.46154482717231815,0.3782816325710629,443972049,446640055,76.55710159065208,66.11645259025117,NaN,NaN,17.251411141850124,11.240490187912929
2017-01-18T09:30:00-05:00,70.7,70.86,70.33,70.47,6174216,7477580.35,54.604086441651546,57.884165325594566,NaN,NaN,45.81109333124652,72.16000551320286,0.03629708737931636,0.4236529917952083,0.38735590441589196,437797833,442376757.8,69.74899925166056,67.41235293845988,NaN,NaN,16.230586843460586,11.953361138705452
2017-01-19T09:30:00-05:00,70.45,70.61,69.91,70.02,6470661,7335197.15,49.51705140007186,57.94430083864244,NaN,NaN,10.46256974415401,52.07074016845081,-0.02729251059999538,0.35324026616589776,0.38053277676589314,431327172,441567720.2,68.50401347668682,68.56821094296474,NaN,NaN,13.843312224149235,12.223354150911707
2017-01-20T09:30:00-05:00,70.02,70.37,69.78,69.84,7006899,7441292.2,47.6065347409495,57.783350353665234,NaN,NaN,-9.881192745650495,34.788239866234086,-0.0806749443494511,0.27968909632907923,0.36036404067853034,424320273,437485521.8,62.44713306566426,69.09280530021667,NaN,NaN,11.278994210811257,12.088445588040214
2017-01-23T09:30:00-05:00,69.75,69.938,69.29,69.55,10003675,7669862.2,44.619560240953234,57.58439813267864,NaN,NaN,-54.04245079286506,5.993158635431395,-0.13169739842073575,0.19574229265261067,0.3274396910733464,414316598,430346785,53.53322175340234,68.93151990938195,NaN,NaN,8.195336834819406,11.532287194722956
2017-01-24T09:30:00-05:00,69.48,69.53,68.75,69.07,8703494,7882116.25,40.1313179839842,56.46267857262455,NaN,NaN,-106.21230841661686,-22.772457775946386,-0.190391172711823,0.08945072518356767,0.27984189789539066,405613104,422674996,45.94329018034936,68.07541729726786,NaN,NaN,4.090552746169063,10.469182273500971
2017-01-25T09:30:00-05:00,69.13,69.75,69.09,69.72,6553834,8000372.8,47.79011476154957,55.586989762697435,NaN,NaN,-66.98812168720731,-45.33230077963715,-0.1782684571545896,0.057006326452153644,0.23527478360674325,412166938,417548817,41.68997189976851,66.7170453581967,NaN,NaN,2.7448793166116823,9.365710422516788
2017-01-26T09:30:00-05:00,69.57,69.69,69.17,69.18,6612453,8073936.75,42.88213934514103,54.18088480646387,NaN,NaN,-80.72484558888608,-63.56978384624517,-0.1979315405543181,-0.012139642086154367,0.18579189846816374,405554485,412394279.6,37.89134672909241,64.7863832906255,NaN,NaN,-0.008312233574025489,8.02656432878953
2017-01-27T09:30:00-05:00,69.34,69.8,69.32,69.75,7264900,8209240.55,48.853163914262026,53.104126083026806,NaN,NaN,-55.814210487726356,-72.75638739466034,-0.16519784276752875,-0.020705404991247178,0.14449243777628157,412819385,410094102,36.301778759462316,62.4807126157933,NaN,NaN,-0.4201880598035046,6.819885416133382
2017-01-30T09:30:00-05:00,69.58,69.72,69.12,69.41,7281928,8296373.3,45.77896715498182,51.66492651887851,NaN,NaN,-79.73728679139909,-77.89535459436715,-0.15903636692954923,-0.05430302088565497,0.10473334604389425,405537457,408338273.8,35.09160528107466,59.76936614040256,NaN,NaN,-1.754228873820948,5.595011946139906
2017-01-31T09:30:00-05:00,69.04,70.52,68.99,70.52,14342468,8681047.75,55.60173183620872,50.8119973143258,NaN,NaN,-24.18522712972356,-61.48993833698849,-0.07695475117878406,0.008539907070414188,0.08549465824919825,419879925,411191638,38.66972220875618,57.06641642224588,NaN,NaN,0.5189598950480956,4.86986165312679
2017-02-01T09:30:00-05:00,70.52,71.13,70.38,71.13,19490501,9065925.9,59.900968715469446,50.88449656599361,NaN,NaN,69.91357697303829,-34.109598604939364,0.016675847056141696,0.10633946706937536,0.08966362001323366,439370426,416632335.6,44.90618802157315,54.783731687692175,NaN,NaN,3.9338019287832253,4.736138835363424
2017-02-02T09:30:00-05:00,70.78,71.15,70.555,71.11,14539361,9334171.15,59.696859940396955,50.90353003640415,NaN,NaN,69.5738435514008,-4.049860776881985,0.07239371726073485,0.18015576658915222,0.10776204932841738,424831065,420487651.6,48.873528819732705,52.73695960854987,NaN,NaN,6.46933033828909,4.983737621495663
2017-02-03T09:30:00-05:00,71.34,71.49,71,71.42,15104788,9790446.05,61.8658534067779,51.03674926928569,NaN,NaN,100.84051337756587,27.28108399617646,0.12232263033640481,0.2606653372489234,0.13834270691251857,439935853,425910945.2,53.902319704858755,51.00430148162389,NaN,NaN,9.242398428215855,5.592117736741404
2017-02-06T09:30:00-05:00,71.29,71.5,71.15,71.5,11561794,10080073,62.42780499662033,51.51972534850133,NaN,NaN,102.83374925063885,63.795291204584046,0.1510489204114314,0.3271538574268078,0.1761049370153764,451497647,435102983.2,60.918796122098726,49.887279662441514,NaN,NaN,11.630080128725723,6.454683792739163
2017-02-07T09:30:00-05:00,71.55,71.83,71.33,71.57,11278046,10356379.75,62.94238753412119,52.115318283677745,NaN,NaN,116.86684769852458,92.00570617023367,0.1639974898772078,0.38110179936188615,0.21710430948467835,462775693,443682136.8,66.10441347836185,49.626952107205895,NaN,NaN,13.721684527479752,7.492826754844962
2017-02-08T09:30:00-05:00,71.19,71.535,70.99,71.46,6812927,10181002.95,61.516582943127844,52.972427679610306,NaN,NaN,94.70629219904468,96.96424921543495,0.15451714138256734,0.41025073621288755,0.2557335948303202,455962766,447000604.8,67.87978345916912,49.58236424881177,NaN,NaN,15.066527251836057,8.574783968700832
2017-02-09T09:30:00-05:00,71.45,71.93,71.39,71.72,7869248,9387367.4,63.614601285160155,54.11586100419679,NaN,NaN,119.32656096713035,106.91479269858087,0.15473611695602835,0.44915374102535566,0.2944176240693273,463832014,454800794.6,71.63993356626936,50.23899285599784,NaN,NaN,16.812422280352486,9.751589441793925
2017-02-10T09:30:00-05:00,71.83,72.02,71.66,71.86,4440343,9141439.3,64.72962748213837,55.55229437856716,NaN,NaN,119.50721083670145,110.64813219040798,0.15301216731826178,0.48568283321715455,0.33267066589889277,468272357,460468095.4,74.01966145919178,51.702309977839946,NaN,NaN,18.595086367363148,11.014946145446672
2017-02-13T09:30:00-05:00,71.93,72.34,71.93,72.3,6465225,9200749.7,68.04412688391155,57.54606644284768,NaN,NaN,133.20920694029374,116.72322372833897,0.16895735555234165,0.5438673603393198,0.37491000478697817,474737582,465116082.4,75.81228165149346,53.83580936863596,NaN,NaN,21.140246651912182,12.461417646370316
2017-02-14T09:30:00-05:00,72.22,72.87,72.165,72.87,10402997,9418987.9,71.74805924877278,59.25734819193506,NaN,NaN,143.37009737340185,122.0238736633144,0.20305255228742392,0.6287256951462581,0.4256731428588342,485140579,469589059.6,77.42648807765083,56.38841766705612,NaN,NaN,24.562484476606787,14.190141479261241
2017-02-15T09:30:00-05:00,72.71,73.8,72.64,73.66,10091712,9614862.7,75.91482499177164,61.61682573812295,NaN,NaN,165.28692647263478,136.14000051803242,0.2603135843742675,0.7510651233266685,0.49075153895240103,495232291,477442964.6,79.95592488178481,59.393030392248434,NaN,NaN,29.05902009667784,16.31426699603504
2017-02-16T09:30:00-05:00,73.68,73.75,73.06,73.56,11332623,9857960.8,74.41862370409874,63.44293000882557,NaN,NaN,149.08301854866312,142.091292034339,0.27170176722888284,0.8303787479885045,0.5586769807596217,483899668,481456495.4,81.12018009108724,62.59434477307878,NaN,NaN,32.201197688738254,18.583828523564073
2017-02-17T09:30:00-05:00,73.28,73.7,73.28,73.66,12118416,10113536.65,74.95030400769991,65.52659692687688,NaN,NaN,136.12848505056806,145.41554687711232,0.26588501900259265,0.8910332545128625,0.6251482355102699,496018084,487005640.8,82.62304528114353,65.98944763022655,NaN,NaN,34.91938809012128,20.917479890215102
2017-02-21T09:30:00-05:00,73.65,74.23,73.65,73.99,10651815,10145943.65,76.67327903704218,67.03170744122211,NaN,NaN,143.54975965409284,147.48365741987215,0.2636615337802002,0.95472515273552,0.6910636189553199,506669899,493392104.2,84.18350130593468,69.24043185145358,NaN,NaN,37.76665365627585,23.324504713938065
2017-02-22T09:30:00-05:00,73.9,74.14,73.815,73.88,6634265,10042482.2,74.82575100359038,68.09776331894504,NaN,NaN,127.79857094250475,144.3693521336927,0.2351260849165604,0.9849712251010203,0.7498451401844599,500035634,496371115.2,84.8661896903343,72.09471768493653,NaN,NaN,39.59817937807405,25.649315380243205
2017-02-23T09:30:00-05:00,73.96,74.545,73.87,74.42,8685596,10149070.3,77.67031294222016,69.38158139050385,NaN,NaN,128.2076513486715,136.95349710890005,0.23254026394488547,1.0405204701155668,0.8079802061706813,508721230,499068903,85.47751646791453,74.70928823123522,NaN,NaN,42.09747239338859,27.99905209640683
2017-02-24T09:30:00-05:00,74.3,74.82,74.27,74.78,9103034,10273599.35,79.34586992974558,70.63015399928726,NaN,NaN,128.4022527306059,132.8173439452886,0.23433753422949744,1.1009021239575532,0.8665645897280557,517824264,505853822.2,86.90969296812081,77.06695775003966,NaN,NaN,44.74931303990393,30.391946516906415
2017-02-27T09:30:00-05:00,74.83,75.18,74.67,75.14,8178202,10319264.45,80.89012519853017,71.94889115656653,NaN,NaN,129.87494210283353,131.5666353557417,0.23825372267867906,1.1643817430764045,0.9261280203977255,526002466,511850698.6,88.03301788845928,79.00368787620826,NaN,NaN,47.489353482025834,32.83443322620919
2017-02-28T09:30:00-05:00,74.93,75.23,74.77,74.99,10258588,10468097.45,78.26439640900442,73.04332036191533,NaN,NaN,117.38991962931566,126.33466735078628,0.2102026779386741,1.1888813678210681,0.978678689882394,515743878,513665494.4,88.3585909483295,80.59327198120596,NaN,NaN,48.97864698115682,35.140749476916
2017-03-01T09:30:00-05:00,75.44,75.93,75.225,75.74,15196599,10510804,81.49825951143848,74.47058297393752,NaN,NaN,133.33333333334028,127.44161982895339,0.22054247587458864,1.2543567847256298,1.0338143088510412,530940477,519846463,89.41485850881611,82.13149162760931,NaN,NaN,51.36983384105572,37.45919010036453
2017-03-02T09:30:00-05:00,75.62,75.885,75.49,75.5,7889322,9930745.05,77.5234381659447,75.46407132256499,NaN,NaN,120.52649953757307,125.90538946673371,0.1907207328588647,1.2722152249246221,1.0814944920657574,523051155,522712448,89.87365811617617,83.43390052403122,NaN,NaN,52.10083801337573,39.55085408793756
2017-03-03T09:30:00-05:00,75.39,75.86,75.365,75.8,6635276,9535540.8,78.90820758512659,76.476827044207,NaN,NaN,113.85575488140158,122.99608989689281,0.17131666641250876,1.2956403250813935,1.1243236586688847,529686431,525084881.4,90.25037833778393,84.59323744393066,NaN,NaN,53.13260012836617,41.491103522284504
2017-03-06T09:30:00-05:00,75.69,75.75,75.24,75.51,5886906,9074646.7,74.15229762773221,76.91312495447991,NaN,NaN,96.01847731655809,116.22479693963774,0.12141650405374138,1.2760942887360613,1.15467778468232,523799525,524644293.2,89.5838485269401,85.57692079217684,NaN,NaN,52.545266844016666,43.070269711103386
2017-03-07T09:30:00-05:00,74.89,75.36,74.74,74.98,12330631,9113088.55,66.28882594001774,76.52317971814026,NaN,NaN,65.6323285033221,105.87327871443901,0.039424856462562996,1.2039588552605238,1.1645339987979608,511468894,523789296.4,88.22220086090182,86.34804313383763,NaN,NaN,49.53235327493798,43.9934245059369
2017-03-08T09:30:00-05:00,74.97,75.54,74.92,75.28,8130032,8955687.85,68.33569359416568,75.98181318973984,NaN,NaN,71.55308102521573,93.5172282528141,-0.0055041709594410015,1.1576537850986597,1.1631579560581007,519598926,521520986.2,84.55044685673221,86.6762232749053,NaN,NaN,47.638653777983265,44.51417154480067
2017-03-09T09:30:00-05:00,75.27,75.79,75.22,75.69,8451394,9037611.2,70.93322067445185,75.73285583047935,NaN,NaN,82.84581334376725,85.98109101405295,-0.01781532408358588,1.1408888009536184,1.1587041250372043,528050320,522520819.2,84.84975940438889,86.94262179728399,NaN,NaN,46.821217329430745,44.84374951403353
2017-03-10T09:30:00-05:00,76.01,76.09,75.7,75.98,10455762,9166936.9,72.64269373607945,75.5680265253636,NaN,NaN,97.60530254437455,82.73100054664755,-0.01665436945194232,1.1378861632222765,1.1545405326742189,538506082,524284749.4,85.38761861743983,87.14009132130515,NaN,NaN,46.66050417808034,45.103285894611645
2017-03-13T09:30:00-04:00,76.05,76.05,75.62,75.92,6898546,9289847.05,71.7030976439406,75.21301356871349,NaN,NaN,88.99476501383052,81.32625808610203,-0.029408441496605375,1.117779980803462,1.1471884223000675,531607536,525846351.6,85.86601448976063,87.26027083443557,NaN,NaN,46.25403406808465,45.26767849082207
2017-03-14T09:30:00-04:00,75.71,75.96,75.56,75.64,7296332,9331402.4,67.32659328226026,74.67735944576134,NaN,NaN,74.47271576115688,83.09433553766898,-0.06418845140444107,1.066952858044516,1.131141309448957,524311204,528414813.6,86.64072041900243,87.38702302934044,NaN,NaN,44.61984698088328,45.17513113225939
2017-03-15T09:30:00-04:00,75.75,76.745,75.745,76.59,11044878,9363496.45,73.28460445854748,74.36409455407043,NaN,NaN,122.61403720838734,93.30652677430331,-0.03230864190050542,1.0907555070733252,1.1230641489738307,535356082,531566244.8,87.54293014944398,87.53455257802112,NaN,NaN,44.989604541376224,45.14862733356179
2017-03-16T09:30:00-04:00,76.4,76.4,75.5601,75.85,12129389,9465380.3,63.561715952353445,73.2366549842567,NaN,NaN,80.08517607429384,92.75439932040862,-0.06809715521924797,1.0379427049497707,1.1060398601690187,523226693,530601519.4,85.63631514796104,87.44359701943827,NaN,NaN,41.96191717401105,44.693383025054544
2017-03-17T09:30:00-04:00,75.39,75.5262,75.12,75.16,10400969,9418797.6,56.08924544736566,71.46516357345925,NaN,NaN,9.214364704449997,75.0762117524237,-0.14107667894185094,0.9296940114917049,1.0707706904335559,512825724,525465447.8,76.13004691979992,86.59338480739119,NaN,NaN,36.73736941350768,43.55680965197642
2017-03-20T09:30:00-04:00,75.18,75.29,74.895,75.0359,4728301,9049291.85,54.84049027758902,69.7920274212153,NaN,NaN,-23.97090226925563,52.483078295806465,-0.19710514200688234,0.824389262924953,1.0214944049318353,508097423,520763425.2,68.62002366098056,85.1834871440091,NaN,NaN,32.26473660840633,41.943656360037835
2017-03-21T09:30:00-04:00,75.13,75.39,72.33,74.46,16650419,9349222.05,49.349616458339156,67.49569577456535,NaN,NaN,-156.22516208810404,6.3435027259542895,-0.2679554820557932,0.6865500523620938,0.954505534417887,491447004,514190585.2,59.74730809861704,83.06437640042348,NaN,NaN,26.611473267964904,39.7533444897417
2017-03-22T09:30:00-04:00,74.57,74.6663,74.11,74.48,9954250,9515221.3,49.5385753110238,65.49677699921385,NaN,NaN,-118.32734874038874,-41.84477446380093,-0.30574212493632724,0.5723278782474779,0.8780700031838051,501401254,507399619.6,52.232624534562696,80.37573114459394,NaN,NaN,22.266592947668475,37.25523712658838
2017-03-23T09:30:00-04:00,74.39,74.7657,74.111,74.25,13250456,9743464.3,47.350840289274885,63.24267933522445,NaN,NaN,-126.10785154684761,-83.08337998802922,-0.3360818125291394,0.45796773752238096,0.7940495500515203,488150798,500384440.6,45.82124936464472,77.20222193222685,NaN,NaN,18.01112266724877,34.506077918111295
2017-03-24T09:30:00-04:00,74.29,74.62,73.98,74.29,9229473,9749786.25,47.78273922228086,61.359139449120775,NaN,NaN,-130.31302904562668,-110.98885873804454,-0.342166668597652,0.3663412143044553,0.7085078829021073,497380271,497295350,43.30077884114904,73.89628838324177,NaN,NaN,14.693786764518112,31.675750610455125
2017-03-27T09:30:00-04:00,73.76,74.62,73.621,74.49,6946344,9688193.35,49.99169737592835,60.195058837400104,NaN,NaN,-122.33624087020455,-130.66192645823432,-0.3217393946892879,0.3063336395404974,0.6280730342297853,504326615,496541188.4,42.68348349170378,70.64352285687049,NaN,NaN,12.509785256943362,28.937755559953445
2017-03-28T09:30:00-04:00,74.34,74.64,74.11,74.54,7392285,9544878.2,50.55484446338258,58.92499818520132,NaN,NaN,-90.33521641587296,-117.48393732378811,-0.29460500320043326,0.2598167802292437,0.554421783429677,511718900,500595567.6,47.053463834812874,67.96516692673339,NaN,NaN,10.852559142450101,26.354156071738682
2017-03-29T09:30:00-04:00,74.57,74.74,74.39,74.56,4357827,9002939.6,50.79354121812162,57.486449652606304,NaN,NaN,-66.81990582674071,-107.18244874105851,-0.26593221550965807,0.2220065140426044,0.4879387295522625,516076727,503530662.2,50.02405659651197,65.47761672617075,NaN,NaN,9.531484361409078,23.95091725597731
2017-03-30T09:30:00-04:00,74.47,74.72,74.27,74.57,7137422,8965344.6,50.92111813859773,55.934908538500466,NaN,NaN,-64.54588030517898,-94.87005449272479,-0.2378303291199761,0.19065081815229235,0.42848114727226844,523214149,510543332.4,56.328537026206604,63.40196804108266,NaN,NaN,8.449595306959608,21.736442691831925
2017-03-31T09:30:00-04:00,74.39,74.56,74.28,74.36,5895356,8928348.6,48.100749818910806,54.24902655099834,NaN,NaN,-70.34703206388753,-82.87685509637694,-0.2250572425380168,0.14715959409974744,0.3722168366377642,517318793,514531036.8,59.46032792172441,61.515847571937215,NaN,NaN,6.772685424152961,19.5987630821635
2017-04-03T09:30:00-04:00,74.44,74.79,74.13,74.42,12354819,9251744.25,48.97040414981632,52.9378701843952,NaN,NaN,-58.90501055598483,-70.19060903353301,-0.20481781680158728,0.11619456563578012,0.3210123824373674,529673612,519600436.2,63.084600279345175,59.83326756196169,NaN,NaN,5.5486663626130115,17.591606407942002
2017-04-04T09:30:00-04:00,74.4,74.48,74.17,74.38,5228588,8896642.1,48.38827526715718,51.15956095643876,NaN,NaN,-63.65690939395679,-64.85494762914978,-0.18687456361820465,0.08741917791461162,0.27429374153281627,524445024,522145661,64.78676221780965,58.20782699541639,NaN,NaN,4.354039397545619,15.700525406456805
2017-04-05T09:30:00-04:00,74.48,74.92,74.1,74.15,6470120,8813646.5,45.07061813113328,49.83876825492303,NaN,NaN,-53.89724264018913,-62.27041499183946,-0.1830105530825567,0.04553055017962038,0.22854110326217708,517974904,522525296.4,65.04565486103468,56.737065546350216,NaN,NaN,2.4413497694025974,13.806357458306204
2017-04-06T09:30:00-04:00,74.17,74.415,73.95,74.28,5253261,8653739.85,47.27120932076631,49.2089085315945,NaN,NaN,-66.9407513661909,-62.74938920404183,-0.1647822198514431,0.022563328447873232,0.18734554829931632,523228165,522528099.6,65.04769829964988,55.945469216339504,NaN,NaN,1.3104258769004855,12.021224375248245
2017-04-07T09:30:00-04:00,74.33,74.597,74.13,74.41,5638152,8412859.35,49.45204494139424,48.82401957900917,NaN,NaN,-45.724798795247864,-57.82494255031391,-0.1381305947757799,0.01468230482959143,0.15281289960537134,528866317,524837604.4,66.77124842697489,55.81341384248196,NaN,NaN,0.8650927865277049,10.42749129114531
2017-04-10T09:30:00-04:00,74.39,74.639,74.2,74.27,4529953,8294429.7,47.18854208141048,48.669657123514256,NaN,NaN,-43.598984995725466,-54.763737438262034,-0.12451247744876841,-0.0028276972055891747,0.12168478024317923,524336364,523770154.8,65.17161735912211,56.200864503946605,NaN,NaN,-0.09576006270260977,8.924169669167036
2017-04-11T09:30:00-04:00,74.15,74.34,73.762,74.17,5472621,8203244.15,45.583590373592024,48.38715819941199,NaN,NaN,-82.23168331699026,-58.47869222286873,-0.11694089881564812,-0.024491343276380917,0.0924495555392672,518863743,522653898.6,63.45952058303862,57.00278565026632,NaN,NaN,-1.3368607013489755,7.458308187664748
2017-04-12T09:30:00-04:00,74.09,74.29,73.87,74.17,3782186,7840109.55,45.583590373592024,48.2609260625775,NaN,NaN,-89.49778032445988,-65.59879975972288,-0.10690778981345868,-0.04118518172755614,0.06572260808590254,518863743,522831666.4,63.62341555352564,58.27436894947209,NaN,NaN,-2.394041152072127,6.050829710559481
2017-04-13T09:30:00-04:00,74.08,74.325,73.98,73.98,6671107,7567195.45,42.40547057293759,47.876835444767266,NaN,NaN,-109.18090070668568,-74.04682962782184,-0.10773948506368637,-0.06895174824370542,0.03878773681998095,512192636,520624560.6,60.02369451622841,59.468862926263476,NaN,NaN,-4.149902795780341,4.593582209653793
2017-04-17T09:30:00-04:00,73.89,74.27,73.83,74.25,6149877,7354640.85,47.95822748547356,47.73158759544907,NaN,NaN,-98.9575105768916,-84.69337198415057,-0.08573574485770676,-0.0683819442521525,0.01735380060555426,518342513,518519799.8,56.727521833960694,60.47200852213898,NaN,NaN,-4.296286878714283,3.323600911315496
2017-04-18T09:30:00-04:00,73.84,73.84,73.16,73.44,7519486,7494200.1,36.56795649097997,46.73252416884888,NaN,NaN,-303.94995945780204,-136.7635668765659,-0.11930033634271739,-0.13177161982284247,-0.012471283480125085,510823027,515817132.4,52.723760757685454,60.87702973091559,NaN,NaN,-8.065094305647435,1.696644451749363
2017-04-19T09:30:00-04:00,73.68,73.87,73.53,73.66,5023119,6912835.1,40.688302009478306,46.0107213682315,NaN,NaN,-192.03208129685154,-158.72364647253815,-0.11993046691496773,-0.16238436712383475,-0.042453900208867024,515846146,515213613,51.843817575997186,61.00701265802167,NaN,NaN,-9.90356930209254,0.03947105834337705
2017-04-20T09:30:00-04:00,73.81,74.27,73.47,74.12,7297513,6779998.25,48.25662290231342,45.82040027992548,NaN,NaN,-88.22711925258912,-158.469514258164,-0.08429529783801581,-0.1478230225063868,-0.06352772466837098,523143659,516069596.2,53.040907121991424,60.77218195057774,NaN,NaN,-8.99340967840782,-1.2509404754782225
2017-04-21T09:30:00-04:00,73.99,74.059,73.51,73.68,6762958,6455623.35,42.650497480297965,45.43109654145314,NaN,NaN,-130.49991188386392,-162.73331649359963,-0.08504156736483229,-0.16982968387441133,-0.08478811650957904,516380701,516907209.2,54.239651980210766,60.3992765261839,NaN,NaN,-10.113763383673517,-2.517058033791836
2017-04-24T09:30:00-04:00,74.39,74.59,74.31,74.41,5450018,6266650.6,52.50826904008667,45.68380117647245,NaN,NaN,67.56291922264248,-129.42923053369285,-0.03369140350031856,-0.12690237088497724,-0.09321096738465869,521830719,517604850.4,55.26397710465302,59.84066058513446,NaN,NaN,-7.436374949725416,-3.219817593210919
2017-04-25T09:30:00-04:00,74.71,74.945,74.5,74.73,8923049,6365485.85,56.07273946997623,46.2326914766738,NaN,NaN,131.83210501570127,-42.27281763899218,0.02153148245474347,-0.06629661431622935,-0.08782809677097282,530753768,521590998.6,60.67986329635991,59.54731066217376,NaN,NaN,-4.000497659992278,-3.3313433170368274
2017-04-26T09:30:00-04:00,75,75.44,74.94,75.14,6240415,6307892.35,60.194980831201505,47.313003098107245,NaN,NaN,212.17766599912227,38.56913182020258,0.08198135579552518,0.014648597973433652,-0.06733275782209153,536994183,525820606,65.4583128296191,59.57678623135837,NaN,NaN,0.30932223971999095,-2.811248237500139
2017-04-27T09:30:00-04:00,75.16,75.65,75.01,75.3,6962756,6438138.8,61.70526668790438,48.34400719575997,NaN,NaN,212.27414784061804,98.669385238844,0.1263972532695034,0.09066380876478775,-0.03573344450471567,543956939,529983262,69.39972989913093,59.8876456313213,NaN,NaN,4.199056281395879,-1.8097761633721368
2017-04-28T09:30:00-04:00,75.36,75.54,75.235,75.5,5781071,6370321.25,63.56615790499437,49.35215812173141,NaN,NaN,199.25567089583706,164.6205017947842,0.16069963220547936,0.16514109575213354,0.004441463546654173,549738010,536654723.8,74.43468071041215,60.43503365156682,NaN,NaN,7.947032451547546,-0.4159463612407537
2017-05-01T09:30:00-04:00,75.63,75.815,75.5,75.67,7182033,6434655.1,65.11779268135498,50.632818878870225,NaN,NaN,192.97421724038622,189.70276139833294,0.18458406938493763,0.2351715502778262,0.05058748089288859,556920043,543672588.6,78.45129262928273,61.383581885149724,NaN,NaN,11.483194929237442,1.2839309659704168
2017-05-02T09:30:00-04:00,75.74,75.9,75.3,75.88,5243780,6079103.15,66.9880883327688,52.16171159023999,NaN,NaN,157.5314813860729,194.84263667240728,0.20281868295740943,0.3041108345896504,0.10129215163224095,562163823,549954599.6,81.28569064058851,62.656879746403284,NaN,NaN,14.999215154415833,3.2432572786054763
2017-05-03T09:30:00-04:00,75.65,75.71,75.34,75.51,8094141,6222380.8,60.802321064674615,53.24876378246017,NaN,NaN,113.61950428646803,175.13100432987645,0.17907969815485883,0.3251417743258145,0.14606207617095565,554069682,553369699.4,82.62377768554214,64.01404847011875,NaN,NaN,16.086623124878287,5.078023828073021
2017-05-04T09:30:00-04:00,75.77,76.01,75.66,76.01,4275352,6112642.4,65.44585955337956,54.89450585249174,NaN,NaN,130.67845710250558,158.81186618225394,0.18539012052991152,0.37779972683334506,0.19240960630343354,558345034,556247318.4,83.6824924278746,65.7039626066649,NaN,NaN,18.566093793625974,7.004890966009157
2017-05-05T09:30:00-04:00,76.18,76.2,75.66,75.97,5720072,6135982.95,64.78465547725122,56.096393566190144,NaN,NaN,117.00307796287457,142.36134759566144,0.17532004635495058,0.41155966424712176,0.23623961789217118,552624962,556824708.8,83.89453247037156,67.64446336640853,NaN,NaN,20.318481766052745,8.906832508872526
2017-05-08T09:30:00-04:00,75.91,75.97,75.39,75.5,6558505,6182000.6,57.44121597900064,57.58734067247734,NaN,NaN,77.34576576176056,119.23565729993629,0.1276696989228152,0.3958267415456902,0.268157042622875,546066457,554653991.6,79.70131011913949,69.57143117794097,NaN,NaN,19.509397932785692,10.421484712288692
2017-05-09T09:30:00-04:00,75.54,75.73,75.45,75.59,3830157,6147010.8,58.413316092557274,58.853413106982984,NaN,NaN,67.18627090145272,101.16661520301227,0.0944095808839503,0.38616901872781284,0.29175943784386255,549896614,552200549.8,75.13055427832813,71.23476951382175,NaN,NaN,19.153355009535332,11.668894754752497
2017-05-10T09:30:00-04:00,75.47,75.48,75.06,75.37,4314913,6089125.4,55.100177267718806,59.34223841879765,NaN,NaN,37.98729816801981,86.04017397932262,0.0519138758756546,0.3566517826884308,0.3047379068127762,545581701,550502953.6,72.05155737196033,72.59267310310524,NaN,NaN,17.85200470540668,12.552196176274522
2017-05-11T09:30:00-04:00,75.25,75.44,75.03,75.41,6791572,6239594.7,55.593348563977145,60.266727781917595,NaN,NaN,33.140280173021225,66.53253859342576,0.02233144932368919,0.3326522184673877,0.3103207691436985,552373273,549308601.4,69.88166299705892,73.70995960430868,NaN,NaN,16.93476928931086,13.178278049565428
2017-05-12T09:30:00-04:00,75.38,75.485,75.23,75.28,2638025,6037940.6,53.535273387313715,60.34008523529095,NaN,NaN,32.816839821879626,49.69529096522675,-0.008506325520316382,0.299687862243303,0.3081941877636194,549735248,548730658.6,68.8018893761182,74.67695333798476,NaN,NaN,15.580693110652746,13.52148020114933
2017-05-15T09:30:00-04:00,75.32,75.81,75.25,75.77,7320754,6096484.45,59.60541669492035,60.59241932278696,NaN,NaN,56.27380523989886,45.4808988608544,0.0010719779641467642,0.30953416021880287,0.3084621822546561,557056002,550928567.6,70.65866282420257,75.38972473283067,NaN,NaN,16.147394391112645,13.896610799715518
2017-05-16T09:30:00-04:00,75.69,75.76,75.265,75.48,5471675,5994093.9,55.02385856216588,60.22305344642727,NaN,NaN,41.47115173216228,40.337875026996315,-0.014300035173105963,0.29058713828827365,0.3048871734613796,551584327,551266110.2,70.94465896185062,75.78160659941862,NaN,NaN,15.243756350594076,14.08906016412674
2017-05-17T09:30:00-04:00,74.87,75.08,74.49,74.49,11434049,6314640.4,42.90074470057227,58.87987330447498,NaN,NaN,-77.44205238085785,17.252004917220777,-0.08914436907078754,0.19345671212289517,0.2826010811936827,540150278,550179825.6,68.62635223326618,75.72636533757114,NaN,NaN,10.075318634293184,13.515668517007661
2017-05-18T09:30:00-04:00,74.45,75.25,74.45,74.82,10690543,6484291.9,47.085778605172365,57.70270335448769,NaN,NaN,-71.2672144040143,-3.6294939981863337,-0.11289884350498497,0.14147752681245152,0.2543763703174365,550840821,549873335.2,67.95165463634241,75.26329204656615,NaN,NaN,7.317507945445242,12.63021700678446
2017-05-19T09:30:00-04:00,74.95,75.265,74.85,75.03,9209758,6606631.9,49.61651426868471,56.5954691821541,NaN,NaN,-59.772546945226175,-22.147371351607497,-0.11078673535698055,0.11589295112121079,0.22667968647819134,560050579,551936401.4,70.0837488438176,74.66561034760436,NaN,NaN,5.949279667019067,11.675797386817974
2017-05-22T09:30:00-04:00,74.96,75.315,74.8,75.23,4999072,6584084.6,51.97243321128177,55.522922387762165,NaN,NaN,-59.23510228280209,-45.24915285614769,-0.0929583458230687,0.11048175419935546,0.20344010002242416,565049651,553535131.2,71.6573265049984,73.97787005220506,NaN,NaN,5.595440921668179,10.807175034653717
2017-05-23T09:30:00-04:00,75.33,75.635,75.27,75.48,4216096,6348736.95,54.81654256150579,55.095366780392965,NaN,NaN,16.005683016469423,-50.342246599286256,-0.06281113516628628,0.12492618106456632,0.1877373162308526,569265747,557071415.2,74.81314296680341,73.41996757229516,NaN,NaN,6.199329159534311,10.148911338208087
2017-05-24T09:30:00-04:00,75.52,75.73,75.34,75.67,5215731,6297502.75,56.90525336417921,54.485323481164365,NaN,NaN,43.24533807507482,-26.204768508099722,-0.030208993230065456,0.1499760746932708,0.18018506792333625,574481478,563937655.2,79.5697842718381,73.12620270400684,NaN,NaN,7.340124745440489,9.747656110669858
2017-05-25T09:30:00-04:00,75.84,76.18,75.66,76.03,4479364,6173333.15,60.619835470008006,54.18783633778985,NaN,NaN,129.61769759451897,13.972213891606987,0.013140649174621793,0.19661087939161348,0.1834702302169917,578960842,569561659.4,82.4871714042054,73.0256769135664,NaN,NaN,9.483001022136046,9.709848240879314
2017-05-26T09:30:00-04:00,75.97,76.19,75.81,75.89,4507362,6109647.7,58.507760528294234,54.26401809131081,NaN,NaN,116.36129861782375,49.19898300421697,0.029015374666146176,0.21973944854967442,0.19072407388352824,574453480,572442239.6,83.76587262006538,73.31600280648968,NaN,NaN,10.608594963362854,9.838240629805535
2017-05-30T09:30:00-04:00,75.65,75.97,75.65,75.78,4651153,5983103.7,56.83228150661921,54.15108704945809,NaN,NaN,73.83991176240914,75.81398581325922,0.028685573178542118,0.2265810403567059,0.19789546717816378,569802327,573392774.8,84.17644502599009,73.9621378598941,NaN,NaN,11.05241945173613,10.01169474722419
2017-05-31T09:30:00-04:00,75.93,76.25,75.865,76.08,5884380,6015133.7,60.18135906526637,54.514028606425775,NaN,NaN,125.27788675299429,97.6684265605642,0.04431623879469829,0.25329076567153663,0.20897452687683835,575686707,574676966.8,84.73803294840938,74.86831468678331,NaN,NaN,12.42545922408133,10.356518243918067
2017-06-01T09:30:00-04:00,76.21,76.98,76.13,76.92,9149905,6067921.9,67.73054968479508,55.38097154362705,NaN,NaN,212.28019968839988,131.4753988832292,0.10349176345488778,0.33833923119544806,0.23484746774056028,584836612,576747993.6,85.62414342716859,75.99277757464829,NaN,NaN,16.26301444151413,11.20030341500322
2017-06-02T09:30:00-04:00,77.14,77.52,77.07,77.42,4832974,6095803,71.22733844564635,56.6446904763651,NaN,NaN,264.3503944658568,158.42193825749678,0.16492439901301525,0.44100296650682935,0.2760785674938141,589669586,578889742.4,86.49724967272844,77.25673188154903,NaN,NaN,20.738645817553174,12.562923758224642
2017-06-05T09:30:00-04:00,77.42,77.5,77.02,77.2,5558935,6087746.15,67.7486477084027,57.22634983447098,NaN,NaN,199.94803170069204,175.13928487407043,0.17822673367104302,0.4988619845826179,0.32063525091157485,584110651,580821176.6,87.24932707166117,78.44177932779607,NaN,NaN,23.205570429429905,14.083301854111108
2017-06-06T09:30:00-04:00,77.05,77.29,76.88,77.01,4316464,5975644.1,64.80495208740902,57.92499937198835,NaN,NaN,145.07129572227615,189.3855616660438,0.16217291293686775,0.5233513920826596,0.3611784791457918,579794187,582819548.6,87.99441048046548,79.65961872198285,NaN,NaN,24.27737428926302,15.539597916275666
2017-06-07T09:30:00-04:00,77.11,77.295,76.97,77.22,4415681,6004920.3,66.53566429256622,59.61320791427363,NaN,NaN,131.38936248455343,190.60785681235566,0.15371823119091943,0.5533262681344411,0.39960803694352165,584209868,584524180.8,88.6060360904653,81.08673899749706,NaN,NaN,25.694628894125195,16.99031662739703
2017-06-08T09:30:00-04:00,77.17,77.355,76.795,77,6304426,6104395.95,63.03833825416639,60.752676460630354,NaN,NaN,104.92187715178372,169.1361923050324,0.12267780054636229,0.5529552876264745,0.4302774870801122,577905442,583137946.8,84.82161669714004,82.29173628755404,NaN,NaN,25.816325890245494,18.25117509351824
2017-06-09T09:30:00-04:00,77.1,77.755,77,77.52,13418971,6435765.9,67.4001115057164,62.02293340613263,NaN,NaN,120.20215222412274,140.3065438566856,0.12605371441955476,0.5878446301045557,0.4617909156850009,591324413,583468912.2,84.98648946724964,83.35621776065634,NaN,NaN,27.300927849787115,19.543996915842364
2017-06-12T09:30:00-04:00,77.46,77.74,77.05,77.42,7700644,6688896.85,65.79218119871615,63.010058262377946,NaN,NaN,102.46303406585506,120.8095443297182,0.11096990181724736,0.6005032929565601,0.48953339113931277,583623769,583371535.8,84.69499054934641,84.28747947810976,NaN,NaN,28.01226807203246,20.753749938155234
2017-06-13T09:30:00-04:00,77.49,77.68,77.305,77.58,5592460,6602482.15,67.14282698101377,63.890507149485664,NaN,NaN,98.1590376263589,111.42709271053475,0.10144627840530085,0.6163412391459389,0.514894960740638,589216229,585255944.2,85.71602882329326,85.06625703928762,NaN,NaN,28.999637430824222,21.931733865679377
2017-06-14T09:30:00-04:00,77.71,78.17,77.68,77.95,6782257,6668011.25,70.08440365513624,64.83187502741117,NaN,NaN,114.22930903569514,107.99508202076308,0.10907741074816724,0.651241724175847,0.5421643134276798,595998486,587613667.8,86.89411563511776,85.58942356523617,NaN,NaN,30.747872016844628,23.191182172988697
2017-06-15T09:30:00-04:00,77.65,77.93,77.44,77.87,8185992,6505608.4,68.65325722484386,65.4056908670423,NaN,NaN,92.53134060190956,105.51697471078823,0.09809421688689501,0.6647820845362986,0.5666878676494036,587812494,589595078.2,87.80444027385053,85.96922848449653,NaN,NaN,31.765111137696756,24.41602916794699
2017-06-16T09:30:00-04:00,77.66,77.85,77.28,77.69,14165188,6679340.65,65.41644979914898,65.89916867210336,NaN,NaN,76.50196141652516,96.77693654926871,0.06941433820690235,0.6534557904080316,0.5840414522011292,573647306,586059656.8,77.46521227261407,85.51918131682145,NaN,NaN,31.70308802709771,25.457037576397095
2017-06-19T09:30:00-04:00,77.8,78.57,77.76,78.5,8294402,6633572.85,71.84856060446268,66.97176003623503,NaN,NaN,122.48785065053819,100.78189986620535,0.09416724481758776,0.7017505082231139,0.6075832634055262,581941708,585723244.6,76.54161111776381,84.97383603766242,NaN,NaN,33.70289832263285,26.635017683002204
2017-06-20T09:30:00-04:00,78.49,79.195,78.46,78.76,7697165,6768477.5,73.54913941069297,67.92660148947978,NaN,NaN,159.68267334412016,113.0866270097576,0.11579885651790722,0.7523318340529102,0.6365329775350029,589638873,585807773.4,76.61704990614876,84.3937658203581,NaN,NaN,35.89738404571892,27.958212877676022
2017-06-21T09:30:00-04:00,78.92,79.8,78.87,79.76,9481247,7031735.05,78.84289351287136,68.72034033434237,NaN,NaN,201.3237503553089,130.50551527368034,0.18130127841541976,0.8631595755542776,0.6818582971388578,599120120,586432100.2,77.2002512839282,83.79205923869806,NaN,NaN,39.865060346030475,29.659191087440945
2017-06-22T09:30:00-04:00,79.89,81.08,79.86,80.59,12341085,7388002.75,82.0533709344989,69.4936283692604,NaN,NaN,246.59438981139746,161.3181251155779,0.2596051038962299,1.0063646770091452,0.7467595731129153,611461205,591161842.4,81.05520614825745,83.40334184409299,NaN,NaN,44.502154416383966,31.77961442014709
2017-06-23T09:30:00-04:00,80.49,80.64,80.17,80.47,8779612,7603015.15,80.15947526639344,70.38011605197403,NaN,NaN,194.06620072918,184.8309729781089,0.28060931204474504,1.0975212131688465,0.8169119011241015,602681593,596968699.8,84.51655392989434,83.20814376253823,NaN,NaN,47.35716439807889,34.004978702708776
2017-06-26T09:30:00-04:00,80.7,80.7,80.27,80.39,7434432,7749368.65,78.85279261174352,71.38353323228364,NaN,NaN,160.81100575731296,192.49560399946387,0.2665112959975995,1.1500510211211008,0.8835397251235013,595247161,599629790.4,85.79720916203468,83.05120081122173,NaN,NaN,49.146788244557655,36.16809435154433
2017-06-27T09:30:00-04:00,80.39,80.49,79.64,79.66,8428044,7938213.2,67.96546892998938,71.48566213495671,NaN,NaN,109.18555860553293,182.3961810517464,0.18906201253000476,1.1198672407860073,0.9308052282560025,586819117,599065839.2,84.20762844275052,82.73702883638497,NaN,NaN,46.98894529151963,37.71393020011223
2017-06-28T09:30:00-04:00,79.92,80.28,79.88,80.08,8674235,8077705.95,70.49001959438617,72.01792508782957,NaN,NaN,102.48707357232422,162.62884569514944,0.14892480419997822,1.1169612335059753,0.9680364293059971,595493352,598340485.6,82.10070270429928,82.54267783689633,NaN,NaN,46.05772024406104,38.90590020639063
2017-06-29T09:30:00-04:00,79.99,80.06,78.865,79.35,8445842,8042502.8,61.42863001384738,71.5913906955532,NaN,NaN,56.61130015188007,124.632227763246,0.06054839735193096,1.0437219259959107,0.9831735286439798,587047510,593457746.6,69.49542469965694,81.43617321063971,NaN,NaN,42.054874374628945,39.35575365899611
2017-06-30T09:30:00-04:00,79.66,79.66,79.24,79.24,7817416,8191724.9,60.173391744424045,71.19004859167521,NaN,NaN,48.05267413875974,95.42952244516194,-0.014001617774879627,0.9656715064253802,0.9796731242002599,579230094,588767446.8,59.97043472026824,79.67013350856269,NaN,NaN,38.535892113554674,39.2386305810759
2017-07-03T09:30:00-04:00,79.51,79.75,79.37,79.38,5904203,8208988.3,61.25844832860183,70.76973583078863,NaN,NaN,49.20205637989969,73.10773256967927,-0.059991154977955596,0.9046841804778154,0.964675335455771,585134297,586744874,56.38175153349884,77.57482798786309,NaN,NaN,36.06077122774308,38.78465067345693
2017-07-05T09:30:00-04:00,79.49,79.95,79.21,79.85,8955511,8440940.65,64.73229590131123,70.38744241980113,NaN,NaN,53.50197260371496,61.97101536931566,-0.06447212935557167,0.8840851737613065,0.9485573031168781,594089808,588199012.2,58.31319813378662,75.53333388062514,NaN,NaN,35.03043106214169,38.24833358612618
2017-07-06T09:30:00-04:00,79.51,79.66,78.71,78.82,6421711,8541242.15,53.42621250328719,69.29979636826137,NaN,NaN,11.722690221101345,43.8181386990711,-0.138280991329651,0.7757060639548143,0.9139870552844653,587668097,586633961.2,55.46642940071231,73.22347596111527,NaN,NaN,30.13903959108554,37.08986301540609
2017-07-07T09:30:00-04:00,79.1,79.31,78.9,79.22,4371418,8444591.75,56.59666822707913,68.66981197025638,NaN,NaN,11.204989665306666,34.736876601756414,-0.16009961802692474,0.7138625327508095,0.8739621507777342,592039515,587632362.2,56.91156063412098,71.7553579869372,NaN,NaN,27.246061476701307,35.683605652733974
2017-07-10T09:30:00-04:00,79.25,79.28,78.87,79.07,3580016,7952644,55.08237919429025,67.4722275838155,NaN,NaN,0.16910173160849523,25.160162120326174,-0.1829228196912981,0.6453086261636116,0.8282314458549097,588459499,589478243.2,59.5265694809893,70.53999787002475,NaN,NaN,24.475620816318777,34.082464961817514
2017-07-11T09:30:00-04:00,79.02,79.19,78.58,78.98,4117501,7773486.85,54.14627873195643,66.08630896390574,NaN,NaN,-20.79241449372731,11.161267945600775,-0.20093326160176628,0.5770648688527018,0.7779981304544681,584341998,589319783.4,59.194450665901634,69.29552649572138,NaN,NaN,21.978861613712724,32.353378769231114
2017-07-12T09:30:00-04:00,79.37,79.78,79.35,79.52,8808227,7934275.2,58.68330484328038,64.64633834464924,NaN,NaN,30.151590871238778,6.491191599105543,-0.17431992605842572,0.560098222881436,0.7344181489398617,593150225,589131866.8,58.775646717571576,67.97948331241018,NaN,NaN,21.21189450790648,30.76173816047045
2017-07-13T09:30:00-04:00,79.59,79.84,79.05,79.59,9437737,8067049.2,59.24623356491071,63.01725710396436,NaN,NaN,18.620728103928382,7.870799175670946,-0.15072937796040453,0.546006426489356,0.6967358044497606,602587962,592115839.8,63.22499991032528,66.70589715255788,NaN,NaN,20.76197030722561,29.333199895721187
2017-07-14T09:30:00-04:00,79.76,80.3,79.6,80.13,5749986,7945248.9,63.390108818595024,61.8194452148359,NaN,NaN,72.23119045358892,20.076039333327394,-0.09993226524873233,0.5718204728888452,0.6717527381375775,608337948,595375526.4,67.36831677911218,65.48102307035916,NaN,NaN,21.635079017401047,28.23346834167545
2017-07-17T09:30:00-04:00,80.23,80.285,79.82,79.84,5743659,7524172.45,59.86937978675065,60.463487155907835,NaN,NaN,61.4225961654871,32.32673822010312,-0.08748636862450787,0.5623947773569427,0.6498811459814505,602594289,598202484.4,70.47510739501169,64.38658722985751,NaN,NaN,21.309994332051637,27.244400626014905
2017-07-18T09:30:00-04:00,79.74,79.98,79.36,79.9,8042690,7511586.85,60.359929982044626,59.92023437391178,NaN,NaN,18.583277745223842,40.20187666789335,-0.0771951242573301,0.553387240659788,0.630582364917118,610636979,603461480.6,75.20457494558133,63.74351198005972,NaN,NaN,21.186873207084844,26.37903956616775
2017-07-19T09:30:00-04:00,80.24,80.55,80.24,80.55,8177869,7535622.05,65.30748024624327,59.55005299190158,NaN,NaN,117.4271254790559,57.65698358945677,-0.030965493261954302,0.5918754983396752,0.6228409916016295,618814848,608594405.2,78.77780469833259,63.50616212249067,NaN,NaN,22.58645411888353,25.837241645127147
2017-07-20T09:30:00-04:00,80.74,81.21,80.61,81.08,8276829,7475401.15,68.73415702043535,60.071876349515,NaN,NaN,166.78461901393084,87.28976177145725,0.02777864554681586,0.6575642985351493,0.6297856529883334,627091677,613495148.2,81.51656374372028,64.36481491135235,NaN,NaN,24.887289965137498,25.701534262271483
2017-07-21T09:30:00-04:00,80.91,81.11,80.845,80.99,4796849,7098189.35,67.5146435576039,60.596251479027856,NaN,NaN,156.9265339661084,104.22883047396117,0.05165690586107863,0.6943567853146817,0.6426998794536031,622294828,616286524.2,82.87238230114428,66.00066830998635,NaN,NaN,26.38227819426959,25.79878339541407
2017-07-24T09:30:00-04:00,80.92,81.04,80.6148,80.96,4476835,6883050.5,67.08735810527925,61.012602177361956,NaN,NaN,132.6442655715359,118.47316435517091,0.056141494428151306,0.7128767474887923,0.656735253060641,617817993,619331265,84.2311221685702,67.98990906963431,NaN,NaN,27.476668847180257,26.038481317094952
2017-07-25T09:30:00-04:00,81.15,81.21,80.26,80.38,8485963,6935627.05,59.276573827611735,60.622907743526284,NaN,NaN,97.3280567760028,134.2221201613267,0.013007742797052857,0.672994931556957,0.6599871887599041,609332030,619070275.2,83.61877033082443,69.7974499408513,NaN,NaN,26.148886255760257,26.054253451189997
2017-07-26T09:30:00-04:00,80.2,80.28,79.89,80.11,4964146,6762432.15,56.00752939782861,60.807287521707806,NaN,NaN,30.01431479826705,116.73955802516893,-0.03795729090761979,0.6125405751253794,0.6504978660329992,604367884,616180882.4,76.94916570812546,71.33193110566651,NaN,NaN,24.058727108010515,25.769178259307214
2017-07-27T09:30:00-04:00,80.19,80.19,79.231,79.56,12536833,6955562.05,49.96290872231518,60.33344755708181,NaN,NaN,-21.15215347375564,79.15220352763166,-0.10894158274132304,0.5143208876063454,0.6232624703476685,591831051,609128757.2,63.61276344975897,71.81058844964065,NaN,NaN,20.336523794600396,24.993084764349096
2017-07-28T09:30:00-04:00,79.59,80.06,79.25,79.96,6426095,6854574.7,53.862827791563774,60.24633674260135,NaN,NaN,-11.466501864272816,45.473596361555394,-0.12787736332846833,0.463415766187083,0.5912931295155514,598257146,604321220.8,56.432339650742094,71.58957203319441,NaN,NaN,18.352888037508976,24.044485231943366
2017-07-31T09:30:00-04:00,80.06,80.225,79.88,79.89,5516781,6739542.95,53.08310082366916,60.17039546343798,NaN,NaN,15.941720475899382,22.13308734242809,-0.14290034412156483,0.4126676993635954,0.5555680434851602,592740365,599305695.2,50.08110353101636,70.9386186664169,NaN,NaN,16.520460002016097,22.9696244848109
2017-08-01T09:30:00-04:00,80.18,80.18,79.61,79.71,8678807,6878273.15,51.037132890819414,59.62424032397649,NaN,NaN,-8.171275421257112,1.0332209029761192,-0.1613775725597355,0.3538460777854908,0.5152236503452263,584061558,594251600.8,44.630176278058755,69.92822792073741,NaN,NaN,14.396496368755612,21.744891896803
2017-08-02T09:30:00-04:00,79.7,79.7,79.25,79.53,7718482,6816421.7,49.003132352262774,58.89259023735877,NaN,NaN,-52.170684050073774,-15.403778866692045,-0.18068343752384453,0.2893693534404207,0.4700527909642652,576343076,588646639.2,39.4960752194191,68.23330472852983,NaN,NaN,12.02710505832489,20.35663663416327
2017-08-03T09:30:00-04:00,79.57,79.82,79.31,79.66,8003584,6895515.35,50.53635916360763,57.974465262002525,NaN,NaN,-44.06858264736052,-19.987064701413022,-0.17930134058012015,0.245926115239115,0.42522745581923516,584346660,587149761,38.23118713946966,66.15208118284109,NaN,NaN,10.450373647088,18.941456207438232
2017-08-04T09:30:00-04:00,80.03,80.03,79.38,79.48,3930128,6873450.85,48.36798255834155,57.15293688854473,NaN,NaN,-44.87206760983215,-26.668177850524888,-0.18439969346993257,0.19472783898181945,0.379127532451752,580416532,583581638.2,35.32688672528025,63.641493992145975,NaN,NaN,8.506242694562104,17.4507114198845
2017-08-07T09:30:00-04:00,79.4,79.66,79.335,79.65,4583270,6923613.55,50.527018852890954,56.45058609360518,NaN,NaN,-63.31662649685989,-42.51984724507675,-0.17053613614730628,0.16595736226761915,0.33649349841492543,584999802,582033525.6,34.11593059155136,60.706590824000976,NaN,NaN,7.416526530494854,16.01725643568598
2017-08-08T09:30:00-04:00,79.55,79.69,79.12,79.28,4423268,6938901.9,46.01682711614372,55.07268229859807,NaN,NaN,-99.86643505363088,-60.85887917155149,-0.17958722355141477,0.112009468975657,0.29159669252707177,580576534,581336520.8,33.558180868976905,57.47661769333273,NaN,NaN,5.177844170736996,14.468768969264696
2017-08-09T09:30:00-04:00,79.09,79.45,78.95,79.37,4886488,6742814.95,47.250264438008436,53.538118542710436,NaN,NaN,-111.17238710678801,-72.65921978289434,-0.17276085241650732,0.07564562700643762,0.24840647942294494,585463022,583160510,36.48457312551493,54.26004693488948,NaN,NaN,3.6318477143503705,12.920637361419793
2017-08-10T09:30:00-04:00,79.13,79.2,78.37,78.38,7054677,6623661.95,37.18538951712627,51.37174325410489,NaN,NaN,-183.17472562385757,-100.4804483781937,-0.22486996751623983,-0.03268097997235486,0.19218898754388497,578408345,581972847,35.39150872828891,50.868555965399814,NaN,NaN,-1.1296480642685696,10.913453729178599
2017-08-11T09:30:00-04:00,78.42,78.99,78.42,78.6,8318560,6752090.65,40.232187566185694,49.45351678702678,NaN,NaN,-155.55605017539443,-122.61724489130616,-0.2334551603361421,-0.09962996287629267,0.13382519745984944,586726905,583234921.6,37.533225530547845,47.532991919826785,NaN,NaN,-4.108015159076855,8.767529602284963
2017-08-14T09:30:00-04:00,78.94,79.255,78.94,79.13,3955758,6662695.6,46.912723652972424,48.5703846316954,NaN,NaN,-88.93756413291622,-127.7414324185174,-0.19399478455854383,-0.10866828323833033,0.0853265013202135,590682663,584371493.8,39.4789250152083,44.38014582585421,NaN,NaN,-4.567651418949391,6.862503742108626
2017-08-15T09:30:00-04:00,79.23,79.39,79.11,79.13,4653777,6493249.95,46.91272365297243,47.92075564991996,NaN,NaN,-69.91646128990432,-121.7514376657721,-0.1598701637530691,-0.11451120337112286,0.04535896038194622,590682663,586392719.6,42.88592637518267,41.94705730207259,NaN,NaN,-4.9300549525799475,5.177852500010259
2017-08-16T09:30:00-04:00,79.26,79.5,79.165,79.35,3756895,6272201.25,49.62346703862284,47.89650981537051,NaN,NaN,-49.9093509596211,-109.49883043633872,-0.11647449732274674,-0.10023416127148721,0.016240336051259532,594439558,588188026.8,45.80428874377189,40.67502339450208,NaN,NaN,-4.426441450524924,3.805810507076661
2017-08-17T09:30:00-04:00,79.1,79.44,78.33,78.36,7133350,6215027.3,39.779784745666745,46.89057816923501,NaN,NaN,-124.53869316635081,-97.77162394483737,-0.14649669592660503,-0.16688053385699675,-0.020383837930391724,587306208,589967599.4,48.60750989597822,40.116106983447516,NaN,NaN,-7.229809848605745,2.2292933134077457
2017-08-18T09:30:00-04:00,78.07,78.53,77.95,78,8434552,6396912.45,36.912346166293084,45.735524265136725,NaN,NaN,-181.6651749119565,-102.99344889214976,-0.18042295292496308,-0.24591252908659555,-0.06548957616163249,578871656,588396549.6,46.32923314785938,39.84811624179344,NaN,NaN,-10.490877635843214,0.4121260349433229
2017-08-21T09:30:00-04:00,77.93,78.45,77.82,78.35,10268993,6686520.35,41.33952909620315,45.042838279806986,NaN,NaN,-158.26407933014517,-116.85875193159555,-0.1692959659224066,-0.27710953356464074,-0.10781356764223415,589140649,588088146.8,45.874675308611025,39.93700902969004,NaN,NaN,-11.730610219227623,-1.3225505727953837
2017-08-22T09:30:00-04:00,78.37,79.39,78.32,79.3,5455500,6534997.2,51.324251085580585,45.20863247504398,NaN,NaN,-39.51071401089164,-110.77760247579302,-0.09183731540961562,-0.22261021190425367,-0.13077289649463805,594596149,588870844,47.28819568605365,40.493589063021076,NaN,NaN,-9.279489483242678,-2.4592561314307115
2017-08-23T09:30:00-04:00,79.03,79.045,78.665,78.7,5662539,6569916.85,45.99887843930613,44.88452670902244,NaN,NaN,-61.65995407445115,-113.12772309875902,-0.0755718368194912,-0.22523769251900205,-0.14966585569951085,588933610,587769654.4,45.48827235677184,41.01195229282837,NaN,NaN,-9.140099142555062,-3.4136622758770474
2017-08-24T09:30:00-04:00,78.78,79.04,78.63,78.93,5502816,6218216,48.2169535476961,44.873738922547766,NaN,NaN,-45.897024903226026,-97.39938944613407,-0.045372811675485375,-0.20638187029386756,-0.1610090586183822,594436426,589195698,48.23606485195932,41.93403644473402,NaN,NaN,-8.27236415731135,-4.107762544653376
2017-08-25T09:30:00-04:00,79.1,79.4,78.89,78.95,5476522,6170737.35,48.41537134304132,44.72290695755851,NaN,NaN,-7.712581495339416,-62.608870762810646,-0.021321887874666545,-0.18766141846171536,-0.1663395305870488,599912948,593403956.4,55.383408366353116,43.453142000077,NaN,NaN,-7.537185297862855,-4.597680080826159
2017-08-28T09:30:00-04:00,79.17,79.5,79.15,79.37,7432771,6266536.85,52.52900258651467,45.18806234829928,NaN,NaN,44.54078138290122,-22.0478986202014,0.023190398367373216,-0.13735153262783228,-0.1605419309952055,607345719,597044970.4,60.469190088874015,45.37535694435537,NaN,NaN,-5.603909091064012,-4.741427082288709
2017-08-29T09:30:00-04:00,79.04,79.6,78.97,79.52,4243532,6044773.1,53.94166987749065,45.66601987969087,NaN,NaN,56.059737613055226,-2.933808295412021,0.06091043774763197,-0.08440388381066555,-0.14531432155829752,611589251,600443590.8,64.53314600085862,47.37882643545135,NaN,NaN,-3.6028196437992035,-4.578768876790209
2017-08-30T09:30:00-04:00,79.43,80.13,79.41,79.93,3667897,5842243.85,57.651286550762585,47.12786966780776,NaN,NaN,135.4221701544538,36.48261655036897,0.10884964697294938,-0.009252262842110781,-0.11810190981506016,615257148,605708298.4,69.72531875489793,49.83124143735199,NaN,NaN,-0.7362817162780844,-4.029842139574191
2017-08-31T09:30:00-04:00,80.13,81.37,80.13,81.29,6987189,5791424.1,67.11325460967366,49.04794588519975,NaN,NaN,277.26415707692604,101.11485294639938,0.22105967157886552,0.15822267965852177,-0.06283699192034377,622244337,611269880.6,74.0475979422122,52.439410895328024,NaN,NaN,5.474709005438827,-2.6720491188580455
2017-09-01T09:30:00-04:00,81.41,81.58,80.9153,81.23,6471618,5918498.6,66.4083008190297,50.440487111346705,NaN,NaN,262.39035055483765,155.1354393564348,0.2765462408962277,0.28284580919994085,0.006299568303713157,615772719,614441834.8,76.13987495041664,55.05805017641433,NaN,NaN,9.999516180551291,-0.8618255046567116
2017-09-05T09:30:00-04:00,80.89,81.37,80.505,80.88,8076875,6093178.85,62.297517654862965,51.5394009686246,NaN,NaN,182.5843341893129,182.74414991771712,0.2744335223741733,0.3493414712714298,0.0749079488972565,607695844,614511859.8,76.18551999314677,57.43659257769748,NaN,NaN,12.39661846851246,1.0322379200817413
2017-09-06T09:30:00-04:00,81.16,81.35,80.795,81.27,8790950,6311562.95,64.90448206983596,52.63090204228268,NaN,NaN,164.141908126779,204.36058402046189,0.2829290200294216,0.4285692239340335,0.1456402039046119,616486794,615491368.4,76.85257762626598,59.654327497875634,NaN,NaN,15.22916782627563,3.0603707638237254
2017-09-07T09:30:00-04:00,81.26,82.35,81.24,82.17,7250995,6429788.3,70.05096540804033,54.793129232452216,NaN,NaN,180.94841055708306,213.46583210098774,0.3295303501237702,0.5575531415593247,0.22802279143555448,623737789,617187496.6,78.00165021130363,61.753908948970306,NaN,NaN,19.527673099528133,5.412842526067212
2017-09-08T09:30:00-04:00,82.05,82.68,81.9108,82.54,4302627,6292185.8,71.87682415133233,57.290591945669306,NaN,NaN,171.33044184252856,192.27908905410823,0.36299833088128974,0.6817707050371666,0.3187723741558769,628040416,618346712.4,78.77707618211159,64.07161202284547,NaN,NaN,23.624297104374957,8.01447889439689
2017-09-11T09:30:00-04:00,82.91,83.2,82.73,83.18,6286176,6190566.6,74.74493404950302,59.676692299476436,NaN,NaN,171.7926781109573,174.15955456533214,0.4028835584628781,0.8223768222344745,0.4194932637715964,634326592,622057487,81.07658330165702,66.58603402234876,NaN,NaN,28.072183127339457,10.879865213388685
2017-09-12T09:30:00-04:00,83.2,83.37,83.035,83.36,6984789,6342018.15,75.50167127472058,61.40365088441501,NaN,NaN,151.45922454299344,167.9345326360683,0.4144257640131992,0.9375254687880954,0.5230997047748962,641311381,628780594.4,84.37897904368239,69.23537569075081,NaN,NaN,31.844554691412974,13.87482085310644
2017-09-13T09:30:00-04:00,83.26,83.41,82.8917,83.05,5873781,6403018.35,71.52665961615284,63.227063825618345,NaN,NaN,124.21697494208645,159.94954599912978,0.3753828355458241,0.9923282492071763,0.6169454136613522,635437600,632570755.6,85.87547556896855,72.12017592019343,NaN,NaN,33.708841125659134,16.70825232061397
2017-09-14T09:30:00-04:00,82.82,83.29,82.7165,83.16,6373776,6533862.4,72.08820553438248,64.9321532532388,NaN,NaN,106.98406978063659,145.15667784384047,0.33262866528774804,1.0327312452710373,0.7001025799832893,641811376,636185473,87.14074617310504,74.8990817288467,NaN,NaN,35.3806730787273,19.375741000344444
2017-09-15T09:30:00-04:00,83.06,83.06,82.5,82.59,7091336,6531761.7,64.9410532347742,66.1125591026483,NaN,NaN,84.28125475743981,127.74684042682273,0.24563546541875625,1.0071469117567347,0.7615114463379784,634720040,637521397.8,87.58343975925939,77.19908397119714,NaN,NaN,34.65076198278972,21.557886854979483
2017-09-18T09:30:00-04:00,82.68,82.9,82.44,82.57,7783052,6499186.7,64.69866920989992,66.98182100431868,NaN,NaN,74.94215067240364,108.376734939112,0.17001428831571153,0.9740293067326178,0.8040150184169063,626936988,636043477,84.13274646394822,78.88933799798815,NaN,NaN,33.99466356560674,23.33456924221195
2017-09-19T09:30:00-04:00,82.61,82.71,81.83,81.92,7329150,6352194.55,57.223407155513435,67.21623080989174,NaN,NaN,47.89425460456871,87.66374095142706,0.06489243667294786,0.8851305642580911,0.8202381275851433,619607838,631702768.4,74.81010885074639,79.62340677298013,NaN,NaN,31.116460605304795,24.44626800836807
2017-09-20T09:30:00-04:00,81.95,82.089,81.41,82,5101780,6334508.55,57.868612783362245,67.23175411222029,NaN,NaN,27.708280850310057,68.36200213307175,-0.006770213482207854,0.8117753607323834,0.8185455742145913,624709618,629557172,70.6431802224671,79.68896830637793,NaN,NaN,28.962110647839012,25.091388385435348
2017-09-21T09:30:00-04:00,81.95,82.04,81.54,81.58,4527869,6277775.05,53.32147515303505,66.24662700817467,NaN,NaN,16.14605246705107,50.19439867035466,-0.08559801104218712,0.7115480604118574,0.7971460714540445,620181749,625231246.6,63.02135181443407,78.90137929725093,NaN,NaN,25.73698494602062,25.18361646551896
2017-09-22T09:30:00-04:00,81.47,81.69,81.155,81.58,6473284,6326298.45,53.32147515303505,65.31185374631791,NaN,NaN,-5.081833217350816,32.32178107539653,-0.13778598679338672,0.6249135879623111,0.7626995747556978,620181749,622323588.4,58.45607040465165,77.63825040112485,NaN,NaN,23.120695706440227,24.888913499936283
2017-09-25T09:30:00-04:00,81.47,81.84,81.215,81.34,12439330,6674438.85,50.682216549381366,64.48218938164065,NaN,NaN,-14.971183109094767,14.339114319096845,-0.1855430555896398,0.530770755268648,0.7163138108582878,607742419,618484674.6,52.99743166786953,75.98195837789076,NaN,NaN,20.13386264712298,24.209620520962954
2017-09-26T09:30:00-04:00,81.57,81.7962,81.18,81.21,4579765,6531788.55,49.259919586363885,63.36472063282122,NaN,NaN,-30.720663840528946,-1.3838693699226803,-0.22057658011121306,0.44059308571927147,0.6611696658304845,603162654,615195637.8,48.793445508459584,73.97773465519029,NaN,NaN,17.21853084820795,23.210893424855097
2017-09-27T09:30:00-04:00,81.42,81.42,80.835,81.18,5384691,6588846.5,48.91874819747761,61.85527654635246,NaN,NaN,-64.58873549631625,-19.843272639247935,-0.23891421330596319,0.3625268991980306,0.6014411125039938,597777963,609809306.8,42.80505029661729,71.46369180414128,NaN,NaN,14.68768526464768,21.99329225911118
2017-09-28T09:30:00-04:00,81.11,81.52,80.99,81.25,4229024,6616902.85,49.79254130216401,60.27782777141186,NaN,NaN,-66.89605056524519,-36.45169324570718,-0.23889959603538014,0.3028166174597686,0.5417162134951488,602006987,606174354.4,39.29972110440953,68.64388072716255,NaN,NaN,12.745846925363056,20.672228640004306
2017-09-29T09:30:00-04:00,81.26,81.77,81.06,81.73,6902730,6612679.9,55.42348373004422,58.8977241771648,NaN,NaN,-45.32772282895494,-44.50087116802801,-0.20067316730776313,0.29087475436044485,0.491547921668208,608909717,603919948,37.261673526698004,65.51424431466549,NaN,NaN,12.448771558114847,19.49744905687724
2017-10-02T09:30:00-04:00,81.97,82.57,81.88,82.56,8764865,6727342.25,63.12485590892717,58.013665936750975,NaN,NaN,32.25842437648474,-35.05494967091211,-0.11770665092828436,0.3444146080078525,0.46212125893613687,617674582,605906380.6,40.20420943082704,62.358903628032955,NaN,NaN,14.511973707256184,18.785238292645662
2017-10-03T09:30:00-04:00,82.68,82.7963,82.215,82.54,5141700,6580583.5,62.84311088831906,57.39341245619143,NaN,NaN,44.71842370957316,-19.967132160891687,-0.06502389323036412,0.3808413923981817,0.4458652856285458,612532882,607780426.2,42.92398750745037,59.29094019506737,NaN,NaN,16.09518188824877,18.400944520588965
2017-10-04T09:30:00-04:00,82.66,82.97,82.58,82.94,3291140,6305593,66.10182900237123,56.96581413247634,NaN,NaN,71.35137838206589,7.2208906147847385,-0.007132504583719668,0.43694965489889626,0.4440821594826159,615824022,611389638,47.84418453734649,56.48404293537033,NaN,NaN,18.459658386359344,18.40933221569902
2017-10-05T09:30:00-04:00,82.94,83.01,82.62,83,7709648,6328525.65,66.5753618445672,57.08255046174727,NaN,NaN,69.34258033309118,34.46861679445201,0.029307041502491027,0.4807159613607297,0.45140891985823867,623533670,615694974.6,53.04412352052246,54.0169489183177,NaN,NaN,20.535826671639896,18.713117137976287
2017-10-06T09:30:00-04:00,82.85,83.21,82.76,82.89,4035940,6315191.3,64.78847234416523,57.088964971337646,NaN,NaN,71.50912753528515,57.83598686730003,0.039474967518935644,0.5007526292569082,0.4612776617379726,619497730,617812577.2,55.39948421012228,51.96457304304442,NaN,NaN,21.793302343622965,19.153143595925812
2017-10-09T09:30:00-04:00,82.88,82.9,82.24,82.37,4558776,6228821.3,56.999967232541515,57.07300497683965,NaN,NaN,28.62705350300751,57.10971269260458,0.006388117956846351,0.4692628091840305,0.46287469122718417,614938954,617265451.6,54.63691217341504,50.52363042323504,NaN,NaN,20.674182729268686,19.37043490068908
2017-10-10T09:30:00-04:00,82.4,82.56,82.11,82.56,4037741,6081468.9,58.94213897265604,57.149685418932066,NaN,NaN,24.632817253381887,53.09259140136633,-0.006779538128602547,0.454400268566431,0.46117980669503356,618976695,618554214.2,56.16744453692052,49.489649302838856,NaN,NaN,20.28570209424792,19.50118735691177
2017-10-11T09:30:00-04:00,82.51,82.81,82.49,82.72,4031596,5989359.65,60.55773135188603,57.66656086170713,NaN,NaN,59.49589567191474,50.7214948593361,-0.00867103732705743,0.45034101003621174,0.45901204736326917,623008291,619991068,57.87397758386601,49.12197971494113,NaN,NaN,20.413550091798385,19.631524890467002
2017-10-12T09:30:00-04:00,82.69,82.82,82.53,82.63,4732044,5907273.05,59.14785290999756,58.08273070149017,NaN,NaN,62.24027921409877,49.30103463553762,-0.01933035723703458,0.4348491008169759,0.4541794580540105,618276247,618939583.4,56.15111239864494,48.95733985736923,NaN,NaN,20.133538134929815,19.703241068247404
2017-10-13T09:30:00-04:00,82.36,82.53,82.22,82.42,5909628,5848187.65,55.878809508765215,58.453915912874734,NaN,NaN,31.826064683018803,41.364422065084355,-0.04254046000856693,0.4010038830433018,0.44354434305186874,612366619,617513361.2,53.811148361635524,49.01546247835252,NaN,NaN,18.988959686420706,19.60120087084359
2017-10-16T09:30:00-04:00,82.36,82.68,81.91,82.06,10219710,5970020.55,50.705108704219064,58.55714370700724,NaN,NaN,13.050445386980952,38.24910044187904,-0.08187612964773044,0.3411991809922057,0.42307531063993614,602146909,614954952.2,49.801889446632515,49.08749418822202,NaN,NaN,16.47840534682602,19.155087224555366
2017-10-17T09:30:00-04:00,82.23,83.38,82.23,83.16,8437761,6025451.1,62.21656910336421,59.50698805742771,NaN,NaN,94.31224074029323,52.184985139261315,-0.035896549958686075,0.37820462319157855,0.4141011731502646,610584670,613276547.2,47.31148492470327,49.40938237594245,NaN,NaN,17.81480861899774,18.96361885233285
2017-10-18T09:30:00-04:00,83.37,83.73,83.18,83.28,6938689,6117296.55,63.225470854024096,60.46648302541772,NaN,NaN,136.72173330670688,67.63015266621974,-0.001312845409535357,0.41246011638834545,0.4137729617978808,617523359,612179560.8,45.702853476437575,49.866748973944446,NaN,NaN,19.198589745363577,18.99718612276581
2017-10-19T09:30:00-04:00,83.18,83.8147,83.06,83.79,6410394,6211422.8,67.23037864328353,61.30983266207766,NaN,NaN,141.3166434224166,83.4454255078833,0.04920709156651337,0.47528182625602255,0.4260747346895092,623933753,613311062,47.678935668804655,50.610839126952065,NaN,NaN,21.727505708071796,19.38723177780952
2017-10-20T09:30:00-04:00,83.82,83.95,83.59,83.88,6343777,6204947.45,67.89485128281422,61.6505466173553,NaN,NaN,155.8487564392619,108.24996385913191,0.0801516399964256,0.5262642846850412,0.44611264468861556,630277530,616893244.2,53.454365227222254,51.55727882669458,NaN,NaN,23.94578954297497,20.0384543156903
2017-10-23T09:30:00-04:00,83.99,84.305,83.63,83.67,7159559,5940958.9,64.60314692702735,61.77626347726304,NaN,NaN,146.96649347339715,135.03317347641516,0.07787656881591482,0.5434583557085091,0.4655817868925943,623117971,621087456.6,59.14131667331226,52.71565948139901,NaN,NaN,24.780286267807487,20.715858880278468
2017-10-24T09:30:00-04:00,83.68,83.69,82.63,83.11,7145502,6069245.75,56.707656737331114,61.105251172617315,NaN,NaN,59.40558369231121,128.05184206681875,0.03238566783592611,0.5060638716875019,0.4736782038515758,615972469,622165016.4,60.477364796303384,53.61802949989593,NaN,NaN,22.987632933203354,21.04039803069631
2017-10-25T09:30:00-04:00,83.03,83.225,82.67,82.99,6819089,6140965.65,55.15217132656656,60.289308992760134,NaN,NaN,30.084668207742258,106.72442904702582,-0.009801411241300184,0.46142643979995057,0.47122785104125076,609153380,620491020.6,57.34049263445214,53.92491300803376,NaN,NaN,21.06085766986864,21.043320836292356
2017-10-26T09:30:00-04:00,82.4,82.635,81.66,82.16,13466887,6602858.8,45.79537118011469,58.932658909613664,NaN,NaN,-94.45049561579071,59.57100123938436,-0.0929944042711569,0.3549848457023046,0.4479792499734615,595686493,614841568.6,48.245586987249006,53.41392034925709,NaN,NaN,16.09670244664003,20.336661066342025
2017-10-27T09:30:00-04:00,81.87,82.23,81.83,82.14,6121961,6563820.35,45.59463987205061,58.1179926695786,NaN,NaN,-118.45806646428535,4.70963665867491,-0.14562373483496804,0.26594958142975145,0.4115733162647195,589564532,606698969,38.71433376453141,52.27659332005112,NaN,NaN,12.168975545325612,19.169848849053967
2017-10-30T09:30:00-04:00,81.8,81.92,81.08,81.26,5884007,6419777.45,37.753366795814784,56.60450894266137,NaN,NaN,-192.87399468927413,-63.25846097385936,-0.23088872234243174,0.12296241333667979,0.35385113567911153,583680525,598811479.8,32.09909425651395,50.55742544287922,NaN,NaN,5.817615780896941,17.26238698217439
2017-10-31T09:30:00-04:00,81.21,81.46,80.97,81.11,6548619,6490123.4,36.597990896981734,54.893098910168206,NaN,NaN,-190.33418207289733,-113.20641412690107,-0.2850262391364967,-0.002431663241509341,0.2825945758949874,577131906,591043367.2,27.17424744348513,48.364587575709166,NaN,NaN,0.424846702754212,14.857024085114366
2017-11-01T09:30:00-04:00,81.25,81.65,81.09,81.31,7427810,6696956.9,39.26679817848946,53.47302357220334,NaN,NaN,-143.14361025051076,-147.85206981855168,-0.2938298674483101,-0.08469275841540025,0.20913710903290983,584559716,586124634.4,24.600498087331502,46.1109722677582,NaN,NaN,-3.1181956487292455,12.289135551708135
2017-11-02T09:30:00-04:00,81.46,81.48,80.755,80.94,10200322,6821490.6,36.22856089777878,52.069434385704305,NaN,NaN,-149.15645017729068,-158.79326073085167,-0.3094639626518876,-0.17769284428194965,0.13177111836993793,574359394,581859214.6,22.601386483581038,43.881703562182885,NaN,NaN,-7.078973999037723,9.522262758744441
2017-11-03T09:30:00-04:00,80.85,81.655,80.85,81.61,6862733,6962830.25,44.58934893367747,51.63259440209419,NaN,NaN,-104.1238987229394,-155.92642718258247,-0.2614839957310192,-0.19508387629383606,0.06640011943718313,581222127,580190733.6,21.853295790211746,41.88537544386711,NaN,NaN,-7.821606191306269,7.044567194451483
2017-11-06T09:30:00-05:00,81.48,81.57,81.3,81.36,4853232,6977553.05,42.35781041710338,50.21411163878985,NaN,NaN,-89.35002190919741,-135.22163262656713,-0.23426343202206082,-0.22642917059039291,0.007834261431667912,576368895,578728407.6,21.1912568936649,40.01964487022151,NaN,NaN,-9.13821045130761,4.732741816485898
2017-11-07T09:30:00-05:00,81.5,81.65,81.2442,81.53,4439915,6997661.75,44.395675469439766,48.869126254176685,NaN,NaN,-74.76608093885939,-112.10801239975953,-0.19414405444771293,-0.23484580662797327,-0.04070175218026033,580808810,579463788.4,22.463371511513344,38.359681872726924,NaN,NaN,-9.572668141944076,2.6891118224244734
2017-11-08T09:30:00-05:00,81.44,81.81,81.34,81.72,6186215,7105392.7,46.66520052474888,47.400184959995634,NaN,NaN,-56.55974937590472,-94.79124022483833,-0.14632422745293733,-0.223607036496432,-0.07728280904349466,586995025,579950850.2,23.345930061557,36.62161004363781,NaN,NaN,-9.244758361707083,0.9842732246913939
2017-11-09T09:30:00-05:00,81.52,81.81,81.2299,81.73,7086392,7223110.1,46.78830238311516,45.892574324302856,NaN,NaN,-54.40769926045083,-75.84149004147037,-0.10733837926795861,-0.21145578312844293,-0.10411740386048432,594081417,583895254.8,30.26821492709749,34.965456450771754,NaN,NaN,-8.944885165804461,-0.4341779739508711
2017-11-10T09:30:00-05:00,81.53,81.53,80.6947,81.2,4826328,7168945.1,41.34195314874423,44.23106048299692,NaN,NaN,-82.97070204093036,-71.61085070506856,-0.11015009302414061,-0.24180502014066008,-0.13165492711651947,589255089,585501847.2,32.9251614876554,33.09287393751055,NaN,NaN,-10.291375870219433,-1.842349101989237
2017-11-13T09:30:00-05:00,80.93,81.435,80.7,81.28,4704018,6893160.5,42.43126858580738,43.211318472173794,NaN,NaN,-75.63884351331986,-68.86861502589304,-0.09983248489863447,-0.25644553323981256,-0.1566130483411781,593959107,589019889.6,38.45514497031367,31.519858235654137,NaN,NaN,-11.080870943404552,-3.162137936477139
2017-11-14T09:30:00-05:00,81.01,81.1,80.585,80.95,7430107,6842777.8,39.19760917909134,42.071706890211274,NaN,NaN,-88.04113775180049,-71.52362638848125,-0.10776424197999307,-0.2913183508161694,-0.18355410883617634,586529000,590163927.6,40.182248403286266,30.294269361999433,NaN,NaN,-12.70631093572184,-4.525591222083524
2017-11-15T09:30:00-05:00,80.65,80.97,80.44,80.72,4952318,6743459.25,37.076765411836625,41.44894933533427,NaN,NaN,-95.31182605425525,-79.27404172415136,-0.12009116892355692,-0.3336680699906225,-0.21357690106706556,581576682,589080259,39.06398562697328,29.63844069340831,NaN,NaN,-14.702129952423034,-5.979382469274883
2017-11-16T09:30:00-05:00,80.84,81.66,80.84,81.56,4780484,6661963.75,48.117670986211444,41.62916584348862,NaN,NaN,-39.47190710813212,-76.28688329368762,-0.06596809295768263,-0.29603701726416887,-0.23006892430648623,586357166,587535408.8,37.46335589438054,29.549085131254678,NaN,NaN,-13.036649800008721,-6.987563516522574
2017-11-17T09:30:00-05:00,81.19,81.5,81.11,81.24,6129753,6651262.55,44.88646644926695,42.13867296159235,NaN,NaN,-42.43196630128225,-68.179136145758,-0.04691079899559472,-0.28870742305097963,-0.2417966240553849,580227413,585729873.6,35.62603067789304,29.801009161353182,NaN,NaN,-12.671013021567399,-7.7994848743861205
2017-11-20T09:30:00-05:00,81.23,81.3,80.77,80.9,4898452,6538207.2,41.683600935843955,42.501930821511074,NaN,NaN,-78.66343507258307,-68.78405445761062,-0.05200050677292234,-0.30679725752153786,-0.2547967507486155,575328961,582003844.4,32.12462521566856,30.154607573651994,NaN,NaN,-13.373972509703759,-8.59584025086007
2017-11-21T09:30:00-05:00,81.34,81.795,81.3101,81.61,7974451,6579654.65,49.747499827970266,43.25055236790257,NaN,NaN,26.671365599467062,-45.841553787357114,-0.004831209861227481,-0.2608357630751499,-0.2560045532139224,583303412,581358726.8,31.546524108076056,30.65075228941946,NaN,NaN,-11.282397228899498,-8.979634104865703
2017-11-22T09:30:00-05:00,81.61,81.9152,81.45,81.58,4853077,6481354.05,49.4364362807101,44.19397203811195,NaN,NaN,70.62903434237504,-12.653381708031068,0.025406266356158946,-0.22424672026872372,-0.24965298662488267,578450335,580733457.4,30.964892135888334,31.24814555029855,NaN,NaN,-9.747571517821862,-9.089339449573725
2017-11-24T09:30:00-05:00,81.69,81.8,81.51,81.77,1650633,5890541.35,51.50464805455236,44.6879219753173,NaN,NaN,95.97016817650412,14.43503334889618,0.05742808693755866,-0.17786787795293435,-0.235295964890493,580100968,579482217.8,29.78157171354239,31.814450973393594,NaN,NaN,-7.852643281451686,-8.912668568413434
2017-11-27T09:30:00-05:00,81.77,81.98,81.7,81.84,4241438,5796515.2,52.279101059530596,45.39658559263353,NaN,NaN,145.32199259275544,51.98582512770372,0.08110065336464586,-0.13392014818468567,-0.21502080154933154,584342406,580305216.4,31.632235251352583,32.56023514179986,NaN,NaN,-6.084744463539467,-8.508679410574295
2017-11-28T09:30:00-05:00,82.04,82.51,81.82,82.44,8290415,5916835.6,58.40997060035691,46.397606673413314,NaN,NaN,216.53487267242434,111.02548667670521,0.13193763101993647,-0.05009876277441094,-0.1820363937943474,592632821,583765988.4,38.92209348077657,33.73585813960437,NaN,NaN,-2.569500999544341,-7.660225351855731
2017-11-29T09:30:00-05:00,82.51,83.15,82.51,82.85,8144634,5996636.35,62.002389972866396,47.493120205421704,NaN,NaN,270.86199561160834,159.86361267913347,0.18470970832346364,0.04885074160998215,-0.1358589667134815,600777455,587260797,45.268660483958065,35.30176745549016,NaN,NaN,1.587201865141005,-6.339164320856197
2017-11-30T09:30:00-05:00,83.11,83.72,82.8647,83.47,10639564,6157224.05,66.68823539067031,48.914543991675636,NaN,NaN,273.64776658957794,200.46735912857406,0.2489089877169334,0.17527726793268528,-0.07363171978424812,611417019,593854133.8,54.8091704323709,37.054692848723974,NaN,NaN,6.814376059437471,-4.4600871236713875
2017-12-01T09:30:00-05:00,83.43,83.65,82.17,83.3,15315398,6412977.85,64.34514326938996,50.55762900029318,NaN,NaN,181.89399901311606,217.65212529589644,0.26592191534052967,0.258770674391414,-0.007151240949115706,596101621,597054264.4,58.58283269471317,38.887383649228106,NaN,NaN,10.29801533844299,-2.351786771940762
2017-12-04T09:30:00-05:00,83.78,83.795,82.28,82.28,9769538,6558318.1,52.439907767998015,51.27253179902108,NaN,NaN,122.75784383481542,213.13929554430842,0.19761640196719735,0.23986926150988097,0.04225285954268363,586332083,597452199.8,59.040861805740136,40.3577919946157,NaN,NaN,9.41761333305485,-0.6704438997985318
2017-12-05T09:30:00-05:00,82.33,82.74,82.07,82.14,13230017,6977157.35,51.04392884742607,52.11869748961642,NaN,NaN,60.12250967987668,181.8568229457989,0.13512476695618858,0.21115881823791938,0.07603405128173078,573102066,593546048.8,52.86112184585433,41.26342581194199,NaN,NaN,8.268078860317534,0.6064879230751916
2017-12-06T09:30:00-05:00,82.19,82.46,81.71,82.07,8532978,7181810.5,50.32259770811622,53.06482836792211,NaN,NaN,30.121337497928597,133.70869132306296,0.08371233282935578,0.1806744673184255,0.09696213448906973,564569088,586304375.4,43.723955249981636,41.59628078501402,NaN,NaN,7.13459484182562,1.5390746257538241
2017-12-07T09:30:00-05:00,82.02,82.25,81.77,82.09,3979212,7071460.35,50.5376686847988,53.23768534639264,NaN,NaN,22.90772587893901,83.56068318093517,0.04749204433269824,0.15632718990494254,0.1088351455722443,568548300,577730631.6,35.82786136182912,41.47945974697463,NaN,NaN,6.288788007020953,2.2176051087919855
2017-12-08T09:30:00-05:00,82.33,83.02,82.27,83.01,8444114,7139346.45,59.27247804835804,54.26525760347057,NaN,NaN,90.37980080641762,65.25784353959547,0.08002027923065408,0.2088604946105619,0.1288402153799078,576992414,573908790.2,32.96965181588665,41.28971839968846,NaN,NaN,8.307826471406806,3.087636732022674
2017-12-11T09:30:00-05:00,83.08,83.41,82.95,83.36,6588637,7227461.9,62.02033947536693,55.71788178486508,NaN,NaN,122.439111250521,65.19409702273659,0.11737512210954876,0.27555911801684374,0.15818399590729498,583581051,573358583.8,32.56685442041095,41.3213062000272,NaN,NaN,10.868474681150454,4.1991850104695
2017-12-12T09:30:00-05:00,83.39,83.82,83.39,83.69,6068627,7295692.35,64.45540677542517,56.76844656682614,NaN,NaN,140.7999925784955,81.32959360246033,0.15425311185210727,0.3510003857224291,0.19674727387032181,589649678,576668106.2,37.51214990860806,41.74742232863663,NaN,NaN,13.77156417350563,5.56666774804609
2017-12-13T09:30:00-05:00,83.68,84.215,83.6543,83.98,8459771,7347175.55,66.48878781304111,57.986471676278356,NaN,NaN,149.44206740690004,105.19373958425463,0.18599473352987306,0.42924069078266314,0.24324595725279008,598109449,583376178.4,46.13485867554787,42.83099136718374,NaN,NaN,16.817706025633488,7.173958930558575
2017-12-14T09:30:00-05:00,84.05,84.16,83.045,83.13,6772081,7438163.7,56.31912148788609,58.330362635802196,NaN,NaN,93.67729319912905,119.34765304829264,0.1396769745810209,0.4178421754790662,0.2781652008980453,591337368,587933992,51.07482551090513,44.351938066995366,NaN,NaN,16.18650332217615,8.461465272218229
2017-12-15T09:30:00-05:00,83.11,83.74,83.11,83.71,8012239,7599751.45,60.73262895595429,58.934186056975314,NaN,NaN,90.296578436065,119.33100857422212,0.13780206875791168,0.4504177868454349,0.3126157180875232,599349607,592405430.6,55.39657721213733,46.049391064194275,NaN,NaN,17.143210882661748,9.70171464513873
2017-12-18T09:30:00-05:00,83.98,84.2,83.685,83.74,5655404,7576034,60.952397142007435,59.11578795280749,NaN,NaN,111.50520716232403,117.14422775658272,0.12846757404534348,0.4732001856442025,0.34473261159885904,605005011,596690222.6,59.1228543123138,47.49230255216122,NaN,NaN,17.954917955207634,10.880743689434288
2017-12-19T09:30:00-05:00,83.87,84.159,83.6,83.64,4777141,7569968.45,59.751935185822454,58.955041182304356,NaN,NaN,98.83820489714607,108.75187022031284,0.10635778328660173,0.4776798407071112,0.3713220574205095,600227870,598805861,60.861486315759336,48.60607582586131,NaN,NaN,18.24779977498506,11.933180273084398
2017-12-20T09:30:00-05:00,83.82,83.95,83.36,83.37,4686673,7405579.55,56.51545264212709,58.2284138431227,NaN,NaN,68.54860780279763,92.57317829949235,0.06630830247993691,0.45420743552043064,0.3878991330404937,595541197,598292210.6,60.19209901660315,48.99057072473504,NaN,NaN,17.532478976110106,12.733080087802357
2017-12-21T09:30:00-05:00,83.63,83.68,83.121,83.18,4304185,7378134.95,54.28705792811456,57.50997917588874,NaN,NaN,39.29136677865556,81.69599301539765,0.022068314534565647,0.4154845262087008,0.39341621167413515,591237012,598272139.4,60.16425295154811,49.10352931450897,NaN,NaN,16.28614809025138,13.24066123100936
2017-12-22T09:30:00-05:00,83.06,83.16,82.71,82.91,7023606,7646783.6,51.197686722050655,57.42124910117821,NaN,NaN,-12.628755793810953,61.11092616942246,-0.027634780088725663,0.35887273656322805,0.3865075166519537,584213406,595244899.2,55.95935669639623,48.883421806698685,NaN,NaN,14.32476468030277,13.39553315233699
2017-12-26T09:30:00-05:00,82.84,83.04,82.75,82.93,2504110,7559917.2,51.418232129216044,57.447985049877495,NaN,NaN,-24.0669196667597,33.99650080360571,-0.05958641802827219,0.3120244941166135,0.3716109121448857,586717516,591587400.2,51.29478288096277,48.77154045206357,NaN,NaN,12.777821579453391,13.307288641925046
2017-12-27T09:30:00-05:00,82.99,83.29,82.98,83.07,4053305,7348061.7,53.018765584693284,57.640568469633,NaN,NaN,-1.8216574834062131,13.86452832749526,-0.07094290000503445,0.28293228713859264,0.3538751871436271,590770821,589695990.4,49.01920540620943,49.14977260607984,NaN,NaN,11.88840753004992,13.1045913402286
2017-12-28T09:30:00-05:00,83.22,83.34,82.93,83.19,5380553,7209857.65,54.40534041752649,57.91683073625641,NaN,NaN,1.8629696666769016,0.5274007002711126,-0.06991007172483554,0.26648759748758266,0.3363976692124182,596151374,589818025.8,49.175870864515595,50.10320185627173,NaN,NaN,11.493789292130984,12.87447676192894
2017-12-29T09:30:00-05:00,83.33,83.46,82.59,82.68,4877164,6921737.65,47.93082318732155,57.10671253189666,NaN,NaN,-32.3594040176266,-13.802753458985313,-0.10121179537185404,0.20988292499760064,0.3110947203694547,591274210,589825465.4,49.186122600871585,51.26152119805637,NaN,NaN,9.293087680870467,12.36284975034916
2018-01-02T09:30:00-05:00,82.99,83.65,82.87,83.61,6708904,6491412.95,57.79438089799441,56.80485834779862,NaN,NaN,36.595359243931576,-3.9579304514368134,-0.059011183613120854,0.2373307408530536,0.29634192446617447,597983114,592579407,52.96802666656786,52.71874778706758,NaN,NaN,10.300414897285574,12.068216199911504
2018-01-03T09:30:00-05:00,83.6,84.47,83.36,84.41,7606500,6383261.05,64.09520124431131,56.77912938129049,NaN,NaN,127.48934753026988,26.3533229879691,0.018885244327374706,0.3199484798753929,0.30106323554801817,605589614,596353826.6,57.623205898440744,54.155251786341346,NaN,NaN,13.374460494845602,12.254822527759233
2018-01-04T09:30:00-05:00,84.68,84.835,84.315,84.53,7762520,6109886.2,64.94068675393419,56.66855073421142,NaN,NaN,177.5019035252317,62.218035189696685,0.0716326041494052,0.3906039907347747,0.3189713865853695,613352134,600870089.2,62.416696181305305,55.31824017960974,NaN,NaN,16.063854495906224,12.798969951780231
2018-01-05T09:30:00-05:00,84.8,85.33,84.635,85.25,7579284,6062201.5,69.57069383848142,57.6150916163968,NaN,NaN,219.5388251409766,105.75320628455663,0.14397924462638645,0.4989454423683526,0.35496619774196614,620931418,605826098,66.84835575926488,56.444920911635435,NaN,NaN,20.01483605007398,13.829807965822194
2018-01-08T09:30:00-05:00,85.15,85.26,84.505,84.94,5167335,6121607.65,65.55641681673951,57.959647892167176,NaN,NaN,171.9359302833267,146.6122731447473,0.15875745252107543,0.5534130133933104,0.39465556087223497,615764083,610724072.6,70.54493912783785,57.5269467627569,NaN,NaN,21.8974087544413,14.982322364196353
2018-01-09T09:30:00-05:00,85.2,86.12,85.12,85.94,6962937,6047548.8,71.30775080474992,58.69931601093449,NaN,NaN,221.6483031281635,183.62286192159368,0.21991748333490702,0.6695524150408687,0.4496349317059617,622727020,615672853.8,73.73199010942508,58.57045646255056,NaN,NaN,25.653361570404883,16.50675653651186
2018-01-10T09:30:00-05:00,85.65,85.81,85.15,85.79,10835795,6259906.7,69.43485448808504,59.390953103953244,NaN,NaN,168.3673720218508,191.79846681990983,0.2330510824922244,0.7409487848212422,0.5078977023290178,611891225,616933176,74.48903899048481,59.543853082173804,NaN,NaN,27.937020615842894,18.13965140498772
2018-01-11T09:30:00-05:00,85.94,86.18,85.695,86.16,4247768,6168863.75,71.42831655332824,60.456157669039044,NaN,NaN,168.36091831361696,189.9702697775869,0.24804817437058102,0.817957920292244,0.569909745921663,616138993,617490547.8,74.83446183961532,60.58973614096039,NaN,NaN,30.463562688857408,19.900210159826248
2018-01-12T09:30:00-05:00,86.32,86.92,86.2489,86.82,5391784,6015464.4,74.60944103931763,61.907756462696405,NaN,NaN,175.49528619838125,181.16156198906782,0.2813688655895932,0.9216208279086544,0.6402519623190612,621530777,617610419.6,74.91313513676496,61.64322772561873,NaN,NaN,33.707114868197586,21.87262511816501
2018-01-16T09:30:00-05:00,87.36,87.9467,87.11,87.25,8920043,6122862.5,76.44919518903326,63.71143563890945,NaN,NaN,182.65549681977942,183.30547529635837,0.3091083489568588,1.0266373985151347,0.7175290495582759,630450820,620547767,76.82502704690323,63.13363275065495,NaN,NaN,36.98777127955307,24.03193171264902
2018-01-17T09:30:00-05:00,87.65,88.2752,87.43,88.09,7214557,6082978.4,79.56429936687508,65.72186901302796,NaN,NaN,173.98977727673028,173.77377012607172,0.3573562115249648,1.164224313964482,0.8068681024395171,637665377,623535438.4,78.61060056206216,65.08476258501919,NaN,NaN,40.929989521485396,26.445939971054216
2018-01-18T09:30:00-05:00,88.1,88.2029,87.595,88.11,7954811,6197948.75,79.63337443062086,67.62291250202279,NaN,NaN,147.57822329418775,169.61594038053912,0.36278412475891664,1.260348258388163,0.8975641336292463,645620188,630281231,81.98553085115014,67.43950011680066,NaN,NaN,43.980720631372805,28.950908636814013
2018-01-19T09:30:00-05:00,88.45,88.4726,88,88.44,4802430,6199213.2,80.78732755796429,69.50734015491119,NaN,NaN,139.41830962402153,163.82741864262002,0.3600454005090449,1.3476208842655524,0.9875754837565075,650422618,637137956,84.63868790647953,69.97255847694095,NaN,NaN,46.861923687036885,31.509625072560137
2018-01-22T09:30:00-05:00,88.41,89.07,88.25,89.02,11152504,6522504.75,82.6481835737115,71.9871516110819,NaN,NaN,136.73734244574257,156.0758298920923,0.3674653542060191,1.4469071765140313,1.0794418223080122,661575122,645146825,87.03970624518942,72.67638588010651,NaN,NaN,49.93715197269259,34.1421289154362
2018-01-23T09:30:00-05:00,89.01,89.18,88.51,88.59,7637626,6689176.8,76.71572731889077,73.33867635543164,NaN,NaN,119.88347375287167,143.52142527871075,0.3155702358714285,1.4739046171472978,1.1583343812758693,653937496,649844160.2,88.204254780852,75.1932593168411,NaN,NaN,50.61998285039151,36.49610804900124
2018-01-24T09:30:00-05:00,89.03,89.18,88.54,88.85,8291063,6752549.65,77.75544294091061,74.31440790518874,NaN,NaN,110.16187078763191,130.75584398089106,0.2725329470004185,1.4990005650263925,1.226467618025974,662228559,654756796.6,89.28830340846282,77.45505199612839,NaN,NaN,51.49638808489298,38.63900519698578
2018-01-25T09:30:00-05:00,89.28,89.699,88.94,89.61,6339257,6944307,80.49689457803369,75.42556560691013,NaN,NaN,115.63895406719627,124.36799013549276,0.268591334025738,1.5622067855581463,1.2936154515324083,668567816,659346322.2,90.19489844089037,79.43920930038446,NaN,NaN,53.149941116900735,40.711996042687915
2018-01-26T09:30:00-05:00,90.02,91.56,90,91.54,9784419,7230862.7,85.41325418308978,76.55717706009645,NaN,NaN,151.08542223094142,126.70141265687676,0.3634152518450908,1.7478845163387717,1.384469264493681,678352235,664932245.6,91.17400632317258,81.17675576923502,NaN,NaN,56.65242770281223,42.98920056556282
2018-01-29T09:30:00-05:00,91.3,91.79,91.28,91.29,12643952,7594032.65,82.51175094494985,77.76827235496862,NaN,NaN,146.5347054485455,128.66088525743734,0.3752218605058548,1.8534965901259994,1.4782747296201446,665708283,665758877.8,91.31226332207223,82.66013606882318,NaN,NaN,58.26493279995154,45.17144802761835
2018-01-30T09:30:00-05:00,89.49,90.11,89.22,89.37,14270628,8063705.85,64.4140209459019,77.27586307933662,NaN,NaN,78.41026468445986,120.36624344375498,0.2269452010678905,1.7619562309550076,1.5350110298871171,651437655,665258909.6,90.38999220121158,83.84999336109365,NaN,NaN,52.46299384929477,46.21309743071498
2018-01-31T09:30:00-05:00,89.83,90.089,87.79,88.1,15872439,8521882.6,55.709849056372434,76.2955055485,NaN,NaN,41.97603669548113,106.72907662532482,0.027068585479161245,1.5688467617360686,1.5417781762569074,635565216,659926241,80.99348434645029,84.31459660080546,NaN,NaN,44.20826131258334,45.92669227098189
2018-02-01T09:30:00-05:00,87.76,88.529,87.535,88.13,12848665,8783990.85,55.86157717630737,75.1835955929985,NaN,NaN,13.679086731421073,86.33710315816978,-0.11177075231672307,1.4020647358610034,1.5138354881777265,648413881,655895454,74.67448506308713,84.30316968819632,NaN,NaN,38.31313699337718,44.83904151703836
2018-02-02T09:30:00-05:00,87.41,88.18,86.87,86.89,10539187,8922824.2,48.470296325357104,73.31651382771561,NaN,NaN,-26.20192935522278,50.87963284093694,-0.28586860426725624,1.1564997328436561,1.4423683371109124,637874694,647799945.8,63.892747882811385,83.51599917005676,NaN,NaN,30.5709015685317,42.80073581010884
2018-02-05T09:30:00-05:00,86.46,86.99,82.37,83.04,34979844,10292852.2,33.60356261561925,70.25611150104318,NaN,NaN,-165.7951873220585,-11.58634571318384,-0.6388518629263833,0.6438035084529332,1.2826553713793165,602894850,635237259.2,51.472854910426896,81.70512973173705,NaN,NaN,16.078723888923232,38.983305535653756
2018-02-06T09:30:00-05:00,81.44,84.32,81.4,83.96,33313394,11700155.15,38.46094705562072,67.32015776452502,NaN,NaN,-189.87671350325635,-65.24374135072709,-0.7795867341958311,0.30817195363452754,1.0877586878303587,636208244,632191377,48.98652812988118,79.58912455800983,NaN,NaN,7.684415159415902,34.51203548190549
2018-02-07T09:30:00-05:00,83.72,85.035,83.43,83.86,17337953,12218905.95,38.13438083843486,64.35594393651174,NaN,NaN,-140.80163876815658,-101.79927644345463,-0.84322805491131,0.03372361919122113,0.8769516741025312,618870291,628852392,46.34377033299282,77.04328452099858,NaN,NaN,1.6176486011119304,29.812837356077843
2018-02-08T09:30:00-05:00,83.84,84.11,80.88,80.95,20252474,12689739.9,30.1197967361133,60.73683459209381,NaN,NaN,-193.1497341205192,-143.16504061384268,-1.0326181965186172,-0.41382107154574044,0.6187971249728768,598617817,618893179.2,39.49895768631977,73.81901807670145,NaN,NaN,-7.115042022396858,24.537426016295743
2018-02-09T09:30:00-05:00,81.69,82.8,79.56,82.1,35535741,14254138.55,35.857034647445246,57.39460966878907,NaN,NaN,-175.30212208100514,-172.98507915899918,-1.0294438578792362,-0.6680076973761686,0.36143616050306765,634153558,618148952,39.034988152636046,70.39010964151908,NaN,NaN,-11.45227936653297,19.396039533034497
2018-02-12T09:30:00-05:00,82.63,83.5149,81.89,82.87,13389160,14654007.35,39.44209998264505,54.73220771620009,NaN,NaN,-116.25961934716612,-163.0779655640207,-0.9276446391554996,-0.7981196384413067,0.12952500071419276,647542718,627078525.6,47.06886067807674,67.45186720560655,NaN,NaN,-13.386813717798308,14.712774782915524
2018-02-13T09:30:00-05:00,82.39,83.115,81.88,82.93,8415182,14628764.3,39.72480393580588,52.01573350154975,NaN,NaN,-101.64032567195008,-145.43068799775943,-0.8125619910717521,-0.8861774881254973,-0.07361549705374529,655957900,631028456.8,50.19535480893054,64.65951373421139,NaN,NaN,-14.728924955073916,10.506817677488462
2018-02-14T09:30:00-05:00,82.4,84.015,82.32,83.87,10110811,14773577,44.12563748379591,49.41778656624705,NaN,NaN,-73.35280350490409,-131.94092094510893,-0.6371748320839563,-0.8700840371586906,-0.23290920507473437,666068711,640468140.8,56.76752870217655,62.271844467160406,NaN,NaN,-14.33885027684526,6.957436541155073
2018-02-15T09:30:00-05:00,84.44,84.83,83.59,84.8,9519095,14851791.2,48.158501994608486,46.756732838498394,NaN,NaN,-45.2679795391838,-102.36457002884183,-0.432369984950332,-0.7733716862626494,-0.3410017013123174,675587806,655862138.6,64.90155722677869,60.395240960275125,NaN,NaN,-12.6749425225884,4.152810960620291
2018-02-16T09:30:00-05:00,84.38,86.01,84.38,85.41,9322953,15077817.35,50.67336377341903,44.48256232624618,NaN,NaN,-22.772275158926593,-71.85860064442612,-0.23929910307944452,-0.640125580161623,-0.4008264770821785,684910759,666013578.8,69.0384918718292,58.804257285257755,NaN,NaN,-10.517134648233984,2.057104445069681
2018-02-20T09:30:00-05:00,85,85.28,84.23,84.47,8872089,14963796.6,46.897880940929994,43.2314094687482,NaN,NaN,-32.642163404300504,-55.13510945585298,-0.16207590582896364,-0.603421359368383,-0.4413454535394194,676038670,671712769.2,71.09811238474038,57.42626586979552,NaN,NaN,-9.901532818608402,0.3487276931156691
2018-02-21T09:30:00-05:00,84.46,85.59,84.11,84.12,9417367,15052783.65,45.53742005096482,42.50480739693336,NaN,NaN,-30.138339203543207,-40.83471216217161,-0.1234901351346992,-0.5957081224577934,-0.47221798732309417,666621303,673845449.8,71.85268224305938,56.773351433839025,NaN,NaN,-9.816469149304773,-1.1034432843729656
2018-02-22T09:30:00-05:00,84.39,84.99,83.79,83.99,6316117,14954036.35,45.01508293413372,41.730057808206666,NaN,NaN,-34.80439899216395,-33.12503125962361,-0.09682293969694689,-0.5932466619442778,-0.4964237222473309,660305186,672692744.8,70.77710139706673,56.49496688626615,NaN,NaN,-9.897860586327925,-2.3597886132236736
2018-02-23T09:30:00-05:00,84.49,85.36,84.12,85.33,5498544,14912000.7,51.22550830403618,41.9268586638266,NaN,NaN,-12.976903391119674,-26.666816030010786,0.01500863009769271,-0.47766293462521503,-0.49267156472290774,665803730,670735929.6,68.89178674414852,56.85204109064737,NaN,NaN,-8.084749204226995,-3.177640126224148
2018-02-26T09:30:00-05:00,85.48,86.51,85.48,86.41,6266120,14736085.75,55.58020547031844,43.49661886773369,NaN,NaN,32.056941428968905,-15.700972712431684,0.1577303838530807,-0.29550858490655685,-0.45323896875963754,672069850,668167747.8,66.39219694118283,57.91770837855851,NaN,NaN,-5.164441951146297,-3.4614689583558835
2018-02-27T09:30:00-05:00,86.41,86.695,85.51,85.51,7460688,14476922.55,51.457192232642555,44.42492209466382,NaN,NaN,40.748633027494925,-1.0228134260725952,0.18561332249501195,-0.22122231564087258,-0.4068356381358845,664609162,665881846.2,64.1607469511808,59.00158115150847,NaN,NaN,-3.946756283676244,-3.530795719115935
2018-02-28T09:30:00-05:00,85.79,85.9,84.12,84.14,6279035,14077342.9,45.87810910724146,44.978045542435716,NaN,NaN,4.140585044192022,5.832971423474448,0.1096384946014125,-0.26978751988411886,-0.37942601448553137,658330127,664223611,62.51918709748568,60.15696806325796,NaN,NaN,-4.651954901464653,-3.6909613165943234
2018-03-01T09:30:00-05:00,83.99,84.42,82.17,82.8,12720268,13919734.35,41.17563933270615,45.767748585049496,NaN,NaN,-65.72009037204964,-0.3501668525026901,-0.02578500166896458,-0.41165726657173707,-0.3858722649027725,645609859,661284545.6,59.60819462068688,61.59334212999847,NaN,NaN,-6.790864585639757,-4.133804640743671
2018-03-02T09:30:00-05:00,82.35,83.82,82.3403,83.64,11205969,13837599.55,44.98261104253931,46.419575470413356,NaN,NaN,-51.2810304863962,-8.010992271557996,-0.0521893717575268,-0.451108979599681,-0.3989196078421542,656815828,659486965.2,57.834501369697286,62.9361645026457,NaN,NaN,-7.340415096181592,-4.591891848663374
2018-03-05T09:30:00-05:00,83.26,84.645,83.08,84.4,11028818,13862081.1,48.2461166693111,47.04843380517523,NaN,NaN,6.048989073065656,-13.212582742738643,-0.0138649678659295,-0.41625081767456606,-0.40238584980863656,667844646,658641924.4,56.97619949848158,63.64383156124605,NaN,NaN,-6.767025545937838,-4.902625233988298
2018-03-06T09:30:00-05:00,84.59,84.73,83.86,84.28,9573287,12591753.25,47.76434577280779,47.6226867935325,NaN,NaN,22.374806415710403,-16.88734806509555,0.006893205878439779,-0.3937693424605868,-0.4006625483390266,658271359,657374363.8,55.642267710488866,64.03289676850022,NaN,NaN,-6.451547782652828,-5.123899883797516
2018-03-07T09:30:00-05:00,83.56,84.8,83.53,84.71,6868154,11269491.25,49.70253505548621,48.02103662008181,NaN,NaN,23.232319315188374,-13.06900121089628,0.05063703320117724,-0.33736625683755506,-0.3880032900387323,665139513,658736241,56.8121853129701,64.03608652641405,NaN,NaN,-5.627247487630495,-5.195806684345084
2018-03-08T09:30:00-05:00,84.94,85.35,84.8,85.28,6402977,10722742.45,52.23271157731642,48.31205159027523,NaN,NaN,72.75802118335992,14.626621100185634,0.115313760062219,-0.24386108996095857,-0.35917485002317756,671542490,663922767.2,61.02782858962516,63.75939162376023,NaN,NaN,-4.200892936891437,-5.053676148994563
2018-03-09T09:30:00-05:00,85.8,86.54,85.48,86.51,8253094,10122773.45,57.232313453780804,48.78054799601536,NaN,NaN,136.83644870369994,52.25011693820486,0.2315771966558352,-0.06970335420338358,-0.3012805508592188,679795584,668518718.4,64.34876612000065,63.42441121291533,NaN,NaN,-1.4278933855992588,-4.5357071827952335
2018-03-12T09:30:00-04:00,86.54,86.67,86.04,86.14,5760183,8633995.55,55.35539215942863,49.38465594019384,NaN,NaN,136.07737604129784,78.2557943318513,0.2714433886640342,0.03802368497082398,-0.23341970369321025,674035401,669756869.4,65.20888278961215,63.003751956120446,NaN,NaN,0.3323047304489607,-3.8402769094746345
2018-03-13T09:30:00-04:00,86.47,86.85,86.06,86.25,6400683,8284571.7,55.81928021655332,50.11907452345015,NaN,NaN,129.9688260113677,99.77459825098276,0.2913492204082063,0.13076682181704768,-0.16058239859115864,680436084,674189814.4,68.16979573423468,62.74068863406155,NaN,NaN,1.9077034044532724,-3.0191368646277907
2018-03-14T09:30:00-04:00,86.55,86.75,85.55,85.83,9416354,8334630.3,53.53210321952187,50.727433115263594,NaN,NaN,92.62723173269771,113.65358073448462,0.2632133828119085,0.16843432992372698,-0.09477905288818152,671019730,675365857.8,68.92537299184322,62.60842231940273,NaN,NaN,2.6327239165154515,-2.2117281816073278
2018-03-15T09:30:00-04:00,86.13,86.375,85.5836,85.69,5883145,8123247,52.75612090021348,50.83676258641912,NaN,NaN,71.60847909519323,113.4236723168513,0.22370991402078438,0.18485833963779896,-0.03885157438298542,665136585,674084676.8,67.05787115498454,62.477428348748155,NaN,NaN,3.036887567673299,-1.4619259317100954
2018-03-16T09:30:00-04:00,85.38,85.85,85.38,85.39,7067672,8000675.85,51.048473574624374,50.5130674510124,NaN,NaN,39.51549225236779,93.95948102658485,0.16843156497804768,0.17168788183957417,0.003256316861526498,658068913,669739342.6,61.01914407985932,62.09363885865362,NaN,NaN,2.9403496981815076,-0.8330294131541521
2018-03-19T09:30:00-04:00,85.23,85.34,83.325,84.01,7190194,7894037.9,43.99404644799548,49.9799856092519,NaN,NaN,-60.6423988127963,54.61552605576603,0.03685664247388818,0.04932711995388672,0.012470477479998543,650878719,665108006.2,55.302892748773985,61.46093498705313,NaN,NaN,0.8395048555052314,-0.5940959462028117
2018-03-20T09:30:00-04:00,84.2,84.43,83.65,84.13,5534438,7727155.35,44.7095567733646,49.89651758540355,NaN,NaN,-68.34535814336736,14.952689224819007,-0.039999627327737666,-0.037529056679673545,0.002470570648064125,656413157,660303420.8,50.06328451054204,60.571227659414305,NaN,NaN,-0.7081524793895616,-0.6103897366580617
2018-03-21T09:30:00-04:00,84.27,84.73,83.7,83.77,5498739,7531223.95,42.937316717713784,50.02235168433266,NaN,NaN,-64.75271457727635,-16.523300037175808,-0.10907168442061527,-0.13386903487770496,-0.024797350457089695,650914418,656282358.4,46.12458358785463,59.60811258564057,NaN,NaN,-2.5174271455820847,-0.8828236522186363
2018-03-22T09:30:00-04:00,82.96,83.02,81.22,81.36,14648453,7947840.75,33.39416210952865,49.194605331974756,NaN,NaN,-193.13333322443492,-69.47166250110143,-0.3002214908184234,-0.400074213980119,-0.09985272316169556,636265965,650508234.4,41.1215530779017,58.41433056479803,NaN,NaN,-7.4373325937875485,-1.8191820724427665
2018-03-23T09:30:00-04:00,81.44,81.6089,79.605,79.67,11048955,8225361.3,28.59465853502438,47.79092975095428,NaN,NaN,-232.6895907978423,-123.91267911114346,-0.5112338932752385,-0.7388950897557436,-0.22766119648050515,625217010,643937853.8,36.29696626461432,56.93724247666466,NaN,NaN,-13.494247426778577,-3.4870485516335963
2018-03-26T09:30:00-04:00,80.57,81.43,79.645,81.32,9183474,8371229,37.968544442362244,47.091229655922454,NaN,NaN,-178.20551702756646,-147.4253027540975,-0.5093179647154038,-0.8643086523747598,-0.3549906876593561,634400484,640642206.8,34.13370538718179,55.40091659642844,NaN,NaN,-15.431396786767282,-5.193384013795551
2018-03-27T09:30:00-04:00,81.61,81.85,79.9,80.36,10948416,8545615.4,35.082816485772085,46.04696404380002,NaN,NaN,-156.1715788481346,-164.99054689505093,-0.5394463834207016,-1.029298666935233,-0.4898522835145315,623452068,634049989,30.25005378739651,53.503621487458894,NaN,NaN,-18.00388093709891,-7.0234550028388885
2018-03-28T09:30:00-04:00,80.59,81.57,80.48,80.79,10146839,8739005.6,37.37862643573885,44.98595796225876,NaN,NaN,-121.11465478099316,-176.26293493579428,-0.4981441365631031,-1.1125324542184103,-0.6143883176553072,633598907,630586886.8,28.42065117353438,51.17453738630956,NaN,NaN,-19.276711057085823,-8.773920153445593
2018-03-29T09:30:00-04:00,81.22,81.99,80.67,81.4,6926405,8449312.45,40.58853449029699,43.797116607724206,NaN,NaN,-93.89506299933353,-156.415280890774,-0.40161311366302155,-1.1164047097340841,-0.7147915960710626,640525312,631438756.2,29.54930515582899,48.68886160315444,NaN,NaN,-19.283198272001005,-10.275245598953509
2018-04-02T09:30:00-04:00,81.06,81.48,78.74,79.55,11364927,8457260.35,34.76784591087578,42.326577589970434,NaN,NaN,-126.69245965684698,-135.21585466257494,-0.4316021750965008,-1.2542943149416885,-0.8226921398451877,629160385,632227431.2,30.63972468991389,46.21963602460456,NaN,NaN,-21.259005781219187,-11.844354196420035
2018-04-03T09:30:00-04:00,79.98,80.91,79.489,80.76,8590726,8335355.75,40.75250369088312,41.25037926670827,NaN,NaN,-95.83031575044294,-118.74081440715024,-0.3430537381907699,-1.25150931258365,-0.9084555743928802,637751111,632897556.6,31.608346259424096,43.60810391926095,NaN,NaN,-20.86322940850944,-13.132764941004236
2018-04-04T09:30:00-04:00,79.79,82.14,79.79,81.91,9085808,8310981.8,45.83838649571056,40.70082807215032,NaN,NaN,-60.728125437963975,-99.65212372511611,-0.18789732012800875,-1.1433272245528912,-0.9554299044248824,646836919,637574526.8,38.10503223584616,41.40665100811831,NaN,NaN,-18.799694748659622,-13.942326342097862
2018-04-05T09:30:00-04:00,82.2,82.27,81.54,81.85,8031346,8369141.4,45.61836044095874,40.19098803934641,NaN,NaN,-38.34258329408412,-83.09770942773432,-0.07591698292481497,-1.050326133080901,-0.9744091501560861,638805573,638615860,39.48342475640752,39.43704769393423,NaN,NaN,-17.26834304361579,-14.417471585171851
2018-04-06T09:30:00-04:00,81.17,81.57,79.16,79.88,12171809,8657583,38.999235976228015,39.33032821088953,NaN,NaN,-80.61543559610182,-80.44178394708797,-0.11858747879085052,-1.1226434986446492,-1.0040560198537987,626633764,635837550.4,37.10892798541946,37.72917511575996,NaN,NaN,-18.1042527844518,-14.944154613640416
2018-04-09T09:30:00-04:00,80.31,81.79,80.08,80.67,6952645,8592560.55,42.59628551811206,39.230488144469284,NaN,NaN,-56.41432870696041,-66.38615775711065,-0.07954622584853177,-1.1034888021644633,-1.0239425763159316,633586409,636722755.2,38.380447733951556,36.52042904327264,NaN,NaN,-17.603888065828844,-15.32411653538162
2018-04-10T09:30:00-04:00,81.47,82.35,81.195,82.03,8240833,8716593.05,48.25333538940755,39.48361518847235,NaN,NaN,-19.7655555859056,-51.173205724203186,0.04522113155071539,-0.9674161618775372,-1.0126372934282526,641827242,637537981.4,39.59174149357718,35.772461684918014,NaN,NaN,-15.291469979318745,-15.319452741658353
2018-04-11T09:30:00-04:00,81.42,81.91,81.25,81.36,6205752,8706846.5,45.85580085200117,39.692078340921455,NaN,NaN,-27.006035189266218,-44.428787674463635,0.08752651373382359,-0.9032291512609731,-0.9907556649947967,635621490,635294895.6,37.412524881601726,35.15017177732852,NaN,NaN,-14.184151144655315,-15.157266799229347
2018-04-12T09:30:00-04:00,81.8,82.3,81.74,81.91,5096902,8490873.9,48.13400590245442,40.74492432613044,NaN,NaN,0.10685902893283665,-36.73889920986024,0.15358666859298442,-0.7987723292535662,-0.9523589978465506,640718392,635677459.4,38.038932965572045,34.929984626447826,NaN,NaN,-12.570681577900237,-14.78775462475376
2018-04-13T09:30:00-04:00,82.3,82.37,81.43,81.87,7837028,8588568.05,47.97590075900391,42.1292987707004,NaN,NaN,6.373081737487799,-19.341195743142322,0.1930703955445936,-0.7110210034158087,-0.9040913989604022,632881364,636926979.4,40.146041109650575,35.20491854395042,NaN,NaN,-11.32902746883273,-14.29365074533647
2018-04-16T09:30:00-04:00,82.47,82.82,82.28,82.52,7217208,8596044.85,50.80379795212078,43.046102592826,NaN,NaN,62.419863385812796,4.425642675412315,0.2574208716927491,-0.582315309344466,-0.839736181037215,640098572,638229412,42.346876242597965,35.79157360505157,NaN,NaN,-9.451135175362154,-13.60186280676871
2018-04-17T09:30:00-04:00,83.15,83.34,82.715,83.16,6500915,8561580.9,53.48484724939548,44.360533361656245,NaN,NaN,110.10723964219794,30.40020172103302,0.3327590953188784,-0.42378731188861707,-0.7565464072074954,646599487,639183861,43.9727109518452,36.77176340251219,NaN,NaN,-7.074956101063839,-12.669447563096584
2018-04-18T09:30:00-04:00,83.37,83.515,82.83,83.23,4704510,8520084.5,53.78152948436094,45.53216929370068,NaN,NaN,129.02961562330853,61.60733188354798,0.37390037835859924,-0.28917093425924634,-0.6630713126178456,651303997,642320362.4,49.056843243513114,38.24577712179639,NaN,NaN,-5.043426375504638,-11.580015964869164
2018-04-19T09:30:00-04:00,83.08,83.16,82.231,82.53,5833634,8536829.25,50.32481163733957,46.22761766134658,NaN,NaN,100.36653990996993,81.65926805975539,0.341459191769764,-0.23624732290564054,-0.5777065146754046,645470363,643270756.6,50.521961508461246,39.743824004127255,NaN,NaN,-4.221320497762692,-10.528773755282526
2018-04-20T09:30:00-04:00,82.6,82.72,81.815,82.09,5250506,8066931.9,48.22656547733408,47.18895477323645,NaN,NaN,60.90089790558834,92.5648312933755,0.28041289737904473,-0.2271903929515986,-0.5076032903306433,640219857,644738455.2,52.780492570955964,41.32530742420169,NaN,NaN,-4.092868862000957,-9.609358770528015
2018-04-23T09:30:00-04:00,82.31,82.67,82.095,82.41,9257292,7977348.75,49.86378826219531,47.839760814044475,NaN,NaN,68.82751403561824,93.84636142333659,0.25249993000389337,-0.19197837782577665,-0.44447830782967,649477149,646614170.6,55.57167535657595,43.036973788283966,NaN,NaN,-3.5446321763020245,-8.742969257067159
2018-04-24T09:30:00-04:00,82.67,82.73,81.17,81.79,8904776,7963413.85,46.777315204300514,47.90682715037233,NaN,NaN,23.01027204968456,76.42696790483392,0.18625343157212954,-0.21166151836450808,-0.3979149499366376,640572373,645408747.8,53.387615722133425,44.12858689444734,NaN,NaN,-3.9022369055578814,-8.051436063994405
2018-04-25T09:30:00-04:00,81.69,82.2,81.12,82.16,8068798,7819432.95,48.81354591659081,48.13505468434604,NaN,NaN,12.708343133114138,53.162713406795035,0.1622079473666671,-0.19515501572830374,-0.35736296309497084,648641171,644876182.6,52.40762149289607,45.05174380419652,NaN,NaN,-3.6644841023355337,-7.42472864090028
2018-04-26T09:30:00-04:00,82.4,83.515,82.4,83.2,9463278,7785254.9,54.126196506196244,49.21555186505806,NaN,NaN,117.07232785907232,56.50387099661551,0.2082618753585619,-0.09703561889676848,-0.30529749425533037,658104449,647402999.8,56.48866413723282,46.436010672183194,NaN,NaN,-1.9495994083882098,-6.642567321969985
2018-04-27T09:30:00-04:00,83.14,83.67,82.96,83.54,6663258,7772097.55,55.74339944314802,50.15463143113205,NaN,NaN,134.90054249549038,71.30379991459593,0.2506914982452734,0.008066878551261425,-0.242624619694012,664767707,652312569.8,63.108075221658545,48.20226977844798,NaN,NaN,-0.04842568033894749,-5.700547087451265
2018-04-30T09:30:00-04:00,83.9,83.95,82.25,82.26,7240985,7565900.45,48.77247602895991,50.19171290538579,NaN,NaN,75.01789779355384,72.54187666618304,0.18466925394437736,-0.011788052263540294,-0.19645730620791765,657526722,653922484.4,64.98897570677451,50.016357936533495,NaN,NaN,-0.3551059687913648,-4.936912641928422
2018-05-01T09:30:00-04:00,82.16,82.45,81.525,82.22,8498012,7561264.75,48.568075290980964,50.38544679388435,NaN,NaN,-6.694376254280605,66.60094700539,0.1328454800443519,-0.030400456152477773,-0.16324593619682967,649028710,655613751.8,66.89829678358011,52.122484500960525,NaN,NaN,-0.6622375034041018,-4.3262447649963764
2018-05-02T09:30:00-04:00,81.79,81.85,80.91,81.09,11594285,7686688.6,43.07589146247241,50.02415290531422,NaN,NaN,-91.45310264081387,45.768657850604406,0.02277368490192619,-0.13477883006942193,-0.15755251497134812,637434425,653372402.6,62.067483854471725,53.838809564453356,NaN,NaN,-2.574235917256237,-4.075957786747785
2018-05-03T09:30:00-04:00,80.72,80.73,79.31,80.36,13524121,7961327.35,39.93416828689948,49.449743443021035,NaN,NaN,-182.44707158696568,-14.135222038603194,-0.09256153642463263,-0.2732544355021389,-0.18069289907750627,623910304,646533573.6,50.164440056585484,54.55440948923442,NaN,NaN,-5.168154306532656,-4.231985861002767
2018-05-04T09:30:00-04:00,80.12,81.27,79.81,81,7889544,7747214.1,43.803906327117936,48.94975118409226,NaN,NaN,-135.96917683631688,-68.30916590496466,-0.11750854253454579,-0.3275785772456885,-0.21007003471114272,631799848,639940001.8,41.83433561828824,54.517799444640865,NaN,NaN,-6.236599963818118,-4.518359304262103
2018-05-07T09:30:00-04:00,81.26,81.58,80.67,80.88,5886540,7693908.85,43.24138419424254,48.21807525158134,NaN,NaN,-103.6026976656803,-104.03328499681147,-0.1327278019375922,-0.37597978713313296,-0.24325198519554075,625913308,633617319,35.71059361924917,53.92764820659829,NaN,NaN,-7.270908710329964,-4.911580647986083
2018-05-08T09:30:00-04:00,80.68,80.75,79.7895,80.27,9522278,7757981.1,40.40115231503385,47.262334025200836,NaN,NaN,-155.02661557075606,-133.69973286010656,-0.17202022119797766,-0.45827726169301286,-0.2862570404950352,616391030,627089783,30.712229227141037,52.61731863400029,NaN,NaN,-8.984502808984516,-5.493426670985859
2018-05-09T09:30:00-04:00,80.42,81.08,79.98,80.73,11340180,8014702.5,43.41926515969253,46.7690807053689,NaN,NaN,-114.02268702953253,-138.2136497378503,-0.15566448797192906,-0.48083765045994653,-0.3251731624880175,627731210,625149140,29.394930303365456,51.108244976493445,NaN,NaN,-9.593995635437622,-6.079222237336111
2018-05-10T09:30:00-04:00,81.07,82.17,81.02,81.81,7845452,8152130,49.84158620645467,46.88443932887752,NaN,NaN,-22.102280394000992,-106.14469149925735,-0.0653652229908031,-0.40687969122652135,-0.34151446823571824,635576662,627482411.6,33.10976948293691,49.70319332734923,NaN,NaN,-8.223382971732425,-6.3855309136784415
2018-05-11T09:30:00-04:00,81.88,83.19,81.73,83.03,10434026,8281979.9,55.927328566940474,47.31754935064503,NaN,NaN,54.36914836522605,-68.07702645894878,0.07563023198706803,-0.24697667825188319,-0.3226069102389512,646010688,630324579.6,37.428441636728515,48.40724806164584,NaN,NaN,-5.066577686216659,-6.197109024041044
2018-05-14T09:30:00-04:00,83.18,83.925,83.01,83.58,11837573,8512998.15,58.379040275379595,48.14624399857926,NaN,NaN,113.05712139902738,-24.745062646007234,0.1980796506176531,-0.07500734696688482,-0.2730869975845379,657848261,636711570.2,45.88403629251586,47.87127810238745,NaN,NaN,-1.673884669809839,-5.550934116293729
2018-05-15T09:30:00-04:00,83.03,83.13,82.23,82.5,8806830,8628293.9,52.23432503055702,48.390585363862556,NaN,NaN,48.56568024830437,15.973396517804854,0.19801151648556123,-0.025572601977586373,-0.2235841184631476,649041431,643241650.4,52.89308066308223,47.905953757400745,NaN,NaN,-0.6615953070600266,-4.852457143546057
2018-05-16T09:30:00-04:00,82.46,83.25,82.45,82.96,7013641,8743750.45,54.434222090718606,48.412587191328434,NaN,NaN,71.67442294632312,53.11281851297598,0.21898321952454303,0.05014490594253118,-0.16883831358201185,656055072,648906422.8,57.97773572080134,48.01231601336992,NaN,NaN,0.8535124679553159,-4.03731862761729
2018-05-17T09:30:00-04:00,82.88,83.13,82.52,82.99,6610357,8782586.6,54.58113866353239,48.32956856421304,NaN,NaN,69.3104163633895,71.39535786445408,0.22410221107095146,0.11128945025667747,-0.11281276081427398,662665429,654324176.2,62.18205918396009,47.946172010677174,NaN,NaN,2.109166025507136,-3.1592493914566573
2018-05-18T09:30:00-04:00,83.05,83.37,82.765,83.2,5838854,8812004,55.65889657476522,48.821455746056266,NaN,NaN,80.07142273174452,76.53581273775777,0.22999308939320876,0.17467860092723697,-0.055314488465971784,668504283,658822895.2,65.28772069856284,47.96751093866205,NaN,NaN,3.4557659124296656,-2.2142472051871827
2018-05-21T09:30:00-04:00,83.59,83.75,83.155,83.28,6406467,8669462.75,56.08639980101466,49.35847892534439,NaN,NaN,92.54677635016729,72.43374372798576,0.22723846474690748,0.22873359246766256,0.0014951277207550795,674910750,662235393,67.4699913764079,48.008346266721176,NaN,NaN,4.688171575887185,-1.228187379319416
2018-05-22T09:30:00-04:00,83.45,83.55,82.99,83.12,5770209,8512734.4,54.94541711563014,50.20630218628423,NaN,NaN,72.35942933690252,77.19249354570539,0.2033752465639083,0.25571418592564044,0.052338939361732145,669140541,666255215,69.87271904375109,48.56586306595542,NaN,NaN,5.431571250101348,-0.2767932894021641
2018-05-23T09:30:00-04:00,82.77,83.42,82.6738,83.39,8360471,8527318.05,56.55170253990692,51.39326891864191,NaN,NaN,62.526238472541614,75.36285665094908,0.19451058233885307,0.2954771672852985,0.10096658494644542,677501012,670544403,72.22968905288806,50.14195227997703,NaN,NaN,6.492676158397039,0.6902737745691506
2018-05-24T09:30:00-04:00,83.34,83.48,82.685,83.06,7166498,8412479.05,54.01687699035922,52.12276682315915,NaN,NaN,56.581969266056355,72.81716723148246,0.15677749425800813,0.2969384527689556,0.14016095851094745,670334514,672078220,73.04189583934345,52.371063724338114,NaN,NaN,6.758267485843403,1.5571300190369008
2018-05-25T09:30:00-04:00,83.09,83.46,82.795,82.94,6853296,8421980.95,53.0850682892027,52.8258871156563,NaN,NaN,57.74525977273789,68.35193463968113,0.11597264998630363,0.285126770993827,0.16915412100752336,663481218,671073607,71.56551099578044,54.932129251233206,NaN,NaN,6.7470714322312535,2.2985502209218085
2018-05-29T09:30:00-04:00,82.4,82.549,81.57,82.09,18236759,8971769.65,46.911968343375946,53.29094540339502,NaN,NaN,-6.860723130035841,48.47043474364051,0.028530326092447572,0.20481702862308282,0.17628670253063525,645244459,665140348.8,63.413106698264635,57.26790621345632,NaN,NaN,5.041451707731178,2.690393290466004
2018-05-30T09:30:00-04:00,82.65,83.51,82.56,83.32,13167674,9205252.75,55.05654083183467,54.1221793799766,NaN,NaN,60.32309321212614,46.06316751868523,0.04911611895612139,0.237681851225787,0.1885657322696656,658412133,662994667.2,60.71930610202392,59.50536162764622,NaN,NaN,5.8503843089651575,3.141820578823026
2018-05-31T09:30:00-04:00,83.16,83.225,82.38,82.41,11543475,9202712.25,49.05976151924779,54.066334759461824,NaN,NaN,26.426926895474555,38.84330520327182,-0.0003490448673799107,0.1881294261854407,0.18847847105282062,646868658,656868196.4,53.7043400638986,60.97640238342918,NaN,NaN,4.685984741446077,3.3624154591977478
2018-06-01T09:30:00-04:00,82.74,83.39,82.65,83.36,8037829,8928397.65,54.6171163769992,53.97274817446602,NaN,NaN,55.42063817591682,38.611038985243916,0.027573904639800917,0.22294585185257176,0.19537194721277085,654906487,653782591,50.5374924649625,61.91276315687447,NaN,NaN,5.458199160391294,3.661813130796826
2018-06-04T09:30:00-04:00,83.46,83.7888,83.19,83.67,7230786,8895459.75,56.292766137802936,53.82372859321055,NaN,NaN,88.34469986219986,44.73092700313631,0.06163230582249585,0.27241232949089067,0.21078002366839482,662137273,653513802,50.25946262510814,62.22529360920249,NaN,NaN,6.607556929194476,4.082633673425062
2018-06-05T09:30:00-04:00,83.7,83.8752,83.1,83.5,5444372,8873351.35,55.09147716746236,54.02781088870379,NaN,NaN,81.60089852079064,62.42325133330161,0.0669779404587389,0.29450244924181845,0.22752450878307956,656692901,655803490.4,52.649223261422996,62.20787522336968,NaN,NaN,7.182982415220583,4.525540636538707
2018-06-06T09:30:00-04:00,83.79,84.53,83.45,84.44,7218947,8758184.8,60.15478870495536,54.4364227897207,NaN,NaN,159.89105336871432,82.33684336461923,0.12473169284457764,0.3834391248388016,0.25870743199422397,663911848,656903433.4,53.79760660215133,61.90929457203754,NaN,NaN,9.27018514081617,5.20334699429263
2018-06-07T09:30:00-04:00,84.69,84.765,84.135,84.55,7405595,8561455.55,60.713007149519235,54.87441339586262,NaN,NaN,216.569307836979,120.36531955292011,0.15905334126099485,0.45752410857046755,0.2984707673094727,671317443,661793190.4,58.60400615001012,61.65371935532683,NaN,NaN,11.120734241852942,6.048688029658389
2018-06-08T09:30:00-04:00,84.52,85.1,84.38,85.04,6247131,8481539.5,63.18710087089181,55.41214227415737,NaN,NaN,228.5195046701567,154.98509285176812,0.20077720085364076,0.5494422683765237,0.3486650675228829,677564574,666324807.8,62.49771738889187,61.45443340463605,NaN,NaN,13.435343228063024,7.103924486573336
2018-06-11T09:30:00-04:00,85.05,85.61,84.85,85.2,7074377,8313557.05,63.98466103113515,55.97630379059455,NaN,NaN,220.1284834196807,181.34184956326425,0.22343594842800835,0.6279600030578933,0.404524054629885,684638951,670825143.4,65.92548563193354,61.344111565745024,NaN,NaN,15.575445127337389,8.314141720968202
2018-06-12T09:30:00-04:00,85.29,85.29,84.77,85.15,6829166,8063136.7,63.521513902164855,56.58888213248989,NaN,NaN,163.30337634673444,197.68234512845302,0.21904627902763701,0.6783319034144313,0.45928562438679427,677809785,675048520.2,68.80693753960269,61.2679843154487,NaN,NaN,17.217718090754676,9.58608120236627
2018-06-13T09:30:00-04:00,85.3,85.72,85.055,85.17,10379181,8141754.25,63.63490331957152,57.09482504532308,NaN,NaN,152.93782114910198,196.29169868453056,0.20190128529478668,0.7116622310052776,0.5097609457104909,688188966,679903943.8,71.7632380070356,61.23466638360209,NaN,NaN,18.617692595274857,10.87631140135321
2018-06-14T09:30:00-04:00,85.34,85.66,85.1,85.61,9379776,8260061,66.12930927710505,57.959998780090636,NaN,NaN,136.58456605125156,180.29475032738506,0.20400351521807802,0.7647653397330885,0.5607618245150104,697568742,685154203.6,74.56982354842707,61.34380407710807,NaN,NaN,20.530212874450953,12.255440183224316
2018-06-15T09:30:00-04:00,85.19,85.5005,84.8,85.46,9367065,8397896.4,64.50488942052507,58.775700289470805,NaN,NaN,104.07554967719375,155.40595932879248,0.17994194275273823,0.7856892529559332,0.6057473102031949,688201677,687281624.2,75.62695835006187,61.63390745955674,NaN,NaN,21.740624771445702,13.610466552970228
2018-06-18T09:30:00-04:00,84.94,84.94,84.29,84.64,7342605,8473083.95,56.355125949060394,59.45021154701969,NaN,NaN,51.443002377323154,121.66886312032098,0.09757479437189764,0.727715803168067,0.6301410087961694,680859072,686525648.4,74.44271107490181,62.421736343602255,NaN,NaN,20.573628645915083,14.605203994819494
2018-06-19T09:30:00-04:00,84.06,84.89,83.93,84.86,6431697,8474345.45,57.89224658238,59.65276195777293,NaN,NaN,42.29835984177116,97.46785981932831,0.04912864027395736,0.6915518091386161,0.6424231688646588,687290769,688421845.2,75.47987783420778,63.47606289590109,NaN,NaN,20.00353208091898,15.376393721405135
2018-06-20T09:30:00-04:00,84.97,85.235,84.785,85.04,5900793,8480874.65,59.15960413824427,60.37417928770124,NaN,NaN,68.71781031500923,80.62385765250976,0.021818455023373984,0.6696962376438762,0.6478777826205022,693191562,689422364.4,76.03256834170267,65.07093634431567,NaN,NaN,19.859302378487477,16.01680924384547
2018-06-21T09:30:00-04:00,84.96,84.965,84.35,84.55,7423429,8434022.55,54.36284894941878,60.35601732858835,NaN,NaN,35.99869102456512,60.50668264717247,-0.03362003281692216,0.6058527415993495,0.6394727744162717,685768133,687062242.6,71.91471556331544,66.59788085134088,NaN,NaN,18.384484198011496,16.355048523012044
2018-06-22T09:30:00-04:00,84.86,85.255,84.64,84.93,9885619,8569978.6,57.257239064646505,60.424908251934326,NaN,NaN,54.877088946009806,50.666990500935675,-0.04818462426753356,0.5792419940818547,0.6274266183493883,695653752,688552657.6,72.91241321536468,68.21594875064491,NaN,NaN,17.903865441636228,16.576308082815498
2018-06-25T09:30:00-04:00,84.61,84.94,83.51,84.15,9925144,8723571,50.21703429393733,60.07673376096825,NaN,NaN,-7.528630793752544,38.872663866720536,-0.11028541689240601,0.48956984723388075,0.5998552641262868,685728608,689526564.8,73.57304920144827,69.710507746361,NaN,NaN,15.341436299547626,16.399897828062944
2018-06-26T09:30:00-04:00,84.22,84.2803,83.78,83.89,5560148,8089740.45,48.094223746777885,59.215264835384154,NaN,NaN,-39.49681404904178,22.513629088557966,-0.16548900535923106,0.392994007427248,0.558483012786479,680168460,688102103,70.85124239835301,70.92862458894685,NaN,NaN,12.565327675045562,15.852102091917603
2018-06-27T09:30:00-04:00,83.89,84.32,83.12,83.18,7420476,7802380.55,42.77639833001033,57.93407849113351,NaN,NaN,-88.30266144854464,-8.890465264152809,-0.2418164623535608,0.25621243484452805,0.49802889719808885,672747984,684013387.4,63.58043239207372,71.28408360623709,NaN,NaN,8.431878680850915,14.792070176050933
2018-06-28T09:30:00-04:00,82.87,83.5,82.29,83.29,9026946,7676554.1,43.81296277436047,56.55021148423841,NaN,NaN,-147.2702141634743,-45.54424630176069,-0.2745011065201702,0.15490251404787614,0.4294036205680463,681774930,683214746.8,62.23694753788709,71.26545718830819,NaN,NaN,5.365848843420418,13.445467128532288
2018-06-29T09:30:00-04:00,83.55,84.2,83.4,83.46,6483097,7598817.5,45.45732860426137,55.22683059660458,NaN,NaN,-85.06874704890514,-73.53341350074368,-0.2736631946754477,0.08732462722373668,0.3609878218991844,688258027,681735601.8,59.72000566061759,70.82220861892847,NaN,NaN,3.273424072875782,11.99231812058136
2018-07-02T09:30:00-04:00,83,83.77,82.72,83.72,9364654,7705510.9,47.96553083517979,54.115688948962784,NaN,NaN,-114.11113365391607,-94.84991407277639,-0.2454905953655025,0.054124577692306275,0.29961517305780877,697622681,684114416.4,62.35662813332637,70.36147223276588,NaN,NaN,2.191663501424378,10.592224603558932
2018-07-03T09:30:00-04:00,84.02,84.31,83.7,83.92,3023094,7584447,49.87503901626436,53.132841498726556,NaN,NaN,-56.60325201190707,-98.27120166534944,-0.20493153482666995,0.043450754524471336,0.2483822893511413,700645775,688209879.4,66.43069366600561,69.98057620840659,NaN,NaN,1.8014118441681424,9.336394209360249
2018-07-05T09:30:00-04:00,84.31,84.875,84.11,84.79,7458631,7596431.2,57.2280235769095,52.497035377284014,NaN,NaN,11.968066720324789,-78.21705603157555,-0.11551013815023883,0.10399461666334275,0.2195047548135816,708104406,695281163.8,72.05451079629013,69.80091101182538,NaN,NaN,3.665688903816126,8.526293451425374
2018-07-06T09:30:00-04:00,85.2,86.155,85.1,86.01,9823810,7717341.95,64.98494922077964,52.531325363016485,NaN,NaN,132.02721244018576,-22.35757071084354,0.022449060127192028,0.24756607997257163,0.2251170198453796,717928216,702511821,76.40698679720659,69.85662732947857,NaN,NaN,8.073595365197498,8.461622296249963
2018-07-09T09:30:00-04:00,86.35,86.805,86.32,86.64,7874410,7798705.9,68.19284692527589,53.37687686131759,NaN,NaN,189.59240923932703,32.574660546802896,0.14589517537274754,0.40748598906131406,0.2615908136885665,725802626,710020740.8,79.9068911933452,70.24692590936739,NaN,NaN,12.872719856658549,9.091779090594047
2018-07-10T09:30:00-04:00,86.81,87.0072,86.58,86.97,6123152,7751144.65,69.75586839401049,54.22427841929119,NaN,NaN,183.31711769113068,92.06031081581224,0.23429569823132734,0.5544604364777257,0.32016473824639835,731925778,716881360.2,82.466182888627,70.74594769896876,NaN,NaN,17.264549390962095,10.25931770493234
2018-07-11T09:30:00-04:00,86.5,86.59,86.22,86.28,6434456,7731409.15,62.80622285378318,54.484751184686836,NaN,NaN,124.22753713473975,128.2264686451416,0.230468196861073,0.6082499843227396,0.3777817874616666,725491322,721850469.6,84.0507572813271,71.31867548037052,NaN,NaN,18.706683302550164,11.466084218877743
2018-07-12T09:30:00-04:00,86.71,87.295,86.66,87.24,4461646,7435532.4,67.63719842018067,55.432919004026964,NaN,NaN,155.01066072923123,156.83498744692287,0.27380846226398436,0.720042365291647,0.44623390302766264,729952968,726220182,85.30815182620356,72.27534949914823,NaN,NaN,21.64002498175718,12.919504327860519
2018-07-13T09:30:00-04:00,87.05,87.59,87,87.4,6048678,7268977.5,68.374483783806,56.227007912538355,NaN,NaN,150.2612163932598,160.4817882375377,0.29276240583462687,0.8121869103209463,0.5194245044863194,736001646,729834868,86.2722749165575,73.22962533494773,NaN,NaN,24.175154449198352,14.527454345194496
2018-07-16T09:30:00-04:00,87.47,87.47,86.745,86.87,5388542,7070051.35,63.23534917470957,57.156887546879226,NaN,NaN,113.46701956107795,145.25671030188786,0.25073642550364983,0.8328450363658817,0.5821086108622319,730613104,730796963.6,86.52572577644196,74.15481651887583,NaN,NaN,24.624836228739905,15.969937471415268
2018-07-17T09:30:00-04:00,86.84,87.4752,86.8,87.35,5849313,6995386.75,65.74638223712965,58.4177560104758,NaN,NaN,106.15554642889205,129.82439604944014,0.23657684300552817,0.8778296646191421,0.641252821613614,736462417,731704291.4,86.77373234047148,75.29213722902716,NaN,NaN,25.80111425824716,17.37439129810554
2018-07-18T09:30:00-04:00,87.37,87.44,87.11,87.42,7575723,7052588.05,66.10990884868205,60.08443533323806,NaN,NaN,98.04053139271566,124.58699490103534,0.21392119887432715,0.9086543202065229,0.6947331213321958,744038140,735413655,87.7651915259648,77.0196200243051,NaN,NaN,26.846765478947827,18.72758760965444
2018-07-19T09:30:00-04:00,87.21,87.39,86.553,86.93,5204046,7017750.7,61.21264366959494,61.32726968289767,NaN,NaN,71.83562748270037,107.95198825172915,0.15090257278767139,0.883361337316785,0.7324587645291136,738834094,737189880.2,88.22054235650322,78.87559108277767,NaN,NaN,26.250577083493553,19.802300391631455
2018-07-20T09:30:00-04:00,86.69,86.89,86.51,86.76,4822554,6887706.95,59.56406780763208,62.33489391170986,NaN,NaN,55.25104463707015,88.94995390049124,0.08596646701887456,0.8399168483027069,0.7539503812838323,734011540,736791859,87.43525536833083,80.85525177618577,NaN,NaN,25.275816365549904,20.584231245048375
2018-07-23T09:30:00-04:00,86.71,87.05,86.61,86.94,3824739,6584662.95,60.7688461425272,63.24941643366325,NaN,NaN,56.85708175317489,77.62796633891064,0.04537282746789262,0.810666415618698,0.7652935881508054,737836279,738236494,87.85772486633803,82.67675868568661,NaN,NaN,24.80285540996944,21.1868918400371
2018-07-24T09:30:00-04:00,87.4,87.88,87.34,87.73,6467139,6411762.7,65.61158566222954,64.37345547980362,NaN,NaN,85.82068309219521,73.56099367157125,0.06098992089038602,0.8415309892637879,0.7805410683734019,744303418,739804694.2,88.3169503399993,84.24006273382902,NaN,NaN,25.823990841016027,21.84933455446266
2018-07-25T09:30:00-04:00,87.68,88.87,87.59,88.85,9297528,6598631.7,71.06490104374072,65.36180387029155,NaN,NaN,113.93344992913973,76.73957737885605,0.13194095960767005,0.9454672678829894,0.8135263082753194,753600946,741717255.4,88.86982467058083,85.44115658199262,NaN,NaN,28.561173058898405,22.80816862652491
2018-07-26T09:30:00-04:00,88.7,88.91,88.41,88.6,5763060,6515760.9,68.45536891206135,65.6096909910974,NaN,NaN,119.51044934506903,86.27454175132979,0.14612395298243697,0.9961812495033655,0.8500572965209285,747837886,743518013.8,89.37943992050732,86.3677603765141,NaN,NaN,29.94441495908426,23.827632388319103
2018-07-27T09:30:00-04:00,88.64,88.64,87.64,87.96,5743036,6351565.4,62.16234303677084,65.17894071334703,NaN,NaN,91.02376645327988,93.42908611457173,0.09876040443174483,0.9735078020606096,0.8747473976288648,742094850,745134675.8,89.82965948945633,87.07652954052205,NaN,NaN,29.11062758222684,24.58234598744878
2018-07-30T09:30:00-04:00,87.89,88.18,87.75,88.01,5531205,6303970.8,62.45274855664437,64.6572892963923,NaN,NaN,84.40385469426903,98.93844070279056,0.059112644331720365,0.9486382030435152,0.8895255587117948,747626055,747092631,90.36251430833757,87.64055321335852,NaN,NaN,28.535212652476076,25.14704122530982
2018-07-31T09:30:00-04:00,88.33,89.05,88.2,88.93,6719131,6171694.65,67.40927234476058,64.98607854574784,NaN,NaN,136.62202003815753,109.09870809198303,0.08176602989984838,0.9917330960866053,0.9099670661867569,754345186,749100984.6,90.88977410952599,88.12905441537272,NaN,NaN,29.590517835779846,25.78182359823411
2018-08-01T09:30:00-04:00,88.88,89.28,88.88,88.95,5733043,6307192.1,67.50968300992932,64.97697030215845,NaN,NaN,150.62938165701397,116.43789443755789,0.084658779936986,1.0157905411079895,0.9311317611710035,760078229,750396441.2,91.22332218823071,88.55156658408895,NaN,NaN,30.456118659226295,26.449580035518707
2018-08-02T09:30:00-04:00,88.57,89.465,88.53,89.28,5666184,6217569.75,69.19608214629037,65.03565589947877,NaN,NaN,138.0005187924946,120.13590832704298,0.09460482501270828,1.0493877924368888,0.9547829674241806,765744413,753977746.6,92.08596397842756,88.96683008850823,NaN,NaN,31.682656123477166,27.197162333798488
2018-08-03T09:30:00-04:00,89.35,89.875,89.23,89.81,5884770,6020617.75,71.73367736535806,65.64267934166796,NaN,NaN,159.34711246597317,133.80057752958163,0.12099825988640234,1.1060307922821835,0.9850325323957811,771629183,759884613.2,93.2622564172607,89.44801084856672,NaN,NaN,33.50971138171169,28.098955054928947
2018-08-06T09:30:00-04:00,89.76,90.1699,89.4434,89.97,4751412,5864467.85,72.4709637186015,66.12300659034452,NaN,NaN,151.08427215713303,147.13666102215444,0.1324286974551767,1.1505684042147521,1.0181397067595754,776380595,765635521.2,94.17069939974272,89.97636563851468,NaN,NaN,35.228676097033414,29.117486632372444
2018-08-07T09:30:00-04:00,89.98,90.28,89.86,89.98,5170584,5816839.45,72.51920966201656,66.58081379129698,NaN,NaN,142.5333583967652,148.318928693876,0.1240069344076642,1.1731483747691556,1.0491414403614914,781551179,771076719.8,94.87480304934533,90.48419503304184,NaN,NaN,36.64638700700147,30.19304382874802
2018-08-08T09:30:00-04:00,89.99,90.25,89.79,90.12,5020356,5746134.45,73.22664271562354,67.43895658029902,NaN,NaN,126.41217410689251,143.4754871838517,0.11159733875890976,1.1886381138101285,1.0770407750512188,786571535,776375381,95.4510251801739,91.00065809187548,NaN,NaN,38.03604375461002,31.31347238958545
2018-08-09T09:30:00-04:00,90.13,90.38,89.925,90.02,5680303,5807067.3,71.80475281961503,68.31329122401209,NaN,NaN,115.15315195127548,138.90601381560788,0.08176818617756476,1.1792510077731748,1.09748282159561,780891232,779404744.8,95.74553152044075,91.59424924559762,NaN,NaN,38.843811960503984,32.389235185430955
2018-08-10T09:30:00-04:00,89.69,90.16,89.32,89.63,5389456,5774106.2,66.39034388611614,68.71482677712558,NaN,NaN,80.44596478710439,123.12578427983412,0.023890997508995593,1.1273465684818547,1.103455570972859,775501776,780179263.4,95.82004213134584,92.16298619309818,NaN,NaN,38.11228371795138,33.20681354721959
2018-08-13T09:30:00-04:00,89.73,90.085,89.425,89.66,6563902,5832874.2,66.59898450583853,68.78535526595479,NaN,NaN,74.60013460529943,107.8289567694674,-0.021783172543328844,1.076226605293698,1.0980097778370268,782065678,781316280,95.93265889596141,92.70696537566688,NaN,NaN,37.551435098439065,33.82747376882237
2018-08-14T09:30:00-04:00,89.79,90.24,89.7,90.08,5497737,5815295.4,69.45756949334739,68.67054586949813,NaN,NaN,85.47049530027725,96.41638415016982,-0.03247587432620569,1.0574149349292696,1.0898908092554753,787563415,782518727.2,96.05374658915763,93.22010265556523,NaN,NaN,37.80089564774667,34.39510546581156
2018-08-15T09:30:00-04:00,89.8,90.04,89.36,89.93,6829302,5777974.35,67.24410624555189,68.5840271076046,NaN,NaN,63.77535327343623,83.88901998347855,-0.05698438969443176,1.0186603221374355,1.0756447118318673,780734113,781351242.8,93.15399594640813,93.48971380027244,NaN,NaN,37.42785937773405,34.82835602465763
2018-08-16T09:30:00-04:00,90.19,90.93,90.08,90.81,6916702,5863607.15,72.73385606083399,69.33913518075197,NaN,NaN,113.73325383262039,83.60504035974755,-0.023005539804100694,1.0468877870767415,1.0698933268808422,787650815,782703159.4,93.40237637861813,93.744907863784,NaN,NaN,38.68060007655014,35.378676603499414
2018-08-17T09:30:00-04:00,90.74,91.3749,90.53,91.09,5455285,5895243.7,74.21465497884029,70.17927135376597,NaN,NaN,133.0706064527596,94.12996869287858,0.007612666071238117,1.0794091594698898,1.0717964933986517,793106100,786224024.2,94.0117253325915,94.00556579408784,NaN,NaN,40.17829187823233,36.06433592846126
2018-08-20T09:30:00-04:00,91.3,91.56,91.25,91.39,8144869,6111250.2,75.73519243749332,70.7739799318183,NaN,NaN,156.62413673029863,110.53476911787843,0.035778430908816716,1.1165195320346726,1.0807411011258559,801250969,790061082.4,94.59734966757695,94.27039261966293,NaN,NaN,41.90278465993953,36.89840003295816
2018-08-21T09:30:00-04:00,91.62,91.66,91.195,91.39,6395926,6107689.55,75.73519243749332,71.36151631950145,NaN,NaN,151.4345700734793,123.72758407251884,0.04170371185451538,1.132870740944,1.0911670290894846,801250969,792798593.2,94.97492376728572,94.53836416102399,NaN,NaN,43.30651054672534,37.81384439206776
2018-08-22T09:30:00-04:00,91.18,91.68,91.07,91.48,3954306,5840528.45,76.22302567521527,71.86344085728179,NaN,NaN,137.19702475406584,138.41191836864476,0.03902701389682095,1.1399507964605107,1.1009237825636897,805205275,797692825.6,95.57089432784247,94.7872877574108,NaN,NaN,44.61873588103957,38.78597174763516
2018-08-23T09:30:00-04:00,91.43,91.67,91.23,91.45,6058378,5855294.35,75.67686416339046,72.14509705714124,NaN,NaN,125.57415979859974,140.78009956184061,0.023352009023318798,1.1301137938428383,1.1067617848195195,799146897,799992042,95.82160432944005,94.97009832256647,NaN,NaN,45.5791927113408,39.75643188530739
2018-08-24T09:30:00-04:00,91.66,91.89,91.485,91.89,4029139,5769599.5,78.14976716745936,72.55072587491681,NaN,NaN,133.63335673649433,140.89264961858757,0.030292704893331912,1.1446276659361843,1.1143349610428523,803176036,802006029.2,96.03340855923946,95.10314897681623,NaN,NaN,47.13615074706825,40.81067743698752
2018-08-27T09:30:00-04:00,92.22,92.29,91.83,92.22,4671309,5726604.7,79.80788459311933,73.07134551285272,NaN,NaN,140.57897592960958,137.68361745844976,0.04395565488202169,1.1692795296453795,1.1253238747633578,807847345,803325304.4,96.17035384620618,95.19568831944915,NaN,NaN,48.97863670494967,41.97752876098211
2018-08-28T09:30:00-04:00,92.36,92.39,92.07,92.27,4954106,5638353.45,80.05485064276067,73.55907465050537,NaN,NaN,131.97276200171345,133.79125584409658,0.0431466194074992,1.1792571490227317,1.1361105296152325,812801451,805635400.8,96.40443991019409,95.26378937159345,NaN,NaN,50.58223416439359,43.206772390040896
2018-08-29T09:30:00-04:00,92.29,92.965,92.19,92.87,5338515,5618627.05,82.77709859662122,74.34281363457724,NaN,NaN,143.97976207734638,135.1478033087527,0.06831061001643479,1.221498792135776,1.1531881821193413,818139966,808222339,96.65129094981012,95.32848647369124,NaN,NaN,52.88281982546962,44.58906488081643
2018-08-30T09:30:00-04:00,92.8,93.11,92.6,92.8,5266116,5598623.65,81.38154098653798,75.41361342746451,NaN,NaN,138.16571583423618,137.66611451588,0.06552132376824238,1.2350898368296441,1.1695685130614017,812873850,810967729.6,96.89492775217727,95.40526401803636,NaN,NaN,54.390730189389004,45.98930278204109
2018-08-31T09:30:00-04:00,92.58,92.86,92.4,92.78,5808393,5594804.8,80.96155668404144,76.4395114401933,NaN,NaN,114.2858804900908,133.7966192665993,0.04839923096557586,1.2300675517683715,1.1816683208027956,807065457,811745613.8,96.96236450123219,95.47881441841284,NaN,NaN,55.52670504967306,47.35178882027422
2018-09-04T09:30:00-04:00,92.7,92.76,91.82,92.04,6875469,5701007.65,67.15271810875069,76.27487919843638,NaN,NaN,74.03605754819756,120.4880355903169,-0.022867848501445298,1.153083510175989,1.1759513586774344,800189988,810214142.4,92.69405952737489,95.23883677114266,NaN,NaN,52.43775210768325,48.078355004189795
2018-09-05T09:30:00-04:00,91.97,92.41,91.795,92.41,10218935,5953425.2,69.91567006635077,76.46570518563631,NaN,NaN,68.09642242390038,107.71276767475429,-0.05344629128801204,1.1091434945674195,1.1625897858554315,810408923,809735636.8,91.34111076143984,95.10934497221635,NaN,NaN,50.59284853388918,48.43756836557542
2018-09-06T09:30:00-04:00,92.4,92.6,91.85,92.41,5940322,5999423.5,69.91567006635078,76.26440618603036,NaN,NaN,69.18474512241171,92.75376428376734,-0.08040963307742044,1.062077744508656,1.1424873775860764,810408923,808189428.2,86.92596822906293,94.64674439010525,NaN,NaN,49.112199026996905,48.53394417434992
2018-09-07T09:30:00-04:00,92.19,92.64,92.05,92.55,5591062,5994961.45,70.98661698481864,76.03383204360024,NaN,NaN,72.325608418309,79.58574280058191,-0.0945758939130863,1.0242675101947185,1.1188434041078048,815999985,808814655.2,87.19549113971387,94.15987051918543,NaN,NaN,48.16287747597057,48.48093464601001
2018-09-10T09:30:00-04:00,92.78,92.95,92.22,92.31,4233993,5937188.3,66.60908848152917,75.38196747531708,NaN,NaN,72.21582867240603,71.17173243704497,-0.12401372818371614,0.9638262438781595,1.0878399720618757,811765992,809754762.2,87.60912158074265,93.66071137012582,NaN,NaN,46.08966120535493,48.13932415448786
2018-09-11T09:30:00-04:00,92.15,92.41,91.84,92.23,5683869,5893186.65,65.16650692894002,74.62706136756329,NaN,NaN,38.4706130947618,64.0586435463578,-0.15098683032490823,0.8991064341557404,1.0500932644806487,806082123,810933189.2,88.12687695785165,93.17156516945197,NaN,NaN,43.95403351693392,47.541425491980156
2018-09-12T09:30:00-04:00,92.29,92.86,92.11,92.69,11056597,6171129.65,69.28559868406002,74.13153086819504,NaN,NaN,71.29412583307337,64.6981842281924,-0.14019544354264135,0.874848960052347,1.0150444035949884,817138720,812279148.6,88.70728681440663,92.68130748992084,NaN,NaN,43.18209846901881,46.91866448869997
2018-09-13T09:30:00-04:00,93.09,93.84,93,93.84,10603828,6359855.95,76.70270662856896,74.2048053299935,NaN,NaN,181.00244382950856,87.06172396961179,-0.06194598724127065,0.9376119195434001,0.9995579067846707,827742548,815745873.6,90.05568128088514,92.26945584359548,NaN,NaN,44.9814888991437,46.64192511876336
2018-09-14T09:30:00-04:00,93.92,93.92,93.36,93.53,5929022,6310471.95,71.67782429754192,73.74252369642798,NaN,NaN,179.88777796240353,108.5741578784307,-0.03854968738420228,0.9513707975544179,0.9899204849386202,821813526,816908581.8,90.46682372514925,91.87184264116048,NaN,NaN,44.72438170556175,46.367990345448845
2018-09-17T09:30:00-04:00,93.53,93.54,93.075,93.19,5543053,6314860.35,66.52987983955438,72.79409478545905,NaN,NaN,122.88943467345172,118.70887907863982,-0.05258742338244082,0.9241862057105692,0.97677362909301,816270473,817809478,90.7847405755335,91.48715597896957,NaN,NaN,42.78097036242768,45.855558919302965
2018-09-18T09:30:00-04:00,93.19,93.97,93.05,93.73,5423032,6178768.5,70.19161560874042,72.08957799731475,NaN,NaN,144.6667832223564,139.94811310415872,-0.033072804984925375,0.9354326228618532,0.9685054278467786,821693505,820931754.4,91.80478179123641,91.1586089704726,NaN,NaN,42.37304608485627,45.35805708581058
2018-09-19T09:30:00-04:00,93.67,93.865,93.5,93.6,4186602,6068302.3,68.25562843220399,71.05233012842781,NaN,NaN,135.45845419574343,152.78097877669273,-0.03623366455738031,0.9232133471500532,0.9594470117074335,817506903,821005391,91.82775694854388,90.814070827525,NaN,NaN,41.42216349809226,44.79578657327939
2018-09-20T09:30:00-04:00,93.87,94.57,93.8144,94.51,5083129,6124743.45,73.71984478724572,70.50506611419264,NaN,NaN,180.63470345733072,152.70743070225717,0.01301157727865998,0.9757114833057585,0.9626999060270985,822590032,819974887.8,88.10521263872776,90.18623403370718,NaN,NaN,42.48390452564814,44.46551770933207
2018-09-21T09:30:00-04:00,94.39,94.48,94.07,94.27,8623345,6252991.8,70.2837086987084,69.74236268666887,NaN,NaN,150.40155585038042,146.81018627985253,0.019102461844794694,0.9865779833330919,0.9674755214882972,813966687,818405520,82.61267951516425,89.16125653470233,NaN,NaN,42.16095004607425,44.1362937574381
2018-09-24T09:30:00-04:00,94.21,94.65,94.075,94.46,5392620,6321165.85,71.4194604356976,70.0471299957365,NaN,NaN,138.48320104454137,149.9289395540705,0.025223794146347123,0.999005264171231,0.9737814700248839,819359307,819023286.8,83.06035156901675,88.47313453767676,NaN,NaN,42.27067075699942,43.869776185946854
2018-09-25T09:30:00-04:00,94.59,94.73,94.07,94.17,5199261,6347563.45,67.19789475783264,69.8530031879852,NaN,NaN,114.77679833435614,143.95094257647045,0.000353351382731959,0.9742231592532988,0.9738698078705669,814160046,817516595,77.79912980835383,87.5058501838849,NaN,NaN,41.01933708210325,43.46257059968348
2018-09-26T09:30:00-04:00,94.35,95.12,94.1801,94.38,10880503,6643883.3,68.64331174352678,69.76212045064062,NaN,NaN,120.68014671864151,140.99528108105008,-0.010730359325597294,0.9604568587135702,0.9711872180391675,825040549,819023324.2,79.21687797319618,86.9552008798944,NaN,NaN,40.436825037224125,43.03032123361786
2018-09-27T09:30:00-04:00,94.51,95.12,94.4,94.86,7168813,6735398.2,71.71166557816086,69.81390963587936,NaN,NaN,124.28148752209499,129.7246378940029,0.004663438845428081,0.9770165165959526,0.9723530777505245,832209362,820947190.2,80.89456279262473,86.50513456938803,NaN,NaN,40.899717918539395,42.725949331463795
2018-09-28T09:30:00-04:00,94.67,95.21,94.63,95.15,5995812,6771883,73.4049045246792,70.29932506753293,NaN,NaN,124.43002659412163,124.53033204275116,0.023709873244491808,1.0019904193061393,0.9782805460616475,838205174,825794887.6,84.32761265083653,86.27074107439475,NaN,NaN,41.81431623508667,42.59571603198135
2018-10-01T09:30:00-04:00,95.51,96.06,95.34,95.62,7307132,6846819.95,75.92051088181637,71.0674682070241,NaN,NaN,157.23282752903538,128.28025733964995,0.055480403594054706,1.047631050554216,0.9921506469601612,845512306,831025487.4,87.0347211661672,86.19272994641729,NaN,NaN,43.406061330814126,42.711479646100315
2018-10-02T09:30:00-04:00,95.62,95.7,95.33,95.51,5572670,6781680,74.1526530600447,71.41511494816586,NaN,NaN,128.4598667614231,131.01687102506335,0.05641999100288997,1.0626756357137737,1.0062556447108837,839939636,836181405.4,89.0436931768264,86.2167589723044,NaN,NaN,44.15600910049686,42.917840996728394
2018-10-03T09:30:00-04:00,95.83,96,95.18,95.33,6367826,6589124.55,71.22975178461967,71.02418960216949,NaN,NaN,114.32795053873204,129.74643178908144,0.0333902569071991,1.0479934658448826,1.0146032089376835,833571810,837887657.6,89.61706214646452,86.1854290341315,NaN,NaN,43.917643393725946,43.06066991058519
2018-10-04T09:30:00-04:00,95.26,95.295,93.9144,94.4,10976848,6840950.85,58.417498014252836,70.07702343907741,NaN,NaN,40.139065815202095,112.91794744770284,-0.05139507784135544,0.9503593616359893,1.0017544394773448,822594962,835964777.6,84.26511913716624,85.74245013498987,NaN,NaN,39.464109194206756,42.54687552253113
2018-10-05T09:30:00-04:00,94.48,94.97,93.7,94.29,12291090,7175952.25,57.10902942824508,69.40410555255531,NaN,NaN,18.188012079966104,91.66954454487174,-0.11799541521665413,0.8542601704565271,0.9722555856731813,810303872,830384517.2,71.01144999794712,84.33007223659084,NaN,NaN,35.507900767576885,41.54130770039481
2018-10-08T09:30:00-04:00,94.17,94.52,93.46,94.25,11924047,7560454.95,56.612455028572356,68.43416551111474,NaN,NaN,-10.063873822198888,58.21020427462489,-0.16497027691674448,0.7660427395272507,0.9310130164439951,798379825,820958021,55.213122597804954,81.71638229420287,NaN,NaN,32.188945059128386,40.20525589449961
2018-10-09T09:30:00-04:00,94,94.74,93.71,94.41,7463876,7649455.3,58.17891575050521,67.71440031956482,NaN,NaN,-0.23024557363973458,32.47218180761233,-0.1840422374049897,0.700960219687758,0.8850024570927477,805843701,814138834,47.05715674583872,78.51848227972394,NaN,NaN,29.862828881871422,38.72776632126701
2018-10-10T09:30:00-04:00,94.4,94.51,92.12,92.18,22549315,8224091.2,37.73181634027375,65.14382685906682,NaN,NaN,-165.09864008033992,-23.41313631620207,-0.3367301633362061,0.4640897529224901,0.8008199162586962,783294386,804083349.2,38.11597004702111,74.94782209460205,NaN,NaN,19.167523941565275,35.93344598130962
2018-10-11T09:30:00-04:00,91.93,92.14,89.04,89.69,46582163,10023007.95,26.52285223628519,62.018051397465165,NaN,NaN,-338.23703309451906,-99.0883560981463,-0.580986950890366,0.07458622764573875,0.6555731785361048,736712223,786906801.4,28.243841566159034,71.06433366967309,NaN,NaN,3.60675649934527,31.31534748388614
2018-10-12T09:30:00-04:00,90.77,91.41,90.02,91.07,20797355,10766424.6,37.58871573085454,59.60156963283352,NaN,NaN,-223.37747044175472,-147.40145260249045,-0.6215344367503371,-0.12134486740181671,0.5001895693485204,757509578,776347942.6,24.109894468789406,66.85358673394256,NaN,NaN,-3.1362817480043415,26.39368616504464
2018-10-15T09:30:00-04:00,90.92,91.32,90.37,90.44,13909713,11184757.6,34.997429914040424,57.3015364297055,NaN,NaN,-187.5763027709602,-182.90393839224274,-0.6591322141716996,-0.3237256983661041,0.33540651580559555,743599865,765391950.6,20.720911331896687,62.77657112848134,NaN,NaN,-9.054902725233212,21.32960203786209
2018-10-16T09:30:00-04:00,91.14,93.08,91.13,92.92,13505912,11588901.6,49.69812366137545,55.94830870955183,NaN,NaN,-79.36391657625843,-198.73067259276647,-0.49293500375152427,-0.2807622388838098,0.21217276486771447,757105777,755644365.8,18.26145320907935,58.42261221675871,NaN,NaN,-7.241677419614994,17.247990686793937
2018-10-17T09:30:00-04:00,92.86,93.64,92.39,93.41,14232285,12091185.75,52.00757633736081,54.540873763780404,NaN,NaN,-34.537433604059736,-172.61843129751043,-0.3335890279284838,-0.20481352004289022,0.12877550788559353,771338062,753253101,17.706224543859264,53.909159484704034,NaN,NaN,-4.994525066004592,14.070488436394147
2018-10-18T09:30:00-04:00,93.36,93.37,91.61,92.35,14455855,12559822.05,46.98236610434062,52.65354959089908,NaN,NaN,-63.634861057187514,-117.69799689004412,-0.28504751462443306,-0.2275338853949478,0.05751362922948526,756882207,757287097.8,22.013931330325903,49.458182247524704,NaN,NaN,-5.309724529245483,11.301886584159915
2018-10-19T09:30:00-04:00,92.51,92.83,91.39,91.51,11318605,12694585.05,43.40330947611926,50.33089234763501,NaN,NaN,-79.56437148791562,-88.9353770992763,-0.293811151141684,-0.30975030969761974,-0.01593915855593575,745563602,754897902.6,21.30269415746612,44.763037461188915,NaN,NaN,-6.934612285224627,8.696672459962123
2018-10-22T09:30:00-04:00,91.5,91.67,90.34,90.76,8288278,12839367.95,40.44105208838634,47.922920849659405,NaN,NaN,-109.69103208781921,-73.3583229626481,-0.33161989628530514,-0.4304640289125672,-0.09884413262726205,737275324,753632994.4,20.917378939694274,39.89687215853663,NaN,NaN,-9.287933014552225,6.127443106460074
2018-10-23T09:30:00-04:00,89.6,90.71,88.88,90.27,15424486,13350629.2,38.5880647799953,45.59137177790053,NaN,NaN,-131.7927491739552,-83.84408948218746,-0.3683031345062103,-0.5592230507600249,-0.1909199162538146,721850838,746582006.6,18.868592150460557,34.84341001596493,NaN,NaN,-11.755442415086897,3.572745174810507
2018-10-24T09:30:00-04:00,90.23,90.75,87.18,87.29,17432153,13678211.7,29.68101917032496,43.53876614619139,NaN,NaN,-164.9393426210391,-109.92447128558334,-0.5604244763913275,-0.8914505117429741,-0.3310260353516465,704418685,733198131.2,15.720952778030863,29.947398133169543,NaN,NaN,-17.62253102827224,0.544848574370115
2018-10-25T09:30:00-04:00,87.28,89.03,86.27,88.42,15725063,14106024.2,35.73832601882255,42.012287331232635,NaN,NaN,-157.35327849772,-128.66815477368982,-0.5763321730750889,-1.0514412516955076,-0.47510907862041873,720143748,725850439.4,14.309626286289657,25.897267868051152,NaN,NaN,-19.825404544674303,-2.365187585493373
2018-10-26T09:30:00-04:00,87.6,88.22,86.35,87.42,25507931,15081630.15,33.02699635672326,40.32761171181484,NaN,NaN,-152.25938871276594,-143.20715821865988,-0.6155767093550264,-1.2445799653142018,-0.6290032559591754,694635817,715664882.4,12.618503921986132,22.854795105492673,NaN,NaN,-22.549167033517797,-5.248613220925433
2018-10-29T09:30:00-04:00,88.43,89.08,86.41,87.64,14024311,15417489.1,34.20954328530915,38.615513678586545,NaN,NaN,-124.07567254634286,-146.0840863103646,-0.5881304874472912,-1.3641663652682894,-0.7760358778209981,708660128,709941843.2,11.776363408471568,20.334738438537876,NaN,NaN,-24.19466391773426,-7.955191891898123
2018-10-30T09:30:00-04:00,87.65,88.72,87.2,88.58,15432052,15910458.2,39.15317790169917,38.71703950440265,NaN,NaN,-99.18939486070686,-139.56341544771493,-0.4730333803311654,-1.3673276032349548,-0.8942942229037895,724092180,710390111.6,12.270241448124196,18.488614967188095,NaN,NaN,-23.860619996201322,-10.227395906798579
2018-10-31T09:30:00-04:00,89.29,89.65,88.63,88.7,13460681,16265100.95,39.77532914633125,39.66364499797737,NaN,NaN,-67.40661760622079,-120.05687044475128,-0.3602843225621247,-1.3446496261064453,-0.9843653035443206,737552861,717016946.8,19.449137788313067,17.8604218401991,NaN,NaN,-23.40380426981228,-12.109739958657679
2018-11-01T09:30:00-04:00,89,89.97,88.97,89.82,9668637,16199690.4,45.38797703638941,40.22073509122986,NaN,NaN,-42.88539848748882,-97.16329444270505,-0.19027864388499593,-1.2222136084005655,-1.0319349645155695,747221498,722432496.8,24.86042476825763,17.914031147303977,NaN,NaN,-21.208757471701336,-13.4095996033782
2018-11-02T09:30:00-04:00,90.69,90.84,88.67,89.26,12952987,16232785.25,43.21915307690885,40.80800103143475,NaN,NaN,-36.92087494943461,-74.09559169003879,-0.10007759475991085,-1.157031957965458,-1.0569543632055471,734268511,730359035.6,32.0551261516939,18.723617920146634,NaN,NaN,-20.0797355079771,-14.362476161178044
2018-11-05T09:30:00-05:00,89.38,90.45,89.38,90.05,7783769,16025771.35,47.06217875792392,40.619719252616775,NaN,NaN,-16.985749244273986,-52.677607029624994,0.021756913825150992,-1.0297582209241085,-1.0515151347492595,742052280,737037466,37.48631191100277,20.09682211314116,NaN,NaN,-17.937563048285252,-14.873202859336217
2018-11-06T09:30:00-05:00,89.93,90.605,89.8,90.51,7980944,16051624.75,49.21744721522374,40.42042431532127,NaN,NaN,6.182082571878282,-31.603311543107974,0.13592247822836656,-0.8816120369638014,-1.017534515192168,750033224,742225674.8,41.404877766652724,21.789583057626405,NaN,NaN,-15.522377406947447,-14.965942080423536
2018-11-07T09:30:00-05:00,91.35,93.25,91.29,93.17,13310811,15589699.55,59.488635103907825,41.31372924386179,NaN,NaN,115.36363455374922,4.950738888886031,0.3793856150315609,-0.5433024964027169,-0.9226881114342778,763344035,747383909.6,45.09015839132599,23.437884990554988,NaN,NaN,-9.658973196142354,-14.207803668383367
2018-11-08T09:30:00-05:00,93,93.555,92.87,93.22,7345597,13627871.25,59.65382427425306,42.47448030087134,NaN,NaN,125.98839514182148,38.72549761474809,0.5236984262472631,-0.2680650786251988,-0.7917635048724619,770689632,752077536.4,48.277860376384936,25.36468257762062,NaN,NaN,-5.0789005829766865,-12.903674656182412
2018-11-09T09:30:00-05:00,93.11,93.26,92.5,92.95,8486522,13012329.6,58.272030315312385,43.74812160279463,NaN,NaN,100.62234396085098,66.23414139680521,0.5766853511478177,-0.07090681593768977,-0.6475921670855075,762203110,757664456.2,51.86030450782253,27.57489154677264,NaN,NaN,-1.802091815746312,-11.317734250405827
2018-11-12T09:30:00-05:00,92.81,92.95,91.48,91.69,8423548,12738021.35,52.195827637517624,44.720104664046225,NaN,NaN,60.49383906671914,81.73005905900384,0.5051594478762481,-0.016142857240197372,-0.5213023051164455,753779562,760009912.6,53.32199310243314,30.03584875762783,NaN,NaN,-0.8058185237505097,-9.816032003740782
2018-11-13T09:30:00-05:00,92,92.365,90.78,91.05,14226950,12774073.25,49.37931763369656,46.12712598285849,NaN,NaN,38.83704533201009,88.2610516110302,0.3977564131631504,-0.024106788662507483,-0.4218632018256579,739552612,757913790.2,51.80800539187257,32.61349537290223,NaN,NaN,-0.837762930440762,-8.533422136126493
2018-11-14T09:30:00-05:00,91.61,91.62,89.891,90.32,11664016,12645659.8,46.309761209567476,46.882228496483116,NaN,NaN,13.640671687688991,67.91645903781816,0.2668463750057749,-0.08830523306843929,-0.3551516080742142,727888596,750822702.4,46.951272187712924,34.945041508718184,NaN,NaN,-1.7966648058362784,-7.571028231799319
2018-11-15T09:30:00-05:00,89.68,91.23,88.83,91.12,15563868,12701060.45,49.97946239412762,48.09311892772629,NaN,NaN,9.290354590140318,44.57685092748192,0.22509795178954584,-0.07377916833728193,-0.29887712012682777,743452464,745375268.8,43.57203277220808,37.156007855162606,NaN,NaN,-1.505709195746082,-6.704554083791714
2018-11-16T09:30:00-05:00,90.96,92.48,90.91,92.04,11323185,12701289.45,53.88317046704556,49.49837801213603,NaN,NaN,75.68147871546365,39.58867787840446,0.24856789869527002,0.011832753242259741,-0.23673514545301028,754775649,743889776.6,42.670132123503684,39.36270562052204,NaN,NaN,-0.06744863932815792,-5.756396163154063
2018-11-19T09:30:00-05:00,92.13,92.19,90.47,90.87,8820959,12727923.5,48.68006266432687,50.17886978089516,NaN,NaN,45.12815767558493,36.51554160017762,0.1777396692044358,-0.014560558947465552,-0.19230022815190134,745954690,742324802.2,41.69105851339325,41.464192553755545,NaN,NaN,-0.43919640268940713,-4.996796197373398
2018-11-20T09:30:00-05:00,90.3,90.97,89.81,90.02,11604320,12536915.2,45.26067415194074,50.57068013843868,NaN,NaN,2.318181253189907,29.21176878441359,0.07153665019799935,-0.10287941540440215,-0.1744160656024015,734350370,741284353.8,41.01722039373395,43.004769882714186,NaN,NaN,-1.818598775892175,-4.542767994304652
2018-11-21T09:30:00-05:00,90.31,90.32,89.485,89.51,9345117,12132563.4,43.29560834085873,50.42122523161506,NaN,NaN,-25.227725852866506,21.438089276302485,-0.029736304602953928,-0.21158644635609392,-0.18185014175314,725005253,740707685.2,40.625298379116906,44.130832283489845,NaN,NaN,-3.5539965452994213,-4.401514930161048
2018-11-23T09:30:00-05:00,89.03,90.18,88.98,89.64,3939469,11543283.7,43.963467968265604,50.474390580997685,NaN,NaN,-40.132881359461145,11.553442086382194,-0.08169921513828465,-0.2839741606759958,-0.20227494553771114,728944722,737806136.8,38.6254582630435,44.60014172001481,NaN,NaN,-4.7702196906576715,-4.454187038803423
2018-11-26T09:30:00-05:00,90.36,90.75,89.98,90.51,7141247,10624949.5,48.347934618647734,50.5662302853351,NaN,NaN,-6.39887920850245,-4.862629498411027,-0.05262028332491453,-0.2680502996938543,-0.21543001636893977,736085969,734068200.8,36.15619094289552,44.50513307943572,NaN,NaN,-4.554753005603593,-4.468553605489161
2018-11-27T09:30:00-05:00,90.21,91.45,89.88,91.45,9261963,10386832.1,52.65801408344354,50.81198506163651,NaN,NaN,15.264469104948272,-10.835367212538358,0.030316908311839252,-0.1775338809791407,-0.20785078929097994,745347932,733946849.2,36.07555923390958,44.12446746995408,NaN,NaN,-3.0843007414425845,-4.27080319633965
2018-11-28T09:30:00-05:00,91.72,93.68,91.7,93.65,11870393,10208749.15,60.884681914205586,50.9117026909435,NaN,NaN,129.69362256758413,14.639721050340455,0.22300486720892548,0.07090529472017693,-0.15209957248874856,757218325,738520440.2,41.38141035538959,43.85955689595862,NaN,NaN,1.0232549572533247,-3.514509174397797
2018-11-29T09:30:00-05:00,93.43,94.505,93.3,93.96,8796008,9975515.5,61.88963163338704,51.07140321659592,NaN,NaN,159.53845364944908,51.59295695080357,0.3532578017749621,0.28947267972995405,-0.06378512204500802,766014333,746722256.2,49.479669760852346,43.94540042342057,NaN,NaN,4.615257347065042,-2.353113957045963
2018-11-30T09:30:00-05:00,93.9037,95.87,93.8,95.87,15875944,10285880.85,67.44017920962506,51.726270994761116,NaN,NaN,190.7533089703116,97.77019501675811,0.5388527147163159,0.6097807713503869,0.07092805663407098,781890277,757311367.2,57.62014795368423,44.3568178124107,NaN,NaN,9.724821239398109,-0.6276946432682384
2018-12-03T09:30:00-05:00,95.81,95.81,94.86,95.41,12158136,10246138.3,64.9853717277544,52.63980985834945,NaN,NaN,168.27106411079788,132.7041836806182,0.5969296979501814,0.8170901790717977,0.22016048112161632,769732141,764040601.6,61.8293880435433,44.96448887963286,NaN,NaN,13.030625978222728,1.3234940169447567
2018-12-04T09:30:00-05:00,95.39,95.92,93.11,93.28,15011336,10607516.65,55.00187514510617,53.041421109164425,NaN,NaN,97.2863465430113,149.10855916823078,0.46410039974385375,0.8002859808014335,0.3361855810575798,754720805,765915176.2,62.93383205869909,45.75919078440618,NaN,NaN,12.587348175814359,2.932616039640414
2018-12-06T09:30:00-05:00,92.12,92.93,90.135,92.93,18492882,11133113.55,53.54618570932003,53.55830857343246,NaN,NaN,-1.6711381117044262,122.83560703237308,0.33111553700862084,0.7500800023183558,0.41896446530973497,736227923,761717095.8,58.82861685999105,46.60757254671176,NaN,NaN,11.764829361034474,4.194360799839566
2018-12-07T09:30:00-05:00,92.67,92.8,90.11,90.56,14930858,11214115.9,44.88366089080096,53.19432275176628,NaN,NaN,-38.20351988018536,83.28721232644618,0.07533809549381065,0.5131370846769983,0.4377989891831876,721297065,752773642.2,51.17067466176525,47.150332681680126,NaN,NaN,7.973933417898792,4.734299745276598
2018-12-10T09:30:00-05:00,90.61,91.25,88.65,90.91,15372051,11615438.6,46.26617040099687,52.650251318477096,NaN,NaN,-73.6353039081126,30.40948975076136,-0.07058274455100239,0.34957055849443464,0.420153303045437,736669116,743729410,44.817097582801814,47.30368735734429,NaN,NaN,5.469801160768227,4.839371376061116
2018-12-11T09:30:00-05:00,91.67,92.28,90.54,91.19,13632328,11872728.9,47.402815622595796,52.559019386924874,NaN,NaN,-19.74077652037485,-7.192878375473191,-0.1443045476275403,0.23977261851101161,0.3840771661385519,750301444,739843270.6,42.38203397596375,47.35304274752789,NaN,NaN,3.831370886470072,4.695371306119538
2018-12-12T09:30:00-05:00,92.2,93.17,91.91,91.97,12581032,12080603.1,50.54144350349289,52.936217197750025,NaN,NaN,29.041349423212534,-20.841877799432954,-0.13667104316068518,0.21323836218769543,0.3499094053483806,762882476,741475604.8,43.76418333571492,47.54925438624082,NaN,NaN,3.420289226537114,4.513216723322049
2018-12-13T09:30:00-05:00,92.22,92.725,91.44,92.06,11567208,11947616,50.90547834791517,53.479779341111204,NaN,NaN,14.007768245854077,-17.706096527921247,-0.1221684560388977,0.19719883529975846,0.31936729133865616,774449684,749119957,49.833342303510655,48.206971809411804,NaN,NaN,3.1951033193334912,4.324914808466541
2018-12-14T09:30:00-05:00,91.16,91.24,88.6926,88.96,19422740,12335552.2,39.98774861332021,53.195799387186526,NaN,NaN,-99.11130358267258,-29.88765326841868,-0.3074206115214495,-0.06490847306315572,0.24251213845829378,755026944,755865932.8,54.500094838860015,49.34087442197012,NaN,NaN,-0.7082058797465934,3.6058975672932365
2018-12-17T09:30:00-05:00,88.04,88.78,86.59,87.19,22089533,12661835.45,35.328752248882,52.265857789346114,NaN,NaN,-175.63473537121112,-50.287539561038386,-0.5225857790349426,-0.4107200853353845,0.11186569369955812,732937411,755119591.8,53.902664813667585,50.60847969845384,NaN,NaN,-5.67132705742636,2.2805797637618657
2018-12-18T09:30:00-05:00,87.94,88.1,85.6,86.43,24712567,13331304.55,33.52270352026754,50.8990498919764,NaN,NaN,-178.50758693526487,-82.04090164401639,-0.6795736101989306,-0.7376013190491051,-0.058027708850174525,708224844,746704271.8,47.57058606267329,51.429553043365544,NaN,NaN,-10.249955136762814,0.4905033494011972
2018-12-19T09:30:00-05:00,86.6,87.64,84.53,85.3,23075642,14044038.7,30.98628880831032,48.76345038441246,NaN,NaN,-176.87872052021876,-123.22491563270265,-0.8139311023929406,-1.0754415868413503,-0.26151048444840963,685149202,731157617,38.558804849810095,51.22793836439558,NaN,NaN,-14.886180758842707,-1.7061658089193603
2018-12-20T09:30:00-05:00,84.91,85.26,83.5,84.1,25321706,14729908,28.51856588322981,46.379802830829796,NaN,NaN,-188.609804338686,-163.74843014961067,-0.929673217630601,-1.4236020064866608,-0.49392878885605984,659827496,708233179.4,29.641734887865496,49.81094301632509,NaN,NaN,-19.56929896079766,-4.258041973473404
2018-12-21T09:30:00-05:00,83.85,85.27,82.51,82.68,28921621,15708733.2,25.890924070287426,43.41199889230568,NaN,NaN,-176.17106330300163,-179.16038209367647,-1.039601155019608,-1.7934302326305698,-0.7538290776109617,630905875,683408965.6,23.34570136287948,47.36276825983904,NaN,NaN,-24.39927777273984,-7.1353613733686085
2018-12-24T09:30:00-05:00,82.13,82.44,80.65,80.7,14235526,16223536.05,22.744123527396326,40.39476687799438,NaN,NaN,-185.37898801413948,-181.10923262226214,-1.1734907046631045,-2.220692458439842,-1.0472017537767377,616670349,660155553.2,19.226136784359042,44.31967888418302,NaN,NaN,-29.657696296002733,-10.352837790887769
2018-12-26T09:30:00-05:00,81,84.3,80.61,84.22,20575130,16895230.2,37.32757501079099,39.13231686840044,NaN,NaN,-124.08546625232765,-170.2248084856747,-0.9617084435339922,-2.249337308194228,-1.2876288646602359,637245479,645959680.2,17.22752941474056,41.05494298104312,NaN,NaN,-28.961979517611265,-13.011286608991124
2018-12-27T09:30:00-05:00,83.23,85.2,82.0999,85.15,14045706,17134417.35,40.52212165601908,38.20202657887894,NaN,NaN,-90.02736166986693,-152.85453671560433,-0.7074635854817293,-2.1719583465123975,-1.4644947610306682,651291185,639188076.8,16.35419853832029,38.02105595806664,NaN,NaN,-27.27759688750404,-15.04933093449297
2018-12-28T09:30:00-05:00,85.7,86.44,84.9,85.25,15770636,17329429.5,40.871128592953035,37.91541712903266,NaN,NaN,-58.89344711219437,-126.91126527030602,-0.49128813824623574,-2.078604933838463,-1.5873167955922272,667061821,640634941.8,17.31865917176478,35.60305485163803,NaN,NaN,-25.879703414551358,-16.59652700307274
2018-12-31T09:30:00-05:00,85.73,86.59,85.67,86.51,10163087,17397783.45,45.231883005619416,37.841539457934275,NaN,NaN,-41.02838229370585,-99.88272906844685,-0.23515789926778075,-1.8812641696769532,-1.6461062704091725,677224908,649898748.4,23.407995302216833,34.07383326016768,NaN,NaN,-23.289990634827987,-17.55273609332349
2019-01-02T09:30:00-05:00,85.18,85.83,84.27,85.2,14191867,17313579.6,41.781762757796095,37.44003568187715,NaN,NaN,-55.62183978779921,-73.9312994231788,-0.13088696483161288,-1.8097149764486886,-1.6788280116170757,663033041,659171286.8,29.041284246958938,33.120922565238764,NaN,NaN,-22.23410044530378,-18.221502429320672
2019-01-03T09:30:00-05:00,85.32,85.5,83.25,83.47,17668044,17589075,37.6928484142452,36.52227888978803,NaN,NaN,-69.67223194293778,-63.04865256130082,-0.1537696560964681,-1.871040081737661,-1.7172704256411928,645364997,660795190.4,30.012124310975864,32.13863263490026,NaN,NaN,-22.66998786822157,-18.85700034916366
2019-01-04T09:30:00-05:00,84.45,86.43,84.41,85.96,16262555,17651635.95,45.89940917664571,36.164702520411645,NaN,NaN,-33.319441261622465,-51.70706847965192,0.014510785373491597,-1.6991319439243284,-1.71364272929782,661627552,662862463.8,31.300719446922898,30.814873859429706,NaN,NaN,-20.225528021408138,-19.052504302341443
2019-01-07T09:30:00-05:00,85.99,87.1,85.73,86.29,12392057,17346594.7,46.89765221615031,36.65826706347094,NaN,NaN,-10.687414989422091,-42.06586205509746,0.15590780932299397,-1.5187579676440777,-1.6746657769670716,674019609,664254021.4,32.205567507620444,29.222407621484027,NaN,NaN,-17.995771980996384,-18.901542542149294
2019-01-08T09:30:00-05:00,86.98,87.25,85.9999,86.96,13370996,17268601.6,48.956937665793006,37.63170887896458,NaN,NaN,4.332077713694363,-32.99377005361741,0.2943852226097168,-1.3066842487049257,-1.6010694713146425,687390605,666287160.8,33.582015528466286,27.77093267254108,NaN,NaN,-15.543296478967934,-18.421793104551956
2019-01-09T09:30:00-05:00,87.34,87.86,87.09,87.35,11259669,17062982.5,50.16832438120496,38.820681797602965,NaN,NaN,29.752809114278538,-15.918840273201862,0.40523355632842395,-1.0945275259041125,-1.4997610822325365,698650274,673410607.4,38.30810153730267,27.109326635014604,NaN,NaN,-13.19073491385029,-17.67449907730886
2019-01-10T09:30:00-05:00,86.96,87.58,86.52,87.52,10396767,16901204.45,50.71737066040072,40.23004478703799,NaN,NaN,32.52581639228521,4.520769393842708,0.4779901701313163,-0.9022733695683911,-1.3802635396997074,709047041,686147016.2,45.74206903289813,27.6224169338066,NaN,NaN,-11.117092123944103,-16.73772665539961
2019-01-11T09:30:00-05:00,87.11,87.835,86.95,87.81,7187901,16631547.9,51.69512154046554,41.88551304826911,NaN,NaN,58.47512701791064,22.87968304974933,0.5296262933029958,-0.7182306730709627,-1.2478569663739585,716234942,697068494.2,51.17522172987468,29.16052313680726,NaN,NaN,-9.119926995942699,-15.649469561191479
2019-01-14T09:30:00-05:00,87.28,87.32,86.83,86.84,5448972,16325636.1,48.247144393120124,43.482385928471444,NaN,NaN,55.56736155843792,36.13063835932134,0.48370026935255006,-0.643231629683271,-1.126931899035821,710785970,704421766.4,54.480230720639106,31.38441809093295,NaN,NaN,-8.317398863949201,-14.602030890156868
2019-01-15T09:30:00-05:00,86.96,88.42,86.9425,88.4,10540620,15881530.1,53.60646602218647,45.68683896381361,NaN,NaN,105.50335328068716,56.36489347271989,0.5393879384457906,-0.4526969759785828,-0.9920849144243734,721326590,711208963.4,57.349993278384325,34.107550697649046,NaN,NaN,-6.0421131662134915,-13.3791855010221
2019-01-16T09:30:00-05:00,88.52,88.895,88.18,88.24,8288920,15191499.45,53.00024161144549,46.80631514957464,NaN,NaN,123.86316085776342,75.18696382141687,0.5448501061360209,-0.3110222817543473,-0.8558723878903682,713037670,714086442.6,58.54328658253115,37.058676209634086,NaN,NaN,-4.337333731085835,-12.087492391031205
2019-01-17T09:30:00-05:00,88,89.39,87.93,89.02,8731630,14392452.6,55.634285609511,47.88575543196692,NaN,NaN,126.63087355134373,94.00797525322858,0.5772923471052392,-0.1342569540088192,-0.7115493011140585,721769300,716630894.4,59.619181693597746,40.149032149296765,NaN,NaN,-2.1299512183843254,-10.664986509224509
2019-01-18T09:30:00-05:00,89.68,90.13,89.01,90.08,13368209,13907080.95,58.997350637396465,49.180485577998596,NaN,NaN,143.04185740251245,110.92132133014893,0.6414976792706374,0.09032279797423826,-0.5511748812963991,735137509,720411407.8,61.229165295183755,43.28549687239812,NaN,NaN,0.7672459270271379,-9.031810446902846
2019-01-22T09:30:00-05:00,89.45,89.62,88.84,89.46,12244517,13253221.5,56.30870342386083,49.97168703644441,NaN,NaN,114.92808668454987,122.79346635537131,0.6135699738517204,0.21578758601825143,-0.397782387833469,722892992,722832812.2,62.2668621212785,46.06113021661681,NaN,NaN,2.4911897441601525,-7.385667562465274
2019-01-23T09:30:00-05:00,89.63,90.05,88.59,89.56,7722861,12193283.5,56.65183840033537,51.03383529662579,NaN,NaN,108.75889965311674,123.44457562985724,0.5739093497207557,0.3196042993174757,-0.25430505040328,730615853,724690664.8,63.08328836622972,48.49270193942186,NaN,NaN,4.013472762379379,-5.757218944630324
2019-01-24T09:30:00-05:00,89.47,89.55,88.39,88.81,11306954,12046854.9,53.272592212863124,52.14667413938422,NaN,NaN,85.7165081508929,115.81524508848312,0.4734207651555534,0.3374709060411618,-0.1359498591143916,719308899,725944910.6,63.655023020847665,50.895766132984136,NaN,NaN,4.435964206641466,-4.301049923020068
2019-01-25T09:30:00-05:00,89.25,89.25,88.66,88.92,7241935,11380195.15,53.70872732384646,52.704482578469985,NaN,NaN,80.86302258305243,106.66167489482487,0.3938783402722502,0.3563980662259212,-0.037480274046329046,726550834,726901217.4,64.11140370164435,53.23938643689281,NaN,NaN,4.903555300440778,-2.9861063196685187
2019-01-28T09:30:00-05:00,88.31,88.4,87.485,87.91,7113845,11033602.1,49.17068069239498,52.8668417553446,NaN,NaN,27.078622586514836,83.46902793162535,0.259260795946362,0.28659572088662344,0.02733492494026145,719436989,723761113.4,61.38568260920689,55.32368037272041,NaN,NaN,4.095356332051814,-1.9744687979941855
2019-01-29T09:30:00-05:00,87.91,88.405,87.66,88.34,11099240,10800032.3,51.06635374275565,53.0175143322705,NaN,NaN,32.7193902986587,67.02728865444712,0.1884866359551449,0.26294321988419256,0.07445658392904766,730536229,725289760.8,62.227598486746615,57.36979344116901,NaN,NaN,3.902726720984241,-1.1348694381401245
2019-01-30T09:30:00-05:00,88.67,89.8,88.45,89.55,11706927,10877224.3,56.035202908015,53.43657708418551,NaN,NaN,86.26888680278451,62.52928608438068,0.21078654943601208,0.3379397707240628,0.1271532212880507,742243156,727615221.4,63.53028250232598,59.171377795813534,NaN,NaN,5.112992174168223,-0.24231777923893205
2019-01-31T09:30:00-05:00,89.45,90.88,89.355,90.67,13410059,10838133.9,60.076275238922406,54.10507026836563,NaN,NaN,133.76726253666152,72.1394369615344,0.2840304757837232,0.4821913160177047,0.1981608402339815,755653215,734884084.6,67.32376974250437,60.71292784649969,NaN,NaN,7.362917272936167,0.8441443710717963
2019-02-01T09:30:00-05:00,90.78,90.96,90.13,90.75,9386492,10424056.3,60.35657284618661,54.72374536163142,NaN,NaN,142.52853214006092,84.4725388729361,0.3183478215196943,0.5960956171335994,0.27774779561390506,765039707,742581859.2,70.78902805637226,62.11391401267809,NaN,NaN,9.287716496549477,2.0503689604257507
2019-02-04T09:30:00-05:00,90.76,90.76,89.72,90.49,9308908,10076373.95,58.909007792994444,55.485307033051015,NaN,NaN,115.44642790649729,102.14609993693259,0.3040441839128222,0.6578030255049327,0.3537588415921106,755730799,749840621.2,73.6289897612854,63.48168251558139,NaN,NaN,10.523703923134715,3.2608453836698885
2019-02-05T09:30:00-05:00,90.64,91.15,90.34,90.36,8921434,9902842.8,58.15794327506267,55.8104125511136,NaN,NaN,123.36761716744812,120.27574531069047,0.26761899430996444,0.6882825844795661,0.4206635901696017,746809365,753095248.4,74.8114668363519,64.7289306268648,NaN,NaN,11.370013158032224,4.419297922864508
2019-02-06T09:30:00-05:00,90.2,90.81,90.09,90.77,6135904,9541088.2,59.89463677641739,56.302869348611594,NaN,NaN,110.47627073414569,125.1172220969627,0.25308949375020806,0.7370254573573618,0.48393596360715374,752945269,755235671,75.58677451689974,65.94632262217684,NaN,NaN,12.557390114148232,5.581882521619326
2019-02-07T09:30:00-05:00,90.18,90.33,89.29,89.77,9511821,9453695.8,54.00675519304524,56.1866171760069,NaN,NaN,53.03406697175005,108.97058298398039,0.16248569918698064,0.6870430875908795,0.5245573884038989,743433448,752791717.6,72.83025473130722,66.88997069629895,NaN,NaN,12.032393783357419,6.503384130439053
2019-02-08T09:30:00-05:00,89.42,89.95,89.29,89.94,7284173,9298066.1,54.819870630168545,55.88822574691919,NaN,NaN,42.45492160927621,88.95586087782347,0.10324594046377922,0.6536148139836229,0.5503688735198436,750717621,749927300.4,69.62538101711392,67.48970039072252,NaN,NaN,11.803154162378652,7.260494135001853
2019-02-11T09:30:00-05:00,90.14,90.2,89.58,89.83,5017407,9189541.4,54.152745829564836,55.734228775898046,NaN,NaN,48.149864458630134,75.49654818825005,0.048665733572329506,0.6112010404852555,0.562535306912926,745700214,747921183.4,67.38876585979756,67.85555065775961,NaN,NaN,11.436126471336193,7.857013040192473
2019-02-12T09:30:00-05:00,90.22,91.11,90.06,91.06,9093318,9371758.7,60.012629987422905,55.97428531783287,NaN,NaN,111.65273147895913,73.15357105055224,0.08527197859804814,0.6691252801604861,0.583853301562438,754793532,749518016.8,68.26270584331056,68.22550904897966,NaN,NaN,12.71012000369039,8.55031403497789
2019-02-13T09:30:00-05:00,91.24,91.53,90.849,91.26,6435569,9166506.15,60.88800715067398,56.518243527676496,NaN,NaN,139.49810896228192,78.95793869617947,0.1111866194369473,0.7228365758586222,0.6116499564216749,761229101,751174783.2,69.18539895337817,68.62053590130326,NaN,NaN,14.019888672830957,9.331681840385471
2019-02-14T09:30:00-05:00,91.03,91.88,90.9,91.47,6938644,9098992.35,61.83280012039123,57.098534441715415,NaN,NaN,142.59412524866053,96.86995035156157,0.12942624144940085,0.7734327582334259,0.6440065167840251,768167745,756121642.6,71.81981405382439,69.17113664074469,NaN,NaN,15.384236835605735,10.196332553988366
2019-02-15T09:30:00-05:00,92.16,92.9,91.47,92.85,8234221,9074121.9,67.40495049523497,58.40098228477542,NaN,NaN,190.89512256366442,126.55799054243921,0.21627083730797336,0.9143450634189918,0.6980742261110184,776401966,761258511.6,74.27888498520643,70.0920796676018,NaN,NaN,18.305373389928334,11.354766959122648
2019-02-19T09:30:00-05:00,92.6,92.99,92.59,92.63,6284092,8719916.05,65.75678292591336,59.45029865500097,NaN,NaN,178.29688985468343,152.58739562164988,0.2389619773617252,0.9967766978131749,0.7578147204514497,770117874,766142043.6,76.3883564305017,71.10356237787002,NaN,NaN,20.275021711872807,12.629089066658384
2019-02-20T09:30:00-05:00,92.4,92.64,92.055,92.52,6959918,8455686.1,64.90225930275324,60.083659826053704,NaN,NaN,137.02181132369864,157.66121159059776,0.2267287674555175,1.0412256797708466,0.8144969123153291,763157956,767814928.4,77.08175338313185,72.07152458364187,NaN,NaN,21.68456109412524,13.922727927725077
2019-02-21T09:30:00-05:00,92.19,92.25,91.3,91.71,8368479,8487967,58.83875098492604,59.99526523648253,NaN,NaN,85.94226314661637,146.95004242746467,0.14805781127330853,0.9995691764069647,0.8515113651336562,754789477,766527003.6,75.24957021937844,72.63765318913286,NaN,NaN,21.23760262413324,14.967710027211957
2019-02-22T09:30:00-05:00,91.89,92.6332,91.78,92.55,6488091,8247023.85,62.7276761327202,60.164629756949225,NaN,NaN,110.21046275863735,140.47330992946002,0.13683071595723173,1.0225497600801958,0.8857190441229641,761277568,765148968.2,73.24352332024809,72.81297427940972,NaN,NaN,21.96445665494705,15.967245259745543
2019-02-25T09:30:00-05:00,93.02,93.24,92.6129,92.68,7652584,8267556.3,63.30549382638083,60.47866447361967,NaN,NaN,125.7880833848163,127.4519020936904,0.1228422627254877,1.0392718725298238,0.9164296098043361,768930152,763654605.4,71.03209908810564,72.62748208846831,NaN,NaN,22.72591372381187,16.93276932604073
2019-02-26T09:30:00-05:00,92.47,92.72,92.24,92.35,7288017,8276264.9,60.73169249802799,60.662503703831476,NaN,NaN,90.56402773110207,109.90532966897413,0.07822023396051048,1.0142049022549742,0.9359846682944637,761642135,761959457.6,68.50534206396152,72.17704460472613,NaN,NaN,22.65859765968637,17.750744802275822
2019-02-27T09:30:00-05:00,92.04,92.36,91.61,91.92,9827557,8212680.75,57.45382234350159,60.488159815766075,NaN,NaN,54.04332168687354,93.30963174160911,0.010176787887260064,0.9487056531535387,0.9385288652662787,751814578,759690782,65.16440144596658,71.43258938537376,NaN,NaN,21.68379353083971,18.312608906356378
2019-02-28T09:30:00-05:00,91.75,92.25,91.55,91.65,9464107,8100539.75,55.430769346630846,60.58987511245075,NaN,NaN,38.06683134274579,83.73454538083499,-0.05879216767425588,0.8650386556734588,0.9238308233477147,742350471,757202980.8,61.61574483648805,70.63155296431526,NaN,NaN,20.294396097228006,18.59572136219518
2019-03-01T09:30:00-05:00,92.22,93.08,92.14,92.95,10795155,7969794.55,62.31186039369534,61.12501723841695,NaN,NaN,94.17252368358577,80.5269575658247,-0.024398016600298833,0.8933333025973411,0.91773131919764,753145626,755576592.4,59.340651823003896,69.89692945045024,NaN,NaN,21.021076723931394,18.94220069958607
2019-03-04T09:30:00-05:00,93.28,93.45,91.06,91.69,15208819,8260910.9,53.66385570917748,61.09009651553214,NaN,NaN,42.39225843731001,63.84779257632344,-0.0903384823544664,0.8048082162545569,0.8951466986090233,737936807,749377923.4,51.53094981504287,68.76422830439635,NaN,NaN,18.882418924448153,18.93366044599494
2019-03-05T09:30:00-05:00,91.73,91.9668,91.1701,91.64,13591690,8475050,53.34745094531665,60.61401229823884,NaN,NaN,3.309988787272107,46.39698478755746,-0.1382847610614346,0.72229074728223,0.8605755083436646,724345117,741918519.8,44.022545591720615,67.03278828642564,NaN,NaN,17.088844011529627,18.670115241071322
2019-03-06T09:30:00-05:00,91.65,91.77,90.05,90.3,11662385,8612097.55,45.58952415204922,59.52126351262279,NaN,NaN,-67.24200355719688,22.139919738743362,-0.25444881615745185,0.5425144881468498,0.7969633043043016,712682732,734092150.6,37.79945719290889,64.79093530353497,NaN,NaN,12.899654134013058,17.845763654348712
2019-03-07T09:30:00-05:00,90.17,90.36,89.28,89.59,14431013,9026853,42.096391280830154,58.11152002408271,NaN,NaN,-132.69363826879263,-12.012174183564326,-0.3664958716491945,0.33884346474280846,0.705339336392003,698251719,725272400.2,32.2642591691739,61.96553852605994,NaN,NaN,8.239231398484867,16.473401903511018
2019-03-08T09:30:00-05:00,89.11,89.445,88.63,89.4,11634189,9132971.4,41.18691936763382,56.23880351496833,NaN,NaN,-166.95164063584212,-64.23700704744991,-0.4360682763394851,0.1602539909676466,0.5963222673071317,686617530,711966781,26.063512118657997,58.52158332130648,NaN,NaN,4.221505790786451,14.723131030264652
2019-03-11T09:30:00-04:00,89.64,90.4979,89.3798,90.42,9694373,9253481.4,47.717235706830046,54.95026442789096,NaN,NaN,-103.17916032652003,-93.35129080021592,-0.3971580313326412,0.09987472814133014,0.49703275947397135,696311903,703641800.2,23.07535430751119,54.713511741092866,NaN,NaN,2.764946729862949,13.014818987350123
2019-03-12T09:30:00-04:00,90.65,91.2901,90.52,91.08,8981596,9451690.85,51.47198757996896,53.99095930483493,NaN,NaN,-46.99422066243463,-103.41213269015728,-0.3143618579773521,0.1040804370022812,0.4184422949796333,705293499,699831476.6,21.841089908682648,50.767750064346494,NaN,NaN,2.739301487506181,11.546887915943845
2019-03-13T09:30:00-04:00,91.35,92.31,91.285,92.06,10098311,9501940.5,56.470834793653644,53.82182243402976,NaN,NaN,22.67972403367049,-85.4277871719838,-0.18726100048158323,0.18436604437765425,0.3716270448592375,715391810,700373292.2,22.47608424697141,46.99821535203171,NaN,NaN,4.355496211608452,10.519546243895931
2019-03-14T09:30:00-04:00,92.03,92.15,91.5831,91.91,9283753,9644349.7,55.52799219538724,53.307559295648836,NaN,NaN,19.982361295341097,-54.89258725915704,-0.11074081667993535,0.2332010240093183,0.34394184068925365,706108057,701944559.8,24.394436888352715,43.5089948926106,NaN,NaN,5.352650073002923,9.781418219482644
2019-03-15T09:30:00-04:00,91.73,92.14,91.41,91.99,10219428,9808388.9,55.95040812601413,52.78219603133693,NaN,NaN,15.430375152267782,-18.416184101535062,-0.05500447031790778,0.2751862527918689,0.3301907231097767,716327485,707886550.8,31.316154306202648,40.67214169390325,NaN,NaN,6.2809560317280075,9.281352192660552
2019-03-18T09:30:00-04:00,92.08,92.17,91.52,91.85,7183529,9755854.3,54.96645588593892,52.3703934161877,NaN,NaN,18.237337578463503,5.867115479461647,-0.0291313417152283,0.2937765459657413,0.3229078876809696,709143956,710452961.4,34.12147684805686,38.216151321338636,NaN,NaN,6.7727840172003,8.922985310451946
2019-03-19T09:30:00-04:00,92.17,92.84,91.8409,92.58,11308845,10007091.95,59.013950911404564,52.48183117103792,NaN,NaN,71.01338429850283,29.468636471649138,0.03225555212969755,0.36322732784309153,0.330971775713394,720452801,713484821.8,37.375639420754666,36.23123974810921,NaN,NaN,8.386536065855795,8.846349704081067
2019-03-20T09:30:00-04:00,92.47,92.58,91.58,91.94,11123700,10215281.05,54.39786533555697,52.408052313104065,NaN,NaN,38.75290663390505,32.68327299169605,0.02518006724200167,0.3624468597658961,0.3372667925238944,709329101,712272280,36.59704091766945,34.444189468193606,NaN,NaN,8.441474863170498,8.788510441093843
2019-03-21T09:30:00-04:00,91.17,92.44,91.04,92.3,7398197,10166766.95,56.46089679181652,51.99012634154129,NaN,NaN,28.117859225607752,34.31037257774939,0.039324871661879035,0.3864228821012432,0.34709801043936417,716727298,714396128.2,38.99425651401321,32.99087551755141,NaN,NaN,9.085560236582355,8.83094612616363
2019-03-22T09:30:00-04:00,91.9,92.24,90.6,90.62,12162589,10450491.85,46.0019415713554,51.44284676026829,NaN,NaN,-35.69813340151935,24.084670866991964,-0.06424901523159593,0.26678674139986924,0.3310357566314652,704564709,712043573,37.31142574189258,31.975195226612104,NaN,NaN,6.295680783519797,8.468765362928796
2019-03-25T09:30:00-04:00,90.78,90.86,89.92,90.57,9893341,10562529.7,45.730428210439776,50.89877370777708,NaN,NaN,-84.51134143838674,3.534935063621913,-0.13200795442683116,0.16602581359792623,0.2980337680247574,694671368,709149055.4,35.29327845324944,31.351676145292732,NaN,NaN,4.011068969074367,7.8319515923781635
2019-03-26T09:30:00-04:00,91.1,91.77,90.5525,91.19,8107248,10603491.25,49.69530700066485,51.19204391124963,NaN,NaN,-17.832697230843465,-14.234281242247349,-0.13070803510824375,0.13464872413945272,0.26535675924769647,702778616,705614218.4,32.94939335367455,31.00524301391885,NaN,NaN,3.2727417072477456,7.180635894502389
2019-03-27T09:30:00-04:00,91.08,91.29,89.8,90.43,10817460,10652986.4,45.32402727472723,51.42258933938513,NaN,NaN,-68.25604395824244,-35.63607136067685,-0.17396197110115427,0.047904295371253625,0.2218662664724079,691961156,702140629.4,30.785740220763216,30.8996345176038,NaN,NaN,1.2733098741291629,6.336732177306214
2019-03-28T09:30:00-04:00,90.7,90.91,90.19,90.66,6726871,10516124.6,46.84777679679718,51.82693629861108,NaN,NaN,-55.374710063909625,-52.33458521858033,-0.17929797595269636,-0.0022562034684625587,0.1770417724842338,698688027,698532775.2,28.679232881558548,31.086471714953834,NaN,NaN,0.09706916338276983,5.445351746745722
2019-03-29T09:30:00-04:00,91.2,91.83,91,91.75,10120891,10482411.4,53.466392052883215,52.237590323329165,NaN,NaN,32.0731881290267,-38.78032091247111,-0.10529618672693736,0.04542153907556212,0.15071772580249948,708808918,699381617,29.894654543572017,31.573564588958185,NaN,NaN,1.131435805919933,4.829078040913466
2019-04-01T09:30:00-04:00,92.31,92.445,91.68,91.89,9082046,10176072.75,54.25431198387514,52.43632778075103,NaN,NaN,76.70804487210061,-6.536443650373641,-0.045833090593389386,0.09342636256076275,0.13925945315415214,717890964,704025536.2,36.2913001392295,32.60572246256867,NaN,NaN,2.201499649831718,4.45370969933036
2019-04-02T09:30:00-04:00,91.91,92.05,91.51,91.68,7002204,9846598.45,52.809849611826266,52.17482883919193,NaN,NaN,51.56486132419117,7.343068060633286,-0.020831438837818905,0.11322015460687851,0.13405159344469741,710888760,705647565,38.40529122447028,33.74352296096145,NaN,NaN,2.6681527849194824,4.198630140128806
2019-04-03T09:30:00-04:00,92.09,92.14,91.285,91.56,7398696,9633414,51.95856312451558,51.91986961984395,NaN,NaN,39.67715801122204,28.929708454526185,-0.012949111881074865,0.11786520359335384,0.1308143154744287,703490064,707953346.6,41.38293519185164,34.95698712549709,NaN,NaN,2.818115996141586,4.001413833844917
2019-04-04T09:30:00-04:00,91.64,91.75,90.84,91.37,9212386,9372482.65,50.56861402019254,51.535455755142415,NaN,NaN,1.1059256529995194,40.22583559790801,-0.020647773477723008,0.10500459862727496,0.12565237210499797,694277678,707071276.8,40.574852546426136,35.618322714084485,NaN,NaN,2.5685532289224224,3.796719461713132
2019-04-05T09:30:00-04:00,91.59,92.16,91.53,92,6262046,9103875.5,54.87878214181614,51.52919334484792,NaN,NaN,56.42918988411958,45.09703594892659,0.014668824499469268,0.14398840272933455,0.12931957822986528,700539724,705417438,39.03573511078399,35.969341161422136,NaN,NaN,3.555105247913727,3.7622031454560743
2019-04-08T09:30:00-04:00,91.93,92.07,91.33,91.98,5961216,8917217.65,54.715673376264974,51.22217352090939,NaN,NaN,38.25932051930614,37.40729107836769,0.033580284709889885,0.17129493411722763,0.13771464940733774,694578508,700754946.8,35.00441600915909,35.799968060593876,NaN,NaN,4.32700246263695,3.8428887621961993
2019-04-09T09:30:00-04:00,91.66,91.937,91.41,91.74,7207595,8828517.6,52.69180689936762,51.10031220403872,NaN,NaN,20.038386364051796,31.101996086339817,0.02710153009315222,0.171591562023778,0.1444900319306258,687370913,696051377.4,31.473231834863483,35.43398169753631,NaN,NaN,4.457990583768327,3.9307604509922176
2019-04-10T09:30:00-04:00,91.85,92.02,91.61,91.77,5433511,8595277.6,52.926199591120366,50.84783383256042,NaN,NaN,37.29426452751037,30.625417389597487,0.022217307097210898,0.17226166580213942,0.15004435870492852,692804424,693914249.4,29.992755201804115,34.791017318092806,NaN,NaN,4.628157918644494,4.030388660656828
2019-04-11T09:30:00-04:00,91.97,92.02,90.2436,90.64,8534189,8557799.4,44.06923192674035,50.70978314365935,NaN,NaN,-82.03108488792863,13.998015281411856,-0.05549058309523808,0.08068112983588094,0.13617171293111902,684270235,691912760.8,28.634273912287753,34.17122075883532,NaN,NaN,2.2460833830616567,3.7754879067146607
2019-04-12T09:30:00-04:00,90.99,91.02,89.661,89.81,11659326,8629794.3,38.91760099370633,50.2231526281784,NaN,NaN,-164.4022120237068,-30.168265100153416,-0.1554975876387313,-0.05820027161729513,0.09729731602143618,672610909,686326997.8,25.203360085210775,33.450512303975415,NaN,NaN,-1.4862004333701049,3.023818143845409
2019-04-15T09:30:00-04:00,89.92,90.235,89.745,90.17,7921955,8666715.6,42.08020881151896,49.679217043239404,NaN,NaN,-150.66247820123428,-67.9526248442615,-0.1879412822207402,-0.13762928675448904,0.05031199546625113,680532864,683517869,23.66750598506907,32.787520349075024,NaN,NaN,-3.6801018074860874,2.066115293655195
2019-04-16T09:30:00-04:00,90.92,91.03,88.165,88.32,14857099,8844128.3,32.7080805381015,48.778077990623274,NaN,NaN,-208.9741533368236,-113.7551327844366,-0.31694553179529994,-0.3458699192778738,-0.028924387482573866,665675765,679178839.4,21.489206721056263,32.1234822419531,NaN,NaN,-9.133026966487346,0.4662378279205466
2019-04-17T09:30:00-04:00,88.62,88.6413,85.33,85.78,34381753,10007030.95,24.605277576783976,47.18932804633662,NaN,NaN,-325.8262726282,-186.37924021557865,-0.5430212556740132,-0.7077009570750903,-0.16467970140107716,631294012,666876757,16.775087637744107,31.273186153109208,NaN,NaN,-17.678392226711733,-2.125852179884065
2019-04-18T09:30:00-04:00,86.04,86.45,84.65,85.92,35300882,11402165.2,25.697875705869336,45.20586259297848,NaN,NaN,-283.3219091556177,-226.63740506911645,-0.6458192417265138,-0.9719537535592195,-0.32613451183270564,666594894,663341688.8,15.708678942721448,30.259902181619882,NaN,NaN,-23.506447569213147,-5.180222949788219
2019-04-22T09:30:00-04:00,85.78,86.465,85.51,85.97,18717732,11729922.35,26.109720393001,43.195534622201755,NaN,NaN,-201.64295298864033,-234.08555326210316,-0.6702319267576287,-1.1639244202797414,-0.4936924935221128,685312626,665882032.2,19.661107553974077,29.072031282673066,NaN,NaN,-27.75546694161778,-8.40525780576387
2019-04-23T09:30:00-04:00,85.94,87.7867,85.79,87.33,30503353,12760422.95,36.43095217943872,42.02561337703121,NaN,NaN,-128.67161286644915,-229.68738019514618,-0.5591057366585847,-1.1925746643453436,-0.633468927686759,715815979,672938655.2,29.544085011004,28.439087981711186,NaN,NaN,-27.795302191920985,-11.175264146643459
2019-04-24T09:30:00-04:00,87.36,87.54,86.84,87.23,14612816,13085701.35,36.032401817219586,40.88803042651007,NaN,NaN,-101.11973396249135,-208.1164963202797,-0.46075129806910486,-1.2094080502731401,-0.7486567522040353,701203163,680044134.8,37.836458886738995,28.185768245631714,NaN,NaN,-27.955530686179813,-13.572445080862938
2019-04-25T09:30:00-04:00,87.04,88.39,86.675,88.13,16166445,13353150.6,42.16482264956382,40.28775961432232,NaN,NaN,-71.72352665277383,-157.29594712519446,-0.3106900388633841,-1.1370193007832654,-0.8263292619198813,717369608,697259254,52.441193853267606,29.033364053263245,NaN,NaN,-26.036995918981432,-15.35309520059415
2019-04-26T09:30:00-04:00,88.25,89.04,88.06,89.01,11322007,13582907.4,47.467828490800024,39.75840578210688,NaN,NaN,-34.57310078284859,-107.54618545064064,-0.1366546332266576,-0.9971475534532033,-0.8604929202265457,728691615,709678598.2,59.782113800228906,30.515248245366454,NaN,NaN,-22.63206829628712,-16.39294849997886
2019-04-29T09:30:00-04:00,89.04,89.195,88.4694,88.85,13264357,13740080.7,46.63063970731021,39.180903377181544,NaN,NaN,-25.939422704005157,-72.40547939371362,-0.022774827425589228,-0.8889614545085323,-0.866186627082943,715427258,715701524.6,62.782392324349914,32.49938941073723,NaN,NaN,-20.20937516317521,-16.93815230900691
2019-04-30T09:30:00-04:00,89.11,89.43,88.48,89.26,11750852,13873521,49.107635250461776,38.9248911165454,NaN,NaN,-14.11873266086158,-49.49490335259611,0.08385882302322067,-0.7613630983039172,-0.8452219213271379,727178110,717973950.8,63.87732924509463,34.81396779718231,NaN,NaN,-17.445564544414648,-17.010639771208016
2019-05-01T09:30:00-04:00,89.38,89.73,88.6,89.1,25596449,14803233.25,48.16809899410751,38.58502678818734,NaN,NaN,-6.751869741200692,-30.62133050833797,0.14379361192167173,-0.6654799064250483,-0.80927351834672,701581661,718049650.4,63.91541397274305,37.237014852249374,NaN,NaN,-15.471341023640347,-16.79073995012692
2019-05-02T09:30:00-04:00,89.01,89.565,88.5,89.48,18927530,15379674.95,50.586129059574716,39.05051944053265,NaN,NaN,-0.6025259210195143,-16.397130361987095,0.20545038216957223,-0.5524605406347547,-0.7579109228043269,720509191,718677567,64.25209194047318,39.78114471140548,NaN,NaN,-13.101963755085366,-16.263771922263842
2019-05-03T09:30:00-04:00,89.73,90.19,89.58,90.16,13623977,15600254.5,54.66214201970521,40.175129513818284,NaN,NaN,36.64314864771746,-2.1538804758738834,0.28363134335358986,-0.40337174361233963,-0.6870030869659295,734133168,719765877.6,64.86399265032725,42.61404703748523,NaN,NaN,-9.819642996224221,-15.343182075686753
2019-05-06T09:30:00-04:00,88.85,90.85,88.7,90.62,25168305,16545567.45,57.23216802107276,41.2574123145007,NaN,NaN,46.51756955280441,12.33751797548803,0.3533846328723024,-0.24527229587555155,-0.5986569287478539,759301473,728540720.6,69.41046340263877,45.8814011387402,NaN,NaN,-6.269383195832948,-14.046925092850495
2019-05-07T09:30:00-04:00,89.92,90.36,88.36,88.88,18011732,17148093.25,46.49562016553008,42.24223657360274,NaN,NaN,14.369481303964285,18.035160768453203,0.2729947429043904,-0.25741350011736586,-0.5304082430217563,741289741,731363046.8,70.72268092915478,49.398077867890095,NaN,NaN,-6.369474226643493,-12.950146397678067
2019-05-08T09:30:00-04:00,88.84,89.48,88.34,89.07,13783307,17476878.85,47.650472010885316,43.888321890324264,NaN,NaN,10.228840762372883,21.43130286916792,0.22525806858896208,-0.24883565728555368,-0.47409372587451576,755073048,742061324.2,75.08557899049345,53.56311296451505,NaN,NaN,-6.089320119544304,-11.970028357944672
2019-05-09T09:30:00-04:00,88.28,89.165,87.855,88.88,15692261,17989816.35,46.568018190898336,45.379046353540616,NaN,NaN,1.2072651734403035,21.793261088059882,0.1757261116412947,-0.2544360863228974,-0.4301621979641921,739380787,745835643.4,76.42059378755692,57.899678310574735,NaN,NaN,-6.184942353986761,-11.1435875002364
2019-05-10T09:30:00-04:00,88.59,89.14,87.01,88.91,17771753,18451694.55,46.77361740909883,46.8550389975476,NaN,NaN,-7.869881841431811,12.890654990230027,0.14130482403672762,-0.25353116791828256,-0.3948359919550102,757152540,750439517.8,77.97118040257222,62.064683514046024,NaN,NaN,-6.204551585160566,-10.438010940939852
2019-05-13T09:30:00-04:00,87.4,88.863,86.9,87.24,17436308,18740543.65,38.006481449215975,46.967576802531696,NaN,NaN,-42.977598033279975,-5.008378526986863,0.00934694124178248,-0.38315231540278205,-0.39249925664456453,739716232,746522469.6,73.54012036107076,65.20725746762221,NaN,NaN,-9.032549716388125,-10.237230766003892
2019-05-14T09:30:00-04:00,87.64,88.29,87.47,87.68,13147143,19001803.05,41.13702588641384,47.33219280747414,NaN,NaN,-27.845244529168298,-13.45132369361338,-0.04219357246895872,-0.4452412222307629,-0.4030476497618042,752863375,748837196.4,74.463664402487,67.8234864330328,NaN,NaN,-10.388930647795117,-10.258902177688352
2019-05-15T09:30:00-04:00,87.22,88.24,86.83,87.94,10587732,18788334.7,42.96969735122195,47.38968385759257,NaN,NaN,-32.5639868382403,-22.009889213736017,-0.05201921008633559,-0.46807166236972364,-0.41605245228338805,763451107,750512808.2,75.14010155091569,69.4448369828648,NaN,NaN,-10.94769831347695,-10.357301625658152
2019-05-16T09:30:00-04:00,88.13,89.39,88.07,88.63,15123987,17825446.4,47.62971715113625,47.40124733333088,NaN,NaN,29.55949496489065,-16.33944325544595,-0.0076235376160355695,-0.42558187430343253,-0.41795833668739696,778575094,758351669.6,78.06713982783799,70.75091027055116,NaN,NaN,-10.013151253150312,-10.308137286728462
2019-05-17T09:30:00-04:00,87.9,89.14,87.9,88.44,13354085,16728106.55,46.50290540176155,47.39212345436311,NaN,NaN,6.43574148040411,-13.478318591078764,0.01228753848937908,-0.4025989135756731,-0.4148864520650522,765221009,759965363.4,78.6250784292564,71.88253070661591,NaN,NaN,-9.57637538226826,-10.203599871805576
2019-05-20T09:30:00-04:00,88.06,88.68,87.75,88.4,10757386,16330089.25,46.254808508812616,47.188350115673884,NaN,NaN,-25.713737016498936,-10.025546387722553,0.025353016214720747,-0.38319518179665124,-0.408548198011372,754463623,762914841.6,79.64433870610297,73.0087456681165,NaN,NaN,-9.288335666826503,-10.072847842522851
2019-05-21T09:30:00-04:00,88.9,89.61,88.84,89.23,11690593,15389451.25,51.97971921790093,47.4606087030877,NaN,NaN,65.18717344711186,8.580937207533477,0.08890647443370031,-0.2974151049692466,-0.3863215794029469,766154216,765573009.8,80.54474683384697,74.19655515819535,NaN,NaN,-7.358599661088339,-9.685098102317921
2019-05-22T09:30:00-04:00,88.97,89.94,88.89,89.74,9021899,15109905.4,55.14162828031825,47.78600150456938,NaN,NaN,91.43335310483444,33.38040519614842,0.1601489551535915,-0.18613538546095754,-0.34628434061454905,775176115,767918011.4,81.32936550118623,75.416360412532,NaN,NaN,-4.76938676244685,-8.982853625193483
2019-05-23T09:30:00-04:00,89.29,89.43,88.68,89.43,13545414,14978853.85,52.86310459967162,47.657498831709844,NaN,NaN,44.63901642323607,36.396309487817504,0.17978062145990936,-0.12155856378966234,-0.3013391852495717,761630701,764529132.8,76.52618024308791,76.24937381201491,NaN,NaN,-3.2394404389777294,-8.162366027162662
2019-05-24T09:30:00-04:00,89.74,90.1,89.34,89.56,9986447,14912075.85,53.72662280699597,47.40710274499007,NaN,NaN,95.50130508215392,54.209422208167474,0.19370452044944175,-0.05920853468776954,-0.2529130551372113,771617148,765808360.6,77.07653011662266,76.7969500058709,NaN,NaN,-1.7291619494375383,-7.24333687320193
2019-05-28T09:30:00-04:00,89.64,90.18,88.27,88.28,20795950,15288655.5,44.98773854908704,47.29939691524413,NaN,NaN,3.1111273572201035,59.97439508291128,0.11289658990205967,-0.11179231775963672,-0.22468890766169639,750821198,765079875.6,75.98399690385494,77.17275828977805,NaN,NaN,-2.9614759630671084,-6.631642457468384
2019-05-29T09:30:00-04:00,87.85,87.8625,86.82,87.43,16302651,15516245.45,40.29998308712629,46.774361992118486,NaN,NaN,-153.04078907626584,16.32880257823574,0.0041329503860843275,-0.21952271967909098,-0.2236556700651753,734518547,758752741.8,67.08919713579974,76.60158815729993,NaN,NaN,-5.532492909666882,-6.474621093496741
2019-05-30T09:30:00-04:00,87.6,88.05,87.505,87.91,12457685,14859307.25,43.85767375492673,46.58076596097766,NaN,NaN,-92.95164843560109,-20.548197729851363,-0.031583143164944594,-0.26313459902135605,-0.23155145585641146,746976232,753112765.2,60.3116826629967,75.45095164840278,NaN,NaN,-6.572506416120075,-6.48860471101436
2019-05-31T09:30:00-04:00,87.34,87.69,86.77,87.28,10712975,14448579.5,40.450446900836766,46.12911092467323,NaN,NaN,-131.9441644231948,-55.86483389913754,-0.09040777589499982,-0.3445611757251612,-0.2541533998301614,736263257,748039276.4,54.93537583315253,73.80553703630137,NaN,NaN,-8.527249314434236,-6.779839654360057
2019-06-03T09:30:00-04:00,87.36,88.24,87.31,87.49,19370992,14735930.25,42.066112788066526,46.41908459173398,NaN,NaN,-82.21699053008786,-91.40849302158588,-0.10681981362914506,-0.38767816686659273,-0.2808583532374477,755634249,744842696.6,51.80213492681282,72.25282379099723,NaN,NaN,-9.634849410787286,-7.187698190992518
2019-06-04T09:30:00-04:00,88.22,89.09,88.11,88.94,15837154,14269372.7,51.791931520356314,47.18014927987274,NaN,NaN,27.750401457128568,-86.4806382016042,-0.0164107452541436,-0.30137178480512716,-0.28496103955098356,771471403,748972737.6,55.34583650276051,70.88726465530247,NaN,NaN,-7.462044439253498,-7.226890512172658
2019-06-05T09:30:00-04:00,89.59,89.82,88.9712,89.61,24291851,14583378.65,55.508657125017635,48.075789263715286,NaN,NaN,105.3453316883268,-34.80341404868567,0.0864719558334327,-0.17687109475919272,-0.2633430505926254,795763254,761221679,63.837878265113105,70.07996299203087,NaN,NaN,-4.425340568056333,-6.826669091584612
2019-06-06T09:30:00-04:00,89.75,90.43,89.535,90.07,18840935,14836260.05,57.90808220607309,48.80995819621078,NaN,NaN,145.7552370452102,12.93796304747659,0.17818081057366825,-0.04061703737554012,-0.21879784794920837,814604189,774747270.4,70.50753679034692,69.5399913464958,NaN,NaN,-1.1677204043711058,-6.018247850554111
2019-06-07T09:30:00-04:00,90.36,91.23,90.33,91.01,9302690,14516781.5,62.373666446322765,49.943583985108,NaN,NaN,187.01886327124268,76.73056858636407,0.28830495371251197,0.1415833441914316,-0.14672160952108038,823906879,792275994.8,76.54510357382453,69.39142171396495,NaN,NaN,3.122290637116356,-4.712456638029759
2019-06-10T09:30:00-04:00,91.29,91.575,90.95,91.28,8552839,14055835.8,63.56921893900276,51.18032758726444,NaN,NaN,182.27677900751476,129.6293224938846,0.36078361323589,0.3042579070237821,-0.05652570621210788,832459718,807641088.6,80.34369343464573,69.44137562314657,NaN,NaN,6.945703729214661,-3.0470051569948424
2019-06-11T09:30:00-04:00,91.73,91.96,90.903,91.13,8317911,13599915.95,62.38329392686998,51.923440066476516,NaN,NaN,159.8954319277801,156.05832858801492,0.3782416442087721,0.41627634904885724,0.03803470484008516,824141807,818175169.4,82.44304077154433,69.57696804726781,NaN,NaN,9.67793465566177,-1.229156612329612
2019-06-12T09:30:00-04:00,91.15,91.6,91.06,91.57,5799156,13232516.6,64.47677409854433,52.59023619634981,NaN,NaN,143.636028890051,163.71646802835977,0.3970889647361342,0.534395910760253,0.13730694602411872,829940963,825010711.2,83.66239987598144,69.74361335975318,NaN,NaN,12.609647219169187,0.7478153635987876
2019-06-13T09:30:00-04:00,91.73,91.73,91.1,91.46,9031760,13154718,63.52494910186712,53.351796517935206,NaN,NaN,127.29136508905489,160.0236936371287,0.37981429618227447,0.6120748162519618,0.23226052006968734,820909203,826271714,83.88475494250554,70.269225838283,NaN,NaN,14.745151031548945,2.747434744734524
2019-06-14T09:30:00-04:00,91.5,91.77,91.175,91.25,5056271,12651332.2,61.653730785383374,53.91801851639144,NaN,NaN,110.00568259642442,144.62105750216503,0.3335571913508713,0.6492070092582765,0.31564981790740515,815852932,824660924.6,82.34307840827626,70.64540785911541,NaN,NaN,16.026489804602704,4.644442610429978
2019-06-17T09:30:00-04:00,91.34,91.72,91.21,91.66,4861481,12226702,63.8901589661311,55.26819140332316,NaN,NaN,103.24621532448084,128.81494476555824,0.31036603807147667,0.703607365496751,0.3932413274252743,820714413,822311863.6,80.03303715832917,70.93462502014928,NaN,NaN,17.756572382372905,6.517604006421825
2019-06-18T09:30:00-04:00,92.12,92.76,91.94,92.44,7979937,12087829.55,67.74434864998632,57.22850322924173,NaN,NaN,128.98277638511212,122.63241365702466,0.32575304357078344,0.8004326318887536,0.47467958831797014,828694350,823222372.2,80.26414938725031,71.87569303811004,NaN,NaN,20.441282298834683,8.506700905337947
2019-06-19T09:30:00-04:00,92.46,93.48,92.4,93.27,6988099,11852704.85,71.25968730773226,59.18578991158498,NaN,NaN,139.2444775449078,121.75410338799603,0.3669619054668589,0.9333819701515438,0.5664200646846849,835682449,824370669.4,80.56960456592013,73.32268745974743,NaN,NaN,23.91028573852396,10.70721302436452
2019-06-20T09:30:00-04:00,94.04,94.33,93.14,93.68,9241301,11863674.95,72.83463915395487,61.49894650109342,NaN,NaN,144.24711216226876,125.1452528026388,0.39455537085022474,1.0596142782474658,0.665058907397241,844923750,829173578.8,81.8359143333778,75.2441544954778,NaN,NaN,27.301264900406196,13.077791863799046
2019-06-21T09:30:00-04:00,93.19,93.91,92.66,93.73,9026071,11637707.8,73.02874906545203,63.71056337804953,NaN,NaN,117.43386772530373,126.63088982841464,0.3882948439471512,1.15042746233118,0.7621326183840289,853949821,836792956.6,83.65571583560194,77.51941027467703,NaN,NaN,30.109397573927815,15.51087839381744
2019-06-24T09:30:00-04:00,93.61,93.6701,93.065,93.24,6493610,11463065.95,67.90766626286984,64.86168728822908,NaN,NaN,101.86813833181003,126.35527442988048,0.32579693675019195,1.1693787893217689,0.8435818525715769,847456211,842141316.2,84.80640198192505,79.62373638033162,NaN,NaN,31.07836603822647,17.73480520016159
2019-06-25T09:30:00-04:00,93.31,93.74,92.77,92.86,14930608,11169798.85,64.15066534244738,65.47897358947405,NaN,NaN,87.5030635368507,118.05933186022818,0.23760415855143535,1.140587050760871,0.9029828922094357,832525603,842907566.8,84.96966750325429,81.13314989734172,NaN,NaN,30.82620890783358,19.605005729829017
2019-06-26T09:30:00-04:00,92.99,93,91.5,91.69,10498431,10879587.85,54.2066456056839,65.21458526087483,NaN,NaN,42.64023585323214,98.73848352189306,0.08697204181029372,1.0116979444723029,0.9247259026620092,822027172,840176511.4,81.60386267143866,81.92574460313399,NaN,NaN,27.44326039502721,20.7247563962859
2019-06-27T09:30:00-04:00,92.01,92.51,91.83,92.33,7416201,10627513.65,58.03835135943527,64.90491989752572,NaN,NaN,45.64099894835219,79.01726087910974,0.020412286423171055,0.9502412606909729,0.9298289742678019,829443373,837080436,77.83950585168098,82.01820190869516,NaN,NaN,25.74791456951732,21.442350421033247
2019-06-28T09:30:00-04:00,92.37,92.715,91.84,92.64,9390623,10561396.05,59.793261728879884,64.63520866823123,NaN,NaN,48.26551052320993,65.18358943869099,-0.011069722046950892,0.9159918217091132,0.9270615437560641,838833996,834057271,74.23833840670457,81.58210512098508,NaN,NaN,24.88827166132442,21.934624883931985
2019-07-01T09:30:00-04:00,93.37,93.41,92.72,93.1,7833409,9984516.9,62.31201776865933,64.63011751407332,NaN,NaN,78.9973316032736,60.60942809298372,-0.00931745970443365,0.915414719125522,0.9247321788299556,846667405,833899509.8,74.04582240222987,80.98230380889119,NaN,NaN,24.922989749996116,22.361534150512576
2019-07-02T09:30:00-04:00,93.18,93.6,92.65,93.6,7952577,9590288.05,64.88687746906095,64.65941061196737,NaN,NaN,86.00935151434949,60.310685688483474,0.015747486169232383,0.944416536541496,0.9286690503722637,854619982,838318385.6,75.92874958450719,80.42990021664302,NaN,NaN,25.731303385560306,22.842929755519393
2019-07-03T09:30:00-04:00,93.81,94.42,93.8,94.4,4066048,8578997.9,68.58508469490016,65.02084886861259,NaN,NaN,139.38219269799086,79.65907705743523,0.07321983199686899,1.02019384036835,0.9469740083714809,858686030,845650157.2,78.6910455524942,80.05892097449937,NaN,NaN,27.600914731953942,23.522641895010043
2019-07-05T09:30:00-04:00,94,94.23,93.54,93.75,5934272,7933664.75,62.79780700414943,65.10256859852446,NaN,NaN,103.41024987692214,91.21292724314921,0.055289217599570395,1.016085530370944,0.9607963127713736,852751758,850311834.2,80.24343582536012,79.90894650429107,NaN,NaN,27.357446868284985,24.070471176906462
2019-07-08T09:30:00-04:00,93.39,93.42,92.62,93.05,15201990,8228629.75,57.2000925533422,64.62470671189666,NaN,NaN,36.36039722082242,88.83190458267171,-0.012279457534630556,0.9454469908530854,0.9577264483877159,837549768,850054988.6,79.89806181695303,79.8993054084785,NaN,NaN,25.344435882857898,24.252466134899525
2019-07-09T09:30:00-04:00,92.71,93.24,92.7,93.14,5537339,8077854.75,57.721900717661846,63.90881757387349,NaN,NaN,30.97486112145988,79.22741048630897,-0.05697430410365212,0.8865085682581508,0.943482872361803,843087107,849338929,78.87876200134681,79.80034916662824,NaN,NaN,23.896921136651592,24.201673992292676
2019-07-10T09:30:00-04:00,93.35,93.71,93.07,93.46,5347279,7929323.15,59.60754779383367,63.076521894309316,NaN,NaN,58.86126974689006,73.79779413281707,-0.07018138171401156,0.8557561452192886,0.9259375269333001,848434386,848101809.8,77.0498839442308,79.54894055079329,NaN,NaN,23.24311887429824,24.0647375468649
2019-07-11T09:30:00-04:00,94.11,94.15,92.85,93.48,13691693,8323950,59.72844272221804,62.14036500632811,NaN,NaN,61.989123644400735,58.31918032209906,-0.08194554050867586,0.8235056012974553,0.9054511418061312,862126079,848789819.6,77.36421549477737,79.22953349089325,NaN,NaN,22.745982406393527,23.87634395536899
2019-07-12T09:30:00-04:00,93.17,93.19,91.795,92.44,11508183,8447771.15,51.15451427487197,60.57791966414381,NaN,NaN,-49.90937760588848,27.655254825536936,-0.15964856228430802,0.7058904389507461,0.8655390012350541,850617896,848363047.2,76.66280192904189,78.73003964042468,NaN,NaN,19.66055575592979,23.27408849830625
2019-07-15T09:30:00-04:00,92.49,92.86,92.18,92.64,5811267,8485520.95,52.564716839899255,59.48199470536021,NaN,NaN,-53.67182555803355,9.64881026976574,-0.19510969062777495,0.6216518879503354,0.8167615785781104,856429163,852138926.2,78.51849114848986,78.28090315232217,NaN,NaN,17.534351738400403,22.454126104033985
2019-07-16T09:30:00-04:00,92.57,92.7,92.115,92.18,9092557,8697074.75,49.056652901028464,58.40385095954457,NaN,NaN,-97.45488196642482,-16.0371383478112,-0.2439104512530328,0.5118735145118194,0.7557839657648522,847336606,852988826,78.9247140006867,77.84912075928163,NaN,NaN,14.668270622772797,21.34186103528239
2019-07-17T09:30:00-04:00,92.37,92.68,92.19,92.2,9567035,8776429.65,49.2153476301625,58.04732967557875,NaN,NaN,-93.46364307382254,-46.50212091195372,-0.26732561856057657,0.42162694256413147,0.688952561124708,856903641,854682677,79.74674202591783,77.71646928460156,NaN,NaN,12.38026116169376,20.061632481912586
2019-07-18T09:30:00-04:00,92.19,92.87,91.74,92.72,6561567,8755103.05,53.28958893374197,57.70813235945781,NaN,NaN,-71.92420971161266,-73.2847875831564,-0.24108400494731086,0.38759755494056947,0.6286815598878803,863465208,854950502.8,79.88036927931363,77.86224524371819,NaN,NaN,11.518283415047671,18.841154043789025
2019-07-19T09:30:00-04:00,92.93,92.969,91.68,91.76,8105933,8698334.65,45.95902125926554,56.71997232591393,NaN,NaN,-99.06407754052327,-83.11572757008335,-0.27899477504900005,0.27993809107663026,0.5589328661256303,855359275,855898778.6,80.37410722885114,78.30051444530008,NaN,NaN,8.466028608733273,17.35899326735249
2019-07-22T09:30:00-04:00,91.86,91.92,91.49,91.57,5192693,8506665.75,44.6498914970242,55.458391877939995,NaN,NaN,-138.8576720350294,-100.15289686548253,-0.3053521845449268,0.17724263544447183,0.4825948199893986,850166582,854646262.4,77.66313668741053,78.55889403709871,NaN,NaN,5.574702318838995,15.67552313185056
2019-07-23T09:30:00-04:00,91.7,92.28,91.32,92.14,6688591,8516414.8,49.31436622450936,54.34606964618631,NaN,NaN,-97.85383709678733,-100.23268789155505,-0.27388908858322114,0.14023345926037223,0.41412254784359337,856855173,856549975.8,78.83181543992075,78.76625588391394,NaN,NaN,4.461436558574321,14.07351076423967
2019-07-24T09:30:00-04:00,92,92.2,91.17,92.19,5430541,8041411.45,49.71468437382227,52.99818390896645,NaN,NaN,-95.1594909041185,-100.57185745761423,-0.24039550400088094,0.11362816784249219,0.35402367184337313,862285714,857626390.4,79.48539551839417,78.82299516719253,NaN,NaN,3.6732403752235956,12.587757851523088
2019-07-25T09:30:00-04:00,91.94,92.29,91.54,91.74,6618662,7847423,46.179615312780456,51.81117021672581,NaN,NaN,-92.30072667130199,-104.6471608495521,-0.23874595946572974,0.05559122251121096,0.2943371819769407,855667052,856066759.2,75.83201581379528,78.50789373779503,NaN,NaN,1.9678390376925097,11.070626592404434
2019-07-26T09:30:00-04:00,92.06,92.24,91.72,92.07,3812448,7667235.35,49.041274334176556,51.228397486785404,NaN,NaN,-72.84404211209355,-99.40315376386614,-0.20682018604814942,0.03581194941675392,0.24263213546490334,859479500,856890804.2,76.44797152632535,78.26145871703592,NaN,NaN,1.334533132298811,9.679756098103631
2019-07-29T09:30:00-04:00,92.12,92.52,91.97,92.45,5887534,7492080.9,52.1934664684946,50.8335093261306,NaN,NaN,-38.587243595381686,-79.3490680759366,-0.15392919248214526,0.050220644862221775,0.20414983734436704,865367034,859930894.6,78.6135232260994,78.24251309023252,NaN,NaN,1.6993278502388471,8.539694919837233
2019-07-30T09:30:00-04:00,91.74,92.09,91.36,92.05,7959161,7498368.5,48.773372882916476,50.05963968963652,NaN,NaN,-84.2549777937339,-76.62929621532592,-0.14009718038330993,0.029028361865229613,0.16912554224853954,857407873,860041434.6,78.69024811663107,78.35968195968971,NaN,NaN,1.0307450002146903,7.466987788462584
2019-07-31T09:30:00-04:00,91.95,92.33,90.5816,91.14,8557587,7528619,42.02638450323628,48.795206959709255,NaN,NaN,-127.57580629152099,-83.11255929280642,-0.1836993768345813,-0.060498678794687066,0.12320069803989422,848850286,857354349,71.93439280492544,77.97183748184314,NaN,NaN,-1.679412177630752,6.160359221877822
2019-08-01T09:30:00-04:00,91.15,92.235,90.71,91.26,16422522,8146442.7,43.143332895754156,48.222979718343694,NaN,NaN,-119.75811163963147,-88.60403628647231,-0.19486364156180055,-0.12037885391235648,0.07448478764944408,865272808,859275500.2,73.67459313008099,77.75839399620307,NaN,NaN,-3.5448803807457336,4.773896421503028
2019-08-02T09:30:00-04:00,91.13,91.41,90.4577,91.05,15956788,8647568.5,41.63168903475008,47.44204916083304,NaN,NaN,-159.2757074647027,-105.89036935699414,-0.2057268853103137,-0.18267381898844803,0.02305306632186565,849316020,857242804.2,68.81287186835334,77.06513547619332,NaN,NaN,-5.537042728829296,3.300905114312696
2019-08-05T09:30:00-04:00,90.02,90.375,88.19,88.91,17626233,8768780.65,30.069478930514393,46.08582244865346,NaN,NaN,-305.1208099302525,-159.1970826239683,-0.33853118373535934,-0.4001109133473335,-0.061579729611974186,831689787,850507354.8,55.697347680174765,75.40603788187104,NaN,NaN,-11.809270619504332,1.1423085809102633
2019-08-06T09:30:00-04:00,89.36,90.08,88.87,90.06,10135861,8998706.75,39.752763736648554,45.409923599116745,NaN,NaN,-209.03816622431367,-184.15372031008425,-0.3300722570630599,-0.4741700509407991,-0.1440977938777392,841825648,847390909.8,50.86647913911516,73.34316196138515,NaN,NaN,-13.545584120632888,-0.9559618050244727
2019-08-07T09:30:00-04:00,89.33,90.34,88.2,90.09,12452460,9353965.8,39.986225082144536,44.45968332400265,NaN,NaN,-178.95453897063925,-194.42946684590794,-0.3042391905722481,-0.5243967820930493,-0.22015759152080122,854278108,848476474.2,52.41473939810759,71.38133125558471,NaN,NaN,-14.765516738139892,-2.928755366898104
2019-08-08T09:30:00-04:00,90.37,91.38,90.0445,91.29,12034822,9271122.25,48.57102873819009,44.64625528678297,NaN,NaN,-54.33359338215496,-181.34456319441261,-0.19351047254554132,-0.4620456822027279,-0.2685352096571866,866312930,848684498.6,52.7221839878957,69.40619388123075,NaN,NaN,-12.739542370650229,-4.330296367434122
2019-08-09T09:30:00-04:00,91.13,91.975,90.61,91.4,7253064,9058366.3,49.28716137212804,44.97748884929039,NaN,NaN,-13.453880863430259,-152.18019787415813,-0.10449559125887697,-0.3991546987307828,-0.2946591074719058,873565994,853534493.4,59.32113505007868,68.09605090713562,NaN,NaN,-10.94694995380679,-5.275532594058789
2019-08-12T09:30:00-04:00,91.06,91.4,90.1551,90.51,7097095,9122657.7,43.9542046596984,44.594620166089605,NaN,NaN,-62.253463002089426,-103.6067284885255,-0.09733632656902563,-0.4163295156831879,-0.31899318911416225,866468899,860490315.8,66.53544027009427,67.21773839500516,NaN,NaN,-11.213405612209097,-6.123800168080262
2019-08-13T09:30:00-04:00,90.48,92.17,90.4,91.69,12260613,9281060.5,51.454224009382784,44.71887299720107,NaN,NaN,7.4244833775560934,-60.31419856815156,-0.009533463760468819,-0.33091001881474824,-0.3213765550542794,878729512,867871088.6,72.1745000374693,66.6955315749391,NaN,NaN,-8.779652694795907,-6.503207671896782
2019-08-14T09:30:00-04:00,90.75,90.97,89.09,89.14,16426117,9624014.6,39.23516660973671,44.22284094698366,NaN,NaN,-126.23579867039288,-49.77045050810228,-0.11380568448056988,-0.4636336606549918,-0.3498279761744219,862303395,869476146,73.23090091202305,66.50973765338394,NaN,NaN,-11.413940992930502,-7.204741003473028
2019-08-15T09:30:00-04:00,89.52,89.79,88.87,89.45,12320668,9911969.65,41.0673904960055,43.653277815685726,NaN,NaN,-133.70006944537732,-65.64374572074675,-0.15022281963788564,-0.537606500721779,-0.3873836810838933,874624063,871138372.6,74.31831182510912,66.35761910329707,NaN,NaN,-12.67154405149735,-7.9857128674765026
2019-08-16T09:30:00-04:00,90.06,90.7861,90,90.55,10252416,10019293.8,47.15624472007235,43.29347626222699,NaN,NaN,-42.46581056841138,-71.44613166174297,-0.09144231272564107,-0.5016865719909447,-0.4102442592653036,884876479,873400469.6,75.76133814123372,66.15389159723523,NaN,NaN,-11.427335452480724,-8.47737323676282
2019-08-19T09:30:00-04:00,91.26,91.65,91.11,91.42,6427436,10081030.95,51.43044872270221,43.483267393640254,NaN,NaN,35.608195337946945,-51.87379999373569,0.00945521349798828,-0.3984252423928183,-0.40788045589080657,891303915,878367472.8,78.60415004774835,66.14774173517218,NaN,NaN,-8.878083685142574,-8.534617586531356
2019-08-20T09:30:00-04:00,91.45,91.64,90.57,90.64,4709026,9982052.7,47.704944958413186,43.888878854724325,NaN,NaN,3.448478162263837,-52.66900103679416,0.026140960790543566,-0.3752042549026271,-0.40134521569317066,886594889,879940548.2,79.42710247698253,66.68293528317626,NaN,NaN,-8.148578015198009,-8.479469076340878
2019-08-21T09:30:00-04:00,91.27,91.53,91.04,91.31,5687080,9994879.65,50.98909009617374,44.449290083325714,NaN,NaN,36.2678089043456,-20.168279521846454,0.08164573405559972,-0.29928804812367105,-0.38093378217927076,892281969,885936263,82.23223899581305,67.29419570215713,NaN,NaN,-6.437687858667103,-8.187786045244625
2019-08-22T09:30:00-04:00,91.48,91.69,90.5038,90.86,6486943,9988293.7,48.77360433740533,44.95942689065823,NaN,NaN,16.324930018225277,9.836720370874065,0.0869099981999294,-0.27229628442935905,-0.35920628262928844,885795026,888170455.6,83.15400267760604,68.31856218853231,NaN,NaN,-5.79708901172861,-7.84625789759948
2019-08-23T09:30:00-04:00,90.7,91.04,88.32,88.76,9822737,10288808.15,40.0320114409456,45.671036355689026,NaN,NaN,-115.82518054159499,-4.835153623762666,-0.04508870764254802,-0.41556716718247344,-0.3704784595399254,875972289,886389617.6,79.60883605744095,70.02652564405133,NaN,NaN,-8.34430850018128,-7.917407983682594
2019-08-26T09:30:00-04:00,89.47,89.76,89.1,89.69,8910549,10439958.9,44.75430022827705,46.02828896223392,NaN,NaN,-90.62693283438792,-30.082179258229633,-0.06273130591661069,-0.44889259193568876,-0.38616128601907806,884882838,885105402.2,77.05750635046216,71.89731330200469,NaN,NaN,-8.740615599868866,-8.035009071709204
2019-08-27T09:30:00-04:00,90.24,90.55,89.1031,89.16,8251963,10454599,42.69106994176238,46.22149216649233,NaN,NaN,-73.83762893909348,-45.5394006785011,-0.10080366909657823,-0.5121658723898008,-0.4113622032932226,876630875,883112599.4,73.14032796389091,73.37771248527494,NaN,NaN,-9.747534810957,-8.279655605887461
2019-08-28T09:30:00-04:00,88.85,90,88.72,89.81,5691503,10311294.8,45.980250179558425,46.0364365551615,NaN,NaN,-73.02388672329104,-67.39773980402842,-0.07415060168254978,-0.5040504553964098,-0.42989985371386,882322378,881120681.2,69.34569510582003,74.56510613655523,NaN,NaN,-9.489378807771086,-8.45247320615655
2019-08-29T09:30:00-04:00,90.49,90.75,89.91,90.49,4360327,9708185.05,49.26110218378864,46.034575184565824,NaN,NaN,6.307539163448251,-69.40121797498384,-0.006242552013227487,-0.43770304373039437,-0.4314604917171669,886682705,881298217,69.497591031323,75.29199584950126,NaN,NaN,-8.223974825714087,-8.419830580379056
2019-08-30T09:30:00-04:00,90.91,91.09,90.205,90.6,4784137,9149552.5,49.79232005970708,46.45158342742359,NaN,NaN,31.04225877839565,-40.0277301109857,0.04760162877818669,-0.37195845574443354,-0.4195600845226202,891466842,884397127.6,72.09666453329162,75.68922615401536,NaN,NaN,-7.058596576491831,-8.225368579823739
2019-09-03T09:30:00-04:00,90.07,90.5,89.75,90.07,6437819,8590131.8,47.22672926354108,46.14961951700633,NaN,NaN,-23.741785799535485,-26.650700704015218,0.04885644950486889,-0.3584895226415341,-0.407345972146403,885029023,884426364.6,72.12080097014967,75.68539050634968,NaN,NaN,-6.839879255769018,-8.027441533530208
2019-09-04T09:30:00-04:00,90.66,90.71,89.71,90.13,9319313,8549304.4,47.556171651869164,46.743977020015784,NaN,NaN,-19.46853674271732,-15.776882264739985,0.054624566313555944,-0.33906526425445804,-0.393689830568014,894348336,887969856.8,74.94909065399816,75.80811834506218,NaN,NaN,-6.56960259218872,-7.819178827624281
2019-09-05T09:30:00-04:00,90.9,91.215,90.42,91.02,7897420,8321552.4,52.31171963605484,47.54714338716217,NaN,NaN,48.55533676297218,8.538962432512658,0.11576331598750428,-0.24898568558363365,-0.36474900157113793,902245756,891954532.4,77.6899700328741,76.04895107418825,NaN,NaN,-4.94967369587362,-7.409249523088472
2019-09-06T09:30:00-04:00,91.21,91.5251,91.08,91.27,13166442,8378133.4,53.58492917513172,48.00633513395212,NaN,NaN,87.89069554986399,24.855593709795805,0.16729515849214943,-0.15563005345595116,-0.3229252119481006,915412198,897700431,80.93011328638237,76.41814929884173,NaN,NaN,-3.2428867860287216,-6.814054846365651
2019-09-09T09:30:00-04:00,91.35,91.38,90.1,90.43,10675897,8549275.05,48.864260569633956,47.823035980161535,NaN,NaN,23.82559622183874,23.412261198484423,0.14016164029555755,-0.14772316157865362,-0.28788480187421117,904736301,900354322.8,82.21489798890056,76.67605986606688,NaN,NaN,-3.0890827713452094,-6.281915978505588
2019-09-10T09:30:00-04:00,89.97,90.7,89.02,90.69,8770748,8632957.7,50.323056244787686,48.010043929188285,NaN,NaN,-28.495273722003667,22.461563613990783,0.13502455534203195,-0.11910410769667124,-0.2541286630387032,913507049,906049928,84.61113696001097,77.04634804342605,NaN,NaN,-2.5518649480972084,-5.749051545590105
2019-09-11T09:30:00-04:00,90.84,91.62,90.62,91.59,8124290,8426141.55,55.09821065650424,48.30355254064047,NaN,NaN,99.65287014506463,46.28584499154718,0.1844792596544412,-0.023529588470651674,-0.20800884812509288,921631339,911506528.6,86.4892441846654,77.35041984262979,NaN,NaN,-0.6826558223483791,-5.0252807279841445
2019-09-12T09:30:00-04:00,92,92.38,91.51,91.56,9344700,8072070.7,54.90874195764826,48.74177665637211,NaN,NaN,140.67839931511278,64.7104575019753,0.2057876496404472,0.04922571392546615,-0.15656193571498106,912286639,913514705.2,87.11261035188994,77.63317753365007,NaN,NaN,0.7906945948680139,-4.194427110433836
2019-09-13T09:30:00-04:00,91.67,92.25,91.32,91.51,6350964,7773585.5,54.57191826673524,49.7803414296428,NaN,NaN,116.66504189014297,70.4653267700311,0.20659206912143166,0.10167815068680852,-0.10491391843462314,905935675,911619400.6,83.21046597041276,77.89043681314806,NaN,NaN,1.9262562932528087,-3.3200437670500302
2019-09-16T09:30:00-04:00,91.01,91.54,90.9,91.31,6668085,7594368.95,53.167009744759824,50.38124925224871,NaN,NaN,62.829263544673545,78.26606023459806,0.18445931343190186,0.12566022335525417,-0.05879909007664767,899267590,910525658.4,80.9567660283837,78.16895536157101,NaN,NaN,2.5338232638706577,-2.4837770483470747
2019-09-17T09:30:00-04:00,91.26,91.7,91.13,91.45,3963154,7471154.85,54.05860093178192,51.19321575153582,NaN,NaN,80.86859892829625,100.13883476465804,0.17038780194870973,0.15418566235923947,-0.01620213958947024,903230744,908470397.4,76.75013901810232,78.42679900830042,NaN,NaN,3.279253869887331,-1.660486917170731
2019-09-18T09:30:00-04:00,91.45,91.56,90.79,91.44,5412788,7506342.95,53.97955130989877,51.76459440370298,NaN,NaN,60.76451466061927,92.36116366776898,0.15214557620661517,0.17397983066879874,0.02183425446218356,897817956,903707720.8,67.94013592200676,78.32640192374232,NaN,NaN,3.892629745411215,-0.8671845368018817
2019-09-19T09:30:00-04:00,91.55,92.28,91.38,91.87,5084444,7476211.15,56.89821081508601,52.31010216308136,NaN,NaN,112.16413534799521,86.65831087434546,0.1599785167201797,0.2218074003624082,0.06182888364222849,902902400,901830873,64.78419681209624,77.98973090808327,NaN,NaN,5.177428000180172,-0.003668460090159642
2019-09-20T09:30:00-04:00,91.7,92.43,91.6901,92,9000207,7601874.35,57.77020017728805,52.879950742908576,NaN,NaN,117.56970687559078,86.83924387143502,0.16423432805259458,0.26712179370797173,0.10288746565537714,911902607,903024259.4,65.86981608465805,77.54495601889515,NaN,NaN,6.50411791849706,0.9260153082794431
2019-09-23T09:30:00-04:00,91.73,92.0588,91.48,91.51,4329101,7327192.55,53.386090430185675,53.31990511195461,NaN,NaN,78.23751516934348,89.920894196369,0.12608369263055663,0.26049208144357294,0.1344083888130163,907573506,904685442.6,67.37739386762337,77.20614122585756,NaN,NaN,6.595130636251548,1.7358889265611723
2019-09-24T09:30:00-04:00,91.85,91.91,90.35,90.67,10615767,7412453.45,46.82569965228019,53.26772854055541,NaN,NaN,4.724348302226083,74.69204407115498,0.0407298847061936,0.18532074469575832,0.14459085998956472,896957739,903430841.6,65.0407141768884,76.49840004892114,NaN,NaN,4.864302879949165,2.1828052056166
2019-09-25T09:30:00-04:00,90.68,90.76,90.1,90.23,8131900,7406450.3,43.790158122817395,52.659045575324164,NaN,NaN,-68.62661907266582,48.81381732449795,-0.04430133573232653,0.08921419032415656,0.1335155260564831,888825839,901632418.2,61.735562579237424,75.35879951651853,NaN,NaN,2.4939670128941662,2.227256892370538
2019-09-26T09:30:00-04:00,90.53,90.56,89.04,89.73,10183821,7631066.2,40.571499107288496,51.7295148561925,NaN,NaN,-139.83504278456482,-1.586018302014054,-0.12840097562515088,-0.026985693474955497,0.10141528215019538,878642018,896780341.8,53.793134304610334,73.4204438749634,NaN,NaN,-0.5142550669567292,1.835612326752357
2019-09-27T09:30:00-04:00,90.03,90.16,89,89.33,10017318,7913915.75,38.15532469562692,50.964590865191994,NaN,NaN,-154.24707981511335,-55.949375640154884,-0.200833658610335,-0.14962679111272337,0.051206867497611636,868624700,888124760.4,43.13264221678002,70.62885417695477,NaN,NaN,-3.81012541961198,1.0290783629860232
2019-09-30T09:30:00-04:00,89.45,90.68,89.39,90.13,8306829,8090050.35,45.18623472173654,50.59767504211691,NaN,NaN,-85.97796346712917,-88.79247136744941,-0.18511774098726586,-0.18019030873647068,0.004927432250795172,876931529,881996365,37.470564175674674,67.26167040664504,NaN,NaN,-4.7038134435536385,0.21009381919464287
2019-10-01T09:30:00-04:00,90.37,90.57,89.07,89.25,13618966,8449107.7,39.82306786222505,49.50659341395412,NaN,NaN,-123.10236437705447,-114.35781390330553,-0.22176759703273746,-0.27228206404012667,-0.0505144670073892,863312563,875267329.8,32.43574004734556,63.400705825407904,NaN,NaN,-7.194124715016119,-0.8476516856926086
2019-10-02T09:30:00-04:00,88.97,89.15,87.56,87.95,13505857,8658434.9,33.497825946413215,47.97724227029447,NaN,NaN,-214.52254088091746,-143.53699826495586,-0.31561602509591447,-0.44503449837728226,-0.12941847328136782,849806706,867463503.2,27.774698996799017,59.16228358575855,NaN,NaN,-11.636594817364383,-2.3889292759314333
2019-10-03T09:30:00-04:00,87.83,88.77,87.2,88.74,12830412,8905084.5,39.759617017438,46.919220752487526,NaN,NaN,-172.65168894771608,-150.1003274975861,-0.306297450160407,-0.5122902859818765,-0.20599283582146957,862637118,864262523.2,26.11686804153844,55.08416944798182,NaN,NaN,-13.21583447644249,-3.935630018861584
2019-10-04T09:30:00-04:00,89,90.18,88.945,90.13,9313631,8712443.95,48.880229744126936,46.61302218101374,NaN,NaN,-57.86306967267371,-130.82352546909817,-0.19381557938151522,-0.4482623100483636,-0.25444673066684836,871950749,864927733,27.09081097867835,51.236601230145716,NaN,NaN,-11.28930155196614,-4.986154523590806
2019-10-07T09:30:00-04:00,89.76,90.42,89.625,89.83,8343461,8595822.15,47.21857679776255,46.12444902858379,NaN,NaN,-39.86367600526636,-121.60066797672562,-0.12997954584843197,-0.41692116297738835,-0.2869416171289564,863607288,862262884.8,25.63304778075684,47.585380427478185,NaN,NaN,-10.359002328284582,-5.7537042099756315
2019-10-08T09:30:00-04:00,89.08,89.12,88.1,88.12,10688556,8691712.55,39.06645551628314,45.059227900468386,NaN,NaN,-125.94547246135629,-122.16928959358597,-0.18966682734215123,-0.5240251513066454,-0.33435832396449416,852918732,860184118.6,24.5244302113057,44.48425859099954,NaN,NaN,-12.5264465680059,-6.721238832551384
2019-10-09T09:30:00-04:00,88.66,89.02,88.36,88.76,7355855,8653290.8,43.030757510195976,44.06869552154767,NaN,NaN,-97.87500245546468,-98.83978190849541,-0.1732434246892695,-0.5509126048260811,-0.37766918013681156,860274587,862277694.8,27.9062237758138,41.8501176598365,NaN,NaN,-12.824959101909839,-7.593198871031163
2019-10-10T09:30:00-04:00,88.5,89.51,88.42,89.2,8236079,8597859.75,45.64880069939289,43.202881273126586,NaN,NaN,-71.06848443887681,-78.52314100672756,-0.12234493758284776,-0.5306003521153713,-0.4082554145325235,868510666,863452404.4,29.806701454565996,39.274180900544216,NaN,NaN,-12.16721469830643,-8.246629703499059
2019-10-11T09:30:00-04:00,90.05,90.995,89.9,89.94,10825812,8821602.15,49.825055513188516,42.94852163619822,NaN,NaN,10.324058920169621,-64.88571528815889,-0.033082170228313834,-0.4496081273179158,-0.41652595708960194,879336478,864929550.2,32.226087040775695,36.76337327005509,NaN,NaN,-10.215624333047089,-8.52791465057735
2019-10-14T09:30:00-04:00,89.88,90.34,89.7582,89.9,5919186,8784157.2,49.60318459922381,43.146913418122764,NaN,NaN,-4.349956681971016,-57.782971423499816,0.0258449061616699,-0.38421982438751456,-0.41006473054918446,873417292,866891551,35.41051730925547,34.64693063665274,NaN,NaN,-8.765934707386766,-8.561917515835837
2019-10-15T09:30:00-04:00,90.89,91.855,90.83,91.54,12622404,9217119.7,57.88392247932203,44.153610872158815,NaN,NaN,95.79559319363294,-13.434758292501991,0.16982387388298187,-0.19778488819545714,-0.367608762078439,886039696,873515743.8,44.8348841921195,33.43973932328718,NaN,NaN,-4.601322616630961,-7.996118244520855
2019-10-16T09:30:00-04:00,91.47,91.89,91.27,91.42,7856921,9339326.35,57.14404635257513,45.33736424682213,NaN,NaN,101.62975049688833,26.46619229796862,0.2468579526803913,-0.059036321227949884,-0.3058942739083412,878182775,877097381.4,49.154785470148724,33.10842869225421,NaN,NaN,-1.5874275547169556,-7.080591003120298
2019-10-17T09:30:00-04:00,91.72,92.36,91.68,92.1,7537106,9461959.45,60.24506553707715,46.9152028783543,NaN,NaN,135.53836316576647,67.78756181889727,0.3283855101807187,0.10458761381755721,-0.2237978963631615,885719881,880539224.4,52.96642138623269,33.81084149007226,NaN,NaN,1.9315553072085914,-5.793141530216171
2019-10-18T09:30:00-04:00,91.84,92.235,91.35,91.76,6784975,9351197.85,57.98578821967964,47.829456699635955,NaN,NaN,120.06500871070116,89.73575177700359,0.3426132096995579,0.20446861576128583,-0.13814459393827203,878934906,880458910,52.86682774187109,34.91057460194342,NaN,NaN,4.116960525126579,-4.377412665167206
2019-10-21T09:30:00-04:00,92.14,92.28,91.475,91.66,4952132,9382349.4,57.3051017542206,49.07817340620706,NaN,NaN,120.34623656512962,114.6749904264237,0.3284481770393715,0.2724156273609424,-0.05603254967842913,873982774,880572006.4,53.00084511067741,36.3795106778957,NaN,NaN,5.68703848699212,-2.9396339291444455
2019-10-22T09:30:00-04:00,92.36,92.953,91.82,91.86,8746301,9288876.1,58.35796549400017,50.853897659606126,NaN,NaN,133.9544537539287,122.30676253848287,0.3156263836382508,0.33850042986938433,0.022874046231133566,882729075,879909882.2,52.06742768862149,38.114705584454455,NaN,NaN,7.28756084982588,-1.4786061035772562
2019-10-23T09:30:00-04:00,92.02,92.7,91.83,92.43,5549276,9159744.9,61.287991242657924,52.39163867569327,NaN,NaN,120.9164091668777,126.16409427248075,0.3272118054184978,0.4318888030042558,0.10467699758575802,888278351,881928997.4,54.688094189679,40.155507452178774,NaN,NaN,9.518053938028748,0.09234533093788722
2019-10-24T09:30:00-04:00,92.59,92.69,91.63,91.96,6984395,8999773.6,57.68385297221391,53.020468906270914,NaN,NaN,93.79445190021707,117.81531201937086,0.2863717176113237,0.46264164459991264,0.17626992698858895,881293956,881043812.4,53.31195222532259,42.02844611265338,NaN,NaN,10.416666746329515,1.5672483902795482
2019-10-25T09:30:00-04:00,91.72,92.305,91.48,92.06,5536898,8775752.6,58.24646131868039,53.80817494347933,NaN,NaN,76.3413124876307,109.07057277475678,0.25053661023812845,0.48944068978624955,0.2389040795481211,886830854,882623002,55.46501490651016,44.15930090735003,NaN,NaN,11.314777801846935,2.959752591932032
2019-10-28T09:30:00-04:00,92.3,93.2,92.22,93.01,6937897,8707306,63.24582793821327,55.53527297361719,NaN,NaN,105.92958948748816,106.18724335922848,0.2733910538135203,0.5806428968150215,0.30725184300150116,893768751,886580197.4,60.393922695308376,46.72140751335023,NaN,NaN,13.591189183308947,4.47852924784302
2019-10-29T09:30:00-04:00,93.23,94.48,93,94.33,13768396,8714777.5,68.83037858822257,57.37810305061909,NaN,NaN,140.1498601797216,107.42632464438707,0.3548223253201011,0.7507797496516275,0.3959574243315264,907537147,891541811.8,65.54318185285612,49.40976166171039,NaN,NaN,17.480388435717025,6.335937703253592
2019-10-30T09:30:00-04:00,94.36,94.9,93.99,94.86,10181074,8548538.35,70.75198570362407,59.17118769377846,NaN,NaN,155.60017570503751,114.36307795201901,0.4174749896725196,0.9178011614221759,0.5003261717496563,917718221,897429785.8,70.45259733166245,52.31303993864585,NaN,NaN,21.328242325416372,8.477695506419703
2019-10-31T09:30:00-04:00,94.68,94.805,94.135,94.75,9675234,8390779.45,69.79030769936008,60.59727713564786,NaN,NaN,146.7658396156223,124.95735549510007,0.42327841587753545,1.0294241915965756,0.6061457757190402,908042987,902779592,74.06793282008886,55.30174320859679,NaN,NaN,24.140780311715833,10.715279050033436
2019-11-01T09:30:00-04:00,95.26,95.67,94.85,94.87,14670803,8658638.05,70.26512917153065,62.07313031938406,NaN,NaN,156.6688048524532,141.02285396806457,0.40685894132099254,1.1147194523702808,0.7078605110492883,922713790,909956179.2,77.96323941933454,58.34122335931672,NaN,NaN,26.582649259428248,12.982046222804122
2019-11-04T09:30:00-05:00,95.31,95.36,94.54,94.58,9878200,8735375,67.50382734083577,62.760266380920754,NaN,NaN,128.6470416271185,145.56634439599065,0.3502787630927757,1.1457089649152579,0.7954302018224821,912835590,913769547,79.70751519846743,60.83212557405586,NaN,NaN,27.883034085099982,15.110758774560674
2019-11-05T09:30:00-05:00,94.72,94.73,93.7,93.91,13273753,8864634.85,61.49139924455583,63.07079158749081,NaN,NaN,86.98423497718389,134.93321935548312,0.24644359187641507,1.103484691668001,0.8570410997915859,899561837,912174485,76.9633825507577,62.81845393695651,NaN,NaN,27.304283867384083,16.852690930678303
2019-11-06T09:30:00-05:00,94,94.41,93.71,94.23,13130204,9153352.3,63.17828388091787,63.28030718347943,NaN,NaN,76.44057124647482,119.10129846377058,0.1810509101742478,1.0833547375093957,0.9023038273351479,912692041,911169249,75.20612985450042,64.40700454183278,NaN,NaN,27.28528713544337,18.343061817073313
2019-11-07T09:30:00-05:00,94.59,94.74,94.155,94.44,7827918,9132944.25,64.28400201937079,63.73017959774314,NaN,NaN,82.28583451349637,106.2052974433454,0.13574863390884806,1.071989619721208,0.9362409858123599,920519959,913664643.4,76.63245644473562,66.10454944918024,NaN,NaN,27.571597031635758,19.661423990582232
2019-11-08T09:30:00-05:00,94.38,95.15,94.27,95.13,7756856,8979496.45,67.71453739027768,64.47371071460437,NaN,NaN,91.21330146270451,93.11419676539563,0.13573653477234404,1.10591165427779,0.970175119505446,928276815,914777248.4,77.26057360165348,67.83738719853567,NaN,NaN,28.80548642184499,20.96771862361977
2019-11-11T09:30:00-05:00,94.77,94.97,94.48,94.74,6092506,8988162.45,63.97425373074479,64.87487416008612,NaN,NaN,77.2148569023572,82.82775982044339,0.09487962755793744,1.0887746539528678,0.9938950263949303,922184309,916646992.2,78.31545512291844,69.71224630098546,NaN,NaN,28.788320319447703,22.084947437309474
2019-11-12T09:30:00-05:00,94.89,95.65,94.76,95.31,13801645,9047124.5,66.85579694531998,65.27257456741913,NaN,NaN,94.93841055877283,84.41859493676117,0.09161247992631782,1.1084106263028275,1.0167981463765097,935985954,923931815.6,81.8485623426104,71.65227974048055,NaN,NaN,29.605748992908442,23.159347659537897
2019-11-13T09:30:00-05:00,95.05,95.65,94.9,95.42,6575151,8983036,67.3977506982615,65.96642440499396,NaN,NaN,92.28358772055097,87.58719823157641,0.08251220591491171,1.1199384037701492,1.0374261978552375,942561105,929905628.4,84.13180145796339,73.85369754281204,NaN,NaN,30.431289289073188,24.198196463757224
2019-11-14T09:30:00-05:00,95.4,95.57,94.85,95.43,6498793,8931120.35,67.44985811356736,66.62380989034303,NaN,NaN,84.42413829383644,88.01485898764443,0.06366306430669688,1.1170050282386086,1.0533419639319117,949059898,935613616.2,85.95033919417216,76.03122070621647,NaN,NaN,31.126813009934963,25.1879988274969
2019-11-15T09:30:00-05:00,95.76,97.63,95.67,97.46,11338575,9158800.35,75.87820369428053,67.52612244434782,NaN,NaN,168.39330402567737,103.45085950023899,0.16845820441600523,1.2639147194519182,1.095456515035913,960398473,942037947.8,87.66390917950626,77.97907688365918,NaN,NaN,34.630134047137034,26.536875287445493
2019-11-18T09:30:00-05:00,97.37,97.925,97.01,97.13,11251369,9473762.2,72.58775300790563,67.79450633146804,NaN,NaN,179.94183039302294,123.99625419837214,0.19426401357463297,1.3382865320042043,1.1440225184295714,949147104,947430506.8,88.8889301524521,79.64663033363031,NaN,NaN,36.42021929029654,27.94878157356707
2019-11-19T09:30:00-05:00,97.47,97.93,97.22,97.79,10025766,9537735.45,74.92938188917063,68.09289177329279,NaN,NaN,180.8516449410298,141.17890107482353,0.23194477740982622,1.433953490191854,1.2020087127820278,959172870,952067890,89.82471362238559,81.03035292582481,NaN,NaN,38.69033640483435,29.483289406605255
2019-11-20T09:30:00-05:00,97.63,97.97,97.075,97.66,12305824,9875562.85,73.59582753168078,68.36471461845856,NaN,NaN,156.5465814448967,154.03149981969267,0.22414864139414337,1.482194514524707,1.2580458731305637,946867046,952929078.2,89.99326093657247,82.16787636271651,NaN,NaN,40.10157503753278,31.000187353880616
2019-11-21T09:30:00-05:00,97.72,97.98,97.05,97.91,9122428,9982464.5,74.5344542251925,68.66966640800584,NaN,NaN,141.32630903151497,165.41193396722838,0.21199698407471512,1.5230421032239576,1.3110451191492425,955989474,954314993.4,90.27251470914729,83.04711031198885,NaN,NaN,41.54406481868859,32.5064555631389
2019-11-22T09:30:00-05:00,98.08,98.395,97.87,98.26,6141823,10012710.75,75.82987810842029,69.26438431997616,NaN,NaN,144.2541269925707,160.58409856060706,0.20365096271138938,1.5656088225384792,1.3619578598270898,962131297,954661558.2,90.34507314916597,83.8069358798959,NaN,NaN,43.13955675434052,34.025470019024844
2019-11-25T09:30:00-05:00,98.66,99.43,98.51,99.41,11727071,10252169.45,79.51685222621197,70.55191667580874,NaN,NaN,159.20101423183453,156.43593532836937,0.24871772178470053,1.6728550120579655,1.424137290273265,973858368,959603811,91.33741242736942,84.83365229965386,NaN,NaN,45.786636372286104,35.70563664091931
2019-11-26T09:30:00-05:00,99.4,99.56,99,99.33,11073600,10117429.65,78.61840554248857,71.65478250877808,NaN,NaN,141.13057889518478,148.49172211920035,0.24583749838417357,1.731434163253482,1.4855966648693084,962784768,960326190.6,91.47532823907945,85.99573789855238,NaN,NaN,47.632350557342214,37.40945291469401
2019-11-27T09:30:00-05:00,99.47,99.99,99.375,99.84,6333327,9925042.3,80.1575957645893,72.78861063343655,NaN,NaN,136.77232462456666,144.53687075513437,0.25014812959225075,1.798281826859622,1.5481336972673712,969118095,964776400.4,92.28972491249623,87.11411421767812,NaN,NaN,49.67433157466119,39.16157843754646
2019-11-29T09:30:00-05:00,99.58,99.81,99.2922,99.49,2391998,9560880.5,76.10841259325684,73.38817314793505,NaN,NaN,113.6778463546736,139.0071782197661,0.20328654967778714,1.802241884364605,1.598955334686818,966726097,966923725,92.65438512227003,88.21367218343644,NaN,NaN,50.18498266117699,40.73635046949368
2019-12-02T09:30:00-05:00,99.69,99.72,98.73,99.05,6684759,9161578.3,71.23655101194359,73.90690866802069,NaN,NaN,90.04653537819752,128.16565989689144,0.12060085974544776,1.7497064093686276,1.6291055496231799,960041338,966505733.2,91.74477644003488,89.17290942037334,NaN,NaN,49.16857487484719,41.94095395597275
2019-12-03T09:30:00-05:00,98.3,98.9082,98.03,98.83,7820107,9058673.65,68.8629771062353,74.05027867951465,NaN,NaN,62.88519077322103,108.90249520516875,0.033560844465611694,1.6710566052051945,1.6374957607395828,952221231,962178305.8,82.693558697209,89.23326630284467,NaN,NaN,47.63246269891594,42.754026633536064
2019-12-04T09:30:00-05:00,99.23,99.88,99.13,99.75,6237742,8706873.1,72.92561654164687,74.44512623975645,NaN,NaN,93.9564871939791,99.46767686492761,0.021030048641967003,1.6637833215420414,1.6427532729000744,958458973,961313146.8,80.97359255895991,89.00767995291585,NaN,NaN,47.45461135834994,43.425538737080906
2019-12-05T09:30:00-05:00,99.81,99.9,98.91,99.75,7390352,8419880.5,72.92561654164687,74.83625184176212,NaN,NaN,86.12053540929503,89.33731902187327,-0.002903109333801668,1.6391243862328224,1.642027495566624,958458973,959181322.4,76.73814144510484,88.34966582798246,NaN,NaN,47.31224553988046,43.98078256605227
2019-12-06T09:30:00-05:00,100.27,100.75,100.2,100.41,5658524,8311410.8,75.57690712737465,74.8147306584117,NaN,NaN,116.16852028525298,89.83545380798913,0.009397843575776665,1.653774800036345,1.6443769564605684,964117497,958659602.4,75.69464218361888,87.49471818541907,NaN,NaN,47.970146458271934,44.55069169351222
2019-12-09T09:30:00-05:00,100.45,100.47,99.71,99.71,5328658,8190000.9,67.97398923478143,74.48517610318855,NaN,NaN,87.3115685426976,89.28846044088915,-0.04304864343950454,1.5905661521611876,1.6336147956006921,958788839,958409102.6,75.16612681211605,86.51451794682364,NaN,NaN,46.19313667994845,44.78532669157454
2019-12-10T09:30:00-05:00,99.69,100.02,99.295,99.93,6029427,8186846.95,69.02852754701799,74.06368650732051,NaN,NaN,71.9570350944737,91.10282930513968,-0.07451787264177456,1.540467454798474,1.6149853274402486,964818266,960928509.6,76.91215597799601,85.59219240079582,NaN,NaN,45.04361074392475,44.82222441333886
2019-12-11T09:30:00-05:00,100.01,100.27,99.82,100.02,6064341,7799981.75,69.47139221026879,73.76908398436251,NaN,NaN,81.18848627596627,88.54922912153711,-0.09931574903978091,1.4908406411405224,1.5901563901803033,970882607,963413236.4,78.51642976289705,84.77241874553329,NaN,NaN,44.22803668231378,44.73734045176385
2019-12-12T09:30:00-05:00,100.07,101.28,100.02,100.95,9769053,7959676.85,73.66233362709437,73.70678965592693,NaN,NaN,115.28332132451072,94.38178630458025,-0.06479900679991513,1.5091576316804094,1.5739566384803245,980651660,967851773.8,81.04957445238821,84.11363729862192,NaN,NaN,44.749031681108434,44.7390106273845
2019-12-13T09:30:00-05:00,100.85,101.47,100.47,100.88,6433171,7956395.75,72.85166411159287,73.49406008472496,NaN,NaN,127.20870943087226,96.58982413370411,-0.0585844091510459,1.500726127041517,1.559310536192563,974218489,969871972.2,82.08497813603283,83.52363051196957,NaN,NaN,44.93378821987144,44.766835997739776
2019-12-16T09:30:00-05:00,101.47,102.34,101.47,101.97,7730256,7775979.8,77.08128772983312,73.32009119212648,NaN,NaN,182.12586196243947,115.55268281765248,0.0037271888413039633,1.563969522244193,1.560242333402889,981948745,974503953.4,84.21460553885349,83.01485859136129,NaN,NaN,46.447113900009334,45.006875698064
2019-12-17T09:30:00-05:00,102.1,102.25,101.72,101.86,4643726,7445597.65,75.79787480531671,73.11862471089991,NaN,NaN,168.296281607283,134.82053212021432,0.021343131339160326,1.5869212475768393,1.565578116237679,977305019,977001304,85.23378987447038,82.56903442246065,NaN,NaN,47.27388552527735,45.33073424480877
2019-12-18T09:30:00-05:00,101.9,102.2,101.79,102,5202934,7204456.05,76.33787172851396,72.84578727975168,NaN,NaN,151.50826112327312,148.8844870896757,0.02592701669792241,1.597986887110082,1.5720598704121596,982507953,979326373.2,86.13156157911138,82.12916561293316,NaN,NaN,48.10832151954196,45.727532426913506
2019-12-19T09:30:00-05:00,102.21,102.51,102.045,102.4,6637192,6921024.45,77.85797062505952,72.97075571059472,NaN,NaN,150.24952966460995,155.87772875769556,0.038635865946834214,1.6203547028457024,1.5817188368988682,989145145,981025070.2,86.76469542312219,81.70847349156544,NaN,NaN,49.26745078659414,46.233235049725025
2019-12-20T09:30:00-05:00,102.28,102.925,102.28,102.7,8586532,6894229.65,78.95019547536234,73.52173031512463,NaN,NaN,146.00866983940372,159.63772083940185,0.04930124094188715,1.6433453880762272,1.59404414713434,997731677,985727707.8,88.35029387231842,81.46601045101427,NaN,NaN,50.565580153921275,46.852141493181634
2019-12-23T09:30:00-05:00,102.94,103.22,102.68,103.11,4770887,6825682.85,80.37498867062418,74.34401685543813,NaN,NaN,145.5074184346126,152.31403213383646,0.0650342848015728,1.6753370031363062,1.6103027183347334,1002502564,989838471.6,89.53097153757011,81.95439708246863,NaN,NaN,52.10177291754241,47.602088839518885
2019-12-24T09:30:00-05:00,103.11,103.24,102.73,102.98,2071790,6342918.8,78.55928297879346,74.7464216009486,NaN,NaN,125.03857418818637,143.66249065001713,0.04850912842012134,1.6709391288598852,1.6224300004397638,1000430774,994463622.6,90.67597754297095,82.64742458132658,NaN,NaN,52.87116339439287,48.35481377592946
2019-12-26T09:30:00-05:00,103.11,103.23,102.5807,102.91,2910075,5934742.55,77.54348067712363,75.07626903919694,NaN,NaN,106.270600066466,134.61495843865572,0.016349930789760547,1.6428674139269646,1.626517483137204,997520699,997466171.8,91.33827724912514,83.69029142447087,NaN,NaN,53.23850097398732,49.05248337565201
2019-12-27T09:30:00-05:00,103.13,103.1429,102.71,102.94,3605004,5798326.4,77.6767032790979,75.22625447860574,NaN,NaN,94.98751004426074,123.56255451458587,-0.017578041151112167,1.6045449316983138,1.622122972849426,1001125703,999862283.4,91.83661428119271,84.84328943144045,NaN,NaN,53.58066256686283,49.699366117253554
2019-12-30T09:30:00-05:00,102.27,102.49,101.51,101.66,5675237,5962488.35,61.03831054339666,74.73084885779255,NaN,NaN,37.36624492653161,101.83406953201145,-0.13439716190021112,1.454126520474162,1.5885236823743731,995450466,999406041.2,90.7657998476121,85.95755179111873,NaN,NaN,48.8154652124529,49.57309455942489
2019-12-31T09:30:00-05:00,101.44,101.95,101.27,101.86,4746947,5865597.75,62.39376566655831,74.25693729490258,NaN,NaN,22.321646321186027,77.19691510932611,-0.20229053674189634,1.3356605114470028,1.5379510481888992,1000197413,998945011,89.62853075902989,86.8658642754783,NaN,NaN,45.276691173024105,48.95932264708192
2020-01-02T09:30:00-05:00,102.17,102.2899,101.4,102.13,6236522,5786418.5,64.20425995968463,73.880713562718,NaN,NaN,30.1136860789257,58.211937487473996,-0.2310308214807133,1.2491625213380075,1.4801933428187208,1006433935,1000145643.2,89.98061560227944,87.68473469257705,NaN,NaN,42.814729401678406,48.08152361202428
2020-01-03T09:30:00-05:00,100.95,101.82,100.45,101.24,8247451,5886903.95,54.83314263242276,72.53577134881287,NaN,NaN,-25.200912051520817,31.917635063876617,-0.3072260187009861,1.0961608194424883,1.4033868381434744,998186484,1000278800.2,90.02107593619361,88.32555622713457,NaN,NaN,37.554398536814794,46.57764860128007
2020-01-06T09:30:00-05:00,100.78,101.9,100.75,101.87,6441759,5839474.3,59.355496851054724,71.57175940163158,NaN,NaN,-10.164461336336457,10.88724078775719,-0.311467678320422,1.0140522402429468,1.3255199185633688,1004628243,1000979308.2,90.24426966696716,88.90836276505846,NaN,NaN,34.46070459665584,44.84665660061946
2020-01-07T09:30:00-05:00,101.59,101.76,101.1,101.67,6336491,5873372.65,57.3909506355653,70.16530675204102,NaN,NaN,-15.163228063059233,0.3813461898390223,-0.3226466628634026,0.9222115899841157,1.2448582528475183,998291752,1001547565.4,90.43123905632446,89.3524080163064,NaN,NaN,31.345733337309174,42.91795327728942
2020-01-08T09:30:00-05:00,101.72,102.785,101.68,102.33,7494732,5981676.35,61.875363964768475,69.17084169200186,NaN,NaN,43.34710951278267,4.586438828158357,-0.2819692395354285,0.8923967034282327,1.1743659429636613,1005786484,1002665379.6,90.8045684599771,89.75032077241403,NaN,NaN,30.058312759845823,41.08086177479748
2020-01-09T09:30:00-05:00,102.64,103.05,102.42,102.77,6661046,6013257.3,64.55371753695943,68.3291163926051,NaN,NaN,85.23792295384268,15.611286203141754,-0.22431882323307972,0.8939674139223115,1.1182862371553912,1012447530,1003868098.6,91.20229548008056,90.11251605105467,NaN,NaN,29.834047813890614,39.474174066096495
2020-01-10T09:30:00-05:00,103.16,103.33,102.62,102.8,9300436,6175062.05,64.73562547401309,67.39180602467322,NaN,NaN,93.72304816833875,39.396078247113664,-0.18470616803333795,0.8874035271137188,1.0721096951470568,1021747966,1008580395,92.56008926596473,90.52647275411485,NaN,NaN,29.710361869232454,38.07934375225877
2020-01-13T09:30:00-05:00,102.97,102.99,102.085,102.44,7621781,6067698.45,60.70935885406017,66.08888912315163,NaN,NaN,39.730539015445665,49.37507831747009,-0.18294369905531283,0.8434300713279157,1.0263737703832285,1014126185,1010479983.4,93.02726391251333,90.86054204270019,NaN,NaN,28.41070579262588,36.6981097580255
2020-01-14T09:30:00-05:00,102.13,103.08,101.95,103.06,7295065,6110793.15,64.77294433390074,64.97445738481424,NaN,NaN,57.47095174470987,63.90191427902391,-0.14203910882010695,0.8488248843580948,0.9908639931782017,1021421250,1015105883,94.0131588823492,91.18069828161299,NaN,NaN,28.5170129174412,35.52938163794203
2020-01-15T09:30:00-05:00,103.18,104.22,103.1,103.95,7521760,6100368.35,69.62879486125364,64.33656537641853,NaN,NaN,170.93090288763955,89.41867295399531,-0.061190776410245284,0.9143755226653951,0.9755662990756404,1028943010,1019737188.2,94.80510570443694,91.47563600743199,NaN,NaN,30.21702130253824,34.77047301859863
2020-01-16T09:30:00-05:00,104.38,104.555,103.97,104.49,5480266,6142195.35,72.13828368943209,63.95047987729772,NaN,NaN,203.14442052410712,112.99997246804818,0.018258600396243496,0.9983895495709447,0.9801309491747012,1034423276,1024132337.4,95.42377750798694,91.76745745449355,NaN,NaN,32.47706272586469,34.442842976779495
2020-01-17T09:30:00-05:00,104.23,104.65,104.23,104.49,6533427,6208720,72.13828368943209,63.55487847803587,NaN,NaN,184.47219252382132,131.14980133914472,0.05816311781156236,1.0528348464391541,0.9946717286275918,1034423276,1026667399.4,95.73898485533252,92.04619820978925,NaN,NaN,34.246995037448514,34.41486469973221
2020-01-21T09:30:00-05:00,104.25,104.84,104.21,104.6,6644775,6209099.15,72.67174561127091,64.38583812574117,NaN,NaN,165.08395405285026,156.22048434662562,0.07807720023900133,1.0922682289263435,1.0141910286873421,1041068051,1032055772.6,96.3193109455807,92.44287757392988,NaN,NaN,35.84685541980485,34.619434802599734
2020-01-22T09:30:00-05:00,104.83,105.08,104.59,104.73,9431510,6251348.05,73.32185514678723,65.16641594575752,NaN,NaN,157.21821241797062,176.16993648127777,0.08551613573142203,1.1210861983516196,1.0355700626201976,1050499561,1037871434.8,96.82233956393063,92.9567210599942,NaN,NaN,37.35979273398736,35.01091450708368
2020-01-23T09:30:00-05:00,104.55,104.7,103.48,104.2,8522609,6438934.15,66.3879036403614,65.3223904943773,NaN,NaN,92.81946205891019,160.54764831553192,0.04243136282683313,1.088609266153739,1.0461779033269059,1041976952,1040478223.2,97.01899992886224,93.45946279760726,NaN,NaN,36.69136525537452,35.25097889969666
2020-01-24T09:30:00-05:00,104.32,104.37,102.2,102.46,15962810,7133485.15,49.75287367265108,64.9595141401079,NaN,NaN,9.27723598918538,121.77421140854756,-0.10737819958247807,0.9119551538488082,1.0193333534312863,1026014142,1038796396.4,93.01916593260684,93.67361208306536,NaN,NaN,30.138153408576983,34.52057525810814
2020-01-27T09:30:00-05:00,101.22,102.07,101.0809,101.68,11762477,7576105.25,44.38391260614754,63.89011526547167,NaN,NaN,-84.96015608280791,67.8877416872217,-0.2547178337383519,0.7009360612583464,0.9556538949966983,1014251665,1034762074.2,84.06594562688265,93.23230322305933,NaN,NaN,22.73025776000962,32.836244186951205
2020-01-28T09:30:00-05:00,101.98,102.58,101.7031,102.18,8079947,7799852.4,48.23983117484385,63.23646387542014,NaN,NaN,-43.13884657894344,26.24318156086297,-0.31051841447195827,0.5675058769067505,0.8780242913787087,1022331612,1031014786.4,76.68288513219902,92.25027794276465,NaN,NaN,18.098774297923505,30.730891345661533
2020-01-29T09:30:00-05:00,102.28,102.64,101.88,101.9,6436020,7837891.55,46.30378109314753,62.124207956018644,NaN,NaN,-45.47204733670794,-14.294870390072742,-0.3550889747782897,0.43416307290584655,0.7892520476841363,1015895592,1024093992.6,65.27988232122419,90.42708607571087,NaN,NaN,13.785162134865391,28.31007288697637
2020-01-30T09:30:00-05:00,101.15,101.22,100.29,101.16,10989547,8150021.55,41.55686105389522,60.481575350085485,NaN,NaN,-125.31196680001163,-57.921156161857105,-0.41883111917731475,0.26571314871249285,0.6845442678898076,1004906045,1016679811.2,55.720538676461366,87.89267487545236,NaN,NaN,8.514843796750883,25.48218301694416
2020-01-31T09:30:00-05:00,100.76,100.84,98.81,99.14,14476689,8562029.9,31.933167386522967,58.13854262955048,NaN,NaN,-183.86116611993754,-96.54883658368169,-0.571980181377241,-0.030430958831743737,0.5415492225454973,990429356,1009562854,48.394626857423134,84.73799898912796,NaN,NaN,-0.2571640142970487,21.805133441052558
2020-02-03T09:30:00-05:00,99.83,100.76,99.83,100.04,11851774,8742246.05,38.740095907976034,56.569309561973036,NaN,NaN,-137.86945961476152,-107.1306972900724,-0.5854882037669419,-0.19031103216318002,0.39517717160376187,1002281130,1007168747,46.19438967428509,81.39279368639737,NaN,NaN,-4.658934688886328,18.024552279632715
2020-02-04T09:30:00-05:00,101.29,102.21,101.27,101.8,9575109,8898913.55,49.39731818727467,55.471050551499744,NaN,NaN,-49.3318295225399,-108.3692938787917,-0.454546177913823,-0.17300555078851687,0.28154062712530614,1011856239,1005073672.4,44.29645213357385,77.84160034719912,NaN,NaN,-4.1109664088874975,14.862335324129827
2020-02-05T09:30:00-05:00,102.28,104.12,102.27,103.76,14131008,9288639.4,58.13251462166616,54.6498876772435,NaN,NaN,41.19276418612514,-91.03633157422509,-0.22613032220300236,-0.0011222756284468005,0.22500804657455556,1025987247,1007092003.4,46.57377573890419,74.39650534966107,NaN,NaN,0.06762043822710936,12.748804626143725
2020-02-06T09:30:00-05:00,104.24,104.24,103.395,103.85,6166481,9222226.85,58.486883522270276,53.67478766530337,NaN,NaN,61.51385668382593,-53.67116687745757,-0.06741732950818921,0.14073638468931904,0.20815371419750825,1032153728,1012541540,52.250088632119905,71.31267042995628,NaN,NaN,3.172593535534926,11.380774470342468
2020-02-07T09:30:00-05:00,103.86,103.95,102.88,103.04,6057198,9192034.45,54.05260898561812,52.38295375788808,NaN,NaN,27.993758386988848,-11.300181976072299,-0.01799497802563843,0.1856599916654602,0.20365496969109864,1026096530,1019674974.8,58.47016672729467,68.65061199223929,NaN,NaN,4.003364804700383,10.32685880382217
2020-02-10T09:30:00-05:00,102.66,103.59,102.58,103.59,4010061,8927515.7,56.466143915234596,51.22541077959978,NaN,NaN,24.610988437610782,21.195907634402158,0.047168352512314465,0.2626154103314917,0.21544705781917725,1030106591,1025240067,62.56689765450947,66.23972532859135,NaN,NaN,5.50212704707695,9.637611410001425
2020-02-11T09:30:00-05:00,103.95,104.3,103.74,104.21,10277109,9060282.1,59.07581884798129,50.2078367582565,NaN,NaN,65.29179368101319,44.12063227511278,0.12314158455534346,0.3693740385133566,0.24623245395801313,1040383700,1030945559.2,66.24344991546073,64.05551892512919,NaN,NaN,7.592934532478908,9.345514713212493
2020-02-12T09:30:00-05:00,104.6,104.84,103.92,104.34,4705691,8930813.4,59.62237699431135,49.724584854967205,NaN,NaN,73.94133651903509,50.67034674169477,0.17035629122480195,0.4591778179890156,0.28882152676421363,1045089391,1034765988,68.47613782120877,62.016743060296804,NaN,NaN,9.398523656970612,9.353087419463654
2020-02-13T09:30:00-05:00,103.96,104.28,103.64,103.85,4778509,8793650.85,56.55635546669673,50.21054784025618,NaN,NaN,49.62146447286846,48.29186829950327,0.15711541037893217,0.4852157897378788,0.32810037935894665,1040310882,1036397418.8,69.40668361990804,60.33013718081832,NaN,NaN,9.944295435195576,9.437545707425357
2020-02-14T09:30:00-05:00,103.96,104,103.42,103.93,5114244,8775349.75,56.94563510775107,51.10781373322785,NaN,NaN,44.34870948769158,51.56285851964382,0.14269421792591597,0.5064681517663416,0.36377393384042567,1045425126,1040263138,71.54972763778635,59.436121610168584,NaN,NaN,10.496269266938874,9.588791930213002
2020-02-18T09:30:00-05:00,103.93,104.06,103.22,103.56,8409262,8869141.5,54.51270521415557,51.55587616460726,NaN,NaN,38.37218562007501,54.31509795613666,0.0992460340575646,0.48783147641238145,0.38858544235481685,1037015864,1041644992.6,72.29678078503815,59.12282844251423,NaN,NaN,10.265368407611481,9.685445712698499
2020-02-19T09:30:00-05:00,103.83,104.19,103.73,104.04,6427863,8858295.9,57.074858372673035,52.32523882743051,NaN,NaN,61.55540861846947,53.56782094362792,0.09390073236743879,0.5059613578141153,0.41206062544667654,1043443727,1042256998,72.63944407291908,59.64851142477814,NaN,NaN,10.799236746531756,9.844558717531822
2020-02-20T09:30:00-05:00,103.8,103.9,102.43,103.37,8080943,8790767.55,52.619525529815476,53.1154291471391,NaN,NaN,24.796530781757152,43.738859796172335,0.03911345644488157,0.4609524460027785,0.42183898955789695,1035362784,1040311676.6,69.68877201161425,60.64624237728906,NaN,NaN,9.976650775188771,9.863429011482815
2020-02-21T09:30:00-05:00,102.97,103.53,102.61,103.43,6510864,8690180.3,52.97355433398428,54.61831392910062,NaN,NaN,25.74801983974881,38.964170869548404,0.00270669556700881,0.42522235901665795,0.42251566344964914,1041873648,1040624229.8,69.90032903583099,62.18236396146106,NaN,NaN,9.400856711711263,9.797347254372593
2020-02-24T09:30:00-05:00,100.93,101.61,99.69,100.17,16284584,8706269,36.85860046554509,54.48392139749841,NaN,NaN,-116.84370945411861,6.725687081186367,-0.2321518249874127,0.13232588221538322,0.36447770720279593,1025589064,1036657017.4,63.812328307058245,63.44078814951627,NaN,NaN,3.003198209733662,8.826754533709888
2020-02-25T09:30:00-05:00,100.53,100.75,96.79,97.13,20301851,9133237.7,28.233329968331248,52.97220795328817,NaN,NaN,-198.04230457672202,-40.55721095817304,-0.5645153851163408,-0.34116652419263005,0.22334886092371073,1005287213,1030311287.2,55.487563630863335,64.24015325646552,NaN,NaN,-6.523648250741901,6.633839850216775
2020-02-26T09:30:00-05:00,97.67,98.82,96.91,97.12,13721649,9415322.8,28.20994443851893,50.834881511634805,NaN,NaN,-181.23620741437017,-89.11553416474098,-0.745916001917422,-0.7090461414730669,0.036869860444355196,991565564,1019935654.6,45.122379262604625,64.136482079587,NaN,NaN,-13.376410271071196,3.7752326900327797
2020-02-27T09:30:00-05:00,96.07,97.34,93.8,93.82,22047900,10195916.8,21.794455548385073,48.21399379921443,NaN,NaN,-215.82199280462945,-137.2392388820183,-1.0314466709042676,-1.2524384781859794,-0.22099180728171175,969517664,1006766630.6,35.94458131833767,62.9718029857454,NaN,NaN,-22.33517662130435,0.04517421698461854
2020-02-28T09:30:00-05:00,91.35,92.6625,89.98,92.61,27751750,11034026.95,19.998555098840114,45.78156137873028,NaN,NaN,-237.85216919789633,-189.95927668954732,-1.2315462567993176,-1.7604246282808589,-0.5288783714815412,941765914,986745083.8,26.96469662761605,60.72141226433978,NaN,NaN,-29.89215531442887,-4.23158714464588
2020-03-02T09:30:00-05:00,92.64,97.1,92.32,96.95,22359393,11428162.15,39.31430614457381,44.55643010939737,NaN,NaN,-128.89686992693618,-192.36990878411083,-1.0106147667225729,-1.7921468298847572,-0.7815320631621843,964125307,974452332.4,23.141965687806604,57.905345695289576,NaN,NaN,-28.137930763626656,-7.6467790902145625
2020-03-03T09:30:00-05:00,97.19,98.89,93.27,94.54,33385475,12504847.2,34.35405394696592,42.790589759324845,NaN,NaN,-110.10112674662206,-174.78167321809084,-0.9658365840254342,-1.9888277931939768,-1.0229912091685427,930739832,959542856.2,19.526244833173095,54.56840247512617,NaN,NaN,-28.933726462598614,-10.687771571983713
2020-03-04T09:30:00-05:00,97.38,100.15,97.18,99.99,26419021,13347042.8,49.783863948573035,42.087838827486394,NaN,NaN,-34.66413777507011,-145.46725929023083,-0.5300070535160972,-1.6855000260636643,-1.155492972547567,957158853,952661514,18.119136310240663,50.97147379577131,NaN,NaN,-22.260677764719482,-12.34104388523168
2020-03-05T09:30:00-05:00,97.85,99.19,96.56,97.67,17873011,13534142.95,44.941309067218214,41.25819265609506,NaN,NaN,-54.02441565340898,-113.10774385998675,-0.3665762728639461,-1.6137133136274997,-1.2471370407635536,939285842,946615149.6,16.96248068361392,47.22545930032173,NaN,NaN,-19.60510853257911,-13.378767406281312
2020-03-06T09:30:00-05:00,94.99,97.5,94.6,97.15,17917672,14121702.5,43.91032339935311,40.32709896263806,NaN,NaN,-72.33711466569314,-80.00473295354611,-0.26673976661149457,-1.5805617490279218,-1.3138219824164272,921368170,942535600.8,16.210568161172745,43.272662194849325,NaN,NaN,-18.161531874656735,-14.062019473192088
2020-03-09T09:30:00-04:00,91.39,94.28,90.01,92.1,21968483,14917266.75,35.41362801722924,38.96287916285761,NaN,NaN,-133.92033542976918,-81.00942605411271,-0.5004825773667001,-1.9394252041248023,-1.4389426267581023,899399687,929590476.8,14.07802235788914,39.114179450052966,NaN,NaN,-20.548019066449633,-14.988590843657452
2020-03-10T09:30:00-04:00,94.76,95.4201,90.94,95.26,26473553,16040441.35,42.86393438969484,37.94781316407346,NaN,NaN,-92.98479098056524,-77.58615890090134,-0.4059695361614928,-1.9464045469599682,-1.5404350107984754,925873240,928617158.4,13.929642989176358,34.92062222978563,NaN,NaN,-19.27154610310272,-15.600441595006776
2020-03-11T09:30:00-04:00,93.01,93.67,90.45,91.62,23217955,16687483.65,37.49805432858621,36.86770807827137,NaN,NaN,-115.15316756054605,-93.68396485799653,-0.5437014433835088,-2.2200618150278615,-1.6763603716443527,902655285,917716444.8,12.358607206332522,30.825610457979792,NaN,NaN,-20.48737096081365,-16.298574361550614
2020-03-12T09:30:00-04:00,86.01,89.73,82.9,84.78,20650836,17484740.9,29.91871615867059,35.22093392289181,NaN,NaN,-192.89431647954544,-121.45794502322383,-1.022757169427175,-2.9548068334283215,-1.9320496640011464,882004449,906260166.2,10.959616672125804,26.61555957485799,NaN,NaN,-24.869909173176534,-17.523050763211458
2020-03-13T09:30:00-04:00,88.72,90.9,84.16,90.66,29162790,18703954.95,40.96546768010574,35.51428158107472,NaN,NaN,-130.8866568349795,-133.1678534570811,-0.8765434055734502,-3.0277289209679594,-2.151185515394509,911167239,904219980,10.726741082684242,22.823731915974133,NaN,NaN,-23.38561428817433,-18.360559838206154
2020-03-16T09:30:00-04:00,82.52,87.05,80.67,81.72,21474783,19521981.9,32.5615393461857,35.8234393937786,NaN,NaN,-187.1087117921677,-143.80552872956082,-1.2898675640930093,-3.763519970510771,-2.4736524064177616,889692456,902278533.8,10.498138496831729,19.610201549257592,NaN,NaN,-26.112448161634305,-19.467972455838748
2020-03-17T09:30:00-04:00,83.41,87.55,82.35,86.85,27899728,20496505.2,40.1490606513085,36.67623340897786,NaN,NaN,-133.41716176378162,-151.8920028862041,-1.1313777179233577,-3.887874553821959,-2.7564968358986013,917592184,900622322.6,10.296543458994933,17.122641848999756,NaN,NaN,-24.700256289204848,-20.21544157489105
2020-03-18T09:30:00-04:00,82.4,85.3,79.92,83.97,28931012,21621662.65,37.591964255581246,37.804626888063304,NaN,NaN,-146.6979683070548,-158.20096303550582,-1.1313950796271008,-4.170740685432477,-3.0393456058053765,888661172,897823500,9.948859096348244,15.265804547429086,NaN,NaN,-24.745145588665928,-20.86254214828746
2020-03-19T09:30:00-04:00,83.03,84.26,81.33,82.25,27121077,22573669.35,36.112678565353754,38.955635707099994,NaN,NaN,-133.46002142580429,-146.31410402475757,-1.1541536100291099,-4.482037618341764,-3.3278840083126537,861540095,893730629.2,9.446513501862498,14.014505752732404,NaN,NaN,-25.343528005778577,-21.502682985071907
2020-03-20T09:30:00-04:00,82.96,83.81,78.64,79.09,22004958,23348374.05,33.50413125628664,38.540623215079485,NaN,NaN,-141.57832148326676,-148.45243695441505,-1.2792397109900984,-4.9269336470502765,-3.647693936060178,839535137,879404208.8,7.9359979418278215,12.928365199448203,NaN,NaN,-26.769850402944645,-22.25513547333944
2020-03-23T09:30:00-04:00,78.2,78.31,73.54,74.62,33633216,24215805.65,30.182858749452237,38.242680700971356,NaN,NaN,-169.2056660615531,-144.87182780829215,-1.5425910241918253,-5.57593271629996,-4.033341692108134,805901921,862646101.8,6.605456408167953,12.00545174051926,NaN,NaN,-29.140699884796717,-23.23878753211905
2020-03-24T09:30:00-04:00,78.15,80.53,77.57,80.37,16775768,24039501.5,38.61287561970051,37.444752963194745,NaN,NaN,-108.77009711795438,-139.9424148791267,-1.2230665815835806,-5.56217491908761,-4.33910833750403,822677689,843663202.8,5.483862358792194,11.102932172558656,NaN,NaN,-27.98585208232623,-23.91693961072008
2020-03-25T09:30:00-04:00,79.84,84.09,78.87,81.44,16851812,24196009.65,40.063185010451654,37.09631553056857,NaN,NaN,-78.64815755281909,-126.33245272827955,-0.8508359572104611,-5.402653284017106,-4.551817326806645,839529501,833836868.6,5.009668892883269,10.24915990179218,NaN,NaN,-26.610166041825295,-24.30168624373511
2020-03-26T09:30:00-04:00,82.17,87.31,82.01,86.85,18822472,24034738.25,46.89473318548768,37.309487658149614,NaN,NaN,-31.854365950148676,-106.01132163314841,-0.18617517538556072,-4.7845362960385955,-4.598361120653035,858351973,833199244.2,4.979579062999008,9.44694639477977,NaN,NaN,-23.0504074152627,-24.122932125381908
2020-03-27T09:30:00-04:00,84.34,87.23,84.28,84.99,13043205,23299311,44.995849797919405,37.99393207105605,NaN,NaN,-27.472172460035615,-83.19009182850218,0.16340246226305588,-4.3941080428242145,-4.55751050508727,845308768,834353970.4,6.079771425681557,8.875642756764943,NaN,NaN,-20.879685275530527,-23.65961114683171
2020-03-30T09:30:00-04:00,86.52,89.1399,86.51,88.97,13766707,22869676.7,49.69026073156539,38.481526809761085,NaN,NaN,7.515497526819826,-47.845859110827604,0.6694893813323732,-3.720648778421804,-4.390138159754177,859075475,844988681.2,15.754319085968987,9.005976763678701,NaN,NaN,-17.507394500040487,-22.780723054432965
2020-03-31T09:30:00-04:00,89.05,89.53,87.64,88.58,13585922,21879699.05,49.24672438826892,39.32071752830985,NaN,NaN,17.47068714656592,-22.597702257923526,0.9667342807339345,-3.181720308836759,-4.148454589570694,845489553,849551054,19.581485465554138,9.521896639337387,NaN,NaN,-15.009310920373139,-21.670521320995846
2020-04-01T09:30:00-04:00,85.62,86.39,84.39,85.21,15255426,21321519.3,45.46985888414908,40.4315134372726,NaN,NaN,-17.936866561329307,-10.455444059625577,0.9251189581968022,-2.992055891824691,-3.9171748500214933,830234127,847691979.2,19.198754560352057,10.110406488496405,NaN,NaN,-14.060821942748348,-20.583421409817632
2020-04-02T09:30:00-04:00,84.78,87.77,83.93,87.57,13588005,21107269,48.451380714066055,40.96622151112691,NaN,NaN,7.791929104174674,-2.5261850487609068,1.0368608377725175,-2.6210988028058466,-3.657959640578364,843822132,844786011,18.587192722926417,10.671867319942276,NaN,NaN,-12.363000023256596,-19.40907549745177
2020-04-03T09:30:00-04:00,87.29,88.12,85.8,86.78,12934360,20858103.4,47.51483206394725,42.03431384810988,NaN,NaN,28.294992641685774,8.62724797158337,1.0354774900274908,-2.3636127780440006,-3.3990902680714914,830887772,841901811.8,17.97518109631288,11.205941791333787,NaN,NaN,-11.256391922988728,-18.244406415385622
2020-04-06T09:30:00-04:00,89.54,91.85,89.14,91.33,13472925,20433325.5,53.133757959173316,42.96179222724307,NaN,NaN,109.96453918959917,29.117056304139236,1.3016882209033285,-1.771979991942331,-3.0736682128456594,844360697,838958856.2,17.347518329283886,11.709582853497283,NaN,NaN,-8.569296355544754,-16.862247835408354
2020-04-07T09:30:00-04:00,93.65,93.82,90.49,90.58,16699512,19944623.45,52.14282153703632,44.001139175918446,NaN,NaN,133.7460093586503,52.37212074655612,1.3804661007015273,-1.3480855869687502,-2.7285516876702776,827661185,835393182.6,16.591584943608822,12.184063271158754,NaN,NaN,-6.668240202516973,-15.405961030709586
2020-04-08T09:30:00-04:00,91.36,94.86,90.22,94.31,32624372,20414944.3,56.488991077186064,45.45659006962075,NaN,NaN,161.79858240016517,88.319210538855,1.6203918064087715,-0.703061929659313,-2.3234537360680845,860285557,841403468.6,22.705677415245944,13.131146407829002,NaN,NaN,-3.7052240998367596,-13.734427183442039
2020-04-09T09:30:00-04:00,95.17,95.35,93.97,94.83,12983196,20031562.3,57.074261456356474,47.14017079819717,NaN,NaN,162.378483465368,119.23652141109369,1.7401966439389376,-0.14820793114441244,-1.88840457508335,873268753,847292792.8,28.255341708814115,14.582528105470876,NaN,NaN,-1.1211403990253659,-11.932529071382515
2020-04-13T09:30:00-04:00,94.49,94.82,92.66,94,9606595,19053752.55,55.78443911843279,48.96885511026721,NaN,NaN,130.95947163885495,139.7694172105275,1.6883115745612434,0.22198489311820424,-1.4663266814430391,863662158,853847670,33.94044720162667,16.535027447860784,NaN,NaN,0.6828606683270626,-10.13033053713829
2020-04-14T09:30:00-04:00,95.84,97.47,95.515,97.12,12830797,18621553.25,59.49046178467214,50.460111264908036,NaN,NaN,152.02047599598504,148.18060457180468,1.779766267283733,0.7583811526616273,-1.0213851146221058,876492955,860274121.6,39.040576343837685,18.931935589649747,NaN,NaN,3.329854168558765,-8.207447007752997
2020-04-15T09:30:00-04:00,95.83,97.19,95.285,96.62,11019107,17777522.2,58.64217423994884,51.787181924157835,NaN,NaN,125.3479968047754,146.5010020610297,1.721192949470969,1.1301060722166056,-0.5910868772543634,865473848,867836654.2,44.473419587762535,21.750774924998268,NaN,NaN,5.299003816298931,-6.277954032888435
2020-04-16T09:30:00-04:00,97.34,98.975,97.03,98.73,11331585,16897550.85,61.15916402670074,52.80606984138734,NaN,NaN,131.7043835797504,140.48216229694677,1.7342966469585528,1.5767839314438277,-0.15751271551472518,876805433,871140629.4,46.70803237593202,24.731378733064908,NaN,NaN,7.707758815721536,-4.279995054515583
2020-04-17T09:30:00-04:00,101.13,101.13,99.39,100.78,11504675,16116730.75,63.48435596242826,54.12667742456654,NaN,NaN,138.56814201659483,135.72009400719213,1.7838573188470817,2.072308933044127,0.2884516141970453,888310108,874148900.4,48.73114397528668,27.77790534375099,NaN,NaN,10.446978534525783,-2.1761416846525306
2020-04-20T09:30:00-04:00,99.82,101.41,99.71,99.98,10558302,15544397.95,61.92635904123479,55.00068444668579,NaN,NaN,122.48657335001671,134.02551434942447,1.667724350138427,2.373107051870079,0.7053827017316521,877751806,876966830,50.622129927506876,30.268463261003696,NaN,NaN,12.343762368310825,-0.10186967708633698
2020-04-21T09:30:00-04:00,98.27,98.83,96.62,96.94,9291372,14327305.75,56.27463623484564,55.50267815001269,NaN,NaN,81.61999238234823,119.94541762669712,1.3070730515515483,2.3392240161710873,1.032150964619539,868460434,875360325.8,49.501178930632854,32.405584222795035,NaN,NaN,12.479577982902983,1.6954799886264227
2020-04-22T09:30:00-04:00,98.35,99.03,97.74,98.42,12007390,14088886.85,58.271335278823805,56.417069321060886,NaN,NaN,85.86943125692987,112.04970451712802,1.0975450945018626,2.4040823327468672,1.3065372382450047,880467824,878359121,51.65328090442558,34.723764675943144,NaN,NaN,13.141997850054093,3.3306968259732326
2020-04-23T09:30:00-04:00,98.94,100.49,98.74,98.96,16013259,14046959.2,59.00687633542406,57.17103329401503,NaN,NaN,91.79370505254823,104.06756881168761,0.9312319906495716,2.470577226556969,1.5393452359073976,896481083,882294251,54.39957747025037,37.281792157894856,NaN,NaN,13.893156074072873,4.839619575701753
2020-04-24T09:30:00-04:00,99.56,100.49,98.94,100.29,7853512,13498511.2,60.837847682729205,58.12267726678516,NaN,NaN,91.07614562302648,94.56916953297392,0.8490170156343027,2.600616505450276,1.7515994898159732,904334595,885499148.4,56.56365791790672,40.038111930865846,NaN,NaN,15.028293829915476,6.2951444691608565
2020-04-27T09:30:00-04:00,100.99,102.01,100.83,101.58,8022181,13247460,62.5834950049582,58.79765848434123,NaN,NaN,104.78363740543611,91.02858234405781,0.8193351752968738,2.7757684589370655,1.9564332836401916,912356776,892420142.4,60.881132890708635,43.14765582811047,NaN,NaN,16.474202498248708,7.749295616173407
2020-04-28T09:30:00-04:00,102.26,102.26,99.41,99.53,11517616,13135005.45,58.14770130906228,59.22657846805736,NaN,NaN,81.6643979650671,91.03746346060157,0.6091176294069918,2.7178303203989316,2.10871269099194,900839160,898895887.6,64.44247780397393,46.565576746707976,NaN,NaN,16.555828077662955,9.007371682100485
2020-04-29T09:30:00-04:00,101.06,101.06,99.54,100.19,9939877,12952703.2,59.151535582383175,59.416760218428585,NaN,NaN,73.6865010286439,88.60087741494439,0.46832131861485493,2.6941143392605085,2.2257930206456535,910779037,904958130.2,67.43165525434678,49.76028944950089,NaN,NaN,16.88815017495709,10.13319718108
2020-04-30T09:30:00-04:00,99.76,100.38,99.21,99.73,12768942,12828379,58.10547144781664,59.490418074961454,NaN,NaN,62.21571899431796,82.68528020329833,0.30587448584320764,2.6081361279496633,2.3022616421064557,898010095,905263932.6,67.57971238610563,52.56917306930743,NaN,NaN,16.900025557162785,11.099886949091827
2020-05-01T09:30:00-04:00,98.59,98.77,96.95,97.83,10101976,12654077.55,53.86802887522359,59.35353162901794,NaN,NaN,20.31185372184954,68.53242182306295,0.045778671016946326,2.359484980877639,2.3137063098606925,887908119,901978637.4,64.20290331398294,54.73077707733288,NaN,NaN,15.781565645026227,11.76869819136817
2020-05-04T09:30:00-04:00,97.53,98,96.89,97.78,9013144,12458016.75,53.756926763021575,58.94399341318576,NaN,NaN,3.3011145446570773,48.235917250907136,-0.14392864237348757,2.133795506893833,2.2777241492673204,878894975,895286277.2,57.8603935818041,56.07504973718762,NaN,NaN,14.813370758807388,12.203651415288059
2020-05-05T09:30:00-04:00,98.64,100.615,98.39,99.9,11497928,12359266.9,57.737092380645194,58.87934470894977,NaN,NaN,54.153097597216004,42.733657177336895,-0.14076066289736033,2.10177332064562,2.2425339835429803,890392903,893197025.8,56.000473634409545,56.898410740519545,NaN,NaN,14.973867807501815,12.599396614175738
2020-05-06T09:30:00-04:00,100.42,100.49,98.86,98.91,9493189,11998950.75,55.34162437738739,58.46380616257026,NaN,NaN,41.49810309797397,36.295977591202906,-0.2150203696360533,1.9737585214979134,2.1887788911339667,880899714,887221161.2,50.95507966380341,57.20177126108179,NaN,NaN,14.478236852467841,12.867802362503182
2020-05-07T09:30:00-04:00,99.92,99.93,98.775,98.9,9454429,10840453.6,55.31665884139671,57.88039922535371,NaN,NaN,26.32926331866768,29.11868645607285,-0.2708860480771724,1.850171331037501,2.1210573791146734,871445285,881908199.2,46.90860739868454,57.07159007703878,NaN,NaN,14.055359820875458,13.037453427984936
2020-05-08T09:30:00-04:00,99.96,100,99.105,99.41,10374531,10710020.35,56.39699830183227,57.48544488682496,NaN,NaN,32.98500035544169,31.65331578279129,-0.27849154547203536,1.772942947274629,2.0514344927466643,881819816,880690538.6,46.006857951832835,56.74192779306206,NaN,NaN,13.956679610930914,13.168771454120076
2020-05-11T09:30:00-04:00,99,101.38,99,101.12,15115448,10985463,59.89799205689101,57.74425601697106,NaN,NaN,79.23489292976444,46.84007145981276,-0.17823386845486677,1.8286421571780807,2.0068760256329474,896935264,884298596.4,49.12752968691377,56.71523856136785,NaN,NaN,14.770798319580134,13.397632434900084
2020-05-12T09:30:00-04:00,101.71,101.8,99.57,99.58,18471031,11267474.7,55.570571486326905,57.551344317507,NaN,NaN,65.01018596545775,49.01148913346111,-0.22262649283855973,1.7285929095847479,1.9512194024233076,878464233,881912862.4,47.18551975604597,56.396112765055015,NaN,NaN,14.345469578275189,13.533037741096527
2020-05-13T09:30:00-04:00,99.45,100.215,97.71,98.5,12667228,11349880.75,52.6953151732038,57.10051852020555,NaN,NaN,-48.98955440454289,30.91395763295774,-0.32549245290675977,1.544353836289858,1.8698462891966177,865797005,878892320.6,44.77237082744367,55.708455147711675,NaN,NaN,13.198757959153632,13.485283486533255
2020-05-14T09:30:00-04:00,97.59,99.63,97.57,99.58,12021392,11384371.1,55.19204478195068,56.697246884435664,NaN,NaN,-44.433731067454964,16.761358755733205,-0.321027946373853,1.4685613562293014,1.7895893026031544,877818397,880166943,46.026768340131476,54.955820177870585,NaN,NaN,12.861835549800032,13.396219495571366
2020-05-15T09:30:00-04:00,99.3,100.51,99.0702,100.42,15170168,11567645.75,57.089080018880836,56.304788671144415,NaN,NaN,44.603087813245985,19.084976247294065,-0.2641093712109239,1.4594525885894996,1.7235619598004235,892988565,882400692.8,48.24530299979954,54.053260899948505,NaN,NaN,13.075458314459066,13.35039646969818
2020-05-18T09:30:00-04:00,102.3,102.77,101.19,101.25,10557491,11567605.2,58.93891987085396,56.36130428270097,NaN,NaN,168.58542365081038,36.955082391503254,-0.17733358575575497,1.5018949776057298,1.6792285633614847,903546056,883722851.2,49.56671633885506,52.99070650958288,NaN,NaN,13.75308263782497,13.407923065144866
2020-05-19T09:30:00-04:00,100.93,101.445,100.02,100.03,10561441,11631108.65,55.17390699356488,56.07718795492824,NaN,NaN,67.61427346480997,37.4758998913737,-0.2068148410968269,1.420710011990451,1.627524853087278,892984615,886626927.6,52.43913595826056,51.91981227414815,NaN,NaN,13.332411650432688,13.397135720185982
2020-05-20T09:30:00-04:00,100.79,101.17,99.92,100.15,10058217,11533650,55.47518850510086,55.88931060187711,NaN,NaN,54.788375099699586,58.2314857922222,-0.22163125884249935,1.3504857795341536,1.572117038376653,903042832,894076093,58.9047082261686,51.300169119866936,NaN,NaN,13.057310077273238,13.348589199769876
2020-05-21T09:30:00-04:00,99.87,99.93,98.83,99.41,12259521,11345963.1,53.10484704443194,55.83479761396342,NaN,NaN,-33.56733124376082,60.40476575696103,-0.28085738780020475,1.221045303626397,1.5019026914266018,890783311,896669075.8,60.89739757174401,51.06406156684987,NaN,NaN,12.196699951857418,13.184033592925239
2020-05-22T09:30:00-04:00,99.42,99.7,98.9,99.62,10233264,11464950.7,53.709321470354396,55.83139723591576,NaN,NaN,-29.523461179679707,45.57945595837589,-0.3035470204148347,1.1224689159080583,1.426015936322893,901016575,898274677.8,62.12217045840627,51.36847420089288,NaN,NaN,11.61455796951185,12.95982278958047
2020-05-26T09:30:00-04:00,101.19,101.28,99.28,99.44,10829204,11605301.85,53.07778180406977,55.49858933758895,NaN,NaN,30.035144379869404,17.869400104187694,-0.3263439007447988,1.0180860603918944,1.3444299611366932,890187371,895602940.8,58.82060525887981,51.56991217406932,NaN,NaN,10.957444438006094,12.673768739355559
2020-05-27T09:30:00-04:00,99.58,100.47,98.07,100.47,15551897,11807015.9,56.24806212000337,55.56333489063295,NaN,NaN,2.6141979585214643,4.8693850029299925,-0.27004977474628866,1.0068677427038324,1.276917517450121,905739268,898153871.4,60.954317727717545,52.28414346434891,NaN,NaN,11.165850853038984,12.458351898453191
2020-05-28T09:30:00-04:00,101.29,102.8,101.26,101.78,11708855,11895464.8,59.953991342540554,55.89457292642894,NaN,NaN,193.74197985435103,32.660105953860274,-0.14864952540394105,1.0911056106951946,1.2397551360991357,917448123,901034929.6,63.26917736544766,53.45275560483198,NaN,NaN,12.340812906187976,12.441560613843874
2020-05-29T09:30:00-04:00,102.22,103.23,100.69,103.01,19057044,12209869.9,63.11327368089793,56.37430688207649,NaN,NaN,181.26910818307263,75.62739383922695,0.002427368291874954,1.2427893464639794,1.2403619781721045,936505167,910179300.8,69.45832683305326,55.12786052491915,NaN,NaN,14.265565914512251,12.702132799653642
2020-06-01T09:30:00-04:00,102.36,102.4825,101.35,101.99,8436318,12126587,58.959322119322536,56.30725902939303,NaN,NaN,136.51163178738094,108.83441243263908,0.020590031272944564,1.2660995172632852,1.2455094859903406,928068849,915589755.6,72.41952004308048,56.7915741217882,NaN,NaN,14.810099429969991,13.003270889698834
2020-06-02T09:30:00-04:00,102.03,102.63,101.42,102.58,13158817,12333870.65,60.57569405041149,56.6647677839705,NaN,NaN,138.30365764345677,130.48811508535655,0.057192022512958074,1.3169995141315383,1.2598074916185802,941227666,925797814.6,76.95867885978713,58.918228343483996,NaN,NaN,15.72052363727329,13.391449853638042
2020-06-03T09:30:00-04:00,102.88,102.98,101.945,102.38,10020912,12260019.85,59.71709946110056,57.16632380453456,NaN,NaN,131.92250625793525,156.34977674523932,0.05288638400978174,1.3259154716308075,1.2730290876210257,931206754,930891311.8,78.83080649866339,61.350973748571114,NaN,NaN,16.25932041614421,13.80114564828178
2020-06-04T09:30:00-04:00,101.76,102.465,100.92,101.57,10848323,12327776.55,56.24031928533519,57.241200554776306,NaN,NaN,70.85890284758948,131.773161343887,-0.01588296931462274,1.2531753759777473,1.26905834529237,920358431,931473373.4,79.04038605540143,63.709089299661834,NaN,NaN,15.798433963261067,14.086472550421679
2020-06-05T09:30:00-04:00,102.21,104.035,101.68,103.21,14579765,12584043.35,61.169704271955226,57.53267371571019,NaN,NaN,131.75090062915993,121.86951983310446,0.03493754977108243,1.312730282506223,1.2777927327351406,934938196,931159979.2,78.58924287286928,65.87651357630968,NaN,NaN,16.774479297344648,14.470473514267818
2020-06-08T09:30:00-04:00,102.8,103.96,102.55,103.92,8191341,12474883.85,63.10727901578561,57.83041365463388,NaN,NaN,137.91990464565546,122.15117440475937,0.09862053136173143,1.4010683969373048,1.3024478655755733,943129537,934172116.8,79.78360908471964,68.03486305815714,NaN,NaN,18.16227555348909,14.997873805585142
2020-06-09T09:30:00-04:00,103.71,104.2224,102.72,102.84,10371107,12237666.8,58.33864294689477,58.056466222728865,NaN,NaN,110.24088180702849,116.5386192374737,0.05256869376356654,1.3681587327800315,1.315590039016465,932758430,932478269.6,77.17641018536982,69.80181121723638,NaN,NaN,18.002317104185327,15.427079991099454
2020-06-10T09:30:00-04:00,103.18,103.52,102.23,102.68,10519660,11840098.25,57.643702636571156,58.21136008926246,NaN,NaN,79.09349949834501,105.97281788555566,-0.0012562531358597528,1.3140197225966403,1.3152759757325,922238770,930684672.8,74.4037873112649,70.90888829474325,NaN,NaN,17.67630160841164,15.748397365001194
2020-06-11T09:30:00-04:00,101.79,101.98,96.63,96.97,39561933,13184833.5,39.541108043476015,57.242521589194176,NaN,NaN,-128.3159261809212,66.1378520798535,-0.41131681263021513,0.8011299599447312,1.2124467725749464,882676837,923148354,63.99971436805376,71.13048235162252,NaN,NaN,10.691935244123604,15.026045633447254
2020-06-12T09:30:00-04:00,99,99.32,95.92,97.6,19397191,13553623.45,41.715950484347665,56.38585223305084,NaN,NaN,-160.8882260770581,7.610026738609901,-0.6176214377259472,0.44041997541751243,1.0580414131434597,902074028,916575520.4,56.569992951832916,70.73389824401013,NaN,NaN,5.991122229829932,13.735342290073351
2020-06-15T09:30:00-04:00,96.14,98.38,95.42,97.82,14522109,13521220.5,42.49389457617588,55.62986028820127,NaN,NaN,-156.57494350231906,-51.288942890985005,-0.710158519175982,0.1703432641734821,0.8805017833494642,916596137,911268840.4,51.38350726094272,70.2026769584432,NaN,NaN,2.568328964126703,12.140054672080973
2020-06-16T09:30:00-04:00,100.12,100.87,98.58,100.23,13272884,13656990.15,50.31709870893879,55.2062200445538,NaN,NaN,-40.67764872436915,-81.47264899726453,-0.5851580829164093,0.14905417970395263,0.7342122626203619,929869021,910690958.6,50.836910555543525,69.48000501757363,NaN,NaN,2.1759484425846654,10.716610925010073
2020-06-17T09:30:00-04:00,100.73,100.91,99.78,100.13,9086302,13583233.2,50.013064944140744,54.49615387323954,NaN,NaN,-24.40648248338036,-102.1726453936096,-0.48921071692671037,0.12269886646197392,0.6119095833886843,920782719,910399748.4,50.54511765159811,68.57114360944152,NaN,NaN,1.7743022209295811,9.439138252998575
2020-06-18T09:30:00-04:00,99.56,100.02,99.16,99.79,7115232,13436083.95,48.93051092512616,53.48309939068441,NaN,NaN,-46.97421640458473,-85.90430343834231,-0.43070420113656704,0.07352933196797551,0.5042335331045426,913667487,916597878.4,56.29507633430806,67.63091143095973,NaN,NaN,1.1237878816927138,8.251231057097737
2020-06-19T09:30:00-04:00,100.93,101.34,99.71,100.75,12176999,13431957.85,52.08422027466531,52.992020687494616,NaN,NaN,-12.15067055297045,-56.15679233352478,-0.314787268176988,0.11074944788330754,0.42553671606029553,925844486,921351970,60.124659483178775,66.75270710525245,NaN,NaN,1.5204055008390271,7.2896845490607785
2020-06-22T09:30:00-04:00,99.91,100.0838,98.91,99.94,6889370,13264763.15,49.31693036926762,52.18782328169862,NaN,NaN,-52.631022209325316,-35.368008074926,-0.2812029562277892,0.07403302077555907,0.35523597700334825,918955116,921823765.8,60.49461427128052,65.5767024917877,NaN,NaN,1.038081957437989,6.396598464543237
2020-06-23T09:30:00-04:00,100.63,101.23,100.18,100.37,5369897,12991797.8,50.811045967393284,51.551676603576674,NaN,NaN,-14.524959022976722,-30.137470134647522,-0.22120885965512282,0.07872490243444474,0.29993376208956757,924325013,920714964.2,59.10669133180271,64.16783712272623,NaN,NaN,1.0680741024479767,5.635380698529628
2020-06-24T09:30:00-04:00,99.62,99.82,97.0399,97.75,15739714,13001188.65,42.57540196123042,50.575611080426334,NaN,NaN,-108.03478831059819,-46.863131300091084,-0.34194630630767187,-0.12749912079502224,0.2144471855126496,908585299,918275480.2,56.059320644171386,62.5263324504955,NaN,NaN,-1.5072998765788108,4.614997759228423
2020-06-25T09:30:00-04:00,97.66,98.83,96.84,98.71,10506729,12941082.35,46.02737650359515,49.494016239829186,NaN,NaN,-99.5406965884351,-57.37642733686115,-0.3403869251713296,-0.21103647095151246,0.12935045421981717,919092028,919360388.4,57.11818777799567,60.99268565800453,NaN,NaN,-2.5771775903717415,3.587544137856971
2020-06-26T09:30:00-04:00,98.53,98.78,97.04,97.51,16631435,12819801.9,42.58160596449357,48.02789673616547,NaN,NaN,-101.50928387515626,-75.24815000129831,-0.39932635018658347,-0.3698074835134122,0.029518866673171287,902460593,914683609.8,51.37128758372881,58.963234122219475,NaN,NaN,-4.56271416965654,2.423221522497898
2020-06-29T09:30:00-04:00,98.28,98.57,97.515,98.39,7490228,12772497.4,45.786848488752554,47.13133998915531,NaN,NaN,-78.7784267689622,-80.47763091322568,-0.3594446665207097,-0.41978696647771585,-0.06034229995700614,909950821,912882750.8,49.313763323328786,56.97304506064511,NaN,NaN,-5.231045558342578,1.3297547966635443
2020-06-30T09:30:00-04:00,98.42,100.6,98.13,100.07,9182991,12573706.1,51.36822440364734,46.68309154394645,NaN,NaN,-20.602835098601588,-81.69320612835067,-0.20784111201831557,-0.3201436899799006,-0.11230257796158505,919133812,911844510.6,48.11722154095181,55.09543321990846,NaN,NaN,-4.037197358291318,0.5630473459557068
2020-07-01T09:30:00-04:00,100.54,101.26,99.91,100.84,10933146,12619317.8,53.72000111917202,47.69586962078189,NaN,NaN,26.442455955965606,-54.79775727503791,-0.05176012426578672,-0.17700273329381844,-0.12524260902803172,930066958,916140842.4,53.1798618182403,54.322586609207505,NaN,NaN,-2.3185537158384992,0.1513900514136774
2020-07-02T09:30:00-04:00,101.73,102.18,101.375,101.6,6502376,12402020.45,55.98260162807713,48.71491613104828,NaN,NaN,69.85622945653859,-20.91837206604317,0.09842500377106667,-0.0022113543141983882,-0.10063635808526505,936569334,919636303.6,56.867511948421786,54.343837966106705,NaN,NaN,-0.19610325821253194,0.10174815003850464
2020-07-06T09:30:00-04:00,102.77,103.22,102.14,102.63,6374838,11991774.1,58.91426384160959,49.88779965000783,NaN,NaN,111.00601613542366,21.584687936072815,0.25404820731691646,0.21692390106088055,-0.037124306256035924,942944172,927733019.4,63.95034799572377,55.241469447162494,NaN,NaN,2.505230727234562,0.4451028039236557
2020-07-07T09:30:00-04:00,101.88,102.97,101.6,101.74,5913221,11877868.1,55.47605245235008,50.25629634596578,NaN,NaN,94.8642637591229,56.31322604168984,0.28181292397069047,0.3151418487073272,0.033328924736636706,937030951,933149045.4,67.76368036492298,56.450524433546676,NaN,NaN,3.7630817259385765,0.9190997927829301
2020-07-08T09:30:00-04:00,102.09,102.4,101.07,101.75,5624902,11640557.85,55.50747156263399,50.64875396157244,NaN,NaN,86.91036152623754,77.81586536665766,0.284776534522291,0.38929959288950045,0.10452305836720945,942655853,937853453.6,70.66623457122029,57.88774707066255,NaN,NaN,4.788134701591491,1.4718190654698673
2020-07-09T09:30:00-04:00,101.64,102.02,99.68,100.95,10522107,11640680.2,52.32624596102554,50.89130646413668,NaN,NaN,55.12381853774552,83.55213788301364,0.2196985638652313,0.37914626319874856,0.15944769933351727,932133746,938266811.2,70.91404740265487,58.931959289830175,NaN,NaN,4.773635082010254,1.9435070678327797
2020-07-10T09:30:00-04:00,101.03,101.13,99.97,100.71,10502651,10187716.1,51.374982858226886,50.8406466486768,NaN,NaN,36.79062847895088,76.9390176874961,0.15062209731951995,0.3477253209829172,0.19710322366339725,921631095,935279163.4,66.538644221981,59.39010105688748,NaN,NaN,4.501318355853843,2.3089086804072174
2020-07-13T09:30:00-04:00,101.29,103.145,101.02,101.28,10167371,9726225.1,53.53546635611609,51.14197064773741,NaN,NaN,90.91212472164406,72.92023940474019,0.13400956299912548,0.3646151774123041,0.23060561441317862,931798466,933050022.2,63.3956876182863,59.59732058167361,NaN,NaN,4.852718411836564,2.6723100706114096
2020-07-14T09:30:00-04:00,101.04,103.46,100.85,103.29,10890003,9544619.8,60.2436319343412,51.81572678823369,NaN,NaN,121.26762747697798,78.2009121483112,0.24274326249828854,0.5340346925360393,0.29129143003775076,942688469,934181525.8,64.31704536041444,59.96948872657445,NaN,NaN,7.178472417845384,3.3160475487876915
2020-07-15T09:30:00-04:00,104.05,104.925,103.83,104.63,9606981,9361324.65,63.97742597357019,53.344442789115114,NaN,NaN,194.14911538391294,99.64866291984629,0.38103045703881666,0.7675795013362716,0.38654904429745496,952295450,936109445.2,65.89235311729094,60.671848188940125,NaN,NaN,10.366478249277536,4.323251934571955
2020-07-16T09:30:00-04:00,104.53,104.54,103.72,104.46,6412217,9227620.4,63.16690904909442,54.56869511379363,NaN,NaN,152.82020244923228,119.18793970214365,0.43335884862757307,0.9282476050819213,0.4948887564543482,945883233,938859342.6,68.05842670863025,61.4532938268426,NaN,NaN,12.720836837048696,5.522906920640061
2020-07-17T09:30:00-04:00,105.01,106.25,104.86,105.89,7548607,9249289.15,66.95885558527024,56.30992722956339,NaN,NaN,178.10110980343893,147.45003596704126,0.530187336701996,1.1576229273318432,0.6274355906298472,953431840,945219491.6,72.4209367819373,62.956840198143205,NaN,NaN,15.968444025125429,7.015126506995113
2020-07-20T09:30:00-04:00,106.13,106.49,105.52,105.87,6776331,8979255.75,66.85518923613752,57.814808711519454,NaN,NaN,158.7884141332304,161.02529384935852,0.5560876970753357,1.3225452119740169,0.7664575148986812,946655509,948190900.2,74.19421539593492,64.7340153461865,NaN,NaN,18.561383301307053,8.66459176332539
2020-07-21T09:30:00-04:00,106.23,106.63,105.58,105.8,7458616,9007718.05,66.46731525614166,58.89331520098334,NaN,NaN,140.93934320738768,164.95963699544046,0.5317156218852302,1.431102042255219,0.8993864203699887,939196893,947492585,73.00617592581673,66.51179780224828,NaN,NaN,20.59543260122288,10.368997597310745
2020-07-22T09:30:00-04:00,106.28,106.93,105.73,106.75,5648586,9021652.5,69.08843446662252,59.99106044008694,NaN,NaN,134.09412514144103,152.94863894694606,0.5409935121140199,1.5756283105125135,1.0346347983984936,944845479,946002590.8,70.41530571291794,67.74290093758239,NaN,NaN,23.135338990375207,12.19276065346281
2020-07-23T09:30:00-04:00,107.09,107.53,105.92,106.27,6970160,8583174.8,66.269814538588,60.72586136226629,NaN,NaN,120.90134334825746,146.5648671267511,0.4783838935173257,1.6326146652951508,1.154230771777825,937875319,944401008,67.63675503353159,68.5121325865188,NaN,NaN,24.53145232141228,13.955430891741306
2020-07-24T09:30:00-04:00,106.1,106.16,104.43,105.1,6240965,8369886.6,59.85931041962104,60.79336468926711,NaN,NaN,73.16355504553279,125.5773561751699,0.32887415505100015,1.5653234655915753,1.2364493105405752,931634354,940041510.8,60.62430591467137,68.27455815215792,NaN,NaN,23.946126091779124,15.38267306317528
2020-07-27T09:30:00-04:00,105.06,106.16,104.73,105.89,5933612,7834995.45,62.497253472606126,61.29487904785684,NaN,NaN,74.55129759883357,108.72993286829053,0.25706770288785763,1.5577839391503971,1.3007162362625395,937567966,938224002.2,57.927815590160435,67.57199638253202,NaN,NaN,24.19216823879916,16.64117237397869
2020-07-28T09:30:00-04:00,105.94,106.47,105.57,105.77,6239393,7772453.7,61.83253692466169,61.74666943085881,NaN,NaN,76.97378038246212,95.93682030330542,0.1790683947252818,1.5245517296691418,1.34548333494386,931328573,936650338.2,55.62100907626887,66.49733741860692,NaN,NaN,24.210720786580346,17.722536432921785
2020-07-29T09:30:00-04:00,106.01,107.31,105.94,106.88,5449855,7585796.9,65.48898725782013,62.686865237772714,NaN,NaN,93.5389952301291,87.82579432104305,0.17936397042176755,1.5696882979710693,1.3903243275493018,936778428,935036928,53.27843698684991,65.23765096033513,NaN,NaN,25.269414635099814,18.80066189037579
2020-07-30T09:30:00-04:00,105.85,106.32,105,106.14,5348664,7306572.8,61.27454685281101,63.393976951671576,NaN,NaN,58.98581187598338,75.44268802658824,0.110246283097859,1.5281321814216255,1.4178858983237665,931429764,933747817,51.41516798261689,64.15740265752342,NaN,NaN,24.96453378258735,19.68121501783458
2020-07-31T09:30:00-04:00,105.81,106.1,104.15,105.53,6920437,7327475.85,57.96318470260028,63.71024254784903,NaN,NaN,35.208430187507545,67.8516630549832,0.009289993368810867,1.4294983900347802,1.4202083966659693,924509327,932322811.6,49.36016904609322,63.15486561665248,NaN,NaN,23.746958548392058,20.262035522199934
2020-08-03T09:30:00-04:00,106.19,106.965,106,106.62,8811926,7449330.25,61.9229645976665,63.830194880943694,NaN,NaN,76.26655098268401,68.1947137317533,0.002139034714378374,1.4228821900589423,1.420743155344564,933321253,931473469,48.125510761905815,61.99832743104472,NaN,NaN,23.8291217151934,20.77161926405614
2020-08-04T09:30:00-04:00,106.38,106.63,105.49,106.15,6092927,7458315.55,59.32785370641311,63.49808257614676,NaN,NaN,55.36970084892844,63.87389782504656,-0.04540212551304146,1.363990498453262,1.4093926239663035,927228326,930653419.6,46.90557656279364,60.642129105723484,NaN,NaN,23.140618327761743,21.11004770172837
2020-08-05T09:30:00-04:00,106.73,106.8313,106.37,106.64,4407041,7397422.5,61.15559835713876,63.354417526721356,NaN,NaN,73.17748131953047,59.80159504292683,-0.05439845752809336,1.3413945520561867,1.39579300958428,931635367,929624807.4,45.3526183872332,59.02028565419512,NaN,NaN,23.07730859757035,21.39108497256294
2020-08-06T09:30:00-04:00,106.51,106.96,105.3,106.07,5369860,7139810.15,57.89623902700315,62.707087772559426,NaN,NaN,48.33135438344495,57.67070354441914,-0.10628677392543207,1.26293454217749,1.369221316102922,926265507,928591956,43.78503087231013,56.97486380350747,NaN,NaN,22.090166782973103,21.490953802621533
2020-08-07T09:30:00-04:00,105.96,106.43,105.655,106.41,4274009,6828378.05,59.28999245960424,62.16671657423562,NaN,NaN,47.97168255306203,60.22335401753004,-0.124022560759385,1.2141931151536909,1.3382156759130759,930539516,929797993.8,46.126623729750435,54.97003582735143,NaN,NaN,21.643036721306423,21.51267993386223
2020-08-10T09:30:00-04:00,106.43,106.52,105.77,106.05,4640201,6552019.55,57.133422428481154,61.50000994368844,NaN,NaN,39.31254067598362,52.83255195618996,-0.16381215662382775,1.1334504801332912,1.297262636757119,925899315,928313606.2,43.713149911752964,52.87767682634688,NaN,NaN,20.668034558772522,21.392016308849414
2020-08-11T09:30:00-04:00,106.64,106.74,105.13,105.38,8115926,6413315.7,53.25129880857291,60.368785968113464,NaN,NaN,-15.62633314999114,38.633345156406044,-0.23474893111362638,1.0038264728650859,1.2385754039787122,917783389,926424618.8,40.78836679349439,50.761466903530916,NaN,NaN,18.72380167181974,21.010842789273745
2020-08-12T09:30:00-04:00,105.95,107.485,105.91,107.15,8205475,6343240.4,60.82446085402889,59.9798321335021,NaN,NaN,130.935404212424,50.18492973498475,-0.16523939079453198,1.0320261654855472,1.1972655562800791,925988864,925295318.2,39.10388376587659,48.72340467012699,NaN,NaN,19.18906813136158,20.750589266714865
2020-08-13T09:30:00-04:00,107.02,107.12,106.29,107.01,5323297,6288794.4,59.99656907758175,59.989636323356436,NaN,NaN,121.25766653725505,64.77019216574676,-0.13285975010871276,1.0311908686441882,1.164050618752901,920665567,924175330.2,37.451947734122065,47.06823622865919,NaN,NaN,19.32289021402903,20.546632259188318
2020-08-14T09:30:00-04:00,106.81,107.28,106.3887,106.8,3826241,6102676.1,58.70578923647784,59.71881744934728,NaN,NaN,108.46767492103925,76.86939063934221,-0.12961422767887565,1.0020328341543063,1.131647061833182,916839326,921435292.2,33.700976626122596,45.33774773122791,NaN,NaN,19.068186562001554,20.33542573101878
2020-08-17T09:30:00-04:00,106.99,107.84,106.94,107.43,4610265,5994372.8,61.389508170540616,59.68717253833863,NaN,NaN,168.43492506814886,102.69386751777526,-0.09089728714899703,1.0180254528969357,1.1089227400459327,921449591,920545347.4,32.56033468105595,43.690556702998414,NaN,NaN,19.610549698176175,20.231872012041265
2020-08-18T09:30:00-04:00,107.65,107.83,106.84,107.4,4220527,5832468.35,61.18558696990743,59.37978680348772,NaN,NaN,138.64326323341837,133.54778679445718,-0.07388963976446172,1.0165606903403557,1.0904503301048174,917229064,920434482.4,32.4131562229731,42.200179505578646,NaN,NaN,20.001836255492925,20.19900976110579
2020-08-19T09:30:00-04:00,107.5,107.8,106.82,107.05,6308081,5865443.1,58.73431441787595,59.19834162956379,NaN,NaN,107.913521285876,128.94341020914754,-0.09163376871054152,0.9759081192166406,1.067541887927182,910920983,917420906.2,28.625420553945958,40.57234040353071,NaN,NaN,19.67891958265129,20.12471116418372
2020-08-20T09:30:00-04:00,106.58,106.95,106.43,106.71,4938320,5763851.1,56.37166705484711,59.08466179758142,NaN,NaN,41.76694592535227,113.04526608676701,-0.1293824327140478,0.9058138470346222,1.03519627974867,905982663,914484325.4,25.49849622862945,38.867935202283306,NaN,NaN,18.767539396255323,19.93082948305109
2020-08-21T09:30:00-04:00,106.54,106.96,105.99,106.82,6466753,5775140.5,56.97468400820077,58.73121318404815,NaN,NaN,22.596781331039658,95.87108736876709,-0.1486778669420421,0.8493489460711174,0.9980268130131595,912449416,913606343.4,24.63214100590703,37.1898373625691,NaN,NaN,18.15107054780307,19.676578206587088
2020-08-24T09:30:00-04:00,107.33,107.37,105.675,106.33,6363195,5796619.65,53.43186233222319,58.31007094303458,NaN,NaN,-1.016146820834071,61.98087299097051,-0.19334740705619802,0.7563425541929121,0.9496899612491101,906086221,910533669.4,21.835937200618062,35.39914883669942,NaN,NaN,16.6657240168092,19.24645617947596
2020-08-25T09:30:00-04:00,106.87,107.09,106.46,107.05,5096537,5739476.85,57.60360400464503,58.0563570607136,NaN,NaN,54.69953775037822,45.19212789436242,-0.17391924298575834,0.7322909075169122,0.9062101505026705,911182758,909324408.2,20.833588000678404,33.64778952337408,NaN,NaN,16.45758258930407,18.84804566659426
2020-08-26T09:30:00-04:00,106.83,107.04,105.77,106.92,6995307,5816749.45,56.617383847905245,57.96501026220661,NaN,NaN,11.180447217878807,25.84551308076298,-0.16918295328540367,0.6947314588959159,0.8639144121813196,904187451,907977701.8,19.74647597115532,31.93074988757731,NaN,NaN,16.019366710737927,18.443948672900497
2020-08-27T09:30:00-04:00,107.1,108.2608,106.34,107.76,7775548,5938093.65,61.235634643125216,58.10398470388668,NaN,NaN,136.6803937767529,44.828202651043114,-0.1116147938678893,0.724395919846458,0.8360107137143473,911962999,909173769,23.561436818706127,30.31895082250271,NaN,NaN,16.916352254890597,18.225720613184798
2020-08-28T09:30:00-04:00,108.06,108.06,107.2,108,5159655,5850054.55,62.46509282277928,58.48481830347941,NaN,NaN,168.08757872819032,73.92636213047325,-0.06198666567660438,0.7585273816185918,0.8205140472951962,917122654,910108416.6,26.501661328681237,29.089558780854734,NaN,NaN,18.01681165712889,18.19587647660538
2020-08-31T09:30:00-04:00,107.77,108.775,107.68,108.26,6721123,5745514.4,63.80441027791595,59.23861197986105,NaN,NaN,200.01063773202546,114.13171904104516,-0.018519150294313946,0.7973651094273038,0.8158842597216177,923843777,913659927.8,36.49729200184384,28.783053438593978,NaN,NaN,19.32386771877097,18.357018082629036
2020-09-01T09:30:00-04:00,108.12,108.29,106.64,107.29,10999335,5990834.8,55.804252574368626,58.88002567417103,NaN,NaN,75.5459392599359,118.3009993429567,-0.059645144258948735,0.7413278293979317,0.8009729736568805,912844442,913992264.6,37.35583730354074,28.65819297699856,NaN,NaN,18.21140944941854,18.33621684931325
2020-09-02T09:30:00-04:00,107.39,109.73,106.94,109.44,8495835,6195274.5,65.98482084915014,59.30775794356878,NaN,NaN,199.5144794300022,155.96780578538136,0.04761023598732861,0.8604857686410412,0.8128755326537126,921340277,917422829.8,45.54075822838694,29.235965155160336,NaN,NaN,20.588803841221203,18.658014991014387
2020-09-03T09:30:00-04:00,109.58,109.74,105.695,106.46,13337297,6593646.35,49.10176292578025,58.62175606423323,NaN,NaN,32.36513822744663,135.10475467552013,-0.0852474460425181,0.706316225100565,0.7915636711430831,908002980,916630826,44.107921379564026,29.979318351834724,NaN,NaN,16.062202239310476,18.28718459791383
2020-09-04T09:30:00-04:00,106.83,107.02,104.41,105.7,14715567,7115724.25,45.87778872906062,57.51377610412752,NaN,NaN,-148.65122985606007,71.75699295867005,-0.21976921466657784,0.5168521528098609,0.7366213674764387,893287413,911863777.8,36.636297192408854,30.270458531217077,NaN,NaN,11.366151526061373,17.298465587649194
2020-09-08T09:30:00-04:00,105.53,105.57,103.67,103.96,9660439,7366736.15,39.485549782341174,55.96377344787278,NaN,NaN,-255.3845126672215,-19.322037121179342,-0.4103225591775588,0.22371816850449022,0.634040727682049,883626974,903820417.2,28.013647133449112,29.95620788196536,NaN,NaN,4.934722794658494,15.532216617221952
2020-09-09T09:30:00-04:00,104.74,106.67,104.72,105.8,8200986,7370989.15,47.7726365186954,55.18079645507417,NaN,NaN,-120.23363265354931,-58.4779515038764,-0.39660384416938577,0.1382859224703168,0.5348897666397026,891827960,899617120.8,24.73710857735874,29.678471312209133,NaN,NaN,2.9832883102037213,13.739512573362205
2020-09-10T09:30:00-04:00,106.1,106.1,103.9,104.18,9186165,7420023.65,42.28247559746938,54.17442563669005,NaN,NaN,-182.73043299754494,-134.92693398938584,-0.4754756937954042,-0.05945485060455269,0.41602084319085153,882641795,891877424.4,20.07989931487873,29.291428675512652,NaN,NaN,-0.7552211116347965,11.668836332648349
2020-09-11T09:30:00-04:00,104.67,105.09,103.79,104.59,8764261,7592071.85,44.03543759782151,53.250193750234395,NaN,NaN,-165.55371210074532,-174.51070405502423,-0.477613360034992,-0.18099585685288844,0.29661750318210356,891406056,888558039.6,18.47353113336817,28.851527970331308,NaN,NaN,-2.8906687279748713,9.588907038273604
2020-09-14T09:30:00-04:00,105.44,106.66,105.23,106.09,5847173,7693118.45,50.016564234288985,53.00624388609623,NaN,NaN,-47.81115019179442,-154.3426881221711,-0.3608936356995273,-0.1544995414423056,0.20639409425722172,897253229,889351202.8,20.117986921711804,28.728817236123717,NaN,NaN,-2.433936657935436,7.871357938815169
2020-09-15T09:30:00-04:00,106.64,107.08,105.96,106.23,5580462,7741628.3,50.547787481641144,52.50225699159596,NaN,NaN,-13.515395990008647,-105.96886478672855,-0.26176451561676806,-0.12081155026373835,0.1409529653530297,902833691,893192546.2,27.721874867921102,29.220837726641054,NaN,NaN,-1.9079003486935007,6.474321040599645
2020-09-16T09:30:00-04:00,106.8,107.01,105.925,106.05,7193286,7890266.25,49.814730216338546,52.016353160769754,NaN,NaN,-17.20261749711468,-85.36266175544161,-0.19868239591184517,-0.10740002953677674,0.09128236637506841,895640405,893955035.2,29.163261199492638,29.893465242950864,NaN,NaN,-1.7282478899804061,5.302525479088209
2020-09-17T09:30:00-04:00,105.07,106.06,104.73,105.7,7597328,7954728.6,48.34654312711082,51.09570376676873,NaN,NaN,-72.57532921472804,-63.33164099887822,-0.1718968721299005,-0.12358872378730723,0.048308148342593275,888043077,895035291.6,31.254930511569682,30.443000506726833,NaN,NaN,-2.027275112146277,4.255411108911854
2020-09-18T09:30:00-04:00,105.83,106.215,104.56,105.54,8649331,8140279.15,47.65507934592538,50.037845661279164,NaN,NaN,-69.05557893327585,-44.03201436538433,-0.15674834904010126,-0.14762728795753333,0.009121061082567952,879393746,892632829.6,29.19054398111315,30.635063553329108,NaN,NaN,-2.46929222081106,3.294739204665724
2020-09-21T09:30:00-04:00,103.72,103.72,101.74,103.18,8783015,8256092.25,38.83282292944718,48.25416085067426,NaN,NaN,-200.4735125122994,-74.56448682948532,-0.2897293823545405,-0.35304066686060764,-0.06331128450606717,870610731,887304330,25.21288049862875,29.829034160242315,NaN,NaN,-5.761313709641281,2.001017359764723
2020-09-22T09:30:00-04:00,103.01,103.28,102.025,102.96,7833370,8329601,38.124277881785304,46.991305515489735,NaN,NaN,-171.90250348033825,-106.24190832755123,-0.3713539139312872,-0.5275036769201762,-0.156149762988889,862777361,879293064,20.65561029504417,28.63616080249256,NaN,NaN,-8.598764063659209,0.4867628707041616
2020-09-23T09:30:00-04:00,103.39,103.428,101.8,101.9,7682189,8458883.6,34.82702157794786,44.76574842468957,NaN,NaN,-162.46975982180015,-135.2953367924883,-0.46927073925602375,-0.7427381870589187,-0.27346744780289495,855095172,871184017.4,17.255695001483986,26.615799143428063,NaN,NaN,-12.068170147410846,-1.306798989026554
2020-09-24T09:30:00-04:00,101.54,101.9,100.77,101.39,8434730,8530854.75,33.333271257196515,43.6394275912193,NaN,NaN,-174.61842952224362,-155.70395685399143,-0.5360970188462306,-0.9435887213606833,-0.40749170251445266,846660442,862907490.4,14.612044315845083,24.50895078173385,NaN,NaN,-15.381731972648602,-3.3175037009725603
2020-09-25T09:30:00-04:00,101.04,103.3,100.93,103.02,6768989,8480526.8,41.90902762290622,43.355944655065414,NaN,NaN,-113.1140628294373,-164.51565363322374,-0.44214152857565203,-0.9601686132340177,-0.5180270846583657,853429431,857714627.4,13.241330895980497,22.8378817605604,NaN,NaN,-15.607350837351744,-5.073196149026729
2020-09-28T09:30:00-04:00,104.01,104.755,103.75,103.95,6511074,8548097.75,46.16417575188906,43.832989367175976,NaN,NaN,-38.971730539401925,-132.21529723864424,-0.2960010765636113,-0.8880284303628798,-0.5920273537992685,859940505,855580582.2,12.713514661169725,21.74501515539759,NaN,NaN,-14.43257487974265,-6.410250253414718
2020-09-29T09:30:00-04:00,104.13,104.66,103.41,103.82,5402704,8482176.8,45.66068265062703,43.682135519456814,NaN,NaN,-40.35451617641619,-105.90569977785981,-0.1917851028212214,-0.8317587323257953,-0.6399736295045739,854537801,853932670.2,12.305600299314634,20.857050278394436,NaN,NaN,-13.646654080759223,-7.444022228749647
2020-09-30T09:30:00-04:00,104.14,106.33,104.12,105.48,7565471,8310483.6,52.747661889951765,44.4296488260627,NaN,NaN,23.642280546042873,-68.68329170429121,-0.004639018121366911,-0.6457724021562825,-0.6411333840349156,862103272,855334290.2,14.809267912341369,20.480576606784627,NaN,NaN,-10.665111346566883,-7.904177817009252
2020-10-01T09:30:00-04:00,105.97,106.4,104.67,105.12,9113225,8341353.1,51.1884746680263,44.94058004536304,NaN,NaN,39.52077603242378,-25.855450593357723,0.09577443884818404,-0.5214153354746855,-0.6171897743228696,852990047,856600211.2,17.111040953871097,20.383255879677694,NaN,NaN,-8.723374157019864,-8.021205865582196
2020-10-02T09:30:00-04:00,104.12,105.21,103.71,104.16,8628570,8105916.75,47.1831697647516,44.73819472611037,NaN,NaN,-7.1153169106013605,-4.655701409590528,0.09805283809697796,-0.4946237267016471,-0.5926765647986251,844361477,854786620.4,16.42629851856387,20.11956385088141,NaN,NaN,-8.283773793610854,-8.05871556958629
2020-10-05T09:30:00-04:00,104.91,106.41,104.88,106.3,6661164,7703196.6,55.53544128274794,45.09445571190371,NaN,NaN,77.56996123482232,18.652636945254283,0.23631392248759253,-0.2972841616891344,-0.5335980841767269,851022641,853003047.6,15.758416712373716,19.26503112548517,NaN,NaN,-5.084437078642906,-7.633818642308664
2020-10-06T09:30:00-04:00,106.6,106.66,104.785,104.89,7747513,7607550.3,49.932621419002025,45.102876512093964,NaN,NaN,49.356822307850486,36.59490464210762,0.2254671312099017,-0.2517641701643498,-0.4772313013742515,843275128,850750513,14.932641478833872,18.24855828829526,NaN,NaN,-4.258765756992402,-7.1516682301206265
2020-10-07T09:30:00-04:00,105.63,107.2,105.61,106.87,7873212,7591161.6,56.560201653768864,45.68956640685525,NaN,NaN,104.99538716145315,52.86552596518968,0.33755901402768557,-0.05528253383964454,-0.3928415478673301,851148340,848559526.6,14.155623325902582,17.027179203604756,NaN,NaN,-1.204002438533252,-6.302001688465287
2020-10-08T09:30:00-04:00,107.49,107.74,107.16,107.39,5942676,7428987.15,58.12784857344948,46.437621351678395,NaN,NaN,131.33836923565298,71.22904460583553,0.42688727988232467,0.14076755198557578,-0.2861197278967489,857091016,849379720.4,15.919432689504177,16.079242682775543,NaN,NaN,1.7196409229820637,-5.1560527439728085
2020-10-09T09:30:00-04:00,107.99,108.68,107.71,108.36,5636183,7272583.25,60.958218210652305,48.01800672890733,NaN,NaN,148.26280702688592,102.30466939333299,0.5250100025816341,0.3701427753302937,-0.15486722725134036,862727199,853052864.8,23.500090876918236,15.956900566939078,NaN,NaN,5.056468139715665,-3.6971211891601694
2020-10-12T09:30:00-04:00,108.85,109.525,108.49,109.1,5065127,7233480.95,63.012309606158105,49.79572328064825,NaN,NaN,163.2563689909226,119.44195094455304,0.6076264985176718,0.6046658958957494,-0.002960602621922409,867792326,856406801.8,29.730014567014166,16.60507230065122,NaN,NaN,8.440252985243372,-1.9632105928168064
2020-10-13T09:30:00-04:00,108.45,109.02,107.99,108.27,6773292,7293122.45,59.24710709922191,51.54001510359639,NaN,NaN,127.72891594547451,135.11636967207784,0.5746144627957139,0.71530747587272,0.1406930130770061,861019034,859955583,35.69708891222048,17.922314722846682,NaN,NaN,10.06846807665857,-0.24439935432032422
2020-10-14T09:30:00-04:00,108.23,108.68,107.295,107.64,5999895,7233452.9,56.48801380286794,53.19392528543007,NaN,NaN,99.39489131200658,133.99627050218854,0.4823131191600444,0.7435844120270616,0.2612712928670172,855019139,860729742.8,36.954796587080516,19.518225599363497,NaN,NaN,10.567689111992093,1.3001847122957353
2020-10-15T09:30:00-04:00,106.31,107.06,106.13,106.86,6197773,7163475.15,53.1855960964834,53.99939446211415,NaN,NaN,50.91870851349413,117.91233835775677,0.34701703616982893,0.6950425880793034,0.3480255519094745,848821366,859075812.8,35.363414517096444,21.098374429443208,NaN,NaN,9.986536322424511,2.5410920851712744
2020-10-16T09:30:00-04:00,107.21,108.72,107.17,107.92,7462098,7104113.5,56.87534865366724,54.76447824081259,NaN,NaN,86.9445141129061,105.64867977496078,0.30849870713995947,0.7336489358344238,0.42515022869446434,856283464,857787065.8,34.130092907886365,22.628130018494396,NaN,NaN,10.607360432282874,3.6934161347586456
2020-10-19T09:30:00-04:00,108.2,108.53,105.845,106.21,8308906,7080408.05,50.02545650546206,55.07624780187224,NaN,NaN,44.18534167691521,81.8344743121593,0.1551799341206776,0.6191251463453114,0.46394521222463375,847974558,853823512.2,30.5959227414278,23.934581621502478,NaN,NaN,8.966353622029603,4.446692918654497
2020-10-20T09:30:00-04:00,106.59,107.23,106.17,106.35,7423444,7059911.75,50.55055131363312,54.919311332135194,NaN,NaN,29.225067583796765,62.13370463982375,0.05565268189510236,0.5335110645935117,0.47785838269840936,855398002,852699305.8,29.657851811069207,24.995194757125894,NaN,NaN,7.817403933061738,4.928223063569817
2020-10-21T09:30:00-04:00,106.34,106.64,105.57,105.82,5474401,6949522.35,48.474056867213335,54.72542434636284,NaN,NaN,0.612162934415137,42.37715896430545,-0.04782638266653555,0.41807540436523993,0.4659017870317755,849923601,851680198.2,28.795941501784156,25.829830510548256,NaN,NaN,6.247774620779943,5.116730428885549
2020-10-22T09:30:00-04:00,105.97,107.61,105.96,107.42,6127112,6834141.45,54.544496524230716,55.251233400611355,NaN,NaN,35.28490299412089,39.250397860430816,-0.012317193153700168,0.45050529558965025,0.4628224887433504,856050713,853126067.6,31.82322135722292,26.929610713309618,NaN,NaN,6.703064524644405,5.343349585422528
2020-10-23T09:30:00-04:00,107.96,108.6,107.21,107.82,5697374,6780560.7,55.94197121386196,55.28027125283379,NaN,NaN,74.24361199768192,36.71021743738598,0.03189256776615135,0.5026881984510396,0.4707956306848883,861748087,854218992.2,34.103845472552834,28.239998481893842,NaN,NaN,7.49160539568659,5.650243272603109
2020-10-26T09:30:00-04:00,106.95,107.08,105.6,106.62,8135488,6861781.4,50.887512657498156,55.348477769869234,NaN,NaN,-14.39229095431034,24.994690911140868,-0.022942822156129306,0.4421171029897266,0.4650599251458559,853612599,855346600.4,36.46530702084453,29.778046020608887,NaN,NaN,6.642761945707537,5.79203165447517
2020-10-27T09:30:00-04:00,106.23,106.76,105.83,105.89,6893116,6936302,48.043708435625064,54.7401568257161,NaN,NaN,-42.17411689366659,10.714854015648196,-0.10693663872506598,0.3313891267395235,0.43832576546458946,846719483,853610896.6,34.420554547823514,31.225541107888954,NaN,NaN,5.072129621358569,5.689188506887084
2020-10-28T09:30:00-04:00,104.14,104.77,102.4,102.53,11431816,7129619.25,37.622140332868426,53.27546337996031,NaN,NaN,-214.910909659273,-32.38976050308943,-0.37240002317552634,-0.02717426350481844,0.3452257596707079,835287667,850683709.8,31.239145441257037,32.31980630444273,NaN,NaN,-0.10829689251703752,4.860976306972209
2020-10-29T09:30:00-04:00,102.46,102.91,101.06,101.69,15974243,7472670.15,35.54620201611084,51.460319366064496,NaN,NaN,-244.40732196679406,-88.32820549527241,-0.5760197000519243,-0.3747988653941974,0.20122083465772683,819313424,843336252,24.994388739040446,32.42654186602289,NaN,NaN,-4.9666767282671955,3.4570258733665806
2020-10-30T09:30:00-04:00,101.56,102.16,100.31,101.66,10741670,7578325.15,35.470923665367806,49.49307751315091,NaN,NaN,-229.30244898430772,-149.03741769167036,-0.6771976860996642,-0.6452762729668535,0.031921413132810744,808571754,832700985.4,19.05625580435354,31.664130525832842,NaN,NaN,-8.76582192378257,1.7109047594881308
2020-11-02T09:30:00-05:00,103.16,103.73,102.41,103.49,10287508,7759642.35,43.35184797074198,48.35770186111662,NaN,NaN,-123.80844420170263,-170.92064834114882,-0.5886189625335565,-0.7038522900341349,-0.11523332750057838,818859262,825750318,16.326287282074475,30.28050183796527,NaN,NaN,-9.564401862269959,0.10014667066554672
2020-11-03T09:30:00-05:00,104.76,106.14,104.68,105,9812871,7862910.25,48.89775089190865,47.81554022461953,NaN,NaN,-38.13802902912094,-170.11343076823968,-0.4048279233792394,-0.6212682317246276,-0.21644030834538824,828672133,822140848,15.115302924649981,28.72053800493452,NaN,NaN,-8.406103352851108,-1.1150319041225467
2020-11-04T09:30:00-05:00,107.99,111.42,107.78,109.66,25531475,8745823.4,61.44308968761217,48.40536119541444,NaN,NaN,125.30510007282257,-102.07022882182056,0.030954046395212792,-0.17774775035137225,-0.20870179674658504,854203608,825924036.2,21.67314538267918,27.742661638190434,NaN,NaN,-2.387097856986838,-1.2967556116745884
2020-11-05T09:30:00-05:00,111.17,111.25,109.68,109.88,12864617,9091920.45,61.918401921012446,48.765579285939104,NaN,NaN,136.47854522637095,-25.893055383187562,0.3184136607721174,0.18931527921856173,-0.12909838155355569,867068225,835474996.4,35.26928854004359,27.82403275477309,NaN,NaN,2.2431743313006733,-0.7910513341066939
2020-11-06T09:30:00-05:00,110,110.67,109.21,109.92,12311222,9425672.4,62.01010140569263,49.62162535024129,NaN,NaN,116.96299562163387,43.36003353800076,0.48562567964871295,0.47793371800733553,-0.007691961641377434,879379447,849636535,49.317249862060194,29.16127040624683,NaN,NaN,5.800263534049044,0.15056507562984
2020-11-09T09:30:00-05:00,113.92,114.41,110.81,110.95,20442868,10194559.45,64.38808561985854,50.610020657828805,NaN,NaN,173.0623306233036,102.73418850300202,0.6307759529380802,0.7807779795312229,0.15000202659314266,899822315,865829145.6,60.005261130481756,31.328942500490587,NaN,NaN,9.502894953675089,1.4866122010648755
2020-11-10T09:30:00-05:00,111.46,111.67,110.07,111.27,12526540,10482221.85,65.11860561496488,51.79891699695391,NaN,NaN,126.64540357800863,135.69087502442792,0.7077411270249854,1.0346784353743743,0.326937308349389,912348855,882564490,67.60809762779817,34.10123936663444,NaN,NaN,12.694380495564772,3.087721957422003
2020-11-11T09:30:00-05:00,112.16,112.16,110.59,111.13,9935420,10678998.1,64.49526225051524,52.50968597740282,NaN,NaN,119.732797240807,134.57641445802483,0.7069653497461876,1.2106439955321235,0.5036786457859359,902413435,892206455.4,71.02555783627976,36.901406257995646,NaN,NaN,15.094976730270288,4.803044067828901
2020-11-12T09:30:00-05:00,110.92,111.36,109.98,110.72,7856407,10761929.8,62.60521245457955,52.985631780311216,NaN,NaN,90.02241920988097,125.28518925472682,0.6386616315035012,1.3020056851653123,0.6633440536618112,894557028,897704216,72.7884480330708,39.6645921551755,NaN,NaN,16.573209551231912,6.484496279743617
2020-11-13T09:30:00-05:00,111.27,112.545,111.07,112.12,6576891,10717669.45,66.24300610732197,54.082452741012865,NaN,NaN,107.5865603895469,123.40990220830943,0.6456676343389107,1.4704285965854496,0.8247609622465388,901133919,902055110.4,74.12993101527329,42.35492244049184,NaN,NaN,18.951842666734294,8.265545763599427
2020-11-16T09:30:00-05:00,113.01,113.19,111.37,111.93,7586032,10681525.75,65.31436912390829,55.31607136160453,NaN,NaN,99.78858744749411,108.75515357314752,0.5965673524949388,1.5704701528652123,0.9739028003702735,893547887,900800224.8,73.0119458133621,45.11145038803031,NaN,NaN,20.65186862126549,10.03502045755172
2020-11-17T09:30:00-05:00,111.36,111.61,110.67,111.2,8898284,10755267.75,61.73355971565792,57.03831560323234,NaN,NaN,69.91483033662124,97.40903892487003,0.47905342015087227,1.5727195755588639,1.0936661554079916,884649603,895260374.4,68.12720404630063,47.74631171696199,NaN,NaN,21.123325019484554,11.619063966399267
2020-11-18T09:30:00-05:00,111.44,111.48,109.1,109.13,9849992,10974047.3,52.88038130355505,58.27647126662122,NaN,NaN,38.73020878356934,81.20852123342252,0.23821188241932667,1.39143100843215,1.1532191260128233,874799611,889737609.6,63.561723015121316,50.501121308110626,NaN,NaN,18.877664557400585,12.656006907970884
2020-11-19T09:30:00-05:00,109.13,109.22,108.235,109.05,10411029,11188243.15,52.566625103715296,59.49759279793175,NaN,NaN,13.671975387505103,65.93843246894734,0.05915052019510503,1.2271572762567047,1.1680067560615996,864388582,883703920.4,58.9164264571277,53.34827635473736,NaN,NaN,16.972216107633503,13.272608222208401
2020-11-20T09:30:00-05:00,108.8,109.305,108.42,108.8,7674538,11287101.35,51.53752876411573,60.082284283172726,NaN,NaN,12.755947283737978,46.97230984778555,-0.08278535125879105,1.0645250669881108,1.1473104182469018,856714044,874819945.4,52.797942096507434,55.95339455576828,NaN,NaN,15.101039119097544,13.533812636049706
2020-11-23T09:30:00-05:00,109.34,109.4,107.84,108.52,7747820,11267717.95,50.348652928775024,60.185920142948895,NaN,NaN,4.961153234107906,28.00682300510831,-0.1957370167718513,0.9026391472820876,1.098376164053939,848966224,865903612.8,47.469660170867996,58.264420073355275,NaN,NaN,13.20143893620534,13.486330678929082
2020-11-24T09:30:00-05:00,109.05,109.58,108.47,108.84,9616222,11403873.25,51.719414952675734,59.49137194759629,NaN,NaN,10.95109284249616,16.2140755062833,-0.24586410802325576,0.7910460290248693,1.036910137048125,858582446,860690181.4,44.63336198066532,59.90443554464,NaN,NaN,11.937889209791882,13.265124754766624
2020-11-25T09:30:00-05:00,108.97,109.05,107.985,108.44,11671834,11415874.15,49.866174476185876,58.63049855868011,NaN,NaN,-7.884853150444555,6.891063119480519,-0.29937457220056596,0.6626919217974176,0.9620664939979836,846910612,855112381.6,41.75857680642644,60.36795613509592,NaN,NaN,10.360073350401514,12.850117411285895
2020-11-27T09:30:00-05:00,108.88,109.515,108.53,109.44,4443906,10839357.3,54.27716399347014,58.07814588637849,NaN,NaN,0.8396664104940705,4.324601324078316,-0.2621734974749441,0.6343496221543035,0.8965231196292476,851354518,852505568.8,40.44738025256966,59.73439402013231,NaN,NaN,10.117348303565933,12.459721824468758
2020-11-30T09:30:00-05:00,109.48,109.84,108.9,109.74,12723443,10938445.95,55.54094364689863,57.446207174024224,NaN,NaN,-2.199366065079677,1.3335386543147842,-0.21414114758787017,0.6288466851444099,0.8429878327322801,864077961,853978352.2,41.56377549808388,58.417145046389614,NaN,NaN,10.245920677536722,12.143464517764182
2020-12-01T09:30:00-05:00,110.8,111.865,110.47,110.66,12682367,11058188.9,59.2598251743075,57.02772285683441,NaN,NaN,58.4750411409718,12.036316235687561,-0.12178287685844935,0.6907592366592183,0.8125421135176677,876760328,859537173,45.701250756796426,56.852370269889484,NaN,NaN,11.383156903759273,12.03484914433491
2020-12-02T09:30:00-05:00,110.74,111.68,110.67,111.49,8552381,10995164.4,62.32190160746096,56.87248281090196,NaN,NaN,66.51847147241921,23.14979196167217,-0.011949572780363016,0.7976051475422139,0.8095547203225769,885312709,864883225.6,49.41100029994611,55.308473303008505,NaN,NaN,13.250702166545475,12.208542433222133
2020-12-03T09:30:00-05:00,111.45,111.79,110.87,111.35,9795704,10208375.85,61.4824819098553,56.79228777199308,NaN,NaN,63.407545798945755,37.40827175155023,0.041203201952706214,0.8610587227634596,0.8198555208107534,875517005,870604504.2,53.10365195637504,53.90241644038738,NaN,NaN,14.58239456966172,12.547664166999217
2020-12-04T09:30:00-05:00,111.39,112.56,111.2488,112.54,7859687,9958129.35,65.71020867091974,56.754230812250064,NaN,NaN,98.97599169247778,57.03553680794697,0.14082694514003846,0.9958892022358015,0.855062257095763,883376692,877008939,56.896513942727886,52.671458078062706,NaN,NaN,17.01472602354007,13.185815860790768
2020-12-07T09:30:00-05:00,112.42,112.52,111.44,111.85,5803253,9632730.9,61.49539823427533,56.48144717727628,NaN,NaN,80.4710718363055,73.56962438822401,0.14405716875236618,1.0351337180362208,0.8910765492838546,877573439,879708034.6,58.422696471694884,51.62936883937219,NaN,NaN,17.914437871998338,13.861333290963278
2020-12-08T09:30:00-05:00,111.58,112.79,111.54,112.7,7953249,9008249.95,64.5149670500904,56.68011912973575,NaN,NaN,101.62917944004755,82.20045204803915,0.18465133494029062,1.121890717959218,0.9372393830189273,885526688,881461306.6,59.42763640459712,51.00797115067909,NaN,NaN,19.58387285454952,14.67883894290417
2020-12-09T09:30:00-05:00,113.15,113.16,111.81,112.31,7386434,8751244.65,62.10831979059617,57.33925759309583,NaN,NaN,97.64766057222091,88.4262898679995,0.1669817223271305,1.1459665359278404,0.9789848136007099,878140254,880026815.6,58.18840209377336,50.62416251343995,NaN,NaN,20.299247817210695,15.48175449637653
2020-12-10T09:30:00-05:00,112.29,112.74,111.89,112.12,5410980,8525022.65,60.91609622402173,57.93564838740343,NaN,NaN,83.12401596678701,92.36958390156775,0.12610271985068455,1.1366132134140656,1.010510493563381,872729274,879469269.4,57.68490741230156,50.536196867380944,NaN,NaN,20.56586047653333,16.208055350684646
2020-12-11T09:30:00-05:00,111.66,111.93,110.91,111.68,5222420,8393323.3,58.13308442853357,58.40675950629043,NaN,NaN,41.46414683873426,80.86721493081905,0.05657763674675431,1.081232539496824,1.0246549027500698,867506854,876295301.8,54.77901845472972,50.67770232153968,NaN,NaN,20.030265266392092,16.754085338642852
2020-12-14T09:30:00-05:00,112.53,113.09,110.77,110.84,8469358,8487946.65,53.14160859993847,58.60625633994495,NaN,NaN,45.842992329936415,73.94159902954524,-0.052913652392281296,0.9585128372597183,1.0114264896519995,859037496,872588113.2,51.514824794159296,50.96664265177477,NaN,NaN,18.13249032776983,16.951000337089564
2020-12-15T09:30:00-05:00,111.61,112.28,111.02,112.04,5007547,8359022.4,58.60920020136266,59.098383857708306,NaN,NaN,58.3892910780053,65.29362135713679,-0.05140663579244664,0.9471681949114412,0.9985748307038879,864045043,868291784.2,47.94885664392858,51.20346369915071,NaN,NaN,18.027301041667318,17.104757580600673
2020-12-16T09:30:00-05:00,111.94,112.34,111.23,111.71,5355406,8181878.5,56.65153791921325,59.58305267506741,NaN,NaN,54.790010284599354,56.722091299612465,-0.07793089136996545,0.9011612164914311,0.9790921078613966,858689637,864401660.8,44.91701410791436,51.4290663635427,NaN,NaN,17.369398456818654,17.142563420060384
2020-12-17T09:30:00-05:00,111.89,112.98,111.88,112.91,4263673,7902562.55,61.66583413206041,60.11081482782385,NaN,NaN,88.93225683176168,57.883739472607395,-0.02281551407937088,0.950572715262183,0.9733882293415539,862953310,862446468,43.430615582752345,51.642154601412905,NaN,NaN,18.30438216713742,17.308537526785674
2020-12-18T09:30:00-05:00,113.02,113.27,111.79,113,7877006,7775861.4,62.02067163846914,60.57365254150746,NaN,NaN,89.61664260330402,67.51423862552136,0.009795158653103764,0.9856321776579335,0.9758370190048298,870830316,863111160.4,44.10777603306909,51.82386892534041,NaN,NaN,19.164081175433026,17.573615190878154
2020-12-21T09:30:00-05:00,110.87,111.51,109.365,111.41,6129646,7698616.8,52.73375592543204,60.10750473801635,NaN,NaN,-20.14604719408159,54.316430720717754,-0.08064518715568858,0.875030535060219,0.9556757222159076,864700670,864243795.2,45.309151245248444,51.79586181737269,NaN,NaN,17.032790704713033,17.496354549997424
2020-12-22T09:30:00-05:00,111.21,111.47,110.44,111.07,13105355,7966493.55,50.97596596692,59.297080763692,NaN,NaN,-15.739480911724177,39.490676322771854,-0.1635146086524456,0.7512824614003506,0.9147970700527962,851595315,861753849.6,43.11512620882873,51.34615652515002,NaN,NaN,14.753857074722193,17.104569196386677
2020-12-23T09:30:00-05:00,111.46,111.97,111.07,111.15,3920706,7681717.75,51.38657663914238,58.57594467292679,NaN,NaN,4.27935878708948,29.38854602326988,-0.21011846778136245,0.6521489853260931,0.8622674531074556,855516021,861119126.4,42.54950027526074,50.59228854792757,NaN,NaN,13.025639121791412,16.521864900015924
2020-12-24T09:30:00-05:00,111.2,111.68,111.05,111.47,1674691,7181860.6,53.07946687693664,57.67374883049943,NaN,NaN,-9.038599164012567,9.794374824115033,-0.2157535818871501,0.592575475748518,0.8083290576356681,857190712,859966606.8,41.485254246640665,49.491484283921345,NaN,NaN,12.045849096510748,15.882434070943756
2020-12-28T09:30:00-05:00,112.05,112.3,111.45,111.75,4390191,7179174.85,54.570220789778936,57.179093298749684,NaN,NaN,25.541724296902775,-3.020608837165212,-0.19747583881302888,0.561484259119382,0.7589600979324109,861580903,858116724.2,39.766000349963676,48.15886313236911,NaN,NaN,11.627746950921992,15.274621625226361
2020-12-29T09:30:00-05:00,112.27,112.79,111.9,112.28,5053353,6795670.35,57.33354655327088,56.666134691833996,NaN,NaN,80.26476373712397,17.061553349075897,-0.14876362628572948,0.573005565075249,0.7217691913609785,866634256,858503441.4,40.322786980857536,46.79423103067343,NaN,NaN,12.030777143072816,14.811215270632998
2020-12-30T09:30:00-05:00,112.51,112.89,112.135,112.26,3563990,6339751.5,57.19217342424193,56.314981379951554,NaN,NaN,86.26729291451718,37.46290811432417,-0.11828990529625238,0.573906809740663,0.6921967150369154,863070266,860798431.6,43.65168188682721,45.75589387303442,NaN,NaN,12.327515084904157,14.45640095838602
2020-12-31T09:30:00-05:00,112.27,113.62,111.895,113.44,5581249,6191194.9,62.990561219215856,56.46315745103685,NaN,NaN,145.47671299681986,65.70237895627024,-0.023994397071124718,0.6622037186980094,0.6861981157691341,868651515,863425530.4,47.277201508577946,45.01248630848273,NaN,NaN,14.285516899219816,14.431988949933706
2021-01-04T09:30:00-05:00,113.88,113.9,111.11,112.95,12911811,6347000.25,59.39292263892089,56.55314589463594,NaN,NaN,90.04744886353559,85.51958856177987,-0.0011605658882929415,0.6847474084087679,0.6859079742970609,855739704,863135328.8,46.91808312104329,44.45099092750513,NaN,NaN,14.934720168788724,14.503807695484422
2021-01-05T09:30:00-05:00,112.75,114.155,112.27,113.77,11081890,6508110.4,63.18256351467487,57.27035695997426,NaN,NaN,161.11609367213805,112.63446243682692,0.05928926817100988,0.7600195595108232,0.7007302913398133,866821594,864183467,48.44140059004608,44.23146062721133,NaN,NaN,16.638549814777516,14.808770855383436
2021-01-06T09:30:00-05:00,112.18,115.63,112.18,115.33,17833407,7109618.1,69.0921894749223,58.01914190808569,NaN,NaN,224.2659824022043,141.434706169843,0.18723714289013416,0.934776719952481,0.7475395770623469,884655001,867787616,53.3942198310831,44.6204151405795,NaN,NaN,20.162786482934596,15.573630230747888
2021-01-07T09:30:00-05:00,115.48,117,115.3,116.83,12407317,7332321.5,73.49722261672804,59.22240510076532,NaN,NaN,311.979055006589,186.57705858825736,0.3465284316719882,1.180700116652332,0.8341716849803439,897062318,874586026.4,61.00383348223327,45.76947366731657,NaN,NaN,24.831041913791445,16.896117614039824
2021-01-08T09:30:00-05:00,117.04,117.91,116.28,117.39,9350781,7430538.85,74.9335555742519,60.17009948949328,NaN,NaN,268.2892302585596,211.1395620406053,0.45633644021131947,1.4045922352444933,0.9482557950331738,906413099,882138343.2,67.37637343530166,47.47988494249866,NaN,NaN,29.074136965194626,18.635834664204797
2021-01-11T09:30:00-05:00,117.42,118.13,117.27,117.94,6428454,7481412.55,76.29252114734598,61.18951731155591,NaN,NaN,220.65304035253288,237.26068033840474,0.5276947103955332,1.6078741830275902,1.080179472632057,912841553,893558713,74.23335741967503,49.631712184399085,NaN,NaN,32.97555744531911,20.68436649007827
2021-01-12T09:30:00-05:00,117.71,117.8365,116.1341,116.66,9225459,7681564.5,67.16614978800823,62.22040258745421,NaN,NaN,145.35098015533404,234.10765763504395,0.4532236632639952,1.646709051712051,1.1934853884480559,903616094,900917613,77.51315368794882,51.9319980731634,NaN,NaN,33.30312214076202,22.487045868747376
2021-01-13T09:30:00-05:00,116.6,117.38,116.17,116.98,5259556,7521074.4,68.19061252938465,63.450020199058834,NaN,NaN,120.56588132988502,213.3676374205801,0.3923287942724507,1.6838963812886192,1.2915675870161685,908875650,905761742.8,79.37431874380172,54.52194039709004,NaN,NaN,33.88971521237771,24.115998632123137
2021-01-14T09:30:00-05:00,117.17,117.61,116.47,116.61,5792149,7560304.5,65.640368185028,64.46814816662209,NaN,NaN,104.15911277495566,171.80364897425343,0.2982070356650235,1.6643263815974478,1.3661193459324243,903083501,906965979.4,79.8214419399684,57.18422194456917,NaN,NaN,33.57641588211586,25.467486810693526
2021-01-15T09:30:00-05:00,116.29,117.24,115.83,116.97,10335242,7809296.3,66.93604722585384,65.45790390583046,NaN,NaN,84.92455106450338,135.13071313544216,0.23410054490476062,1.6587450270633752,1.4246444821586146,913418743,908367108.2,80.3550480465602,59.960635787420564,NaN,NaN,33.70282544200085,26.643963758023144
2021-01-19T09:30:00-05:00,117.9,118.23,117.23,117.85,6193043,7905764.8,69.92187370680648,66.554450542761,NaN,NaN,103.29615131855444,111.65933532864646,0.22481923340500143,1.7056685239148663,1.480849290509865,919611786,909721154.8,80.88122398214941,62.89743747543382,NaN,NaN,34.72046353032168,27.797749439780077
2021-01-20T09:30:00-05:00,118.05,118.6889,117.34,118.5,6871999,7855514.45,71.93767972842926,67.59760291241517,NaN,NaN,101.29068873160614,102.84727704390086,0.23519735262373254,1.7748459812895305,1.539648628665798,926483785,914294693,82.57855863447111,65.91570687926335,NaN,NaN,36.19596552018091,28.997494594123054
2021-01-21T09:30:00-05:00,118.35,118.47,117.54,117.94,5796233,7838843.8,67.72638890910599,68.35004687561975,NaN,NaN,86.50024426990508,96.0341496319049,0.17959814843030997,1.7641463142036855,1.5845481657733755,920687552,916657073.4,83.39841747547938,68.75475942130994,NaN,NaN,36.16443457011959,30.02134316212256
2021-01-22T09:30:00-05:00,117.59,118.25,117.44,117.59,4796466,7423399.35,65.1589644069889,68.50493281760353,NaN,NaN,73.49993406225853,89.90231388936546,0.09855260716494296,1.7077389247295542,1.6091863175646113,915891086,919218590.4,84.26319361336753,71.39661600022347,NaN,NaN,35.37996095260043,30.78685998933368
2021-01-25T09:30:00-05:00,117.66,118.43,117.415,118.36,6962045,7575466.3,68.03031050760416,69.12188909393805,NaN,NaN,76.31443141294686,88.18028995905415,0.07705749814379814,1.705508190244359,1.6284506921005608,922853131,921105468,84.88767108535708,74.10872942624589,NaN,NaN,35.54769285949481,31.46697897078527
2021-01-26T09:30:00-05:00,118.7,118.9856,117.855,117.92,5504027,7766933.1,64.74664873089426,69.23360946652517,NaN,NaN,77.47184454325175,83.01542860399363,0.01661925265883335,1.6492247579241024,1.632605505265269,917349104,920652931.6,84.02645783620089,76.65051922954267,NaN,NaN,34.71915655864807,31.931575769051385
2021-01-27T09:30:00-05:00,116.62,116.62,114.05,114.34,13097040,8202275.55,45.502264836959355,67.54861484952781,NaN,NaN,-35.09959663948006,55.73737152977638,-0.2654848666359224,1.300749421970366,1.5662342886062883,904252064,916206587.4,75.88069724876608,78.25669618794859,NaN,NaN,26.597785868843815,31.169605783307446
2021-01-28T09:30:00-05:00,115.31,117.47,115.09,116.01,12626273,8580921.55,52.58244064479434,66.05470185153254,NaN,NaN,0.21175830525906414,38.47967433684717,-0.336088668408814,1.1461234530952709,1.4822121215040849,916878337,915444744.4,74.54719431969966,79.22407910491049,NaN,NaN,22.510137239866985,29.93253884853024
2021-01-29T09:30:00-05:00,115.84,116.66,114.1,115.03,10462743,8925859.2,48.59281680442735,64.1732205108308,NaN,NaN,-49.18102864934353,13.943481794526758,-0.438777795702624,0.933739876875805,1.372517672578429,906415594,913549646,71.19548696181296,79.49687292823272,NaN,NaN,17.813452352189817,28.201240777624463
2021-02-01T09:30:00-05:00,115.97,116.35,115.29,115.47,10105262,9152059.85,50.4120107123575,62.32461262261733,NaN,NaN,-39.75219470032664,-9.269843428127938,-0.46457310372530025,0.7918012929218037,1.256374396647104,916520856,912283191,68.96397232303998,79.12048827847308,NaN,NaN,14.823472939676105,26.290131086488984
2021-02-02T09:30:00-05:00,116.38,116.95,115.77,115.8,11515727,9082255.65,51.78997662391202,61.2263145394676,NaN,NaN,-29.201654119733945,-30.604543160725076,-0.44678170978147613,0.6978972594202588,1.144678969201735,928036583,914420686.8,70.63679870168326,78.62932006516839,NaN,NaN,12.929826884912629,24.381516200549505
2021-02-03T09:30:00-05:00,115.8,115.86,114.615,114.98,11279192,9092120.75,48.2053662444005,59.79879694768302,NaN,NaN,-109.1828934037161,-45.42120251357228,-0.4749756772282696,0.5509593726663979,1.0259350498946676,916757391,916921752.2,72.50427208571037,78.1386024467333,NaN,NaN,10.200211820631077,22.355615574846873
2021-02-04T09:30:00-05:00,114.98,115.93,114.73,115.46,8451583,8623029.55,50.37080326571595,58.70811373916074,NaN,NaN,-103.11547442834701,-66.08664906029351,-0.44646887533926716,0.4678489557205836,0.9143178310598508,925208974,918587879.6,73.7040681306461,77.70164717463885,NaN,NaN,8.655698387870391,20.398484548135947
2021-02-05T09:30:00-05:00,116.25,116.43,115.39,115.67,5557076,8280517.5,51.32951751697192,57.59336161709774,NaN,NaN,-65.36321201191711,-69.32308573280821,-0.4001306797197941,0.41415448141010813,0.8142851611299022,930766050,923457970.8,76.879822725235,77.45341679454418,NaN,NaN,7.693590681768647,18.583499710083476
2021-02-08T09:30:00-05:00,116.08,116.24,115.465,115.81,6956278,8160792.35,51.99529509627666,56.31289171634562,NaN,NaN,-58.4960938065144,-73.07186555404577,-0.34860049445622965,0.3785345430596152,0.7271350375158449,937722328,927698265.2,79.2316428993007,77.3355895743407,NaN,NaN,7.097003793959374,16.942571722065747
2021-02-09T09:30:00-05:00,115.8,116.085,115.69,115.98,4730313,8075885.3,52.838926552864365,54.948695060948126,NaN,NaN,-47.31110211857363,-76.69375515381371,-0.29380830717437445,0.35987465354787673,0.6536829607222512,942452641,930581476.8,80.67136702058808,77.1993616019205,NaN,NaN,6.832456895884231,15.498269604039816
2021-02-10T09:30:00-05:00,116.82,116.85,115.78,116.19,5405720,7884898.35,53.91631233947025,53.96226102025986,NaN,NaN,-20.122942390934544,-58.8817649512574,-0.2366215021039929,0.35790608309226,0.5945275851962529,947858361,936801670.8,83.35260583437424,77.19608934184156,NaN,NaN,6.897227709585953,14.26954933340355
2021-02-11T09:30:00-05:00,116.6,116.7,115.86,116.41,4683971,7856119.1,55.07421305637685,53.241921638073286,NaN,NaN,-14.86383397540225,-41.23143686066844,-0.17975413890864567,0.3698349115604458,0.5495890504690915,952542332,942268342.4,85.2846171366432,77.26904816493267,NaN,NaN,7.256077366817711,13.26762476674843
2021-02-12T09:30:00-05:00,116.18,117.41,116.03,117.28,6345295,7883776.4,59.416828177999065,52.62667290024435,NaN,NaN,26.737004356554074,-22.81139358697421,-0.08417689931493177,0.44436792632542677,0.5285448256403585,958887627,947892657.8,86.96122519738326,77.41715917293455,NaN,NaN,8.779413537806676,12.626451734042465
2021-02-16T09:30:00-05:00,117.43,117.54,115.74,116.12,9531893,7843608.95,52.175097980700684,51.728704989516245,NaN,NaN,-3.9313102579458765,-11.898436877260497,-0.09870537733211693,0.4051631039752124,0.5038684813073293,949355734,950219339,87.59108748136507,77.67177557616057,NaN,NaN,8.086004736979636,11.977816448747776
2021-02-17T09:30:00-05:00,115.74,116.599,115.605,116.54,5025583,7785235.95,54.34479531212737,52.360314309171095,NaN,NaN,-15.471797652662657,-5.53057598407825,-0.08042750086788752,0.40333410522246993,0.48376160609035745,954381317,952605074.2,88.2194969170581,78.55311840960998,NaN,NaN,8.124574421922935,11.427353302058513
2021-02-18T09:30:00-05:00,115.97,116.279,115.33,115.81,7756644,7829468.2,50.091122485879,52.18236301210572,NaN,NaN,-46.39219678721929,-10.784426863335199,-0.11575239631344203,0.3390711106985549,0.4548235070119969,946624673,952358336.6,87.72469811665458,79.49436868082105,NaN,NaN,6.918891535181169,10.78328733536175
2021-02-19T09:30:00-05:00,115.9,115.99,114.31,114.41,9387849,8009049,43.12038656874457,51.791475138128376,NaN,NaN,-122.01129704566647,-32.21391947738804,-0.2253166929752431,0.17317764079294307,0.39849433376818616,937236824,949297235,81.60922047900337,80.2382067891918,NaN,NaN,3.6217125885848986,9.760205228679343
2021-02-22T09:30:00-05:00,113.86,114.49,113.115,114.14,7213401,8129895.75,41.909100783813486,51.18412442894667,NaN,NaN,-194.51927548796098,-76.46517544629106,-0.30304176415162537,0.019692128578654433,0.3227338927302798,930023423,943524394.2,71.48789217814732,80.41848677884231,NaN,NaN,0.5727252814805287,8.447708093365227
2021-02-23T09:30:00-05:00,114.06,114.76,113.42,113.95,8730474,8218317.2,41.03552913079669,50.41594960800985,NaN,NaN,-168.27650744043544,-109.33421488278896,-0.350940042371425,-0.11594116023400147,0.23499888213742354,921292949,937911837.2,63.27181613622678,79.89241659559544,NaN,NaN,-2.1799581294866397,6.929470061529246
2021-02-24T09:30:00-05:00,114.08,115.36,113.72,114.74,9842009,8435216.3,46.06920435957227,50.263366616236404,NaN,NaN,-101.32581571605962,-126.50501849546836,-0.314291383828872,-0.15786534764866644,0.15642603618020554,931134958,933262565.4,57.38796547578951,78.8126804091725,NaN,NaN,-3.1094875486069378,5.49533326008122
2021-02-25T09:30:00-05:00,114.58,115.04,113.01,113.59,14494847,8505106.65,40.63152780614547,49.567704083409936,NaN,NaN,-154.00391953214145,-148.02736304445278,-0.34966146067777,-0.28065078966700696,0.06901067101076303,916640111,927265653,50.8229110612001,77.17831204706923,NaN,NaN,-5.626948251521976,3.906435901280764
2021-02-26T09:30:00-05:00,113.99,113.99,112.32,112.61,14687164,8608151.2,36.660408970717626,48.51991061582034,NaN,NaN,-193.08897835066293,-162.2428993054521,-0.41667137571344387,-0.4518285486310418,-0.03515717291759794,901952947,920208877.6,44.387950774045414,74.85746405055568,NaN,NaN,-9.071384475034414,2.052461561807167
2021-03-01T09:30:00-05:00,113.53,114.61,113.5,114.08,7361242,8453076.15,45.29690489834224,48.04145417311075,NaN,NaN,-92.846692676015,-141.90838274306287,-0.3426968031817711,-0.46352817689481185,-0.12083137371304073,909314189,916067030.8,41.098771159578924,72.13368749771841,NaN,NaN,-9.235070368632506,0.43995700031578533
2021-03-02T09:30:00-05:00,114.32,114.59,113.64,113.75,8456128,8370619.45,43.85137582795132,47.39948626418839,NaN,NaN,-86.36891122838307,-125.52686350065241,-0.29832447403249857,-0.4937369662536639,-0.19541249222116536,900858061,911980053.2,38.09873839001841,69.09278545267773,NaN,NaN,-9.825320501164047,-1.0265112141813335
2021-03-03T09:30:00-05:00,113.33,113.45,112.045,112.31,14946770,8542171.6,38.132773103010564,46.27209060444126,NaN,NaN,-155.4892407375799,-136.35954850495648,-0.3449899933768172,-0.6266499839421869,-0.28165999056536967,885911291,902935319.8,32.45289527125563,65.4570918410264,NaN,NaN,-12.25824341513094,-2.6310443857455628
2021-03-04T09:30:00-05:00,112.06,112.8,109.93,110.8,23441139,9150268.95,33.237919834172615,44.712355374283824,NaN,NaN,-196.9154025220983,-144.94184510294787,-0.449950923313591,-0.8440986447073584,-0.3941477213937674,862470152,892101328,27.244796664421926,61.31139037872487,NaN,NaN,-16.07185446758273,-4.551160111722301
2021-03-05T09:30:00-05:00,111.45,113.38,110.55,113.02,15645239,9509951.75,44.51458828578607,43.64790966769717,NaN,NaN,-118.147291329041,-129.95350769862347,-0.3468826466431073,-0.8277510296976516,-0.48086838305454427,878115391,887333816.8,25.319206975078586,56.90838907713169,NaN,NaN,-15.22340745262422,-6.07576687470829
2021-03-08T09:30:00-05:00,113.11,114.525,112.6,112.74,12691821,9866689,43.51621757492663,43.02941821014189,NaN,NaN,-63.55186271851286,-124.09454170712304,-0.2775822466672916,-0.8278461913886588,-0.5502639447213672,865423570,878555693,22.20702347800875,52.23809879117767,NaN,NaN,-14.924637356929068,-7.339891229311258
2021-03-09T09:30:00-05:00,113.57,115.2,113.35,113.4,11022343,10069992.25,46.55875961614422,42.47327280328595,NaN,NaN,-25.511938115542,-111.92314708455481,-0.17245846901353012,-0.7658370309882798,-0.5933785619747497,876445913,873673263.4,20.68412412058568,47.41414359142964,NaN,NaN,-13.65987656496673,-8.24274627726204
2021-03-10T09:30:00-05:00,114.15,114.8,113.62,113.66,11641102,10415531.7,47.75272183111744,42.306244185088694,NaN,NaN,-19.498243296698885,-84.7249475963786,-0.07552605217024044,-0.6877861271875503,-0.6122600750173098,888087015,874108408.2,21.202773988983708,42.662577582310284,NaN,NaN,-12.279788903072788,-8.81946665237786
2021-03-11T09:30:00-05:00,114.05,114.98,113.89,114.35,6549499,10472720.65,50.88858379457031,42.86111541550482,NaN,NaN,6.503815532428731,-44.04110398547319,0.03880455553776807,-0.5637543805950997,-0.6025589361328678,894636514,880541680.6,28.632882088556002,38.87855341156405,NaN,NaN,-10.146799148169634,-9.009085580348113
2021-03-12T09:30:00-05:00,114.11,114.76,113.93,114.6,7452438,10611144,52.01240659362831,43.58278011620588,NaN,NaN,14.973851534453175,-17.416875412774356,0.12987839733119877,-0.44021093946886936,-0.5700893368000681,902088952,885336392.8,33.654148480107835,36.17614314741838,NaN,NaN,-8.08002808115785,-8.87636308046379
2021-03-15T09:30:00-04:00,114.39,115.42,114.26,115.39,7119410,10649849.75,55.47936400159704,44.61448260697734,NaN,NaN,67.60478113532795,8.814453357993802,0.23576662685092198,-0.2753810532364156,-0.5111476800873376,909208362,894093351.2,41.719344997537014,34.63668092322625,NaN,NaN,-5.259851904180007,-8.359718626708963
2021-03-16T09:30:00-04:00,115.51,115.715,114.9,115.32,8618552,10604182.7,55.09950461535175,45.25950405381873,NaN,NaN,100.73655966558538,34.06415291421928,0.2899688409151883,-0.14868662894335216,-0.4386554698585405,900589810,898922130.6,45.64329163977254,33.79777564922503,NaN,NaN,-3.080123782969445,-7.605490791889032
2021-03-17T09:30:00-04:00,114.82,115.47,114.205,114.9,7524923,10729149.7,52.765110529078356,46.12618853402822,NaN,NaN,75.90179855389157,53.14416128433737,0.2859368122110554,-0.08123445459472123,-0.3671712668057766,893064887,899917705,46.443915494872705,33.48499025163022,NaN,NaN,-1.8777164148834888,-6.787237309459669
2021-03-18T09:30:00-04:00,114.37,115.6,114.32,114.66,8553350,10768985,51.4243779525324,47.18075774701499,NaN,NaN,83.73325504277267,68.59004918640616,0.25645152558479944,-0.0466068598247773,-0.30305838540957675,884511537,897892709.6,44.99230978003836,33.52815875205829,NaN,NaN,-1.2298423739148368,-5.993323747238978
2021-03-19T09:30:00-04:00,114.78,115.75,114.2,115.07,12595940,10929389.55,53.59372634670569,47.773387850469526,NaN,NaN,96.04500728521234,84.804280336558,0.2534552740314485,0.013760707129733873,-0.23969456690171462,897107477,896896414.6,44.25936108399194,33.75391517523065,NaN,NaN,-0.0840948368766438,-5.149148188615788
2021-03-22T09:30:00-04:00,114.6,115.75,114.03,115.67,6156842,10876561.6,56.645138122469014,48.68722801436364,NaN,NaN,98.45890410958333,90.97510493140906,0.2787665852285127,0.10876366463392628,-0.17000292059458644,903264319,895707606,43.351850705358494,34.12913748346922,NaN,NaN,1.7625589031660505,-4.161761461218383
2021-03-23T09:30:00-04:00,115.53,115.715,114.21,114.5,9170522,10898564,49.77236937143986,49.51862774782287,NaN,NaN,63.34810610344647,83.49741421898129,0.20690103719732839,0.08862337590207403,-0.11827766129525434,894093797,894408403.4,42.33032869829937,34.83466844254377,NaN,NaN,1.4626098762306432,-3.358279841582808
2021-03-24T09:30:00-04:00,114.56,115.25,114.335,114.37,12647014,11038814.25,49.06010739614567,50.64878400224951,NaN,NaN,50.15009470667724,78.34707344953843,0.1437930282652831,0.06146362403634953,-0.08232940422893356,881446783,892084782.6,40.492570010973644,35.78093796729746,NaN,NaN,1.0158525806949639,-2.733403781257412
2021-03-25T09:30:00-04:00,114.54,115.07,113.35,114.85,11505266,10889335.2,51.80267264721799,51.16936145663751,NaN,NaN,28.96662187291703,67.39374681556731,0.12808334281913078,0.07777477429497992,-0.050308568524150866,892952049,893772885,42.44744794799493,37.00438375107721,NaN,NaN,1.394849919387511,-2.1436532525938516
2021-03-26T09:30:00-04:00,115.14,117.17,114.83,117.02,8283287,10569141.35,61.81244091608823,52.476234552434775,NaN,NaN,166.23212451607554,81.43117026173994,0.25046545995091324,0.2627732564144907,0.012307796463577443,901235336,894598456.8,43.42627058729529,38.52004425888339,NaN,NaN,5.01839355919542,-1.120503708052527
2021-03-29T09:30:00-04:00,116.55,117.97,116.51,117.57,8959005,10649029.5,63.861072955181264,53.71211407665171,NaN,NaN,208.8481372653154,103.50901689288635,0.3490298940170278,0.4485951639848622,0.09956526996783441,910194341,895984461.2,45.113972191377606,40.265033406797095,NaN,NaN,8.65118461035852,0.2754517660061939
2021-03-30T09:30:00-04:00,117.25,117.25,116.24,116.51,6865742,10569510.2,57.4628803242641,54.405696826162185,NaN,NaN,140.03983627727482,118.84736292765201,0.3239570067826595,0.5045115284461588,0.18055452166349928,903328599,897831421.6,47.36724917920141,42.13392449181264,NaN,NaN,9.722369877265125,1.6250114961860411
2021-03-31T09:30:00-04:00,116.76,117.4481,116.56,116.74,8504094,10247376.4,58.43595366570277,54.944794674100216,NaN,NaN,143.7864464474171,137.57463327579998,0.3042914267664597,0.5609188051215739,0.2566273783551142,911832693,903908603.6,54.0515097080801,43.94954075035008,NaN,NaN,10.88002958280124,2.9471569371310697
2021-04-01T09:30:00-04:00,116.93,117.04,116.02,116.39,6676369,9409137.9,56.32441481938645,55.25279526165436,NaN,NaN,107.32323509195363,153.2459559196073,0.2513381576302707,0.5708000753929525,0.31946191776268185,905156324,906349458.6,56.444101969551305,45.57739457102461,NaN,NaN,11.204022238637059,4.126709123060497
2021-04-05T09:30:00-04:00,116.98,117.5627,116.79,117.2,7190918,8986421.85,59.932774852993006,55.57089603675407,NaN,NaN,135.96095653522843,147.1917223234379,0.25375234723938894,0.636652351811918,0.3829000045725291,912347242,908571839.8,58.559924522771915,46.78029310854139,NaN,NaN,12.573352069777116,5.333372401162871
2021-04-06T09:30:00-04:00,117.35,117.69,116.58,116.75,5206716,8612166.6,57.10988089564084,55.71449434248901,NaN,NaN,105.88582938657751,126.5992607476903,0.20975462219712793,0.645093282318939,0.4353386601218111,907140526,907961076.8,57.72993579786516,47.64362483411943,NaN,NaN,12.87986785123394,6.4114431797444515
2021-04-07T09:30:00-04:00,116.68,117.08,116.187,116.49,5753273,8348713.1,55.483800923797865,55.90868651354041,NaN,NaN,67.84168179546774,112.15962985132887,0.15062052456148944,0.6236143158236729,0.47299379126218344,901387253,907572807.6,57.17515181326622,48.41014171400469,NaN,NaN,12.665185317468158,7.304834913704981
2021-04-08T09:30:00-04:00,116.83,117.1819,116.51,116.67,4292455,7981280.75,56.40915882278085,56.26474228998672,NaN,NaN,72.32305268074887,97.86695109799523,0.11283562637398759,0.6140383242296679,0.5012026978556803,905679708,906342210.6,55.35929748450067,49.15064083575199,NaN,NaN,12.741962640982582,8.08156744617321
2021-04-09T09:30:00-04:00,116.74,118.02,116.67,117.95,5919162,7949763.9,62.39540680163715,56.89343375105326,NaN,NaN,109.9249491094724,98.38729390149899,0.1603549945800593,0.7016464410807544,0.541291446500695,911598870,907630719.8,56.90270306571936,50.05373669158967,NaN,NaN,14.602256733649032,9.013094487241185
2021-04-12T09:30:00-04:00,117.78,118.31,117.65,118.07,8279707,7991127.35,62.909659096574096,57.34089953491791,NaN,NaN,126.42894883604156,96.48089236166162,0.18445640904233063,0.7718619578036083,0.5874055487612777,919878577,909136986.8,58.700310888672526,51.1500552761121,NaN,NaN,16.267886335100954,10.049493322649724
2021-04-13T09:30:00-04:00,117.7,118.89,117.59,118.56,6519617,7961137.7,65.0136026554508,58.4295590552044,NaN,NaN,133.492768741225,102.0022802325911,0.21580858995197683,0.8571662862012488,0.641357696249272,926398194,912988520.4,62.95520297379545,52.623260581504674,NaN,NaN,18.299367902972584,11.228046834124418
2021-04-14T09:30:00-04:00,118.42,119.03,118.335,118.55,6226675,7841543.85,64.9326511371817,59.563312179564115,NaN,NaN,137.4377655087965,115.92149697525686,0.21766117433092003,0.913434164162922,0.695772989832002,920171519,916745373.6,66.5727759236025,54.48613243240674,NaN,NaN,19.944352364123148,12.473233338409951
2021-04-15T09:30:00-04:00,119.02,120.9284,119.02,120.58,8438303,7887212.85,72.43584503929733,61.03711020756979,NaN,NaN,204.36370841240114,142.3296281215873,0.3306188079155781,1.1090464997264746,0.7784276918108965,928609822,921331396.4,70.37583338538813,56.48101710650625,NaN,NaN,23.996381313421043,14.119397334840107
2021-04-16T09:30:00-04:00,121.2,121.615,120.78,121.48,7447536,7831922.15,74.99075165068791,61.97841811718404,NaN,NaN,224.56741178365158,165.25812065642316,0.4344260008192299,1.3214601928349339,0.887034192015704,936057358,926223094,73.79990971900229,58.65056275877104,NaN,NaN,28.294893354808835,16.14446819483564
2021-04-19T09:30:00-04:00,121.25,121.54,120.8892,121.51,7094305,7556840.4,75.073689311048,62.77931928546024,NaN,NaN,186.51182332608144,177.27469555443113,0.4705446179396864,1.4752149644403119,1.0046703465006255,943151663,930877711.2,76.57447918961344,60.89774183007359,NaN,NaN,31.71457788944126,18.368769579779297
2021-04-20T09:30:00-04:00,120.95,122.29,120.95,121.98,8063897,7652193.15,76.39445696076004,64.13157475949566,NaN,NaN,169.5843451521545,184.493010836617,0.48935125522631817,1.6163594155335232,1.127008160307205,951215560,935841184.4,79.11443123294544,63.16539769105531,NaN,NaN,34.98607571987441,20.74267045693574
2021-04-21T09:30:00-04:00,122.36,123.4884,122.3,123.42,9635877,7675460.9,79.90728135187112,65.66524102279341,NaN,NaN,182.81202983851406,193.56786370256052,0.5571090073457248,1.823394419489361,1.2662854121436362,960851437,943977168,82.46974774274477,65.1952718363885,NaN,NaN,39.129151105393525,23.369310549572567
2021-04-22T09:30:00-04:00,123.32,123.6,122.4,122.87,10030936,7544657,75.29822454590955,67.02051314611649,NaN,NaN,149.79708181226164,182.65453838253262,0.5237294814546958,1.920947263962006,1.3972177825073102,950820501,948419303.8,83.98275641522909,67.16231858250833,NaN,NaN,41.09461526169624,25.901496937018806
2021-04-23T09:30:00-04:00,122.81,123.96,122.55,123.68,4975346,7218161,77.36857828827273,68.26592767720788,NaN,NaN,138.3701561843996,165.41508726268222,0.5143072163298723,2.0401018029196507,1.5257945865897784,955795847,952367001.6,85.20486276741606,69.06552845712578,NaN,NaN,43.419443743942956,28.4040607665794
2021-04-26T09:30:00-04:00,123.61,123.62,123.03,123.26,6907131,7149353.2,73.90946032826429,69.46589763668099,NaN,NaN,116.10909196854494,151.33454099117492,0.4407268921560248,2.0767032017848095,1.6359763096287847,948888716,953514412.2,85.5499665465652,71.05267351060435,NaN,NaN,44.253547127990615,30.66827310392386
2021-04-27T09:30:00-04:00,122.95,122.965,122.35,122.55,7034730,7053139.45,68.34644297645978,70.38465778329972,NaN,NaN,85.40952888355456,134.49957773745493,0.31127911345309056,2.025075201445148,1.7137960879920573,941853986,951642097.4,82.18137155644979,72.8388320636889,NaN,NaN,43.22695363786328,32.46237032305806
2021-04-28T09:30:00-04:00,122.35,122.49,121.96,122.18,6788235,7049264.1,65.57640302178166,71.03946094037119,NaN,NaN,66.72522593928481,111.28221695760908,0.17458910067885625,1.9320324638406277,1.7574433631617714,935065751,946484960.2,73.58646085288179,74.14077230428755,NaN,NaN,41.53746310552953,33.75881214912541
2021-04-29T09:30:00-04:00,122.31,122.34,121.03,121.69,8148869,7031502.85,61.99303000351752,71.0107197405055,NaN,NaN,47.20462766324081,90.7637261278049,0.0324692686989676,1.798029949035481,1.7655606803365134,926916882,941704236.4,66.62972293058702,74.83555943749239,NaN,NaN,39.03532933551281,34.51260031860932
2021-04-30T09:30:00-04:00,121.21,121.92,121.11,121.33,7153422,7055355.5,59.423839878948264,70.76173265353222,NaN,NaN,35.78762607333263,70.24722010559151,-0.09738142006659145,1.643833905253274,1.7412153253198654,919763460,934497759,57.76462135019662,74.7687244704584,NaN,NaN,36.18448109217524,34.75144042911874
2021-05-03T09:30:00-04:00,121.99,122.8387,121.82,122.71,13179071,7354763.15,65.35168407052281,70.78588132603737,NaN,NaN,60.74827999160159,59.175057710202836,-0.1014703728877362,1.614377359210195,1.7158477320979313,932942531,931308522,54.32013104836795,74.15193361864215,NaN,NaN,35.38773107974215,34.842339093493514
2021-05-04T09:30:00-04:00,122.53,122.93,122,122.84,16186498,7903752.25,65.85770386804879,70.85195652109931,NaN,NaN,60.665473242679376,54.226246582027805,-0.10606076463198266,1.583271776307953,1.6893325409399356,949129029,932763530.6,55.62033215877359,73.36961620686864,NaN,NaN,34.89777539963894,34.850258565800004
2021-05-05T09:30:00-04:00,123.01,123.44,122.41,123.06,16713749,8451776.05,66.74288860087844,70.44531677549796,NaN,NaN,71.12296360827533,55.10579411582595,-0.10473948897817342,1.558408179717219,1.6631476686953923,965842778,938918936,60.71471288968442,72.67953617146125,NaN,NaN,34.746820345369485,34.835481677167074
2021-05-06T09:30:00-04:00,122.36,123.23,121.73,123.22,16114981,9042902.35,67.40476559179828,69.90346062843442,NaN,NaN,59.21207748858753,57.507284080895296,-0.1033724955274391,1.5339320492860935,1.6373045448135326,981957759,949927111.4,67.82744251326571,72.25293137105149,NaN,NaN,34.80438569443961,34.83103939392029
2021-05-07T09:30:00-04:00,123.51,124.72,123.46,124.07,7576917,9125790.1,70.73672232551954,69.59367727232524,NaN,NaN,118.53379233301851,74.05651733283248,-0.057778712241214114,1.565081154512015,1.622859866753229,989534676,963881354.6,74.20338888705308,72.08356777801147,NaN,NaN,35.819647021176635,34.97226905495691
2021-05-10T09:30:00-04:00,124.52,125.19,124.18,124.23,8846741,9154141.8,71.33080445942093,69.23198780794387,NaN,NaN,136.63267505660568,89.2333963458333,-0.030757034022984353,1.5844135742244987,1.615170608247483,998381417,976969131.8,78.50590514453673,72.04010162883942,NaN,NaN,36.82746000959755,35.237296334191285
2021-05-11T09:30:00-04:00,123.58,124.1,122.606,122.89,11357836,9396052.75,60.29134100233185,67.83084921154821,NaN,NaN,58.19590410292067,88.73948251788156,-0.1124489067077672,1.474609474862774,1.5870583815705412,987023581,984548042.2,80.53093116028651,71.9016147300924,NaN,NaN,34.37925666189385,35.114719238148794
2021-05-12T09:30:00-04:00,122.23,122.84,121.61,121.73,10946457,9632041.85,52.68928562637481,66.21592500301001,NaN,NaN,-35.810247853158124,67.35284022559486,-0.2462544307198855,1.2792403431706845,1.52549477389057,976077124,986594911.4,81.05019047583403,71.69214573442132,NaN,NaN,29.713528714204497,34.343120591871035
2021-05-13T09:30:00-04:00,121.95,123.385,121.76,122.83,11228009,9771527.15,58.08627677490178,64.83861775205494,NaN,NaN,4.190090395836199,56.34844280704459,-0.2609202912152444,1.1993444098715145,1.4602647010867589,987305133,987664386.2,81.33037227645927,71.41539641363869,NaN,NaN,27.453037501113435,33.35882300747709
2021-05-14T09:30:00-04:00,123.54,123.855,123.14,123.45,6590493,9728675,60.80056343596095,63.90226797403328,NaN,NaN,77.97704823650716,48.23709398774232,-0.230180698605831,1.1725388278294702,1.4027195264353012,993895626,988536576.2,81.56969983587938,71.1310916485897,NaN,NaN,26.48370054839272,32.37666265617933
2021-05-17T09:30:00-04:00,123.31,123.875,123.14,123.22,5997915,9673855.5,59.267235764827895,63.25375317320243,NaN,NaN,63.518158829540475,33.61419074232928,-0.2263136537516368,1.119827459245755,1.346141112997392,987897711,986439835,78.94955587076782,70.90024767104099,NaN,NaN,25.230155546704086,31.355733069111437
2021-05-18T09:30:00-04:00,123.18,123.9689,122.77,123.26,9201952,9730758.25,59.45872379158324,62.81677608533112,NaN,NaN,49.22924111386129,31.820858144517395,-0.2217459342776733,1.0689586951503003,1.2907046294279736,997099663,988455051.4,79.62690842204063,71.33170821169519,NaN,NaN,24.283718056901044,30.345445210224238
2021-05-19T09:30:00-04:00,122.46,123.13,121.59,123.05,10063161,9752122.45,57.91927639126752,62.52579368445612,NaN,NaN,-33.98476734910344,32.18595424532833,-0.23242750504458276,1.0001702481222452,1.232597753166828,987036502,990646927,80.36689097908783,72.31293450087382,NaN,NaN,23.061119812643106,29.304827296284078
2021-05-20T09:30:00-04:00,123.01,124.87,123.01,124.34,7522727,9626712,64.07284682284407,62.85786560902006,NaN,NaN,118.48717935291212,55.045372036743515,-0.15585084489083512,1.0377841970532842,1.1936350419441193,994559229,992097746.2,80.86238056937731,73.96277444510102,NaN,NaN,23.815805329528548,28.52068130103329
2021-05-21T09:30:00-04:00,124.75,125.66,124.26,124.36,8423300,9799109.7,64.16035178542657,62.772770445798905,NaN,NaN,164.59737161904607,72.3694367132513,-0.10928990857859122,1.0570226562208802,1.1663125647994714,1002982529,993915126.8,81.49248262890151,75.9036567008534,NaN,NaN,24.44602280397935,27.938587230025583
2021-05-24T09:30:00-04:00,125,125.2499,124.43,124.48,4958873,9701696.8,64.71565208439517,62.69119531839507,NaN,NaN,138.90039394975213,87.44588373729363,-0.07735218749831096,1.0696223304265828,1.1469745179248938,1007941402,997923865,82.83498098958144,77.84756018876826,NaN,NaN,25.121800677117058,27.536189151038652
2021-05-25T09:30:00-04:00,124.66,124.67,123.97,124.11,6798493,9689884.95,61.5490694774563,62.320208238150634,NaN,NaN,88.19520883715003,95.23907728195138,-0.08734859652887894,1.037788772263795,1.125137368792674,1001142909,998732514.2,83.10127215605057,79.44660013636584,NaN,NaN,24.828010747463026,27.14930652195642
2021-05-26T09:30:00-04:00,124.08,124.12,122.86,123.39,6848847,9692915.55,55.82475156552245,61.49306437913093,NaN,NaN,19.688538813843053,105.97373851454067,-0.1452415748500433,0.9435854002301198,1.0888269750801631,994294062,1000184026.2,83.59328809955207,80.57273196395772,NaN,NaN,22.921296384741407,26.545305073782846
2021-05-27T09:30:00-04:00,123.65,123.75,123.05,123.12,8103209,9690632.55,53.80391100312981,60.283577856103086,NaN,NaN,0.0969605240529455,82.29569474876884,-0.20107136565822814,0.837487768007378,1.0385591336656061,986190853,998510351,80.67648335714765,81.03509585467876,NaN,NaN,20.74326696107346,25.716442486252934
2021-05-28T09:30:00-04:00,123.59,124.615,123.52,123.6,10059940,9835958.45,56.79804226477622,59.24552341362847,NaN,NaN,50.222228575106904,59.420666139981016,-0.2043597704371949,0.7831094206191125,0.9874691910563074,996250793,997164003.8,78.3093636670724,81.02105717771701,NaN,NaN,19.693544370118673,24.856028469662323
2021-06-01T09:30:00-04:00,123.75,123.79,121.465,121.57,13368331,9845421.45,43.85297821641981,58.07135464320618,NaN,NaN,-117.48374307341504,8.143838735347583,-0.33426042766428865,0.5696436564759466,0.9039040841402353,982882462,992152215.8,70.06775880359172,80.2736877236674,NaN,NaN,14.288352482374206,23.346360471478306
2021-06-02T09:30:00-04:00,121.68,121.99,121.04,121.33,13245071,9698350.1,42.61632835228245,57.35185769505672,NaN,NaN,-180.4233404205128,-45.57987111618498,-0.42171411937422243,0.3767614349224573,0.7984755542966797,969637391,985851112.2,61.32859779755169,78.8650025323615,NaN,NaN,9.590477926976988,21.381234393692402
2021-06-03T09:30:00-04:00,120.88,122.02,120.61,121.7,13244609,9524893.1,45.182818088592185,56.43018207460604,NaN,NaN,-155.81695124660573,-80.68096912827473,-0.4380884616917401,0.2508649771820046,0.6889534388737447,982882000,983568699.8,58.48318855181495,77.23306083774405,NaN,NaN,6.523643874292352,19.258721462349538
2021-06-04T09:30:00-04:00,122.34,122.6999,121.95,122.09,11229016,9280594.85,47.83136830372507,55.503810993732046,NaN,NaN,-82.84631553533613,-97.26962434015255,-0.4067784292675858,0.18048040228926254,0.5872588315568483,994111016,985152732.4,59.8746005766064,75.68341089065314,NaN,NaN,4.77506561443255,17.18962776978997
2021-06-07T09:30:00-04:00,122.39,123.61,122.18,122.53,13978496,9600673.8,50.72404130099481,54.89358281774397,NaN,NaN,-34.964939700251726,-114.30705799522427,-0.34310406467825183,0.1583787507090335,0.5014828153872853,1008089512,987520476.2,61.92853523348723,74.46762370227596,NaN,NaN,4.170276560276454,15.32972045414518
2021-06-08T09:30:00-04:00,122.83,122.9,121.21,122.15,10799556,9698314.55,48.23644015365929,54.09199112932083,NaN,NaN,-81.4654564854881,-107.10340067763889,-0.31403075986203915,0.10894436555973641,0.42297512542177557,997289956,990401975,64.32204718084404,73.37441932790477,NaN,NaN,2.9324939932296883,13.558688102585824
2021-06-09T09:30:00-04:00,122.46,123.535,122.46,123.33,7965618,9528703.65,55.52967644398467,53.92130541880063,NaN,NaN,3.1790941508708306,-70.38291376336215,-0.20789750447833366,0.16310324482385852,0.3710007493021922,1005255574,997525611.6,69.43758882558082,72.59375488836857,NaN,NaN,4.117638439885789,12.209966722200106
2021-06-10T09:30:00-04:00,123.63,125.58,123.58,125.44,9350874,9448924.5,65.02034491457741,53.98898385392444,NaN,NaN,133.7198213495288,-12.475559244135251,0.0007960222141193962,0.37199577706984144,0.37119975485572204,1014606448,1003870501.2,73.13266416906718,72.0416322883464,NaN,NaN,8.727159741798104,11.712422867856963
2021-06-11T09:30:00-04:00,125.25,125.31,123.92,124.55,6958093,9235428.7,59.27410501352568,53.63996622736009,NaN,NaN,101.11894565014693,24.317492992961366,0.0713774747726928,0.460421598321588,0.3890441235488952,1007648355,1006577969,74.54683350512717,71.5455144937911,NaN,NaN,10.433158647121882,11.52967083632338
2021-06-14T09:30:00-04:00,124.48,124.68,123.78,124.66,5155991,9163703.6,59.74759810479407,53.28510522881715,NaN,NaN,76.52938485036663,46.616357903085046,0.11534793868070536,0.5332290468997769,0.41788110821907154,1012804346,1007520935.8,75.03960552743155,70.98870196078039,NaN,NaN,11.897011722327074,11.582148105752479
2021-06-15T09:30:00-04:00,124.79,124.98,124.17,124.7,5409192,9134267.45,59.93003553925117,53.169459947516785,NaN,NaN,84.52150649844918,79.8137504998725,0.1356040083152883,0.5873861186131819,0.4517821102978936,1018213538,1011705652.2,77.1534773231545,70.56385947271637,NaN,NaN,13.099384167660554,11.79889611459649
2021-06-16T09:30:00-04:00,124.83,125.46,123.87,124.22,11653343,9256837,56.614052295909026,53.22583857111584,NaN,NaN,69.90968101406007,93.15986787251035,0.10644024425162507,0.5848324156124249,0.47839217136079987,1006560195,1011966576.4,77.28266396666967,70.11310060608191,NaN,NaN,13.099357125197136,11.98467625896801
2021-06-17T09:30:00-04:00,124,125.5,123.98,125.17,6527291,9080043.5,61.19091841342617,53.75348195756557,NaN,NaN,85.46521035331571,83.50894567326773,0.13884655896219644,0.6519503700635454,0.513103811101349,1013087486,1011662784,76.73858924941379,69.8318224555295,NaN,NaN,14.541257290309062,12.34990212058816
2021-06-18T09:30:00-04:00,124.24,124.41,123.57,123.74,11152652,9261539.75,52.25491402696029,53.42897279772158,NaN,NaN,21.848075188016892,67.65477158084173,0.05594251439209463,0.5830319540914672,0.5270894396993726,1001934834,1010520079.8,74.61084215941369,69.5676423478396,NaN,NaN,12.845823059724982,12.420747969036277
2021-06-21T09:30:00-04:00,123.65,124.965,123.2,124.74,6655407,9173145.1,56.985548939018216,54.36701356362146,NaN,NaN,50.61868447785311,62.47263150633903,0.060059556337177966,0.6021638851208451,0.5421043287836671,1008590241,1009677258.8,73.00303731968981,69.77730509898946,NaN,NaN,13.020119976112662,12.506372541475761
2021-06-22T09:30:00-04:00,124.82,125.18,124.4,125.01,7194053,9284904.1,58.19008143801692,55.47942449831678,NaN,NaN,87.6100234936947,63.090334905388126,0.07178012482495288,0.6318294848148582,0.5600493599899053,1015784294,1009191410,72.03931605868644,70.54235640335622,NaN,NaN,13.546172379290509,12.654915375449296
2021-06-23T09:30:00-04:00,124.84,125.13,124.44,124.49,6506579,9270308.4,54.99590603386082,56.180359351550244,NaN,NaN,72.80544679393589,63.66948806136329,0.03707246903737649,0.606389946286626,0.5693174772492495,1009277715,1009734914,72.47703170829875,71.54191662881935,NaN,NaN,12.97586650253859,12.700765536462052
2021-06-24T09:30:00-04:00,125.22,126.005,124.99,125.13,7029228,9279327.45,58.04816954441211,56.91013086874218,NaN,NaN,105.23067356045992,67.62258070279213,0.04902792877882711,0.6306023882227834,0.5815744594439562,1016306943,1010378805.4,73.01597805018574,72.48058644836074,NaN,NaN,13.450520024321156,12.807873320441924
2021-06-25T09:30:00-04:00,125.08,126.08,125.01,125.7,8344223,9291378.15,60.61047172846988,57.616304470704684,NaN,NaN,107.58741475583504,84.77044861635576,0.08502521932973672,0.6878559836061271,0.6028307642763904,1024651166,1014922071.8,76.51103601238408,73.52219364685337,NaN,NaN,14.640628580390185,13.069695500434532
2021-06-28T09:30:00-04:00,125.83,126.05,125.41,125.89,4631451,9019953.7,61.45556481074305,58.56052766049638,NaN,NaN,106.87514771658644,96.02174126410242,0.10975992428656145,0.7400306696345922,0.6302707453480307,1029282617,1019060547,79.15905960422796,74.58198024852365,NaN,NaN,15.858171445823361,13.46804920691865
2021-06-29T09:30:00-04:00,125.9,126.42,125.74,126.03,6165555,8659814.9,62.10079252527396,59.02989309487418,NaN,NaN,114.95371690525668,101.49047994641482,0.12269777641908841,0.7836429658718913,0.6609451894528029,1035448172,1022993322.6,81.31481233584714,75.4303533563998,NaN,NaN,17.04147273750097,13.978538282716125
2021-06-30T09:30:00-04:00,125.9,126.21,125.47,125.95,8542687,8424695.7,61.467587821495215,58.7761247310826,NaN,NaN,102.93809342310416,107.51700927224847,0.11324382706523062,0.8024999732843412,0.6892561462191106,1026905485,1026518876.6,83.01131407328906,76.13597120670137,NaN,NaN,17.850047131914692,14.531610975458777
2021-07-01T09:30:00-04:00,126.04,127.16,125.99,127.07,12020983,8363514.4,66.6018917842945,59.29953807185179,NaN,NaN,157.93110352316245,118.05709526478896,0.16657381298046903,0.8974734124446968,0.7308995994642278,1038926468,1031042781.6,84.90520457108028,76.87585485426946,NaN,NaN,20.11187541025663,15.328791609001328
2021-07-02T09:30:00-04:00,127.23,128.41,127.005,128.29,12328134,8418470.3,71.11660447692864,60.111609955575695,NaN,NaN,214.60674157302174,139.4609606282263,0.26246201817769665,1.0589771221863487,0.796515104008652,1051254602,1036363468.8,86.77287208889138,77.71394532294515,NaN,NaN,23.603138580624524,16.510841176376072
2021-07-06T09:30:00-04:00,127.91,128.18,127.2601,128.17,11413300,8290210.5,70.11265749690672,60.83894009540823,NaN,NaN,177.48823007046354,153.58357709900173,0.2938843990212687,1.163870602785238,0.8699862037639692,1039841302,1038475205.8,87.43724804065529,78.4485003741952,NaN,NaN,26.114607476672013,17.882807790704064
2021-07-07T09:30:00-04:00,128.18,128.98,127.71,128.98,18435650,8672015.2,72.89422759247327,62.00180975944854,NaN,NaN,189.9214466856417,168.57712305507872,0.34193424230203606,1.2974040066415142,0.9554697643394782,1058276952,1043040961.8,88.75264356987486,79.26778463156701,NaN,NaN,29.16541814471079,19.49460926984788
2021-07-08T09:30:00-04:00,127.78,128.37,127.11,128.27,8386584,8693063.5,67.0073729437256,62.41727079732708,NaN,NaN,131.79112201055818,174.34772877256952,0.3001048184203381,1.3306007873649008,1.0304959689445627,1049890368,1047637938.4,89.8993806575129,80.20784116071694,NaN,NaN,29.978650921619554,20.992329505815263
2021-07-09T09:30:00-04:00,128.73,129.105,128.4199,128.71,5224302,8486734.9,68.69465497019554,63.59153800755816,NaN,NaN,150.30634383405857,172.82277683474877,0.2768398924558719,1.3765458345144026,1.0997059420585307,1055114670,1050875578.8,90.62440601033259,81.35166715006831,NaN,NaN,31.165268945598502,22.44560656864144
2021-07-12T09:30:00-04:00,128.71,129.6,128.61,128.96,9097975,8593729,69.64455818242058,64.49575295351546,NaN,NaN,139.52034264588144,157.80549704932068,0.25367408975513706,1.416798554252452,1.1631244644973149,1064212645,1053467187.4,91.17073616103123,82.64935992444983,NaN,NaN,32.42102390083939,23.87066618752686
2021-07-13T09:30:00-04:00,128.8,129.2552,128.525,128.84,9698814,8820870.15,68.56904708382146,65.23710764250151,NaN,NaN,112.52366803640096,144.81258464250817,0.20759409507693372,1.4226170833434821,1.2150229882665484,1054513831,1056401693.2,91.75649459081167,84.05772981960162,NaN,NaN,33.15408959257036,25.196869531104504
2021-07-14T09:30:00-04:00,129.13,129.24,128.49,128.72,7487030,8924762.05,67.44734570060352,66.12649619012599,NaN,NaN,96.88037169656272,126.20436964469238,0.1490943693188842,1.4013909499151538,1.2522965805962696,1047026801,1054151663,86.99101608970108,85.09444298970178,NaN,NaN,33.4625381695894,26.377679336602345
2021-07-15T09:30:00-04:00,128.03,128.59,127.48,128.27,8750949,8779642.35,63.26763075800906,66.49931484824005,NaN,NaN,60.451947272574834,111.93653469709571,0.06447720373442634,1.3328930852643026,1.2684158815298763,1038275852,1051828759.8,82.24213262016127,85.75345403041433,NaN,NaN,32.587967734864094,27.26486339349688
2021-07-16T09:30:00-04:00,128.6,129.085,128.18,128.62,6511034,8778829.5,65.08019665169078,66.81858091418441,NaN,NaN,74.35908363805143,96.74708265789427,0.018833078953263804,1.2919572302214561,1.2731241512681923,1044786886,1049763203,78.15637829983936,85.87097847951827,NaN,NaN,32.3196289034989,27.9869727520686
2021-07-19T09:30:00-04:00,127.78,128.39,126.23,127.27,19460594,9194226.6,54.00970147921011,66.28673353336062,NaN,NaN,11.442841928767645,71.13158251447152,-0.10852371132780303,1.1374695121084386,1.2459932234362416,1025326292,1041985932.4,65.05207866240917,84.86333698367409,NaN,NaN,28.665260509616186,28.083871003146825
2021-07-20T09:30:00-04:00,127.68,129.55,127.68,128.82,15053906,9614151.55,62.00184559442135,66.27966589544258,NaN,NaN,71.31215002891672,62.88927891297469,-0.09510159135173613,1.1271162342465715,1.2222178255983076,1040380198,1039159205.8,61.04575409110425,83.41554710904958,NaN,NaN,27.908850602609387,28.058868088784333
2021-07-21T09:30:00-04:00,129.34,129.38,127.64,129.03,8295729,9669235.35,62.94147687369007,66.38494368488506,NaN,NaN,66.2033414828425,56.753872870230644,-0.07944450122724978,1.1229121990642454,1.2023567002914952,1048675927,1039489031,61.34489548713518,81.86794578146717,NaN,NaN,27.608823973902325,27.994576072372617
2021-07-22T09:30:00-04:00,129.14,129.98,128.79,129.98,9261132,9806963,66.9259535443478,66.4080909534603,NaN,NaN,111.38455745198945,66.94039490611358,-0.015801204335417207,1.1826051948722238,1.198406399207641,1057937059,1043421272.4,64.81411087896764,80.43286766060199,NaN,NaN,28.652945461921377,28.088628842308154
2021-07-23T09:30:00-04:00,130.53,131.61,130.37,131.48,8303834,9870693.3,72.03808914108603,66.4739112866144,NaN,NaN,192.57143356839688,90.58286489218267,0.10971835976289457,1.3355543489112591,1.2258359891483646,1066240893,1047712073.8,68.17095340547635,79.10415918321519,NaN,NaN,31.38531837262332,28.559584489496036
2021-07-26T09:30:00-04:00,131.11,131.49,130.1999,130.63,6626516,9784807.95,65.82878121981564,66.16792012396503,NaN,NaN,156.2714523194659,119.54858697032232,0.11721924613532364,1.3723600468175192,1.2551408006821956,1059614377,1054569690.8,72.66023379075207,78.04865816536496,NaN,NaN,31.468855718710948,28.975194665098165
2021-07-27T09:30:00-04:00,130.45,131.24,130.105,131.24,9551785,10030824.65,67.96295166781468,65.81568612934657,NaN,NaN,152.24797881817685,135.73575272817433,0.14326172565343098,1.4342179577489844,1.2909562320955534,1069166162,1060326883.6,75.75228167058712,77.12006088684441,NaN,NaN,32.256969542366264,29.444019647565035
2021-07-28T09:30:00-04:00,131.05,132.09,130.715,131.71,7432563,10094175.05,69.54140313121474,65.9966882855958,NaN,NaN,175.08313493885967,157.5117114193778,0.17029953134932585,1.5038306462822106,1.3335311149328848,1076598725,1065911443.2,78.31432884253532,76.29255718577458,NaN,NaN,33.40755874368621,30.010239518439487
2021-07-29T09:30:00-04:00,132.14,132.23,131.64,132.03,5662818,9950181.6,70.60337499795581,66.13302543043581,NaN,NaN,169.54902630778395,169.14460519053668,0.18658302510567393,1.5667598963149771,1.3801768712093032,1082261543,1070776340,80.27006916967737,75.55296169715635,NaN,NaN,34.66789522637175,30.675618905286953
2021-07-30T09:30:00-04:00,131.81,132.635,131.63,132.15,6634362,9680850.55,71.01154783203833,66.23066754826566,NaN,NaN,148.5193057641218,160.33417962968167,0.18208352361445845,1.6077812757273762,1.4256977521129177,1088895905,1075307342.4,81.90673705757621,74.891247475481,NaN,NaN,35.80214375335566,31.407979597868195
2021-08-02T09:30:00-04:00,132.67,132.85,131.94,132.33,8366436,9482765.65,71.64748492462951,66.45055596546624,NaN,NaN,135.77269912057497,156.2344289899035,0.16820756928588554,1.6359572137202747,1.4677496444343892,1097262341,1082836935.2,84.24557174805894,74.35475298671295,NaN,NaN,36.91770183919257,32.19508277520025
2021-08-03T09:30:00-04:00,132.39,134.21,132.3,134.17,7701800,9297190.65,77.16271468063184,67.14451089261111,NaN,NaN,159.80619593581275,157.74607241343068,0.2547359792877748,1.7861696185441076,1.5314336392563328,1104964141,1089996531,86.08718840336856,74.29019386626064,NaN,NaN,39.79996140588527,33.28149400815525
2021-08-04T09:30:00-04:00,133.65,134.47,133.43,133.6,8322214,8791518.85,72.46037180086682,67.80113525281524,NaN,NaN,145.1995771665987,151.76936085897847,0.24527877283735666,1.8380321053030286,1.592753332465672,1096641927,1094005171.4,87.00324990806119,74.63027367253919,NaN,NaN,40.67798180098771,34.33813512141703
2021-08-05T09:30:00-04:00,133.5,133.52,132.045,133.05,8240873,8784233.3,68.14504589372996,68.02005305581804,NaN,NaN,96.29934014855637,137.11942362713296,0.17687271727271892,1.8138442290565706,1.6369715117838517,1088401054,1095233073.6,87.27953912625567,75.28192801728324,NaN,NaN,40.0481540856121,35.15385211630204
2021-08-06T09:30:00-04:00,132.99,133.11,132.09,132.94,6923733,8869204.85,67.28201427667612,68.9680753984942,NaN,NaN,81.80107959407813,123.77577839312423,0.10278126696003076,1.7654480954838903,1.6626668285238595,1081477321,1093749356.8,84.93010774951269,76.70178723779063,NaN,NaN,39.285278553509876,35.74405589304602
2021-08-09T09:30:00-04:00,133.13,133.7,133.03,133.45,9852525,8906932.35,69.2278763829272,69.48422045481604,NaN,NaN,98.19027846128857,116.25929426126694,0.06834300988842412,1.7480955908843896,1.6797525809959655,1091329846,1092562857.8,83.00586375842329,78.27036649974198,NaN,NaN,39.20761220087781,36.2388496513077
2021-08-10T09:30:00-04:00,133.52,133.79,132.625,133.14,5832607,8713622,66.63372224351102,69.7479522669461,NaN,NaN,82.41894564808362,100.7818442037211,0.008077664598136858,1.6898496617436365,1.6817719971454996,1085497239,1088669477.4,76.85265716424082,79.37806376239239,NaN,NaN,38.392836925248815,36.54656211901358
2021-08-11T09:30:00-04:00,133.35,133.56,131.71,131.82,14512544,9064897.7,56.862716049432514,69.02914958873787,NaN,NaN,46.57900071398283,81.05772891319795,-0.1296906413372736,1.5196586954739075,1.6493493368111811,1070984695,1083538031,69.53619260547228,79.71535531428559,NaN,NaN,34.56857584790621,36.26399265171253
2021-08-12T09:30:00-04:00,131.95,132.97,131.86,132.86,8220335,9038367,61.63596009960355,68.28614037148911,NaN,NaN,49.47327185569661,71.69251525462599,-0.15790898145973853,1.451963109986508,1.6098720914462465,1079205030,1081698826.2,67.07154039449853,79.63682581350146,NaN,NaN,32.75188155501936,35.76226249504207
2021-08-13T09:30:00-04:00,133.19,133.72,133.03,133.69,7923108,9108970.7,64.9676148194792,68.2246284857508,NaN,NaN,83.30296347624184,71.99289203105874,-0.1290260762195865,1.4485894961717634,1.5776155723913499,1087128138,1082828989.6,67.82618611290869,79.2915366936555,NaN,NaN,32.29373231943649,35.266758184241276
2021-08-16T09:30:00-04:00,133.69,135.23,133.23,135.21,8404315,8556156.75,70.09030223204093,68.37658209748125,NaN,NaN,131.63895762189202,78.68262786317942,-0.021539041679350834,1.5506917702921612,1.572230811971512,1095532453,1083669511,68.40610478305092,78.7668097731172,NaN,NaN,33.65589758535362,35.03663524154304
2021-08-17T09:30:00-04:00,134.85,136.81,134.775,136.81,13874827,8497202.8,74.34325688975315,68.71957165166256,NaN,NaN,200.75881673521337,102.35060208060538,0.13473539526491685,1.740650056052658,1.6059146607877413,1109407280,1088451519.2,71.54820766075206,78.2835154029898,NaN,NaN,36.38374792607542,35.22907991076195
2021-08-18T09:30:00-04:00,136.63,136.78,134.65,134.73,12427698,8703801.25,62.00074221721965,68.10509788160998,NaN,NaN,149.1442965507099,122.86366124795079,0.07824057458214351,1.7037153790154207,1.6254748044332772,1096979582,1093650496.6,74.51565486912669,77.87248581009335,NaN,NaN,34.01885771662834,35.056191025885724
2021-08-19T09:30:00-04:00,133.84,136.04,133.8,135.34,11669503,8824219.8,63.89392908500228,67.59669654253597,NaN,NaN,118.30367419008438,136.62974171482833,0.06283884667130102,1.7040233627724035,1.6411845161011025,1108649085,1099539307.6,77.3919347234785,77.54999992908635,NaN,NaN,32.89128384306891,34.74691857119761
2021-08-20T09:30:00-04:00,135.47,136.52,135,136.11,7252909,8771673.55,66.18418395476724,67.20646075897439,NaN,NaN,144.51047743520968,148.8712445066219,0.08406846099990428,1.7462700923509828,1.6622016313510786,1115901994,1105294078.8,79.7922127592793,77.23190285845924,NaN,NaN,32.79856894151956,34.468582909815034
2021-08-23T09:30:00-04:00,136.88,136.98,136.12,136.16,8471263,8863910.9,66.33352020953294,66.43294686818162,NaN,NaN,152.3031398119664,153.00408094463677,0.08100467253714427,1.763457472022509,1.6824527994853646,1124373257,1111062239.6,81.8699521936524,76.93067170062237,NaN,NaN,32.775938412584274,34.22677655306778
2021-08-24T09:30:00-04:00,136.16,136.18,135.29,135.68,6548195,8713731.4,63.43720809587469,65.78843517496789,NaN,NaN,101.048990068063,133.0621156112067,0.028866870842441106,1.718536388038416,1.6896695171959748,1117825062,1112745796,82.4375395034001,76.60454952886086,NaN,NaN,31.85073928556994,33.887342657710946
2021-08-25T09:30:00-04:00,135.55,135.6217,134.75,135.31,6918537,8688030.1,61.21830278020256,65.29366780971593,NaN,NaN,66.74472055306838,116.58220041167843,-0.044342272323849574,1.634241676791163,1.6785839491150125,1110906525,1115531184.6,83.3654125700723,76.32496906056204,NaN,NaN,30.423552445963402,33.392515484604154
2021-08-26T09:30:00-04:00,135.39,135.69,134.52,134.78,5972119,8703495.15,58.08421153226551,64.63668189940088,NaN,NaN,48.07200714138005,102.53586700193755,-0.13703054105032253,1.5072957728021095,1.644326313852432,1104934406,1114788248.8,82.11918313491017,76.12418873094758,NaN,NaN,28.293403596916622,32.66407092922022
2021-08-27T09:30:00-04:00,135.08,135.45,134.41,134.63,8679232,8805738.65,57.19180199106522,63.77696229998218,NaN,NaN,33.69177629694488,80.37212677428458,-0.21250604352559366,1.37869375944544,1.5911998029710337,1096255174,1110858884.8,75.67565199941542,75.60060217673274,NaN,NaN,26.296568684115968,31.754427751348185
2021-08-30T09:30:00-04:00,134.51,135.88,134.5,135.39,6417153,8708274.5,60.50294429259438,63.33904958920242,NaN,NaN,51.893033155706284,60.29010544303255,-0.21467794869142875,1.3228523671067478,1.5375303157981766,1102672327,1106518698.8,69.21535445116913,75.05508055437046,NaN,NaN,25.50197582074928,30.8612203326912
2021-08-31T09:30:00-04:00,135.42,136.05,134.73,135.21,9299100,8788139.5,59.3324038081547,63.515455857682575,NaN,NaN,51.47077665695838,50.374462760811646,-0.2302900338513021,1.249667773484049,1.479957807335351,1093373227,1101628331.8,62.71840959493392,74.56809605361774,NaN,NaN,24.5182454621093,29.955081065465215
2021-09-01T09:30:00-04:00,135.32,135.44,133.965,135.25,10571193,8900588.45,59.519827485029396,63.36430352807014,NaN,NaN,22.56272639777077,41.53806392975212,-0.23894298854010976,1.1812790716602137,1.4202220602003235,1103944420,1100235910.8,60.9637526430362,74.13182549994187,NaN,NaN,23.75360529288123,29.069155955096075
2021-09-02T09:30:00-04:00,135.75,136.72,135.6,136.7,6848211,8830955.35,65.69231306112005,63.41606768818734,NaN,NaN,104.59940187695689,52.84354287686749,-0.15225298750034977,1.2299058258248863,1.382158813325236,1110792631,1101407555.8,61.928919823559454,73.71059219355978,NaN,NaN,24.83526034653383,28.46431372530147
2021-09-03T09:30:00-04:00,136.56,137.045,135.91,136.85,5632771,8766407.25,66.26537498865315,63.14285859937393,NaN,NaN,117.25547078703923,69.55628177488636,-0.09296424961968563,1.2659535013006291,1.3589177509203147,1116425402,1105441601.4,65.12608202019987,73.47630485335613,NaN,NaN,25.888020574989458,28.096271846685468
2021-09-07T09:30:00-04:00,136.34,136.56,135.16,136.05,8739238,8710742.9,60.46449404427469,62.15151839612547,NaN,NaN,66.49132527917736,72.47594019958058,-0.11437300254333604,1.2159514977411447,1.3303245002844808,1107686164,1106444368.8,65.89284140052276,73.0723501204826,NaN,NaN,25.147550661036984,27.675025963021398
2021-09-08T09:30:00-04:00,135.78,136.21,135.42,135.99,6986150,8768420.05,60.039978335106,62.011463833117354,NaN,NaN,58.17758692089398,73.81730225236768,-0.13775334669523231,1.1581328169154403,1.2958861636106727,1100700014,1107909726.2,67.03350902942492,72.53791113193246,NaN,NaN,24.423039981483573,27.210456537087424
2021-09-09T09:30:00-04:00,135.8,136.11,134.34,134.42,8905636,8488074.65,50.12330270669283,61.0278476632381,NaN,NaN,-30.359763365118738,63.23280429978979,-0.25719451438121554,0.9743930206341531,1.2315875350153687,1091794378,1105479717.8,63.25551827343818,71.52816709978673,NaN,NaN,20.684088192243504,26.27811820210972
2021-09-10T09:30:00-04:00,134.9,135.02,133.12,133.19,10561623,8605139.05,43.99278464755933,59.44274771272325,NaN,NaN,-164.8101457944759,9.350894765503233,-0.4082992378522736,0.7212134877000267,1.1295127255523003,1081232755,1099567742.6,55.11669502696331,69.76563011890701,NaN,NaN,15.371633779397156,24.720048998865067
2021-09-13T09:30:00-04:00,133.89,133.97,131.7,132.37,11676713,8792819.3,40.44155493140911,57.59332162142869,NaN,NaN,-260.3253803484203,-66.16527546158868,-0.5442330666526212,0.4492213922365238,0.993454458889145,1069556042,1090193870.6,45.18865138475323,67.14553720398565,NaN,NaN,9.737704812840255,22.579714115147237
2021-09-14T09:30:00-04:00,132.99,133.3,132.12,132.35,10436274,8894417.25,40.355987967240665,55.94466304081198,NaN,NaN,-223.37430188693932,-124.13840089481201,-0.6112376483566534,0.22940739844332825,0.8406450467999816,1059119768,1080480591.4,37.62562277282503,63.94468600894457,NaN,NaN,5.266836878765488,20.106445938521272
2021-09-15T09:30:00-04:00,132.18,133.83,131.98,133.21,10299867,8715669.25,45.67834953255166,54.83466638026549,NaN,NaN,-157.8825318508797,-167.35042464916674,-0.5739735440685796,0.12317811671425716,0.6971516607828367,1069419635,1074224515.6,33.712058682972895,60.39801787415176,NaN,NaN,3.0135093815761227,17.66459785895768
2021-09-16T09:30:00-04:00,133.38,133.63,131.96,132.87,10525706,8620569.65,44.006417238636544,53.82910964500628,NaN,NaN,-142.49875628023554,-189.7782232321901,-0.548582288114915,0.011423800639192905,0.560006088754108,1058893929,1067644425.8,30.15886963226258,56.68656690967693,NaN,NaN,0.6580735167469903,15.23509438149901
2021-09-17T09:30:00-04:00,132.76,133.11,132.13,133,13541430,8714166,44.83779616207645,52.94668065722136,NaN,NaN,-122.48545854535512,-181.31328578236594,-0.5007191230804213,-0.06589281509641864,0.4348263079840026,1072435359,1065884946.6,29.270487139990507,53.371912276860876,NaN,NaN,-1.032275817422522,12.911184353081648
2021-09-20T09:30:00-04:00,131.03,132.32,130.01,131.15,17245017,9213771.4,36.52629553932734,51.23406288913085,NaN,NaN,-172.63065846981928,-163.77434140664576,-0.5664978011809401,-0.27329594349217246,0.2932018576887676,1055190342,1063011806.6,27.82890818425558,50.4157375435099,NaN,NaN,-5.328680934623064,10.305489311980976
2021-09-21T09:30:00-04:00,131.75,132.7,131.33,131.35,11741913,9377303.9,37.8672036993893,49.70083430993332,NaN,NaN,-120.31521870311829,-143.16252476988157,-0.5679393840441518,-0.4167223723664222,0.15121701167772963,1066932255,1064574304,29.852250770924186,48.06815477036634,NaN,NaN,-8.364660712954176,7.638325022704525
2021-09-22T09:30:00-04:00,131.74,132.2321,130.94,131.57,11964144,9648101.35,39.38414505607658,48.26257127929383,NaN,NaN,-113.44770795204742,-134.2755599901151,-0.5264093498585792,-0.5067946756454944,0.019614674213084826,1078896399,1066469656.8,32.330552714858285,46.02292620406792,NaN,NaN,-10.402326877136229,5.061089037012989
2021-09-23T09:30:00-04:00,131.87,133.29,131.77,132.52,10366547,9820501.85,45.56452937577355,46.82487244462623,NaN,NaN,-64.0892301229798,-118.59365475866393,-0.4123359236456371,-0.4958052303439615,-0.08346930669832445,1089262946,1072543460.2,39.68456413389444,44.43404365480614,NaN,NaN,-10.32058818883243,2.8637065761779295
2021-09-24T09:30:00-04:00,132.3,132.79,131.7,131.98,6962579,9870024.85,42.88772232621406,45.15504011159487,NaN,NaN,-72.8442416039882,-108.66541137039056,-0.35292214431982105,-0.5246219870981008,-0.17169984277827974,1082300367,1074516461.8,41.89362089147664,42.77458214561161,NaN,NaN,-11.048900324487127,0.8761913046543501
2021-09-27T09:30:00-04:00,131.6,131.76,129.82,130.1,11631377,10017632.1,35.146332102515046,43.34659997289775,NaN,NaN,-125.56956786083788,-99.25319324859427,-0.4155938297783462,-0.6911921300012125,-0.2755983002228663,1070668990,1077612191.4,45.28006742402514,41.30224114729036,NaN,NaN,-14.312882418733896,-1.2936763701153993
2021-09-28T09:30:00-04:00,129.27,129.271,127.43,127.87,17433739,10568461.4,28.560834856192884,41.098089724403955,NaN,NaN,-193.83469976290579,-113.95708946055179,-0.5728899259955607,-0.9917107077173171,-0.4188207817217564,1053235251,1074872790.6,42.89758089583775,39.57824628060556,NaN,NaN,-19.727207234712953,-3.927037922200764
2021-09-29T09:30:00-04:00,128.44,129.48,128.18,128.88,11171392,10662076,34.543094117734285,39.98521768233548,NaN,NaN,-154.07693037367406,-122.0829339448771,-0.5731740856193763,-1.1352883887459768,-0.5621143031266005,1064406643,1071974839.4,40.47156543158164,37.9508210776158,NaN,NaN,-21.903981633856883,-6.495172738151638
2021-09-30T09:30:00-04:00,129.31,130.12,127.19,127.3,21653745,11216203.6,30.272420311774155,39.00519165835083,NaN,NaN,-158.53529815537206,-140.97214755135556,-0.6390126787015376,-1.3608801515035225,-0.7218674728019849,1042752898,1062672829.8,33.85345308160883,36.432018081519054,NaN,NaN,-25.293562840108613,-9.180657038431205
2021-10-01T09:30:00-04:00,127.47,127.93,125.28,127.33,23188944,12033240.25,30.4482499484279,38.291384159566455,NaN,NaN,-176.91064021522104,-161.78542727360212,-0.6382852749323126,-1.5197240664673757,-0.8814387915350631,1065941842,1059401124.8,31.87889707071443,35.481321344802,NaN,NaN,-27.77522618408314,-11.837024059238624
2021-10-04T09:30:00-04:00,126.81,127.46,124.76,125.39,27580669,13130635.15,25.89992795444813,37.258808444366984,NaN,NaN,-177.13795170620693,-172.09910404267595,-0.7201397421092433,-1.7816134691716172,-1.061473727062374,1038361173,1052939561.4,28.360617676580887,34.819535266498846,NaN,NaN,-31.574014208514118,-14.656594080563695
2021-10-05T09:30:00-04:00,125.9,127.42,125.73,126.14,19152027,13651274.6,30.238519560709705,36.15596344637827,NaN,NaN,-136.44237009557594,-160.62063810920998,-0.6761531198799307,-1.9066651269122872,-1.2305120070323565,1057513200,1053795151.2,29.47058448949882,34.51657282410785,NaN,NaN,-33.09469599699407,-17.290608640053748
2021-10-06T09:30:00-04:00,125.44,126.02,124.5,125.91,21322290,14368081.6,29.66489956777106,35.13156932703074,NaN,NaN,-139.91556188761635,-157.78836441199843,-0.6165978129889507,-2.001259273268545,-1.3846614602795941,1036190910,1048152004.6,26.548828512584407,34.25871274413083,NaN,NaN,-34.46390796941486,-19.743937115676765
2021-10-07T09:30:00-04:00,126.78,128.4,126.54,127.58,15806657,14713132.65,38.75024472921764,34.696744224683684,NaN,NaN,-74.22115002840565,-140.92553478660517,-0.42774743137097837,-1.919345749493317,-1.4915983181223387,1051997567,1050000938.4,29.031424186411954,34.24163681887522,NaN,NaN,-32.58038117270754,-21.57771483810973
2021-10-08T09:30:00-04:00,127.76,128,126.68,126.94,9552253,14662664.15,36.78898414069326,34.71550769620982,NaN,NaN,-73.22233537856991,-120.18787381927493,-0.31420113133912375,-1.8843497322962435,-1.5701486009571197,1042445314,1045301632.8,26.573061942052007,34.15193351586068,NaN,NaN,-31.6931120995321,-23.0227715897415
2021-10-11T09:30:00-04:00,126.83,127.5,125.91,125.95,7843732,14471015.1,33.92834284576661,34.434160492379625,NaN,NaN,-84.02311432517182,-101.56490634306792,-0.27542630983853544,-1.914431488255289,-1.6390051784167536,1034601582,1044549714.6,26.190898165722146,33.890408329774814,NaN,NaN,-31.871016120485173,-24.286806522704882
2021-10-12T09:30:00-04:00,126.35,126.48,125.025,125.34,13007521,14599577.45,32.263634266923276,33.925552578868675,NaN,NaN,-96.5323198524435,-93.58289629444144,-0.26067097820863316,-1.9648439011775451,-1.704172922968912,1021594061,1037365886.8,22.814938682801724,33.21072161319935,NaN,NaN,-32.537155629491224,-25.46542782367436
2021-10-13T09:30:00-04:00,125.55,126.105,124.765,125.54,10610423,14615105.25,33.417148099202564,33.057882487685035,NaN,NaN,-93.12885298102388,-84.22555451312294,-0.20945766678096023,-1.9659950064451124,-1.7565373396641522,1032204484,1036568601.6,22.468785048642715,31.981023107109937,NaN,NaN,-32.72535961505652,-26.502560936728955
2021-10-14T09:30:00-04:00,126.84,127.84,126.84,127.34,8857911,14531715.5,42.8500247325448,33.055189802422944,NaN,NaN,-37.17232636214411,-76.81578977987064,-0.035492227835706824,-1.8009026244587858,-1.765410396623079,1041062395,1034381567.2,21.504924707787538,30.524687665417854,NaN,NaN,-29.85420983700297,-26.981367922482384
2021-10-15T09:30:00-04:00,128,128.55,127.73,127.97,8976053,14303446.65,45.74708523468798,33.81238645472101,NaN,NaN,-9.385847805565476,-64.04849226526976,0.13170653805979993,-1.6007772240483291,-1.732483762108129,1050038448,1035900194,23.94466900419242,29.000730635429807,NaN,NaN,-26.581147748972363,-26.924193611980954
2021-10-18T09:30:00-04:00,127.41,127.54,126.55,127.1,11660799,14024235.75,42.540055703168946,34.81090222950501,NaN,NaN,-39.40541225556833,-55.12495185134905,0.18987256722066181,-1.4951430530823018,-1.6850156203029636,1038377649,1036655407.4,25.189943784833687,27.735899413215233,NaN,NaN,-24.810969258925805,-26.62230441868736
2021-10-19T09:30:00-04:00,127.79,129.1,127.79,128.77,9486966,13911488.4,49.81303521027658,35.90161230754374,NaN,NaN,22.116674218552635,-31.39515303714983,0.33831393805683163,-1.262123197731924,-1.6004371357887557,1047864615,1041909518.2,33.36435298784019,27.228241381519414,NaN,NaN,-20.847420756474264,-25.797321038371205
2021-10-20T09:30:00-04:00,129.54,130.8025,129.42,130.61,13665717,13996567.05,56.36626751059225,37.76545853603075,NaN,NaN,97.69315111413671,6.769247781882288,0.5456345191344241,-0.9183939868707256,-1.4640285060051497,1061530332,1047774687.8,41.10127655522111,27.745943058206006,NaN,NaN,-15.115939133013201,-24.271409337605775
2021-10-21T09:30:00-04:00,130.88,131.215,129.93,131.14,8267518,13891615.6,58.06484594084914,39.738072535489415,NaN,NaN,129.40804269655735,40.08532159362258,0.6941466100296112,-0.5963452434681358,-1.290491853497747,1069797850,1053521778.8,47.53000251475095,28.863879161351473,NaN,NaN,-9.997806349191984,-22.232323196403804
2021-10-22T09:30:00-04:00,131.02,131.72,130.82,131.67,8009739,13943973.6,59.75213977519595,42.15608766554283,NaN,NaN,164.08017340010437,74.77852583475655,0.7964313288432596,-0.2949526924436725,-1.0913840212869321,1077807589,1059075607,52.88221058833476,30.615421512191034,NaN,NaN,-5.319987991266731,-19.81627530995565
2021-10-25T09:30:00-04:00,131.73,131.9746,130.71,131.83,10629842,13893896.85,60.27182443164217,44.30132372775228,NaN,NaN,160.8362011471401,114.82684851529822,0.8389519287190789,-0.04269411038808357,-0.8816460391071624,1088437431,1069087563.4,60.67064192020548,32.8439970429558,NaN,NaN,-1.4148005223148958,-17.187493197435543
2021-10-26T09:30:00-04:00,132.13,132.86,131.41,132.48,9271663,13485793.05,62.396086993646854,46.63926568674341,NaN,NaN,160.96957981382414,142.59742963435252,0.8711430506831523,0.207282774246778,-0.6638602764363744,1097709094,1079056459.2,66.59208142952019,35.704229394165495,NaN,NaN,2.511446464792138,-14.373358959974446
2021-10-27T09:30:00-04:00,132.69,132.83,131.39,131.43,11851449,13519795.9,57.086020396998144,47.94896394872774,NaN,NaN,127.78509797796366,148.61581900711792,0.7846968044840711,0.31701072916871453,-0.46768607531535655,1085857645,1083921921.8,69.04196576361255,38.56212522110839,NaN,NaN,4.347647792741265,-11.698929423872203
2021-10-28T09:30:00-04:00,131.67,133.04,131.665,132.53,9282753,12901246.3,60.84537862223714,49.667277840266586,NaN,NaN,122.71806604306707,147.27782367641987,0.7638421038421941,0.4871165544873861,-0.276725549354808,1095140398,1088990431.4,71.39525376097484,41.763710351031456,NaN,NaN,7.086475163394344,-9.015300197119839
2021-10-29T09:30:00-04:00,132.36,133.99,131.855,133.82,15415091,12512553.65,64.74576737222833,51.86852244929957,NaN,NaN,125.55584530267397,139.5729580569338,0.7955765565659251,0.7177451463525983,-0.07783141021332671,1110555489,1095540011.4,74.13170303909146,45.188053556272116,NaN,NaN,10.697781529443523,-6.199145664753644
2021-11-01T09:30:00-04:00,133.94,134.49,133.15,133.66,14356751,11851357.75,63.89558774948193,54.12794769805375,NaN,NaN,122.1942698492664,131.84457179735904,0.764260406910903,0.8774940984253021,0.11323369151439908,1096198738,1097092272.8,74.74826484658894,48.89757685368549,NaN,NaN,13.345343412944386,-3.407075796511068
2021-11-02T09:30:00-04:00,134.18,135.165,133.01,134.5,20851468,11936329.8,66.39076778626483,56.48320624712964,NaN,NaN,118.41159038469446,123.33297391153312,0.7571427652467801,1.0596621480728743,0.30251938282609414,1117050206,1100960495.2,76.26637773756596,52.74026204575143,NaN,NaN,16.355554297094823,-0.5838429259959406
2021-11-03T09:30:00-04:00,134.24,135.34,133.74,135.29,14610094,11600720,68.58938931527624,58.3217322887533,NaN,NaN,120.25939962925217,121.82783424179084,0.7606488334185972,1.2533304245993406,0.49268159118074345,1131660300,1110121026.2,79.421526841592,56.87716219816604,NaN,NaN,19.57784852434297,2.296398709766761
2021-11-04T09:30:00-04:00,134.98,135.19,133.43,134.36,15818549,11601314.6,63.33663138732949,59.57812844251341,NaN,NaN,99.00104805034229,117.08443064324588,0.6591297888918668,1.316593827295577,0.6574640384037103,1115841751,1114261296.8,80.67216542482394,60.929126228211146,NaN,NaN,20.777491342402186,4.93655480014325
2021-11-05T09:30:00-04:00,133.15,133.7,131.895,132.86,14867391,11867071.5,55.90061964946677,60.53245443867754,NaN,NaN,56.53043233224016,103.2793480491591,0.45922647597341726,1.2314971333704818,0.7722706573970646,1100974360,1112345071,78.3003281167698,64.72272510906372,NaN,NaN,19.496149385257336,7.0164968837309765
2021-11-08T09:30:00-05:00,133.1,133.82,132.58,133.65,8948840,11922326.9,58.65383899456521,61.16394042326959,NaN,NaN,65.19630522092604,91.87975512349104,0.3532328517465153,1.2138117220802087,0.8605788703336934,1109923200,1115089963.4,79.24181419274689,67.99968662369993,NaN,NaN,19.270125631755086,8.767015276305848
2021-11-09T09:30:00-05:00,133.69,133.81,132.9,133.16,7287021,11636301.9,56.30574900321785,61.15961767274285,NaN,NaN,59.57188562756158,80.11181417206446,0.22916466317921336,1.14703469930771,0.9178700361284967,1102636179,1112207158,75.53513964105363,70.45924827268796,NaN,NaN,18.370795398169264,10.138983865143478
2021-11-10T09:30:00-05:00,133.12,134.08,133.1,133.54,8445219,11528041.7,57.719366715815156,61.134940585240415,NaN,NaN,64.26314845551627,68.91256393731727,0.15527060220225164,1.1119582888813113,0.9566876866790597,1111081398,1108091377.6,70.46712184528677,72.0976139391548,NaN,NaN,18.036221527095467,11.267160673993763
2021-11-11T09:30:00-05:00,133.52,133.61,132.83,133.15,8597304,11515011.35,55.72669099773879,60.84740852970776,NaN,NaN,46.080727391170775,58.32849980548296,0.06720486689503191,1.0406937702978496,0.9734889034028177,1102484094,1105419846.2,67.31020751862673,73.12818514846137,NaN,NaN,17.18538635219217,12.112621485164963
2021-11-12T09:30:00-05:00,134,134.12,133.07,133.81,8317641,11482090.75,58.347413615769725,60.709950614288296,NaN,NaN,60.66067024139297,59.154547387313514,0.04172852555787432,1.0256495603501605,0.9839210347922862,1110801735,1107385321.2,68.43076027926085,73.68247931696533,NaN,NaN,17.19207691067086,12.838257974522948
2021-11-15T09:30:00-05:00,134.12,134.19,132.85,132.98,6268910,11212496.3,54.01700927161681,60.11144506271472,NaN,NaN,39.41938684966439,53.99916371306119,-0.03836591112522947,0.9359636458857494,0.9743295570109789,1104532825,1106307246.2,67.07266008527023,73.71680636380461,NaN,NaN,15.941250766774381,13.281542659130295
2021-11-16T09:30:00-05:00,132.95,134.265,132.72,133.54,6150892,11045692.6,56.36982756126473,60.060288431590905,NaN,NaN,43.23285096949248,50.73135678144737,-0.05970123274351258,0.8997030160815882,0.9594042488251008,1110683717,1107916753.8,68.09084007313805,73.648868814485,NaN,NaN,15.54347192934586,13.604675412018233
2021-11-17T09:30:00-05:00,133.69,134.25,133.11,133.73,8229054,10773859.45,57.170553491164185,59.797800922228554,NaN,NaN,51.92990223856963,48.26470753805804,-0.06656551100501717,0.8761973600688293,0.9427628710738465,1118912771,1109483028.4,69.09243531648997,73.4843817827361,NaN,NaN,15.432558239768229,13.865801530268232
2021-11-18T09:30:00-05:00,133.87,134.12,133.32,133.78,9029418,10811954.45,57.39216256661877,59.27254343611359,NaN,NaN,52.20853350908007,49.4902687616399,-0.07278253950209468,0.8517846966962281,0.9245672361983228,1127942189,1114574647.4,72.15253279215585,73.34301247938355,NaN,NaN,15.398635478878745,14.084777808641162
2021-11-19T09:30:00-05:00,134.18,134.63,132.855,132.97,10166202,10919777.6,52.640307406226995,58.4685948401668,NaN,NaN,20.857585454964223,41.529651804354145,-0.132985282232444,0.7583356334077678,0.8913209156402118,1117775987,1115969497.8,72.94286326330977,73.21405522343503,NaN,NaN,14.065674710082545,14.08204879456136
2021-11-22T09:30:00-05:00,133.16,133.62,132.2,132.37,11146204,10945595.7,49.37891494864906,57.253462494622816,NaN,NaN,-82.11276733636488,17.223220967148297,-0.21016448775280083,0.6286153059492108,0.8387797937020116,1106629783,1116388889.4,73.18924518940938,72.99426004142384,NaN,NaN,11.993943402522621,13.78374802427011
2021-11-23T09:30:00-05:00,131.75,132.645,131.35,132.51,12075241,11085774.6,50.154926797519785,55.936715171925925,NaN,NaN,-153.16937255532943,-22.057223737816084,-0.24623427117067698,0.5309869547386654,0.7772212259093424,1118705024,1117993150.8,74.15860079171344,72.6183367521468,NaN,NaN,10.460662186956208,13.30902147608241
2021-11-24T09:30:00-05:00,132.26,132.7,131.8,132.46,6760796,10831241.95,49.86094256464402,54.97416597030554,NaN,NaN,-142.47356939083747,-60.93791806369751,-0.26621076600059623,0.4444577684085971,0.7106685344091933,1111944228,1116599442.2,71.73216095711857,71.97976500445357,NaN,NaN,9.095490372852284,12.70708846133525
2021-11-26T09:30:00-05:00,132.94,133.72,131.5099,131.97,11896923,10961950.45,46.95615910854166,54.335275931668036,NaN,NaN,-131.5045317760754,-97.6805311207286,-0.30252612234896703,0.33251088147298447,0.6350370038219515,1100047305,1111020465.4,62.86500739021325,70.87724209541382,NaN,NaN,7.122253618136544,11.909254912306864
2021-11-29T09:30:00-05:00,132.69,133.22,132.19,132.33,17137200,11048055.9,49.293427768101076,53.66667512977774,NaN,NaN,-96.78769720024646,-121.20958765177075,-0.2922441171001212,0.26973185744679995,0.5619759745469212,1117184505,1110902169,62.68805486431307,69.6948307148114,NaN,NaN,6.001498758453768,11.065289747470707
2021-11-30T09:30:00-05:00,131.57,132.17,129.54,129.73,19467132,11303574.95,36.711842095035216,52.26711035062183,NaN,NaN,-265.39148478085605,-157.86533114066896,-0.4415289894908905,0.010064737683308067,0.45159372717419854,1097717373,1109119687,59.9498001564298,68.58159218019541,NaN,NaN,0.737686535438173,9.589917860037488
2021-12-01T09:30:00-05:00,130.35,132.09,129.48,129.5,22241709,11373087,35.84036112449526,50.70432423695613,NaN,NaN,-217.51927947329781,-170.73531252426264,-0.5307473326427153,-0.21184043862919566,0.3189068940135197,1075475664,1100473815,48.81232235640933,67.03482078813275,NaN,NaN,-3.7701989066752937,7.681329750507091
2021-12-02T09:30:00-05:00,129.46,130.66,128.84,130.13,17531246,11519144.6,40.03908559053203,49.58378099358422,NaN,NaN,-211.3147441077733,-184.50354746764984,-0.5215472945618645,-0.33302722418881103,0.18852007037305354,1093006910,1096686351.4,44.878940945606594,65.43258746148845,NaN,NaN,-6.312933954657626,5.682149221197846
2021-12-03T09:30:00-05:00,131.04,131.54,129.29,130.37,22111856,11833809.95,41.60682167636002,48.388024426483526,NaN,NaN,-145.58201488803874,-187.3190440900425,-0.47484298011020903,-0.40503365476470776,0.06980932534550129,1115118766,1099700643.6,48.43993778674494,64.00467156916588,NaN,NaN,-7.938927639709576,3.7362810982110712
2021-12-06T09:30:00-05:00,130.71,131.68,130.505,131.11,15230869,11851983.85,46.271429684160815,47.834768741665236,NaN,NaN,-85.79575952342408,-185.12065655467802,-0.374088934035318,-0.3978018421986462,-0.023712908163328217,1130349635,1102333669.6,51.39386381666477,62.88475754997978,NaN,NaN,-7.957862571433348,2.065689145404726
2021-12-07T09:30:00-05:00,132,133.12,131.82,132.8,11974712,12003277.45,55.09403312584305,47.74364056770655,NaN,NaN,10.080820548422155,-130.02619548882237,-0.18325985190183833,-0.25278772304062613,-0.0695278711387878,1142324347,1111255064.4,59.79804890589378,62.292415323748045,NaN,NaN,-5.064663531995049,1.0470673343476151
2021-12-08T09:30:00-05:00,133.18,133.89,132.51,133.8,15144681,12396160.45,59.34779842162787,47.899158062739666,NaN,NaN,62.55909572868565,-74.0105204484257,0.010406440212124696,-0.05651982087363194,-0.06692626108575664,1157469028,1127653737.2,70.04921629685188,62.360756822345316,NaN,NaN,-1.179684543485319,0.7289599232286246
2021-12-09T09:30:00-05:00,133.67,134.55,133.57,134.11,9095914,12428695.2,60.593971921785396,48.127858730965855,NaN,NaN,102.57212246487501,-11.233147133896034,0.15164082710854426,0.12262477279992368,-0.029016054308620573,1166564942,1142365343.6,75.96930928234917,62.63338371450198,NaN,NaN,2.329486006855331,0.9576065066038684
2021-12-10T09:30:00-05:00,133.76,134.86,133.7,134.58,8554302,12426545.1,62.47228264476044,48.83014267657539,NaN,NaN,112.94380216016516,40.472016275744764,0.2624733777416,0.29907566786837947,0.036602290126779444,1175119244,1154365439.2,79.52450866280805,63.10350124303757,NaN,NaN,5.811717101051515,1.6510508772392465
2021-12-13T09:30:00-05:00,134.58,136.23,134.58,135.85,12201839,12620755,67.04354190101208,50.091901744601316,NaN,NaN,166.02288086979323,90.83574435438821,0.39889652207330095,0.5352229427184056,0.1363264206451047,1187321083,1165759728.8,82.21503879721682,63.748200786452394,NaN,NaN,10.398329942835046,2.9006621723243606
2021-12-14T09:30:00-05:00,135.22,136.01,134.63,135.3,11070804,12860849.7,63.43952139355361,51.04080135860374,NaN,NaN,135.61415079898973,115.94241040450174,0.42715051409825283,0.6702645632679207,0.2431140491696679,1176250279,1172544915.2,83.59726467241414,64.42239106364529,NaN,NaN,13.041455527495232,4.349346937348771
2021-12-15T09:30:00-05:00,135.59,138.14,135.47,138.07,14996251,13303117.65,71.69283640229185,52.600222347007154,NaN,NaN,194.76000911873302,142.38259308251122,0.5970261375419297,0.98939672109708,0.3923705835551503,1191246530,1179300415.6,84.85898073789569,65.36002104798652,NaN,NaN,18.645272335503194,6.3916219942279735
2021-12-16T09:30:00-05:00,138.06,139.59,137.81,138.89,19227482,13853039.05,73.59325873727371,54.50287232048802,NaN,NaN,212.51334099923514,164.37083678938325,0.7209571072270238,1.29356696758893,0.5726098603619063,1210474012,1188082229.6,86.33093880279014,67.03615900602773,NaN,NaN,23.77779342366472,8.875360769861794
2021-12-17T09:30:00-05:00,138.19,139.035,137.38,137.92,21505772,14476856.75,67.79504415045386,55.82441634779893,NaN,NaN,158.02462847371436,173.38700205209307,0.6937173664993578,1.4397565684861036,0.7460392019867458,1188968240,1190852028.8,86.76787561376213,68.75614620241694,NaN,NaN,25.931910617450356,11.312010748088731
2021-12-20T09:30:00-05:00,137.11,137.525,135.38,136.56,16185740,14777833.65,60.58744321069534,57.52981642748894,NaN,NaN,90.9559016830435,158.37360621474312,0.5466846942770199,1.4293950698330207,0.8827103755560007,1172782500,1187944312.2,83.74159195235688,70.45555990212601,NaN,NaN,25.190966518231978,13.294718715252053
2021-12-21T09:30:00-05:00,136.95,137.19,135.68,137.13,10773365,14759191.7,62.39209159274209,59.426368603792284,NaN,NaN,85.00680190690755,148.25213643632668,0.4541979151733593,1.4504577695227,0.9962598543493406,1183555865,1189405429.4,84.04277171556397,72.97202057063707,NaN,NaN,25.20756149157359,14.9965533975837
2021-12-22T09:30:00-05:00,137.06,138.81,136.82,138.73,7245983,14517728.8,66.96471888463805,61.34962812479986,NaN,NaN,111.3745110644024,131.57503682546056,0.46544473974341205,1.5780657790286057,1.1126210392851936,1190801848,1189316493,83.94084212812785,75.76215636938858,NaN,NaN,26.800787974806735,16.682872622901275
2021-12-23T09:30:00-05:00,139.09,139.749,138.68,139.3,7743780,14566878,68.43704441932495,63.26607260644021,NaN,NaN,123.84267075314168,113.84090277624186,0.4743271638699702,1.7055299941226565,1.2312028302526863,1198545628,1186930816.2,81.09942863419414,78.09497714420638,NaN,NaN,28.5548435568051,18.378868470601823
2021-12-27T09:30:00-05:00,139.8,140.77,139.65,140.77,6969387,14320501.2,71.91359928418865,65.09765614929934,NaN,NaN,132.75987856251987,108.78795279400296,0.5376168061372806,1.903223837924287,1.3656070317870064,1205515015,1190240171.2,82.0091915493714,80.28178626797114,NaN,NaN,31.23308510378009,20.215185132484432
2021-12-28T09:30:00-05:00,140.9,141.15,140.03,140.4,6066669,13766974.65,69.82874953818497,66.15013589303804,NaN,NaN,120.5106038163353,114.69889322066133,0.513040252189024,2.0069073470232865,1.4938670948342625,1199448346,1195573340.4,83.39622467480582,81.96737025146487,NaN,NaN,32.67743766294441,21.995506922550145
2021-12-29T09:30:00-05:00,140.26,141.49,140.16,141.2,7103573,13148796.7,71.73666895143852,67.03505521659595,NaN,NaN,118.2593875789071,121.34941035506124,0.5081765564272889,2.1290877903683736,1.6209112339410847,1206551919,1200172551.2,84.5056358794192,82.99997165021968,NaN,NaN,34.477962721364065,23.778714893809276
2021-12-30T09:30:00-05:00,141.46,141.975,141.31,141.49,7931674,12433294.95,72.41758213794077,67.87959880346419,NaN,NaN,121.12706914395558,123.29992197097188,0.4822182155314081,2.223684003355345,1.7414657878239368,1214483593,1204908900.2,85.5745896872246,83.68606310771078,NaN,NaN,36.13544369566545,25.543961865503015
2021-12-31T09:30:00-05:00,141.32,141.86,140.84,140.89,7882794,11950872.35,68.72829945386536,68.32645714697169,NaN,NaN,104.2678234792609,119.38495251619572,0.38650214520688797,2.2245934693325466,1.8380913241256587,1206600799,1206519934.4,85.93015568238138,84.14360932339459,NaN,NaN,36.42415776096392,27.09827556485457
2022-01-03T09:30:00-05:00,140.29,140.55,138.24,139.44,15122472,11601403.15,60.68260453385785,67.87210447788924,NaN,NaN,55.77342329812008,103.98766146331577,0.19695494526272173,2.0842850057040607,1.887330060441339,1191478327,1203712596.8,82.13111177653192,84.13761453620282,NaN,NaN,34.16046788278972,28.10716018170245
2022-01-04T09:30:00-05:00,139.13,139.29,137.01,137.6,13718254,11525772.4,52.31354566178448,67.07739192562002,NaN,NaN,10.826401616618572,82.05082102337244,-0.06680520053205008,1.8038235597762764,1.8706287603083265,1177760073,1199374942.2,76.5031270610568,83.63089042110586,NaN,NaN,29.33559027273036,28.282650194706438
2022-01-05T09:30:00-05:00,137.9,138.73,136.565,136.62,15370687,11695571.15,48.47863108674853,65.41923440308122,NaN,NaN,-17.557112858586006,54.887520935873816,-0.3082183869082584,1.4853557766730034,1.7935741635812619,1162389386,1190542435.6,66.50911111156782,82.32018544779672,NaN,NaN,24.0661922582399,27.680299060925503
2022-01-06T09:30:00-05:00,135.77,136.6,134.8,135.04,15181986,11697436.4,43.00499260699187,63.23435825091822,NaN,NaN,-86.46218660542131,13.36966978599843,-0.560557760147907,1.0928769633963782,1.6534347235442852,1147207400,1177087197,54.77087933474414,80.06589548579345,NaN,NaN,17.66232432935883,26.249159813558837
2022-01-07T09:30:00-05:00,134.72,134.97,134.07,134.35,9619354,11723608.4,40.836533113710104,61.30875031972224,NaN,NaN,-124.29418723598212,-32.34273235705017,-0.7484420633995843,0.7178821442948049,1.4663242076943892,1137588046,1163284646.4,45.83441274209239,77.14207670924559,NaN,NaN,11.77654309980882,24.181643140165978
2022-01-10T09:30:00-05:00,133.76,135.81,133.4427,135.73,15589881,12075387.35,46.6324768724684,60.311967009848885,NaN,NaN,-108.32954190157653,-65.16332539698949,-0.7522695568851796,0.5259872615879146,1.2782568184730942,1153177927,1155624566.4,41.761963561310644,74.14353182417086,NaN,NaN,8.667101599739375,21.96528006296218
2022-01-11T09:30:00-05:00,135.93,136.83,135,136.81,12168273,12073709.05,50.70274169429753,59.477013445674274,NaN,NaN,-66.60858155355591,-80.65032203102439,-0.6579638889058499,0.4558019573407819,1.1137658462466318,1165346200,1153141791.8,40.50573351889954,71.03374338155199,NaN,NaN,7.415767433895989,19.886778258809866
2022-01-12T09:30:00-05:00,136.03,136.63,135.8279,136.42,10831825,12061760.1,49.24221749741289,58.2111204894439,NaN,NaN,-67.31239145361269,-90.60137775002973,-0.5994062484405127,0.3645080356959909,0.9639142841365036,1154514375,1151566789.6,39.690092735313776,67.87297556777955,NaN,NaN,5.958328934784649,17.89699978394912
2022-01-13T09:30:00-05:00,136.18,136.35,134.055,134.3,13804867,12002190.9,42.13672720679692,56.33252640283475,NaN,NaN,-108.34816619980542,-94.97857366890655,-0.6753628576586124,0.11971071206323813,0.7950735697218505,1140709508,1150267211.2,38.992393369544786,64.86533019173316,NaN,NaN,2.276544272677256,15.66550613948171
2022-01-14T09:30:00-05:00,133.94,134.21,132.69,134.07,14341860,11757909.8,41.438119859188745,54.1557064439062,NaN,NaN,-131.28591388192746,-96.37691899809559,-0.7094939484568499,-0.0917938658492119,0.617700082607638,1126367648,1148023131.6,37.75810438248443,61.70453825124124,NaN,NaN,-0.8432008364691627,13.307119428631585
2022-01-18T09:30:00-05:00,132.75,132.955,131.845,132.19,16471761,11506209.25,36.160676384382406,51.75084407577744,NaN,NaN,-149.08784708902525,-104.52858003558534,-0.819302471500564,-0.406428006768067,0.412874464732497,1109895887,1139366723.6,33.369996776665914,58.13123625851697,NaN,NaN,-5.347209062670295,10.642215358445602
2022-01-19T09:30:00-05:00,132.44,133.48,131.52,131.65,14639582,11428901.35,34.79011040011399,49.11180417925426,NaN,NaN,-134.14955136744965,-118.03677399836411,-0.8834047731562695,-0.69138150171284,0.19202327144342962,1095256305,1125348744.6,27.746486925221276,54.077011333217115,NaN,NaN,-9.409546828696719,7.777677903139557
2022-01-20T09:30:00-05:00,131.97,133.32,130.71,130.79,15127778,11646622,32.666589345192946,46.27244755120085,NaN,NaN,-130.43199835750437,-130.66069537914242,-0.9339071463950271,-0.9753606615503543,-0.041453515155327164,1080128527,1110471575,23.265416930551382,49.626356136311884,NaN,NaN,-13.45715936821017,4.744129721518167
2022-01-21T09:30:00-05:00,131.19,131.6,129.26,129.47,25804772,12574561.45,29.672811153261705,43.48276981544344,NaN,NaN,-144.3747685663942,-137.86601585246018,-1.0004654921795222,-1.2920353803797298,-0.2915698882002077,1054323755,1093194424.4,19.35589637557753,44.87105190011162,NaN,NaN,-17.886481910847536,1.511185202608781
2022-01-24T09:30:00-05:00,128.3,129.26,124.92,129.04,37986741,14086709.5,28.7485164314203,41.201763522412186,NaN,NaN,-170.4722743963311,-145.70328795534093,-1.01452032800359,-1.5597202982046952,-0.5451999702011052,1016337014,1071188297.6,15.73012096728175,40.128123985165175,NaN,NaN,-21.764061585012826,-1.813850052765734
2022-01-25T09:30:00-05:00,127.33,129.305,126.27,128.21,19326773,14704578.8,27.000226305150377,39.3936692826526,NaN,NaN,-147.60855487524876,-145.40742951258562,-1.0181449717112445,-1.8178811848401608,-0.7997362131289163,997010241,1048611168.4,13.032787116845782,35.59452827486439,NaN,NaN,-25.563228744053596,-5.206618437235429
2022-01-26T09:30:00-05:00,128.42,129.58,126.535,127.54,29557376,15879114.15,25.64449503712376,37.762659564822265,NaN,NaN,-132.0335231178478,-144.98422386266526,-1.0025107787032257,-2.0528746865079484,-1.0503639078047227,967452865,1023050480.4,10.779185736960997,31.61381931953533,NaN,NaN,-29.15071836958348,-8.627204141856579
2022-01-27T09:30:00-05:00,128.16,129.84,127.45,127.87,18489082,16448389.6,27.573474830303837,36.660408295058836,NaN,NaN,-108.84620959522431,-140.66706611020922,-0.9095225015098323,-2.187267034692013,-1.2777445331821808,985941947,1004213164.4,9.478399388683883,28.378642180531024,NaN,NaN,-31.562090310531293,-11.903616451667252
2022-01-28T09:30:00-05:00,127.76,130.53,126.86,130.48,20906755,17097143.65,40.68097336480583,36.64929688442281,NaN,NaN,-82.60354468911301,-128.31282133475298,-0.6253475228302978,-2.059428936720053,-1.4340814138897553,1006848702,994718153.8,8.895678976944609,25.74016119730618,NaN,NaN,-29.648410270895702,-14.438586997271317
2022-01-31T09:30:00-05:00,130.24,131.465,129.98,131.23,19044360,17655221.95,43.826950824394906,36.44890216670327,NaN,NaN,-44.12645348526176,-103.04365715253911,-0.3535129067219842,-1.8759725472922355,-1.5224596405702513,1025893062,996629363.4,10.09383192857078,23.478151794967612,NaN,NaN,-27.07390168238357,-16.243631952287352
2022-02-01T09:30:00-05:00,131.7,131.82,130.53,131.58,14674817,17632839.2,45.28528546713522,36.061941007620256,NaN,NaN,-29.13496762302088,-79.34893970209355,-0.1283843486668923,-1.6829400764038667,-1.5545557277369744,1040567879,1005340891,15.545940529289737,21.695309438566913,NaN,NaN,-24.54188835024356,-17.429097151995382
2022-02-02T09:30:00-05:00,131.49,133.67,131.22,133.35,13595217,17626687.35,52.063091303281965,36.26343199375376,NaN,NaN,12.001913030297342,-50.541852472464505,0.14658184254778273,-1.371328424552246,-1.5179102671000286,1054163096,1022682937.2,25.262337030425186,20.6647554596463,NaN,NaN,-20.099272176046938,-17.81055072685989
2022-02-03T09:30:00-05:00,133.17,133.28,132.53,132.78,13805709,17548438.45,49.91855565708756,36.81927688306023,NaN,NaN,22.696196931509643,-24.23337116711771,0.2887036916049459,-1.1570306525938463,-1.4457343441987922,1040357387,1033566025.2,30.65422880936468,20.069172276776293,NaN,NaN,-17.108348237164023,-17.710236085474765
2022-02-04T09:30:00-05:00,131.57,133.23,131.33,132.3,12004325,17389555.4,48.12097334320931,37.296623560490275,NaN,NaN,11.543705053926397,-5.403921218509824,0.34519659407926206,-1.0142386015997147,-1.3594351956789767,1028353062,1037866897.2,32.71997452497254,19.709305858382585,NaN,NaN,-15.1712291186788,-17.34752080450391
2022-02-07T09:30:00-05:00,132.35,132.81,131.7,132.07,9229161,17370045.75,47.243090904684585,38.08822459765471,NaN,NaN,12.746509040264963,5.970671286595521,0.36022512353641245,-0.9091537912584613,-1.2693789147948737,1019123901,1036513065,32.39286048551857,19.63951040901492,NaN,NaN,-13.829617243882264,-16.844963152986534
2022-02-08T09:30:00-05:00,131.37,133.38,131.07,133.15,11071565,17144129.95,51.69902217773803,39.29600401034214,NaN,NaN,28.989571528842998,17.5955791169683,0.43125688061574263,-0.7303078140251955,-1.1615646946409381,1030195466,1034438582.4,31.867135170072487,19.93384242650429,NaN,NaN,-11.342302100102906,-16.0588687168603
2022-02-09T09:30:00-05:00,133.79,134.46,133.65,134.18,10811034,17076268,55.55455620296498,40.930858785897286,NaN,NaN,89.05547892203182,33.00629229531516,0.5294929688692329,-0.49969848355439694,-1.0291914524236299,1041006500,1031807263.2,31.175976007356937,20.49888236056183,NaN,NaN,-8.026310632837951,-14.911360419142822
2022-02-10T09:30:00-05:00,132.63,133.79,131.56,132.08,14393345,17254344,47.269809696677015,42.1877872532841,NaN,NaN,42.212239956673486,36.909500900347936,0.43867439746278314,-0.4808484555951509,-0.919522853057934,1026613155,1029058416.8,30.43338960101005,21.29013187666415,NaN,NaN,-7.605422659856886,-13.867655024959117
2022-02-11T09:30:00-05:00,131.9,132.9,130.09,130.25,13072313,17217716.3,41.46652751296213,43.09621661625137,NaN,NaN,-4.189126857912665,33.76293451798012,0.25035182910680176,-0.6065830666744318,-0.8569348957812336,1013540842,1026095972.8,29.614701174625935,22.28188760576017,NaN,NaN,-9.175571627719087,-13.19735739678197
2022-02-14T09:30:00-05:00,129.98,130.23,127.95,128.92,14386969,17219971.75,37.83134018429206,43.86986760761863,NaN,NaN,-78.22393612318233,15.568845485290662,0.0421260541000128,-0.8042773281562177,-0.8464033822562305,999153873,1022101967.2,28.501486211078287,23.386794683919636,NaN,NaN,-11.710887942448892,-12.98500461759153
2022-02-15T09:30:00-05:00,130.04,130.88,129.71,130.37,8969944,16844880.9,43.63303431806747,45.154763270543185,NaN,NaN,-21.929461439747435,5.385038891572576,0.00965796557091192,-0.8343309252925906,-0.8439888908635025,1008123817,1017687637.4,27.28089272198801,24.565488039992992,NaN,NaN,-11.894758639975622,-12.829255192217829
2022-02-16T09:30:00-05:00,129.7,130.94,129.34,130.57,8779207,16551862.15,44.40371727552392,46.35692344520176,NaN,NaN,-19.819316186126695,-16.389920130059128,0.009259328556256441,-0.8324147301681819,-0.8416740587244383,1016903024,1012866942.2,25.972761677830306,25.74365677493202,NaN,NaN,-11.795680992314733,-12.681601735088815
2022-02-17T09:30:00-05:00,130.04,130.11,128.275,128.47,11906813,16390813.9,38.457910810167206,46.19813326272757,NaN,NaN,-68.35296125618594,-38.50296037263101,-0.11781963099001413,-0.9889485974619561,-0.8711289664719419,1004996211,1008543553.4,24.823155811436777,26.88133369168146,NaN,NaN,-13.685557154167514,-12.825023937814343
2022-02-18T09:30:00-05:00,128.35,129.04,127.08,127.51,13505608,15775855.7,36.07949125532509,45.644743293508306,NaN,NaN,-100.8912314326776,-57.843381287583995,-0.24461700192235958,-1.1769002188748914,-0.9322832169525318,991490603,1004133505.6,23.672163356017236,27.851214507927633,NaN,NaN,-16.011327698822676,-13.280210189386962
2022-02-22T09:30:00-05:00,127.06,128.23,126.34,127.19,13682107,14560624,35.29589843396751,44.931215648282034,NaN,NaN,-122.14346470087762,-66.62728700312306,-0.3231901143881677,-1.3362708599377413,-1.0130807455495736,977808496,999864430.2,22.580654601600443,28.353694084521255,NaN,NaN,-18.110420902731377,-13.970240291293306
2022-02-23T09:30:00-05:00,127.84,128.28,126.425,126.55,12022840,14195427.35,33.71859866458392,43.62089474551789,NaN,NaN,-123.94929542797223,-87.03125380076801,-0.3871033002912434,-1.4969598709136278,-1.1098565706223844,965785656,991396798,20.556043363712305,28.017530251184617,NaN,NaN,-20.326025037625193,-14.87820954076929
2022-02-24T09:30:00-05:00,124.29,127.32,124.06,127.06,23220097,13878563.4,36.166606574094395,42.63861266816123,NaN,NaN,-148.24827910116832,-112.71704638377635,-0.3642048933035533,-1.5651126872518262,-1.2009077939482729,989005753,985817343.8,19.326423096274027,27.208401271678145,NaN,NaN,-21.448494951374226,-15.816821742284281
2022-02-25T09:30:00-05:00,127.63,131.27,127.49,130.95,17012274,13804723,51.02468067147342,42.84602033446581,NaN,NaN,-19.36608412458029,-102.91967095745522,-0.07156123371747936,-1.290359336095122,-1.2187981023776426,1006018027,986021707,19.516327455485694,26.265283623857652,NaN,NaN,-17.427872656063716,-16.0469718728242
2022-02-28T09:30:00-05:00,128.85,130.11,128.45,129.96,17987714,13658770.95,47.96478005315669,42.897569559356675,NaN,NaN,-34.525402611784116,-89.64650519327651,0.06354556325387284,-1.1393661483103017,-1.2029117115641745,988030313,985329649,19.35021056294609,25.333665772245332,NaN,NaN,-15.206494320789787,-15.926903651104999
2022-03-01T09:30:00-05:00,129.28,130.34,128.235,129.24,14064394,13409772.65,45.81300063560053,42.477139449203996,NaN,NaN,-39.59811143273685,-73.13743453964835,0.10991472122206392,-1.0655183100365946,-1.1754330312586585,973965919,984561133.6,19.15522710326188,24.425672338901716,NaN,NaN,-14.111942401386468,-15.66762347257378
2022-03-02T09:30:00-05:00,129.81,131.9,129.64,131.19,12395631,13295813.35,52.08279845573227,42.22915675297309,NaN,NaN,20.939406343762474,-44.15969418530141,0.268376742824747,-0.8399621027277249,-1.1083388455524719,986361550,988676312.4,23.594941253794246,23.884169856504382,NaN,NaN,-11.06148266579257,-15.009603357319321
2022-03-03T09:30:00-05:00,131.77,132.63,130.74,131.86,11172608,13174682.9,54.05008673625054,42.71346225579977,NaN,NaN,55.035125108534835,-3.5030133433607817,0.40649126416487147,-0.6002247653463826,-1.006716029511254,997534158,990381993.4,25.42304770218098,23.526288292302308,NaN,NaN,-7.975403269339728,-14.004717630465093
2022-03-04T09:30:00-05:00,130.53,132.64,130.14,132.52,12160672,13092431.05,55.96787230475644,43.74927259807079,NaN,NaN,59.69610849229092,12.309425180013458,0.5230475226509848,-0.3529066261975231,-0.8759541488485079,1009694830,991117354,26.24240503043336,23.285409996288553,NaN,NaN,-4.860236308727607,-12.698363155931165
2022-03-07T09:30:00-05:00,131.69,131.94,129.62,130.21,15703953,13277412.45,48.36013387175964,44.501329290032764,NaN,NaN,17.91706849953723,22.79791940227772,0.4292508153190291,-0.33939062969972156,-0.7686414450187506,993990877,992309466.8,27.63052126357003,23.223198214323677,NaN,NaN,-4.561486075031109,-11.535952144374015
2022-03-08T09:30:00-05:00,129.35,130.31,127.47,127.55,21794622,13905685.5,41.384154298607484,44.34069500292848,NaN,NaN,-62.700417590346774,18.177458170755735,0.18521139084369287,-0.5371272064641346,-0.7223385973078275,972196255,991955534,27.465252481828045,23.236366768597964,NaN,NaN,-6.731732118412399,-10.849634997808069
2022-03-09T09:30:00-05:00,129.63,130.625,128.67,129.96,15576472,14130930.85,48.61624163081857,44.64158959973524,NaN,NaN,-3.2533035548086358,13.338916191041514,0.18292911316645089,-0.4936772058497638,-0.6766063190162147,987772727,992237769.4,27.83593159369532,23.369450334016893,NaN,NaN,-5.999993998029476,-10.156829140696841
2022-03-10T09:30:00-05:00,128.39,130.19,128.25,129.91,10708939,14125826.1,48.482590668529795,45.35763816104685,NaN,NaN,-7.345216567636842,0.8628478558071786,0.17488678681203207,-0.4579978355011747,-0.6328846223132067,977063788,988143695.4,25.77800359259028,23.437653746956425,NaN,NaN,-5.488498970889779,-9.489924830724403
2022-03-11T09:30:00-05:00,130.26,131.02,128.81,128.94,9869161,13899616.9,45.84923674799337,46.05547712480887,NaN,NaN,8.226523546377535,-9.431069133375498,0.1045449124988812,-0.5022034816896053,-0.6067483941884865,967194627,979643654.8,22.121333972757242,23.326880219580715,NaN,NaN,-5.914152223971973,-8.979100172616914
2022-03-14T09:30:00-04:00,129.98,131.72,129.47,129.85,14373221,13964662.3,48.66619992399016,47.01049865981049,NaN,NaN,55.5473087314098,-1.9050210870009834,0.11858125472831538,-0.4585218257780923,-0.5771030805064077,981567848,977159049,21.175757669386243,23.22653043870827,NaN,NaN,-5.3862135927035455,-8.465830661200718
2022-03-15T09:30:00-04:00,130.9,132.58,130.675,132.44,14374061,13964016.9,55.72566353275868,48.58243186468012,NaN,NaN,130.16606852380477,36.668276135829316,0.2917118247029661,-0.21246329962770005,-0.5041751243306661,995941909,981908179.8,27.55049115958387,23.726133852699096,NaN,NaN,-2.5746827111549653,-7.624238096908467
2022-03-16T09:30:00-04:00,133.11,134.05,131.75,134.03,13840385,14207538.95,59.415526585729076,50.24306900836831,NaN,NaN,177.20352812377567,72.75964247154619,0.49100124982474636,0.10957643795026684,-0.3814248118744795,1009782294,986310093.2,32.96219544903036,24.70011759218169,NaN,NaN,0.9992692505605851,-6.3923084758414594
2022-03-17T09:30:00-04:00,133.64,136.21,133.46,136.15,10973125,14317234.85,63.75315029158703,51.152245409805,NaN,NaN,219.11693053068095,118.05207189120975,0.7289437282521347,0.5297548484406889,-0.19918887981144584,1020755419,995048419.4,42.19320032252692,26.31989422554178,NaN,NaN,5.520553825493707,-4.69047100422215
2022-03-18T09:30:00-04:00,136.07,137.16,135.66,136.99,11364223,14290105.35,65.33411563884451,52.39291223735413,NaN,NaN,215.43695659644828,159.4941585012239,0.8952918338634742,0.9199259125178969,0.024634078654422714,1032119642,1008033422.4,52.63125486695512,28.697111675828143,NaN,NaN,9.662227360638981,-2.640085523527703
2022-03-21T09:30:00-04:00,136.5,137.67,135.82,136.46,11473090,14188479.45,63.45354672606599,53.65295124381595,NaN,NaN,178.59693373649753,184.10408350224142,0.9185749804153656,1.1728528041736297,0.25427782375826413,1020646552,1015849163.2,57.594601036178744,31.44278124246506,NaN,NaN,12.409469031907053,-0.49014915846559504
2022-03-22T09:30:00-04:00,136.6,136.79,135.99,136.49,8892191,13948983.65,63.517558990868324,54.469719853468526,NaN,NaN,145.53345760510686,187.17756131850186,0.8846115147907037,1.3600422172466438,0.4754307024559401,1029538743,1022568530,61.34463616642393,34.13918802193861,NaN,NaN,14.621367296885357,1.6686389065845408
2022-03-23T09:30:00-04:00,135.84,136.09,134,134.04,10013480,13848515.65,55.0390683724146,54.540361398908814,NaN,NaN,86.64757328745424,169.06637035123757,0.6562633878464437,1.2957599372639947,0.6394965494175511,1019525263,1024517123.8,62.38352698038926,36.77922225609634,NaN,NaN,14.007527974975265,3.4313373449260727
2022-03-24T09:30:00-04:00,134.54,135.64,134.25,135.64,7189377,13046979.65,58.89766857554714,54.74963256110815,NaN,NaN,87.68513268747571,142.78001078259652,0.575014888637787,1.3582651602147848,0.7832502715769978,1026714640,1025708968,63.03786187459187,39.407469173536235,NaN,NaN,14.68406787619369,5.038870277964303
2022-03-25T09:30:00-04:00,136.1,136.5,135.23,136.27,7040191,12548375.5,60.340921192642014,55.60540308402832,NaN,NaN,96.20615952589183,118.93385136848522,0.5270110577378135,1.4420140937492647,0.9150030360114512,1033754831,1026036005.8,63.22688527568603,41.950066602973095,NaN,NaN,15.671824539792139,6.557863743939708
2022-03-28T09:30:00-04:00,136.5,137.3,136.01,137.26,8466953,12072337.45,62.56540072394236,57.11834925726652,NaN,NaN,104.27653814801182,104.06977225078808,0.5241339751862177,1.5701705049942234,1.0460365298080057,1042221784,1030351052.2,65.71801663164254,44.68240689938842,NaN,NaN,17.166237391704282,8.073345693620361
2022-03-29T09:30:00-04:00,138.4,138.95,137.25,138.07,12327806,11985508.05,64.32836423723808,58.24064372915363,NaN,NaN,120.0293201392713,98.96894475762097,0.5370104988324902,1.7172996533486184,1.1802891545161283,1054549590,1035353221.6,68.39121746944897,47.57921303337082,NaN,NaN,18.93602900545717,9.625157595311332
2022-03-30T09:30:00-04:00,138.09,138.89,137.64,138.34,10752953,11903374.15,64.92139319513387,59.41484390962535,NaN,NaN,110.53888727060918,103.74720755425196,0.5234005749840802,1.8345398732462286,1.3111392982621484,1065302543,1044508677.6,72.6022350298901,50.923800993177956,NaN,NaN,20.557845362529115,11.186970133485302
2022-03-31T09:30:00-04:00,138.05,138.81,136.75,136.99,15843211,12136904.3,59.58729242931284,60.396133601148165,NaN,NaN,83.47173490383753,102.90452799752434,0.3893253625031661,1.7977960013911058,1.4084706388879398,1049459332,1049057616,74.42530958093367,54.65979925090484,NaN,NaN,20.44787665459717,12.509956779358426
2022-04-01T09:30:00-04:00,137.37,138.12,136.45,138.07,20785728,12568157.1,62.25884222585678,61.36703662271007,NaN,NaN,76.96199685181047,99.05569546270807,0.34096285691827677,1.8346742100357858,1.493711353117509,1070245060,1056355661.8,77.06236437788566,58.651699730083365,NaN,NaN,21.120173173874196,13.739987692860678
2022-04-04T09:30:00-04:00,137.76,138,136.6,136.92,16769479,12621433.4,57.87180685840575,61.520332574541996,NaN,NaN,63.81231671554248,90.9628511762142,0.2057681443087367,1.7509215335034298,1.5451533891946931,1053475581,1058606421.2,77.82188669348326,62.24251369679047,NaN,NaN,20.417207090591713,14.693876178250827
2022-04-05T09:30:00-04:00,136.57,138.84,136.5,137.21,15025053,12282954.95,58.6628415956711,61.466569360966425,NaN,NaN,68.69622824451338,80.69623279726261,0.11466426546314934,1.6884837210236299,1.5738194555604805,1068500634,1061396630,78.76079350793032,65.51384212956904,NaN,NaN,20.056600106100177,15.45997959651502
2022-04-06T09:30:00-04:00,136.86,139.63,136.77,139.3,23197763,12664019.5,63.920751891349745,61.47854090380661,NaN,NaN,93.05782416174078,77.20002017548893,0.1705819347271258,1.7870468739693877,1.6164649392422619,1091698397,1066675800.8,80.44740834343834,68.24628555963413,NaN,NaN,21.29016577785361,16.292863336706247
2022-04-07T09:30:00-04:00,138.8,142.34,138.8,141.98,18160032,13036574.15,69.31120825454568,61.76261894778526,NaN,NaN,160.63370629425563,92.63241445357255,0.35298219636108685,2.0576926846936203,1.7047104883325335,1109858429,1078755620.2,83.64736923788597,70.4617223004149,NaN,NaN,24.167506557141373,17.41781236819698
2022-04-08T09:30:00-04:00,141.99,143.42,141.78,142.83,19102690,13498250.6,70.80125879829887,62.28745552437333,NaN,NaN,207.87078878411182,118.81417284003282,0.48750673078776896,2.3140939018172446,1.8265871710294757,1128961119,1090498832,86.03934733512588,72.49348989319685,NaN,NaN,26.992131887382065,18.785572299509134
2022-04-11T09:30:00-04:00,142.42,143,139.78,139.99,16570651,13608122.1,60.27152301500395,62.055595811811585,NaN,NaN,139.3928315739779,133.9302758117199,0.3483733825828703,2.2620538992580634,1.9136805166751931,1112390468,1102281809.4,87.94479491392265,74.3935012323039,NaN,NaN,25.990159540353307,19.81479904820116
2022-04-12T09:30:00-04:00,139.64,140.46,138.03,138.63,14085400,13593689.05,55.97813470772132,62.12267197861921,NaN,NaN,63.41365056961465,132.87376027674014,0.13866630424110404,2.087013396976573,1.9483470927354691,1098305068,1108242696.2,88.77916186548315,76.27890372409634,NaN,NaN,23.730901936252632,20.3742423179228
2022-04-13T09:30:00-04:00,138.62,139.45,137.9,139.31,15496408,13676490.2,57.60429932852174,62.03028846097454,NaN,NaN,48.88240176297311,124.03867579698662,0.02559015629242789,1.980334788101004,1.9547446318085762,1113801476,1112663312,89.36691936408931,78.15955068763186,NaN,NaN,22.43008863149963,20.667934648433775
2022-04-14T09:30:00-04:00,139.44,140.15,138.54,138.64,10993551,13677511.5,55.43157869563168,61.67962113975951,NaN,NaN,51.442115713622144,102.20035768085992,-0.10720412930949919,1.8207394701717021,1.9279435994812013,1102807925,1111253211.2,87.78728501222551,79.91386495452753,NaN,NaN,20.698163428810016,20.67225304563038
2022-04-18T09:30:00-04:00,138.5,138.82,136.53,137.11,10125007,13615550.7,50.726318485850655,60.833972408467254,NaN,NaN,-22.451958527077913,56.13580821862197,-0.30003491669259974,1.5528999536154515,1.8529348703080513,1092682918,1103997571,79.95586738798966,80.93085429426661,NaN,NaN,17.737243252419837,20.252965932314588
2022-04-19T09:30:00-04:00,137.47,138.91,137.42,138.42,11733062,13628549.3,54.302987519801455,60.117874071507494,NaN,NaN,8.711943793911345,29.99963066260866,-0.33846090627130576,1.4298587374689191,1.7683196437402249,1104415980,1102402673.4,78.30228830566536,81.63878792542492,NaN,NaN,16.332854424515254,19.69295000262897
2022-04-20T09:30:00-04:00,138.8,140.82,138.64,140.28,13674762,13867677.85,58.86826428391045,59.685507720705814,NaN,NaN,78.01715771903308,32.920332092492345,-0.2422234700658672,1.4655403061578909,1.707763776223758,1118090742,1106359808.2,79.43850717405543,82.12709307857959,NaN,NaN,16.562728858513662,19.245775553469638
2022-04-21T09:30:00-04:00,140.67,140.83,138.42,138.73,11409874,13937497.55,54.024597278317025,59.28817235277755,NaN,NaN,43.10590443629011,31.76503262715575,-0.2836926902069201,1.3531479134651079,1.636840603672028,1106680868,1104935686.6,77.8583361513618,82.3723092621816,NaN,NaN,15.207966267555978,18.668945655481973
2022-04-22T09:30:00-04:00,137.48,137.52,133.525,133.67,17525347,14454296.05,41.90339366743475,57.83421174146169,NaN,NaN,-176.89735270489913,-13.902861056548511,-0.6326532966541214,0.8460239828543763,1.4786772795084977,1089155521,1102205205.8,74.78667040714619,82.20975969284306,NaN,NaN,9.413803413518075,17.34678247805856
2022-04-25T09:30:00-04:00,133.28,134.86,131.78,134.57,16501856,14927379.3,44.297299880638484,56.864604100192594,NaN,NaN,-213.23564871345323,-52.05959909382358,-0.7742552341309834,0.5108582368447685,1.285113470975752,1105657377,1104800097.6,75.76519809785191,82.06285336458369,NaN,NaN,5.756141559863478,15.690976632602121
2022-04-26T09:30:00-04:00,133.76,134.48,132.01,132.2,20087676,15508415.45,39.66253835818996,55.507439583229655,NaN,NaN,-212.90262599626334,-96.38251305185851,-0.9853848439430353,0.053382416046957815,1.038767259989993,1085569701,1101030841.8,71.428723098402,81.53913404961737,NaN,NaN,1.062173274230769,13.601147581406213
2022-04-27T09:30:00-04:00,132.18,133.25,131.26,131.91,16726731,15728361.7,39.12312951684888,53.73618084219388,NaN,NaN,-193.08001888933578,-150.60194837353228,-1.0940386566554572,-0.32878106082932845,0.7652575958261287,1068842970,1091181287.4,61.51977650496287,80.18716034686913,NaN,NaN,-2.733285154557494,11.267657190554255
2022-04-28T09:30:00-04:00,132.84,134.17,131.61,133.73,15510666,15966247.35,44.24771022939255,51.945930983254364,NaN,NaN,-135.06192640114,-186.2355145410183,-0.9956180065726021,-0.479264912389624,0.5163530941829781,1084353636,1086715841,57.617298417151524,78.32786957395953,NaN,NaN,-4.2460595527491,9.051411941510919
2022-04-29T09:30:00-04:00,132.43,133.115,130.085,130.29,17430156,16045594.6,37.77505006395917,49.58691607365868,NaN,NaN,-158.31948704494698,-182.51994140902787,-1.105978164869512,-0.8661196119039118,0.23985855296560016,1066923480,1082269432.8,53.947626810318724,76.03560382218758,NaN,NaN,-7.833918353805582,6.639221899322848
2022-05-02T09:30:00-04:00,130.18,130.91,127.38,129.48,23615284,16187072.4,36.42394162844541,47.883517403190204,NaN,NaN,-164.85014731831743,-172.84284113000072,-1.1710516234484771,-1.223955976344996,-0.05290435289651907,1043308196,1069799596.6,45.24448497450783,72.98558168365795,NaN,NaN,-11.108657838448686,4.103810508212629
2022-05-03T09:30:00-04:00,129.88,131.14,129.43,129.89,13585397,16027868.3,37.63978129409921,46.57363501650291,NaN,NaN,-122.29171678293612,-154.72065928733525,-1.123802384379087,-1.4576573333703777,-0.3338549489912908,1056893593,1064064375,41.89669917482304,69.6368343486108,NaN,NaN,-13.32434050464267,1.6140746492333005
2022-05-04T09:30:00-04:00,129.68,133.25,128.59,132.77,19053548,16229293.05,45.52118661796748,45.710555537177605,NaN,NaN,-84.36272042576317,-132.97719959462074,-0.848437335078197,-1.394401617839037,-0.5459642827608401,1075947141,1065485209.2,43.02151341573689,66.32644820944277,NaN,NaN,-12.708561586181686,-0.4320162415402691
2022-05-05T09:30:00-04:00,132.12,132.255,128.85,130.19,16119817,15875395.75,40.574025722729125,44.64930175339885,NaN,NaN,-92.67871780490948,-124.50055787537465,-0.7910394903019395,-1.5347636456382645,-0.743724155336325,1059827324,1060579946.8,40.13293322289099,62.922565938776025,NaN,NaN,-13.824187878334671,-2.3451836182251835
2022-05-06T09:30:00-04:00,128.93,130.14,128.27,129.78,21742337,16054511,39.83316577202487,43.87121941669701,NaN,NaN,-100.48892723612336,-112.93444591360992,-0.7329808869703005,-1.6599502640492005,-0.9269693770789,1038084987,1054812248.2,36.9881791114265,59.85344534759293,NaN,NaN,-14.9353110342477,-4.143773249085543
2022-05-09T09:30:00-04:00,128.33,128.36,125.93,126.42,17289879,15963870.45,34.30495079759072,42.44278822225339,NaN,NaN,-132.2105041315782,-106.40651727626206,-0.8641431574549907,-2.0071483238976384,-1.1430051664426477,1020795108,1050309630.6,34.702112429926004,56.73914707075441,NaN,NaN,-17.76800399812352,-6.0900919275195395
2022-05-10T09:30:00-04:00,127.74,128.22,125.7,126.87,21850268,16227851.3,35.594159624665934,40.78035217516449,NaN,NaN,-122.32113419057048,-106.41240075778894,-0.8619148066767941,-2.2203986747886404,-1.3584838681118463,1042645376,1047459987.2,33.29938809816312,53.44349570819067,NaN,NaN,-19.597143573041212,-8.019670734022636
2022-05-11T09:30:00-04:00,126.24,129.09,125.88,126.03,19987173,16522939.95,34.24327763725371,39.3674007722314,NaN,NaN,-111.59660397740049,-111.8591774681164,-0.8565569206596371,-2.4291800189363926,-1.5726230982767555,1022658203,1036802199.6,28.637030063267247,49.92768813046963,NaN,NaN,-21.502907356591436,-9.945847394389608
2022-05-12T09:30:00-04:00,125.57,127.33,125.28,127.25,17497046,16622971.85,37.927958865062614,39.083441143490525,NaN,NaN,-108.74429813236935,-115.07229353360837,-0.7161017178721936,-2.4677502456169975,-1.751648527744804,1040155249,1032867784.6,27.12705489977624,46.5234298799432,NaN,NaN,-21.995266964238304,-11.667193047225135
2022-05-13T09:30:00-04:00,128.09,129,127.53,128.6,9841601,16565374.35,41.81340865898283,38.906020341943695,NaN,NaN,-70.6304398964951,-109.10059606568272,-0.4884045910605903,-2.362154266570542,-1.8737496755099516,1049996850,1035250157.2,29.54942540485176,43.22230325901462,NaN,NaN,-21.246708515455566,-13.035695256972339
2022-05-16T09:30:00-04:00,128.45,130.43,128.42,129.55,8839812,16501114.6,44.448615344095124,39.247882983794064,NaN,NaN,-44.40379702923452,-91.53925464521399,-0.2423760687366585,-2.1767197614307747,-1.9343436926941162,1058836662,1042858468,36.77729882721468,40.747201525358385,NaN,NaN,-19.842422763300046,-14.00808490073344
2022-05-17T09:30:00-04:00,130.9,131.39,129.93,131.33,9058782,16367400.6,49.100082179362786,39.960522459687915,NaN,NaN,-7.801782241998367,-68.63538425549956,0.055766080530113005,-1.8646360920314748,-1.9204021725615879,1067895444,1047908481.6,41.09698790494537,39.28843091107142,NaN,NaN,-17.219480731539193,-14.46685573370569
2022-05-18T09:30:00-04:00,130.44,130.76,127.53,127.94,10005035,16183914.25,41.90373433577435,39.79309561014376,NaN,NaN,-53.25390126333356,-56.96684371268617,0.040878513319654974,-1.8693040309120192,-1.9101825442316742,1057890409,1054954922.8,46.58144387574718,38.5001555866854,NaN,NaN,-17.104859707460644,-14.843713444242113
2022-05-19T09:30:00-04:00,126.92,129,126.46,128.22,9672865,16097063.8,42.651380165690384,40.14140490312456,NaN,NaN,-72.11916343749257,-49.64181677371081,0.0646880708984785,-1.829322455608576,-1.8940105265070546,1067563274,1060436527.8,50.44680686700106,38.25009701930556,NaN,NaN,-16.786179471733767,-15.121208591026635
2022-05-20T09:30:00-04:00,129.08,130.06,127.33,129.78,12833744,15862483.65,46.76211744915809,40.87984603317546,NaN,NaN,-27.044231637714166,-40.924575121954625,0.1930432727435758,-1.652706435577585,-1.8457497083211607,1080397018,1066516561.4,54.38910662346764,38.903284279945545,NaN,NaN,-15.26066000373427,-15.14113022141344
2022-05-23T09:30:00-04:00,130.65,131.43,130.38,130.92,9196515,15497216.6,49.60493939625478,41.73450018332943,NaN,NaN,51.15540778751132,-21.81273415860546,0.3529536637808144,-1.4045576285951427,-1.757511292375957,1089593533,1072667935.6,58.0273769165757,40.05547554721359,NaN,NaN,-13.124434406587449,-14.85303081929544
2022-05-24T09:30:00-04:00,130.535,131.53,129.7,131.31,9031266,14944396.1,50.57723948238228,42.09564681650192,NaN,NaN,56.61761110839365,-8.928855488527052,0.47559176848230167,-1.16302158177308,-1.6386133502553817,1098624799,1078813806.6,61.345006978597326,41.364296515989345,NaN,NaN,-11.09337709831276,-14.315937430583629
2022-05-25T09:30:00-04:00,131.22,132.13,130.04,131.27,8532579,14534688.5,50.46968635925923,42.80247971911121,NaN,NaN,74.46630727256479,16.615186218652617,0.539913868810139,-0.963721014242708,-1.503634883052847,1090092220,1085254168.8,64.51071349298786,43.10556653528198,NaN,NaN,-9.45964675973642,-13.6221816204626
2022-05-26T09:30:00-04:00,131.6,132.33,131.22,131.83,9090060,14213658.2,52.00835897187144,43.67213637624311,NaN,NaN,112.13717713451221,53.46645433305357,0.6013727819491295,-0.751918905616435,-1.3532916875655645,1099182280,1091577970,67.33914220433437,45.27349247048968,NaN,NaN,-7.654597996759814,-12.769669674219344
2022-05-27T09:30:00-04:00,132.06,134.05,131.51,134.02,13696005,14026950.65,57.56079039925099,45.3332677763617,NaN,NaN,161.30918663462194,91.13713798752079,0.7604674688520663,-0.40270735150048154,-1.1631748203525478,1112878285,1098074223.4,69.98549973138024,47.79373442059356,NaN,NaN,-4.400086289832704,-11.574014905021253
2022-05-31T09:30:00-04:00,132.84,133.08,131.16,132.23,11740800,13433226.45,52.24068689793558,46.5223054387381,NaN,NaN,101.4235420174494,101.19076483350841,0.7166907996694217,-0.2673113207657707,-0.9840021204351924,1101137485,1100383013.8,70.88830615489682,50.47865713893168,NaN,NaN,-3.0650863119229466,-10.358453677435781
2022-06-01T09:30:00-04:00,132.71,132.73,129.29,130.33,9259949,13216954.05,47.24875184517638,47.451267882161154,NaN,NaN,43.24640002669715,98.5165226171691,0.5393997137756853,-0.3097524782155858,-0.8491521919912711,1091877536,1099033561.2,69.57111056061915,53.40252003159967,NaN,NaN,-3.3972784003605283,-9.364000066425032
2022-06-02T09:30:00-04:00,130.5,131.39,128.17,131.36,9575484,12743050.85,50.03606028874736,48.316132269567206,NaN,NaN,27.64176932272978,89.1516150272021,0.4734746237023999,-0.25730891236327125,-0.7307835360656711,1101453020,1101305721.2,70.56293793978371,56.50508310588592,NaN,NaN,-2.847767348146562,-8.433109678099536
2022-06-03T09:30:00-04:00,130.45,131.03,129.65,129.82,5852628,12229691.4,46.11284294827374,48.623234718802266,NaN,NaN,22.557651991613525,71.23570999862235,0.31571694399631167,-0.3361373560702816,-0.6518543000665933,1095600392,1100589343.6,69.790551937826,59.379449286812644,NaN,NaN,-3.557727996843072,-7.736626580777184
2022-06-06T09:30:00-04:00,130.75,131.02,129.49,129.84,7729119,11529030.5,46.17187155047376,48.74632444782931,NaN,NaN,18.842754710689775,42.742423613835925,0.2075062672309096,-0.39247146602795624,-0.5999777332588658,1103329511,1098679588.8,67.66419126626212,61.585655889601746,NaN,NaN,-4.113373014540721,-7.2190189284576896
2022-06-07T09:30:00-04:00,129.84,131.66,129.37,131.53,7219071,11025490.1,51.05120628902516,48.885690455662335,NaN,NaN,44.614992197815,31.38071364990904,0.2421258243277391,-0.29732045284919195,-0.539446277176931,1110548582,1100561808.2,68.67712093168275,63.55566539151156,NaN,NaN,-3.180721025331417,-6.6421192280110795
2022-06-08T09:30:00-04:00,131.16,131.64,130.12,130.49,5372007,10201577.05,48.15817788434691,49.33243642341752,NaN,NaN,35.152325341875375,29.761898712944692,0.18967971458594873,-0.3023466339444951,-0.49202634853044386,1105176575,1103221616,70.10238958882258,65.23573294244552,NaN,NaN,-3.2277639950862635,-6.154354194736106
2022-06-09T09:30:00-04:00,130.05,130.49,127.505,127.54,7772883,9590862.55,41.051744817881804,49.21817675571691,NaN,NaN,-88.04047003312098,6.625450841774539,-0.0369122129817816,-0.5381666147576709,-0.5012544017758893,1097403692,1102411750.4,69.0718059289494,66.56609001829896,NaN,NaN,-5.520678657435982,-6.063829117978946
2022-06-10T09:30:00-04:00,126.03,126.66,124.9998,125.49,11289024,9280461.45,36.96913868037193,48.518678272232194,NaN,NaN,-227.08979994477932,-43.30403954550403,-0.30325701429333596,-0.8803256696425592,-0.5770686553492232,1086114668,1100514605.6,66.60174180179814,67.43842110246543,NaN,NaN,-8.828138915164908,-6.4587305175769405
2022-06-13T09:30:00-04:00,123.01,123.76,121.18,121.69,14886247,9532693.75,30.84547012642244,47.178716181529886,NaN,NaN,-299.70049414966303,-107.01268931757458,-0.6915456397304519,-1.441500705012288,-0.7499550652818362,1071228421,1094094387.6,58.9224340133121,67.50235375223232,NaN,NaN,-14.003334804535559,-7.5365311299996005
2022-06-14T09:30:00-04:00,121.55,121.86,119.67,120.53,9299504,9555678.35,29.25254599741558,45.655523789746546,NaN,NaN,-255.88058405138779,-167.11180456741516,-0.9658567554461815,-1.9572760095895632,-0.9914192541433816,1061928917,1084370454.6,49.59519771186948,66.66308166175175,NaN,NaN,-18.675127208874898,-9.1277591412675
2022-06-15T09:30:00-04:00,121.19,123.03,119.89,121.75,10301639,9617821.2,33.16197924976582,44.419258996211305,NaN,NaN,-182.11776584839814,-210.56582280546985,-1.0002617114119736,-2.2417463934083486,-1.241484681996375,1072230556,1077781250.8,44.459361257666465,65.23084221637166,NaN,NaN,-21.191043634017696,-10.85108549737467
2022-06-16T09:30:00-04:00,119.52,120.04,118.75,119.96,9383292,9586734.05,30.499007396629608,42.88287674083689,NaN,NaN,-179.3066722559242,-228.81906325003052,-1.0723059388766676,-2.5818671055922096,-1.509561166715542,1062847264,1070869965.2,39.803467608431674,63.26400831666432,NaN,NaN,-24.17001600240603,-12.753789855236294
2022-06-17T09:30:00-04:00,120,121.79,119.85,119.89,13725168,9789349.2,30.39621161700444,40.942549684962145,NaN,NaN,-132.17705665093723,-209.83651459126207,-1.0519546711655838,-2.8245045056725218,-1.772549834506938,1049122096,1063471450.8,35.515705821994985,60.80188018027966,NaN,NaN,-26.54233240145193,-14.723581647552813
2022-06-21T09:30:00-04:00,121.06,123.1517,120.66,122.6,7987177,9547020.85,38.97201030842646,39.994787071425776,NaN,NaN,-89.3595923784404,-167.76833423701754,-0.794947821261583,-2.7662346110839167,-1.9712867898223336,1057109273,1060647621.2,34.009817755578936,58.16770243747124,NaN,NaN,-25.909182752718472,-16.32152466257648
2022-06-22T09:30:00-04:00,121.82,125.665,121.76,124.3,10188900,9596640.1,43.661357536427325,39.73854462080084,NaN,NaN,-53.97986772281229,-127.38819097130245,-0.4657265545449798,-2.5534449830035584,-2.0877184284585786,1067298173,1061721472.4,35.136146816072255,55.7080621700036,NaN,NaN,-23.868045756498425,-17.39959910456533
2022-06-23T09:30:00-04:00,124.88,127.19,124.88,127.09,11943316,9742242.6,50.39771296935982,39.764376955130295,NaN,NaN,-11.863278342787554,-93.33729347018033,-0.037878274623762476,-2.135066271738282,-2.0971879971145193,1079241489,1063123659,36.656465537239654,53.286171284107596,NaN,NaN,-19.827080782260396,-17.74638220137891
2022-06-24T09:30:00-04:00,128.02,129.22,127.16,129.2,10448107,9838019,54.79946087414558,40.38484966412114,NaN,NaN,25.414572653581804,-52.39304448827913,0.38604931348595706,-1.614626355257073,-2.00067566874303,1089689596,1068492125.4,42.238581563558604,51.31817340023135,NaN,NaN,-14.953223537190874,-17.347359535066335
2022-06-27T09:30:00-04:00,129.2,130.23,128.79,129.68,8963597,9831695.85,55.76122814141971,41.06980370633157,NaN,NaN,45.62576401459473,-16.832480355172756,0.6803938267508456,-1.150183385304473,-1.8305772120553185,1098653193,1078398344.8,50.84642000573874,50.116904024479695,NaN,NaN,-10.789480096289711,-16.410519615241103
2022-06-28T09:30:00-04:00,129.94,130.59,127.175,127.42,7518756,9522833.4,50.33104801360755,41.01836382951603,NaN,NaN,31.529625167001992,7.345363153915713,0.7016769993566423,-0.9534809628595156,-1.6551579622161579,1091134437,1085203377.6,55.727311136909876,49.19191761056735,NaN,NaN,-8.933457548065725,-15.342367891358906
2022-06-29T09:30:00-04:00,127.59,129.17,127.39,128.53,9157664,9393676.6,52.76411030722405,41.347359002578685,NaN,NaN,36.02926514903213,25.347189728284626,0.7641611778871433,-0.6999564898572288,-1.4641176677443721,1100292101,1091802163.2,59.88688493997864,48.46223870707849,NaN,NaN,-6.648006135356951,-14.100316211930055
2022-06-30T09:30:00-04:00,127.86,128.97,126.89,128.24,10697670,9465562.65,52.04677573113759,42.13271835352553,NaN,NaN,33.50465147931582,34.4207756927053,0.758107417603296,-0.5164833957402521,-1.2745908133435482,1089594431,1093872751.6,61.1212391198037,47.8943410778538,NaN,NaN,-5.022180013892083,-12.803439612210346
2022-07-01T09:30:00-04:00,128.29,129.85,126.86,129.68,9366753,9455126.1,55.29669069132818,43.44182921145097,NaN,NaN,50.74975455694061,39.487812073377064,0.8180894314390552,-0.25197902404472927,-1.0700684554837845,1098961184,1095727069.2,62.24181066385992,47.582917425143926,NaN,NaN,-2.663373993704766,-11.354858809566691
2022-07-05T09:30:00-04:00,128.43,128.96,126.17,128.93,9987031,9661846.25,53.27164985460313,45.04369919203531,NaN,NaN,38.45250663167282,38.05316059679268,0.7746917578291853,-0.10170375819730282,-0.8763955160264881,1088974153,1093791261.2,60.2882683260461,47.68047701891064,NaN,NaN,-1.281004062758148,-9.915736702879757
2022-07-06T09:30:00-04:00,129.11,130.47,128.88,129.8,9033298,9727055.2,55.31588332245713,46.90536614382399,NaN,NaN,73.76562818100749,46.50036119959377,0.7703916128521402,0.08659400003868711,-0.6837976128134531,1098007451,1095165864,61.21907272289567,48.510753805412506,NaN,NaN,0.4697402171796469,-8.432097142871271
2022-07-07T09:30:00-04:00,129.61,130.52,129.54,130.35,6805503,9706376.8,56.60824878926857,48.5800996823599,NaN,NaN,83.8298683395236,56.060481837692066,0.7686449313409437,0.2770085513627265,-0.4916363799782172,1104812954,1096070034.6,61.852452314799756,49.7531174523506,NaN,NaN,2.297651466500108,-6.899275912961074
2022-07-08T09:30:00-04:00,129.98,132.0389,129.85,130.74,6505846,9763068.75,57.54589384946583,50.512020143276764,NaN,NaN,98.81272598578057,69.12209673898501,0.7566275517021948,0.4541480596495262,-0.3024794920526685,1111318800,1100414908.4,64.82539523867536,51.540397997368004,NaN,NaN,4.087661728187887,-5.329713392796937
2022-07-11T09:30:00-04:00,130.01,131.14,129.87,130.41,7027344,9725791.8,56.43464554820935,52.37190828121998,NaN,NaN,86.39035259727125,76.25021634705115,0.6911294431629356,0.561432311901001,-0.12969713126193458,1104291456,1101480962.8,65.53510982261332,53.684641140269314,NaN,NaN,5.31318274140992,-3.809299659338815
2022-07-12T09:30:00-04:00,130,130.88,128.17,128.75,9280413,9625361.25,51.09008249276288,53.23748486581543,NaN,NaN,57.19311479688736,79.99833798009405,0.5090914522432965,0.5066671840421861,-0.0024242682011104133,1095011043,1102688340.8,66.36290252181541,55.99557576642906,NaN,NaN,4.964212478908707,-2.555940782446312
2022-07-13T09:30:00-04:00,127.66,128.53,127.17,127.5,9296486,9345873.2,47.4462772668562,53.50783627513179,NaN,NaN,23.15054238480744,69.87532082085404,0.2885561728548053,0.3582709478673962,0.06971477501259092,1085714557,1100229762,63.0424059973991,57.98887999366669,NaN,NaN,3.634598655265986,-1.6715780056302694
2022-07-14T09:30:00-04:00,126.04,127.32,125.2286,127.13,7784950,9270145.5,46.39156506820806,53.22168285362095,NaN,NaN,-8.804156120886988,51.34851592877192,0.11095422890600261,0.20840756114509418,0.09745333223909157,1077929607,1094853092.6,56.396643739754346,59.398892722417735,NaN,NaN,2.228279367400683,-1.1144555237687048
2022-07-15T09:30:00-04:00,129.02,130.26,128.45,130.2,9684755,9239301.3,55.275385425771304,53.25567746445135,NaN,NaN,61.715812818699085,43.929133295355626,0.18885213163028391,0.33351849677694645,0.14466636514666253,1087614362,1090112205,51.26491950969566,60.04363114714181,NaN,NaN,3.5351388239332837,-0.45022775981127794
2022-07-18T09:30:00-04:00,130.33,130.445,127.02,127.45,7047900,9122531.7,47.656857817920276,52.67679386991568,NaN,NaN,18.50337429387021,30.35173763467542,0.05095961598606183,0.20836588512923981,0.15740626914317798,1080566462,1085367206.2,46.68604955693675,59.74646182937024,NaN,NaN,2.260789614930269,-0.06293956341962842
2022-07-19T09:30:00-04:00,128.81,129.835,128.25,129.62,6585773,8765561.95,53.14479161016984,52.87777555538441,NaN,NaN,46.9418906656479,28.301492808427533,0.09890915890020074,0.28104271776842893,0.18213355886822818,1087152235,1083795444.6,45.24446945267468,58.99768742335344,NaN,NaN,2.9676742219071404,0.37000526305562426
2022-07-20T09:30:00-04:00,129.44,129.61,127.82,128.34,7599526,8746179.4,49.82628633798992,52.6679309861534,NaN,NaN,3.8498793796761466,24.441360207401274,0.040430935336032064,0.23267222803826826,0.1922412927022362,1079552709,1082563075,44.094787038438454,57.86968043038628,NaN,NaN,2.4718726660586707,0.6702720349132023
2022-07-21T09:30:00-04:00,128.72,130.37,128.39,130.37,9507672,8712118,54.661540574368885,52.85469990352707,NaN,NaN,64.2623493106752,39.05466129371371,0.12945569165811907,0.35406090727488504,0.22460521561676597,1089060381,1084789229.8,46.72814140160611,56.841602021943594,NaN,NaN,3.6349239506358857,1.0937937371592998
2022-07-22T09:30:00-04:00,130.67,130.92,129.04,129.83,8657252,8547814.8,53.193019721214846,52.70443769137612,NaN,NaN,72.48788750782398,41.20907623153868,0.14195918161361454,0.40205419263378417,0.26009501102016963,1080403129,1083346983.2,45.24131234565049,55.62728071350006,NaN,NaN,4.105106821517841,1.5239813206390913
2022-07-25T09:30:00-04:00,129.93,130.75,129.81,130.51,5489039,8299861.4,54.83840408962955,52.816348708163716,NaN,NaN,94.51816917386132,56.4120352075369,0.18337916683655048,0.48931896956585774,0.30593980272930726,1085892168,1084412124.4,46.59286860183409,54.64903787605635,NaN,NaN,4.9868690370145305,2.0186795658355825
2022-07-26T09:30:00-04:00,130.88,131.985,130.53,131.18,7482401,8225801.6,56.4623526693832,52.89823937580129,NaN,NaN,141.54385441399282,75.3324279572059,0.23969601216565917,0.6055598179363813,0.3658638057707221,1093374569,1085656591.2,48.201509170647604,53.71921190803863,NaN,NaN,6.194494220375589,2.6152245164841545
2022-07-27T09:30:00-04:00,131.1,132.59,130.485,132,7680640,8233895.8,58.43242172525218,53.02853744265725,NaN,NaN,150.77707261538708,104.71786660434809,0.31142403259327134,0.7551438465123113,0.4437198139190399,1101055209,1089957091.2,53.42253599632176,53.11707502814734,NaN,NaN,7.782114157883551,3.3533516081126398
2022-07-28T09:30:00-04:00,132.17,133.805,129.92,132.84,11052782,8328651.7,60.40877921017325,53.233029254136355,NaN,NaN,158.8548635279325,123.63636944779955,0.38961793256426525,0.9307422296243715,0.5411242970601062,1112107991,1094566613.2,58.27694677471425,52.64932870929299,NaN,NaN,9.69533874959948,4.259349771182189
2022-07-29T09:30:00-04:00,132.17,132.64,131.47,132.4,8309561,8209246.25,58.830897906537395,53.404190136874085,NaN,NaN,141.70257590206094,137.47930712664692,0.38519083935585885,1.0226128462549298,0.6374220068990709,1103798430,1099245673.4,62.544365574683034,52.4357041201551,NaN,NaN,10.860617459467925,5.202388012365865
2022-08-01T09:30:00-04:00,131.66,132.38,131.115,131.42,7665402,8124178.7,55.36235621586031,53.70935254566676,NaN,NaN,98.3854118038305,138.25275565264076,0.29387111749808925,1.0047609037716825,0.7108897862735932,1096133028,1101293845.4,64.26721955464112,52.28601247964268,NaN,NaN,10.906583399633979,6.017273067689881
2022-08-02T09:30:00-04:00,131.74,132.8,130.88,130.95,7935081,8021581.2,53.726348920624204,54.157929092364476,NaN,NaN,84.31599696910956,126.8071841636641,0.18475312693753132,0.9418311949455074,0.7570780680079761,1088197947,1100258521,62.697308955001866,52.26136269090002,NaN,NaN,10.498508929485554,6.657449619374977
2022-08-03T09:30:00-04:00,131.66,132.67,131.3,132.15,6825710,7911201.8,57.20367352851567,54.93022255381501,NaN,NaN,99.54155785359077,116.56008121130485,0.17635408056547275,0.977520668714817,0.8011665881493443,1095023657,1099052210.6,60.832691486606734,52.578223244246615,NaN,NaN,11.09806428225872,7.291823142644083
2022-08-04T09:30:00-04:00,132.46,132.49,131.295,131.5,5493014,7845577.35,54.80141346957015,54.89636741408635,NaN,NaN,76.1833034614301,100.02576919800435,0.11305938436508878,0.9424908186057053,0.8294314342406165,1089530643,1094536741,54.320419949994964,52.79647327569658,NaN,NaN,10.949188387676788,7.814303891934469
2022-08-05T09:30:00-04:00,130.68,131.51,130.37,131.45,8883422,7964456.15,54.61142774783878,55.39312240908053,NaN,NaN,42.48435477609404,80.18212497281095,0.05670808400617622,0.9003165392483368,0.8436084552421605,1080647221,1089906499.2,48.57769750205546,52.9315909860622,NaN,NaN,10.775150107388248,8.23728192271358
2022-08-08T09:30:00-04:00,131.7,132.63,131.09,131.76,7075100,7966843.95,55.63829384729558,55.57122971173237,NaN,NaN,71.60377880729592,74.82579837350404,0.03050790770573819,0.8817433398743333,0.8512354321685951,1087722321,1088224357.8,46.648247401018075,53.03186083951529,NaN,NaN,10.889498079361164,8.616169945091807
2022-08-09T09:30:00-04:00,131.93,132.56,131.05,131.36,5802683,7792957.45,53.94246861394535,55.86524273144347,NaN,NaN,57.84834574674003,69.53226812903014,-0.020800746627072875,0.825234498884754,0.8460352455118268,1081919638,1086968696,45.20488025873438,53.111153212393575,NaN,NaN,10.555126255812018,8.893163703766122
2022-08-10T09:30:00-04:00,132.76,132.89,132.02,132.79,6736304,7664948.35,58.779523612357835,56.15938437701411,NaN,NaN,95.08365706321109,68.64068797095425,0.03167650978056258,0.8856308827375301,0.8539543729569675,1088655942,1085695153,43.72707395734623,52.89679125208931,NaN,NaN,11.546322589042562,9.272186401662756
2022-08-11T09:30:00-04:00,132.39,133.69,131.645,131.93,8471414,7699271.55,55.0360504337272,56.29102942790785,NaN,NaN,86.55525692807372,70.71507866428297,0.0002391725619154128,0.8542533386593618,0.8540141660974464,1080184528,1083825930,41.57858049906061,52.63516754876145,NaN,NaN,11.392597161693285,9.57510222452426
2022-08-12T09:30:00-04:00,132.25,133.68,132.03,133.62,7515511,7590809.35,60.37646334412286,56.68660508894309,NaN,NaN,120.25721825122307,86.26965135930877,0.08058828853129107,0.9547495267615602,0.8741612382302691,1087700039,1085236493.6,43.82177966832011,52.43723262493903,NaN,NaN,12.802822536593908,10.036205126248495
2022-08-15T09:30:00-04:00,133.55,134.47,133.07,134.29,7486084,7612718.55,62.2887546102578,57.10277665614842,NaN,NaN,169.02191773895623,105.75327914564082,0.1615132601607706,1.0760528134312324,0.9145395532704618,1095186123,1086729254,46.17707381126985,52.292630099269175,NaN,NaN,14.552017494998909,10.681321178927126
2022-08-16T09:30:00-04:00,134,134.38,133.41,133.93,7138443,7640352.05,60.59651887401902,57.25735502391747,NaN,NaN,161.04531874302336,126.39267374489748,0.17245663110397524,1.1301103421504308,0.9576537110464556,1088047680,1087954862.4,48.100974648589144,51.91251857443114,NaN,NaN,15.542635739777836,11.375794687620084
2022-08-17T09:30:00-04:00,133.15,133.92,132.95,133.15,7251754,7622963.45,56.984228353943834,57.012744248472515,NaN,NaN,112.08678022672505,129.79329837760025,0.1117667385679102,1.0973621342563433,0.9855953956884331,1080795926,1086382859.2,45.83776298180622,51.02400544636628,NaN,NaN,15.384915312959132,11.948526205525663
2022-08-18T09:30:00-04:00,133.11,133.38,131.845,132.56,7053785,7500269.1,54.3452334783183,56.692339646456865,NaN,NaN,46.586035616209074,121.79945411522733,0.02123058582209436,1.012133627966051,0.9909030421439567,1073742141,1085094381.8,44.009956152263115,49.70011905905057,NaN,NaN,14.510186225480377,12.314477636947766
2022-08-19T09:30:00-04:00,132.56,133.56,132.37,132.92,5946717,7364742.35,55.69353236129309,56.71599508541635,NaN,NaN,69.08634445368435,111.5652793557196,-0.022688178047054697,0.9625428195851384,0.9852309976321931,1079688858,1083492145.6,41.778959500424456,48.09381476946367,NaN,NaN,14.134180554312504,12.574435196571299
2022-08-22T09:30:00-04:00,132.1,132.52,130.74,131.18,6420368,7411308.8,48.27298954987682,56.32646941607726,NaN,NaN,-76.73039650471831,62.414816506984685,-0.1690511545928357,0.7739170543911484,0.9429682089839841,1073268490,1079108619,36.3498087284258,46.211850467565384,NaN,NaN,11.584262340364308,12.432981931398873
2022-08-23T09:30:00-04:00,130.6,130.74,128.985,129.35,7501923,7412284.9,41.943330103339356,55.23644488570752,NaN,NaN,-224.6989061730363,-14.734028476227246,-0.37730987785298553,0.4713308616677523,0.8486407395207378,1065766567,1074652396.4,31.822533029319956,44.1396962920449,NaN,NaN,7.252690631240453,11.692940317090526
2022-08-24T09:30:00-04:00,129.48,130.0069,129.04,129.51,6719608,7364233.3,42.65136201649609,54.368584067630806,NaN,NaN,-201.20746353220207,-77.39287722801267,-0.485589273098576,0.24165414814751784,0.7272434212460939,1072486175,1072990446.2,30.306507493047306,42.42441683083435,NaN,NaN,3.9774604625728682,10.590728909302289
2022-08-25T09:30:00-04:00,130.06,130.98,129.15,130.94,5636652,7093426.8,48.67588815171945,53.94461695362228,NaN,NaN,-117.35312936582612,-110.1807102244197,-0.44337218841766934,0.17302818572400724,0.6164003741416766,1078122827,1073866583.4,32.14183132272866,41.25042638945387,NaN,NaN,2.924987202705594,9.495622951217047
2022-08-26T09:30:00-04:00,130.98,130.99,127.19,127.29,9044717,7130184.6,37.7694691958097,52.66827233565899,NaN,NaN,-205.56013928317074,-165.1100069717907,-0.6322231123509257,-0.17387851629698048,0.4583445960539452,1069078110,1071744433.8,30.075847538530013,40.0666835421333,NaN,NaN,-2.025273085239863,7.849780660294631
2022-08-29T09:30:00-04:00,126.52,127.19,125.74,126.4,6727668,7083297.9,35.670713380581006,51.36314696184725,NaN,NaN,-248.39240351668997,-199.44240837418505,-0.7784253935629841,-0.514687145899785,0.2637382476631991,1062350442,1069560824.2,28.076093196396954,38.84319875196634,NaN,NaN,-6.6869126080951675,5.773110193381803
2022-08-30T09:30:00-04:00,126.85,126.85,125.25,125.56,7910498,7082068.75,33.76373621612413,49.57630500497341,NaN,NaN,-207.02926028638478,-195.90847919685476,-0.8852670944678612,-0.8428456204216275,0.042421474046233754,1054439944,1067295499.6,26.134687852348534,37.586599744466504,NaN,NaN,-11.075827071687417,3.3661191555147716
2022-08-31T09:30:00-04:00,125.97,126.76,124.74,124.76,8954532,7188509.85,32.00865772296616,47.93149123991906,NaN,NaN,-177.60575481823884,-191.1881374540621,-0.9572671183362766,-1.1541624238741122,-0.19689530553783546,1045485412,1061895347,22.194744559153094,36.20204003447311,NaN,NaN,-15.21484301312026,0.7116959885669099
2022-09-01T09:30:00-04:00,124.56,126.87,124.39,126.81,11212375,7474477.9,40.538319012232606,46.51448093049833,NaN,NaN,-132.20640812446425,-194.15879320578975,-0.8195925465298508,-1.221385988700149,-0.40179344217029817,1056697787,1057610339,19.661797252219486,34.47632700475163,NaN,NaN,-15.959191425497139,-1.6698593562993826
2022-09-02T09:30:00-04:00,127.54,127.66,124.445,124.99,9730278,7516820.7,36.196720985613545,44.65076424302374,NaN,NaN,-120.77063366239155,-177.20089208163387,-0.8028214705512057,-1.4053202803593052,-0.6024988098080996,1046967509,1053188218.8,17.448690184561258,32.42429960284388,NaN,NaN,-18.07440736402413,-4.0133662145457745
2022-09-06T09:30:00-04:00,125.48,126.68,124.76,125.11,9663569,7646244.15,36.678259754942445,42.94231716308969,NaN,NaN,-108.85680980930323,-149.29377334015652,-0.737073470651385,-1.5238406481223308,-0.7867671774709458,1056631078,1052044346,16.91821434610567,30.196959581237916,NaN,NaN,-19.558515285206614,-6.234101796068751
2022-09-07T09:30:00-04:00,125.08,127.36,124.68,127.15,9038440,7808032,44.36543156808809,42.04097453552857,NaN,NaN,-78.51934350237562,-123.59178998335469,-0.5198644484125026,-1.436597737986574,-0.9167332895740714,1065669518,1054290260.8,21.93645270688974,28.4897231330296,NaN,NaN,-18.291034494027418,-7.956520752919989
2022-09-08T09:30:00-04:00,126.68,129.4,126.42,129.36,9394760,7940954.8,51.26749953035072,41.821136396388034,NaN,NaN,-28.22901533578995,-93.71644208686493,-0.20707516844104012,-1.1755772501253716,-0.9685020816843315,1075064278,1060206034,33.355114545726565,27.728663018276986,NaN,NaN,-14.79242487222909,-8.93307848424986
2022-09-09T09:30:00-04:00,129.68,130.85,129.44,130.5,8880372,7961402.7,54.40949917735823,41.729419740392686,NaN,NaN,19.57886537442781,-63.35938738708651,0.08141210037499336,-0.8667369562155898,-0.9481490565905831,1083944650,1065655406.6,41.80026868464656,27.73018510286428,NaN,NaN,-10.886464512157566,-9.212133631093819
2022-09-12T09:30:00-04:00,131,132.05,130.65,131.37,7982550,7984754.65,56.70372946823236,42.33161544884665,NaN,NaN,50.23872902929429,-29.157514848749337,0.3221280361975484,-0.5454890113436477,-0.8676170475411961,1091927200,1074647344.8,52.49704419760216,28.883559064948304,NaN,NaN,-6.973829000007109,-8.89237582665286
2022-09-13T09:30:00-04:00,129.28,129.57,126.685,127.03,11928461,8206873.5,44.63649192586034,42.523984150455284,NaN,NaN,-35.41193906317419,-14.46854069952353,0.18705887541994537,-0.6337934532662644,-0.8208523286862097,1079998739,1079320877,56.92805672062199,30.676810757184164,NaN,NaN,-7.686216690237934,-8.720067378593585
2022-09-14T09:30:00-04:00,127.45,128.2,126.26,127.1,8080138,8253958.25,44.84038873468111,42.68034320175421,NaN,NaN,-45.16323857735756,-7.7973197145199125,0.10454499728031874,-0.6901710820858113,-0.7947160793661301,1088078877,1083802748.8,60.71276716127095,32.84868644777156,NaN,NaN,-8.151815349849867,-8.638888517344483
2022-09-15T09:30:00-04:00,127.65,129.0326,127.52,127.81,8624440,8322592.55,46.97355322840992,42.55874785008924,NaN,NaN,-11.651627368461815,-4.48184212105428,0.09990229162018893,-0.6698382148408939,-0.7697405064610828,1096703317,1088130556.6,64.00210524828748,35.1244202995972,NaN,NaN,-7.833164535188534,-8.523785091322205
2022-09-16T09:30:00-04:00,127.41,127.73,126.465,127.45,10810287,8510417.65,46.00212684167039,43.14679482479358,NaN,NaN,-35.56273458305435,-15.510162112550725,0.0757985087416666,-0.6749923705339995,-0.7507908792756661,1085893030,1088520232.6,64.29200173666425,37.568431313749635,NaN,NaN,-7.8759060018642195,-8.43123093568535
2022-09-19T09:30:00-04:00,126.14,126.29,124.455,126.26,9430349,8684599.25,42.84774950676911,43.659440262378446,NaN,NaN,-84.97724564694822,-42.553357047799224,-0.012380961288070425,-0.7662670808857541,-0.7538861195976837,1076462681,1085427328.8,60.151439528385765,39.85952748032027,NaN,NaN,-8.87609610600725,-8.494783102874193
2022-09-20T09:30:00-04:00,125.41,125.6,124.005,124.78,9010647,8814113.2,39.24359078635276,44.050858445966206,NaN,NaN,-110.63037129129597,-57.597043493423584,-0.15457822093517037,-0.9471088957666467,-0.7925306748314763,1067452034,1082917987.8,56.94700635847812,42.06040737361524,NaN,NaN,-10.85329681561226,-8.831713633265345
2022-09-21T09:30:00-04:00,125.28,126.11,122.68,122.71,11642390,9021136.55,34.83062579006992,44.252427593616474,NaN,NaN,-136.52856761487706,-75.87010930092748,-0.3604786759143557,-1.243129019724421,-0.8826503438100652,1055809644,1076464141.2,49.624717166516234,44.01969113128404,NaN,NaN,-14.011908980553969,-9.571741540020863
2022-09-22T09:30:00-04:00,122.52,124.2,122,123.36,9505590,9160435.65,37.218021645527344,44.01526349599467,NaN,NaN,-145.3158795892016,-102.60295974507544,-0.4211077681035402,-1.4090350539394905,-0.9879272858359502,1065315234,1070186524.6,43.734145346959004,45.73914456662258,NaN,NaN,-15.840645323287195,-10.467299223344625
2022-09-23T09:30:00-04:00,122.7,122.95,121.2,122.73,16611134,9709159.75,35.84730018069776,43.99030486707211,NaN,NaN,-166.7524731164047,-128.84090745174552,-0.4682321271743044,-1.5732174448038307,-1.1049853176295263,1048704100,1062748738.6,37.9815287960114,47.20577589601187,NaN,NaN,-17.755932643224025,-11.508532569041682
2022-09-26T09:30:00-04:00,122,122.59,121.02,121.56,10450594,9779453.6,33.38797474497187,43.75528450921707,NaN,NaN,-167.02230218112004,-145.24991875857987,-0.5378159871148918,-1.777255301523141,-1.2394393144082492,1038253506,1055106903.6,33.155993570414566,48.36561726917679,NaN,NaN,-20.130220458639812,-12.7402022675557
2022-09-27T09:30:00-04:00,122.41,123.2,120.7,121.19,13239875,10105063.95,32.625685589804576,42.916731225053965,NaN,NaN,-145.03342076269615,-152.1305286528599,-0.5655494036901321,-1.9463760690209142,-1.3808266653307821,1025013631,1046619223,28.782070531948435,48.85458997096669,NaN,NaN,-22.30061967340854,-14.105976182677534
2022-09-28T09:30:00-04:00,122.89,124.455,122.1,123.84,16359969,10527537.5,42.71377065237719,42.305750590913,NaN,NaN,-75.91678214590328,-140.00817155906515,-0.37157959539838803,-1.8453011595787672,-1.4737215641803791,1041373600,1043732014.2,27.45526119819428,48.43317187471439,NaN,NaN,-21.1608743732118,-15.113818781325286
2022-09-29T09:30:00-04:00,123.47,123.77,121.97,122.8,10791664,10619394.1,40.17159474674577,41.28875741729782,NaN,NaN,-86.8193972208209,-128.30887508538902,-0.2834589931622198,-1.8280453056331538,-1.544586312470934,1030581936,1036785354.6,24.525773330270425,47.19927934940181,NaN,NaN,-20.988647957713912,-15.953080092237947
2022-09-30T09:30:00-04:00,122.81,123.66,120.97,121.11,12389824,10678266.55,36.382240746596636,39.83722250860956,NaN,NaN,-101.03435377307814,-115.1652512167237,-0.30713747132163527,-1.928508151622978,-1.6213706803013428,1018192112,1030682957,22.277064373812024,45.04070936198823,NaN,NaN,-22.02859288335943,-16.821010490969588
2022-10-03T09:30:00-04:00,121.99,124.0701,121.62,123.6,9326783,10658091.8,44.664474281025726,39.839221248264224,NaN,NaN,-60.909639953545884,-93.94271877120886,-0.132190319030437,-1.786608579089389,-1.654418260058952,1027518895,1028536034.8,21.529173245297287,42.51221768517932,NaN,NaN,-20.19972341266586,-17.303683765497627
2022-10-04T09:30:00-04:00,124.63,126.52,124.335,126.47,13718048,10860815.75,52.36259065563891,40.37652138547549,NaN,NaN,11.513985403102042,-62.63323753804923,0.1826325123268746,-1.4261276196503587,-1.6087601319772333,1041236943,1031780697.2,25.594747604731367,40.003787716855065,NaN,NaN,-15.890648442351033,-17.101821576476684
2022-10-05T09:30:00-04:00,125.66,127.545,125.19,126.89,9913388,10904563.15,53.38461625177625,40.834454458573084,NaN,NaN,31.963811482546248,-41.05711881235933,0.4118536436491458,-1.0939430774158012,-1.505796721064947,1051150331,1033736043.4,28.01518256392056,37.43329323940029,NaN,NaN,-12.19886881973386,-16.401399754084853
2022-10-06T09:30:00-04:00,126.42,126.81,124.94,125.27,9399262,10904788.25,49.01638775453279,41.049758809491834,NaN,NaN,12.921737579159934,-21.10889185236316,0.4442784053447728,-0.950448714383981,-1.3947271197287539,1041751069,1035969870,30.78530283660359,35.039957603681664,NaN,NaN,-10.522072181253474,-15.561495815108941
2022-10-07T09:30:00-04:00,124.32,124.54,121.92,122.62,10068945,10964216.9,42.84099835103912,41.049276584082556,NaN,NaN,-56.62569961671182,-12.227161021089897,0.2849104614639353,-1.0385890428988347,-1.32349950436277,1031682124,1038667872.4,34.0846053045249,33.17804087340589,NaN,NaN,-11.156524569569989,-14.932214208603376
2022-10-10T09:30:00-04:00,122.91,123.08,121.38,121.85,8377954,10983987.1,41.216124199567496,41.1901718278836,NaN,NaN,-79.72563306569917,-15.990359643520554,0.13301273573527927,-1.157233584693671,-1.2902463204289503,1023304170,1037824927.4,33.546566649903966,31.506580894222022,NaN,NaN,-12.190835424998761,-14.540588668088432
2022-10-11T09:30:00-04:00,121.6,123.8,121.29,122.5,10792901,10927209.1,43.17543608696607,41.78622970623333,NaN,NaN,-59.7612373674389,-30.245404197628744,0.08407784749464442,-1.1851490110606449,-1.2692268585552893,1034097071,1036396953,32.6075374932863,30.29106806041989,NaN,NaN,-12.415823753257172,-14.237050823112538
2022-10-12T09:30:00-04:00,122.89,123.615,121.87,121.9,9292811,10987842.75,41.79075996728731,42.11285387207333,NaN,NaN,-58.04159666727691,-48.246485827593375,0.022279608578790855,-1.2413773478318006,-1.2636569564105915,1024804260,1031127738.8,29.34351427773551,29.263165841189636,NaN,NaN,-13.015243130230267,-14.0625068669865
2022-10-13T09:30:00-04:00,120.15,125.33,119.95,124.74,14063585,11259800,49.969689085406564,43.121595936695385,NaN,NaN,-15.326269204298578,-53.89608718428508,0.17514042026305576,-1.0447314310817717,-1.2198718513448275,1038867845,1030551094,29.001376478338898,28.621726389927314,NaN,NaN,-10.936743944307329,-13.61596930660376
2022-10-14T09:30:00-04:00,125.47,126.4,123.52,123.9,11444396,11291505.45,47.82905731954118,44.15310183487891,NaN,NaN,58.93902572007759,-30.783142116927195,0.21928396659355398,-0.9457668931028849,-1.1650508596964388,1027423449,1029699359,28.473287214035764,28.287247364471682,NaN,NaN,-9.903319318007776,-13.085590736804335
2022-10-17T09:30:00-04:00,124.69,126.14,124.54,125.89,8420426,11241009.3,52.969210500868485,45.60621075709776,NaN,NaN,110.3143421760672,7.22485293142608,0.37307575564886086,-0.6987061651353628,-1.0717819207842236,1035843875,1032207300,32.37787376913188,28.544090452841925,NaN,NaN,-7.37093041362429,-12.269210690635758
2022-10-18T09:30:00-04:00,127.76,127.8,125.97,126.59,10016876,11291320.75,54.66138547950397,46.459611816178246,NaN,NaN,157.58365626051523,50.6938316570169,0.5043558178560985,-0.44133714846410044,-0.945692966320199,1045860751,1034560036,35.912324050238084,29.148166370845058,NaN,NaN,-4.788316858679354,-11.200511571784842
2022-10-19T09:30:00-04:00,126.2,126.21,123.73,124.82,7676230,11093012.75,49.783737975167845,47.146193475351254,NaN,NaN,58.84922924705062,74.07199683988242,0.4558648894494388,-0.3758618545084005,-0.8317267439578393,1038184521,1037236088.2,39.76854972120517,30.236936113054686,NaN,NaN,-4.073806686078715,-10.182410873826825
2022-10-20T09:30:00-04:00,124.6,125.51,123.6,123.76,7196824,10977574.45,47.07458482280244,47.909932337937384,NaN,NaN,26.12847149231428,82.36294497920498,0.34151049447887816,-0.4048386258592416,-0.7463491203381197,1030987697,1035660058.6,38.306653302184024,31.381906750795537,NaN,NaN,-4.308763730412224,-9.343318424767597
2022-10-21T09:30:00-04:00,123.67,126.88,123.01,126.54,8433295,10568682.5,54.125436991405856,48.58571538867882,NaN,NaN,72.5334902087825,85.08183787694597,0.4361502585619145,-0.2011612971357266,-0.6373115556976411,1039420992,1038059567.2,41.813689841518595,32.83080079338277,NaN,NaN,-2.2379685169527326,-8.328268437936902
2022-10-24T09:30:00-04:00,127.6,129.37,127.6,128.98,7411288,10416717.2,59.2560596701971,49.07810603257583,NaN,NaN,185.2801468641125,100.07499881455502,0.6341302594706391,0.15535126864065774,-0.4787789908299813,1046832280,1040257248.2,44.90296919470883,34.20995947838116,NaN,NaN,1.2664654144902254,-6.957592173304455
2022-10-25T09:30:00-04:00,128.59,130.11,128.52,129.96,7174177,10113432.3,61.13609291139683,49.63178293683445,NaN,NaN,189.71793951657403,106.5018554657668,0.7918843796880661,0.5110764837801014,-0.28080789590796473,1054006457,1041886389.4,47.14331492428923,35.57625464697892,NaN,NaN,4.704036592868081,-5.291645206708378
2022-10-26T09:30:00-04:00,130.36,132.62,130.32,131.4,8277066,9709287.15,63.780714163261905,50.6863776803151,NaN,NaN,212.28201558873613,137.1884127341039,0.9437072262079444,0.8988261368519659,-0.04488108935597859,1062283523,1046706189.8,53.205592418577446,37.177703902834196,NaN,NaN,8.413565641096152,-3.3337579427363027
2022-10-27T09:30:00-04:00,131.7,131.72,130.515,130.71,6497027,9494555.3,61.6170530972563,52.02752444790203,NaN,NaN,167.75274101298243,165.51326663823752,0.9457711371996395,1.1373328321435707,0.19156169494393127,1055786496,1051665949.6,58.482541715265455,38.92041364645852,NaN,NaN,10.765229520783542,-1.319616876519182
2022-10-28T09:30:00-04:00,130.91,132.96,130.5,132.86,6267145,9188421.35,65.53981143813712,53.764930679228435,NaN,NaN,168.1215114237075,184.6308708812225,1.0329474166010049,1.4827459656951874,0.4497985490941825,1062053641,1056192479.4,62.62501243760848,40.99744548843741,NaN,NaN,14.054684974379441,0.8767119593234782
2022-10-31T09:30:00-04:00,132.17,133.27,131.87,132.75,7852874,9114725.9,65.17281770707515,55.33617222352194,NaN,NaN,151.57432267512678,177.88970604342535,1.0223183386686405,1.727696472429983,0.7053781337613426,1054200767,1057666176.8,63.88830567717033,43.23178607300055,NaN,NaN,16.56590971120999,3.1180259238786943
2022-11-01T09:30:00-04:00,132.91,133.57,131.41,132.83,8033434,8830495.2,65.32489111445008,57.01718159117643,NaN,NaN,127.09350853720001,165.36481984755056,0.9607392372308712,1.9063021802999316,0.9455629430690604,1062234201,1059311725.6,65.29874818832069,45.80001706661377,NaN,NaN,18.647473079228206,5.33651837464291
2022-11-02T09:30:00-04:00,132.52,134.03,130.5,130.57,10230651,8846358.35,57.66456757241639,57.566815768819986,NaN,NaN,93.16520867958347,141.54145846572004,0.7189306739853376,1.8442262855507323,1.1252956115653947,1052003550,1057255731,62.03839988401337,48.159804452733376,NaN,NaN,18.264385779122374,7.183356575282834
2022-11-03T09:30:00-04:00,129.62,130.74,128.7,130.02,7916588,8772224.65,55.94519442569822,58.1465398478312,NaN,NaN,50.2170370011779,118.03431766335912,0.4843233968561296,1.7306998576355568,1.2463764607794272,1044086962,1054915824.2,58.460851215833856,50.30177331000466,NaN,NaN,17.448942205443355,8.649868808162909
2022-11-04T09:30:00-04:00,131,131.28,128.97,130.81,8082235,8672889.15,57.88751561550395,58.49784735601945,NaN,NaN,54.29718875501923,95.2694531296215,0.35094004601544637,1.6850515182987351,1.3341114722832887,1052169197,1052938935.4,55.54644811093711,51.95667147727647,NaN,NaN,17.302451030506262,9.885951982783387
2022-11-07T09:30:00-05:00,131.02,132.56,130.53,132.21,6054386,8556710.75,61.155936954695015,58.96174388996167,NaN,NaN,75.12353500964385,79.9792955965249,0.32612297837175186,1.7417651952479787,1.4156422168762268,1058223583,1053743498.6,56.49697959026016,53.427004015849484,NaN,NaN,18.109146647998845,11.060694077814167
2022-11-08T09:30:00-05:00,132.24,133.89,131.33,132.87,8930880,8463609.7,62.62848169890039,59.879225584513996,NaN,NaN,87.6673097900433,72.09405584709356,0.3226857339909617,1.818999384364929,1.4963136503739674,1067154463,1054727551,57.68865936061375,54.7070118472358,NaN,NaN,19.202788095624395,12.22385036607277
2022-11-09T09:30:00-05:00,132.66,133.55,131.28,131.44,8963460,8447142.15,57.53889892527941,60.62667659183377,NaN,NaN,69.67773399998437,67.39656091117372,0.1987147512262677,1.744707089406802,1.5459923381805343,1058191003,1055965041.6,59.20217036583186,56.1995487803535,NaN,NaN,18.692214390429903,13.14790236955236
2022-11-10T09:30:00-05:00,134.47,135.05,132.66,134.78,12416829,8364804.35,64.74535518392264,61.38524217701354,NaN,NaN,112.19527210046685,79.7922079310315,0.30965166543434597,1.9330569199734668,1.6234052545391209,1070607832,1061269215.6,64.98389232856184,57.85456324371374,NaN,NaN,20.498488238499643,14.197986065116257
2022-11-11T09:30:00-05:00,134.61,134.63,131.4,133.13,10487243,8316946.7,59.383461786937644,61.3943423282093,NaN,NaN,79.87523552925742,84.90781728587913,0.24285290095359757,1.9269713807311177,1.6841184797775202,1060120589,1062859494,66.5160278995113,59.39835315119963,NaN,NaN,20.299375242632227,15.069613090475682
2022-11-14T09:30:00-05:00,133.53,134.84,133.2,133.25,10537222,8422786.5,59.64521174193518,61.28785081610489,NaN,NaN,93.42511085487054,88.56813245492448,0.180558312068698,1.9098163698633925,1.7292580577946945,1070657811,1065346339.6,68.8140226439884,60.94626084546386,NaN,NaN,20.220110203162662,15.805398392288108
2022-11-15T09:30:00-05:00,134.1,134.66,131.97,133.08,8184215,8331153.45,59.064497360445266,60.950978187332275,NaN,NaN,73.89918898423159,85.81450829376215,0.10543378704964002,1.8610502916067446,1.7556165045571046,1062473596,1064410166.2,66.95123724518574,61.928092618793016,NaN,NaN,19.98865287374285,16.40300617535307
2022-11-16T09:30:00-05:00,133.41,134.305,132.79,133.02,6122194,8253451.65,58.84672822293927,60.75309783916678,NaN,NaN,75.85869719297898,87.05070093236107,0.0329854964499694,1.7968483751195663,1.763862878669597,1056351402,1064042246,66.19287078957237,62.47883040981494,NaN,NaN,19.73904359504014,16.87958294959408
2022-11-17T09:30:00-05:00,131.97,133.5,131.86,132.96,6498840,8218552.45,58.61399636582721,60.25839676257321,NaN,NaN,51.617867951193034,74.93522010250629,-0.034062703773257264,1.7212844989530254,1.7553472027262826,1049852562,1059891192,58.18493641237455,62.16168212229824,NaN,NaN,19.469984029436617,17.249640246714442
2022-11-18T09:30:00-05:00,134.09,134.8,133.65,134.57,6720662,8132920.8,62.85872236444175,60.09310423809939,NaN,NaN,125.10830802345781,83.98183460134638,0.012441679849508835,1.7708993025381687,1.75845762268866,1056573224,1059181719,56.917525413929496,61.66376924635246,NaN,NaN,20.385023208183977,17.697552098352947
2022-11-21T09:30:00-05:00,134.29,135.21,134.14,134.63,7995562,8162134.5,63.0109799900029,59.92782487206745,NaN,NaN,134.90531078735162,92.2778745878426,0.0287350504910191,1.7943764358024339,1.7656413853114148,1064568786,1057963914,54.71442003201975,60.90774580661668,NaN,NaN,21.185697271187593,18.19585855161504
2022-11-22T09:30:00-05:00,134.95,135.9,134.93,135.8,5931101,8099980.7,65.94288169679986,60.5191330238092,NaN,NaN,174.23214195948302,112.34446518289288,0.0960107319129837,1.8856548002026443,1.7896440682896606,1070499887,1059569172.2,57.07310822131929,60.55308211642425,NaN,NaN,22.69933553331437,18.839212406143513
2022-11-23T09:30:00-05:00,135.82,136.54,135.475,136.34,5340732,7953164,67.23378993893152,61.32546127475443,NaN,NaN,175.72925805771325,132.31857735583975,0.151290479568559,1.9787571677503593,1.8274666881818002,1075840619,1063467015.6,62.218870394576186,60.82151205776298,NaN,NaN,24.345971716654375,19.625892307645064
2022-11-25T09:30:00-05:00,136.5,137.26,136.475,137.15,3255961,7791110.7,69.1243050769257,62.12808909342742,NaN,NaN,186.7884179550114,159.35268735660344,0.21303950024655505,2.093766063489994,1.8807265632434391,1079096580,1069315819.2,68.34977315891994,61.73603527547605,NaN,NaN,26.30122977136267,20.57951194531901
2022-11-28T09:30:00-05:00,136.73,137.54,135.85,136.12,5026871,7729097,64.06261554542601,62.33570899276534,NaN,NaN,139.51226473194419,162.23347869830067,0.15769628868601115,2.077846924100953,1.920150635414942,1074069709,1072815116.2,71.34574083801866,62.79666107888737,NaN,NaN,26.63541817883665,21.4446414072501
2022-11-29T09:30:00-05:00,135.83,136.05,135.05,135.78,5439633,7608434.95,62.43730902380326,62.32205380168697,NaN,NaN,88.07105833869431,152.86662820856924,0.07553788330575317,2.0145729895471334,1.9390351062413802,1068630076,1073627374.2,72.00809553508205,63.81947794849225,NaN,NaN,26.47809626114988,22.16370638637864
2022-11-30T09:30:00-05:00,135.98,139.11,135.26,139.02,9377430,7675634.75,70.19695669318463,63.226200785108766,NaN,NaN,152.82264451622856,148.58472871991836,0.20917418365773743,2.200502835813552,1.9913286521558144,1078007506,1075128898,73.23954836467166,64.82214780555223,NaN,NaN,28.740874500006502,23.10330183118262
2022-12-01T09:30:00-05:00,139.82,140.16,138.67,139.42,15140193,7921111.85,70.99362658259795,63.672505885014154,NaN,NaN,181.58810870268402,149.75649884891249,0.2893420737182284,2.3530062443036,2.0636641705853718,1093147699,1078590314,75.87447411836335,65.60004650482377,NaN,NaN,30.821536903392904,24.205906841498376
2022-12-02T09:30:00-05:00,138.02,139.965,138.02,139.78,7779758,7914270.35,71.7261638415044,64.55412746034035,NaN,NaN,154.0259259881945,143.2040004555491,0.32858229112854165,2.4743920344960486,2.145809743367507,1100927457,1082956489.4,78.7206709956744,66.47180672597828,NaN,NaN,32.74774904470643,25.426170013385242
2022-12-05T09:30:00-05:00,138.88,139.2,137.965,138.44,6921643,7856240.75,65.1325797922317,64.9460823210758,NaN,NaN,115.02182156995646,138.30591182315158,0.23087386518760766,2.4344020748520165,2.203528209664409,1094005814,1086943710.4,80.93288413608315,67.33743968969934,NaN,NaN,32.47420004892219,26.43303144703338
2022-12-06T09:30:00-05:00,138.18,138.62,136.7145,137.39,8171529,7962097.9,60.443749403572106,65.04460032415629,NaN,NaN,74.89071979605454,135.6698441146236,0.07043163414090525,2.2915677523405407,2.2211361181996354,1085834285,1090384552.2,82.61276556502519,68.45612028397359,NaN,NaN,30.821480744103464,27.059952775186247
2022-12-07T09:30:00-05:00,137.39,138.915,137.35,138.52,7427063,7886907.05,63.48991115349618,65.3762562477675,NaN,NaN,88.96933504207759,122.89918221979342,0.01804169546085399,2.243688237525703,2.225646542064849,1093261348,1093435320.6,83.96195882997237,69.72534085828786,NaN,NaN,30.31112823110778,27.524406411746465
2022-12-08T09:30:00-05:00,138.76,139.93,138.49,139.77,6765133,7776990.7,66.55786026091849,65.94367509741689,NaN,NaN,114.67716459719763,109.51699339869614,0.043740206456029274,2.2803218001348853,2.236581593678856,1100026481,1094811077,84.54439281993058,71.60815917311331,NaN,NaN,30.807355917677455,27.993399198308037
2022-12-09T09:30:00-05:00,139.58,140,137.94,137.98,6202991,7466298.8,58.92227284698269,65.6625001318841,NaN,NaN,80.24427540504395,94.76066328206603,-0.07706950431215187,2.1402447132886664,2.2173142176008183,1093823490,1093390283.6,81.26224398372736,73.34706764238457,NaN,NaN,28.79050089500223,28.10727086926435
2022-12-12T09:30:00-05:00,138.07,139.45,138.07,139.45,5669673,7225420.3,62.70608893824332,65.64072219961555,NaN,NaN,84.05464204546037,88.56722737716683,-0.07515344444315364,2.1233724120468764,2.19852585649003,1099493163,1094487753.4,81.84842808212358,75.28521107453484,NaN,NaN,28.286656897389584,28.132897444710814
2022-12-13T09:30:00-05:00,141.35,141.77,138.91,139.88,9886543,7192886.35,63.7577471187549,65.48464115832662,NaN,NaN,113.39570976371415,96.26822537069874,-0.06261477262501725,2.1202573907087583,2.1828721633337755,1109379706,1099196837.6,84.14099006109714,77.21863120594755,NaN,NaN,28.20586630703334,28.143321567899747
2022-12-14T09:30:00-05:00,139.82,141.28,138.92,140.1,10882243,7327787.75,64.31223861321106,65.27595892077517,NaN,NaN,102.06778480312904,98.88791532290904,-0.05733434899646506,2.1112042270881943,2.1685385760846594,1120261949,1104596957.8,86.280851515224,78.93734414313667,NaN,NaN,28.303480458447922,28.16620140940663
2022-12-15T09:30:00-05:00,138.85,139.2,137.04,137.53,8747994,7459077.75,53.931719040472764,64.19077420388567,NaN,NaN,19.43784265269563,79.84005093400864,-0.2348006687219728,1.8750377401821936,2.1098384089041664,1111513955,1106894452.6,87.07961955560731,80.27519031432863,NaN,NaN,25.028668368946633,27.71798240362663
2022-12-16T09:30:00-05:00,136.49,136.58,134.78,135.53,10843898,7676330.65,47.50556009559583,63.008127386040655,NaN,NaN,-85.21556897608211,46.748082057783414,-0.4805948024644855,1.5090949058235594,1.989689708288045,1100670057,1108263766,87.54506418301438,81.43228483897119,NaN,NaN,20.00087090679622,26.615537904079428
2022-12-19T09:30:00-05:00,134.93,135.18,133.86,134.47,6801724,7680383.75,44.48047778290104,61.725496583119075,NaN,NaN,-135.8060439993844,2.7759448488144587,-0.6952465748990373,1.1206314896642482,1.8158780645632855,1093868333,1107138800,84.8409835567337,82.34891969766059,NaN,NaN,14.877868918764165,24.938728049034392
2022-12-20T09:30:00-05:00,134.52,134.96,133.71,134.44,4815535,7521382.4,44.39431490730253,59.88245074127035,NaN,NaN,-139.50129973656826,-47.80345705124203,-0.8118097166769924,0.8011159187170449,1.6129256353940373,1089052798,1103073418.4,75.73679024873461,82.52729411795079,NaN,NaN,10.835684016480517,22.924007472955267
2022-12-21T09:30:00-05:00,135.26,136.63,134.84,136.21,5937459,7521700.3,50.488223622285446,58.417779101248016,NaN,NaN,-74.7693204010172,-83.17087809207126,-0.7440602991201692,0.6828502614938259,1.4269105606139951,1094990257,1098019080,66.22225799850469,81.83785010938946,NaN,NaN,9.204303443253258,20.96404975442641
2022-12-22T09:30:00-05:00,135.45,136.06,134.26,136.02,5483301,7528828.75,49.85659129575369,56.85566677655154,NaN,NaN,-90.6685082714245,-105.1921482768953,-0.6877256336718727,0.5672535185241543,1.254979152196027,1089506956,1093617680.2,59.242719309538806,80.44656784609408,NaN,NaN,7.709857975384257,19.070593785991814
2022-12-23T09:30:00-05:00,135.89,136.23,135.095,136.1,3766896,7554375.5,50.13943888989123,55.78472814067008,NaN,NaN,-69.4887882387951,-102.0467921294379,-0.6227004348936347,0.47660360857898354,1.0993040434726182,1093273852,1092138439.2,57.06585257042375,78.74177987711839,NaN,NaN,6.579166742562135,17.286104208359003
2022-12-27T09:30:00-05:00,136.36,136.47,135.21,135.75,7050478,7655555.85,48.84139482917708,54.9559885282133,NaN,NaN,-66.28388776287635,-88.14236088213629,-0.5816592417479148,0.3722299912877247,0.9538892330356395,1086223374,1090609447.4,54.823447310643274,76.75682857323397,NaN,NaN,5.2738947378440395,15.570074283999723
2022-12-28T09:30:00-05:00,136.2,136.86,134.82,134.87,5054288,7636288.6,45.64195797688491,53.681134729883915,NaN,NaN,-77.55032965624969,-75.75216686607259,-0.5902998486012057,0.21601442228413248,0.8063142708853381,1081169086,1089032705,52.531028463330166,74.51176211847381,NaN,NaN,3.2411363457205975,13.808797435674133
2022-12-29T09:30:00-05:00,135.71,137.045,135.4,136.34,6297337,7482283.95,51.372394609215476,52.59645861190513,NaN,NaN,-43.33216187853139,-69.46473516157542,-0.47831016757638767,0.2084265614148535,0.6867367289912412,1087466423,1087527938.2,50.36650363689711,72.07048431968572,NaN,NaN,3.0807296342649746,12.27621632118711
2022-12-30T09:30:00-05:00,135.88,136.02,134.47,135.85,6369600,7043754.3,49.499189116760604,51.923381202603544,NaN,NaN,-67.52495623211163,-64.83602475371285,-0.4205748986986284,0.1610181056179556,0.581593004316584,1081096823,1085845911.6,47.986309605801004,69.69363186411954,NaN,NaN,2.414095460557427,10.867341912525728
2023-01-03T09:30:00-05:00,135.96,136.33,134.43,135.46,7239269,7016729.85,47.999016741366475,50.87287604568377,NaN,NaN,-62.850395459195866,-63.508346197793,-0.39253148082014755,0.09092865329139954,0.4834601341115471,1073857554,1081962652,42.94096737443532,66.9145275278561,NaN,NaN,1.4378772161762852,9.52027552733295
2023-01-04T09:30:00-05:00,136.22,136.57,134.94,135.82,8469936,7094144.5,49.51986594992829,49.855884533624724,NaN,NaN,-43.79390589726028,-59.01034982466979,-0.3358105157170324,0.06369698946525659,0.399507505182289,1082327490,1081183475.2,41.98704537481926,63.903531478836236,NaN,NaN,1.026756895838477,8.30691572283374
2023-01-05T09:30:00-05:00,134.92,135.25,133.895,134.43,6714235,7021279.8,44.15067410031131,48.415772782703314,NaN,NaN,-86.94839067332208,-60.88996202808424,-0.3750039578956747,-0.06924744218730439,0.3057565157083703,1075613255,1080072309,40.60183913350911,60.64074488014232,NaN,NaN,-0.8820368148092823,6.9942082174561655
2023-01-06T09:30:00-05:00,135.33,136.04,133.61,135.67,7175745,7008713.9,49.419393424122134,48.093463810106854,NaN,NaN,-59.5373135881646,-64.13099237001089,-0.3035649416685625,-0.07369966137733286,0.22986528029122966,1082789000,1079136824.4,39.42264004870965,57.23667491536393,NaN,NaN,-1.0123602134295786,5.850412727329631
2023-01-09T09:30:00-05:00,135.81,135.85,133.215,133.4,7719462,7056430.35,41.66952193217793,47.67660394129128,NaN,NaN,-97.69379956602886,-70.16476103679433,-0.3898367091907013,-0.25743060619714697,0.13240610299355432,1075069538,1077931367.4,37.895331096807425,53.690265409206276,NaN,NaN,-3.627680089085967,4.496399467841688
2023-01-10T09:30:00-05:00,133.35,134.725,133.15,134.52,7675320,7130046.8,46.1560544118598,47.79628798621691,NaN,NaN,-96.74917231594111,-76.94451640814339,-0.3532056349324063,-0.3091009406719536,0.04410469426045273,1082744858,1079708828.2,41.49456754569605,50.594092836989304,NaN,NaN,-4.375069068710351,3.2290468197628255
2023-01-11T09:30:00-05:00,134.61,135.3,133.99,135.28,7307184,7211922.35,49.021440154581455,48.12679693245112,NaN,NaN,-58.952035770780846,-79.9761423828475,-0.26363103379865016,-0.28543409798786,-0.021803064189209825,1090052042,1081253738.6,44.504993716758996,48.36325022756247,NaN,NaN,-4.083127066525026,2.1844505502931324
2023-01-12T09:30:00-05:00,134.99,135.41,133.54,134.85,7580538,7096622.1,47.481821595762455,47.912053930556624,NaN,NaN,-73.85899008484965,-77.358262265153,-0.22091025580225854,-0.297940883942033,-0.07703062813977446,1082471504,1082625388.4,47.10726427580304,46.99789353308379,NaN,NaN,-4.309234570749686,1.2567812472870157
2023-01-13T09:30:00-05:00,134.11,135.86,134.05,135.45,6334065,6869213.2,49.84870415225747,47.91149056316404,NaN,NaN,-20.05924053463729,-69.46264765444754,-0.14356034732360792,-0.25648106229428436,-0.11292071497067643,1088805569,1083828702.2,49.3510893097335,46.29134853309769,NaN,NaN,-3.7918917443784275,0.5355422484776667
2023-01-17T09:30:00-05:00,135.38,135.6121,134.64,134.82,6664139,6765020.45,47.431528783650286,47.71806841271825,NaN,NaN,-18.28419708149239,-53.58072715754025,-0.1267289041784074,-0.2713318451936857,-0.1446029410152783,1082141430,1085243080.6,51.932267550142114,45.92466388879187,NaN,NaN,-4.05826202840655,-0.12071550536293563
2023-01-18T09:30:00-05:00,134.82,135.17,132.795,132.92,10629147,6754282.9,40.977929023618834,47.15639228374981,NaN,NaN,-164.7759156290206,-67.18607582015616,-0.22947118697020463,-0.4314419247280341,-0.20197073775782948,1071512283,1082996565.6,47.76822304352714,45.42071929828357,NaN,NaN,-6.316701322029659,-1.0058563363153246
2023-01-19T09:30:00-05:00,132.53,133.77,132.26,133.24,9902281,6909310.75,42.39941589570291,46.92478213509395,NaN,NaN,-191.84049589492207,-93.7637678449844,-0.2595758194862269,-0.526440512115613,-0.26686469262938617,1081414564,1081269070,44.793892757610195,44.868066747875,NaN,NaN,-7.723642253133573,-1.9655400387179314
2023-01-20T09:30:00-05:00,133.54,134.01,132.52,133.91,5962205,6966644.25,45.36628670851129,46.4957744279008,NaN,NaN,-137.12968113495182,-106.41790605500482,-0.21964663731687084,-0.5414229892754747,-0.3217763519586039,1087376769,1082250123,46.819084375929165,44.61467965780586,NaN,NaN,-8.030462823860198,-2.831957579452541
2023-01-23T09:30:00-05:00,133.99,135.12,133.69,134.37,7211043,7030323.45,47.37061010725877,46.34373307007923,NaN,NaN,-45.92665796881254,-111.59138954183989,-0.15081586087768561,-0.5102961780557109,-0.3594803171780253,1094587812,1083406571.6,49.18546968335199,44.700333949059505,NaN,NaN,-7.70632612551639,-3.528295943175948
2023-01-24T09:30:00-05:00,133.7,134.48,132.62,133.48,5754776,7043897.2,44.00671182588359,46.05856843325903,NaN,NaN,-111.41250316706805,-130.21705075895503,-0.15328845440549255,-0.551090885184891,-0.3978024307793985,1088833036,1084744892.8,51.855376771816935,45.33707747744391,NaN,NaN,-8.398706663366326,-4.224068903203145
2023-01-25T09:30:00-05:00,132.59,133.55,132.21,133.52,5999062,7155505.5,44.198505542480596,45.678471261298476,NaN,NaN,-131.96467906820254,-123.6548034467914,-0.1406231986692048,-0.5735814291159045,-0.4329582304466997,1094832098,1089408855.8,59.785353462871065,46.60838519801904,NaN,NaN,-8.911293636332859,-4.89367243650739
2023-01-26T09:30:00-05:00,133.83,133.95,132.73,133.77,6861168,7146040,45.4560113440398,45.77170963585052,NaN,NaN,-89.50244623306968,-103.18719351442091,-0.10541154780048706,-0.5647226651973085,-0.45931111739682146,1101693266,1093464596.2,65.15948637451552,48.36250285809092,NaN,NaN,-9.004286106481592,-5.480902960789418
2023-01-27T09:30:00-05:00,133.57,133.71,132.69,132.86,5854552,7186053.2,41.76642609788823,45.2250691125481,NaN,NaN,-109.86350987846839,-97.73395926312425,-0.13170234197050462,-0.6239390448599522,-0.4922367028894476,1095838714,1095156985.2,67.13325212601912,50.341832292184456,NaN,NaN,-10.103727873799091,-6.1413065197908
2023-01-30T09:30:00-05:00,132.61,133.44,131.455,131.66,7055400,7223956.35,37.4496589017429,44.92365032465988,NaN,NaN,-164.3345511323212,-121.41553789582596,-0.2133704165457364,-0.758949723571618,-0.5455793070258816,1088783314,1093996085.6,64.43661249933956,52.23763810665104,NaN,NaN,-12.347535848346151,-7.027910709584422
2023-01-31T09:30:00-05:00,131.96,133.38,131.83,133.36,6290643,7220008.5,45.96935025718087,44.91031431361139,NaN,NaN,-98.47665329213449,-118.82836792083927,-0.1399091828124771,-0.720465785541478,-0.5805566027290009,1095073957,1095244269.8,66.01718102907655,53.98925335546393,NaN,NaN,-11.758180716624754,-7.703663567733041
2023-02-01T09:30:00-05:00,133.36,134.81,132.36,133.99,11843040,7450197.05,48.754972499145936,44.891280909651705,NaN,NaN,-23.334927884129016,-97.10241768402456,-0.04103288220334467,-0.6318477054831817,-0.590814823279837,1106916997,1097661249.6,68.89958845520424,55.73172440821003,NaN,NaN,-10.411377531147282,-8.09047984822079
2023-02-02T09:30:00-05:00,133.01,133.258,132.13,133.08,11274699,7590435.2,45.13518724901657,44.72366417059843,NaN,NaN,-93.11555919035006,-97.82504027548063,-0.029595849151944353,-0.6278096347197675,-0.5982137855678231,1095642298,1096451056,65.88618791972127,57.07307609706133,NaN,NaN,-10.36256410173341,-8.415063313008307
2023-02-03T09:30:00-05:00,133.17,133.6,132.25,132.69,10046771,7757062,43.639797114511865,44.28017081075946,NaN,NaN,-83.3864955497466,-92.52963740973628,-0.04031096308492477,-0.648602489423979,-0.6082915263390543,1085595527,1094402418.6,61.02084579492744,57.90663013171804,NaN,NaN,-10.764311780994712,-8.750670237006364
2023-02-06T09:30:00-05:00,132.5,132.78,131.77,131.95,7328283,7764688.9,40.872700090430264,43.81168304695803,NaN,NaN,-135.66508205970854,-86.79574359521374,-0.08659321510829532,-0.7165330452244234,-0.6299398301161281,1078267244,1092299204.6,56.414928880706476,58.226820226758356,NaN,NaN,-11.925424090117936,-9.20420650173659
2023-02-07T09:30:00-05:00,131.49,133.19,131.025,132.8,7551007,7756266.15,45.17308531476514,44.1113370677542,NaN,NaN,-108.17012114047976,-88.73443716488279,-0.05107461918459033,-0.693783104096866,-0.6427084849122757,1085818251,1090448063.4,52.648217739443695,58.575391276466675,NaN,NaN,-11.640998514585267,-9.552319646429257
2023-02-08T09:30:00-05:00,132.32,133.15,132.21,132.41,5614147,7653207.5,43.60598854653723,44.19752082852808,NaN,NaN,-77.29258858512702,-99.52596930508238,-0.04516427374890153,-0.6991638270984026,-0.6539995533495011,1080204104,1085105484.8,43.60021093051237,58.49012828881683,NaN,NaN,-11.857211769339134,-9.881589949702096
2023-02-09T09:30:00-05:00,132.74,133.245,131.04,131.25,8085922,7692144.4,39.24505861483149,43.76029025040809,NaN,NaN,-132.00385768274757,-107.3036290035619,-0.10715829881001393,-0.7879474268620186,-0.6807891280520046,1072118182,1080400661.6,37.48993281499893,57.82376032017895,NaN,NaN,-13.357780684642279,-10.378188626122123
2023-02-10T09:30:00-05:00,131.43,132.625,131.25,132.49,6198653,7623050.15,45.51752289411437,43.62792687804063,NaN,NaN,-99.80962400742399,-110.58825469509739,-0.05505700993700824,-0.7496103904732649,-0.6945533805362567,1078316835,1078944923.2,35.817339249523684,56.868893860619785,NaN,NaN,-12.727418477127243,-10.713792890551426
2023-02-13T09:30:00-05:00,132.51,133.595,132.51,133.59,6300295,7621361.65,50.408744885224344,44.085214953707826,NaN,NaN,17.485798740036735,-79.95807853514833,0.05701678878840044,-0.6232823945507562,-0.6802991833391566,1084617130,1080214900.4,38.39935158369879,55.90774920432563,NaN,NaN,-10.631655201764522,-10.70205893501044
2023-02-14T09:30:00-05:00,133.77,134.01,132.13,132.8,6905994,7633454.4,47.13585772207366,44.29502582367877,NaN,NaN,0.7606034120199794,-58.171933624648375,0.08005976369600887,-0.5802244787191455,-0.6602842424151544,1077711136,1078593477.4,36.386701077577186,54.23641689109036,NaN,NaN,-9.893551065693096,-10.586557810822248
2023-02-15T09:30:00-05:00,132.28,132.455,131.69,132.14,6491948,7426594.45,44.53436881932626,44.22919421477065,NaN,NaN,-104.74139805996207,-63.661695519615385,0.05420581612732667,-0.592526972255996,-0.6467327883833227,1071219188,1076796494.2,34.244465447488864,52.02820111058845,NaN,NaN,-10.076446602891236,-10.513684781117817
2023-02-16T09:30:00-05:00,130.93,131.985,130.54,130.82,8008010,7331880.9,39.802861289786264,44.088939585620516,NaN,NaN,-189.16636709508282,-75.09419740208243,-0.0431836726448257,-0.7007123791893548,-0.6575287065445291,1063211178,1075015093.4,32.219376968385575,49.5343528850432,NaN,NaN,-11.739825346372774,-10.688847719011383
2023-02-17T09:30:00-05:00,130.2,132.23,130.08,131.99,10434450,7555493.15,45.34561822581092,44.65293668019681,NaN,NaN,-132.01928913764033,-81.53613042812569,-0.021300527608533737,-0.6841543660551963,-0.6628538384466626,1073645628,1074080852,31.178055582625646,47.15874167670649,NaN,NaN,-11.378025170716585,-10.787301640683555
2023-02-21T09:30:00-05:00,131.03,131.57,130.0899,130.28,9066218,7648251.9,39.60573572151731,44.19839278479226,NaN,NaN,-187.11040779659845,-122.45537173545272,-0.10955308060281577,-0.7997951892001822,-0.6902421085973665,1064579410,1070073308,27.127770226773976,44.38092661939917,NaN,NaN,-12.989789967277796,-11.101942830197018
2023-02-22T09:30:00-05:00,130.42,130.73,129.57,129.84,7318937,7726459.95,38.26360502471668,43.44900939376161,NaN,NaN,-207.24062096015714,-164.05561660988815,-0.1809120841017664,-0.9163822137245745,-0.7354701296228081,1057260473,1065983175.4,23.738312583944477,41.15512120002347,NaN,NaN,-14.707217502647424,-11.616982069118505
2023-02-23T09:30:00-05:00,129.81,130.85,129.235,130.19,9955508,7924282.25,40.00521255788685,43.082582630109485,NaN,NaN,-172.20208068998016,-177.54775313589175,-0.18711349153055878,-0.9693619940360065,-0.7822485025054478,1067215981,1065182534,23.129111863970266,38.101044338898404,NaN,NaN,-15.558666188622652,-12.180079800476241
2023-02-24T09:30:00-05:00,129.09,129.34,128.13,128.51,9008017,8031624.7,34.91386364004707,42.45930166764771,NaN,NaN,-224.09745477104,-184.53397067108318,-0.2812736800837159,-1.1338406026100927,-0.8525669225263768,1058207964,1064181891.2,22.356880417845673,35.33933252624971,NaN,NaN,-17.9663008911759,-13.006682813433335
2023-02-27T09:30:00-05:00,129.21,129.57,127.83,128.12,6463899,8062092.05,33.83727049443387,41.956770982219396,NaN,NaN,-185.91090019089745,-195.31229288173463,-0.3426628299870471,-1.2808954600101856,-0.9382326300231385,1051744065,1059801578.6,19.316501504837504,32.68944485654478,NaN,NaN,-20.242870366746427,-14.040423892478062
2023-02-28T09:30:00-05:00,127.83,127.91,127.06,127.17,10282751,8223459.6,31.304994637343555,40.96619307668929,NaN,NaN,-196.13869671494967,-197.11795066540486,-0.41525050090129856,-1.4572957561497617,-1.0420452552484631,1041461314,1055177959.4,16.730199354950088,30.123872114795237,NaN,NaN,-22.96562227586796,-15.315452232962333
2023-03-01T09:30:00-05:00,126.56,127.24,126.41,126.96,11101021,8463978.5,30.757044964897347,40.04841139228644,NaN,NaN,-178.42717300956966,-191.3552610752874,-0.4428805110658267,-1.5956458940807465,-1.1527653830149198,1030360293,1049797923.4,14.326506861156588,28.032893252698393,NaN,NaN,-25.331082980668874,-16.74625662549184
2023-03-02T09:30:00-05:00,126.39,128.105,126.39,127.74,10203680,8382010.5,35.28782546799266,39.765751881797954,NaN,NaN,-133.14083380085123,-183.5430116974616,-0.3766946182081057,-1.623633655775052,-1.2469390375669462,1040563973,1044467521.8,12.42220452976241,26.24234123232436,NaN,NaN,-26.01671335610366,-18.070607587007814
2023-03-03T09:30:00-05:00,128.33,129.22,127.69,129.17,10048013,8320676.2,42.69142859047181,39.563888002966344,NaN,NaN,-74.35491869017014,-153.59450448128763,-0.21283626400883127,-1.5129843675779853,-1.300148103569154,1050611986,1042948326.2,11.935274622321685,24.536479473238504,NaN,NaN,-24.32934881714085,-18.96471347702682
2023-03-06T09:30:00-05:00,129.26,129.7,128.81,129.11,8153402,8226007.75,42.471865985657395,38.9969680815687,NaN,NaN,-48.525633112805295,-126.1174510656692,-0.09095165115124026,-1.4138376675082043,-1.322886016356964,1042458584,1041091230,11.349603443548418,22.604354606084907,NaN,NaN,-23.03999113411411,-19.54689599946786
2023-03-07T09:30:00-05:00,129.37,129.52,126.81,127.03,9604352,8339811.2,35.63058527504063,38.175162906780635,NaN,NaN,-91.98298857564168,-105.2863094378076,-0.13046914271191978,-1.4859724447468636,-1.3555033020349438,1032854232,1039369813.6,10.819611437714613,20.778133917523295,NaN,NaN,-24.005314807771825,-20.183812972082713
2023-03-08T09:30:00-05:00,126.77,127.16,125.84,126.35,10793366,8501929.15,33.7183861721181,37.40259271769434,NaN,NaN,-125.34860802295874,-94.67059644048543,-0.1794366793242741,-1.5797991511902865,-1.4003624718660124,1022060866,1037709928.2,10.31921726889118,19.069187619052027,NaN,NaN,-25.400205686546713,-20.929011931291857
2023-03-09T09:30:00-05:00,126.84,127.05,124.56,125.07,13270342,8884738.9,30.41002667491955,36.73167595948957,NaN,NaN,-138.05569936660243,-95.65356955363566,-0.2696419877151057,-1.7374149565098946,-1.467772968794789,1008790524,1031355238.4,8.666670385572871,17.386851434565408,NaN,NaN,-27.664597185490038,-21.89123839617731
2023-03-10T09:30:00-05:00,124.86,125.9,123.67,124.15,20483224,9504604,28.263508692082837,35.51152527850899,NaN,NaN,-151.3080539489214,-111.04419660538592,-0.3573766936179037,-1.9144938358171686,-1.557117142199265,988307300,1018894301.2,6.4764602956840065,15.622451771212436,NaN,NaN,-30.24407734066253,-23.084501102532343
2023-03-13T09:30:00-04:00,123.75,127.02,123.6,125.31,21294203,10259381.5,34.53778013760733,35.14952845108685,NaN,NaN,-115.55874942370467,-124.4508198675658,-0.30540840097121036,-1.938877643413278,-1.6334692424420676,1009601503,1012322885,5.663594912777015,14.089296391641225,NaN,NaN,-30.42692540360161,-24.13341885982795
2023-03-14T09:30:00-04:00,126.16,126.82,125.17,126.43,14583013,10673517.4,39.99481431105003,35.27318625725352,NaN,NaN,-82.36133831709598,-122.52648981585666,-0.17045785813371062,-1.8465415651092059,-1.6760837069754952,1024184516,1010588941.8,5.468559081291062,12.784313998594556,NaN,NaN,-28.816121297998038,-24.802376350995107
2023-03-15T09:30:00-04:00,125.07,126.5,124.84,126.32,17244563,11190445.85,39.64525848517748,35.24747525205999,NaN,NaN,-82.8335573414418,-114.02347967955328,-0.06867719751766832,-1.7619302038725806,-1.6932530063549123,1006939953,1007564759.2,5.13633336022815,11.499115534041547,NaN,NaN,-27.643685580185178,-25.208277669450833
2023-03-16T09:30:00-04:00,125.37,127.56,125.02,127.5,16015825,11666639.7,45.1803305306759,35.98079431567634,NaN,NaN,-47.965194844695354,-96.00537877517186,0.08945902866520661,-1.581429220523404,-1.6708882491886106,1022955778,1010397810,10.614775919336353,10.660393784148026,NaN,NaN,-24.904042747547084,-25.164815537750297
2023-03-17T09:30:00-04:00,127.39,127.49,125.455,125.86,15072931,12019885.75,39.72719479694791,36.40150319442734,NaN,NaN,-59.053998358311546,-77.55456765704989,0.0944583620845747,-1.5528152965828923,-1.647273658667467,1007882847,1014312919.4,17.689157421596903,10.54415492105941,NaN,NaN,-24.225620510520606,-25.030644819574626
2023-03-20T09:30:00-04:00,125.58,127.145,125.58,126.96,10594319,12027879.2,44.560556398031906,37.34832903447652,NaN,NaN,-41.27475999228141,-62.69776977076524,0.1778574937017834,-1.4249517915402379,-1.6028092852420213,1018477166,1016088052,20.751714554024474,10.831406006707581,NaN,NaN,-22.08750496433156,-24.610196268825618
2023-03-21T09:30:00-04:00,127.45,127.88,126.675,127.73,8816257,12015381.15,47.720930231846545,38.560035124972885,NaN,NaN,8.144230983770312,-44.59665591059197,0.2845589774181494,-1.2471105634693345,-1.5316695408874839,1027293423,1016709833.4,21.84858567875834,11.368697350821991,NaN,NaN,-19.3188497765179,-23.854289627067374
2023-03-22T09:30:00-04:00,127.8,128.27,125.78,125.8,10480142,12173441.4,41.357070103516385,38.99355259893887,NaN,NaN,-28.99497773521424,-33.82893998934646,0.22731619611884546,-1.247524295738927,-1.4748404918577724,1016813281,1018684499,25.38087601024114,12.294316742284758,NaN,NaN,-18.97215960549086,-23.15684248112787
2023-03-23T09:30:00-04:00,126.32,127.08,124.84,125.56,10092300,12180281,40.6314444918754,38.84641087761055,NaN,NaN,-71.40781473534551,-38.51746396747647,0.17765083908043078,-1.252776943007234,-1.4304277820876647,1006720981,1015437539.6,23.50001914034773,13.120369922143762,NaN,NaN,-18.92683379046327,-22.552555525318642
2023-03-24T09:30:00-04:00,125.44,127.42,124.97,127.3,8163893,12138074.8,47.78440402849756,39.225877880670566,NaN,NaN,-16.561611667296383,-30.01898662927345,0.26129247701533354,-1.103812185818498,-1.3651046628338315,1014884874,1016837945,26.04553122918962,14.170079049689564,NaN,NaN,-16.542538687853284,-21.69398169139502
2023-03-27T09:30:00-04:00,128.2,128.78,127.67,127.82,9455363,12287648,49.73355827371721,40.23323309486175,NaN,NaN,101.00432240018537,-1.563170150780088,0.3456506356753397,-0.9330413682396568,-1.2786920039149965,1024340237,1018010559.2,28.199923585322196,15.41152991737582,NaN,NaN,-14.002891870421664,-20.595254574113113
2023-03-28T09:30:00-04:00,127.69,128.15,126.74,127.05,8037474,12175384.15,46.93937228059341,41.177589245467125,NaN,NaN,42.20945083012425,5.249873818490699,0.3429231075309067,-0.8500381195013631,-1.1929612270322698,1016302763,1015812427.2,26.63362702447482,16.576844899917507,NaN,NaN,-12.752601135257121,-19.4748755114194
2023-03-29T09:30:00-04:00,127.68,127.84,126.85,127.4,8183112,12029488.7,48.359598071117794,42.459701488052715,NaN,NaN,42.69798922976666,19.58846721148688,0.35644913190742433,-0.7473998121479895,-1.1038489440554138,1024485875,1017346946,29.574388612177813,18.070253344675002,NaN,NaN,-11.310712912034564,-18.308566568650136
2023-03-30T09:30:00-04:00,128.09,128.13,127.275,128.09,6820534,11860331.4,51.13634735992103,44.09347567861259,NaN,NaN,73.78171856976576,48.62637387250913,0.40033909759607633,-0.6034250720603183,-1.0037641696563946,1031306409,1022264031.6,38.13193980370626,20.33135902381945,NaN,NaN,-9.274950744960782,-17.0180500224088
2023-03-31T09:30:00-04:00,128.52,129.53,128.45,129.46,9202493,11818055.4,56.175111554101925,45.63899935121935,NaN,NaN,162.17320261437808,84.37333672884401,0.5034433665380579,-0.3744599614838222,-0.8779033280218801,1040508902,1027388837.2,45.55722958455186,23.18090435751765,NaN,NaN,-5.932800240810408,-15.434442910751887
2023-04-03T09:30:00-04:00,129.56,131.06,129.2,130.91,8937258,11857248.2,60.784354435724694,47.123966502981816,NaN,NaN,228.0873248615157,109.78993722111008,0.642215081274816,-0.07513447642836013,-0.7173495577031761,1049446160,1032410021.8,51.6767391276893,26.481488646546097,NaN,NaN,-1.542617035268547,-13.44989635711141
2023-04-04T09:30:00-04:00,131.05,131.69,130.69,130.93,9052600,11829660.6,60.84552420819397,48.63827119748299,NaN,NaN,220.81287506819316,145.51062206872388,0.7033448201103877,0.16183146743480847,-0.5415133526755792,1058498760,1040849221.2,59.84603427724395,30.389324426332937,NaN,NaN,1.9648533789680895,-11.247789251957196
2023-04-05T09:30:00-04:00,131.66,133.42,131.51,133.19,12325750,11906279.8,67.09208523174834,50.20339653327388,NaN,NaN,235.42383346564273,184.05579091589908,0.8539540525387449,0.5259292129978519,-0.328024839540893,1070824510,1050116948.2,66.53650043369936,34.38373332021601,NaN,NaN,7.259346430126655,-8.603912725945218
2023-04-06T09:30:00-04:00,133.71,134.11,133.07,133.52,8276295,11656577.45,67.89744396030713,52.21555718779955,NaN,NaN,209.46841053062664,211.19312930807126,0.9276376880203814,0.8315222704845837,-0.09611541753579766,1079100805,1059675827.4,71.76253283016192,38.246117277970654,NaN,NaN,11.759391195886945,-5.694869308540623
2023-04-10T09:30:00-04:00,133.16,133.5,132.46,133.43,8024299,11033631.2,67.41288661305933,53.84786648887293,NaN,NaN,157.64189581436065,210.28686794806777,0.9203255389676759,1.0542915061737972,0.1339659672061213,1071076506,1065789348.2,74.50490549359802,42.08563091651162,NaN,NaN,15.24034105736923,-2.7041249705535013
2023-04-11T09:30:00-04:00,133.74,134.365,133.66,133.88,8887512,10413296.65,68.61879966816133,55.3405714486097,NaN,NaN,150.78560895727185,194.826524767219,0.8949940466495618,1.2527085255180737,0.3577144788685118,1079964018,1071892919.8,76.9153712163873,46.01897274062797,NaN,NaN,18.50642545734266,0.32595366200309295
2023-04-12T09:30:00-04:00,134.4,134.895,133.68,133.92,8988716,10133581.8,68.72957321832585,57.29575024252466,NaN,NaN,132.00318823438624,177.0645874004576,0.8314911831147503,1.3970784577619497,0.5655872746471994,1088952734,1077983714.6,79.04456692702652,49.852093520398356,NaN,NaN,21.22351264908974,3.3113192315868996
2023-04-13T09:30:00-04:00,134.49,135.81,134.195,135.66,9373699,9740038.6,73.16681144681309,59.61970502502021,NaN,NaN,134.98370849005818,156.9765624053407,0.8539870605340074,1.6330711003147087,0.7790840397807013,1098326433,1083484099.2,80.76955389722325,53.94277457446089,NaN,NaN,25.085433524516375,6.421906987719682
2023-04-14T09:30:00-04:00,135.35,135.635,134.07,134.57,6632126,9270853.65,66.77458612327587,60.97614660321866,NaN,NaN,108.29812455176193,136.74250520956778,0.746655613785047,1.71240355701201,0.965747943226963,1091694307,1086002799.6,81.51973398743148,57.905217628621024,NaN,NaN,26.531721862855555,9.294737684167664
2023-04-17T09:30:00-04:00,134.61,134.76,133.755,134.46,7187113,8876562.75,66.14653368330039,62.14850198961746,NaN,NaN,88.48424835882251,122.91097571846015,0.6244169385806648,1.746269116452794,1.121852177872129,1084507194,1088688937.2,82.31221008911663,61.770380950320636,NaN,NaN,27.525474577450705,11.899128668922383
2023-04-18T09:30:00-04:00,134.73,134.73,133.36,133.54,7194221,8706557.85,60.980518913331714,63.151441034813054,NaN,NaN,70.97083529270769,106.9480209855473,0.4461271745235642,1.6795111460265844,1.2333839715030201,1077312973,1088158728.2,81.5686692016854,65.6943125344071,NaN,NaN,26.881112052988946,14.039412009503321
2023-04-19T09:30:00-04:00,133.58,134.15,133.17,133.95,7048082,8618149.1,62.39022946187746,64.15362899129589,NaN,NaN,62.12466039590277,92.97231541785062,0.32591259670988104,1.6407747173903715,1.3148621206804905,1084361055,1087240392.4,80.21707439469992,69.31164723315868,NaN,NaN,26.734302792636623,15.852967835665222
2023-04-20T09:30:00-04:00,133.31,133.6,132.7707,133.4,6672031,8427743.55,59.29542535195525,64.73642027644118,NaN,NaN,45.781776430113844,75.13192900586174,0.18639248934621033,1.5478527323632534,1.361460243017043,1077689024,1083112910.6,74.26109963267187,71.89230150665622,NaN,NaN,25.728064478940198,17.263695927561646
2023-04-21T09:30:00-04:00,134.13,134.75,133.71,134.3,6536148,8249935.95,62.567546530167995,65.19302277473163,NaN,NaN,64.18206379566847,66.30871685464305,0.13419671099397235,1.5292061317595085,1.3950094207655361,1084225172,1081619083.6,72.17248876771345,73.79339144831063,NaN,NaN,25.770287913969785,18.47892335419138